UNITID,EFLEVEL,EFTOTAL,EFMEN,EFWOM,EFFT,EFFTMEN,EFFTWOM,EFPT,EFPTMEN,EFPTWOM
100654,10,5969,2353,3616,5064,1986,3078,905,367,538
100663,10,22289,8111,14178,14926,5613,9313,7363,2498,4865
100690,10,723,293,430,289,121,168,434,172,262
100706,10,9636,5485,4151,6897,4080,2817,2739,1405,1334
100724,10,3964,1364,2600,3378,1149,2229,586,215,371
100751,10,38316,16228,22088,31895,13914,17981,6421,2314,4107
100760,10,1578,646,932,494,235,259,1084,411,673
100812,10,2794,863,1931,1168,357,811,1626,506,1120
100830,10,5068,1746,3322,3417,1228,2189,1651,518,1133
100858,10,31526,15681,15845,26269,12799,13470,5257,2882,2375
100937,10,1058,515,543,1041,504,537,17,11,6
101028,10,1360,471,889,498,192,306,862,279,583
101116,10,395,64,331,252,43,209,143,21,122
101143,10,1796,945,851,913,500,413,883,445,438
101161,10,7048,2947,4101,2826,1122,1704,4222,1825,2397
101189,10,2866,1181,1685,2062,852,1210,804,329,475
101240,10,4308,1710,2598,1854,840,1014,2454,870,1584
101277,10,57,2,55,57,2,55,,,
101286,10,3899,1255,2644,1298,426,872,2601,829,1772
101295,10,5204,1758,3446,2384,909,1475,2820,849,1971
101301,10,1627,662,965,480,237,243,1147,425,722
101365,10,615,143,472,279,81,198,336,62,274
101435,10,844,463,381,797,452,345,47,11,36
101453,10,131,113,18,40,34,6,91,79,12
101462,10,872,374,498,255,118,137,617,256,361
101471,10,400,303,97,291,213,78,109,90,19
101480,10,9540,3664,5876,6729,2669,4060,2811,995,1816
101505,10,8519,3086,5433,2247,885,1362,6272,2201,4071
101514,10,8702,3930,4772,2503,1159,1344,6199,2771,3428
101569,10,3094,1046,2048,1214,455,759,1880,591,1289
101587,10,5594,1365,4229,4751,1085,3666,843,280,563
101602,10,1816,821,995,763,302,461,1053,519,534
101648,10,314,232,82,314,232,82,,,
101675,10,1520,709,811,1421,651,770,99,58,41
101693,10,1911,677,1234,1107,372,735,804,305,499
101709,10,2625,893,1732,2118,744,1374,507,149,358
101736,10,3371,1452,1919,900,407,493,2471,1045,1426
101879,10,8526,3049,5477,5127,1796,3331,3399,1253,2146
101897,10,2489,824,1665,885,308,577,1604,516,1088
101912,10,1452,624,828,1313,564,749,139,60,79
101994,10,374,145,229,144,74,70,230,71,159
102030,10,2479,822,1657,887,374,513,1592,448,1144
102049,10,5758,1897,3861,5490,1819,3671,268,78,190
102058,10,30,21,9,11,8,3,19,13,6
102067,10,4659,1794,2865,1671,770,901,2988,1024,1964
102076,10,2245,869,1376,997,392,605,1248,477,771
102094,10,13992,4462,9530,11548,3658,7890,2444,804,1640
102234,10,1107,481,626,971,405,566,136,76,60
102270,10,728,320,408,643,268,375,85,52,33
102298,10,1203,579,624,1061,515,546,142,64,78
102313,10,1846,731,1115,758,356,402,1088,375,713
102368,10,14901,5295,9606,8580,2953,5627,6321,2342,3979
102377,10,2654,929,1725,2482,870,1612,172,59,113
102395,10,168,123,45,47,34,13,121,89,32
102429,10,3371,1337,2034,1061,455,606,2310,882,1428
102553,10,10845,4163,6682,4194,1852,2342,6651,2311,4340
102580,10,44,28,16,24,19,5,20,9,11
102614,10,6826,2625,4201,2711,1290,1421,4115,1335,2780
102632,10,1997,670,1327,534,202,332,1463,468,995
102669,10,554,134,420,344,79,265,210,55,155
102711,10,259,193,66,83,63,20,176,130,46
102845,10,2215,570,1645,2215,570,1645,,,
103501,10,317,42,275,317,42,275,,,
103741,10,138,5,133,112,5,107,26,0,26
103893,10,1281,262,1019,1281,262,1019,,,
103909,10,591,66,525,591,66,525,,,
103927,10,517,80,437,517,80,437,,,
103954,10,48,3,45,48,3,45,,,
103963,10,398,359,39,397,359,38,1,0,1
104090,10,1032,133,899,1032,133,899,,,
104151,10,77881,39380,38501,69401,34812,34589,8480,4568,3912
104160,10,8081,3372,4709,2012,885,1127,6069,2487,3582
104179,10,48274,21394,26880,35632,15403,20229,12642,5991,6651
104346,10,4841,1773,3068,1030,458,572,3811,1315,2496
104391,10,56,3,53,56,3,53,,,
104425,10,3473,1472,2001,1383,530,853,2090,942,1148
104443,10,43,2,41,33,2,31,10,0,10
104568,10,377,11,366,213,6,207,164,5,159
104577,10,4583,1801,2782,1315,584,731,3268,1217,2051
104586,10,3071,2257,814,2925,2140,785,146,117,29
104665,10,6,5,1,6,5,1,,,
104708,10,13882,6045,7837,3654,1780,1874,10228,4265,5963
104717,10,103072,27655,75417,22295,8683,13612,80777,18972,61805
105145,10,4673,1600,3073,985,387,598,3688,1213,2475
105154,10,16494,7395,9099,4264,2068,2196,12230,5327,6903
105206,10,3793,1244,2549,729,288,441,3064,956,2108
105215,10,781,728,53,781,728,53,,,
105297,10,1315,319,996,652,161,491,663,158,505
105330,10,28711,10412,18299,22343,8136,14207,6368,2276,4092
105349,10,2786,1092,1694,435,203,232,2351,889,1462
105367,10,938,326,612,598,219,379,340,107,233
105428,10,9050,3189,5861,2062,779,1283,6988,2410,4578
105525,10,15000,6234,8766,3119,1451,1668,11881,4783,7098
105534,10,2551,459,2092,2551,459,2092,,,
105543,10,782,126,656,782,126,656,,,
105589,10,1047,252,795,544,153,391,503,99,404
105659,10,1007,934,73,1007,934,73,,,
105668,10,15682,6363,9319,2074,833,1241,13608,5530,8078
105677,10,12,12,0,12,12,0,,,
105747,10,7320,3128,4192,1643,777,866,5677,2351,3326
105792,10,3597,1413,2184,891,393,498,2706,1020,1686
105899,10,1053,639,414,876,555,321,177,84,93
106041,10,1986,1898,88,1986,1898,88,,,
106111,10,48,1,47,27,1,26,21,0,21
106148,10,7550,3054,4496,1353,646,707,6197,2408,3789
106245,10,8295,3086,5209,4154,1672,2482,4141,1414,2727
106263,10,3088,882,2206,2294,717,1577,794,165,629
106306,10,414,324,90,344,267,77,70,57,13
106315,10,28,2,26,28,2,26,,,
106324,10,33,0,33,28,0,28,5,0,5
106342,10,579,342,237,573,338,235,6,4,2
106351,10,62,47,15,62,47,15,,,
106360,10,25,1,24,25,1,24,,,
106397,10,29068,12926,16142,23282,10198,13084,5786,2728,3058
106412,10,2670,1111,1559,2220,923,1297,450,188,262
106449,10,2776,1100,1676,1295,514,781,1481,586,895
106458,10,12863,4492,8371,6052,2438,3614,6811,2054,4757
106467,10,9640,4169,5471,5550,2557,2993,4090,1612,2478
106485,10,2677,1093,1584,1774,778,996,903,315,588
106494,10,38,0,38,38,0,38,,,
106546,10,666,81,585,592,75,517,74,6,68
106625,10,1380,461,919,693,247,446,687,214,473
106704,10,10105,3710,6395,7571,2821,4750,2534,889,1645
106713,10,622,332,290,497,280,217,125,52,73
106795,10,1360,516,844,492,183,309,868,333,535
106810,10,197,111,86,170,95,75,27,16,11
106883,10,1056,353,703,391,121,270,665,232,433
106892,10,62,1,61,62,1,61,,,
106908,10,330,21,309,315,20,295,15,1,14
106980,10,2325,916,1409,1224,505,719,1101,411,690
106999,10,1060,347,713,520,163,357,540,184,356
107044,10,4973,2050,2923,3683,1553,2130,1290,497,793
107071,10,2919,1209,1710,2156,989,1167,763,220,543
107080,10,1120,548,572,1110,542,568,10,6,4
107099,10,85,3,82,85,3,82,,,
107123,10,66,8,58,66,8,58,,,
107141,10,2459,909,1550,1412,563,849,1047,346,701
107220,10,196,2,194,196,2,194,,,
107293,10,53,0,53,53,0,53,,,
107318,10,1077,425,652,233,55,178,844,370,474
107327,10,1457,564,893,481,210,271,976,354,622
107442,10,33,22,11,33,22,11,,,
107460,10,1792,769,1023,750,319,431,1042,450,592
107488,10,155,106,49,153,104,49,2,2,0
107512,10,1764,747,1017,1599,661,938,165,86,79
107521,10,1597,750,847,281,76,205,1316,674,642
107549,10,1007,306,701,480,123,357,527,183,344
107558,10,784,370,414,776,366,410,8,4,4
107585,10,1953,750,1203,1025,417,608,928,333,595
107600,10,710,256,454,613,221,392,97,35,62
107619,10,1289,474,815,492,168,324,797,306,491
107637,10,997,301,696,268,107,161,729,194,535
107655,10,37,0,37,37,0,37,,,
107664,10,4418,1472,2946,2313,844,1469,2105,628,1477
107725,10,1191,376,815,470,152,318,721,224,497
107743,10,718,253,465,405,165,240,313,88,225
107789,10,118,2,116,118,2,116,,,
107831,10,84,1,83,84,1,83,,,
107840,10,245,75,170,202,64,138,43,11,32
107877,10,629,299,330,588,285,303,41,14,27
107974,10,1132,377,755,450,149,301,682,228,454
107983,10,4434,1821,2613,2913,1311,1602,1521,510,1011
107992,10,984,445,539,480,217,263,504,228,276
108065,10,15,0,15,11,0,11,4,0,4
108092,10,5447,2228,3219,3378,1311,2067,2069,917,1152
108232,10,7805,3158,4647,3824,1675,2149,3981,1483,2498
108269,10,119,40,79,96,36,60,23,4,19
108667,10,4983,2107,2876,595,322,273,4388,1785,2603
108807,10,9836,4410,5426,2872,1308,1564,6964,3102,3862
108852,10,217,98,119,217,98,119,,,
108861,10,60,40,20,13,8,5,47,32,15
108870,10,430,207,223,421,202,219,9,5,4
108977,10,185,53,132,101,32,69,84,21,63
109040,10,1902,397,1505,1902,397,1505,,,
109086,10,24,11,13,24,11,13,,,
109208,10,25849,12142,13707,4660,2073,2587,21189,10069,11120
109350,10,11105,4633,6472,3199,1440,1759,7906,3193,4713
109651,10,2319,969,1350,1990,839,1151,329,130,199
109721,10,180,52,128,180,52,128,,,
109730,10,43,35,8,43,35,8,,,
109785,10,8126,2336,5790,5355,1587,3768,2771,749,2022
109819,10,24479,10606,13873,6140,2602,3538,18339,8004,10335
109907,10,2341,730,1611,910,278,632,1431,452,979
109934,10,406,63,343,406,63,343,,,
110060,10,366,263,103,290,219,71,76,44,32
110097,10,5551,2432,3119,4048,1666,2382,1503,766,737
110194,10,241,240,1,241,240,1,,,
110219,10,1361,394,967,1361,394,967,,,
110246,10,9537,4203,5334,4096,1897,2199,5441,2306,3135
110316,10,1846,389,1457,1169,272,897,677,117,560
110334,10,9075,3782,5293,2933,1295,1638,6142,2487,3655
110361,10,11489,3861,7628,9444,3238,6206,2045,623,1422
110370,10,1630,567,1063,1523,537,986,107,30,77
110398,10,1140,444,696,1107,433,674,33,11,22
110404,10,2397,1487,910,2397,1487,910,,,
110413,10,3766,1620,2146,3437,1474,1963,329,146,183
110422,10,22231,11381,10850,20776,10506,10270,1455,875,580
110468,10,3662,880,2782,1337,246,1091,2325,634,1691
110486,10,10972,3650,7322,8541,2771,5770,2431,879,1552
110495,10,10481,3340,7141,8208,2569,5639,2273,771,1502
110510,10,19514,7208,12306,15213,5477,9736,4301,1731,2570
110529,10,29456,15610,13846,24305,12671,11634,5151,2939,2212
110538,10,15702,7003,8699,13619,6086,7533,2083,917,1166
110547,10,17837,6365,11472,13018,4623,8395,4819,1742,3077
110556,10,25047,9819,15228,20507,7859,12648,4540,1960,2580
110565,10,40738,16545,24193,30104,12030,18074,10634,4515,6119
110574,10,15189,5867,9322,11539,4420,7119,3650,1447,2203
110583,10,40190,16691,23499,32144,13098,19046,8046,3593,4453
110592,10,27513,11007,16506,22088,8646,13442,5425,2361,3064
110608,10,40108,17387,22721,30944,13183,17761,9164,4204,4960
110617,10,32498,13605,18893,25120,10188,14932,7378,3417,3961
110635,10,45036,21273,23763,40937,19052,21885,4099,2221,1878
110644,10,40050,16285,23765,38382,15512,22870,1668,773,895
110653,10,36505,16883,19622,35304,16255,19049,1201,628,573
110662,10,46116,19990,26126,43955,18701,25254,2161,1289,872
110671,10,26847,12888,13959,25729,12280,13449,1118,608,510
110680,10,41885,21160,20725,40280,20232,20048,1605,928,677
110699,10,3165,1130,2035,3165,1130,2035,,,
110705,10,26124,11729,14395,25244,11289,13955,880,440,440
110714,10,19841,10375,9466,19004,9898,9106,837,477,360
110778,10,1046,452,594,83,16,67,963,436,527
110875,10,63,0,63,59,0,59,4,0,4
110918,10,14,10,4,7,5,2,7,5,2
111045,10,62,22,40,41,17,24,21,5,16
111054,10,94,21,73,94,21,73,,,
111081,10,1444,579,865,1410,562,848,34,17,17
111188,10,925,738,187,852,687,165,73,51,22
111391,10,758,315,443,495,195,300,263,120,143
111434,10,4845,1861,2984,505,222,283,4340,1639,2701
111461,10,15443,7415,8028,5196,2443,2753,10247,4972,5275
111513,10,194,5,189,151,3,148,43,2,41
111638,10,246,96,150,246,96,150,,,
111708,10,198,158,40,198,158,40,,,
111717,10,176,134,42,170,132,38,6,2,4
111726,10,159,118,41,159,118,41,,,
111744,10,135,115,20,135,115,20,,,
111762,10,90,48,42,90,48,42,,,
111799,10,156,22,134,156,22,134,,,
111887,10,18656,8592,10064,6735,2995,3740,11921,5597,6324
111896,10,4862,2252,2610,822,434,388,4040,1818,2222
111920,10,11071,5176,5895,2791,1273,1518,8280,3903,4377
111939,10,18688,7173,11515,4926,2006,2920,13762,5167,8595
111948,10,9991,3948,6043,8927,3499,5428,1064,449,615
111966,10,895,256,639,738,224,514,157,32,125
112075,10,3710,1375,2335,3038,1072,1966,672,303,369
112084,10,462,210,252,395,185,210,67,25,42
112127,10,64,27,37,25,16,9,39,11,28
112172,10,9982,4222,5760,3676,1637,2039,6306,2585,3721
112181,10,101,2,99,101,2,99,,,
112190,10,17447,7973,9474,5317,2740,2577,12130,5233,6897
112251,10,1953,797,1156,1174,488,686,779,309,470
112260,10,1422,700,722,1416,696,720,6,4,2
112288,10,430,25,405,430,25,405,,,
112367,10,340,38,302,114,10,104,226,28,198
112385,10,6792,3463,3329,591,261,330,6201,3202,2999
112394,10,434,319,115,346,256,90,88,63,25
112455,10,132,25,107,132,25,107,,,
112525,10,3788,1381,2407,3731,1370,2361,57,11,46
112561,10,2063,963,1100,509,215,294,1554,748,806
112570,10,493,280,213,448,254,194,45,26,19
112686,10,4236,1461,2775,742,302,440,3494,1159,2335
112826,10,5631,2227,3404,1353,593,760,4278,1634,2644
113096,10,13799,5769,8030,2988,1366,1622,10811,4403,6408
113111,10,5260,2296,2964,1541,697,844,3719,1599,2120
113193,10,9661,4632,5029,2613,1259,1354,7048,3373,3675
113218,10,7809,3312,4497,1379,638,741,6430,2674,3756
113236,10,13406,5558,7848,4559,1984,2575,8847,3574,5273
113333,10,16706,8233,8473,8178,4391,3787,8528,3842,4686
113449,10,159,42,117,159,42,117,,,
113537,10,13,3,10,13,3,10,,,
113573,10,10229,4205,6024,3727,1567,2160,6502,2638,3864
113582,10,127,13,114,82,10,72,45,3,42
113634,10,17123,8103,9020,5934,3022,2912,11189,5081,6108
113698,10,1855,537,1318,1617,468,1149,238,69,169
113704,10,65,54,11,46,41,5,19,13,6
113856,10,29506,13904,15602,5033,2179,2854,24473,11725,12748
113980,10,19675,9055,10620,6663,3198,3465,13012,5857,7155
114114,10,198,35,163,81,12,69,117,23,94
114123,10,73,20,53,63,17,46,10,3,7
114266,10,8085,3530,4555,2023,939,1084,6062,2591,3471
114354,10,1764,306,1458,1515,256,1259,249,50,199
114433,10,1376,702,674,443,213,230,933,489,444
114460,10,297,41,256,183,30,153,114,11,103
114549,10,1146,253,893,788,174,614,358,79,279
114585,10,375,90,285,243,57,186,132,33,99
114637,10,58,2,56,58,2,56,,,
114716,10,12438,6502,5936,3338,1571,1767,9100,4931,4169
114734,10,64,41,23,26,21,5,38,20,18
114761,10,59,7,52,59,7,52,,,
114789,10,20435,8143,12292,5579,2341,3238,14856,5802,9054
114813,10,3524,954,2570,1777,511,1266,1747,443,1304
114840,10,2191,1151,1040,505,222,283,1686,929,757
114859,10,17813,8081,9732,6611,3106,3505,11202,4975,6227
114938,10,4538,2062,2476,1460,670,790,3078,1392,1686
114947,10,104,47,57,104,47,57,,,
115001,10,11398,4958,6440,5608,2518,3090,5790,2440,3350
115010,10,305,62,243,305,62,243,,,
115083,10,2425,1351,1074,1260,768,492,1165,583,582
115126,10,10189,4385,5804,2963,1365,1598,7226,3020,4206
115214,10,194,97,97,145,79,66,49,18,31
115296,10,13023,5171,7852,3916,1649,2267,9107,3522,5585
115357,10,116,27,89,56,16,40,60,11,49
115393,10,9808,4714,5094,3047,1298,1749,6761,3416,3345
115409,10,905,455,450,902,454,448,3,1,2
115658,10,99,15,84,48,11,37,51,4,47
115728,10,1015,306,709,690,222,468,325,84,241
115746,10,908,247,661,620,175,445,288,72,216
115755,10,5908,2392,3516,5055,2014,3041,853,378,475
115773,10,352,90,262,163,47,116,189,43,146
115861,10,7225,3007,4218,3307,1290,2017,3918,1717,2201
115931,10,693,505,188,693,505,188,,,
116226,10,113,1,112,49,0,49,64,1,63
116350,10,158,28,130,158,28,130,,,
116439,10,11045,5621,5424,3813,2102,1711,7232,3519,3713
116563,10,226,7,219,226,7,219,,,
116846,10,124,26,98,83,17,66,41,9,32
117052,10,6329,2856,3473,1660,873,787,4669,1983,2686
117104,10,551,250,301,470,208,262,81,42,39
117140,10,6201,2248,3953,4281,1572,2709,1920,676,1244
117168,10,766,207,559,654,175,479,112,32,80
117195,10,2024,1241,783,606,328,278,1418,913,505
117238,10,82,18,64,82,18,64,,,
117247,10,8168,3816,4352,1406,753,653,6762,3063,3699
117274,10,1610,1178,432,463,302,161,1147,876,271
117283,10,49,22,27,24,9,15,25,13,12
117520,10,607,331,276,571,312,259,36,19,17
117557,10,370,254,116,362,249,113,8,5,3
117575,10,180,109,71,65,28,37,115,81,34
117627,10,1738,684,1054,1393,561,832,345,123,222
117636,10,4390,1484,2906,3524,1279,2245,866,205,661
117645,10,21761,9354,12407,8242,3627,4615,13519,5727,7792
117672,10,1564,675,889,1005,518,487,559,157,402
117690,10,6815,2681,4134,1420,661,759,5395,2020,3375
117706,10,15148,6506,8642,3744,1671,2073,11404,4835,6569
117715,10,4565,1425,3140,528,155,373,4037,1270,2767
117724,10,9822,5116,4706,1899,1107,792,7923,4009,3914
117733,10,14018,5910,8108,2433,1117,1316,11585,4793,6792
117751,10,2435,1561,874,1412,833,579,1023,728,295
117788,10,12747,5362,7385,2479,1107,1372,10268,4255,6013
117803,10,180,53,127,,,,180,53,127
117867,10,8840,3418,5422,1424,641,783,7416,2777,4639
117894,10,7859,3309,4550,2648,1216,1432,5211,2093,3118
117946,10,10184,4465,5719,9420,4133,5287,764,332,432
117955,10,272,54,218,170,32,138,102,22,80
118134,10,93,2,91,35,2,33,58,0,58
118143,10,103,4,99,18,2,16,85,2,83
118161,10,76,4,72,76,4,72,,,
118198,10,555,126,429,555,126,429,,,
118347,10,4213,1713,2500,1001,466,535,3212,1247,1965
118541,10,514,246,268,458,216,242,56,30,26
118684,10,3269,1074,2195,697,219,478,2572,855,1717
118693,10,745,405,340,712,389,323,33,16,17
118718,10,9282,3603,5679,3779,1524,2255,5503,2079,3424
118772,10,6289,2125,4164,980,310,670,5309,1815,3494
118888,10,817,70,747,584,42,542,233,28,205
118912,10,11125,4440,6685,3933,1678,2255,7192,2762,4430
118930,10,5910,2544,3366,1316,657,659,4594,1887,2707
118958,10,81,33,48,28,10,18,53,23,30
118976,10,14642,5516,9126,4770,1885,2885,9872,3631,6241
118994,10,346,200,146,346,200,146,,,
119058,10,713,224,489,583,184,399,130,40,90
119067,10,6828,2987,3841,1901,862,1039,4927,2125,2802
119137,10,12709,5781,6928,4254,2055,2199,8455,3726,4729
119164,10,25540,11656,13884,8486,4109,4377,17054,7547,9507
119173,10,2625,274,2351,2107,206,1901,518,68,450
119216,10,14035,5609,8426,4550,1912,2638,9485,3697,5788
119270,10,777,563,214,486,363,123,291,200,91
119331,10,4481,1838,2643,1520,645,875,2961,1193,1768
119553,10,1201,290,911,1178,281,897,23,9,14
119605,10,17135,6321,10814,8430,2976,5454,8705,3345,5360
119678,10,2787,2217,570,1490,1233,257,1297,984,313
119775,10,378,229,149,321,193,128,57,36,21
119951,10,221,14,207,221,14,207,,,
120069,10,190,18,172,190,18,172,,,
120078,10,384,46,338,384,46,338,,,
120087,10,171,24,147,171,24,147,,,
120166,10,57,23,34,56,23,33,1,0,1
120184,10,203,52,151,53,9,44,150,43,107
120254,10,1964,826,1138,1938,815,1123,26,11,15
120290,10,8267,4094,4173,2858,1483,1375,5409,2611,2798
120342,10,16779,8084,8695,6224,3153,3071,10555,4931,5624
120403,10,1252,375,877,1214,358,856,38,17,21
120421,10,6438,2865,3573,1476,690,786,4962,2175,2787
120537,10,1138,428,710,871,335,536,267,93,174
120661,10,735,159,576,705,156,549,30,3,27
120698,10,1149,202,947,775,132,643,374,70,304
120768,10,1175,134,1041,32,3,29,1143,131,1012
120795,10,97,40,57,27,7,20,70,33,37
120838,10,25,16,9,25,16,9,,,
120865,10,829,306,523,735,285,450,94,21,73
120883,10,6066,2634,3432,5319,2322,2997,747,312,435
120953,10,4152,3641,511,530,397,133,3622,3244,378
120971,10,17566,8950,8616,5331,2602,2729,12235,6348,5887
121044,10,21192,9676,11516,7165,3506,3659,14027,6170,7857
121150,10,10446,3602,6844,6377,2504,3873,4069,1098,2971
121257,10,1168,483,685,1132,463,669,36,20,16
121275,10,64,46,18,64,46,18,,,
121309,10,4445,1461,2984,3133,1043,2090,1312,418,894
121345,10,1761,799,962,1753,795,958,8,4,4
121363,10,3623,1288,2335,1216,476,740,2407,812,1595
121433,10,137,5,132,126,4,122,11,1,10
121619,10,23936,14029,9907,3715,1807,1908,20221,12222,7999
121628,10,132,72,60,132,72,60,,,
121637,10,116,15,101,116,15,101,,,
121691,10,4059,1569,2490,3361,1272,2089,698,297,401
121707,10,3686,1708,1978,971,478,493,2715,1230,1485
121859,10,194,15,179,110,15,95,84,0,84
121868,10,187,3,184,111,1,110,76,2,74
121886,10,15593,8531,7062,3886,1871,2015,11707,6660,5047
121901,10,17960,7009,10951,5038,2132,2906,12922,4877,8045
122117,10,108,41,67,81,31,50,27,10,17
122180,10,18333,7072,11261,4091,1646,2445,14242,5426,8816
122205,10,17392,7707,9685,5277,2712,2565,12115,4995,7120
122296,10,2048,495,1553,1418,374,1044,630,121,509
122339,10,12956,5493,7463,1687,714,973,11269,4779,6490
122375,10,18028,7896,10132,3553,1749,1804,14475,6147,8328
122384,10,13101,6908,6193,1690,1045,645,11411,5863,5548
122409,10,36484,15350,21134,31032,12835,18197,5452,2515,2937
122436,10,9041,3918,5123,7187,2994,4193,1854,924,930
122454,10,70,30,40,52,21,31,18,9,9
122506,10,442,223,219,441,223,218,1,0,1
122597,10,26899,11635,15264,20865,8819,12046,6034,2816,3218
122612,10,10034,3503,6531,7735,2662,5073,2299,841,1458
122649,10,161,57,104,10,5,5,151,52,99
122658,10,16640,6706,9934,6930,2917,4013,9710,3789,5921
122685,10,2240,570,1670,2240,570,1670,,,
122694,10,813,226,587,813,226,587,,,
122728,10,1676,717,959,1299,547,752,377,170,207
122746,10,7326,2954,4372,1567,698,869,5759,2256,3503
122755,10,37133,17682,19451,27333,13200,14133,9800,4482,5318
122791,10,6894,3379,3515,1237,685,552,5657,2694,2963
122834,10,9,2,7,9,2,7,,,
122889,10,12746,5476,7270,5514,2495,3019,7232,2981,4251
122931,10,8918,4497,4421,7678,3914,3764,1240,583,657
122977,10,23408,10082,13326,8812,4031,4781,14596,6051,8545
123013,10,14967,6476,8491,4236,1981,2255,10731,4495,6236
123095,10,915,168,747,233,47,186,682,121,561
123165,10,1116,7,1109,1110,6,1104,6,1,5
123217,10,11928,4762,7166,4482,1934,2548,7446,2828,4618
123280,10,39,20,19,13,6,7,26,14,12
123299,10,7075,2654,4421,2519,958,1561,4556,1696,2860
123341,10,15773,6972,8801,5553,2557,2996,10220,4415,5805
123350,10,122,11,111,83,10,73,39,1,38
123448,10,371,121,250,175,63,112,196,58,138
123457,10,858,354,504,710,289,421,148,65,83
123484,10,1329,656,673,523,276,247,806,380,426
123493,10,163,50,113,163,50,113,,,
123509,10,7776,3612,4164,1193,629,564,6583,2983,3600
123527,10,9913,3797,6116,2391,1002,1389,7522,2795,4727
123554,10,3165,1267,1898,2482,1035,1447,683,232,451
123563,10,8105,3411,4694,2436,1020,1416,5669,2391,3278
123572,10,7371,2739,4632,6108,2212,3896,1263,527,736
123633,10,260,79,181,171,46,125,89,33,56
123642,10,272,19,253,176,14,162,96,5,91
123651,10,2268,714,1554,1831,571,1260,437,143,294
123679,10,734,210,524,653,195,458,81,15,66
123800,10,15985,7002,8983,6001,2601,3400,9984,4401,5583
123916,10,75,18,57,35,12,23,40,6,34
123943,10,729,225,504,705,215,490,24,10,14
123952,10,522,305,217,511,298,213,11,7,4
123961,10,49318,22707,26611,42631,19670,22961,6687,3037,3650
123970,10,956,399,557,745,328,417,211,71,140
124113,10,3943,1939,2004,852,273,579,3091,1666,1425
124283,10,237,139,98,168,97,71,69,42,27
124292,10,497,247,250,497,247,250,,,
124487,10,132,73,59,20,12,8,112,61,51
124681,10,1108,424,684,1108,424,684,,,
124706,10,744,161,583,744,161,583,,,
124937,10,714,220,494,659,215,444,55,5,50
125028,10,10741,4441,6300,3044,1324,1720,7697,3117,4580
125037,10,258,89,169,233,86,147,25,3,22
125082,10,94,14,80,93,13,80,1,1,0
125091,10,10523,3972,6551,3004,1250,1754,7519,2722,4797
125170,10,5484,2296,3188,790,338,452,4694,1958,2736
125231,10,46455,8474,37981,18782,3322,15460,27673,5152,22521
125310,10,55,12,43,55,12,43,,,
125462,10,3801,1794,2007,434,213,221,3367,1581,1786
125471,10,9481,3735,5746,1563,698,865,7918,3037,4881
125499,10,6717,2946,3771,2035,988,1047,4682,1958,2724
125532,10,1641,165,1476,1641,165,1476,,,
125718,10,124,112,12,87,78,9,37,34,3
125727,10,1238,489,749,1233,487,746,5,2,3
125763,10,1387,595,792,1309,555,754,78,40,38
125897,10,1036,494,542,948,454,494,88,40,48
126012,10,517,111,406,517,111,406,,,
126049,10,286,113,173,230,89,141,56,24,32
126076,10,142,142,0,142,142,0,,,
126119,10,5243,1939,3304,1259,533,726,3984,1406,2578
126164,10,53,1,52,53,1,52,,,
126182,10,3138,1347,1791,1912,765,1147,1226,582,644
126207,10,6940,3101,3839,1941,897,1044,4999,2204,2795
126289,10,11897,5213,6684,2150,970,1180,9747,4243,5504
126359,10,217,32,185,217,32,185,,,
126562,10,24267,9656,14611,12631,5260,7371,11636,4396,7240
126580,10,12031,5396,6635,7960,3586,4374,4071,1810,2261
126605,10,316,278,38,316,278,38,,,
126614,10,39000,21625,17375,31369,16980,14389,7631,4645,2986
126669,10,8472,2697,5775,2524,859,1665,5948,1838,4110
126678,10,2266,979,1287,2200,953,1247,66,26,40
126687,10,781,125,656,781,125,656,,,
126711,10,5134,2136,2998,1373,657,716,3761,1479,2282
126748,10,1150,481,669,435,184,251,715,297,418
126775,10,7187,4926,2261,6439,4388,2051,748,538,210
126784,10,149,147,2,149,147,2,,,
126818,10,32586,14701,17885,22955,10110,12845,9631,4591,5040
126827,10,24015,8208,15807,15727,5281,10446,8288,2927,5361
126863,10,7839,3307,4532,1300,609,691,6539,2698,3841
126915,10,205,73,132,65,24,41,140,49,91
126942,10,7091,2616,4475,1766,670,1096,5325,1946,3379
126951,10,1292,1180,112,1292,1180,112,,,
126979,10,899,485,414,560,290,270,339,195,144
127060,10,14130,5424,8706,8881,3473,5408,5249,1951,3298
127158,10,5086,4468,618,1123,843,280,3963,3625,338
127185,10,3567,1601,1966,2952,1343,1609,615,258,357
127200,10,18537,7959,10578,4305,2056,2249,14232,5903,8329
127273,10,197,76,121,132,48,84,65,28,37
127316,10,228,45,183,84,25,59,144,20,124
127389,10,696,278,418,350,153,197,346,125,221
127556,10,8907,4066,4841,6704,3084,3620,2203,982,1221
127565,10,17678,7537,10141,10515,4599,5916,7163,2938,4225
127617,10,1365,498,867,316,119,197,1049,379,670
127653,10,964,247,717,645,170,475,319,77,242
127714,10,588,300,288,31,11,20,557,289,268
127732,10,1392,581,811,710,336,374,682,245,437
127741,10,10348,3156,7192,6880,2264,4616,3468,892,2576
127778,10,1151,469,682,501,255,246,650,214,436
127820,10,11845,4713,7132,3962,1708,2254,7883,3005,4878
127884,10,5938,2450,3488,1589,724,865,4349,1726,2623
127909,10,6035,2884,3151,1939,1049,890,4096,1835,2261
127918,10,5566,1870,3696,3983,1265,2718,1583,605,978
127945,10,1849,443,1406,1073,261,812,776,182,594
127954,10,38,5,33,38,5,33,,,
128106,10,6110,2291,3819,3038,1303,1735,3072,988,2084
128151,10,926,487,439,918,484,434,8,3,5
128179,10,672,485,187,672,485,187,,,
128188,10,787,333,454,787,333,454,,,
128258,10,1500,662,838,615,301,314,885,361,524
128328,10,4181,2987,1194,4181,2987,1194,,,
128337,10,84,1,83,59,1,58,25,0,25
128391,10,3689,1805,1884,1947,1070,877,1742,735,1007
128498,10,1328,488,840,1114,426,688,214,62,152
128577,10,1220,557,663,437,241,196,783,316,467
128586,10,40,40,0,40,40,0,,,
128744,10,3563,1137,2426,2282,828,1454,1281,309,972
128771,10,9653,4830,4823,6555,3387,3168,3098,1443,1655
128780,10,1618,397,1221,383,81,302,1235,316,919
128896,10,158,30,128,158,30,128,,,
128902,10,1829,744,1085,1811,734,1077,18,10,8
129002,10,318,150,168,275,131,144,43,19,24
129020,10,26876,12588,14288,23619,10999,12620,3257,1589,1668
129154,10,3258,580,2678,421,123,298,2837,457,2380
129181,10,1170,1083,87,869,805,64,301,278,23
129215,10,4319,1787,2532,3550,1470,2080,769,317,452
129242,10,5826,2342,3484,5053,2083,2970,773,259,514
129349,10,180,4,176,171,4,167,9,0,9
129367,10,2474,628,1846,525,168,357,1949,460,1489
129428,10,105,79,26,,,,105,79,26
129482,10,407,31,376,407,31,376,,,
129491,10,112,60,52,33,23,10,79,37,42
129525,10,5917,2520,3397,4365,1927,2438,1552,593,959
129534,10,695,446,249,155,101,54,540,345,195
129543,10,3604,1313,2291,1154,472,682,2450,841,1609
129695,10,4494,1891,2603,1460,649,811,3034,1242,1792
129729,10,4673,1794,2879,1676,753,923,2997,1041,1956
129756,10,1988,768,1220,770,346,424,1218,422,796
129774,10,526,303,223,493,284,209,33,19,14
129808,10,3019,1123,1896,1060,476,584,1959,647,1312
129923,10,568,276,292,329,167,162,239,109,130
129932,10,323,287,36,254,221,33,69,66,3
129941,10,7513,3488,4025,6460,2934,3526,1053,554,499
130004,10,4106,1696,2410,1238,592,646,2868,1104,1764
130040,10,1128,367,761,439,173,266,689,194,495
130110,10,213,82,131,124,43,81,89,39,50
130174,10,1633,790,843,1458,745,713,175,45,130
130183,10,14052,4022,10030,5094,1402,3692,8958,2620,6338
130217,10,1118,413,705,405,159,246,713,254,459
130226,10,9217,3316,5901,7759,2873,4886,1458,443,1015
130253,10,9785,2980,6805,7451,2448,5003,2334,532,1802
130314,10,2132,429,1703,1525,317,1208,607,112,495
130396,10,5703,2142,3561,1774,797,977,3929,1345,2584
130493,10,8788,3043,5745,6453,2286,4167,2335,757,1578
130509,10,566,42,524,234,22,212,332,20,312
130590,10,2190,1119,1071,2125,1080,1045,65,39,26
130606,10,3320,1390,1930,1322,584,738,1998,806,1192
130624,10,1049,628,421,1049,628,421,,,
130697,10,3581,1566,2015,3370,1479,1891,211,87,124
130776,10,4802,2147,2655,3521,1674,1847,1281,473,808
130794,10,14567,6895,7672,14360,6810,7550,207,85,122
130837,10,67,8,59,67,8,59,,,
130873,10,251,47,204,251,47,204,,,
130907,10,12402,3990,8412,3524,1391,2133,8878,2599,6279
130934,10,5200,1668,3532,4471,1451,3020,729,217,512
130943,10,23996,10273,13723,21510,9089,12421,2486,1184,1302
130989,10,1116,496,620,684,314,370,432,182,250
131061,10,144,11,133,75,8,67,69,3,66
131113,10,13129,4424,8705,3602,1468,2134,9527,2956,6571
131159,10,14852,5515,9337,11240,4132,7108,3612,1383,2229
131283,10,5059,2298,2761,3692,1698,1994,1367,600,767
131399,10,3476,1302,2174,1653,712,941,1823,590,1233
131405,10,74,67,7,71,66,5,3,1,2
131450,10,1433,567,866,1150,462,688,283,105,178
131469,10,26457,9871,16586,17659,6745,10914,8798,3126,5672
131496,10,20935,9352,11583,15382,6847,8535,5553,2505,3048
131520,10,12065,3523,8542,11056,3162,7894,1009,361,648
131803,10,446,116,330,44,25,19,402,91,311
131830,10,27,17,10,27,17,10,,,
131876,10,1862,83,1779,1114,27,1087,748,56,692
131973,10,448,224,224,179,93,86,269,131,138
132374,10,2790,2318,472,2790,2318,472,,,
132408,10,446,213,233,199,95,104,247,118,129
132471,10,7337,2283,5054,4950,1592,3358,2387,691,1696
132602,10,2624,992,1632,2475,930,1545,149,62,87
132657,10,3385,1625,1760,2825,1377,1448,560,248,312
132675,10,51,29,22,43,21,22,8,8,0
132693,10,12677,4945,7732,3635,1583,2052,9042,3362,5680
132709,10,30947,12117,18830,9364,3975,5389,21583,8142,13441
132842,10,838,125,713,564,79,485,274,46,228
132851,10,5331,1906,3425,2025,797,1228,3306,1109,2197
132879,10,149,88,61,134,81,53,15,7,8
132903,10,70309,31148,39161,46732,20976,25756,23577,10172,13405
132976,10,481,249,232,481,249,232,,,
133021,10,1756,641,1115,700,287,413,1056,354,702
133155,10,740,331,409,447,232,215,293,99,194
133386,10,11613,4438,7175,4385,1958,2427,7228,2480,4748
133465,10,522,81,441,399,64,335,123,17,106
133492,10,2036,619,1417,1981,597,1384,55,22,33
133508,10,14756,5134,9622,5552,2110,3442,9204,3024,6180
133526,10,1110,571,539,1042,545,497,68,26,42
133553,10,9593,7048,2545,7139,5322,1817,2454,1726,728
133650,10,9000,3075,5925,7618,2526,5092,1382,549,833
133669,10,30155,12420,17735,18295,7555,10740,11860,4865,6995
133702,10,20717,7399,13318,5895,2310,3585,14822,5089,9733
133711,10,2641,872,1769,2552,837,1715,89,35,54
133809,10,535,258,277,522,254,268,13,4,9
133845,10,678,75,603,658,75,583,20,0,20
133854,10,349,79,270,349,79,270,,,
133863,10,438,51,387,438,51,387,,,
133872,10,1667,333,1334,700,157,543,967,176,791
133881,10,7830,3970,3860,4048,2660,1388,3782,1310,2472
133942,10,53,4,49,53,4,49,,,
133951,10,56664,24109,32555,34000,14138,19862,22664,9971,12693
133960,10,865,357,508,337,191,146,528,166,362
133979,10,1028,513,515,904,451,453,124,62,62
133997,10,353,135,218,353,135,218,,,
134024,10,26,9,17,26,9,17,,,
134079,10,3386,1198,2188,3012,1088,1924,374,110,264
134097,10,45130,18841,26289,36819,15546,21273,8311,3295,5016
134130,10,55781,24049,31732,44576,19513,25063,11205,4536,6669
134228,10,29,11,18,24,10,14,5,1,4
134237,10,25622,17597,8025,25622,17597,8025,,,
134291,10,603,506,97,587,491,96,16,15,1
134307,10,890,830,60,189,182,7,701,648,53
134343,10,4377,1504,2873,1610,604,1006,2767,900,1867
134422,10,24,0,24,23,0,23,1,0,1
134495,10,19198,7948,11250,8652,4036,4616,10546,3912,6634
134510,10,160,82,78,89,39,50,71,43,28
134529,10,324,28,296,324,28,296,,,
134574,10,115,14,101,115,14,101,,,
134608,10,14461,5506,8955,4287,1816,2471,10174,3690,6484
134714,10,186,30,156,51,11,40,135,19,116
134811,10,934,318,616,559,192,367,375,126,249
134945,10,3995,1363,2632,3029,1122,1907,966,241,725
135081,10,19861,5487,14374,11690,3415,8275,8171,2072,6099
135142,10,223,6,217,16,0,16,207,6,201
135160,10,2792,919,1873,944,324,620,1848,595,1253
135179,10,692,404,288,454,271,183,238,133,105
135188,10,4342,1591,2751,1390,543,847,2952,1048,1904
135267,10,704,482,222,701,480,221,3,2,1
135276,10,1468,790,678,805,385,420,663,405,258
135294,10,458,214,244,348,211,137,110,3,107
135337,10,85,4,81,50,4,46,35,0,35
135364,10,611,424,187,120,86,34,491,338,153
135391,10,8424,3074,5350,3493,1450,2043,4931,1624,3307
135407,10,1044,577,467,1041,576,465,3,1,2
135522,10,257,166,91,257,166,91,,,
135559,10,83,6,77,51,3,48,32,3,29
135610,10,137,54,83,50,21,29,87,33,54
135647,10,896,737,159,590,506,84,306,231,75
135717,10,44002,17898,26104,18565,7833,10732,25437,10065,15372
135726,10,19096,8725,10371,17738,8174,9564,1358,551,807
135735,10,2330,1732,598,238,209,29,2092,1523,569
136109,10,134,3,131,75,3,72,59,0,59
136145,10,1182,339,843,356,96,260,826,243,583
136172,10,16594,6734,9860,11432,4699,6733,5162,2035,3127
136215,10,20898,5814,15084,14807,4596,10211,6091,1218,4873
136233,10,4697,1798,2899,1946,827,1119,2751,971,1780
136303,10,243,22,221,123,16,107,120,6,114
136330,10,3687,1346,2341,2663,917,1746,1024,429,595
136358,10,24151,9452,14699,6343,2771,3572,17808,6681,11127
136400,10,9257,3511,5746,2962,1228,1734,6295,2283,4012
136473,10,8604,2896,5708,3174,1178,1996,5430,1718,3712
136491,10,644,380,264,516,339,177,128,41,87
136516,10,9044,3111,5933,3148,1179,1969,5896,1932,3964
136659,10,428,295,133,168,127,41,260,168,92
136701,10,136,134,2,114,113,1,22,21,1
136765,10,335,166,169,287,142,145,48,24,24
136774,10,1663,469,1194,1635,465,1170,28,4,24
136826,10,435,228,207,232,125,107,203,103,100
136950,10,3057,1248,1809,2760,1137,1623,297,111,186
137023,10,379,175,204,373,171,202,6,4,2
137032,10,9523,3628,5895,7452,2734,4718,2071,894,1177
137078,10,24543,9239,15304,7226,3096,4130,17317,6143,11174
137087,10,655,351,304,606,339,267,49,12,37
137096,10,12830,5787,7043,5347,2661,2686,7483,3126,4357
137120,10,1489,825,664,866,467,399,623,358,265
137209,10,15315,6496,8819,4850,2412,2438,10465,4084,6381
137245,10,1492,765,727,1492,765,727,,,
137272,10,45,43,2,45,43,2,,,
137281,10,6318,2251,4067,1681,659,1022,4637,1592,3045
137315,10,2777,971,1806,1044,407,637,1733,564,1169
137351,10,49708,20957,28751,35770,15290,20480,13938,5667,8271
137476,10,5896,2530,3366,3513,1584,1929,2383,946,1437
137546,10,4257,1846,2411,3761,1625,2136,496,221,275
137564,10,9365,3871,5494,5154,2061,3093,4211,1810,2401
137591,10,278,43,235,259,42,217,19,1,18
137713,10,199,69,130,118,43,75,81,26,55
137759,10,11935,5052,6883,6278,2870,3408,5657,2182,3475
137777,10,32,32,0,32,32,0,,,
137801,10,511,248,263,487,243,244,24,5,19
137847,10,10794,4236,6558,9943,3889,6054,851,347,504
137856,10,178,105,73,89,52,37,89,53,36
137865,10,329,177,152,312,162,150,17,15,2
137953,10,365,204,161,276,161,115,89,43,46
137962,10,204,121,83,161,100,61,43,21,22
138187,10,43599,17360,26239,14581,6223,8358,29018,11137,17881
138275,10,907,468,439,717,375,342,190,93,97
138284,10,347,186,161,261,141,120,86,45,41
138293,10,812,540,272,767,512,255,45,28,17
138309,10,8469,1156,7313,4228,605,3623,4241,551,3690
138354,10,13288,5156,8132,6827,2919,3908,6461,2237,4224
138372,10,1624,1049,575,242,79,163,1382,970,412
138479,10,833,535,298,833,535,298,,,
138488,10,610,212,398,214,51,163,396,161,235
138497,10,384,200,184,384,200,184,,,
138558,10,3814,1527,2287,2407,1103,1304,1407,424,983
138600,10,1109,17,1092,1065,13,1052,44,4,40
138655,10,702,475,227,657,445,212,45,30,15
138664,10,65,19,46,65,19,46,,,
138682,10,2370,707,1663,831,264,567,1539,443,1096
138716,10,6297,1607,4690,4140,1127,3013,2157,480,1677
138761,10,272,125,147,200,116,84,72,9,63
138813,10,586,289,297,358,177,181,228,112,116
138822,10,577,15,562,577,15,562,,,
138840,10,3383,1124,2259,1039,444,595,2344,680,1664
138868,10,1666,782,884,721,367,354,945,415,530
138901,10,1605,548,1057,633,223,410,972,325,647
138929,10,303,121,182,193,86,107,110,35,75
138938,10,396,32,364,222,14,208,174,18,156
138947,10,4055,986,3069,3685,880,2805,370,106,264
138956,10,3705,1576,2129,1274,565,709,2431,1011,1420
139144,10,2303,825,1478,2213,794,1419,90,31,59
139153,10,410,206,204,209,103,106,201,103,98
139199,10,2551,324,2227,1617,194,1423,934,130,804
139205,10,893,532,361,549,336,213,344,196,148
139250,10,3232,999,2233,1661,528,1133,1571,471,1100
139278,10,6200,2025,4175,1735,620,1115,4465,1405,3060
139311,10,6817,1988,4829,3706,1072,2634,3111,916,2195
139348,10,177,85,92,133,63,70,44,22,22
139357,10,2927,860,2067,791,261,530,2136,599,1537
139366,10,7898,3025,4873,4737,1798,2939,3161,1227,1934
139384,10,6326,2333,3993,1520,618,902,4806,1715,3091
139393,10,914,419,495,840,384,456,74,35,39
139463,10,4525,1721,2804,2705,1054,1651,1820,667,1153
139506,10,113,72,41,113,72,41,,,
139579,10,787,206,581,642,171,471,145,35,110
139621,10,2008,852,1156,1215,539,676,793,313,480
139630,10,918,493,425,758,418,340,160,75,85
139658,10,14779,5783,8996,13384,5169,8215,1395,614,781
139700,10,5240,1867,3373,2042,795,1247,3198,1072,2126
139719,10,2923,1049,1874,2370,863,1507,553,186,367
139746,10,67,14,53,67,14,53,,,
139755,10,43843,30031,13812,22571,14036,8535,21272,15995,5277
139764,10,3157,1033,2124,1940,593,1347,1217,440,777
139861,10,6763,2348,4415,5342,1848,3494,1421,500,921
139931,10,27076,10908,16168,20732,8614,12118,6344,2294,4050
139940,10,36973,14351,22622,27697,10813,16884,9276,3538,5738
139959,10,40118,16480,23638,35681,14684,20997,4437,1796,2641
139968,10,3101,1035,2066,1580,585,995,1521,450,1071
139986,10,4996,1404,3592,1283,401,882,3713,1003,2710
139995,10,320,138,182,320,138,182,,,
140003,10,172,33,139,87,21,66,85,12,73
140012,10,8004,3275,4729,1649,837,812,6355,2438,3917
140146,10,237,131,106,130,64,66,107,67,40
140234,10,643,336,307,616,335,281,27,1,26
140243,10,5068,1992,3076,1238,491,747,3830,1501,2329
140252,10,2787,1350,1437,2373,1174,1199,414,176,238
140331,10,8980,3785,5195,2579,1251,1328,6401,2534,3867
140340,10,608,111,497,385,82,303,223,29,194
140447,10,9009,2987,6022,7165,2546,4619,1844,441,1403
140553,10,2554,2553,1,2197,2197,0,357,356,1
140562,10,753,293,460,725,283,442,28,10,18
140678,10,2660,1081,1579,817,389,428,1843,692,1151
140696,10,1446,534,912,1375,504,871,71,30,41
140720,10,251,134,117,209,113,96,42,21,21
140818,10,2060,577,1483,1426,452,974,634,125,509
140827,10,66,12,54,66,12,54,,,
140872,10,1218,625,593,1078,555,523,140,70,70
140942,10,3582,1317,2265,1115,494,621,2467,823,1644
140951,10,15636,4769,10867,12694,3871,8823,2942,898,2044
140960,10,3385,1268,2117,2627,999,1628,758,269,489
140988,10,1460,658,802,1216,557,659,244,101,143
141006,10,1611,762,849,679,370,309,932,392,540
141015,10,144,58,86,141,55,86,3,3,0
141060,10,2417,0,2417,2363,0,2363,54,0,54
141167,10,1388,445,943,896,301,595,492,144,348
141185,10,1764,692,1072,828,332,496,936,360,576
141237,10,2710,1237,1473,901,419,482,1809,818,991
141255,10,3567,1253,2314,734,234,500,2833,1019,1814
141264,10,11557,3585,7972,7477,2367,5110,4080,1218,2862
141325,10,734,47,687,492,4,488,242,43,199
141334,10,12687,4068,8619,7356,2597,4759,5331,1471,3860
141361,10,1407,580,827,920,406,514,487,174,313
141486,10,2214,602,1612,1781,464,1317,433,138,295
141565,10,3243,1120,2123,2269,780,1489,974,340,634
141574,10,19098,7474,11624,13698,5239,8459,5400,2235,3165
141608,10,72,48,24,72,48,24,,,
141644,10,4586,1611,2975,2921,884,2037,1665,727,938
141680,10,3210,1741,1469,884,581,303,2326,1160,1166
141796,10,6100,2126,3974,1617,658,959,4483,1468,3015
141802,10,1343,517,826,246,119,127,1097,398,699
141811,10,6413,2278,4135,1833,758,1075,4580,1520,3060
141839,10,2724,864,1860,737,241,496,1987,623,1364
141981,10,3008,999,2009,1641,590,1051,1367,409,958
141990,10,2386,779,1607,459,112,347,1927,667,1260
142054,10,489,69,420,489,69,420,,,
142090,10,89,51,38,74,43,31,15,8,7
142115,10,25794,10778,15016,14555,6199,8356,11239,4579,6660
142179,10,2156,795,1361,619,258,361,1537,537,1000
142276,10,12135,4942,7193,6993,2883,4110,5142,2059,3083
142285,10,11303,5439,5864,8114,3983,4131,3189,1456,1733
142294,10,1145,561,584,1118,547,571,27,14,13
142328,10,3710,1302,2408,2064,780,1284,1646,522,1124
142407,10,90,10,80,64,10,54,26,0,26
142416,10,11,1,10,11,1,10,,,
142443,10,4579,1756,2823,1735,825,910,2844,931,1913
142461,10,2044,772,1272,1611,609,1002,433,163,270
142489,10,43,0,43,43,0,43,,,
142522,10,44304,19348,24956,17917,8521,9396,26387,10827,15560
142559,10,7927,2942,4985,1821,707,1114,6106,2235,3871
142832,10,1864,333,1531,1175,208,967,689,125,564
142887,10,145,46,99,112,36,76,33,10,23
142957,10,19,13,6,7,7,0,12,6,6
143048,10,3559,890,2669,3187,794,2393,372,96,276
143084,10,2367,1075,1292,2346,1062,1284,21,13,8
143118,10,6165,1807,4358,4722,1460,3262,1443,347,1096
143215,10,7213,3148,4065,3011,1417,1594,4202,1731,2471
143233,10,74,39,35,22,13,9,52,26,26
143279,10,3736,1382,2354,1306,506,800,2430,876,1554
143288,10,414,185,229,405,181,224,9,4,5
143297,10,157,8,149,112,5,107,45,3,42
143358,10,5588,2423,3165,4575,2214,2361,1013,209,804
143376,10,224,14,210,133,12,121,91,2,89
143464,10,116,3,113,91,3,88,25,0,25
143473,10,40,1,39,21,1,20,19,0,19
143482,10,32,0,32,13,0,13,19,0,19
143491,10,39,2,37,12,1,11,27,1,26
143552,10,47,1,46,21,0,21,26,1,25
143613,10,1687,610,1077,674,285,389,1013,325,688
143659,10,227,143,84,90,78,12,137,65,72
143853,10,2853,999,1854,2805,987,1818,48,12,36
143978,10,1297,247,1050,842,147,695,455,100,355
144005,10,2366,720,1646,1421,472,949,945,248,697
144014,10,317,111,206,126,45,81,191,66,125
144050,10,18832,10151,8681,16710,8833,7877,2122,1318,804
144157,10,1903,725,1178,800,320,480,1103,405,698
144166,10,6551,1524,5027,2458,585,1873,4093,939,3154
144175,10,1831,642,1189,613,236,377,1218,406,812
144184,10,4749,1681,3068,1087,410,677,3662,1271,2391
144193,10,4545,1882,2663,1389,781,608,3156,1101,2055
144209,10,5750,2346,3404,2149,923,1226,3601,1423,2178
144218,10,7236,3088,4148,2477,1226,1251,4759,1862,2897
144281,10,6736,2688,4048,6322,2510,3812,414,178,236
144351,10,6086,2114,3972,1464,622,842,4622,1492,3130
144485,10,149,102,47,149,102,47,,,
144564,10,2032,860,1172,732,291,441,1300,569,731
144573,10,134,2,132,87,1,86,47,1,46
144740,10,21670,9745,11925,18123,8018,10105,3547,1727,1820
144795,10,436,110,326,398,101,297,38,9,29
144865,10,20849,9502,11347,6887,3383,3504,13962,6119,7843
144883,10,487,217,270,487,217,270,,,
144892,10,8608,3445,5163,4714,1928,2786,3894,1517,2377
144944,10,8050,3434,4616,2618,1254,1364,5432,2180,3252
144962,10,3518,1326,2192,2865,1043,1822,653,283,370
144971,10,476,263,213,459,254,205,17,9,8
145099,10,283,21,262,283,21,262,,,
145239,10,308,48,260,308,48,260,,,
145275,10,284,127,157,163,72,91,121,55,66
145309,10,48,15,33,48,15,33,,,
145336,10,4395,1523,2872,2441,942,1499,1954,581,1373
145354,10,52,2,50,12,0,12,40,2,38
145372,10,1047,530,517,820,457,363,227,73,154
145406,10,500,7,493,136,3,133,364,4,360
145424,10,75,2,73,21,2,19,54,0,54
145433,10,114,1,113,46,0,46,68,1,67
145497,10,170,31,139,67,10,57,103,21,82
145521,10,1203,456,747,581,238,343,622,218,404
145558,10,2051,865,1186,1980,847,1133,71,18,53
145600,10,34199,15189,19010,28487,12929,15558,5712,2260,3452
145619,10,3378,1403,1975,2155,1046,1109,1223,357,866
145628,10,514,136,378,496,134,362,18,2,16
145637,10,56607,30978,25629,46600,25220,21380,10007,5758,4249
145646,10,1653,816,837,1645,812,833,8,4,4
145682,10,7385,2990,4395,2187,1050,1137,5198,1940,3258
145691,10,1097,522,575,1069,512,557,28,10,18
145707,10,992,433,559,461,210,251,531,223,308
145725,10,6486,4111,2375,5132,3149,1983,1354,962,392
145813,10,20233,8492,11741,17733,7503,10230,2500,989,1511
145831,10,2470,1018,1452,914,430,484,1556,588,968
145886,10,127,26,101,123,25,98,4,1,3
146205,10,2954,1151,1803,1268,524,744,1686,627,1059
146278,10,1728,687,1041,836,354,482,892,333,559
146296,10,11551,4994,6557,3657,1753,1904,7894,3241,4653
146339,10,1173,523,650,1058,493,565,115,30,85
146348,10,2231,845,1386,864,370,494,1367,475,892
146366,10,2282,816,1466,1109,415,694,1173,401,772
146418,10,2442,1023,1419,885,419,466,1557,604,953
146427,10,1156,501,655,1129,489,640,27,12,15
146454,10,48,0,48,48,0,48,,,
146472,10,12117,5056,7061,3800,1880,1920,8317,3176,5141
146481,10,1690,702,988,1654,687,967,36,15,21
146490,10,394,175,219,,,,394,175,219
146506,10,3644,1505,2139,1722,717,1005,1922,788,1134
146533,10,152,30,122,105,21,84,47,9,38
146603,10,4125,1714,2411,1324,585,739,2801,1129,1672
146612,10,6183,2803,3380,4161,2014,2147,2022,789,1233
146667,10,537,311,226,318,172,146,219,139,80
146676,10,888,435,453,649,352,297,239,83,156
146685,10,4840,1882,2958,1758,815,943,3082,1067,2015
146700,10,1184,852,332,1184,852,332,,,
146719,10,17498,5584,11914,15377,4984,10393,2121,600,1521
146728,10,130,63,67,111,51,60,19,12,7
146755,10,133,20,113,97,16,81,36,4,32
146807,10,74,7,67,24,3,21,50,4,46
146816,10,258,24,234,176,13,163,82,11,71
146977,10,203,126,77,51,31,20,152,95,57
147004,10,8765,3836,4929,2079,1050,1029,6686,2786,3900
147013,10,1958,887,1071,1431,739,692,527,148,379
147031,10,70,22,48,44,14,30,26,8,18
147129,10,550,60,490,273,33,240,277,27,250
147244,10,1906,817,1089,1755,765,990,151,52,99
147341,10,755,368,387,750,366,384,5,2,3
147369,10,2606,1419,1187,1714,868,846,892,551,341
147378,10,10578,5103,5475,3808,1831,1977,6770,3272,3498
147396,10,74,68,6,71,65,6,3,3,0
147411,10,3850,1602,2248,1016,490,526,2834,1112,1722
147536,10,7315,1581,5734,4201,1094,3107,3114,487,2627
147590,10,466,191,275,421,180,241,45,11,34
147642,10,55,6,49,25,2,23,30,4,26
147660,10,2728,1258,1470,2638,1221,1417,90,37,53
147679,10,2749,1105,1644,1812,723,1089,937,382,555
147697,10,346,243,103,251,188,63,95,55,40
147703,10,16234,7372,8862,11889,5528,6361,4345,1844,2501
147767,10,23409,10964,12445,18835,8837,9998,4574,2127,2447
147776,10,6440,2504,3936,3144,1276,1868,3296,1228,2068
147800,10,7433,3426,4007,2136,1119,1017,5297,2307,2990
147819,10,45,2,43,45,2,43,,,
147828,10,3462,1313,2149,2562,1106,1456,900,207,693
147916,10,5394,2410,2984,2052,1034,1018,3342,1376,1966
148007,10,2618,914,1704,784,309,475,1834,605,1229
148016,10,321,170,151,316,167,149,5,3,2
148098,10,41,0,41,26,0,26,15,0,15
148131,10,1188,589,599,974,495,479,214,94,120
148256,10,2002,900,1102,951,428,523,1051,472,579
148292,10,2252,820,1432,533,199,334,1719,621,1098
148380,10,5494,2353,3141,2431,1103,1328,3063,1250,1813
148405,10,1231,527,704,966,428,538,265,99,166
148487,10,4127,1436,2691,3144,1158,1986,983,278,705
148496,10,3066,838,2228,2256,661,1595,810,177,633
148511,10,2889,678,2211,1811,536,1275,1078,142,936
148575,10,431,62,369,217,33,184,214,29,185
148584,10,3426,852,2574,1446,480,966,1980,372,1608
148593,10,108,10,98,86,9,77,22,1,21
148627,10,3749,1303,2446,3010,1081,1929,739,222,517
148654,10,3944,1877,2067,2217,968,1249,1727,909,818
148672,10,1378,539,839,606,237,369,772,302,470
148821,10,1054,373,681,465,162,303,589,211,378
148876,10,737,131,606,536,94,442,201,37,164
148885,10,187,166,21,130,125,5,57,41,16
148937,10,1239,539,700,450,221,229,789,318,471
148982,10,110,31,79,45,11,34,65,20,45
148991,10,1273,526,747,525,222,303,748,304,444
149028,10,262,26,236,147,21,126,115,5,110
149204,10,35,0,35,35,0,35,,,
149222,10,11266,5633,5633,8637,4244,4393,2629,1389,1240
149231,10,13010,5419,7591,9407,4042,5365,3603,1377,2226
149310,10,231,119,112,231,119,112,,,
149329,10,88,88,0,88,88,0,,,
149365,10,3691,1389,2302,715,272,443,2976,1117,1859
149499,10,9,0,9,9,0,9,,,
149505,10,985,330,655,834,286,548,151,44,107
149514,10,1330,865,465,717,453,264,613,412,201
149532,10,9048,4199,4849,2585,1203,1382,6463,2996,3467
149550,10,151,19,132,121,17,104,30,2,28
149639,10,252,116,136,90,45,45,162,71,91
149727,10,7779,3434,4345,2355,1156,1199,5424,2278,3146
149763,10,566,103,463,406,71,335,160,32,128
149772,10,7455,3231,4224,5581,2497,3084,1874,734,1140
149781,10,3047,1296,1751,2430,1051,1379,617,245,372
149842,10,12015,5313,6702,4010,2055,1955,8005,3258,4747
150066,10,1345,620,725,1085,514,571,260,106,154
150136,10,20319,7011,13308,14259,5390,8869,6060,1621,4439
150145,10,1339,499,840,1059,408,651,280,91,189
150163,10,5559,2158,3401,4825,1904,2921,734,254,480
150172,10,638,341,297,382,194,188,256,147,109
150215,10,145,48,97,107,39,68,38,9,29
150251,10,195,9,186,102,3,99,93,6,87
150288,10,307,270,37,212,187,25,95,83,12
150303,10,296,5,291,98,3,95,198,2,196
150400,10,1724,852,872,1700,844,856,24,8,16
150428,10,9,0,9,9,0,9,,,
150455,10,736,332,404,697,319,378,39,13,26
150534,10,2078,803,1275,1795,679,1116,283,124,159
150604,10,962,499,463,928,482,446,34,17,17
150668,10,811,295,516,695,273,422,116,22,94
150677,10,1919,782,1137,1493,563,930,426,219,207
150756,10,1083,524,559,1075,519,556,8,5,3
150765,10,131,3,128,131,3,128,,,
150774,10,468,251,217,431,237,194,37,14,23
150853,10,224,2,222,125,1,124,99,1,98
150941,10,1350,505,845,1103,404,699,247,101,146
150987,10,86114,38439,47675,15729,6022,9707,70385,32417,37968
151102,10,8298,4014,4284,4972,2510,2462,3326,1504,1822
151111,10,27690,10943,16747,21019,8470,12549,6671,2473,4198
151263,10,5325,1813,3512,4413,1528,2885,912,285,627
151290,10,2450,1414,1036,1791,1078,713,659,336,323
151306,10,9756,3520,6236,5618,1947,3671,4138,1573,2565
151324,10,9459,4003,5456,7110,2982,4128,2349,1021,1328
151333,10,2995,1071,1924,2267,793,1474,728,278,450
151342,10,4449,1525,2924,3011,1024,1987,1438,501,937
151351,10,45328,23035,22293,40072,20311,19761,5256,2724,2532
151360,10,3460,921,2539,2308,625,1683,1152,296,856
151379,10,4051,1586,2465,2507,960,1547,1544,626,918
151388,10,3111,1072,2039,1678,500,1178,1433,572,861
151467,10,224,36,188,224,36,188,,,
151564,10,52,2,50,16,1,15,36,1,35
151607,10,104,5,99,71,3,68,33,2,31
151652,10,238,6,232,134,4,130,104,2,102
151661,10,1152,1044,108,1152,1044,108,,,
151777,10,1303,618,685,1241,600,641,62,18,44
151786,10,4071,1488,2583,3186,1279,1907,885,209,676
151801,10,2862,981,1881,2398,857,1541,464,124,340
151810,10,231,64,167,102,26,76,129,38,91
151865,10,122,68,54,29,9,20,93,59,34
151962,10,271,85,186,271,85,186,,,
152044,10,88,48,40,35,29,6,53,19,34
152080,10,13139,6979,6160,12850,6834,6016,289,145,144
152099,10,867,425,442,642,316,326,225,109,116
152150,10,53,3,50,38,2,36,15,1,14
152275,10,146,46,100,88,9,79,58,37,21
152309,10,109,40,69,88,31,57,21,9,12
152318,10,2101,1586,515,2073,1564,509,28,22,6
152336,10,2196,636,1560,1689,540,1149,507,96,411
152381,10,1127,173,954,775,141,634,352,32,320
152390,10,1527,11,1516,1431,1,1430,96,10,86
152451,10,183,154,29,104,101,3,79,53,26
152497,10,156,12,144,134,12,122,22,0,22
152530,10,1982,904,1078,1687,767,920,295,137,158
152567,10,4024,2072,1952,2467,1476,991,1557,596,961
152600,10,2924,1238,1686,2777,1191,1586,147,47,100
152628,10,42,1,41,20,1,19,22,0,22
152637,10,16389,8240,8149,4099,2160,1939,12290,6080,6210
152673,10,840,840,0,837,837,0,3,3,0
152798,10,552,49,503,423,38,385,129,11,118
152992,10,1000,437,563,690,351,339,310,86,224
153001,10,1959,624,1335,1295,498,797,664,126,538
153074,10,148,6,142,148,6,142,,,
153083,10,144,6,138,144,6,138,,,
153108,10,1139,584,555,1079,551,528,60,33,27
153126,10,888,429,459,812,411,401,76,18,58
153144,10,1371,597,774,1346,580,766,25,17,8
153162,10,1055,552,503,1044,543,501,11,9,2
153214,10,20536,8831,11705,5414,2559,2855,15122,6272,8850
153241,10,67,25,42,67,25,42,,,
153250,10,1784,896,888,1404,743,661,380,153,227
153269,10,4875,1814,3061,3697,1417,2280,1178,397,781
153278,10,2001,1103,898,1640,960,680,361,143,218
153296,10,714,345,369,517,273,244,197,72,125
153302,10,193,84,109,161,72,89,32,12,20
153311,10,7460,3140,4320,2091,837,1254,5369,2303,3066
153320,10,446,235,211,291,150,141,155,85,70
153366,10,1427,541,886,1102,480,622,325,61,264
153375,10,1757,825,932,1498,725,773,259,100,159
153384,10,1748,831,917,1718,812,906,30,19,11
153427,10,103,41,62,103,41,62,,,
153445,10,5085,2099,2986,1921,879,1042,3164,1220,1944
153463,10,26,1,25,26,1,25,,,
153472,10,3385,1581,1804,1704,823,881,1681,758,923
153524,10,5009,2572,2437,2497,1403,1094,2512,1169,1343
153533,10,1803,803,1000,725,406,319,1078,397,681
153542,10,14,2,12,14,2,12,,,
153597,10,48,2,46,48,2,46,,,
153603,10,30708,16948,13760,27553,15154,12399,3155,1794,1361
153621,10,827,476,351,737,435,302,90,41,49
153630,10,5684,2540,3144,2427,1335,1092,3257,1205,2052
153658,10,29909,13392,16517,24854,10985,13869,5055,2407,2648
153737,10,12604,5638,6966,4338,2078,2260,8266,3560,4706
153746,10,23,2,21,23,2,21,,,
153764,10,46,1,45,46,1,45,,,
153773,10,44,0,44,44,0,44,,,
153782,10,14,0,14,14,0,14,,,
153825,10,1386,768,618,1266,707,559,120,61,59
153834,10,1744,757,987,1717,740,977,27,17,10
153861,10,2403,1231,1172,1453,929,524,950,302,648
153922,10,1754,715,1039,670,327,343,1084,388,696
153977,10,951,151,800,535,109,426,416,42,374
154004,10,2319,832,1487,1202,594,608,1117,238,879
154013,10,1580,543,1037,1129,383,746,451,160,291
154022,10,40362,14321,26041,40362,14321,26041,,,
154059,10,2482,1133,1349,1173,582,591,1309,551,758
154095,10,9217,3424,5793,7739,2929,4810,1478,495,983
154101,10,1513,625,888,1066,521,545,447,104,343
154110,10,4013,1622,2391,916,444,472,3097,1178,1919
154129,10,1716,730,986,562,349,213,1154,381,773
154156,10,1562,741,821,1396,693,703,166,48,118
154165,10,10,0,10,10,0,10,,,
154174,10,2182,1220,962,2141,1196,945,41,24,17
154208,10,133,2,131,15,0,15,118,2,116
154235,10,2913,1199,1714,2600,1059,1541,313,140,173
154262,10,202,19,183,91,10,81,111,9,102
154332,10,74,5,69,74,5,69,,,
154350,10,1218,568,650,1077,510,567,141,58,83
154378,10,2319,924,1395,1103,465,638,1216,459,757
154396,10,1542,646,896,607,260,347,935,386,549
154448,10,140,4,136,140,4,136,,,
154457,10,14,0,14,14,0,14,,,
154466,10,41,4,37,41,4,37,,,
154493,10,3031,1183,1848,1699,680,1019,1332,503,829
154518,10,2520,1554,966,1481,866,615,1039,688,351
154527,10,1541,733,808,1474,700,774,67,33,34
154536,10,206,77,129,181,66,115,25,11,14
154545,10,96,70,26,96,70,26,,,
154572,10,5451,2139,3312,1689,766,923,3762,1373,2389
154590,10,1372,724,648,1252,677,575,120,47,73
154642,10,2090,830,1260,961,431,530,1129,399,730
154688,10,2364,941,1423,1045,470,575,1319,471,848
154697,10,3748,1547,2201,1336,557,779,2412,990,1422
154712,10,2287,1123,1164,2127,1048,1079,160,75,85
154721,10,737,425,312,687,404,283,50,21,29
154749,10,485,266,219,476,260,216,9,6,3
154800,10,7008,2635,4373,2931,1202,1729,4077,1433,2644
154855,10,570,256,314,496,227,269,74,29,45
154907,10,1531,634,897,585,264,321,946,370,576
154925,10,1402,812,590,863,531,332,539,281,258
154934,10,1317,399,918,576,201,375,741,198,543
154952,10,2407,974,1433,1308,623,685,1099,351,748
154998,10,1713,827,886,827,479,348,886,348,538
155007,10,345,106,239,164,59,105,181,47,134
155025,10,5615,1821,3794,3227,1113,2114,2388,708,1680
155052,10,1365,751,614,274,138,136,1091,613,478
155061,10,14102,5262,8840,5415,2091,3324,8687,3171,5516
155070,10,199,99,100,156,75,81,43,24,19
155089,10,1694,726,968,1056,484,572,638,242,396
155098,10,1644,783,861,785,429,356,859,354,505
155104,10,1962,885,1077,1017,511,506,945,374,571
155140,10,701,255,446,633,236,397,68,19,49
155159,10,94,0,94,94,0,94,,,
155177,10,331,145,186,303,137,166,28,8,20
155186,10,2640,1174,1466,897,437,460,1743,737,1006
155195,10,5114,2227,2887,1885,870,1015,3229,1357,1872
155201,10,901,432,469,453,267,186,448,165,283
155210,10,16643,7464,9179,4808,2301,2507,11835,5163,6672
155283,10,668,59,609,625,58,567,43,1,42
155292,10,4877,2046,2831,1534,682,852,3343,1364,1979
155308,10,127,101,26,124,100,24,3,1,2
155317,10,26780,12225,14555,22123,10269,11854,4657,1956,2701
155335,10,2617,981,1636,1215,416,799,1402,565,837
155353,10,71,62,9,71,62,9,,,
155399,10,20229,9647,10582,16490,8128,8362,3739,1519,2220
155414,10,812,468,344,718,408,310,94,60,34
155423,10,1233,744,489,925,614,311,308,130,178
155450,10,1453,561,892,564,208,356,889,353,536
155487,10,896,525,371,250,145,105,646,380,266
155496,10,177,103,74,143,88,55,34,15,19
155511,10,842,560,282,812,545,267,30,15,15
155520,10,1584,637,947,996,463,533,588,174,414
155566,10,1639,677,962,556,232,324,1083,445,638
155593,10,884,525,359,395,288,107,489,237,252
155618,10,688,463,225,374,291,83,314,172,142
155627,10,880,541,339,810,486,324,70,55,15
155636,10,551,199,352,305,135,170,246,64,182
155681,10,6017,2825,3192,4465,2246,2219,1552,579,973
155715,10,1125,600,525,512,342,170,613,258,355
155812,10,1280,581,699,925,431,494,355,150,205
155830,10,852,383,469,234,131,103,618,252,366
155858,10,1664,633,1031,683,277,406,981,356,625
155900,10,1282,816,466,704,429,275,578,387,191
155937,10,700,407,293,562,344,218,138,63,75
155973,10,688,400,288,544,339,205,144,61,83
156082,10,5657,2080,3577,3655,1395,2260,2002,685,1317
156107,10,4834,2573,2261,1434,928,506,3400,1645,1755
156125,10,15415,6742,8673,10153,4577,5576,5262,2165,3097
156134,10,1012,597,415,1012,597,415,,,
156189,10,613,305,308,580,290,290,33,15,18
156213,10,1720,696,1024,1147,477,670,573,219,354
156222,10,1725,1024,701,581,323,258,1144,701,443
156231,10,2479,989,1490,1126,542,584,1353,447,906
156277,10,27,2,25,27,2,25,,,
156286,10,3149,1146,2003,2617,983,1634,532,163,369
156295,10,1468,598,870,1432,583,849,36,15,21
156310,10,275,5,270,245,5,240,30,0,30
156338,10,4368,1749,2619,1426,595,831,2942,1154,1788
156356,10,841,278,563,675,241,434,166,37,129
156365,10,10238,5048,5190,4910,2456,2454,5328,2592,2736
156392,10,9750,3929,5821,3729,1655,2074,6021,2274,3747
156408,10,1320,636,684,1320,636,684,,,
156417,10,158,132,26,92,78,14,66,54,12
156426,10,195,13,182,126,10,116,69,3,66
156471,10,4268,361,3907,1995,160,1835,2273,201,2072
156541,10,19272,9782,9490,5846,2106,3740,13426,7676,5750
156620,10,13984,5438,8546,9958,3887,6071,4026,1551,2475
156648,10,5657,2317,3340,2004,819,1185,3653,1498,2155
156727,10,2468,141,2327,1793,101,1692,675,40,635
156745,10,1625,668,957,1226,557,669,399,111,288
156754,10,45,1,44,45,1,44,,,
156790,10,2887,1265,1622,919,356,563,1968,909,1059
156842,10,207,8,199,153,5,148,54,3,51
156851,10,1454,383,1071,385,102,283,1069,281,788
156860,10,2036,618,1418,680,184,496,1356,434,922
156921,10,11811,5030,6781,2889,1308,1581,8922,3722,5200
156967,10,84,1,83,84,1,83,,,
157021,10,242,31,211,42,18,24,200,13,187
157030,10,81,47,34,53,29,24,28,18,10
157058,10,2279,938,1341,1414,577,837,865,361,504
157076,10,811,432,379,757,398,359,54,34,20
157085,10,30390,12636,17754,26273,11058,15215,4117,1578,2539
157100,10,674,393,281,512,342,170,162,51,111
157207,10,94,40,54,6,2,4,88,38,50
157216,10,2618,1011,1607,2090,870,1220,528,141,387
157289,10,22140,9959,12181,15873,7235,8638,6267,2724,3543
157298,10,136,48,88,84,30,54,52,18,34
157304,10,3239,1378,1861,935,293,642,2304,1085,1219
157331,10,3532,1287,2245,1000,394,606,2532,893,1639
157377,10,1390,455,935,1033,372,661,357,83,274
157386,10,8982,3469,5513,4967,1971,2996,4015,1498,2517
157401,10,9420,3490,5930,6485,2479,4006,2935,1011,1924
157438,10,4089,1780,2309,1026,512,514,3063,1268,1795
157447,10,15979,5639,10340,8910,3437,5473,7069,2202,4867
157483,10,4869,1905,2964,1595,604,991,3274,1301,1973
157535,10,2269,1034,1235,1868,847,1021,401,187,214
157553,10,2162,849,1313,1236,527,709,926,322,604
157614,10,100,0,100,56,0,56,44,0,44
157650,10,125,7,118,87,5,82,38,2,36
157669,10,87,1,86,87,1,86,,,
157678,10,111,1,110,111,1,110,,,
157711,10,5014,1876,3138,1890,764,1126,3124,1112,2012
157739,10,2492,1055,1437,969,328,641,1523,727,796
157748,10,4448,3502,946,2235,1762,473,2213,1740,473
157757,10,1562,386,1176,1115,273,842,447,113,334
157793,10,2785,955,1830,1702,589,1113,1083,366,717
157809,10,1980,927,1053,1369,674,695,611,253,358
157818,10,970,401,569,960,396,564,10,5,5
157863,10,1024,524,500,838,447,391,186,77,109
157951,10,16750,6250,10500,12115,4615,7500,4635,1635,3000
158088,10,2087,1149,938,1061,526,535,1026,623,403
158246,10,161,63,98,161,63,98,,,
158325,10,110,14,96,110,14,96,,,
158343,10,48,22,26,26,10,16,22,12,10
158431,10,5727,1807,3920,2610,897,1713,3117,910,2207
158477,10,542,232,310,515,216,299,27,16,11
158538,10,57,1,56,57,1,56,,,
158617,10,475,181,294,475,181,294,,,
158662,10,12139,3691,8448,4002,1375,2627,8137,2316,5821
158778,10,47,4,43,47,4,43,,,
158787,10,60,2,58,60,2,58,,,
158802,10,1202,274,928,1128,253,875,74,21,53
158884,10,2109,785,1324,704,289,415,1405,496,909
159009,10,5270,1816,3454,4030,1463,2567,1240,353,887
159027,10,17,0,17,17,0,17,,,
159197,10,555,479,76,555,479,76,,,
159328,10,102,2,100,102,2,100,,,
159373,10,2835,828,2007,2631,796,1835,204,32,172
159382,10,3771,1111,2660,2107,637,1470,1664,474,1190
159391,10,35912,15903,20009,29953,13315,16638,5959,2588,3371
159407,10,3023,791,2232,1573,441,1132,1450,350,1100
159416,10,8881,3513,5368,3016,1137,1879,5865,2376,3489
159513,10,184,6,178,184,6,178,,,
159522,10,193,9,184,193,9,184,,,
159531,10,32,0,32,32,0,32,,,
159568,10,1135,553,582,902,478,424,233,75,158
159601,10,38,2,36,38,2,36,,,
159647,10,11037,5727,5310,8266,4564,3702,2771,1163,1608
159656,10,4570,1489,3081,3812,1287,2525,758,202,556
159717,10,6454,2415,4039,5024,1921,3103,1430,494,936
159939,10,7953,3682,4271,5288,2543,2745,2665,1139,1526
159948,10,2004,1347,657,564,341,223,1440,1006,434
159966,10,6225,2153,4072,4804,1726,3078,1421,427,994
159993,10,8718,2807,5911,5413,1856,3557,3305,951,2354
160010,10,957,632,325,351,280,71,606,352,254
160038,10,10735,3005,7730,5891,1776,4115,4844,1229,3615
160065,10,1236,295,941,528,93,435,708,202,506
160074,10,1341,263,1078,762,157,605,579,106,473
160117,10,201,1,200,201,1,200,,,
160126,10,34,0,34,8,0,8,26,0,26
160199,10,44,0,44,44,0,44,,,
160320,10,2564,88,2476,2564,88,2476,,,
160409,10,114,114,0,112,112,0,2,2,0
160472,10,195,6,189,128,4,124,67,2,65
160481,10,1762,544,1218,781,266,515,981,278,703
160524,10,279,79,200,279,79,200,,,
160579,10,3068,1449,1619,1470,753,717,1598,696,902
160597,10,127,43,84,66,21,45,61,22,39
160612,10,13456,4870,8586,8702,3218,5484,4754,1652,3102
160621,10,8317,2887,5430,6156,2128,4028,2161,759,1402
160630,10,2106,568,1538,1094,266,828,1012,302,710
160649,10,2745,889,1856,1256,442,814,1489,447,1042
160658,10,16225,6918,9307,11966,5202,6764,4259,1716,2543
160667,10,4612,2158,2454,1344,663,681,3268,1495,1773
160755,10,14124,5507,8617,12342,4887,7455,1782,620,1162
160904,10,3604,861,2743,3461,811,2650,143,50,93
160959,10,376,112,264,361,109,252,15,3,12
160977,10,1821,885,936,1821,885,936,,,
160995,10,519,102,417,519,102,417,,,
161004,10,1951,963,988,1948,960,988,3,3,0
161022,10,235,22,213,111,10,101,124,12,112
161077,10,3003,1263,1740,913,470,443,2090,793,1297
161086,10,2262,1065,1197,2262,1065,1197,,,
161138,10,2076,1000,1076,698,360,338,1378,640,738
161192,10,2108,696,1412,443,161,282,1665,535,1130
161208,10,53,48,5,53,48,5,,,
161217,10,4422,1404,3018,1443,428,1015,2979,976,2003
161226,10,1878,551,1327,1314,410,904,564,141,423
161235,10,2216,635,1581,589,199,390,1627,436,1191
161253,10,12657,6070,6587,9043,4524,4519,3614,1546,2068
161299,10,888,723,165,842,683,159,46,40,6
161341,10,1590,556,1034,783,292,491,807,264,543
161457,10,6642,1924,4718,4663,1389,3274,1979,535,1444
161484,10,596,285,311,261,143,118,335,142,193
161493,10,165,6,159,129,4,125,36,2,34
161509,10,491,123,368,457,115,342,34,8,26
161518,10,1235,449,786,771,305,466,464,144,320
161527,10,226,22,204,148,6,142,78,16,62
161545,10,5435,2382,3053,1779,914,865,3656,1468,2188
161554,10,7996,2936,5060,4191,1617,2574,3805,1319,2486
161563,10,1394,641,753,703,361,342,691,280,411
161572,10,2439,642,1797,2178,572,1606,261,70,191
161581,10,405,163,242,176,86,90,229,77,152
161688,10,2421,682,1739,777,268,509,1644,414,1230
161767,10,10630,4145,6485,2726,1276,1450,7904,2869,5035
161800,10,94,38,56,42,15,27,52,23,29
161855,10,28,1,27,21,1,20,7,0,7
161864,10,3864,994,2870,805,229,576,3059,765,2294
161873,10,3710,1398,2312,1859,717,1142,1851,681,1170
162007,10,6308,2392,3916,4815,1835,2980,1493,557,936
162061,10,796,623,173,559,446,113,237,177,60
162104,10,1783,634,1149,515,226,289,1268,408,860
162122,10,5660,2081,3579,2061,870,1191,3599,1211,2388
162168,10,1738,565,1173,413,168,245,1325,397,928
162210,10,785,258,527,502,161,341,283,97,186
162283,10,2101,486,1615,1418,336,1082,683,150,533
162335,10,49,0,49,49,0,49,,,
162371,10,643,580,63,643,580,63,,,
162557,10,5389,2259,3130,1537,751,786,3852,1508,2344
162584,10,4452,1979,2473,3152,1532,1620,1300,447,853
162609,10,578,279,299,292,166,126,286,113,173
162654,10,1917,544,1373,1100,377,723,817,167,650
162690,10,3533,1259,2274,1137,481,656,2396,778,1618
162706,10,4596,1861,2735,1590,733,857,3006,1128,1878
162760,10,2095,706,1389,1316,474,842,779,232,547
162779,10,8080,3268,4812,2377,1176,1201,5703,2092,3611
162830,10,129,5,124,129,5,124,,,
162928,10,32049,14571,17478,17255,7583,9672,14794,6988,7806
163028,10,1109,965,144,734,638,96,375,327,48
163046,10,5140,2021,3119,4136,1694,2442,1004,327,677
163204,10,55323,29195,26128,10072,5097,4975,45251,24098,21153
163259,10,7244,1940,5304,5143,1472,3671,2101,468,1633
163268,10,13638,7342,6296,10683,5827,4856,2955,1515,1440
163286,10,41272,20946,20326,36431,18496,17935,4841,2450,2391
163295,10,2147,544,1603,1705,431,1274,442,113,329
163338,10,2384,1018,1366,1966,860,1106,418,158,260
163347,10,510,39,471,510,39,471,,,
163408,10,117,27,90,72,9,63,45,18,27
163426,10,17284,7773,9511,5801,2773,3028,11483,5000,6483
163453,10,8469,3267,5202,7402,2819,4583,1067,448,619
163462,10,2570,1316,1254,2184,1135,1049,386,181,205
163532,10,449,449,0,432,432,0,17,17,0
163541,10,348,147,201,180,83,97,168,64,104
163578,10,2184,311,1873,978,89,889,1206,222,984
163657,10,10577,3669,6908,3145,1205,1940,7432,2464,4968
163815,10,62,2,60,28,0,28,34,2,32
163851,10,7570,3169,4401,6619,2784,3835,951,385,566
163912,10,1544,649,895,1495,626,869,49,23,26
163976,10,540,302,238,515,283,232,25,19,6
164076,10,20856,7927,12929,16519,6428,10091,4337,1499,2838
164085,10,807,69,738,106,10,96,701,59,642
164155,10,4528,3230,1298,4528,3230,1298,,,
164173,10,3454,1182,2272,2708,1019,1689,746,163,583
164216,10,1026,429,597,1015,421,594,11,8,3
164270,10,3053,1030,2023,2297,883,1414,756,147,609
164313,10,2434,783,1651,504,240,264,1930,543,1387
164368,10,2214,1285,929,1978,1145,833,236,140,96
164447,10,2244,792,1452,2056,739,1317,188,53,135
164465,10,1971,957,1014,1971,957,1014,,,
164492,10,1521,906,615,1041,567,474,480,339,141
164535,10,50,8,42,50,8,42,,,
164562,10,2284,927,1357,2056,871,1185,228,56,172
164580,10,3684,2109,1575,3099,1793,1306,585,316,269
164599,10,52,10,42,,,,52,10,42
164614,10,42,28,14,32,21,11,10,7,3
164632,10,2745,124,2621,1445,43,1402,1300,81,1219
164641,10,346,133,213,182,99,83,164,34,130
164739,10,5158,2975,2183,4413,2623,1790,745,352,393
164748,10,7943,4584,3359,6133,3403,2730,1810,1181,629
164775,10,1453,490,963,344,140,204,1109,350,759
164845,10,87,4,83,67,2,65,20,2,18
164872,10,728,312,416,616,278,338,112,34,78
164915,10,163,60,103,66,27,39,97,33,64
164924,10,15561,7046,8515,13610,6163,7447,1951,883,1068
164988,10,36104,15319,20785,29047,12280,16767,7057,3039,4018
165015,10,5558,2311,3247,5120,2150,2970,438,161,277
165024,10,9942,3769,6173,7021,2765,4256,2921,1004,1917
165033,10,5977,2027,3950,2333,873,1460,3644,1154,2490
165060,10,170,20,150,106,15,91,64,5,59
165112,10,9371,3736,5635,2509,1199,1310,6862,2537,4325
165167,10,2451,561,1890,631,149,482,1820,412,1408
165194,10,2510,891,1619,785,351,434,1725,540,1185
165255,10,190,5,185,75,3,72,115,2,113
165264,10,1038,80,958,51,6,45,987,74,913
165334,10,3350,1487,1863,3165,1410,1755,185,77,108
165495,10,18,5,13,18,5,13,,,
165529,10,2242,899,1343,1855,761,1094,387,138,249
165556,10,436,56,380,319,38,281,117,18,99
165574,10,1206,610,596,1108,567,541,98,43,55
165608,10,57,5,52,39,4,35,18,1,17
165635,10,235,219,16,235,219,16,,,
165644,10,647,300,347,541,268,273,106,32,74
165662,10,5906,1689,4217,5341,1616,3725,565,73,492
165671,10,1950,434,1516,1759,398,1361,191,36,155
165699,10,3982,1321,2661,3095,1111,1984,887,210,677
165750,10,60,26,34,60,26,34,,,
165802,10,1367,428,939,597,307,290,770,121,649
165820,10,6674,2570,4104,3026,1415,1611,3648,1155,2493
165866,10,4495,1693,2802,2838,1239,1599,1657,454,1203
165884,10,476,398,78,300,249,51,176,149,27
165936,10,1804,655,1149,1464,547,917,340,108,232
165945,10,1380,870,510,356,196,160,1024,674,350
165981,10,1433,507,926,374,136,238,1059,371,688
166018,10,472,180,292,472,180,292,,,
166027,10,31345,14778,16567,21160,10151,11009,10185,4627,5558
166045,10,133,55,78,101,43,58,32,12,20
166054,10,118,91,27,102,84,18,16,7,9
166124,10,3029,1382,1647,3005,1375,1630,24,7,17
166133,10,3738,1293,2445,1264,530,734,2474,763,1711
166391,10,1695,635,1060,1295,466,829,400,169,231
166407,10,257,18,239,17,1,16,240,17,223
166452,10,4010,718,3292,1939,404,1535,2071,314,1757
166489,10,277,117,160,260,113,147,17,4,13
166498,10,66,5,61,29,5,24,37,0,37
166513,10,17597,10079,7518,11617,6776,4841,5980,3303,2677
166629,10,32045,15557,16488,25259,12437,12822,6786,3120,3666
166638,10,15637,6283,9354,11305,4598,6707,4332,1685,2647
166647,10,3423,1470,1953,1136,583,553,2287,887,1400
166656,10,7304,1862,5442,5739,1515,4224,1565,347,1218
166674,10,1907,521,1386,1658,452,1206,249,69,180
166683,10,11934,6931,5003,11787,6824,4963,147,107,40
166692,10,1538,1321,217,1503,1290,213,35,31,4
166708,10,1292,445,847,1202,433,769,90,12,78
166717,10,854,161,693,569,100,469,285,61,224
166805,10,56,41,15,30,24,6,26,17,9
166823,10,5482,2101,3381,1920,893,1027,3562,1208,2354
166850,10,5452,2282,3170,4650,2098,2552,802,184,618
166869,10,1339,197,1142,1024,145,879,315,52,263
166887,10,7134,2794,4340,1835,853,982,5299,1941,3358
166911,10,341,81,260,331,77,254,10,4,6
166939,10,2342,18,2324,2215,3,2212,127,15,112
166957,10,3099,953,2146,903,356,547,2196,597,1599
167039,10,13,1,12,13,1,12,,,
167057,10,827,436,391,743,388,355,84,48,36
167093,10,525,125,400,525,125,400,,,
167215,10,1064,378,686,807,272,535,257,106,151
167260,10,1434,950,484,1175,811,364,259,139,120
167288,10,994,382,612,823,328,495,171,54,117
167297,10,141,90,51,141,90,51,,,
167312,10,4573,1592,2981,1460,605,855,3113,987,2126
167358,10,28167,13686,14481,26900,13099,13801,1267,587,680
167376,10,4770,1643,3127,1337,602,735,3433,1041,2392
167394,10,1379,318,1061,985,234,751,394,84,310
167455,10,93,44,49,91,43,48,2,1,1
167464,10,41,41,0,41,41,0,,,
167525,10,2722,989,1733,933,401,532,1789,588,1201
167534,10,6916,2509,4407,2239,969,1270,4677,1540,3137
167598,10,3599,489,3110,1456,265,1191,2143,224,1919
167631,10,1142,381,761,302,146,156,840,235,605
167677,10,96,75,21,66,64,2,30,11,19
167729,10,7131,2262,4869,4878,1560,3318,2253,702,1551
167783,10,5984,484,5500,3082,189,2893,2902,295,2607
167792,10,328,120,208,299,105,194,29,15,14
167835,10,2924,60,2864,2895,53,2842,29,7,22
167871,10,158,47,111,71,7,64,87,40,47
167899,10,2965,1294,1671,2754,1215,1539,211,79,132
167905,10,4020,1516,2504,1408,614,794,2612,902,1710
167987,10,7717,3676,4041,5656,2804,2852,2061,872,1189
167996,10,2479,1082,1397,2367,1025,1342,112,57,55
168005,10,6647,2634,4013,5388,2109,3279,1259,525,734
168032,10,16,0,16,16,0,16,,,
168148,10,13293,5547,7746,12001,4988,7013,1292,559,733
168218,10,2461,30,2431,2381,0,2381,80,30,50
168227,10,4163,3218,945,3779,2928,851,384,290,94
168254,10,3675,1912,1763,3138,1719,1419,537,193,344
168263,10,5013,2129,2884,3875,1680,2195,1138,449,689
168281,10,1701,651,1050,1700,650,1050,1,1,0
168342,10,2224,1067,1157,2185,1054,1131,39,13,26
168421,10,7230,4533,2697,5917,3622,2295,1313,911,402
168430,10,5417,1921,3496,3735,1381,2354,1682,540,1142
168528,10,1867,981,886,1765,942,823,102,39,63
168546,10,1523,710,813,1500,697,803,23,13,10
168555,10,20,0,20,18,0,18,2,0,2
168573,10,823,803,20,823,803,20,,,
168591,10,1353,572,781,1321,554,767,32,18,14
168607,10,1487,684,803,484,265,219,1003,419,584
168740,10,2927,1620,1307,1814,976,838,1113,644,469
168786,10,1362,571,791,1114,487,627,248,84,164
168847,10,4969,1323,3646,1778,465,1313,3191,858,2333
168883,10,1958,710,1248,671,277,394,1287,433,854
168892,10,75,5,70,30,2,28,45,3,42
169080,10,3257,1516,1741,2890,1316,1574,367,200,167
169099,10,249,171,78,163,118,45,86,53,33
169187,10,128,23,105,34,10,24,94,13,81
169220,10,203,51,152,141,36,105,62,15,47
169248,10,15424,6075,9349,11433,4585,6848,3991,1490,2501
169275,10,6245,2115,4130,1750,607,1143,4495,1508,2987
169284,10,259,13,246,195,11,184,64,2,62
169327,10,751,442,309,540,340,200,211,102,109
169363,10,1135,515,620,920,452,468,215,63,152
169424,10,129,47,82,129,47,82,,,
169442,10,1620,616,1004,1270,469,801,350,147,203
169479,10,5384,2323,3061,2407,1217,1190,2977,1106,1871
169503,10,240,7,233,240,7,233,,,
169521,10,7054,2604,4450,1971,792,1179,5083,1812,3271
169576,10,93,3,90,93,3,90,,,
169655,10,1441,1344,97,1441,1344,97,,,
169716,10,5227,2148,3079,3906,1501,2405,1321,647,674
169761,10,441,38,403,441,38,403,,,
169798,10,15340,5791,9549,9910,3770,6140,5430,2021,3409
169813,10,42,1,41,42,1,41,,,
169910,10,10361,4743,5618,7289,3484,3805,3072,1259,1813
169974,10,1068,450,618,357,160,197,711,290,421
169983,10,1858,1466,392,1562,1237,325,296,229,67
169992,10,857,301,556,382,156,226,475,145,330
170000,10,1104,499,605,639,274,365,465,225,240
170037,10,1930,776,1154,1171,463,708,759,313,446
170055,10,12642,5347,7295,3554,1634,1920,9088,3713,5375
170082,10,22406,8388,14018,18526,6881,11645,3880,1507,2373
170091,10,165,86,79,125,65,60,40,21,19
170240,10,11379,4658,6721,3771,1587,2184,7608,3071,4537
170286,10,1602,825,777,1508,774,734,94,51,43
170301,10,3132,1205,1927,2966,1132,1834,166,73,93
170444,10,4103,1431,2672,922,357,565,3181,1074,2107
170532,10,1241,542,699,1233,539,694,8,3,5
170541,10,6966,3032,3934,1810,826,984,5156,2206,2950
170550,10,3453,972,2481,782,284,498,2671,688,1983
170587,10,1458,556,902,425,144,281,1033,412,621
170611,10,105,2,103,91,2,89,14,0,14
170620,10,2729,958,1771,737,291,446,1992,667,1325
170639,10,1812,801,1011,1406,641,765,406,160,246
170657,10,10303,4337,5966,3248,1441,1807,7055,2896,4159
170675,10,2955,1996,959,1729,1229,500,1226,767,459
170736,10,23,1,22,5,0,5,18,1,17
170790,10,16762,6868,9894,4604,1993,2611,12158,4875,7283
170806,10,2444,823,1621,1594,559,1035,850,264,586
170967,10,1114,432,682,717,310,407,397,122,275
170976,10,50278,24655,25623,46710,22537,24173,3568,2118,1450
171012,10,135,107,28,135,107,28,,,
171100,10,49659,23366,26293,43142,20361,22781,6517,3005,3512
171128,10,7008,4946,2062,6284,4438,1846,724,508,216
171137,10,8331,4614,3717,5281,2853,2428,3050,1761,1289
171146,10,6418,2277,4141,3672,1302,2370,2746,975,1771
171155,10,3297,1162,2135,978,426,552,2319,736,1583
171225,10,2475,929,1546,602,247,355,1873,682,1191
171234,10,1507,500,1007,336,102,234,1171,398,773
171304,10,3699,1425,2274,1199,543,656,2500,882,1618
171395,10,1645,555,1090,533,181,352,1112,374,738
171456,10,7214,2928,4286,6014,2495,3519,1200,433,767
171483,10,3296,1484,1812,1162,587,575,2134,897,1237
171492,10,2422,1428,994,1425,900,525,997,528,469
171535,10,13963,6162,7801,3306,1665,1641,10657,4497,6160
171571,10,17170,7268,9902,12798,5261,7537,4372,2007,2365
171599,10,885,513,372,788,461,327,97,52,45
171775,10,54,0,54,34,0,34,20,0,20
171881,10,127,53,74,81,32,49,46,21,25
171988,10,87,4,83,87,4,83,,,
171997,10,114,3,111,114,3,111,,,
172015,10,111,8,103,111,8,103,,,
172033,10,289,205,84,94,92,2,195,113,82
172051,10,7523,2570,4953,5941,2034,3907,1582,536,1046
172200,10,8330,3367,4963,1867,859,1008,6463,2508,3955
172264,10,1966,825,1141,1173,560,613,793,265,528
172291,10,3231,1094,2137,1144,422,722,2087,672,1415
172307,10,1756,657,1099,726,311,415,1030,346,684
172334,10,2685,577,2108,2234,467,1767,451,110,341
172422,10,118,95,23,118,95,23,,,
172440,10,424,250,174,385,237,148,39,13,26
172477,10,691,280,411,161,66,95,530,214,316
172495,10,261,7,254,207,7,200,54,0,54
172608,10,1492,752,740,84,57,27,1408,695,713
172617,10,10884,4716,6168,2738,1316,1422,8146,3400,4746
172635,10,12749,4276,8473,1177,483,694,11572,3793,7779
172644,10,24919,10067,14852,17971,7101,10870,6948,2966,3982
172671,10,1004,353,651,233,94,139,771,259,512
172680,10,96,4,92,59,3,56,37,1,36
172699,10,18266,8678,9588,13514,6509,7005,4752,2169,2583
172705,10,377,233,144,73,40,33,304,193,111
172866,10,85,77,8,85,77,8,,,
172918,10,2586,1207,1379,1062,593,469,1524,614,910
172954,10,1690,770,920,837,475,362,853,295,558
172963,10,7951,2971,4980,2691,1088,1603,5260,1883,3377
173045,10,3166,1286,1880,2676,1127,1549,490,159,331
173063,10,3276,1479,1797,1094,535,559,2182,944,1238
173115,10,794,254,540,252,149,103,542,105,437
173124,10,4279,1799,2480,2632,1196,1436,1647,603,1044
173142,10,798,360,438,665,309,356,133,51,82
173160,10,3731,1383,2348,2466,914,1552,1265,469,796
173203,10,4448,1819,2629,1508,682,826,2940,1137,1803
173258,10,2044,996,1048,2032,994,1038,12,2,10
173300,10,1919,837,1082,1837,810,1027,82,27,55
173328,10,5545,1914,3631,4284,1500,2784,1261,414,847
173416,10,2451,1353,1098,1286,832,454,1165,521,644
173452,10,920,449,471,654,333,321,266,116,150
173461,10,4373,1841,2532,1456,733,723,2917,1108,1809
173470,10,27,0,27,27,0,27,,,
173559,10,5360,2003,3357,1905,913,992,3455,1090,2365
173638,10,3347,1675,1672,974,494,480,2373,1181,1192
173647,10,2251,982,1269,2224,964,1260,27,18,9
173665,10,2931,982,1949,1788,641,1147,1143,341,802
173683,10,172,52,120,102,31,71,70,21,49
173708,10,4083,2497,1586,1375,990,385,2708,1507,1201
173735,10,859,320,539,448,248,200,411,72,339
173744,10,618,34,584,618,34,584,,,
173799,10,3729,1374,2355,1249,526,723,2480,848,1632
173805,10,983,474,509,552,321,231,431,153,278
173896,10,480,210,270,301,135,166,179,75,104
173902,10,2244,971,1273,2206,953,1253,38,18,20
173911,10,2511,1083,1428,993,499,494,1518,584,934
173920,10,14576,6338,8238,10704,4940,5764,3872,1398,2474
173957,10,1250,521,729,1205,501,704,45,20,25
173993,10,885,409,476,552,300,252,333,109,224
174020,10,6914,2891,4023,2882,1220,1662,4032,1671,2361
174066,10,52376,23418,28958,38721,17187,21534,13655,6231,7424
174075,10,2304,978,1326,1050,437,613,1254,541,713
174127,10,775,235,540,705,218,487,70,17,53
174136,10,5973,2391,3582,1865,858,1007,4108,1533,2575
174154,10,759,87,672,373,49,324,386,38,348
174190,10,189,18,171,126,5,121,63,13,50
174233,10,9884,4898,4986,8261,4133,4128,1623,765,858
174251,10,1286,552,734,1140,486,654,146,66,80
174321,10,128,5,123,128,5,123,,,
174358,10,5088,1814,3274,3340,1224,2116,1748,590,1158
174376,10,5173,2002,3171,1543,637,906,3630,1365,2265
174428,10,8842,3712,5130,3309,1514,1795,5533,2198,3335
174437,10,1034,463,571,866,391,475,168,72,96
174473,10,2716,1086,1630,919,396,523,1797,690,1107
174491,10,3398,1345,2053,2019,818,1201,1379,527,852
174507,10,1126,446,680,813,361,452,313,85,228
174525,10,94,55,39,63,38,25,31,17,14
174570,10,1766,692,1074,398,179,219,1368,513,855
174604,10,179,79,100,146,70,76,33,9,24
174738,10,4658,1652,3006,1849,823,1026,2809,829,1980
174747,10,1557,0,1557,1547,0,1547,10,0,10
174756,10,3638,1430,2208,1701,781,920,1937,649,1288
174783,10,10774,4767,6007,5668,2635,3033,5106,2132,2974
174792,10,1643,1599,44,1562,1537,25,81,62,19
174817,10,4701,1510,3191,3257,1056,2201,1444,454,990
174844,10,2988,1261,1727,2964,1249,1715,24,12,12
174862,10,1476,683,793,888,425,463,588,258,330
174899,10,3512,976,2536,2761,787,1974,751,189,562
174914,10,9336,4608,4728,6904,3424,3480,2432,1184,1248
174978,10,144,4,140,116,3,113,28,1,27
175005,10,3904,255,3649,2296,99,2197,1608,156,1452
175014,10,3914,607,3307,1875,304,1571,2039,303,1736
175041,10,5083,2167,2916,1770,859,911,3313,1308,2005
175078,10,6986,2676,4310,1875,760,1115,5111,1916,3195
175120,10,409,280,129,409,280,129,,,
175139,10,197,82,115,93,37,56,104,45,59
175157,10,575,329,246,381,250,131,194,79,115
175227,10,1382,1135,247,1141,951,190,241,184,57
175236,10,2846,1066,1780,1578,696,882,1268,370,898
175263,10,1838,832,1006,662,333,329,1176,499,677
175272,10,6545,2062,4483,5208,1678,3530,1337,384,953
175281,10,1210,534,676,468,200,268,742,334,408
175315,10,7678,3190,4488,2915,1325,1590,4763,1865,2898
175342,10,3074,985,2089,2302,795,1507,772,190,582
175421,10,4278,1230,3048,1321,493,828,2957,737,2220
175430,10,989,456,533,620,301,319,369,155,214
175494,10,59,12,47,59,12,47,,,
175519,10,1561,612,949,1102,444,658,459,168,291
175573,10,2837,1095,1742,1800,741,1059,1037,354,683
175616,10,2727,1034,1693,1764,704,1060,963,330,633
175643,10,2219,867,1352,1495,628,867,724,239,485
175652,10,3277,1363,1914,2090,959,1131,1187,404,783
175698,10,36,29,7,26,22,4,10,7,3
175722,10,33,0,33,33,0,33,,,
175786,10,10802,4084,6718,5299,2115,3184,5503,1969,3534
175810,10,4890,1643,3247,2990,1037,1953,1900,606,1294
175829,10,4548,1741,2807,2802,1112,1690,1746,629,1117
175856,10,7080,2236,4844,4916,1631,3285,2164,605,1559
175883,10,4345,1687,2658,2845,1119,1726,1500,568,932
175935,10,2718,784,1934,1798,568,1230,920,216,704
175980,10,728,364,364,709,356,353,19,8,11
176008,10,2114,708,1406,1533,552,981,581,156,425
176017,10,21203,8830,12373,18671,7844,10827,2532,986,1546
176035,10,2477,506,1971,1802,321,1481,675,185,490
176044,10,2064,837,1227,1251,527,724,813,310,503
176053,10,4250,1589,2661,3264,1263,2001,986,326,660
176062,10,66,0,66,66,0,66,,,
176071,10,8208,3129,5079,4721,1955,2766,3487,1174,2313
176080,10,23086,11264,11822,18862,9112,9750,4224,2152,2072
176169,10,3185,1227,1958,2353,940,1413,832,287,545
176178,10,6841,2560,4281,4045,1562,2483,2796,998,1798
176239,10,4986,1754,3232,3610,1323,2287,1376,431,945
176318,10,768,332,436,462,182,280,306,150,156
176336,10,90,68,22,84,63,21,6,5,1
176354,10,1673,635,1038,1275,526,749,398,109,289
176372,10,14146,4939,9207,10590,3629,6961,3556,1310,2246
176406,10,713,262,451,595,216,379,118,46,72
176433,10,53,1,52,33,1,32,20,0,20
176451,10,251,141,110,66,37,29,185,104,81
176479,10,5738,1857,3881,3547,1167,2380,2191,690,1501
176600,10,99,63,36,34,26,8,65,37,28
176628,10,1376,477,899,1196,428,768,180,49,131
176664,10,280,171,109,224,133,91,56,38,18
176716,10,112,1,111,102,1,101,10,0,10
176770,10,956,128,828,472,70,402,484,58,426
176789,10,387,205,182,213,103,110,174,102,72
176798,10,239,65,174,136,33,103,103,32,71
176910,10,170,103,67,105,65,40,65,38,27
176947,10,1144,562,582,1132,555,577,12,7,5
176965,10,10530,4637,5893,6803,3179,3624,3727,1458,2269
176983,10,50,44,6,40,38,2,10,6,4
177038,10,628,321,307,568,301,267,60,20,40
177065,10,6765,2700,4065,2764,1026,1738,4001,1674,2327
177083,10,26,26,0,25,25,0,1,1,0
177092,10,597,554,43,269,248,21,328,306,22
177117,10,303,0,303,302,0,302,1,0,1
177126,10,634,400,234,196,129,67,438,271,167
177135,10,3989,1468,2521,1758,712,1046,2231,756,1475
177144,10,932,519,413,856,487,369,76,32,44
177214,10,1615,672,943,1340,586,754,275,86,189
177250,10,2657,1014,1643,1244,519,725,1413,495,918
177278,10,103,50,53,51,21,30,52,29,23
177302,10,390,315,75,390,315,75,,,
177339,10,2100,940,1160,1616,720,896,484,220,264
177418,10,955,321,634,747,264,483,208,57,151
177436,10,35,4,31,35,4,31,,,
177472,10,10506,4422,6084,4901,2067,2834,5605,2355,3250
177542,10,714,309,405,515,237,278,199,72,127
177551,10,1210,354,856,998,295,703,212,59,153
177588,10,48,3,45,48,3,45,,,
177603,10,72,0,72,71,0,71,1,0,1
177676,10,3680,1429,2251,1698,698,1000,1982,731,1251
177685,10,134,10,124,134,10,124,,,
177719,10,672,92,580,580,85,495,92,7,85
177746,10,726,188,538,713,184,529,13,4,9
177816,10,54,54,0,54,54,0,,,
177834,10,3647,1400,2247,2972,1184,1788,675,216,459
177870,10,8,8,0,8,8,0,,,
177931,10,29,1,28,29,1,28,,,
177940,10,1794,729,1065,1208,510,698,586,219,367
177968,10,7003,2737,4266,4590,1954,2636,2413,783,1630
177977,10,1855,1543,312,1674,1411,263,181,132,49
177986,10,1878,795,1083,1245,615,630,633,180,453
177995,10,13874,5483,8391,5873,2555,3318,8001,2928,5073
178004,10,16,0,16,,,,16,0,16
178059,10,10596,2855,7741,3934,1391,2543,6662,1464,5198
178077,10,68,2,66,67,2,65,1,0,1
178183,10,223,18,205,223,18,205,,,
178208,10,3514,2844,670,1955,1668,287,1559,1176,383
178217,10,2282,787,1495,1314,452,862,968,335,633
178244,10,4970,1933,3037,1467,665,802,3503,1268,2235
178341,10,4352,1686,2666,2783,1074,1709,1569,612,957
178369,10,1776,1001,775,1423,879,544,353,122,231
178387,10,4395,1640,2755,2638,1015,1623,1757,625,1132
178396,10,31401,13836,17565,26125,11736,14389,5276,2100,3176
178402,10,16003,6717,9286,9062,3852,5210,6941,2865,4076
178411,10,7241,5543,1698,5969,4592,1377,1272,951,321
178420,10,15189,6139,9050,5290,2230,3060,9899,3909,5990
178448,10,4509,1623,2886,2145,821,1324,2364,802,1562
178518,10,220,131,89,163,94,69,57,37,20
178527,10,44,2,42,33,1,32,11,1,10
178615,10,4225,1683,2542,3447,1357,2090,778,326,452
178624,10,7870,3180,4690,5390,2304,3086,2480,876,1604
178679,10,559,307,252,455,258,197,104,49,55
178697,10,1479,649,830,1451,639,812,28,10,18
178721,10,8782,4604,4178,3478,1620,1858,5304,2984,2320
178767,10,97,12,85,42,7,35,55,5,50
178828,10,28,9,19,28,9,19,,,
178891,10,1826,1679,147,1329,1223,106,497,456,41
178989,10,389,52,337,260,37,223,129,15,114
179043,10,3626,1273,2353,2166,740,1426,1460,533,927
179052,10,46,19,27,46,19,27,,,
179159,10,13474,5346,8128,10754,4183,6571,2720,1163,1557
179195,10,33,0,33,33,0,33,,,
179229,10,21,4,17,21,4,17,,,
179256,10,62,33,29,48,26,22,14,7,7
179265,10,799,278,521,773,261,512,26,17,9
179308,10,14910,4822,10088,5269,2053,3216,9641,2769,6872
179317,10,102,49,53,68,34,34,34,15,19
179326,10,2709,989,1720,1611,637,974,1098,352,746
179344,10,1960,632,1328,684,199,485,1276,433,843
179511,10,119,1,118,71,1,70,48,0,48
179539,10,3785,1343,2442,1859,634,1225,1926,709,1217
179548,10,593,31,562,513,29,484,80,2,78
179557,10,9851,3853,5998,7166,2866,4300,2685,987,1698
179566,10,22925,9175,13750,13789,5361,8428,9136,3814,5322
179645,10,2689,800,1889,1384,423,961,1305,377,928
179715,10,1641,437,1204,699,209,490,942,228,714
179812,10,1335,671,664,1331,670,661,4,1,3
179867,10,16973,7976,8997,14825,7108,7717,2148,868,1280
179894,10,6779,2870,3909,2935,1269,1666,3844,1601,2243
179946,10,654,377,277,639,370,269,15,7,8
179955,10,805,396,409,793,393,400,12,3,9
179964,10,1737,612,1125,711,224,487,1026,388,638
179991,10,38,0,38,38,0,38,,,
180054,10,297,81,216,203,61,142,94,20,74
180063,10,30,1,29,30,1,29,,,
180081,10,656,330,326,266,176,90,390,154,236
180090,10,81,2,79,81,2,79,,,
180106,10,1121,436,685,1089,419,670,32,17,15
180151,10,458,212,246,258,137,121,200,75,125
180160,10,135,47,88,54,22,32,81,25,56
180179,10,4114,1426,2688,2105,824,1281,2009,602,1407
180197,10,2015,934,1081,651,325,326,1364,609,755
180203,10,143,63,80,90,38,52,53,25,28
180212,10,574,189,385,321,111,210,253,78,175
180249,10,1185,337,848,442,144,298,743,193,550
180258,10,888,289,599,740,254,486,148,35,113
180276,10,1468,598,870,338,182,156,1130,416,714
180328,10,270,83,187,176,51,125,94,32,62
180373,10,555,177,378,267,100,167,288,77,211
180416,10,1683,1032,651,1453,883,570,230,149,81
180461,10,16788,8733,8055,12984,6864,6120,3804,1869,1935
180489,10,10106,4092,6014,6965,2908,4057,3141,1184,1957
180522,10,1050,593,457,714,413,301,336,180,156
180595,10,1058,474,584,986,451,535,72,23,49
180647,10,620,193,427,466,150,316,154,43,111
180692,10,1399,461,938,1017,381,636,382,80,302
180717,10,57,33,24,41,27,14,16,6,10
180814,10,11902,5278,6624,7980,3510,4470,3922,1768,2154
180832,10,1180,152,1028,346,44,302,834,108,726
180878,10,744,75,669,445,48,397,299,27,272
180902,10,6309,2537,3772,1698,837,861,4611,1700,2911
180948,10,2250,876,1374,1550,625,925,700,251,449
180957,10,57,47,10,57,47,10,,,
180984,10,2989,1294,1695,1495,643,852,1494,651,843
181002,10,8735,3498,5237,7376,2990,4386,1359,508,851
181020,10,2060,830,1230,1355,646,709,705,184,521
181127,10,946,437,509,931,430,501,15,7,8
181145,10,19,1,18,19,1,18,,,
181190,10,127,3,124,127,3,124,,,
181215,10,6275,2226,4049,4099,1533,2566,2176,693,1483
181297,10,1229,123,1106,909,94,815,320,29,291
181303,10,13709,6445,7264,4441,2230,2211,9268,4215,5053
181312,10,2101,848,1253,669,308,361,1432,540,892
181330,10,1671,759,912,1243,623,620,428,136,292
181394,10,15328,6691,8637,11000,4711,6289,4328,1980,2348
181419,10,409,129,280,74,22,52,335,107,228
181428,10,3750,1104,2646,2942,894,2048,808,210,598
181446,10,1816,757,1059,1629,705,924,187,52,135
181464,10,24431,12274,12157,21055,10593,10462,3376,1681,1695
181491,10,5345,2875,2470,1909,1022,887,3436,1853,1583
181534,10,2067,750,1317,1193,480,713,874,270,604
181543,10,26,17,9,16,14,2,10,3,7
181604,10,1011,58,953,908,39,869,103,19,84
181640,10,9416,4458,4958,3249,1842,1407,6167,2616,3551
181738,10,774,309,465,650,261,389,124,48,76
181765,10,282,96,186,233,82,151,49,14,35
181783,10,4580,1828,2752,2963,1217,1746,1617,611,1006
181817,10,1704,667,1037,699,301,398,1005,366,639
181853,10,648,297,351,434,240,194,214,57,157
181880,10,215,9,206,215,9,206,,,
181941,10,362,222,140,362,222,140,,,
182005,10,29942,12531,17411,9075,3873,5202,20867,8658,12209
182148,10,632,138,494,632,138,494,,,
182281,10,30679,13087,17592,22453,9512,12941,8226,3575,4651
182290,10,21034,9588,11446,15638,7191,8447,5396,2397,2999
182306,10,3414,1154,2260,934,348,586,2480,806,1674
182458,10,631,234,397,482,197,285,149,37,112
182500,10,9431,4219,5212,2656,1146,1510,6775,3073,3702
182564,10,3528,1611,1917,1132,466,666,2396,1145,1251
182634,10,838,233,605,769,220,549,69,13,56
182670,10,6761,3422,3339,6727,3403,3324,34,19,15
182704,10,82,1,81,63,1,62,19,0,19
182722,10,158,22,136,117,21,96,41,1,40
182795,10,1777,795,982,1398,653,745,379,142,237
182829,10,557,319,238,365,199,166,192,120,72
182892,10,53,2,51,37,2,35,16,0,16
182917,10,67,34,33,67,34,33,,,
182953,10,84,3,81,67,2,65,17,1,16
182980,10,3806,2291,1515,3488,2164,1324,318,127,191
182999,10,21,0,21,21,0,21,,,
183026,10,145533,52410,93123,43386,16149,27237,102147,36261,65886
183035,10,17,2,15,17,2,15,,,
183044,10,14001,6016,7985,12646,5416,7230,1355,600,755
183062,10,3100,1401,1699,2900,1309,1591,200,92,108
183071,10,664,332,332,549,274,275,115,58,57
183080,10,4224,1981,2243,3745,1824,1921,479,157,322
183099,10,2887,1037,1850,919,430,489,1968,607,1361
183105,10,617,201,416,186,91,95,431,110,321
183114,10,746,173,573,126,40,86,620,133,487
183123,10,696,327,369,201,121,80,495,206,289
183132,10,2133,984,1149,601,365,236,1532,619,913
183141,10,1183,540,643,372,208,164,811,332,479
183150,10,1544,594,950,464,223,241,1080,371,709
183202,10,87,6,81,65,4,61,22,2,20
183211,10,2424,564,1860,1162,368,794,1262,196,1066
183239,10,1977,769,1208,1963,764,1199,14,5,9
183248,10,109,22,87,46,11,35,63,11,52
183257,10,1692,464,1228,720,203,517,972,261,711
183275,10,89,41,48,89,41,48,,,
183488,10,507,23,484,387,18,369,120,5,115
183600,10,32,0,32,19,0,19,13,0,13
183655,10,4373,1561,2812,1752,711,1041,2621,850,1771
183725,10,479,214,265,404,205,199,75,9,66
183743,10,10800,4990,5810,5748,2853,2895,5052,2137,2915
183789,10,2227,570,1657,1412,393,1019,815,177,638
183804,10,7541,7541,0,7185,7185,0,356,356,0
183822,10,1300,507,793,1217,475,742,83,32,51
183859,10,9566,4407,5159,4105,2108,1997,5461,2299,3162
183877,10,6273,2470,3803,2953,1305,1648,3320,1165,2155
183910,10,2098,701,1397,1685,622,1063,413,79,334
183938,10,7658,2935,4723,2978,1249,1729,4680,1686,2994
183974,10,1551,514,1037,1052,368,684,499,146,353
183983,10,76,71,5,76,71,5,,,
184056,10,618,144,474,396,103,293,222,41,181
184092,10,699,59,640,699,59,640,,,
184180,10,6219,3237,2982,2695,1515,1180,3524,1722,1802
184205,10,2465,833,1632,995,365,630,1470,468,1002
184348,10,2244,998,1246,1872,828,1044,372,170,202
184427,10,340,320,20,183,178,5,157,142,15
184481,10,6131,2405,3726,3055,1217,1838,3076,1188,1888
184506,10,107,8,99,76,3,73,31,5,26
184603,10,7467,2945,4522,2481,1030,1451,4986,1915,3071
184612,10,2411,645,1766,1819,492,1327,592,153,439
184694,10,3078,1215,1863,2788,1087,1701,290,128,162
184746,10,92,91,1,78,77,1,14,14,0
184773,10,2126,570,1556,1340,332,1008,786,238,548
184782,10,19052,9583,9469,15174,7971,7203,3878,1612,2266
184791,10,5667,2288,3379,2809,1220,1589,2858,1068,1790
184816,10,85,4,81,62,2,60,23,2,21
184959,10,680,98,582,320,44,276,360,54,306
184968,10,182,22,160,35,6,29,147,16,131
184995,10,6776,2566,4210,3420,1369,2051,3356,1197,2159
185129,10,6918,2606,4312,4719,1985,2734,2199,621,1578
185174,10,86,70,16,86,70,16,,,
185262,10,12759,4510,8249,9445,3453,5992,3314,1057,2257
185396,10,1550,1497,53,1299,1260,39,251,237,14
185466,10,316,3,313,171,2,169,145,1,144
185509,10,6205,2728,3477,1866,977,889,4339,1751,2588
185536,10,9477,4249,5228,3894,1822,2072,5583,2427,3156
185572,10,5436,1867,3569,4628,1657,2971,808,210,598
185590,10,20744,7567,13177,16020,5921,10099,4724,1646,3078
185679,10,637,82,555,51,11,40,586,71,515
185721,10,436,128,308,279,95,184,157,33,124
185758,10,128,62,66,30,12,18,98,50,48
185767,10,199,20,179,101,10,91,98,10,88
185828,10,11901,8592,3309,8886,6505,2381,3015,2087,928
185873,10,7321,3104,4217,3384,1548,1836,3937,1556,2381
185970,10,143,9,134,102,7,95,41,2,39
186016,10,466,25,441,278,15,263,188,10,178
186034,10,5076,1917,3159,1772,786,986,3304,1131,2173
186052,10,824,694,130,567,486,81,257,208,49
186122,10,333,164,169,322,156,166,11,8,3
186131,10,8478,4514,3964,8397,4466,3931,81,48,33
186186,10,228,228,0,228,228,0,,,
186201,10,5732,2296,3436,4678,1935,2743,1054,361,693
186274,10,200,20,180,110,13,97,90,7,83
186283,10,4204,1677,2527,3306,1352,1954,898,325,573
186371,10,6569,2601,3968,4817,1842,2975,1752,759,993
186380,10,50804,23354,27450,43245,20739,22506,7559,2615,4944
186399,10,12168,5688,6480,9058,4192,4866,3110,1496,1614
186405,10,15,4,11,15,4,11,,,
186423,10,73,7,66,73,7,66,,,
186432,10,3009,1199,1810,2393,996,1397,616,203,413
186469,10,889,335,554,487,195,292,402,140,262
186584,10,9881,4233,5648,7652,3371,4281,2229,862,1367
186593,10,151,24,127,105,15,90,46,9,37
186618,10,1198,335,863,778,246,532,420,89,331
186645,10,6688,3247,3441,2475,1296,1179,4213,1951,2262
186867,10,8287,5922,2365,6825,4864,1961,1462,1058,404
186876,10,9352,3535,5817,8385,3201,5184,967,334,633
186900,10,76,76,0,76,76,0,,,
187000,10,330,316,14,289,277,12,41,39,2
187046,10,9721,5680,4041,80,19,61,9641,5661,3980
187134,10,7589,3138,4451,7019,2954,4065,570,184,386
187198,10,7930,2943,4987,3486,1585,1901,4444,1358,3086
187444,10,9369,3478,5891,6225,2535,3690,3144,943,2201
187505,10,732,117,615,732,117,615,,,
187532,10,18563,7154,11409,4595,1941,2654,13968,5213,8755
187596,10,1301,498,803,537,207,330,764,291,473
187620,10,6454,2534,3920,2832,1114,1718,3622,1420,2202
187639,10,2162,666,1496,582,172,410,1580,494,1086
187648,10,4991,1780,3211,2370,840,1530,2621,940,1681
187666,10,1627,650,977,734,329,405,893,321,572
187745,10,803,321,482,266,102,164,537,219,318
187897,10,2645,821,1824,1603,549,1054,1042,272,770
187903,10,1889,646,1243,856,381,475,1033,265,768
187912,10,476,368,108,374,303,71,102,65,37
187958,10,2005,728,1277,581,214,367,1424,514,910
187967,10,1734,1144,590,1374,942,432,360,202,158
187976,10,845,392,453,108,54,54,737,338,399
187985,10,22139,9372,12767,14680,6183,8497,7459,3189,4270
187994,10,946,342,604,235,94,141,711,248,463
188003,10,1361,439,922,273,87,186,1088,352,736
188021,10,692,214,478,137,40,97,555,174,381
188030,10,13904,5744,8160,10426,4356,6070,3478,1388,2090
188049,10,1883,721,1162,299,93,206,1584,628,956
188058,10,1136,480,656,506,180,326,630,300,330
188100,10,5307,1669,3638,1477,597,880,3830,1072,2758
188137,10,3266,1158,2108,682,256,426,2584,902,1682
188182,10,1064,415,649,508,245,263,556,170,386
188207,10,192,15,177,86,10,76,106,5,101
188216,10,357,108,249,233,87,146,124,21,103
188225,10,1244,426,818,138,53,85,1106,373,733
188261,10,745,466,279,102,57,45,643,409,234
188289,10,67,2,65,62,2,60,5,0,5
188304,10,3013,957,2056,1392,497,895,1621,460,1161
188340,10,1290,1123,167,1022,884,138,268,239,29
188429,10,7520,2229,5291,6233,1848,4385,1287,381,906
188438,10,2683,1121,1562,1349,629,720,1334,492,842
188517,10,363,145,218,285,129,156,78,16,62
188526,10,1078,381,697,1054,373,681,24,8,16
188535,10,597,268,329,543,249,294,54,19,35
188580,10,839,334,505,839,334,505,,,
188641,10,1982,855,1127,1592,748,844,390,107,283
188650,10,140,6,134,140,6,134,,,
188669,10,35,6,29,35,6,29,,,
188678,10,181,66,115,181,66,115,,,
188687,10,412,119,293,79,21,58,333,98,235
188696,10,168,19,149,168,19,149,,,
188854,10,1666,480,1186,1666,480,1186,,,
188890,10,945,903,42,832,793,39,113,110,3
188915,10,35,9,26,19,7,12,16,2,14
188942,10,277,0,277,243,0,243,34,0,34
189015,10,635,75,560,267,29,238,368,46,322
189088,10,2591,1133,1458,2314,982,1332,277,151,126
189097,10,3043,8,3035,2959,0,2959,84,8,76
189219,10,159,147,12,159,147,12,,,
189228,10,1981,687,1294,1334,469,865,647,218,429
189255,10,135,2,133,87,2,85,48,0,48
189273,10,75,75,0,75,75,0,,,
189282,10,290,32,258,257,32,225,33,0,33
189404,10,154,3,151,56,1,55,98,2,96
189413,10,423,63,360,423,63,360,,,
189468,10,210,6,204,126,6,120,84,0,84
189477,10,110,3,107,73,2,71,37,1,36
189501,10,1184,468,716,1079,423,656,105,45,60
189547,10,4755,1937,2818,2549,1055,1494,2206,882,1324
189565,10,484,134,350,383,110,273,101,24,77
189583,10,749,177,572,462,103,359,287,74,213
189592,10,333,91,242,249,82,167,84,9,75
189705,10,2630,1235,1395,2192,1046,1146,438,189,249
189714,10,290,11,279,193,9,184,97,2,95
189811,10,813,167,646,813,167,646,,,
189839,10,1693,632,1061,832,316,516,861,316,545
189848,10,746,212,534,589,169,420,157,43,114
189857,10,672,672,0,672,672,0,,,
189990,10,590,7,583,163,3,160,427,4,423
190008,10,35,11,24,35,11,24,,,
190044,10,3953,2586,1367,3436,2277,1159,517,309,208
190053,10,1010,440,570,294,144,150,716,296,420
190071,10,100,8,92,17,2,15,83,6,77
190080,10,44,28,16,8,7,1,36,21,15
190099,10,3176,1428,1748,3150,1411,1739,26,17,9
190114,10,660,178,482,511,121,390,149,57,92
190150,10,33777,15638,18139,28935,13345,15590,4842,2293,2549
190169,10,1355,462,893,397,158,239,958,304,654
190239,10,104,1,103,72,1,71,32,0,32
190318,10,247,16,231,230,16,214,17,0,17
190372,10,936,514,422,902,483,419,34,31,3
190415,10,25582,12294,13288,25008,11964,13044,574,330,244
190424,10,1371,595,776,1317,576,741,54,19,35
190442,10,3954,1658,2296,1248,517,731,2706,1141,1565
190451,10,252,36,216,82,16,66,170,20,150
190503,10,2965,1490,1475,2834,1414,1420,131,76,55
190512,10,19969,9820,10149,13150,6614,6536,6819,3206,3613
190521,10,19336,7935,11401,12311,5237,7074,7025,2698,4327
190530,10,7265,2942,4323,4493,1896,2597,2772,1046,1726
190549,10,15938,6546,9392,10512,4450,6062,5426,2096,3330
190558,10,11793,5164,6629,8604,3924,4680,3189,1240,1949
190567,10,15031,6712,8319,10658,4745,5913,4373,1967,2406
190576,10,9017,3001,6016,4168,1629,2539,4849,1372,3477
190585,10,5441,1645,3796,2656,912,1744,2785,733,2052
190594,10,24099,7553,16546,15421,4930,10491,8678,2623,6055
190600,10,15210,5773,9437,11024,4024,7000,4186,1749,2437
190619,10,14214,6436,7778,5732,2480,3252,8482,3956,4526
190628,10,14919,6373,8546,7473,3164,4309,7446,3209,4237
190637,10,14392,4407,9985,8142,2643,5499,6250,1764,4486
190646,10,4134,1075,3059,2978,805,2173,1156,270,886
190655,10,14277,7773,6504,8969,5258,3711,5308,2515,2793
190664,10,18772,8074,10698,11961,5365,6596,6811,2709,4102
190673,10,10989,4786,6203,6116,2892,3224,4873,1894,2979
190682,10,699,239,460,472,158,314,227,81,146
190691,10,7027,2381,4646,4418,1481,2937,2609,900,1709
190707,10,14,3,11,14,3,11,,,
190716,10,2619,726,1893,1762,545,1217,857,181,676
190725,10,2642,648,1994,2135,552,1583,507,96,411
190752,10,55,55,0,55,55,0,,,
190761,10,1527,476,1051,1266,419,847,261,57,204
190840,10,7222,3173,4049,2720,1291,1429,4502,1882,2620
190956,10,141,10,131,4,0,4,137,10,127
190983,10,673,203,470,629,195,434,44,8,36
191083,10,8140,3784,4356,4704,2318,2386,3436,1466,1970
191126,10,8150,1360,6790,7055,1141,5914,1095,219,876
191199,10,5414,2263,3151,2053,913,1140,3361,1350,2011
191205,10,552,384,168,510,356,154,42,28,14
191241,10,16986,6475,10511,13422,5463,7959,3564,1012,2552
191302,10,1738,745,993,616,271,345,1122,474,648
191311,10,81,35,46,81,35,46,,,
191320,10,53,22,31,30,13,17,23,9,14
191339,10,4472,1687,2785,1556,621,935,2916,1066,1850
191515,10,2050,942,1108,2049,941,1108,1,1,0
191533,10,1170,491,679,1137,472,665,33,19,14
191597,10,557,75,482,270,37,233,287,38,249
191612,10,2024,800,1224,1132,446,686,892,354,538
191621,10,784,333,451,751,316,435,33,17,16
191630,10,1684,815,869,1664,804,860,20,11,9
191649,10,10243,4121,6122,8777,3588,5189,1466,533,933
191676,10,895,337,558,821,304,517,74,33,41
191719,10,8454,4103,4351,4317,2375,1942,4137,1728,2409
191728,10,1015,198,817,698,147,551,317,51,266
191931,10,3617,1660,1957,3002,1354,1648,615,306,309
191940,10,213,22,191,213,22,191,,,
191959,10,52,40,12,52,40,12,,,
191968,10,5239,2271,2968,5087,2199,2888,152,72,80
191986,10,3798,1577,2221,1438,592,846,2360,985,1375
192004,10,287,74,213,282,73,209,5,1,4
192022,10,2362,859,1503,1225,473,752,1137,386,751
192040,10,348,165,183,242,115,127,106,50,56
192110,10,979,522,457,841,442,399,138,80,58
192165,10,175,175,0,175,175,0,,,
192192,10,1287,310,977,1149,278,871,138,32,106
192271,10,1442,149,1293,1261,133,1128,181,16,165
192323,10,3301,1175,2126,2623,1010,1613,678,165,513
192448,10,15191,5007,10184,7974,2381,5593,7217,2626,4591
192484,10,136,2,134,74,0,74,62,2,60
192509,10,980,157,823,880,143,737,100,14,86
192624,10,172,172,0,172,172,0,,,
192688,10,457,64,393,369,54,315,88,10,78
192703,10,3694,2060,1634,3444,1900,1544,250,160,90
192712,10,1047,507,540,1033,506,527,14,1,13
192749,10,2350,868,1482,1656,679,977,694,189,505
192785,10,792,95,697,164,28,136,628,67,561
192800,10,20,0,20,7,0,7,13,0,13
192819,10,6396,2690,3706,5293,2187,3106,1103,503,600
192864,10,1770,334,1436,1533,313,1220,237,21,216
192925,10,1814,465,1349,1537,410,1127,277,55,222
192961,10,130,21,109,2,1,1,128,20,108
192970,10,18,5,13,18,5,13,,,
193016,10,8772,2444,6328,6216,1756,4460,2556,688,1868
193052,10,534,534,0,530,530,0,4,4,0
193061,10,49,49,0,49,49,0,,,
193070,10,67,67,0,67,67,0,,,
193186,10,92,2,90,53,1,52,39,1,38
193201,10,476,46,430,476,46,430,,,
193247,10,146,146,0,146,146,0,,,
193265,10,90,82,8,72,66,6,18,16,2
193283,10,5347,2415,2932,2323,1120,1203,3024,1295,1729
193292,10,4910,1210,3700,2947,856,2091,1963,354,1609
193308,10,7256,2577,4679,4244,1819,2425,3012,758,2254
193326,10,8721,3747,4974,4667,2097,2570,4054,1650,2404
193353,10,1941,519,1422,1335,386,949,606,133,473
193380,10,116,17,99,,,,116,17,99
193399,10,2948,644,2304,2471,592,1879,477,52,425
193405,10,1249,520,729,1249,520,729,,,
193478,10,12628,5976,6652,6931,3560,3371,5697,2416,3281
193584,10,2639,651,1988,2357,592,1765,282,59,223
193609,10,81,28,53,81,28,53,,,
193654,10,10493,2790,7703,9236,2455,6781,1257,335,922
193672,10,14,11,3,14,11,3,,,
193751,10,569,284,285,449,259,190,120,25,95
193821,10,1130,434,696,939,353,586,191,81,110
193830,10,1561,594,967,1314,533,781,247,61,186
193858,10,298,21,277,298,21,277,,,
193894,10,222,105,117,199,97,102,23,8,15
193900,10,58226,24509,33717,49397,20836,28561,8829,3673,5156
193946,10,4154,1655,2499,2279,964,1315,1875,691,1184
193973,10,3708,1296,2412,3271,1164,2107,437,132,305
193991,10,47,1,46,33,1,32,14,0,14
194028,10,1595,509,1086,580,187,393,1015,322,693
194073,10,338,171,167,337,171,166,1,0,1
194091,10,6696,3579,3117,5817,3114,2703,879,465,414
194116,10,670,73,597,302,43,259,368,30,338
194161,10,1863,769,1094,1156,473,683,707,296,411
194189,10,85,85,0,85,85,0,,,
194222,10,7687,3568,4119,3012,1499,1513,4675,2069,2606
194240,10,5047,1988,3059,2008,893,1115,3039,1095,1944
194259,10,32,2,30,32,2,30,,,
194310,10,13479,4658,8821,9981,3361,6620,3498,1297,2201
194392,10,745,479,266,715,462,253,30,17,13
194435,10,55,2,53,52,2,50,3,0,3
194499,10,896,180,716,873,175,698,23,5,18
194569,10,147,83,64,69,37,32,78,46,32
194578,10,5370,1456,3914,5083,1377,3706,287,79,208
194657,10,378,378,0,378,378,0,,,
194666,10,462,462,0,462,462,0,,,
194693,10,52,52,0,52,52,0,,,
194718,10,49,49,0,49,49,0,,,
194736,10,157,157,0,157,157,0,,,
194763,10,620,620,0,620,620,0,,,
194824,10,6774,4675,2099,6704,4630,2074,70,45,25
194958,10,1662,453,1209,1449,403,1046,213,50,163
195003,10,16790,11037,5753,14923,9772,5151,1867,1265,602
195030,10,12039,5607,6432,10148,5030,5118,1891,577,1314
195049,10,268,145,123,268,145,123,,,
195058,10,5637,2532,3105,2576,1324,1252,3061,1208,1853
195067,10,307,20,287,235,18,217,72,2,70
195128,10,2266,484,1782,1526,376,1150,740,108,632
195155,10,115,94,21,8,6,2,107,88,19
195164,10,2594,1274,1320,1943,1028,915,651,246,405
195173,10,2489,909,1580,2322,823,1499,167,86,81
195191,10,387,51,336,254,25,229,133,26,107
195216,10,2279,1053,1226,2240,1035,1205,39,18,21
195234,10,3307,959,2348,2305,698,1607,1002,261,741
195243,10,2026,988,1038,1118,564,554,908,424,484
195289,10,144,19,125,9,2,7,135,17,118
195304,10,1766,373,1393,1705,362,1343,61,11,50
195322,10,3705,1593,2112,1131,503,628,2574,1090,1484
195438,10,287,287,0,287,287,0,,,
195474,10,3634,1625,2009,3478,1548,1930,156,77,79
195526,10,2686,1097,1589,2655,1083,1572,31,14,17
195544,10,4687,1371,3316,3522,1126,2396,1165,245,920
195580,10,79,72,7,64,58,6,15,14,1
195702,10,137,16,121,75,12,63,62,4,58
195720,10,3539,1320,2219,3025,1205,1820,514,115,399
195784,10,710,82,628,710,82,628,,,
195809,10,19658,8218,11440,12601,5426,7175,7057,2792,4265
195988,10,1595,707,888,583,276,307,1012,431,581
196006,10,3414,2143,1271,3092,2050,1042,322,93,229
196015,10,2863,1252,1611,2353,1064,1289,510,188,322
196024,10,2634,1172,1462,1981,1050,931,653,122,531
196033,10,1820,807,1013,1682,743,939,138,64,74
196042,10,9348,5496,3852,7341,4363,2978,2007,1133,874
196051,10,1957,906,1051,1648,843,805,309,63,246
196060,10,17075,7415,9660,13960,6244,7716,3115,1171,1944
196079,10,18055,8790,9265,16200,7842,8358,1855,948,907
196088,10,32332,16810,15522,27279,14482,12797,5053,2328,2725
196097,10,26608,12432,14176,22457,10997,11460,4151,1435,2716
196103,10,2012,984,1028,1470,731,739,542,253,289
196112,10,2850,1697,1153,2003,1375,628,847,322,525
196121,10,6991,2698,4293,5222,2105,3117,1769,593,1176
196130,10,7173,2924,4249,5767,2353,3414,1406,571,835
196149,10,6658,2820,3838,6065,2593,3472,593,227,366
196158,10,3764,1518,2246,3578,1441,2137,186,77,109
196167,10,4537,1643,2894,4331,1558,2773,206,85,121
196176,10,7075,2542,4533,6053,2143,3910,1022,399,623
196185,10,5918,2188,3730,5405,2061,3344,513,127,386
196194,10,7058,3249,3809,6038,2808,3230,1020,441,579
196200,10,2607,955,1652,2398,884,1514,209,71,138
196219,10,3522,1455,2067,3214,1302,1912,308,153,155
196228,10,407,112,295,405,111,294,2,1,1
196237,10,4381,1745,2636,3548,1394,2154,833,351,482
196246,10,4738,1868,2870,4110,1636,2474,628,232,396
196255,10,2117,699,1418,1705,595,1110,412,104,308
196264,10,9462,3288,6174,3413,1009,2404,6049,2279,3770
196291,10,1545,1321,224,1368,1160,208,177,161,16
196307,10,1545,542,1003,1351,509,842,194,33,161
196389,10,900,182,718,885,178,707,15,4,11
196413,10,21772,10058,11714,18281,8348,9933,3491,1710,1781
196431,10,385,385,0,383,383,0,2,2,0
196440,10,14,14,0,14,14,0,,,
196468,10,4805,1036,3769,3209,671,2538,1596,365,1231
196565,10,4563,1908,2655,1008,419,589,3555,1489,2066
196583,10,39,39,0,39,39,0,,,
196592,10,11222,3333,7889,6933,2374,4559,4289,959,3330
196653,10,1101,159,942,425,58,367,676,101,575
196680,10,17166,9054,8112,,,,17166,9054,8112
196699,10,2907,1377,1530,973,447,526,1934,930,1004
196866,10,2096,1150,946,2075,1138,937,21,12,9
196884,10,222,91,131,205,84,121,17,7,10
197018,10,3069,3069,0,3069,3069,0,,,
197027,10,1023,801,222,1006,788,218,17,13,4
197036,10,4411,3379,1032,4411,3379,1032,,,
197045,10,4242,1584,2658,2654,1075,1579,1588,509,1079
197133,10,2516,966,1550,2498,961,1537,18,5,13
197142,10,452,216,236,387,192,195,65,24,41
197151,10,4111,1111,3000,3977,1071,2906,134,40,94
197197,10,1958,671,1287,1641,608,1033,317,63,254
197221,10,105,78,27,105,78,27,,,
197230,10,342,135,207,335,131,204,7,4,3
197285,10,873,244,629,678,201,477,195,43,152
197294,10,9121,4222,4899,4369,2184,2185,4752,2038,2714
197337,10,65,0,65,59,0,59,6,0,6
197531,10,461,219,242,461,219,242,,,
197601,10,156,156,0,156,156,0,,,
197647,10,142,142,0,136,136,0,6,6,0
197674,10,204,204,0,197,197,0,7,7,0
197692,10,82,82,0,82,82,0,,,
197708,10,5501,2364,3137,4789,2070,2719,712,294,418
197735,10,989,989,0,989,989,0,,,
197744,10,227,227,0,215,215,0,12,12,0
197814,10,2354,793,1561,772,271,501,1582,522,1060
197850,10,2967,1057,1910,600,255,345,2367,802,1565
197869,10,20641,8648,11993,18338,7861,10477,2303,787,1516
197887,10,6270,2337,3933,1636,669,967,4634,1668,2966
197911,10,1213,538,675,1046,523,523,167,15,152
197966,10,1627,520,1107,440,139,301,1187,381,806
197984,10,1517,784,733,1371,726,645,146,58,88
197993,10,207,0,207,181,0,181,26,0,26
198011,10,1016,306,710,276,73,203,740,233,507
198039,10,2635,1005,1630,732,304,428,1903,701,1202
198066,10,780,458,322,753,443,310,27,15,12
198084,10,1649,624,1025,569,250,319,1080,374,706
198109,10,557,35,522,237,14,223,320,21,299
198118,10,3550,1419,2131,1205,527,678,2345,892,1453
198136,10,5622,2459,3163,4691,2013,2678,931,446,485
198154,10,13059,6233,6826,3760,1888,1872,9299,4345,4954
198206,10,1535,497,1038,397,138,259,1138,359,779
198215,10,1207,581,626,1108,551,557,99,30,69
198233,10,4168,1754,2414,1207,552,655,2961,1202,1759
198251,10,4871,1709,3162,1397,578,819,3474,1131,2343
198260,10,17208,7004,10204,6468,2759,3709,10740,4245,6495
198303,10,981,557,424,922,537,385,59,20,39
198321,10,2425,905,1520,796,311,485,1629,594,1035
198330,10,3571,1302,2269,1535,574,961,2036,728,1308
198367,10,2713,1121,1592,746,368,378,1967,753,1214
198376,10,3636,1222,2414,1457,533,924,2179,689,1490
198385,10,1973,931,1042,1973,931,1042,,,
198419,10,17620,8213,9407,17013,7943,9070,607,270,337
198455,10,4119,1518,2601,731,335,396,3388,1183,2205
198464,10,28021,11071,16950,20822,8555,12267,7199,2516,4683
198491,10,1508,337,1171,307,67,240,1201,270,931
198507,10,2054,807,1247,1663,708,955,391,99,292
198516,10,7127,2836,4291,6876,2724,4152,251,112,139
198534,10,9790,3592,6198,3488,1338,2150,6302,2254,4048
198543,10,6748,2027,4721,4129,1242,2887,2619,785,1834
198552,10,7774,2787,4987,2749,1153,1596,5025,1634,3391
198561,10,3441,1146,2295,2137,797,1340,1304,349,955
198570,10,4949,1734,3215,1169,484,685,3780,1250,2530
198598,10,875,433,442,649,366,283,226,67,159
198613,10,1198,571,627,1085,532,553,113,39,74
198622,10,9960,4108,5852,3685,1600,2085,6275,2508,3767
198640,10,943,299,644,231,76,155,712,223,489
198668,10,1318,474,844,444,175,269,874,299,575
198677,10,30,11,19,17,5,12,13,6,7
198695,10,5860,2493,3367,5741,2447,3294,119,46,73
198710,10,1913,684,1229,644,253,391,1269,431,838
198729,10,1320,408,912,396,145,251,924,263,661
198756,10,1166,485,681,1107,458,649,59,27,32
198774,10,4059,1474,2585,1359,533,826,2700,941,1759
198808,10,873,303,570,841,294,547,32,9,23
198817,10,2348,840,1508,703,284,419,1645,556,1089
198835,10,2405,879,1526,1866,723,1143,539,156,383
198844,10,135,4,131,133,4,129,2,0,2
198862,10,890,491,399,869,482,387,21,9,12
198871,10,501,373,128,474,352,122,27,21,6
198899,10,1072,527,545,994,499,495,78,28,50
198905,10,856,271,585,317,77,240,539,194,345
198914,10,863,374,489,267,99,168,596,275,321
198923,10,1135,443,692,269,122,147,866,321,545
198950,10,1711,34,1677,1501,16,1485,210,18,192
198969,10,1916,948,968,1670,859,811,246,89,157
198978,10,1860,358,1502,1822,352,1470,38,6,32
198987,10,3286,1295,1991,943,398,545,2343,897,1446
199005,10,32,0,32,32,0,32,,,
199023,10,712,341,371,253,141,112,459,200,259
199032,10,1013,512,501,886,460,426,127,52,75
199069,10,2288,751,1537,1343,519,824,945,232,713
199078,10,175,22,153,165,21,144,10,1,9
199087,10,2874,1161,1713,799,329,470,2075,832,1243
199102,10,13322,5223,8099,11236,4306,6930,2086,917,1169
199111,10,3233,1375,1858,2805,1177,1628,428,198,230
199120,10,31641,12751,18890,26490,10547,15943,5151,2204,2947
199139,10,30448,15146,15302,23403,12007,11396,7045,3139,3906
199148,10,19038,6198,12840,14300,4685,9615,4738,1513,3225
199157,10,7953,2270,5683,6187,1818,4369,1766,452,1314
199184,10,1119,453,666,1090,439,651,29,14,15
199193,10,36831,18623,18208,29099,14549,14550,7732,4074,3658
199209,10,1531,703,828,1274,627,647,257,76,181
199218,10,18030,6070,11960,13134,4781,8353,4896,1289,3607
199263,10,307,85,222,49,8,41,258,77,181
199272,10,742,340,402,628,309,319,114,31,83
199281,10,8318,2934,5384,5329,1967,3362,2989,967,2022
199306,10,1122,421,701,880,329,551,242,92,150
199324,10,1187,455,732,199,81,118,988,374,614
199333,10,7346,2913,4433,2454,1001,1453,4892,1912,2980
199412,10,2063,693,1370,1471,531,940,592,162,430
199421,10,2289,774,1515,601,215,386,1688,559,1129
199449,10,2164,753,1411,760,278,482,1404,475,929
199458,10,145,92,53,123,78,45,22,14,8
199467,10,624,156,468,134,39,95,490,117,373
199476,10,1809,477,1332,736,211,525,1073,266,807
199485,10,1867,649,1218,463,191,272,1404,458,946
199494,10,6716,2391,4325,1997,813,1184,4719,1578,3141
199582,10,1261,710,551,871,503,368,390,207,183
199607,10,506,21,485,283,1,282,223,20,203
199625,10,1556,486,1070,409,157,252,1147,329,818
199634,10,3986,1469,2517,1169,460,709,2817,1009,1808
199643,10,1141,495,646,977,450,527,164,45,119
199689,10,190,9,181,155,4,151,35,5,30
199698,10,911,421,490,879,413,466,32,8,24
199722,10,1105,370,735,315,139,176,790,231,559
199731,10,2504,911,1593,626,223,403,1878,688,1190
199740,10,2456,669,1787,601,178,423,1855,491,1364
199759,10,3048,2182,866,1257,952,305,1791,1230,561
199768,10,2849,1061,1788,778,312,466,2071,749,1322
199786,10,3789,1462,2327,1176,481,695,2613,981,1632
199795,10,962,381,581,355,129,226,607,252,355
199838,10,2757,862,1895,760,278,482,1997,584,1413
199847,10,8947,3974,4973,8076,3682,4394,871,292,579
199856,10,21299,9287,12012,6639,3245,3394,14660,6042,8618
199865,10,803,271,532,798,269,529,5,2,3
199883,10,144,13,131,144,13,131,,,
199892,10,2815,1064,1751,693,308,385,2122,756,1366
199908,10,1670,582,1088,518,199,319,1152,383,769
199926,10,2315,960,1355,753,366,387,1562,594,968
199953,10,1709,535,1174,360,124,236,1349,411,938
199962,10,3439,1318,2121,3162,1185,1977,277,133,144
199971,10,79,40,39,79,40,39,,,
199980,10,26,23,3,26,23,3,,,
199999,10,5226,1221,4005,4322,1059,3263,904,162,742
200004,10,11877,4983,6894,9165,3990,5175,2712,993,1719
200013,10,597,90,507,322,42,280,275,48,227
200022,10,3549,1863,1686,1826,1048,778,1723,815,908
200059,10,1415,618,797,990,454,536,425,164,261
200086,10,187,62,125,124,42,82,63,20,43
200110,10,36,0,36,36,0,36,,,
200156,10,1276,674,602,1085,591,494,191,83,108
200192,10,1621,702,919,422,201,221,1199,501,698
200208,10,248,66,182,106,42,64,142,24,118
200217,10,3794,1438,2356,2554,965,1589,1240,473,767
200226,10,1172,468,704,622,287,335,550,181,369
200253,10,2836,1006,1830,1961,736,1225,875,270,605
200280,10,13772,6979,6793,8795,4423,4372,4977,2556,2421
200305,10,2802,1542,1260,1475,978,497,1327,564,763
200314,10,1163,424,739,351,110,241,812,314,498
200332,10,12461,6153,6308,10024,5053,4971,2437,1100,1337
200341,10,908,318,590,565,210,355,343,108,235
200466,10,256,86,170,192,69,123,64,17,47
200484,10,279,170,109,167,97,70,112,73,39
200527,10,472,194,278,353,157,196,119,37,82
200554,10,474,179,295,423,162,261,51,17,34
200572,10,1686,690,996,826,369,457,860,321,539
200590,10,129,24,105,109,12,97,20,12,8
200697,10,1178,979,199,586,512,74,592,467,125
200785,10,410,43,367,199,23,176,211,20,191
200800,10,14516,7357,7159,10650,5604,5046,3866,1753,2113
200846,10,1575,620,955,641,268,373,934,352,582
200873,10,77,32,45,62,26,36,15,6,9
201034,10,536,301,235,120,35,85,416,266,150
201061,10,239,70,169,225,64,161,14,6,8
201098,10,47,24,23,30,13,17,17,11,6
201104,10,4929,2224,2705,2936,1264,1672,1993,960,1033
201131,10,105,39,66,55,1,54,50,38,12
201140,10,162,142,20,73,73,0,89,69,20
201159,10,99,82,17,57,46,11,42,36,6
201177,10,259,25,234,105,11,94,154,14,140
201195,10,3325,1407,1918,3040,1301,1739,285,106,179
201283,10,803,302,501,369,161,208,434,141,293
201371,10,791,421,370,754,409,345,37,12,25
201432,10,1940,694,1246,916,329,587,1024,365,659
201441,10,17645,7499,10146,13316,5680,7636,4329,1819,2510
201469,10,619,154,465,470,124,346,149,30,119
201478,10,190,54,136,143,10,133,47,44,3
201496,10,448,277,171,448,277,171,,,
201539,10,84,13,71,73,7,66,11,6,5
201548,10,2820,1117,1703,2524,998,1526,296,119,177
201645,10,12142,5909,6233,11023,5456,5567,1119,453,666
201654,10,4643,2062,2581,3839,1749,2090,804,313,491
201672,10,2636,779,1857,485,134,351,2151,645,1506
201681,10,44,3,41,44,3,41,,,
201690,10,6044,1774,4270,3209,1063,2146,2835,711,2124
201751,10,152,37,115,46,11,35,106,26,80
201803,10,52,4,48,52,4,48,,,
201821,10,879,66,813,608,45,563,271,21,250
201867,10,104,15,89,104,15,89,,,
201885,10,40329,18556,21773,30074,14984,15090,10255,3572,6683
201928,10,8140,3144,4996,1933,847,1086,6207,2297,3910
201946,10,6529,2815,3714,1132,503,629,5397,2312,3085
201955,10,6133,2408,3725,2795,1110,1685,3338,1298,2040
201964,10,1900,767,1133,1002,453,549,898,314,584
201973,10,5042,1646,3396,943,348,595,4099,1298,2801
202046,10,580,157,423,570,150,420,10,7,3
202073,10,343,169,174,343,169,174,,,
202134,10,15308,6892,8416,11106,5175,5931,4202,1717,2485
202152,10,179,12,167,179,12,167,,,
202170,10,1000,299,701,985,293,692,15,6,9
202222,10,25102,11110,13992,5964,2768,3196,19138,8342,10796
202356,10,17523,6579,10944,4309,1874,2435,13214,4705,8509
202435,10,106,22,84,63,11,52,43,11,32
202453,10,73,60,13,63,52,11,10,8,2
202480,10,11971,6212,5759,10800,5630,5170,1171,582,589
202514,10,585,348,237,511,311,200,74,37,37
202523,10,2321,1109,1212,2307,1097,1210,14,12,2
202648,10,4435,1648,2787,1184,498,686,3251,1150,2101
202657,10,371,112,259,51,12,39,320,100,220
202763,10,4811,1702,3109,2777,901,1876,2034,801,1233
202806,10,6815,2618,4197,2590,957,1633,4225,1661,2564
202888,10,40,1,39,20,1,19,20,0,20
202903,10,348,175,173,149,71,78,199,104,95
202912,10,305,17,288,129,6,123,176,11,165
202949,10,166,150,16,166,150,16,,,
202985,10,54,4,50,44,4,40,10,0,10
203030,10,53,6,47,53,6,47,,,
203067,10,322,123,199,277,115,162,45,8,37
203085,10,1197,595,602,1085,544,541,112,51,61
203128,10,1335,597,738,808,387,421,527,210,317
203146,10,359,327,32,359,327,32,,,
203155,10,2348,1149,1199,1419,811,608,929,338,591
203234,10,96,6,90,96,6,90,,,
203289,10,55,43,12,55,43,12,,,
203331,10,45173,14353,30820,13430,4290,9140,31743,10063,21680
203368,10,3171,1655,1516,2858,1514,1344,313,141,172
203386,10,2541,179,2362,1819,118,1701,722,61,661
203438,10,106,3,103,51,1,50,55,2,53
203447,10,1859,687,1172,173,57,116,1686,630,1056
203456,10,1021,337,684,28,7,21,993,330,663
203465,10,4653,1766,2887,1111,439,672,3542,1327,2215
203474,10,2068,786,1282,405,135,270,1663,651,1012
203483,10,1986,788,1198,455,175,280,1531,613,918
203492,10,1566,444,1122,270,43,227,1296,401,895
203517,10,26597,9778,16819,19946,7392,12554,6651,2386,4265
203526,10,2240,807,1433,286,101,185,1954,706,1248
203535,10,1875,855,1020,1868,853,1015,7,2,5
203544,10,811,134,677,571,82,489,240,52,188
203580,10,920,477,443,704,383,321,216,94,122
203599,10,4786,1752,3034,1354,630,724,3432,1122,2310
203614,10,454,89,365,454,89,365,,,
203678,10,3402,1207,2195,498,177,321,2904,1030,1874
203720,10,183,95,88,149,90,59,34,5,29
203739,10,54,7,47,28,5,23,26,2,24
203748,10,9520,3587,5933,2227,882,1345,7293,2705,4588
203757,10,1112,454,658,898,393,505,214,61,153
203775,10,1306,499,807,863,350,513,443,149,294
203845,10,1265,618,647,1196,583,613,69,35,34
203881,10,2662,1125,1537,365,128,237,2297,997,1300
203942,10,34,16,18,34,16,18,,,
203960,10,1311,147,1164,330,48,282,981,99,882
203997,10,126,42,84,78,21,57,48,21,27
204006,10,2289,1107,1182,1619,767,852,670,340,330
204015,10,1492,674,818,958,453,505,534,221,313
204024,10,19264,8950,10314,17564,8451,9113,1700,499,1201
204121,10,67,0,67,28,0,28,39,0,39
204158,10,157,47,110,157,47,110,,,
204176,10,790,107,683,587,81,506,203,26,177
204185,10,2133,1069,1064,2036,1017,1019,97,52,45
204194,10,2064,788,1276,1582,640,942,482,148,334
204200,10,2064,804,1260,1261,562,699,803,242,561
204255,10,1731,699,1032,771,348,423,960,351,609
204264,10,2171,846,1325,1567,711,856,604,135,469
204334,10,131,3,128,1,0,1,130,3,127
204422,10,2582,1008,1574,700,306,394,1882,702,1180
204431,10,45,9,36,45,9,36,,,
204440,10,2777,1566,1211,514,259,255,2263,1307,956
204459,10,20,14,6,20,14,6,,,
204468,10,1522,693,829,953,507,446,569,186,383
204477,10,1011,470,541,995,464,531,16,6,10
204486,10,2741,2295,446,2563,2181,382,178,114,64
204501,10,2953,1232,1721,2916,1220,1696,37,12,25
204608,10,470,419,51,470,419,51,,,
204617,10,1332,574,758,927,438,489,405,136,269
204635,10,3116,1613,1503,2846,1475,1371,270,138,132
204662,10,490,212,278,421,177,244,69,35,34
204671,10,874,353,521,717,290,427,157,63,94
204680,10,954,427,527,757,352,405,197,75,122
204699,10,1047,520,527,875,439,436,172,81,91
204705,10,2730,1371,1359,2254,1133,1121,476,238,238
204714,10,84,7,77,84,7,77,,,
204723,10,299,230,69,299,230,69,,,
204769,10,157,7,150,157,7,150,,,
204778,10,89,2,87,89,2,87,,,
204796,10,61677,29739,31938,53218,25663,27555,8459,4076,4383
204802,10,1204,414,790,230,74,156,974,340,634
204820,10,2211,753,1458,715,241,474,1496,512,984
204839,10,2451,811,1640,606,188,418,1845,623,1222
204848,10,2125,796,1329,502,178,324,1623,618,1005
204857,10,24797,9991,14806,17552,7709,9843,7245,2282,4963
204866,10,2184,643,1541,549,123,426,1635,520,1115
204884,10,133,8,125,133,8,125,,,
204893,10,35,6,29,12,4,8,23,2,21
204909,10,1339,598,741,1333,595,738,6,3,3
204936,10,2605,1010,1595,2182,881,1301,423,129,294
204945,10,7516,3776,3740,1896,810,1086,5620,2966,2654
204963,10,41,2,39,40,2,38,1,0,1
204981,10,156,39,117,24,6,18,132,33,99
204990,10,200,100,100,115,66,49,85,34,51
205027,10,150,145,5,52,52,0,98,93,5
205054,10,354,31,323,354,31,323,,,
205090,10,74,4,70,9,2,7,65,2,63
205124,10,72,72,0,71,71,0,1,1,0
205142,10,164,45,119,158,45,113,6,0,6
205179,10,491,93,398,471,90,381,20,3,17
205203,10,1868,752,1116,1109,528,581,759,224,535
205391,10,195,47,148,108,26,82,87,21,66
205443,10,3216,1358,1858,2250,1005,1245,966,353,613
205470,10,18544,8685,9859,3467,1769,1698,15077,6916,8161
205559,10,57,14,43,57,14,43,,,
205841,10,10596,4351,6245,2695,1264,1431,7901,3087,4814
205887,10,482,69,413,482,69,413,,,
205957,10,3415,1441,1974,2477,1047,1430,938,394,544
205966,10,1933,604,1329,475,153,322,1458,451,1007
206011,10,2015,1079,936,481,243,238,1534,836,698
206039,10,48,0,48,32,0,32,16,0,16
206048,10,2934,1342,1592,1738,883,855,1196,459,737
206084,10,16979,7858,9121,13444,6347,7097,3535,1511,2024
206154,10,24,17,7,3,2,1,21,15,6
206172,10,17,2,15,17,2,15,,,
206181,10,160,30,130,56,7,49,104,23,81
206279,10,776,348,428,368,159,209,408,189,219
206288,10,399,233,166,325,196,129,74,37,37
206321,10,82,27,55,55,3,52,27,24,3
206349,10,1079,96,983,648,45,603,431,51,380
206394,10,47,10,37,28,7,21,19,3,16
206437,10,2440,896,1544,1691,720,971,749,176,573
206446,10,1842,657,1185,526,233,293,1316,424,892
206491,10,557,226,331,389,158,231,168,68,100
206507,10,1036,462,574,986,445,541,50,17,33
206516,10,107,55,52,82,41,41,25,14,11
206525,10,1326,609,717,1252,578,674,74,31,43
206589,10,1968,900,1068,1947,888,1059,21,12,9
206604,10,10295,4673,5622,6706,2932,3774,3589,1741,1848
206613,10,1444,581,863,758,314,444,686,267,419
206622,10,6633,2796,3837,5385,2283,3102,1248,513,735
206695,10,11298,4793,6505,8324,3671,4653,2974,1122,1852
206817,10,266,137,129,245,131,114,21,6,15
206835,10,902,438,464,608,339,269,294,99,195
206862,10,2159,907,1252,1692,739,953,467,168,299
206905,10,282,146,136,60,23,37,222,123,99
206914,10,3470,1213,2257,2195,790,1405,1275,423,852
206923,10,1781,552,1229,867,301,566,914,251,663
206932,10,433,47,386,413,44,369,20,3,17
206941,10,13250,4912,8338,9137,3389,5748,4113,1523,2590
206996,10,1890,579,1311,978,315,663,912,264,648
207041,10,3350,1321,2029,2397,1018,1379,953,303,650
207050,10,1334,459,875,626,241,385,708,218,490
207069,10,1848,716,1132,470,207,263,1378,509,869
207087,10,25,2,23,25,2,23,,,
207102,10,62,12,50,62,12,50,,,
207157,10,301,173,128,238,144,94,63,29,34
207209,10,1960,725,1235,1778,653,1125,182,72,110
207236,10,2162,679,1483,836,308,528,1326,371,955
207254,10,684,608,76,684,608,76,,,
207263,10,7025,2363,4662,4448,1610,2838,2577,753,1824
207281,10,2997,1135,1862,1222,518,704,1775,617,1158
207290,10,1763,738,1025,1234,584,650,529,154,375
207306,10,1791,713,1078,1297,539,758,494,174,320
207315,10,1303,585,718,841,359,482,462,226,236
207324,10,2184,1038,1146,1749,828,921,435,210,225
207342,10,3235,987,2248,2752,857,1895,483,130,353
207351,10,1294,589,705,920,472,448,374,117,257
207388,10,24577,11774,12803,19571,9332,10239,5006,2442,2564
207397,10,4456,1568,2888,998,438,560,3458,1130,2328
207403,10,1510,647,863,1358,559,799,152,88,64
207449,10,11388,4114,7274,3208,1278,1930,8180,2836,5344
207458,10,2551,918,1633,2195,787,1408,356,131,225
207500,10,28042,13425,14617,21960,10566,11394,6082,2859,3223
207564,10,2286,1514,772,1356,1032,324,930,482,448
207582,10,4711,1904,2807,3307,1303,2004,1404,601,803
207661,10,3182,1208,1974,1997,757,1240,1185,451,734
207670,10,6851,2445,4406,2247,873,1374,4604,1572,3032
207704,10,158,4,154,75,2,73,83,2,81
207722,10,849,304,545,780,278,502,69,26,43
207740,10,1530,500,1030,754,269,485,776,231,545
207786,10,24,1,23,24,1,23,,,
207847,10,5420,2235,3185,2855,1234,1621,2565,1001,1564
207856,10,482,272,210,427,237,190,55,35,20
207865,10,4648,1756,2892,3534,1422,2112,1114,334,780
207935,10,14428,5240,9188,4645,1913,2732,9783,3327,6456
207962,10,706,622,84,706,622,84,,,
207971,10,3832,1954,1878,3408,1716,1692,424,238,186
208035,10,1314,441,873,503,233,270,811,208,603
208044,10,55,5,50,55,5,50,,,
208053,10,272,148,124,12,1,11,260,147,113
208275,10,1224,517,707,600,262,338,624,255,369
208318,10,3735,1667,2068,1727,815,912,2008,852,1156
208390,10,7492,3242,4250,3232,1357,1875,4260,1885,2375
208406,10,5217,2618,2599,1696,794,902,3521,1824,1697
208415,10,741,350,391,279,126,153,462,224,238
208433,10,79,3,76,79,3,76,,,
208479,10,464,66,398,464,66,398,,,
208512,10,401,69,332,401,69,332,,,
208637,10,198,42,156,,,,198,42,156
208646,10,2825,1102,1723,1632,666,966,1193,436,757
208725,10,44,26,18,37,20,17,7,6,1
208822,10,4285,1540,2745,2967,1081,1886,1318,459,859
208859,10,38,5,33,38,5,33,,,
209038,10,6807,3167,3640,2701,1256,1445,4106,1911,2195
209056,10,3499,1166,2333,3046,1038,2008,453,128,325
209065,10,1297,518,779,1252,498,754,45,20,25
209074,10,4190,1850,2340,1583,724,859,2607,1126,1481
209083,10,98,25,73,98,25,73,,,
209153,10,27,3,24,27,3,24,,,
209205,10,35,2,33,35,2,33,,,
209241,10,119,118,1,82,82,0,37,36,1
209250,10,5893,3301,2592,1929,858,1071,3964,2443,1521
209287,10,595,328,267,433,248,185,162,80,82
209296,10,466,73,393,395,63,332,71,10,61
209409,10,686,259,427,523,211,312,163,48,115
209490,10,2984,938,2046,2189,729,1460,795,209,586
209506,10,4910,2352,2558,2265,1201,1064,2645,1151,1494
209542,10,33193,16929,16264,22273,11599,10674,10920,5330,5590
209551,10,22257,9928,12329,20574,9142,11432,1683,786,897
209603,10,472,125,347,437,117,320,35,8,27
209612,10,3751,1190,2561,3435,1092,2343,316,98,218
209667,10,58,4,54,58,4,54,,,
209676,10,92,15,77,92,15,77,,,
209694,10,42,7,35,42,7,35,,,
209700,10,210,19,191,210,19,191,,,
209719,10,63,0,63,63,0,63,,,
209746,10,21214,8953,12261,8312,3666,4646,12902,5287,7615
209807,10,22858,9597,13261,14418,6053,8365,8440,3544,4896
209825,10,4033,1520,2513,3613,1383,2230,420,137,283
209922,10,1566,655,911,1515,631,884,51,24,27
209940,10,3438,1337,2101,1121,429,692,2317,908,1409
210146,10,5179,1937,3242,2752,1112,1640,2427,825,1602
210155,10,1490,559,931,797,362,435,693,197,496
210234,10,1417,617,800,734,358,376,683,259,424
210270,10,2236,833,1403,771,305,466,1465,528,937
210304,10,410,137,273,385,126,259,25,11,14
210331,10,1082,484,598,754,326,428,328,158,170
210340,10,46,7,39,46,7,39,,,
210368,10,835,585,250,62,34,28,773,551,222
210401,10,1785,791,994,1721,764,957,64,27,37
210429,10,4029,1302,2727,3274,1065,2209,755,237,518
210438,10,1141,435,706,582,294,288,559,141,418
210492,10,256,128,128,238,120,118,18,8,10
210508,10,24,12,12,24,12,12,,,
210571,10,1465,641,824,1340,597,743,125,44,81
210599,10,733,376,357,733,376,357,,,
210605,10,11977,5586,6391,3791,1803,1988,8186,3783,4403
210669,10,1575,726,849,1528,707,821,47,19,28
210711,10,39,1,38,39,1,38,,,
210739,10,3101,1105,1996,2356,842,1514,745,263,482
210748,10,92,1,91,39,1,38,53,0,53
210775,10,2536,847,1689,1919,705,1214,617,142,475
210784,10,137,2,135,117,2,115,20,0,20
210809,10,6856,4721,2135,,,,6856,4721,2135
211006,10,378,351,27,365,339,26,13,12,1
211024,10,696,365,331,461,240,221,235,125,110
211079,10,1735,692,1043,549,268,281,1186,424,762
211088,10,3063,913,2150,2163,692,1471,900,221,679
211130,10,225,135,90,138,85,53,87,50,37
211158,10,7739,2932,4807,6683,2593,4090,1056,339,717
211273,10,1778,78,1700,1729,72,1657,49,6,43
211291,10,3757,1765,1992,3731,1757,1974,26,8,18
211307,10,6223,2556,3667,2117,1043,1074,4106,1513,2593
211316,10,113,1,112,81,1,80,32,0,32
211334,10,26,0,26,26,0,26,,,
211343,10,2529,972,1557,953,421,532,1576,551,1025
211352,10,1760,659,1101,1311,513,798,449,146,303
211361,10,6509,2555,3954,4338,1763,2575,2171,792,1379
211431,10,1985,273,1712,1195,188,1007,790,85,705
211440,10,15057,8541,6516,14069,7929,6140,988,612,376
211468,10,1440,120,1320,926,59,867,514,61,453
211477,10,891,285,606,205,89,116,686,196,490
211556,10,2439,586,1853,1847,476,1371,592,110,482
211583,10,1505,530,975,1083,443,640,422,87,335
211608,10,642,231,411,593,212,381,49,19,30
211635,10,105,13,92,105,13,92,,,
211644,10,3922,1115,2807,2631,811,1820,1291,304,987
211802,10,150,23,127,150,23,127,,,
211893,10,151,81,70,151,81,70,,,
211927,10,8706,3252,5454,2084,987,1097,6622,2265,4357
211981,10,2168,844,1324,1599,644,955,569,200,369
212009,10,2186,920,1266,2151,906,1245,35,14,21
212045,10,206,46,160,204,46,158,2,0,2
212054,10,23216,10551,12665,17387,8535,8852,5829,2016,3813
212106,10,8300,2916,5384,7935,2790,5145,365,126,239
212115,10,5129,2113,3016,4096,1769,2327,1033,344,689
212133,10,4429,1656,2773,1984,765,1219,2445,891,1554
212160,10,4043,1361,2682,3113,1093,2020,930,268,662
212197,10,1933,748,1185,1653,643,1010,280,105,175
212230,10,37,5,32,37,5,32,,,
212267,10,73,1,72,52,1,51,21,0,21
212276,10,60,2,58,45,2,43,15,0,15
212294,10,57,1,56,51,1,50,6,0,6
212300,10,60,1,59,60,1,59,,,
212328,10,79,3,76,55,1,54,24,2,22
212337,10,80,2,78,51,0,51,29,2,27
212355,10,108,4,104,79,3,76,29,1,28
212382,10,122,2,120,78,1,77,44,1,43
212391,10,68,1,67,46,1,45,22,0,22
212434,10,227,210,17,227,210,17,,,
212443,10,180,119,61,81,56,25,99,63,36
212577,10,2145,949,1196,2127,940,1187,18,9,9
212601,10,4596,1847,2749,3664,1532,2132,932,315,617
212656,10,1315,647,668,1072,546,526,243,101,142
212674,10,2401,1174,1227,2398,1173,1225,3,1,2
212753,10,86,4,82,61,4,57,25,0,25
212771,10,403,79,324,125,23,102,278,56,222
212805,10,2317,1196,1121,2159,1111,1048,158,85,73
212832,10,2521,651,1870,1994,444,1550,527,207,320
212869,10,996,175,821,601,120,481,395,55,340
212878,10,14023,4600,9423,3683,1393,2290,10340,3207,7133
212911,10,1420,657,763,1419,657,762,1,0,1
212975,10,89,69,20,89,69,20,,,
212984,10,3011,666,2345,1925,465,1460,1086,201,885
212993,10,71,27,44,66,24,42,5,3,2
213011,10,2478,637,1841,1196,349,847,1282,288,994
213020,10,9298,3602,5696,7171,2732,4439,2127,870,1257
213163,10,271,39,232,271,39,232,,,
213181,10,346,21,325,248,17,231,98,4,94
213233,10,530,413,117,438,360,78,92,53,39
213251,10,1293,586,707,1233,556,677,60,30,30
213303,10,1244,537,707,931,465,466,313,72,241
213321,10,2130,1004,1126,1772,889,883,358,115,243
213330,10,18,0,18,18,0,18,,,
213349,10,7673,3163,4510,6348,2745,3603,1325,418,907
213358,10,1235,425,810,1035,362,673,200,63,137
213367,10,4043,1327,2716,2574,914,1660,1469,413,1056
213376,10,1916,734,1182,1256,530,726,660,204,456
213385,10,2725,1395,1330,2706,1383,1323,19,12,7
213400,10,1967,953,1014,766,355,411,1201,598,603
213446,10,86,42,44,40,18,22,46,24,22
213455,10,367,9,358,42,0,42,325,9,316
213473,10,131,22,109,92,14,78,39,8,31
213491,10,52,2,50,20,2,18,32,0,32
213507,10,2041,914,1127,1797,799,998,244,115,129
213525,10,6324,2162,4162,2017,905,1112,4307,1257,3050
213534,10,334,102,232,311,97,214,23,5,18
213543,10,7263,3903,3360,6407,3480,2927,856,423,433
213570,10,560,123,437,560,123,437,,,
213589,10,338,304,34,235,212,23,103,92,11
213598,10,1916,633,1283,1772,590,1182,144,43,101
213613,10,2920,1092,1828,2427,982,1445,493,110,383
213622,10,114,14,100,98,12,86,16,2,14
213631,10,291,137,154,106,50,56,185,87,98
213659,10,4187,1428,2759,1414,592,822,2773,836,1937
213668,10,1089,491,598,1081,487,594,8,4,4
213774,10,660,160,500,409,106,303,251,54,197
213783,10,1796,641,1155,1384,514,870,412,127,285
213826,10,2647,773,1874,2286,658,1628,361,115,246
213914,10,280,17,263,280,17,263,,,
213932,10,141,20,121,141,20,121,,,
213987,10,3041,1200,1841,2678,1105,1573,363,95,268
213996,10,3276,1197,2079,2588,963,1625,688,234,454
214023,10,8,3,5,7,2,5,1,1,0
214041,10,7191,2786,4405,5118,2122,2996,2073,664,1409
214069,10,2239,699,1540,1664,563,1101,575,136,439
214111,10,8996,3560,5436,2580,1257,1323,6416,2303,4113
214148,10,382,1,381,368,0,368,14,1,13
214157,10,2560,909,1651,2032,764,1268,528,145,383
214166,10,2706,868,1838,971,295,676,1735,573,1162
214175,10,2095,849,1246,2028,816,1212,67,33,34
214272,10,2212,777,1435,1518,558,960,694,219,475
214290,10,667,623,44,667,623,44,,,
214379,10,7843,2826,5017,2929,1284,1645,4914,1542,3372
214476,10,29,5,24,27,4,23,2,1,1
214528,10,215,203,12,172,162,10,43,41,2
214564,10,1186,244,942,1087,228,859,99,16,83
214582,10,549,57,492,334,42,292,215,15,200
214883,10,875,231,644,191,47,144,684,184,500
214892,10,266,108,158,266,108,158,,,
214944,10,566,484,82,387,334,53,179,150,29
214971,10,178,41,137,175,40,135,3,1,2
215008,10,61,59,2,61,59,2,,,
215044,10,106,30,76,106,30,76,,,
215053,10,228,65,163,211,60,151,17,5,12
215062,10,28038,12385,15653,23030,10406,12624,5008,1979,3029
215105,10,1557,531,1026,1508,520,988,49,11,38
215114,10,1116,487,629,830,379,451,286,108,178
215123,10,3062,1137,1925,2913,1110,1803,149,27,122
215132,10,2420,766,1654,2119,642,1477,301,124,177
215239,10,11647,3699,7948,3689,1321,2368,7958,2378,5580
215266,10,1164,491,673,1092,469,623,72,22,50
215275,10,1320,567,753,1259,534,725,61,33,28
215284,10,2121,1196,925,2066,1164,902,55,32,23
215293,10,33230,14170,19060,26558,11498,15060,6672,2672,4000
215309,10,33,5,28,25,4,21,8,1,7
215336,10,34,0,34,34,0,34,,,
215381,10,609,560,49,609,560,49,,,
215390,10,191,65,126,45,24,21,146,41,105
215415,10,1240,728,512,1055,631,424,185,97,88
215424,10,240,129,111,206,112,94,34,17,17
215442,10,3505,1274,2231,2490,903,1587,1015,371,644
215479,10,65,15,50,65,15,50,,,
215530,10,58,0,58,41,0,41,17,0,17
215585,10,4737,1576,3161,895,366,529,3842,1210,2632
215594,10,288,42,246,207,31,176,81,11,70
215619,10,53,19,34,47,18,29,6,1,5
215637,10,245,98,147,245,98,147,,,
215655,10,3764,1981,1783,2788,1541,1247,976,440,536
215682,10,484,430,54,484,430,54,,,
215691,10,635,242,393,431,175,256,204,67,137
215743,10,3034,1111,1923,1779,659,1120,1255,452,803
215770,10,6464,2806,3658,4301,2026,2275,2163,780,1383
215798,10,1592,864,728,1449,783,666,143,81,62
215813,10,66,55,11,43,43,0,23,12,11
215886,10,58,14,44,39,13,26,19,1,18
215929,10,4692,1919,2773,3845,1570,2275,847,349,498
215947,10,2012,686,1326,1803,636,1167,209,50,159
215974,10,327,64,263,191,41,150,136,23,113
215983,10,23,5,18,23,5,18,,,
215992,10,144,67,77,143,66,77,1,1,0
216010,10,5667,2602,3065,4604,2176,2428,1063,426,637
216038,10,8405,3419,4986,7062,3013,4049,1343,406,937
216047,10,174,166,8,150,150,0,24,16,8
216074,10,187,7,180,108,5,103,79,2,77
216083,10,274,101,173,237,91,146,37,10,27
216162,10,301,24,277,301,24,277,,,
216223,10,31,1,30,31,1,30,,,
216278,10,2202,960,1242,2110,924,1186,92,36,56
216287,10,1651,821,830,1649,820,829,2,1,1
216296,10,1207,1079,128,1173,1051,122,34,28,6
216311,10,117,117,0,117,117,0,,,
216339,10,35626,15305,20321,30992,13317,17675,4634,1988,2646
216348,10,20,18,2,6,5,1,14,13,1
216357,10,845,430,415,832,424,408,13,6,7
216366,10,8270,2213,6057,5983,1767,4216,2287,446,1841
216436,10,125,112,13,125,112,13,,,
216445,10,133,127,6,133,127,6,,,
216454,10,98,86,12,98,86,12,,,
216463,10,200,142,58,76,58,18,124,84,40
216524,10,1556,812,744,1530,798,732,26,14,12
216542,10,583,274,309,430,198,232,153,76,77
216551,10,78,61,17,71,55,16,7,6,1
216579,10,85,2,83,85,2,83,,,
216597,10,10870,4997,5873,8192,3736,4456,2678,1261,1417
216630,10,33,4,29,33,4,29,,,
216667,10,1157,590,567,1138,575,563,19,15,4
216694,10,1470,584,886,1249,520,729,221,64,157
216746,10,58,52,6,46,42,4,12,10,2
216764,10,17614,6786,10828,13760,5362,8398,3854,1424,2430
216773,10,117,19,98,117,19,98,,,
216782,10,284,13,271,137,4,133,147,9,138
216807,10,1225,559,666,1085,518,567,140,41,99
216816,10,904,613,291,215,159,56,689,454,235
216825,10,4182,1427,2755,1349,555,794,2833,872,1961
216852,10,5875,2033,3842,4294,1727,2567,1581,306,1275
216931,10,5276,1701,3575,2527,1102,1425,2749,599,2150
216940,10,243,243,0,243,243,0,,,
217013,10,1403,334,1069,604,149,455,799,185,614
217040,10,38,38,0,38,38,0,,,
217059,10,3852,1611,2241,3245,1388,1857,607,223,384
217077,10,446,134,312,446,134,312,,,
217156,10,10696,5210,5486,10256,5049,5207,440,161,279
217165,10,3441,2127,1314,3235,2015,1220,206,112,94
217235,10,5110,1972,3138,4704,1799,2905,406,173,233
217305,10,1907,1115,792,1661,983,678,246,132,114
217323,10,623,579,44,623,579,44,,,
217402,10,4671,2090,2581,4205,1911,2294,466,179,287
217420,10,6331,1856,4475,4316,1339,2977,2015,517,1498
217475,10,11962,4698,7264,4736,2169,2567,7226,2529,4697
217484,10,17511,7426,10085,14529,6126,8403,2982,1300,1682
217493,10,2576,866,1710,2576,866,1710,,,
217518,10,4529,2252,2277,3990,1976,2014,539,276,263
217536,10,2828,921,1907,2266,735,1531,562,186,376
217581,10,134,2,132,88,1,87,46,1,45
217606,10,250,145,105,156,87,69,94,58,36
217615,10,1873,659,1214,600,227,373,1273,432,841
217624,10,621,363,258,578,337,241,43,26,17
217633,10,4008,1387,2621,3471,1191,2280,537,196,341
217688,10,3341,1196,2145,2611,917,1694,730,279,451
217712,10,2046,594,1452,471,167,304,1575,427,1148
217721,10,1908,831,1077,1897,827,1070,11,4,7
217749,10,3155,1467,1688,2372,1087,1285,783,380,403
217776,10,1300,406,894,767,275,492,533,131,402
217794,10,116,2,114,82,2,80,34,0,34
217819,10,10941,3569,7372,9549,3120,6429,1392,449,943
217828,10,39,2,37,26,1,25,13,1,12
217837,10,1717,515,1202,261,79,182,1456,436,1020
217864,10,3693,2836,857,2697,2296,401,996,540,456
217873,10,1866,544,1322,1737,513,1224,129,31,98
217882,10,27341,13224,14117,23929,11745,12184,3412,1479,1933
217891,10,153,68,85,148,66,82,5,2,3
217907,10,1280,560,720,861,355,506,419,205,214
217925,10,2338,1100,1238,835,420,415,1503,680,823
217934,10,1389,203,1186,1017,133,884,372,70,302
217961,10,1440,262,1178,906,165,741,534,97,437
217989,10,612,217,395,257,106,151,355,111,244
217998,10,945,631,314,813,536,277,132,95,37
218025,10,2861,1047,1814,1024,485,539,1837,562,1275
218061,10,3923,1258,2665,2837,937,1900,1086,321,765
218070,10,2463,956,1507,2377,927,1450,86,29,57
218113,10,9756,3839,5917,4005,1729,2276,5751,2110,3641
218140,10,6416,2272,4144,2907,1247,1660,3509,1025,2484
218159,10,116,3,113,91,2,89,25,1,24
218195,10,100,3,97,60,3,57,40,0,40
218229,10,3825,1193,2632,3284,1024,2260,541,169,372
218238,10,1840,856,984,1474,715,759,366,141,225
218335,10,3240,994,2246,2974,962,2012,266,32,234
218353,10,8702,3177,5525,3586,1623,1963,5116,1554,3562
218399,10,410,184,226,402,180,222,8,4,4
218414,10,1242,723,519,1213,714,499,29,9,20
218441,10,2273,1047,1226,1794,860,934,479,187,292
218487,10,2145,623,1522,640,258,382,1505,365,1140
218520,10,4491,1442,3049,1520,572,948,2971,870,2101
218539,10,1231,543,688,1161,521,640,70,22,48
218645,10,3869,1342,2527,2606,929,1677,1263,413,850
218654,10,2037,629,1408,1609,495,1114,428,134,294
218663,10,35471,15280,20191,31575,13882,17693,3896,1398,2498
218672,10,1809,742,1067,704,316,388,1105,426,679
218681,10,833,343,490,343,162,181,490,181,309
218690,10,1419,562,857,514,226,288,905,336,569
218706,10,1244,568,676,335,166,169,909,402,507
218724,10,10473,4603,5870,9095,4046,5049,1378,557,821
218733,10,2374,1000,1374,2028,854,1174,346,146,200
218742,10,5438,1691,3747,4022,1271,2751,1416,420,996
218751,10,394,199,195,394,199,195,,,
218821,10,1042,470,572,1008,455,553,34,15,19
218830,10,6097,2347,3750,2601,1154,1447,3496,1193,2303
218858,10,2640,857,1783,769,319,450,1871,538,1333
218885,10,5617,2597,3020,3147,1638,1509,2470,959,1511
218894,10,11286,4355,6931,4060,1724,2336,7226,2631,4595
218919,10,402,169,233,349,150,199,53,19,34
218955,10,530,116,414,102,19,83,428,97,331
218964,10,5174,1505,3669,3884,1213,2671,1290,292,998
218973,10,1765,853,912,1745,840,905,20,13,7
218991,10,3835,1514,2321,1865,846,1019,1970,668,1302
219000,10,2022,722,1300,1701,636,1065,321,86,235
219037,10,53,1,52,53,1,52,,,
219046,10,3539,1297,2242,1725,589,1136,1814,708,1106
219082,10,3219,2025,1194,1514,1075,439,1705,950,755
219091,10,926,385,541,684,333,351,242,52,190
219125,10,88,4,84,80,3,77,8,1,7
219143,10,2190,1128,1062,1511,899,612,679,229,450
219170,10,24,2,22,24,2,22,,,
219189,10,1189,769,420,845,598,247,344,171,173
219198,10,1236,576,660,731,359,372,505,217,288
219204,10,1204,560,644,215,116,99,989,444,545
219240,10,739,451,288,156,79,77,583,372,211
219259,10,3340,1291,2049,1193,516,677,2147,775,1372
219277,10,1451,417,1034,628,191,437,823,226,597
219295,10,577,233,344,382,205,177,195,28,167
219338,10,17,1,16,17,1,16,,,
219347,10,2416,1845,571,1912,1466,446,504,379,125
219356,10,11465,5050,6415,8090,3800,4290,3375,1250,2125
219374,10,604,132,472,237,51,186,367,81,286
219383,10,1625,599,1026,1246,465,781,379,134,245
219392,10,28,7,21,28,7,21,,,
219408,10,140,59,81,80,42,38,60,17,43
219426,10,2381,1083,1298,1280,741,539,1101,342,759
219453,10,131,1,130,131,1,130,,,
219471,10,9464,3429,6035,5864,2226,3638,3600,1203,2397
219480,10,1292,527,765,593,302,291,699,225,474
219505,10,57,36,21,43,26,17,14,10,4
219587,10,79,0,79,79,0,79,,,
219596,10,221,148,73,221,148,73,,,
219602,10,9609,3699,5910,5925,2248,3677,3684,1451,2233
219639,10,935,93,842,348,40,308,587,53,534
219709,10,8696,2965,5731,8019,2677,5342,677,288,389
219718,10,4011,1831,2180,2139,1109,1030,1872,722,1150
219790,10,1550,711,839,762,379,383,788,332,456
219806,10,2835,998,1837,1739,767,972,1096,231,865
219824,10,6575,2425,4150,3162,1268,1894,3413,1157,2256
219833,10,1794,837,957,1530,726,804,264,111,153
219842,10,516,322,194,110,69,41,406,253,153
219851,10,120,3,117,120,3,117,,,
219879,10,3161,1303,1858,1423,676,747,1738,627,1111
219888,10,5383,2031,3352,2988,1260,1728,2395,771,1624
219903,10,1370,100,1270,1370,100,1270,,,
219921,10,380,251,129,182,106,76,198,145,53
219949,10,2540,1039,1501,1885,788,1097,655,251,404
219976,10,4778,1690,3088,4334,1523,2811,444,167,277
219994,10,799,496,303,576,328,248,223,168,55
220002,10,48,3,45,48,3,45,,,
220057,10,2778,830,1948,1186,397,789,1592,433,1159
220075,10,13303,4870,8433,10279,3868,6411,3024,1002,2022
220118,10,216,12,204,216,12,204,,,
220127,10,457,262,195,426,235,191,31,27,4
220163,10,50,1,49,24,0,24,26,1,25
220181,10,942,314,628,897,296,601,45,18,27
220206,10,335,163,172,187,100,87,148,63,85
220215,10,2320,927,1393,1485,668,817,835,259,576
220251,10,525,297,228,235,130,105,290,167,123
220279,10,696,498,198,210,146,64,486,352,134
220321,10,798,437,361,426,213,213,372,224,148
220394,10,257,156,101,198,110,88,59,46,13
220400,10,3938,1181,2757,1723,548,1175,2215,633,1582
220464,10,191,80,111,56,24,32,135,56,79
220473,10,942,466,476,694,323,371,248,143,105
220491,10,273,11,262,199,8,191,74,3,71
220516,10,1656,565,1091,1424,490,934,232,75,157
220552,10,5796,1025,4771,4547,833,3714,1249,192,1057
220598,10,1047,560,487,988,528,460,59,32,27
220604,10,613,215,398,529,184,345,84,31,53
220613,10,4505,1725,2780,3202,1151,2051,1303,574,729
220631,10,5118,1749,3369,4284,1548,2736,834,201,633
220640,10,1602,960,642,307,143,164,1295,817,478
220701,10,876,378,498,728,321,407,148,57,91
220710,10,1046,479,567,963,444,519,83,35,48
220756,10,106,88,18,85,68,17,21,20,1
220765,10,326,74,252,231,44,187,95,30,65
220792,10,964,352,612,964,352,612,,,
220853,10,1118,702,416,678,433,245,440,269,171
220862,10,21622,8471,13151,13397,5409,7988,8225,3062,5163
220871,10,221,98,123,146,60,86,75,38,37
220978,10,21568,9475,12093,15992,7237,8755,5576,2238,3338
220996,10,291,140,151,209,100,109,82,40,42
221050,10,787,597,190,526,394,132,261,203,58
221096,10,5852,2147,3705,2804,1168,1636,3048,979,2069
221102,10,496,349,147,400,266,134,96,83,13
221148,10,1464,1372,92,1464,1372,92,,,
221184,10,6647,2390,4257,2830,1145,1685,3817,1245,2572
221236,10,477,318,159,247,172,75,230,146,84
221281,10,205,104,101,145,72,73,60,32,28
221333,10,561,429,132,201,117,84,360,312,48
221351,10,2073,842,1231,2003,828,1175,70,14,56
221388,10,197,72,125,141,41,100,56,31,25
221397,10,4775,1610,3165,2276,883,1393,2499,727,1772
221430,10,1004,701,303,257,168,89,747,533,214
221485,10,7168,2549,4619,3017,1179,1838,4151,1370,2781
221494,10,472,382,90,366,307,59,106,75,31
221519,10,1820,868,952,1791,855,936,29,13,16
221582,10,335,232,103,147,86,61,188,146,42
221591,10,451,306,145,330,211,119,121,95,26
221607,10,336,253,83,185,123,62,151,130,21
221616,10,1541,1149,392,493,333,160,1048,816,232
221625,10,971,612,359,698,395,303,273,217,56
221643,10,8835,4150,4685,4201,2115,2086,4634,2035,2599
221661,10,2719,1147,1572,2202,969,1233,517,178,339
221670,10,537,178,359,537,178,359,,,
221731,10,1086,376,710,966,331,635,120,45,75
221740,10,11457,4752,6705,9700,3941,5759,1757,811,946
221759,10,31701,14398,17303,27812,12510,15302,3889,1888,2001
221768,10,6712,2523,4189,4549,1778,2771,2163,745,1418
221829,10,329,12,317,329,12,317,,,
221838,10,8077,2842,5235,5631,1943,3688,2446,899,1547
221847,10,9840,5053,4787,7874,4139,3735,1966,914,1052
221892,10,3717,1244,2473,2356,808,1548,1361,436,925
221908,10,5205,2362,2843,2833,1282,1551,2372,1080,1292
221953,10,1494,660,834,1169,536,633,325,124,201
221971,10,2930,972,1958,2160,697,1463,770,275,495
221999,10,13796,6115,7681,12600,5722,6878,1196,393,803
222053,10,7417,2727,4690,3623,1430,2193,3794,1297,2497
222062,10,5379,1879,3500,2691,1030,1661,2688,849,1839
222105,10,340,316,24,153,143,10,187,173,14
222178,10,4912,1730,3182,3442,1245,2197,1470,485,985
222567,10,4973,2017,2956,894,383,511,4079,1634,2445
222576,10,9179,3231,5948,3266,1230,2036,5913,2001,3912
222628,10,1002,280,722,422,124,298,580,156,424
222822,10,4272,1548,2724,1352,494,858,2920,1054,1866
222831,10,10826,4288,6538,5900,2293,3607,4926,1995,2931
222877,10,216,131,85,210,130,80,6,1,5
222886,10,343,30,313,328,29,299,15,1,14
222938,10,386,171,215,243,113,130,143,58,85
222983,10,1228,569,659,1221,567,654,7,2,5
222992,10,35609,14716,20893,7722,3690,4032,27887,11026,16861
223001,10,185,69,116,44,18,26,141,51,90
223056,10,41,2,39,41,2,39,,,
223083,10,508,86,422,127,21,106,381,65,316
223117,10,112,91,21,15,10,5,97,81,16
223223,10,1596,671,925,1587,664,923,9,7,2
223232,10,20626,7924,12702,18501,7294,11207,2125,630,1495
223320,10,3902,1481,2421,897,361,536,3005,1120,1885
223427,10,17420,8688,8732,8388,4357,4031,9032,4331,4701
223463,10,427,132,295,427,132,295,,,
223472,10,220,20,200,220,20,200,,,
223506,10,3916,1818,2098,634,320,314,3282,1498,1784
223816,10,8922,3733,5189,1593,608,985,7329,3125,4204
223852,10,23,1,22,23,1,22,,,
223898,10,3105,1181,1924,1104,431,673,2001,750,1251
223922,10,1372,570,802,571,244,327,801,326,475
224004,10,2137,690,1447,1533,511,1022,604,179,425
224013,10,32,2,30,32,2,30,,,
224110,10,7653,3180,4473,1646,726,920,6007,2454,3553
224147,10,10762,4154,6608,6423,2427,3996,4339,1727,2612
224156,10,383,8,375,374,8,366,9,0,9
224226,10,4340,1855,2485,2841,1206,1635,1499,649,850
224244,10,317,179,138,239,140,99,78,39,39
224271,10,595,157,438,594,156,438,1,1,0
224305,10,2568,1551,1017,965,579,386,1603,972,631
224323,10,2538,1237,1301,1776,832,944,762,405,357
224350,10,10395,4282,6113,1590,704,886,8805,3578,5227
224527,10,1688,798,890,1286,640,646,402,158,244
224545,10,2112,746,1366,1397,539,858,715,207,508
224554,10,11504,4345,7159,6631,2665,3966,4873,1680,3193
224615,10,69171,27460,41711,15147,6547,8600,54024,20913,33111
224642,10,24621,10085,14536,6691,2938,3753,17930,7147,10783
224660,10,581,294,287,447,240,207,134,54,80
224679,10,1303,1122,181,778,655,123,525,467,58
224712,10,140,38,102,58,19,39,82,19,63
224758,10,34,3,31,26,2,24,8,1,7
224776,10,331,151,180,190,90,100,141,61,80
224828,10,59,0,59,42,0,42,17,0,17
224891,10,1586,680,906,679,304,375,907,376,531
224961,10,1870,651,1219,661,281,380,1209,370,839
225070,10,3792,1383,2409,1311,495,816,2481,888,1593
225201,10,923,599,324,923,599,324,,,
225247,10,1933,851,1082,1736,773,963,197,78,119
225308,10,5461,2184,3277,1645,676,969,3816,1508,2308
225371,10,3826,1498,2328,1892,756,1136,1934,742,1192
225399,10,4120,1290,2830,2368,817,1551,1752,473,1279
225414,10,9279,3320,5959,4309,1562,2747,4970,1758,3212
225423,10,46780,18363,28417,13236,5701,7535,33544,12662,20882
225432,10,15077,5531,9546,6686,2504,4182,8391,3027,5364
225502,10,4189,1391,2798,1695,585,1110,2494,806,1688
225511,10,47031,22646,24385,33368,15749,17619,13663,6897,6766
225520,10,4050,1561,2489,1027,363,664,3023,1198,1825
225548,10,931,488,443,720,379,341,211,109,102
225575,10,1001,401,600,921,371,550,80,30,50
225627,10,7508,2885,4623,6170,2294,3876,1338,591,747
225876,10,477,205,272,211,115,96,266,90,176
225885,10,721,324,397,615,289,326,106,35,71
225991,10,117,70,47,117,70,47,,,
226019,10,5120,2058,3062,2020,916,1104,3100,1142,1958
226091,10,16320,5436,10884,5351,2283,3068,10969,3153,7816
226107,10,2353,728,1625,806,257,549,1547,471,1076
226116,10,2361,853,1508,788,292,496,1573,561,1012
226125,10,124,11,113,124,11,113,,,
226134,10,9984,4265,5719,2316,958,1358,7668,3307,4361
226152,10,8455,3232,5223,5691,2180,3511,2764,1052,1712
226204,10,7159,3650,3509,1015,542,473,6144,3108,3036
226231,10,3209,1663,1546,1438,916,522,1771,747,1024
226277,10,1387,1285,102,1387,1285,102,,,
226383,10,1661,562,1099,1209,430,779,452,132,320
226408,10,4133,1576,2557,1118,446,672,3015,1130,1885
226471,10,3732,1284,2448,3327,1144,2183,405,140,265
226578,10,7337,2341,4996,2134,735,1399,5203,1606,3597
226587,10,1145,581,564,999,520,479,146,61,85
226675,10,377,49,328,377,49,328,,,
226806,10,5016,1955,3061,1409,548,861,3607,1407,2200
226833,10,5797,2050,3747,3919,1452,2467,1878,598,1280
226860,10,56,2,54,56,2,54,,,
226879,10,216,34,182,109,14,95,107,20,87
226903,10,1013,463,550,1013,463,550,,,
227058,10,88,0,88,88,0,88,,,
227146,10,6565,2493,4072,2341,986,1355,4224,1507,2717
227182,10,68653,27200,41453,19610,8446,11164,49043,18754,30289
227216,10,42441,19231,23210,30336,13897,16439,12105,5334,6771
227225,10,2823,1052,1771,1285,443,842,1538,609,929
227289,10,184,124,60,103,83,20,81,41,40
227298,10,174,166,8,174,166,8,,,
227304,10,7947,3157,4790,2763,1044,1719,5184,2113,3071
227313,10,284,3,281,134,2,132,150,1,149
227322,10,338,7,331,186,4,182,152,3,149
227331,10,2550,641,1909,2231,570,1661,319,71,248
227368,10,31940,12709,19231,21522,8508,13014,10418,4201,6217
227377,10,7527,3074,4453,1829,852,977,5698,2222,3476
227386,10,2469,833,1636,960,348,612,1509,485,1024
227401,10,4365,1630,2735,1466,588,878,2899,1042,1857
227429,10,384,166,218,329,142,187,55,24,31
227526,10,9400,3069,6331,8098,2615,5483,1302,454,848
227687,10,2249,1009,1240,763,373,390,1486,636,850
227748,10,244,220,24,191,176,15,53,44,9
227757,10,8285,4767,3518,7848,4503,3345,437,264,173
227845,10,3577,1268,2309,2847,1048,1799,730,220,510
227854,10,12455,5048,7407,1605,709,896,10850,4339,6511
227863,10,3877,1528,2349,2617,961,1656,1260,567,693
227881,10,21612,7676,13936,15259,5492,9767,6353,2184,4169
227924,10,17677,6462,11215,3347,1251,2096,14330,5211,9119
227979,10,31577,12666,18911,8268,3521,4747,23309,9145,14164
228042,10,1103,479,624,973,451,522,130,28,102
228088,10,18,0,18,18,0,18,,,
228149,10,3432,1439,1993,2914,1209,1705,518,230,288
228158,10,8930,3574,5356,3967,1772,2195,4963,1802,3161
228185,10,14,12,2,14,12,2,,,
228194,10,984,468,516,793,379,414,191,89,102
228200,10,332,163,169,306,161,145,26,2,24
228219,10,444,124,320,423,118,305,21,6,15
228246,10,12385,6358,6027,9366,4726,4640,3019,1632,1387
228282,10,19,4,15,19,4,15,,,
228316,10,5875,2347,3528,1278,498,780,4597,1849,2748
228325,10,1843,885,958,1329,649,680,514,236,278
228343,10,1504,697,807,1480,685,795,24,12,12
228431,10,12000,4276,7724,8993,3216,5777,3007,1060,1947
228459,10,37864,15011,22853,29222,11349,17873,8642,3662,4980
228468,10,855,340,515,642,250,392,213,90,123
228486,10,92,57,35,81,50,31,11,7,4
228501,10,2100,786,1314,1080,507,573,1020,279,741
228529,10,13995,4973,9022,9163,3239,5924,4832,1734,3098
228547,10,36264,14506,21758,5857,2771,3086,30407,11735,18672
228608,10,4396,1406,2990,1484,483,1001,2912,923,1989
228635,10,2308,1062,1246,1735,742,993,573,320,253
228644,10,3499,1268,2231,3030,1105,1925,469,163,306
228653,10,3484,990,2494,2190,739,1451,1294,251,1043
228699,10,3575,1356,2219,1057,398,659,2518,958,1560
228705,10,6405,3148,3257,4623,2342,2281,1782,806,976
228723,10,72530,38300,34230,62587,32737,29850,9943,5563,4380
228769,10,45949,16972,28977,23732,10736,12996,22217,6236,15981
228778,10,51991,23245,28746,48771,21666,27105,3220,1579,1641
228787,10,29696,16732,12964,23719,13343,10376,5977,3389,2588
228796,10,24003,10531,13472,14826,6595,8231,9177,3936,5241
228802,10,9687,3523,6164,5561,2176,3385,4126,1347,2779
228866,10,259,130,129,257,130,127,2,0,2
228875,10,11938,4754,7184,11621,4605,7016,317,149,168
228884,10,731,430,301,671,400,271,60,30,30
228909,10,2472,872,1600,2286,826,1460,186,46,140
228981,10,1468,657,811,1392,628,764,76,29,47
229018,10,5534,2251,3283,2823,1198,1625,2711,1053,1658
229027,10,34734,16421,18313,24298,11291,13007,10436,5130,5306
229063,10,7524,2710,4814,6190,2220,3970,1334,490,844
229115,10,40542,20191,20351,33465,16936,16529,7077,3255,3822
229160,10,2531,1054,1477,1787,806,981,744,248,496
229179,10,16338,1838,14500,9009,811,8198,7329,1027,6302
229267,10,2704,1265,1439,2602,1220,1382,102,45,57
229300,10,5796,1662,4134,3642,1184,2458,2154,478,1676
229337,10,5378,1297,4081,3796,994,2802,1582,303,1279
229355,10,11913,4351,7562,5290,2098,3192,6623,2253,4370
229416,10,1868,1767,101,1868,1767,101,,,
229425,10,155,2,153,48,1,47,107,1,106
229504,10,2358,779,1579,622,240,382,1736,539,1197
229522,10,97,15,82,50,5,45,47,10,37
229540,10,3210,1041,2169,713,311,402,2497,730,1767
229656,10,264,6,258,228,3,225,36,3,33
229780,10,3508,1602,1906,1721,811,910,1787,791,996
229799,10,5421,1859,3562,1548,575,973,3873,1284,2589
229814,10,9602,3926,5676,5919,2335,3584,3683,1591,2092
229832,10,1430,686,744,484,237,247,946,449,497
229841,10,5479,2276,3203,2308,1068,1240,3171,1208,1963
229887,10,665,311,354,584,277,307,81,34,47
230010,10,1704,927,777,528,248,280,1176,679,497
230038,10,34811,17125,17686,30307,14846,15461,4504,2279,2225
230047,10,2893,1078,1815,2728,1016,1712,165,62,103
230056,10,240,94,146,108,15,93,132,79,53
230065,10,287,4,283,76,1,75,211,3,208
230144,10,28,0,28,28,0,28,,,
230162,10,3778,2373,1405,442,177,265,3336,2196,1140
230171,10,12266,5140,7126,7236,2916,4320,5030,2224,2806
230199,10,61,10,51,61,10,51,,,
230205,10,71,8,63,63,6,57,8,2,6
230214,10,311,42,269,114,8,106,197,34,163
230366,10,334,47,287,334,47,287,,,
230418,10,2663,1297,1366,1122,594,528,1541,703,838
230490,10,2773,1620,1153,404,144,260,2369,1476,893
230597,10,6106,2831,3275,3520,1683,1837,2586,1148,1438
230603,10,13611,5593,8018,8613,3671,4942,4998,1922,3076
230676,10,1155,803,352,90,50,40,1065,753,312
230728,10,27426,12136,15290,17692,8141,9551,9734,3995,5739
230737,10,41262,20956,20306,18875,9753,9122,22387,11203,11184
230746,10,27225,12386,14839,6126,2870,3256,21099,9516,11583
230764,10,34464,17701,16763,27279,13922,13357,7185,3779,3406
230782,10,29774,13053,16721,12045,5268,6777,17729,7785,9944
230807,10,1535,546,989,1421,499,922,114,47,67
230816,10,884,297,587,812,254,558,72,43,29
230834,10,2369,911,1458,1506,700,806,863,211,652
230852,10,3825,2243,1582,2255,1409,846,1570,834,736
230861,10,5541,1582,3959,805,282,523,4736,1300,3436
230889,10,369,109,260,341,103,238,28,6,22
230913,10,1746,636,1110,1000,432,568,746,204,542
230959,10,2937,1334,1603,2835,1319,1516,102,15,87
230995,10,3672,2618,1054,3085,2105,980,587,513,74
231004,10,45,5,40,45,5,40,,,
231059,10,1573,704,869,1438,664,774,135,40,95
231068,10,473,119,354,336,84,252,137,35,102
231095,10,126,60,66,101,48,53,25,12,13
231147,10,655,231,424,574,206,368,81,25,56
231165,10,1452,708,744,758,410,348,694,298,396
231174,10,13826,5233,8593,12540,4732,7808,1286,501,785
231280,10,107,1,106,90,0,90,17,1,16
231411,10,466,424,42,466,424,42,,,
231420,10,1336,656,680,1030,548,482,306,108,198
231536,10,3386,1300,2086,956,428,528,2430,872,1558
231554,10,948,434,514,797,389,408,151,45,106
231581,10,1463,673,790,1449,665,784,14,8,6
231624,10,9517,3990,5527,8206,3471,4735,1311,519,792
231651,10,10330,3690,6640,4406,1628,2778,5924,2062,3862
231688,10,20,1,19,11,0,11,9,1,8
231697,10,3464,1445,2019,1061,443,618,2403,1002,1401
231712,10,4584,2081,2503,4478,2018,2460,106,63,43
231721,10,12,1,11,,,,12,1,11
231785,10,1245,223,1022,735,181,554,510,42,468
231873,10,1069,410,659,354,141,213,715,269,446
231882,10,2330,977,1353,875,435,440,1455,542,913
231970,10,1301,487,814,1128,440,688,173,47,126
232016,10,113,30,83,66,22,44,47,8,39
232025,10,1372,620,752,1334,601,733,38,19,19
232043,10,1342,468,874,907,363,544,435,105,330
232052,10,637,253,384,178,76,102,459,177,282
232089,10,869,513,356,846,507,339,23,6,17
232186,10,38628,18322,20306,25916,12641,13275,12712,5681,7031
232195,10,7496,2765,4731,2134,893,1241,5362,1872,3490
232256,10,851,847,4,842,838,4,9,9,0
232265,10,3317,1090,2227,3078,1008,2070,239,82,157
232308,10,855,41,814,746,10,736,109,31,78
232414,10,7252,2760,4492,2270,938,1332,4982,1822,3160
232423,10,22166,9098,13068,19838,8133,11705,2328,965,1363
232450,10,8558,3527,5031,1985,867,1118,6573,2660,3913
232557,10,95148,38896,56252,53203,21391,31812,41945,17505,24440
232566,10,4612,1408,3204,3274,978,2296,1338,430,908
232575,10,5862,2182,3680,1713,717,996,4149,1465,2684
232609,10,2553,940,1613,2047,780,1267,506,160,346
232618,10,304,24,280,34,0,34,270,24,246
232672,10,2142,435,1707,1621,349,1272,521,86,435
232681,10,3956,1386,2570,3234,1125,2109,722,261,461
232706,10,3555,1362,2193,2359,791,1568,1196,571,625
232724,10,19,0,19,19,0,19,,,
232788,10,2079,776,1303,899,341,558,1180,435,745
232797,10,997,192,805,332,89,243,665,103,562
232867,10,3903,1906,1997,1482,729,753,2421,1177,1244
232885,10,356,32,324,276,29,247,80,3,77
232919,10,466,400,66,376,322,54,90,78,12
232937,10,5458,1784,3674,4827,1580,3247,631,204,427
232946,10,49560,23163,26397,13939,7157,6782,35621,16006,19615
232982,10,23494,10105,13389,15626,6756,8870,7868,3349,4519
233019,10,1906,782,1124,961,416,545,945,366,579
233037,10,1239,441,798,313,148,165,926,293,633
233082,10,107,10,97,6,0,6,101,10,91
233116,10,4997,2073,2924,1030,512,518,3967,1561,2406
233277,10,8998,2919,6079,6746,2473,4273,2252,446,1806
233286,10,146,17,129,98,8,90,48,9,39
233295,10,1501,682,819,1459,657,802,42,25,17
233301,10,550,200,350,535,191,344,15,9,6
233310,10,2588,879,1709,599,227,372,1989,652,1337
233329,10,441,30,411,441,30,411,,,
233338,10,2670,1084,1586,1209,450,759,1461,634,827
233356,10,427,26,401,343,25,318,84,1,83
233374,10,3890,1762,2128,3510,1621,1889,380,141,239
233408,10,322,33,289,273,29,244,49,4,45
233426,10,1863,854,1009,1817,829,988,46,25,21
233480,10,33,7,26,33,7,26,,,
233541,10,4287,1340,2947,2953,1043,1910,1334,297,1037
233602,10,61,35,26,58,32,26,3,3,0
233611,10,1170,604,566,1018,518,500,152,86,66
233639,10,2961,951,2010,940,279,661,2021,672,1349
233648,10,2135,767,1368,1029,403,626,1106,364,742
233666,10,44,1,43,31,1,30,13,0,13
233684,10,3223,1080,2143,613,348,265,2610,732,1878
233718,10,454,0,454,450,0,450,4,0,4
233754,10,5832,2293,3539,1693,749,944,4139,1544,2595
233772,10,16797,6526,10271,5337,2203,3134,11460,4323,7137
233842,10,181,64,117,98,39,59,83,25,58
233897,10,1814,700,1114,1074,507,567,740,193,547
233903,10,2451,917,1534,955,414,541,1496,503,993
233921,10,37279,21299,15980,34448,19555,14893,2831,1744,1087
233949,10,5625,2365,3260,1633,672,961,3992,1693,2299
234030,10,28594,10330,18264,23539,8433,15106,5055,1897,3158
234076,10,26005,11650,14355,23247,10612,12635,2758,1038,1720
234085,10,1652,1424,228,1652,1424,228,,,
234119,10,34,13,21,19,8,11,15,5,10
234137,10,558,324,234,509,290,219,49,34,15
234155,10,4300,1684,2616,3911,1539,2372,389,145,244
234164,10,1730,881,849,1434,727,707,296,154,142
234173,10,1324,521,803,1128,447,681,196,74,122
234207,10,2238,1091,1147,2232,1089,1143,6,2,4
234377,10,2089,716,1373,726,254,472,1363,462,901
234669,10,11546,4994,6552,6038,2775,3263,5508,2219,3289
234696,10,1915,972,943,1096,632,464,819,340,479
234711,10,1778,759,1019,1262,529,733,516,230,286
234827,10,10176,4724,5452,8611,4024,4587,1565,700,865
234845,10,2153,822,1331,1167,466,701,986,356,630
234915,10,1996,784,1212,204,87,117,1792,697,1095
234924,10,286,30,256,286,30,256,,,
234933,10,6921,2734,4187,3676,1516,2160,3245,1218,2027
234951,10,2846,1095,1751,1841,879,962,1005,216,789
234979,10,6089,2717,3372,3274,1295,1979,2815,1422,1393
235024,10,455,145,310,416,136,280,39,9,30
235088,10,247,233,14,247,233,14,,,
235097,10,10892,4317,6575,9195,3646,5549,1697,671,1026
235103,10,5606,2411,3195,2474,1207,1267,3132,1204,1928
235149,10,6682,2788,3894,3582,1521,2061,3100,1267,1833
235158,10,92,20,72,92,20,72,,,
235167,10,2116,806,1310,1799,700,1099,317,106,211
235237,10,7363,2631,4732,4372,1564,2808,2991,1067,1924
235307,10,105,6,99,105,6,99,,,
235316,10,7381,3100,4281,6720,2870,3850,661,230,431
235334,10,1469,694,775,954,423,531,515,271,244
235343,10,6559,3165,3394,3969,1960,2009,2590,1205,1385
235352,10,110,24,86,110,24,86,,,
235422,10,898,224,674,740,170,570,158,54,104
235431,10,4951,1854,3097,2644,1012,1632,2307,842,1465
235501,10,158,92,66,158,92,66,,,
235547,10,751,114,637,612,90,522,139,24,115
235583,10,101,3,98,101,3,98,,,
235671,10,4106,2495,1611,1795,1152,643,2311,1343,968
235699,10,3240,1338,1902,1553,736,817,1687,602,1085
235750,10,2164,648,1516,1227,387,840,937,261,676
236018,10,39,4,35,39,4,35,,,
236072,10,4887,1916,2971,1405,689,716,3482,1227,2255
236133,10,1083,378,705,979,335,644,104,43,61
236188,10,4999,2116,2883,3069,1347,1722,1930,769,1161
236212,10,867,717,150,867,717,150,,,
236230,10,2706,952,1754,2507,872,1635,199,80,119
236258,10,1702,606,1096,826,287,539,876,319,557
236328,10,2173,860,1313,2084,845,1239,89,15,74
236382,10,3097,2054,1043,1075,511,564,2022,1543,479
236452,10,1616,647,969,1312,512,800,304,135,169
236504,10,4893,3486,1407,1299,784,515,3594,2702,892
236513,10,4698,1889,2809,2792,1176,1616,1906,713,1193
236577,10,3443,1076,2367,2840,875,1965,603,201,402
236595,10,7268,2668,4600,5803,2106,3697,1465,562,903
236610,10,4843,1870,2973,2180,994,1186,2663,876,1787
236638,10,3891,1698,2193,2018,858,1160,1873,840,1033
236656,10,4215,1650,2565,2422,1019,1403,1793,631,1162
236692,10,6890,2790,4100,3523,1511,2012,3367,1279,2088
236708,10,3805,1540,2265,2627,1090,1537,1178,450,728
236744,10,36,2,34,36,2,34,,,
236753,10,5359,1882,3477,3176,1188,1988,2183,694,1489
236887,10,3084,1520,1564,1763,865,898,1321,655,666
236896,10,1584,757,827,1396,658,738,188,99,89
236939,10,29843,13634,16209,24858,11375,13483,4985,2259,2726
236948,10,52434,22626,29808,42729,18313,24416,9705,4313,5392
236975,10,2661,959,1702,1831,704,1127,830,255,575
237011,10,15125,6376,8749,13261,5481,7780,1864,895,969
237039,10,3850,1627,2223,1891,828,1063,1959,799,1160
237057,10,1559,684,875,1524,665,859,35,19,16
237066,10,2681,1073,1608,2405,980,1425,276,93,183
237109,10,3643,976,2667,2438,663,1775,1205,313,892
237118,10,828,477,351,746,453,293,82,24,58
237127,10,51,2,49,51,2,49,,,
237136,10,199,99,100,136,60,76,63,39,24
237145,10,26,3,23,26,3,23,,,
237172,10,39,31,8,39,31,8,,,
237181,10,559,296,263,552,295,257,7,1,6
237215,10,1358,541,817,996,424,572,362,117,245
237242,10,80,53,27,76,50,26,4,3,1
237303,10,52,19,33,52,19,33,,,
237312,10,2926,1710,1216,1713,839,874,1213,871,342
237321,10,47,4,43,47,4,43,,,
237330,10,1749,673,1076,1424,573,851,325,100,225
237358,10,661,270,391,653,269,384,8,1,7
237367,10,3562,1425,2137,2573,1094,1479,989,331,658
237385,10,1557,845,712,995,536,459,562,309,253
237437,10,151,27,124,135,26,109,16,1,15
237473,10,151,106,45,151,106,45,,,
237491,10,19,3,16,19,3,16,,,
237525,10,11023,4353,6670,8450,3423,5027,2573,930,1643
237543,10,104,31,73,69,15,54,35,16,19
237561,10,69,22,47,69,22,47,,,
237570,10,76,2,74,76,2,74,,,
237598,10,20,1,19,20,1,19,,,
237686,10,2258,826,1432,983,381,602,1275,445,830
237701,10,1174,554,620,883,421,462,291,133,158
237729,10,140,39,101,82,13,69,58,26,32
237783,10,991,462,529,897,410,487,94,52,42
237792,10,3015,1095,1920,2185,862,1323,830,233,597
237817,10,1439,454,985,926,293,633,513,161,352
237844,10,100,56,44,100,56,44,,,
237880,10,806,411,395,806,411,395,,,
237899,10,3415,1432,1983,1392,641,751,2023,791,1232
237905,10,62,12,50,62,12,50,,,
237932,10,2291,859,1432,1921,723,1198,370,136,234
237950,10,1619,819,800,1038,599,439,581,220,361
237969,10,1054,473,581,1035,468,567,19,5,14
237987,10,211,30,181,211,30,181,,,
237996,10,558,88,470,558,88,470,,,
238005,10,83,6,77,83,6,77,,,
238014,10,1099,395,704,483,200,283,616,195,421
238032,10,25476,11999,13477,22286,10639,11647,3190,1360,1830
238078,10,700,415,285,511,332,179,189,83,106
238096,10,16,1,15,16,1,15,,,
238175,10,124,2,122,124,2,122,,,
238193,10,1822,126,1696,1354,82,1272,468,44,424
238263,10,12152,5194,6958,3048,1500,1548,9104,3694,5410
238324,10,697,140,557,273,29,244,424,111,313
238333,10,1011,480,531,978,466,512,33,14,19
238397,10,2424,821,1603,576,241,335,1848,580,1268
238430,10,1365,410,955,583,209,374,782,201,581
238458,10,3397,1058,2339,3085,931,2154,312,127,185
238476,10,2746,1201,1545,2612,1141,1471,134,60,74
238616,10,5204,1691,3513,3402,1228,2174,1802,463,1339
238661,10,1894,554,1340,1473,419,1054,421,135,286
238722,10,11664,6428,5236,1756,1000,756,9908,5428,4480
238759,10,9311,4493,4818,1184,565,619,8127,3928,4199
238810,10,66,4,62,42,1,41,24,3,21
238980,10,2094,825,1269,858,389,469,1236,436,800
239008,10,2322,1139,1183,483,245,238,1839,894,945
239017,10,1483,679,804,1463,668,795,20,11,9
239071,10,1066,495,571,510,214,296,556,281,275
239080,10,1445,439,1006,1026,353,673,419,86,333
239105,10,11320,4779,6541,9978,4222,5756,1342,557,785
239169,10,1538,643,895,1460,623,837,78,20,58
239220,10,3006,1413,1593,612,352,260,2394,1061,1333
239248,10,11828,4936,6892,3197,1585,1612,8631,3351,5280
239309,10,898,223,675,881,218,663,17,5,12
239318,10,2746,1968,778,2566,1845,721,180,123,57
239372,10,3269,1322,1947,879,424,455,2390,898,1492
239390,10,1273,50,1223,1072,32,1040,201,18,183
239424,10,134,111,23,91,76,15,43,35,8
239442,10,1224,406,818,221,78,143,1003,328,675
239460,10,6084,2473,3611,1124,490,634,4960,1983,2977
239488,10,10088,4149,5939,2210,1106,1104,7878,3043,4835
239512,10,531,249,282,516,241,275,15,8,7
239628,10,810,407,403,794,400,394,16,7,9
239637,10,111,101,10,89,89,0,22,12,10
239716,10,2009,844,1165,1913,793,1120,96,51,45
239877,10,45,1,44,43,1,42,2,0,2
239910,10,2520,988,1532,701,305,396,1819,683,1136
240107,10,2520,618,1902,1874,454,1420,646,164,482
240116,10,6998,3002,3996,2031,992,1039,4967,2010,2957
240125,10,7357,3827,3530,1503,825,678,5854,3002,2852
240170,10,3963,1792,2171,1557,817,740,2406,975,1431
240189,10,11446,5754,5692,8989,4604,4385,2457,1150,1307
240198,10,2656,985,1671,897,425,472,1759,560,1199
240213,10,75,10,65,34,3,31,41,7,34
240268,10,10569,4127,6442,9088,3512,5576,1481,615,866
240277,10,9780,3181,6599,5118,1901,3217,4662,1280,3382
240329,10,10337,4304,6033,9212,3806,5406,1125,498,627
240338,10,1147,475,672,941,398,543,206,77,129
240365,10,14142,5598,8544,7531,3013,4518,6611,2585,4026
240374,10,4132,1828,2304,2756,1198,1558,1376,630,746
240392,10,2939,442,2497,1814,307,1507,1125,135,990
240417,10,7695,4139,3556,5621,3185,2436,2074,954,1120
240426,10,2613,875,1738,1716,630,1086,897,245,652
240444,10,47016,22205,24811,42333,19958,22375,4683,2247,2436
240453,10,23829,10428,13401,18442,8146,10296,5387,2282,3105
240462,10,6773,4238,2535,5517,3490,2027,1256,748,508
240471,10,5394,1811,3583,4460,1487,2973,934,324,610
240480,10,8129,3411,4718,6574,2892,3682,1555,519,1036
240505,10,3405,1411,1994,1517,606,911,1888,805,1083
240514,10,1770,785,985,586,238,348,1184,547,637
240596,10,1367,601,766,456,196,260,911,405,506
240620,10,3883,1519,2364,1343,522,821,2540,997,1543
240657,10,1427,573,854,652,277,375,775,296,479
240666,10,3921,2040,1881,1217,508,709,2704,1532,1172
240693,10,2453,1022,1431,886,399,487,1567,623,944
240709,10,43,4,39,34,4,30,9,0,9
240718,10,742,704,38,742,704,38,,,
240727,10,11479,5329,6150,8986,4343,4643,2493,986,1507
240736,10,1301,427,874,595,196,399,706,231,475
240745,10,1635,740,895,689,297,392,946,443,503
240754,10,3105,1282,1823,2215,900,1315,890,382,508
240790,10,1298,511,787,1016,409,607,282,102,180
240879,10,220,56,164,220,56,164,,,
241100,10,259,126,133,219,105,114,40,21,19
241128,10,287,117,170,244,100,144,43,17,26
241146,10,215,48,167,211,46,165,4,2,2
241182,10,428,93,335,428,93,335,,,
241191,10,932,361,571,778,299,479,154,62,92
241216,10,1591,1006,585,1043,643,400,548,363,185
241225,10,953,289,664,645,192,453,308,97,211
241304,10,2452,606,1846,1509,367,1142,943,239,704
241331,10,2380,342,2038,1945,298,1647,435,44,391
241377,10,849,319,530,495,197,298,354,122,232
241386,10,143,32,111,82,20,62,61,12,49
241395,10,737,195,542,485,137,348,252,58,194
241410,10,6175,2078,4097,4842,1640,3202,1333,438,895
241517,10,236,62,174,186,46,140,50,16,34
241614,10,418,223,195,211,126,85,207,97,110
241720,10,675,258,417,496,189,307,179,69,110
241739,10,7721,2355,5366,4777,1497,3280,2944,858,2086
241766,10,346,235,111,215,146,69,131,89,42
241793,10,395,202,193,273,133,140,122,69,53
241836,10,954,307,647,424,148,276,530,159,371
241906,10,200,59,141,200,59,141,,,
241951,10,485,134,351,336,94,242,149,40,109
242042,10,283,157,126,273,154,119,10,3,7
242112,10,505,240,265,390,200,190,115,40,75
242121,10,282,99,183,170,55,115,112,44,68
242130,10,275,79,196,202,60,142,73,19,54
242149,10,355,94,261,278,72,206,77,22,55
242413,10,66,0,66,66,0,66,,,
242556,10,244,164,80,212,142,70,32,22,10
242565,10,199,145,54,199,145,54,,,
242583,10,216,156,60,200,145,55,16,11,5
242617,10,3299,1382,1917,2655,1123,1532,644,259,385
242626,10,3275,1293,1982,2618,1009,1609,657,284,373
242635,10,3069,1096,1973,2510,929,1581,559,167,392
242644,10,1216,414,802,998,335,663,218,79,139
242653,10,5774,2189,3585,4242,1606,2636,1532,583,949
242662,10,3448,1228,2220,2558,908,1650,890,320,570
242680,10,1424,551,873,1145,434,711,279,117,162
242699,10,1632,513,1119,1317,421,896,315,92,223
242705,10,3892,2126,1766,3288,1787,1501,604,339,265
242723,10,696,261,435,335,130,205,361,131,230
242750,10,90,29,61,90,29,61,,,
242820,10,948,724,224,948,724,224,,,
242945,10,138,40,98,109,31,78,29,9,20
242954,10,73,22,51,60,17,43,13,5,8
242972,10,24784,8568,16216,16619,5790,10829,8165,2778,5387
243081,10,783,308,475,774,306,468,9,2,7
243106,10,2199,936,1263,1977,841,1136,222,95,127
243115,10,3117,1150,1967,2838,1044,1794,279,106,173
243133,10,3326,1667,1659,2878,1459,1419,448,208,240
243142,10,2367,849,1518,1804,633,1171,563,216,347
243151,10,2559,822,1737,2275,732,1543,284,90,194
243179,10,2848,952,1896,2572,859,1713,276,93,183
243188,10,457,215,242,414,196,218,43,19,24
243197,10,12126,6640,5486,10896,5912,4984,1230,728,502
243203,10,2164,710,1454,2062,680,1382,102,30,72
243212,10,2262,978,1284,2062,894,1168,200,84,116
243221,10,13226,4784,8442,11198,4040,7158,2028,744,1284
243346,10,6604,2228,4376,4397,1447,2950,2207,781,1426
243443,10,4110,1437,2673,3065,1049,2016,1045,388,657
243498,10,133,84,49,65,37,28,68,47,21
243568,10,459,186,273,441,182,259,18,4,14
243577,10,4252,3069,1183,2021,1399,622,2231,1670,561
243586,10,785,252,533,641,205,436,144,47,97
243601,10,11100,4280,6820,7819,2887,4932,3281,1393,1888
243638,10,1946,803,1143,1353,548,805,593,255,338
243647,10,525,239,286,321,154,167,204,85,119
243665,10,1624,435,1189,946,262,684,678,173,505
243744,10,17680,9445,8235,16605,8713,7892,1075,732,343
243780,10,50344,29057,21287,42732,24730,18002,7612,4327,3285
243799,10,56,5,51,56,5,51,,,
243823,10,1954,868,1086,1732,786,946,222,82,140
243832,10,1365,416,949,559,185,374,806,231,575
243841,10,463,85,378,377,71,306,86,14,72
244233,10,85,18,67,17,4,13,68,14,54
244279,10,194,5,189,194,5,189,,,
244437,10,15353,5656,9697,5426,2223,3203,9927,3433,6494
244446,10,2577,883,1694,560,223,337,2017,660,1357
244613,10,406,394,12,253,246,7,153,148,5
245281,10,74,36,38,74,36,38,,,
245625,10,3303,1449,1854,563,232,331,2740,1217,1523
245652,10,449,238,211,412,218,194,37,20,17
245777,10,88,88,0,88,88,0,,,
245838,10,815,215,600,664,161,503,151,54,97
245847,10,249,52,197,203,43,160,46,9,37
245865,10,1035,179,856,727,136,591,308,43,265
245883,10,779,126,653,496,86,410,283,40,243
245892,10,477,110,367,332,74,258,145,36,109
245953,10,2237,768,1469,1666,546,1120,571,222,349
245962,10,136,10,126,125,8,117,11,2,9
245980,10,29,11,18,29,11,18,,,
245999,10,2224,1121,1103,286,126,160,1938,995,943
246017,10,1122,635,487,198,120,78,924,515,409
246035,10,350,51,299,350,51,299,,,
246071,10,69,9,60,69,9,60,,,
246345,10,59,22,37,16,7,9,43,15,28
246354,10,10559,4026,6533,1837,655,1182,8722,3371,5351
246406,10,21,3,18,21,3,18,,,
246415,10,60,8,52,14,1,13,46,7,39
246460,10,156,16,140,156,16,140,,,
246789,10,129,75,54,35,20,15,94,55,39
246813,10,3943,1366,2577,753,305,448,3190,1061,2129
246895,10,661,229,432,340,137,203,321,92,229
246974,10,317,32,285,317,32,285,,,
247010,10,26,0,26,26,0,26,,,
247047,10,91,0,91,91,0,91,,,
247065,10,753,38,715,430,23,407,323,15,308
247153,10,241,56,185,241,56,185,,,
247162,10,43,18,25,2,1,1,41,17,24
247409,10,67,3,64,67,3,64,,,
247603,10,2162,1135,1027,1255,709,546,907,426,481
247649,10,619,385,234,364,247,117,255,138,117
247773,10,58,58,0,57,57,0,1,1,0
247825,10,11,10,1,6,6,0,5,4,1
247834,10,33686,14762,18924,10747,5456,5291,22939,9306,13633
247940,10,4111,1808,2303,1454,648,806,2657,1160,1497
248192,10,24,0,24,24,0,24,,,
248527,10,70,0,70,70,0,70,,,
248606,10,1527,986,541,116,35,81,1411,951,460
248624,10,102,18,84,102,18,84,,,
248633,10,57,0,57,57,0,57,,,
248660,10,142,43,99,123,42,81,19,1,18
248703,10,187,3,184,121,2,119,66,1,65
248925,10,782,475,307,581,322,259,201,153,48
248934,10,12466,4895,7571,12349,4846,7503,117,49,68
249061,10,49,0,49,23,0,23,26,0,26
249238,10,364,23,341,243,14,229,121,9,112
249609,10,172,107,65,172,107,65,,,
250027,10,285,94,191,276,93,183,9,1,8
250285,10,317,290,27,233,215,18,84,75,9
250744,10,428,49,379,428,49,379,,,
250902,10,82,10,72,42,5,37,40,5,35
250993,10,493,261,232,56,21,35,437,240,197
251260,10,4069,1776,2293,2145,1056,1089,1924,720,1204
251312,10,625,106,519,388,71,317,237,35,202
260336,10,14,0,14,14,0,14,,,
260363,10,19,2,17,19,2,17,,,
260372,10,306,58,248,110,19,91,196,39,157
260664,10,283,214,69,283,214,69,,,
260691,10,820,240,580,820,240,580,,,
260789,10,670,121,549,670,121,549,,,
260813,10,222,23,199,222,23,199,,,
260929,10,202,22,180,200,22,178,2,0,2
260965,10,78,0,78,78,0,78,,,
260992,10,474,23,451,122,7,115,352,16,336
261436,10,889,57,832,889,57,832,,,
261676,10,29,1,28,29,1,28,,,
261685,10,33,2,31,33,2,31,,,
261719,10,165,2,163,165,2,163,,,
261773,10,39,9,30,37,7,30,2,2,0
261861,10,54,2,52,54,2,52,,,
262022,10,7,0,7,,,,7,0,7
262031,10,5705,2251,3454,3112,1355,1757,2593,896,1697
262086,10,9798,2881,6917,4015,1209,2806,5783,1672,4111
262129,10,659,223,436,642,216,426,17,7,10
262341,10,450,396,54,450,396,54,,,
262369,10,72,2,70,72,2,70,,,
262457,10,437,70,367,437,70,367,,,
262466,10,54,19,35,54,19,35,,,
362700,10,425,37,388,418,36,382,7,1,6
362782,10,267,7,260,82,3,79,185,4,181
363013,10,36,2,34,36,2,34,,,
363077,10,242,56,186,126,7,119,116,49,67
363147,10,429,13,416,429,13,416,,,
363165,10,2030,1046,984,1058,553,505,972,493,479
363439,10,17,1,16,17,1,16,,,
363633,10,821,297,524,279,113,166,542,184,358
363679,10,206,3,203,171,3,168,35,0,35
363712,10,52,52,0,52,52,0,,,
363882,10,98,1,97,98,1,97,,,
363907,10,480,261,219,259,154,105,221,107,114
363916,10,134,35,99,84,22,62,50,13,37
363934,10,858,687,171,449,365,84,409,322,87
364016,10,5965,2620,3345,1731,910,821,4234,1710,2524
364025,10,13498,6365,7133,3473,1742,1731,10025,4623,5402
364548,10,194,93,101,137,53,84,57,40,17
364575,10,30,1,29,30,1,29,,,
364627,10,392,198,194,51,15,36,341,183,158
364636,10,167,48,119,143,47,96,24,1,23
364751,10,26,1,25,26,1,25,,,
364760,10,73,6,67,36,3,33,37,3,34
364946,10,325,159,166,91,23,68,234,136,98
364964,10,35,1,34,35,1,34,,,
365091,10,363,21,342,363,21,342,,,
365125,10,157,4,153,157,4,153,,,
365198,10,633,347,286,78,5,73,555,342,213
365213,10,727,316,411,152,46,106,575,270,305
365240,10,25,20,5,25,20,5,,,
365374,10,1473,805,668,212,100,112,1261,705,556
365383,10,105,10,95,105,10,95,,,
365480,10,797,442,355,112,32,80,685,410,275
365505,10,26,4,22,26,4,22,,,
365693,10,154,5,149,154,5,149,,,
365763,10,35,9,26,35,9,26,,,
365824,10,122,4,118,122,4,118,,,
365833,10,127,6,121,127,6,121,,,
366003,10,299,112,187,143,39,104,156,73,83
366155,10,29,16,13,29,16,13,,,
366191,10,1331,1290,41,1331,1290,41,,,
366252,10,4240,2680,1560,3485,2433,1052,755,247,508
366261,10,272,90,182,254,84,170,18,6,12
366270,10,284,9,275,284,9,275,,,
366289,10,7,7,0,7,7,0,,,
366340,10,373,127,246,192,70,122,181,57,124
366368,10,86,27,59,85,27,58,1,0,1
366395,10,20549,9036,11513,9328,4436,4892,11221,4600,6621
366401,10,7125,3328,3797,2194,1102,1092,4931,2226,2705
366438,10,43,3,40,25,2,23,18,1,17
366465,10,2167,726,1441,775,267,508,1392,459,933
366535,10,295,66,229,295,66,229,,,
366553,10,1294,344,950,462,92,370,832,252,580
366571,10,21,5,16,21,5,16,,,
366605,10,18,5,13,17,5,12,1,0,1
366623,10,261,147,114,32,10,22,229,137,92
366632,10,8,0,8,8,0,8,,,
366711,10,16255,6107,10148,13033,4811,8222,3222,1296,1926
367051,10,78,2,76,46,2,44,32,0,32
367088,10,120,7,113,75,5,70,45,2,43
367103,10,100,69,31,100,69,31,,,
367112,10,205,35,170,188,31,157,17,4,13
367158,10,46,4,42,46,4,42,,,
367334,10,157,143,14,145,131,14,12,12,0
367361,10,79,51,28,77,50,27,2,1,1
367431,10,28,6,22,28,6,22,,,
367459,10,7037,2894,4143,1804,772,1032,5233,2122,3111
367875,10,160,86,74,160,86,74,,,
367884,10,551,207,344,289,105,184,262,102,160
367954,10,5224,1544,3680,4807,1446,3361,417,98,319
367972,10,105,2,103,105,2,103,,,
367981,10,72,2,70,39,2,37,33,0,33
368230,10,86,3,83,68,3,65,18,0,18
368364,10,330,171,159,95,55,40,235,116,119
368407,10,30,1,29,,,,30,1,29
368443,10,387,44,343,387,44,343,,,
368452,10,270,99,171,270,99,171,,,
368540,10,30,3,27,30,3,27,,,
368629,10,553,114,439,553,114,439,,,
368647,10,11,1,10,11,1,10,,,
368771,10,265,62,203,265,62,203,,,
368832,10,66,10,56,14,2,12,52,8,44
368911,10,1673,521,1152,256,81,175,1417,440,977
369002,10,290,101,189,121,48,73,169,53,116
369109,10,59,8,51,50,7,43,9,1,8
369400,10,1159,1121,38,1159,1121,38,,,
369419,10,665,318,347,665,318,347,,,
369446,10,75,3,72,48,3,45,27,0,27
369455,10,211,53,158,211,53,158,,,
369516,10,184,45,139,184,45,139,,,
369659,10,181,44,137,160,37,123,21,7,14
369668,10,168,67,101,134,66,68,34,1,33
369686,10,89,26,63,89,26,63,,,
369695,10,62,7,55,62,7,55,,,
369783,10,327,20,307,327,20,307,,,
369950,10,165,139,26,165,139,26,,,
371052,10,301,58,243,301,58,243,,,
371690,10,1013,222,791,118,16,102,895,206,689
371830,10,76,50,26,72,48,24,4,2,2
371928,10,111,36,75,111,36,75,,,
371964,10,512,357,155,512,357,155,,,
372028,10,123,21,102,123,21,102,,,
372073,10,156,40,116,156,40,116,,,
372082,10,81,28,53,60,26,34,21,2,19
372240,10,18,2,16,17,2,15,1,0,1
372329,10,409,38,371,409,38,371,,,
372356,10,177,8,169,177,8,169,,,
372462,10,122,22,100,121,22,99,1,0,1
372718,10,308,53,255,292,51,241,16,2,14
372921,10,516,178,338,516,178,338,,,
373085,10,48,2,46,38,1,37,10,1,9
373216,10,109,11,98,109,11,98,,,
373456,10,22,0,22,19,0,19,3,0,3
373526,10,272,221,51,272,221,51,,,
373678,10,176,81,95,117,63,54,59,18,41
373696,10,45,31,14,45,31,14,,,
373711,10,76,3,73,76,3,73,,,
373784,10,528,268,260,528,268,260,,,
374024,10,233,50,183,11,2,9,222,48,174
374316,10,57,45,12,40,31,9,17,14,3
374343,10,57,2,55,57,2,55,,,
374574,10,746,130,616,480,97,383,266,33,233
374592,10,66,7,59,66,7,59,,,
375106,10,125,107,18,107,92,15,18,15,3
375230,10,201,201,0,201,201,0,,,
375373,10,140,41,99,8,0,8,132,41,91
375407,10,106,25,81,85,20,65,21,5,16
375416,10,252,67,185,252,67,185,,,
375540,10,71,2,69,45,1,44,26,1,25
375568,10,51,26,25,10,7,3,41,19,22
375656,10,137,73,64,12,1,11,125,72,53
375683,10,861,528,333,163,111,52,698,417,281
375726,10,538,280,258,387,174,213,151,106,45
375939,10,110,14,96,110,14,96,,,
375966,10,135,14,121,78,7,71,57,7,50
375984,10,204,7,197,162,7,155,42,0,42
376224,10,162,24,138,128,18,110,34,6,28
376242,10,128,73,55,128,73,55,,,
376288,10,100,16,84,100,16,84,,,
376330,10,200,40,160,200,40,160,,,
376385,10,92,22,70,92,22,70,,,
376446,10,74,1,73,12,1,11,62,0,62
376631,10,23,7,16,21,6,15,2,1,1
376677,10,117,52,65,116,51,65,1,1,0
376695,10,1267,577,690,642,289,353,625,288,337
377111,10,264,91,173,264,91,173,,,
377193,10,25,2,23,9,1,8,16,1,15
377218,10,110,109,1,110,109,1,,,
377272,10,18,3,15,18,3,15,,,
377281,10,69,6,63,69,6,63,,,
377315,10,98,0,98,98,0,98,,,
377449,10,174,62,112,130,55,75,44,7,37
377458,10,222,90,132,166,74,92,56,16,40
377485,10,50,8,42,14,1,13,36,7,29
377546,10,103,40,63,93,39,54,10,1,9
377555,10,6052,3181,2871,4993,2599,2394,1059,582,477
377564,10,5027,2383,2644,4270,2041,2229,757,342,415
377643,10,100,9,91,100,9,91,,,
377652,10,90,5,85,90,5,85,,,
377661,10,621,70,551,621,70,551,,,
377722,10,422,29,393,422,29,393,,,
377759,10,36,35,1,36,35,1,,,
378105,10,364,19,345,261,12,249,103,7,96
378576,10,1045,207,838,413,91,322,632,116,516
378886,10,233,44,189,73,18,55,160,26,134
378956,10,762,719,43,762,719,43,,,
379621,10,78,7,71,57,6,51,21,1,20
379746,10,259,15,244,259,15,244,,,
379782,10,263,26,237,263,26,237,,,
380067,10,137,2,135,137,2,135,,,
380359,10,583,119,464,232,49,183,351,70,281
380368,10,1525,578,947,335,115,220,1190,463,727
380377,10,622,150,472,401,112,289,221,38,183
380438,10,684,101,583,684,101,583,,,
381255,10,87,68,19,87,68,19,,,
381282,10,94,32,62,94,32,62,,,
381325,10,116,20,96,116,20,96,,,
381352,10,73,12,61,59,11,48,14,1,13
381370,10,323,12,311,171,5,166,152,7,145
381404,10,367,9,358,203,4,199,164,5,159
381459,10,284,187,97,60,34,26,224,153,71
381486,10,15,1,14,15,1,14,,,
381699,10,30,0,30,23,0,23,7,0,7
381732,10,65,18,47,17,8,9,48,10,38
382258,10,146,28,118,96,12,84,50,16,34
382416,10,80,13,67,80,13,67,,,
382461,10,42,0,42,31,0,31,11,0,11
382780,10,173,5,168,169,5,164,4,0,4
382911,10,50,25,25,37,20,17,13,5,8
382957,10,455,119,336,445,117,328,10,2,8
383020,10,62,16,46,51,14,37,11,2,9
383084,10,748,200,548,568,145,423,180,55,125
383163,10,242,4,238,27,1,26,215,3,212
383190,10,2248,867,1381,757,377,380,1491,490,1001
383279,10,162,25,137,80,17,63,82,8,74
383297,10,206,7,199,65,1,64,141,6,135
383312,10,80,40,40,80,40,40,,,
383330,10,92,13,79,92,13,79,,,
383367,10,233,69,164,184,67,117,49,2,47
383464,10,132,9,123,132,9,123,,,
383525,10,26,0,26,26,0,26,,,
383765,10,127,2,125,93,2,91,34,0,34
383996,10,602,243,359,149,54,95,453,189,264
384236,10,898,340,558,898,340,558,,,
384245,10,736,310,426,736,310,426,,,
384254,10,460,307,153,418,278,140,42,29,13
384306,10,101,23,78,65,16,49,36,7,29
384333,10,8516,3266,5250,2346,949,1397,6170,2317,3853
384342,10,4697,2012,2685,1634,751,883,3063,1261,1802
384412,10,384,205,179,384,205,179,,,
384421,10,93,93,0,93,93,0,,,
385132,10,141,12,129,95,10,85,46,2,44
385415,10,1271,564,707,1232,554,678,39,10,29
385503,10,241,17,224,241,17,224,,,
385619,10,2649,1446,1203,2561,1412,1149,88,34,54
386153,10,475,0,475,475,0,475,,,
386472,10,732,117,615,512,84,428,220,33,187
387925,10,106,12,94,106,12,94,,,
388520,10,351,206,145,131,76,55,220,130,90
388663,10,79,3,76,79,3,76,,,
389860,10,238,128,110,132,42,90,106,86,20
390905,10,225,127,98,67,45,22,158,82,76
391005,10,108,5,103,108,5,103,,,
391759,10,29,0,29,,,,29,0,29
392257,10,2991,234,2757,2991,234,2757,,,
392354,10,9,4,5,9,4,5,,,
392415,10,327,82,245,327,82,245,,,
393524,10,48,1,47,48,1,47,,,
393649,10,1248,537,711,1248,537,711,,,
393861,10,357,58,299,340,56,284,17,2,15
395362,10,1353,457,896,339,103,236,1014,354,660
395690,10,264,143,121,264,143,121,,,
397942,10,1077,344,733,1077,344,733,,,
399212,10,12159,8114,4045,2243,1129,1114,9916,6985,2931
399869,10,521,499,22,521,499,22,,,
399911,10,445,157,288,445,157,288,,,
400080,10,1100,761,339,1100,761,339,,,
400187,10,550,48,502,291,31,260,259,17,242
400558,10,47,21,26,47,21,26,,,
401223,10,349,101,248,225,75,150,124,26,98
401250,10,134,25,109,83,19,64,51,6,45
401764,10,240,4,236,107,1,106,133,3,130
402563,10,178,8,170,178,8,170,,,
402800,10,134,0,134,121,0,121,13,0,13
403469,10,2337,1351,986,266,129,137,2071,1222,849
403478,10,632,284,348,362,178,184,270,106,164
403487,10,865,328,537,427,198,229,438,130,308
404055,10,301,39,262,301,39,262,,,
404222,10,210,73,137,205,73,132,5,0,5
404338,10,25,16,9,25,16,9,,,
404426,10,2929,1342,1587,882,478,404,2047,864,1183
404684,10,318,99,219,318,99,219,,,
404718,10,214,7,207,214,7,207,,,
404912,10,768,123,645,768,123,645,,,
404994,10,2745,873,1872,2365,792,1573,380,81,299
405012,10,66,1,65,66,1,65,,,
405058,10,155,155,0,155,155,0,,,
405076,10,518,86,432,518,86,432,,,
405854,10,225,225,0,225,225,0,,,
405872,10,2770,1081,1689,891,423,468,1879,658,1221
406024,10,2374,299,2075,1290,176,1114,1084,123,961
406033,10,3722,465,3257,2179,282,1897,1543,183,1360
406149,10,93,25,68,93,25,68,,,
406325,10,105,14,91,25,1,24,80,13,67
406361,10,19,1,18,19,1,18,,,
406422,10,74,5,69,32,2,30,42,3,39
406486,10,48,19,29,23,8,15,25,11,14
406547,10,147,17,130,42,6,36,105,11,94
407090,10,574,15,559,203,8,195,371,7,364
407142,10,89,1,88,89,1,88,,,
407151,10,53,0,53,53,0,53,,,
407179,10,79,0,79,51,0,51,28,0,28
407355,10,166,13,153,166,13,153,,,
407391,10,132,29,103,65,5,60,67,24,43
407407,10,74,16,58,51,14,37,23,2,21
407425,10,80,12,68,43,0,43,37,12,25
407434,10,55,0,55,55,0,55,,,
407461,10,86,58,28,86,58,28,,,
407470,10,126,3,123,100,3,97,26,0,26
407489,10,76,51,25,23,12,11,53,39,14
407513,10,184,82,102,80,17,63,104,65,39
407522,10,26,9,17,,,,26,9,17
407568,10,174,6,168,143,3,140,31,3,28
407577,10,75,30,45,62,22,40,13,8,5
407595,10,72,12,60,72,12,60,,,
407610,10,48,25,23,7,3,4,41,22,19
407629,10,4384,1978,2406,4384,1978,2406,,,
407683,10,78,4,74,28,1,27,50,3,47
407708,10,233,7,226,233,7,226,,,
407735,10,47,2,45,47,2,45,,,
407832,10,164,113,51,63,45,18,101,68,33
408066,10,175,47,128,135,38,97,40,9,31
408163,10,48,1,47,48,1,47,,,
408385,10,712,234,478,712,234,478,,,
408729,10,92,11,81,87,11,76,5,0,5
408844,10,2985,829,2156,1811,531,1280,1174,298,876
408862,10,265,9,256,91,5,86,174,4,170
409032,10,52,1,51,52,1,51,,,
409120,10,99,28,71,99,28,71,,,
409193,10,155,154,1,155,154,1,,,
409254,10,399,9,390,52,2,50,347,7,340
409315,10,28962,12198,16764,8384,3590,4794,20578,8608,11970
409537,10,23,10,13,,,,23,10,13
409591,10,119,34,85,57,18,39,62,16,46
409616,10,525,209,316,523,208,315,2,1,1
409698,10,7503,2792,4711,6457,2298,4159,1046,494,552
410797,10,275,156,119,275,156,119,,,
410964,10,41,1,40,35,1,34,6,0,6
411684,10,98,28,70,98,28,70,,,
411754,10,40,8,32,40,8,32,,,
412173,10,452,40,412,412,37,375,40,3,37
412535,10,39,3,36,38,3,35,1,0,1
412544,10,156,15,141,110,15,95,46,0,46
412599,10,379,121,258,379,121,258,,,
413176,10,32,17,15,32,17,15,,,
413413,10,38716,6853,31863,7783,1505,6278,30933,5348,25585
413617,10,191,56,135,67,20,47,124,36,88
413626,10,156,65,91,82,39,43,74,26,48
413680,10,319,293,26,319,293,26,,,
413778,10,368,22,346,190,10,180,178,12,166
413820,10,6,0,6,6,0,6,,,
413893,10,1269,729,540,1269,729,540,,,
413945,10,50,6,44,50,6,44,,,
413972,10,27,2,25,27,2,25,,,
414063,10,109,3,106,92,3,89,17,0,17
414124,10,314,235,79,251,193,58,63,42,21
414461,10,2122,2020,102,1856,1766,90,266,254,12
414489,10,54,2,52,54,2,52,,,
414540,10,283,9,274,259,8,251,24,1,23
414595,10,671,128,543,315,69,246,356,59,297
414869,10,283,20,263,102,16,86,181,4,177
414878,10,1367,875,492,308,152,156,1059,723,336
414911,10,2345,830,1515,643,271,372,1702,559,1143
414939,10,281,22,259,281,22,259,,,
414966,10,167,82,85,29,16,13,138,66,72
415039,10,48,1,47,27,1,26,21,0,21
415057,10,39,39,0,39,39,0,,,
415987,10,95,6,89,95,6,89,,,
416458,10,202,52,150,202,52,150,,,
416801,10,358,72,286,310,64,246,48,8,40
417008,10,136,5,131,136,5,131,,,
417062,10,45,0,45,31,0,31,14,0,14
417105,10,362,224,138,214,130,84,148,94,54
417123,10,60,13,47,28,9,19,32,4,28
417248,10,50,49,1,50,49,1,,,
417275,10,35,31,4,35,31,4,,,
417327,10,218,27,191,47,5,42,171,22,149
417442,10,52,5,47,52,5,47,,,
417503,10,265,3,262,173,3,170,92,0,92
417600,10,16,0,16,16,0,16,,,
417628,10,27,2,25,25,2,23,2,0,2
417637,10,56,21,35,56,21,35,,,
417646,10,23,1,22,23,1,22,,,
417655,10,28,0,28,28,0,28,,,
417682,10,26,3,23,26,3,23,,,
417716,10,183,11,172,183,11,172,,,
417725,10,42,0,42,42,0,42,,,
417734,10,158,24,134,58,13,45,100,11,89
417752,10,31,13,18,29,11,18,2,2,0
417831,10,122,84,38,122,84,38,,,
417840,10,400,17,383,400,17,383,,,
417868,10,46,15,31,28,6,22,18,9,9
417886,10,24,1,23,24,1,23,,,
417910,10,212,31,181,212,31,181,,,
417983,10,31,1,30,,,,31,1,30
417992,10,51,5,46,51,5,46,,,
418001,10,87,7,80,87,7,80,,,
418010,10,82,4,78,35,2,33,47,2,45
418029,10,39,2,37,39,2,37,,,
418038,10,146,13,133,146,13,133,,,
418056,10,22,7,15,22,7,15,,,
418065,10,266,28,238,195,24,171,71,4,67
418083,10,48,7,41,48,7,41,,,
418126,10,327,95,232,187,51,136,140,44,96
418171,10,76,76,0,76,76,0,,,
418199,10,36,33,3,36,33,3,,,
418205,10,248,131,117,177,121,56,71,10,61
418223,10,103,1,102,103,1,102,,,
418250,10,195,126,69,29,21,8,166,105,61
418269,10,280,165,115,280,165,115,,,
418278,10,66,38,28,40,17,23,26,21,5
418296,10,1571,779,792,392,132,260,1179,647,532
418302,10,498,260,238,112,19,93,386,241,145
418320,10,980,552,428,44,11,33,936,541,395
418348,10,483,341,142,59,49,10,424,292,132
418357,10,181,84,97,49,19,30,132,65,67
418409,10,223,110,113,159,70,89,64,40,24
418427,10,81,7,74,60,5,55,21,2,19
418445,10,18,0,18,18,0,18,,,
418454,10,127,48,79,120,41,79,7,7,0
418481,10,53,2,51,53,2,51,,,
418515,10,68,4,64,44,4,40,24,0,24
418524,10,47,2,45,47,2,45,,,
418533,10,353,45,308,269,28,241,84,17,67
418542,10,111,15,96,46,5,41,65,10,55
418560,10,109,19,90,19,1,18,90,18,72
418588,10,28,3,25,28,3,25,,,
418612,10,10,1,9,10,1,9,,,
418658,10,403,357,46,403,357,46,,,
418773,10,303,137,166,249,121,128,54,16,38
418782,10,211,202,9,211,202,9,,,
418889,10,58,51,7,37,30,7,21,21,0
418913,10,8,3,5,8,3,5,,,
418968,10,188,6,182,188,6,182,,,
419031,10,26,7,19,26,7,19,,,
419095,10,32,3,29,32,3,29,,,
419183,10,79,4,75,79,4,75,,,
419217,10,76,16,60,76,16,60,,,
419226,10,461,236,225,346,189,157,115,47,68
419235,10,143,36,107,143,36,107,,,
419244,10,183,146,37,99,80,19,84,66,18
419253,10,121,79,42,121,79,42,,,
419280,10,32,2,30,23,1,22,9,1,8
419332,10,2,2,0,2,2,0,,,
419341,10,8,2,6,8,2,6,,,
419420,10,33,14,19,33,14,19,,,
419484,10,25,2,23,25,2,23,,,
419633,10,85,9,76,85,9,76,,,
419703,10,460,432,28,460,432,28,,,
419712,10,116,108,8,116,108,8,,,
419721,10,224,215,9,224,215,9,,,
420024,10,204,20,184,164,13,151,40,7,33
420042,10,62,37,25,62,37,25,,,
420130,10,307,16,291,307,16,291,,,
420246,10,599,77,522,510,60,450,89,17,72
420255,10,29,27,2,29,27,2,,,
420325,10,77,77,0,77,77,0,,,
420343,10,1000,965,35,780,754,26,220,211,9
420370,10,479,159,320,479,159,320,,,
420398,10,16604,6676,9928,3064,1315,1749,13540,5361,8179
420431,10,1705,613,1092,322,105,217,1383,508,875
420440,10,1381,473,908,299,111,188,1082,362,720
420468,10,250,93,157,204,88,116,46,5,41
420538,10,1246,455,791,510,179,331,736,276,460
420556,10,644,220,424,242,92,150,402,128,274
420705,10,134,89,45,63,42,21,71,47,24
420723,10,484,199,285,128,51,77,356,148,208
420981,10,269,31,238,269,31,238,,,
421513,10,67,10,57,62,9,53,5,1,4
421610,10,119,10,109,119,10,109,,,
421665,10,45,1,44,9,0,9,36,1,35
421708,10,1084,137,947,704,85,619,380,52,328
421717,10,28,19,9,17,10,7,11,9,2
421771,10,38,0,38,29,0,29,9,0,9
421832,10,203,91,112,183,89,94,20,2,18
421841,10,246,97,149,246,97,149,,,
421878,10,369,41,328,251,25,226,118,16,102
421896,10,141,42,99,141,42,99,,,
422020,10,203,197,6,203,197,6,,,
422695,10,373,49,324,373,49,324,,,
422835,10,287,57,230,287,57,230,,,
423120,10,235,9,226,235,9,226,,,
423397,10,495,299,196,495,299,196,,,
423412,10,42,35,7,42,35,7,,,
423643,10,3890,1585,2305,3809,1558,2251,81,27,54
423652,10,427,134,293,176,45,131,251,89,162
425250,10,113,14,99,63,8,55,50,6,44
425986,10,197,24,173,197,24,173,,,
426314,10,12720,10456,2264,3977,3123,854,8743,7333,1410
427308,10,92,2,90,92,2,90,,,
427335,10,84,0,84,78,0,78,6,0,6
427894,10,82,80,2,82,80,2,,,
427973,10,224,197,27,153,133,20,71,64,7
427982,10,177,104,73,140,89,51,37,15,22
427991,10,579,314,265,311,149,162,268,165,103
428000,10,97,36,61,97,36,61,,,
428019,10,202,107,95,49,21,28,153,86,67
428055,10,191,40,151,191,40,151,,,
428125,10,47,33,14,45,31,14,2,2,0
428143,10,6,1,5,6,1,5,,,
428170,10,694,77,617,424,45,379,270,32,238
428259,10,156,48,108,82,33,49,74,15,59
428392,10,1245,541,704,447,200,247,798,341,457
429012,10,158,136,22,158,136,22,,,
429085,10,102,27,75,44,13,31,58,14,44
429094,10,143,23,120,107,16,91,36,7,29
429128,10,586,22,564,34,1,33,552,21,531
430184,10,1690,441,1249,210,100,110,1480,341,1139
430227,10,77,1,76,66,1,65,11,0,11
430245,10,616,118,498,616,118,498,,,
430306,10,45,5,40,31,4,27,14,1,13
430403,10,322,26,296,322,26,296,,,
430564,10,25,8,17,8,1,7,17,7,10
430582,10,417,194,223,417,194,223,,,
430670,10,369,146,223,369,146,223,,,
430704,10,99,30,69,93,29,64,6,1,5
430795,10,155,44,111,155,44,111,,,
430883,10,28,2,26,28,2,26,,,
430908,10,42,8,34,28,7,21,14,1,13
430935,10,656,509,147,439,347,92,217,162,55
430971,10,61,13,48,61,13,48,,,
431017,10,333,191,142,86,38,48,247,153,94
431071,10,22,3,19,13,1,12,9,2,7
431105,10,88,11,77,43,5,38,45,6,39
431123,10,170,164,6,170,164,6,,,
431141,10,1403,535,868,1361,531,830,42,4,38
431169,10,78,16,62,64,13,51,14,3,11
431187,10,77,68,9,77,68,9,,,
431196,10,112,9,103,112,9,103,,,
431266,10,100,3,97,42,1,41,58,2,56
431275,10,64,3,61,18,1,17,46,2,44
431284,10,100,3,97,91,1,90,9,2,7
431558,10,283,92,191,262,90,172,21,2,19
431600,10,148,19,129,123,17,106,25,2,23
431716,10,435,256,179,435,256,179,,,
431929,10,8,5,3,5,3,2,3,2,1
431983,10,88,88,0,88,88,0,,,
432117,10,181,1,180,114,1,113,67,0,67
432269,10,39,32,7,39,32,7,,,
432348,10,158,89,69,158,89,69,,,
432384,10,502,109,393,502,109,393,,,
432524,10,108,34,74,107,33,74,1,1,0
433004,10,504,132,372,504,132,372,,,
433013,10,699,250,449,699,250,449,,,
433040,10,25,2,23,25,2,23,,,
433068,10,455,278,177,371,210,161,84,68,16
433101,10,752,75,677,441,42,399,311,33,278
433138,10,130,30,100,113,21,92,17,9,8
433174,10,473,53,420,73,10,63,400,43,357
433387,10,150116,53754,96362,150116,53754,96362,,,
433420,10,298,251,47,298,251,47,,,
433536,10,391,46,345,206,26,180,185,20,165
433660,10,15909,6589,9320,12066,4984,7082,3843,1605,2238
434016,10,165,50,115,42,15,27,123,35,88
434061,10,5996,2348,3648,3068,1410,1658,2928,938,1990
434140,10,710,142,568,710,142,568,,,
434159,10,516,390,126,516,390,126,,,
434274,10,83,12,71,56,7,49,27,5,22
434283,10,30,3,27,28,2,26,2,1,1
434308,10,356,13,343,356,13,343,,,
434344,10,223,8,215,221,8,213,2,0,2
434362,10,35,34,1,35,34,1,,,
434432,10,14,3,11,14,3,11,,,
434441,10,76,14,62,76,14,62,,,
434469,10,20,3,17,20,3,17,,,
434496,10,81,0,81,81,0,81,,,
434539,10,55,18,37,7,2,5,48,16,32
434584,10,268,75,193,55,15,40,213,60,153
434672,10,16126,5851,10275,4181,1911,2270,11945,3940,8005
434751,10,123,36,87,57,23,34,66,13,53
434821,10,822,28,794,822,28,794,,,
434830,10,194,6,188,131,6,125,63,0,63
434900,10,335,78,257,190,39,151,145,39,106
434937,10,33,33,0,33,33,0,,,
435000,10,1020,375,645,919,348,571,101,27,74
436003,10,71,10,61,46,6,40,25,4,21
436030,10,231,100,131,136,59,77,95,41,54
436100,10,13,2,11,13,2,11,,,
436261,10,37,6,31,37,6,31,,,
436304,10,2401,1212,1189,1102,620,482,1299,592,707
436429,10,5827,3867,1960,5827,3867,1960,,,
436553,10,372,63,309,372,63,309,,,
436599,10,102,19,83,18,5,13,84,14,70
436614,10,71,47,24,28,13,15,43,34,9
436632,10,145,18,127,74,12,62,71,6,65
436641,10,89,31,58,89,31,58,,,
436650,10,174,18,156,174,18,156,,,
436775,10,129,6,123,129,6,123,,,
436818,10,795,347,448,720,312,408,75,35,40
436827,10,522,290,232,469,254,215,53,36,17
436836,10,2405,1222,1183,2188,1096,1092,217,126,91
437097,10,1309,808,501,1275,789,486,34,19,15
437103,10,7494,2542,4952,3344,1263,2081,4150,1279,2871
437237,10,58,50,8,58,50,8,,,
437316,10,359,52,307,339,51,288,20,1,19
437325,10,142,31,111,12,6,6,130,25,105
437556,10,1246,555,691,1197,554,643,49,1,48
437608,10,145,102,43,143,100,43,2,2,0
437635,10,688,70,618,688,70,618,,,
437723,10,73,18,55,73,18,55,,,
437732,10,103,9,94,78,6,72,25,3,22
437750,10,82,81,1,82,81,1,,,
437769,10,108,7,101,108,7,101,,,
437778,10,212,4,208,212,4,208,,,
437857,10,108,0,108,81,0,81,27,0,27
437936,10,619,66,553,619,66,553,,,
438179,10,248,35,213,248,35,213,,,
438221,10,171,15,156,164,15,149,7,0,7
438258,10,415,98,317,415,98,317,,,
438285,10,228,19,209,228,19,209,,,
438337,10,142,52,90,114,42,72,28,10,18
438498,10,1397,285,1112,346,97,249,1051,188,863
438504,10,1366,1310,56,1366,1310,56,,,
438586,10,1187,366,821,893,267,626,294,99,195
438674,10,63,0,63,39,0,39,24,0,24
438708,10,361,92,269,112,27,85,249,65,184
438735,10,191,174,17,146,134,12,45,40,5
438984,10,35,12,23,35,12,23,,,
439020,10,52,15,37,35,6,29,17,9,8
439118,10,393,50,343,393,50,343,,,
439190,10,1996,991,1005,1143,569,574,853,422,431
439367,10,1132,312,820,1132,312,820,,,
439394,10,71,12,59,71,12,59,,,
439446,10,124,18,106,124,18,106,,,
439455,10,213,9,204,114,1,113,99,8,91
439473,10,213,91,122,115,51,64,98,40,58
439491,10,309,53,256,309,53,256,,,
439507,10,299,23,276,299,23,276,,,
439570,10,515,27,488,515,27,488,,,
439622,10,312,49,263,312,49,263,,,
439668,10,214,185,29,214,185,29,,,
439686,10,23,1,22,23,1,22,,,
439701,10,650,275,375,271,108,163,379,167,212
439738,10,387,76,311,387,76,311,,,
439747,10,158,32,126,114,25,89,44,7,37
439774,10,53,18,35,38,16,22,15,2,13
439783,10,205,67,138,132,43,89,73,24,49
439792,10,442,39,403,442,39,403,,,
439817,10,219,106,113,78,42,36,141,64,77
439844,10,47,1,46,47,1,46,,,
439862,10,82,24,58,66,18,48,16,6,10
439871,10,140,4,136,123,4,119,17,0,17
439899,10,77,37,40,50,17,33,27,20,7
439914,10,30,8,22,30,8,22,,,
439932,10,66,10,56,66,10,56,,,
439969,10,161,42,119,161,42,119,,,
440004,10,41,12,29,41,12,29,,,
440031,10,573,202,371,553,196,357,20,6,14
440059,10,716,660,56,554,508,46,162,152,10
440101,10,101,6,95,48,2,46,53,4,49
440226,10,50,0,50,50,0,50,,,
440262,10,423,401,22,337,322,15,86,79,7
440271,10,134,68,66,134,68,66,,,
440396,10,241,116,125,215,100,115,26,16,10
440402,10,1829,617,1212,729,243,486,1100,374,726
440651,10,574,151,423,354,90,264,220,61,159
440730,10,304,110,194,304,110,194,,,
440749,10,65,52,13,2,2,0,63,50,13
440776,10,48,9,39,48,9,39,,,
440794,10,546,142,404,403,106,297,143,36,107
440819,10,18,9,9,18,9,9,,,
440828,10,1248,577,671,702,327,375,546,250,296
440855,10,113,4,109,113,4,109,,,
440989,10,513,391,122,513,391,122,,,
441025,10,240,60,180,234,59,175,6,1,5
441052,10,1374,324,1050,1374,324,1050,,,
441070,10,131,48,83,20,8,12,111,40,71
441104,10,315,58,257,166,29,137,149,29,120
441131,10,279,64,215,186,42,144,93,22,71
441168,10,23,1,22,23,1,22,,,
441210,10,252,117,135,2,0,2,250,117,133
441229,10,1389,255,1134,1389,255,1134,,,
441238,10,95,36,59,95,36,59,,,
441256,10,23,0,23,23,0,23,,,
441371,10,5978,194,5784,5962,193,5769,16,1,15
441380,10,227,68,159,203,62,141,24,6,18
441414,10,145,39,106,29,12,17,116,27,89
441423,10,218,48,170,218,48,170,,,
441487,10,55,3,52,54,3,51,1,0,1
441496,10,163,141,22,134,115,19,29,26,3
441502,10,345,30,315,345,30,315,,,
441548,10,86,18,68,86,18,68,,,
441575,10,247,34,213,247,34,213,,,
441593,10,11,0,11,11,0,11,,,
441609,10,102,102,0,102,102,0,,,
441618,10,26,0,26,15,0,15,11,0,11
441636,10,496,71,425,436,61,375,60,10,50
441645,10,132,2,130,91,1,90,41,1,40
441663,10,293,23,270,293,23,270,,,
441672,10,34,4,30,34,4,30,,,
441690,10,190,106,84,73,41,32,117,65,52
441706,10,335,122,213,335,122,213,,,
441742,10,746,65,681,637,58,579,109,7,102
441760,10,4487,1977,2510,1387,727,660,3100,1250,1850
441788,10,529,479,50,372,335,37,157,144,13
441830,10,43,13,30,43,13,30,,,
441858,10,152,8,144,137,6,131,15,2,13
441876,10,233,10,223,120,7,113,113,3,110
441900,10,7227,1892,5335,2087,419,1668,5140,1473,3667
441937,10,6966,2391,4575,5204,1707,3497,1762,684,1078
441982,10,382,183,199,360,174,186,22,9,13
442064,10,97,15,82,88,13,75,9,2,7
442073,10,792,155,637,514,115,399,278,40,238
442134,10,363,50,313,363,50,313,,,
442213,10,39,0,39,33,0,33,6,0,6
442240,10,403,76,327,230,41,189,173,35,138
442295,10,299,135,164,286,132,154,13,3,10
442329,10,937,844,93,937,844,93,,,
442356,10,1816,201,1615,647,73,574,1169,128,1041
442383,10,115,21,94,115,21,94,,,
442426,10,440,41,399,277,22,255,163,19,144
442435,10,31,5,26,31,5,26,,,
442444,10,802,430,372,802,430,372,,,
442523,10,78,33,45,71,31,40,7,2,5
442569,10,5445,2506,2939,1990,907,1083,3455,1599,1856
442602,10,490,76,414,490,76,414,,,
442611,10,1211,1144,67,1211,1144,67,,,
442639,10,450,287,163,450,287,163,,,
442657,10,246,18,228,246,18,228,,,
442781,10,766,158,608,200,38,162,566,120,446
442806,10,2276,1005,1271,2276,1005,1271,,,
442842,10,219,40,179,105,19,86,114,21,93
442879,10,900,65,835,670,48,622,230,17,213
442888,10,23,23,0,23,23,0,,,
442930,10,578,286,292,539,263,276,39,23,16
442949,10,3,0,3,,,,3,0,3
442976,10,93,3,90,93,3,90,,,
442985,10,250,28,222,250,28,222,,,
443021,10,57,47,10,57,47,10,,,
443030,10,74,22,52,74,22,52,,,
443049,10,291,170,121,157,96,61,134,74,60
443058,10,180,83,97,56,21,35,124,62,62
443076,10,144,71,73,87,41,46,57,30,27
443100,10,59,40,19,59,40,19,,,
443128,10,137,67,70,116,57,59,21,10,11
443137,10,331,58,273,331,58,273,,,
443146,10,64,53,11,50,40,10,14,13,1
443207,10,129,121,8,129,121,8,,,
443216,10,151,115,36,151,115,36,,,
443225,10,72,57,15,72,57,15,,,
443234,10,162,3,159,162,3,159,,,
443252,10,1635,993,642,1635,993,642,,,
443261,10,210,10,200,152,8,144,58,2,56
443289,10,168,26,142,168,26,142,,,
443298,10,27,23,4,27,23,4,,,
443322,10,30,5,25,30,5,25,,,
443331,10,2581,531,2050,2096,415,1681,485,116,369
443340,10,55,26,29,48,24,24,7,2,5
443377,10,54,48,6,54,48,6,,,
443410,10,1197,849,348,1086,760,326,111,89,22
443492,10,1596,648,948,801,388,413,795,260,535
443562,10,522,108,414,352,77,275,170,31,139
443571,10,105,56,49,105,56,49,,,
443599,10,1123,82,1041,236,23,213,887,59,828
443632,10,99,61,38,99,61,38,,,
443641,10,167,3,164,70,1,69,97,2,95
443650,10,1010,168,842,912,159,753,98,9,89
443669,10,114,7,107,114,7,107,,,
443696,10,55,12,43,55,12,43,,,
443702,10,73,48,25,58,37,21,15,11,4
443748,10,700,164,536,682,161,521,18,3,15
443766,10,2909,507,2402,183,67,116,2726,440,2286
443784,10,1520,352,1168,120,40,80,1400,312,1088
443951,10,51,25,26,51,25,26,,,
443979,10,43,0,43,16,0,16,27,0,27
444051,10,86,3,83,70,3,67,16,0,16
444088,10,556,65,491,556,65,491,,,
444103,10,39,34,5,9,9,0,30,25,5
444130,10,12648,3115,9533,5038,1398,3640,7610,1717,5893
444194,10,61,3,58,61,3,58,,,
444219,10,8926,3926,5000,1821,836,985,7105,3090,4015
444228,10,32,0,32,32,0,32,,,
444255,10,63,12,51,63,12,51,,,
444264,10,12,3,9,11,3,8,1,0,1
444282,10,84,2,82,49,2,47,35,0,35
444291,10,90,3,87,57,1,56,33,2,31
444307,10,69,4,65,47,3,44,22,1,21
444325,10,210,28,182,178,24,154,32,4,28
444334,10,62,5,57,62,5,57,,,
444361,10,63,25,38,63,25,38,,,
444370,10,48,48,0,48,48,0,,,
444398,10,120,56,64,86,46,40,34,10,24
444404,10,15,10,5,8,5,3,7,5,2
444413,10,170,170,0,170,170,0,,,
444440,10,25,2,23,25,2,23,,,
444468,10,23,1,22,21,1,20,2,0,2
444486,10,340,17,323,304,14,290,36,3,33
444510,10,116,14,102,116,14,102,,,
444529,10,115,21,94,115,21,94,,,
444556,10,543,241,302,543,241,302,,,
444565,10,303,146,157,236,113,123,67,33,34
444583,10,364,171,193,364,171,193,,,
444635,10,90,9,81,6,0,6,84,9,75
444662,10,108,96,12,108,96,12,,,
444671,10,87,44,43,87,44,43,,,
444699,10,59,6,53,56,5,51,3,1,2
444714,10,248,17,231,248,17,231,,,
444732,10,30,2,28,30,2,28,,,
444778,10,136,47,89,62,19,43,74,28,46
444787,10,2275,310,1965,1441,197,1244,834,113,721
444796,10,131,73,58,131,73,58,,,
444811,10,619,33,586,327,18,309,292,15,277
444857,10,141,3,138,60,1,59,81,2,79
444866,10,185,19,166,119,14,105,66,5,61
444893,10,341,13,328,341,13,328,,,
444936,10,135,47,88,133,47,86,2,0,2
444945,10,234,23,211,234,23,211,,,
444954,10,1127,404,723,650,277,373,477,127,350
445027,10,13480,5213,8267,11924,4768,7156,1556,445,1111
445054,10,42,35,7,42,35,7,,,
445133,10,195,69,126,119,46,73,76,23,53
445188,10,9093,4403,4690,8996,4347,4649,97,56,41
445203,10,223,34,189,223,34,189,,,
445212,10,225,34,191,126,19,107,99,15,84
445230,10,786,214,572,786,214,572,,,
445249,10,272,60,212,272,60,212,,,
445258,10,6,1,5,6,1,5,,,
445267,10,3242,905,2337,1028,211,817,2214,694,1520
445364,10,361,36,325,361,36,325,,,
445461,10,746,275,471,724,269,455,22,6,16
445498,10,8,8,0,8,8,0,,,
445540,10,66,0,66,66,0,66,,,
445638,10,10,0,10,6,0,6,4,0,4
445647,10,167,2,165,94,1,93,73,1,72
445656,10,175,7,168,109,5,104,66,2,64
445692,10,517,438,79,470,398,72,47,40,7
445708,10,1262,438,824,1231,421,810,31,17,14
445735,10,1552,584,968,1552,584,968,,,
445744,10,481,89,392,481,89,392,,,
445762,10,244,224,20,195,179,16,49,45,4
445780,10,30,3,27,30,3,27,,,
445799,10,1031,978,53,1031,978,53,,,
445841,10,141,0,141,107,0,107,34,0,34
445850,10,145,0,145,97,0,97,48,0,48
445869,10,397,140,257,253,92,161,144,48,96
445911,10,831,332,499,537,211,326,294,121,173
445948,10,1576,221,1355,1576,221,1355,,,
445957,10,319,62,257,,,,319,62,257
446002,10,36,8,28,17,3,14,19,5,14
446039,10,30,8,22,30,8,22,,,
446048,10,1302,598,704,1268,575,693,34,23,11
446084,10,82,7,75,21,2,19,61,5,56
446093,10,104,9,95,88,7,81,16,2,14
446109,10,323,37,286,249,24,225,74,13,61
446118,10,649,118,531,649,118,531,,,
446127,10,200,5,195,200,5,195,,,
446163,10,483,442,41,331,309,22,152,133,19
446206,10,25,6,19,16,2,14,9,4,5
446224,10,68,16,52,55,10,45,13,6,7
446233,10,148,89,59,135,85,50,13,4,9
446242,10,117,41,76,117,41,76,,,
446251,10,104,20,84,104,20,84,,,
446260,10,765,22,743,765,22,743,,,
446288,10,75,4,71,44,0,44,31,4,27
446303,10,45,1,44,29,0,29,16,1,15
446349,10,25,3,22,25,3,22,,,
446385,10,251,144,107,236,134,102,15,10,5
446394,10,35,13,22,4,2,2,31,11,20
446455,10,25,23,2,25,23,2,,,
446516,10,4,1,3,4,1,3,,,
446525,10,271,228,43,271,228,43,,,
446552,10,1568,803,765,1568,803,765,,,
446561,10,1901,442,1459,1901,442,1459,,,
446589,10,402,76,326,402,76,326,,,
446598,10,14,0,14,12,0,12,2,0,2
446604,10,2399,2399,0,2399,2399,0,,,
446640,10,3206,1747,1459,3021,1644,1377,185,103,82
446774,10,4060,1511,2549,844,346,498,3216,1165,2051
447014,10,177,13,164,177,13,164,,,
447023,10,1637,695,942,1626,695,931,11,0,11
447050,10,2560,486,2074,1905,358,1547,655,128,527
447148,10,170,5,165,111,4,107,59,1,58
447166,10,56,5,51,33,5,28,23,0,23
447175,10,64,2,62,45,1,44,19,1,18
447263,10,2173,304,1869,1691,219,1472,482,85,397
447351,10,493,248,245,493,248,245,,,
447379,10,12,10,2,12,10,2,,,
447421,10,230,25,205,230,25,205,,,
447449,10,46,9,37,27,7,20,19,2,17
447458,10,253,204,49,253,204,49,,,
447467,10,70,3,67,70,3,67,,,
447582,10,1042,329,713,568,203,365,474,126,348
447591,10,651,61,590,651,61,590,,,
447607,10,1514,776,738,1514,776,738,,,
447616,10,1182,628,554,1182,628,554,,,
447689,10,10949,4517,6432,6890,2884,4006,4059,1633,2426
447698,10,135,28,107,105,22,83,30,6,24
447704,10,139,4,135,139,4,135,,,
447713,10,206,56,150,206,56,150,,,
447722,10,30,3,27,30,3,27,,,
447731,10,165,5,160,112,5,107,53,0,53
447759,10,198,49,149,173,45,128,25,4,21
447768,10,1526,299,1227,1526,299,1227,,,
447777,10,843,438,405,19,14,5,824,424,400
447795,10,42,8,34,42,8,34,,,
447801,10,99,29,70,61,21,40,38,8,30
447810,10,219,21,198,219,21,198,,,
447847,10,128,120,8,128,120,8,,,
447865,10,8,3,5,4,2,2,4,1,3
447874,10,213,208,5,213,208,5,,,
447883,10,166,23,143,71,12,59,95,11,84
447892,10,127,12,115,77,9,68,50,3,47
447908,10,66,3,63,42,1,41,24,2,22
447917,10,50,10,40,50,10,40,,,
447935,10,286,14,272,286,14,272,,,
447953,10,628,354,274,515,296,219,113,58,55
447962,10,163,14,149,163,14,149,,,
447971,10,29,0,29,29,0,29,,,
447980,10,96,4,92,21,1,20,75,3,72
447999,10,181,46,135,181,46,135,,,
448026,10,128,5,123,93,4,89,35,1,34
448071,10,333,16,317,217,7,210,116,9,107
448123,10,208,17,191,208,17,191,,,
448196,10,102,9,93,97,9,88,5,0,5
448220,10,152,8,144,152,8,144,,,
448239,10,117,1,116,117,1,116,,,
448248,10,3772,2093,1679,498,106,392,3274,1987,1287
448257,10,17,0,17,2,0,2,15,0,15
448275,10,24,1,23,24,1,23,,,
448354,10,220,23,197,140,10,130,80,13,67
448372,10,196,91,105,196,91,105,,,
448424,10,71,5,66,32,1,31,39,4,35
448433,10,1232,1193,39,1232,1193,39,,,
448594,10,3484,1245,2239,1049,410,639,2435,835,1600
448600,10,257,16,241,257,16,241,,,
448619,10,654,43,611,323,27,296,331,16,315
448646,10,34,0,34,34,0,34,,,
448673,10,2696,265,2431,996,104,892,1700,161,1539
448691,10,184,44,140,10,2,8,174,42,132
448770,10,284,271,13,267,256,11,17,15,2
448798,10,150,5,145,150,5,145,,,
448859,10,154,144,10,154,144,10,,,
448895,10,526,90,436,526,90,436,,,
449038,10,1522,371,1151,190,81,109,1332,290,1042
449074,10,576,80,496,576,80,496,,,
449083,10,123,122,1,123,122,1,,,
449092,10,133,132,1,133,132,1,,,
449135,10,213,64,149,147,49,98,66,15,51
449250,10,688,132,556,688,132,556,,,
449311,10,182,1,181,65,0,65,117,1,116
449320,10,673,650,23,471,457,14,202,193,9
449339,10,48298,30497,17801,3062,1589,1473,45236,28908,16328
449348,10,117,45,72,10,4,6,107,41,66
449357,10,62,3,59,62,3,59,,,
449384,10,409,257,152,294,187,107,115,70,45
449393,10,85,33,52,85,33,52,,,
449445,10,121,22,99,121,22,99,,,
449454,10,44,7,37,,,,44,7,37
449463,10,157,21,136,131,17,114,26,4,22
449472,10,66,2,64,66,2,64,,,
449481,10,40,9,31,40,9,31,,,
449490,10,164,40,124,164,40,124,,,
449506,10,63,36,27,63,36,27,,,
449524,10,298,24,274,298,24,274,,,
449533,10,83,7,76,83,7,76,,,
449597,10,4,0,4,4,0,4,,,
449603,10,191,120,71,191,120,71,,,
449612,10,93,53,40,93,53,40,,,
449658,10,117,117,0,117,117,0,,,
449676,10,273,129,144,273,129,144,,,
449685,10,230,19,211,230,19,211,,,
449700,10,382,73,309,382,73,309,,,
449719,10,45,6,39,45,6,39,,,
449728,10,160,3,157,160,3,157,,,
449764,10,261,119,142,215,108,107,46,11,35
449773,10,180,50,130,180,50,130,,,
449782,10,21,2,19,17,1,16,4,1,3
449807,10,70,1,69,70,1,69,,,
449816,10,642,417,225,49,29,20,593,388,205
449834,10,35,33,2,11,11,0,24,22,2
449861,10,172,8,164,172,8,164,,,
449870,10,180,76,104,147,63,84,33,13,20
449889,10,8766,2160,6606,8766,2160,6606,,,
449898,10,809,152,657,551,104,447,258,48,210
449904,10,169,6,163,169,6,163,,,
449922,10,172,74,98,172,74,98,,,
449959,10,210,32,178,134,19,115,76,13,63
449968,10,261,52,209,176,34,142,85,18,67
449977,10,185,7,178,127,3,124,58,4,54
449986,10,346,77,269,206,37,169,140,40,100
449995,10,109,3,106,64,3,61,45,0,45
450021,10,160,31,129,160,31,129,,,
450058,10,904,163,741,904,163,741,,,
450067,10,562,152,410,558,152,406,4,0,4
450119,10,36,3,33,36,3,33,,,
450128,10,548,14,534,548,14,534,,,
450298,10,300,72,228,22,10,12,278,62,216
450304,10,131,55,76,88,40,48,43,15,28
450377,10,1345,243,1102,83,33,50,1262,210,1052
450395,10,112,0,112,60,0,60,52,0,52
450401,10,418,35,383,418,35,383,,,
450571,10,538,50,488,282,22,260,256,28,228
450599,10,68,2,66,68,2,66,,,
450605,10,45,1,44,31,0,31,14,1,13
450614,10,110,3,107,85,3,82,25,0,25
450632,10,115,20,95,,,,115,20,95
450641,10,248,36,212,149,30,119,99,6,93
450650,10,196,14,182,74,3,71,122,11,111
450696,10,357,43,314,357,43,314,,,
450702,10,199,13,186,199,13,186,,,
450711,10,56,43,13,56,43,13,,,
450720,10,664,17,647,302,5,297,362,12,350
450933,10,16412,10160,6252,11110,6447,4663,5302,3713,1589
450951,10,158,91,67,158,91,67,,,
450960,10,286,27,259,228,20,208,58,7,51
450988,10,201,26,175,132,20,112,69,6,63
451042,10,11,0,11,7,0,7,4,0,4
451051,10,106,9,97,,,,106,9,97
451079,10,83,13,70,83,13,70,,,
451097,10,52,8,44,39,4,35,13,4,9
451103,10,835,247,588,359,112,247,476,135,341
451121,10,111,9,102,56,4,52,55,5,50
451149,10,645,44,601,645,44,601,,,
451158,10,636,31,605,636,31,605,,,
451167,10,137,54,83,79,39,40,58,15,43
451194,10,29,3,26,29,3,26,,,
451228,10,216,179,37,216,179,37,,,
451237,10,197,4,193,197,4,193,,,
451255,10,52,2,50,29,0,29,23,2,21
451264,10,125,15,110,125,15,110,,,
451282,10,111,4,107,80,3,77,31,1,30
451291,10,12,1,11,,,,12,1,11
451307,10,21,1,20,3,0,3,18,1,17
451316,10,58,11,47,58,11,47,,,
451334,10,285,114,171,206,84,122,79,30,49
451343,10,91,3,88,59,2,57,32,1,31
451352,10,231,25,206,170,20,150,61,5,56
451370,10,68,68,0,68,68,0,,,
451398,10,230,230,0,230,230,0,,,
451404,10,473,473,0,473,473,0,,,
451413,10,216,60,156,216,60,156,,,
451459,10,127,25,102,56,11,45,71,14,57
451468,10,406,7,399,406,7,399,,,
451477,10,2397,1960,437,2397,1960,437,,,
451495,10,296,60,236,296,60,236,,,
451501,10,258,82,176,258,82,176,,,
451510,10,607,243,364,557,222,335,50,21,29
451529,10,57,3,54,13,0,13,44,3,41
451547,10,16,0,16,16,0,16,,,
451556,10,1419,501,918,1419,501,918,,,
451565,10,214,30,184,210,29,181,4,1,3
451574,10,144,2,142,126,2,124,18,0,18
451583,10,958,679,279,186,138,48,772,541,231
451626,10,59,12,47,49,12,37,10,0,10
451714,10,349,54,295,299,39,260,50,15,35
451741,10,108,30,78,82,23,59,26,7,19
451750,10,1229,268,961,751,224,527,478,44,434
451820,10,130,74,56,83,51,32,47,23,24
451857,10,99,12,87,99,12,87,,,
451866,10,341,45,296,341,45,296,,,
451918,10,115,10,105,115,10,105,,,
451927,10,387,195,192,351,180,171,36,15,21
452009,10,71,0,71,71,0,71,,,
452072,10,35,4,31,35,4,31,,,
452081,10,968,33,935,968,33,935,,,
452106,10,72,69,3,72,69,3,,,
452124,10,479,88,391,476,87,389,3,1,2
452373,10,265,13,252,265,13,252,,,
452771,10,15,2,13,,,,15,2,13
452780,10,13,0,13,,,,13,0,13
452887,10,73,71,2,73,71,2,,,
452948,10,952,86,866,481,37,444,471,49,422
453163,10,3536,568,2968,214,72,142,3322,496,2826
453215,10,609,125,484,44,14,30,565,111,454
453297,10,32,9,23,32,9,23,,,
453756,10,277,163,114,277,163,114,,,
453792,10,86,4,82,86,4,82,,,
454184,10,384,140,244,351,129,222,33,11,22
454227,10,27744,2720,25024,3495,367,3128,24249,2353,21896
454236,10,679,76,603,247,26,221,432,50,382
454245,10,797,135,662,254,38,216,543,97,446
454458,10,15,4,11,15,4,11,,,
454537,10,76,0,76,76,0,76,,,
454546,10,169,7,162,169,7,162,,,
454555,10,244,17,227,244,17,227,,,
454582,10,218,70,148,65,23,42,153,47,106
454607,10,311,6,305,311,6,305,,,
454616,10,128,107,21,128,107,21,,,
454652,10,146,2,144,146,2,144,,,
454689,10,555,253,302,273,116,157,282,137,145
454698,10,323,93,230,323,93,230,,,
454722,10,35,8,27,32,5,27,3,3,0
454759,10,32,27,5,20,15,5,12,12,0
454768,10,275,45,230,157,31,126,118,14,104
454777,10,205,26,179,134,21,113,71,5,66
454786,10,734,426,308,167,96,71,567,330,237
454795,10,346,85,261,225,56,169,121,29,92
454801,10,179,39,140,179,39,140,,,
454810,10,9606,2767,6839,9606,2767,6839,,,
454829,10,9989,1437,8552,2799,401,2398,7190,1036,6154
454838,10,28,8,20,28,8,20,,,
454856,10,1072,133,939,1072,133,939,,,
454865,10,777,99,678,541,67,474,236,32,204
454874,10,52,5,47,34,4,30,18,1,17
454917,10,745,115,630,464,70,394,281,45,236
454926,10,266,19,247,236,17,219,30,2,28
454935,10,75,1,74,75,1,74,,,
454944,10,197,30,167,197,30,167,,,
454953,10,39,1,38,25,1,24,14,0,14
454962,10,54,0,54,31,0,31,23,0,23
454971,10,215,30,185,124,29,95,91,1,90
454980,10,118,2,116,36,1,35,82,1,81
454999,10,127,1,126,52,1,51,75,0,75
455008,10,210,7,203,98,6,92,112,1,111
455026,10,102,90,12,,,,102,90,12
455062,10,61,2,59,34,1,33,27,1,26
455071,10,100,20,80,,,,100,20,80
455080,10,250,27,223,249,27,222,1,0,1
455099,10,95,60,35,25,14,11,70,46,24
455105,10,76,0,76,76,0,76,,,
455114,10,10403,4891,5512,2590,1277,1313,7813,3614,4199
455141,10,217,5,212,217,5,212,,,
455178,10,108,23,85,105,22,83,3,1,2
455187,10,242,25,217,88,13,75,154,12,142
455196,10,2905,257,2648,2905,257,2648,,,
455202,10,403,48,355,224,12,212,179,36,143
455211,10,313,15,298,313,15,298,,,
455220,10,61,9,52,61,9,52,,,
455257,10,370,370,0,370,370,0,,,
455275,10,255,5,250,255,5,250,,,
455284,10,232,5,227,184,4,180,48,1,47
455327,10,37,1,36,34,1,33,3,0,3
455336,10,194,162,32,194,162,32,,,
455354,10,350,12,338,350,12,338,,,
455381,10,182,0,182,124,0,124,58,0,58
455406,10,593,256,337,590,255,335,3,1,2
455433,10,506,107,399,412,85,327,94,22,72
455460,10,141,31,110,141,31,110,,,
455479,10,668,60,608,574,54,520,94,6,88
455488,10,264,61,203,264,61,203,,,
455512,10,3227,1161,2066,554,205,349,2673,956,1717
455558,10,91,22,69,91,22,69,,,
455628,10,539,156,383,539,156,383,,,
455664,10,3260,562,2698,543,95,448,2717,467,2250
455707,10,54,13,41,54,13,41,,,
455725,10,704,18,686,560,15,545,144,3,141
455734,10,244,53,191,244,53,191,,,
455761,10,325,35,290,213,29,184,112,6,106
455770,10,117,71,46,117,71,46,,,
455798,10,101,4,97,56,3,53,45,1,44
455804,10,132,83,49,72,38,34,60,45,15
455813,10,66,41,25,45,26,19,21,15,6
455831,10,188,21,167,188,21,167,,,
455859,10,268,4,264,231,4,227,37,0,37
455868,10,330,63,267,330,63,267,,,
455877,10,117,6,111,117,6,111,,,
455886,10,159,5,154,70,3,67,89,2,87
455895,10,365,28,337,172,4,168,193,24,169
455901,10,182,17,165,63,7,56,119,10,109
455910,10,54,14,40,54,14,40,,,
455929,10,65,1,64,65,1,64,,,
455965,10,144,13,131,144,13,131,,,
455974,10,114,15,99,114,15,99,,,
455983,10,238,77,161,230,75,155,8,2,6
455992,10,348,111,237,346,110,236,2,1,1
456001,10,70,62,8,70,62,8,,,
456029,10,213,13,200,140,13,127,73,0,73
456038,10,383,38,345,383,38,345,,,
456065,10,155,6,149,152,6,146,3,0,3
456074,10,137,6,131,135,6,129,2,0,2
456135,10,89,0,89,53,0,53,36,0,36
456153,10,80,67,13,80,67,13,,,
456205,10,225,42,183,216,42,174,9,0,9
456214,10,409,291,118,409,291,118,,,
456287,10,114,1,113,114,1,113,,,
456454,10,490,149,341,419,138,281,71,11,60
456481,10,135,63,72,49,19,30,86,44,42
456490,10,149,103,46,50,36,14,99,67,32
456506,10,102,3,99,102,3,99,,,
456515,10,45,1,44,45,1,44,,,
456542,10,689,285,404,593,262,331,96,23,73
456551,10,60,1,59,60,1,59,,,
456579,10,242,88,154,234,86,148,8,2,6
456588,10,47,3,44,33,3,30,14,0,14
456597,10,214,2,212,95,1,94,119,1,118
456621,10,286,70,216,21,11,10,265,59,206
456825,10,124,2,122,118,2,116,6,0,6
456852,10,295,69,226,295,69,226,,,
456922,10,273,57,216,258,54,204,15,3,12
456931,10,327,172,155,315,169,146,12,3,9
456959,10,646,133,513,616,128,488,30,5,25
456968,10,841,19,822,797,19,778,44,0,44
456977,10,39,24,15,39,24,15,,,
457031,10,58,1,57,44,1,43,14,0,14
457077,10,375,33,342,375,33,342,,,
457086,10,179,34,145,136,30,106,43,4,39
457101,10,349,89,260,349,89,260,,,
457110,10,486,73,413,486,73,413,,,
457129,10,1010,108,902,292,29,263,718,79,639
457192,10,29,14,15,29,14,15,,,
457208,10,47,41,6,47,41,6,,,
457226,10,44,31,13,15,10,5,29,21,8
457253,10,186,8,178,27,1,26,159,7,152
457271,10,68,23,45,25,8,17,43,15,28
457299,10,291,42,249,269,38,231,22,4,18
457314,10,109,24,85,109,24,85,,,
457323,10,388,45,343,388,45,343,,,
457332,10,49,2,47,49,2,47,,,
457341,10,185,2,183,176,2,174,9,0,9
457350,10,66,0,66,,,,66,0,66
457378,10,250,115,135,109,36,73,141,79,62
457387,10,373,218,155,186,118,68,187,100,87
457396,10,136,29,107,22,6,16,114,23,91
457402,10,128,110,18,101,91,10,27,19,8
457411,10,229,214,15,190,178,12,39,36,3
457420,10,190,12,178,120,10,110,70,2,68
457439,10,71,1,70,25,1,24,46,0,46
457448,10,81,5,76,81,5,76,,,
457466,10,43,31,12,43,31,12,,,
457475,10,99,4,95,99,4,95,,,
457484,10,135,65,70,62,27,35,73,38,35
457493,10,90,3,87,90,3,87,,,
457527,10,249,34,215,15,1,14,234,33,201
457536,10,649,135,514,649,135,514,,,
457545,10,107,5,102,87,3,84,20,2,18
457554,10,36,0,36,21,0,21,15,0,15
457563,10,244,4,240,244,4,240,,,
457572,10,124,5,119,124,5,119,,,
457581,10,195,3,192,172,3,169,23,0,23
457606,10,107,10,97,107,10,97,,,
457615,10,44,6,38,,,,44,6,38
457624,10,37,5,32,37,5,32,,,
457633,10,266,4,262,110,1,109,156,3,153
457642,10,82,1,81,82,1,81,,,
457679,10,18,2,16,18,2,16,,,
457688,10,48,17,31,21,8,13,27,9,18
457697,10,154,73,81,28,16,12,126,57,69
457721,10,14,0,14,14,0,14,,,
457749,10,89,6,83,89,6,83,,,
457767,10,125,81,44,125,81,44,,,
457776,10,170,13,157,165,12,153,5,1,4
457785,10,52,0,52,52,0,52,,,
457794,10,78,2,76,78,2,76,,,
457800,10,98,11,87,98,11,87,,,
457819,10,688,277,411,,,,688,277,411
457837,10,165,10,155,78,10,68,87,0,87
457855,10,47,4,43,39,3,36,8,1,7
457873,10,99,66,33,44,36,8,55,30,25
457916,10,80,0,80,41,0,41,39,0,39
457925,10,12,7,5,12,7,5,,,
457943,10,62,10,52,62,10,52,,,
457952,10,197,3,194,153,2,151,44,1,43
457989,10,48,1,47,48,1,47,,,
457998,10,72,12,60,38,1,37,34,11,23
458007,10,50,3,47,25,2,23,25,1,24
458034,10,100,16,84,100,16,84,,,
458043,10,110,0,110,71,0,71,39,0,39
458061,10,67,7,60,24,4,20,43,3,40
458070,10,291,8,283,271,8,263,20,0,20
458098,10,120,2,118,110,2,108,10,0,10
458104,10,198,2,196,2,0,2,196,2,194
458113,10,68,30,38,8,5,3,60,25,35
458122,10,10,0,10,10,0,10,,,
458131,10,114,7,107,114,7,107,,,
458140,10,52,38,14,52,38,14,,,
458168,10,67,4,63,67,4,63,,,
458210,10,4302,883,3419,3165,667,2498,1137,216,921
458229,10,2500,525,1975,2043,436,1607,457,89,368
458274,10,205,7,198,149,6,143,56,1,55
458405,10,259,89,170,251,88,163,8,1,7
458423,10,83,20,63,83,20,63,,,
458441,10,335,51,284,327,51,276,8,0,8
458496,10,122,54,68,90,39,51,32,15,17
458681,10,308,57,251,308,57,251,,,
458803,10,154,3,151,117,3,114,37,0,37
458812,10,93,6,87,79,4,75,14,2,12
458821,10,59,2,57,59,2,57,,,
458830,10,142,5,137,108,4,104,34,1,33
458858,10,139,4,135,74,1,73,65,3,62
458867,10,170,6,164,125,5,120,45,1,44
458885,10,402,71,331,23,7,16,379,64,315
458919,10,5235,1070,4165,549,240,309,4686,830,3856
458955,10,442,66,376,23,4,19,419,62,357
458964,10,1936,346,1590,181,72,109,1755,274,1481
458973,10,2504,611,1893,296,150,146,2208,461,1747
458982,10,249,121,128,174,87,87,75,34,41
459019,10,64,4,60,53,3,50,11,1,10
459046,10,51,3,48,35,2,33,16,1,15
459055,10,64,4,60,45,3,42,19,1,18
459064,10,70,5,65,46,3,43,24,2,22
459116,10,94,5,89,94,5,89,,,
459125,10,6,0,6,6,0,6,,,
459170,10,347,28,319,198,25,173,149,3,146
459189,10,175,2,173,31,2,29,144,0,144
459198,10,270,52,218,200,47,153,70,5,65
459204,10,4188,529,3659,4188,529,3659,,,
459213,10,2708,554,2154,2708,554,2154,,,
459231,10,228,26,202,228,26,202,,,
459259,10,462,139,323,267,45,222,195,94,101
459268,10,314,41,273,205,33,172,109,8,101
459277,10,356,19,337,356,19,337,,,
459286,10,222,31,191,179,28,151,43,3,40
459295,10,74,0,74,32,0,32,42,0,42
459301,10,112,6,106,89,3,86,23,3,20
459310,10,77,11,66,77,11,66,,,
459329,10,242,138,104,242,138,104,,,
459347,10,86,3,83,30,2,28,56,1,55
459374,10,123,2,121,41,0,41,82,2,80
459392,10,165,5,160,99,3,96,66,2,64
459408,10,46,8,38,32,3,29,14,5,9
459417,10,74,55,19,68,49,19,6,6,0
459426,10,177,5,172,177,5,172,,,
459462,10,337,288,49,337,288,49,,,
459499,10,29,5,24,29,5,24,,,
459514,10,79,14,65,79,14,65,,,
459523,10,19,1,18,19,1,18,,,
459532,10,75,0,75,2,0,2,73,0,73
459541,10,34,2,32,17,2,15,17,0,17
459550,10,130,2,128,116,2,114,14,0,14
459578,10,125,31,94,92,22,70,33,9,24
459727,10,2251,582,1669,1116,275,841,1135,307,828
459736,10,1248,495,753,1102,449,653,146,46,100
459745,10,699,106,593,420,54,366,279,52,227
459824,10,1696,692,1004,1339,604,735,357,88,269
459842,10,652,84,568,367,58,309,285,26,259
459851,10,351,45,306,193,29,164,158,16,142
459949,10,6893,2430,4463,3560,1234,2326,3333,1196,2137
459958,10,300,60,240,300,60,240,,,
459967,10,615,219,396,615,219,396,,,
459985,10,509,255,254,509,255,254,,,
459994,10,10426,3701,6725,974,488,486,9452,3213,6239
460011,10,161,0,161,113,0,113,48,0,48
460020,10,438,88,350,438,88,350,,,
460093,10,45,1,44,45,1,44,,,
460109,10,121,2,119,121,2,119,,,
460118,10,102,1,101,102,1,101,,,
460127,10,80,4,76,80,4,76,,,
460136,10,922,131,791,922,131,791,,,
460145,10,373,220,153,373,220,153,,,
460172,10,642,591,51,640,589,51,2,2,0
460181,10,650,81,569,650,81,569,,,
460190,10,318,39,279,318,39,279,,,
460206,10,488,110,378,488,110,378,,,
460349,10,2349,679,1670,721,200,521,1628,479,1149
460376,10,17,9,8,13,7,6,4,2,2
460385,10,41,6,35,41,6,35,,,
460394,10,7694,3007,4687,1375,590,785,6319,2417,3902
460464,10,8756,3855,4901,1543,809,734,7213,3046,4167
460482,10,184,18,166,184,18,166,,,
460516,10,130,7,123,130,7,123,,,
460525,10,113,8,105,113,8,105,,,
460534,10,393,13,380,393,13,380,,,
460543,10,1839,1759,80,1839,1759,80,,,
460677,10,377,84,293,309,69,240,68,15,53
460701,10,214,27,187,64,7,57,150,20,130
460738,10,2513,297,2216,1152,122,1030,1361,175,1186
460756,10,354,25,329,300,23,277,54,2,52
460765,10,41,0,41,41,0,41,,,
460808,10,25,5,20,25,5,20,,,
460817,10,175,50,125,170,50,120,5,0,5
460826,10,505,119,386,504,119,385,1,0,1
460835,10,310,92,218,306,91,215,4,1,3
460862,10,249,14,235,120,5,115,129,9,120
460871,10,715,77,638,275,28,247,440,49,391
460914,10,364,3,361,364,3,361,,,
460932,10,44,1,43,44,1,43,,,
460969,10,238,19,219,238,19,219,,,
460978,10,281,6,275,138,2,136,143,4,139
460987,10,111,2,109,111,2,109,,,
460996,10,161,1,160,106,0,106,55,1,54
461014,10,1199,85,1114,1199,85,1114,,,
461023,10,581,81,500,560,76,484,21,5,16
461032,10,162,85,77,63,31,32,99,54,45
461087,10,1039,521,518,162,61,101,877,460,417
461111,10,35,30,5,24,22,2,11,8,3
461120,10,70,37,33,66,35,31,4,2,2
461139,10,72,16,56,72,16,56,,,
461148,10,1261,684,577,1261,684,577,,,
461175,10,237,15,222,175,13,162,62,2,60
461193,10,281,8,273,275,8,267,6,0,6
461218,10,676,51,625,676,51,625,,,
461245,10,103,47,56,43,18,25,60,29,31
461254,10,26,5,21,26,5,21,,,
461263,10,124,9,115,124,9,115,,,
461272,10,71,0,71,47,0,47,24,0,24
461281,10,111,9,102,75,8,67,36,1,35
461306,10,101,23,78,24,5,19,77,18,59
461315,10,79,18,61,36,13,23,43,5,38
461324,10,774,178,596,738,166,572,36,12,24
461333,10,6,5,1,,,,6,5,1
461342,10,147,0,147,95,0,95,52,0,52
461379,10,34,1,33,4,0,4,30,1,29
461388,10,58,17,41,58,17,41,,,
461412,10,120,36,84,,,,120,36,84
461421,10,233,12,221,231,12,219,2,0,2
461430,10,681,632,49,,,,681,632,49
461485,10,142,120,22,46,38,8,96,82,14
461494,10,187,21,166,122,13,109,65,8,57
461500,10,12,4,8,4,2,2,8,2,6
461528,10,235,139,96,76,38,38,159,101,58
461537,10,39,1,38,32,1,31,7,0,7
461555,10,105,7,98,105,7,98,,,
461573,10,100,98,2,100,98,2,,,
461582,10,162,3,159,162,3,159,,,
461591,10,141,9,132,141,9,132,,,
461607,10,76,8,68,39,5,34,37,3,34
461625,10,21,20,1,21,20,1,,,
461643,10,32,4,28,32,4,28,,,
461652,10,71,5,66,71,5,66,,,
461689,10,385,33,352,385,33,352,,,
461704,10,170,13,157,170,13,157,,,
461713,10,52,0,52,19,0,19,33,0,33
461722,10,50,2,48,50,2,48,,,
461740,10,40,29,11,40,29,11,,,
461759,10,163,91,72,115,63,52,48,28,20
461768,10,235,6,229,235,6,229,,,
461786,10,27,0,27,27,0,27,,,
461795,10,821,520,301,590,403,187,231,117,114
461810,10,19,5,14,16,4,12,3,1,2
461829,10,79,9,70,79,9,70,,,
461838,10,241,5,236,96,3,93,145,2,143
461847,10,66,66,0,66,66,0,,,
461856,10,185,60,125,185,60,125,,,
461865,10,33,5,28,33,5,28,,,
461874,10,87,9,78,87,9,78,,,
461883,10,143,64,79,126,57,69,17,7,10
461892,10,110,11,99,110,11,99,,,
461908,10,107,2,105,106,1,105,1,1,0
461917,10,192,5,187,112,2,110,80,3,77
461926,10,156,2,154,119,2,117,37,0,37
461944,10,64,1,63,64,1,63,,,
461953,10,56,4,52,44,2,42,12,2,10
461962,10,197,134,63,166,104,62,31,30,1
461999,10,148,4,144,136,4,132,12,0,12
462008,10,293,25,268,185,20,165,108,5,103
462017,10,127,17,110,127,17,110,,,
462035,10,427,168,259,140,10,130,287,158,129
462044,10,95,24,71,41,13,28,54,11,43
462053,10,91,7,84,91,7,84,,,
462062,10,114,3,111,67,2,65,47,1,46
462071,10,148,37,111,145,37,108,3,0,3
462336,10,87,3,84,86,3,83,1,0,1
462345,10,19,0,19,10,0,10,9,0,9
462354,10,292,147,145,266,126,140,26,21,5
463056,10,1548,747,801,1420,676,744,128,71,57
464226,10,909,560,349,813,489,324,96,71,25
466921,10,409,27,382,108,8,100,301,19,282
466930,10,1923,259,1664,496,68,428,1427,191,1236
467094,10,146,0,146,146,0,146,,,
467368,10,128,11,117,128,11,117,,,
467863,10,206,41,165,146,27,119,60,14,46
467872,10,233,4,229,175,3,172,58,1,57
467906,10,124,5,119,81,3,78,43,2,41
468246,10,139,7,132,139,7,132,,,
468255,10,25,2,23,25,2,23,,,
468291,10,75,5,70,75,5,70,,,
468769,10,132,124,8,132,124,8,,,
468848,10,840,385,455,840,385,455,,,
468893,10,126,4,122,116,4,112,10,0,10
468909,10,1048,417,631,1048,417,631,,,
468963,10,257,228,29,257,228,29,,,
469416,10,282,74,208,191,59,132,91,15,76
469610,10,27,5,22,27,5,22,,,
469629,10,143,124,19,143,124,19,,,
469911,10,54,3,51,54,3,51,,,
469957,10,121,11,110,121,11,110,,,
470038,10,1199,485,714,1199,485,714,,,
470047,10,41,7,34,41,7,34,,,
470296,10,19,0,19,19,0,19,,,
470393,10,123,8,115,51,5,46,72,3,69
474863,10,2009,389,1620,836,175,661,1173,214,959
474915,10,491,15,476,284,8,276,207,7,200
474924,10,203,2,201,47,0,47,156,2,154
475015,10,163,4,159,163,4,159,,,
475024,10,266,97,169,266,97,169,,,
475033,10,3201,780,2421,,,,3201,780,2421
475060,10,249,22,227,242,20,222,7,2,5
475121,10,6724,1376,5348,3903,864,3039,2821,512,2309
475176,10,601,278,323,601,278,323,,,
475200,10,227,62,165,36,7,29,191,55,136
475228,10,70,28,42,70,28,42,,,
475273,10,529,105,424,113,22,91,416,83,333
475282,10,81,22,59,81,22,59,,,
475325,10,211,12,199,211,12,199,,,
475398,10,173,93,80,15,7,8,158,86,72
475404,10,119,1,118,78,1,77,41,0,41
475413,10,65,7,58,43,6,37,22,1,21
475422,10,106,6,100,33,1,32,73,5,68
475431,10,60,4,56,60,4,56,,,
475468,10,282,7,275,112,5,107,170,2,168
475477,10,183,54,129,29,7,22,154,47,107
475486,10,329,43,286,329,43,286,,,
475495,10,1265,390,875,1264,390,874,1,0,1
475547,10,125,20,105,76,13,63,49,7,42
475556,10,164,6,158,102,3,99,62,3,59
475565,10,867,437,430,772,391,381,95,46,49
475574,10,43,16,27,19,6,13,24,10,14
475608,10,181,121,60,96,65,31,85,56,29
475635,10,20,3,17,4,0,4,16,3,13
475653,10,32,4,28,27,2,25,5,2,3
475662,10,41,1,40,18,1,17,23,0,23
475705,10,20,7,13,20,7,13,,,
475714,10,452,362,90,375,302,73,77,60,17
475723,10,492,310,182,131,61,70,361,249,112
475732,10,1372,134,1238,334,27,307,1038,107,931
475741,10,244,18,226,87,2,85,157,16,141
475839,10,263,115,148,116,55,61,147,60,87
476063,10,257,240,17,257,240,17,,,
476179,10,160,9,151,113,8,105,47,1,46
476230,10,33,2,31,33,2,31,,,
476294,10,150,15,135,41,3,38,109,12,97
476355,10,46,23,23,46,23,23,,,
476489,10,78,68,10,78,68,10,,,
476498,10,150,95,55,150,95,55,,,
476513,10,59,1,58,59,1,58,,,
476540,10,145,4,141,125,2,123,20,2,18
476559,10,152,2,150,146,1,145,6,1,5
476568,10,14,11,3,14,11,3,,,
476595,10,78,13,65,78,13,65,,,
476601,10,81,81,0,81,81,0,,,
476610,10,47,32,15,47,32,15,,,
476629,10,151,5,146,151,5,146,,,
476683,10,329,17,312,329,17,312,,,
476692,10,36,36,0,36,36,0,,,
476708,10,145,111,34,109,84,25,36,27,9
476717,10,576,576,0,576,576,0,,,
476726,10,610,105,505,610,105,505,,,
476735,10,48,23,25,14,9,5,34,14,20
476753,10,217,7,210,126,5,121,91,2,89
476780,10,61,7,54,42,6,36,19,1,18
476799,10,399,59,340,399,59,340,,,
476805,10,54,1,53,54,1,53,,,
476814,10,588,409,179,,,,588,409,179
476841,10,247,31,216,129,18,111,118,13,105
476850,10,61,42,19,61,42,19,,,
476869,10,119,6,113,119,6,113,,,
476878,10,69,0,69,12,0,12,57,0,57
476887,10,617,15,602,525,14,511,92,1,91
476896,10,76,3,73,76,3,73,,,
476902,10,88,2,86,57,1,56,31,1,30
476939,10,690,64,626,690,64,626,,,
476948,10,385,311,74,385,311,74,,,
476957,10,11,1,10,9,1,8,2,0,2
476966,10,139,122,17,139,122,17,,,
476975,10,10844,4691,6153,2054,932,1122,8790,3759,5031
476984,10,185,7,178,136,6,130,49,1,48
476993,10,218,2,216,218,2,216,,,
477002,10,56,3,53,55,3,52,1,0,1
477039,10,1329,186,1143,869,113,756,460,73,387
478582,10,153,4,149,112,3,109,41,1,40
478591,10,159,3,156,111,0,111,48,3,45
478616,10,114,10,104,83,7,76,31,3,28
478917,10,55,3,52,55,3,52,,,
478953,10,200,6,194,200,6,194,,,
479062,10,66,63,3,52,49,3,14,14,0
479424,10,309,40,269,309,40,269,,,
479965,10,195,51,144,195,51,144,,,
479974,10,108,27,81,104,27,77,4,0,4
479983,10,101,15,86,101,15,86,,,
479992,10,24,24,0,12,12,0,12,12,0
480000,10,54,35,19,54,35,19,,,
480019,10,800,732,68,720,659,61,80,73,7
480028,10,136,110,26,132,107,25,4,3,1
480037,10,1701,1341,360,1701,1341,360,,,
480073,10,359,73,286,253,47,206,106,26,80
480091,10,8749,1150,7599,5132,549,4583,3617,601,3016
480125,10,391,11,380,206,4,202,185,7,178
480161,10,11,0,11,11,0,11,,,
480198,10,382,119,263,272,88,184,110,31,79
480204,10,466,66,400,466,66,400,,,
480310,10,82,4,78,61,4,57,21,0,21
480347,10,36,3,33,36,3,33,,,
480471,10,686,193,493,686,193,493,,,
480523,10,112,3,109,112,3,109,,,
480532,10,28,1,27,28,1,27,,,
480550,10,51,2,49,51,2,49,,,
480569,10,1461,662,799,576,226,350,885,436,449
480657,10,695,73,622,372,39,333,323,34,289
480693,10,62,20,42,59,19,40,3,1,2
480727,10,30,26,4,30,26,4,,,
480781,10,202,137,65,201,136,65,1,1,0
480790,10,1456,739,717,1456,739,717,,,
480824,10,506,49,457,506,49,457,,,
480833,10,784,64,720,784,64,720,,,
480842,10,23,6,17,23,6,17,,,
480851,10,142,74,68,142,74,68,,,
480879,10,40,1,39,40,1,39,,,
480888,10,139,41,98,139,41,98,,,
480903,10,502,440,62,439,379,60,63,61,2
480912,10,7,2,5,7,2,5,,,
480921,10,84,66,18,84,66,18,,,
480930,10,117,6,111,83,5,78,34,1,33
480967,10,205,64,141,102,39,63,103,25,78
480976,10,59,3,56,59,3,56,,,
480985,10,258,1,257,256,1,255,2,0,2
480994,10,100,3,97,74,3,71,26,0,26
481003,10,139,126,13,139,126,13,,,
481021,10,51,45,6,45,40,5,6,5,1
481030,10,27,15,12,14,8,6,13,7,6
481049,10,26,3,23,26,3,23,,,
481058,10,315,167,148,179,81,98,136,86,50
481085,10,137,7,130,137,7,130,,,
481094,10,197,18,179,195,18,177,2,0,2
481100,10,106,20,86,25,5,20,81,15,66
481128,10,115,9,106,96,6,90,19,3,16
481137,10,89,47,42,89,47,42,,,
481146,10,179,23,156,101,13,88,78,10,68
481155,10,218,87,131,218,87,131,,,
481182,10,36,4,32,36,4,32,,,
481191,10,206,16,190,206,16,190,,,
481207,10,125,34,91,125,34,91,,,
481225,10,17,10,7,15,10,5,2,0,2
481243,10,270,2,268,104,0,104,166,2,164
481252,10,60,8,52,60,8,52,,,
481289,10,76,17,59,76,17,59,,,
481298,10,44,4,40,44,4,40,,,
481313,10,80,1,79,49,1,48,31,0,31
481322,10,52,3,49,16,0,16,36,3,33
481331,10,93,77,16,91,75,16,2,2,0
481340,10,46,1,45,46,1,45,,,
481368,10,51,2,49,51,2,49,,,
481386,10,308,40,268,,,,308,40,268
481401,10,669,444,225,110,79,31,559,365,194
481410,10,77,77,0,77,77,0,,,
481429,10,158,13,145,158,13,145,,,
481438,10,69,69,0,69,69,0,,,
481447,10,31,3,28,18,2,16,13,1,12
481456,10,17,1,16,5,0,5,12,1,11
481465,10,52,1,51,47,1,46,5,0,5
481474,10,148,3,145,127,3,124,21,0,21
481483,10,164,4,160,98,2,96,66,2,64
481508,10,38,1,37,37,1,36,1,0,1
481517,10,90,5,85,50,4,46,40,1,39
481526,10,167,1,166,159,1,158,8,0,8
481535,10,31,17,14,31,17,14,,,
481571,10,3,0,3,3,0,3,,,
481678,10,68,2,66,43,0,43,25,2,23
481720,10,43,3,40,31,3,28,12,0,12
481739,10,69,7,62,44,6,38,25,1,24
481748,10,127,3,124,86,3,83,41,0,41
481775,10,198,57,141,198,57,141,,,
481845,10,78,4,74,54,3,51,24,1,23
481863,10,79,2,77,79,2,77,,,
481890,10,94,4,90,94,4,90,,,
481906,10,71,1,70,71,1,70,,,
481960,10,62,55,7,62,55,7,,,
482015,10,938,580,358,938,580,358,,,
482060,10,254,20,234,254,20,234,,,
482097,10,385,205,180,377,204,173,8,1,7
482149,10,8961,3034,5927,7113,2448,4665,1848,586,1262
482158,10,7843,3428,4415,4542,2171,2371,3301,1257,2044
482167,10,202,4,198,77,4,73,125,0,125
482176,10,259,14,245,223,11,212,36,3,33
482185,10,89,66,23,89,66,23,,,
482194,10,103,21,82,85,18,67,18,3,15
482200,10,74,13,61,74,13,61,,,
482228,10,186,118,68,47,33,14,139,85,54
482246,10,20,16,4,20,16,4,,,
482255,10,286,253,33,230,206,24,56,47,9
482291,10,1204,512,692,1204,512,692,,,
482413,10,1030,481,549,529,283,246,501,198,303
482422,10,128,78,50,44,25,19,84,53,31
482431,10,1662,981,681,853,514,339,809,467,342
482440,10,52,21,31,17,5,12,35,16,19
482459,10,506,248,258,209,89,120,297,159,138
482468,10,993,396,597,471,189,282,522,207,315
482477,10,22994,8037,14957,8224,2972,5252,14770,5065,9705
482538,10,27,22,5,12,9,3,15,13,2
482547,10,30,19,11,18,14,4,12,5,7
482556,10,127,72,55,67,35,32,60,37,23
482565,10,29,14,15,11,5,6,18,9,9
482574,10,404,186,218,188,95,93,216,91,125
482608,10,153,68,85,55,22,33,98,46,52
482617,10,19,8,11,12,4,8,7,4,3
482635,10,229,123,106,108,62,46,121,61,60
482653,10,139,70,69,50,29,21,89,41,48
482680,10,18972,8005,10967,12246,5351,6895,6726,2654,4072
482699,10,1771,596,1175,1013,396,617,758,200,558
482705,10,10918,4691,6227,3358,1371,1987,7560,3320,4240
482936,10,1562,1294,268,1351,1125,226,211,169,42
482963,10,341,30,311,341,30,311,,,
482981,10,169,137,32,140,110,30,29,27,2
482990,10,348,37,311,348,37,311,,,
483009,10,253,32,221,253,32,221,,,
483018,10,133,41,92,133,41,92,,,
483036,10,2219,893,1326,847,338,509,1372,555,817
483045,10,9614,3704,5910,1772,654,1118,7842,3050,4792
483054,10,98,77,21,98,77,21,,,
483106,10,184,32,152,136,22,114,48,10,38
483124,10,57848,21274,36574,20244,6534,13710,37604,14740,22864
483212,10,3956,1640,2316,1700,694,1006,2256,946,1310
483230,10,189,185,4,134,131,3,55,54,1
483258,10,28,23,5,28,23,5,,,
483276,10,59,52,7,59,52,7,,,
483328,10,126,12,114,79,10,69,47,2,45
483337,10,184,5,179,131,4,127,53,1,52
483346,10,53,3,50,53,3,50,,,
483355,10,147,6,141,147,6,141,,,
483364,10,112,5,107,112,5,107,,,
483373,10,113,15,98,59,10,49,54,5,49
483382,10,204,199,5,204,199,5,,,
483425,10,34,0,34,34,0,34,,,
483443,10,385,327,58,385,327,58,,,
483470,10,20,2,18,20,2,18,,,
483504,10,330,110,220,330,110,220,,,
483513,10,50,36,14,50,36,14,,,
483559,10,53,14,39,31,11,20,22,3,19
483577,10,33,1,32,16,0,16,17,1,16
483595,10,5150,1315,3835,3291,843,2448,1859,472,1387
483647,10,34,2,32,34,2,32,,,
483708,10,279,52,227,87,9,78,192,43,149
483726,10,28,1,27,9,0,9,19,1,18
483735,10,67,4,63,37,3,34,30,1,29
483744,10,56,46,10,56,46,10,,,
483753,10,36,31,5,9,9,0,27,22,5
483780,10,365,241,124,333,224,109,32,17,15
483799,10,59,15,44,59,15,44,,,
483814,10,518,50,468,471,43,428,47,7,40
483823,10,675,502,173,675,502,173,,,
483841,10,25,4,21,25,4,21,,,
483850,10,7,1,6,7,1,6,,,
483869,10,81,23,58,81,23,58,,,
483878,10,198,24,174,198,24,174,,,
483887,10,49,11,38,49,11,38,,,
483896,10,244,8,236,43,0,43,201,8,193
483911,10,22,1,21,22,1,21,,,
483920,10,201,113,88,201,113,88,,,
483948,10,65,52,13,45,35,10,20,17,3
483957,10,55,14,41,55,14,41,,,
483975,10,731,358,373,724,354,370,7,4,3
484002,10,1352,108,1244,1288,100,1188,64,8,56
484011,10,118,22,96,89,22,67,29,0,29
484020,10,53,41,12,31,25,6,22,16,6
484039,10,152,125,27,152,125,27,,,
484048,10,13,10,3,13,10,3,,,
484057,10,238,12,226,64,3,61,174,9,165
484066,10,218,16,202,218,16,202,,,
484075,10,44,35,9,30,23,7,14,12,2
484084,10,77,2,75,51,1,50,26,1,25
484093,10,152,4,148,106,2,104,46,2,44
484109,10,111,1,110,111,1,110,,,
484127,10,109,19,90,109,19,90,,,
484136,10,10,2,8,10,2,8,,,
484163,10,181,52,129,108,29,79,73,23,50
484172,10,16,2,14,16,2,14,,,
484190,10,32,24,8,32,24,8,,,
484206,10,237,7,230,116,5,111,121,2,119
484233,10,213,124,89,,,,213,124,89
484330,10,40,0,40,40,0,40,,,
484349,10,91,5,86,91,5,86,,,
484358,10,53,2,51,53,2,51,,,
484367,10,212,31,181,212,31,181,,,
484376,10,322,38,284,322,38,284,,,
484394,10,205,30,175,139,21,118,66,9,57
484473,10,5168,2389,2779,2454,1156,1298,2714,1233,1481
484604,10,476,9,467,251,4,247,225,5,220
484613,10,85362,24519,60843,85362,24519,60843,,,
484631,10,1591,924,667,1591,924,667,,,
484710,10,80,52,28,80,52,28,,,
484756,10,134,61,73,134,61,73,,,
484826,10,44,0,44,44,0,44,,,
484835,10,84,21,63,84,21,63,,,
484844,10,636,282,354,604,265,339,32,17,15
484862,10,251,112,139,115,56,59,136,56,80
484871,10,114,114,0,114,114,0,,,
484899,10,212,3,209,212,3,209,,,
484905,10,4120,1335,2785,2319,774,1545,1801,561,1240
484923,10,45,0,45,45,0,45,,,
484932,10,1573,637,936,973,363,610,600,274,326
484950,10,105,13,92,105,13,92,,,
484996,10,161,3,158,161,3,158,,,
485014,10,85,2,83,60,1,59,25,1,24
485032,10,206,9,197,124,7,117,82,2,80
485111,10,7014,2632,4382,2743,1197,1546,4271,1435,2836
485139,10,262,217,45,262,217,45,,,
485166,10,122,19,103,122,19,103,,,
485236,10,99,2,97,31,1,30,68,1,67
485272,10,1123,148,975,565,88,477,558,60,498
485306,10,16,0,16,16,0,16,,,
485342,10,345,183,162,171,118,53,174,65,109
485360,10,22,2,20,22,2,20,,,
485379,10,278,56,222,278,56,222,,,
485388,10,355,46,309,355,46,309,,,
485397,10,142,9,133,112,9,103,30,0,30
485403,10,102,21,81,53,10,43,49,11,38
485412,10,96,14,82,96,14,82,,,
485458,10,4021,1466,2555,688,225,463,3333,1241,2092
485476,10,82,3,79,82,3,79,,,
485485,10,147,18,129,147,18,129,,,
485494,10,90,74,16,90,74,16,,,
485500,10,253,238,15,16,16,0,237,222,15
485519,10,390,274,116,190,133,57,200,141,59
485546,10,446,242,204,203,118,85,243,124,119
485564,10,316,34,282,311,34,277,5,0,5
485573,10,202,33,169,186,32,154,16,1,15
485591,10,40,0,40,40,0,40,,,
485607,10,32,3,29,23,2,21,9,1,8
485698,10,121,106,15,118,103,15,3,3,0
485704,10,5,0,5,2,0,2,3,0,3
485768,10,858,432,426,856,432,424,2,0,2
485801,10,84,12,72,84,12,72,,,
485856,10,41,13,28,15,6,9,26,7,19
485874,10,167,6,161,99,4,95,68,2,66
485926,10,216,63,153,210,62,148,6,1,5
485953,10,59,51,8,59,51,8,,,
485962,10,37,25,12,18,12,6,19,13,6
485999,10,96,96,0,96,96,0,,,
486017,10,32,32,0,32,32,0,,,
486026,10,111,111,0,111,111,0,,,
486053,10,205,149,56,162,121,41,43,28,15
486080,10,12,8,4,12,8,4,,,
486105,10,7,0,7,7,0,7,,,
486123,10,26,10,16,26,10,16,,,
486141,10,12,0,12,12,0,12,,,
486150,10,145,52,93,96,40,56,49,12,37
486169,10,65,50,15,65,50,15,,,
486196,10,184,184,0,184,184,0,,,
486202,10,30,3,27,30,3,27,,,
486239,10,211,77,134,176,65,111,35,12,23
486248,10,118,35,83,118,35,83,,,
486257,10,308,127,181,215,90,125,93,37,56
486284,10,328,100,228,284,79,205,44,21,23
486309,10,4,1,3,4,1,3,,,
486345,10,175,173,2,77,76,1,98,97,1
486354,10,47,15,32,47,15,32,,,
486372,10,107,83,24,73,62,11,34,21,13
486381,10,208,23,185,208,23,185,,,
486390,10,89,45,44,89,45,44,,,
486406,10,17,4,13,17,4,13,,,
486415,10,261,64,197,261,64,197,,,
486424,10,142,4,138,131,1,130,11,3,8
486433,10,152,37,115,136,34,102,16,3,13
486442,10,48,1,47,48,1,47,,,
486460,10,24,5,19,24,5,19,,,
486488,10,23,18,5,20,16,4,3,2,1
486497,10,42,40,2,40,38,2,2,2,0
486503,10,53,0,53,53,0,53,,,
486512,10,304,155,149,304,155,149,,,
486530,10,158,1,157,158,1,157,,,
486558,10,265,240,25,200,181,19,65,59,6
486567,10,232,13,219,228,12,216,4,1,3
486576,10,126,30,96,126,30,96,,,
486594,10,33,14,19,13,5,8,20,9,11
486619,10,135,5,130,103,5,98,32,0,32
486691,10,97,2,95,64,1,63,33,1,32
486707,10,84,2,82,84,2,82,,,
486716,10,92,2,90,92,2,90,,,
486752,10,96,4,92,96,4,92,,,
486770,10,123,30,93,123,30,93,,,
486798,10,1273,1154,119,1273,1154,119,,,
486813,10,542,111,431,542,111,431,,,
486822,10,821,101,720,821,101,720,,,
486840,10,42899,20901,21998,29998,14592,15406,12901,6309,6592
486859,10,33,0,33,33,0,33,,,
486868,10,8,0,8,8,0,8,,,
486877,10,8,0,8,8,0,8,,,
486886,10,30,0,30,15,0,15,15,0,15
486901,10,1162,530,632,980,448,532,182,82,100
486938,10,543,95,448,246,35,211,297,60,237
486947,10,549,68,481,242,30,212,307,38,269
486956,10,1219,167,1052,543,72,471,676,95,581
486965,10,231,85,146,231,85,146,,,
486983,10,61,16,45,61,16,45,,,
487010,10,3235,1164,2071,3019,1109,1910,216,55,161
487047,10,56,2,54,56,2,54,,,
487065,10,77,6,71,77,6,71,,,
487083,10,29,0,29,29,0,29,,,
487092,10,1067,500,567,1066,499,567,1,1,0
487153,10,45,11,34,45,11,34,,,
487162,10,4246,1364,2882,1138,350,788,3108,1014,2094
487232,10,119,0,119,119,0,119,,,
487302,10,561,118,443,560,118,442,1,0,1
487311,10,348,325,23,348,325,23,,,
487320,10,10107,7139,2968,5226,4119,1107,4881,3020,1861
487348,10,111,4,107,47,3,44,64,1,63
487375,10,938,118,820,604,74,530,334,44,290
487384,10,608,195,413,608,195,413,,,
487393,10,722,308,414,722,308,414,,,
487409,10,668,258,410,668,258,410,,,
487418,10,814,311,503,814,311,503,,,
487427,10,571,198,373,571,198,373,,,
487436,10,575,107,468,575,107,468,,,
487445,10,587,214,373,587,214,373,,,
487454,10,619,208,411,619,208,411,,,
487472,10,659,245,414,659,245,414,,,
487481,10,1441,311,1130,1441,311,1130,,,
487490,10,1109,216,893,1109,216,893,,,
487506,10,85,2,83,27,0,27,58,2,56
487524,10,3311,1247,2064,2510,1001,1509,801,246,555
487533,10,121,1,120,44,1,43,77,0,77
487588,10,362,27,335,362,27,335,,,
487597,10,1340,1286,54,1340,1286,54,,,
487603,10,1323,560,763,460,173,287,863,387,476
487621,10,18,16,2,17,15,2,1,1,0
487649,10,215,65,150,210,62,148,5,3,2
487658,10,90,67,23,90,67,23,,,
487676,10,197,12,185,160,8,152,37,4,33
487746,10,28,28,0,28,28,0,,,
487773,10,44,6,38,32,3,29,12,3,9
487791,10,505,463,42,298,275,23,207,188,19
487807,10,56,34,22,35,23,12,21,11,10
487816,10,16,0,16,16,0,16,,,
487852,10,13,4,9,,,,13,4,9
487861,10,329,38,291,248,30,218,81,8,73
487889,10,65,5,60,65,5,60,,,
487898,10,16,13,3,12,11,1,4,2,2
487904,10,25,19,6,25,19,6,,,
487922,10,65,0,65,48,0,48,17,0,17
487959,10,48,0,48,24,0,24,24,0,24
487968,10,55,3,52,55,3,52,,,
487977,10,2061,166,1895,1665,42,1623,396,124,272
487995,10,142,36,106,73,19,54,69,17,52
488004,10,20,20,0,20,20,0,,,
488013,10,83,2,81,83,2,81,,,
488022,10,72,40,32,44,23,21,28,17,11
488031,10,208,105,103,206,104,102,2,1,1
488059,10,175,61,114,175,61,114,,,
488068,10,104,14,90,22,5,17,82,9,73
488077,10,3009,2939,70,2196,2144,52,813,795,18
488101,10,113,113,0,113,113,0,,,
488110,10,39,0,39,29,0,29,10,0,10
488129,10,25,0,25,,,,25,0,25
488138,10,41,2,39,41,2,39,,,
488147,10,71,1,70,71,1,70,,,
488174,10,28,15,13,22,12,10,6,3,3
488183,10,19,2,17,19,2,17,,,
488192,10,75,74,1,,,,75,74,1
488217,10,175,5,170,175,5,170,,,
488226,10,19,9,10,19,9,10,,,
488253,10,83,58,25,55,35,20,28,23,5
488262,10,25,16,9,19,15,4,6,1,5
488271,10,95,3,92,95,3,92,,,
488280,10,34,23,11,34,23,11,,,
488299,10,74,34,40,21,7,14,53,27,26
488305,10,112,67,45,86,48,38,26,19,7
488314,10,54,54,0,54,54,0,,,
488332,10,197,27,170,197,27,170,,,
488350,10,99,99,0,99,99,0,,,
488369,10,51,43,8,51,43,8,,,
488378,10,83,3,80,82,3,79,1,0,1
488387,10,325,68,257,105,26,79,220,42,178
488396,10,37,30,7,6,5,1,31,25,6
488411,10,124,1,123,124,1,123,,,
488420,10,145,13,132,,,,145,13,132
488439,10,104,81,23,58,44,14,46,37,9
488448,10,124,82,42,119,79,40,5,3,2
488527,10,718,349,369,717,348,369,1,1,0
488554,10,636,290,346,636,290,346,,,
488563,10,10,8,2,10,8,2,,,
488572,10,282,137,145,282,137,145,,,
488590,10,13,4,9,13,4,9,,,
488651,10,181,20,161,109,14,95,72,6,66
488679,10,10008,2780,7228,9511,2643,6868,497,137,360
488730,10,6704,2770,3934,1121,520,601,5583,2250,3333
488749,10,131,19,112,119,16,103,12,3,9
488776,10,205,78,127,128,44,84,77,34,43
488785,10,267,145,122,245,131,114,22,14,8
488800,10,943,279,664,920,276,644,23,3,20
488828,10,11,5,6,11,5,6,,,
488837,10,170,143,27,170,143,27,,,
488846,10,39048,22831,16217,11703,6859,4844,27345,15972,11373
488891,10,293,95,198,293,95,198,,,
488907,10,40,4,36,29,3,26,11,1,10
488916,10,30,0,30,30,0,30,,,
488934,10,3980,2163,1817,663,364,299,3317,1799,1518
488952,10,60,3,57,60,3,57,,,
488961,10,58,2,56,58,2,56,,,
488970,10,63,1,62,63,1,62,,,
488989,10,160,10,150,112,7,105,48,3,45
488998,10,123,22,101,121,22,99,2,0,2
489122,10,28,4,24,14,0,14,14,4,10
489131,10,45,10,35,29,6,23,16,4,12
489140,10,63,12,51,32,5,27,31,7,24
489159,10,170,1,169,97,0,97,73,1,72
489201,10,7768,3104,4664,2061,948,1113,5707,2156,3551
489238,10,131,12,119,84,6,78,47,6,41
489247,10,55,9,46,21,4,17,34,5,29
489256,10,217,198,19,215,196,19,2,2,0
489283,10,609,89,520,609,89,520,,,
489335,10,36,21,15,3,1,2,33,20,13
489344,10,251,22,229,90,8,82,161,14,147
489353,10,437,95,342,267,59,208,170,36,134
489371,10,199,178,21,199,178,21,,,
489779,10,43458,15815,27643,10571,3524,7047,32887,12291,20596
489812,10,50,0,50,50,0,50,,,
489830,10,67,2,65,67,2,65,,,
489858,10,617,204,413,612,201,411,5,3,2
489937,10,988,588,400,419,230,189,569,358,211
490018,10,18,9,9,18,9,9,,,
490045,10,193,92,101,108,60,48,85,32,53
490054,10,238,85,153,151,66,85,87,19,68
490063,10,352,176,176,352,176,176,,,
490081,10,150,74,76,140,73,67,10,1,9
490090,10,49,26,23,8,4,4,41,22,19
490106,10,374,147,227,105,33,72,269,114,155
490115,10,38,26,12,38,26,12,,,
490124,10,8,4,4,8,4,4,,,
490133,10,4123,2271,1852,4001,2204,1797,122,67,55
490142,10,28,3,25,14,3,11,14,0,14
490151,10,89,6,83,55,3,52,34,3,31
490160,10,101,16,85,101,16,85,,,
490197,10,48,9,39,48,9,39,,,
490203,10,129,6,123,54,2,52,75,4,71
490212,10,21,1,20,21,1,20,,,
490221,10,26,4,22,13,2,11,13,2,11
490230,10,257,119,138,253,117,136,4,2,2
490249,10,25,24,1,25,24,1,,,
490258,10,120,26,94,120,26,94,,,
490267,10,9,5,4,3,3,0,6,2,4
490276,10,119,119,0,119,119,0,,,
490285,10,618,490,128,618,490,128,,,
490294,10,152,48,104,132,38,94,20,10,10
490300,10,86,21,65,39,4,35,47,17,30
490319,10,18,18,0,18,18,0,,,
490328,10,67,67,0,67,67,0,,,
490337,10,106,28,78,43,14,29,63,14,49
490346,10,57,0,57,57,0,57,,,
490373,10,348,175,173,348,175,173,,,
490382,10,38,13,25,38,13,25,,,
490391,10,68,3,65,68,3,65,,,
490407,10,125,0,125,63,0,63,62,0,62
490416,10,20,18,2,20,18,2,,,
490425,10,185,1,184,185,1,184,,,
490434,10,37,0,37,37,0,37,,,
490443,10,107,0,107,107,0,107,,,
490452,10,58,13,45,19,3,16,39,10,29
490461,10,104,3,101,104,3,101,,,
490470,10,26,4,22,26,4,22,,,
490489,10,45,36,9,41,33,8,4,3,1
490498,10,34,26,8,34,26,8,,,
490504,10,46,46,0,46,46,0,,,
490513,10,37,37,0,35,35,0,2,2,0
490522,10,29,0,29,28,0,28,1,0,1
490531,10,32,25,7,15,13,2,17,12,5
490540,10,23,1,22,19,1,18,4,0,4
490559,10,455,23,432,455,23,432,,,
490601,10,645,336,309,645,336,309,,,
490674,10,5,0,5,5,0,5,,,
490692,10,55,47,8,55,47,8,,,
490717,10,80,5,75,80,5,75,,,
490735,10,144,20,124,144,20,124,,,
490744,10,25,20,5,25,20,5,,,
490753,10,28,6,22,28,6,22,,,
490805,10,8794,3609,5185,4915,2326,2589,3879,1283,2596
490814,10,91,9,82,91,9,82,,,
490832,10,293,19,274,237,16,221,56,3,53
490841,10,263,8,255,263,8,255,,,
490869,10,411,44,367,411,44,367,,,
490878,10,430,91,339,430,91,339,,,
490896,10,159,8,151,97,6,91,62,2,60
490948,10,10,7,3,10,7,3,,,
490975,10,379,46,333,350,41,309,29,5,24
491057,10,208,208,0,208,208,0,,,
491066,10,70,0,70,32,0,32,38,0,38
491075,10,15,14,1,15,14,1,,,
491084,10,59,0,59,59,0,59,,,
491136,10,70,5,65,40,4,36,30,1,29
491145,10,102,3,99,75,2,73,27,1,26
491181,10,525,77,448,311,41,270,214,36,178
491190,10,126,24,102,91,20,71,35,4,31
491215,10,52,50,2,52,50,2,,,
491224,10,96,8,88,66,5,61,30,3,27
491233,10,32,0,32,19,0,19,13,0,13
491242,10,61,29,32,61,29,32,,,
491251,10,103,50,53,103,50,53,,,
491260,10,41,0,41,17,0,17,24,0,24
491288,10,630,190,440,59,15,44,571,175,396
491297,10,131,54,77,7,3,4,124,51,73
491394,10,90,84,6,90,84,6,,,
491446,10,161,0,161,161,0,161,,,
491464,10,125,22,103,125,22,103,,,
491473,10,526,387,139,32,2,30,494,385,109
491507,10,66,7,59,66,7,59,,,
491525,10,77,50,27,56,37,19,21,13,8
491534,10,17,1,16,,,,17,1,16
491543,10,104,16,88,69,13,56,35,3,32
491552,10,22,0,22,22,0,22,,,
491570,10,32,0,32,32,0,32,,,
491589,10,31,23,8,6,4,2,25,19,6
491598,10,33,6,27,33,6,27,,,
491613,10,74,74,0,74,74,0,,,
491622,10,85,85,0,85,85,0,,,
491631,10,189,0,189,113,0,113,76,0,76
491640,10,169,169,0,169,169,0,,,
491659,10,81,37,44,81,37,44,,,
491668,10,164,2,162,164,2,162,,,
491677,10,34,21,13,22,14,8,12,7,5
491686,10,37,34,3,37,34,3,,,
491695,10,48,12,36,48,12,36,,,
491701,10,56,11,45,,,,56,11,45
491710,10,63,63,0,63,63,0,,,
491729,10,26,0,26,26,0,26,,,
491738,10,56,9,47,49,5,44,7,4,3
491747,10,19,8,11,19,8,11,,,
491756,10,101,86,15,101,86,15,,,
491765,10,98,98,0,98,98,0,,,
491774,10,137,18,119,91,11,80,46,7,39
491783,10,68,51,17,29,14,15,39,37,2
491792,10,108,3,105,108,3,105,,,
491808,10,167,32,135,100,21,79,67,11,56
491817,10,225,0,225,167,0,167,58,0,58
491826,10,92,0,92,92,0,92,,,
491835,10,90,1,89,90,1,89,,,
491844,10,152,50,102,86,34,52,66,16,50
491853,10,47,0,47,47,0,47,,,
491871,10,17,0,17,9,0,9,8,0,8
491880,10,95,92,3,95,92,3,,,
491899,10,92,7,85,11,1,10,81,6,75
491905,10,118,3,115,118,3,115,,,
491914,10,167,167,0,167,167,0,,,
491923,10,289,3,286,284,2,282,5,1,4
491932,10,33,32,1,33,32,1,,,
491941,10,130,6,124,130,6,124,,,
491950,10,879,128,751,46,8,38,833,120,713
491969,10,21,3,18,21,3,18,,,
491978,10,45,17,28,11,5,6,34,12,22
491996,10,45,3,42,45,3,42,,,
492005,10,70,0,70,55,0,55,15,0,15
492032,10,32,0,32,,,,32,0,32
492069,10,95,58,37,84,54,30,11,4,7
492078,10,127,124,3,,,,127,124,3
492096,10,9,1,8,9,1,8,,,
492139,10,131,109,22,131,109,22,,,
492157,10,94,83,11,94,83,11,,,
492209,10,49,7,42,43,7,36,6,0,6
492281,10,26,22,4,26,22,4,,,
492306,10,122,58,64,,,,122,58,64
492315,10,111,28,83,,,,111,28,83
492324,10,212,22,190,,,,212,22,190
492360,10,47,10,37,23,3,20,24,7,17
492379,10,16,15,1,16,15,1,,,
492421,10,13,13,0,13,13,0,,,
492449,10,537,102,435,537,102,435,,,
492476,10,168,42,126,36,12,24,132,30,102
492591,10,91,70,21,91,70,21,,,
492607,10,114,26,88,30,5,25,84,21,63
492643,10,89,26,63,89,26,63,,,
492652,10,43,32,11,43,32,11,,,
492661,10,282,46,236,280,46,234,2,0,2
492689,10,785,291,494,716,281,435,69,10,59
492704,10,169,29,140,165,26,139,4,3,1
492722,10,409,40,369,409,40,369,,,
492731,10,127,26,101,127,26,101,,,
492759,10,314,22,292,139,11,128,175,11,164
492801,10,847,308,539,447,162,285,400,146,254
492935,10,134,13,121,134,13,121,,,
492953,10,90,6,84,55,6,49,35,0,35
492962,10,3114,1134,1980,1333,460,873,1781,674,1107
493071,10,454,111,343,454,111,343,,,
493080,10,351,173,178,21,8,13,330,165,165
493132,10,1067,1033,34,1067,1033,34,,,
493150,10,148,12,136,148,12,136,,,
493372,10,16,2,14,16,2,14,,,
493451,10,76,14,62,76,14,62,,,
493479,10,10,5,5,10,5,5,,,
493488,10,17,2,15,17,2,15,,,
493503,10,25,14,11,25,14,11,,,
493512,10,154,95,59,154,95,59,,,
493521,10,46,34,12,45,33,12,1,1,0
493530,10,48,18,30,30,13,17,18,5,13
493549,10,137,128,9,137,128,9,,,
493558,10,17,17,0,17,17,0,,,
493567,10,85,3,82,,,,85,3,82
493576,10,12,0,12,12,0,12,,,
493585,10,44,5,39,44,5,39,,,
493594,10,36,36,0,36,36,0,,,
493600,10,176,176,0,176,176,0,,,
493619,10,31,13,18,20,12,8,11,1,10
493628,10,149,13,136,84,8,76,65,5,60
493637,10,61,1,60,61,1,60,,,
493646,10,229,0,229,229,0,229,,,
493655,10,17,11,6,17,11,6,,,
493664,10,63,63,0,62,62,0,1,1,0
493673,10,123,45,78,57,19,38,66,26,40
493682,10,97,5,92,83,4,79,14,1,13
493691,10,38,1,37,29,1,28,9,0,9
493707,10,90,90,0,90,90,0,,,
493716,10,68,68,0,68,68,0,,,
493725,10,668,230,438,431,139,292,237,91,146
493734,10,10,8,2,10,8,2,,,
493743,10,210,153,57,122,93,29,88,60,28
493752,10,15,1,14,15,1,14,,,
493761,10,108,34,74,19,11,8,89,23,66
493770,10,24,1,23,24,1,23,,,
493789,10,136,0,136,57,0,57,79,0,79
493798,10,107,0,107,100,0,100,7,0,7
493804,10,84,69,15,84,69,15,,,
493813,10,121,7,114,121,7,114,,,
493822,10,193,46,147,124,28,96,69,18,51
493831,10,37,25,12,37,25,12,,,
493868,10,12,9,3,8,6,2,4,3,1
493895,10,748,678,70,557,507,50,191,171,20
493910,10,6,0,6,2,0,2,4,0,4
493947,10,622,387,235,622,387,235,,,
493992,10,247,78,169,247,78,169,,,
494001,10,86,5,81,17,2,15,69,3,66
494010,10,72,17,55,72,17,55,,,
494029,10,21,16,5,11,10,1,10,6,4
494162,10,225,16,209,112,6,106,113,10,103
494232,10,29,0,29,26,0,26,3,0,3
494250,10,351,26,325,351,26,325,,,
494269,10,33,29,4,5,4,1,28,25,3
494278,10,253,60,193,75,16,59,178,44,134
494287,10,311,96,215,96,26,70,215,70,145
494357,10,947,336,611,947,336,611,,,
494436,10,303,65,238,303,65,238,,,
494463,10,330,0,330,330,0,330,,,
494472,10,11,0,11,7,0,7,4,0,4
494524,10,96,4,92,89,1,88,7,3,4
494551,10,27,4,23,4,1,3,23,3,20
494588,10,303,27,276,303,27,276,,,
494597,10,119,59,60,88,39,49,31,20,11
494603,10,2071,1477,594,639,427,212,1432,1050,382
494621,10,89,11,78,,,,89,11,78
494630,10,44,24,20,37,21,16,7,3,4
494649,10,28,0,28,17,0,17,11,0,11
494658,10,35,1,34,28,1,27,7,0,7
494685,10,445,184,261,374,149,225,71,35,36
494694,10,70,1,69,64,1,63,6,0,6
494700,10,59,1,58,57,1,56,2,0,2
494719,10,35,29,6,22,16,6,13,13,0
494728,10,49,38,11,46,36,10,3,2,1
494737,10,169,169,0,169,169,0,,,
494746,10,167,24,143,167,24,143,,,
494755,10,65,4,61,65,4,61,,,
494764,10,180,166,14,150,140,10,30,26,4
494807,10,665,119,546,659,117,542,6,2,4
494843,10,603,41,562,603,41,562,,,
494852,10,497,112,385,497,112,385,,,
494898,10,82,13,69,82,13,69,,,
494904,10,131,55,76,52,25,27,79,30,49
494940,10,23,12,11,19,12,7,4,0,4
494959,10,76,22,54,10,5,5,66,17,49
494977,10,49,5,44,49,5,44,,,
494986,10,42,2,40,29,2,27,13,0,13
494995,10,46,42,4,46,42,4,,,
495013,10,247,220,27,,,,247,220,27
495031,10,62,62,0,59,59,0,3,3,0
495040,10,50,2,48,50,2,48,,,
495059,10,50,23,27,49,23,26,1,0,1
495077,10,25,2,23,25,2,23,,,
495101,10,53,6,47,53,6,47,,,
495110,10,17,14,3,17,14,3,,,
495129,10,127,107,20,127,107,20,,,
495138,10,6,3,3,6,3,3,,,
495147,10,21,9,12,11,7,4,10,2,8
495165,10,29,5,24,29,5,24,,,
495174,10,26,8,18,,,,26,8,18
495183,10,187,82,105,187,82,105,,,
495192,10,257,57,200,244,51,193,13,6,7
495208,10,19,14,5,19,14,5,,,
495217,10,10,8,2,10,8,2,,,
495226,10,4,0,4,4,0,4,,,
495235,10,17,2,15,10,1,9,7,1,6
495244,10,23,1,22,11,1,10,12,0,12
495253,10,47,10,37,45,10,35,2,0,2
495262,10,37,0,37,21,0,21,16,0,16
495271,10,27,7,20,,,,27,7,20
495280,10,25,14,11,12,6,6,13,8,5
495299,10,39,8,31,39,8,31,,,
495305,10,94,22,72,43,9,34,51,13,38
495314,10,405,213,192,405,213,192,,,
495341,10,48,35,13,47,34,13,1,1,0
495350,10,32,18,14,32,18,14,,,
495369,10,72,13,59,48,11,37,24,2,22
495378,10,91,5,86,11,0,11,80,5,75
495387,10,41,29,12,15,12,3,26,17,9
495396,10,27,1,26,27,1,26,,,
495411,10,116,7,109,112,5,107,4,2,2
495420,10,225,21,204,114,13,101,111,8,103
495439,10,237,18,219,112,9,103,125,9,116
495448,10,494,57,437,278,30,248,216,27,189
495457,10,418,39,379,257,23,234,161,16,145
495518,10,72,3,69,42,1,41,30,2,28
495730,10,77,0,77,62,0,62,15,0,15
495767,10,88914,47469,41445,73028,39111,33917,15886,8358,7528
495776,10,39,35,4,39,35,4,,,
495794,10,235,5,230,179,2,177,56,3,53
495837,10,121,6,115,121,6,115,,,
495916,10,9,2,7,6,1,5,3,1,2
495925,10,65,2,63,65,2,63,,,
495934,10,85,5,80,85,5,80,,,
495943,10,35,3,32,35,3,32,,,
495952,10,143,35,108,143,35,108,,,
495961,10,124,15,109,124,15,109,,,
495970,10,302,97,205,302,97,205,,,
495998,10,67,6,61,67,6,61,,,
496043,10,474,247,227,474,247,227,,,
496052,10,18,11,7,18,11,7,,,
496061,10,91,0,91,36,0,36,55,0,55
496186,10,121,112,9,121,112,9,,,
496265,10,57,47,10,57,47,10,,,
496283,10,105,11,94,105,11,94,,,
496292,10,6,6,0,6,6,0,,,
496326,10,151,17,134,151,17,134,,,
496371,10,10,10,0,10,10,0,,,
496399,10,22,5,17,22,5,17,,,
496469,10,142,14,128,81,5,76,61,9,52
496478,10,80,59,21,,,,80,59,21
496511,10,17,0,17,15,0,15,2,0,2
496520,10,38,9,29,,,,38,9,29
496539,10,63,1,62,43,1,42,20,0,20
496593,10,243,138,105,243,138,105,,,
496618,10,76,4,72,76,4,72,,,
496627,10,946,431,515,733,313,420,213,118,95
496636,10,143,22,121,143,22,121,,,
496645,10,278,175,103,37,2,35,241,173,68
496654,10,46,10,36,,,,46,10,36
496663,10,29,21,8,27,19,8,2,2,0
496672,10,35,4,31,21,4,17,14,0,14
496681,10,239,6,233,239,6,233,,,
496690,10,42,6,36,30,3,27,12,3,9
496706,10,105,64,41,105,64,41,,,
496715,10,65,21,44,57,19,38,8,2,6
496724,10,33,0,33,33,0,33,,,
496733,10,70,0,70,70,0,70,,,
496742,10,5,0,5,5,0,5,,,
496751,10,65,6,59,65,6,59,,,
496894,10,13,0,13,11,0,11,2,0,2
496919,10,955,351,604,955,351,604,,,
496955,10,361,144,217,361,144,217,,,
496964,10,18,10,8,18,10,8,,,
496973,10,68,5,63,34,2,32,34,3,31
496991,10,219,28,191,103,17,86,116,11,105
497000,10,252,56,196,252,56,196,,,
497037,10,422,75,347,314,57,257,108,18,90
497046,10,4735,1482,3253,627,213,414,4108,1269,2839
497073,10,395,8,387,225,4,221,170,4,166
497116,10,68,8,60,31,5,26,37,3,34
497161,10,66,62,4,54,50,4,12,12,0
497189,10,12,0,12,12,0,12,,,
497198,10,76,1,75,50,1,49,26,0,26
497204,10,47,43,4,16,15,1,31,28,3
497213,10,25,10,15,14,6,8,11,4,7
497222,10,23,0,23,13,0,13,10,0,10
497268,10,186,21,165,107,12,95,79,9,70
497277,10,504,56,448,504,56,448,,,
497301,10,170,5,165,112,5,107,58,0,58
497310,10,97,0,97,97,0,97,,,
497329,10,83,14,69,83,14,69,,,
497338,10,36,4,32,36,4,32,,,
100654,20,5107,2072,3035,4529,1823,2706,578,249,329
100663,20,13547,5129,8418,10401,3943,6458,3146,1186,1960
100690,20,251,79,172,136,45,91,115,34,81
100706,20,7569,4475,3094,6223,3727,2496,1346,748,598
100724,20,3499,1225,2274,3055,1053,2002,444,172,272
100751,20,31685,13780,17905,28124,12391,15733,3561,1389,2172
100760,20,1578,646,932,494,235,259,1084,411,673
100812,20,2559,769,1790,1136,343,793,1423,426,997
100830,20,4086,1349,2737,3017,1013,2004,1069,336,733
100858,20,24931,12602,12329,22715,11319,11396,2216,1283,933
100937,20,1058,515,543,1041,504,537,17,11,6
101028,20,1360,471,889,498,192,306,862,279,583
101116,20,341,55,286,217,36,181,124,19,105
101143,20,1796,945,851,913,500,413,883,445,438
101161,20,7048,2947,4101,2826,1122,1704,4222,1825,2397
101189,20,1919,823,1096,1298,577,721,621,246,375
101240,20,4308,1710,2598,1854,840,1014,2454,870,1584
101277,20,57,2,55,57,2,55,,,
101286,20,3899,1255,2644,1298,426,872,2601,829,1772
101295,20,5204,1758,3446,2384,909,1475,2820,849,1971
101301,20,1627,662,965,480,237,243,1147,425,722
101365,20,608,142,466,273,80,193,335,62,273
101435,20,839,462,377,792,451,341,47,11,36
101453,20,84,69,15,34,29,5,50,40,10
101462,20,872,374,498,255,118,137,617,256,361
101471,20,400,303,97,291,213,78,109,90,19
101480,20,8067,3190,4877,6273,2520,3753,1794,670,1124
101505,20,8519,3086,5433,2247,885,1362,6272,2201,4071
101514,20,8702,3930,4772,2503,1159,1344,6199,2771,3428
101569,20,3094,1046,2048,1214,455,759,1880,591,1289
101587,20,2322,710,1612,1754,508,1246,568,202,366
101602,20,1816,821,995,763,302,461,1053,519,534
101648,20,314,232,82,314,232,82,,,
101675,20,1520,709,811,1421,651,770,99,58,41
101693,20,1654,596,1058,1045,362,683,609,234,375
101709,20,2215,797,1418,1965,711,1254,250,86,164
101736,20,3371,1452,1919,900,407,493,2471,1045,1426
101879,20,6084,2215,3869,4530,1625,2905,1554,590,964
101897,20,2489,824,1665,885,308,577,1604,516,1088
101912,20,1378,596,782,1255,543,712,123,53,70
101994,20,374,145,229,144,74,70,230,71,159
102030,20,2479,822,1657,887,374,513,1592,448,1144
102049,20,3607,1203,2404,3549,1185,2364,58,18,40
102058,20,22,16,6,9,6,3,13,10,3
102067,20,4659,1794,2865,1671,770,901,2988,1024,1964
102076,20,2245,869,1376,997,392,605,1248,477,771
102094,20,8833,3418,5415,7400,2789,4611,1433,629,804
102234,20,990,410,580,948,393,555,42,17,25
102270,20,728,320,408,643,268,375,85,52,33
102298,20,1144,564,580,1004,502,502,140,62,78
102313,20,1846,731,1115,758,356,402,1088,375,713
102368,20,11297,3975,7322,7474,2651,4823,3823,1324,2499
102377,20,2184,816,1368,2068,770,1298,116,46,70
102395,20,71,52,19,14,11,3,57,41,16
102429,20,3371,1337,2034,1061,455,606,2310,882,1428
102553,20,10259,3969,6290,4052,1803,2249,6207,2166,4041
102580,20,44,28,16,24,19,5,20,9,11
102614,20,5844,2245,3599,2345,1135,1210,3499,1110,2389
102632,20,1757,618,1139,477,186,291,1280,432,848
102669,20,376,82,294,294,68,226,82,14,68
102711,20,259,193,66,83,63,20,176,130,46
102845,20,2215,570,1645,2215,570,1645,,,
103501,20,317,42,275,317,42,275,,,
103741,20,138,5,133,112,5,107,26,0,26
103893,20,1281,262,1019,1281,262,1019,,,
103909,20,591,66,525,591,66,525,,,
103927,20,517,80,437,517,80,437,,,
103954,20,48,3,45,48,3,45,,,
103963,20,398,359,39,397,359,38,1,0,1
104090,20,1000,123,877,1000,123,877,,,
104151,20,64716,32522,32194,59070,29350,29720,5646,3172,2474
104160,20,8081,3372,4709,2012,885,1127,6069,2487,3582
104179,20,37434,16573,20861,29498,12772,16726,7936,3801,4135
104346,20,4841,1773,3068,1030,458,572,3811,1315,2496
104391,20,56,3,53,56,3,53,,,
104425,20,3473,1472,2001,1383,530,853,2090,942,1148
104443,20,43,2,41,33,2,31,10,0,10
104568,20,377,11,366,213,6,207,164,5,159
104577,20,4583,1801,2782,1315,584,731,3268,1217,2051
104586,20,3033,2226,807,2892,2111,781,141,115,26
104708,20,13882,6045,7837,3654,1780,1874,10228,4265,5963
104717,20,65870,19271,46599,22293,8683,13610,43577,10588,32989
105145,20,4673,1600,3073,985,387,598,3688,1213,2475
105154,20,16494,7395,9099,4264,2068,2196,12230,5327,6903
105206,20,3793,1244,2549,729,288,441,3064,956,2108
105215,20,781,728,53,781,728,53,,,
105297,20,1315,319,996,652,161,491,663,158,505
105330,20,24162,8950,15212,19918,7314,12604,4244,1636,2608
105349,20,2786,1092,1694,435,203,232,2351,889,1462
105367,20,361,88,273,161,31,130,200,57,143
105428,20,9050,3189,5861,2062,779,1283,6988,2410,4578
105525,20,15000,6234,8766,3119,1451,1668,11881,4783,7098
105534,20,2485,448,2037,2485,448,2037,,,
105543,20,782,126,656,782,126,656,,,
105589,20,388,132,256,311,114,197,77,18,59
105659,20,1007,934,73,1007,934,73,,,
105668,20,15682,6363,9319,2074,833,1241,13608,5530,8078
105677,20,12,12,0,12,12,0,,,
105747,20,7320,3128,4192,1643,777,866,5677,2351,3326
105792,20,3597,1413,2184,891,393,498,2706,1020,1686
105899,20,1053,639,414,876,555,321,177,84,93
106041,20,1986,1898,88,1986,1898,88,,,
106111,20,48,1,47,27,1,26,21,0,21
106148,20,7550,3054,4496,1353,646,707,6197,2408,3789
106245,20,5969,2190,3779,3047,1216,1831,2922,974,1948
106263,20,1084,161,923,732,112,620,352,49,303
106306,20,414,324,90,344,267,77,70,57,13
106315,20,28,2,26,28,2,26,,,
106324,20,33,0,33,28,0,28,5,0,5
106342,20,579,342,237,573,338,235,6,4,2
106351,20,62,47,15,62,47,15,,,
106360,20,25,1,24,25,1,24,,,
106397,20,24265,10689,13576,21495,9451,12044,2770,1238,1532
106412,20,2484,1019,1465,2093,857,1236,391,162,229
106449,20,2776,1100,1676,1295,514,781,1481,586,895
106458,20,8241,3126,5115,5401,2191,3210,2840,935,1905
106467,20,8901,3901,5000,5398,2469,2929,3503,1432,2071
106485,20,2268,952,1316,1628,730,898,640,222,418
106494,20,38,0,38,38,0,38,,,
106546,20,666,81,585,592,75,517,74,6,68
106625,20,1380,461,919,693,247,446,687,214,473
106704,20,8244,3215,5029,6821,2608,4213,1423,607,816
106713,20,622,332,290,497,280,217,125,52,73
106795,20,1360,516,844,492,183,309,868,333,535
106810,20,197,111,86,170,95,75,27,16,11
106883,20,1056,353,703,391,121,270,665,232,433
106892,20,62,1,61,62,1,61,,,
106908,20,330,21,309,315,20,295,15,1,14
106980,20,2325,916,1409,1224,505,719,1101,411,690
106999,20,1060,347,713,520,163,357,540,184,356
107044,20,3684,1612,2072,3072,1334,1738,612,278,334
107071,20,2228,1055,1173,1992,952,1040,236,103,133
107080,20,1111,543,568,1101,537,564,10,6,4
107099,20,85,3,82,85,3,82,,,
107123,20,66,8,58,66,8,58,,,
107141,20,1774,724,1050,1285,525,760,489,199,290
107220,20,196,2,194,196,2,194,,,
107293,20,53,0,53,53,0,53,,,
107318,20,1077,425,652,233,55,178,844,370,474
107327,20,1457,564,893,481,210,271,976,354,622
107442,20,33,22,11,33,22,11,,,
107460,20,1792,769,1023,750,319,431,1042,450,592
107488,20,155,106,49,153,104,49,2,2,0
107512,20,1716,746,970,1551,660,891,165,86,79
107521,20,1597,750,847,281,76,205,1316,674,642
107549,20,1007,306,701,480,123,357,527,183,344
107558,20,784,370,414,776,366,410,8,4,4
107585,20,1953,750,1203,1025,417,608,928,333,595
107600,20,710,256,454,613,221,392,97,35,62
107619,20,1289,474,815,492,168,324,797,306,491
107637,20,997,301,696,268,107,161,729,194,535
107655,20,37,0,37,37,0,37,,,
107664,20,4418,1472,2946,2313,844,1469,2105,628,1477
107725,20,1191,376,815,470,152,318,721,224,497
107743,20,718,253,465,405,165,240,313,88,225
107789,20,118,2,116,118,2,116,,,
107831,20,84,1,83,84,1,83,,,
107840,20,245,75,170,202,64,138,43,11,32
107877,20,604,290,314,588,285,303,16,5,11
107974,20,1132,377,755,450,149,301,682,228,454
107983,20,3160,1372,1788,2637,1174,1463,523,198,325
107992,20,984,445,539,480,217,263,504,228,276
108065,20,15,0,15,11,0,11,4,0,4
108092,20,5403,2219,3184,3366,1308,2058,2037,911,1126
108232,20,5363,2327,3036,2639,1223,1416,2724,1104,1620
108667,20,4983,2107,2876,595,322,273,4388,1785,2603
108807,20,9836,4410,5426,2872,1308,1564,6964,3102,3862
108852,20,217,98,119,217,98,119,,,
108977,20,185,53,132,101,32,69,84,21,63
109040,20,1902,397,1505,1902,397,1505,,,
109086,20,11,5,6,11,5,6,,,
109208,20,25849,12142,13707,4660,2073,2587,21189,10069,11120
109350,20,11105,4633,6472,3199,1440,1759,7906,3193,4713
109651,20,2028,845,1183,1730,730,1000,298,115,183
109721,20,180,52,128,180,52,128,,,
109730,20,43,35,8,43,35,8,,,
109785,20,3939,1251,2688,3373,1071,2302,566,180,386
109819,20,24479,10606,13873,6140,2602,3538,18339,8004,10335
109907,20,2341,730,1611,910,278,632,1431,452,979
109934,20,406,63,343,406,63,343,,,
110060,20,264,204,60,218,176,42,46,28,18
110097,20,3596,1367,2229,3289,1254,2035,307,113,194
110194,20,241,240,1,241,240,1,,,
110219,20,1361,394,967,1361,394,967,,,
110246,20,9537,4203,5334,4096,1897,2199,5441,2306,3135
110316,20,84,16,68,76,14,62,8,2,6
110334,20,9075,3782,5293,2933,1295,1638,6142,2487,3655
110361,20,8252,3013,5239,7314,2706,4608,938,307,631
110370,20,1249,453,796,1178,430,748,71,23,48
110404,20,987,546,441,987,546,441,,,
110413,20,2592,1170,1422,2517,1131,1386,75,39,36
110422,20,21128,10825,10303,19960,10117,9843,1168,708,460
110468,20,378,139,239,,,,378,139,239
110486,20,9367,3247,6120,7387,2505,4882,1980,742,1238
110495,20,9198,3027,6171,7355,2379,4976,1843,648,1195
110510,20,16858,6333,10525,13649,5013,8636,3209,1320,1889
110529,20,26974,14437,12537,23140,12174,10966,3834,2263,1571
110538,20,14462,6586,7876,12908,5867,7041,1554,719,835
110547,20,15238,5623,9615,11647,4270,7377,3591,1353,2238
110556,20,22187,8852,13335,18516,7226,11290,3671,1626,2045
110565,20,35600,14653,20947,27874,11318,16556,7726,3335,4391
110574,20,12114,4827,7287,9447,3726,5721,2667,1101,1566
110583,20,33897,14332,19565,28353,11723,16630,5544,2609,2935
110592,20,23536,9560,13976,19558,7782,11776,3978,1778,2200
110608,20,34496,15534,18962,28242,12332,15910,6254,3202,3052
110617,20,29451,12603,16848,23473,9703,13770,5978,2900,3078
110635,20,31814,14442,17372,30200,13697,16503,1614,745,869
110644,20,31657,12610,19047,30782,12193,18589,875,417,458
110653,20,29449,13369,16080,28753,12965,15788,696,404,292
110662,20,32122,12924,19198,31485,12595,18890,637,329,308
110671,20,22868,10747,12121,22071,10316,11755,797,431,366
110680,20,33343,16242,17101,32327,15680,16647,1016,562,454
110705,20,23091,10116,12975,22458,9789,12669,633,327,306
110714,20,17864,9319,8545,17087,8877,8210,777,442,335
110778,20,8,2,6,7,2,5,1,0,1
110875,20,63,0,63,59,0,59,4,0,4
110918,20,14,10,4,7,5,2,7,5,2
111045,20,35,13,22,22,8,14,13,5,8
111054,20,94,21,73,94,21,73,,,
111081,20,965,401,564,938,389,549,27,12,15
111188,20,880,710,170,852,687,165,28,23,5
111434,20,4845,1861,2984,505,222,283,4340,1639,2701
111461,20,15443,7415,8028,5196,2443,2753,10247,4972,5275
111513,20,194,5,189,151,3,148,43,2,41
111638,20,246,96,150,246,96,150,,,
111708,20,198,158,40,198,158,40,,,
111717,20,176,134,42,170,132,38,6,2,4
111726,20,159,118,41,159,118,41,,,
111744,20,135,115,20,135,115,20,,,
111762,20,90,48,42,90,48,42,,,
111799,20,156,22,134,156,22,134,,,
111887,20,18656,8592,10064,6735,2995,3740,11921,5597,6324
111896,20,4862,2252,2610,822,434,388,4040,1818,2222
111920,20,11071,5176,5895,2791,1273,1518,8280,3903,4377
111939,20,18688,7173,11515,4926,2006,2920,13762,5167,8595
111948,20,7714,3081,4633,7156,2808,4348,558,273,285
111966,20,255,87,168,164,71,93,91,16,75
112075,20,1584,630,954,1484,596,888,100,34,66
112084,20,449,202,247,385,178,207,64,24,40
112172,20,9982,4222,5760,3676,1637,2039,6306,2585,3721
112181,20,101,2,99,101,2,99,,,
112190,20,17447,7973,9474,5317,2740,2577,12130,5233,6897
112260,20,1416,696,720,1411,693,718,5,3,2
112288,20,430,25,405,430,25,405,,,
112367,20,340,38,302,114,10,104,226,28,198
112385,20,6792,3463,3329,591,261,330,6201,3202,2999
112394,20,425,312,113,340,251,89,85,61,24
112455,20,132,25,107,132,25,107,,,
112561,20,2063,963,1100,509,215,294,1554,748,806
112570,20,493,280,213,448,254,194,45,26,19
112686,20,4236,1461,2775,742,302,440,3494,1159,2335
112826,20,5631,2227,3404,1353,593,760,4278,1634,2644
113096,20,13799,5769,8030,2988,1366,1622,10811,4403,6408
113111,20,5260,2296,2964,1541,697,844,3719,1599,2120
113193,20,9661,4632,5029,2613,1259,1354,7048,3373,3675
113218,20,7809,3312,4497,1379,638,741,6430,2674,3756
113236,20,13406,5558,7848,4559,1984,2575,8847,3574,5273
113333,20,16706,8233,8473,8178,4391,3787,8528,3842,4686
113449,20,159,42,117,159,42,117,,,
113537,20,13,3,10,13,3,10,,,
113573,20,10229,4205,6024,3727,1567,2160,6502,2638,3864
113582,20,119,13,106,80,10,70,39,3,36
113634,20,17123,8103,9020,5934,3022,2912,11189,5081,6108
113698,20,1249,389,860,1134,346,788,115,43,72
113856,20,29506,13904,15602,5033,2179,2854,24473,11725,12748
113980,20,19675,9055,10620,6663,3198,3465,13012,5857,7155
114266,20,8085,3530,4555,2023,939,1084,6062,2591,3471
114354,20,1724,302,1422,1494,252,1242,230,50,180
114433,20,1376,702,674,443,213,230,933,489,444
114460,20,297,41,256,183,30,153,114,11,103
114637,20,58,2,56,58,2,56,,,
114716,20,12438,6502,5936,3338,1571,1767,9100,4931,4169
114761,20,59,7,52,59,7,52,,,
114789,20,20435,8143,12292,5579,2341,3238,14856,5802,9054
114813,20,2686,733,1953,1395,422,973,1291,311,980
114859,20,17813,8081,9732,6611,3106,3505,11202,4975,6227
114938,20,4538,2062,2476,1460,670,790,3078,1392,1686
114947,20,104,47,57,104,47,57,,,
115001,20,11398,4958,6440,5608,2518,3090,5790,2440,3350
115010,20,305,62,243,305,62,243,,,
115083,20,691,501,190,503,386,117,188,115,73
115126,20,10189,4385,5804,2963,1365,1598,7226,3020,4206
115296,20,13023,5171,7852,3916,1649,2267,9107,3522,5585
115357,20,116,27,89,56,16,40,60,11,49
115393,20,9808,4714,5094,3047,1298,1749,6761,3416,3345
115409,20,905,455,450,902,454,448,3,1,2
115658,20,99,15,84,48,11,37,51,4,47
115728,20,596,199,397,492,169,323,104,30,74
115755,20,5354,2226,3128,4643,1885,2758,711,341,370
115773,20,199,44,155,98,27,71,101,17,84
115861,20,7225,3007,4218,3307,1290,2017,3918,1717,2201
115931,20,693,505,188,693,505,188,,,
116226,20,110,1,109,46,0,46,64,1,63
116350,20,158,28,130,158,28,130,,,
116439,20,11045,5621,5424,3813,2102,1711,7232,3519,3713
116563,20,226,7,219,226,7,219,,,
116846,20,48,7,41,20,2,18,28,5,23
117052,20,6329,2856,3473,1660,873,787,4669,1983,2686
117104,20,420,190,230,358,157,201,62,33,29
117140,20,3691,1465,2226,2891,1137,1754,800,328,472
117168,20,735,194,541,627,164,463,108,30,78
117195,20,2024,1241,783,606,328,278,1418,913,505
117238,20,82,18,64,82,18,64,,,
117247,20,8168,3816,4352,1406,753,653,6762,3063,3699
117274,20,1610,1178,432,463,302,161,1147,876,271
117283,20,49,22,27,24,9,15,25,13,12
117557,20,168,131,37,161,127,34,7,4,3
117575,20,46,30,16,5,3,2,41,27,14
117627,20,1351,556,795,1144,484,660,207,72,135
117636,20,1073,273,800,819,222,597,254,51,203
117645,20,21761,9354,12407,8242,3627,4615,13519,5727,7792
117672,20,545,149,396,4,1,3,541,148,393
117690,20,6815,2681,4134,1420,661,759,5395,2020,3375
117706,20,15148,6506,8642,3744,1671,2073,11404,4835,6569
117715,20,4565,1425,3140,528,155,373,4037,1270,2767
117724,20,9822,5116,4706,1899,1107,792,7923,4009,3914
117733,20,14018,5910,8108,2433,1117,1316,11585,4793,6792
117751,20,1582,824,758,1030,502,528,552,322,230
117788,20,12747,5362,7385,2479,1107,1372,10268,4255,6013
117803,20,180,53,127,,,,180,53,127
117867,20,8840,3418,5422,1424,641,783,7416,2777,4639
117894,20,7859,3309,4550,2648,1216,1432,5211,2093,3118
117946,20,7127,3317,3810,6945,3220,3725,182,97,85
117955,20,272,54,218,170,32,138,102,22,80
118134,20,93,2,91,35,2,33,58,0,58
118143,20,103,4,99,18,2,16,85,2,83
118161,20,76,4,72,76,4,72,,,
118198,20,555,126,429,555,126,429,,,
118347,20,4213,1713,2500,1001,466,535,3212,1247,1965
118541,20,443,212,231,431,208,223,12,4,8
118684,20,3269,1074,2195,697,219,478,2572,855,1717
118693,20,745,405,340,712,389,323,33,16,17
118718,20,9282,3603,5679,3779,1524,2255,5503,2079,3424
118772,20,6289,2125,4164,980,310,670,5309,1815,3494
118888,20,446,2,444,395,2,393,51,0,51
118912,20,11125,4440,6685,3933,1678,2255,7192,2762,4430
118930,20,5910,2544,3366,1316,657,659,4594,1887,2707
118958,20,81,33,48,28,10,18,53,23,30
118976,20,14642,5516,9126,4770,1885,2885,9872,3631,6241
118994,20,346,200,146,346,200,146,,,
119058,20,13,9,4,13,9,4,,,
119067,20,6828,2987,3841,1901,862,1039,4927,2125,2802
119137,20,12709,5781,6928,4254,2055,2199,8455,3726,4729
119164,20,25540,11656,13884,8486,4109,4377,17054,7547,9507
119173,20,1930,126,1804,1532,83,1449,398,43,355
119216,20,14035,5609,8426,4550,1912,2638,9485,3697,5788
119270,20,766,557,209,475,357,118,291,200,91
119331,20,4481,1838,2643,1520,645,875,2961,1193,1768
119553,20,1201,290,911,1178,281,897,23,9,14
119605,20,7648,3601,4047,2932,1403,1529,4716,2198,2518
119775,20,301,177,124,258,151,107,43,26,17
119951,20,221,14,207,221,14,207,,,
120069,20,190,18,172,190,18,172,,,
120078,20,384,46,338,384,46,338,,,
120087,20,171,24,147,171,24,147,,,
120166,20,6,3,3,5,3,2,1,0,1
120254,20,1964,826,1138,1938,815,1123,26,11,15
120290,20,8267,4094,4173,2858,1483,1375,5409,2611,2798
120342,20,16779,8084,8695,6224,3153,3071,10555,4931,5624
120403,20,1197,365,832,1159,348,811,38,17,21
120421,20,6438,2865,3573,1476,690,786,4962,2175,2787
120537,20,619,275,344,516,234,282,103,41,62
120661,20,735,159,576,705,156,549,30,3,27
120698,20,64,14,50,55,14,41,9,0,9
120768,20,479,43,436,,,,479,43,436
120838,20,8,6,2,8,6,2,,,
120865,20,825,305,520,733,284,449,92,21,71
120883,20,3306,1582,1724,3186,1521,1665,120,61,59
120953,20,4152,3641,511,530,397,133,3622,3244,378
120971,20,17566,8950,8616,5331,2602,2729,12235,6348,5887
121044,20,21192,9676,11516,7165,3506,3659,14027,6170,7857
121150,20,3708,1570,2138,3427,1443,1984,281,127,154
121257,20,1168,483,685,1132,463,669,36,20,16
121275,20,64,46,18,64,46,18,,,
121309,20,3174,1090,2084,2574,887,1687,600,203,397
121345,20,1761,799,962,1753,795,958,8,4,4
121363,20,3623,1288,2335,1216,476,740,2407,812,1595
121433,20,137,5,132,126,4,122,11,1,10
121619,20,23936,14029,9907,3715,1807,1908,20221,12222,7999
121637,20,116,15,101,116,15,101,,,
121691,20,2644,1064,1580,2249,899,1350,395,165,230
121707,20,3686,1708,1978,971,478,493,2715,1230,1485
121859,20,194,15,179,110,15,95,84,0,84
121868,20,187,3,184,111,1,110,76,2,74
121886,20,15593,8531,7062,3886,1871,2015,11707,6660,5047
121901,20,17960,7009,10951,5038,2132,2906,12922,4877,8045
122117,20,2,0,2,1,0,1,1,0,1
122180,20,18333,7072,11261,4091,1646,2445,14242,5426,8816
122205,20,17392,7707,9685,5277,2712,2565,12115,4995,7120
122296,20,728,150,578,574,125,449,154,25,129
122339,20,12956,5493,7463,1687,714,973,11269,4779,6490
122375,20,18028,7896,10132,3553,1749,1804,14475,6147,8328
122384,20,13101,6908,6193,1690,1045,645,11411,5863,5548
122409,20,31321,13499,17822,27810,11777,16033,3511,1722,1789
122436,20,5702,2501,3201,5544,2411,3133,158,90,68
122454,20,42,21,21,25,12,13,17,9,8
122506,20,228,135,93,228,135,93,,,
122597,20,23424,10430,12994,18629,8058,10571,4795,2372,2423
122612,20,5969,2122,3847,5739,2004,3735,230,118,112
122658,20,16640,6706,9934,6930,2917,4013,9710,3789,5921
122685,20,2240,570,1670,2240,570,1670,,,
122694,20,813,226,587,813,226,587,,,
122728,20,1210,513,697,964,408,556,246,105,141
122746,20,7326,2954,4372,1567,698,869,5759,2256,3503
122755,20,28288,14452,13836,23015,11567,11448,5273,2885,2388
122791,20,6894,3379,3515,1237,685,552,5657,2694,2963
122834,20,9,2,7,9,2,7,,,
122889,20,12746,5476,7270,5514,2495,3019,7232,2981,4251
122931,20,5895,3105,2790,5779,3033,2746,116,72,44
122977,20,23408,10082,13326,8812,4031,4781,14596,6051,8545
123013,20,14967,6476,8491,4236,1981,2255,10731,4495,6236
123165,20,1095,0,1095,1090,0,1090,5,0,5
123217,20,11928,4762,7166,4482,1934,2548,7446,2828,4618
123280,20,29,16,13,9,6,3,20,10,10
123299,20,7075,2654,4421,2519,958,1561,4556,1696,2860
123341,20,15773,6972,8801,5553,2557,2996,10220,4415,5805
123350,20,122,11,111,83,10,73,39,1,38
123457,20,745,311,434,663,277,386,82,34,48
123484,20,1329,656,673,523,276,247,806,380,426
123493,20,163,50,113,163,50,113,,,
123509,20,7776,3612,4164,1193,629,564,6583,2983,3600
123527,20,9913,3797,6116,2391,1002,1389,7522,2795,4727
123554,20,2199,924,1275,1989,835,1154,210,89,121
123563,20,8105,3411,4694,2436,1020,1416,5669,2391,3278
123572,20,6587,2495,4092,5732,2117,3615,855,378,477
123642,20,272,19,253,176,14,162,96,5,91
123651,20,1975,622,1353,1777,563,1214,198,59,139
123679,20,734,210,524,653,195,458,81,15,66
123800,20,15985,7002,8983,6001,2601,3400,9984,4401,5583
123952,20,256,154,102,246,148,98,10,6,4
123961,20,20790,10074,10716,20206,9756,10450,584,318,266
124113,20,3943,1939,2004,852,273,579,3091,1666,1425
124292,20,497,247,250,497,247,250,,,
124487,20,92,47,45,12,5,7,80,42,38
124681,20,1108,424,684,1108,424,684,,,
124706,20,744,161,583,744,161,583,,,
124937,20,714,220,494,659,215,444,55,5,50
125028,20,10741,4441,6300,3044,1324,1720,7697,3117,4580
125082,20,94,14,80,93,13,80,1,1,0
125091,20,10523,3972,6551,3004,1250,1754,7519,2722,4797
125170,20,5484,2296,3188,790,338,452,4694,1958,2736
125231,20,7119,1145,5974,1704,235,1469,5415,910,4505
125310,20,55,12,43,55,12,43,,,
125462,20,3801,1794,2007,434,213,221,3367,1581,1786
125471,20,9481,3735,5746,1563,698,865,7918,3037,4881
125499,20,6717,2946,3771,2035,988,1047,4682,1958,2724
125532,20,1641,165,1476,1641,165,1476,,,
125727,20,1238,489,749,1233,487,746,5,2,3
125763,20,1325,579,746,1276,548,728,49,31,18
125897,20,937,448,489,880,421,459,57,27,30
126076,20,142,142,0,142,142,0,,,
126119,20,5243,1939,3304,1259,533,726,3984,1406,2578
126164,20,53,1,52,53,1,52,,,
126182,20,1835,968,867,1173,611,562,662,357,305
126207,20,6940,3101,3839,1941,897,1044,4999,2204,2795
126289,20,11897,5213,6684,2150,970,1180,9747,4243,5504
126359,20,217,32,185,217,32,185,,,
126562,20,14289,6112,8177,8414,3644,4770,5875,2468,3407
126580,20,10002,4585,5417,7461,3417,4044,2541,1168,1373
126605,20,316,278,38,316,278,38,,,
126614,20,30886,16933,13953,28463,15464,12999,2423,1469,954
126669,20,7188,2378,4810,1921,697,1224,5267,1681,3586
126678,20,2241,974,1267,2190,950,1240,51,24,27
126687,20,781,125,656,781,125,656,,,
126711,20,5134,2136,2998,1373,657,716,3761,1479,2282
126748,20,1150,481,669,435,184,251,715,297,418
126775,20,5487,3752,1735,5200,3559,1641,287,193,94
126784,20,149,147,2,149,147,2,,,
126818,20,24954,11368,13586,20016,9026,10990,4938,2342,2596
126827,20,21160,7072,14088,13320,4350,8970,7840,2722,5118
126863,20,7839,3307,4532,1300,609,691,6539,2698,3841
126915,20,205,73,132,65,24,41,140,49,91
126942,20,7091,2616,4475,1766,670,1096,5325,1946,3379
126951,20,1292,1180,112,1292,1180,112,,,
127060,20,5867,2629,3238,5436,2431,3005,431,198,233
127158,20,5086,4468,618,1123,843,280,3963,3625,338
127185,20,3449,1573,1876,2914,1331,1583,535,242,293
127200,20,18537,7959,10578,4305,2056,2249,14232,5903,8329
127316,20,228,45,183,84,25,59,144,20,124
127389,20,696,278,418,350,153,197,346,125,221
127556,20,8712,3998,4714,6614,3054,3560,2098,944,1154
127565,20,16515,7286,9229,9851,4498,5353,6664,2788,3876
127617,20,1365,498,867,316,119,197,1049,379,670
127653,20,325,86,239,287,73,214,38,13,25
127714,20,588,300,288,31,11,20,557,289,268
127732,20,1392,581,811,710,336,374,682,245,437
127741,20,7357,2423,4934,5948,1976,3972,1409,447,962
127778,20,1151,469,682,501,255,246,650,214,436
127820,20,11845,4713,7132,3962,1708,2254,7883,3005,4878
127884,20,5938,2450,3488,1589,724,865,4349,1726,2623
127909,20,5938,2859,3079,1842,1024,818,4096,1835,2261
127918,20,2745,988,1757,1916,622,1294,829,366,463
127945,20,1837,440,1397,1072,261,811,765,179,586
127954,20,5,0,5,5,0,5,,,
128106,20,3928,1812,2116,2589,1187,1402,1339,625,714
128151,20,926,487,439,918,484,434,8,3,5
128179,20,672,485,187,672,485,187,,,
128188,20,787,333,454,787,333,454,,,
128258,20,1500,662,838,615,301,314,885,361,524
128328,20,4181,2987,1194,4181,2987,1194,,,
128337,20,84,1,83,59,1,58,25,0,25
128391,20,3241,1665,1576,1645,966,679,1596,699,897
128498,20,1031,411,620,918,374,544,113,37,76
128577,20,1220,557,663,437,241,196,783,316,467
128586,20,40,40,0,40,40,0,,,
128744,20,1873,535,1338,1422,444,978,451,91,360
128771,20,7748,4146,3602,6071,3223,2848,1677,923,754
128780,20,1526,375,1151,377,81,296,1149,294,855
128896,20,158,30,128,158,30,128,,,
128902,20,1829,744,1085,1811,734,1077,18,10,8
129002,20,318,150,168,275,131,144,43,19,24
129020,20,18567,8844,9723,17951,8481,9470,616,363,253
129154,20,3156,557,2599,411,121,290,2745,436,2309
129181,20,1170,1083,87,869,805,64,301,278,23
129215,20,4145,1734,2411,3476,1441,2035,669,293,376
129242,20,4603,1937,2666,4486,1873,2613,117,64,53
129349,20,180,4,176,171,4,167,9,0,9
129367,20,2474,628,1846,525,168,357,1949,460,1489
129482,20,407,31,376,407,31,376,,,
129525,20,4003,1809,2194,3681,1668,2013,322,141,181
129534,20,278,139,139,101,56,45,177,83,94
129543,20,3604,1313,2291,1154,472,682,2450,841,1609
129695,20,4494,1891,2603,1460,649,811,3034,1242,1792
129729,20,4673,1794,2879,1676,753,923,2997,1041,1956
129756,20,1988,768,1220,770,346,424,1218,422,796
129774,20,526,303,223,493,284,209,33,19,14
129808,20,3019,1123,1896,1060,476,584,1959,647,1312
129923,20,568,276,292,329,167,162,239,109,130
129932,20,323,287,36,254,221,33,69,66,3
129941,20,5023,2196,2827,4718,2020,2698,305,176,129
130004,20,4106,1696,2410,1238,592,646,2868,1104,1764
130040,20,1128,367,761,439,173,266,689,194,495
130110,20,212,81,131,124,43,81,88,38,50
130174,20,1633,790,843,1458,745,713,175,45,130
130183,20,12994,3643,9351,4986,1364,3622,8008,2279,5729
130217,20,1118,413,705,405,159,246,713,254,459
130226,20,6298,2364,3934,5985,2254,3731,313,110,203
130253,20,6761,2201,4560,6071,2021,4050,690,180,510
130314,20,906,207,699,852,199,653,54,8,46
130396,20,5703,2142,3561,1774,797,977,3929,1345,2584
130493,20,6800,2552,4248,5644,2105,3539,1156,447,709
130509,20,566,42,524,234,22,212,332,20,312
130590,20,2159,1096,1063,2118,1075,1043,41,21,20
130606,20,3320,1390,1930,1322,584,738,1998,806,1192
130624,20,1049,628,421,1049,628,421,,,
130697,20,3385,1483,1902,3238,1413,1825,147,70,77
130776,20,4172,1987,2185,3440,1651,1789,732,336,396
130794,20,6536,3174,3362,6532,3170,3362,4,4,0
130837,20,67,8,59,67,8,59,,,
130873,20,251,47,204,251,47,204,,,
130907,20,12402,3990,8412,3524,1391,2133,8878,2599,6279
130934,20,4399,1442,2957,3766,1252,2514,633,190,443
130943,20,19410,8138,11272,18006,7434,10572,1404,704,700
130989,20,671,316,355,592,285,307,79,31,48
131061,20,144,11,133,75,8,67,69,3,66
131113,20,8332,3021,5311,2644,1106,1538,5688,1915,3773
131159,20,8463,3147,5316,8124,2993,5131,339,154,185
131283,20,2929,1292,1637,2805,1242,1563,124,50,74
131399,20,2947,1091,1856,1332,592,740,1615,499,1116
131450,20,1012,462,550,911,421,490,101,41,60
131469,20,11502,4172,7330,10284,3752,6532,1218,420,798
131496,20,7598,3254,4344,7213,3073,4140,385,181,204
131520,20,8964,2507,6457,8419,2299,6120,545,208,337
131803,20,368,89,279,28,17,11,340,72,268
131830,20,27,17,10,27,17,10,,,
131876,20,1441,40,1401,996,18,978,445,22,423
132374,20,2790,2318,472,2790,2318,472,,,
132408,20,422,196,226,191,92,99,231,104,127
132471,20,3332,1148,2184,2580,845,1735,752,303,449
132602,20,2513,946,1567,2384,893,1491,129,53,76
132657,20,2640,1319,1321,2439,1225,1214,201,94,107
132675,20,51,29,22,43,21,22,8,8,0
132693,20,12677,4945,7732,3635,1583,2052,9042,3362,5680
132709,20,30947,12117,18830,9364,3975,5389,21583,8142,13441
132842,20,179,31,148,101,17,84,78,14,64
132851,20,5331,1906,3425,2025,797,1228,3306,1109,2197
132879,20,149,88,61,134,81,53,15,7,8
132903,20,59995,26995,33000,41843,18802,23041,18152,8193,9959
132976,20,481,249,232,481,249,232,,,
133021,20,1756,641,1115,700,287,413,1056,354,702
133155,20,740,331,409,447,232,215,293,99,194
133386,20,11613,4438,7175,4385,1958,2427,7228,2480,4748
133465,20,359,47,312,267,36,231,92,11,81
133492,20,2036,619,1417,1981,597,1384,55,22,33
133508,20,14756,5134,9622,5552,2110,3442,9204,3024,6180
133526,20,1079,557,522,1011,531,480,68,26,42
133553,20,8916,6565,2351,6557,4911,1646,2359,1654,705
133650,20,7301,2508,4793,6218,2068,4150,1083,440,643
133669,20,24799,10385,14414,15920,6640,9280,8879,3745,5134
133702,20,20717,7399,13318,5895,2310,3585,14822,5089,9733
133711,20,2630,872,1758,2550,837,1713,80,35,45
133809,20,535,258,277,522,254,268,13,4,9
133845,20,678,75,603,658,75,583,20,0,20
133854,20,349,79,270,349,79,270,,,
133863,20,438,51,387,438,51,387,,,
133872,20,1144,196,948,391,67,324,753,129,624
133881,20,3491,2422,1069,3085,2162,923,406,260,146
133942,20,53,4,49,53,4,49,,,
133951,20,46415,20160,26255,26207,11150,15057,20208,9010,11198
133960,20,865,357,508,337,191,146,528,166,362
133979,20,992,500,492,880,441,439,112,59,53
133997,20,353,135,218,353,135,218,,,
134024,20,26,9,17,26,9,17,,,
134079,20,2811,1006,1805,2647,959,1688,164,47,117
134097,20,33593,14408,19185,30153,12694,17459,3440,1714,1726
134130,20,34876,15240,19636,31337,13357,17980,3539,1883,1656
134228,20,29,11,18,24,10,14,5,1,4
134237,20,24187,16803,7384,24187,16803,7384,,,
134291,20,603,506,97,587,491,96,16,15,1
134307,20,890,830,60,189,182,7,701,648,53
134343,20,4377,1504,2873,1610,604,1006,2767,900,1867
134422,20,24,0,24,23,0,23,1,0,1
134495,20,19198,7948,11250,8652,4036,4616,10546,3912,6634
134510,20,158,81,77,88,39,49,70,42,28
134529,20,324,28,296,324,28,296,,,
134574,20,115,14,101,115,14,101,,,
134608,20,14461,5506,8955,4287,1816,2471,10174,3690,6484
134714,20,186,30,156,51,11,40,135,19,116
134811,20,894,308,586,535,186,349,359,122,237
134945,20,2646,1036,1610,2398,967,1431,248,69,179
135081,20,17990,4890,13100,10519,3026,7493,7471,1864,5607
135142,20,223,6,217,16,0,16,207,6,201
135160,20,2792,919,1873,944,324,620,1848,595,1253
135179,20,692,404,288,454,271,183,238,133,105
135188,20,4342,1591,2751,1390,543,847,2952,1048,1904
135267,20,704,482,222,701,480,221,3,2,1
135276,20,1468,790,678,805,385,420,663,405,258
135294,20,458,214,244,348,211,137,110,3,107
135337,20,85,4,81,50,4,46,35,0,35
135364,20,203,135,68,27,17,10,176,118,58
135391,20,8424,3074,5350,3493,1450,2043,4931,1624,3307
135407,20,1044,577,467,1041,576,465,3,1,2
135522,20,257,166,91,257,166,91,,,
135559,20,83,6,77,51,3,48,32,3,29
135610,20,83,34,49,34,15,19,49,19,30
135647,20,896,737,159,590,506,84,306,231,75
135717,20,44002,17898,26104,18565,7833,10732,25437,10065,15372
135726,20,12089,5616,6473,11535,5359,6176,554,257,297
135735,20,2330,1732,598,238,209,29,2092,1523,569
136109,20,134,3,131,75,3,72,59,0,59
136145,20,1182,339,843,356,96,260,826,243,583
136172,20,14167,6062,8105,10446,4410,6036,3721,1652,2069
136215,20,6637,1845,4792,5810,1690,4120,827,155,672
136233,20,4697,1798,2899,1946,827,1119,2751,971,1780
136303,20,243,22,221,123,16,107,120,6,114
136330,20,2837,1049,1788,2136,754,1382,701,295,406
136358,20,24151,9452,14699,6343,2771,3572,17808,6681,11127
136400,20,9257,3511,5746,2962,1228,1734,6295,2283,4012
136473,20,8604,2896,5708,3174,1178,1996,5430,1718,3712
136491,20,644,380,264,516,339,177,128,41,87
136516,20,9044,3111,5933,3148,1179,1969,5896,1932,3964
136659,20,428,295,133,168,127,41,260,168,92
136765,20,335,166,169,287,142,145,48,24,24
136774,20,1663,469,1194,1635,465,1170,28,4,24
136826,20,435,228,207,232,125,107,203,103,100
136950,20,2510,1003,1507,2427,972,1455,83,31,52
137023,20,379,175,204,373,171,202,6,4,2
137032,20,6740,2622,4118,4940,1860,3080,1800,762,1038
137078,20,24543,9239,15304,7226,3096,4130,17317,6143,11174
137087,20,655,351,304,606,339,267,49,12,37
137096,20,12830,5787,7043,5347,2661,2686,7483,3126,4357
137120,20,1489,825,664,866,467,399,623,358,265
137209,20,15315,6496,8819,4850,2412,2438,10465,4084,6381
137245,20,1492,765,727,1492,765,727,,,
137272,20,37,35,2,37,35,2,,,
137281,20,6318,2251,4067,1681,659,1022,4637,1592,3045
137315,20,2777,971,1806,1044,407,637,1733,564,1169
137351,20,38011,16437,21574,29197,12490,16707,8814,3947,4867
137476,20,3583,1699,1884,1614,887,727,1969,812,1157
137546,20,2876,1249,1627,2781,1195,1586,95,54,41
137564,20,8118,3399,4719,4589,1840,2749,3529,1559,1970
137591,20,278,43,235,259,42,217,19,1,18
137713,20,199,69,130,118,43,75,81,26,55
137759,20,11935,5052,6883,6278,2870,3408,5657,2182,3475
137777,20,30,30,0,30,30,0,,,
137801,20,511,248,263,487,243,244,24,5,19
137847,20,9838,3856,5982,9509,3684,5825,329,172,157
137856,20,178,105,73,89,52,37,89,53,36
137865,20,329,177,152,312,162,150,17,15,2
137953,20,355,199,156,276,161,115,79,38,41
137962,20,204,121,83,161,100,61,43,21,22
138187,20,43599,17360,26239,14581,6223,8358,29018,11137,17881
138275,20,782,405,377,710,371,339,72,34,38
138284,20,347,186,161,261,141,120,86,45,41
138293,20,776,522,254,747,503,244,29,19,10
138309,20,8334,1136,7198,4136,589,3547,4198,547,3651
138354,20,9319,3896,5423,6241,2736,3505,3078,1160,1918
138372,20,1624,1049,575,242,79,163,1382,970,412
138479,20,833,535,298,833,535,298,,,
138488,20,610,212,398,214,51,163,396,161,235
138497,20,384,200,184,384,200,184,,,
138558,20,3814,1527,2287,2407,1103,1304,1407,424,983
138600,20,1063,14,1049,1050,12,1038,13,2,11
138655,20,702,475,227,657,445,212,45,30,15
138664,20,65,19,46,65,19,46,,,
138682,20,2370,707,1663,831,264,567,1539,443,1096
138716,20,5824,1521,4303,3880,1077,2803,1944,444,1500
138761,20,272,125,147,200,116,84,72,9,63
138813,20,586,289,297,358,177,181,228,112,116
138822,20,577,15,562,577,15,562,,,
138840,20,3383,1124,2259,1039,444,595,2344,680,1664
138868,20,1641,767,874,709,361,348,932,406,526
138901,20,1605,548,1057,633,223,410,972,325,647
138938,20,396,32,364,222,14,208,174,18,156
138947,20,3390,803,2587,3224,762,2462,166,41,125
138956,20,3705,1576,2129,1274,565,709,2431,1011,1420
139144,20,2172,789,1383,2157,781,1376,15,8,7
139153,20,181,101,80,77,39,38,104,62,42
139199,20,1427,125,1302,927,57,870,500,68,432
139205,20,893,532,361,549,336,213,344,196,148
139250,20,3232,999,2233,1661,528,1133,1571,471,1100
139278,20,6200,2025,4175,1735,620,1115,4465,1405,3060
139311,20,6145,1807,4338,3435,1000,2435,2710,807,1903
139357,20,2927,860,2067,791,261,530,2136,599,1537
139366,20,6403,2537,3866,4274,1613,2661,2129,924,1205
139384,20,6326,2333,3993,1520,618,902,4806,1715,3091
139393,20,872,407,465,804,375,429,68,32,36
139463,20,4525,1721,2804,2705,1054,1651,1820,667,1153
139506,20,113,72,41,113,72,41,,,
139579,20,239,63,176,160,43,117,79,20,59
139621,20,2008,852,1156,1215,539,676,793,313,480
139630,20,918,493,425,758,418,340,160,75,85
139658,20,7130,3010,4120,7028,2960,4068,102,50,52
139700,20,5240,1867,3373,2042,795,1247,3198,1072,2126
139719,20,2666,986,1680,2236,830,1406,430,156,274
139746,20,67,14,53,67,14,53,,,
139755,20,17447,10504,6943,15238,9088,6150,2209,1416,793
139764,20,2466,881,1585,1521,536,985,945,345,600
139861,20,5586,2012,3574,5045,1761,3284,541,251,290
139931,20,23527,9902,13625,19307,8190,11117,4220,1712,2508
139940,20,28985,11451,17534,21992,8650,13342,6993,2801,4192
139959,20,30166,12678,17488,28223,11713,16510,1943,965,978
139968,20,3101,1035,2066,1580,585,995,1521,450,1071
139986,20,4996,1404,3592,1283,401,882,3713,1003,2710
139995,20,320,138,182,320,138,182,,,
140003,20,172,33,139,87,21,66,85,12,73
140012,20,8004,3275,4729,1649,837,812,6355,2438,3917
140234,20,583,321,262,563,320,243,20,1,19
140243,20,5068,1992,3076,1238,491,747,3830,1501,2329
140252,20,921,446,475,746,385,361,175,61,114
140331,20,8980,3785,5195,2579,1251,1328,6401,2534,3867
140340,20,572,100,472,351,72,279,221,28,193
140447,20,4941,1710,3231,4231,1555,2676,710,155,555
140553,20,2554,2553,1,2197,2197,0,357,356,1
140678,20,2660,1081,1579,817,389,428,1843,692,1151
140696,20,1446,534,912,1375,504,871,71,30,41
140720,20,251,134,117,209,113,96,42,21,21
140818,20,1255,416,839,1117,385,732,138,31,107
140827,20,66,12,54,66,12,54,,,
140872,20,1099,567,532,995,519,476,104,48,56
140942,20,3582,1317,2265,1115,494,621,2467,823,1644
140951,20,12772,3928,8844,10536,3222,7314,2236,706,1530
140960,20,3138,1190,1948,2502,960,1542,636,230,406
140988,20,1332,590,742,1113,505,608,219,85,134
141006,20,1611,762,849,679,370,309,932,392,540
141015,20,144,58,86,141,55,86,3,3,0
141060,20,2417,0,2417,2363,0,2363,54,0,54
141167,20,763,333,430,471,221,250,292,112,180
141185,20,1735,677,1058,817,327,490,918,350,568
141237,20,2605,1193,1412,834,396,438,1771,797,974
141255,20,3567,1253,2314,734,234,500,2833,1019,1814
141264,20,8760,2895,5865,6605,2180,4425,2155,715,1440
141325,20,695,43,652,455,0,455,240,43,197
141334,20,9538,3323,6215,6781,2415,4366,2757,908,1849
141361,20,1388,575,813,902,401,501,486,174,312
141486,20,1549,422,1127,1308,347,961,241,75,166
141565,20,2763,973,1790,1975,696,1279,788,277,511
141574,20,14120,5593,8527,11279,4347,6932,2841,1246,1595
141608,20,72,48,24,72,48,24,,,
141644,20,4066,1429,2637,2548,752,1796,1518,677,841
141680,20,3210,1741,1469,884,581,303,2326,1160,1166
141796,20,6100,2126,3974,1617,658,959,4483,1468,3015
141802,20,1343,517,826,246,119,127,1097,398,699
141811,20,6413,2278,4135,1833,758,1075,4580,1520,3060
141839,20,2724,864,1860,737,241,496,1987,623,1364
141981,20,3008,999,2009,1641,590,1051,1367,409,958
141990,20,2386,779,1607,459,112,347,1927,667,1260
142054,20,489,69,420,489,69,420,,,
142090,20,89,51,38,74,43,31,15,8,7
142115,20,22404,9565,12839,13270,5731,7539,9134,3834,5300
142179,20,2156,795,1361,619,258,361,1537,537,1000
142276,20,9818,4038,5780,5505,2265,3240,4313,1773,2540
142285,20,8631,4115,4516,6372,3121,3251,2259,994,1265
142294,20,1119,550,569,1104,539,565,15,11,4
142328,20,3709,1301,2408,2064,780,1284,1645,521,1124
142407,20,90,10,80,64,10,54,26,0,26
142416,20,11,1,10,11,1,10,,,
142443,20,4579,1756,2823,1735,825,910,2844,931,1913
142461,20,1323,567,756,1042,451,591,281,116,165
142489,20,43,0,43,43,0,43,,,
142522,20,44304,19348,24956,17917,8521,9396,26387,10827,15560
142559,20,7927,2942,4985,1821,707,1114,6106,2235,3871
142887,20,145,46,99,112,36,76,33,10,23
142957,20,6,4,2,3,3,0,3,1,2
143048,20,2795,693,2102,2515,620,1895,280,73,207
143084,20,2338,1075,1263,2317,1062,1255,21,13,8
143118,20,4114,1383,2731,3779,1284,2495,335,99,236
143215,20,7213,3148,4065,3011,1417,1594,4202,1731,2471
143279,20,3736,1382,2354,1306,506,800,2430,876,1554
143288,20,414,185,229,405,181,224,9,4,5
143297,20,141,8,133,112,5,107,29,3,26
143358,20,4331,2144,2187,4215,2076,2139,116,68,48
143376,20,224,14,210,133,12,121,91,2,89
143464,20,116,3,113,91,3,88,25,0,25
143473,20,40,1,39,21,1,20,19,0,19
143482,20,32,0,32,13,0,13,19,0,19
143491,20,39,2,37,12,1,11,27,1,26
143552,20,47,1,46,21,0,21,26,1,25
143613,20,1687,610,1077,674,285,389,1013,325,688
143978,20,30,5,25,23,4,19,7,1,6
144005,20,1502,461,1041,954,317,637,548,144,404
144050,20,7636,3986,3650,7601,3970,3631,35,16,19
144157,20,1903,725,1178,800,320,480,1103,405,698
144166,20,6551,1524,5027,2458,585,1873,4093,939,3154
144175,20,1831,642,1189,613,236,377,1218,406,812
144184,20,4749,1681,3068,1087,410,677,3662,1271,2391
144193,20,4545,1882,2663,1389,781,608,3156,1101,2055
144209,20,5750,2346,3404,2149,923,1226,3601,1423,2178
144218,20,7236,3088,4148,2477,1226,1251,4759,1862,2897
144281,20,6493,2594,3899,6124,2426,3698,369,168,201
144351,20,1438,622,816,1222,538,684,216,84,132
144485,20,149,102,47,149,102,47,,,
144564,20,2032,860,1172,732,291,441,1300,569,731
144573,20,134,2,132,87,1,86,47,1,46
144740,20,14294,6548,7746,12950,5871,7079,1344,677,667
144795,20,436,110,326,398,101,297,38,9,29
144865,20,20849,9502,11347,6887,3383,3504,13962,6119,7843
144883,20,487,217,270,487,217,270,,,
144892,20,6903,2805,4098,3984,1585,2399,2919,1220,1699
144944,20,8050,3434,4616,2618,1254,1364,5432,2180,3252
144962,20,2914,1122,1792,2689,1011,1678,225,111,114
144971,20,476,263,213,459,254,205,17,9,8
145099,20,283,21,262,283,21,262,,,
145239,20,308,48,260,308,48,260,,,
145309,20,48,15,33,48,15,33,,,
145336,20,2709,988,1721,1659,625,1034,1050,363,687
145354,20,52,2,50,12,0,12,40,2,38
145372,20,890,483,407,808,453,355,82,30,52
145406,20,500,7,493,136,3,133,364,4,360
145424,20,75,2,73,21,2,19,54,0,54
145433,20,114,1,113,46,0,46,68,1,67
145497,20,170,31,139,67,10,57,103,21,82
145521,20,1203,456,747,581,238,343,622,218,404
145600,20,22279,10437,11842,20071,9370,10701,2208,1067,1141
145619,20,2185,1092,1093,1837,947,890,348,145,203
145637,20,34779,18808,15971,33481,17963,15518,1298,845,453
145646,20,1653,816,837,1645,812,833,8,4,4
145682,20,7385,2990,4395,2187,1050,1137,5198,1940,3258
145691,20,1097,522,575,1069,512,557,28,10,18
145707,20,992,433,559,461,210,251,531,223,308
145725,20,2998,2025,973,2716,1806,910,282,219,63
145813,20,17674,7595,10079,16444,6972,9472,1230,623,607
145831,20,2470,1018,1452,914,430,484,1556,588,968
146205,20,2954,1151,1803,1268,524,744,1686,627,1059
146278,20,1728,687,1041,836,354,482,892,333,559
146296,20,11551,4994,6557,3657,1753,1904,7894,3241,4653
146339,20,932,428,504,850,410,440,82,18,64
146348,20,2231,845,1386,864,370,494,1367,475,892
146366,20,2282,816,1466,1109,415,694,1173,401,772
146418,20,2442,1023,1419,885,419,466,1557,604,953
146427,20,1156,501,655,1129,489,640,27,12,15
146454,20,48,0,48,48,0,48,,,
146472,20,12117,5056,7061,3800,1880,1920,8317,3176,5141
146481,20,1661,692,969,1641,682,959,20,10,10
146506,20,3644,1505,2139,1722,717,1005,1922,788,1134
146533,20,152,30,122,105,21,84,47,9,38
146603,20,4125,1714,2411,1324,585,739,2801,1129,1672
146612,20,3907,1937,1970,3253,1572,1681,654,365,289
146667,20,287,166,121,237,136,101,50,30,20
146676,20,858,428,430,649,352,297,209,76,133
146685,20,4840,1882,2958,1758,815,943,3082,1067,2015
146700,20,1184,852,332,1184,852,332,,,
146719,20,11819,3763,8056,11205,3551,7654,614,212,402
146755,20,108,17,91,72,13,59,36,4,32
146807,20,74,7,67,24,3,21,50,4,46
146816,20,258,24,234,176,13,163,82,11,71
147004,20,8765,3836,4929,2079,1050,1029,6686,2786,3900
147013,20,1443,721,722,1257,654,603,186,67,119
147129,20,514,58,456,245,31,214,269,27,242
147244,20,1812,779,1033,1693,740,953,119,39,80
147341,20,755,368,387,750,366,384,5,2,3
147369,20,1903,980,923,1511,748,763,392,232,160
147378,20,10578,5103,5475,3808,1831,1977,6770,3272,3498
147396,20,74,68,6,71,65,6,3,3,0
147411,20,3850,1602,2248,1016,490,526,2834,1112,1722
147536,20,3607,931,2676,2582,755,1827,1025,176,849
147590,20,31,9,22,17,7,10,14,2,12
147642,20,55,6,49,25,2,23,30,4,26
147660,20,2404,1163,1241,2352,1137,1215,52,26,26
147679,20,1849,749,1100,1699,691,1008,150,58,92
147703,20,11834,5575,6259,9994,4624,5370,1840,951,889
147767,20,8847,4082,4765,8438,3947,4491,409,135,274
147776,20,4608,1917,2691,2657,1095,1562,1951,822,1129
147800,20,7433,3426,4007,2136,1119,1017,5297,2307,2990
147819,20,45,2,43,45,2,43,,,
147828,20,2643,1125,1518,2508,1086,1422,135,39,96
147916,20,5394,2410,2984,2052,1034,1018,3342,1376,1966
148007,20,2618,914,1704,784,309,475,1834,605,1229
148016,20,321,170,151,316,167,149,5,3,2
148098,20,41,0,41,26,0,26,15,0,15
148131,20,1055,523,532,939,476,463,116,47,69
148256,20,2002,900,1102,951,428,523,1051,472,579
148292,20,2252,820,1432,533,199,334,1719,621,1098
148380,20,5494,2353,3141,2431,1103,1328,3063,1250,1813
148405,20,987,435,552,899,400,499,88,35,53
148487,20,2656,1041,1615,2248,910,1338,408,131,277
148496,20,2063,641,1422,1908,595,1313,155,46,109
148511,20,118,29,89,54,9,45,64,20,44
148575,20,274,43,231,216,33,183,58,10,48
148584,20,1572,480,1092,1250,419,831,322,61,261
148593,20,93,9,84,86,9,77,7,0,7
148627,20,3101,1147,1954,2848,1044,1804,253,103,150
148654,20,2503,1172,1331,1739,757,982,764,415,349
148672,20,1378,539,839,606,237,369,772,302,470
148821,20,1054,373,681,465,162,303,589,211,378
148876,20,737,131,606,536,94,442,201,37,164
148937,20,1239,539,700,450,221,229,789,318,471
148991,20,1273,526,747,525,222,303,748,304,444
149028,20,189,22,167,143,21,122,46,1,45
149204,20,35,0,35,35,0,35,,,
149222,20,8147,4189,3958,6754,3414,3340,1393,775,618
149231,20,9967,4261,5706,8089,3511,4578,1878,750,1128
149310,20,231,119,112,231,119,112,,,
149329,20,73,73,0,73,73,0,,,
149365,20,3691,1389,2302,715,272,443,2976,1117,1859
149499,20,9,0,9,9,0,9,,,
149505,20,921,324,597,774,280,494,147,44,103
149514,20,517,300,217,428,254,174,89,46,43
149532,20,9048,4199,4849,2585,1203,1382,6463,2996,3467
149550,20,151,19,132,121,17,104,30,2,28
149639,20,88,46,42,75,35,40,13,11,2
149727,20,7779,3434,4345,2355,1156,1199,5424,2278,3146
149763,20,507,95,412,369,66,303,138,29,109
149772,20,5394,2347,3047,4574,1966,2608,820,381,439
149781,20,2341,1052,1289,2202,979,1223,139,73,66
149842,20,12015,5313,6702,4010,2055,1955,8005,3258,4747
150066,20,1159,534,625,1063,504,559,96,30,66
150136,20,14898,5766,9132,13041,5052,7989,1857,714,1143
150145,20,1206,448,758,1021,390,631,185,58,127
150163,20,4537,1815,2722,4352,1753,2599,185,62,123
150172,20,523,287,236,363,188,175,160,99,61
150251,20,195,9,186,102,3,99,93,6,87
150303,20,296,5,291,98,3,95,198,2,196
150400,20,1724,852,872,1700,844,856,24,8,16
150428,20,9,0,9,9,0,9,,,
150455,20,658,299,359,657,299,358,1,0,1
150534,20,1796,717,1079,1520,595,925,276,122,154
150604,20,899,483,416,867,467,400,32,16,16
150668,20,749,288,461,683,270,413,66,18,48
150677,20,1598,609,989,1413,534,879,185,75,110
150756,20,1004,491,513,996,486,510,8,5,3
150765,20,131,3,128,131,3,128,,,
150774,20,468,251,217,431,237,194,37,14,23
150853,20,224,2,222,125,1,124,99,1,98
150941,20,1120,454,666,895,362,533,225,92,133
150987,20,86114,38439,47675,15729,6022,9707,70385,32417,37968
151102,20,7768,3767,4001,4752,2395,2357,3016,1372,1644
151111,20,19197,7777,11420,15922,6360,9562,3275,1417,1858
151263,20,4063,1472,2591,3707,1345,2362,356,127,229
151290,20,1522,897,625,1335,805,530,187,92,95
151306,20,7908,2842,5066,5242,1833,3409,2666,1009,1657
151324,20,7704,3368,4336,6280,2712,3568,1424,656,768
151333,20,2817,1012,1805,2227,782,1445,590,230,360
151342,20,3865,1366,2499,2869,992,1877,996,374,622
151351,20,34253,17152,17101,33160,16619,16541,1093,533,560
151360,20,3063,819,2244,2206,597,1609,857,222,635
151379,20,3514,1412,2102,2412,934,1478,1102,478,624
151388,20,2887,1000,1887,1666,495,1171,1221,505,716
151467,20,224,36,188,224,36,188,,,
151564,20,52,2,50,16,1,15,36,1,35
151607,20,104,5,99,71,3,68,33,2,31
151652,20,238,6,232,134,4,130,104,2,102
151661,20,1152,1044,108,1152,1044,108,,,
151777,20,981,496,485,966,488,478,15,8,7
151786,20,2980,1049,1931,2385,928,1457,595,121,474
151801,20,2461,903,1558,2222,809,1413,239,94,145
151810,20,180,48,132,85,22,63,95,26,69
151962,20,271,85,186,271,85,186,,,
152044,20,88,48,40,35,29,6,53,19,34
152080,20,8973,4627,4346,8956,4615,4341,17,12,5
152099,20,694,343,351,576,287,289,118,56,62
152150,20,53,3,50,38,2,36,15,1,14
152275,20,146,46,100,88,9,79,58,37,21
152309,20,109,40,69,88,31,57,21,9,12
152318,20,2081,1568,513,2058,1551,507,23,17,6
152336,20,1726,513,1213,1516,495,1021,210,18,192
152381,20,793,138,655,663,125,538,130,13,117
152390,20,1402,3,1399,1368,0,1368,34,3,31
152497,20,156,12,144,134,12,122,22,0,22
152530,20,1944,881,1063,1670,759,911,274,122,152
152567,20,3811,2015,1796,2259,1421,838,1552,594,958
152600,20,2507,1059,1448,2472,1045,1427,35,14,21
152628,20,42,1,41,20,1,19,22,0,22
152637,20,16389,8240,8149,4099,2160,1939,12290,6080,6210
152673,20,840,840,0,837,837,0,3,3,0
152798,20,314,25,289,280,24,256,34,1,33
152992,20,766,363,403,584,305,279,182,58,124
153001,20,1506,550,956,1289,497,792,217,53,164
153074,20,148,6,142,148,6,142,,,
153083,20,144,6,138,144,6,138,,,
153108,20,1139,584,555,1079,551,528,60,33,27
153126,20,717,391,326,690,382,308,27,9,18
153144,20,1371,597,774,1346,580,766,25,17,8
153162,20,1046,549,497,1038,542,496,8,7,1
153214,20,20536,8831,11705,5414,2559,2855,15122,6272,8850
153241,20,67,25,42,67,25,42,,,
153250,20,1535,808,727,1403,743,660,132,65,67
153269,20,2902,1156,1746,2776,1087,1689,126,69,57
153278,20,1594,927,667,1289,810,479,305,117,188
153296,20,714,345,369,517,273,244,197,72,125
153302,20,193,84,109,161,72,89,32,12,20
153311,20,7460,3140,4320,2091,837,1254,5369,2303,3066
153320,20,384,183,201,269,131,138,115,52,63
153366,20,957,465,492,877,440,437,80,25,55
153375,20,1561,748,813,1399,677,722,162,71,91
153384,20,1748,831,917,1718,812,906,30,19,11
153427,20,103,41,62,103,41,62,,,
153445,20,5085,2099,2986,1921,879,1042,3164,1220,1944
153463,20,26,1,25,26,1,25,,,
153472,20,3385,1581,1804,1704,823,881,1681,758,923
153524,20,5009,2572,2437,2497,1403,1094,2512,1169,1343
153533,20,1803,803,1000,725,406,319,1078,397,681
153542,20,14,2,12,14,2,12,,,
153597,20,48,2,46,48,2,46,,,
153603,20,25808,14467,11341,24461,13635,10826,1347,832,515
153621,20,761,442,319,677,404,273,84,38,46
153630,20,5684,2540,3144,2427,1335,1092,3257,1205,2052
153658,20,21608,9564,12044,19748,8709,11039,1860,855,1005
153737,20,12604,5638,6966,4338,2078,2260,8266,3560,4706
153746,20,23,2,21,23,2,21,,,
153764,20,46,1,45,46,1,45,,,
153773,20,44,0,44,44,0,44,,,
153782,20,14,0,14,14,0,14,,,
153825,20,1296,742,554,1185,683,502,111,59,52
153834,20,1744,757,987,1717,740,977,27,17,10
153861,20,655,153,502,320,81,239,335,72,263
153922,20,1754,715,1039,670,327,343,1084,388,696
153977,20,951,151,800,535,109,426,416,42,374
154004,20,1245,626,619,1160,591,569,85,35,50
154013,20,1290,444,846,1013,356,657,277,88,189
154022,20,33084,12097,20987,33084,12097,20987,,,
154059,20,2482,1133,1349,1173,582,591,1309,551,758
154095,20,7967,3100,4867,7290,2809,4481,677,291,386
154101,20,1053,513,540,979,503,476,74,10,64
154110,20,4013,1622,2391,916,444,472,3097,1178,1919
154129,20,1716,730,986,562,349,213,1154,381,773
154165,20,10,0,10,10,0,10,,,
154174,20,43,20,23,39,20,19,4,0,4
154208,20,133,2,131,15,0,15,118,2,116
154235,20,2228,1009,1219,2121,965,1156,107,44,63
154262,20,202,19,183,91,10,81,111,9,102
154332,20,74,5,69,74,5,69,,,
154350,20,1172,550,622,1073,507,566,99,43,56
154378,20,2319,924,1395,1103,465,638,1216,459,757
154396,20,1542,646,896,607,260,347,935,386,549
154448,20,140,4,136,140,4,136,,,
154457,20,14,0,14,14,0,14,,,
154466,20,41,4,37,41,4,37,,,
154493,20,2510,1011,1499,1289,551,738,1221,460,761
154518,20,2088,1285,803,1452,848,604,636,437,199
154527,20,1516,726,790,1473,700,773,43,26,17
154545,20,96,70,26,96,70,26,,,
154572,20,5451,2139,3312,1689,766,923,3762,1373,2389
154590,20,1304,682,622,1210,647,563,94,35,59
154642,20,2090,830,1260,961,431,530,1129,399,730
154688,20,1544,667,877,979,450,529,565,217,348
154697,20,3748,1547,2201,1336,557,779,2412,990,1422
154712,20,2202,1076,1126,2060,1012,1048,142,64,78
154721,20,737,425,312,687,404,283,50,21,29
154749,20,485,266,219,476,260,216,9,6,3
154800,20,7008,2635,4373,2931,1202,1729,4077,1433,2644
154855,20,554,241,313,480,212,268,74,29,45
154907,20,1531,634,897,585,264,321,946,370,576
154925,20,1402,812,590,863,531,332,539,281,258
154934,20,1317,399,918,576,201,375,741,198,543
154952,20,2407,974,1433,1308,623,685,1099,351,748
154998,20,1713,827,886,827,479,348,886,348,538
155007,20,345,106,239,164,59,105,181,47,134
155025,20,2948,1036,1912,2676,950,1726,272,86,186
155052,20,1365,751,614,274,138,136,1091,613,478
155061,20,11402,4459,6943,4822,1930,2892,6580,2529,4051
155070,20,168,77,91,139,64,75,29,13,16
155089,20,1192,565,627,889,447,442,303,118,185
155098,20,1644,783,861,785,429,356,859,354,505
155104,20,1962,885,1077,1017,511,506,945,374,571
155140,20,701,255,446,633,236,397,68,19,49
155159,20,94,0,94,94,0,94,,,
155177,20,331,145,186,303,137,166,28,8,20
155186,20,2640,1174,1466,897,437,460,1743,737,1006
155195,20,5114,2227,2887,1885,870,1015,3229,1357,1872
155201,20,901,432,469,453,267,186,448,165,283
155210,20,16643,7464,9179,4808,2301,2507,11835,5163,6672
155283,20,668,59,609,625,58,567,43,1,42
155292,20,4877,2046,2831,1534,682,852,3343,1364,1979
155308,20,127,101,26,124,100,24,3,1,2
155317,20,19158,8972,10186,16618,7825,8793,2540,1147,1393
155335,20,2154,837,1317,832,294,538,1322,543,779
155353,20,71,62,9,71,62,9,,,
155399,20,15619,7861,7758,13936,7097,6839,1683,764,919
155414,20,760,434,326,718,408,310,42,26,16
155423,20,1233,744,489,925,614,311,308,130,178
155450,20,1453,561,892,564,208,356,889,353,536
155487,20,896,525,371,250,145,105,646,380,266
155496,20,177,103,74,143,88,55,34,15,19
155511,20,830,557,273,811,545,266,19,12,7
155520,20,1171,552,619,906,439,467,265,113,152
155566,20,1639,677,962,556,232,324,1083,445,638
155593,20,884,525,359,395,288,107,489,237,252
155618,20,688,463,225,374,291,83,314,172,142
155627,20,787,475,312,728,428,300,59,47,12
155636,20,294,63,231,113,30,83,181,33,148
155681,20,4560,2261,2299,4045,2047,1998,515,214,301
155715,20,1125,600,525,512,342,170,613,258,355
155812,20,858,429,429,738,371,367,120,58,62
155830,20,852,383,469,234,131,103,618,252,366
155858,20,1664,633,1031,683,277,406,981,356,625
155900,20,1164,760,404,658,404,254,506,356,150
155937,20,686,405,281,548,342,206,138,63,75
155973,20,621,375,246,544,339,205,77,36,41
156082,20,4828,1803,3025,3156,1187,1969,1672,616,1056
156107,20,4834,2573,2261,1434,928,506,3400,1645,1755
156125,20,12098,5350,6748,8529,3813,4716,3569,1537,2032
156134,20,1012,597,415,1012,597,415,,,
156189,20,613,305,308,580,290,290,33,15,18
156213,20,1472,598,874,1127,467,660,345,131,214
156231,20,2479,989,1490,1126,542,584,1353,447,906
156277,20,27,2,25,27,2,25,,,
156286,20,2407,895,1512,2291,841,1450,116,54,62
156295,20,1468,598,870,1432,583,849,36,15,21
156310,20,275,5,270,245,5,240,30,0,30
156338,20,4368,1749,2619,1426,595,831,2942,1154,1788
156356,20,752,268,484,619,234,385,133,34,99
156365,20,4666,1838,2828,2424,1050,1374,2242,788,1454
156392,20,9750,3929,5821,3729,1655,2074,6021,2274,3747
156408,20,1320,636,684,1320,636,684,,,
156417,20,134,109,25,68,55,13,66,54,12
156426,20,195,13,182,126,10,116,69,3,66
156471,20,3992,332,3660,1773,135,1638,2219,197,2022
156541,20,4838,1688,3150,3638,1291,2347,1200,397,803
156620,20,11684,4749,6935,9250,3680,5570,2434,1069,1365
156648,20,5657,2317,3340,2004,819,1185,3653,1498,2155
156745,20,1259,573,686,1225,557,668,34,16,18
156754,20,45,1,44,45,1,44,,,
156790,20,2887,1265,1622,919,356,563,1968,909,1059
156842,20,207,8,199,153,5,148,54,3,51
156851,20,1454,383,1071,385,102,283,1069,281,788
156860,20,2036,618,1418,680,184,496,1356,434,922
156921,20,11811,5030,6781,2889,1308,1581,8922,3722,5200
156967,20,84,1,83,84,1,83,,,
157021,20,210,15,195,20,6,14,190,9,181
157030,20,81,47,34,53,29,24,28,18,10
157058,20,2135,860,1275,1339,538,801,796,322,474
157076,20,811,432,379,757,398,359,54,34,20
157085,20,21900,9433,12467,19829,8469,11360,2071,964,1107
157100,20,603,372,231,501,338,163,102,34,68
157216,20,1764,705,1059,1628,648,980,136,57,79
157289,20,15634,6929,8705,11450,5175,6275,4184,1754,2430
157304,20,3239,1378,1861,935,293,642,2304,1085,1219
157331,20,3532,1287,2245,1000,394,606,2532,893,1639
157377,20,1181,390,791,978,346,632,203,44,159
157386,20,8312,3217,5095,4778,1889,2889,3534,1328,2206
157401,20,7657,2871,4786,5930,2290,3640,1727,581,1146
157438,20,4089,1780,2309,1026,512,514,3063,1268,1795
157447,20,10814,4300,6514,7598,3073,4525,3216,1227,1989
157483,20,4869,1905,2964,1595,604,991,3274,1301,1973
157535,20,1369,643,726,975,461,514,394,182,212
157553,20,2162,849,1313,1236,527,709,926,322,604
157614,20,100,0,100,56,0,56,44,0,44
157650,20,125,7,118,87,5,82,38,2,36
157669,20,87,1,86,87,1,86,,,
157678,20,111,1,110,111,1,110,,,
157711,20,5014,1876,3138,1890,764,1126,3124,1112,2012
157739,20,2492,1055,1437,969,328,641,1523,727,796
157748,20,1019,546,473,639,334,305,380,212,168
157757,20,765,242,523,578,184,394,187,58,129
157793,20,2329,778,1551,1337,445,892,992,333,659
157809,20,1836,858,978,1312,643,669,524,215,309
157818,20,970,401,569,960,396,564,10,5,5
157863,20,789,418,371,741,403,338,48,15,33
157951,20,14729,5561,9168,11359,4374,6985,3370,1187,2183
158088,20,2087,1149,938,1061,526,535,1026,623,403
158246,20,161,63,98,161,63,98,,,
158325,20,110,14,96,110,14,96,,,
158343,20,48,22,26,26,10,16,22,12,10
158431,20,5727,1807,3920,2610,897,1713,3117,910,2207
158477,20,523,221,302,515,216,299,8,5,3
158538,20,57,1,56,57,1,56,,,
158617,20,475,181,294,475,181,294,,,
158662,20,12139,3691,8448,4002,1375,2627,8137,2316,5821
158778,20,47,4,43,47,4,43,,,
158787,20,60,2,58,60,2,58,,,
158802,20,1202,274,928,1128,253,875,74,21,53
158884,20,2109,785,1324,704,289,415,1405,496,909
159009,20,4405,1592,2813,3836,1407,2429,569,185,384
159027,20,17,0,17,17,0,17,,,
159197,20,555,479,76,555,479,76,,,
159328,20,102,2,100,102,2,100,,,
159373,20,893,115,778,788,97,691,105,18,87
159382,20,3771,1111,2660,2107,637,1470,1664,474,1190
159391,20,29273,13270,16003,25344,11518,13826,3929,1752,2177
159407,20,3023,791,2232,1573,441,1132,1450,350,1100
159416,20,2477,936,1541,1672,661,1011,805,275,530
159513,20,184,6,178,184,6,178,,,
159522,20,193,9,184,193,9,184,,,
159531,20,32,0,32,32,0,32,,,
159568,20,959,512,447,839,467,372,120,45,75
159601,20,38,2,36,38,2,36,,,
159647,20,10053,5270,4783,7643,4263,3380,2410,1007,1403
159656,20,3365,1111,2254,3090,1031,2059,275,80,195
159717,20,5893,2275,3618,4757,1838,2919,1136,437,699
159939,20,6508,3094,3414,4579,2221,2358,1929,873,1056
159948,20,792,479,313,178,98,80,614,381,233
159966,20,5567,2029,3538,4582,1679,2903,985,350,635
159993,20,6728,2330,4398,4333,1559,2774,2395,771,1624
160010,20,957,632,325,351,280,71,606,352,254
160038,20,9622,2792,6830,5694,1704,3990,3928,1088,2840
160065,20,881,227,654,341,62,279,540,165,375
160074,20,988,171,817,494,79,415,494,92,402
160117,20,201,1,200,201,1,200,,,
160126,20,34,0,34,8,0,8,26,0,26
160199,20,44,0,44,44,0,44,,,
160320,20,2564,88,2476,2564,88,2476,,,
160409,20,114,114,0,112,112,0,2,2,0
160472,20,195,6,189,128,4,124,67,2,65
160481,20,1762,544,1218,781,266,515,981,278,703
160524,20,279,79,200,279,79,200,,,
160579,20,3068,1449,1619,1470,753,717,1598,696,902
160597,20,127,43,84,66,21,45,61,22,39
160612,20,12459,4635,7824,8324,3111,5213,4135,1524,2611
160621,20,6560,2247,4313,5050,1695,3355,1510,552,958
160630,20,1812,493,1319,927,222,705,885,271,614
160649,20,2745,889,1856,1256,442,814,1489,447,1042
160658,20,13700,5805,7895,10874,4686,6188,2826,1119,1707
160667,20,4612,2158,2454,1344,663,681,3268,1495,1773
160755,20,8777,3416,5361,8231,3210,5021,546,206,340
160904,20,2755,650,2105,2642,608,2034,113,42,71
160959,20,374,111,263,360,108,252,14,3,11
160977,20,1821,885,936,1821,885,936,,,
160995,20,513,101,412,513,101,412,,,
161004,20,1951,963,988,1948,960,988,3,3,0
161022,20,235,22,213,111,10,101,124,12,112
161077,20,3003,1263,1740,913,470,443,2090,793,1297
161086,20,2262,1065,1197,2262,1065,1197,,,
161138,20,2076,1000,1076,698,360,338,1378,640,738
161192,20,2108,696,1412,443,161,282,1665,535,1130
161208,20,53,48,5,53,48,5,,,
161217,20,4374,1382,2992,1438,424,1014,2936,958,1978
161226,20,1580,512,1068,1293,409,884,287,103,184
161235,20,2216,635,1581,589,199,390,1627,436,1191
161253,20,10115,5097,5018,8162,4147,4015,1953,950,1003
161299,20,871,711,160,832,677,155,39,34,5
161341,20,1573,547,1026,774,285,489,799,262,537
161457,20,3671,1125,2546,2209,682,1527,1462,443,1019
161484,20,596,285,311,261,143,118,335,142,193
161493,20,165,6,159,129,4,125,36,2,34
161509,20,409,105,304,390,101,289,19,4,15
161518,20,1066,387,679,736,287,449,330,100,230
161527,20,226,22,204,148,6,142,78,16,62
161545,20,5435,2382,3053,1779,914,865,3656,1468,2188
161554,20,5956,2420,3536,3567,1397,2170,2389,1023,1366
161563,20,1304,609,695,673,344,329,631,265,366
161572,20,1991,529,1462,1990,529,1461,1,0,1
161581,20,405,163,242,176,86,90,229,77,152
161688,20,2421,682,1739,777,268,509,1644,414,1230
161767,20,10630,4145,6485,2726,1276,1450,7904,2869,5035
161800,20,94,38,56,42,15,27,52,23,29
161855,20,28,1,27,21,1,20,7,0,7
161864,20,3864,994,2870,805,229,576,3059,765,2294
161873,20,1605,634,971,869,344,525,736,290,446
162007,20,5381,2097,3284,4344,1670,2674,1037,427,610
162061,20,331,266,65,263,213,50,68,53,15
162104,20,1783,634,1149,515,226,289,1268,408,860
162122,20,5660,2081,3579,2061,870,1191,3599,1211,2388
162168,20,1738,565,1173,413,168,245,1325,397,928
162210,20,690,234,456,481,156,325,209,78,131
162283,20,1845,419,1426,1353,317,1036,492,102,390
162335,20,49,0,49,49,0,49,,,
162371,20,643,580,63,643,580,63,,,
162557,20,5389,2259,3130,1537,751,786,3852,1508,2344
162584,20,3680,1697,1983,2888,1428,1460,792,269,523
162609,20,578,279,299,292,166,126,286,113,173
162654,20,1057,366,691,1033,357,676,24,9,15
162690,20,3533,1259,2274,1137,481,656,2396,778,1618
162706,20,4596,1861,2735,1590,733,857,3006,1128,1878
162760,20,1217,435,782,1162,414,748,55,21,34
162779,20,8080,3268,4812,2377,1176,1201,5703,2092,3611
162830,20,129,5,124,129,5,124,,,
162928,20,6132,2754,3378,5727,2646,3081,405,108,297
163028,20,1109,965,144,734,638,96,375,327,48
163046,20,3787,1634,2153,3735,1607,2128,52,27,25
163204,20,45100,24548,20552,9952,5056,4896,35148,19492,15656
163259,20,930,171,759,724,139,585,206,32,174
163268,20,10835,5895,4940,9147,4992,4155,1688,903,785
163286,20,30922,15699,15223,28425,14360,14065,2497,1339,1158
163295,20,1540,375,1165,1485,363,1122,55,12,43
163338,20,1811,831,980,1619,747,872,192,84,108
163347,20,510,39,471,510,39,471,,,
163408,20,117,27,90,72,9,63,45,18,27
163426,20,17284,7773,9511,5801,2773,3028,11483,5000,6483
163453,20,7034,2696,4338,6258,2363,3895,776,333,443
163462,20,2055,999,1056,1911,925,986,144,74,70
163532,20,261,261,0,261,261,0,,,
163541,20,348,147,201,180,83,97,168,64,104
163578,20,807,30,777,623,19,604,184,11,173
163657,20,10577,3669,6908,3145,1205,1940,7432,2464,4968
163815,20,62,2,60,28,0,28,34,2,32
163851,20,6695,2974,3721,6106,2665,3441,589,309,280
163912,20,1519,643,876,1471,621,850,48,22,26
163976,20,473,250,223,470,248,222,3,2,1
164076,20,17907,7252,10655,15526,6191,9335,2381,1061,1320
164155,20,4528,3230,1298,4528,3230,1298,,,
164173,20,2979,1072,1907,2616,993,1623,363,79,284
164216,20,1026,429,597,1015,421,594,11,8,3
164270,20,1757,758,999,1736,749,987,21,9,12
164313,20,2434,783,1651,504,240,264,1930,543,1387
164368,20,638,395,243,638,395,243,,,
164447,20,1288,537,751,1199,506,693,89,31,58
164465,20,1971,957,1014,1971,957,1014,,,
164492,20,1119,635,484,921,499,422,198,136,62
164535,20,50,8,42,50,8,42,,,
164562,20,1911,833,1078,1879,821,1058,32,12,20
164580,20,2576,1465,1111,2538,1446,1092,38,19,19
164599,20,52,10,42,,,,52,10,42
164614,20,42,28,14,32,21,11,10,7,3
164632,20,1530,0,1530,968,0,968,562,0,562
164641,20,346,133,213,182,99,83,164,34,130
164739,20,3996,2422,1574,3907,2363,1544,89,59,30
164748,20,7177,4172,3005,5494,3074,2420,1683,1098,585
164775,20,1453,490,963,344,140,204,1109,350,759
164845,20,87,4,83,67,2,65,20,2,18
164872,20,290,131,159,207,106,101,83,25,58
164924,20,9939,4673,5266,9717,4544,5173,222,129,93
164988,20,18229,7719,10510,17460,7331,10129,769,388,381
165015,20,3591,1456,2135,3568,1451,2117,23,5,18
165024,20,8369,3404,4965,6520,2667,3853,1849,737,1112
165033,20,5977,2027,3950,2333,873,1460,3644,1154,2490
165060,20,170,20,150,106,15,91,64,5,59
165112,20,9371,3736,5635,2509,1199,1310,6862,2537,4325
165167,20,988,229,759,174,46,128,814,183,631
165194,20,2510,891,1619,785,351,434,1725,540,1185
165255,20,190,5,185,75,3,72,115,2,113
165264,20,1038,80,958,51,6,45,987,74,913
165334,20,2302,970,1332,2284,961,1323,18,9,9
165529,20,2050,826,1224,1807,754,1053,243,72,171
165556,20,436,56,380,319,38,281,117,18,99
165574,20,1206,610,596,1108,567,541,98,43,55
165608,20,57,5,52,39,4,35,18,1,17
165635,20,235,219,16,235,219,16,,,
165644,20,492,255,237,450,236,214,42,19,23
165662,20,4123,1468,2655,4056,1444,2612,67,24,43
165671,20,1870,422,1448,1745,394,1351,125,28,97
165699,20,2977,1105,1872,2799,1025,1774,178,80,98
165750,20,60,26,34,60,26,34,,,
165802,20,1253,391,862,588,301,287,665,90,575
165820,20,3349,1549,1800,2506,1226,1280,843,323,520
165866,20,3213,1398,1815,2734,1207,1527,479,191,288
165884,20,476,398,78,300,249,51,176,149,27
165936,20,1368,540,828,1300,512,788,68,28,40
165981,20,1433,507,926,374,136,238,1059,371,688
166018,20,472,180,292,472,180,292,,,
166027,20,9579,4696,4883,7483,3713,3770,2096,983,1113
166045,20,30,13,17,30,13,17,,,
166054,20,39,28,11,39,28,11,,,
166124,20,3029,1382,1647,3005,1375,1630,24,7,17
166133,20,3738,1293,2445,1264,530,734,2474,763,1711
166391,20,1301,472,829,1267,456,811,34,16,18
166407,20,257,18,239,17,1,16,240,17,223
166452,20,1757,411,1346,1322,317,1005,435,94,341
166489,20,39,17,22,37,16,21,2,1,1
166498,20,66,5,61,29,5,24,37,0,37
166513,20,12884,7549,5335,9997,5877,4120,2887,1672,1215
166629,20,24231,11814,12417,22539,11091,11448,1692,723,969
166638,20,12269,5156,7113,9994,4134,5860,2275,1022,1253
166647,20,3423,1470,1953,1136,583,553,2287,887,1400
166656,20,3668,893,2775,3494,850,2644,174,43,131
166674,20,1778,473,1305,1556,412,1144,222,61,161
166683,20,4638,2407,2231,4588,2373,2215,50,34,16
166692,20,1440,1244,196,1405,1213,192,35,31,4
166717,20,37,9,28,17,5,12,20,4,16
166805,20,56,41,15,30,24,6,26,17,9
166823,20,5482,2101,3381,1920,893,1027,3562,1208,2354
166850,20,4120,1918,2202,3926,1853,2073,194,65,129
166869,20,195,23,172,195,23,172,,,
166887,20,7134,2794,4340,1835,853,982,5299,1941,3358
166911,20,341,81,260,331,77,254,10,4,6
166939,20,2220,2,2218,2200,0,2200,20,2,18
166957,20,3099,953,2146,903,356,547,2196,597,1599
167039,20,13,1,12,13,1,12,,,
167057,20,423,233,190,392,213,179,31,20,11
167260,20,1207,801,406,1111,767,344,96,34,62
167288,20,870,341,529,759,309,450,111,32,79
167297,20,141,90,51,141,90,51,,,
167312,20,4573,1592,2981,1460,605,855,3113,987,2126
167358,20,15747,7221,8526,15711,7199,8512,36,22,14
167376,20,4770,1643,3127,1337,602,735,3433,1041,2392
167394,20,1060,251,809,885,210,675,175,41,134
167455,20,77,39,38,75,38,37,2,1,1
167525,20,2722,989,1733,933,401,532,1789,588,1201
167534,20,6916,2509,4407,2239,969,1270,4677,1540,3137
167598,20,1271,232,1039,1017,196,821,254,36,218
167631,20,1142,381,761,302,146,156,840,235,605
167677,20,18,18,0,18,18,0,,,
167729,20,5555,1919,3636,4234,1421,2813,1321,498,823
167783,20,1748,0,1748,1638,0,1638,110,0,110
167792,20,328,120,208,299,105,194,29,15,14
167835,20,2566,2,2564,2554,1,2553,12,1,11
167871,20,158,47,111,71,7,64,87,40,47
167899,20,2059,1016,1043,2026,995,1031,33,21,12
167905,20,4020,1516,2504,1408,614,794,2612,902,1710
167987,20,5833,2801,3032,4905,2430,2475,928,371,557
167996,20,2423,1061,1362,2349,1015,1334,74,46,28
168005,20,4227,1735,2492,4043,1637,2406,184,98,86
168032,20,16,0,16,16,0,16,,,
168148,20,6676,2991,3685,6509,2904,3605,167,87,80
168218,20,2461,30,2431,2381,0,2381,80,30,50
168227,20,3958,3080,878,3658,2855,803,300,225,75
168254,20,2601,1499,1102,2517,1460,1057,84,39,45
168263,20,4239,1877,2362,3486,1559,1927,753,318,435
168281,20,1701,651,1050,1700,650,1050,1,1,0
168342,20,2174,1045,1129,2135,1032,1103,39,13,26
168421,20,5224,3152,2072,5051,3024,2027,173,128,45
168430,20,4640,1783,2857,3575,1370,2205,1065,413,652
168528,20,1801,947,854,1715,914,801,86,33,53
168546,20,1523,710,813,1500,697,803,23,13,10
168555,20,20,0,20,18,0,18,2,0,2
168573,20,823,803,20,823,803,20,,,
168591,20,1340,568,772,1308,550,758,32,18,14
168607,20,1487,684,803,484,265,219,1003,419,584
168740,20,1358,660,698,1198,570,628,160,90,70
168786,20,1238,534,704,1059,466,593,179,68,111
168847,20,4662,1246,3416,1677,446,1231,2985,800,2185
168883,20,1958,710,1248,671,277,394,1287,433,854
168892,20,75,5,70,30,2,28,45,3,42
169080,20,3068,1444,1624,2787,1275,1512,281,169,112
169187,20,128,23,105,34,10,24,94,13,81
169248,20,11417,4492,6925,9807,3901,5906,1610,591,1019
169275,20,6245,2115,4130,1750,607,1143,4495,1508,2987
169284,20,259,13,246,195,11,184,64,2,62
169327,20,612,373,239,448,287,161,164,86,78
169363,20,968,480,488,833,433,400,135,47,88
169442,20,1558,583,975,1218,441,777,340,142,198
169479,20,4352,1936,2416,2233,1167,1066,2119,769,1350
169503,20,240,7,233,240,7,233,,,
169521,20,7054,2604,4450,1971,792,1179,5083,1812,3271
169576,20,93,3,90,93,3,90,,,
169655,20,1441,1344,97,1441,1344,97,,,
169716,20,2924,1190,1734,2182,765,1417,742,425,317
169761,20,441,38,403,441,38,403,,,
169798,20,12730,4958,7772,9038,3506,5532,3692,1452,2240
169813,20,42,1,41,42,1,41,,,
169910,20,9248,4362,4886,6566,3211,3355,2682,1151,1531
169974,20,1068,450,618,357,160,197,711,290,421
169983,20,1516,1198,318,1452,1149,303,64,49,15
169992,20,857,301,556,382,156,226,475,145,330
170000,20,1049,481,568,594,258,336,455,223,232
170037,20,1507,583,924,1132,447,685,375,136,239
170055,20,12642,5347,7295,3554,1634,1920,9088,3713,5375
170082,20,19379,7539,11840,16993,6483,10510,2386,1056,1330
170091,20,165,86,79,125,65,60,40,21,19
170240,20,11379,4658,6721,3771,1587,2184,7608,3071,4537
170286,20,1515,766,749,1473,746,727,42,20,22
170301,20,3132,1205,1927,2966,1132,1834,166,73,93
170444,20,4103,1431,2672,922,357,565,3181,1074,2107
170532,20,1241,542,699,1233,539,694,8,3,5
170541,20,6966,3032,3934,1810,826,984,5156,2206,2950
170550,20,3453,972,2481,782,284,498,2671,688,1983
170587,20,1458,556,902,425,144,281,1033,412,621
170611,20,105,2,103,91,2,89,14,0,14
170620,20,2729,958,1771,737,291,446,1992,667,1325
170639,20,1812,801,1011,1406,641,765,406,160,246
170657,20,10303,4337,5966,3248,1441,1807,7055,2896,4159
170675,20,2356,1591,765,1702,1208,494,654,383,271
170736,20,23,1,22,5,0,5,18,1,17
170790,20,16762,6868,9894,4604,1993,2611,12158,4875,7283
170806,20,2040,728,1312,1485,530,955,555,198,357
170967,20,1087,412,675,692,292,400,395,120,275
170976,20,32282,15767,16515,30798,14904,15894,1484,863,621
171012,20,135,107,28,135,107,28,,,
171100,20,38574,18668,19906,35062,16763,18299,3512,1905,1607
171128,20,5777,4087,1690,5470,3878,1592,307,209,98
171137,20,6355,3404,2951,4770,2555,2215,1585,849,736
171146,20,4995,1811,3184,3032,1122,1910,1963,689,1274
171155,20,3297,1162,2135,978,426,552,2319,736,1583
171225,20,2475,929,1546,602,247,355,1873,682,1191
171234,20,1507,500,1007,336,102,234,1171,398,773
171304,20,3699,1425,2274,1199,543,656,2500,882,1618
171395,20,1645,555,1090,533,181,352,1112,374,738
171456,20,6611,2736,3875,5785,2405,3380,826,331,495
171483,20,3296,1484,1812,1162,587,575,2134,897,1237
171492,20,2116,1261,855,1340,858,482,776,403,373
171535,20,13963,6162,7801,3306,1665,1641,10657,4497,6160
171571,20,13771,5800,7971,10869,4461,6408,2902,1339,1563
171599,20,851,494,357,788,461,327,63,33,30
171775,20,54,0,54,34,0,34,20,0,20
171881,20,114,43,71,72,25,47,42,18,24
171988,20,87,4,83,87,4,83,,,
171997,20,114,3,111,114,3,111,,,
172015,20,111,8,103,111,8,103,,,
172033,20,179,119,60,48,47,1,131,72,59
172051,20,6789,2415,4374,5713,1983,3730,1076,432,644
172200,20,8330,3367,4963,1867,859,1008,6463,2508,3955
172264,20,1782,757,1025,1116,542,574,666,215,451
172291,20,3231,1094,2137,1144,422,722,2087,672,1415
172307,20,1756,657,1099,726,311,415,1030,346,684
172334,20,1215,403,812,933,318,615,282,85,197
172422,20,118,95,23,118,95,23,,,
172440,20,424,250,174,385,237,148,39,13,26
172495,20,261,7,254,207,7,200,54,0,54
172608,20,634,343,291,63,45,18,571,298,273
172617,20,10884,4716,6168,2738,1316,1422,8146,3400,4746
172635,20,12749,4276,8473,1177,483,694,11572,3793,7779
172644,20,16839,6835,10004,12900,5070,7830,3939,1765,2174
172671,20,1004,353,651,233,94,139,771,259,512
172680,20,96,4,92,59,3,56,37,1,36
172699,20,14587,7303,7284,12149,6066,6083,2438,1237,1201
172866,20,85,77,8,85,77,8,,,
172918,20,2586,1207,1379,1062,593,469,1524,614,910
172954,20,1690,770,920,837,475,362,853,295,558
172963,20,7951,2971,4980,2691,1088,1603,5260,1883,3377
173045,20,2363,1046,1317,2113,955,1158,250,91,159
173063,20,3276,1479,1797,1094,535,559,2182,944,1238
173115,20,794,254,540,252,149,103,542,105,437
173124,20,3877,1646,2231,2550,1164,1386,1327,482,845
173142,20,781,349,432,651,301,350,130,48,82
173160,20,2653,1033,1620,2121,849,1272,532,184,348
173203,20,4448,1819,2629,1508,682,826,2940,1137,1803
173258,20,2044,996,1048,2032,994,1038,12,2,10
173300,20,1883,834,1049,1837,810,1027,46,24,22
173328,20,3357,1158,2199,2130,761,1369,1227,397,830
173416,20,2451,1353,1098,1286,832,454,1165,521,644
173452,20,795,382,413,652,332,320,143,50,93
173461,20,4373,1841,2532,1456,733,723,2917,1108,1809
173470,20,27,0,27,27,0,27,,,
173559,20,5360,2003,3357,1905,913,992,3455,1090,2365
173638,20,3347,1675,1672,974,494,480,2373,1181,1192
173647,20,2251,982,1269,2224,964,1260,27,18,9
173665,20,1817,656,1161,1747,628,1119,70,28,42
173708,20,4083,2497,1586,1375,990,385,2708,1507,1201
173735,20,859,320,539,448,248,200,411,72,339
173744,20,618,34,584,618,34,584,,,
173799,20,3729,1374,2355,1249,526,723,2480,848,1632
173805,20,983,474,509,552,321,231,431,153,278
173902,20,2244,971,1273,2206,953,1253,38,18,20
173911,20,2511,1083,1428,993,499,494,1518,584,934
173920,20,12620,5717,6903,10035,4741,5294,2585,976,1609
173957,20,258,57,201,258,57,201,,,
173993,20,885,409,476,552,300,252,333,109,224
174020,20,6000,2521,3479,2663,1151,1512,3337,1370,1967
174066,20,36209,16424,19785,29074,13262,15812,7135,3162,3973
174075,20,2304,978,1326,1050,437,613,1254,541,713
174127,20,675,213,462,667,209,458,8,4,4
174136,20,5973,2391,3582,1865,858,1007,4108,1533,2575
174154,20,750,86,664,365,48,317,385,38,347
174190,20,189,18,171,126,5,121,63,13,50
174233,20,9024,4550,4474,7699,3938,3761,1325,612,713
174251,20,1286,552,734,1140,486,654,146,66,80
174321,20,128,5,123,128,5,123,,,
174358,20,4026,1517,2509,3134,1173,1961,892,344,548
174376,20,5173,2002,3171,1543,637,906,3630,1365,2265
174428,20,8842,3712,5130,3309,1514,1795,5533,2198,3335
174437,20,950,429,521,806,364,442,144,65,79
174473,20,2716,1086,1630,919,396,523,1797,690,1107
174491,20,3289,1282,2007,2003,806,1197,1286,476,810
174507,20,387,111,276,124,33,91,263,78,185
174525,20,94,55,39,63,38,25,31,17,14
174570,20,1766,692,1074,398,179,219,1368,513,855
174604,20,179,79,100,146,70,76,33,9,24
174738,20,4658,1652,3006,1849,823,1026,2809,829,1980
174747,20,1542,0,1542,1533,0,1533,9,0,9
174756,20,3638,1430,2208,1701,781,920,1937,649,1288
174783,20,8956,4097,4859,4991,2362,2629,3965,1735,2230
174792,20,1538,1538,0,1515,1515,0,23,23,0
174817,20,1246,547,699,978,435,543,268,112,156
174844,20,2988,1261,1727,2964,1249,1715,24,12,12
174862,20,1139,528,611,644,316,328,495,212,283
174899,20,2144,658,1486,1804,579,1225,340,79,261
174914,20,6056,3127,2929,5845,3005,2840,211,122,89
174978,20,144,4,140,116,3,113,28,1,27
175005,20,2585,111,2474,1772,30,1742,813,81,732
175014,20,3658,547,3111,1694,270,1424,1964,277,1687
175041,20,5083,2167,2916,1770,859,911,3313,1308,2005
175078,20,6556,2533,4023,1650,697,953,4906,1836,3070
175120,20,409,280,129,409,280,129,,,
175157,20,575,329,246,381,250,131,194,79,115
175227,20,1382,1135,247,1141,951,190,241,184,57
175236,20,2846,1066,1780,1578,696,882,1268,370,898
175263,20,1838,832,1006,662,333,329,1176,499,677
175272,20,5748,1903,3845,4920,1612,3308,828,291,537
175315,20,7678,3190,4488,2915,1325,1590,4763,1865,2898
175342,20,2533,853,1680,2131,739,1392,402,114,288
175421,20,1714,566,1148,1105,411,694,609,155,454
175430,20,958,442,516,602,293,309,356,149,207
175494,20,59,12,47,59,12,47,,,
175519,20,1561,612,949,1102,444,658,459,168,291
175573,20,2837,1095,1742,1800,741,1059,1037,354,683
175616,20,2041,814,1227,1486,603,883,555,211,344
175643,20,2219,867,1352,1495,628,867,724,239,485
175652,20,3277,1363,1914,2090,959,1131,1187,404,783
175698,20,36,29,7,26,22,4,10,7,3
175722,20,33,0,33,33,0,33,,,
175786,20,10802,4084,6718,5299,2115,3184,5503,1969,3534
175810,20,4890,1643,3247,2990,1037,1953,1900,606,1294
175829,20,4548,1741,2807,2802,1112,1690,1746,629,1117
175856,20,4763,1670,3093,4046,1423,2623,717,247,470
175883,20,4345,1687,2658,2845,1119,1726,1500,568,932
175935,20,2718,784,1934,1798,568,1230,920,216,704
175980,20,697,348,349,690,345,345,7,3,4
176008,20,2114,708,1406,1533,552,981,581,156,425
176017,20,16092,6831,9261,15040,6326,8714,1052,505,547
176035,20,2178,462,1716,1627,305,1322,551,157,394
176044,20,1714,723,991,1134,486,648,580,237,343
176053,20,2523,1041,1482,2082,844,1238,441,197,244
176062,20,66,0,66,66,0,66,,,
176071,20,8208,3129,5079,4721,1955,2766,3487,1174,2313
176080,20,18584,9225,9359,16794,8215,8579,1790,1010,780
176169,20,3185,1227,1958,2353,940,1413,832,287,545
176178,20,6841,2560,4281,4045,1562,2483,2796,998,1798
176239,20,4986,1754,3232,3610,1323,2287,1376,431,945
176318,20,768,332,436,462,182,280,306,150,156
176336,20,90,68,22,84,63,21,6,5,1
176354,20,1673,635,1038,1275,526,749,398,109,289
176372,20,10693,3775,6918,9018,3053,5965,1675,722,953
176406,20,687,256,431,594,216,378,93,40,53
176433,20,53,1,52,33,1,32,20,0,20
176451,20,20,9,11,1,0,1,19,9,10
176479,20,3337,1095,2242,1888,591,1297,1449,504,945
176628,20,1024,398,626,916,368,548,108,30,78
176664,20,236,135,101,203,116,87,33,19,14
176716,20,112,1,111,102,1,101,10,0,10
176770,20,749,100,649,367,56,311,382,44,338
176789,20,303,141,162,176,77,99,127,64,63
176798,20,239,65,174,136,33,103,103,32,71
176910,20,141,79,62,82,47,35,59,32,27
176947,20,1144,562,582,1132,555,577,12,7,5
176965,20,7577,3369,4208,5626,2564,3062,1951,805,1146
176983,20,50,44,6,40,38,2,10,6,4
177038,20,91,29,62,60,18,42,31,11,20
177065,20,6351,2547,3804,2683,1000,1683,3668,1547,2121
177083,20,26,26,0,25,25,0,1,1,0
177117,20,303,0,303,302,0,302,1,0,1
177135,20,3989,1468,2521,1758,712,1046,2231,756,1475
177144,20,879,495,384,803,463,340,76,32,44
177214,20,1345,587,758,1318,577,741,27,10,17
177250,20,2657,1014,1643,1244,519,725,1413,495,918
177302,20,390,315,75,390,315,75,,,
177339,20,1669,757,912,1421,630,791,248,127,121
177418,20,665,252,413,592,237,355,73,15,58
177436,20,35,4,31,35,4,31,,,
177472,20,10506,4422,6084,4901,2067,2834,5605,2355,3250
177542,20,658,287,371,477,221,256,181,66,115
177551,20,1210,354,856,998,295,703,212,59,153
177588,20,48,3,45,48,3,45,,,
177603,20,72,0,72,71,0,71,1,0,1
177676,20,3680,1429,2251,1698,698,1000,1982,731,1251
177685,20,134,10,124,134,10,124,,,
177719,20,566,69,497,498,63,435,68,6,62
177746,20,726,188,538,713,184,529,13,4,9
177870,20,8,8,0,8,8,0,,,
177931,20,29,1,28,29,1,28,,,
177940,20,1689,678,1011,1174,497,677,515,181,334
177968,20,4619,2030,2589,3958,1754,2204,661,276,385
177977,20,1855,1543,312,1674,1411,263,181,132,49
177986,20,372,117,255,179,50,129,193,67,126
177995,20,13874,5483,8391,5873,2555,3318,8001,2928,5073
178004,20,16,0,16,,,,16,0,16
178059,20,5685,1775,3910,3215,1156,2059,2470,619,1851
178077,20,68,2,66,67,2,65,1,0,1
178183,20,223,18,205,223,18,205,,,
178208,20,942,630,312,440,319,121,502,311,191
178217,20,2282,787,1495,1314,452,862,968,335,633
178244,20,4238,1752,2486,1348,631,717,2890,1121,1769
178341,20,4245,1651,2594,2755,1062,1693,1490,589,901
178369,20,1741,986,755,1411,873,538,330,113,217
178387,20,4219,1584,2635,2579,993,1586,1640,591,1049
178396,20,23696,10888,12808,21875,10013,11862,1821,875,946
178402,20,10698,4409,6289,5786,2320,3466,4912,2089,2823
178411,20,5696,4396,1300,5059,3891,1168,637,505,132
178420,20,12347,5236,7111,4415,1919,2496,7932,3317,4615
178448,20,4509,1623,2886,2145,821,1324,2364,802,1562
178527,20,44,2,42,33,1,32,11,1,10
178615,20,3890,1571,2319,3203,1282,1921,687,289,398
178624,20,5306,2127,3179,4405,1792,2613,901,335,566
178679,20,559,307,252,455,258,197,104,49,55
178697,20,1479,649,830,1451,639,812,28,10,18
178721,20,7387,4006,3381,3321,1564,1757,4066,2442,1624
178767,20,97,12,85,42,7,35,55,5,50
178828,20,28,9,19,28,9,19,,,
178891,20,1826,1679,147,1329,1223,106,497,456,41
178989,20,259,37,222,259,37,222,,,
179043,20,2704,921,1783,1779,633,1146,925,288,637
179052,20,46,19,27,46,19,27,,,
179159,20,8745,3457,5288,6647,2499,4148,2098,958,1140
179195,20,33,0,33,33,0,33,,,
179229,20,21,4,17,21,4,17,,,
179256,20,62,33,29,48,26,22,14,7,7
179265,20,255,89,166,253,88,165,2,1,1
179308,20,14910,4822,10088,5269,2053,3216,9641,2769,6872
179326,20,2101,773,1328,1352,528,824,749,245,504
179344,20,1960,632,1328,684,199,485,1276,433,843
179511,20,119,1,118,71,1,70,48,0,48
179539,20,3785,1343,2442,1859,634,1225,1926,709,1217
179548,20,409,0,409,366,0,366,43,0,43
179557,20,8629,3373,5256,6548,2562,3986,2081,811,1270
179566,20,18837,7677,11160,12049,4720,7329,6788,2957,3831
179645,20,2689,800,1889,1384,423,961,1305,377,928
179715,20,1641,437,1204,699,209,490,942,228,714
179867,20,8034,3724,4310,7348,3508,3840,686,216,470
179894,20,2346,1028,1318,1881,797,1084,465,231,234
179946,20,654,377,277,639,370,269,15,7,8
179955,20,779,386,393,770,383,387,9,3,6
179964,20,781,237,544,608,178,430,173,59,114
179991,20,38,0,38,38,0,38,,,
180054,20,297,81,216,203,61,142,94,20,74
180063,20,30,1,29,30,1,29,,,
180081,20,656,330,326,266,176,90,390,154,236
180090,20,81,2,79,81,2,79,,,
180106,20,1098,428,670,1067,412,655,31,16,15
180151,20,458,212,246,258,137,121,200,75,125
180160,20,135,47,88,54,22,32,81,25,56
180179,20,3728,1335,2393,1954,785,1169,1774,550,1224
180197,20,2015,934,1081,651,325,326,1364,609,755
180203,20,143,63,80,90,38,52,53,25,28
180212,20,574,189,385,321,111,210,253,78,175
180249,20,1185,337,848,442,144,298,743,193,550
180258,20,665,243,422,530,212,318,135,31,104
180276,20,1468,598,870,338,182,156,1130,416,714
180328,20,270,83,187,176,51,125,94,32,62
180373,20,555,177,378,267,100,167,288,77,211
180416,20,1474,897,577,1382,839,543,92,58,34
180461,20,14648,7835,6813,12317,6599,5718,2331,1236,1095
180489,20,7223,3024,4199,5779,2447,3332,1444,577,867
180522,20,1008,583,425,703,412,291,305,171,134
180595,20,817,417,400,791,406,385,26,11,15
180647,20,615,191,424,463,149,314,152,42,110
180692,20,1399,461,938,1017,381,636,382,80,302
180717,20,57,33,24,41,27,14,16,6,10
180814,20,8903,3974,4929,5765,2540,3225,3138,1434,1704
180832,20,616,73,543,320,37,283,296,36,260
180878,20,620,55,565,381,29,352,239,26,213
180902,20,6309,2537,3772,1698,837,861,4611,1700,2911
180948,20,1800,719,1081,1444,591,853,356,128,228
180957,20,57,47,10,57,47,10,,,
180984,20,2550,1198,1352,1177,568,609,1373,630,743
181002,20,4481,1827,2654,4366,1779,2587,115,48,67
181020,20,1105,598,507,959,536,423,146,62,84
181127,20,924,425,499,919,422,497,5,3,2
181145,20,19,1,18,19,1,18,,,
181190,20,127,3,124,127,3,124,,,
181215,20,4427,1667,2760,3781,1452,2329,646,215,431
181297,20,857,81,776,572,57,515,285,24,261
181303,20,13709,6445,7264,4441,2230,2211,9268,4215,5053
181312,20,2101,848,1253,669,308,361,1432,540,892
181330,20,1401,686,715,1183,600,583,218,86,132
181394,20,12197,5448,6749,9969,4305,5664,2228,1143,1085
181419,20,409,129,280,74,22,52,335,107,228
181428,20,936,121,815,767,103,664,169,18,151
181446,20,1706,734,972,1606,699,907,100,35,65
181464,20,19552,9873,9679,18437,9238,9199,1115,635,480
181491,20,5345,2875,2470,1909,1022,887,3436,1853,1583
181534,20,1763,670,1093,1130,464,666,633,206,427
181543,20,26,17,9,16,14,2,10,3,7
181604,20,635,9,626,582,0,582,53,9,44
181640,20,9416,4458,4958,3249,1842,1407,6167,2616,3551
181738,20,685,294,391,561,246,315,124,48,76
181765,20,282,96,186,233,82,151,49,14,35
181783,20,3766,1543,2223,2814,1175,1639,952,368,584
181817,20,1704,667,1037,699,301,398,1005,366,639
181853,20,435,233,202,417,233,184,18,0,18
181880,20,215,9,206,215,9,206,,,
181941,20,362,222,140,362,222,140,,,
182005,20,29942,12531,17411,9075,3873,5202,20867,8658,12209
182148,20,632,138,494,632,138,494,,,
182281,20,25312,10898,14414,19496,8272,11224,5816,2626,3190
182290,20,17025,8014,9011,14016,6543,7473,3009,1471,1538
182306,20,3414,1154,2260,934,348,586,2480,806,1674
182458,20,279,143,136,261,139,122,18,4,14
182500,20,9431,4219,5212,2656,1146,1510,6775,3073,3702
182564,20,3528,1611,1917,1132,466,666,2396,1145,1251
182634,20,788,223,565,757,213,544,31,10,21
182670,20,4556,2310,2246,4555,2309,2246,1,1,0
182704,20,82,1,81,63,1,62,19,0,19
182722,20,158,22,136,117,21,96,41,1,40
182795,20,1279,598,681,1059,519,540,220,79,141
182892,20,53,2,51,37,2,35,16,0,16
182917,20,67,34,33,67,34,33,,,
182953,20,84,3,81,67,2,65,17,1,16
182980,20,1311,589,722,1172,531,641,139,58,81
182999,20,21,0,21,21,0,21,,,
183026,20,121884,44872,77012,35970,13725,22245,85914,31147,54767
183035,20,17,2,15,17,2,15,,,
183044,20,11528,5042,6486,11232,4874,6358,296,168,128
183062,20,2964,1350,1614,2877,1303,1574,87,47,40
183071,20,653,328,325,548,274,274,105,54,51
183080,20,3536,1787,1749,3368,1706,1662,168,81,87
183099,20,2887,1037,1850,919,430,489,1968,607,1361
183105,20,617,201,416,186,91,95,431,110,321
183114,20,746,173,573,126,40,86,620,133,487
183123,20,696,327,369,201,121,80,495,206,289
183132,20,2133,984,1149,601,365,236,1532,619,913
183141,20,1183,540,643,372,208,164,811,332,479
183150,20,1544,594,950,464,223,241,1080,371,709
183202,20,87,6,81,65,4,61,22,2,20
183211,20,1454,334,1120,942,259,683,512,75,437
183239,20,1954,760,1194,1940,755,1185,14,5,9
183248,20,109,22,87,46,11,35,63,11,52
183257,20,1413,399,1014,686,194,492,727,205,522
183275,20,89,41,48,89,41,48,,,
183488,20,507,23,484,387,18,369,120,5,115
183600,20,32,0,32,19,0,19,13,0,13
183655,20,4373,1561,2812,1752,711,1041,2621,850,1771
183725,20,479,214,265,404,205,199,75,9,66
183743,20,10800,4990,5810,5748,2853,2895,5052,2137,2915
183789,20,2105,536,1569,1380,384,996,725,152,573
183804,20,3150,3150,0,3129,3129,0,21,21,0
183822,20,1299,506,793,1217,475,742,82,31,51
183859,20,9566,4407,5159,4105,2108,1997,5461,2299,3162
183877,20,6273,2470,3803,2953,1305,1648,3320,1165,2155
183910,20,1631,624,1007,1565,605,960,66,19,47
183938,20,7658,2935,4723,2978,1249,1729,4680,1686,2994
183974,20,1128,410,718,1028,367,661,100,43,57
183983,20,76,71,5,76,71,5,,,
184056,20,618,144,474,396,103,293,222,41,181
184092,20,699,59,640,699,59,640,,,
184180,20,6219,3237,2982,2695,1515,1180,3524,1722,1802
184205,20,2465,833,1632,995,365,630,1470,468,1002
184348,20,1634,706,928,1589,683,906,45,23,22
184427,20,340,320,20,183,178,5,157,142,15
184481,20,6131,2405,3726,3055,1217,1838,3076,1188,1888
184506,20,107,8,99,76,3,73,31,5,26
184603,20,5540,2368,3172,1890,826,1064,3650,1542,2108
184612,20,1999,546,1453,1749,476,1273,250,70,180
184694,20,2320,1005,1315,2211,946,1265,109,59,50
184746,20,92,91,1,78,77,1,14,14,0
184773,20,1612,462,1150,1202,302,900,410,160,250
184782,20,15119,7940,7179,13061,6958,6103,2058,982,1076
184791,20,5667,2288,3379,2809,1220,1589,2858,1068,1790
184816,20,85,4,81,62,2,60,23,2,21
184959,20,680,98,582,320,44,276,360,54,306
184968,20,182,22,160,35,6,29,147,16,131
184995,20,6776,2566,4210,3420,1369,2051,3356,1197,2159
185129,20,5262,2197,3065,4385,1876,2509,877,321,556
185174,20,86,70,16,86,70,16,,,
185262,20,10573,4045,6528,8421,3231,5190,2152,814,1338
185396,20,1550,1497,53,1299,1260,39,251,237,14
185466,20,316,3,313,171,2,169,145,1,144
185509,20,6205,2728,3477,1866,977,889,4339,1751,2588
185536,20,9477,4249,5228,3894,1822,2072,5583,2427,3156
185572,20,4080,1563,2517,3908,1486,2422,172,77,95
185590,20,16093,6228,9865,14361,5471,8890,1732,757,975
185679,20,637,82,555,51,11,40,586,71,515
185721,20,436,128,308,279,95,184,157,33,124
185767,20,199,20,179,101,10,91,98,10,88
185828,20,9183,6740,2443,7305,5444,1861,1878,1296,582
185873,20,7321,3104,4217,3384,1548,1836,3937,1556,2381
185970,20,143,9,134,102,7,95,41,2,39
186016,20,466,25,441,278,15,263,188,10,178
186034,20,5076,1917,3159,1772,786,986,3304,1131,2173
186052,20,824,694,130,567,486,81,257,208,49
186131,20,5321,2674,2647,5240,2626,2614,81,48,33
186186,20,217,217,0,217,217,0,,,
186201,20,5145,2155,2990,4459,1877,2582,686,278,408
186274,20,200,20,180,110,13,97,90,7,83
186283,20,3222,1353,1869,3005,1249,1756,217,104,113
186371,20,4856,1870,2986,4055,1517,2538,801,353,448
186380,20,36152,18032,18120,34389,17185,17204,1763,847,916
186399,20,8334,3773,4561,7138,3203,3935,1196,570,626
186405,20,15,4,11,15,4,11,,,
186423,20,73,7,66,73,7,66,,,
186432,20,2134,797,1337,1937,736,1201,197,61,136
186469,20,889,335,554,487,195,292,402,140,262
186584,20,6063,2797,3266,5914,2704,3210,149,93,56
186593,20,151,24,127,105,15,90,46,9,37
186618,20,752,243,509,597,220,377,155,23,132
186645,20,6688,3247,3441,2475,1296,1179,4213,1951,2262
186867,20,4064,2841,1223,4035,2816,1219,29,25,4
186876,20,8392,3303,5089,7958,3118,4840,434,185,249
186900,20,76,76,0,76,76,0,,,
187000,20,330,316,14,289,277,12,41,39,2
187046,20,8754,5292,3462,76,19,57,8678,5273,3405
187134,20,6959,3011,3948,6781,2920,3861,178,91,87
187198,20,7930,2943,4987,3486,1585,1901,4444,1358,3086
187444,20,7219,2950,4269,5708,2394,3314,1511,556,955
187505,20,732,117,615,732,117,615,,,
187532,20,18563,7154,11409,4595,1941,2654,13968,5213,8755
187596,20,1291,496,795,528,206,322,763,290,473
187620,20,6454,2534,3920,2832,1114,1718,3622,1420,2202
187639,20,2162,666,1496,582,172,410,1580,494,1086
187648,20,3756,1478,2278,1985,760,1225,1771,718,1053
187666,20,1627,650,977,734,329,405,893,321,572
187745,20,742,301,441,208,84,124,534,217,317
187897,20,1544,543,1001,975,401,574,569,142,427
187903,20,1889,646,1243,856,381,475,1033,265,768
187912,20,476,368,108,374,303,71,102,65,37
187958,20,2005,728,1277,581,214,367,1424,514,910
187967,20,1244,847,397,1135,782,353,109,65,44
187976,20,845,392,453,108,54,54,737,338,399
187985,20,15793,6573,9220,11480,4847,6633,4313,1726,2587
187994,20,946,342,604,235,94,141,711,248,463
188003,20,1361,439,922,273,87,186,1088,352,736
188021,20,692,214,478,137,40,97,555,174,381
188030,20,11231,4705,6526,9084,3792,5292,2147,913,1234
188049,20,1883,721,1162,299,93,206,1584,628,956
188058,20,1136,480,656,506,180,326,630,300,330
188100,20,5307,1669,3638,1477,597,880,3830,1072,2758
188137,20,3266,1158,2108,682,256,426,2584,902,1682
188182,20,414,232,182,356,194,162,58,38,20
188216,20,357,108,249,233,87,146,124,21,103
188225,20,1244,426,818,138,53,85,1106,373,733
188261,20,745,466,279,102,57,45,643,409,234
188289,20,67,2,65,62,2,60,5,0,5
188304,20,1982,735,1247,1067,450,617,915,285,630
188340,20,1284,1120,164,1021,884,137,263,236,27
188429,20,5251,1643,3608,4939,1514,3425,312,129,183
188438,20,2683,1121,1562,1349,629,720,1334,492,842
188517,20,363,145,218,285,129,156,78,16,62
188526,20,647,227,420,636,224,412,11,3,8
188641,20,1485,718,767,1425,687,738,60,31,29
188650,20,140,6,134,140,6,134,,,
188669,20,35,6,29,35,6,29,,,
188678,20,181,66,115,181,66,115,,,
188687,20,412,119,293,79,21,58,333,98,235
188696,20,168,19,149,168,19,149,,,
188854,20,1656,477,1179,1656,477,1179,,,
188890,20,945,903,42,832,793,39,113,110,3
188915,20,35,9,26,19,7,12,16,2,14
188942,20,277,0,277,243,0,243,34,0,34
189088,20,2171,964,1207,1982,846,1136,189,118,71
189097,20,3043,8,3035,2959,0,2959,84,8,76
189219,20,159,147,12,159,147,12,,,
189228,20,1981,687,1294,1334,469,865,647,218,429
189255,20,135,2,133,87,2,85,48,0,48
189273,20,75,75,0,75,75,0,,,
189282,20,290,32,258,257,32,225,33,0,33
189404,20,154,3,151,56,1,55,98,2,96
189413,20,377,58,319,377,58,319,,,
189468,20,210,6,204,126,6,120,84,0,84
189477,20,110,3,107,73,2,71,37,1,36
189547,20,4755,1937,2818,2549,1055,1494,2206,882,1324
189565,20,484,134,350,383,110,273,101,24,77
189583,20,749,177,572,462,103,359,287,74,213
189592,20,333,91,242,249,82,167,84,9,75
189705,20,1866,912,954,1783,870,913,83,42,41
189714,20,290,11,279,193,9,184,97,2,95
189811,20,813,167,646,813,167,646,,,
189839,20,1693,632,1061,832,316,516,861,316,545
189848,20,717,210,507,560,167,393,157,43,114
189857,20,577,577,0,577,577,0,,,
189990,20,590,7,583,163,3,160,427,4,423
190008,20,35,11,24,35,11,24,,,
190044,20,2852,1976,876,2796,1937,859,56,39,17
190053,20,1010,440,570,294,144,150,716,296,420
190071,20,100,8,92,17,2,15,83,6,77
190099,20,3164,1423,1741,3142,1408,1734,22,15,7
190114,20,402,108,294,290,61,229,112,47,65
190150,20,8833,4472,4361,8174,4135,4039,659,337,322
190169,20,1355,462,893,397,158,239,958,304,654
190239,20,104,1,103,72,1,71,32,0,32
190318,20,247,16,231,230,16,214,17,0,17
190372,20,876,466,410,873,464,409,3,2,1
190415,20,15503,7150,8353,15450,7115,8335,53,35,18
190442,20,3954,1658,2296,1248,517,731,2706,1141,1565
190451,20,252,36,216,82,16,66,170,20,150
190503,20,2854,1449,1405,2724,1373,1351,130,76,54
190512,20,15859,8007,7852,12455,6305,6150,3404,1702,1702
190521,20,19336,7935,11401,12311,5237,7074,7025,2698,4327
190530,20,7265,2942,4323,4493,1896,2597,2772,1046,1726
190549,20,13405,5684,7721,9948,4256,5692,3457,1428,2029
190558,20,10743,4887,5856,8378,3857,4521,2365,1030,1335
190567,20,12364,5689,6675,9761,4366,5395,2603,1323,1280
190576,20,2748,705,2043,734,178,556,2014,527,1487
190585,20,5441,1645,3796,2656,912,1744,2785,733,2052
190594,20,18152,6206,11946,13706,4550,9156,4446,1656,2790
190600,20,13146,4968,8178,10452,3865,6587,2694,1103,1591
190619,20,14214,6436,7778,5732,2480,3252,8482,3956,4526
190628,20,14919,6373,8546,7473,3164,4309,7446,3209,4237
190637,20,12375,3880,8495,7927,2605,5322,4448,1275,3173
190646,20,4134,1075,3059,2978,805,2173,1156,270,886
190655,20,14277,7773,6504,8969,5258,3711,5308,2515,2793
190664,20,15883,7285,8598,11487,5248,6239,4396,2037,2359
190673,20,10989,4786,6203,6116,2892,3224,4873,1894,2979
190691,20,6769,2323,4446,4239,1447,2792,2530,876,1654
190707,20,14,3,11,14,3,11,,,
190716,20,1396,358,1038,1075,289,786,321,69,252
190725,20,1781,478,1303,1566,423,1143,215,55,160
190752,20,55,55,0,55,55,0,,,
190761,20,1147,386,761,1065,367,698,82,19,63
190840,20,7222,3173,4049,2720,1291,1429,4502,1882,2620
190956,20,141,10,131,4,0,4,137,10,127
190983,20,634,194,440,610,188,422,24,6,18
191083,20,8140,3784,4356,4704,2318,2386,3436,1466,1970
191126,20,7908,1324,6584,6875,1114,5761,1033,210,823
191199,20,5414,2263,3151,2053,913,1140,3361,1350,2011
191205,20,524,362,162,496,344,152,28,18,10
191241,20,9904,4045,5859,9443,3867,5576,461,178,283
191302,20,1738,745,993,616,271,345,1122,474,648
191311,20,81,35,46,81,35,46,,,
191339,20,4472,1687,2785,1556,621,935,2916,1066,1850
191515,20,2050,942,1108,2049,941,1108,1,1,0
191533,20,1163,488,675,1137,472,665,26,16,10
191597,20,557,75,482,270,37,233,287,38,249
191612,20,2024,800,1224,1132,446,686,892,354,538
191621,20,728,317,411,700,302,398,28,15,13
191630,20,1660,802,858,1640,791,849,20,11,9
191649,20,6050,2615,3435,5747,2453,3294,303,162,141
191676,20,863,321,542,807,297,510,56,24,32
191719,20,8454,4103,4351,4317,2375,1942,4137,1728,2409
191728,20,1015,198,817,698,147,551,317,51,266
191931,20,2994,1438,1556,2618,1231,1387,376,207,169
191940,20,213,22,191,213,22,191,,,
191959,20,52,40,12,52,40,12,,,
191968,20,4818,2157,2661,4719,2108,2611,99,49,50
191986,20,3798,1577,2221,1438,592,846,2360,985,1375
192004,20,287,74,213,282,73,209,5,1,4
192022,20,2362,859,1503,1225,473,752,1137,386,751
192040,20,144,63,81,144,63,81,,,
192110,20,602,323,279,487,259,228,115,64,51
192165,20,175,175,0,175,175,0,,,
192192,20,1119,287,832,1033,267,766,86,20,66
192271,20,1203,133,1070,1128,123,1005,75,10,65
192323,20,2713,1014,1699,2290,926,1364,423,88,335
192448,20,10707,4025,6682,5400,1791,3609,5307,2234,3073
192484,20,136,2,134,74,0,74,62,2,60
192509,20,980,157,823,880,143,737,100,14,86
192624,20,172,172,0,172,172,0,,,
192688,20,457,64,393,369,54,315,88,10,78
192703,20,3166,1802,1364,3016,1688,1328,150,114,36
192712,20,500,254,246,486,253,233,14,1,13
192749,20,1342,526,816,1290,506,784,52,20,32
192785,20,752,92,660,142,25,117,610,67,543
192800,20,20,0,20,7,0,7,13,0,13
192819,20,5510,2350,3160,4880,2035,2845,630,315,315
192864,20,1770,334,1436,1533,313,1220,237,21,216
192925,20,1293,344,949,1140,325,815,153,19,134
192961,20,130,21,109,2,1,1,128,20,108
192970,20,18,5,13,18,5,13,,,
193016,20,6505,1963,4542,5057,1458,3599,1448,505,943
193052,20,369,369,0,369,369,0,,,
193061,20,49,49,0,49,49,0,,,
193070,20,44,44,0,44,44,0,,,
193186,20,92,2,90,53,1,52,39,1,38
193201,20,476,46,430,476,46,430,,,
193247,20,125,125,0,125,125,0,,,
193265,20,90,82,8,72,66,6,18,16,2
193283,20,5347,2415,2932,2323,1120,1203,3024,1295,1729
193292,20,3308,922,2386,2657,783,1874,651,139,512
193308,20,6445,2330,4115,3993,1732,2261,2452,598,1854
193326,20,8721,3747,4974,4667,2097,2570,4054,1650,2404
193353,20,1568,445,1123,1275,367,908,293,78,215
193380,20,116,17,99,,,,116,17,99
193399,20,2281,532,1749,2126,498,1628,155,34,121
193478,20,12628,5976,6652,6931,3560,3371,5697,2416,3281
193584,20,2057,540,1517,1995,521,1474,62,19,43
193609,20,81,28,53,81,28,53,,,
193654,20,7381,1796,5585,6793,1646,5147,588,150,438
193672,20,14,11,3,14,11,3,,,
193858,20,298,21,277,298,21,277,,,
193900,20,28772,12025,16747,27642,11515,16127,1130,510,620
193946,20,4154,1655,2499,2279,964,1315,1875,691,1184
193973,20,2785,991,1794,2706,960,1746,79,31,48
193991,20,47,1,46,33,1,32,14,0,14
194028,20,1595,509,1086,580,187,393,1015,322,693
194091,20,3414,2027,1387,3008,1773,1235,406,254,152
194116,20,487,48,439,120,18,102,367,30,337
194161,20,982,407,575,783,308,475,199,99,100
194189,20,85,85,0,85,85,0,,,
194222,20,7687,3568,4119,3012,1499,1513,4675,2069,2606
194240,20,5047,1988,3059,2008,893,1115,3039,1095,1944
194259,20,32,2,30,32,2,30,,,
194310,20,8260,2837,5423,7483,2491,4992,777,346,431
194392,20,711,459,252,697,453,244,14,6,8
194435,20,55,2,53,52,2,50,3,0,3
194499,20,896,180,716,873,175,698,23,5,18
194569,20,147,83,64,69,37,32,78,46,32
194578,20,3908,1085,2823,3785,1038,2747,123,47,76
194657,20,167,167,0,167,167,0,,,
194666,20,407,407,0,407,407,0,,,
194693,20,52,52,0,52,52,0,,,
194718,20,49,49,0,49,49,0,,,
194736,20,157,157,0,157,157,0,,,
194763,20,415,415,0,415,415,0,,,
194824,20,5614,3874,1740,5564,3842,1722,50,32,18
194958,20,1118,352,766,1017,321,696,101,31,70
195003,20,14000,9304,4696,12742,8408,4334,1258,896,362
195030,20,6568,3151,3417,6239,3063,3176,329,88,241
195058,20,5637,2532,3105,2576,1324,1252,3061,1208,1853
195067,20,307,20,287,235,18,217,72,2,70
195128,20,1197,317,880,1149,305,844,48,12,36
195164,20,1796,980,816,1724,947,777,72,33,39
195173,20,2372,845,1527,2263,791,1472,109,54,55
195191,20,387,51,336,254,25,229,133,26,107
195216,20,2247,1035,1212,2222,1025,1197,25,10,15
195234,20,1798,606,1192,1720,569,1151,78,37,41
195243,20,1848,929,919,1037,539,498,811,390,421
195289,20,144,19,125,9,2,7,135,17,118
195304,20,1529,334,1195,1512,331,1181,17,3,14
195322,20,3705,1593,2112,1131,503,628,2574,1090,1484
195438,20,241,241,0,241,241,0,,,
195474,20,3496,1543,1953,3394,1498,1896,102,45,57
195526,20,2686,1097,1589,2655,1083,1572,31,14,17
195544,20,3774,1171,2603,3352,1066,2286,422,105,317
195702,20,137,16,121,75,12,63,62,4,58
195720,20,2597,1088,1509,2491,1050,1441,106,38,68
195784,20,710,82,628,710,82,628,,,
195809,20,15452,6684,8768,9890,4377,5513,5562,2307,3255
195988,20,1595,707,888,583,276,307,1012,431,581
196006,20,3414,2143,1271,3092,2050,1042,322,93,229
196015,20,2863,1252,1611,2353,1064,1289,510,188,322
196024,20,2503,1161,1342,1971,1050,921,532,111,421
196033,20,1820,807,1013,1682,743,939,138,64,74
196042,20,9284,5441,3843,7321,4345,2976,1963,1096,867
196051,20,1957,906,1051,1648,843,805,309,63,246
196060,20,12654,5867,6787,11792,5419,6373,862,448,414
196079,20,14307,6970,7337,13966,6756,7210,341,214,127
196088,20,21467,11646,9821,19773,10817,8956,1694,829,865
196097,20,17999,8810,9189,16698,8140,8558,1301,670,631
196103,20,1638,828,810,1278,652,626,360,176,184
196112,20,2037,1371,666,1737,1241,496,300,130,170
196121,20,5714,2285,3429,4880,1991,2889,834,294,540
196130,20,6147,2660,3487,5384,2271,3113,763,389,374
196149,20,5984,2629,3355,5816,2526,3290,168,103,65
196158,20,3552,1476,2076,3449,1422,2027,103,54,49
196167,20,4466,1626,2840,4293,1546,2747,173,80,93
196176,20,6256,2284,3972,5622,1997,3625,634,287,347
196185,20,5380,2089,3291,5238,2020,3218,142,69,73
196194,20,6135,2906,3229,5670,2675,2995,465,231,234
196200,20,2352,884,1468,2251,839,1412,101,45,56
196219,20,3439,1412,2027,3145,1264,1881,294,148,146
196237,20,4033,1608,2425,3399,1329,2070,634,279,355
196246,20,4323,1739,2584,3860,1568,2292,463,171,292
196255,20,193,40,153,174,39,135,19,1,18
196264,20,7926,2855,5071,3269,967,2302,4657,1888,2769
196291,20,1401,1202,199,1300,1107,193,101,95,6
196307,20,195,38,157,131,26,105,64,12,52
196389,20,900,182,718,885,178,707,15,4,11
196413,20,14778,6702,8076,14167,6376,7791,611,326,285
196431,20,385,385,0,383,383,0,2,2,0
196440,20,14,14,0,14,14,0,,,
196565,20,4563,1908,2655,1008,419,589,3555,1489,2066
196583,20,39,39,0,39,39,0,,,
196592,20,5179,1550,3629,3349,1081,2268,1830,469,1361
196653,20,1101,159,942,425,58,367,676,101,575
196680,20,15260,8002,7258,,,,15260,8002,7258
196699,20,2907,1377,1530,973,447,526,1934,930,1004
196866,20,2096,1150,946,2075,1138,937,21,12,9
197018,20,1985,1985,0,1985,1985,0,,,
197027,20,1006,788,218,1006,788,218,,,
197036,20,4411,3379,1032,4411,3379,1032,,,
197045,20,2986,1220,1766,2384,1013,1371,602,207,395
197133,20,2516,966,1550,2498,961,1537,18,5,13
197142,20,452,216,236,387,192,195,65,24,41
197151,20,3529,966,2563,3455,935,2520,74,31,43
197197,20,1568,570,998,1514,550,964,54,20,34
197221,20,105,78,27,105,78,27,,,
197230,20,342,135,207,335,131,204,7,4,3
197285,20,873,244,629,678,201,477,195,43,152
197294,20,9121,4222,4899,4369,2184,2185,4752,2038,2714
197337,20,65,0,65,59,0,59,6,0,6
197531,20,461,219,242,461,219,242,,,
197601,20,129,129,0,129,129,0,,,
197647,20,110,110,0,110,110,0,,,
197674,20,176,176,0,176,176,0,,,
197692,20,68,68,0,68,68,0,,,
197708,20,2657,1470,1187,2536,1376,1160,121,94,27
197735,20,744,744,0,744,744,0,,,
197744,20,174,174,0,174,174,0,,,
197814,20,2354,793,1561,772,271,501,1582,522,1060
197850,20,2967,1057,1910,600,255,345,2367,802,1565
197869,20,18555,8031,10524,17418,7525,9893,1137,506,631
197887,20,6270,2337,3933,1636,669,967,4634,1668,2966
197911,20,1150,513,637,1011,500,511,139,13,126
197966,20,1627,520,1107,440,139,301,1187,381,806
197984,20,1507,784,723,1363,726,637,144,58,86
197993,20,207,0,207,181,0,181,26,0,26
198011,20,1016,306,710,276,73,203,740,233,507
198039,20,2635,1005,1630,732,304,428,1903,701,1202
198066,20,770,453,317,743,438,305,27,15,12
198084,20,1649,624,1025,569,250,319,1080,374,706
198109,20,438,28,410,145,9,136,293,19,274
198118,20,3550,1419,2131,1205,527,678,2345,892,1453
198136,20,3325,1580,1745,2766,1251,1515,559,329,230
198154,20,13059,6233,6826,3760,1888,1872,9299,4345,4954
198206,20,1535,497,1038,397,138,259,1138,359,779
198215,20,1142,547,595,1044,517,527,98,30,68
198233,20,4168,1754,2414,1207,552,655,2961,1202,1759
198251,20,4871,1709,3162,1397,578,819,3474,1131,2343
198260,20,17208,7004,10204,6468,2759,3709,10740,4245,6495
198303,20,920,531,389,887,518,369,33,13,20
198321,20,2425,905,1520,796,311,485,1629,594,1035
198330,20,3571,1302,2269,1535,574,961,2036,728,1308
198367,20,2713,1121,1592,746,368,378,1967,753,1214
198376,20,3636,1222,2414,1457,533,924,2179,689,1490
198385,20,1973,931,1042,1973,931,1042,,,
198419,20,6883,3329,3554,6838,3307,3531,45,22,23
198455,20,4119,1518,2601,731,335,396,3388,1183,2205
198464,20,22463,9260,13203,18245,7684,10561,4218,1576,2642
198491,20,1508,337,1171,307,67,240,1201,270,931
198507,20,1956,786,1170,1627,696,931,329,90,239
198516,20,6302,2535,3767,6125,2461,3664,177,74,103
198534,20,9790,3592,6198,3488,1338,2150,6302,2254,4048
198543,20,5557,1640,3917,3658,1125,2533,1899,515,1384
198552,20,7774,2787,4987,2749,1153,1596,5025,1634,3391
198561,20,1983,700,1283,1669,647,1022,314,53,261
198570,20,4949,1734,3215,1169,484,685,3780,1250,2530
198598,20,755,405,350,599,354,245,156,51,105
198613,20,1192,571,621,1085,532,553,107,39,68
198622,20,9960,4108,5852,3685,1600,2085,6275,2508,3767
198640,20,943,299,644,231,76,155,712,223,489
198668,20,1318,474,844,444,175,269,874,299,575
198677,20,30,11,19,17,5,12,13,6,7
198695,20,4910,2167,2743,4854,2145,2709,56,22,34
198710,20,1913,684,1229,644,253,391,1269,431,838
198729,20,1320,408,912,396,145,251,924,263,661
198756,20,1122,477,645,1063,450,613,59,27,32
198774,20,4059,1474,2585,1359,533,826,2700,941,1759
198808,20,872,303,569,841,294,547,31,9,22
198817,20,2348,840,1508,703,284,419,1645,556,1089
198835,20,1579,666,913,1388,608,780,191,58,133
198844,20,135,4,131,133,4,129,2,0,2
198862,20,890,491,399,869,482,387,21,9,12
198871,20,501,373,128,474,352,122,27,21,6
198899,20,1025,504,521,966,486,480,59,18,41
198905,20,856,271,585,317,77,240,539,194,345
198914,20,863,374,489,267,99,168,596,275,321
198923,20,1135,443,692,269,122,147,866,321,545
198950,20,1427,2,1425,1373,0,1373,54,2,52
198969,20,1520,836,684,1376,767,609,144,69,75
198978,20,1860,358,1502,1822,352,1470,38,6,32
198987,20,3286,1295,1991,943,398,545,2343,897,1446
199005,20,32,0,32,32,0,32,,,
199023,20,712,341,371,253,141,112,459,200,259
199032,20,853,465,388,743,417,326,110,48,62
199069,20,2085,711,1374,1236,499,737,849,212,637
199078,20,175,22,153,165,21,144,10,1,9
199087,20,2874,1161,1713,799,329,470,2075,832,1243
199102,20,11596,4548,7048,10347,3944,6403,1249,604,645
199111,20,3233,1375,1858,2805,1177,1628,428,198,230
199120,20,19845,7867,11978,18931,7457,11474,914,410,504
199139,20,24116,12653,11463,20654,10797,9857,3462,1856,1606
199148,20,15178,5048,10130,12625,4195,8430,2553,853,1700
199157,20,5892,1739,4153,4770,1438,3332,1122,301,821
199184,20,938,365,573,911,352,559,27,13,14
199193,20,26505,13478,13027,23414,11732,11682,3091,1746,1345
199209,20,1424,678,746,1196,610,586,228,68,160
199218,20,14488,5071,9417,11849,4418,7431,2639,653,1986
199263,20,307,85,222,49,8,41,258,77,181
199272,20,742,340,402,628,309,319,114,31,83
199281,20,6317,2346,3971,4728,1836,2892,1589,510,1079
199306,20,744,315,429,719,302,417,25,13,12
199324,20,1187,455,732,199,81,118,988,374,614
199333,20,7346,2913,4433,2454,1001,1453,4892,1912,2980
199412,20,1440,517,923,1347,489,858,93,28,65
199421,20,2289,774,1515,601,215,386,1688,559,1129
199449,20,2164,753,1411,760,278,482,1404,475,929
199458,20,145,92,53,123,78,45,22,14,8
199467,20,624,156,468,134,39,95,490,117,373
199476,20,1809,477,1332,736,211,525,1073,266,807
199485,20,1867,649,1218,463,191,272,1404,458,946
199494,20,6716,2391,4325,1997,813,1184,4719,1578,3141
199582,20,1239,701,538,862,499,363,377,202,175
199607,20,374,9,365,280,0,280,94,9,85
199625,20,1556,486,1070,409,157,252,1147,329,818
199634,20,3986,1469,2517,1169,460,709,2817,1009,1808
199643,20,998,427,571,886,402,484,112,25,87
199689,20,190,9,181,155,4,151,35,5,30
199698,20,876,402,474,846,395,451,30,7,23
199722,20,1105,370,735,315,139,176,790,231,559
199731,20,2504,911,1593,626,223,403,1878,688,1190
199740,20,2456,669,1787,601,178,423,1855,491,1364
199759,20,775,470,305,289,192,97,486,278,208
199768,20,2849,1061,1788,778,312,466,2071,749,1322
199786,20,3789,1462,2327,1176,481,695,2613,981,1632
199795,20,962,381,581,355,129,226,607,252,355
199838,20,2757,862,1895,760,278,482,1997,584,1413
199847,20,5472,2502,2970,5391,2469,2922,81,33,48
199856,20,21299,9287,12012,6639,3245,3394,14660,6042,8618
199865,20,723,245,478,718,243,475,5,2,3
199883,20,144,13,131,144,13,131,,,
199892,20,2815,1064,1751,693,308,385,2122,756,1366
199908,20,1670,582,1088,518,199,319,1152,383,769
199926,20,2315,960,1355,753,366,387,1562,594,968
199953,20,1709,535,1174,360,124,236,1349,411,938
199962,20,2483,1029,1454,2408,991,1417,75,38,37
199971,20,65,35,30,65,35,30,,,
199980,20,26,23,3,26,23,3,,,
199999,20,4726,1126,3600,3961,993,2968,765,133,632
200004,20,10145,4427,5718,8233,3704,4529,1912,723,1189
200013,20,575,86,489,310,38,272,265,48,217
200022,20,3549,1863,1686,1826,1048,778,1723,815,908
200059,20,1337,577,760,988,454,534,349,123,226
200086,20,187,62,125,124,42,82,63,20,43
200110,20,36,0,36,36,0,36,,,
200156,20,1018,582,436,967,544,423,51,38,13
200192,20,1621,702,919,422,201,221,1199,501,698
200208,20,248,66,182,106,42,64,142,24,118
200217,20,2579,1069,1510,1856,757,1099,723,312,411
200226,20,1147,465,682,619,286,333,528,179,349
200253,20,2576,937,1639,1840,701,1139,736,236,500
200280,20,9718,5502,4216,6988,3693,3295,2730,1809,921
200305,20,2802,1542,1260,1475,978,497,1327,564,763
200314,20,1163,424,739,351,110,241,812,314,498
200332,20,10199,5081,5118,9019,4603,4416,1180,478,702
200341,20,908,318,590,565,210,355,343,108,235
200466,20,233,81,152,184,68,116,49,13,36
200484,20,161,79,82,121,62,59,40,17,23
200527,20,472,194,278,353,157,196,119,37,82
200554,20,474,179,295,423,162,261,51,17,34
200572,20,1523,637,886,819,366,453,704,271,433
200590,20,129,24,105,109,12,97,20,12,8
200785,20,410,43,367,199,23,176,211,20,191
200800,20,12268,6387,5881,9417,4996,4421,2851,1391,1460
200846,20,1575,620,955,641,268,373,934,352,582
200873,20,77,32,45,62,26,36,15,6,9
201034,20,536,301,235,120,35,85,416,266,150
201061,20,234,69,165,221,63,158,13,6,7
201098,20,47,24,23,30,13,17,17,11,6
201104,20,3731,1731,2000,2219,960,1259,1512,771,741
201131,20,105,39,66,55,1,54,50,38,12
201140,20,46,36,10,,,,46,36,10
201159,20,99,82,17,57,46,11,42,36,6
201177,20,259,25,234,105,11,94,154,14,140
201195,20,2840,1254,1586,2687,1189,1498,153,65,88
201283,20,803,302,501,369,161,208,434,141,293
201371,20,728,400,328,700,388,312,28,12,16
201432,20,1940,694,1246,916,329,587,1024,365,659
201441,20,14465,6295,8170,11915,5093,6822,2550,1202,1348
201469,20,619,154,465,470,124,346,149,30,119
201478,20,190,54,136,143,10,133,47,44,3
201496,20,448,277,171,448,277,171,,,
201539,20,84,13,71,73,7,66,11,6,5
201548,20,2090,821,1269,2010,782,1228,80,39,41
201645,20,5792,3042,2750,5661,2983,2678,131,59,72
201654,20,4191,1866,2325,3597,1631,1966,594,235,359
201672,20,2636,779,1857,485,134,351,2151,645,1506
201681,20,44,3,41,44,3,41,,,
201690,20,6035,1769,4266,3205,1062,2143,2830,707,2123
201751,20,152,37,115,46,11,35,106,26,80
201803,20,52,4,48,52,4,48,,,
201821,20,879,66,813,608,45,563,271,21,250
201867,20,104,15,89,104,15,89,,,
201885,20,28968,14320,14648,24125,12413,11712,4843,1907,2936
201928,20,8140,3144,4996,1933,847,1086,6207,2297,3910
201946,20,6529,2815,3714,1132,503,629,5397,2312,3085
201955,20,6133,2408,3725,2795,1110,1685,3338,1298,2040
201964,20,1711,666,1045,860,376,484,851,290,561
201973,20,5042,1646,3396,943,348,595,4099,1298,2801
202046,20,580,157,423,570,150,420,10,7,3
202073,20,208,102,106,208,102,106,,,
202134,20,10481,4663,5818,8241,3709,4532,2240,954,1286
202152,20,179,12,167,179,12,167,,,
202170,20,976,291,685,962,285,677,14,6,8
202222,20,25102,11110,13992,5964,2768,3196,19138,8342,10796
202356,20,17523,6579,10944,4309,1874,2435,13214,4705,8509
202435,20,106,22,84,63,11,52,43,11,32
202453,20,73,60,13,63,52,11,10,8,2
202480,20,8637,4521,4116,8285,4327,3958,352,194,158
202514,20,529,315,214,497,301,196,32,14,18
202523,20,2321,1109,1212,2307,1097,1210,14,12,2
202648,20,4435,1648,2787,1184,498,686,3251,1150,2101
202657,20,371,112,259,51,12,39,320,100,220
202763,20,3778,1349,2429,2164,706,1458,1614,643,971
202806,20,4740,1900,2840,1430,565,865,3310,1335,1975
202888,20,40,1,39,20,1,19,20,0,20
202903,20,336,165,171,149,71,78,187,94,93
202912,20,305,17,288,129,6,123,176,11,165
202949,20,166,150,16,166,150,16,,,
202985,20,54,4,50,44,4,40,10,0,10
203030,20,53,6,47,53,6,47,,,
203085,20,1054,539,515,1015,517,498,39,22,17
203128,20,1315,588,727,788,378,410,527,210,317
203146,20,359,327,32,359,327,32,,,
203155,20,2348,1149,1199,1419,811,608,929,338,591
203234,20,96,6,90,96,6,90,,,
203289,20,55,43,12,55,43,12,,,
203331,20,45173,14353,30820,13430,4290,9140,31743,10063,21680
203368,20,2660,1465,1195,2591,1417,1174,69,48,21
203386,20,2541,179,2362,1819,118,1701,722,61,661
203438,20,106,3,103,51,1,50,55,2,53
203447,20,1859,687,1172,173,57,116,1686,630,1056
203456,20,1021,337,684,28,7,21,993,330,663
203465,20,4641,1764,2877,1111,439,672,3530,1325,2205
203474,20,2068,786,1282,405,135,270,1663,651,1012
203483,20,1986,788,1198,455,175,280,1531,613,918
203492,20,1566,444,1122,270,43,227,1296,401,895
203517,20,21133,7959,13174,16988,6243,10745,4145,1716,2429
203526,20,2240,807,1433,286,101,185,1954,706,1248
203535,20,1875,855,1020,1868,853,1015,7,2,5
203544,20,617,101,516,393,53,340,224,48,176
203580,20,726,393,333,612,351,261,114,42,72
203599,20,4786,1752,3034,1354,630,724,3432,1122,2310
203614,20,454,89,365,454,89,365,,,
203678,20,3402,1207,2195,498,177,321,2904,1030,1874
203720,20,183,95,88,149,90,59,34,5,29
203739,20,54,7,47,28,5,23,26,2,24
203748,20,9520,3587,5933,2227,882,1345,7293,2705,4588
203757,20,912,387,525,734,337,397,178,50,128
203775,20,1018,422,596,796,324,472,222,98,124
203845,20,1173,599,574,1105,564,541,68,35,33
203881,20,2662,1125,1537,365,128,237,2297,997,1300
203942,20,34,16,18,34,16,18,,,
203960,20,1224,136,1088,306,43,263,918,93,825
204006,20,2289,1107,1182,1619,767,852,670,340,330
204015,20,1492,674,818,958,453,505,534,221,313
204024,20,17003,8297,8706,16615,8088,8527,388,209,179
204121,20,67,0,67,28,0,28,39,0,39
204158,20,157,47,110,157,47,110,,,
204176,20,621,77,544,433,53,380,188,24,164
204185,20,1891,964,927,1866,956,910,25,8,17
204194,20,1699,667,1032,1359,560,799,340,107,233
204200,20,1475,689,786,1013,482,531,462,207,255
204255,20,1731,699,1032,771,348,423,960,351,609
204264,20,1580,721,859,1348,657,691,232,64,168
204334,20,131,3,128,1,0,1,130,3,127
204422,20,2582,1008,1574,700,306,394,1882,702,1180
204431,20,45,9,36,45,9,36,,,
204440,20,2777,1566,1211,514,259,255,2263,1307,956
204459,20,20,14,6,20,14,6,,,
204468,20,1376,639,737,953,507,446,423,132,291
204486,20,2687,2277,410,2526,2166,360,161,111,50
204501,20,2942,1224,1718,2905,1212,1693,37,12,25
204608,20,470,419,51,470,419,51,,,
204617,20,904,445,459,766,383,383,138,62,76
204635,20,2426,1346,1080,2158,1208,950,268,138,130
204662,20,490,212,278,421,177,244,69,35,34
204671,20,871,353,518,717,290,427,154,63,91
204680,20,948,425,523,757,352,405,191,73,118
204699,20,1047,520,527,875,439,436,172,81,91
204705,20,2727,1370,1357,2254,1133,1121,473,237,236
204714,20,84,7,77,84,7,77,,,
204723,20,299,230,69,299,230,69,,,
204769,20,157,7,150,157,7,150,,,
204778,20,89,2,87,89,2,87,,,
204796,20,47106,23681,23425,43057,21554,21503,4049,2127,1922
204802,20,1204,414,790,230,74,156,974,340,634
204820,20,2211,753,1458,715,241,474,1496,512,984
204839,20,2451,811,1640,606,188,418,1845,623,1222
204848,20,2125,796,1329,502,178,324,1623,618,1005
204857,20,18399,7291,11108,14327,6318,8009,4072,973,3099
204866,20,2184,643,1541,549,123,426,1635,520,1115
204884,20,133,8,125,133,8,125,,,
204893,20,35,6,29,12,4,8,23,2,21
204909,20,1339,598,741,1333,595,738,6,3,3
204936,20,2253,905,1348,2102,846,1256,151,59,92
204945,20,7516,3776,3740,1896,810,1086,5620,2966,2654
204963,20,41,2,39,40,2,38,1,0,1
204981,20,156,39,117,24,6,18,132,33,99
205027,20,32,32,0,32,32,0,,,
205054,20,354,31,323,354,31,323,,,
205090,20,74,4,70,9,2,7,65,2,63
205124,20,51,51,0,51,51,0,,,
205142,20,164,45,119,158,45,113,6,0,6
205179,20,491,93,398,471,90,381,20,3,17
205203,20,1850,738,1112,1101,522,579,749,216,533
205391,20,195,47,148,108,26,82,87,21,66
205443,20,3025,1300,1725,2163,982,1181,862,318,544
205470,20,18544,8685,9859,3467,1769,1698,15077,6916,8161
205559,20,57,14,43,57,14,43,,,
205841,20,10596,4351,6245,2695,1264,1431,7901,3087,4814
205887,20,482,69,413,482,69,413,,,
205957,20,2610,1087,1523,2301,970,1331,309,117,192
205966,20,1933,604,1329,475,153,322,1458,451,1007
206011,20,2015,1079,936,481,243,238,1534,836,698
206039,20,48,0,48,32,0,32,16,0,16
206048,20,2204,1049,1155,1522,797,725,682,252,430
206084,20,13161,6304,6857,10738,5231,5507,2423,1073,1350
206154,20,23,17,6,3,2,1,20,15,5
206172,20,17,2,15,17,2,15,,,
206181,20,160,30,130,56,7,49,104,23,81
206279,20,489,260,229,212,105,107,277,155,122
206321,20,82,27,55,55,3,52,27,24,3
206349,20,663,47,616,566,39,527,97,8,89
206394,20,47,10,37,28,7,21,19,3,16
206437,20,1639,738,901,1377,642,735,262,96,166
206446,20,1842,657,1185,526,233,293,1316,424,892
206491,20,544,220,324,381,153,228,163,67,96
206507,20,1032,462,570,982,445,537,50,17,33
206525,20,1286,588,698,1238,567,671,48,21,27
206589,20,1968,900,1068,1947,888,1059,21,12,9
206604,20,7477,3393,4084,5564,2505,3059,1913,888,1025
206613,20,1435,578,857,758,314,444,677,264,413
206622,20,5140,2238,2902,4880,2114,2766,260,124,136
206695,20,9377,4138,5239,7428,3369,4059,1949,769,1180
206817,20,266,137,129,245,131,114,21,6,15
206835,20,782,404,378,604,336,268,178,68,110
206862,20,1486,660,826,1260,584,676,226,76,150
206905,20,282,146,136,60,23,37,222,123,99
206914,20,3158,1132,2026,2077,761,1316,1081,371,710
206923,20,1781,552,1229,867,301,566,914,251,663
206932,20,433,47,386,413,44,369,20,3,17
206941,20,11771,4452,7319,8590,3192,5398,3181,1260,1921
206996,20,1890,579,1311,978,315,663,912,264,648
207041,20,2706,1123,1583,2166,933,1233,540,190,350
207050,20,1334,459,875,626,241,385,708,218,490
207069,20,1848,716,1132,470,207,263,1378,509,869
207087,20,25,2,23,25,2,23,,,
207102,20,62,12,50,62,12,50,,,
207157,20,285,160,125,232,139,93,53,21,32
207209,20,1814,672,1142,1708,630,1078,106,42,64
207236,20,2162,679,1483,836,308,528,1326,371,955
207254,20,684,608,76,684,608,76,,,
207263,20,5523,1990,3533,3821,1449,2372,1702,541,1161
207281,20,2997,1135,1862,1222,518,704,1775,617,1158
207290,20,1763,738,1025,1234,584,650,529,154,375
207306,20,1590,661,929,1218,517,701,372,144,228
207324,20,1862,852,1010,1625,756,869,237,96,141
207342,20,853,101,752,822,94,728,31,7,24
207351,20,1294,589,705,920,472,448,374,117,257
207388,20,20216,9682,10534,17765,8605,9160,2451,1077,1374
207397,20,4456,1568,2888,998,438,560,3458,1130,2328
207403,20,1430,622,808,1332,554,778,98,68,30
207449,20,11388,4114,7274,3208,1278,1930,8180,2836,5344
207458,20,1429,479,950,1383,459,924,46,20,26
207500,20,21152,10314,10838,18307,8948,9359,2845,1366,1479
207564,20,2286,1514,772,1356,1032,324,930,482,448
207582,20,4009,1589,2420,2752,1048,1704,1257,541,716
207661,20,3054,1157,1897,1912,724,1188,1142,433,709
207670,20,6851,2445,4406,2247,873,1374,4604,1572,3032
207704,20,158,4,154,75,2,73,83,2,81
207722,20,849,304,545,780,278,502,69,26,43
207740,20,1530,500,1030,754,269,485,776,231,545
207786,20,24,1,23,24,1,23,,,
207847,20,3021,1324,1697,2076,961,1115,945,363,582
207856,20,460,261,199,410,230,180,50,31,19
207865,20,3749,1483,2266,3021,1231,1790,728,252,476
207935,20,14428,5240,9188,4645,1913,2732,9783,3327,6456
207962,20,706,622,84,706,622,84,,,
207971,20,2728,1376,1352,2614,1323,1291,114,53,61
208035,20,1314,441,873,503,233,270,811,208,603
208044,20,55,5,50,55,5,50,,,
208053,20,272,148,124,12,1,11,260,147,113
208275,20,1224,517,707,600,262,338,624,255,369
208318,20,3735,1667,2068,1727,815,912,2008,852,1156
208390,20,7492,3242,4250,3232,1357,1875,4260,1885,2375
208406,20,5217,2618,2599,1696,794,902,3521,1824,1697
208415,20,741,350,391,279,126,153,462,224,238
208433,20,79,3,76,79,3,76,,,
208479,20,464,66,398,464,66,398,,,
208512,20,401,69,332,401,69,332,,,
208637,20,198,42,156,,,,198,42,156
208646,20,2540,1017,1523,1514,621,893,1026,396,630
208725,20,44,26,18,37,20,17,7,6,1
208822,20,2559,998,1561,2341,909,1432,218,89,129
208859,20,38,5,33,38,5,33,,,
209038,20,6807,3167,3640,2701,1256,1445,4106,1911,2195
209056,20,2116,769,1347,2097,757,1340,19,12,7
209065,20,1283,509,774,1241,491,750,42,18,24
209074,20,4190,1850,2340,1583,724,859,2607,1126,1481
209083,20,98,25,73,98,25,73,,,
209153,20,27,3,24,27,3,24,,,
209205,20,35,2,33,35,2,33,,,
209241,20,34,34,0,28,28,0,6,6,0
209250,20,5893,3301,2592,1929,858,1071,3964,2443,1521
209287,20,336,189,147,289,173,116,47,16,31
209296,20,32,8,24,32,8,24,,,
209409,20,476,198,278,401,175,226,75,23,52
209490,20,783,147,636,483,94,389,300,53,247
209506,20,4776,2300,2476,2212,1177,1035,2564,1123,1441
209542,20,27564,14330,13234,18851,9934,8917,8713,4396,4317
209551,20,18602,8270,10332,17168,7589,9579,1434,681,753
209603,20,388,108,280,360,101,259,28,7,21
209612,20,1741,663,1078,1624,618,1006,117,45,72
209667,20,58,4,54,58,4,54,,,
209676,20,92,15,77,92,15,77,,,
209694,20,42,7,35,42,7,35,,,
209700,20,210,19,191,210,19,191,,,
209719,20,63,0,63,63,0,63,,,
209746,20,21214,8953,12261,8312,3666,4646,12902,5287,7615
209807,20,17753,7784,9969,12014,5183,6831,5739,2601,3138
209825,20,3589,1364,2225,3483,1321,2162,106,43,63
209922,20,1548,644,904,1515,631,884,33,13,20
209940,20,3438,1337,2101,1121,429,692,2317,908,1409
210146,20,4396,1700,2696,2589,1057,1532,1807,643,1164
210155,20,1490,559,931,797,362,435,693,197,496
210234,20,1417,617,800,734,358,376,683,259,424
210270,20,2236,833,1403,771,305,466,1465,528,937
210304,20,406,135,271,383,124,259,23,11,12
210331,20,886,393,493,697,294,403,189,99,90
210340,20,46,7,39,46,7,39,,,
210401,20,1236,521,715,1200,501,699,36,20,16
210429,20,3615,1177,2438,3049,987,2062,566,190,376
210438,20,11,5,6,,,,11,5,6
210492,20,241,122,119,226,114,112,15,8,7
210571,20,1375,615,760,1312,590,722,63,25,38
210599,20,733,376,357,733,376,357,,,
210605,20,11977,5586,6391,3791,1803,1988,8186,3783,4403
210669,20,1575,726,849,1528,707,821,47,19,28
210711,20,39,1,38,39,1,38,,,
210739,20,2309,845,1464,1949,734,1215,360,111,249
210748,20,92,1,91,39,1,38,53,0,53
210775,20,2032,691,1341,1641,615,1026,391,76,315
210784,20,137,2,135,117,2,115,20,0,20
210809,20,6283,4409,1874,,,,6283,4409,1874
211006,20,378,351,27,365,339,26,13,12,1
211024,20,467,230,237,321,160,161,146,70,76
211079,20,1735,692,1043,549,268,281,1186,424,762
211088,20,1831,621,1210,1645,555,1090,186,66,120
211130,20,25,15,10,25,15,10,,,
211158,20,7063,2751,4312,6367,2498,3869,696,253,443
211273,20,1423,0,1423,1421,0,1421,2,0,2
211291,20,3724,1755,1969,3715,1753,1962,9,2,7
211307,20,6223,2556,3667,2117,1043,1074,4106,1513,2593
211316,20,113,1,112,81,1,80,32,0,32
211334,20,26,0,26,26,0,26,,,
211343,20,2529,972,1557,953,421,532,1576,551,1025
211352,20,1343,540,803,1235,487,748,108,53,55
211361,20,4463,1933,2530,3566,1551,2015,897,382,515
211431,20,1247,191,1056,953,157,796,294,34,260
211440,20,6932,3482,3450,6743,3373,3370,189,109,80
211468,20,1053,65,988,792,42,750,261,23,238
211477,20,872,282,590,205,89,116,667,193,474
211556,20,1456,383,1073,1155,325,830,301,58,243
211583,20,1072,432,640,867,398,469,205,34,171
211608,20,642,231,411,593,212,381,49,19,30
211635,20,105,13,92,105,13,92,,,
211644,20,3156,970,2186,2451,791,1660,705,179,526
211802,20,150,23,127,150,23,127,,,
211893,20,109,59,50,109,59,50,,,
211927,20,8706,3252,5454,2084,987,1097,6622,2265,4357
211981,20,1749,706,1043,1551,633,918,198,73,125
212009,20,2180,918,1262,2145,904,1241,35,14,21
212045,20,206,46,160,204,46,158,2,0,2
212054,20,14413,7375,7038,13143,6853,6290,1270,522,748
212106,20,5085,1854,3231,5000,1805,3195,85,49,36
212115,20,4320,1877,2443,3844,1678,2166,476,199,277
212133,20,1726,554,1172,1237,447,790,489,107,382
212160,20,2939,1175,1764,2544,993,1551,395,182,213
212197,20,1691,692,999,1537,631,906,154,61,93
212230,20,37,5,32,37,5,32,,,
212267,20,73,1,72,52,1,51,21,0,21
212276,20,60,2,58,45,2,43,15,0,15
212294,20,57,1,56,51,1,50,6,0,6
212300,20,60,1,59,60,1,59,,,
212328,20,79,3,76,55,1,54,24,2,22
212337,20,80,2,78,51,0,51,29,2,27
212355,20,108,4,104,79,3,76,29,1,28
212382,20,122,2,120,78,1,77,44,1,43
212391,20,68,1,67,46,1,45,22,0,22
212434,20,227,210,17,227,210,17,,,
212577,20,2145,949,1196,2127,940,1187,18,9,9
212601,20,3165,1262,1903,2627,1065,1562,538,197,341
212656,20,1180,600,580,996,520,476,184,80,104
212674,20,2401,1174,1227,2398,1173,1225,3,1,2
212753,20,86,4,82,61,4,57,25,0,25
212771,20,129,2,127,51,0,51,78,2,76
212805,20,2306,1189,1117,2157,1109,1048,149,80,69
212832,20,1792,505,1287,1321,302,1019,471,203,268
212869,20,996,175,821,601,120,481,395,55,340
212878,20,14023,4600,9423,3683,1393,2290,10340,3207,7133
212911,20,1420,657,763,1419,657,762,1,0,1
212975,20,89,69,20,89,69,20,,,
212984,20,2171,530,1641,1813,448,1365,358,82,276
212993,20,71,27,44,66,24,42,5,3,2
213011,20,1576,456,1120,1000,319,681,576,137,439
213020,20,7333,2909,4424,6437,2448,3989,896,461,435
213163,20,271,39,232,271,39,232,,,
213181,20,346,21,325,248,17,231,98,4,94
213233,20,530,413,117,438,360,78,92,53,39
213251,20,1259,571,688,1225,554,671,34,17,17
213303,20,1171,508,663,903,450,453,268,58,210
213321,20,1831,932,899,1697,871,826,134,61,73
213330,20,18,0,18,18,0,18,,,
213349,20,6695,2890,3805,6047,2632,3415,648,258,390
213358,20,934,359,575,798,316,482,136,43,93
213367,20,2746,955,1791,2304,863,1441,442,92,350
213376,20,1916,734,1182,1256,530,726,660,204,456
213385,20,2725,1395,1330,2706,1383,1323,19,12,7
213400,20,1545,724,821,738,343,395,807,381,426
213455,20,367,9,358,42,0,42,325,9,316
213473,20,131,22,109,92,14,78,39,8,31
213491,20,52,2,50,20,2,18,32,0,32
213507,20,1691,791,900,1607,752,855,84,39,45
213525,20,6324,2162,4162,2017,905,1112,4307,1257,3050
213534,20,334,102,232,311,97,214,23,5,18
213543,20,5451,2941,2510,5375,2895,2480,76,46,30
213570,20,560,123,437,560,123,437,,,
213589,20,338,304,34,235,212,23,103,92,11
213598,20,1767,597,1170,1664,567,1097,103,30,73
213613,20,2466,956,1510,2150,891,1259,316,65,251
213622,20,114,14,100,98,12,86,16,2,14
213659,20,4187,1428,2759,1414,592,822,2773,836,1937
213668,20,1089,491,598,1081,487,594,8,4,4
213774,20,660,160,500,409,106,303,251,54,197
213783,20,1783,637,1146,1384,514,870,399,123,276
213826,20,1790,554,1236,1654,517,1137,136,37,99
213914,20,280,17,263,280,17,263,,,
213932,20,141,20,121,141,20,121,,,
213987,20,2641,1057,1584,2404,1012,1392,237,45,192
213996,20,2495,974,1521,2304,898,1406,191,76,115
214023,20,8,3,5,7,2,5,1,1,0
214041,20,6237,2551,3686,4916,2075,2841,1321,476,845
214069,20,1773,587,1186,1417,508,909,356,79,277
214111,20,8996,3560,5436,2580,1257,1323,6416,2303,4113
214148,20,357,0,357,350,0,350,7,0,7
214157,20,1928,744,1184,1802,701,1101,126,43,83
214166,20,2678,851,1827,949,280,669,1729,571,1158
214175,20,2074,839,1235,2007,806,1201,67,33,34
214272,20,1738,626,1112,1357,491,866,381,135,246
214290,20,667,623,44,667,623,44,,,
214379,20,7843,2826,5017,2929,1284,1645,4914,1542,3372
214476,20,29,5,24,27,4,23,2,1,1
214528,20,215,203,12,172,162,10,43,41,2
214582,20,549,57,492,334,42,292,215,15,200
214883,20,788,210,578,182,46,136,606,164,442
214892,20,266,108,158,266,108,158,,,
214944,20,566,484,82,387,334,53,179,150,29
214971,20,121,29,92,119,28,91,2,1,1
215008,20,61,59,2,61,59,2,,,
215044,20,106,30,76,106,30,76,,,
215053,20,228,65,163,211,60,151,17,5,12
215062,20,11292,5052,6240,10106,4609,5497,1186,443,743
215105,20,1397,485,912,1380,479,901,17,6,11
215114,20,844,380,464,786,355,431,58,25,33
215132,20,1387,452,935,1287,414,873,100,38,62
215239,20,11647,3699,7948,3689,1321,2368,7958,2378,5580
215266,20,1164,491,673,1092,469,623,72,22,50
215275,20,1320,567,753,1259,534,725,61,33,28
215284,20,2121,1196,925,2066,1164,902,55,32,23
215293,20,23885,10385,13500,19251,8453,10798,4634,1932,2702
215309,20,33,5,28,25,4,21,8,1,7
215336,20,34,0,34,34,0,34,,,
215381,20,609,560,49,609,560,49,,,
215390,20,191,65,126,45,24,21,146,41,105
215415,20,1240,728,512,1055,631,424,185,97,88
215442,20,2575,953,1622,2339,841,1498,236,112,124
215479,20,65,15,50,65,15,50,,,
215530,20,58,0,58,41,0,41,17,0,17
215585,20,4737,1576,3161,895,366,529,3842,1210,2632
215594,20,288,42,246,207,31,176,81,11,70
215637,20,245,98,147,245,98,147,,,
215655,20,3005,1656,1349,2788,1541,1247,217,115,102
215682,20,484,430,54,484,430,54,,,
215691,20,425,186,239,355,165,190,70,21,49
215743,20,2552,970,1582,1501,580,921,1051,390,661
215770,20,4196,2008,2188,3859,1844,2015,337,164,173
215798,20,1430,801,629,1365,757,608,65,44,21
215886,20,58,14,44,39,13,26,19,1,18
215929,20,3487,1457,2030,3349,1381,1968,138,76,62
215947,20,1653,582,1071,1526,549,977,127,33,94
215974,20,327,64,263,191,41,150,136,23,113
215983,20,23,5,18,23,5,18,,,
215992,20,144,67,77,143,66,77,1,1,0
216010,20,4900,2314,2586,4319,2080,2239,581,234,347
216038,20,6901,3049,3852,6423,2825,3598,478,224,254
216047,20,47,47,0,47,47,0,,,
216074,20,187,7,180,108,5,103,79,2,77
216083,20,274,101,173,237,91,146,37,10,27
216162,20,301,24,277,301,24,277,,,
216223,20,31,1,30,31,1,30,,,
216278,20,2197,960,1237,2108,924,1184,89,36,53
216287,20,1651,821,830,1649,820,829,2,1,1
216296,20,1207,1079,128,1173,1051,122,34,28,6
216311,20,117,117,0,117,117,0,,,
216339,20,25967,11445,14522,23750,10320,13430,2217,1125,1092
216357,20,783,408,375,770,402,368,13,6,7
216366,20,3754,945,2809,3326,852,2474,428,93,335
216436,20,125,112,13,125,112,13,,,
216445,20,133,127,6,133,127,6,,,
216454,20,98,86,12,98,86,12,,,
216524,20,1556,812,744,1530,798,732,26,14,12
216542,20,508,238,270,425,196,229,83,42,41
216551,20,78,61,17,71,55,16,7,6,1
216579,20,85,2,83,85,2,83,,,
216597,20,7032,3208,3824,6812,3096,3716,220,112,108
216630,20,33,4,29,33,4,29,,,
216667,20,1156,590,566,1138,575,563,18,15,3
216694,20,1182,493,689,1132,482,650,50,11,39
216746,20,58,52,6,46,42,4,12,10,2
216764,20,14471,5790,8681,12686,5068,7618,1785,722,1063
216773,20,117,19,98,117,19,98,,,
216782,20,284,13,271,137,4,133,147,9,138
216807,20,1163,539,624,1064,509,555,99,30,69
216825,20,4182,1427,2755,1349,555,794,2833,872,1961
216852,20,2766,1159,1607,2540,1096,1444,226,63,163
216931,20,2232,1016,1216,2007,925,1082,225,91,134
216940,20,243,243,0,243,243,0,,,
217013,20,977,233,744,586,142,444,391,91,300
217040,20,36,36,0,36,36,0,,,
217059,20,3527,1539,1988,3171,1361,1810,356,178,178
217077,20,446,134,312,446,134,312,,,
217156,20,7349,3536,3813,7082,3455,3627,267,81,186
217165,20,3063,1933,1130,3038,1919,1119,25,14,11
217235,20,4645,1840,2805,4332,1707,2625,313,133,180
217305,20,1739,1073,666,1523,950,573,216,123,93
217323,20,623,579,44,623,579,44,,,
217402,20,4179,1891,2288,4001,1808,2193,178,83,95
217420,20,5252,1627,3625,4058,1279,2779,1194,348,846
217475,20,11962,4698,7264,4736,2169,2567,7226,2529,4697
217484,20,14744,6389,8355,12791,5507,7284,1953,882,1071
217493,20,2044,684,1360,2044,684,1360,,,
217518,20,4207,2118,2089,3765,1889,1876,442,229,213
217536,20,2149,689,1460,2069,668,1401,80,21,59
217581,20,134,2,132,88,1,87,46,1,45
217606,20,210,117,93,155,86,69,55,31,24
217615,20,1873,659,1214,600,227,373,1273,432,841
217624,20,563,337,226,544,321,223,19,16,3
217633,20,3157,999,2158,2750,884,1866,407,115,292
217688,20,2725,970,1755,2480,882,1598,245,88,157
217712,20,2046,594,1452,471,167,304,1575,427,1148
217721,20,1895,823,1072,1884,819,1065,11,4,7
217749,20,2705,1227,1478,2285,1045,1240,420,182,238
217776,20,1043,354,689,719,262,457,324,92,232
217794,20,116,2,114,82,2,80,34,0,34
217819,20,9967,3349,6618,9230,3031,6199,737,318,419
217828,20,39,2,37,26,1,25,13,1,12
217837,20,1717,515,1202,261,79,182,1456,436,1020
217864,20,2718,2348,370,2512,2209,303,206,139,67
217873,20,1779,518,1261,1687,498,1189,92,20,72
217882,20,21653,10560,11093,20847,10060,10787,806,500,306
217891,20,153,68,85,148,66,82,5,2,3
217907,20,1171,522,649,809,336,473,362,186,176
217925,20,905,418,487,571,291,280,334,127,207
217934,20,1065,162,903,727,94,633,338,68,270
217961,20,822,138,684,781,134,647,41,4,37
217989,20,612,217,395,257,106,151,355,111,244
217998,20,820,538,282,794,524,270,26,14,12
218025,20,2861,1047,1814,1024,485,539,1837,562,1275
218061,20,3475,1156,2319,2712,924,1788,763,232,531
218070,20,2307,924,1383,2285,908,1377,22,16,6
218113,20,9756,3839,5917,4005,1729,2276,5751,2110,3641
218140,20,6416,2272,4144,2907,1247,1660,3509,1025,2484
218159,20,116,3,113,91,2,89,25,1,24
218195,20,100,3,97,60,3,57,40,0,40
218229,20,3599,1127,2472,3206,1003,2203,393,124,269
218238,20,1680,798,882,1335,666,669,345,132,213
218335,20,334,31,303,325,31,294,9,0,9
218353,20,8702,3177,5525,3586,1623,1963,5116,1554,3562
218399,20,410,184,226,402,180,222,8,4,4
218414,20,1237,722,515,1208,713,495,29,9,20
218441,20,1982,894,1088,1551,737,814,431,157,274
218487,20,2145,623,1522,640,258,382,1505,365,1140
218520,20,4491,1442,3049,1520,572,948,2971,870,2101
218539,20,991,481,510,930,462,468,61,19,42
218645,20,3101,1085,2016,2441,867,1574,660,218,442
218654,20,2023,626,1397,1605,494,1111,418,132,286
218663,20,26864,12063,14801,25634,11416,14218,1230,647,583
218672,20,1809,742,1067,704,316,388,1105,426,679
218681,20,833,343,490,343,162,181,490,181,309
218690,20,1419,562,857,514,226,288,905,336,569
218706,20,1244,568,676,335,166,169,909,402,507
218724,20,9790,4393,5397,8926,3968,4958,864,425,439
218733,20,2074,927,1147,1833,805,1028,241,122,119
218742,20,4981,1629,3352,3993,1266,2727,988,363,625
218821,20,1042,470,572,1008,455,553,34,15,19
218830,20,6097,2347,3750,2601,1154,1447,3496,1193,2303
218858,20,2640,857,1783,769,319,450,1871,538,1333
218885,20,5617,2597,3020,3147,1638,1509,2470,959,1511
218894,20,11286,4355,6931,4060,1724,2336,7226,2631,4595
218919,20,402,169,233,349,150,199,53,19,34
218955,20,530,116,414,102,19,83,428,97,331
218964,20,3973,1291,2682,3537,1141,2396,436,150,286
218973,20,1765,853,912,1745,840,905,20,13,7
218991,20,3835,1514,2321,1865,846,1019,1970,668,1302
219000,20,1715,642,1073,1626,595,1031,89,47,42
219037,20,53,1,52,53,1,52,,,
219046,20,3346,1231,2115,1697,581,1116,1649,650,999
219082,20,2751,1675,1076,1424,1005,419,1327,670,657
219091,20,770,330,440,619,301,318,151,29,122
219125,20,88,4,84,80,3,77,8,1,7
219143,20,2190,1128,1062,1511,899,612,679,229,450
219170,20,24,2,22,24,2,22,,,
219189,20,1189,769,420,845,598,247,344,171,173
219198,20,1061,509,552,578,298,280,483,211,272
219204,20,942,428,514,124,70,54,818,358,460
219240,20,36,22,14,10,3,7,26,19,7
219259,20,2867,1165,1702,1136,484,652,1731,681,1050
219277,20,1414,404,1010,628,191,437,786,213,573
219295,20,553,229,324,375,204,171,178,25,153
219338,20,17,1,16,17,1,16,,,
219347,20,2083,1591,492,1708,1318,390,375,273,102
219356,20,9847,4447,5400,7558,3559,3999,2289,888,1401
219374,20,526,116,410,198,44,154,328,72,256
219383,20,1337,483,854,1183,426,757,154,57,97
219392,20,28,7,21,28,7,21,,,
219408,20,140,59,81,80,42,38,60,17,43
219426,20,2381,1083,1298,1280,741,539,1101,342,759
219453,20,131,1,130,131,1,130,,,
219471,20,6987,2508,4479,4502,1667,2835,2485,841,1644
219480,20,1292,527,765,593,302,291,699,225,474
219505,20,57,36,21,43,26,17,14,10,4
219587,20,79,0,79,79,0,79,,,
219596,20,221,148,73,221,148,73,,,
219602,20,8418,3292,5126,5531,2108,3423,2887,1184,1703
219639,20,910,88,822,343,39,304,567,49,518
219709,20,7076,2463,4613,6792,2348,4444,284,115,169
219718,20,3446,1635,1811,1973,1062,911,1473,573,900
219790,20,1376,639,737,747,374,373,629,265,364
219806,20,1695,725,970,1566,669,897,129,56,73
219824,20,6575,2425,4150,3162,1268,1894,3413,1157,2256
219833,20,1321,588,733,1226,538,688,95,50,45
219842,20,134,79,55,12,7,5,122,72,50
219851,20,120,3,117,120,3,117,,,
219879,20,3161,1303,1858,1423,676,747,1738,627,1111
219888,20,5383,2031,3352,2988,1260,1728,2395,771,1624
219903,20,1370,100,1270,1370,100,1270,,,
219921,20,380,251,129,182,106,76,198,145,53
219949,20,2257,918,1339,1815,756,1059,442,162,280
219976,20,2952,1160,1792,2762,1076,1686,190,84,106
219994,20,799,496,303,576,328,248,223,168,55
220002,20,48,3,45,48,3,45,,,
220057,20,2778,830,1948,1186,397,789,1592,433,1159
220075,20,10316,3952,6364,8396,3224,5172,1920,728,1192
220118,20,216,12,204,216,12,204,,,
220127,20,457,262,195,426,235,191,31,27,4
220163,20,50,1,49,24,0,24,26,1,25
220181,20,914,305,609,874,291,583,40,14,26
220206,20,308,151,157,181,95,86,127,56,71
220215,20,1797,763,1034,1378,614,764,419,149,270
220251,20,525,297,228,235,130,105,290,167,123
220279,20,696,498,198,210,146,64,486,352,134
220321,20,798,437,361,426,213,213,372,224,148
220394,20,257,156,101,198,110,88,59,46,13
220400,20,3938,1181,2757,1723,548,1175,2215,633,1582
220464,20,191,80,111,56,24,32,135,56,79
220473,20,658,319,339,570,268,302,88,51,37
220491,20,273,11,262,199,8,191,74,3,71
220516,20,1356,491,865,1160,424,736,196,67,129
220552,20,4598,642,3956,3503,493,3010,1095,149,946
220598,20,1047,560,487,988,528,460,59,32,27
220604,20,613,215,398,529,184,345,84,31,53
220613,20,3950,1495,2455,3041,1099,1942,909,396,513
220631,20,1673,481,1192,1209,402,807,464,79,385
220640,20,1602,960,642,307,143,164,1295,817,478
220701,20,852,369,483,715,314,401,137,55,82
220710,20,1046,479,567,963,444,519,83,35,48
220756,20,106,88,18,85,68,17,21,20,1
220765,20,326,74,252,231,44,187,95,30,65
220853,20,1118,702,416,678,433,245,440,269,171
220862,20,16702,6573,10129,11142,4480,6662,5560,2093,3467
220978,20,18603,8405,10198,15112,6903,8209,3491,1502,1989
221050,20,787,597,190,526,394,132,261,203,58
221096,20,5852,2147,3705,2804,1168,1636,3048,979,2069
221102,20,496,349,147,400,266,134,96,83,13
221148,20,1464,1372,92,1464,1372,92,,,
221184,20,6647,2390,4257,2830,1145,1685,3817,1245,2572
221236,20,477,318,159,247,172,75,230,146,84
221281,20,205,104,101,145,72,73,60,32,28
221333,20,561,429,132,201,117,84,360,312,48
221351,20,2050,833,1217,1996,825,1171,54,8,46
221388,20,197,72,125,141,41,100,56,31,25
221397,20,4775,1610,3165,2276,883,1393,2499,727,1772
221430,20,1004,701,303,257,168,89,747,533,214
221485,20,7168,2549,4619,3017,1179,1838,4151,1370,2781
221494,20,472,382,90,366,307,59,106,75,31
221519,20,1735,818,917,1724,813,911,11,5,6
221582,20,335,232,103,147,86,61,188,146,42
221591,20,451,306,145,330,211,119,121,95,26
221607,20,336,253,83,185,123,62,151,130,21
221616,20,1541,1149,392,493,333,160,1048,816,232
221625,20,971,612,359,698,395,303,273,217,56
221643,20,8835,4150,4685,4201,2115,2086,4634,2035,2599
221661,20,2400,1077,1323,2100,953,1147,300,124,176
221731,20,974,350,624,895,318,577,79,32,47
221740,20,10016,4175,5841,8957,3688,5269,1059,487,572
221759,20,25067,11525,13542,23875,10875,13000,1192,650,542
221768,20,6007,2304,3703,4363,1728,2635,1644,576,1068
221829,20,329,12,317,329,12,317,,,
221838,20,6375,2320,4055,4907,1702,3205,1468,618,850
221847,20,8394,4469,3925,7550,4013,3537,844,456,388
221892,20,1917,729,1188,1486,571,915,431,158,273
221908,20,5205,2362,2843,2833,1282,1551,2372,1080,1292
221953,20,1234,568,666,979,476,503,255,92,163
221971,20,1993,696,1297,1634,563,1071,359,133,226
221999,20,7111,3476,3635,7042,3435,3607,69,41,28
222053,20,7417,2727,4690,3623,1430,2193,3794,1297,2497
222062,20,5379,1879,3500,2691,1030,1661,2688,849,1839
222105,20,340,316,24,153,143,10,187,173,14
222178,20,3138,1231,1907,3032,1180,1852,106,51,55
222567,20,4973,2017,2956,894,383,511,4079,1634,2445
222576,20,9179,3231,5948,3266,1230,2036,5913,2001,3912
222628,20,162,55,107,38,21,17,124,34,90
222822,20,4272,1548,2724,1352,494,858,2920,1054,1866
222831,20,9121,3705,5416,4955,2016,2939,4166,1689,2477
222877,20,213,128,85,208,128,80,5,0,5
222886,20,343,30,313,328,29,299,15,1,14
222938,20,386,171,215,243,113,130,143,58,85
222983,20,1212,564,648,1205,562,643,7,2,5
222992,20,35609,14716,20893,7722,3690,4032,27887,11026,16861
223056,20,41,2,39,41,2,39,,,
223083,20,508,86,422,127,21,106,381,65,316
223117,20,51,40,11,2,1,1,49,39,10
223232,20,15191,6053,9138,14878,5927,8951,313,126,187
223320,20,3902,1481,2421,897,361,536,3005,1120,1885
223427,20,17420,8688,8732,8388,4357,4031,9032,4331,4701
223463,20,427,132,295,427,132,295,,,
223472,20,220,20,200,220,20,200,,,
223506,20,3916,1818,2098,634,320,314,3282,1498,1784
223816,20,8922,3733,5189,1593,608,985,7329,3125,4204
223852,20,23,1,22,23,1,22,,,
223898,20,3105,1181,1924,1104,431,673,2001,750,1251
223922,20,1372,570,802,571,244,327,801,326,475
224004,20,1708,555,1153,1414,479,935,294,76,218
224013,20,32,2,30,32,2,30,,,
224110,20,7653,3180,4473,1646,726,920,6007,2454,3553
224147,20,8027,3160,4867,5954,2269,3685,2073,891,1182
224156,20,383,8,375,374,8,366,9,0,9
224226,20,3067,1330,1737,2300,985,1315,767,345,422
224244,20,317,179,138,239,140,99,78,39,39
224271,20,595,157,438,594,156,438,1,1,0
224323,20,1500,651,849,1466,636,830,34,15,19
224350,20,10395,4282,6113,1590,704,886,8805,3578,5227
224527,20,1519,721,798,1223,611,612,296,110,186
224545,20,1769,652,1117,1317,515,802,452,137,315
224554,20,7584,3083,4501,5447,2229,3218,2137,854,1283
224615,20,69171,27460,41711,15147,6547,8600,54024,20913,33111
224642,20,24621,10085,14536,6691,2938,3753,17930,7147,10783
224660,20,566,288,278,447,240,207,119,48,71
224679,20,1303,1122,181,778,655,123,525,467,58
224758,20,34,3,31,26,2,24,8,1,7
224776,20,330,151,179,190,90,100,140,61,79
224828,20,59,0,59,42,0,42,17,0,17
224891,20,1586,680,906,679,304,375,907,376,531
224961,20,1870,651,1219,661,281,380,1209,370,839
225070,20,3792,1383,2409,1311,495,816,2481,888,1593
225201,20,868,570,298,868,570,298,,,
225247,20,1476,695,781,1412,667,745,64,28,36
225308,20,5461,2184,3277,1645,676,969,3816,1508,2308
225371,20,3826,1498,2328,1892,756,1136,1934,742,1192
225399,20,2780,962,1818,2164,757,1407,616,205,411
225414,20,6764,2421,4343,3363,1213,2150,3401,1208,2193
225423,20,46780,18363,28417,13236,5701,7535,33544,12662,20882
225432,20,13612,4957,8655,6584,2468,4116,7028,2489,4539
225502,20,3037,1053,1984,1377,512,865,1660,541,1119
225511,20,38581,18823,19758,27648,13109,14539,10933,5714,5219
225520,20,4050,1561,2489,1027,363,664,3023,1198,1825
225548,20,863,440,423,715,378,337,148,62,86
225575,20,991,397,594,912,368,544,79,29,50
225627,20,4846,1781,3065,3994,1427,2567,852,354,498
225876,20,477,205,272,211,115,96,266,90,176
225885,20,721,324,397,615,289,326,106,35,71
225991,20,117,70,47,117,70,47,,,
226019,20,5120,2058,3062,2020,916,1104,3100,1142,1958
226091,20,8377,3393,4984,4496,1931,2565,3881,1462,2419
226107,20,2353,728,1625,806,257,549,1547,471,1076
226116,20,2361,853,1508,788,292,496,1573,561,1012
226125,20,124,11,113,124,11,113,,,
226134,20,9984,4265,5719,2316,958,1358,7668,3307,4361
226152,20,6890,2661,4229,5282,2043,3239,1608,618,990
226204,20,7159,3650,3509,1015,542,473,6144,3108,3036
226231,20,2991,1613,1378,1390,904,486,1601,709,892
226277,20,1387,1285,102,1387,1285,102,,,
226383,20,1393,512,881,1173,423,750,220,89,131
226408,20,4133,1576,2557,1118,446,672,3015,1130,1885
226471,20,3224,1131,2093,2994,1048,1946,230,83,147
226578,20,7337,2341,4996,2134,735,1399,5203,1606,3597
226587,20,1142,580,562,998,519,479,144,61,83
226675,20,377,49,328,377,49,328,,,
226806,20,5016,1955,3061,1409,548,861,3607,1407,2200
226833,20,5041,1790,3251,3619,1347,2272,1422,443,979
226860,20,56,2,54,56,2,54,,,
226879,20,216,34,182,109,14,95,107,20,87
226903,20,1013,463,550,1013,463,550,,,
227058,20,88,0,88,88,0,88,,,
227146,20,6565,2493,4072,2341,986,1355,4224,1507,2717
227182,20,68653,27200,41453,19610,8446,11164,49043,18754,30289
227216,20,32590,15010,17580,25441,11516,13925,7149,3494,3655
227225,20,2823,1052,1771,1285,443,842,1538,609,929
227298,20,174,166,8,174,166,8,,,
227304,20,7947,3157,4790,2763,1044,1719,5184,2113,3071
227313,20,284,3,281,134,2,132,150,1,149
227322,20,338,7,331,186,4,182,152,3,149
227331,20,1217,389,828,1081,354,727,136,35,101
227368,20,26405,10751,15654,19630,7723,11907,6775,3028,3747
227377,20,7527,3074,4453,1829,852,977,5698,2222,3476
227386,20,2469,833,1636,960,348,612,1509,485,1024
227401,20,4365,1630,2735,1466,588,878,2899,1042,1857
227429,20,384,166,218,329,142,187,55,24,31
227526,20,8444,2714,5730,7578,2395,5183,866,319,547
227687,20,2249,1009,1240,763,373,390,1486,636,850
227748,20,244,220,24,191,176,15,53,44,9
227757,20,4247,2187,2060,4156,2143,2013,91,44,47
227845,20,2870,1088,1782,2670,1000,1670,200,88,112
227854,20,12455,5048,7407,1605,709,896,10850,4339,6511
227863,20,2667,1061,1606,2212,777,1435,455,284,171
227881,20,18288,6623,11665,14352,5204,9148,3936,1419,2517
227924,20,17677,6462,11215,3347,1251,2096,14330,5211,9119
227979,20,31577,12666,18911,8268,3521,4747,23309,9145,14164
228042,20,1017,450,567,908,428,480,109,22,87
228088,20,18,0,18,18,0,18,,,
228149,20,2093,865,1228,2007,817,1190,86,48,38
228158,20,8930,3574,5356,3967,1772,2195,4963,1802,3161
228185,20,14,12,2,14,12,2,,,
228200,20,332,163,169,306,161,145,26,2,24
228219,20,444,124,320,423,118,305,21,6,15
228246,20,6908,3486,3422,6728,3401,3327,180,85,95
228282,20,19,4,15,19,4,15,,,
228316,20,5875,2347,3528,1278,498,780,4597,1849,2748
228325,20,1519,732,787,1273,630,643,246,102,144
228343,20,1504,697,807,1480,685,795,24,12,12
228431,20,10353,3801,6552,8341,3031,5310,2012,770,1242
228459,20,33175,13394,19781,26527,10421,16106,6648,2973,3675
228468,20,838,332,506,637,249,388,201,83,118
228486,20,92,57,35,81,50,31,11,7,4
228501,20,1608,630,978,984,470,514,624,160,464
228529,20,11666,4237,7429,8567,3058,5509,3099,1179,1920
228547,20,36264,14506,21758,5857,2771,3086,30407,11735,18672
228608,20,4396,1406,2990,1484,483,1001,2912,923,1989
228644,20,787,228,559,670,178,492,117,50,67
228653,20,672,124,548,541,96,445,131,28,103
228699,20,3575,1356,2219,1057,398,659,2518,958,1560
228705,20,5085,2521,2564,4002,2031,1971,1083,490,593
228723,20,56723,30026,26697,50225,26121,24104,6498,3905,2593
228769,20,32962,12583,20379,19010,8291,10719,13952,4292,9660
228778,20,40916,17763,23153,38250,16419,21831,2666,1344,1322
228787,20,21446,12132,9314,17997,10084,7913,3449,2048,1401
228796,20,20065,8839,11226,13290,5894,7396,6775,2945,3830
228802,20,7185,2791,4394,4731,1897,2834,2454,894,1560
228875,20,10222,4061,6161,10020,3956,6064,202,105,97
228884,20,731,430,301,671,400,271,60,30,30
228981,20,1427,641,786,1351,612,739,76,29,47
229018,20,4249,1724,2525,2423,1023,1400,1826,701,1125
229027,20,29801,14240,15561,22125,10280,11845,7676,3960,3716
229063,20,5726,2049,3677,4877,1733,3144,849,316,533
229115,20,33132,16887,16245,28969,14677,14292,4163,2210,1953
229160,20,1775,782,993,1300,615,685,475,167,308
229179,20,10290,1296,8994,6561,567,5994,3729,729,3000
229267,20,2527,1196,1331,2472,1171,1301,55,25,30
229300,20,685,88,597,542,65,477,143,23,120
229337,20,1468,187,1281,1233,156,1077,235,31,204
229355,20,11913,4351,7562,5290,2098,3192,6623,2253,4370
229416,20,1868,1767,101,1868,1767,101,,,
229425,20,155,2,153,48,1,47,107,1,106
229504,20,2358,779,1579,622,240,382,1736,539,1197
229522,20,97,15,82,50,5,45,47,10,37
229540,20,3210,1041,2169,713,311,402,2497,730,1767
229656,20,264,6,258,228,3,225,36,3,33
229780,20,2690,1254,1436,1385,675,710,1305,579,726
229799,20,5421,1859,3562,1548,575,973,3873,1284,2589
229814,20,7083,2910,4173,5332,2155,3177,1751,755,996
229832,20,1430,686,744,484,237,247,946,449,497
229841,20,5479,2276,3203,2308,1068,1240,3171,1208,1963
229887,20,665,311,354,584,277,307,81,34,47
230010,20,1704,927,777,528,248,280,1176,679,497
230038,20,31642,15400,16242,28282,13739,14543,3360,1661,1699
230047,20,2893,1078,1815,2728,1016,1712,165,62,103
230056,20,240,94,146,108,15,93,132,79,53
230065,20,287,4,283,76,1,75,211,3,208
230144,20,28,0,28,28,0,28,,,
230162,20,3778,2373,1405,442,177,265,3336,2196,1140
230171,20,12201,5111,7090,7200,2894,4306,5001,2217,2784
230199,20,61,10,51,61,10,51,,,
230205,20,71,8,63,63,6,57,8,2,6
230214,20,311,42,269,114,8,106,197,34,163
230366,20,298,37,261,298,37,261,,,
230418,20,2663,1297,1366,1122,594,528,1541,703,838
230490,20,2773,1620,1153,404,144,260,2369,1476,893
230597,20,6106,2831,3275,3520,1683,1837,2586,1148,1438
230603,20,12080,4878,7202,8281,3500,4781,3799,1378,2421
230676,20,1155,803,352,90,50,40,1065,753,312
230728,20,24255,10749,13506,16476,7569,8907,7779,3180,4599
230737,20,40542,20625,19917,18555,9626,8929,21987,10999,10988
230746,20,27225,12386,14839,6126,2870,3256,21099,9516,11583
230764,20,25826,13389,12437,20405,10550,9855,5421,2839,2582
230782,20,28788,12670,16118,11599,5087,6512,17189,7583,9606
230807,20,1166,421,745,1130,402,728,36,19,17
230816,20,771,274,497,699,231,468,72,43,29
230834,20,1744,770,974,1473,684,789,271,86,185
230852,20,3217,1944,1273,2220,1397,823,997,547,450
230861,20,5541,1582,3959,805,282,523,4736,1300,3436
230889,20,146,44,102,133,40,93,13,4,9
230913,20,1495,576,919,970,423,547,525,153,372
230959,20,2858,1327,1531,2835,1319,1516,23,8,15
230995,20,2988,2208,780,2429,1708,721,559,500,59
231004,20,45,5,40,45,5,40,,,
231059,20,1421,665,756,1395,649,746,26,16,10
231068,20,361,97,264,296,77,219,65,20,45
231095,20,126,60,66,101,48,53,25,12,13
231165,20,1449,706,743,757,410,347,692,296,396
231174,20,11626,4395,7231,10842,4058,6784,784,337,447
231280,20,107,1,106,90,0,90,17,1,16
231411,20,466,424,42,466,424,42,,,
231420,20,1114,591,523,979,531,448,135,60,75
231536,20,3386,1300,2086,956,428,528,2430,872,1558
231554,20,718,360,358,632,333,299,86,27,59
231581,20,1427,660,767,1416,653,763,11,7,4
231624,20,6543,2721,3822,6465,2688,3777,78,33,45
231651,20,4507,1700,2807,2313,906,1407,2194,794,1400
231688,20,20,1,19,11,0,11,9,1,8
231697,20,3464,1445,2019,1061,443,618,2403,1002,1401
231712,20,4472,2036,2436,4388,1986,2402,84,50,34
231721,20,12,1,11,,,,12,1,11
231785,20,1245,223,1022,735,181,554,510,42,468
231873,20,1069,410,659,354,141,213,715,269,446
231882,20,2330,977,1353,875,435,440,1455,542,913
232016,20,113,30,83,66,22,44,47,8,39
232025,20,1084,535,549,1048,518,530,36,17,19
232043,20,958,388,570,824,338,486,134,50,84
232052,20,637,253,384,178,76,102,459,177,282
232089,20,863,512,351,842,506,336,21,6,15
232186,20,26882,13547,13335,21142,10508,10634,5740,3039,2701
232195,20,7496,2765,4731,2134,893,1241,5362,1872,3490
232256,20,851,847,4,842,838,4,9,9,0
232265,20,2867,969,1898,2708,912,1796,159,57,102
232308,20,713,0,713,707,0,707,6,0,6
232414,20,7252,2760,4492,2270,938,1332,4982,1822,3160
232423,20,20070,8482,11588,18723,7835,10888,1347,647,700
232450,20,8558,3527,5031,1985,867,1118,6573,2660,3913
232557,20,48135,20681,27454,30204,12562,17642,17931,8119,9812
232566,20,3486,1068,2418,3010,910,2100,476,158,318
232575,20,5862,2182,3680,1713,717,996,4149,1465,2684
232609,20,1640,623,1017,1582,604,978,58,19,39
232618,20,304,24,280,34,0,34,270,24,246
232672,20,1489,311,1178,1214,265,949,275,46,229
232681,20,3660,1295,2365,3111,1101,2010,549,194,355
232706,20,2221,966,1255,1759,632,1127,462,334,128
232724,20,19,0,19,19,0,19,,,
232788,20,2079,776,1303,899,341,558,1180,435,745
232797,20,868,121,747,243,36,207,625,85,540
232867,20,3903,1906,1997,1482,729,753,2421,1177,1244
232885,20,304,29,275,231,26,205,73,3,70
232919,20,466,400,66,376,322,54,90,78,12
232937,20,5016,1622,3394,4520,1478,3042,496,144,352
232946,20,49560,23163,26397,13939,7157,6782,35621,16006,19615
232982,20,18678,8207,10471,13905,6164,7741,4773,2043,2730
233019,20,1906,782,1124,961,416,545,945,366,579
233037,20,1239,441,798,313,148,165,926,293,633
233082,20,107,10,97,6,0,6,101,10,91
233116,20,4997,2073,2924,1030,512,518,3967,1561,2406
233277,20,6513,2529,3984,6024,2320,3704,489,209,280
233286,20,146,17,129,98,8,90,48,9,39
233295,20,1501,682,819,1459,657,802,42,25,17
233301,20,482,184,298,471,177,294,11,7,4
233310,20,2588,879,1709,599,227,372,1989,652,1337
233329,20,441,30,411,441,30,411,,,
233338,20,2670,1084,1586,1209,450,759,1461,634,827
233356,20,427,26,401,343,25,318,84,1,83
233374,20,3166,1483,1683,3030,1425,1605,136,58,78
233408,20,322,33,289,273,29,244,49,4,45
233426,20,1863,854,1009,1817,829,988,46,25,21
233480,20,33,7,26,33,7,26,,,
233541,20,2416,923,1493,2034,827,1207,382,96,286
233602,20,61,35,26,58,32,26,3,3,0
233611,20,1170,604,566,1018,518,500,152,86,66
233639,20,2961,951,2010,940,279,661,2021,672,1349
233648,20,2135,767,1368,1029,403,626,1106,364,742
233666,20,44,1,43,31,1,30,13,0,13
233684,20,2595,860,1735,443,265,178,2152,595,1557
233718,20,452,0,452,448,0,448,4,0,4
233754,20,5832,2293,3539,1693,749,944,4139,1544,2595
233772,20,16797,6526,10271,5337,2203,3134,11460,4323,7137
233897,20,1814,700,1114,1074,507,567,740,193,547
233903,20,2451,917,1534,955,414,541,1496,503,993
233921,20,29760,17049,12711,28929,16489,12440,831,560,271
233949,20,5625,2365,3260,1633,672,961,3992,1693,2299
234030,20,21394,7904,13490,18525,6691,11834,2869,1213,1656
234076,20,17294,7566,9728,16427,7201,9226,867,365,502
234085,20,1652,1424,228,1652,1424,228,,,
234119,20,34,13,21,19,8,11,15,5,10
234137,20,217,186,31,181,158,23,36,28,8
234155,20,3899,1562,2337,3665,1463,2202,234,99,135
234164,20,1243,609,634,1092,550,542,151,59,92
234173,20,1241,487,754,1108,439,669,133,48,85
234207,20,1857,905,952,1853,903,950,4,2,2
234377,20,2089,716,1373,726,254,472,1363,462,901
234669,20,11546,4994,6552,6038,2775,3263,5508,2219,3289
234696,20,1915,972,943,1096,632,464,819,340,479
234711,20,1778,759,1019,1262,529,733,516,230,286
234827,20,9566,4496,5070,8373,3937,4436,1193,559,634
234845,20,2153,822,1331,1167,466,701,986,356,630
234915,20,1145,472,673,112,58,54,1033,414,619
234924,20,286,30,256,286,30,256,,,
234933,20,6921,2734,4187,3676,1516,2160,3245,1218,2027
234951,20,2846,1095,1751,1841,879,962,1005,216,789
234979,20,6089,2717,3372,3274,1295,1979,2815,1422,1393
235024,20,455,145,310,416,136,280,39,9,30
235088,20,247,233,14,247,233,14,,,
235097,20,8217,3497,4720,7203,3049,4154,1014,448,566
235103,20,5606,2411,3195,2474,1207,1267,3132,1204,1928
235149,20,6682,2788,3894,3582,1521,2061,3100,1267,1833
235158,20,92,20,72,92,20,72,,,
235167,20,1849,719,1130,1625,642,983,224,77,147
235237,20,7363,2631,4732,4372,1564,2808,2991,1067,1924
235307,20,105,6,99,105,6,99,,,
235316,20,4986,2285,2701,4909,2248,2661,77,37,40
235334,20,1469,694,775,954,423,531,515,271,244
235343,20,6559,3165,3394,3969,1960,2009,2590,1205,1385
235352,20,110,24,86,110,24,86,,,
235422,20,811,203,608,706,162,544,105,41,64
235431,20,4951,1854,3097,2644,1012,1632,2307,842,1465
235501,20,158,92,66,158,92,66,,,
235547,20,75,13,62,46,10,36,29,3,26
235583,20,101,3,98,101,3,98,,,
235671,20,4106,2495,1611,1795,1152,643,2311,1343,968
235699,20,3240,1338,1902,1553,736,817,1687,602,1085
235750,20,2164,648,1516,1227,387,840,937,261,676
236018,20,39,4,35,39,4,35,,,
236072,20,4887,1916,2971,1405,689,716,3482,1227,2255
236133,20,778,268,510,750,258,492,28,10,18
236188,20,4999,2116,2883,3069,1347,1722,1930,769,1161
236212,20,867,717,150,867,717,150,,,
236230,20,2373,860,1513,2279,812,1467,94,48,46
236258,20,1702,606,1096,826,287,539,876,319,557
236328,20,1866,794,1072,1835,782,1053,31,12,19
236382,20,3097,2054,1043,1075,511,564,2022,1543,479
236452,20,1358,531,827,1249,477,772,109,54,55
236504,20,4893,3486,1407,1299,784,515,3594,2702,892
236513,20,4698,1889,2809,2792,1176,1616,1906,713,1193
236577,20,2640,867,1773,2513,794,1719,127,73,54
236595,20,4241,1642,2599,4098,1576,2522,143,66,77
236610,20,4843,1870,2973,2180,994,1186,2663,876,1787
236638,20,3891,1698,2193,2018,858,1160,1873,840,1033
236656,20,4215,1650,2565,2422,1019,1403,1793,631,1162
236692,20,6890,2790,4100,3523,1511,2012,3367,1279,2088
236708,20,3805,1540,2265,2627,1090,1537,1178,450,728
236744,20,36,2,34,36,2,34,,,
236753,20,5359,1882,3477,3176,1188,1988,2183,694,1489
236887,20,3084,1520,1564,1763,865,898,1321,655,666
236896,20,1402,715,687,1236,627,609,166,88,78
236939,20,24278,11145,13133,21272,9843,11429,3006,1302,1704
236948,20,36201,15687,20514,29626,12849,16777,6575,2838,3737
236975,20,2661,959,1702,1831,704,1127,830,255,575
237011,20,14019,5973,8046,12447,5180,7267,1572,793,779
237039,20,3850,1627,2223,1891,828,1063,1959,799,1160
237057,20,1559,684,875,1524,665,859,35,19,16
237066,20,2309,948,1361,2253,921,1332,56,27,29
237109,20,3643,976,2667,2438,663,1775,1205,313,892
237118,20,750,446,304,668,422,246,82,24,58
237127,20,51,2,49,51,2,49,,,
237136,20,192,97,95,136,60,76,56,37,19
237145,20,26,3,23,26,3,23,,,
237172,20,39,31,8,39,31,8,,,
237181,20,545,286,259,538,285,253,7,1,6
237215,20,1358,541,817,996,424,572,362,117,245
237242,20,80,53,27,76,50,26,4,3,1
237303,20,52,19,33,52,19,33,,,
237312,20,2162,1267,895,1123,511,612,1039,756,283
237321,20,47,4,43,47,4,43,,,
237330,20,1387,586,801,1286,540,746,101,46,55
237358,20,661,270,391,653,269,384,8,1,7
237367,20,3273,1330,1943,2478,1054,1424,795,276,519
237385,20,1557,845,712,995,536,459,562,309,253
237437,20,151,27,124,135,26,109,16,1,15
237473,20,151,106,45,151,106,45,,,
237491,20,19,3,16,19,3,16,,,
237525,20,8008,3316,4692,6553,2734,3819,1455,582,873
237543,20,104,31,73,69,15,54,35,16,19
237561,20,69,22,47,69,22,47,,,
237570,20,76,2,74,76,2,74,,,
237598,20,20,1,19,20,1,19,,,
237686,20,2258,826,1432,983,381,602,1275,445,830
237701,20,1174,554,620,883,421,462,291,133,158
237729,20,140,39,101,82,13,69,58,26,32
237783,20,782,368,414,698,321,377,84,47,37
237792,20,2450,970,1480,2040,805,1235,410,165,245
237817,20,1439,454,985,926,293,633,513,161,352
237844,20,100,56,44,100,56,44,,,
237899,20,3281,1376,1905,1317,604,713,1964,772,1192
237905,20,55,12,43,55,12,43,,,
237932,20,2087,760,1327,1798,653,1145,289,107,182
237950,20,1619,819,800,1038,599,439,581,220,361
237969,20,982,456,526,970,451,519,12,5,7
237987,20,211,30,181,211,30,181,,,
237996,20,558,88,470,558,88,470,,,
238005,20,83,6,77,83,6,77,,,
238014,20,1099,395,704,483,200,283,616,195,421
238032,20,19601,9392,10209,18022,8726,9296,1579,666,913
238078,20,599,371,228,506,330,176,93,41,52
238096,20,16,1,15,16,1,15,,,
238175,20,124,2,122,124,2,122,,,
238193,20,917,26,891,703,12,691,214,14,200
238263,20,12087,5178,6909,3030,1494,1536,9057,3684,5373
238324,20,514,69,445,243,22,221,271,47,224
238333,20,1011,480,531,978,466,512,33,14,19
238397,20,2424,821,1603,576,241,335,1848,580,1268
238430,20,877,278,599,464,172,292,413,106,307
238458,20,2884,881,2003,2702,809,1893,182,72,110
238476,20,2635,1155,1480,2563,1120,1443,72,35,37
238616,20,2914,1117,1797,2192,891,1301,722,226,496
238661,20,1233,392,841,1050,312,738,183,80,103
238722,20,11664,6428,5236,1756,1000,756,9908,5428,4480
238759,20,9311,4493,4818,1184,565,619,8127,3928,4199
238810,20,66,4,62,42,1,41,24,3,21
238980,20,1488,635,853,751,359,392,737,276,461
239008,20,2322,1139,1183,483,245,238,1839,894,945
239017,20,1483,679,804,1463,668,795,20,11,9
239071,20,818,351,467,482,195,287,336,156,180
239080,20,1149,388,761,993,349,644,156,39,117
239105,20,7660,3348,4312,7391,3212,4179,269,136,133
239220,20,3006,1413,1593,612,352,260,2394,1061,1333
239248,20,11828,4936,6892,3197,1585,1612,8631,3351,5280
239309,20,898,223,675,881,218,663,17,5,12
239318,20,2564,1867,697,2496,1818,678,68,49,19
239372,20,3269,1322,1947,879,424,455,2390,898,1492
239390,20,716,6,710,623,0,623,93,6,87
239442,20,1224,406,818,221,78,143,1003,328,675
239460,20,6084,2473,3611,1124,490,634,4960,1983,2977
239488,20,10088,4149,5939,2210,1106,1104,7878,3043,4835
239512,20,531,249,282,516,241,275,15,8,7
239628,20,810,407,403,794,400,394,16,7,9
239716,20,1941,813,1128,1905,790,1115,36,23,13
239877,20,45,1,44,43,1,42,2,0,2
239910,20,2520,988,1532,701,305,396,1819,683,1136
240107,20,1660,383,1277,1336,315,1021,324,68,256
240116,20,6998,3002,3996,2031,992,1039,4967,2010,2957
240125,20,7357,3827,3530,1503,825,678,5854,3002,2852
240170,20,3963,1792,2171,1557,817,740,2406,975,1431
240189,20,9751,5007,4744,8434,4381,4053,1317,626,691
240198,20,2656,985,1671,897,425,472,1759,560,1199
240268,20,9869,3816,6053,8980,3496,5484,889,320,569
240277,20,9257,2987,6270,4952,1852,3100,4305,1135,3170
240329,20,9400,3980,5420,8819,3688,5131,581,292,289
240338,20,1031,443,588,938,398,540,93,45,48
240365,20,12946,5247,7699,7236,2961,4275,5710,2286,3424
240374,20,3365,1447,1918,2563,1112,1451,802,335,467
240392,20,1664,246,1418,829,147,682,835,99,736
240417,20,6634,3815,2819,5383,3133,2250,1251,682,569
240426,20,2204,771,1433,1627,608,1019,577,163,414
240444,20,34561,16404,18157,32071,15136,16935,2490,1268,1222
240453,20,19411,8779,10632,15864,7186,8678,3547,1593,1954
240462,20,6266,3973,2293,5468,3476,1992,798,497,301
240471,20,4988,1707,3281,4313,1446,2867,675,261,414
240480,20,7489,3242,4247,6403,2843,3560,1086,399,687
240505,20,3405,1411,1994,1517,606,911,1888,805,1083
240514,20,1770,785,985,586,238,348,1184,547,637
240596,20,1367,601,766,456,196,260,911,405,506
240620,20,3883,1519,2364,1343,522,821,2540,997,1543
240657,20,1427,573,854,652,277,375,775,296,479
240666,20,3921,2040,1881,1217,508,709,2704,1532,1172
240693,20,2453,1022,1431,886,399,487,1567,623,944
240709,20,43,4,39,34,4,30,9,0,9
240718,20,742,704,38,742,704,38,,,
240727,20,8869,4194,4675,7376,3599,3777,1493,595,898
240736,20,1301,427,874,595,196,399,706,231,475
240745,20,1635,740,895,689,297,392,946,443,503
240754,20,2767,1167,1600,2088,856,1232,679,311,368
240790,20,1298,511,787,1016,409,607,282,102,180
240879,20,220,56,164,220,56,164,,,
241100,20,226,120,106,190,100,90,36,20,16
241128,20,271,116,155,232,99,133,39,17,22
241146,20,215,48,167,211,46,165,4,2,2
241182,20,428,93,335,428,93,335,,,
241191,20,863,337,526,732,278,454,131,59,72
241216,20,1513,962,551,994,617,377,519,345,174
241225,20,759,230,529,537,162,375,222,68,154
241304,20,2217,566,1651,1369,341,1028,848,225,623
241331,20,667,76,591,484,56,428,183,20,163
241377,20,617,273,344,385,174,211,232,99,133
241386,20,127,28,99,76,18,58,51,10,41
241395,20,361,119,242,290,101,189,71,18,53
241410,20,4473,1555,2918,3744,1285,2459,729,270,459
241517,20,236,62,174,186,46,140,50,16,34
241614,20,316,176,140,168,105,63,148,71,77
241720,20,675,258,417,496,189,307,179,69,110
241739,20,6116,1842,4274,3647,1141,2506,2469,701,1768
241766,20,325,221,104,201,137,64,124,84,40
241836,20,912,293,619,399,139,260,513,154,359
241906,20,200,59,141,200,59,141,,,
241951,20,485,134,351,336,94,242,149,40,109
242042,20,283,157,126,273,154,119,10,3,7
242112,20,505,240,265,390,200,190,115,40,75
242121,20,282,99,183,170,55,115,112,44,68
242130,20,275,79,196,202,60,142,73,19,54
242149,20,355,94,261,278,72,206,77,22,55
242413,20,66,0,66,66,0,66,,,
242556,20,244,164,80,212,142,70,32,22,10
242565,20,199,145,54,199,145,54,,,
242583,20,216,156,60,200,145,55,16,11,5
242617,20,2735,1197,1538,2314,1008,1306,421,189,232
242626,20,3035,1212,1823,2403,940,1463,632,272,360
242635,20,2728,1009,1719,2242,857,1385,486,152,334
242644,20,1101,374,727,911,307,604,190,67,123
242653,20,3735,1564,2171,2756,1149,1607,979,415,564
242662,20,2968,1092,1876,2283,828,1455,685,264,421
242680,20,1313,505,808,1049,397,652,264,108,156
242699,20,1506,445,1061,1203,361,842,303,84,219
242705,20,3816,2099,1717,3230,1771,1459,586,328,258
242750,20,90,29,61,90,29,61,,,
242820,20,948,724,224,948,724,224,,,
242945,20,138,40,98,109,31,78,29,9,20
242954,20,73,22,51,60,17,43,13,5,8
242972,20,23595,8268,15327,16166,5677,10489,7429,2591,4838
243106,20,2199,936,1263,1977,841,1136,222,95,127
243115,20,3117,1150,1967,2838,1044,1794,279,106,173
243133,20,3326,1667,1659,2878,1459,1419,448,208,240
243142,20,2367,849,1518,1804,633,1171,563,216,347
243151,20,2559,822,1737,2275,732,1543,284,90,194
243179,20,2848,952,1896,2572,859,1713,276,93,183
243188,20,457,215,242,414,196,218,43,19,24
243197,20,11246,6178,5068,10099,5496,4603,1147,682,465
243203,20,336,66,270,315,62,253,21,4,17
243212,20,2262,978,1284,2062,894,1168,200,84,116
243221,20,10207,3703,6504,8928,3194,5734,1279,509,770
243346,20,5495,1989,3506,3614,1281,2333,1881,708,1173
243443,20,3611,1278,2333,2987,1029,1958,624,249,375
243568,20,94,21,73,76,17,59,18,4,14
243577,20,3687,2714,973,1712,1206,506,1975,1508,467
243586,20,707,237,470,598,199,399,109,38,71
243601,20,8772,3568,5204,6016,2344,3672,2756,1224,1532
243638,20,1946,803,1143,1353,548,805,593,255,338
243647,20,525,239,286,321,154,167,204,85,119
243665,20,1374,384,990,877,248,629,497,136,361
243744,20,7645,3778,3867,7645,3778,3867,,,
243780,20,37806,21853,15953,35878,20788,15090,1928,1065,863
243799,20,56,5,51,56,5,51,,,
243823,20,466,135,331,304,83,221,162,52,110
243832,20,1246,359,887,471,140,331,775,219,556
243841,20,463,85,378,377,71,306,86,14,72
244233,20,85,18,67,17,4,13,68,14,54
244279,20,194,5,189,194,5,189,,,
244437,20,15353,5656,9697,5426,2223,3203,9927,3433,6494
244446,20,2577,883,1694,560,223,337,2017,660,1357
244613,20,406,394,12,253,246,7,153,148,5
245281,20,74,36,38,74,36,38,,,
245625,20,3303,1449,1854,563,232,331,2740,1217,1523
245652,20,368,188,180,356,182,174,12,6,6
245777,20,40,40,0,40,40,0,,,
245838,20,133,46,87,48,11,37,85,35,50
245847,20,48,13,35,17,6,11,31,7,24
245883,20,101,20,81,11,5,6,90,15,75
245892,20,137,36,101,59,17,42,78,19,59
245953,20,1662,609,1053,1166,414,752,496,195,301
245962,20,136,10,126,125,8,117,11,2,9
245980,20,29,11,18,29,11,18,,,
245999,20,2224,1121,1103,286,126,160,1938,995,943
246017,20,1122,635,487,198,120,78,924,515,409
246035,20,350,51,299,350,51,299,,,
246071,20,69,9,60,69,9,60,,,
246354,20,10559,4026,6533,1837,655,1182,8722,3371,5351
246406,20,21,3,18,21,3,18,,,
246415,20,60,8,52,14,1,13,46,7,39
246460,20,156,16,140,156,16,140,,,
246813,20,3943,1366,2577,753,305,448,3190,1061,2129
246895,20,661,229,432,340,137,203,321,92,229
246974,20,317,32,285,317,32,285,,,
247010,20,26,0,26,26,0,26,,,
247047,20,91,0,91,91,0,91,,,
247065,20,753,38,715,430,23,407,323,15,308
247153,20,241,56,185,241,56,185,,,
247162,20,8,2,6,,,,8,2,6
247409,20,67,3,64,67,3,64,,,
247603,20,2162,1135,1027,1255,709,546,907,426,481
247649,20,564,382,182,364,247,117,200,135,65
247773,20,54,54,0,54,54,0,,,
247825,20,5,4,1,1,1,0,4,3,1
247834,20,33686,14762,18924,10747,5456,5291,22939,9306,13633
247940,20,4111,1808,2303,1454,648,806,2657,1160,1497
248192,20,24,0,24,24,0,24,,,
248527,20,70,0,70,70,0,70,,,
248606,20,1527,986,541,116,35,81,1411,951,460
248624,20,102,18,84,102,18,84,,,
248633,20,57,0,57,57,0,57,,,
248660,20,142,43,99,123,42,81,19,1,18
248703,20,187,3,184,121,2,119,66,1,65
248925,20,782,475,307,581,322,259,201,153,48
248934,20,12139,4722,7417,12022,4673,7349,117,49,68
249061,20,49,0,49,23,0,23,26,0,26
249238,20,364,23,341,243,14,229,121,9,112
249609,20,172,107,65,172,107,65,,,
250027,20,285,94,191,276,93,183,9,1,8
250285,20,317,290,27,233,215,18,84,75,9
250744,20,428,49,379,428,49,379,,,
250902,20,82,10,72,42,5,37,40,5,35
250993,20,493,261,232,56,21,35,437,240,197
251260,20,4069,1776,2293,2145,1056,1089,1924,720,1204
251312,20,486,69,417,294,46,248,192,23,169
260336,20,14,0,14,14,0,14,,,
260363,20,19,2,17,19,2,17,,,
260372,20,306,58,248,110,19,91,196,39,157
260664,20,283,214,69,283,214,69,,,
260691,20,820,240,580,820,240,580,,,
260789,20,670,121,549,670,121,549,,,
260813,20,222,23,199,222,23,199,,,
260929,20,202,22,180,200,22,178,2,0,2
260965,20,78,0,78,78,0,78,,,
260992,20,474,23,451,122,7,115,352,16,336
261436,20,889,57,832,889,57,832,,,
261676,20,29,1,28,29,1,28,,,
261685,20,33,2,31,33,2,31,,,
261719,20,165,2,163,165,2,163,,,
261773,20,39,9,30,37,7,30,2,2,0
261861,20,54,2,52,54,2,52,,,
262031,20,5705,2251,3454,3112,1355,1757,2593,896,1697
262086,20,5237,1743,3494,1789,685,1104,3448,1058,2390
262129,20,632,206,426,615,199,416,17,7,10
262341,20,450,396,54,450,396,54,,,
262369,20,72,2,70,72,2,70,,,
262457,20,437,70,367,437,70,367,,,
262466,20,54,19,35,54,19,35,,,
362700,20,425,37,388,418,36,382,7,1,6
362782,20,267,7,260,82,3,79,185,4,181
363013,20,36,2,34,36,2,34,,,
363077,20,242,56,186,126,7,119,116,49,67
363147,20,429,13,416,429,13,416,,,
363165,20,2030,1046,984,1058,553,505,972,493,479
363439,20,17,1,16,17,1,16,,,
363633,20,821,297,524,279,113,166,542,184,358
363679,20,206,3,203,171,3,168,35,0,35
363712,20,52,52,0,52,52,0,,,
363882,20,98,1,97,98,1,97,,,
363907,20,370,236,134,231,150,81,139,86,53
363916,20,118,30,88,75,18,57,43,12,31
363934,20,806,648,158,441,358,83,365,290,75
364016,20,5965,2620,3345,1731,910,821,4234,1710,2524
364025,20,13498,6365,7133,3473,1742,1731,10025,4623,5402
364548,20,194,93,101,137,53,84,57,40,17
364575,20,30,1,29,30,1,29,,,
364627,20,392,198,194,51,15,36,341,183,158
364636,20,167,48,119,143,47,96,24,1,23
364751,20,26,1,25,26,1,25,,,
364760,20,73,6,67,36,3,33,37,3,34
364946,20,325,159,166,91,23,68,234,136,98
364964,20,35,1,34,35,1,34,,,
365091,20,363,21,342,363,21,342,,,
365125,20,157,4,153,157,4,153,,,
365198,20,633,347,286,78,5,73,555,342,213
365213,20,727,316,411,152,46,106,575,270,305
365240,20,25,20,5,25,20,5,,,
365374,20,1473,805,668,212,100,112,1261,705,556
365383,20,105,10,95,105,10,95,,,
365480,20,797,442,355,112,32,80,685,410,275
365505,20,26,4,22,26,4,22,,,
365693,20,154,5,149,154,5,149,,,
365763,20,35,9,26,35,9,26,,,
365824,20,122,4,118,122,4,118,,,
365833,20,127,6,121,127,6,121,,,
366003,20,226,81,145,110,27,83,116,54,62
366155,20,29,16,13,29,16,13,,,
366191,20,1331,1290,41,1331,1290,41,,,
366252,20,4235,2680,1555,3480,2433,1047,755,247,508
366261,20,272,90,182,254,84,170,18,6,12
366270,20,284,9,275,284,9,275,,,
366289,20,7,7,0,7,7,0,,,
366340,20,373,127,246,192,70,122,181,57,124
366395,20,20549,9036,11513,9328,4436,4892,11221,4600,6621
366401,20,7125,3328,3797,2194,1102,1092,4931,2226,2705
366438,20,43,3,40,25,2,23,18,1,17
366465,20,2167,726,1441,775,267,508,1392,459,933
366535,20,295,66,229,295,66,229,,,
366553,20,1294,344,950,462,92,370,832,252,580
366571,20,21,5,16,21,5,16,,,
366623,20,261,147,114,32,10,22,229,137,92
366632,20,8,0,8,8,0,8,,,
366711,20,14963,5740,9223,12123,4555,7568,2840,1185,1655
367051,20,78,2,76,46,2,44,32,0,32
367088,20,120,7,113,75,5,70,45,2,43
367103,20,100,69,31,100,69,31,,,
367112,20,205,35,170,188,31,157,17,4,13
367158,20,46,4,42,46,4,42,,,
367334,20,157,143,14,145,131,14,12,12,0
367361,20,79,51,28,77,50,27,2,1,1
367431,20,28,6,22,28,6,22,,,
367459,20,7037,2894,4143,1804,772,1032,5233,2122,3111
367875,20,160,86,74,160,86,74,,,
367884,20,432,185,247,211,93,118,221,92,129
367972,20,105,2,103,105,2,103,,,
367981,20,72,2,70,39,2,37,33,0,33
368230,20,86,3,83,68,3,65,18,0,18
368364,20,330,171,159,95,55,40,235,116,119
368407,20,30,1,29,,,,30,1,29
368443,20,387,44,343,387,44,343,,,
368452,20,270,99,171,270,99,171,,,
368540,20,30,3,27,30,3,27,,,
368629,20,553,114,439,553,114,439,,,
368647,20,11,1,10,11,1,10,,,
368771,20,265,62,203,265,62,203,,,
368832,20,66,10,56,14,2,12,52,8,44
368911,20,1673,521,1152,256,81,175,1417,440,977
369109,20,59,8,51,50,7,43,9,1,8
369400,20,1159,1121,38,1159,1121,38,,,
369419,20,665,318,347,665,318,347,,,
369446,20,75,3,72,48,3,45,27,0,27
369455,20,211,53,158,211,53,158,,,
369516,20,174,44,130,174,44,130,,,
369668,20,168,67,101,134,66,68,34,1,33
369686,20,89,26,63,89,26,63,,,
369695,20,62,7,55,62,7,55,,,
369783,20,327,20,307,327,20,307,,,
369950,20,165,139,26,165,139,26,,,
371052,20,301,58,243,301,58,243,,,
371690,20,1013,222,791,118,16,102,895,206,689
371830,20,76,50,26,72,48,24,4,2,2
371928,20,111,36,75,111,36,75,,,
371964,20,512,357,155,512,357,155,,,
372028,20,123,21,102,123,21,102,,,
372073,20,150,38,112,150,38,112,,,
372082,20,81,28,53,60,26,34,21,2,19
372240,20,18,2,16,17,2,15,1,0,1
372329,20,409,38,371,409,38,371,,,
372356,20,177,8,169,177,8,169,,,
372462,20,122,22,100,121,22,99,1,0,1
372718,20,308,53,255,292,51,241,16,2,14
372921,20,516,178,338,516,178,338,,,
373085,20,48,2,46,38,1,37,10,1,9
373216,20,109,11,98,109,11,98,,,
373456,20,22,0,22,19,0,19,3,0,3
373526,20,272,221,51,272,221,51,,,
373678,20,176,81,95,117,63,54,59,18,41
373696,20,45,31,14,45,31,14,,,
373711,20,76,3,73,76,3,73,,,
373784,20,528,268,260,528,268,260,,,
374316,20,57,45,12,40,31,9,17,14,3
374343,20,57,2,55,57,2,55,,,
374574,20,746,130,616,480,97,383,266,33,233
374592,20,66,7,59,66,7,59,,,
375106,20,125,107,18,107,92,15,18,15,3
375230,20,201,201,0,201,201,0,,,
375373,20,140,41,99,8,0,8,132,41,91
375407,20,106,25,81,85,20,65,21,5,16
375416,20,252,67,185,252,67,185,,,
375540,20,71,2,69,45,1,44,26,1,25
375568,20,51,26,25,10,7,3,41,19,22
375656,20,137,73,64,12,1,11,125,72,53
375683,20,861,528,333,163,111,52,698,417,281
375726,20,538,280,258,387,174,213,151,106,45
375939,20,110,14,96,110,14,96,,,
375966,20,135,14,121,78,7,71,57,7,50
375984,20,204,7,197,162,7,155,42,0,42
376224,20,162,24,138,128,18,110,34,6,28
376242,20,128,73,55,128,73,55,,,
376288,20,100,16,84,100,16,84,,,
376330,20,200,40,160,200,40,160,,,
376385,20,92,22,70,92,22,70,,,
376446,20,74,1,73,12,1,11,62,0,62
376631,20,23,7,16,21,6,15,2,1,1
376677,20,117,52,65,116,51,65,1,1,0
376695,20,1267,577,690,642,289,353,625,288,337
377111,20,264,91,173,264,91,173,,,
377193,20,25,2,23,9,1,8,16,1,15
377218,20,110,109,1,110,109,1,,,
377272,20,18,3,15,18,3,15,,,
377281,20,69,6,63,69,6,63,,,
377315,20,98,0,98,98,0,98,,,
377449,20,174,62,112,130,55,75,44,7,37
377458,20,222,90,132,166,74,92,56,16,40
377485,20,50,8,42,14,1,13,36,7,29
377546,20,103,40,63,93,39,54,10,1,9
377555,20,5454,2883,2571,4683,2464,2219,771,419,352
377564,20,4327,2112,2215,3825,1854,1971,502,258,244
377643,20,100,9,91,100,9,91,,,
377652,20,90,5,85,90,5,85,,,
377661,20,621,70,551,621,70,551,,,
377722,20,422,29,393,422,29,393,,,
377759,20,36,35,1,36,35,1,,,
378105,20,364,19,345,261,12,249,103,7,96
378576,20,293,63,230,43,20,23,250,43,207
378886,20,233,44,189,73,18,55,160,26,134
378956,20,762,719,43,762,719,43,,,
379621,20,78,7,71,57,6,51,21,1,20
379746,20,259,15,244,259,15,244,,,
379782,20,263,26,237,263,26,237,,,
380067,20,137,2,135,137,2,135,,,
380359,20,583,119,464,232,49,183,351,70,281
380368,20,1525,578,947,335,115,220,1190,463,727
380377,20,622,150,472,401,112,289,221,38,183
380438,20,684,101,583,684,101,583,,,
381255,20,87,68,19,87,68,19,,,
381282,20,94,32,62,94,32,62,,,
381325,20,116,20,96,116,20,96,,,
381370,20,323,12,311,171,5,166,152,7,145
381404,20,367,9,358,203,4,199,164,5,159
381486,20,15,1,14,15,1,14,,,
381699,20,30,0,30,23,0,23,7,0,7
381732,20,65,18,47,17,8,9,48,10,38
382258,20,146,28,118,96,12,84,50,16,34
382416,20,80,13,67,80,13,67,,,
382461,20,42,0,42,31,0,31,11,0,11
382780,20,173,5,168,169,5,164,4,0,4
382911,20,50,25,25,37,20,17,13,5,8
382957,20,455,119,336,445,117,328,10,2,8
383020,20,8,2,6,4,1,3,4,1,3
383084,20,748,200,548,568,145,423,180,55,125
383163,20,242,4,238,27,1,26,215,3,212
383190,20,2248,867,1381,757,377,380,1491,490,1001
383279,20,162,25,137,80,17,63,82,8,74
383297,20,206,7,199,65,1,64,141,6,135
383312,20,80,40,40,80,40,40,,,
383330,20,92,13,79,92,13,79,,,
383367,20,233,69,164,184,67,117,49,2,47
383464,20,132,9,123,132,9,123,,,
383525,20,26,0,26,26,0,26,,,
383765,20,127,2,125,93,2,91,34,0,34
383996,20,602,243,359,149,54,95,453,189,264
384236,20,898,340,558,898,340,558,,,
384245,20,736,310,426,736,310,426,,,
384254,20,460,307,153,418,278,140,42,29,13
384333,20,8516,3266,5250,2346,949,1397,6170,2317,3853
384342,20,4697,2012,2685,1634,751,883,3063,1261,1802
384412,20,171,90,81,171,90,81,,,
384421,20,93,93,0,93,93,0,,,
385132,20,141,12,129,95,10,85,46,2,44
385503,20,241,17,224,241,17,224,,,
385619,20,2212,1239,973,2212,1239,973,,,
386153,20,475,0,475,475,0,475,,,
386472,20,728,116,612,509,83,426,219,33,186
387925,20,106,12,94,106,12,94,,,
388520,20,351,206,145,131,76,55,220,130,90
388663,20,79,3,76,79,3,76,,,
389860,20,238,128,110,132,42,90,106,86,20
390905,20,225,127,98,67,45,22,158,82,76
391005,20,108,5,103,108,5,103,,,
391759,20,29,0,29,,,,29,0,29
392257,20,2991,234,2757,2991,234,2757,,,
392354,20,9,4,5,9,4,5,,,
392415,20,327,82,245,327,82,245,,,
393524,20,48,1,47,48,1,47,,,
393649,20,1248,537,711,1248,537,711,,,
393861,20,357,58,299,340,56,284,17,2,15
395362,20,1353,457,896,339,103,236,1014,354,660
395690,20,264,143,121,264,143,121,,,
397942,20,1077,344,733,1077,344,733,,,
399212,20,12159,8114,4045,2243,1129,1114,9916,6985,2931
399869,20,521,499,22,521,499,22,,,
399911,20,435,151,284,435,151,284,,,
400080,20,1100,761,339,1100,761,339,,,
400187,20,550,48,502,291,31,260,259,17,242
400558,20,47,21,26,47,21,26,,,
401223,20,179,39,140,121,26,95,58,13,45
401764,20,240,4,236,107,1,106,133,3,130
402563,20,178,8,170,178,8,170,,,
402800,20,134,0,134,121,0,121,13,0,13
403469,20,2337,1351,986,266,129,137,2071,1222,849
403478,20,632,284,348,362,178,184,270,106,164
403487,20,865,328,537,427,198,229,438,130,308
404055,20,301,39,262,301,39,262,,,
404338,20,17,11,6,17,11,6,,,
404426,20,2929,1342,1587,882,478,404,2047,864,1183
404684,20,318,99,219,318,99,219,,,
404718,20,214,7,207,214,7,207,,,
404912,20,768,123,645,768,123,645,,,
404994,20,2745,873,1872,2365,792,1573,380,81,299
405012,20,66,1,65,66,1,65,,,
405058,20,155,155,0,155,155,0,,,
405076,20,518,86,432,518,86,432,,,
405854,20,225,225,0,225,225,0,,,
405872,20,2770,1081,1689,891,423,468,1879,658,1221
406024,20,2374,299,2075,1290,176,1114,1084,123,961
406033,20,3722,465,3257,2179,282,1897,1543,183,1360
406149,20,93,25,68,93,25,68,,,
406325,20,105,14,91,25,1,24,80,13,67
406361,20,19,1,18,19,1,18,,,
406422,20,74,5,69,32,2,30,42,3,39
406486,20,48,19,29,23,8,15,25,11,14
406547,20,147,17,130,42,6,36,105,11,94
407090,20,574,15,559,203,8,195,371,7,364
407142,20,89,1,88,89,1,88,,,
407151,20,53,0,53,53,0,53,,,
407179,20,79,0,79,51,0,51,28,0,28
407355,20,166,13,153,166,13,153,,,
407391,20,132,29,103,65,5,60,67,24,43
407407,20,74,16,58,51,14,37,23,2,21
407425,20,80,12,68,43,0,43,37,12,25
407434,20,55,0,55,55,0,55,,,
407461,20,86,58,28,86,58,28,,,
407470,20,126,3,123,100,3,97,26,0,26
407489,20,76,51,25,23,12,11,53,39,14
407513,20,184,82,102,80,17,63,104,65,39
407522,20,26,9,17,,,,26,9,17
407568,20,174,6,168,143,3,140,31,3,28
407577,20,75,30,45,62,22,40,13,8,5
407595,20,72,12,60,72,12,60,,,
407610,20,48,25,23,7,3,4,41,22,19
407629,20,12,2,10,12,2,10,,,
407683,20,78,4,74,28,1,27,50,3,47
407708,20,233,7,226,233,7,226,,,
407735,20,47,2,45,47,2,45,,,
407832,20,164,113,51,63,45,18,101,68,33
408066,20,175,47,128,135,38,97,40,9,31
408163,20,48,1,47,48,1,47,,,
408385,20,712,234,478,712,234,478,,,
408729,20,92,11,81,87,11,76,5,0,5
408844,20,2695,757,1938,1694,500,1194,1001,257,744
408862,20,265,9,256,91,5,86,174,4,170
409032,20,52,1,51,52,1,51,,,
409120,20,99,28,71,99,28,71,,,
409193,20,155,154,1,155,154,1,,,
409315,20,28962,12198,16764,8384,3590,4794,20578,8608,11970
409537,20,23,10,13,,,,23,10,13
409591,20,119,34,85,57,18,39,62,16,46
409698,20,6692,2550,4142,5848,2126,3722,844,424,420
410797,20,275,156,119,275,156,119,,,
410964,20,41,1,40,35,1,34,6,0,6
411684,20,98,28,70,98,28,70,,,
411754,20,40,8,32,40,8,32,,,
412173,20,452,40,412,412,37,375,40,3,37
412535,20,39,3,36,38,3,35,1,0,1
412544,20,156,15,141,110,15,95,46,0,46
412599,20,379,121,258,379,121,258,,,
413176,20,32,17,15,32,17,15,,,
413413,20,12383,2382,10001,2326,431,1895,10057,1951,8106
413617,20,191,56,135,67,20,47,124,36,88
413626,20,156,65,91,82,39,43,74,26,48
413680,20,319,293,26,319,293,26,,,
413778,20,368,22,346,190,10,180,178,12,166
413820,20,6,0,6,6,0,6,,,
413893,20,1269,729,540,1269,729,540,,,
413945,20,50,6,44,50,6,44,,,
413972,20,27,2,25,27,2,25,,,
414063,20,109,3,106,92,3,89,17,0,17
414124,20,314,235,79,251,193,58,63,42,21
414461,20,2122,2020,102,1856,1766,90,266,254,12
414489,20,54,2,52,54,2,52,,,
414540,20,283,9,274,259,8,251,24,1,23
414595,20,271,50,221,34,10,24,237,40,197
414869,20,283,20,263,102,16,86,181,4,177
414878,20,383,150,233,156,53,103,227,97,130
414911,20,2345,830,1515,643,271,372,1702,559,1143
414939,20,281,22,259,281,22,259,,,
415039,20,48,1,47,27,1,26,21,0,21
415057,20,39,39,0,39,39,0,,,
415987,20,95,6,89,95,6,89,,,
416458,20,202,52,150,202,52,150,,,
416801,20,331,67,264,293,62,231,38,5,33
417008,20,136,5,131,136,5,131,,,
417062,20,45,0,45,31,0,31,14,0,14
417105,20,362,224,138,214,130,84,148,94,54
417123,20,60,13,47,28,9,19,32,4,28
417248,20,50,49,1,50,49,1,,,
417275,20,35,31,4,35,31,4,,,
417327,20,218,27,191,47,5,42,171,22,149
417442,20,52,5,47,52,5,47,,,
417503,20,265,3,262,173,3,170,92,0,92
417600,20,16,0,16,16,0,16,,,
417628,20,27,2,25,25,2,23,2,0,2
417637,20,56,21,35,56,21,35,,,
417646,20,23,1,22,23,1,22,,,
417655,20,28,0,28,28,0,28,,,
417682,20,26,3,23,26,3,23,,,
417716,20,183,11,172,183,11,172,,,
417725,20,42,0,42,42,0,42,,,
417734,20,158,24,134,58,13,45,100,11,89
417752,20,31,13,18,29,11,18,2,2,0
417831,20,122,84,38,122,84,38,,,
417840,20,400,17,383,400,17,383,,,
417868,20,46,15,31,28,6,22,18,9,9
417886,20,24,1,23,24,1,23,,,
417910,20,212,31,181,212,31,181,,,
417983,20,31,1,30,,,,31,1,30
417992,20,51,5,46,51,5,46,,,
418001,20,87,7,80,87,7,80,,,
418010,20,82,4,78,35,2,33,47,2,45
418029,20,39,2,37,39,2,37,,,
418038,20,146,13,133,146,13,133,,,
418056,20,22,7,15,22,7,15,,,
418065,20,266,28,238,195,24,171,71,4,67
418083,20,48,7,41,48,7,41,,,
418126,20,222,62,160,128,32,96,94,30,64
418171,20,76,76,0,76,76,0,,,
418199,20,36,33,3,36,33,3,,,
418205,20,248,131,117,177,121,56,71,10,61
418223,20,103,1,102,103,1,102,,,
418250,20,195,126,69,29,21,8,166,105,61
418269,20,280,165,115,280,165,115,,,
418278,20,66,38,28,40,17,23,26,21,5
418296,20,1571,779,792,392,132,260,1179,647,532
418302,20,498,260,238,112,19,93,386,241,145
418320,20,980,552,428,44,11,33,936,541,395
418348,20,483,341,142,59,49,10,424,292,132
418357,20,181,84,97,49,19,30,132,65,67
418409,20,223,110,113,159,70,89,64,40,24
418427,20,81,7,74,60,5,55,21,2,19
418445,20,18,0,18,18,0,18,,,
418454,20,127,48,79,120,41,79,7,7,0
418481,20,53,2,51,53,2,51,,,
418515,20,68,4,64,44,4,40,24,0,24
418524,20,47,2,45,47,2,45,,,
418533,20,353,45,308,269,28,241,84,17,67
418542,20,111,15,96,46,5,41,65,10,55
418560,20,109,19,90,19,1,18,90,18,72
418588,20,28,3,25,28,3,25,,,
418612,20,10,1,9,10,1,9,,,
418658,20,403,357,46,403,357,46,,,
418773,20,303,137,166,249,121,128,54,16,38
418782,20,211,202,9,211,202,9,,,
418889,20,58,51,7,37,30,7,21,21,0
418913,20,8,3,5,8,3,5,,,
418968,20,188,6,182,188,6,182,,,
419031,20,26,7,19,26,7,19,,,
419095,20,32,3,29,32,3,29,,,
419183,20,79,4,75,79,4,75,,,
419217,20,76,16,60,76,16,60,,,
419226,20,461,236,225,346,189,157,115,47,68
419235,20,143,36,107,143,36,107,,,
419244,20,183,146,37,99,80,19,84,66,18
419253,20,121,79,42,121,79,42,,,
419280,20,32,2,30,23,1,22,9,1,8
419332,20,2,2,0,2,2,0,,,
419341,20,8,2,6,8,2,6,,,
419420,20,33,14,19,33,14,19,,,
419484,20,25,2,23,25,2,23,,,
419633,20,85,9,76,85,9,76,,,
419703,20,460,432,28,460,432,28,,,
419712,20,116,108,8,116,108,8,,,
419721,20,224,215,9,224,215,9,,,
420024,20,204,20,184,164,13,151,40,7,33
420042,20,55,33,22,55,33,22,,,
420130,20,307,16,291,307,16,291,,,
420255,20,29,27,2,29,27,2,,,
420325,20,77,77,0,77,77,0,,,
420343,20,1000,965,35,780,754,26,220,211,9
420370,20,479,159,320,479,159,320,,,
420398,20,16604,6676,9928,3064,1315,1749,13540,5361,8179
420431,20,1705,613,1092,322,105,217,1383,508,875
420440,20,1381,473,908,299,111,188,1082,362,720
420468,20,250,93,157,204,88,116,46,5,41
420538,20,1246,455,791,510,179,331,736,276,460
420556,20,644,220,424,242,92,150,402,128,274
420723,20,484,199,285,128,51,77,356,148,208
420981,20,269,31,238,269,31,238,,,
421513,20,67,10,57,62,9,53,5,1,4
421610,20,119,10,109,119,10,109,,,
421665,20,45,1,44,9,0,9,36,1,35
421708,20,1084,137,947,704,85,619,380,52,328
421717,20,28,19,9,17,10,7,11,9,2
421771,20,38,0,38,29,0,29,9,0,9
421832,20,203,91,112,183,89,94,20,2,18
421841,20,246,97,149,246,97,149,,,
421878,20,369,41,328,251,25,226,118,16,102
421896,20,141,42,99,141,42,99,,,
422020,20,203,197,6,203,197,6,,,
422695,20,356,48,308,356,48,308,,,
422835,20,287,57,230,287,57,230,,,
423120,20,235,9,226,235,9,226,,,
423397,20,495,299,196,495,299,196,,,
423412,20,42,35,7,42,35,7,,,
423652,20,427,134,293,176,45,131,251,89,162
425250,20,113,14,99,63,8,55,50,6,44
425986,20,197,24,173,197,24,173,,,
426314,20,9394,8007,1387,2250,1876,374,7144,6131,1013
427308,20,92,2,90,92,2,90,,,
427335,20,84,0,84,78,0,78,6,0,6
427894,20,82,80,2,82,80,2,,,
427973,20,224,197,27,153,133,20,71,64,7
427982,20,177,104,73,140,89,51,37,15,22
427991,20,579,314,265,311,149,162,268,165,103
428000,20,97,36,61,97,36,61,,,
428019,20,202,107,95,49,21,28,153,86,67
428055,20,191,40,151,191,40,151,,,
428125,20,47,33,14,45,31,14,2,2,0
428143,20,6,1,5,6,1,5,,,
428170,20,694,77,617,424,45,379,270,32,238
428259,20,77,14,63,26,6,20,51,8,43
428392,20,1245,541,704,447,200,247,798,341,457
429012,20,158,136,22,158,136,22,,,
429128,20,586,22,564,34,1,33,552,21,531
430184,20,1423,366,1057,154,81,73,1269,285,984
430227,20,77,1,76,66,1,65,11,0,11
430245,20,616,118,498,616,118,498,,,
430306,20,45,5,40,31,4,27,14,1,13
430403,20,322,26,296,322,26,296,,,
430564,20,25,8,17,8,1,7,17,7,10
430582,20,417,194,223,417,194,223,,,
430670,20,63,16,47,63,16,47,,,
430704,20,28,6,22,25,5,20,3,1,2
430795,20,155,44,111,155,44,111,,,
430883,20,28,2,26,28,2,26,,,
430908,20,42,8,34,28,7,21,14,1,13
430935,20,656,509,147,439,347,92,217,162,55
430971,20,61,13,48,61,13,48,,,
431017,20,333,191,142,86,38,48,247,153,94
431071,20,22,3,19,13,1,12,9,2,7
431105,20,88,11,77,43,5,38,45,6,39
431123,20,170,164,6,170,164,6,,,
431141,20,1403,535,868,1361,531,830,42,4,38
431169,20,78,16,62,64,13,51,14,3,11
431187,20,77,68,9,77,68,9,,,
431196,20,112,9,103,112,9,103,,,
431266,20,100,3,97,42,1,41,58,2,56
431275,20,64,3,61,18,1,17,46,2,44
431284,20,100,3,97,91,1,90,9,2,7
431558,20,283,92,191,262,90,172,21,2,19
431600,20,148,19,129,123,17,106,25,2,23
431716,20,435,256,179,435,256,179,,,
431929,20,8,5,3,5,3,2,3,2,1
431983,20,88,88,0,88,88,0,,,
432117,20,181,1,180,114,1,113,67,0,67
432269,20,39,32,7,39,32,7,,,
432384,20,502,109,393,502,109,393,,,
432524,20,108,34,74,107,33,74,1,1,0
433004,20,369,87,282,369,87,282,,,
433013,20,699,250,449,699,250,449,,,
433040,20,25,2,23,25,2,23,,,
433068,20,455,278,177,371,210,161,84,68,16
433101,20,752,75,677,441,42,399,311,33,278
433138,20,130,30,100,113,21,92,17,9,8
433174,20,473,53,420,73,10,63,400,43,357
433387,20,107952,41445,66507,107952,41445,66507,,,
433420,20,292,248,44,292,248,44,,,
433536,20,372,43,329,189,23,166,183,20,163
433660,20,14228,6098,8130,11379,4806,6573,2849,1292,1557
434016,20,165,50,115,42,15,27,123,35,88
434061,20,5996,2348,3648,3068,1410,1658,2928,938,1990
434140,20,710,142,568,710,142,568,,,
434159,20,516,390,126,516,390,126,,,
434274,20,83,12,71,56,7,49,27,5,22
434283,20,30,3,27,28,2,26,2,1,1
434308,20,356,13,343,356,13,343,,,
434344,20,223,8,215,221,8,213,2,0,2
434362,20,35,34,1,35,34,1,,,
434432,20,14,3,11,14,3,11,,,
434469,20,20,3,17,20,3,17,,,
434496,20,81,0,81,81,0,81,,,
434539,20,55,18,37,7,2,5,48,16,32
434584,20,268,75,193,55,15,40,213,60,153
434672,20,16126,5851,10275,4181,1911,2270,11945,3940,8005
434751,20,123,36,87,57,23,34,66,13,53
434821,20,822,28,794,822,28,794,,,
434830,20,194,6,188,131,6,125,63,0,63
434900,20,335,78,257,190,39,151,145,39,106
434937,20,33,33,0,33,33,0,,,
435000,20,27,3,24,27,3,24,,,
436003,20,71,10,61,46,6,40,25,4,21
436030,20,231,100,131,136,59,77,95,41,54
436100,20,13,2,11,13,2,11,,,
436304,20,2401,1212,1189,1102,620,482,1299,592,707
436429,20,5827,3867,1960,5827,3867,1960,,,
436553,20,372,63,309,372,63,309,,,
436599,20,102,19,83,18,5,13,84,14,70
436614,20,46,27,19,24,11,13,22,16,6
436632,20,145,18,127,74,12,62,71,6,65
436641,20,89,31,58,89,31,58,,,
436650,20,174,18,156,174,18,156,,,
436775,20,129,6,123,129,6,123,,,
436818,20,795,347,448,720,312,408,75,35,40
436827,20,522,290,232,469,254,215,53,36,17
436836,20,2405,1222,1183,2188,1096,1092,217,126,91
437097,20,388,216,172,362,202,160,26,14,12
437103,20,7494,2542,4952,3344,1263,2081,4150,1279,2871
437237,20,58,50,8,58,50,8,,,
437316,20,343,52,291,339,51,288,4,1,3
437325,20,136,28,108,12,6,6,124,22,102
437556,20,1246,555,691,1197,554,643,49,1,48
437608,20,145,102,43,143,100,43,2,2,0
437635,20,688,70,618,688,70,618,,,
437723,20,73,18,55,73,18,55,,,
437732,20,103,9,94,78,6,72,25,3,22
437750,20,82,81,1,82,81,1,,,
437769,20,108,7,101,108,7,101,,,
437778,20,212,4,208,212,4,208,,,
437857,20,108,0,108,81,0,81,27,0,27
437936,20,619,66,553,619,66,553,,,
438179,20,248,35,213,248,35,213,,,
438221,20,171,15,156,164,15,149,7,0,7
438258,20,415,98,317,415,98,317,,,
438285,20,228,19,209,228,19,209,,,
438337,20,142,52,90,114,42,72,28,10,18
438498,20,1240,207,1033,269,55,214,971,152,819
438504,20,1366,1310,56,1366,1310,56,,,
438586,20,1086,331,755,863,256,607,223,75,148
438674,20,63,0,63,39,0,39,24,0,24
438708,20,361,92,269,112,27,85,249,65,184
438735,20,191,174,17,146,134,12,45,40,5
438984,20,35,12,23,35,12,23,,,
439020,20,7,3,4,5,1,4,2,2,0
439118,20,393,50,343,393,50,343,,,
439190,20,1996,991,1005,1143,569,574,853,422,431
439367,20,1132,312,820,1132,312,820,,,
439455,20,213,9,204,114,1,113,99,8,91
439473,20,213,91,122,115,51,64,98,40,58
439491,20,309,53,256,309,53,256,,,
439507,20,299,23,276,299,23,276,,,
439570,20,515,27,488,515,27,488,,,
439622,20,312,49,263,312,49,263,,,
439668,20,214,185,29,214,185,29,,,
439686,20,23,1,22,23,1,22,,,
439701,20,299,114,185,149,55,94,150,59,91
439738,20,387,76,311,387,76,311,,,
439747,20,158,32,126,114,25,89,44,7,37
439774,20,53,18,35,38,16,22,15,2,13
439783,20,87,31,56,72,26,46,15,5,10
439792,20,442,39,403,442,39,403,,,
439844,20,47,1,46,47,1,46,,,
439862,20,82,24,58,66,18,48,16,6,10
439871,20,140,4,136,123,4,119,17,0,17
439899,20,77,37,40,50,17,33,27,20,7
439932,20,66,10,56,66,10,56,,,
439969,20,76,26,50,76,26,50,,,
440059,20,716,660,56,554,508,46,162,152,10
440101,20,101,6,95,48,2,46,53,4,49
440226,20,50,0,50,50,0,50,,,
440262,20,423,401,22,337,322,15,86,79,7
440271,20,134,68,66,134,68,66,,,
440396,20,198,86,112,188,81,107,10,5,5
440402,20,1829,617,1212,729,243,486,1100,374,726
440651,20,574,151,423,354,90,264,220,61,159
440730,20,304,110,194,304,110,194,,,
440749,20,65,52,13,2,2,0,63,50,13
440776,20,48,9,39,48,9,39,,,
440794,20,443,111,332,304,76,228,139,35,104
440819,20,18,9,9,18,9,9,,,
440828,20,1044,531,513,566,293,273,478,238,240
440855,20,113,4,109,113,4,109,,,
440989,20,513,391,122,513,391,122,,,
441025,20,240,60,180,234,59,175,6,1,5
441052,20,1374,324,1050,1374,324,1050,,,
441070,20,131,48,83,20,8,12,111,40,71
441168,20,23,1,22,23,1,22,,,
441210,20,252,117,135,2,0,2,250,117,133
441229,20,1389,255,1134,1389,255,1134,,,
441256,20,23,0,23,23,0,23,,,
441371,20,5978,194,5784,5962,193,5769,16,1,15
441380,20,227,68,159,203,62,141,24,6,18
441414,20,145,39,106,29,12,17,116,27,89
441423,20,218,48,170,218,48,170,,,
441487,20,55,3,52,54,3,51,1,0,1
441496,20,163,141,22,134,115,19,29,26,3
441502,20,345,30,315,345,30,315,,,
441548,20,86,18,68,86,18,68,,,
441575,20,247,34,213,247,34,213,,,
441593,20,11,0,11,11,0,11,,,
441609,20,102,102,0,102,102,0,,,
441618,20,26,0,26,15,0,15,11,0,11
441636,20,476,68,408,416,58,358,60,10,50
441645,20,132,2,130,91,1,90,41,1,40
441663,20,293,23,270,293,23,270,,,
441672,20,34,4,30,34,4,30,,,
441690,20,164,95,69,61,37,24,103,58,45
441706,20,335,122,213,335,122,213,,,
441742,20,746,65,681,637,58,579,109,7,102
441760,20,4487,1977,2510,1387,727,660,3100,1250,1850
441788,20,529,479,50,372,335,37,157,144,13
441830,20,43,13,30,43,13,30,,,
441858,20,152,8,144,137,6,131,15,2,13
441876,20,233,10,223,120,7,113,113,3,110
441900,20,7158,1887,5271,2055,417,1638,5103,1470,3633
441937,20,6471,2203,4268,4991,1648,3343,1480,555,925
441982,20,382,183,199,360,174,186,22,9,13
442073,20,792,155,637,514,115,399,278,40,238
442134,20,363,50,313,363,50,313,,,
442213,20,39,0,39,33,0,33,6,0,6
442240,20,403,76,327,230,41,189,173,35,138
442329,20,937,844,93,937,844,93,,,
442356,20,1670,179,1491,646,72,574,1024,107,917
442383,20,115,21,94,115,21,94,,,
442426,20,416,36,380,268,21,247,148,15,133
442435,20,31,5,26,31,5,26,,,
442444,20,802,430,372,802,430,372,,,
442523,20,78,33,45,71,31,40,7,2,5
442569,20,4498,2037,2461,1360,607,753,3138,1430,1708
442602,20,490,76,414,490,76,414,,,
442611,20,1211,1144,67,1211,1144,67,,,
442639,20,80,57,23,80,57,23,,,
442657,20,246,18,228,246,18,228,,,
442781,20,766,158,608,200,38,162,566,120,446
442842,20,51,13,38,32,9,23,19,4,15
442879,20,900,65,835,670,48,622,230,17,213
442888,20,23,23,0,23,23,0,,,
442930,20,550,275,275,516,254,262,34,21,13
442949,20,3,0,3,,,,3,0,3
442976,20,93,3,90,93,3,90,,,
442985,20,250,28,222,250,28,222,,,
443021,20,57,47,10,57,47,10,,,
443049,20,140,83,57,73,45,28,67,38,29
443058,20,39,17,22,11,3,8,28,14,14
443100,20,59,40,19,59,40,19,,,
443137,20,331,58,273,331,58,273,,,
443146,20,64,53,11,50,40,10,14,13,1
443207,20,129,121,8,129,121,8,,,
443216,20,151,115,36,151,115,36,,,
443225,20,72,57,15,72,57,15,,,
443234,20,162,3,159,162,3,159,,,
443252,20,1635,993,642,1635,993,642,,,
443261,20,210,10,200,152,8,144,58,2,56
443289,20,168,26,142,168,26,142,,,
443298,20,27,23,4,27,23,4,,,
443322,20,30,5,25,30,5,25,,,
443331,20,2581,531,2050,2096,415,1681,485,116,369
443340,20,43,20,23,37,19,18,6,1,5
443377,20,54,48,6,54,48,6,,,
443410,20,1138,804,334,1041,729,312,97,75,22
443492,20,1596,648,948,801,388,413,795,260,535
443562,20,335,55,280,209,37,172,126,18,108
443571,20,105,56,49,105,56,49,,,
443599,20,802,57,745,163,17,146,639,40,599
443632,20,99,61,38,99,61,38,,,
443641,20,167,3,164,70,1,69,97,2,95
443650,20,1010,168,842,912,159,753,98,9,89
443669,20,114,7,107,114,7,107,,,
443696,20,55,12,43,55,12,43,,,
443748,20,700,164,536,682,161,521,18,3,15
443766,20,2569,449,2120,126,53,73,2443,396,2047
443784,20,1347,299,1048,73,27,46,1274,272,1002
443951,20,51,25,26,51,25,26,,,
443979,20,43,0,43,16,0,16,27,0,27
444051,20,86,3,83,70,3,67,16,0,16
444088,20,556,65,491,556,65,491,,,
444130,20,158,57,101,41,27,14,117,30,87
444194,20,61,3,58,61,3,58,,,
444219,20,8926,3926,5000,1821,836,985,7105,3090,4015
444228,20,32,0,32,32,0,32,,,
444255,20,63,12,51,63,12,51,,,
444264,20,12,3,9,11,3,8,1,0,1
444282,20,84,2,82,49,2,47,35,0,35
444291,20,90,3,87,57,1,56,33,2,31
444307,20,69,4,65,47,3,44,22,1,21
444325,20,210,28,182,178,24,154,32,4,28
444334,20,62,5,57,62,5,57,,,
444361,20,63,25,38,63,25,38,,,
444370,20,48,48,0,48,48,0,,,
444398,20,120,56,64,86,46,40,34,10,24
444404,20,15,10,5,8,5,3,7,5,2
444413,20,155,155,0,155,155,0,,,
444440,20,25,2,23,25,2,23,,,
444468,20,23,1,22,21,1,20,2,0,2
444486,20,340,17,323,304,14,290,36,3,33
444510,20,116,14,102,116,14,102,,,
444529,20,115,21,94,115,21,94,,,
444556,20,543,241,302,543,241,302,,,
444565,20,303,146,157,236,113,123,67,33,34
444583,20,364,171,193,364,171,193,,,
444635,20,90,9,81,6,0,6,84,9,75
444662,20,108,96,12,108,96,12,,,
444671,20,87,44,43,87,44,43,,,
444714,20,248,17,231,248,17,231,,,
444732,20,30,2,28,30,2,28,,,
444778,20,58,24,34,31,12,19,27,12,15
444787,20,2273,310,1963,1441,197,1244,832,113,719
444796,20,131,73,58,131,73,58,,,
444811,20,619,33,586,327,18,309,292,15,277
444857,20,141,3,138,60,1,59,81,2,79
444866,20,185,19,166,119,14,105,66,5,61
444893,20,341,13,328,341,13,328,,,
444936,20,135,47,88,133,47,86,2,0,2
444945,20,234,23,211,234,23,211,,,
444954,20,1127,404,723,650,277,373,477,127,350
445027,20,11267,4115,7152,10090,3773,6317,1177,342,835
445133,20,149,53,96,104,41,63,45,12,33
445188,20,8321,3972,4349,8227,3919,4308,94,53,41
445203,20,223,34,189,223,34,189,,,
445212,20,225,34,191,126,19,107,99,15,84
445230,20,786,214,572,786,214,572,,,
445249,20,272,60,212,272,60,212,,,
445258,20,6,1,5,6,1,5,,,
445267,20,2886,822,2064,949,188,761,1937,634,1303
445364,20,361,36,325,361,36,325,,,
445461,20,746,275,471,724,269,455,22,6,16
445498,20,8,8,0,8,8,0,,,
445540,20,66,0,66,66,0,66,,,
445638,20,10,0,10,6,0,6,4,0,4
445647,20,167,2,165,94,1,93,73,1,72
445656,20,175,7,168,109,5,104,66,2,64
445692,20,517,438,79,470,398,72,47,40,7
445708,20,1262,438,824,1231,421,810,31,17,14
445735,20,559,142,417,559,142,417,,,
445744,20,481,89,392,481,89,392,,,
445762,20,244,224,20,195,179,16,49,45,4
445780,20,30,3,27,30,3,27,,,
445799,20,1031,978,53,1031,978,53,,,
445841,20,141,0,141,107,0,107,34,0,34
445850,20,145,0,145,97,0,97,48,0,48
445911,20,831,332,499,537,211,326,294,121,173
445948,20,1576,221,1355,1576,221,1355,,,
445957,20,319,62,257,,,,319,62,257
446048,20,1259,568,691,1234,552,682,25,16,9
446084,20,82,7,75,21,2,19,61,5,56
446093,20,104,9,95,88,7,81,16,2,14
446109,20,323,37,286,249,24,225,74,13,61
446118,20,649,118,531,649,118,531,,,
446127,20,200,5,195,200,5,195,,,
446163,20,483,442,41,331,309,22,152,133,19
446206,20,25,6,19,16,2,14,9,4,5
446224,20,12,6,6,,,,12,6,6
446233,20,148,89,59,135,85,50,13,4,9
446242,20,117,41,76,117,41,76,,,
446251,20,104,20,84,104,20,84,,,
446260,20,765,22,743,765,22,743,,,
446288,20,75,4,71,44,0,44,31,4,27
446303,20,45,1,44,29,0,29,16,1,15
446349,20,25,3,22,25,3,22,,,
446385,20,251,144,107,236,134,102,15,10,5
446394,20,20,6,14,3,2,1,17,4,13
446455,20,25,23,2,25,23,2,,,
446516,20,4,1,3,4,1,3,,,
446525,20,271,228,43,271,228,43,,,
446552,20,1568,803,765,1568,803,765,,,
446561,20,1710,400,1310,1710,400,1310,,,
446589,20,402,76,326,402,76,326,,,
446598,20,14,0,14,12,0,12,2,0,2
446604,20,2399,2399,0,2399,2399,0,,,
446640,20,637,429,208,588,402,186,49,27,22
446774,20,4060,1511,2549,844,346,498,3216,1165,2051
447014,20,177,13,164,177,13,164,,,
447023,20,1637,695,942,1626,695,931,11,0,11
447050,20,188,45,143,60,15,45,128,30,98
447148,20,170,5,165,111,4,107,59,1,58
447166,20,56,5,51,33,5,28,23,0,23
447175,20,64,2,62,45,1,44,19,1,18
447263,20,1996,268,1728,1518,183,1335,478,85,393
447351,20,493,248,245,493,248,245,,,
447379,20,12,10,2,12,10,2,,,
447421,20,230,25,205,230,25,205,,,
447449,20,46,9,37,27,7,20,19,2,17
447458,20,253,204,49,253,204,49,,,
447467,20,70,3,67,70,3,67,,,
447582,20,1042,329,713,568,203,365,474,126,348
447591,20,651,61,590,651,61,590,,,
447607,20,1514,776,738,1514,776,738,,,
447616,20,1182,628,554,1182,628,554,,,
447689,20,10949,4517,6432,6890,2884,4006,4059,1633,2426
447704,20,139,4,135,139,4,135,,,
447713,20,206,56,150,206,56,150,,,
447722,20,30,3,27,30,3,27,,,
447731,20,165,5,160,112,5,107,53,0,53
447759,20,198,49,149,173,45,128,25,4,21
447768,20,1526,299,1227,1526,299,1227,,,
447777,20,843,438,405,19,14,5,824,424,400
447795,20,42,8,34,42,8,34,,,
447810,20,219,21,198,219,21,198,,,
447847,20,128,120,8,128,120,8,,,
447865,20,8,3,5,4,2,2,4,1,3
447874,20,213,208,5,213,208,5,,,
447883,20,166,23,143,71,12,59,95,11,84
447892,20,127,12,115,77,9,68,50,3,47
447908,20,66,3,63,42,1,41,24,2,22
447917,20,50,10,40,50,10,40,,,
447935,20,286,14,272,286,14,272,,,
447953,20,416,210,206,352,180,172,64,30,34
447962,20,163,14,149,163,14,149,,,
447971,20,29,0,29,29,0,29,,,
447980,20,96,4,92,21,1,20,75,3,72
447999,20,181,46,135,181,46,135,,,
448026,20,128,5,123,93,4,89,35,1,34
448071,20,333,16,317,217,7,210,116,9,107
448123,20,208,17,191,208,17,191,,,
448196,20,102,9,93,97,9,88,5,0,5
448220,20,152,8,144,152,8,144,,,
448239,20,117,1,116,117,1,116,,,
448248,20,3772,2093,1679,498,106,392,3274,1987,1287
448257,20,17,0,17,2,0,2,15,0,15
448275,20,24,1,23,24,1,23,,,
448354,20,220,23,197,140,10,130,80,13,67
448372,20,196,91,105,196,91,105,,,
448424,20,71,5,66,32,1,31,39,4,35
448433,20,1232,1193,39,1232,1193,39,,,
448594,20,3484,1245,2239,1049,410,639,2435,835,1600
448600,20,257,16,241,257,16,241,,,
448619,20,654,43,611,323,27,296,331,16,315
448646,20,34,0,34,34,0,34,,,
448673,20,2620,258,2362,947,100,847,1673,158,1515
448770,20,284,271,13,267,256,11,17,15,2
448798,20,150,5,145,150,5,145,,,
448859,20,154,144,10,154,144,10,,,
448895,20,526,90,436,526,90,436,,,
449038,20,1277,301,976,137,63,74,1140,238,902
449074,20,576,80,496,576,80,496,,,
449083,20,123,122,1,123,122,1,,,
449092,20,133,132,1,133,132,1,,,
449135,20,206,62,144,144,48,96,62,14,48
449250,20,688,132,556,688,132,556,,,
449311,20,182,1,181,65,0,65,117,1,116
449320,20,673,650,23,471,457,14,202,193,9
449339,20,38969,24796,14173,2405,1188,1217,36564,23608,12956
449348,20,79,26,53,7,2,5,72,24,48
449357,20,62,3,59,62,3,59,,,
449384,20,409,257,152,294,187,107,115,70,45
449393,20,85,33,52,85,33,52,,,
449445,20,121,22,99,121,22,99,,,
449454,20,44,7,37,,,,44,7,37
449463,20,157,21,136,131,17,114,26,4,22
449472,20,66,2,64,66,2,64,,,
449490,20,164,40,124,164,40,124,,,
449506,20,63,36,27,63,36,27,,,
449524,20,298,24,274,298,24,274,,,
449533,20,83,7,76,83,7,76,,,
449597,20,4,0,4,4,0,4,,,
449603,20,191,120,71,191,120,71,,,
449612,20,93,53,40,93,53,40,,,
449658,20,117,117,0,117,117,0,,,
449676,20,273,129,144,273,129,144,,,
449685,20,230,19,211,230,19,211,,,
449700,20,382,73,309,382,73,309,,,
449719,20,45,6,39,45,6,39,,,
449728,20,160,3,157,160,3,157,,,
449764,20,244,108,136,200,98,102,44,10,34
449773,20,180,50,130,180,50,130,,,
449782,20,21,2,19,17,1,16,4,1,3
449807,20,70,1,69,70,1,69,,,
449816,20,642,417,225,49,29,20,593,388,205
449834,20,1,1,0,,,,1,1,0
449861,20,172,8,164,172,8,164,,,
449870,20,77,28,49,60,21,39,17,7,10
449889,20,73,19,54,73,19,54,,,
449898,20,491,91,400,324,62,262,167,29,138
449904,20,169,6,163,169,6,163,,,
449959,20,210,32,178,134,19,115,76,13,63
449968,20,261,52,209,176,34,142,85,18,67
449977,20,185,7,178,127,3,124,58,4,54
449986,20,346,77,269,206,37,169,140,40,100
449995,20,109,3,106,64,3,61,45,0,45
450021,20,160,31,129,160,31,129,,,
450058,20,904,163,741,904,163,741,,,
450067,20,562,152,410,558,152,406,4,0,4
450119,20,36,3,33,36,3,33,,,
450128,20,548,14,534,548,14,534,,,
450298,20,267,60,207,13,7,6,254,53,201
450377,20,1188,215,973,62,27,35,1126,188,938
450395,20,112,0,112,60,0,60,52,0,52
450401,20,418,35,383,418,35,383,,,
450571,20,496,43,453,255,19,236,241,24,217
450599,20,68,2,66,68,2,66,,,
450605,20,45,1,44,31,0,31,14,1,13
450614,20,110,3,107,85,3,82,25,0,25
450632,20,115,20,95,,,,115,20,95
450641,20,248,36,212,149,30,119,99,6,93
450650,20,196,14,182,74,3,71,122,11,111
450696,20,357,43,314,357,43,314,,,
450702,20,199,13,186,199,13,186,,,
450711,20,56,43,13,56,43,13,,,
450720,20,664,17,647,302,5,297,362,12,350
450933,20,11672,7607,4065,6370,3894,2476,5302,3713,1589
450951,20,158,91,67,158,91,67,,,
450960,20,286,27,259,228,20,208,58,7,51
450988,20,201,26,175,132,20,112,69,6,63
451042,20,11,0,11,7,0,7,4,0,4
451051,20,106,9,97,,,,106,9,97
451097,20,52,8,44,39,4,35,13,4,9
451103,20,393,79,314,108,18,90,285,61,224
451121,20,111,9,102,56,4,52,55,5,50
451149,20,645,44,601,645,44,601,,,
451158,20,636,31,605,636,31,605,,,
451167,20,137,54,83,79,39,40,58,15,43
451194,20,29,3,26,29,3,26,,,
451228,20,216,179,37,216,179,37,,,
451237,20,197,4,193,197,4,193,,,
451255,20,52,2,50,29,0,29,23,2,21
451264,20,125,15,110,125,15,110,,,
451282,20,111,4,107,80,3,77,31,1,30
451291,20,12,1,11,,,,12,1,11
451307,20,21,1,20,3,0,3,18,1,17
451316,20,58,11,47,58,11,47,,,
451334,20,285,114,171,206,84,122,79,30,49
451343,20,91,3,88,59,2,57,32,1,31
451352,20,231,25,206,170,20,150,61,5,56
451370,20,68,68,0,68,68,0,,,
451398,20,230,230,0,230,230,0,,,
451404,20,473,473,0,473,473,0,,,
451413,20,216,60,156,216,60,156,,,
451459,20,127,25,102,56,11,45,71,14,57
451468,20,406,7,399,406,7,399,,,
451477,20,2397,1960,437,2397,1960,437,,,
451495,20,296,60,236,296,60,236,,,
451501,20,258,82,176,258,82,176,,,
451529,20,57,3,54,13,0,13,44,3,41
451547,20,16,0,16,16,0,16,,,
451556,20,1419,501,918,1419,501,918,,,
451565,20,214,30,184,210,29,181,4,1,3
451574,20,144,2,142,126,2,124,18,0,18
451583,20,958,679,279,186,138,48,772,541,231
451626,20,59,12,47,49,12,37,10,0,10
451714,20,349,54,295,299,39,260,50,15,35
451741,20,108,30,78,82,23,59,26,7,19
451750,20,1229,268,961,751,224,527,478,44,434
451820,20,130,74,56,83,51,32,47,23,24
451857,20,99,12,87,99,12,87,,,
451866,20,341,45,296,341,45,296,,,
451918,20,115,10,105,115,10,105,,,
451927,20,387,195,192,351,180,171,36,15,21
452009,20,71,0,71,71,0,71,,,
452072,20,35,4,31,35,4,31,,,
452081,20,968,33,935,968,33,935,,,
452106,20,72,69,3,72,69,3,,,
452124,20,479,88,391,476,87,389,3,1,2
452373,20,265,13,252,265,13,252,,,
452771,20,15,2,13,,,,15,2,13
452780,20,13,0,13,,,,13,0,13
452887,20,73,71,2,73,71,2,,,
452948,20,952,86,866,481,37,444,471,49,422
453163,20,3022,473,2549,150,59,91,2872,414,2458
453215,20,551,117,434,29,8,21,522,109,413
453297,20,32,9,23,32,9,23,,,
453756,20,277,163,114,277,163,114,,,
453792,20,86,4,82,86,4,82,,,
454184,20,384,140,244,351,129,222,33,11,22
454227,20,13324,1397,11927,2891,300,2591,10433,1097,9336
454236,20,679,76,603,247,26,221,432,50,382
454245,20,797,135,662,254,38,216,543,97,446
454458,20,15,4,11,15,4,11,,,
454537,20,76,0,76,76,0,76,,,
454546,20,169,7,162,169,7,162,,,
454555,20,244,17,227,244,17,227,,,
454582,20,172,57,115,34,15,19,138,42,96
454607,20,311,6,305,311,6,305,,,
454616,20,128,107,21,128,107,21,,,
454652,20,146,2,144,146,2,144,,,
454689,20,3,1,2,3,1,2,,,
454698,20,323,93,230,323,93,230,,,
454722,20,35,8,27,32,5,27,3,3,0
454759,20,32,27,5,20,15,5,12,12,0
454768,20,275,45,230,157,31,126,118,14,104
454777,20,205,26,179,134,21,113,71,5,66
454786,20,734,426,308,167,96,71,567,330,237
454795,20,346,85,261,225,56,169,121,29,92
454801,20,179,39,140,179,39,140,,,
454810,20,9606,2767,6839,9606,2767,6839,,,
454829,20,6385,838,5547,1772,209,1563,4613,629,3984
454856,20,1046,132,914,1046,132,914,,,
454865,20,777,99,678,541,67,474,236,32,204
454874,20,52,5,47,34,4,30,18,1,17
454917,20,745,115,630,464,70,394,281,45,236
454926,20,266,19,247,236,17,219,30,2,28
454935,20,75,1,74,75,1,74,,,
454944,20,197,30,167,197,30,167,,,
454953,20,39,1,38,25,1,24,14,0,14
454962,20,54,0,54,31,0,31,23,0,23
454971,20,215,30,185,124,29,95,91,1,90
454980,20,118,2,116,36,1,35,82,1,81
454999,20,127,1,126,52,1,51,75,0,75
455008,20,210,7,203,98,6,92,112,1,111
455026,20,102,90,12,,,,102,90,12
455062,20,61,2,59,34,1,33,27,1,26
455071,20,100,20,80,,,,100,20,80
455080,20,250,27,223,249,27,222,1,0,1
455105,20,76,0,76,76,0,76,,,
455114,20,10403,4891,5512,2590,1277,1313,7813,3614,4199
455141,20,217,5,212,217,5,212,,,
455187,20,242,25,217,88,13,75,154,12,142
455196,20,2905,257,2648,2905,257,2648,,,
455202,20,403,48,355,224,12,212,179,36,143
455211,20,313,15,298,313,15,298,,,
455220,20,61,9,52,61,9,52,,,
455257,20,370,370,0,370,370,0,,,
455275,20,255,5,250,255,5,250,,,
455284,20,232,5,227,184,4,180,48,1,47
455327,20,37,1,36,34,1,33,3,0,3
455336,20,194,162,32,194,162,32,,,
455354,20,350,12,338,350,12,338,,,
455381,20,182,0,182,124,0,124,58,0,58
455460,20,141,31,110,141,31,110,,,
455479,20,668,60,608,574,54,520,94,6,88
455488,20,264,61,203,264,61,203,,,
455512,20,3227,1161,2066,554,205,349,2673,956,1717
455558,20,91,22,69,91,22,69,,,
455628,20,539,156,383,539,156,383,,,
455664,20,223,29,194,15,4,11,208,25,183
455707,20,54,13,41,54,13,41,,,
455725,20,704,18,686,560,15,545,144,3,141
455734,20,244,53,191,244,53,191,,,
455761,20,325,35,290,213,29,184,112,6,106
455770,20,117,71,46,117,71,46,,,
455798,20,101,4,97,56,3,53,45,1,44
455831,20,188,21,167,188,21,167,,,
455859,20,268,4,264,231,4,227,37,0,37
455868,20,330,63,267,330,63,267,,,
455877,20,117,6,111,117,6,111,,,
455886,20,159,5,154,70,3,67,89,2,87
455895,20,365,28,337,172,4,168,193,24,169
455901,20,182,17,165,63,7,56,119,10,109
455910,20,54,14,40,54,14,40,,,
455929,20,65,1,64,65,1,64,,,
455965,20,144,13,131,144,13,131,,,
455974,20,114,15,99,114,15,99,,,
455983,20,238,77,161,230,75,155,8,2,6
456001,20,70,62,8,70,62,8,,,
456029,20,213,13,200,140,13,127,73,0,73
456038,20,383,38,345,383,38,345,,,
456065,20,155,6,149,152,6,146,3,0,3
456074,20,137,6,131,135,6,129,2,0,2
456135,20,89,0,89,53,0,53,36,0,36
456153,20,80,67,13,80,67,13,,,
456205,20,225,42,183,216,42,174,9,0,9
456214,20,409,291,118,409,291,118,,,
456287,20,114,1,113,114,1,113,,,
456454,20,490,149,341,419,138,281,71,11,60
456481,20,69,36,33,11,4,7,58,32,26
456490,20,128,88,40,36,26,10,92,62,30
456506,20,102,3,99,102,3,99,,,
456515,20,45,1,44,45,1,44,,,
456551,20,60,1,59,60,1,59,,,
456579,20,242,88,154,234,86,148,8,2,6
456588,20,47,3,44,33,3,30,14,0,14
456597,20,214,2,212,95,1,94,119,1,118
456621,20,270,69,201,19,11,8,251,58,193
456825,20,124,2,122,118,2,116,6,0,6
456852,20,295,69,226,295,69,226,,,
456922,20,273,57,216,258,54,204,15,3,12
456931,20,327,172,155,315,169,146,12,3,9
456959,20,646,133,513,616,128,488,30,5,25
456968,20,841,19,822,797,19,778,44,0,44
456977,20,39,24,15,39,24,15,,,
457031,20,58,1,57,44,1,43,14,0,14
457077,20,375,33,342,375,33,342,,,
457086,20,177,34,143,134,30,104,43,4,39
457101,20,349,89,260,349,89,260,,,
457110,20,486,73,413,486,73,413,,,
457129,20,1010,108,902,292,29,263,718,79,639
457192,20,29,14,15,29,14,15,,,
457208,20,47,41,6,47,41,6,,,
457226,20,38,26,12,15,10,5,23,16,7
457253,20,186,8,178,27,1,26,159,7,152
457299,20,286,41,245,264,37,227,22,4,18
457314,20,109,24,85,109,24,85,,,
457323,20,388,45,343,388,45,343,,,
457332,20,49,2,47,49,2,47,,,
457341,20,185,2,183,176,2,174,9,0,9
457350,20,66,0,66,,,,66,0,66
457378,20,250,115,135,109,36,73,141,79,62
457387,20,373,218,155,186,118,68,187,100,87
457396,20,136,29,107,22,6,16,114,23,91
457402,20,120,106,14,101,91,10,19,15,4
457411,20,229,214,15,190,178,12,39,36,3
457420,20,190,12,178,120,10,110,70,2,68
457439,20,71,1,70,25,1,24,46,0,46
457448,20,81,5,76,81,5,76,,,
457466,20,43,31,12,43,31,12,,,
457475,20,99,4,95,99,4,95,,,
457484,20,111,51,60,56,24,32,55,27,28
457493,20,90,3,87,90,3,87,,,
457527,20,249,34,215,15,1,14,234,33,201
457536,20,649,135,514,649,135,514,,,
457545,20,107,5,102,87,3,84,20,2,18
457554,20,36,0,36,21,0,21,15,0,15
457563,20,244,4,240,244,4,240,,,
457572,20,124,5,119,124,5,119,,,
457581,20,195,3,192,172,3,169,23,0,23
457606,20,107,10,97,107,10,97,,,
457615,20,44,6,38,,,,44,6,38
457624,20,37,5,32,37,5,32,,,
457633,20,266,4,262,110,1,109,156,3,153
457642,20,82,1,81,82,1,81,,,
457679,20,18,2,16,18,2,16,,,
457688,20,42,15,27,15,6,9,27,9,18
457697,20,107,45,62,22,11,11,85,34,51
457721,20,14,0,14,14,0,14,,,
457749,20,89,6,83,89,6,83,,,
457767,20,125,81,44,125,81,44,,,
457776,20,170,13,157,165,12,153,5,1,4
457785,20,52,0,52,52,0,52,,,
457794,20,78,2,76,78,2,76,,,
457800,20,98,11,87,98,11,87,,,
457819,20,688,277,411,,,,688,277,411
457837,20,165,10,155,78,10,68,87,0,87
457855,20,47,4,43,39,3,36,8,1,7
457873,20,99,66,33,44,36,8,55,30,25
457916,20,80,0,80,41,0,41,39,0,39
457925,20,12,7,5,12,7,5,,,
457943,20,62,10,52,62,10,52,,,
457952,20,197,3,194,153,2,151,44,1,43
457989,20,48,1,47,48,1,47,,,
457998,20,72,12,60,38,1,37,34,11,23
458007,20,50,3,47,25,2,23,25,1,24
458034,20,100,16,84,100,16,84,,,
458043,20,110,0,110,71,0,71,39,0,39
458061,20,67,7,60,24,4,20,43,3,40
458070,20,291,8,283,271,8,263,20,0,20
458098,20,120,2,118,110,2,108,10,0,10
458104,20,198,2,196,2,0,2,196,2,194
458113,20,68,30,38,8,5,3,60,25,35
458122,20,10,0,10,10,0,10,,,
458131,20,114,7,107,114,7,107,,,
458140,20,52,38,14,52,38,14,,,
458168,20,67,4,63,67,4,63,,,
458210,20,2971,648,2323,2093,466,1627,878,182,696
458229,20,2500,525,1975,2043,436,1607,457,89,368
458274,20,205,7,198,149,6,143,56,1,55
458405,20,259,89,170,251,88,163,8,1,7
458423,20,83,20,63,83,20,63,,,
458441,20,335,51,284,327,51,276,8,0,8
458496,20,122,54,68,90,39,51,32,15,17
458681,20,308,57,251,308,57,251,,,
458803,20,154,3,151,117,3,114,37,0,37
458812,20,93,6,87,79,4,75,14,2,12
458821,20,59,2,57,59,2,57,,,
458830,20,142,5,137,108,4,104,34,1,33
458858,20,139,4,135,74,1,73,65,3,62
458867,20,170,6,164,125,5,120,45,1,44
458885,20,355,64,291,20,7,13,335,57,278
458919,20,4593,945,3648,411,201,210,4182,744,3438
458955,20,406,61,345,21,3,18,385,58,327
458964,20,1693,303,1390,139,61,78,1554,242,1312
458973,20,2269,554,1715,244,133,111,2025,421,1604
458982,20,249,121,128,174,87,87,75,34,41
459019,20,64,4,60,53,3,50,11,1,10
459046,20,51,3,48,35,2,33,16,1,15
459055,20,64,4,60,45,3,42,19,1,18
459064,20,70,5,65,46,3,43,24,2,22
459116,20,94,5,89,94,5,89,,,
459125,20,6,0,6,6,0,6,,,
459170,20,347,28,319,198,25,173,149,3,146
459189,20,175,2,173,31,2,29,144,0,144
459198,20,270,52,218,200,47,153,70,5,65
459204,20,4188,529,3659,4188,529,3659,,,
459213,20,2708,554,2154,2708,554,2154,,,
459231,20,228,26,202,228,26,202,,,
459259,20,342,115,227,174,28,146,168,87,81
459268,20,254,31,223,158,24,134,96,7,89
459277,20,356,19,337,356,19,337,,,
459286,20,222,31,191,179,28,151,43,3,40
459295,20,74,0,74,32,0,32,42,0,42
459301,20,112,6,106,89,3,86,23,3,20
459310,20,77,11,66,77,11,66,,,
459329,20,242,138,104,242,138,104,,,
459347,20,86,3,83,30,2,28,56,1,55
459374,20,123,2,121,41,0,41,82,2,80
459392,20,165,5,160,99,3,96,66,2,64
459408,20,46,8,38,32,3,29,14,5,9
459417,20,74,55,19,68,49,19,6,6,0
459426,20,177,5,172,177,5,172,,,
459462,20,337,288,49,337,288,49,,,
459499,20,29,5,24,29,5,24,,,
459514,20,79,14,65,79,14,65,,,
459523,20,19,1,18,19,1,18,,,
459532,20,75,0,75,2,0,2,73,0,73
459541,20,34,2,32,17,2,15,17,0,17
459550,20,130,2,128,116,2,114,14,0,14
459578,20,125,31,94,92,22,70,33,9,24
459727,20,447,140,307,247,70,177,200,70,130
459824,20,55,6,49,51,6,45,4,0,4
459842,20,644,82,562,360,56,304,284,26,258
459851,20,348,44,304,191,28,163,157,16,141
459949,20,6404,2287,4117,3465,1214,2251,2939,1073,1866
459958,20,300,60,240,300,60,240,,,
459967,20,615,219,396,615,219,396,,,
459985,20,509,255,254,509,255,254,,,
459994,20,7418,2321,5097,428,208,220,6990,2113,4877
460011,20,161,0,161,113,0,113,48,0,48
460020,20,438,88,350,438,88,350,,,
460093,20,45,1,44,45,1,44,,,
460109,20,121,2,119,121,2,119,,,
460118,20,102,1,101,102,1,101,,,
460127,20,80,4,76,80,4,76,,,
460136,20,922,131,791,922,131,791,,,
460145,20,373,220,153,373,220,153,,,
460172,20,642,591,51,640,589,51,2,2,0
460181,20,650,81,569,650,81,569,,,
460190,20,318,39,279,318,39,279,,,
460206,20,488,110,378,488,110,378,,,
460349,20,1571,456,1115,500,129,371,1071,327,744
460376,20,8,5,3,7,5,2,1,0,1
460385,20,41,6,35,41,6,35,,,
460394,20,7694,3007,4687,1375,590,785,6319,2417,3902
460464,20,8756,3855,4901,1543,809,734,7213,3046,4167
460482,20,184,18,166,184,18,166,,,
460516,20,130,7,123,130,7,123,,,
460525,20,113,8,105,113,8,105,,,
460534,20,393,13,380,393,13,380,,,
460543,20,1839,1759,80,1839,1759,80,,,
460677,20,377,84,293,309,69,240,68,15,53
460701,20,214,27,187,64,7,57,150,20,130
460738,20,953,126,827,136,18,118,817,108,709
460756,20,354,25,329,300,23,277,54,2,52
460765,20,41,0,41,41,0,41,,,
460808,20,25,5,20,25,5,20,,,
460817,20,175,50,125,170,50,120,5,0,5
460826,20,505,119,386,504,119,385,1,0,1
460835,20,310,92,218,306,91,215,4,1,3
460862,20,249,14,235,120,5,115,129,9,120
460871,20,715,77,638,275,28,247,440,49,391
460914,20,364,3,361,364,3,361,,,
460932,20,44,1,43,44,1,43,,,
460969,20,238,19,219,238,19,219,,,
460978,20,281,6,275,138,2,136,143,4,139
460987,20,111,2,109,111,2,109,,,
460996,20,161,1,160,106,0,106,55,1,54
461014,20,1199,85,1114,1199,85,1114,,,
461023,20,506,68,438,487,64,423,19,4,15
461032,20,132,68,64,48,24,24,84,44,40
461087,20,1039,521,518,162,61,101,877,460,417
461111,20,35,30,5,24,22,2,11,8,3
461148,20,967,534,433,967,534,433,,,
461175,20,237,15,222,175,13,162,62,2,60
461193,20,281,8,273,275,8,267,6,0,6
461218,20,676,51,625,676,51,625,,,
461245,20,103,47,56,43,18,25,60,29,31
461254,20,26,5,21,26,5,21,,,
461263,20,124,9,115,124,9,115,,,
461272,20,71,0,71,47,0,47,24,0,24
461281,20,99,7,92,66,6,60,33,1,32
461306,20,101,23,78,24,5,19,77,18,59
461315,20,79,18,61,36,13,23,43,5,38
461324,20,774,178,596,738,166,572,36,12,24
461333,20,6,5,1,,,,6,5,1
461342,20,147,0,147,95,0,95,52,0,52
461379,20,34,1,33,4,0,4,30,1,29
461388,20,58,17,41,58,17,41,,,
461412,20,120,36,84,,,,120,36,84
461421,20,233,12,221,231,12,219,2,0,2
461430,20,681,632,49,,,,681,632,49
461494,20,187,21,166,122,13,109,65,8,57
461500,20,12,4,8,4,2,2,8,2,6
461528,20,184,100,84,68,32,36,116,68,48
461537,20,39,1,38,32,1,31,7,0,7
461555,20,105,7,98,105,7,98,,,
461573,20,100,98,2,100,98,2,,,
461582,20,162,3,159,162,3,159,,,
461591,20,141,9,132,141,9,132,,,
461607,20,76,8,68,39,5,34,37,3,34
461625,20,21,20,1,21,20,1,,,
461643,20,20,2,18,20,2,18,,,
461652,20,71,5,66,71,5,66,,,
461689,20,385,33,352,385,33,352,,,
461704,20,170,13,157,170,13,157,,,
461713,20,52,0,52,19,0,19,33,0,33
461722,20,50,2,48,50,2,48,,,
461740,20,40,29,11,40,29,11,,,
461759,20,163,91,72,115,63,52,48,28,20
461768,20,235,6,229,235,6,229,,,
461786,20,27,0,27,27,0,27,,,
461795,20,396,305,91,363,283,80,33,22,11
461810,20,19,5,14,16,4,12,3,1,2
461829,20,79,9,70,79,9,70,,,
461838,20,241,5,236,96,3,93,145,2,143
461847,20,66,66,0,66,66,0,,,
461856,20,185,60,125,185,60,125,,,
461865,20,33,5,28,33,5,28,,,
461874,20,87,9,78,87,9,78,,,
461883,20,57,25,32,43,20,23,14,5,9
461892,20,110,11,99,110,11,99,,,
461908,20,107,2,105,106,1,105,1,1,0
461917,20,192,5,187,112,2,110,80,3,77
461926,20,156,2,154,119,2,117,37,0,37
461944,20,64,1,63,64,1,63,,,
461953,20,56,4,52,44,2,42,12,2,10
461962,20,197,134,63,166,104,62,31,30,1
461999,20,148,4,144,136,4,132,12,0,12
462008,20,293,25,268,185,20,165,108,5,103
462017,20,127,17,110,127,17,110,,,
462035,20,427,168,259,140,10,130,287,158,129
462053,20,91,7,84,91,7,84,,,
462062,20,114,3,111,67,2,65,47,1,46
462071,20,148,37,111,145,37,108,3,0,3
462336,20,87,3,84,86,3,83,1,0,1
462345,20,19,0,19,10,0,10,9,0,9
462354,20,292,147,145,266,126,140,26,21,5
463056,20,1548,747,801,1420,676,744,128,71,57
464226,20,830,515,315,745,451,294,85,64,21
466921,20,409,27,382,108,8,100,301,19,282
466930,20,1923,259,1664,496,68,428,1427,191,1236
467094,20,146,0,146,146,0,146,,,
467368,20,128,11,117,128,11,117,,,
467863,20,206,41,165,146,27,119,60,14,46
467872,20,233,4,229,175,3,172,58,1,57
467906,20,124,5,119,81,3,78,43,2,41
468246,20,139,7,132,139,7,132,,,
468255,20,25,2,23,25,2,23,,,
468291,20,75,5,70,75,5,70,,,
468769,20,132,124,8,132,124,8,,,
468848,20,840,385,455,840,385,455,,,
468893,20,126,4,122,116,4,112,10,0,10
468909,20,1048,417,631,1048,417,631,,,
468963,20,257,228,29,257,228,29,,,
469416,20,282,74,208,191,59,132,91,15,76
469610,20,27,5,22,27,5,22,,,
469629,20,143,124,19,143,124,19,,,
469911,20,54,3,51,54,3,51,,,
469957,20,121,11,110,121,11,110,,,
470038,20,1199,485,714,1199,485,714,,,
470047,20,41,7,34,41,7,34,,,
470296,20,19,0,19,19,0,19,,,
470393,20,123,8,115,51,5,46,72,3,69
474863,20,1738,325,1413,641,126,515,1097,199,898
474915,20,491,15,476,284,8,276,207,7,200
474924,20,203,2,201,47,0,47,156,2,154
475015,20,163,4,159,163,4,159,,,
475024,20,266,97,169,266,97,169,,,
475033,20,170,29,141,,,,170,29,141
475060,20,249,22,227,242,20,222,7,2,5
475121,20,4751,966,3785,2972,667,2305,1779,299,1480
475176,20,601,278,323,601,278,323,,,
475200,20,227,62,165,36,7,29,191,55,136
475273,20,355,59,296,66,11,55,289,48,241
475282,20,81,22,59,81,22,59,,,
475325,20,211,12,199,211,12,199,,,
475398,20,82,43,39,8,4,4,74,39,35
475404,20,119,1,118,78,1,77,41,0,41
475413,20,65,7,58,43,6,37,22,1,21
475422,20,106,6,100,33,1,32,73,5,68
475431,20,60,4,56,60,4,56,,,
475468,20,282,7,275,112,5,107,170,2,168
475477,20,183,54,129,29,7,22,154,47,107
475486,20,329,43,286,329,43,286,,,
475547,20,125,20,105,76,13,63,49,7,42
475556,20,164,6,158,102,3,99,62,3,59
475565,20,867,437,430,772,391,381,95,46,49
475574,20,43,16,27,19,6,13,24,10,14
475608,20,137,93,44,74,48,26,63,45,18
475635,20,20,3,17,4,0,4,16,3,13
475653,20,32,4,28,27,2,25,5,2,3
475662,20,41,1,40,18,1,17,23,0,23
475705,20,20,7,13,20,7,13,,,
475714,20,452,362,90,375,302,73,77,60,17
475723,20,492,310,182,131,61,70,361,249,112
475732,20,1372,134,1238,334,27,307,1038,107,931
475741,20,244,18,226,87,2,85,157,16,141
475839,20,263,115,148,116,55,61,147,60,87
476063,20,257,240,17,257,240,17,,,
476179,20,160,9,151,113,8,105,47,1,46
476230,20,33,2,31,33,2,31,,,
476294,20,150,15,135,41,3,38,109,12,97
476355,20,46,23,23,46,23,23,,,
476489,20,78,68,10,78,68,10,,,
476498,20,150,95,55,150,95,55,,,
476513,20,59,1,58,59,1,58,,,
476540,20,145,4,141,125,2,123,20,2,18
476559,20,152,2,150,146,1,145,6,1,5
476568,20,14,11,3,14,11,3,,,
476595,20,78,13,65,78,13,65,,,
476601,20,81,81,0,81,81,0,,,
476610,20,47,32,15,47,32,15,,,
476629,20,151,5,146,151,5,146,,,
476683,20,329,17,312,329,17,312,,,
476692,20,36,36,0,36,36,0,,,
476708,20,145,111,34,109,84,25,36,27,9
476717,20,576,576,0,576,576,0,,,
476726,20,610,105,505,610,105,505,,,
476735,20,48,23,25,14,9,5,34,14,20
476753,20,217,7,210,126,5,121,91,2,89
476780,20,61,7,54,42,6,36,19,1,18
476799,20,399,59,340,399,59,340,,,
476805,20,54,1,53,54,1,53,,,
476814,20,588,409,179,,,,588,409,179
476841,20,247,31,216,129,18,111,118,13,105
476850,20,61,42,19,61,42,19,,,
476869,20,119,6,113,119,6,113,,,
476878,20,69,0,69,12,0,12,57,0,57
476887,20,617,15,602,525,14,511,92,1,91
476896,20,76,3,73,76,3,73,,,
476902,20,88,2,86,57,1,56,31,1,30
476939,20,690,64,626,690,64,626,,,
476948,20,385,311,74,385,311,74,,,
476957,20,11,1,10,9,1,8,2,0,2
476966,20,139,122,17,139,122,17,,,
476975,20,6897,3175,3722,1767,826,941,5130,2349,2781
476984,20,185,7,178,136,6,130,49,1,48
476993,20,218,2,216,218,2,216,,,
477002,20,56,3,53,55,3,52,1,0,1
477039,20,1022,133,889,627,73,554,395,60,335
478582,20,153,4,149,112,3,109,41,1,40
478591,20,159,3,156,111,0,111,48,3,45
478616,20,114,10,104,83,7,76,31,3,28
478917,20,55,3,52,55,3,52,,,
478953,20,200,6,194,200,6,194,,,
479062,20,66,63,3,52,49,3,14,14,0
479424,20,309,40,269,309,40,269,,,
479965,20,195,51,144,195,51,144,,,
479974,20,108,27,81,104,27,77,4,0,4
479983,20,101,15,86,101,15,86,,,
479992,20,24,24,0,12,12,0,12,12,0
480000,20,54,35,19,54,35,19,,,
480019,20,800,732,68,720,659,61,80,73,7
480028,20,136,110,26,132,107,25,4,3,1
480037,20,1701,1341,360,1701,1341,360,,,
480073,20,335,67,268,233,42,191,102,25,77
480091,20,8749,1150,7599,5132,549,4583,3617,601,3016
480125,20,391,11,380,206,4,202,185,7,178
480161,20,11,0,11,11,0,11,,,
480198,20,251,70,181,161,47,114,90,23,67
480204,20,466,66,400,466,66,400,,,
480310,20,82,4,78,61,4,57,21,0,21
480347,20,36,3,33,36,3,33,,,
480471,20,686,193,493,686,193,493,,,
480523,20,112,3,109,112,3,109,,,
480532,20,28,1,27,28,1,27,,,
480550,20,51,2,49,51,2,49,,,
480569,20,938,389,549,562,220,342,376,169,207
480657,20,679,71,608,361,38,323,318,33,285
480693,20,62,20,42,59,19,40,3,1,2
480727,20,30,26,4,30,26,4,,,
480781,20,91,70,21,91,70,21,,,
480824,20,506,49,457,506,49,457,,,
480833,20,784,64,720,784,64,720,,,
480842,20,23,6,17,23,6,17,,,
480851,20,142,74,68,142,74,68,,,
480879,20,40,1,39,40,1,39,,,
480888,20,139,41,98,139,41,98,,,
480903,20,502,440,62,439,379,60,63,61,2
480912,20,7,2,5,7,2,5,,,
480921,20,84,66,18,84,66,18,,,
480930,20,117,6,111,83,5,78,34,1,33
480967,20,205,64,141,102,39,63,103,25,78
480976,20,59,3,56,59,3,56,,,
480985,20,252,1,251,252,1,251,,,
480994,20,100,3,97,74,3,71,26,0,26
481003,20,139,126,13,139,126,13,,,
481021,20,51,45,6,45,40,5,6,5,1
481049,20,26,3,23,26,3,23,,,
481058,20,68,25,43,42,15,27,26,10,16
481085,20,137,7,130,137,7,130,,,
481100,20,106,20,86,25,5,20,81,15,66
481128,20,115,9,106,96,6,90,19,3,16
481137,20,89,47,42,89,47,42,,,
481146,20,179,23,156,101,13,88,78,10,68
481155,20,218,87,131,218,87,131,,,
481182,20,36,4,32,36,4,32,,,
481191,20,206,16,190,206,16,190,,,
481207,20,125,34,91,125,34,91,,,
481225,20,17,10,7,15,10,5,2,0,2
481243,20,270,2,268,104,0,104,166,2,164
481252,20,60,8,52,60,8,52,,,
481289,20,76,17,59,76,17,59,,,
481298,20,44,4,40,44,4,40,,,
481313,20,80,1,79,49,1,48,31,0,31
481322,20,52,3,49,16,0,16,36,3,33
481331,20,93,77,16,91,75,16,2,2,0
481340,20,46,1,45,46,1,45,,,
481368,20,51,2,49,51,2,49,,,
481386,20,308,40,268,,,,308,40,268
481401,20,212,140,72,48,30,18,164,110,54
481410,20,77,77,0,77,77,0,,,
481429,20,158,13,145,158,13,145,,,
481438,20,69,69,0,69,69,0,,,
481447,20,31,3,28,18,2,16,13,1,12
481456,20,17,1,16,5,0,5,12,1,11
481465,20,52,1,51,47,1,46,5,0,5
481474,20,148,3,145,127,3,124,21,0,21
481483,20,164,4,160,98,2,96,66,2,64
481508,20,38,1,37,37,1,36,1,0,1
481517,20,90,5,85,50,4,46,40,1,39
481526,20,167,1,166,159,1,158,8,0,8
481571,20,3,0,3,3,0,3,,,
481678,20,68,2,66,43,0,43,25,2,23
481720,20,38,3,35,29,3,26,9,0,9
481739,20,69,7,62,44,6,38,25,1,24
481748,20,127,3,124,86,3,83,41,0,41
481775,20,198,57,141,198,57,141,,,
481845,20,78,4,74,54,3,51,24,1,23
481863,20,79,2,77,79,2,77,,,
481890,20,94,4,90,94,4,90,,,
481906,20,71,1,70,71,1,70,,,
481960,20,62,55,7,62,55,7,,,
482015,20,938,580,358,938,580,358,,,
482060,20,254,20,234,254,20,234,,,
482097,20,385,205,180,377,204,173,8,1,7
482149,20,5487,1874,3613,4346,1468,2878,1141,406,735
482158,20,7457,3240,4217,4347,2073,2274,3110,1167,1943
482167,20,202,4,198,77,4,73,125,0,125
482176,20,259,14,245,223,11,212,36,3,33
482185,20,89,66,23,89,66,23,,,
482194,20,103,21,82,85,18,67,18,3,15
482200,20,74,13,61,74,13,61,,,
482228,20,141,85,56,40,29,11,101,56,45
482246,20,20,16,4,20,16,4,,,
482255,20,286,253,33,230,206,24,56,47,9
482291,20,1204,512,692,1204,512,692,,,
482413,20,781,362,419,461,245,216,320,117,203
482422,20,103,69,34,44,25,19,59,44,15
482431,20,1462,870,592,828,502,326,634,368,266
482440,20,51,21,30,17,5,12,34,16,18
482459,20,460,223,237,202,85,117,258,138,120
482468,20,927,374,553,458,183,275,469,191,278
482477,20,19866,6843,13023,7870,2825,5045,11996,4018,7978
482538,20,23,19,4,11,8,3,12,11,1
482547,20,29,19,10,18,14,4,11,5,6
482556,20,116,67,49,65,33,32,51,34,17
482565,20,21,10,11,11,5,6,10,5,5
482574,20,387,177,210,186,94,92,201,83,118
482608,20,71,37,34,38,19,19,33,18,15
482617,20,16,6,10,11,4,7,5,2,3
482635,20,174,101,73,101,57,44,73,44,29
482653,20,88,45,43,45,25,20,43,20,23
482680,20,18143,7775,10368,12039,5296,6743,6104,2479,3625
482699,20,1771,596,1175,1013,396,617,758,200,558
482705,20,4795,2064,2731,3218,1331,1887,1577,733,844
482936,20,1478,1224,254,1292,1073,219,186,151,35
482963,20,341,30,311,341,30,311,,,
482981,20,169,137,32,140,110,30,29,27,2
482990,20,348,37,311,348,37,311,,,
483009,20,253,32,221,253,32,221,,,
483018,20,133,41,92,133,41,92,,,
483036,20,1774,726,1048,671,273,398,1103,453,650
483045,20,9614,3704,5910,1772,654,1118,7842,3050,4792
483054,20,98,77,21,98,77,21,,,
483106,20,184,32,152,136,22,114,48,10,38
483124,20,42709,15998,26711,16432,5422,11010,26277,10576,15701
483212,20,3956,1640,2316,1700,694,1006,2256,946,1310
483230,20,189,185,4,134,131,3,55,54,1
483258,20,28,23,5,28,23,5,,,
483276,20,59,52,7,59,52,7,,,
483328,20,126,12,114,79,10,69,47,2,45
483337,20,184,5,179,131,4,127,53,1,52
483346,20,53,3,50,53,3,50,,,
483355,20,147,6,141,147,6,141,,,
483364,20,112,5,107,112,5,107,,,
483373,20,113,15,98,59,10,49,54,5,49
483382,20,204,199,5,204,199,5,,,
483425,20,34,0,34,34,0,34,,,
483443,20,385,327,58,385,327,58,,,
483470,20,20,2,18,20,2,18,,,
483504,20,330,110,220,330,110,220,,,
483513,20,50,36,14,50,36,14,,,
483559,20,53,14,39,31,11,20,22,3,19
483577,20,33,1,32,16,0,16,17,1,16
483595,20,2961,716,2245,1640,397,1243,1321,319,1002
483647,20,34,2,32,34,2,32,,,
483708,20,279,52,227,87,9,78,192,43,149
483726,20,28,1,27,9,0,9,19,1,18
483735,20,67,4,63,37,3,34,30,1,29
483744,20,56,46,10,56,46,10,,,
483753,20,36,31,5,9,9,0,27,22,5
483780,20,95,66,29,80,57,23,15,9,6
483799,20,59,15,44,59,15,44,,,
483814,20,518,50,468,471,43,428,47,7,40
483823,20,675,502,173,675,502,173,,,
483841,20,25,4,21,25,4,21,,,
483850,20,7,1,6,7,1,6,,,
483869,20,81,23,58,81,23,58,,,
483878,20,198,24,174,198,24,174,,,
483887,20,49,11,38,49,11,38,,,
483896,20,244,8,236,43,0,43,201,8,193
483911,20,22,1,21,22,1,21,,,
483920,20,201,113,88,201,113,88,,,
483948,20,65,52,13,45,35,10,20,17,3
483957,20,55,14,41,55,14,41,,,
484002,20,1352,108,1244,1288,100,1188,64,8,56
484011,20,118,22,96,89,22,67,29,0,29
484020,20,53,41,12,31,25,6,22,16,6
484039,20,152,125,27,152,125,27,,,
484048,20,13,10,3,13,10,3,,,
484057,20,238,12,226,64,3,61,174,9,165
484066,20,218,16,202,218,16,202,,,
484075,20,44,35,9,30,23,7,14,12,2
484084,20,77,2,75,51,1,50,26,1,25
484093,20,152,4,148,106,2,104,46,2,44
484109,20,111,1,110,111,1,110,,,
484127,20,109,19,90,109,19,90,,,
484136,20,10,2,8,10,2,8,,,
484163,20,181,52,129,108,29,79,73,23,50
484172,20,16,2,14,16,2,14,,,
484190,20,32,24,8,32,24,8,,,
484206,20,237,7,230,116,5,111,121,2,119
484233,20,213,124,89,,,,213,124,89
484330,20,40,0,40,40,0,40,,,
484349,20,91,5,86,91,5,86,,,
484358,20,53,2,51,53,2,51,,,
484367,20,212,31,181,212,31,181,,,
484376,20,322,38,284,322,38,284,,,
484394,20,205,30,175,139,21,118,66,9,57
484473,20,5168,2389,2779,2454,1156,1298,2714,1233,1481
484604,20,476,9,467,251,4,247,225,5,220
484613,20,66597,19859,46738,66597,19859,46738,,,
484631,20,1158,744,414,1158,744,414,,,
484710,20,76,49,27,76,49,27,,,
484756,20,126,55,71,126,55,71,,,
484826,20,44,0,44,44,0,44,,,
484835,20,84,21,63,84,21,63,,,
484844,20,604,265,339,604,265,339,,,
484862,20,1,0,1,,,,1,0,1
484871,20,114,114,0,114,114,0,,,
484899,20,212,3,209,212,3,209,,,
484905,20,3368,1082,2286,1894,608,1286,1474,474,1000
484923,20,45,0,45,45,0,45,,,
484932,20,1573,637,936,973,363,610,600,274,326
484950,20,105,13,92,105,13,92,,,
484996,20,161,3,158,161,3,158,,,
485014,20,85,2,83,60,1,59,25,1,24
485032,20,206,9,197,124,7,117,82,2,80
485111,20,7014,2632,4382,2743,1197,1546,4271,1435,2836
485139,20,262,217,45,262,217,45,,,
485166,20,122,19,103,122,19,103,,,
485236,20,99,2,97,31,1,30,68,1,67
485272,20,1123,148,975,565,88,477,558,60,498
485306,20,16,0,16,16,0,16,,,
485342,20,345,183,162,171,118,53,174,65,109
485360,20,22,2,20,22,2,20,,,
485379,20,278,56,222,278,56,222,,,
485388,20,355,46,309,355,46,309,,,
485397,20,142,9,133,112,9,103,30,0,30
485412,20,96,14,82,96,14,82,,,
485458,20,4021,1466,2555,688,225,463,3333,1241,2092
485476,20,82,3,79,82,3,79,,,
485485,20,147,18,129,147,18,129,,,
485494,20,90,74,16,90,74,16,,,
485500,20,253,238,15,16,16,0,237,222,15
485519,20,390,274,116,190,133,57,200,141,59
485546,20,133,63,70,2,1,1,131,62,69
485564,20,316,34,282,311,34,277,5,0,5
485573,20,202,33,169,186,32,154,16,1,15
485591,20,40,0,40,40,0,40,,,
485607,20,32,3,29,23,2,21,9,1,8
485698,20,121,106,15,118,103,15,3,3,0
485704,20,5,0,5,2,0,2,3,0,3
485768,20,375,258,117,375,258,117,,,
485801,20,84,12,72,84,12,72,,,
485856,20,41,13,28,15,6,9,26,7,19
485874,20,167,6,161,99,4,95,68,2,66
485926,20,216,63,153,210,62,148,6,1,5
485953,20,59,51,8,59,51,8,,,
485962,20,37,25,12,18,12,6,19,13,6
485999,20,96,96,0,96,96,0,,,
486017,20,32,32,0,32,32,0,,,
486026,20,111,111,0,111,111,0,,,
486053,20,123,74,49,96,60,36,27,14,13
486105,20,7,0,7,7,0,7,,,
486123,20,26,10,16,26,10,16,,,
486141,20,12,0,12,12,0,12,,,
486150,20,145,52,93,96,40,56,49,12,37
486169,20,65,50,15,65,50,15,,,
486196,20,184,184,0,184,184,0,,,
486202,20,30,3,27,30,3,27,,,
486239,20,124,46,78,106,39,67,18,7,11
486248,20,118,35,83,118,35,83,,,
486257,20,308,127,181,215,90,125,93,37,56
486284,20,284,77,207,274,74,200,10,3,7
486309,20,4,1,3,4,1,3,,,
486345,20,175,173,2,77,76,1,98,97,1
486354,20,45,14,31,45,14,31,,,
486372,20,107,83,24,73,62,11,34,21,13
486381,20,208,23,185,208,23,185,,,
486390,20,89,45,44,89,45,44,,,
486406,20,17,4,13,17,4,13,,,
486415,20,261,64,197,261,64,197,,,
486424,20,142,4,138,131,1,130,11,3,8
486442,20,48,1,47,48,1,47,,,
486488,20,23,18,5,20,16,4,3,2,1
486497,20,42,40,2,40,38,2,2,2,0
486503,20,53,0,53,53,0,53,,,
486512,20,304,155,149,304,155,149,,,
486530,20,158,1,157,158,1,157,,,
486558,20,265,240,25,200,181,19,65,59,6
486567,20,232,13,219,228,12,216,4,1,3
486576,20,126,30,96,126,30,96,,,
486594,20,33,14,19,13,5,8,20,9,11
486619,20,135,5,130,103,5,98,32,0,32
486691,20,97,2,95,64,1,63,33,1,32
486707,20,84,2,82,84,2,82,,,
486716,20,92,2,90,92,2,90,,,
486752,20,96,4,92,96,4,92,,,
486770,20,123,30,93,123,30,93,,,
486798,20,1273,1154,119,1273,1154,119,,,
486813,20,542,111,431,542,111,431,,,
486822,20,821,101,720,821,101,720,,,
486840,20,38891,19295,19596,28629,14065,14564,10262,5230,5032
486859,20,33,0,33,33,0,33,,,
486868,20,8,0,8,8,0,8,,,
486877,20,8,0,8,8,0,8,,,
486886,20,30,0,30,15,0,15,15,0,15
486901,20,789,390,399,741,369,372,48,21,27
486938,20,543,95,448,246,35,211,297,60,237
486947,20,549,68,481,242,30,212,307,38,269
486956,20,1219,167,1052,543,72,471,676,95,581
486965,20,231,85,146,231,85,146,,,
486983,20,61,16,45,61,16,45,,,
487010,20,264,23,241,248,20,228,16,3,13
487047,20,56,2,54,56,2,54,,,
487065,20,77,6,71,77,6,71,,,
487083,20,29,0,29,29,0,29,,,
487092,20,1067,500,567,1066,499,567,1,1,0
487162,20,4246,1364,2882,1138,350,788,3108,1014,2094
487232,20,119,0,119,119,0,119,,,
487302,20,561,118,443,560,118,442,1,0,1
487311,20,348,325,23,348,325,23,,,
487320,20,10107,7139,2968,5226,4119,1107,4881,3020,1861
487348,20,111,4,107,47,3,44,64,1,63
487375,20,938,118,820,604,74,530,334,44,290
487384,20,608,195,413,608,195,413,,,
487393,20,722,308,414,722,308,414,,,
487409,20,668,258,410,668,258,410,,,
487418,20,814,311,503,814,311,503,,,
487427,20,571,198,373,571,198,373,,,
487436,20,575,107,468,575,107,468,,,
487445,20,587,214,373,587,214,373,,,
487454,20,619,208,411,619,208,411,,,
487472,20,659,245,414,659,245,414,,,
487481,20,1441,311,1130,1441,311,1130,,,
487490,20,1109,216,893,1109,216,893,,,
487506,20,85,2,83,27,0,27,58,2,56
487524,20,2588,1028,1560,2208,896,1312,380,132,248
487533,20,121,1,120,44,1,43,77,0,77
487588,20,362,27,335,362,27,335,,,
487597,20,1340,1286,54,1340,1286,54,,,
487603,20,1136,502,634,378,155,223,758,347,411
487621,20,18,16,2,17,15,2,1,1,0
487658,20,90,67,23,90,67,23,,,
487676,20,197,12,185,160,8,152,37,4,33
487746,20,28,28,0,28,28,0,,,
487773,20,44,6,38,32,3,29,12,3,9
487791,20,505,463,42,298,275,23,207,188,19
487807,20,56,34,22,35,23,12,21,11,10
487816,20,16,0,16,16,0,16,,,
487852,20,13,4,9,,,,13,4,9
487861,20,329,38,291,248,30,218,81,8,73
487889,20,65,5,60,65,5,60,,,
487898,20,16,13,3,12,11,1,4,2,2
487904,20,25,19,6,25,19,6,,,
487922,20,65,0,65,48,0,48,17,0,17
487959,20,48,0,48,24,0,24,24,0,24
487968,20,55,3,52,55,3,52,,,
487977,20,2061,166,1895,1665,42,1623,396,124,272
487995,20,48,9,39,20,4,16,28,5,23
488004,20,20,20,0,20,20,0,,,
488013,20,83,2,81,83,2,81,,,
488022,20,72,40,32,44,23,21,28,17,11
488031,20,63,28,35,61,27,34,2,1,1
488059,20,175,61,114,175,61,114,,,
488068,20,74,11,63,18,5,13,56,6,50
488077,20,3009,2939,70,2196,2144,52,813,795,18
488101,20,113,113,0,113,113,0,,,
488110,20,39,0,39,29,0,29,10,0,10
488129,20,25,0,25,,,,25,0,25
488138,20,41,2,39,41,2,39,,,
488147,20,71,1,70,71,1,70,,,
488174,20,28,15,13,22,12,10,6,3,3
488183,20,19,2,17,19,2,17,,,
488192,20,75,74,1,,,,75,74,1
488217,20,175,5,170,175,5,170,,,
488226,20,19,9,10,19,9,10,,,
488253,20,83,58,25,55,35,20,28,23,5
488262,20,25,16,9,19,15,4,6,1,5
488271,20,95,3,92,95,3,92,,,
488280,20,34,23,11,34,23,11,,,
488299,20,74,34,40,21,7,14,53,27,26
488305,20,112,67,45,86,48,38,26,19,7
488314,20,54,54,0,54,54,0,,,
488332,20,197,27,170,197,27,170,,,
488350,20,99,99,0,99,99,0,,,
488369,20,51,43,8,51,43,8,,,
488378,20,83,3,80,82,3,79,1,0,1
488396,20,37,30,7,6,5,1,31,25,6
488411,20,124,1,123,124,1,123,,,
488420,20,145,13,132,,,,145,13,132
488439,20,104,81,23,58,44,14,46,37,9
488448,20,86,56,30,81,53,28,5,3,2
488563,20,10,8,2,10,8,2,,,
488590,20,13,4,9,13,4,9,,,
488651,20,181,20,161,109,14,95,72,6,66
488679,20,5701,1463,4238,5346,1364,3982,355,99,256
488730,20,6704,2770,3934,1121,520,601,5583,2250,3333
488749,20,131,19,112,119,16,103,12,3,9
488776,20,124,53,71,78,30,48,46,23,23
488785,20,245,128,117,231,120,111,14,8,6
488800,20,694,213,481,694,213,481,,,
488828,20,11,5,6,11,5,6,,,
488837,20,170,143,27,170,143,27,,,
488846,20,28597,16895,11702,9369,5479,3890,19228,11416,7812
488891,20,293,95,198,293,95,198,,,
488916,20,30,0,30,30,0,30,,,
488934,20,3980,2163,1817,663,364,299,3317,1799,1518
488952,20,60,3,57,60,3,57,,,
488961,20,58,2,56,58,2,56,,,
488970,20,63,1,62,63,1,62,,,
488989,20,160,10,150,112,7,105,48,3,45
488998,20,123,22,101,121,22,99,2,0,2
489122,20,28,4,24,14,0,14,14,4,10
489131,20,45,10,35,29,6,23,16,4,12
489140,20,63,12,51,32,5,27,31,7,24
489159,20,170,1,169,97,0,97,73,1,72
489201,20,7768,3104,4664,2061,948,1113,5707,2156,3551
489238,20,131,12,119,84,6,78,47,6,41
489247,20,55,9,46,21,4,17,34,5,29
489256,20,217,198,19,215,196,19,2,2,0
489283,20,609,89,520,609,89,520,,,
489344,20,251,22,229,90,8,82,161,14,147
489353,20,437,95,342,267,59,208,170,36,134
489371,20,199,178,21,199,178,21,,,
489779,20,32477,12875,19602,4865,1674,3191,27612,11201,16411
489812,20,50,0,50,50,0,50,,,
489830,20,67,2,65,67,2,65,,,
489937,20,477,236,241,380,204,176,97,32,65
490018,20,18,9,9,18,9,9,,,
490045,20,41,13,28,21,6,15,20,7,13
490054,20,238,85,153,151,66,85,87,19,68
490063,20,88,39,49,88,39,49,,,
490081,20,43,19,24,40,19,21,3,0,3
490090,20,49,26,23,8,4,4,41,22,19
490115,20,38,26,12,38,26,12,,,
490124,20,8,4,4,8,4,4,,,
490133,20,1300,798,502,1272,778,494,28,20,8
490142,20,28,3,25,14,3,11,14,0,14
490151,20,89,6,83,55,3,52,34,3,31
490160,20,101,16,85,101,16,85,,,
490197,20,48,9,39,48,9,39,,,
490203,20,129,6,123,54,2,52,75,4,71
490212,20,21,1,20,21,1,20,,,
490221,20,26,4,22,13,2,11,13,2,11
490230,20,235,107,128,232,105,127,3,2,1
490249,20,25,24,1,25,24,1,,,
490258,20,120,26,94,120,26,94,,,
490267,20,9,5,4,3,3,0,6,2,4
490276,20,119,119,0,119,119,0,,,
490285,20,618,490,128,618,490,128,,,
490294,20,152,48,104,132,38,94,20,10,10
490300,20,86,21,65,39,4,35,47,17,30
490319,20,18,18,0,18,18,0,,,
490328,20,67,67,0,67,67,0,,,
490337,20,106,28,78,43,14,29,63,14,49
490346,20,57,0,57,57,0,57,,,
490382,20,38,13,25,38,13,25,,,
490391,20,68,3,65,68,3,65,,,
490407,20,125,0,125,63,0,63,62,0,62
490416,20,20,18,2,20,18,2,,,
490425,20,185,1,184,185,1,184,,,
490434,20,37,0,37,37,0,37,,,
490443,20,107,0,107,107,0,107,,,
490452,20,58,13,45,19,3,16,39,10,29
490461,20,104,3,101,104,3,101,,,
490470,20,26,4,22,26,4,22,,,
490489,20,45,36,9,41,33,8,4,3,1
490498,20,34,26,8,34,26,8,,,
490504,20,46,46,0,46,46,0,,,
490513,20,37,37,0,35,35,0,2,2,0
490522,20,29,0,29,28,0,28,1,0,1
490531,20,32,25,7,15,13,2,17,12,5
490540,20,23,1,22,19,1,18,4,0,4
490559,20,455,23,432,455,23,432,,,
490674,20,5,0,5,5,0,5,,,
490692,20,55,47,8,55,47,8,,,
490717,20,80,5,75,80,5,75,,,
490735,20,144,20,124,144,20,124,,,
490744,20,25,20,5,25,20,5,,,
490753,20,2,0,2,2,0,2,,,
490805,20,8044,3350,4694,4687,2199,2488,3357,1151,2206
490814,20,91,9,82,91,9,82,,,
490832,20,293,19,274,237,16,221,56,3,53
490841,20,263,8,255,263,8,255,,,
490869,20,411,44,367,411,44,367,,,
490878,20,430,91,339,430,91,339,,,
490896,20,159,8,151,97,6,91,62,2,60
490948,20,10,7,3,10,7,3,,,
490975,20,379,46,333,350,41,309,29,5,24
491057,20,208,208,0,208,208,0,,,
491066,20,70,0,70,32,0,32,38,0,38
491075,20,15,14,1,15,14,1,,,
491084,20,59,0,59,59,0,59,,,
491136,20,70,5,65,40,4,36,30,1,29
491145,20,102,3,99,75,2,73,27,1,26
491181,20,525,77,448,311,41,270,214,36,178
491190,20,2,2,0,2,2,0,,,
491215,20,52,50,2,52,50,2,,,
491224,20,96,8,88,66,5,61,30,3,27
491233,20,32,0,32,19,0,19,13,0,13
491242,20,61,29,32,61,29,32,,,
491251,20,103,50,53,103,50,53,,,
491260,20,41,0,41,17,0,17,24,0,24
491288,20,630,190,440,59,15,44,571,175,396
491297,20,131,54,77,7,3,4,124,51,73
491394,20,90,84,6,90,84,6,,,
491446,20,161,0,161,161,0,161,,,
491464,20,125,22,103,125,22,103,,,
491473,20,526,387,139,32,2,30,494,385,109
491507,20,66,7,59,66,7,59,,,
491525,20,77,50,27,56,37,19,21,13,8
491534,20,17,1,16,,,,17,1,16
491543,20,104,16,88,69,13,56,35,3,32
491552,20,22,0,22,22,0,22,,,
491570,20,32,0,32,32,0,32,,,
491589,20,31,23,8,6,4,2,25,19,6
491598,20,33,6,27,33,6,27,,,
491613,20,74,74,0,74,74,0,,,
491622,20,85,85,0,85,85,0,,,
491631,20,189,0,189,113,0,113,76,0,76
491640,20,169,169,0,169,169,0,,,
491659,20,81,37,44,81,37,44,,,
491668,20,164,2,162,164,2,162,,,
491677,20,34,21,13,22,14,8,12,7,5
491686,20,37,34,3,37,34,3,,,
491695,20,48,12,36,48,12,36,,,
491701,20,56,11,45,,,,56,11,45
491710,20,63,63,0,63,63,0,,,
491729,20,26,0,26,26,0,26,,,
491738,20,56,9,47,49,5,44,7,4,3
491747,20,19,8,11,19,8,11,,,
491756,20,101,86,15,101,86,15,,,
491765,20,98,98,0,98,98,0,,,
491774,20,137,18,119,91,11,80,46,7,39
491783,20,68,51,17,29,14,15,39,37,2
491792,20,108,3,105,108,3,105,,,
491817,20,225,0,225,167,0,167,58,0,58
491826,20,92,0,92,92,0,92,,,
491835,20,90,1,89,90,1,89,,,
491844,20,152,50,102,86,34,52,66,16,50
491853,20,47,0,47,47,0,47,,,
491871,20,17,0,17,9,0,9,8,0,8
491880,20,95,92,3,95,92,3,,,
491899,20,92,7,85,11,1,10,81,6,75
491905,20,118,3,115,118,3,115,,,
491914,20,167,167,0,167,167,0,,,
491923,20,289,3,286,284,2,282,5,1,4
491932,20,33,32,1,33,32,1,,,
491941,20,130,6,124,130,6,124,,,
491950,20,879,128,751,46,8,38,833,120,713
491969,20,21,3,18,21,3,18,,,
491978,20,45,17,28,11,5,6,34,12,22
491996,20,45,3,42,45,3,42,,,
492005,20,70,0,70,55,0,55,15,0,15
492032,20,32,0,32,,,,32,0,32
492069,20,95,58,37,84,54,30,11,4,7
492078,20,127,124,3,,,,127,124,3
492096,20,9,1,8,9,1,8,,,
492139,20,131,109,22,131,109,22,,,
492157,20,94,83,11,94,83,11,,,
492281,20,26,22,4,26,22,4,,,
492306,20,122,58,64,,,,122,58,64
492315,20,111,28,83,,,,111,28,83
492324,20,212,22,190,,,,212,22,190
492360,20,47,10,37,23,3,20,24,7,17
492379,20,16,15,1,16,15,1,,,
492421,20,13,13,0,13,13,0,,,
492449,20,537,102,435,537,102,435,,,
492476,20,168,42,126,36,12,24,132,30,102
492591,20,91,70,21,91,70,21,,,
492643,20,89,26,63,89,26,63,,,
492652,20,43,32,11,43,32,11,,,
492661,20,282,46,236,280,46,234,2,0,2
492689,20,267,48,219,202,39,163,65,9,56
492722,20,409,40,369,409,40,369,,,
492731,20,127,26,101,127,26,101,,,
492759,20,314,22,292,139,11,128,175,11,164
492801,20,847,308,539,447,162,285,400,146,254
492935,20,134,13,121,134,13,121,,,
492953,20,90,6,84,55,6,49,35,0,35
492962,20,3114,1134,1980,1333,460,873,1781,674,1107
493071,20,454,111,343,454,111,343,,,
493080,20,351,173,178,21,8,13,330,165,165
493132,20,1067,1033,34,1067,1033,34,,,
493150,20,148,12,136,148,12,136,,,
493372,20,16,2,14,16,2,14,,,
493451,20,76,14,62,76,14,62,,,
493479,20,10,5,5,10,5,5,,,
493488,20,17,2,15,17,2,15,,,
493503,20,25,14,11,25,14,11,,,
493512,20,151,93,58,151,93,58,,,
493521,20,46,34,12,45,33,12,1,1,0
493530,20,48,18,30,30,13,17,18,5,13
493549,20,137,128,9,137,128,9,,,
493558,20,17,17,0,17,17,0,,,
493567,20,85,3,82,,,,85,3,82
493576,20,12,0,12,12,0,12,,,
493585,20,44,5,39,44,5,39,,,
493594,20,36,36,0,36,36,0,,,
493600,20,176,176,0,176,176,0,,,
493619,20,31,13,18,20,12,8,11,1,10
493628,20,149,13,136,84,8,76,65,5,60
493637,20,61,1,60,61,1,60,,,
493646,20,229,0,229,229,0,229,,,
493655,20,17,11,6,17,11,6,,,
493664,20,63,63,0,62,62,0,1,1,0
493682,20,97,5,92,83,4,79,14,1,13
493691,20,38,1,37,29,1,28,9,0,9
493707,20,90,90,0,90,90,0,,,
493716,20,68,68,0,68,68,0,,,
493725,20,668,230,438,431,139,292,237,91,146
493734,20,10,8,2,10,8,2,,,
493743,20,210,153,57,122,93,29,88,60,28
493752,20,15,1,14,15,1,14,,,
493761,20,108,34,74,19,11,8,89,23,66
493770,20,24,1,23,24,1,23,,,
493789,20,136,0,136,57,0,57,79,0,79
493798,20,107,0,107,100,0,100,7,0,7
493804,20,84,69,15,84,69,15,,,
493813,20,121,7,114,121,7,114,,,
493822,20,193,46,147,124,28,96,69,18,51
493831,20,37,25,12,37,25,12,,,
493868,20,12,9,3,8,6,2,4,3,1
493895,20,147,130,17,38,35,3,109,95,14
493910,20,6,0,6,2,0,2,4,0,4
493992,20,247,78,169,247,78,169,,,
494001,20,86,5,81,17,2,15,69,3,66
494029,20,21,16,5,11,10,1,10,6,4
494162,20,225,16,209,112,6,106,113,10,103
494232,20,29,0,29,26,0,26,3,0,3
494250,20,351,26,325,351,26,325,,,
494269,20,33,29,4,5,4,1,28,25,3
494278,20,253,60,193,75,16,59,178,44,134
494287,20,311,96,215,96,26,70,215,70,145
494357,20,947,336,611,947,336,611,,,
494436,20,303,65,238,303,65,238,,,
494463,20,330,0,330,330,0,330,,,
494472,20,11,0,11,7,0,7,4,0,4
494524,20,96,4,92,89,1,88,7,3,4
494588,20,303,27,276,303,27,276,,,
494597,20,80,34,46,71,30,41,9,4,5
494603,20,258,149,109,171,99,72,87,50,37
494621,20,89,11,78,,,,89,11,78
494630,20,44,24,20,37,21,16,7,3,4
494649,20,28,0,28,17,0,17,11,0,11
494658,20,35,1,34,28,1,27,7,0,7
494685,20,445,184,261,374,149,225,71,35,36
494694,20,70,1,69,64,1,63,6,0,6
494700,20,59,1,58,57,1,56,2,0,2
494719,20,35,29,6,22,16,6,13,13,0
494728,20,49,38,11,46,36,10,3,2,1
494737,20,169,169,0,169,169,0,,,
494746,20,167,24,143,167,24,143,,,
494755,20,65,4,61,65,4,61,,,
494764,20,180,166,14,150,140,10,30,26,4
494807,20,47,6,41,47,6,41,,,
494843,20,603,41,562,603,41,562,,,
494852,20,497,112,385,497,112,385,,,
494898,20,82,13,69,82,13,69,,,
494904,20,131,55,76,52,25,27,79,30,49
494959,20,76,22,54,10,5,5,66,17,49
494977,20,49,5,44,49,5,44,,,
494986,20,42,2,40,29,2,27,13,0,13
494995,20,46,42,4,46,42,4,,,
495013,20,247,220,27,,,,247,220,27
495031,20,62,62,0,59,59,0,3,3,0
495040,20,50,2,48,50,2,48,,,
495059,20,50,23,27,49,23,26,1,0,1
495077,20,25,2,23,25,2,23,,,
495101,20,53,6,47,53,6,47,,,
495110,20,17,14,3,17,14,3,,,
495129,20,127,107,20,127,107,20,,,
495138,20,6,3,3,6,3,3,,,
495147,20,21,9,12,11,7,4,10,2,8
495165,20,29,5,24,29,5,24,,,
495174,20,26,8,18,,,,26,8,18
495183,20,187,82,105,187,82,105,,,
495208,20,19,14,5,19,14,5,,,
495217,20,10,8,2,10,8,2,,,
495226,20,4,0,4,4,0,4,,,
495235,20,17,2,15,10,1,9,7,1,6
495244,20,23,1,22,11,1,10,12,0,12
495253,20,47,10,37,45,10,35,2,0,2
495262,20,37,0,37,21,0,21,16,0,16
495271,20,27,7,20,,,,27,7,20
495280,20,25,14,11,12,6,6,13,8,5
495299,20,39,8,31,39,8,31,,,
495305,20,94,22,72,43,9,34,51,13,38
495341,20,48,35,13,47,34,13,1,1,0
495350,20,32,18,14,32,18,14,,,
495369,20,72,13,59,48,11,37,24,2,22
495378,20,91,5,86,11,0,11,80,5,75
495387,20,41,29,12,15,12,3,26,17,9
495396,20,27,1,26,27,1,26,,,
495411,20,116,7,109,112,5,107,4,2,2
495420,20,225,21,204,114,13,101,111,8,103
495439,20,237,18,219,112,9,103,125,9,116
495448,20,494,57,437,278,30,248,216,27,189
495457,20,418,39,379,257,23,234,161,16,145
495518,20,72,3,69,42,1,41,30,2,28
495730,20,77,0,77,62,0,62,15,0,15
495767,20,73476,39482,33994,64631,34802,29829,8845,4680,4165
495776,20,39,35,4,39,35,4,,,
495794,20,235,5,230,179,2,177,56,3,53
495837,20,121,6,115,121,6,115,,,
495916,20,9,2,7,6,1,5,3,1,2
495925,20,65,2,63,65,2,63,,,
495934,20,85,5,80,85,5,80,,,
495943,20,35,3,32,35,3,32,,,
495952,20,143,35,108,143,35,108,,,
495961,20,124,15,109,124,15,109,,,
495970,20,302,97,205,302,97,205,,,
495998,20,67,6,61,67,6,61,,,
496052,20,18,11,7,18,11,7,,,
496061,20,91,0,91,36,0,36,55,0,55
496186,20,121,112,9,121,112,9,,,
496265,20,57,47,10,57,47,10,,,
496283,20,105,11,94,105,11,94,,,
496292,20,6,6,0,6,6,0,,,
496326,20,148,15,133,148,15,133,,,
496371,20,10,10,0,10,10,0,,,
496399,20,22,5,17,22,5,17,,,
496478,20,80,59,21,,,,80,59,21
496511,20,17,0,17,15,0,15,2,0,2
496520,20,38,9,29,,,,38,9,29
496539,20,63,1,62,43,1,42,20,0,20
496593,20,243,138,105,243,138,105,,,
496618,20,76,4,72,76,4,72,,,
496627,20,191,91,100,191,91,100,,,
496636,20,143,22,121,143,22,121,,,
496645,20,278,175,103,37,2,35,241,173,68
496654,20,46,10,36,,,,46,10,36
496663,20,29,21,8,27,19,8,2,2,0
496672,20,35,4,31,21,4,17,14,0,14
496681,20,239,6,233,239,6,233,,,
496690,20,42,6,36,30,3,27,12,3,9
496706,20,105,64,41,105,64,41,,,
496715,20,65,21,44,57,19,38,8,2,6
496724,20,33,0,33,33,0,33,,,
496733,20,70,0,70,70,0,70,,,
496742,20,5,0,5,5,0,5,,,
496751,20,65,6,59,65,6,59,,,
496894,20,13,0,13,11,0,11,2,0,2
496919,20,955,351,604,955,351,604,,,
496955,20,361,144,217,361,144,217,,,
496964,20,18,10,8,18,10,8,,,
496973,20,68,5,63,34,2,32,34,3,31
496991,20,219,28,191,103,17,86,116,11,105
497000,20,252,56,196,252,56,196,,,
497037,20,422,75,347,314,57,257,108,18,90
497046,20,4735,1482,3253,627,213,414,4108,1269,2839
497073,20,395,8,387,225,4,221,170,4,166
497116,20,68,8,60,31,5,26,37,3,34
497161,20,66,62,4,54,50,4,12,12,0
497189,20,12,0,12,12,0,12,,,
497198,20,76,1,75,50,1,49,26,0,26
497204,20,47,43,4,16,15,1,31,28,3
497213,20,25,10,15,14,6,8,11,4,7
497222,20,23,0,23,13,0,13,10,0,10
497268,20,186,21,165,107,12,95,79,9,70
497277,20,504,56,448,504,56,448,,,
497301,20,170,5,165,112,5,107,58,0,58
497310,20,97,0,97,97,0,97,,,
497329,20,83,14,69,83,14,69,,,
497338,20,36,4,32,36,4,32,,,
100654,30,5098,2070,3028,4529,1823,2706,569,247,322
100663,30,13284,5035,8249,10366,3924,6442,2918,1111,1807
100690,30,251,79,172,136,45,91,115,34,81
100706,30,7358,4380,2978,6217,3726,2491,1141,654,487
100724,30,3495,1225,2270,3055,1053,2002,440,172,268
100751,30,30725,13474,17251,28074,12366,15708,2651,1108,1543
100760,30,940,368,572,490,233,257,450,135,315
100812,30,2511,741,1770,1136,343,793,1375,398,977
100830,30,3742,1240,2502,2912,979,1933,830,261,569
100858,30,24782,12507,12275,22674,11290,11384,2108,1217,891
100937,30,1048,513,535,1039,504,535,9,9,0
101028,30,1107,377,730,470,180,290,637,197,440
101116,30,337,52,285,217,36,181,120,16,104
101143,30,1336,705,631,877,477,400,459,228,231
101161,30,5217,1874,3343,2797,1110,1687,2420,764,1656
101189,30,1695,719,976,1295,574,721,400,145,255
101240,30,3513,1316,2197,1834,832,1002,1679,484,1195
101277,30,57,2,55,57,2,55,,,
101286,30,3191,950,2241,1292,422,870,1899,528,1371
101295,30,4303,1391,2912,2292,869,1423,2011,522,1489
101301,30,942,313,629,478,236,242,464,77,387
101365,30,608,142,466,273,80,193,335,62,273
101435,30,838,462,376,792,451,341,46,11,35
101453,30,72,64,8,33,29,4,39,35,4
101462,30,688,288,400,250,114,136,438,174,264
101471,30,400,303,97,291,213,78,109,90,19
101480,30,6992,2743,4249,6111,2395,3716,881,348,533
101505,30,6143,2187,3956,2221,876,1345,3922,1311,2611
101514,30,6795,2936,3859,2479,1144,1335,4316,1792,2524
101569,30,2779,940,1839,1211,454,757,1568,486,1082
101587,30,2310,703,1607,1754,508,1246,556,195,361
101602,30,1129,394,735,750,294,456,379,100,279
101648,30,314,232,82,314,232,82,,,
101675,30,1517,707,810,1421,651,770,96,56,40
101693,30,1112,382,730,1045,362,683,67,20,47
101709,30,2184,788,1396,1960,710,1250,224,78,146
101736,30,2095,777,1318,893,404,489,1202,373,829
101879,30,5165,1878,3287,4480,1607,2873,685,271,414
101897,30,1565,512,1053,834,295,539,731,217,514
101912,30,1353,587,766,1255,543,712,98,44,54
101994,30,254,89,165,142,74,68,112,15,97
102030,30,1885,613,1272,886,373,513,999,240,759
102049,30,3604,1200,2404,3549,1185,2364,55,15,40
102058,30,22,16,6,9,6,3,13,10,3
102067,30,4018,1554,2464,1655,766,889,2363,788,1575
102076,30,1537,572,965,975,384,591,562,188,374
102094,30,8631,3341,5290,7389,2785,4604,1242,556,686
102234,30,989,410,579,948,393,555,41,17,24
102270,30,721,313,408,636,261,375,85,52,33
102298,30,1144,564,580,1004,502,502,140,62,78
102313,30,1522,602,920,734,344,390,788,258,530
102368,30,10916,3820,7096,7401,2625,4776,3515,1195,2320
102377,30,2184,816,1368,2068,770,1298,116,46,70
102395,30,68,50,18,14,11,3,54,39,15
102429,30,2291,844,1447,1046,448,598,1245,396,849
102553,30,7284,2868,4416,3704,1653,2051,3580,1215,2365
102580,30,37,25,12,24,19,5,13,6,7
102614,30,4108,1681,2427,2264,1101,1163,1844,580,1264
102632,30,999,318,681,452,176,276,547,142,405
102669,30,347,77,270,283,66,217,64,11,53
102711,30,259,193,66,83,63,20,176,130,46
102845,30,2215,570,1645,2215,570,1645,,,
103501,30,317,42,275,317,42,275,,,
103741,30,138,5,133,112,5,107,26,0,26
103893,30,1281,262,1019,1281,262,1019,,,
103909,30,591,66,525,591,66,525,,,
103927,30,517,80,437,517,80,437,,,
103954,30,48,3,45,48,3,45,,,
103963,30,398,359,39,397,359,38,1,0,1
104090,30,1000,123,877,1000,123,877,,,
104151,30,64216,32311,31905,58993,29322,29671,5223,2989,2234
104160,30,7388,3043,4345,1953,855,1098,5435,2188,3247
104179,30,36560,16080,20480,29440,12749,16691,7120,3331,3789
104346,30,4388,1618,2770,1028,457,571,3360,1161,2199
104391,30,56,3,53,56,3,53,,,
104425,30,2922,1221,1701,1345,515,830,1577,706,871
104443,30,43,2,41,33,2,31,10,0,10
104568,30,377,11,366,213,6,207,164,5,159
104577,30,3187,1298,1889,1164,526,638,2023,772,1251
104586,30,3015,2211,804,2891,2110,781,124,101,23
104708,30,10528,4613,5915,3462,1681,1781,7066,2932,4134
104717,30,64210,18769,45441,22290,8681,13609,41920,10088,31832
105145,30,3691,1218,2473,939,362,577,2752,856,1896
105154,30,12167,5588,6579,3985,1926,2059,8182,3662,4520
105206,30,2622,795,1827,587,244,343,2035,551,1484
105215,30,781,728,53,781,728,53,,,
105297,30,1224,288,936,652,161,491,572,127,445
105330,30,23772,8668,15104,19918,7314,12604,3854,1354,2500
105349,30,1124,348,776,220,83,137,904,265,639
105367,30,348,85,263,158,30,128,190,55,135
105428,30,6674,2265,4409,1958,740,1218,4716,1525,3191
105525,30,13128,5394,7734,2958,1362,1596,10170,4032,6138
105534,30,2485,448,2037,2485,448,2037,,,
105543,30,782,126,656,782,126,656,,,
105589,30,383,132,251,309,114,195,74,18,56
105659,30,1007,934,73,1007,934,73,,,
105668,30,3824,1367,2457,743,305,438,3081,1062,2019
105677,30,12,12,0,12,12,0,,,
105747,30,4764,2032,2732,1520,724,796,3244,1308,1936
105792,30,2395,975,1420,851,379,472,1544,596,948
105899,30,1012,620,392,876,555,321,136,65,71
106041,30,1986,1898,88,1986,1898,88,,,
106111,30,48,1,47,27,1,26,21,0,21
106148,30,4004,1596,2408,1266,601,665,2738,995,1743
106245,30,5025,1801,3224,2945,1175,1770,2080,626,1454
106263,30,1072,156,916,729,111,618,343,45,298
106306,30,414,324,90,344,267,77,70,57,13
106315,30,28,2,26,28,2,26,,,
106324,30,33,0,33,28,0,28,5,0,5
106342,30,576,339,237,572,337,235,4,2,2
106351,30,62,47,15,62,47,15,,,
106360,30,25,1,24,25,1,24,,,
106397,30,24001,10541,13460,21454,9427,12027,2547,1114,1433
106412,30,2444,999,1445,2088,855,1233,356,144,212
106449,30,1787,653,1134,1278,509,769,509,144,365
106458,30,7478,2788,4690,5355,2173,3182,2123,615,1508
106467,30,6467,2852,3615,5359,2454,2905,1108,398,710
106485,30,1957,812,1145,1628,730,898,329,82,247
106494,30,38,0,38,38,0,38,,,
106546,30,666,81,585,592,75,517,74,6,68
106625,30,1068,339,729,680,243,437,388,96,292
106704,30,7763,2983,4780,6787,2591,4196,976,392,584
106713,30,546,299,247,497,280,217,49,19,30
106795,30,858,265,593,452,170,282,406,95,311
106810,30,170,95,75,170,95,75,,,
106883,30,606,167,439,383,117,266,223,50,173
106892,30,62,1,61,62,1,61,,,
106908,30,330,21,309,315,20,295,15,1,14
106980,30,1903,721,1182,1210,502,708,693,219,474
106999,30,698,211,487,506,158,348,192,53,139
107044,30,3262,1441,1821,3071,1334,1737,191,107,84
107071,30,2205,1042,1163,1992,952,1040,213,90,123
107080,30,1103,539,564,1098,536,562,5,3,2
107099,30,85,3,82,85,3,82,,,
107123,30,66,8,58,66,8,58,,,
107141,30,1381,555,826,1284,524,760,97,31,66
107220,30,196,2,194,196,2,194,,,
107293,30,53,0,53,53,0,53,,,
107318,30,525,183,342,226,53,173,299,130,169
107327,30,786,269,517,462,195,267,324,74,250
107442,30,33,22,11,33,22,11,,,
107460,30,1161,441,720,726,312,414,435,129,306
107488,30,155,106,49,153,104,49,2,2,0
107512,30,1572,670,902,1551,660,891,21,10,11
107521,30,424,119,305,273,73,200,151,46,105
107549,30,627,154,473,464,119,345,163,35,128
107558,30,775,367,408,773,365,408,2,2,0
107585,30,1586,591,995,1009,414,595,577,177,400
107600,30,709,256,453,613,221,392,96,35,61
107619,30,611,189,422,429,148,281,182,41,141
107637,30,808,214,594,227,75,152,581,139,442
107655,30,37,0,37,37,0,37,,,
107664,30,4110,1373,2737,2275,823,1452,1835,550,1285
107725,30,760,190,570,411,127,284,349,63,286
107743,30,529,201,328,386,159,227,143,42,101
107789,30,118,2,116,118,2,116,,,
107831,30,84,1,83,84,1,83,,,
107840,30,245,75,170,202,64,138,43,11,32
107877,30,593,288,305,588,285,303,5,3,2
107974,30,889,244,645,448,149,299,441,95,346
107983,30,2795,1242,1553,2627,1171,1456,168,71,97
107992,30,725,331,394,480,217,263,245,114,131
108065,30,15,0,15,11,0,11,4,0,4
108092,30,4188,1646,2542,3249,1254,1995,939,392,547
108232,30,5294,2299,2995,2634,1220,1414,2660,1079,1581
108667,30,3629,1560,2069,512,276,236,3117,1284,1833
108807,30,7389,3287,4102,2814,1279,1535,4575,2008,2567
108852,30,217,98,119,217,98,119,,,
108977,30,185,53,132,101,32,69,84,21,63
109040,30,1902,397,1505,1902,397,1505,,,
109086,30,1,1,0,1,1,0,,,
109208,30,22837,10989,11848,4408,1982,2426,18429,9007,9422
109350,30,9670,4041,5629,3160,1423,1737,6510,2618,3892
109651,30,2026,844,1182,1728,729,999,298,115,183
109721,30,180,52,128,180,52,128,,,
109730,30,43,35,8,43,35,8,,,
109785,30,3937,1249,2688,3372,1070,2302,565,179,386
109819,30,16900,7474,9426,5995,2542,3453,10905,4932,5973
109907,30,2071,631,1440,896,276,620,1175,355,820
109934,30,406,63,343,406,63,343,,,
110060,30,264,204,60,218,176,42,46,28,18
110097,30,3592,1365,2227,3289,1254,2035,303,111,192
110194,30,241,240,1,241,240,1,,,
110219,30,1361,394,967,1361,394,967,,,
110246,30,8798,3859,4939,4036,1869,2167,4762,1990,2772
110316,30,84,16,68,76,14,62,8,2,6
110334,30,8035,3348,4687,2842,1251,1591,5193,2097,3096
110361,30,8234,3006,5228,7310,2704,4606,924,302,622
110370,30,1239,451,788,1178,430,748,61,21,40
110404,30,987,546,441,987,546,441,,,
110413,30,2588,1167,1421,2516,1130,1386,72,37,35
110422,30,21090,10814,10276,19923,10106,9817,1167,708,459
110468,30,227,74,153,,,,227,74,153
110486,30,8870,3047,5823,7387,2505,4882,1483,542,941
110495,30,9161,3017,6144,7342,2376,4966,1819,641,1178
110510,30,16595,6214,10381,13617,4997,8620,2978,1217,1761
110529,30,26802,14371,12431,23140,12174,10966,3662,2197,1465
110538,30,14343,6525,7818,12880,5856,7024,1463,669,794
110547,30,15214,5615,9599,11628,4264,7364,3586,1351,2235
110556,30,21826,8686,13140,18515,7226,11289,3311,1460,1851
110565,30,35502,14614,20888,27848,11304,16544,7654,3310,4344
110574,30,12047,4801,7246,9434,3717,5717,2613,1084,1529
110583,30,33765,14273,19492,28275,11689,16586,5490,2584,2906
110592,30,23506,9549,13957,19534,7773,11761,3972,1776,2196
110608,30,34436,15515,18921,28212,12320,15892,6224,3195,3029
110617,30,29370,12572,16798,23448,9688,13760,5922,2884,3038
110635,30,31811,14441,17370,30197,13696,16501,1614,745,869
110644,30,31637,12600,19037,30762,12183,18579,875,417,458
110653,30,29438,13364,16074,28742,12960,15782,696,404,292
110662,30,32122,12924,19198,31485,12595,18890,637,329,308
110671,30,22817,10727,12090,22069,10315,11754,748,412,336
110680,30,33339,16239,17100,32327,15680,16647,1012,559,453
110705,30,23081,10116,12965,22458,9789,12669,623,327,296
110714,30,17864,9319,8545,17087,8877,8210,777,442,335
110778,30,8,2,6,7,2,5,1,0,1
110875,30,63,0,63,59,0,59,4,0,4
110918,30,14,10,4,7,5,2,7,5,2
111045,30,22,9,13,17,5,12,5,4,1
111054,30,94,21,73,94,21,73,,,
111081,30,959,400,559,938,389,549,21,11,10
111188,30,880,710,170,852,687,165,28,23,5
111434,30,3859,1484,2375,488,214,274,3371,1270,2101
111461,30,13371,6522,6849,5127,2403,2724,8244,4119,4125
111513,30,194,5,189,151,3,148,43,2,41
111638,30,246,96,150,246,96,150,,,
111708,30,198,158,40,198,158,40,,,
111717,30,176,134,42,170,132,38,6,2,4
111726,30,159,118,41,159,118,41,,,
111744,30,135,115,20,135,115,20,,,
111762,30,90,48,42,90,48,42,,,
111799,30,156,22,134,156,22,134,,,
111887,30,17437,8148,9289,6685,2975,3710,10752,5173,5579
111896,30,3706,1834,1872,797,419,378,2909,1415,1494
111920,30,10067,4769,5298,2747,1249,1498,7320,3520,3800
111939,30,15267,5829,9438,4667,1904,2763,10600,3925,6675
111948,30,7469,2960,4509,7148,2807,4341,321,153,168
111966,30,255,87,168,164,71,93,91,16,75
112075,30,1580,628,952,1482,595,887,98,33,65
112084,30,438,197,241,385,178,207,53,19,34
112172,30,8260,3562,4698,3573,1593,1980,4687,1969,2718
112181,30,101,2,99,101,2,99,,,
112190,30,16219,7433,8786,5262,2699,2563,10957,4734,6223
112260,30,1414,696,718,1409,693,716,5,3,2
112288,30,430,25,405,430,25,405,,,
112367,30,340,38,302,114,10,104,226,28,198
112385,30,5719,2945,2774,558,243,315,5161,2702,2459
112394,30,420,310,110,340,251,89,80,59,21
112455,30,132,25,107,132,25,107,,,
112561,30,1509,683,826,484,207,277,1025,476,549
112570,30,493,280,213,448,254,194,45,26,19
112686,30,2635,850,1785,735,300,435,1900,550,1350
112826,30,4429,1734,2695,1313,577,736,3116,1157,1959
113096,30,12575,5267,7308,2921,1338,1583,9654,3929,5725
113111,30,4481,1997,2484,1464,660,804,3017,1337,1680
113193,30,6961,3219,3742,2577,1238,1339,4384,1981,2403
113218,30,6473,2761,3712,1342,620,722,5131,2141,2990
113236,30,12090,4972,7118,4507,1951,2556,7583,3021,4562
113333,30,14706,7265,7441,7921,4245,3676,6785,3020,3765
113449,30,159,42,117,159,42,117,,,
113537,30,13,3,10,13,3,10,,,
113573,30,8634,3481,5153,3605,1523,2082,5029,1958,3071
113582,30,119,13,106,80,10,70,39,3,36
113634,30,15326,7351,7975,5857,2975,2882,9469,4376,5093
113698,30,1243,388,855,1133,346,787,110,42,68
113856,30,25649,12347,13302,4901,2129,2772,20748,10218,10530
113980,30,16764,7649,9115,5999,2867,3132,10765,4782,5983
114266,30,6746,2969,3777,1923,894,1029,4823,2075,2748
114354,30,1724,302,1422,1494,252,1242,230,50,180
114433,30,1242,638,604,443,213,230,799,425,374
114460,30,297,41,256,183,30,153,114,11,103
114637,30,58,2,56,58,2,56,,,
114716,30,10593,5556,5037,3202,1515,1687,7391,4041,3350
114761,30,59,7,52,59,7,52,,,
114789,30,15554,6102,9452,4595,1923,2672,10959,4179,6780
114813,30,2668,726,1942,1393,421,972,1275,305,970
114859,30,16287,7435,8852,6528,3068,3460,9759,4367,5392
114938,30,3744,1722,2022,1404,630,774,2340,1092,1248
114947,30,104,47,57,104,47,57,,,
115001,30,10107,4426,5681,5504,2480,3024,4603,1946,2657
115010,30,305,62,243,305,62,243,,,
115083,30,679,490,189,499,382,117,180,108,72
115126,30,8830,3768,5062,2903,1336,1567,5927,2432,3495
115296,30,11455,4532,6923,3784,1607,2177,7671,2925,4746
115357,30,116,27,89,56,16,40,60,11,49
115393,30,8635,4197,4438,3000,1281,1719,5635,2916,2719
115409,30,905,455,450,902,454,448,3,1,2
115658,30,99,15,84,48,11,37,51,4,47
115728,30,592,199,393,492,169,323,100,30,70
115755,30,5336,2221,3115,4643,1885,2758,693,336,357
115773,30,197,44,153,98,27,71,99,17,82
115861,30,6385,2681,3704,3062,1203,1859,3323,1478,1845
115931,30,693,505,188,693,505,188,,,
116226,30,110,1,109,46,0,46,64,1,63
116350,30,158,28,130,158,28,130,,,
116439,30,9140,4712,4428,3735,2064,1671,5405,2648,2757
116563,30,226,7,219,226,7,219,,,
116846,30,22,2,20,20,2,18,2,0,2
117052,30,3852,1683,2169,1247,639,608,2605,1044,1561
117104,30,419,190,229,358,157,201,61,33,28
117140,30,3686,1462,2224,2891,1137,1754,795,325,470
117168,30,735,194,541,627,164,463,108,30,78
117195,30,1830,1146,684,592,323,269,1238,823,415
117238,30,82,18,64,82,18,64,,,
117247,30,5722,2730,2992,1239,672,567,4483,2058,2425
117274,30,1392,1066,326,455,297,158,937,769,168
117283,30,49,22,27,24,9,15,25,13,12
117557,30,168,131,37,161,127,34,7,4,3
117575,30,46,30,16,5,3,2,41,27,14
117627,30,1270,525,745,1141,484,657,129,41,88
117636,30,980,258,722,818,222,596,162,36,126
117645,30,20180,8624,11556,8117,3559,4558,12063,5065,6998
117672,30,130,22,108,1,0,1,129,22,107
117690,30,5487,2158,3329,1384,647,737,4103,1511,2592
117706,30,13016,5604,7412,3675,1636,2039,9341,3968,5373
117715,30,3539,1069,2470,508,151,357,3031,918,2113
117724,30,7867,4212,3655,1790,1045,745,6077,3167,2910
117733,30,11201,4636,6565,2381,1088,1293,8820,3548,5272
117751,30,1338,699,639,1030,502,528,308,197,111
117788,30,10494,4433,6061,2369,1061,1308,8125,3372,4753
117803,30,180,53,127,,,,180,53,127
117867,30,6538,2511,4027,1356,613,743,5182,1898,3284
117894,30,6919,2931,3988,2610,1202,1408,4309,1729,2580
117946,30,6999,3249,3750,6859,3174,3685,140,75,65
117955,30,272,54,218,170,32,138,102,22,80
118134,30,93,2,91,35,2,33,58,0,58
118143,30,103,4,99,18,2,16,85,2,83
118161,30,76,4,72,76,4,72,,,
118198,30,550,125,425,550,125,425,,,
118347,30,3584,1442,2142,988,458,530,2596,984,1612
118541,30,443,212,231,431,208,223,12,4,8
118684,30,2223,652,1571,675,218,457,1548,434,1114
118693,30,743,404,339,710,388,322,33,16,17
118718,30,7737,3013,4724,3708,1501,2207,4029,1512,2517
118772,30,4798,1573,3225,897,285,612,3901,1288,2613
118888,30,438,2,436,392,2,390,46,0,46
118912,30,10436,4148,6288,3919,1674,2245,6517,2474,4043
118930,30,4950,2174,2776,1262,636,626,3688,1538,2150
118958,30,81,33,48,28,10,18,53,23,30
118976,30,12949,4874,8075,4630,1839,2791,8319,3035,5284
118994,30,346,200,146,346,200,146,,,
119058,30,13,9,4,13,9,4,,,
119067,30,5706,2557,3149,1850,840,1010,3856,1717,2139
119137,30,11336,5181,6155,4233,2047,2186,7103,3134,3969
119164,30,22907,10512,12395,8297,4012,4285,14610,6500,8110
119173,30,1898,120,1778,1532,83,1449,366,37,329
119216,30,12452,4985,7467,4437,1862,2575,8015,3123,4892
119270,30,744,540,204,474,356,118,270,184,86
119331,30,3777,1516,2261,1441,603,838,2336,913,1423
119553,30,1201,290,911,1178,281,897,23,9,14
119605,30,7160,3452,3708,2903,1394,1509,4257,2058,2199
119775,30,301,177,124,258,151,107,43,26,17
119951,30,221,14,207,221,14,207,,,
120069,30,190,18,172,190,18,172,,,
120078,30,384,46,338,384,46,338,,,
120087,30,171,24,147,171,24,147,,,
120166,30,6,3,3,5,3,2,1,0,1
120254,30,1952,822,1130,1930,813,1117,22,9,13
120290,30,6929,3406,3523,2792,1445,1347,4137,1961,2176
120342,30,15761,7621,8140,6139,3100,3039,9622,4521,5101
120403,30,1191,361,830,1153,344,809,38,17,21
120421,30,5789,2585,3204,1464,681,783,4325,1904,2421
120537,30,619,275,344,516,234,282,103,41,62
120661,30,735,159,576,705,156,549,30,3,27
120698,30,64,14,50,55,14,41,9,0,9
120768,30,479,43,436,,,,479,43,436
120838,30,2,0,2,2,0,2,,,
120865,30,799,299,500,731,283,448,68,16,52
120883,30,3269,1551,1718,3152,1493,1659,117,58,59
120953,30,3734,3330,404,508,390,118,3226,2940,286
120971,30,13873,7142,6731,5014,2444,2570,8859,4698,4161
121044,30,19090,8674,10416,7077,3461,3616,12013,5213,6800
121150,30,3706,1569,2137,3427,1443,1984,279,126,153
121257,30,1168,483,685,1132,463,669,36,20,16
121275,30,64,46,18,64,46,18,,,
121309,30,3170,1087,2083,2574,887,1687,596,200,396
121345,30,1744,792,952,1744,792,952,,,
121363,30,2725,975,1750,1187,463,724,1538,512,1026
121433,30,137,5,132,126,4,122,11,1,10
121619,30,20846,12502,8344,3645,1781,1864,17201,10721,6480
121637,30,116,15,101,116,15,101,,,
121691,30,2596,1060,1536,2249,899,1350,347,161,186
121707,30,2947,1373,1574,930,465,465,2017,908,1109
121859,30,194,15,179,110,15,95,84,0,84
121868,30,187,3,184,111,1,110,76,2,74
121886,30,13960,7842,6118,3797,1830,1967,10163,6012,4151
121901,30,15516,6171,9345,4891,2078,2813,10625,4093,6532
122117,30,2,0,2,1,0,1,1,0,1
122180,30,16654,6411,10243,4042,1630,2412,12612,4781,7831
122205,30,15431,6829,8602,5173,2662,2511,10258,4167,6091
122296,30,677,140,537,574,125,449,103,15,88
122339,30,10852,4684,6168,1629,700,929,9223,3984,5239
122375,30,15217,6651,8566,3380,1675,1705,11837,4976,6861
122384,30,10881,5886,4995,1553,980,573,9328,4906,4422
122409,30,30991,13364,17627,27611,11707,15904,3380,1657,1723
122436,30,5601,2456,3145,5481,2387,3094,120,69,51
122454,30,26,12,14,25,12,13,1,0,1
122506,30,228,135,93,228,135,93,,,
122597,30,22563,10071,12492,18462,7993,10469,4101,2078,2023
122612,30,5937,2106,3831,5728,1999,3729,209,107,102
122658,30,13242,5350,7892,6684,2824,3860,6558,2526,4032
122685,30,2124,554,1570,2124,554,1570,,,
122694,30,788,223,565,788,223,565,,,
122728,30,1187,501,686,964,408,556,223,93,130
122746,30,6076,2449,3627,1525,672,853,4551,1777,2774
122755,30,28190,14408,13782,22942,11533,11409,5248,2875,2373
122791,30,5553,2739,2814,1203,662,541,4350,2077,2273
122834,30,9,2,7,9,2,7,,,
122889,30,10570,4474,6096,5346,2417,2929,5224,2057,3167
122931,30,5887,3101,2786,5773,3030,2743,114,71,43
122977,30,21482,9276,12206,8685,3967,4718,12797,5309,7488
123013,30,12916,5611,7305,4160,1947,2213,8756,3664,5092
123165,30,1091,0,1091,1087,0,1087,4,0,4
123217,30,9546,3895,5651,4344,1878,2466,5202,2017,3185
123280,30,29,16,13,9,6,3,20,10,10
123299,30,5079,1803,3276,2445,927,1518,2634,876,1758
123341,30,12847,5667,7180,5464,2527,2937,7383,3140,4243
123350,30,122,11,111,83,10,73,39,1,38
123457,30,730,302,428,663,277,386,67,25,42
123484,30,1049,544,505,512,269,243,537,275,262
123493,30,163,50,113,163,50,113,,,
123509,30,5664,2561,3103,1157,610,547,4507,1951,2556
123527,30,8578,3277,5301,2188,910,1278,6390,2367,4023
123554,30,2190,918,1272,1984,831,1153,206,87,119
123563,30,6942,2908,4034,2395,1004,1391,4547,1904,2643
123572,30,6560,2485,4075,5727,2115,3612,833,370,463
123642,30,272,19,253,176,14,162,96,5,91
123651,30,1972,622,1350,1777,563,1214,195,59,136
123679,30,734,210,524,653,195,458,81,15,66
123800,30,14285,6311,7974,5918,2569,3349,8367,3742,4625
123952,30,252,152,100,242,146,96,10,6,4
123961,30,20619,9974,10645,20110,9702,10408,509,272,237
124113,30,3208,1705,1503,815,268,547,2393,1437,956
124292,30,497,247,250,497,247,250,,,
124487,30,88,46,42,11,5,6,77,41,36
124681,30,1108,424,684,1108,424,684,,,
124706,30,744,161,583,744,161,583,,,
124937,30,714,220,494,659,215,444,55,5,50
125028,30,9808,4063,5745,3023,1314,1709,6785,2749,4036
125082,30,94,14,80,93,13,80,1,1,0
125091,30,8271,3138,5133,2896,1194,1702,5375,1944,3431
125170,30,4017,1659,2358,681,293,388,3336,1366,1970
125231,30,7086,1131,5955,1704,235,1469,5382,896,4486
125310,30,55,12,43,55,12,43,,,
125462,30,1999,987,1012,423,207,216,1576,780,796
125471,30,7921,3097,4824,1537,689,848,6384,2408,3976
125499,30,5779,2553,3226,2017,982,1035,3762,1571,2191
125532,30,1606,147,1459,1606,147,1459,,,
125727,30,1238,489,749,1233,487,746,5,2,3
125763,30,1321,578,743,1273,548,725,48,30,18
125897,30,937,448,489,880,421,459,57,27,30
126076,30,142,142,0,142,142,0,,,
126119,30,4153,1510,2643,1226,517,709,2927,993,1934
126164,30,53,1,52,53,1,52,,,
126182,30,1484,837,647,1157,604,553,327,233,94
126207,30,3392,1421,1971,1436,688,748,1956,733,1223
126289,30,5274,2078,3196,1725,810,915,3549,1268,2281
126359,30,217,32,185,217,32,185,,,
126562,30,11042,4801,6241,8369,3626,4743,2673,1175,1498
126580,30,9634,4402,5232,7443,3405,4038,2191,997,1194
126605,30,316,278,38,316,278,38,,,
126614,30,30414,16680,13734,28389,15418,12971,2025,1262,763
126669,30,4995,1451,3544,1742,614,1128,3253,837,2416
126678,30,2235,971,1264,2187,948,1239,48,23,25
126687,30,781,125,656,781,125,656,,,
126711,30,2740,1111,1629,1170,566,604,1570,545,1025
126748,30,562,199,363,389,163,226,173,36,137
126775,30,5440,3722,1718,5175,3542,1633,265,180,85
126784,30,149,147,2,149,147,2,,,
126818,30,24344,11154,13190,19968,9002,10966,4376,2152,2224
126827,30,21008,7061,13947,13320,4350,8970,7688,2711,4977
126863,30,3613,1444,2169,1091,532,559,2522,912,1610
126915,30,120,46,74,65,24,41,55,22,33
126942,30,5050,1811,3239,1694,641,1053,3356,1170,2186
126951,30,1292,1180,112,1292,1180,112,,,
127060,30,5771,2593,3178,5431,2428,3003,340,165,175
127158,30,5086,4468,618,1123,843,280,3963,3625,338
127185,30,3260,1503,1757,2892,1323,1569,368,180,188
127200,30,11436,4729,6707,3750,1794,1956,7686,2935,4751
127316,30,228,45,183,84,25,59,144,20,124
127389,30,408,162,246,294,135,159,114,27,87
127556,30,7904,3626,4278,6544,3022,3522,1360,604,756
127565,30,15625,6990,8635,9718,4451,5267,5907,2539,3368
127617,30,614,197,417,231,84,147,383,113,270
127653,30,317,84,233,287,73,214,30,11,19
127714,30,347,166,181,31,11,20,316,155,161
127732,30,918,413,505,662,321,341,256,92,164
127741,30,6683,2164,4519,5922,1964,3958,761,200,561
127778,30,754,317,437,480,247,233,274,70,204
127820,30,9213,3596,5617,3421,1500,1921,5792,2096,3696
127884,30,3291,1017,2274,1183,454,729,2108,563,1545
127909,30,4249,2140,2109,1642,942,700,2607,1198,1409
127918,30,2616,958,1658,1916,622,1294,700,336,364
127945,30,1832,440,1392,1072,261,811,760,179,581
127954,30,5,0,5,5,0,5,,,
128106,30,3092,1460,1632,2517,1160,1357,575,300,275
128151,30,609,304,305,601,301,300,8,3,5
128179,30,672,485,187,672,485,187,,,
128188,30,787,333,454,787,333,454,,,
128258,30,1014,445,569,603,295,308,411,150,261
128328,30,4181,2987,1194,4181,2987,1194,,,
128337,30,84,1,83,59,1,58,25,0,25
128391,30,1722,1017,705,1619,951,668,103,66,37
128498,30,1023,407,616,918,374,544,105,33,72
128577,30,953,437,516,436,241,195,517,196,321
128586,30,40,40,0,40,40,0,,,
128744,30,1733,498,1235,1422,444,978,311,54,257
128771,30,7616,4075,3541,6065,3221,2844,1551,854,697
128780,30,1472,369,1103,377,81,296,1095,288,807
128896,30,158,30,128,158,30,128,,,
128902,30,1811,734,1077,1810,734,1076,1,0,1
129002,30,318,150,168,275,131,144,43,19,24
129020,30,18362,8739,9623,17883,8449,9434,479,290,189
129154,30,2901,443,2458,411,121,290,2490,322,2168
129181,30,1170,1083,87,869,805,64,301,278,23
129215,30,3767,1598,2169,3462,1435,2027,305,163,142
129242,30,4548,1904,2644,4485,1872,2613,63,32,31
129349,30,180,4,176,171,4,167,9,0,9
129367,30,2199,540,1659,520,165,355,1679,375,1304
129482,30,407,31,376,407,31,376,,,
129525,30,3915,1767,2148,3681,1668,2013,234,99,135
129534,30,216,104,112,100,55,45,116,49,67
129543,30,3167,1133,2034,1153,472,681,2014,661,1353
129695,30,3985,1705,2280,1450,645,805,2535,1060,1475
129729,30,4297,1648,2649,1666,746,920,2631,902,1729
129756,30,1748,680,1068,766,344,422,982,336,646
129774,30,508,292,216,493,284,209,15,8,7
129808,30,2809,1038,1771,1047,472,575,1762,566,1196
129923,30,568,276,292,329,167,162,239,109,130
129932,30,323,287,36,254,221,33,69,66,3
129941,30,4970,2164,2806,4718,2020,2698,252,144,108
130004,30,3557,1470,2087,1181,561,620,2376,909,1467
130040,30,976,323,653,439,173,266,537,150,387
130110,30,171,58,113,108,37,71,63,21,42
130174,30,1633,790,843,1458,745,713,175,45,130
130183,30,12795,3540,9255,4977,1362,3615,7818,2178,5640
130217,30,975,362,613,395,158,237,580,204,376
130226,30,6243,2343,3900,5985,2254,3731,258,89,169
130253,30,6699,2185,4514,6070,2021,4049,629,164,465
130314,30,895,207,688,852,199,653,43,8,35
130396,30,5194,1905,3289,1748,781,967,3446,1124,2322
130493,30,6584,2478,4106,5616,2100,3516,968,378,590
130509,30,566,42,524,234,22,212,332,20,312
130590,30,2143,1082,1061,2106,1064,1042,37,18,19
130606,30,3019,1252,1767,1319,582,737,1700,670,1030
130624,30,1049,628,421,1049,628,421,,,
130697,30,3250,1425,1825,3232,1411,1821,18,14,4
130776,30,4028,1918,2110,3440,1651,1789,588,267,321
130794,30,6535,3174,3361,6531,3170,3361,4,4,0
130837,30,67,8,59,67,8,59,,,
130873,30,251,47,204,251,47,204,,,
130907,30,10837,3493,7344,3486,1372,2114,7351,2121,5230
130934,30,4179,1384,2795,3750,1249,2501,429,135,294
130943,30,18707,7795,10912,17986,7422,10564,721,373,348
130989,30,667,314,353,591,284,307,76,30,46
131061,30,144,11,133,75,8,67,69,3,66
131113,30,7626,2728,4898,2640,1103,1537,4986,1625,3361
131159,30,8158,2997,5161,7882,2869,5013,276,128,148
131283,30,2891,1273,1618,2801,1238,1563,90,35,55
131399,30,2810,1049,1761,1328,589,739,1482,460,1022
131450,30,998,456,542,911,421,490,87,35,52
131469,30,10929,4026,6903,10196,3722,6474,733,304,429
131496,30,7395,3162,4233,7194,3064,4130,201,98,103
131520,30,8902,2477,6425,8419,2299,6120,483,178,305
131803,30,368,89,279,28,17,11,340,72,268
131830,30,27,17,10,27,17,10,,,
131876,30,1383,28,1355,958,10,948,425,18,407
132374,30,2543,2190,353,2543,2190,353,,,
132408,30,252,129,123,180,90,90,72,39,33
132471,30,2932,983,1949,2569,840,1729,363,143,220
132602,30,2513,946,1567,2384,893,1491,129,53,76
132657,30,2632,1317,1315,2439,1225,1214,193,92,101
132675,30,51,29,22,43,21,22,8,8,0
132693,30,9855,3874,5981,3204,1438,1766,6651,2436,4215
132709,30,25570,10308,15262,8249,3601,4648,17321,6707,10614
132842,30,178,30,148,101,17,84,77,13,64
132851,30,4334,1541,2793,1767,706,1061,2567,835,1732
132879,30,148,88,60,134,81,53,14,7,7
132903,30,59709,26848,32861,41722,18749,22973,17987,8099,9888
132976,30,243,124,119,243,124,119,,,
133021,30,1248,436,812,677,278,399,571,158,413
133155,30,740,331,409,447,232,215,293,99,194
133386,30,9190,3562,5628,3918,1779,2139,5272,1783,3489
133465,30,359,47,312,267,36,231,92,11,81
133492,30,2026,615,1411,1975,596,1379,51,19,32
133508,30,11309,4017,7292,4253,1681,2572,7056,2336,4720
133526,30,1079,557,522,1011,531,480,68,26,42
133553,30,6899,5194,1705,6543,4903,1640,356,291,65
133650,30,7005,2378,4627,6194,2057,4137,811,321,490
133669,30,23695,9946,13749,15417,6425,8992,8278,3521,4757
133702,30,17329,6148,11181,5391,2131,3260,11938,4017,7921
133711,30,2623,869,1754,2550,837,1713,73,32,41
133809,30,528,257,271,522,254,268,6,3,3
133845,30,678,75,603,658,75,583,20,0,20
133854,30,349,79,270,349,79,270,,,
133863,30,438,51,387,438,51,387,,,
133872,30,1058,161,897,384,66,318,674,95,579
133881,30,3219,2263,956,3080,2159,921,139,104,35
133942,30,53,4,49,53,4,49,,,
133951,30,39936,17316,22620,25454,10747,14707,14482,6569,7913
133960,30,832,340,492,336,191,145,496,149,347
133979,30,945,482,463,880,441,439,65,41,24
133997,30,353,135,218,353,135,218,,,
134024,30,26,9,17,26,9,17,,,
134079,30,2741,989,1752,2646,959,1687,95,30,65
134097,30,33368,14306,19062,30065,12662,17403,3303,1644,1659
134130,30,34044,14860,19184,31023,13214,17809,3021,1646,1375
134228,30,29,11,18,24,10,14,5,1,4
134237,30,24172,16793,7379,24172,16793,7379,,,
134291,30,603,506,97,587,491,96,16,15,1
134307,30,890,830,60,189,182,7,701,648,53
134343,30,3422,1157,2265,1577,589,988,1845,568,1277
134422,30,23,0,23,23,0,23,,,
134495,30,19166,7941,11225,8637,4034,4603,10529,3907,6622
134510,30,157,81,76,88,39,49,69,42,27
134529,30,324,28,296,324,28,296,,,
134574,30,115,14,101,115,14,101,,,
134608,30,10886,4127,6759,3689,1581,2108,7197,2546,4651
134714,30,186,30,156,51,11,40,135,19,116
134811,30,857,296,561,535,186,349,322,110,212
134945,30,2627,1023,1604,2396,966,1430,231,57,174
135081,30,17516,4742,12774,10378,3022,7356,7138,1720,5418
135142,30,223,6,217,16,0,16,207,6,201
135160,30,2065,654,1411,837,294,543,1228,360,868
135179,30,660,379,281,447,270,177,213,109,104
135188,30,3080,1138,1942,1104,457,647,1976,681,1295
135267,30,704,482,222,701,480,221,3,2,1
135276,30,881,452,429,780,380,400,101,72,29
135294,30,458,214,244,348,211,137,110,3,107
135337,30,85,4,81,50,4,46,35,0,35
135364,30,201,135,66,27,17,10,174,118,56
135391,30,7200,2639,4561,2964,1263,1701,4236,1376,2860
135407,30,1044,577,467,1041,576,465,3,1,2
135522,30,253,163,90,253,163,90,,,
135559,30,83,6,77,51,3,48,32,3,29
135610,30,80,32,48,34,15,19,46,17,29
135647,30,896,737,159,590,506,84,306,231,75
135717,30,39727,16421,23306,17976,7610,10366,21751,8811,12940
135726,30,11928,5549,6379,11495,5338,6157,433,211,222
135735,30,944,862,82,238,209,29,706,653,53
136109,30,134,3,131,75,3,72,59,0,59
136145,30,807,202,605,273,68,205,534,134,400
136172,30,13862,5949,7913,10397,4392,6005,3465,1557,1908
136215,30,6578,1834,4744,5808,1690,4118,770,144,626
136233,30,3154,1222,1932,1396,613,783,1758,609,1149
136303,30,139,18,121,123,16,107,16,2,14
136330,30,2274,804,1470,2133,754,1379,141,50,91
136358,30,20631,8205,12426,5955,2632,3323,14676,5573,9103
136400,30,7018,2755,4263,2907,1213,1694,4111,1542,2569
136473,30,6792,2221,4571,2831,1059,1772,3961,1162,2799
136491,30,644,380,264,516,339,177,128,41,87
136516,30,6946,2336,4610,2449,910,1539,4497,1426,3071
136659,30,177,134,43,168,127,41,9,7,2
136765,30,335,166,169,287,142,145,48,24,24
136774,30,1661,469,1192,1635,465,1170,26,4,22
136826,30,435,228,207,232,125,107,203,103,100
136950,30,2501,1002,1499,2425,972,1453,76,30,46
137023,30,379,175,204,373,171,202,6,4,2
137032,30,6456,2516,3940,4890,1845,3045,1566,671,895
137078,30,20107,7440,12667,6202,2701,3501,13905,4739,9166
137087,30,655,351,304,606,339,267,49,12,37
137096,30,11219,5171,6048,4806,2446,2360,6413,2725,3688
137120,30,1489,825,664,866,467,399,623,358,265
137209,30,12983,5510,7473,4621,2283,2338,8362,3227,5135
137245,30,1296,651,645,1296,651,645,,,
137272,30,37,35,2,37,35,2,,,
137281,30,3818,1309,2509,1416,573,843,2402,736,1666
137315,30,2035,681,1354,847,346,501,1188,335,853
137351,30,36681,15831,20850,28798,12267,16531,7883,3564,4319
137476,30,1797,933,864,1603,883,720,194,50,144
137546,30,2826,1222,1604,2769,1191,1578,57,31,26
137564,30,5296,2169,3127,4534,1816,2718,762,353,409
137591,30,278,43,235,259,42,217,19,1,18
137713,30,199,69,130,118,43,75,81,26,55
137759,30,10653,4599,6054,6121,2806,3315,4532,1793,2739
137777,30,30,30,0,30,30,0,,,
137801,30,511,248,263,487,243,244,24,5,19
137847,30,9838,3856,5982,9509,3684,5825,329,172,157
137856,30,107,56,51,85,48,37,22,8,14
137865,30,329,177,152,312,162,150,17,15,2
137953,30,341,192,149,276,161,115,65,31,34
137962,30,199,120,79,160,99,61,39,21,18
138187,30,36131,14492,21639,12660,5508,7152,23471,8984,14487
138275,30,762,398,364,709,371,338,53,27,26
138284,30,347,186,161,261,141,120,86,45,41
138293,30,775,521,254,747,503,244,28,18,10
138309,30,8333,1136,7197,4136,589,3547,4197,547,3650
138354,30,8881,3767,5114,6170,2706,3464,2711,1061,1650
138372,30,515,339,176,242,79,163,273,260,13
138479,30,624,408,216,624,408,216,,,
138488,30,358,164,194,214,51,163,144,113,31
138497,30,384,200,184,384,200,184,,,
138558,30,3323,1368,1955,2390,1102,1288,933,266,667
138600,30,1013,0,1013,1008,0,1008,5,0,5
138655,30,702,475,227,657,445,212,45,30,15
138664,30,65,19,46,65,19,46,,,
138682,30,2063,603,1460,794,247,547,1269,356,913
138716,30,5576,1455,4121,3836,1064,2772,1740,391,1349
138761,30,266,124,142,199,116,83,67,8,59
138813,30,580,289,291,358,177,181,222,112,110
138822,30,577,15,562,577,15,562,,,
138840,30,3188,1069,2119,1025,435,590,2163,634,1529
138868,30,794,380,414,655,339,316,139,41,98
138901,30,1467,511,956,623,220,403,844,291,553
138938,30,396,32,364,222,14,208,174,18,156
138947,30,3376,798,2578,3218,758,2460,158,40,118
138956,30,3316,1416,1900,1238,549,689,2078,867,1211
139144,30,2170,789,1381,2157,781,1376,13,8,5
139153,30,181,101,80,77,39,38,104,62,42
139199,30,1310,94,1216,925,57,868,385,37,348
139205,30,597,373,224,545,335,210,52,38,14
139250,30,2750,837,1913,1640,521,1119,1110,316,794
139278,30,4889,1516,3373,1496,527,969,3393,989,2404
139311,30,5170,1499,3671,3336,963,2373,1834,536,1298
139357,30,2563,708,1855,765,250,515,1798,458,1340
139366,30,5986,2370,3616,4197,1580,2617,1789,790,999
139384,30,4229,1458,2771,1407,558,849,2822,900,1922
139393,30,840,393,447,804,375,429,36,18,18
139463,30,4169,1583,2586,2647,1031,1616,1522,552,970
139506,30,113,72,41,113,72,41,,,
139579,30,239,63,176,160,43,117,79,20,59
139621,30,1682,742,940,1210,537,673,472,205,267
139630,30,786,434,352,754,416,338,32,18,14
139658,30,7050,2971,4079,6974,2927,4047,76,44,32
139700,30,4691,1691,3000,2013,788,1225,2678,903,1775
139719,30,2635,980,1655,2235,830,1405,400,150,250
139746,30,67,14,53,67,14,53,,,
139755,30,16552,9911,6641,15178,9051,6127,1374,860,514
139764,30,2018,693,1325,1511,531,980,507,162,345
139861,30,5489,1964,3525,5027,1753,3274,462,211,251
139931,30,22404,9519,12885,19208,8156,11052,3196,1363,1833
139940,30,28415,11258,17157,21929,8631,13298,6486,2627,3859
139959,30,30032,12627,17405,28162,11685,16477,1870,942,928
139968,30,2546,858,1688,1555,578,977,991,280,711
139986,30,4124,1108,3016,1222,380,842,2902,728,2174
139995,30,320,138,182,320,138,182,,,
140003,30,172,33,139,87,21,66,85,12,73
140012,30,6683,2791,3892,1549,795,754,5134,1996,3138
140234,30,580,321,259,563,320,243,17,1,16
140243,30,3792,1500,2292,1171,459,712,2621,1041,1580
140252,30,908,440,468,746,385,361,162,55,107
140331,30,7592,3205,4387,2379,1169,1210,5213,2036,3177
140340,30,571,99,472,351,72,279,220,27,193
140447,30,4699,1674,3025,4173,1545,2628,526,129,397
140553,30,2554,2553,1,2197,2197,0,357,356,1
140678,30,1970,819,1151,807,384,423,1163,435,728
140696,30,1408,521,887,1361,501,860,47,20,27
140720,30,241,131,110,209,113,96,32,18,14
140818,30,1213,403,810,1115,385,730,98,18,80
140827,30,66,12,54,66,12,54,,,
140872,30,1069,554,515,978,513,465,91,41,50
140942,30,3193,1124,2069,1028,447,581,2165,677,1488
140951,30,12542,3856,8686,10513,3203,7310,2029,653,1376
140960,30,3021,1152,1869,2500,959,1541,521,193,328
140988,30,1183,526,657,1107,502,605,76,24,52
141006,30,1298,639,659,670,368,302,628,271,357
141015,30,144,58,86,141,55,86,3,3,0
141060,30,2417,0,2417,2363,0,2363,54,0,54
141167,30,688,297,391,467,221,246,221,76,145
141185,30,784,307,477,718,287,431,66,20,46
141237,30,838,399,439,799,379,420,39,20,19
141255,30,2350,818,1532,708,227,481,1642,591,1051
141264,30,8421,2766,5655,6580,2172,4408,1841,594,1247
141325,30,574,0,574,446,0,446,128,0,128
141334,30,8572,3016,5556,6739,2401,4338,1833,615,1218
141361,30,892,401,491,886,397,489,6,4,2
141486,30,1536,420,1116,1299,346,953,237,74,163
141565,30,2630,921,1709,1974,695,1279,656,226,430
141574,30,13839,5506,8333,11140,4312,6828,2699,1194,1505
141608,30,72,48,24,72,48,24,,,
141644,30,2726,905,1821,2268,661,1607,458,244,214
141680,30,2099,1331,768,877,579,298,1222,752,470
141796,30,4039,1459,2580,1557,633,924,2482,826,1656
141802,30,817,284,533,243,118,125,574,166,408
141811,30,4085,1513,2572,1762,732,1030,2323,781,1542
141839,30,1915,599,1316,721,235,486,1194,364,830
141981,30,2651,922,1729,1637,590,1047,1014,332,682
141990,30,1028,290,738,429,103,326,599,187,412
142054,30,489,69,420,489,69,420,,,
142090,30,88,50,38,74,43,31,14,7,7
142115,30,17075,7337,9738,13234,5713,7521,3841,1624,2217
142179,30,1326,450,876,599,251,348,727,199,528
142276,30,6842,2788,4054,5389,2210,3179,1453,578,875
142285,30,6861,3370,3491,6350,3110,3240,511,260,251
142294,30,1118,550,568,1104,539,565,14,11,3
142328,30,2441,852,1589,1888,715,1173,553,137,416
142407,30,90,10,80,64,10,54,26,0,26
142416,30,11,1,10,11,1,10,,,
142443,30,3018,1134,1884,1459,715,744,1559,419,1140
142461,30,1172,495,677,1042,451,591,130,44,86
142489,30,43,0,43,43,0,43,,,
142522,30,43532,19081,24451,17914,8521,9393,25618,10560,15058
142559,30,3550,1201,2349,1731,679,1052,1819,522,1297
142887,30,145,46,99,112,36,76,33,10,23
142957,30,5,4,1,3,3,0,2,1,1
143048,30,2795,693,2102,2515,620,1895,280,73,207
143084,30,2317,1061,1256,2298,1048,1250,19,13,6
143118,30,4076,1372,2704,3766,1283,2483,310,89,221
143215,30,5738,2485,3253,2780,1323,1457,2958,1162,1796
143279,30,2308,793,1515,1268,494,774,1040,299,741
143288,30,384,176,208,378,172,206,6,4,2
143297,30,141,8,133,112,5,107,29,3,26
143358,30,4319,2139,2180,4214,2075,2139,105,64,41
143376,30,224,14,210,133,12,121,91,2,89
143464,30,116,3,113,91,3,88,25,0,25
143473,30,40,1,39,21,1,20,19,0,19
143482,30,32,0,32,13,0,13,19,0,19
143491,30,39,2,37,12,1,11,27,1,26
143552,30,47,1,46,21,0,21,26,1,25
143613,30,1108,392,716,631,274,357,477,118,359
143978,30,30,5,25,23,4,19,7,1,6
144005,30,1496,457,1039,954,317,637,542,140,402
144050,30,7558,3955,3603,7556,3954,3602,2,1,1
144157,30,1081,451,630,502,241,261,579,210,369
144166,30,5224,1123,4101,2245,528,1717,2979,595,2384
144175,30,965,357,608,428,185,243,537,172,365
144184,30,2132,822,1310,864,364,500,1268,458,810
144193,30,2203,1177,1026,1048,682,366,1155,495,660
144209,30,4216,1734,2482,2075,887,1188,2141,847,1294
144218,30,4537,2147,2390,2152,1128,1024,2385,1019,1366
144281,30,6458,2577,3881,6103,2416,3687,355,161,194
144351,30,1370,597,773,1222,538,684,148,59,89
144485,30,149,102,47,149,102,47,,,
144564,30,1264,512,752,667,264,403,597,248,349
144573,30,134,2,132,87,1,86,47,1,46
144740,30,14059,6477,7582,12836,5854,6982,1223,623,600
144795,30,436,110,326,398,101,297,38,9,29
144865,30,14801,6744,8057,6241,3060,3181,8560,3684,4876
144883,30,487,217,270,487,217,270,,,
144892,30,4616,1786,2830,3981,1585,2396,635,201,434
144944,30,6347,2904,3443,2367,1180,1187,3980,1724,2256
144962,30,2791,1064,1727,2688,1011,1677,103,53,50
144971,30,468,261,207,457,253,204,11,8,3
145099,30,283,21,262,283,21,262,,,
145239,30,308,48,260,308,48,260,,,
145309,30,48,15,33,48,15,33,,,
145336,30,2698,984,1714,1657,623,1034,1041,361,680
145354,30,52,2,50,12,0,12,40,2,38
145372,30,828,453,375,777,436,341,51,17,34
145406,30,500,7,493,136,3,133,364,4,360
145424,30,75,2,73,21,2,19,54,0,54
145433,30,114,1,113,46,0,46,68,1,67
145497,30,81,13,68,66,9,57,15,4,11
145521,30,901,323,578,510,203,307,391,120,271
145600,30,22011,10306,11705,19910,9279,10631,2101,1027,1074
145619,30,2174,1090,1084,1835,947,888,339,143,196
145637,30,33889,18248,15641,33113,17727,15386,776,521,255
145646,30,1646,810,836,1642,809,833,4,1,3
145682,30,4800,1900,2900,1974,954,1020,2826,946,1880
145691,30,1088,519,569,1066,511,555,22,8,14
145707,30,585,242,343,435,201,234,150,41,109
145725,30,2889,1959,930,2675,1787,888,214,172,42
145813,30,17632,7576,10056,16430,6968,9462,1202,608,594
145831,30,1853,825,1028,893,422,471,960,403,557
146205,30,2157,846,1311,1227,514,713,930,332,598
146278,30,1370,516,854,823,351,472,547,165,382
146296,30,8937,3863,5074,3614,1735,1879,5323,2128,3195
146339,30,923,427,496,846,409,437,77,18,59
146348,30,1837,696,1141,821,354,467,1016,342,674
146366,30,1740,597,1143,1094,412,682,646,185,461
146418,30,1731,726,1005,851,408,443,880,318,562
146427,30,1140,494,646,1129,489,640,11,5,6
146454,30,48,0,48,48,0,48,,,
146472,30,9124,4018,5106,3395,1710,1685,5729,2308,3421
146481,30,1657,690,967,1640,681,959,17,9,8
146506,30,2439,953,1486,1684,699,985,755,254,501
146533,30,152,30,122,105,21,84,47,9,38
146603,30,2417,923,1494,1264,556,708,1153,367,786
146612,30,3799,1866,1933,3252,1572,1680,547,294,253
146667,30,284,164,120,237,136,101,47,28,19
146676,30,795,392,403,647,351,296,148,41,107
146685,30,3959,1502,2457,1676,771,905,2283,731,1552
146700,30,1184,852,332,1184,852,332,,,
146719,30,11739,3732,8007,11189,3545,7644,550,187,363
146755,30,108,17,91,72,13,59,36,4,32
146807,30,74,7,67,24,3,21,50,4,46
146816,30,258,24,234,176,13,163,82,11,71
147004,30,4595,2075,2520,1980,1006,974,2615,1069,1546
147013,30,1436,717,719,1256,654,602,180,63,117
147129,30,514,58,456,245,31,214,269,27,242
147244,30,1719,751,968,1655,733,922,64,18,46
147341,30,750,365,385,748,365,383,2,0,2
147369,30,1878,967,911,1508,745,763,370,222,148
147378,30,7443,3363,4080,3691,1775,1916,3752,1588,2164
147396,30,74,68,6,71,65,6,3,3,0
147411,30,2702,1102,1600,994,478,516,1708,624,1084
147536,30,3485,911,2574,2561,750,1811,924,161,763
147590,30,19,6,13,15,5,10,4,1,3
147642,30,55,6,49,25,2,23,30,4,26
147660,30,2384,1155,1229,2348,1137,1211,36,18,18
147679,30,1834,744,1090,1696,689,1007,138,55,83
147703,30,11819,5567,6252,9994,4624,5370,1825,943,882
147767,30,8691,4052,4639,8412,3938,4474,279,114,165
147776,30,4547,1891,2656,2627,1082,1545,1920,809,1111
147800,30,6862,3283,3579,2091,1094,997,4771,2189,2582
147819,30,45,2,43,45,2,43,,,
147828,30,2599,1111,1488,2494,1083,1411,105,28,77
147916,30,3272,1616,1656,1715,920,795,1557,696,861
148007,30,2306,816,1490,764,299,465,1542,517,1025
148016,30,318,169,149,314,166,148,4,3,1
148098,30,41,0,41,26,0,26,15,0,15
148131,30,966,489,477,939,476,463,27,13,14
148256,30,1211,531,680,903,414,489,308,117,191
148292,30,1442,467,975,504,187,317,938,280,658
148380,30,4636,2053,2583,2052,973,1079,2584,1080,1504
148405,30,956,419,537,899,400,499,57,19,38
148487,30,2585,1019,1566,2244,908,1336,341,111,230
148496,30,2034,633,1401,1908,595,1313,126,38,88
148511,30,118,29,89,54,9,45,64,20,44
148575,30,272,42,230,216,33,183,56,9,47
148584,30,1519,471,1048,1250,419,831,269,52,217
148593,30,93,9,84,86,9,77,7,0,7
148627,30,3087,1140,1947,2844,1042,1802,243,98,145
148654,30,2441,1150,1291,1715,748,967,726,402,324
148672,30,1076,424,652,585,230,355,491,194,297
148821,30,667,226,441,389,142,247,278,84,194
148876,30,714,130,584,534,93,441,180,37,143
148937,30,634,279,355,437,217,220,197,62,135
148991,30,821,326,495,516,221,295,305,105,200
149028,30,189,22,167,143,21,122,46,1,45
149204,30,35,0,35,35,0,35,,,
149222,30,7973,4126,3847,6746,3413,3333,1227,713,514
149231,30,9903,4226,5677,8071,3497,4574,1832,729,1103
149310,30,231,119,112,231,119,112,,,
149329,30,73,73,0,73,73,0,,,
149365,30,2032,604,1428,665,244,421,1367,360,1007
149499,30,9,0,9,9,0,9,,,
149505,30,832,293,539,731,265,466,101,28,73
149514,30,476,285,191,405,245,160,71,40,31
149532,30,6500,3139,3361,2404,1151,1253,4096,1988,2108
149550,30,151,19,132,121,17,104,30,2,28
149639,30,72,33,39,72,33,39,,,
149727,30,5591,2430,3161,2318,1144,1174,3273,1286,1987
149763,30,506,94,412,369,66,303,137,28,109
149772,30,5268,2299,2969,4574,1966,2608,694,333,361
149781,30,2301,1034,1267,2202,979,1223,99,55,44
149842,30,9111,4062,5049,3894,2011,1883,5217,2051,3166
150066,30,1137,522,615,1060,502,558,77,20,57
150136,30,13896,5370,8526,13037,5051,7986,859,319,540
150145,30,1144,420,724,1020,389,631,124,31,93
150163,30,4388,1774,2614,4323,1732,2591,65,42,23
150172,30,522,287,235,363,188,175,159,99,60
150251,30,195,9,186,102,3,99,93,6,87
150303,30,296,5,291,98,3,95,198,2,196
150400,30,1708,847,861,1700,844,856,8,3,5
150428,30,9,0,9,9,0,9,,,
150455,30,653,298,355,653,298,355,,,
150534,30,1554,605,949,1506,591,915,48,14,34
150604,30,880,474,406,867,467,400,13,7,6
150668,30,725,284,441,682,270,412,43,14,29
150677,30,1426,556,870,1378,533,845,48,23,25
150756,30,1000,488,512,995,485,510,5,3,2
150765,30,131,3,128,131,3,128,,,
150774,30,445,247,198,431,237,194,14,10,4
150853,30,224,2,222,125,1,124,99,1,98
150941,30,1002,405,597,894,362,532,108,43,65
150987,30,51103,21578,29525,14141,5354,8787,36962,16224,20738
151102,30,5708,2898,2810,4734,2392,2342,974,506,468
151111,30,18707,7597,11110,15869,6339,9530,2838,1258,1580
151263,30,3954,1431,2523,3707,1345,2362,247,86,161
151290,30,1380,829,551,1335,805,530,45,24,21
151306,30,6031,2111,3920,5194,1822,3372,837,289,548
151324,30,7653,3335,4318,6278,2711,3567,1375,624,751
151333,30,2612,919,1693,2225,781,1444,387,138,249
151342,30,3791,1329,2462,2863,989,1874,928,340,588
151351,30,33995,17041,16954,33079,16570,16509,916,471,445
151360,30,2941,781,2160,2198,594,1604,743,187,556
151379,30,3427,1377,2050,2407,931,1476,1020,446,574
151388,30,2639,897,1742,1651,486,1165,988,411,577
151467,30,224,36,188,224,36,188,,,
151564,30,52,2,50,16,1,15,36,1,35
151607,30,104,5,99,71,3,68,33,2,31
151652,30,238,6,232,134,4,130,104,2,102
151661,30,1124,1020,104,1124,1020,104,,,
151777,30,977,496,481,966,488,478,11,8,3
151786,30,2668,988,1680,2329,922,1407,339,66,273
151801,30,2268,825,1443,2222,809,1413,46,16,30
151810,30,180,48,132,85,22,63,95,26,69
151962,30,271,85,186,271,85,186,,,
152044,30,88,48,40,35,29,6,53,19,34
152080,30,8950,4616,4334,8933,4604,4329,17,12,5
152099,30,584,293,291,523,262,261,61,31,30
152150,30,53,3,50,38,2,36,15,1,14
152275,30,146,46,100,88,9,79,58,37,21
152309,30,109,40,69,88,31,57,21,9,12
152318,30,2075,1566,509,2054,1551,503,21,15,6
152336,30,1724,512,1212,1516,495,1021,208,17,191
152381,30,784,137,647,662,125,537,122,12,110
152390,30,1375,0,1375,1367,0,1367,8,0,8
152497,30,156,12,144,134,12,122,22,0,22
152530,30,1713,783,930,1666,757,909,47,26,21
152567,30,2254,1424,830,2215,1399,816,39,25,14
152600,30,2493,1054,1439,2463,1042,1421,30,12,18
152628,30,42,1,41,20,1,19,22,0,22
152637,30,4136,2256,1880,2976,1626,1350,1160,630,530
152673,30,840,840,0,837,837,0,3,3,0
152798,30,314,25,289,280,24,256,34,1,33
152992,30,648,315,333,582,305,277,66,10,56
153001,30,1451,538,913,1275,492,783,176,46,130
153074,30,148,6,142,148,6,142,,,
153083,30,144,6,138,144,6,138,,,
153108,30,1106,568,538,1078,550,528,28,18,10
153126,30,702,387,315,689,381,308,13,6,7
153144,30,1347,583,764,1336,576,760,11,7,4
153162,30,1045,548,497,1037,541,496,8,7,1
153214,30,10175,4291,5884,5060,2422,2638,5115,1869,3246
153241,30,67,25,42,67,25,42,,,
153250,30,1411,746,665,1401,742,659,10,4,6
153269,30,2857,1134,1723,2773,1086,1687,84,48,36
153278,30,1582,921,661,1289,810,479,293,111,182
153296,30,574,293,281,514,273,241,60,20,40
153302,30,176,80,96,160,72,88,16,8,8
153311,30,3435,1164,2271,1844,731,1113,1591,433,1158
153320,30,297,145,152,260,126,134,37,19,18
153366,30,922,444,478,877,440,437,45,4,41
153375,30,1532,735,797,1398,676,722,134,59,75
153384,30,1713,810,903,1709,809,900,4,1,3
153427,30,103,41,62,103,41,62,,,
153445,30,2714,1107,1607,1818,846,972,896,261,635
153463,30,26,1,25,26,1,25,,,
153472,30,1814,813,1001,1464,715,749,350,98,252
153524,30,2938,1528,1410,2270,1315,955,668,213,455
153533,30,920,486,434,700,396,304,220,90,130
153542,30,14,2,12,14,2,12,,,
153597,30,48,2,46,48,2,46,,,
153603,30,25537,14342,11195,24416,13606,10810,1121,736,385
153621,30,718,420,298,671,401,270,47,19,28
153630,30,3481,1568,1913,2198,1232,966,1283,336,947
153658,30,21198,9373,11825,19644,8650,10994,1554,723,831
153737,30,7778,3278,4500,4199,2025,2174,3579,1253,2326
153746,30,23,2,21,23,2,21,,,
153764,30,46,1,45,46,1,45,,,
153773,30,44,0,44,44,0,44,,,
153782,30,14,0,14,14,0,14,,,
153825,30,1236,720,516,1183,681,502,53,39,14
153834,30,1732,754,978,1712,739,973,20,15,5
153861,30,652,152,500,320,81,239,332,71,261
153922,30,803,334,469,562,273,289,241,61,180
153977,30,950,151,799,535,109,426,415,42,373
154004,30,1188,603,585,1158,591,567,30,12,18
154013,30,1280,441,839,1013,356,657,267,85,182
154022,30,31534,11017,20517,31534,11017,20517,,,
154059,30,1391,629,762,1073,517,556,318,112,206
154095,30,7812,3042,4770,7270,2800,4470,542,242,300
154101,30,1030,508,522,974,502,472,56,6,50
154110,30,1769,560,1209,819,397,422,950,163,787
154129,30,779,379,400,540,336,204,239,43,196
154165,30,10,0,10,10,0,10,,,
154174,30,39,18,21,36,18,18,3,0,3
154208,30,133,2,131,15,0,15,118,2,116
154235,30,2220,1006,1214,2121,965,1156,99,41,58
154262,30,202,19,183,91,10,81,111,9,102
154332,30,74,5,69,74,5,69,,,
154350,30,1167,548,619,1073,507,566,94,41,53
154378,30,1495,570,925,1061,446,615,434,124,310
154396,30,749,287,462,570,250,320,179,37,142
154448,30,140,4,136,140,4,136,,,
154457,30,14,0,14,14,0,14,,,
154466,30,41,4,37,41,4,37,,,
154493,30,2323,945,1378,1287,551,736,1036,394,642
154518,30,2034,1259,775,1450,846,604,584,413,171
154527,30,1505,722,783,1472,699,773,33,23,10
154545,30,96,70,26,96,70,26,,,
154572,30,2657,953,1704,1463,679,784,1194,274,920
154590,30,1263,668,595,1206,644,562,57,24,33
154642,30,1224,494,730,744,357,387,480,137,343
154688,30,1206,529,677,979,450,529,227,79,148
154697,30,2157,879,1278,1212,519,693,945,360,585
154712,30,2073,1021,1052,2058,1012,1046,15,9,6
154721,30,690,405,285,687,404,283,3,1,2
154749,30,478,266,212,471,260,211,7,6,1
154800,30,6129,2303,3826,2890,1176,1714,3239,1127,2112
154855,30,497,224,273,475,212,263,22,12,10
154907,30,781,307,474,565,256,309,216,51,165
154925,30,890,514,376,779,459,320,111,55,56
154934,30,827,221,606,551,193,358,276,28,248
154952,30,1785,710,1075,1199,541,658,586,169,417
154998,30,1029,480,549,671,363,308,358,117,241
155007,30,343,104,239,164,59,105,179,45,134
155025,30,2859,1010,1849,2653,946,1707,206,64,142
155052,30,338,179,159,240,127,113,98,52,46
155061,30,11024,4285,6739,4751,1890,2861,6273,2395,3878
155070,30,162,74,88,139,64,75,23,10,13
155089,30,978,480,498,853,430,423,125,50,75
155098,30,990,507,483,731,390,341,259,117,142
155104,30,1408,636,772,969,488,481,439,148,291
155140,30,700,255,445,632,236,396,68,19,49
155159,30,94,0,94,94,0,94,,,
155177,30,331,145,186,303,137,166,28,8,20
155186,30,1511,672,839,870,426,444,641,246,395
155195,30,3137,1266,1871,1768,807,961,1369,459,910
155201,30,518,293,225,432,259,173,86,34,52
155210,30,10583,4739,5844,4163,1964,2199,6420,2775,3645
155283,30,668,59,609,625,58,567,43,1,42
155292,30,3357,1359,1998,1353,605,748,2004,754,1250
155308,30,127,101,26,124,100,24,3,1,2
155317,30,18427,8623,9804,16535,7786,8749,1892,837,1055
155335,30,865,317,548,815,288,527,50,29,21
155353,30,71,62,9,71,62,9,,,
155399,30,15384,7743,7641,13907,7079,6828,1477,664,813
155414,30,758,433,325,718,408,310,40,25,15
155423,30,1227,740,487,925,614,311,302,126,176
155450,30,1401,533,868,557,203,354,844,330,514
155487,30,363,190,173,243,142,101,120,48,72
155496,30,172,101,71,143,88,55,29,13,16
155511,30,825,556,269,811,545,266,14,11,3
155520,30,1008,467,541,899,436,463,109,31,78
155566,30,813,289,524,525,216,309,288,73,215
155593,30,457,307,150,395,288,107,62,19,43
155618,30,321,228,93,294,223,71,27,5,22
155627,30,787,475,312,728,428,300,59,47,12
155636,30,283,58,225,111,28,83,172,30,142
155681,30,4292,2148,2144,4014,2035,1979,278,113,165
155715,30,561,374,187,474,326,148,87,48,39
155812,30,791,396,395,738,371,367,53,25,28
155830,30,260,122,138,193,103,90,67,19,48
155858,30,960,348,612,615,255,360,345,93,252
155900,30,1145,746,399,658,404,254,487,342,145
155937,30,599,373,226,534,338,196,65,35,30
155973,30,555,347,208,539,337,202,16,10,6
156082,30,3984,1486,2498,3137,1180,1957,847,306,541
156107,30,2305,1231,1074,1166,745,421,1139,486,653
156125,30,10466,4681,5785,8475,3789,4686,1991,892,1099
156134,30,1012,597,415,1012,597,415,,,
156189,30,613,305,308,580,290,290,33,15,18
156213,30,1335,550,785,1124,466,658,211,84,127
156231,30,1665,692,973,1091,528,563,574,164,410
156277,30,27,2,25,27,2,25,,,
156286,30,2356,869,1487,2290,841,1449,66,28,38
156295,30,1454,591,863,1432,583,849,22,8,14
156310,30,275,5,270,245,5,240,30,0,30
156338,30,2830,1095,1735,1393,587,806,1437,508,929
156356,30,702,247,455,616,232,384,86,15,71
156365,30,2652,1102,1550,2377,1034,1343,275,68,207
156392,30,7612,3020,4592,3627,1617,2010,3985,1403,2582
156408,30,1315,635,680,1315,635,680,,,
156417,30,105,86,19,68,55,13,37,31,6
156426,30,195,13,182,126,10,116,69,3,66
156471,30,3992,332,3660,1773,135,1638,2219,197,2022
156541,30,4379,1495,2884,3618,1280,2338,761,215,546
156620,30,10987,4487,6500,9247,3678,5569,1740,809,931
156648,30,3646,1450,2196,1682,706,976,1964,744,1220
156745,30,1228,560,668,1224,557,667,4,3,1
156754,30,45,1,44,45,1,44,,,
156790,30,1468,528,940,844,330,514,624,198,426
156842,30,207,8,199,153,5,148,54,3,51
156851,30,837,192,645,355,93,262,482,99,383
156860,30,1444,421,1023,634,168,466,810,253,557
156921,30,7286,3013,4273,2708,1226,1482,4578,1787,2791
156967,30,84,1,83,84,1,83,,,
157021,30,210,15,195,20,6,14,190,9,181
157030,30,69,42,27,53,29,24,16,13,3
157058,30,1660,675,985,1330,537,793,330,138,192
157076,30,774,405,369,751,395,356,23,10,13
157085,30,21358,9199,12159,19782,8442,11340,1576,757,819
157100,30,514,344,170,501,338,163,13,6,7
157216,30,1713,681,1032,1618,646,972,95,35,60
157289,30,13815,6283,7532,11380,5128,6252,2435,1155,1280
157304,30,1817,577,1240,819,256,563,998,321,677
157331,30,1955,618,1337,934,367,567,1021,251,770
157377,30,1168,384,784,977,346,631,191,38,153
157386,30,5210,2012,3198,4614,1817,2797,596,195,401
157401,30,6750,2577,4173,5891,2275,3616,859,302,557
157438,30,2520,1084,1436,857,448,409,1663,636,1027
157447,30,8982,3621,5361,7385,3006,4379,1597,615,982
157483,30,2961,967,1994,1588,602,986,1373,365,1008
157535,30,1001,475,526,974,460,514,27,15,12
157553,30,1690,674,1016,1173,504,669,517,170,347
157614,30,100,0,100,56,0,56,44,0,44
157650,30,125,7,118,87,5,82,38,2,36
157669,30,87,1,86,87,1,86,,,
157678,30,111,1,110,111,1,110,,,
157711,30,3382,1148,2234,1850,735,1115,1532,413,1119
157739,30,1381,455,926,822,271,551,559,184,375
157748,30,853,472,381,635,333,302,218,139,79
157757,30,683,202,481,578,184,394,105,18,87
157793,30,2304,767,1537,1329,441,888,975,326,649
157809,30,1446,694,752,1311,642,669,135,52,83
157818,30,970,401,569,960,396,564,10,5,5
157863,30,776,414,362,741,403,338,35,11,24
157951,30,12526,4802,7724,11158,4278,6880,1368,524,844
158088,30,1364,676,688,1018,487,531,346,189,157
158246,30,161,63,98,161,63,98,,,
158325,30,110,14,96,110,14,96,,,
158343,30,48,22,26,26,10,16,22,12,10
158431,30,5104,1568,3536,2550,869,1681,2554,699,1855
158477,30,514,217,297,507,212,295,7,5,2
158538,30,57,1,56,57,1,56,,,
158617,30,475,181,294,475,181,294,,,
158662,30,11283,3340,7943,3919,1331,2588,7364,2009,5355
158778,30,47,4,43,47,4,43,,,
158787,30,60,2,58,60,2,58,,,
158802,30,1200,274,926,1128,253,875,72,21,51
158884,30,1506,532,974,690,279,411,816,253,563
159009,30,4405,1592,2813,3836,1407,2429,569,185,384
159027,30,17,0,17,17,0,17,,,
159197,30,555,479,76,555,479,76,,,
159328,30,102,2,100,102,2,100,,,
159373,30,893,115,778,788,97,691,105,18,87
159382,30,3176,897,2279,2041,616,1425,1135,281,854
159391,30,26455,12100,14355,25204,11440,13764,1251,660,591
159407,30,2528,631,1897,1569,440,1129,959,191,768
159416,30,2196,846,1350,1670,660,1010,526,186,340
159513,30,184,6,178,184,6,178,,,
159522,30,193,9,184,193,9,184,,,
159531,30,32,0,32,32,0,32,,,
159568,30,869,481,388,838,467,371,31,14,17
159601,30,38,2,36,38,2,36,,,
159647,30,7785,4347,3438,7316,4133,3183,469,214,255
159656,30,3230,1089,2141,3033,1016,2017,197,73,124
159717,30,5202,2007,3195,4632,1795,2837,570,212,358
159939,30,5629,2742,2887,4543,2202,2341,1086,540,546
159948,30,792,479,313,178,98,80,614,381,233
159966,30,5181,1890,3291,4574,1675,2899,607,215,392
159993,30,5376,1812,3564,4293,1542,2751,1083,270,813
160010,30,779,521,258,285,232,53,494,289,205
160038,30,7513,2030,5483,5478,1638,3840,2035,392,1643
160065,30,530,86,444,341,62,279,189,24,165
160074,30,929,145,784,494,79,415,435,66,369
160117,30,201,1,200,201,1,200,,,
160126,30,34,0,34,8,0,8,26,0,26
160199,30,44,0,44,44,0,44,,,
160320,30,2564,88,2476,2564,88,2476,,,
160409,30,114,114,0,112,112,0,2,2,0
160472,30,195,6,189,128,4,124,67,2,65
160481,30,1541,446,1095,777,263,514,764,183,581
160524,30,279,79,200,279,79,200,,,
160579,30,2631,1249,1382,1424,736,688,1207,513,694
160597,30,127,43,84,66,21,45,61,22,39
160612,30,10106,3736,6370,8316,3107,5209,1790,629,1161
160621,30,5809,1920,3889,5026,1684,3342,783,236,547
160630,30,1293,297,996,927,222,705,366,75,291
160649,30,1913,553,1360,1242,435,807,671,118,553
160658,30,12612,5318,7294,10845,4667,6178,1767,651,1116
160667,30,1934,919,1015,1333,654,679,601,265,336
160755,30,8515,3303,5212,8135,3153,4982,380,150,230
160904,30,2727,635,2092,2637,603,2034,90,32,58
160959,30,369,109,260,357,107,250,12,2,10
160977,30,1821,885,936,1821,885,936,,,
160995,30,511,101,410,511,101,410,,,
161004,30,1948,960,988,1948,960,988,,,
161022,30,235,22,213,111,10,101,124,12,112
161077,30,2011,803,1208,903,462,441,1108,341,767
161086,30,2262,1065,1197,2262,1065,1197,,,
161138,30,1289,590,699,664,334,330,625,256,369
161192,30,1293,394,899,433,161,272,860,233,627
161208,30,53,48,5,53,48,5,,,
161217,30,3020,880,2140,1412,414,998,1608,466,1142
161226,30,1380,437,943,1284,407,877,96,30,66
161235,30,1050,282,768,585,197,388,465,85,380
161253,30,9246,4767,4479,8144,4145,3999,1102,622,480
161299,30,868,709,159,831,676,155,37,33,4
161341,30,983,335,648,727,263,464,256,72,184
161457,30,2224,686,1538,2183,668,1515,41,18,23
161484,30,440,207,233,260,143,117,180,64,116
161493,30,165,6,159,129,4,125,36,2,34
161509,30,407,105,302,390,101,289,17,4,13
161518,30,1066,387,679,736,287,449,330,100,230
161527,30,226,22,204,148,6,142,78,16,62
161545,30,4163,1870,2293,1764,909,855,2399,961,1438
161554,30,4668,1857,2811,3525,1378,2147,1143,479,664
161563,30,682,347,335,667,342,325,15,5,10
161572,30,1981,527,1454,1980,527,1453,1,0,1
161581,30,230,100,130,154,83,71,76,17,59
161688,30,1671,416,1255,737,253,484,934,163,771
161767,30,8574,3325,5249,2676,1255,1421,5898,2070,3828
161800,30,94,38,56,42,15,27,52,23,29
161855,30,28,1,27,21,1,20,7,0,7
161864,30,3171,751,2420,766,221,545,2405,530,1875
161873,30,1579,623,956,869,344,525,710,279,431
162007,30,5279,2051,3228,4338,1668,2670,941,383,558
162061,30,322,261,61,263,213,50,59,48,11
162104,30,1356,472,884,489,215,274,867,257,610
162122,30,5149,1904,3245,2018,858,1160,3131,1046,2085
162168,30,1341,433,908,402,167,235,939,266,673
162210,30,594,193,401,479,155,324,115,38,77
162283,30,1785,391,1394,1350,314,1036,435,77,358
162335,30,49,0,49,49,0,49,,,
162371,30,643,580,63,643,580,63,,,
162557,30,3632,1515,2117,1391,694,697,2241,821,1420
162584,30,3289,1476,1813,2750,1353,1397,539,123,416
162609,30,390,213,177,288,165,123,102,48,54
162654,30,1054,366,688,1033,357,676,21,9,12
162690,30,2675,911,1764,1049,452,597,1626,459,1167
162706,30,3758,1507,2251,1545,708,837,2213,799,1414
162760,30,1202,430,772,1159,413,746,43,17,26
162779,30,7188,2922,4266,2309,1144,1165,4879,1778,3101
162830,30,129,5,124,129,5,124,,,
162928,30,5727,2653,3074,5719,2646,3073,8,7,1
163028,30,1109,965,144,734,638,96,375,327,48
163046,30,3768,1627,2141,3729,1605,2124,39,22,17
163204,30,42992,23288,19704,9902,5034,4868,33090,18254,14836
163259,30,912,168,744,724,139,585,188,29,159
163268,30,10747,5853,4894,9144,4989,4155,1603,864,739
163286,30,30368,15428,14940,28344,14315,14029,2024,1113,911
163295,30,1539,375,1164,1485,363,1122,54,12,42
163338,30,1758,805,953,1619,747,872,139,58,81
163347,30,510,39,471,510,39,471,,,
163408,30,117,27,90,72,9,63,45,18,27
163426,30,13650,6541,7109,4832,2417,2415,8818,4124,4694
163453,30,7027,2694,4333,6258,2363,3895,769,331,438
163462,30,2009,982,1027,1905,924,981,104,58,46
163532,30,261,261,0,261,261,0,,,
163541,30,348,147,201,180,83,97,168,64,104
163578,30,781,28,753,621,19,602,160,9,151
163657,30,8397,2960,5437,2745,1077,1668,5652,1883,3769
163815,30,62,2,60,28,0,28,34,2,32
163851,30,6455,2851,3604,6100,2664,3436,355,187,168
163912,30,1507,634,873,1469,620,849,38,14,24
163976,30,473,250,223,470,248,222,3,2,1
164076,30,17817,7209,10608,15510,6183,9327,2307,1026,1281
164155,30,4528,3230,1298,4528,3230,1298,,,
164173,30,2959,1067,1892,2616,993,1623,343,74,269
164216,30,1010,423,587,1004,418,586,6,5,1
164270,30,1741,752,989,1732,747,985,9,5,4
164313,30,1997,649,1348,496,237,259,1501,412,1089
164368,30,638,395,243,638,395,243,,,
164447,30,1264,526,738,1199,506,693,65,20,45
164465,30,1971,957,1014,1971,957,1014,,,
164492,30,1076,622,454,921,499,422,155,123,32
164535,30,50,8,42,50,8,42,,,
164562,30,1896,831,1065,1879,821,1058,17,10,7
164580,30,2532,1444,1088,2519,1436,1083,13,8,5
164599,30,52,10,42,,,,52,10,42
164614,30,40,27,13,32,21,11,8,6,2
164632,30,1484,0,1484,966,0,966,518,0,518
164641,30,345,133,212,182,99,83,163,34,129
164739,30,3942,2397,1545,3856,2340,1516,86,57,29
164748,30,7126,4147,2979,5493,3074,2419,1633,1073,560
164775,30,1151,366,785,333,136,197,818,230,588
164845,30,87,4,83,67,2,65,20,2,18
164872,30,264,124,140,205,105,100,59,19,40
164924,30,9776,4597,5179,9626,4512,5114,150,85,65
164988,30,17501,7347,10154,17197,7199,9998,304,148,156
165015,30,3577,1453,2124,3565,1450,2115,12,3,9
165024,30,8142,3315,4827,6496,2660,3836,1646,655,991
165033,30,5331,1762,3569,2284,857,1427,3047,905,2142
165060,30,170,20,150,106,15,91,64,5,59
165112,30,8014,3292,4722,2457,1184,1273,5557,2108,3449
165167,30,803,168,635,174,46,128,629,122,507
165194,30,2140,777,1363,750,343,407,1390,434,956
165255,30,190,5,185,75,3,72,115,2,113
165264,30,1035,80,955,51,6,45,984,74,910
165334,30,2290,964,1326,2278,959,1319,12,5,7
165529,30,2025,815,1210,1796,748,1048,229,67,162
165556,30,436,56,380,319,38,281,117,18,99
165574,30,1203,610,593,1108,567,541,95,43,52
165608,30,57,5,52,39,4,35,18,1,17
165635,30,235,219,16,235,219,16,,,
165644,30,491,254,237,450,236,214,41,18,23
165662,30,4113,1464,2649,4053,1442,2611,60,22,38
165671,30,1792,404,1388,1744,393,1351,48,11,37
165699,30,2912,1070,1842,2791,1024,1767,121,46,75
165750,30,60,26,34,60,26,34,,,
165802,30,1086,372,714,588,301,287,498,71,427
165820,30,3168,1453,1715,2497,1223,1274,671,230,441
165866,30,3035,1324,1711,2724,1201,1523,311,123,188
165884,30,419,355,64,282,233,49,137,122,15
165936,30,1336,528,808,1291,510,781,45,18,27
165981,30,1097,389,708,325,120,205,772,269,503
166018,30,465,177,288,465,177,288,,,
166027,30,7938,3904,4034,7376,3653,3723,562,251,311
166054,30,38,27,11,38,27,11,,,
166124,30,3005,1375,1630,3005,1375,1630,,,
166133,30,3229,1122,2107,1229,522,707,2000,600,1400
166391,30,1294,467,827,1267,456,811,27,11,16
166407,30,257,18,239,17,1,16,240,17,223
166452,30,1685,382,1303,1270,294,976,415,88,327
166489,30,39,17,22,37,16,21,2,1,1
166498,30,66,5,61,29,5,24,37,0,37
166513,30,12546,7385,5161,9973,5865,4108,2573,1520,1053
166629,30,23947,11695,12252,22466,11059,11407,1481,636,845
166638,30,11949,4988,6961,9889,4080,5809,2060,908,1152
166647,30,2787,1257,1530,1082,558,524,1705,699,1006
166656,30,3664,893,2771,3494,850,2644,170,43,127
166674,30,1723,455,1268,1556,412,1144,167,43,124
166683,30,4629,2401,2228,4579,2367,2212,50,34,16
166692,30,1431,1243,188,1398,1213,185,33,30,3
166717,30,37,9,28,17,5,12,20,4,16
166805,30,56,41,15,30,24,6,26,17,9
166823,30,4289,1671,2618,1734,820,914,2555,851,1704
166850,30,4001,1889,2112,3926,1853,2073,75,36,39
166869,30,190,20,170,190,20,170,,,
166887,30,4930,1890,3040,1709,787,922,3221,1103,2118
166911,30,336,78,258,331,77,254,5,1,4
166939,30,2214,0,2214,2197,0,2197,17,0,17
166957,30,2622,798,1824,808,323,485,1814,475,1339
167039,30,13,1,12,13,1,12,,,
167057,30,405,223,182,392,213,179,13,10,3
167260,30,1204,801,403,1111,767,344,93,34,59
167288,30,851,339,512,759,309,450,92,30,62
167297,30,141,90,51,141,90,51,,,
167312,30,4077,1427,2650,1442,592,850,2635,835,1800
167358,30,15645,7176,8469,15645,7176,8469,,,
167376,30,3884,1375,2509,1289,586,703,2595,789,1806
167394,30,1015,236,779,885,210,675,130,26,104
167455,30,60,25,35,59,25,34,1,0,1
167525,30,2365,863,1502,894,380,514,1471,483,988
167534,30,5723,2100,3623,2177,943,1234,3546,1157,2389
167598,30,1237,227,1010,1016,196,820,221,31,190
167631,30,1007,340,667,289,137,152,718,203,515
167677,30,13,13,0,13,13,0,,,
167729,30,5046,1727,3319,4198,1404,2794,848,323,525
167783,30,1746,0,1746,1637,0,1637,109,0,109
167792,30,302,107,195,299,105,194,3,2,1
167835,30,2566,2,2564,2554,1,2553,12,1,11
167871,30,156,46,110,71,7,64,85,39,46
167899,30,2056,1015,1041,2026,995,1031,30,20,10
167905,30,3652,1407,2245,1393,608,785,2259,799,1460
167987,30,5618,2720,2898,4894,2424,2470,724,296,428
167996,30,2371,1034,1337,2346,1014,1332,25,20,5
168005,30,4187,1724,2463,4026,1633,2393,161,91,70
168032,30,16,0,16,16,0,16,,,
168148,30,6628,2965,3663,6499,2901,3598,129,64,65
168218,30,2383,0,2383,2375,0,2375,8,0,8
168227,30,3866,3025,841,3645,2844,801,221,181,40
168254,30,2597,1499,1098,2517,1460,1057,80,39,41
168263,30,3974,1764,2210,3483,1558,1925,491,206,285
168281,30,1698,651,1047,1697,650,1047,1,1,0
168342,30,2129,1030,1099,2129,1030,1099,,,
168421,30,5134,3101,2033,5010,3004,2006,124,97,27
168430,30,4271,1636,2635,3572,1368,2204,699,268,431
168528,30,1737,927,810,1715,914,801,22,13,9
168546,30,1511,704,807,1498,696,802,13,8,5
168555,30,20,0,20,18,0,18,2,0,2
168573,30,823,803,20,823,803,20,,,
168591,30,1310,557,753,1298,549,749,12,8,4
168607,30,752,381,371,385,232,153,367,149,218
168740,30,1315,641,674,1187,566,621,128,75,53
168786,30,1155,492,663,1058,466,592,97,26,71
168847,30,4113,1058,3055,1640,436,1204,2473,622,1851
168883,30,1224,428,796,608,251,357,616,177,439
168892,30,75,5,70,30,2,28,45,3,42
169080,30,2963,1405,1558,2785,1275,1510,178,130,48
169187,30,128,23,105,34,10,24,94,13,81
169248,30,11323,4448,6875,9800,3897,5903,1523,551,972
169275,30,4876,1629,3247,1490,521,969,3386,1108,2278
169284,30,259,13,246,195,11,184,64,2,62
169327,30,612,373,239,448,287,161,164,86,78
169363,30,860,443,417,833,433,400,27,10,17
169442,30,1431,538,893,1212,436,776,219,102,117
169479,30,3901,1758,2143,2225,1163,1062,1676,595,1081
169503,30,240,7,233,240,7,233,,,
169521,30,5961,2189,3772,1844,750,1094,4117,1439,2678
169576,30,93,3,90,93,3,90,,,
169655,30,1441,1344,97,1441,1344,97,,,
169716,30,2385,825,1560,2182,765,1417,203,60,143
169761,30,441,38,403,441,38,403,,,
169798,30,12344,4792,7552,8920,3449,5471,3424,1343,2081
169813,30,42,1,41,42,1,41,,,
169910,30,8810,4198,4612,6561,3211,3350,2249,987,1262
169974,30,653,300,353,292,138,154,361,162,199
169983,30,1496,1184,312,1448,1146,302,48,38,10
169992,30,579,194,385,333,137,196,246,57,189
170000,30,811,349,462,594,258,336,217,91,126
170037,30,1463,559,904,1130,445,685,333,114,219
170055,30,11244,4765,6479,3486,1604,1882,7758,3161,4597
170082,30,19239,7495,11744,16984,6475,10509,2255,1020,1235
170091,30,155,83,72,125,65,60,30,18,12
170240,30,9277,3748,5529,3308,1373,1935,5969,2375,3594
170286,30,1495,759,736,1470,744,726,25,15,10
170301,30,3055,1174,1881,2964,1131,1833,91,43,48
170444,30,2989,993,1996,822,318,504,2167,675,1492
170532,30,1226,539,687,1219,536,683,7,3,4
170541,30,5574,2436,3138,1591,731,860,3983,1705,2278
170550,30,2666,723,1943,711,265,446,1955,458,1497
170587,30,938,271,667,411,137,274,527,134,393
170611,30,105,2,103,91,2,89,14,0,14
170620,30,2354,808,1546,724,283,441,1630,525,1105
170639,30,1593,718,875,1398,637,761,195,81,114
170657,30,8899,3832,5067,2987,1354,1633,5912,2478,3434
170675,30,1906,1360,546,1701,1208,493,205,152,53
170736,30,23,1,22,5,0,5,18,1,17
170790,30,15270,6345,8925,4491,1943,2548,10779,4402,6377
170806,30,1954,659,1295,1470,519,951,484,140,344
170967,30,842,320,522,651,278,373,191,42,149
170976,30,32063,15645,16418,30654,14819,15835,1409,826,583
171012,30,135,107,28,135,107,28,,,
171100,30,38424,18604,19820,34986,16732,18254,3438,1872,1566
171128,30,5701,4050,1651,5470,3878,1592,231,172,59
171137,30,6193,3334,2859,4754,2549,2205,1439,785,654
171146,30,4372,1564,2808,2955,1096,1859,1417,468,949
171155,30,2160,779,1381,923,404,519,1237,375,862
171225,30,1744,657,1087,558,224,334,1186,433,753
171234,30,1091,366,725,329,99,230,762,267,495
171304,30,2957,1181,1776,1086,509,577,1871,672,1199
171395,30,1006,303,703,464,152,312,542,151,391
171456,30,6330,2645,3685,5775,2399,3376,555,246,309
171483,30,2861,1335,1526,1134,575,559,1727,760,967
171492,30,2092,1248,844,1336,855,481,756,393,363
171535,30,11978,5169,6809,3015,1494,1521,8963,3675,5288
171571,30,13538,5714,7824,10836,4446,6390,2702,1268,1434
171599,30,838,488,350,788,461,327,50,27,23
171775,30,54,0,54,34,0,34,20,0,20
171881,30,92,33,59,67,22,45,25,11,14
171988,30,87,4,83,87,4,83,,,
171997,30,114,3,111,114,3,111,,,
172015,30,111,8,103,111,8,103,,,
172033,30,155,104,51,48,47,1,107,57,50
172051,30,6522,2337,4185,5607,1953,3654,915,384,531
172200,30,7440,3022,4418,1821,836,985,5619,2186,3433
172264,30,1640,708,932,1113,540,573,527,168,359
172291,30,2198,727,1471,953,352,601,1245,375,870
172307,30,1289,458,831,685,288,397,604,170,434
172334,30,1109,355,754,933,318,615,176,37,139
172422,30,118,95,23,118,95,23,,,
172440,30,400,243,157,385,237,148,15,6,9
172495,30,261,7,254,207,7,200,54,0,54
172608,30,634,343,291,63,45,18,571,298,273
172617,30,8404,3547,4857,2232,1039,1193,6172,2508,3664
172635,30,9036,2845,6191,1064,444,620,7972,2401,5571
172644,30,16530,6735,9795,12877,5064,7813,3653,1671,1982
172671,30,683,234,449,187,76,111,496,158,338
172680,30,96,4,92,59,3,56,37,1,36
172699,30,14286,7178,7108,12127,6057,6070,2159,1121,1038
172866,30,82,75,7,82,75,7,,,
172918,30,1255,633,622,878,518,360,377,115,262
172954,30,1493,681,812,802,449,353,691,232,459
172963,30,4288,1591,2697,1796,774,1022,2492,817,1675
173045,30,2346,1037,1309,2110,953,1157,236,84,152
173063,30,1951,934,1017,857,459,398,1094,475,619
173115,30,567,185,382,246,145,101,321,40,281
173124,30,3508,1496,2012,2513,1149,1364,995,347,648
173142,30,659,304,355,646,298,348,13,6,7
173160,30,2298,906,1392,1949,787,1162,349,119,230
173203,30,1624,753,871,922,504,418,702,249,453
173258,30,2008,986,1022,2008,986,1022,,,
173300,30,1862,827,1035,1832,809,1023,30,18,12
173328,30,2985,1032,1953,2013,719,1294,972,313,659
173416,30,2072,1148,924,1257,814,443,815,334,481
173452,30,736,363,373,652,332,320,84,31,53
173461,30,2719,1209,1510,1276,679,597,1443,530,913
173470,30,27,0,27,27,0,27,,,
173559,30,3175,1269,1906,1665,845,820,1510,424,1086
173638,30,1745,989,756,757,421,336,988,568,420
173647,30,2251,982,1269,2224,964,1260,27,18,9
173665,30,1787,647,1140,1739,627,1112,48,20,28
173708,30,2966,1910,1056,1273,910,363,1693,1000,693
173735,30,649,264,385,356,220,136,293,44,249
173744,30,618,34,584,618,34,584,,,
173799,30,2422,943,1479,989,429,560,1433,514,919
173805,30,606,350,256,436,288,148,170,62,108
173902,30,2235,968,1267,2201,950,1251,34,18,16
173911,30,1970,831,1139,954,487,467,1016,344,672
173920,30,11500,5332,6168,9899,4696,5203,1601,636,965
173957,30,258,57,201,258,57,201,,,
173993,30,582,304,278,452,262,190,130,42,88
174020,30,5689,2370,3319,2646,1142,1504,3043,1228,1815
174066,30,30734,14146,16588,28575,13036,15539,2159,1110,1049
174075,30,1574,680,894,1006,427,579,568,253,315
174127,30,667,210,457,662,207,455,5,3,2
174136,30,4806,1956,2850,1697,788,909,3109,1168,1941
174154,30,746,85,661,365,48,317,381,37,344
174190,30,189,18,171,126,5,121,63,13,50
174233,30,8084,4160,3924,7596,3894,3702,488,266,222
174251,30,1189,506,683,1114,474,640,75,32,43
174321,30,128,5,123,128,5,123,,,
174358,30,3778,1428,2350,3107,1168,1939,671,260,411
174376,30,3565,1428,2137,1170,517,653,2395,911,1484
174428,30,6157,2718,3439,2559,1233,1326,3598,1485,2113
174437,30,868,399,469,779,352,427,89,47,42
174473,30,1732,748,984,884,381,503,848,367,481
174491,30,1599,661,938,1442,601,841,157,60,97
174507,30,249,64,185,67,13,54,182,51,131
174525,30,80,49,31,62,37,25,18,12,6
174570,30,596,248,348,347,165,182,249,83,166
174604,30,119,57,62,98,52,46,21,5,16
174738,30,3384,1221,2163,1496,716,780,1888,505,1383
174747,30,1535,0,1535,1531,0,1531,4,0,4
174756,30,3083,1222,1861,1520,712,808,1563,510,1053
174783,30,6054,2966,3088,4730,2299,2431,1324,667,657
174792,30,1533,1533,0,1514,1514,0,19,19,0
174817,30,1216,526,690,975,433,542,241,93,148
174844,30,2955,1248,1707,2948,1245,1703,7,3,4
174862,30,751,367,384,550,285,265,201,82,119
174899,30,2134,656,1478,1799,578,1221,335,78,257
174914,30,6030,3111,2919,5844,3005,2839,186,106,80
174978,30,144,4,140,116,3,113,28,1,27
175005,30,2546,110,2436,1771,30,1741,775,80,695
175014,30,3553,547,3006,1694,270,1424,1859,277,1582
175041,30,3895,1717,2178,1635,810,825,2260,907,1353
175078,30,1982,760,1222,1463,629,834,519,131,388
175120,30,409,280,129,409,280,129,,,
175157,30,379,260,119,358,247,111,21,13,8
175227,30,1374,1128,246,1140,950,190,234,178,56
175236,30,2184,859,1325,1325,621,704,859,238,621
175263,30,1010,457,553,586,295,291,424,162,262
175272,30,5606,1866,3740,4900,1608,3292,706,258,448
175315,30,6270,2607,3663,2620,1199,1421,3650,1408,2242
175342,30,2478,841,1637,2131,739,1392,347,102,245
175421,30,1632,530,1102,1104,411,693,528,119,409
175430,30,619,295,324,590,291,299,29,4,25
175494,30,59,12,47,59,12,47,,,
175519,30,1308,513,795,1102,444,658,206,69,137
175573,30,2007,818,1189,1696,708,988,311,110,201
175616,30,1716,691,1025,1479,599,880,237,92,145
175643,30,1654,658,996,1450,605,845,204,53,151
175652,30,2565,1127,1438,2015,934,1081,550,193,357
175698,30,36,29,7,26,22,4,10,7,3
175722,30,33,0,33,33,0,33,,,
175786,30,7674,2770,4904,5079,2015,3064,2595,755,1840
175810,30,3978,1286,2692,2986,1033,1953,992,253,739
175829,30,3756,1438,2318,2767,1101,1666,989,337,652
175856,30,4742,1658,3084,4040,1421,2619,702,237,465
175883,30,3491,1335,2156,2799,1104,1695,692,231,461
175935,30,2356,658,1698,1794,565,1229,562,93,469
175980,30,695,347,348,690,345,345,5,2,3
176008,30,1767,606,1161,1523,544,979,244,62,182
176017,30,15994,6773,9221,14970,6283,8687,1024,490,534
176035,30,1834,333,1501,1627,305,1322,207,28,179
176044,30,1316,557,759,1110,484,626,206,73,133
176053,30,2244,899,1345,2077,843,1234,167,56,111
176062,30,66,0,66,66,0,66,,,
176071,30,6633,2522,4111,4437,1852,2585,2196,670,1526
176080,30,18451,9155,9296,16761,8195,8566,1690,960,730
176169,30,2677,1038,1639,2352,940,1412,325,98,227
176178,30,5212,1947,3265,4023,1556,2467,1189,391,798
176239,30,4195,1477,2718,3477,1293,2184,718,184,534
176318,30,768,332,436,462,182,280,306,150,156
176336,30,86,66,20,82,62,20,4,4,0
176354,30,1468,564,904,1275,526,749,193,38,155
176372,30,10597,3746,6851,9016,3051,5965,1581,695,886
176406,30,563,214,349,527,197,330,36,17,19
176433,30,53,1,52,33,1,32,20,0,20
176451,30,20,9,11,1,0,1,19,9,10
176479,30,1960,564,1396,1730,514,1216,230,50,180
176628,30,999,390,609,916,368,548,83,22,61
176664,30,236,135,101,203,116,87,33,19,14
176716,30,112,1,111,102,1,101,10,0,10
176770,30,749,100,649,367,56,311,382,44,338
176789,30,232,108,124,163,70,93,69,38,31
176798,30,239,65,174,136,33,103,103,32,71
176910,30,130,73,57,82,47,35,48,26,22
176947,30,1143,561,582,1132,555,577,11,6,5
176965,30,6407,2934,3473,5598,2556,3042,809,378,431
176983,30,50,44,6,40,38,2,10,6,4
177038,30,91,29,62,60,18,42,31,11,20
177065,30,6159,2459,3700,2669,995,1674,3490,1464,2026
177083,30,25,25,0,25,25,0,,,
177117,30,303,0,303,302,0,302,1,0,1
177135,30,2778,1003,1775,1694,685,1009,1084,318,766
177144,30,840,478,362,803,463,340,37,15,22
177214,30,1340,586,754,1314,576,738,26,10,16
177250,30,1819,682,1137,1135,461,674,684,221,463
177302,30,390,315,75,390,315,75,,,
177339,30,1654,749,905,1421,630,791,233,119,114
177418,30,656,248,408,591,237,354,65,11,54
177436,30,35,4,31,35,4,31,,,
177472,30,8414,3441,4973,4750,2003,2747,3664,1438,2226
177542,30,543,250,293,477,221,256,66,29,37
177551,30,1199,350,849,993,294,699,206,56,150
177588,30,48,3,45,48,3,45,,,
177603,30,72,0,72,71,0,71,1,0,1
177676,30,2584,963,1621,1565,653,912,1019,310,709
177685,30,134,10,124,134,10,124,,,
177719,30,566,69,497,498,63,435,68,6,62
177746,30,724,187,537,713,184,529,11,3,8
177870,30,8,8,0,8,8,0,,,
177931,30,29,1,28,29,1,28,,,
177940,30,1313,507,806,1133,460,673,180,47,133
177968,30,4599,2023,2576,3958,1754,2204,641,269,372
177977,30,1757,1483,274,1651,1402,249,106,81,25
177986,30,339,101,238,173,48,125,166,53,113
177995,30,11784,4552,7232,5499,2385,3114,6285,2167,4118
178004,30,16,0,16,,,,16,0,16
178059,30,5627,1763,3864,3215,1156,2059,2412,607,1805
178077,30,68,2,66,67,2,65,1,0,1
178183,30,223,18,205,223,18,205,,,
178208,30,872,583,289,433,314,119,439,269,170
178217,30,1542,538,1004,1186,424,762,356,114,242
178244,30,1491,682,809,1289,617,672,202,65,137
178341,30,3593,1410,2183,2731,1053,1678,862,357,505
178369,30,1447,889,558,1399,870,529,48,19,29
178387,30,2976,1146,1830,2531,966,1565,445,180,265
178396,30,23092,10590,12502,21831,9992,11839,1261,598,663
178402,30,6762,2761,4001,5713,2274,3439,1049,487,562
178411,30,5668,4378,1290,5054,3888,1166,614,490,124
178420,30,5718,2533,3185,4053,1749,2304,1665,784,881
178448,30,3139,1152,1987,1960,757,1203,1179,395,784
178527,30,44,2,42,33,1,32,11,1,10
178615,30,3318,1325,1993,3186,1273,1913,132,52,80
178624,30,4760,1937,2823,4375,1783,2592,385,154,231
178679,30,555,303,252,455,258,197,100,45,55
178697,30,1468,644,824,1451,639,812,17,5,12
178721,30,7131,3840,3291,3311,1557,1754,3820,2283,1537
178767,30,96,12,84,42,7,35,54,5,49
178828,30,28,9,19,28,9,19,,,
178891,30,1820,1673,147,1329,1223,106,491,450,41
178989,30,259,37,222,259,37,222,,,
179043,30,1921,653,1268,1772,632,1140,149,21,128
179052,30,46,19,27,46,19,27,,,
179159,30,7277,2804,4473,6615,2473,4142,662,331,331
179195,30,33,0,33,33,0,33,,,
179229,30,21,4,17,21,4,17,,,
179256,30,60,32,28,48,26,22,12,6,6
179265,30,254,89,165,252,88,164,2,1,1
179308,30,12011,3955,8056,4762,1865,2897,7249,2090,5159
179326,30,1700,600,1100,1326,516,810,374,84,290
179344,30,922,270,652,637,186,451,285,84,201
179511,30,119,1,118,71,1,70,48,0,48
179539,30,2658,923,1735,1827,624,1203,831,299,532
179548,30,409,0,409,366,0,366,43,0,43
179557,30,7306,2902,4404,6462,2530,3932,844,372,472
179566,30,14210,5740,8470,11985,4701,7284,2225,1039,1186
179645,30,2049,593,1456,1361,415,946,688,178,510
179715,30,1077,261,816,683,204,479,394,57,337
179867,30,7713,3638,4075,7323,3499,3824,390,139,251
179894,30,2327,1018,1309,1881,797,1084,446,221,225
179946,30,650,376,274,639,370,269,11,6,5
179955,30,779,386,393,770,383,387,9,3,6
179964,30,726,199,527,607,178,429,119,21,98
179991,30,38,0,38,38,0,38,,,
180054,30,283,81,202,203,61,142,80,20,60
180063,30,30,1,29,30,1,29,,,
180081,30,312,195,117,266,176,90,46,19,27
180090,30,81,2,79,81,2,79,,,
180106,30,1084,421,663,1062,410,652,22,11,11
180151,30,308,157,151,247,133,114,61,24,37
180160,30,129,45,84,54,22,32,75,23,52
180179,30,2818,1002,1816,1922,775,1147,896,227,669
180197,30,1188,514,674,624,311,313,564,203,361
180203,30,105,45,60,89,38,51,16,7,9
180212,30,462,147,315,321,111,210,141,36,105
180249,30,748,191,557,409,124,285,339,67,272
180258,30,660,241,419,530,212,318,130,29,101
180276,30,637,266,371,322,173,149,315,93,222
180328,30,265,81,184,175,51,124,90,30,60
180373,30,383,124,259,265,100,165,118,24,94
180416,30,1467,895,572,1382,839,543,85,56,29
180461,30,14329,7691,6638,12293,6592,5701,2036,1099,937
180489,30,7026,2957,4069,5754,2439,3315,1272,518,754
180522,30,838,458,380,702,411,291,136,47,89
180595,30,807,413,394,789,405,384,18,8,10
180647,30,561,173,388,463,149,314,98,24,74
180692,30,1283,441,842,1013,378,635,270,63,207
180717,30,35,22,13,32,21,11,3,1,2
180814,30,8378,3767,4611,5729,2526,3203,2649,1241,1408
180832,30,616,73,543,320,37,283,296,36,260
180878,30,560,46,514,381,29,352,179,17,162
180902,30,3477,1319,2158,1642,814,828,1835,505,1330
180948,30,1642,662,980,1441,589,852,201,73,128
180957,30,57,47,10,57,47,10,,,
180984,30,1190,579,611,1176,568,608,14,11,3
181002,30,4455,1815,2640,4359,1776,2583,96,39,57
181020,30,1102,597,505,958,536,422,144,61,83
181127,30,923,425,498,918,422,496,5,3,2
181145,30,19,1,18,19,1,18,,,
181190,30,127,3,124,127,3,124,,,
181215,30,4289,1610,2679,3761,1449,2312,528,161,367
181297,30,857,81,776,572,57,515,285,24,261
181303,30,6467,3047,3420,2244,1132,1112,4223,1915,2308
181312,30,943,375,568,607,292,315,336,83,253
181330,30,1200,605,595,1182,600,582,18,5,13
181394,30,12010,5355,6655,9948,4298,5650,2062,1057,1005
181419,30,218,57,161,74,22,52,144,35,109
181428,30,913,117,796,753,101,652,160,16,144
181446,30,1686,730,956,1589,695,894,97,35,62
181464,30,19448,9826,9622,18435,9238,9197,1013,588,425
181491,30,2493,1175,1318,1831,992,839,662,183,479
181534,30,1415,544,871,1128,464,664,287,80,207
181543,30,24,17,7,16,14,2,8,3,5
181604,30,599,0,599,582,0,582,17,0,17
181640,30,5984,2962,3022,3165,1796,1369,2819,1166,1653
181738,30,574,252,322,553,245,308,21,7,14
181765,30,246,86,160,232,82,150,14,4,10
181783,30,3048,1268,1780,2807,1173,1634,241,95,146
181817,30,978,365,613,644,271,373,334,94,240
181853,30,435,233,202,417,233,184,18,0,18
181880,30,215,9,206,215,9,206,,,
181941,30,362,222,140,362,222,140,,,
182005,30,27817,11226,16591,8922,3804,5118,18895,7422,11473
182148,30,632,138,494,632,138,494,,,
182281,30,24835,10717,14118,19487,8268,11219,5348,2449,2899
182290,30,16274,7635,8639,13993,6534,7459,2281,1101,1180
182306,30,1954,663,1291,804,303,501,1150,360,790
182458,30,276,141,135,261,139,122,15,2,13
182500,30,6307,2613,3694,2375,1020,1355,3932,1593,2339
182564,30,2010,784,1226,772,314,458,1238,470,768
182634,30,780,221,559,757,213,544,23,8,15
182670,30,4533,2296,2237,4532,2295,2237,1,1,0
182704,30,82,1,81,63,1,62,19,0,19
182722,30,158,22,136,117,21,96,41,1,40
182795,30,1277,597,680,1059,519,540,218,78,140
182892,30,53,2,51,37,2,35,16,0,16
182917,30,67,34,33,67,34,33,,,
182953,30,84,3,81,67,2,65,17,1,16
182980,30,1261,568,693,1163,527,636,98,41,57
182999,30,21,0,21,21,0,21,,,
183026,30,119248,43814,75434,35851,13661,22190,83397,30153,53244
183035,30,17,2,15,17,2,15,,,
183044,30,11429,4989,6440,11208,4862,6346,221,127,94
183062,30,2930,1329,1601,2872,1300,1572,58,29,29
183071,30,643,324,319,547,274,273,96,50,46
183080,30,3486,1766,1720,3365,1705,1660,121,61,60
183099,30,2411,870,1541,907,424,483,1504,446,1058
183105,30,501,169,332,184,90,94,317,79,238
183114,30,654,147,507,125,40,85,529,107,422
183123,30,527,257,270,199,119,80,328,138,190
183132,30,1781,813,968,587,355,232,1194,458,736
183141,30,1033,468,565,357,200,157,676,268,408
183150,30,1394,537,857,459,220,239,935,317,618
183202,30,87,6,81,65,4,61,22,2,20
183211,30,1394,307,1087,942,259,683,452,48,404
183239,30,1952,759,1193,1939,755,1184,13,4,9
183248,30,109,22,87,46,11,35,63,11,52
183257,30,1340,389,951,682,191,491,658,198,460
183275,30,89,41,48,89,41,48,,,
183488,30,507,23,484,387,18,369,120,5,115
183600,30,32,0,32,19,0,19,13,0,13
183655,30,4098,1447,2651,1687,681,1006,2411,766,1645
183725,30,479,214,265,404,205,199,75,9,66
183743,30,9587,4483,5104,5475,2731,2744,4112,1752,2360
183789,30,2031,501,1530,1379,384,995,652,117,535
183804,30,3150,3150,0,3129,3129,0,21,21,0
183822,30,1294,503,791,1217,475,742,77,28,49
183859,30,7884,3736,4148,4039,2078,1961,3845,1658,2187
183877,30,5900,2308,3592,2872,1263,1609,3028,1045,1983
183910,30,1624,620,1004,1565,605,960,59,15,44
183938,30,6207,2343,3864,2853,1195,1658,3354,1148,2206
183974,30,1111,405,706,1021,366,655,90,39,51
183983,30,76,71,5,76,71,5,,,
184056,30,618,144,474,396,103,293,222,41,181
184092,30,699,59,640,699,59,640,,,
184180,30,5478,2886,2592,2540,1450,1090,2938,1436,1502
184205,30,1937,643,1294,985,360,625,952,283,669
184348,30,1520,634,886,1509,628,881,11,6,5
184427,30,340,320,20,183,178,5,157,142,15
184481,30,5539,2181,3358,2847,1142,1705,2692,1039,1653
184506,30,107,8,99,76,3,73,31,5,26
184603,30,2515,1131,1384,1877,818,1059,638,313,325
184612,30,1903,520,1383,1740,473,1267,163,47,116
184694,30,2230,950,1280,2145,905,1240,85,45,40
184746,30,92,91,1,78,77,1,14,14,0
184773,30,1314,326,988,1202,302,900,112,24,88
184782,30,14925,7856,7069,13057,6956,6101,1868,900,968
184791,30,4706,1951,2755,2734,1188,1546,1972,763,1209
184816,30,85,4,81,62,2,60,23,2,21
184959,30,678,97,581,320,44,276,358,53,305
184968,30,182,22,160,35,6,29,147,16,131
184995,30,6286,2393,3893,3361,1352,2009,2925,1041,1884
185129,30,5146,2161,2985,4364,1868,2496,782,293,489
185174,30,86,70,16,86,70,16,,,
185262,30,10291,3963,6328,8304,3202,5102,1987,761,1226
185396,30,1550,1497,53,1299,1260,39,251,237,14
185466,30,316,3,313,171,2,169,145,1,144
185509,30,5434,2395,3039,1816,949,867,3618,1446,2172
185536,30,8159,3704,4455,3848,1796,2052,4311,1908,2403
185572,30,4057,1552,2505,3902,1481,2421,155,71,84
185590,30,15993,6185,9808,14335,5461,8874,1658,724,934
185679,30,637,82,555,51,11,40,586,71,515
185721,30,435,127,308,279,95,184,156,32,124
185767,30,199,20,179,101,10,91,98,10,88
185828,30,8377,6306,2071,7287,5430,1857,1090,876,214
185873,30,5965,2552,3413,3226,1482,1744,2739,1070,1669
185970,30,143,9,134,102,7,95,41,2,39
186016,30,466,25,441,278,15,263,188,10,178
186034,30,4623,1722,2901,1672,737,935,2951,985,1966
186052,30,824,694,130,567,486,81,257,208,49
186131,30,5236,2623,2613,5236,2623,2613,,,
186186,30,216,216,0,216,216,0,,,
186201,30,4859,2058,2801,4450,1876,2574,409,182,227
186274,30,200,20,180,110,13,97,90,7,83
186283,30,3174,1329,1845,2996,1248,1748,178,81,97
186371,30,4747,1778,2969,4052,1515,2537,695,263,432
186380,30,35827,17913,17914,34361,17175,17186,1466,738,728
186399,30,8066,3649,4417,7129,3201,3928,937,448,489
186405,30,15,4,11,15,4,11,,,
186423,30,73,7,66,73,7,66,,,
186432,30,2017,761,1256,1911,728,1183,106,33,73
186469,30,878,328,550,485,195,290,393,133,260
186584,30,5924,2712,3212,5795,2632,3163,129,80,49
186593,30,151,24,127,105,15,90,46,9,37
186618,30,688,243,445,590,220,370,98,23,75
186645,30,5387,2713,2674,2388,1254,1134,2999,1459,1540
186867,30,4053,2831,1222,4025,2807,1218,28,24,4
186876,30,8359,3290,5069,7948,3113,4835,411,177,234
186900,30,76,76,0,76,76,0,,,
187000,30,330,316,14,289,277,12,41,39,2
187046,30,8615,5210,3405,76,19,57,8539,5191,3348
187134,30,6848,2948,3900,6693,2868,3825,155,80,75
187198,30,7591,2802,4789,3456,1569,1887,4135,1233,2902
187444,30,7165,2925,4240,5702,2393,3309,1463,532,931
187505,30,732,117,615,732,117,615,,,
187532,30,15275,5739,9536,4475,1892,2583,10800,3847,6953
187596,30,924,331,593,526,206,320,398,125,273
187620,30,4707,1825,2882,2585,1023,1562,2122,802,1320
187639,30,1277,323,954,495,140,355,782,183,599
187648,30,2861,1123,1738,1975,754,1221,886,369,517
187666,30,1169,436,733,610,252,358,559,184,375
187745,30,294,113,181,208,84,124,86,29,57
187897,30,1451,510,941,973,401,572,478,109,369
187903,30,1739,591,1148,817,359,458,922,232,690
187912,30,374,303,71,374,303,71,,,
187958,30,1287,411,876,392,133,259,895,278,617
187967,30,1201,834,367,1134,782,352,67,52,15
187976,30,719,327,392,105,53,52,614,274,340
187985,30,15092,6249,8843,11379,4800,6579,3713,1449,2264
187994,30,461,164,297,212,85,127,249,79,170
188003,30,428,105,323,208,60,148,220,45,175
188021,30,264,67,197,127,38,89,137,29,108
188030,30,10674,4502,6172,9061,3781,5280,1613,721,892
188049,30,1174,424,750,288,92,196,886,332,554
188058,30,876,350,526,491,173,318,385,177,208
188100,30,3911,1189,2722,1346,532,814,2565,657,1908
188137,30,2150,688,1462,623,235,388,1527,453,1074
188182,30,414,232,182,356,194,162,58,38,20
188216,30,344,104,240,228,85,143,116,19,97
188225,30,813,265,548,126,47,79,687,218,469
188261,30,321,233,88,98,56,42,223,177,46
188289,30,67,2,65,62,2,60,5,0,5
188304,30,1528,519,1009,1013,420,593,515,99,416
188340,30,1283,1119,164,1021,884,137,262,235,27
188429,30,5168,1591,3577,4922,1501,3421,246,90,156
188438,30,1975,792,1183,1304,601,703,671,191,480
188517,30,351,144,207,285,129,156,66,15,51
188526,30,639,225,414,636,224,412,3,1,2
188641,30,1460,710,750,1421,686,735,39,24,15
188650,30,140,6,134,140,6,134,,,
188669,30,35,6,29,35,6,29,,,
188678,30,181,66,115,181,66,115,,,
188687,30,412,119,293,79,21,58,333,98,235
188696,30,168,19,149,168,19,149,,,
188854,30,1656,477,1179,1656,477,1179,,,
188890,30,945,903,42,832,793,39,113,110,3
188915,30,35,9,26,19,7,12,16,2,14
188942,30,273,0,273,239,0,239,34,0,34
189088,30,2036,894,1142,1938,821,1117,98,73,25
189097,30,3007,0,3007,2958,0,2958,49,0,49
189219,30,159,147,12,159,147,12,,,
189228,30,1688,537,1151,1173,392,781,515,145,370
189255,30,135,2,133,87,2,85,48,0,48
189273,30,75,75,0,75,75,0,,,
189282,30,290,32,258,257,32,225,33,0,33
189404,30,154,3,151,56,1,55,98,2,96
189413,30,377,58,319,377,58,319,,,
189468,30,210,6,204,126,6,120,84,0,84
189477,30,110,3,107,73,2,71,37,1,36
189547,30,3422,1328,2094,2472,1017,1455,950,311,639
189565,30,455,130,325,382,110,272,73,20,53
189583,30,637,140,497,462,103,359,175,37,138
189592,30,329,90,239,249,82,167,80,8,72
189705,30,1807,885,922,1769,865,904,38,20,18
189714,30,290,11,279,193,9,184,97,2,95
189811,30,813,167,646,813,167,646,,,
189839,30,1276,466,810,803,307,496,473,159,314
189848,30,690,198,492,557,165,392,133,33,100
189857,30,577,577,0,577,577,0,,,
189990,30,590,7,583,163,3,160,427,4,423
190008,30,35,11,24,35,11,24,,,
190044,30,2790,1933,857,2778,1926,852,12,7,5
190053,30,438,185,253,256,119,137,182,66,116
190071,30,100,8,92,17,2,15,83,6,77
190099,30,3153,1416,1737,3142,1408,1734,11,8,3
190114,30,356,92,264,290,61,229,66,31,35
190150,30,8833,4472,4361,8174,4135,4039,659,337,322
190169,30,833,256,577,393,157,236,440,99,341
190239,30,104,1,103,72,1,71,32,0,32
190318,30,247,16,231,230,16,214,17,0,17
190372,30,869,464,405,867,462,405,2,2,0
190415,30,15451,7123,8328,15399,7089,8310,52,34,18
190442,30,1476,556,920,893,370,523,583,186,397
190451,30,252,36,216,82,16,66,170,20,150
190503,30,2854,1449,1405,2724,1373,1351,130,76,54
190512,30,15483,7891,7592,12400,6288,6112,3083,1603,1480
190521,30,18255,7534,10721,12245,5204,7041,6010,2330,3680
190530,30,6602,2714,3888,4481,1887,2594,2121,827,1294
190549,30,12567,5399,7168,9839,4216,5623,2728,1183,1545
190558,30,10392,4759,5633,8366,3849,4517,2026,910,1116
190567,30,11861,5440,6421,9698,4340,5358,2163,1100,1063
190576,30,2703,684,2019,732,178,554,1971,506,1465
190585,30,4930,1493,3437,2601,887,1714,2329,606,1723
190594,30,17293,5868,11425,13679,4536,9143,3614,1332,2282
190600,30,12834,4878,7956,10450,3863,6587,2384,1015,1369
190619,30,7748,3307,4441,5562,2408,3154,2186,899,1287
190628,30,11737,4822,6915,7250,3050,4200,4487,1772,2715
190637,30,11609,3683,7926,7918,2605,5313,3691,1078,2613
190646,30,3824,990,2834,2887,774,2113,937,216,721
190655,30,13490,7424,6066,8928,5232,3696,4562,2192,2370
190664,30,14859,6865,7994,11470,5246,6224,3389,1619,1770
190673,30,9733,4356,5377,6096,2879,3217,3637,1477,2160
190691,30,5595,1853,3742,4017,1325,2692,1578,528,1050
190707,30,14,3,11,14,3,11,,,
190716,30,1388,350,1038,1075,289,786,313,61,252
190725,30,1721,459,1262,1566,423,1143,155,36,119
190752,30,54,54,0,54,54,0,,,
190761,30,1131,382,749,1065,367,698,66,15,51
190840,30,3988,1791,2197,2486,1212,1274,1502,579,923
190956,30,141,10,131,4,0,4,137,10,127
190983,30,632,194,438,610,188,422,22,6,16
191083,30,6368,3005,3363,4636,2285,2351,1732,720,1012
191126,30,7660,1278,6382,6857,1111,5746,803,167,636
191199,30,2975,1238,1737,1987,881,1106,988,357,631
191205,30,523,362,161,496,344,152,27,18,9
191241,30,9669,3969,5700,9403,3852,5551,266,117,149
191302,30,995,426,569,585,266,319,410,160,250
191311,30,81,35,46,81,35,46,,,
191339,30,2192,757,1435,1383,560,823,809,197,612
191515,30,2049,942,1107,2048,941,1107,1,1,0
191533,30,1159,487,672,1135,472,663,24,15,9
191597,30,557,75,482,270,37,233,287,38,249
191612,30,1325,535,790,1034,409,625,291,126,165
191621,30,723,313,410,700,302,398,23,11,12
191630,30,1639,796,843,1621,786,835,18,10,8
191649,30,6004,2579,3425,5730,2442,3288,274,137,137
191676,30,841,310,531,807,297,510,34,13,21
191719,30,6103,3062,3041,4152,2278,1874,1951,784,1167
191728,30,1015,198,817,698,147,551,317,51,266
191931,30,2667,1265,1402,2618,1231,1387,49,34,15
191940,30,213,22,191,213,22,191,,,
191959,30,52,40,12,52,40,12,,,
191968,30,4778,2138,2640,4716,2107,2609,62,31,31
191986,30,1702,643,1059,1275,531,744,427,112,315
192004,30,287,74,213,282,73,209,5,1,4
192022,30,1664,606,1058,1193,457,736,471,149,322
192040,30,144,63,81,144,63,81,,,
192110,30,487,259,228,487,259,228,,,
192165,30,175,175,0,175,175,0,,,
192192,30,1118,287,831,1033,267,766,85,20,65
192271,30,1203,133,1070,1128,123,1005,75,10,65
192323,30,2604,989,1615,2290,926,1364,314,63,251
192448,30,5909,1872,4037,5333,1759,3574,576,113,463
192484,30,136,2,134,74,0,74,62,2,60
192509,30,939,146,793,874,139,735,65,7,58
192624,30,172,172,0,172,172,0,,,
192688,30,457,64,393,369,54,315,88,10,78
192703,30,3166,1802,1364,3016,1688,1328,150,114,36
192712,30,489,253,236,484,252,232,5,1,4
192749,30,1326,520,806,1289,506,783,37,14,23
192785,30,715,81,634,142,25,117,573,56,517
192800,30,20,0,20,7,0,7,13,0,13
192819,30,5097,2157,2940,4880,2035,2845,217,122,95
192864,30,1713,319,1394,1524,311,1213,189,8,181
192925,30,1276,338,938,1139,325,814,137,13,124
192961,30,130,21,109,2,1,1,128,20,108
192970,30,18,5,13,18,5,13,,,
193016,30,5860,1755,4105,5039,1456,3583,821,299,522
193052,30,369,369,0,369,369,0,,,
193061,30,46,46,0,46,46,0,,,
193070,30,44,44,0,44,44,0,,,
193186,30,92,2,90,53,1,52,39,1,38
193201,30,476,46,430,476,46,430,,,
193247,30,125,125,0,125,125,0,,,
193265,30,90,82,8,72,66,6,18,16,2
193283,30,2856,1273,1583,2120,1005,1115,736,268,468
193292,30,3248,905,2343,2649,782,1867,599,123,476
193308,30,5976,2181,3795,3987,1728,2259,1989,453,1536
193326,30,8002,3370,4632,4657,2090,2567,3345,1280,2065
193353,30,1560,443,1117,1275,367,908,285,76,209
193380,30,116,17,99,,,,116,17,99
193399,30,2253,516,1737,2123,498,1625,130,18,112
193478,30,11075,5393,5682,6565,3392,3173,4510,2001,2509
193584,30,2050,539,1511,1995,521,1474,55,18,37
193609,30,81,28,53,81,28,53,,,
193654,30,7373,1791,5582,6792,1645,5147,581,146,435
193672,30,14,11,3,14,11,3,,,
193858,30,298,21,277,298,21,277,,,
193900,30,28556,11932,16624,27561,11481,16080,995,451,544
193946,30,2999,1188,1811,2192,927,1265,807,261,546
193973,30,2764,983,1781,2698,958,1740,66,25,41
193991,30,47,1,46,33,1,32,14,0,14
194028,30,764,236,528,530,174,356,234,62,172
194091,30,3345,1993,1352,3007,1772,1235,338,221,117
194116,30,444,44,400,120,18,102,324,26,298
194161,30,975,406,569,782,307,475,193,99,94
194189,30,85,85,0,85,85,0,,,
194222,30,4226,1905,2321,2914,1436,1478,1312,469,843
194240,30,3702,1409,2293,1939,860,1079,1763,549,1214
194259,30,32,2,30,32,2,30,,,
194310,30,7820,2660,5160,7453,2484,4969,367,176,191
194392,30,707,459,248,697,453,244,10,6,4
194435,30,55,2,53,52,2,50,3,0,3
194499,30,873,175,698,873,175,698,,,
194569,30,95,56,39,62,33,29,33,23,10
194578,30,3869,1075,2794,3767,1032,2735,102,43,59
194657,30,167,167,0,167,167,0,,,
194666,30,407,407,0,407,407,0,,,
194693,30,51,51,0,51,51,0,,,
194718,30,49,49,0,49,49,0,,,
194736,30,157,157,0,157,157,0,,,
194763,30,415,415,0,415,415,0,,,
194824,30,5579,3852,1727,5564,3842,1722,15,10,5
194958,30,1085,340,745,1017,321,696,68,19,49
195003,30,13085,8641,4444,12733,8401,4332,352,240,112
195030,30,6417,3108,3309,6236,3062,3174,181,46,135
195058,30,4223,1923,2300,2563,1317,1246,1660,606,1054
195067,30,307,20,287,235,18,217,72,2,70
195128,30,1192,315,877,1149,305,844,43,10,33
195164,30,1742,956,786,1724,947,777,18,9,9
195173,30,2364,840,1524,2263,791,1472,101,49,52
195191,30,387,51,336,254,25,229,133,26,107
195216,30,2227,1030,1197,2220,1025,1195,7,5,2
195234,30,1778,597,1181,1720,569,1151,58,28,30
195243,30,1051,562,489,1020,539,481,31,23,8
195289,30,144,19,125,9,2,7,135,17,118
195304,30,1499,326,1173,1486,323,1163,13,3,10
195322,30,1569,641,928,1006,450,556,563,191,372
195438,30,200,200,0,200,200,0,,,
195474,30,3454,1525,1929,3393,1497,1896,61,28,33
195526,30,2676,1095,1581,2650,1082,1568,26,13,13
195544,30,3753,1161,2592,3350,1064,2286,403,97,306
195702,30,137,16,121,75,12,63,62,4,58
195720,30,2586,1084,1502,2491,1050,1441,95,34,61
195784,30,710,82,628,710,82,628,,,
195809,30,10058,4472,5586,9875,4370,5505,183,102,81
195988,30,833,355,478,509,241,268,324,114,210
196006,30,3400,2136,1264,3091,2049,1042,309,87,222
196015,30,2778,1215,1563,2351,1063,1288,427,152,275
196024,30,2486,1152,1334,1971,1050,921,515,102,413
196033,30,1806,802,1004,1682,743,939,124,59,65
196042,30,8918,5265,3653,7237,4292,2945,1681,973,708
196051,30,1939,895,1044,1641,837,804,298,58,240
196060,30,12556,5836,6720,11787,5417,6370,769,419,350
196079,30,14303,6967,7336,13963,6754,7209,340,213,127
196088,30,21303,11554,9749,19751,10807,8944,1552,747,805
196097,30,17900,8773,9127,16633,8120,8513,1267,653,614
196103,30,1576,803,773,1255,647,608,321,156,165
196112,30,1924,1344,580,1732,1237,495,192,107,85
196121,30,5668,2268,3400,4878,1991,2887,790,277,513
196130,30,6024,2604,3420,5374,2267,3107,650,337,313
196149,30,5974,2624,3350,5816,2526,3290,158,98,60
196158,30,3540,1473,2067,3449,1422,2027,91,51,40
196167,30,4448,1619,2829,4288,1544,2744,160,75,85
196176,30,6142,2252,3890,5619,1994,3625,523,258,265
196185,30,5374,2088,3286,5237,2020,3217,137,68,69
196194,30,6095,2880,3215,5669,2674,2995,426,206,220
196200,30,2346,881,1465,2250,838,1412,96,43,53
196219,30,3369,1382,1987,3130,1258,1872,239,124,115
196237,30,3936,1563,2373,3384,1320,2064,552,243,309
196246,30,4286,1720,2566,3853,1565,2288,433,155,278
196255,30,193,40,153,174,39,135,19,1,18
196264,30,7289,2567,4722,3209,944,2265,4080,1623,2457
196291,30,1399,1201,198,1300,1107,193,99,94,5
196307,30,191,37,154,131,26,105,60,11,49
196389,30,900,182,718,885,178,707,15,4,11
196413,30,14515,6572,7943,14072,6345,7727,443,227,216
196431,30,384,384,0,382,382,0,2,2,0
196440,30,14,14,0,14,14,0,,,
196565,30,1365,496,869,859,353,506,506,143,363
196583,30,39,39,0,39,39,0,,,
196592,30,4329,1336,2993,3324,1072,2252,1005,264,741
196653,30,1048,124,924,424,58,366,624,66,558
196680,30,15260,8002,7258,,,,15260,8002,7258
196699,30,1340,545,795,756,350,406,584,195,389
196866,30,2072,1139,933,2065,1132,933,7,7,0
197018,30,1985,1985,0,1985,1985,0,,,
197027,30,1006,788,218,1006,788,218,,,
197036,30,4348,3328,1020,4348,3328,1020,,,
197045,30,2810,1171,1639,2373,1011,1362,437,160,277
197133,30,2500,963,1537,2492,960,1532,8,3,5
197142,30,448,215,233,387,192,195,61,23,38
197151,30,3521,963,2558,3447,932,2515,74,31,43
197197,30,1562,566,996,1514,550,964,48,16,32
197221,30,105,78,27,105,78,27,,,
197230,30,341,134,207,335,131,204,6,3,3
197285,30,750,224,526,678,201,477,72,23,49
197294,30,7917,3653,4264,4214,2086,2128,3703,1567,2136
197337,30,65,0,65,59,0,59,6,0,6
197531,30,461,219,242,461,219,242,,,
197601,30,129,129,0,129,129,0,,,
197647,30,109,109,0,109,109,0,,,
197674,30,176,176,0,176,176,0,,,
197692,30,68,68,0,68,68,0,,,
197708,30,2583,1411,1172,2536,1376,1160,47,35,12
197735,30,744,744,0,744,744,0,,,
197744,30,174,174,0,174,174,0,,,
197814,30,1255,372,883,503,169,334,752,203,549
197850,30,1497,522,975,476,219,257,1021,303,718
197869,30,18486,7996,10490,17381,7505,9876,1105,491,614
197887,30,4111,1511,2600,1419,598,821,2692,913,1779
197911,30,1045,506,539,1010,500,510,35,6,29
197966,30,1401,429,972,402,125,277,999,304,695
197984,30,1426,748,678,1362,725,637,64,23,41
197993,30,207,0,207,181,0,181,26,0,26
198011,30,908,288,620,217,65,152,691,223,468
198039,30,1830,688,1142,669,276,393,1161,412,749
198066,30,769,453,316,743,438,305,26,15,11
198084,30,1074,406,668,490,216,274,584,190,394
198109,30,438,28,410,145,9,136,293,19,274
198118,30,2195,865,1330,959,428,531,1236,437,799
198136,30,3313,1574,1739,2765,1250,1515,548,324,224
198154,30,8904,3673,5231,3281,1487,1794,5623,2186,3437
198206,30,1202,374,828,376,130,246,826,244,582
198215,30,1132,545,587,1044,517,527,88,28,60
198233,30,3030,1306,1724,1043,490,553,1987,816,1171
198251,30,3014,1058,1956,1189,497,692,1825,561,1264
198260,30,13449,5655,7794,5906,2544,3362,7543,3111,4432
198303,30,920,531,389,887,518,369,33,13,20
198321,30,1536,570,966,697,274,423,839,296,543
198330,30,2796,1056,1740,1457,546,911,1339,510,829
198367,30,1995,827,1168,629,314,315,1366,513,853
198376,30,2459,778,1681,1162,439,723,1297,339,958
198385,30,1970,930,1040,1970,930,1040,,,
198419,30,6815,3297,3518,6789,3283,3506,26,14,12
198455,30,3276,1233,2043,648,302,346,2628,931,1697
198464,30,21231,8954,12277,18228,7678,10550,3003,1276,1727
198491,30,1391,304,1087,300,66,234,1091,238,853
198507,30,1807,749,1058,1618,692,926,189,57,132
198516,30,6302,2535,3767,6125,2461,3664,177,74,103
198534,30,8332,3011,5321,3374,1292,2082,4958,1719,3239
198543,30,4986,1469,3517,3501,1070,2431,1485,399,1086
198552,30,6465,2310,4155,2601,1103,1498,3864,1207,2657
198561,30,1980,700,1280,1669,647,1022,311,53,258
198570,30,3034,1022,2012,1035,425,610,1999,597,1402
198598,30,608,365,243,592,354,238,16,11,5
198613,30,1025,501,524,981,486,495,44,15,29
198622,30,8280,3397,4883,3452,1521,1931,4828,1876,2952
198640,30,498,123,375,162,52,110,336,71,265
198668,30,824,281,543,405,158,247,419,123,296
198677,30,30,11,19,17,5,12,13,6,7
198695,30,4871,2155,2716,4849,2142,2707,22,13,9
198710,30,1115,404,711,496,201,295,619,203,416
198729,30,1027,308,719,370,130,240,657,178,479
198756,30,1122,477,645,1063,450,613,59,27,32
198774,30,2682,954,1728,1225,482,743,1457,472,985
198808,30,869,302,567,840,294,546,29,8,21
198817,30,1454,469,985,552,235,317,902,234,668
198835,30,1458,620,838,1365,603,762,93,17,76
198844,30,135,4,131,133,4,129,2,0,2
198862,30,890,491,399,869,482,387,21,9,12
198871,30,501,373,128,474,352,122,27,21,6
198899,30,1017,503,514,965,486,479,52,17,35
198905,30,380,96,284,238,59,179,142,37,105
198914,30,433,155,278,207,70,137,226,85,141
198923,30,431,172,259,257,116,141,174,56,118
198950,30,1411,0,1411,1372,0,1372,39,0,39
198969,30,1512,833,679,1374,767,607,138,66,72
198978,30,1860,358,1502,1822,352,1470,38,6,32
198987,30,1844,745,1099,809,345,464,1035,400,635
199005,30,32,0,32,32,0,32,,,
199023,30,519,241,278,188,112,76,331,129,202
199032,30,851,464,387,743,417,326,108,47,61
199069,30,1891,668,1223,1221,496,725,670,172,498
199078,30,175,22,153,165,21,144,10,1,9
199087,30,1750,701,1049,708,294,414,1042,407,635
199102,30,11327,4410,6917,10253,3897,6356,1074,513,561
199111,30,3084,1325,1759,2775,1162,1613,309,163,146
199120,30,19722,7815,11907,18916,7452,11464,806,363,443
199139,30,23708,12443,11265,20555,10745,9810,3153,1698,1455
199148,30,14889,4935,9954,12524,4140,8384,2365,795,1570
199157,30,5323,1545,3778,4617,1385,3232,706,160,546
199184,30,935,364,571,911,352,559,24,12,12
199193,30,24999,12645,12354,23285,11656,11629,1714,989,725
199209,30,1362,656,706,1189,610,579,173,46,127
199218,30,14161,4946,9215,11670,4341,7329,2491,605,1886
199263,30,198,48,150,41,6,35,157,42,115
199272,30,666,326,340,609,309,300,57,17,40
199281,30,6179,2325,3854,4720,1835,2885,1459,490,969
199306,30,744,315,429,719,302,417,25,13,12
199324,30,726,269,457,113,46,67,613,223,390
199333,30,5327,1886,3441,2255,926,1329,3072,960,2112
199412,30,1418,505,913,1338,482,856,80,23,57
199421,30,1409,465,944,536,192,344,873,273,600
199449,30,1329,426,903,549,203,346,780,223,557
199458,30,133,86,47,122,77,45,11,9,2
199467,30,562,133,429,133,39,94,429,94,335
199476,30,1381,359,1022,663,194,469,718,165,553
199485,30,1277,434,843,443,182,261,834,252,582
199494,30,4404,1544,2860,1672,683,989,2732,861,1871
199582,30,1239,701,538,862,499,363,377,202,175
199607,30,348,7,341,276,0,276,72,7,65
199625,30,883,254,629,336,121,215,547,133,414
199634,30,2608,906,1702,1048,420,628,1560,486,1074
199643,30,986,426,560,882,402,480,104,24,80
199689,30,190,9,181,155,4,151,35,5,30
199698,30,876,402,474,846,395,451,30,7,23
199722,30,855,301,554,276,127,149,579,174,405
199731,30,1650,508,1142,541,184,357,1109,324,785
199740,30,1638,395,1243,516,157,359,1122,238,884
199759,30,529,366,163,287,190,97,242,176,66
199768,30,1682,616,1066,635,262,373,1047,354,693
199786,30,2656,1009,1647,933,384,549,1723,625,1098
199795,30,481,172,309,219,83,136,262,89,173
199838,30,1744,503,1241,602,217,385,1142,286,856
199847,30,5465,2497,2968,5387,2465,2922,78,32,46
199856,30,18327,8217,10110,6358,3155,3203,11969,5062,6907
199865,30,718,243,475,714,241,473,4,2,2
199883,30,144,13,131,144,13,131,,,
199892,30,2522,973,1549,690,308,382,1832,665,1167
199908,30,1059,359,700,385,157,228,674,202,472
199926,30,1321,537,784,665,322,343,656,215,441
199953,30,936,257,679,317,112,205,619,145,474
199962,30,2480,1027,1453,2408,991,1417,72,36,36
199971,30,65,35,30,65,35,30,,,
199980,30,26,23,3,26,23,3,,,
199999,30,4581,1093,3488,3939,980,2959,642,113,529
200004,30,9980,4398,5582,8205,3693,4512,1775,705,1070
200013,30,575,86,489,310,38,272,265,48,217
200022,30,2613,1500,1113,1809,1037,772,804,463,341
200059,30,1166,520,646,983,453,530,183,67,116
200086,30,155,51,104,124,42,82,31,9,22
200110,30,36,0,36,36,0,36,,,
200156,30,992,565,427,964,542,422,28,23,5
200192,30,550,243,307,401,192,209,149,51,98
200208,30,223,60,163,106,42,64,117,18,99
200217,30,2185,897,1288,1854,757,1097,331,140,191
200226,30,866,352,514,619,286,333,247,66,181
200253,30,2248,819,1429,1837,699,1138,411,120,291
200280,30,8998,5048,3950,6970,3684,3286,2028,1364,664
200305,30,1778,1105,673,1463,973,490,315,132,183
200314,30,490,142,348,343,109,234,147,33,114
200332,30,9932,4944,4988,8987,4590,4397,945,354,591
200341,30,669,232,437,557,206,351,112,26,86
200466,30,216,75,141,184,68,116,32,7,25
200484,30,144,70,74,121,62,59,23,8,15
200527,30,383,168,215,352,156,196,31,12,19
200554,30,448,174,274,423,162,261,25,12,13
200572,30,942,450,492,721,358,363,221,92,129
200590,30,129,24,105,109,12,97,20,12,8
200785,30,410,43,367,199,23,176,211,20,191
200800,30,11096,5893,5203,9327,4968,4359,1769,925,844
200846,30,725,300,425,581,245,336,144,55,89
200873,30,74,31,43,62,26,36,12,5,7
201034,30,536,301,235,120,35,85,416,266,150
201061,30,233,68,165,221,63,158,12,5,7
201098,30,47,24,23,30,13,17,17,11,6
201104,30,2991,1469,1522,2144,936,1208,847,533,314
201131,30,105,39,66,55,1,54,50,38,12
201140,30,35,32,3,,,,35,32,3
201159,30,99,82,17,57,46,11,42,36,6
201177,30,251,22,229,103,10,93,148,12,136
201195,30,2808,1246,1562,2667,1184,1483,141,62,79
201283,30,486,187,299,283,124,159,203,63,140
201371,30,718,394,324,700,388,312,18,6,12
201432,30,1138,395,743,854,311,543,284,84,200
201441,30,12779,5590,7189,11843,5062,6781,936,528,408
201469,30,619,154,465,470,124,346,149,30,119
201478,30,190,54,136,143,10,133,47,44,3
201496,30,448,277,171,448,277,171,,,
201539,30,84,13,71,73,7,66,11,6,5
201548,30,2045,802,1243,1990,776,1214,55,26,29
201645,30,5697,2998,2699,5646,2969,2677,51,29,22
201654,30,3613,1636,1977,3576,1619,1957,37,17,20
201672,30,1670,378,1292,421,112,309,1249,266,983
201681,30,44,3,41,44,3,41,,,
201690,30,6017,1758,4259,3202,1061,2141,2815,697,2118
201751,30,61,13,48,22,6,16,39,7,32
201803,30,52,4,48,52,4,48,,,
201821,30,870,66,804,608,45,563,262,21,241
201867,30,104,15,89,104,15,89,,,
201885,30,27188,13524,13664,23973,12329,11644,3215,1195,2020
201928,30,5550,2195,3355,1805,788,1017,3745,1407,2338
201946,30,2133,776,1357,1073,469,604,1060,307,753
201955,30,3965,1481,2484,2751,1090,1661,1214,391,823
201964,30,1155,462,693,846,373,473,309,89,220
201973,30,3330,1015,2315,835,308,527,2495,707,1788
202046,30,574,153,421,570,150,420,4,3,1
202073,30,208,102,106,208,102,106,,,
202134,30,10208,4551,5657,8205,3693,4512,2003,858,1145
202152,30,179,12,167,179,12,167,,,
202170,30,975,291,684,962,285,677,13,6,7
202222,30,16911,7874,9037,5384,2508,2876,11527,5366,6161
202356,30,13276,4977,8299,4001,1743,2258,9275,3234,6041
202435,30,102,18,84,61,9,52,41,9,32
202453,30,73,60,13,63,52,11,10,8,2
202480,30,8555,4473,4082,8265,4318,3947,290,155,135
202514,30,516,311,205,495,300,195,21,11,10
202523,30,2312,1101,1211,2307,1097,1210,5,4,1
202648,30,1724,610,1114,661,302,359,1063,308,755
202657,30,371,112,259,51,12,39,320,100,220
202763,30,2204,714,1490,2127,689,1438,77,25,52
202806,30,4444,1809,2635,1388,556,832,3056,1253,1803
202888,30,40,1,39,20,1,19,20,0,20
202903,30,221,112,109,147,71,76,74,41,33
202912,30,282,16,266,118,6,112,164,10,154
202949,30,166,150,16,166,150,16,,,
202985,30,54,4,50,44,4,40,10,0,10
203030,30,53,6,47,53,6,47,,,
203085,30,1036,531,505,1014,516,498,22,15,7
203128,30,849,401,448,780,373,407,69,28,41
203146,30,359,327,32,359,327,32,,,
203155,30,1690,925,765,1349,787,562,341,138,203
203234,30,96,6,90,96,6,90,,,
203289,30,55,43,12,55,43,12,,,
203331,30,43555,13726,29829,13334,4256,9078,30221,9470,20751
203368,30,2609,1435,1174,2566,1404,1162,43,31,12
203386,30,2541,179,2362,1819,118,1701,722,61,661
203438,30,106,3,103,51,1,50,55,2,53
203447,30,1468,555,913,169,57,112,1299,498,801
203456,30,729,238,491,27,7,20,702,231,471
203465,30,3712,1419,2293,1083,432,651,2629,987,1642
203474,30,1744,674,1070,399,132,267,1345,542,803
203483,30,1627,650,977,428,166,262,1199,484,715
203492,30,1173,296,877,269,42,227,904,254,650
203517,30,20136,7576,12560,16862,6188,10674,3274,1388,1886
203526,30,1668,603,1065,274,98,176,1394,505,889
203535,30,1868,853,1015,1868,853,1015,,,
203544,30,567,79,488,392,53,339,175,26,149
203580,30,644,362,282,608,350,258,36,12,24
203599,30,3524,1298,2226,1131,538,593,2393,760,1633
203614,30,454,89,365,454,89,365,,,
203678,30,1390,355,1035,448,153,295,942,202,740
203720,30,183,95,88,149,90,59,34,5,29
203739,30,54,7,47,28,5,23,26,2,24
203748,30,5919,2126,3793,1895,754,1141,4024,1372,2652
203757,30,811,361,450,731,337,394,80,24,56
203775,30,882,362,520,791,324,467,91,38,53
203845,30,1124,576,548,1104,563,541,20,13,7
203881,30,1371,643,728,331,113,218,1040,530,510
203942,30,34,16,18,34,16,18,,,
203960,30,1215,135,1080,306,43,263,909,92,817
204006,30,2117,1041,1076,1588,754,834,529,287,242
204015,30,1152,546,606,874,401,473,278,145,133
204024,30,16868,8235,8633,16577,8063,8514,291,172,119
204121,30,67,0,67,28,0,28,39,0,39
204158,30,157,47,110,157,47,110,,,
204176,30,621,77,544,433,53,380,188,24,164
204185,30,1865,956,909,1852,951,901,13,5,8
204194,30,1490,598,892,1319,551,768,171,47,124
204200,30,1087,506,581,1009,480,529,78,26,52
204255,30,886,389,497,620,294,326,266,95,171
204264,30,1501,684,817,1337,654,683,164,30,134
204334,30,131,3,128,1,0,1,130,3,127
204422,30,1399,518,881,509,196,313,890,322,568
204431,30,45,9,36,45,9,36,,,
204440,30,966,408,558,354,168,186,612,240,372
204459,30,20,14,6,20,14,6,,,
204468,30,1141,559,582,939,504,435,202,55,147
204486,30,2687,2277,410,2526,2166,360,161,111,50
204501,30,2942,1224,1718,2905,1212,1693,37,12,25
204608,30,470,419,51,470,419,51,,,
204617,30,823,411,412,751,380,371,72,31,41
204635,30,2187,1237,950,2152,1206,946,35,31,4
204662,30,459,202,257,411,174,237,48,28,20
204671,30,780,317,463,705,283,422,75,34,41
204680,30,820,377,443,738,344,394,82,33,49
204699,30,968,482,486,856,428,428,112,54,58
204705,30,2612,1335,1277,2244,1129,1115,368,206,162
204714,30,84,7,77,84,7,77,,,
204723,30,299,230,69,299,230,69,,,
204769,30,157,7,150,157,7,150,,,
204778,30,89,2,87,89,2,87,,,
204796,30,45986,23099,22887,42905,21474,21431,3081,1625,1456
204802,30,268,97,171,214,70,144,54,27,27
204820,30,965,345,620,690,232,458,275,113,162
204839,30,718,230,488,593,185,408,125,45,80
204848,30,693,257,436,491,176,315,202,81,121
204857,30,17899,7100,10799,14268,6284,7984,3631,816,2815
204866,30,673,153,520,528,121,407,145,32,113
204884,30,133,8,125,133,8,125,,,
204893,30,35,6,29,12,4,8,23,2,21
204909,30,1338,597,741,1332,594,738,6,3,3
204936,30,2180,878,1302,2083,841,1242,97,37,60
204945,30,4499,1671,2828,1782,743,1039,2717,928,1789
204963,30,41,2,39,40,2,38,1,0,1
204981,30,156,39,117,24,6,18,132,33,99
205027,30,32,32,0,32,32,0,,,
205054,30,349,29,320,349,29,320,,,
205090,30,74,4,70,9,2,7,65,2,63
205124,30,51,51,0,51,51,0,,,
205142,30,164,45,119,158,45,113,6,0,6
205179,30,491,93,398,471,90,381,20,3,17
205203,30,868,316,552,534,253,281,334,63,271
205391,30,195,47,148,108,26,82,87,21,66
205443,30,2537,1135,1402,2127,973,1154,410,162,248
205470,30,14334,6910,7424,3271,1656,1615,11063,5254,5809
205559,30,57,14,43,57,14,43,,,
205841,30,6992,2861,4131,2464,1182,1282,4528,1679,2849
205887,30,482,69,413,482,69,413,,,
205957,30,2443,1018,1425,2289,959,1330,154,59,95
205966,30,795,237,558,309,111,198,486,126,360
206011,30,1108,597,511,443,229,214,665,368,297
206039,30,48,0,48,32,0,32,16,0,16
206048,30,1824,907,917,1510,792,718,314,115,199
206084,30,12016,5895,6121,10629,5185,5444,1387,710,677
206154,30,23,17,6,3,2,1,20,15,5
206172,30,17,2,15,17,2,15,,,
206181,30,160,30,130,56,7,49,104,23,81
206279,30,489,260,229,212,105,107,277,155,122
206321,30,82,27,55,55,3,52,27,24,3
206349,30,657,46,611,566,39,527,91,7,84
206394,30,47,10,37,28,7,21,19,3,16
206437,30,1503,680,823,1364,637,727,139,43,96
206446,30,957,315,642,456,201,255,501,114,387
206491,30,528,216,312,381,153,228,147,63,84
206507,30,1027,461,566,982,445,537,45,16,29
206525,30,1256,574,682,1230,563,667,26,11,15
206589,30,1960,898,1062,1946,887,1059,14,11,3
206604,30,6879,3110,3769,5517,2484,3033,1362,626,736
206613,30,1094,458,636,748,308,440,346,150,196
206622,30,5125,2227,2898,4879,2114,2765,246,113,133
206695,30,8306,3750,4556,7327,3340,3987,979,410,569
206817,30,266,137,129,245,131,114,21,6,15
206835,30,780,403,377,604,336,268,176,67,109
206862,30,1479,656,823,1258,583,675,221,73,148
206905,30,74,36,38,60,23,37,14,13,1
206914,30,2792,993,1799,2070,759,1311,722,234,488
206923,30,1245,372,873,769,272,497,476,100,376
206932,30,433,47,386,413,44,369,20,3,17
206941,30,11420,4300,7120,8585,3189,5396,2835,1111,1724
206996,30,1500,436,1064,968,312,656,532,124,408
207041,30,2552,1066,1486,2162,931,1231,390,135,255
207050,30,1003,332,671,624,240,384,379,92,287
207069,30,781,288,493,415,182,233,366,106,260
207087,30,25,2,23,25,2,23,,,
207102,30,62,12,50,62,12,50,,,
207157,30,279,157,122,232,139,93,47,18,29
207209,30,1814,672,1142,1708,630,1078,106,42,64
207236,30,1188,377,811,645,259,386,543,118,425
207254,30,684,608,76,684,608,76,,,
207263,30,5212,1875,3337,3817,1446,2371,1395,429,966
207281,30,1913,714,1199,1209,513,696,704,201,503
207290,30,1522,664,858,1222,583,639,300,81,219
207306,30,1408,585,823,1215,514,701,193,71,122
207324,30,1736,788,948,1622,755,867,114,33,81
207342,30,853,101,752,822,94,728,31,7,24
207351,30,1181,537,644,912,468,444,269,69,200
207388,30,19841,9543,10298,17729,8587,9142,2112,956,1156
207397,30,3711,1300,2411,984,431,553,2727,869,1858
207403,30,1407,609,798,1332,554,778,75,55,20
207449,30,9759,3525,6234,3102,1236,1866,6657,2289,4368
207458,30,1425,478,947,1381,458,923,44,20,24
207500,30,20800,10142,10658,18220,8894,9326,2580,1248,1332
207564,30,1987,1381,606,1350,1030,320,637,351,286
207582,30,3186,1221,1965,2748,1046,1702,438,175,263
207661,30,2591,976,1615,1901,722,1179,690,254,436
207670,30,4694,1595,3099,2201,860,1341,2493,735,1758
207704,30,158,4,154,75,2,73,83,2,81
207722,30,841,300,541,780,278,502,61,22,39
207740,30,1143,350,793,723,258,465,420,92,328
207786,30,24,1,23,24,1,23,,,
207847,30,2832,1257,1575,2068,961,1107,764,296,468
207856,30,456,259,197,410,230,180,46,29,17
207865,30,3541,1392,2149,3021,1231,1790,520,161,359
207935,30,11810,4275,7535,4436,1840,2596,7374,2435,4939
207962,30,706,622,84,706,622,84,,,
207971,30,2698,1365,1333,2598,1319,1279,100,46,54
208035,30,937,293,644,493,227,266,444,66,378
208044,30,55,5,50,55,5,50,,,
208053,30,71,34,37,12,1,11,59,33,26
208275,30,921,343,578,572,253,319,349,90,259
208318,30,3459,1540,1919,1714,809,905,1745,731,1014
208390,30,6524,2867,3657,3049,1275,1774,3475,1592,1883
208406,30,4578,2305,2273,1575,741,834,3003,1564,1439
208415,30,503,195,308,231,89,142,272,106,166
208433,30,79,3,76,79,3,76,,,
208479,30,464,66,398,464,66,398,,,
208512,30,401,69,332,401,69,332,,,
208637,30,198,42,156,,,,198,42,156
208646,30,2397,976,1421,1511,620,891,886,356,530
208725,30,40,22,18,37,20,17,3,2,1
208822,30,2545,987,1558,2341,909,1432,204,78,126
208859,30,38,5,33,38,5,33,,,
209038,30,5932,2753,3179,2674,1242,1432,3258,1511,1747
209056,30,2096,758,1338,2088,751,1337,8,7,1
209065,30,1273,504,769,1233,486,747,40,18,22
209074,30,4162,1839,2323,1564,718,846,2598,1121,1477
209083,30,98,25,73,98,25,73,,,
209153,30,27,3,24,27,3,24,,,
209205,30,35,2,33,35,2,33,,,
209241,30,29,29,0,28,28,0,1,1,0
209250,30,3380,1351,2029,1657,736,921,1723,615,1108
209287,30,334,188,146,289,173,116,45,15,30
209296,30,32,8,24,32,8,24,,,
209409,30,470,193,277,401,175,226,69,18,51
209490,30,783,147,636,483,94,389,300,53,247
209506,30,3257,1701,1556,2205,1172,1033,1052,529,523
209542,30,27038,14092,12946,18676,9827,8849,8362,4265,4097
209551,30,18489,8208,10281,17165,7589,9576,1324,619,705
209603,30,384,108,276,356,101,255,28,7,21
209612,30,1638,644,994,1584,615,969,54,29,25
209667,30,58,4,54,58,4,54,,,
209676,30,92,15,77,92,15,77,,,
209694,30,42,7,35,42,7,35,,,
209700,30,210,19,191,210,19,191,,,
209719,30,63,0,63,63,0,63,,,
209746,30,19609,8292,11317,8147,3593,4554,11462,4699,6763
209807,30,15674,6862,8812,11891,5123,6768,3783,1739,2044
209825,30,3565,1349,2216,3483,1321,2162,82,28,54
209922,30,1521,633,888,1511,630,881,10,3,7
209940,30,3020,1177,1843,1044,408,636,1976,769,1207
210146,30,3208,1290,1918,2457,1013,1444,751,277,474
210155,30,1193,457,736,759,342,417,434,115,319
210234,30,1133,495,638,703,342,361,430,153,277
210270,30,1919,727,1192,746,298,448,1173,429,744
210304,30,406,135,271,383,124,259,23,11,12
210331,30,861,381,480,690,290,400,171,91,80
210340,30,46,7,39,46,7,39,,,
210401,30,1186,504,682,1159,491,668,27,13,14
210429,30,3587,1166,2421,3046,986,2060,541,180,361
210492,30,241,122,119,226,114,112,15,8,7
210571,30,1366,613,753,1309,590,719,57,23,34
210599,30,733,376,357,733,376,357,,,
210605,30,10617,4876,5741,3656,1723,1933,6961,3153,3808
210669,30,1538,714,824,1525,707,818,13,7,6
210711,30,39,1,38,39,1,38,,,
210739,30,2265,827,1438,1941,730,1211,324,97,227
210748,30,92,1,91,39,1,38,53,0,53
210775,30,2025,689,1336,1641,615,1026,384,74,310
210784,30,137,2,135,117,2,115,20,0,20
210809,30,6283,4409,1874,,,,6283,4409,1874
211006,30,378,351,27,365,339,26,13,12,1
211024,30,395,201,194,281,145,136,114,56,58
211079,30,1233,502,731,548,267,281,685,235,450
211088,30,1702,570,1132,1644,555,1089,58,15,43
211130,30,25,15,10,25,15,10,,,
211158,30,6719,2624,4095,6235,2447,3788,484,177,307
211273,30,1422,0,1422,1420,0,1420,2,0,2
211291,30,3714,1754,1960,3713,1753,1960,1,1,0
211307,30,5513,2275,3238,2075,1018,1057,3438,1257,2181
211316,30,113,1,112,81,1,80,32,0,32
211334,30,26,0,26,26,0,26,,,
211343,30,1998,749,1249,946,417,529,1052,332,720
211352,30,1292,521,771,1235,487,748,57,34,23
211361,30,4314,1885,2429,3565,1551,2014,749,334,415
211431,30,1244,191,1053,952,157,795,292,34,258
211440,30,6880,3451,3429,6743,3373,3370,137,78,59
211468,30,1041,65,976,792,42,750,249,23,226
211477,30,858,276,582,205,89,116,653,187,466
211556,30,1192,337,855,1141,323,818,51,14,37
211583,30,1011,426,585,856,396,460,155,30,125
211608,30,629,229,400,593,212,381,36,17,19
211635,30,105,13,92,105,13,92,,,
211644,30,3071,945,2126,2451,791,1660,620,154,466
211802,30,150,23,127,150,23,127,,,
211893,30,109,59,50,109,59,50,,,
211927,30,8706,3252,5454,2084,987,1097,6622,2265,4357
211981,30,1644,669,975,1551,633,918,93,36,57
212009,30,2138,903,1235,2124,897,1227,14,6,8
212045,30,206,46,160,204,46,158,2,0,2
212054,30,14308,7328,6980,13124,6848,6276,1184,480,704
212106,30,5071,1847,3224,5000,1805,3195,71,42,29
212115,30,4275,1859,2416,3840,1676,2164,435,183,252
212133,30,1665,548,1117,1237,447,790,428,101,327
212160,30,2779,1105,1674,2541,993,1548,238,112,126
212197,30,1667,678,989,1537,631,906,130,47,83
212230,30,37,5,32,37,5,32,,,
212267,30,73,1,72,52,1,51,21,0,21
212276,30,60,2,58,45,2,43,15,0,15
212294,30,57,1,56,51,1,50,6,0,6
212300,30,60,1,59,60,1,59,,,
212328,30,79,3,76,55,1,54,24,2,22
212337,30,80,2,78,51,0,51,29,2,27
212355,30,108,4,104,79,3,76,29,1,28
212382,30,122,2,120,78,1,77,44,1,43
212391,30,68,1,67,46,1,45,22,0,22
212434,30,227,210,17,227,210,17,,,
212577,30,2137,945,1192,2127,940,1187,10,5,5
212601,30,2681,1082,1599,2622,1064,1558,59,18,41
212656,30,1072,552,520,992,520,472,80,32,48
212674,30,2399,1174,1225,2397,1173,1224,2,1,1
212753,30,86,4,82,61,4,57,25,0,25
212771,30,84,2,82,51,0,51,33,2,31
212805,30,2173,1123,1050,2157,1109,1048,16,14,2
212832,30,1484,336,1148,1321,302,1019,163,34,129
212869,30,990,175,815,601,120,481,389,55,334
212878,30,11295,3598,7697,3581,1361,2220,7714,2237,5477
212911,30,1420,657,763,1419,657,762,1,0,1
212975,30,89,69,20,89,69,20,,,
212984,30,2141,525,1616,1813,448,1365,328,77,251
212993,30,71,27,44,66,24,42,5,3,2
213011,30,1363,393,970,998,318,680,365,75,290
213020,30,6989,2708,4281,6431,2445,3986,558,263,295
213163,30,271,39,232,271,39,232,,,
213181,30,343,21,322,248,17,231,95,4,91
213233,30,484,377,107,417,340,77,67,37,30
213251,30,1196,541,655,1193,541,652,3,0,3
213303,30,1055,479,576,887,446,441,168,33,135
213321,30,1750,902,848,1695,871,824,55,31,24
213330,30,18,0,18,18,0,18,,,
213349,30,6484,2832,3652,6044,2632,3412,440,200,240
213358,30,932,358,574,798,316,482,134,42,92
213367,30,2656,934,1722,2298,862,1436,358,72,286
213376,30,1728,660,1068,1238,520,718,490,140,350
213385,30,2719,1393,1326,2706,1383,1323,13,10,3
213400,30,1350,644,706,738,343,395,612,301,311
213455,30,367,9,358,42,0,42,325,9,316
213473,30,131,22,109,92,14,78,39,8,31
213491,30,52,2,50,20,2,18,32,0,32
213507,30,1635,765,870,1606,752,854,29,13,16
213525,30,4809,1656,3153,1844,841,1003,2965,815,2150
213534,30,334,102,232,311,97,214,23,5,18
213543,30,5446,2939,2507,5374,2895,2479,72,44,28
213570,30,560,123,437,560,123,437,,,
213589,30,338,304,34,235,212,23,103,92,11
213598,30,1763,595,1168,1664,567,1097,99,28,71
213613,30,2361,938,1423,2142,888,1254,219,50,169
213622,30,114,14,100,98,12,86,16,2,14
213659,30,3492,1189,2303,1393,585,808,2099,604,1495
213668,30,1081,488,593,1076,485,591,5,3,2
213774,30,537,126,411,404,106,298,133,20,113
213783,30,1487,547,940,1380,513,867,107,34,73
213826,30,1719,547,1172,1636,517,1119,83,30,53
213914,30,280,17,263,280,17,263,,,
213932,30,141,20,121,141,20,121,,,
213987,30,2594,1048,1546,2402,1011,1391,192,37,155
213996,30,2350,918,1432,2304,898,1406,46,20,26
214023,30,8,3,5,7,2,5,1,1,0
214041,30,6093,2490,3603,4872,2060,2812,1221,430,791
214069,30,1763,583,1180,1417,508,909,346,75,271
214111,30,7620,3009,4611,2492,1215,1277,5128,1794,3334
214148,30,357,0,357,350,0,350,7,0,7
214157,30,1871,725,1146,1797,700,1097,74,25,49
214166,30,1035,282,753,910,260,650,125,22,103
214175,30,2052,829,1223,2007,806,1201,45,23,22
214272,30,1682,606,1076,1357,491,866,325,115,210
214290,30,667,623,44,667,623,44,,,
214379,30,7173,2605,4568,2910,1280,1630,4263,1325,2938
214476,30,29,5,24,27,4,23,2,1,1
214528,30,215,203,12,172,162,10,43,41,2
214582,30,548,57,491,334,42,292,214,15,199
214883,30,788,210,578,182,46,136,606,164,442
214892,30,266,108,158,266,108,158,,,
214944,30,566,484,82,387,334,53,179,150,29
214971,30,121,29,92,119,28,91,2,1,1
215008,30,61,59,2,61,59,2,,,
215044,30,106,30,76,106,30,76,,,
215053,30,222,63,159,211,60,151,11,3,8
215062,30,10644,4795,5849,9887,4504,5383,757,291,466
215105,30,1395,485,910,1380,479,901,15,6,9
215114,30,807,366,441,775,350,425,32,16,16
215132,30,1311,422,889,1287,414,873,24,8,16
215239,30,10881,3462,7419,3612,1295,2317,7269,2167,5102
215266,30,1154,487,667,1090,468,622,64,19,45
215275,30,1317,565,752,1257,533,724,60,32,28
215284,30,2116,1194,922,2066,1164,902,50,30,20
215293,30,19961,8848,11113,19204,8432,10772,757,416,341
215309,30,32,5,27,24,4,20,8,1,7
215336,30,34,0,34,34,0,34,,,
215381,30,609,560,49,609,560,49,,,
215390,30,191,65,126,45,24,21,146,41,105
215415,30,1169,682,487,1055,631,424,114,51,63
215442,30,2567,950,1617,2339,841,1498,228,109,119
215479,30,65,15,50,65,15,50,,,
215530,30,58,0,58,41,0,41,17,0,17
215585,30,3242,1021,2221,850,342,508,2392,679,1713
215594,30,288,42,246,207,31,176,81,11,70
215637,30,245,98,147,245,98,147,,,
215655,30,2986,1648,1338,2785,1541,1244,201,107,94
215682,30,484,430,54,484,430,54,,,
215691,30,425,186,239,355,165,190,70,21,49
215743,30,1699,628,1071,1484,573,911,215,55,160
215770,30,4112,1951,2161,3859,1844,2015,253,107,146
215798,30,1383,776,607,1354,751,603,29,25,4
215886,30,58,14,44,39,13,26,19,1,18
215929,30,3433,1433,2000,3345,1381,1964,88,52,36
215947,30,1635,578,1057,1525,548,977,110,30,80
215974,30,327,64,263,191,41,150,136,23,113
215983,30,23,5,18,23,5,18,,,
215992,30,143,66,77,143,66,77,,,
216010,30,4676,2268,2408,4301,2070,2231,375,198,177
216038,30,6823,3014,3809,6409,2819,3590,414,195,219
216047,30,38,38,0,38,38,0,,,
216074,30,187,7,180,108,5,103,79,2,77
216083,30,274,101,173,237,91,146,37,10,27
216162,30,301,24,277,301,24,277,,,
216223,30,31,1,30,31,1,30,,,
216278,30,2112,927,1185,2106,923,1183,6,4,2
216287,30,1643,819,824,1643,819,824,,,
216296,30,1175,1055,120,1149,1031,118,26,24,2
216311,30,117,117,0,117,117,0,,,
216339,30,25596,11288,14308,23689,10295,13394,1907,993,914
216357,30,767,405,362,762,402,360,5,3,2
216366,30,3727,939,2788,3320,849,2471,407,90,317
216436,30,125,112,13,125,112,13,,,
216445,30,133,127,6,133,127,6,,,
216454,30,98,86,12,98,86,12,,,
216524,30,1534,800,734,1530,798,732,4,2,2
216542,30,473,218,255,425,196,229,48,22,26
216551,30,78,61,17,71,55,16,7,6,1
216579,30,85,2,83,85,2,83,,,
216597,30,7000,3197,3803,6808,3094,3714,192,103,89
216630,30,33,4,29,33,4,29,,,
216667,30,1151,588,563,1134,574,560,17,14,3
216694,30,1165,488,677,1132,482,650,33,6,27
216746,30,58,52,6,46,42,4,12,10,2
216764,30,14152,5639,8513,12669,5061,7608,1483,578,905
216773,30,117,19,98,117,19,98,,,
216782,30,284,13,271,137,4,133,147,9,138
216807,30,1073,513,560,1061,507,554,12,6,6
216825,30,2817,943,1874,1238,510,728,1579,433,1146
216852,30,2729,1154,1575,2535,1095,1440,194,59,135
216931,30,2134,974,1160,2006,925,1081,128,49,79
216940,30,243,243,0,243,243,0,,,
217013,30,663,139,524,545,133,412,118,6,112
217040,30,36,36,0,36,36,0,,,
217059,30,3452,1507,1945,3168,1358,1810,284,149,135
217077,30,446,134,312,446,134,312,,,
217156,30,7125,3478,3647,7076,3453,3623,49,25,24
217165,30,3060,1931,1129,3036,1917,1119,24,14,10
217235,30,4621,1832,2789,4328,1706,2622,293,126,167
217305,30,1739,1073,666,1523,950,573,216,123,93
217323,30,623,579,44,623,579,44,,,
217402,30,4141,1869,2272,3994,1802,2192,147,67,80
217420,30,5128,1597,3531,4044,1272,2772,1084,325,759
217475,30,11136,4425,6711,4608,2129,2479,6528,2296,4232
217484,30,13850,5983,7867,12769,5496,7273,1081,487,594
217493,30,2044,684,1360,2044,684,1360,,,
217518,30,4090,2061,2029,3762,1888,1874,328,173,155
217536,30,2140,687,1453,2065,667,1398,75,20,55
217581,30,134,2,132,88,1,87,46,1,45
217606,30,209,116,93,155,86,69,54,30,24
217615,30,1650,572,1078,597,227,370,1053,345,708
217624,30,563,337,226,544,321,223,19,16,3
217633,30,2900,925,1975,2745,880,1865,155,45,110
217688,30,2714,966,1748,2478,881,1597,236,85,151
217712,30,1609,444,1165,454,161,293,1155,283,872
217721,30,1894,822,1072,1883,818,1065,11,4,7
217749,30,2427,1104,1323,2280,1043,1237,147,61,86
217776,30,941,309,632,718,261,457,223,48,175
217794,30,116,2,114,82,2,80,34,0,34
217819,30,9770,3279,6491,9184,3014,6170,586,265,321
217828,30,39,2,37,26,1,25,13,1,12
217837,30,1017,267,750,251,77,174,766,190,576
217864,30,2682,2331,351,2512,2209,303,170,122,48
217873,30,1773,517,1256,1687,498,1189,86,19,67
217882,30,21577,10521,11056,20834,10051,10783,743,470,273
217891,30,153,68,85,148,66,82,5,2,3
217907,30,834,339,495,802,331,471,32,8,24
217925,30,743,354,389,564,287,277,179,67,112
217934,30,1045,161,884,727,94,633,318,67,251
217961,30,821,138,683,781,134,647,40,4,36
217989,30,318,114,204,219,95,124,99,19,80
217998,30,820,538,282,794,524,270,26,14,12
218025,30,2383,853,1530,988,478,510,1395,375,1020
218061,30,2867,967,1900,2685,912,1773,182,55,127
218070,30,2299,921,1378,2281,908,1373,18,13,5
218113,30,7870,3022,4848,3945,1704,2241,3925,1318,2607
218140,30,5213,1829,3384,2739,1157,1582,2474,672,1802
218159,30,116,3,113,91,2,89,25,1,24
218195,30,100,3,97,60,3,57,40,0,40
218229,30,3392,1066,2326,3199,1003,2196,193,63,130
218238,30,1679,798,881,1335,666,669,344,132,212
218335,30,334,31,303,325,31,294,9,0,9
218353,30,7641,2838,4803,3531,1600,1931,4110,1238,2872
218399,30,410,184,226,402,180,222,8,4,4
218414,30,1226,719,507,1208,713,495,18,6,12
218441,30,1609,762,847,1550,736,814,59,26,33
218487,30,1511,390,1121,578,231,347,933,159,774
218520,30,3587,1075,2512,1401,537,864,2186,538,1648
218539,30,931,464,467,923,460,463,8,4,4
218645,30,2813,984,1829,2367,842,1525,446,142,304
218654,30,1847,566,1281,1596,489,1107,251,77,174
218663,30,26430,11844,14586,25423,11294,14129,1007,550,457
218672,30,728,321,407,634,291,343,94,30,64
218681,30,405,182,223,326,157,169,79,25,54
218690,30,573,263,310,448,203,245,125,60,65
218706,30,264,121,143,238,112,126,26,9,17
218724,30,9384,4213,5171,8896,3957,4939,488,256,232
218733,30,2063,924,1139,1833,805,1028,230,119,111
218742,30,4496,1474,3022,3912,1243,2669,584,231,353
218821,30,1039,469,570,1008,455,553,31,14,17
218830,30,4974,1928,3046,2474,1092,1382,2500,836,1664
218858,30,2060,649,1411,706,305,401,1354,344,1010
218885,30,4916,2258,2658,3136,1633,1503,1780,625,1155
218894,30,8755,3334,5421,3644,1529,2115,5111,1805,3306
218919,30,402,169,233,349,150,199,53,19,34
218955,30,390,66,324,95,16,79,295,50,245
218964,30,3765,1231,2534,3537,1141,2396,228,90,138
218973,30,1759,852,907,1745,840,905,14,12,2
218991,30,3215,1265,1950,1724,791,933,1491,474,1017
219000,30,1658,613,1045,1611,591,1020,47,22,25
219037,30,53,1,52,53,1,52,,,
219046,30,2042,690,1352,1666,571,1095,376,119,257
219082,30,1910,1320,590,1393,999,394,517,321,196
219091,30,654,303,351,613,299,314,41,4,37
219125,30,88,4,84,80,3,77,8,1,7
219143,30,1803,968,835,1506,896,610,297,72,225
219170,30,24,2,22,24,2,22,,,
219189,30,986,660,326,835,592,243,151,68,83
219198,30,666,348,318,575,298,277,91,50,41
219204,30,937,427,510,124,70,54,813,357,456
219240,30,36,22,14,10,3,7,26,19,7
219259,30,1344,546,798,1109,471,638,235,75,160
219277,30,1353,390,963,627,190,437,726,200,526
219295,30,547,228,319,375,204,171,172,24,148
219338,30,17,1,16,17,1,16,,,
219347,30,1976,1523,453,1704,1314,390,272,209,63
219356,30,8651,4024,4627,7534,3549,3985,1117,475,642
219374,30,526,116,410,198,44,154,328,72,256
219383,30,1306,467,839,1183,426,757,123,41,82
219392,30,28,7,21,28,7,21,,,
219408,30,131,56,75,80,42,38,51,14,37
219426,30,2075,962,1113,1279,740,539,796,222,574
219453,30,131,1,130,131,1,130,,,
219471,30,5328,1969,3359,4468,1656,2812,860,313,547
219480,30,826,356,470,577,291,286,249,65,184
219505,30,57,36,21,43,26,17,14,10,4
219587,30,79,0,79,79,0,79,,,
219596,30,221,148,73,221,148,73,,,
219602,30,7490,2943,4547,5491,2093,3398,1999,850,1149
219639,30,888,82,806,343,39,304,545,43,502
219709,30,7050,2455,4595,6784,2347,4437,266,108,158
219718,30,2372,1237,1135,1945,1039,906,427,198,229
219790,30,869,414,455,734,369,365,135,45,90
219806,30,1601,683,918,1560,666,894,41,17,24
219824,30,5058,1809,3249,3029,1205,1824,2029,604,1425
219833,30,1261,563,698,1213,534,679,48,29,19
219851,30,120,3,117,120,3,117,,,
219879,30,2131,903,1228,1336,622,714,795,281,514
219888,30,4265,1619,2646,2957,1237,1720,1308,382,926
219903,30,1370,100,1270,1370,100,1270,,,
219921,30,252,147,105,182,106,76,70,41,29
219949,30,1870,772,1098,1773,738,1035,97,34,63
219976,30,2945,1157,1788,2761,1076,1685,184,81,103
219994,30,622,369,253,576,328,248,46,41,5
220002,30,48,3,45,48,3,45,,,
220057,30,1981,562,1419,1125,378,747,856,184,672
220075,30,9768,3720,6048,8370,3211,5159,1398,509,889
220118,30,216,12,204,216,12,204,,,
220127,30,455,260,195,426,235,191,29,25,4
220163,30,50,1,49,24,0,24,26,1,25
220181,30,914,305,609,874,291,583,40,14,26
220206,30,261,142,119,181,95,86,80,47,33
220215,30,1422,629,793,1373,612,761,49,17,32
220251,30,274,153,121,235,130,105,39,23,16
220279,30,279,199,80,210,146,64,69,53,16
220321,30,444,216,228,426,213,213,18,3,15
220394,30,201,112,89,198,110,88,3,2,1
220400,30,2776,777,1999,1622,516,1106,1154,261,893
220464,30,191,80,111,56,24,32,135,56,79
220473,30,657,319,338,570,268,302,87,51,36
220491,30,273,11,262,199,8,191,74,3,71
220516,30,1301,470,831,1160,424,736,141,46,95
220552,30,4580,638,3942,3498,493,3005,1082,145,937
220598,30,1047,560,487,988,528,460,59,32,27
220604,30,613,215,398,529,184,345,84,31,53
220613,30,3412,1280,2132,3039,1098,1941,373,182,191
220631,30,1575,443,1132,1209,402,807,366,41,325
220640,30,382,198,184,307,143,164,75,55,20
220701,30,741,324,417,715,314,401,26,10,16
220710,30,975,449,526,958,442,516,17,7,10
220756,30,88,71,17,85,68,17,3,3,0
220765,30,326,74,252,231,44,187,95,30,65
220853,30,836,558,278,678,433,245,158,125,33
220862,30,14591,5736,8855,11096,4456,6640,3495,1280,2215
220978,30,17713,8077,9636,15080,6892,8188,2633,1185,1448
221050,30,623,478,145,526,394,132,97,84,13
221096,30,4204,1580,2624,2670,1101,1569,1534,479,1055
221102,30,493,347,146,400,266,134,93,81,12
221148,30,1464,1372,92,1464,1372,92,,,
221184,30,5436,1952,3484,2702,1086,1616,2734,866,1868
221236,30,329,202,127,247,172,75,82,30,52
221281,30,161,80,81,145,72,73,16,8,8
221333,30,281,191,90,201,117,84,80,74,6
221351,30,1983,824,1159,1978,820,1158,5,4,1
221388,30,171,50,121,141,41,100,30,9,21
221397,30,3382,1133,2249,2072,790,1282,1310,343,967
221430,30,381,253,128,257,168,89,124,85,39
221485,30,5963,2058,3905,2998,1172,1826,2965,886,2079
221494,30,431,343,88,366,307,59,65,36,29
221519,30,1725,814,911,1724,813,911,1,1,0
221582,30,167,98,69,147,86,61,20,12,8
221591,30,350,228,122,330,211,119,20,17,3
221607,30,336,253,83,185,123,62,151,130,21
221616,30,511,342,169,493,333,160,18,9,9
221625,30,727,415,312,698,395,303,29,20,9
221643,30,6870,3338,3532,4150,2090,2060,2720,1248,1472
221661,30,2303,1039,1264,2100,953,1147,203,86,117
221731,30,962,345,617,894,317,577,68,28,40
221740,30,9970,4154,5816,8957,3688,5269,1013,466,547
221759,30,24957,11474,13483,23852,10864,12988,1105,610,495
221768,30,4743,1862,2881,4344,1717,2627,399,145,254
221829,30,329,12,317,329,12,317,,,
221838,30,5855,2046,3809,4904,1702,3202,951,344,607
221847,30,8186,4381,3805,7547,4013,3534,639,368,271
221892,30,1814,675,1139,1486,571,915,328,104,224
221908,30,4289,1968,2321,2768,1257,1511,1521,711,810
221953,30,1065,510,555,979,476,503,86,34,52
221971,30,1850,637,1213,1634,563,1071,216,74,142
221999,30,7104,3474,3630,7042,3435,3607,62,39,23
222053,30,5796,2145,3651,3541,1405,2136,2255,740,1515
222062,30,3761,1310,2451,2601,1003,1598,1160,307,853
222105,30,338,314,24,153,143,10,185,171,14
222178,30,3131,1226,1905,3032,1180,1852,99,46,53
222567,30,2969,1218,1751,762,334,428,2207,884,1323
222576,30,7206,2428,4778,3136,1181,1955,4070,1247,2823
222628,30,159,54,105,37,21,16,122,33,89
222822,30,2664,875,1789,1238,460,778,1426,415,1011
222831,30,5418,2289,3129,4811,1975,2836,607,314,293
222877,30,213,128,85,208,128,80,5,0,5
222886,30,343,30,313,328,29,299,15,1,14
222938,30,380,169,211,243,113,130,137,56,81
222983,30,1208,562,646,1204,561,643,4,1,3
222992,30,26378,10823,15555,7139,3412,3727,19239,7411,11828
223056,30,41,2,39,41,2,39,,,
223083,30,508,86,422,127,21,106,381,65,316
223117,30,51,40,11,2,1,1,49,39,10
223232,30,15102,6014,9088,14841,5906,8935,261,108,153
223320,30,2372,823,1549,828,334,494,1544,489,1055
223427,30,15486,7790,7696,8317,4330,3987,7169,3460,3709
223463,30,427,132,295,427,132,295,,,
223472,30,220,20,200,220,20,200,,,
223506,30,2905,1369,1536,563,280,283,2342,1089,1253
223816,30,5426,2274,3152,865,325,540,4561,1949,2612
223852,30,23,1,22,23,1,22,,,
223898,30,3019,1146,1873,1078,420,658,1941,726,1215
223922,30,1372,570,802,571,244,327,801,326,475
224004,30,1707,554,1153,1414,479,935,293,75,218
224013,30,32,2,30,32,2,30,,,
224110,30,5697,2314,3383,1603,703,900,4094,1611,2483
224147,30,7969,3131,4838,5951,2267,3684,2018,864,1154
224156,30,383,8,375,374,8,366,9,0,9
224226,30,2717,1158,1559,2300,985,1315,417,173,244
224244,30,263,154,109,239,140,99,24,14,10
224271,30,595,157,438,594,156,438,1,1,0
224323,30,1496,649,847,1465,636,829,31,13,18
224350,30,9779,4007,5772,1516,670,846,8263,3337,4926
224527,30,1321,643,678,1223,611,612,98,32,66
224545,30,1762,650,1112,1317,515,802,445,135,310
224554,30,7517,3054,4463,5412,2216,3196,2105,838,1267
224615,30,42033,16325,25708,10730,4674,6056,31303,11651,19652
224642,30,24423,10018,14405,6668,2928,3740,17755,7090,10665
224660,30,566,288,278,447,240,207,119,48,71
224679,30,1303,1122,181,778,655,123,525,467,58
224758,30,34,3,31,26,2,24,8,1,7
224776,30,322,150,172,190,90,100,132,60,72
224828,30,59,0,59,42,0,42,17,0,17
224891,30,777,352,425,530,256,274,247,96,151
224961,30,1489,481,1008,574,240,334,915,241,674
225070,30,2618,1012,1606,1242,477,765,1376,535,841
225201,30,844,550,294,844,550,294,,,
225247,30,1459,688,771,1411,666,745,48,22,26
225308,30,4597,1822,2775,1554,645,909,3043,1177,1866
225371,30,1973,736,1237,988,417,571,985,319,666
225399,30,2773,960,1813,2164,757,1407,609,203,406
225414,30,6747,2419,4328,3361,1213,2148,3386,1206,2180
225423,30,38181,14971,23210,12353,5400,6953,25828,9571,16257
225432,30,13515,4925,8590,6573,2464,4109,6942,2461,4481
225502,30,2956,1027,1929,1373,510,863,1583,517,1066
225511,30,37553,18278,19275,27380,12996,14384,10173,5282,4891
225520,30,1790,539,1251,941,343,598,849,196,653
225548,30,775,407,368,715,378,337,60,29,31
225575,30,990,397,593,912,368,544,78,29,49
225627,30,4689,1721,2968,3961,1414,2547,728,307,421
225876,30,227,116,111,206,113,93,21,3,18
225885,30,717,322,395,615,289,326,102,33,69
225991,30,117,70,47,117,70,47,,,
226019,30,3341,1332,2009,1952,899,1053,1389,433,956
226091,30,7881,3216,4665,4493,1931,2562,3388,1285,2103
226107,30,1458,423,1035,767,246,521,691,177,514
226116,30,2274,821,1453,769,287,482,1505,534,971
226125,30,124,11,113,124,11,113,,,
226134,30,8013,3341,4672,2012,827,1185,6001,2514,3487
226152,30,6352,2446,3906,5202,2021,3181,1150,425,725
226204,30,7118,3636,3482,1014,541,473,6104,3095,3009
226231,30,1623,991,632,1344,888,456,279,103,176
226277,30,1387,1285,102,1387,1285,102,,,
226383,30,1275,459,816,1173,423,750,102,36,66
226408,30,2750,1026,1724,936,391,545,1814,635,1179
226471,30,3176,1112,2064,2989,1047,1942,187,65,122
226578,30,5467,1598,3869,2086,716,1370,3381,882,2499
226587,30,1115,563,552,996,517,479,119,46,73
226675,30,377,49,328,377,49,328,,,
226806,30,4818,1880,2938,1402,546,856,3416,1334,2082
226833,30,4832,1703,3129,3617,1345,2272,1215,358,857
226860,30,56,2,54,56,2,54,,,
226879,30,216,34,182,109,14,95,107,20,87
226903,30,1013,463,550,1013,463,550,,,
227058,30,88,0,88,88,0,88,,,
227146,30,6565,2493,4072,2341,986,1355,4224,1507,2717
227182,30,49093,19068,30025,17371,7546,9825,31722,11522,20200
227216,30,32590,15010,17580,25441,11516,13925,7149,3494,3655
227225,30,1795,593,1202,1130,386,744,665,207,458
227298,30,174,166,8,174,166,8,,,
227304,30,4537,1569,2968,2265,847,1418,2272,722,1550
227313,30,284,3,281,134,2,132,150,1,149
227322,30,338,7,331,186,4,182,152,3,149
227331,30,1188,381,807,1077,353,724,111,28,83
227368,30,26402,10750,15652,19630,7723,11907,6772,3027,3745
227377,30,3865,1642,2223,1754,826,928,2111,816,1295
227386,30,1539,429,1110,879,311,568,660,118,542
227401,30,2418,876,1542,1342,540,802,1076,336,740
227429,30,384,166,218,329,142,187,55,24,31
227526,30,8444,2714,5730,7578,2395,5183,866,319,547
227687,30,2066,924,1142,738,362,376,1328,562,766
227748,30,244,220,24,191,176,15,53,44,9
227757,30,4240,2186,2054,4150,2143,2007,90,43,47
227845,30,2867,1086,1781,2670,1000,1670,197,86,111
227854,30,8900,3436,5464,1192,553,639,7708,2883,4825
227863,30,2603,1011,1592,2210,777,1433,393,234,159
227881,30,18288,6623,11665,14352,5204,9148,3936,1419,2517
227924,30,14741,5392,9349,3096,1146,1950,11645,4246,7399
227979,30,23993,9674,14319,6997,3030,3967,16996,6644,10352
228042,30,967,435,532,906,426,480,61,9,52
228088,30,18,0,18,18,0,18,,,
228149,30,2083,860,1223,2006,817,1189,77,43,34
228158,30,6714,2664,4050,3846,1717,2129,2868,947,1921
228185,30,14,12,2,14,12,2,,,
228200,30,332,163,169,306,161,145,26,2,24
228219,30,444,124,320,423,118,305,21,6,15
228246,30,6894,3481,3413,6727,3400,3327,167,81,86
228282,30,19,4,15,19,4,15,,,
228316,30,2950,1103,1847,1036,414,622,1914,689,1225
228325,30,1469,710,759,1269,626,643,200,84,116
228343,30,1500,696,804,1479,684,795,21,12,9
228431,30,9515,3467,6048,8316,3021,5295,1199,446,753
228459,30,33175,13394,19781,26527,10421,16106,6648,2973,3675
228468,30,689,273,416,637,249,388,52,24,28
228486,30,92,57,35,81,50,31,11,7,4
228501,30,1603,628,975,984,470,514,619,158,461
228529,30,11666,4237,7429,8567,3058,5509,3099,1179,1920
228547,30,35075,13976,21099,5728,2700,3028,29347,11276,18071
228608,30,3038,912,2126,1149,380,769,1889,532,1357
228644,30,787,228,559,670,178,492,117,50,67
228653,30,672,124,548,541,96,445,131,28,103
228699,30,2672,993,1679,802,314,488,1870,679,1191
228705,30,4755,2380,2375,3997,2031,1966,758,349,409
228723,30,56006,29467,26539,50109,26053,24056,5897,3414,2483
228769,30,32659,12471,20188,18990,8283,10707,13669,4188,9481
228778,30,40506,17562,22944,38062,16305,21757,2444,1257,1187
228787,30,21416,12114,9302,17968,10066,7902,3448,2048,1400
228796,30,20008,8811,11197,13285,5892,7393,6723,2919,3804
228802,30,6752,2592,4160,4729,1897,2832,2023,695,1328
228875,30,10215,4058,6157,10019,3956,6063,196,102,94
228884,30,731,430,301,671,400,271,60,30,30
228981,30,1400,630,770,1350,612,738,50,18,32
229018,30,3443,1451,1992,2265,980,1285,1178,471,707
229027,30,29151,13910,15241,21953,10184,11769,7198,3726,3472
229063,30,5726,2049,3677,4877,1733,3144,849,316,533
229115,30,32414,16576,15838,28935,14660,14275,3479,1916,1563
229160,30,1454,657,797,1299,615,684,155,42,113
229179,30,9035,797,8238,6546,558,5988,2489,239,2250
229267,30,2509,1191,1318,2471,1170,1301,38,21,17
229300,30,685,88,597,542,65,477,143,23,120
229337,30,1468,187,1281,1233,156,1077,235,31,204
229355,30,9288,3285,6003,5115,2030,3085,4173,1255,2918
229416,30,1868,1767,101,1868,1767,101,,,
229425,30,155,2,153,48,1,47,107,1,106
229504,30,2339,772,1567,621,240,381,1718,532,1186
229522,30,97,15,82,50,5,45,47,10,37
229540,30,2514,784,1730,704,305,399,1810,479,1331
229656,30,264,6,258,228,3,225,36,3,33
229780,30,2393,1128,1265,1384,675,709,1009,453,556
229799,30,3873,1212,2661,1428,532,896,2445,680,1765
229814,30,6953,2833,4120,5332,2155,3177,1621,678,943
229832,30,527,285,242,337,171,166,190,114,76
229841,30,4918,2071,2847,2281,1057,1224,2637,1014,1623
229887,30,665,311,354,584,277,307,81,34,47
230010,30,1562,898,664,528,248,280,1034,650,384
230038,30,31642,15400,16242,28282,13739,14543,3360,1661,1699
230047,30,2861,1068,1793,2727,1015,1712,134,53,81
230056,30,127,21,106,108,15,93,19,6,13
230065,30,287,4,283,76,1,75,211,3,208
230144,30,28,0,28,28,0,28,,,
230162,30,2425,1446,979,412,165,247,2013,1281,732
230171,30,8796,3590,5206,6963,2783,4180,1833,807,1026
230199,30,61,10,51,61,10,51,,,
230205,30,71,8,63,63,6,57,8,2,6
230214,30,311,42,269,114,8,106,197,34,163
230366,30,285,32,253,285,32,253,,,
230418,30,2641,1288,1353,1120,593,527,1521,695,826
230490,30,1948,1106,842,343,123,220,1605,983,622
230597,30,3672,1743,1929,3192,1545,1647,480,198,282
230603,30,9297,3969,5328,8061,3397,4664,1236,572,664
230676,30,245,146,99,80,44,36,165,102,63
230728,30,20516,9314,11202,16323,7502,8821,4193,1812,2381
230737,30,27489,14513,12976,17313,9009,8304,10176,5504,4672
230746,30,18373,8400,9973,5573,2596,2977,12800,5804,6996
230764,30,24850,12884,11966,20294,10490,9804,4556,2394,2162
230782,30,15944,6843,9101,10284,4452,5832,5660,2391,3269
230807,30,1153,416,737,1120,397,723,33,19,14
230816,30,735,269,466,695,231,464,40,38,2
230834,30,1617,736,881,1438,678,760,179,58,121
230852,30,3170,1915,1255,2218,1396,822,952,519,433
230861,30,3379,886,2493,629,227,402,2750,659,2091
230889,30,146,44,102,133,40,93,13,4,9
230913,30,1292,512,780,924,413,511,368,99,269
230959,30,2837,1320,1517,2823,1316,1507,14,4,10
230995,30,2924,2180,744,2385,1694,691,539,486,53
231004,30,45,5,40,45,5,40,,,
231059,30,1415,662,753,1395,649,746,20,13,7
231095,30,108,51,57,99,46,53,9,5,4
231165,30,1162,529,633,721,389,332,441,140,301
231174,30,11081,4193,6888,10779,4033,6746,302,160,142
231280,30,107,1,106,90,0,90,17,1,16
231411,30,466,424,42,466,424,42,,,
231420,30,1094,586,508,977,530,447,117,56,61
231536,30,2428,956,1472,904,406,498,1524,550,974
231554,30,628,327,301,583,312,271,45,15,30
231581,30,1426,660,766,1415,653,762,11,7,4
231624,30,6521,2709,3812,6457,2680,3777,64,29,35
231651,30,4246,1627,2619,2307,905,1402,1939,722,1217
231688,30,20,1,19,11,0,11,9,1,8
231697,30,1997,794,1203,686,319,367,1311,475,836
231712,30,4463,2031,2432,4387,1985,2402,76,46,30
231721,30,12,1,11,,,,12,1,11
231785,30,1239,221,1018,735,181,554,504,40,464
231873,30,511,171,340,292,114,178,219,57,162
231882,30,1312,479,833,673,324,349,639,155,484
232016,30,113,30,83,66,22,44,47,8,39
232025,30,1072,533,539,1048,518,530,24,15,9
232043,30,916,370,546,823,338,485,93,32,61
232052,30,393,139,254,133,54,79,260,85,175
232089,30,860,512,348,842,506,336,18,6,12
232186,30,26339,13288,13051,21016,10451,10565,5323,2837,2486
232195,30,5261,1884,3377,1962,828,1134,3299,1056,2243
232256,30,851,847,4,842,838,4,9,9,0
232265,30,2855,963,1892,2701,908,1793,154,55,99
232308,30,713,0,713,707,0,707,6,0,6
232414,30,5299,1965,3334,1682,709,973,3617,1256,2361
232423,30,19743,8320,11423,18696,7825,10871,1047,495,552
232450,30,5386,2228,3158,1880,828,1052,3506,1400,2106
232557,30,47618,20438,27180,30145,12534,17611,17473,7904,9569
232566,30,3200,976,2224,3000,909,2091,200,67,133
232575,30,3180,1083,2097,1117,464,653,2063,619,1444
232609,30,1614,620,994,1578,603,975,36,17,19
232618,30,304,24,280,34,0,34,270,24,246
232672,30,1458,301,1157,1208,265,943,250,36,214
232681,30,3624,1285,2339,3100,1099,2001,524,186,338
232706,30,1891,690,1201,1755,630,1125,136,60,76
232724,30,19,0,19,19,0,19,,,
232788,30,1268,433,835,696,275,421,572,158,414
232797,30,868,121,747,243,36,207,625,85,540
232867,30,1954,940,1014,1072,557,515,882,383,499
232885,30,260,26,234,231,26,205,29,0,29
232919,30,466,400,66,376,322,54,90,78,12
232937,30,5004,1616,3388,4520,1478,3042,484,138,346
232946,30,32902,15620,17282,13185,6735,6450,19717,8885,10832
232982,30,18429,8096,10333,13890,6161,7729,4539,1935,2604
233019,30,1402,571,831,795,365,430,607,206,401
233037,30,618,212,406,261,132,129,357,80,277
233082,30,107,10,97,6,0,6,101,10,91
233116,30,3039,1202,1837,858,450,408,2181,752,1429
233277,30,6437,2494,3943,6011,2316,3695,426,178,248
233286,30,146,17,129,98,8,90,48,9,39
233295,30,1490,680,810,1452,656,796,38,24,14
233301,30,475,181,294,470,177,293,5,4,1
233310,30,1216,321,895,347,125,222,869,196,673
233329,30,441,30,411,441,30,411,,,
233338,30,1243,471,772,1166,439,727,77,32,45
233356,30,427,26,401,343,25,318,84,1,83
233374,30,3098,1449,1649,2972,1397,1575,126,52,74
233408,30,322,33,289,273,29,244,49,4,45
233426,30,1837,845,992,1811,827,984,26,18,8
233480,30,33,7,26,33,7,26,,,
233541,30,2122,858,1264,2034,827,1207,88,31,57
233602,30,61,35,26,58,32,26,3,3,0
233611,30,1066,539,527,1018,518,500,48,21,27
233639,30,1575,406,1169,495,108,387,1080,298,782
233648,30,1554,528,1026,962,373,589,592,155,437
233666,30,44,1,43,31,1,30,13,0,13
233684,30,2594,859,1735,443,265,178,2151,594,1557
233718,30,451,0,451,447,0,447,4,0,4
233754,30,4327,1667,2660,1562,690,872,2765,977,1788
233772,30,13610,5206,8404,5087,2087,3000,8523,3119,5404
233897,30,1102,521,581,1062,502,560,40,19,21
233903,30,1718,642,1076,825,369,456,893,273,620
233921,30,29699,17020,12679,28886,16470,12416,813,550,263
233949,30,3535,1406,2129,1523,631,892,2012,775,1237
234030,30,20918,7689,13229,18471,6673,11798,2447,1016,1431
234076,30,17041,7459,9582,16372,7173,9199,669,286,383
234085,30,1652,1424,228,1652,1424,228,,,
234119,30,34,13,21,19,8,11,15,5,10
234137,30,217,186,31,181,158,23,36,28,8
234155,30,3886,1555,2331,3665,1463,2202,221,92,129
234164,30,1190,591,599,1086,548,538,104,43,61
234173,30,1190,464,726,1105,439,666,85,25,60
234207,30,1850,903,947,1847,901,946,3,2,1
234377,30,1188,326,862,583,210,373,605,116,489
234669,30,9752,4311,5441,5481,2510,2971,4271,1801,2470
234696,30,1706,855,851,1082,623,459,624,232,392
234711,30,1696,691,1005,1262,529,733,434,162,272
234827,30,9508,4477,5031,8346,3925,4421,1162,552,610
234845,30,1616,661,955,1122,449,673,494,212,282
234915,30,1004,436,568,112,58,54,892,378,514
234924,30,286,30,256,286,30,256,,,
234933,30,5874,2284,3590,3259,1319,1940,2615,965,1650
234951,30,1184,510,674,904,404,500,280,106,174
234979,30,5301,2018,3283,3213,1267,1946,2088,751,1337
235024,30,428,141,287,414,136,278,14,5,9
235088,30,247,233,14,247,233,14,,,
235097,30,7589,3263,4326,6782,2892,3890,807,371,436
235103,30,3839,1681,2158,1945,921,1024,1894,760,1134
235149,30,6484,2674,3810,3496,1483,2013,2988,1191,1797
235158,30,92,20,72,92,20,72,,,
235167,30,1819,708,1111,1621,640,981,198,68,130
235237,30,6407,2179,4228,3953,1376,2577,2454,803,1651
235307,30,105,6,99,105,6,99,,,
235316,30,4962,2277,2685,4899,2246,2653,63,31,32
235334,30,1297,602,695,872,384,488,425,218,207
235343,30,6330,3042,3288,3879,1905,1974,2451,1137,1314
235352,30,110,24,86,110,24,86,,,
235422,30,805,202,603,706,162,544,99,40,59
235431,30,4254,1580,2674,2311,871,1440,1943,709,1234
235501,30,158,92,66,158,92,66,,,
235547,30,67,12,55,46,10,36,21,2,19
235583,30,101,3,98,101,3,98,,,
235671,30,703,329,374,549,287,262,154,42,112
235699,30,1522,707,815,978,493,485,544,214,330
235750,30,1997,590,1407,1197,377,820,800,213,587
236018,30,39,4,35,39,4,35,,,
236072,30,2914,1210,1704,1224,589,635,1690,621,1069
236133,30,754,264,490,735,256,479,19,8,11
236188,30,4122,1663,2459,2549,1034,1515,1573,629,944
236212,30,867,717,150,867,717,150,,,
236230,30,2331,840,1491,2271,811,1460,60,29,31
236258,30,1191,458,733,703,250,453,488,208,280
236328,30,1866,794,1072,1835,782,1053,31,12,19
236382,30,1056,473,583,658,301,357,398,172,226
236452,30,1347,527,820,1245,476,769,102,51,51
236504,30,1808,997,811,1101,660,441,707,337,370
236513,30,3325,1334,1991,2141,900,1241,1184,434,750
236577,30,2611,849,1762,2513,794,1719,98,55,43
236595,30,4233,1638,2595,4098,1576,2522,135,62,73
236610,30,2719,1082,1637,1371,599,772,1348,483,865
236638,30,2987,1147,1840,1935,821,1114,1052,326,726
236656,30,3450,1356,2094,2075,872,1203,1375,484,891
236692,30,4789,1904,2885,3425,1468,1957,1364,436,928
236708,30,3646,1471,2175,2605,1079,1526,1041,392,649
236744,30,36,2,34,36,2,34,,,
236753,30,4945,1713,3232,2998,1105,1893,1947,608,1339
236887,30,1863,845,1018,1247,553,694,616,292,324
236896,30,1316,672,644,1236,627,609,80,45,35
236939,30,23966,11024,12942,21209,9813,11396,2757,1211,1546
236948,30,31367,13671,17696,29515,12800,16715,1852,871,981
236975,30,2411,897,1514,1798,695,1103,613,202,411
237011,30,13933,5936,7997,12413,5162,7251,1520,774,746
237039,30,3611,1523,2088,1876,823,1053,1735,700,1035
237057,30,1539,672,867,1524,665,859,15,7,8
237066,30,2293,940,1353,2250,920,1330,43,20,23
237109,30,2761,757,2004,1917,529,1388,844,228,616
237118,30,706,433,273,668,422,246,38,11,27
237127,30,51,2,49,51,2,49,,,
237136,30,167,88,79,136,60,76,31,28,3
237145,30,26,3,23,26,3,23,,,
237172,30,39,31,8,39,31,8,,,
237181,30,531,284,247,531,284,247,,,
237215,30,1334,531,803,994,423,571,340,108,232
237242,30,80,53,27,76,50,26,4,3,1
237303,30,52,19,33,52,19,33,,,
237312,30,2118,1250,868,1123,511,612,995,739,256
237321,30,47,4,43,47,4,43,,,
237330,30,1345,562,783,1280,537,743,65,25,40
237358,30,659,270,389,653,269,384,6,1,5
237367,30,2908,1195,1713,2475,1053,1422,433,142,291
237385,30,1182,708,474,970,529,441,212,179,33
237437,30,147,27,120,134,26,108,13,1,12
237473,30,151,106,45,151,106,45,,,
237491,30,19,3,16,19,3,16,,,
237525,30,7175,3005,4170,6522,2716,3806,653,289,364
237543,30,104,31,73,69,15,54,35,16,19
237561,30,69,22,47,69,22,47,,,
237570,30,76,2,74,76,2,74,,,
237598,30,20,1,19,20,1,19,,,
237686,30,1514,557,957,932,367,565,582,190,392
237701,30,998,494,504,882,421,461,116,73,43
237729,30,140,39,101,82,13,69,58,26,32
237783,30,782,368,414,698,321,377,84,47,37
237792,30,2299,911,1388,2040,805,1235,259,106,153
237817,30,1215,378,837,914,288,626,301,90,211
237844,30,100,56,44,100,56,44,,,
237899,30,1373,635,738,1216,564,652,157,71,86
237905,30,55,12,43,55,12,43,,,
237932,30,1653,591,1062,1574,567,1007,79,24,55
237950,30,1103,634,469,1038,599,439,65,35,30
237969,30,978,456,522,968,451,517,10,5,5
237987,30,211,30,181,211,30,181,,,
237996,30,558,88,470,558,88,470,,,
238005,30,83,6,77,83,6,77,,,
238014,30,841,298,543,459,191,268,382,107,275
238032,30,18759,9090,9669,17963,8699,9264,796,391,405
238078,30,599,371,228,506,330,176,93,41,52
238096,30,16,1,15,16,1,15,,,
238175,30,124,2,122,124,2,122,,,
238193,30,858,16,842,692,10,682,166,6,160
238263,30,8536,3497,5039,2751,1360,1391,5785,2137,3648
238324,30,356,26,330,243,22,221,113,4,109
238333,30,956,459,497,955,458,497,1,1,0
238397,30,2247,739,1508,569,238,331,1678,501,1177
238430,30,602,215,387,464,172,292,138,43,95
238458,30,2799,842,1957,2669,796,1873,130,46,84
238476,30,2616,1149,1467,2563,1120,1443,53,29,24
238616,30,2628,1012,1616,2187,890,1297,441,122,319
238661,30,1147,339,808,1043,309,734,104,30,74
238722,30,5758,3177,2581,1618,925,693,4140,2252,1888
238759,30,4685,1863,2822,1147,545,602,3538,1318,2220
238810,30,66,4,62,42,1,41,24,3,21
238980,30,1396,601,795,748,357,391,648,244,404
239008,30,1840,856,984,474,243,231,1366,613,753
239017,30,1468,674,794,1452,665,787,16,9,7
239071,30,563,231,332,469,191,278,94,40,54
239080,30,1144,388,756,993,349,644,151,39,112
239105,30,7466,3255,4211,7360,3198,4162,106,57,49
239220,30,2162,987,1175,604,350,254,1558,637,921
239248,30,11010,4583,6427,3068,1507,1561,7942,3076,4866
239309,30,896,222,674,881,218,663,15,4,11
239318,30,2553,1861,692,2496,1818,678,57,43,14
239372,30,2407,905,1502,840,397,443,1567,508,1059
239390,30,659,0,659,622,0,622,37,0,37
239442,30,807,256,551,218,77,141,589,179,410
239460,30,3155,1176,1979,1020,444,576,2135,732,1403
239488,30,7089,2689,4400,2102,1061,1041,4987,1628,3359
239512,30,520,244,276,515,241,274,5,3,2
239628,30,790,399,391,790,399,391,,,
239716,30,1919,801,1118,1899,788,1111,20,13,7
239877,30,45,1,44,43,1,42,2,0,2
239910,30,1421,481,940,679,297,382,742,184,558
240107,30,1639,376,1263,1336,315,1021,303,61,242
240116,30,4105,1582,2523,1909,940,969,2196,642,1554
240125,30,4449,2495,1954,1450,803,647,2999,1692,1307
240170,30,3698,1657,2041,1548,810,738,2150,847,1303
240189,30,9298,4808,4490,8371,4351,4020,927,457,470
240198,30,2183,800,1383,873,411,462,1310,389,921
240268,30,9633,3739,5894,8953,3482,5471,680,257,423
240277,30,6475,2364,4111,4854,1832,3022,1621,532,1089
240329,30,9230,3919,5311,8790,3677,5113,440,242,198
240338,30,976,416,560,938,398,540,38,18,20
240365,30,8419,3578,4841,7123,2925,4198,1296,653,643
240374,30,3244,1396,1848,2562,1111,1451,682,285,397
240392,30,1661,246,1415,829,147,682,832,99,733
240417,30,6480,3754,2726,5333,3116,2217,1147,638,509
240426,30,2075,725,1350,1626,608,1018,449,117,332
240444,30,33506,15907,17599,31884,15022,16862,1622,885,737
240453,30,18322,8418,9904,15669,7125,8544,2653,1293,1360
240462,30,6124,3922,2202,5460,3471,1989,664,451,213
240471,30,4730,1604,3126,4286,1436,2850,444,168,276
240480,30,7103,3123,3980,6400,2840,3560,703,283,420
240505,30,2358,852,1506,1489,592,897,869,260,609
240514,30,961,389,572,518,199,319,443,190,253
240596,30,498,199,299,361,153,208,137,46,91
240620,30,2489,859,1630,1329,516,813,1160,343,817
240657,30,892,338,554,624,261,363,268,77,191
240666,30,1687,678,1009,1077,462,615,610,216,394
240693,30,1394,569,825,860,389,471,534,180,354
240709,30,43,4,39,34,4,30,9,0,9
240718,30,742,704,38,742,704,38,,,
240727,30,8700,4115,4585,7374,3598,3776,1326,517,809
240736,30,1237,415,822,595,196,399,642,219,423
240745,30,1633,738,895,688,296,392,945,442,503
240754,30,2742,1154,1588,2085,855,1230,657,299,358
240790,30,1276,501,775,1011,407,604,265,94,171
240879,30,220,56,164,220,56,164,,,
241100,30,221,119,102,188,100,88,33,19,14
241128,30,266,115,151,230,99,131,36,16,20
241146,30,215,48,167,211,46,165,4,2,2
241182,30,428,93,335,428,93,335,,,
241191,30,852,333,519,732,278,454,120,55,65
241216,30,1513,962,551,994,617,377,519,345,174
241225,30,742,225,517,535,162,373,207,63,144
241304,30,2217,566,1651,1369,341,1028,848,225,623
241331,30,666,76,590,484,56,428,182,20,162
241377,30,616,273,343,385,174,211,231,99,132
241386,30,126,28,98,76,18,58,50,10,40
241395,30,346,115,231,287,100,187,59,15,44
241410,30,4301,1517,2784,3740,1283,2457,561,234,327
241517,30,236,62,174,186,46,140,50,16,34
241614,30,316,176,140,168,105,63,148,71,77
241720,30,675,258,417,496,189,307,179,69,110
241739,30,6116,1842,4274,3647,1141,2506,2469,701,1768
241766,30,315,213,102,201,137,64,114,76,38
241836,30,910,293,617,399,139,260,511,154,357
241906,30,200,59,141,200,59,141,,,
241951,30,485,134,351,336,94,242,149,40,109
242042,30,283,157,126,273,154,119,10,3,7
242112,30,505,240,265,390,200,190,115,40,75
242121,30,282,99,183,170,55,115,112,44,68
242130,30,275,79,196,202,60,142,73,19,54
242149,30,355,94,261,278,72,206,77,22,55
242413,30,66,0,66,66,0,66,,,
242556,30,244,164,80,212,142,70,32,22,10
242565,30,99,72,27,99,72,27,,,
242583,30,216,156,60,200,145,55,16,11,5
242617,30,2688,1178,1510,2307,1006,1301,381,172,209
242626,30,2986,1197,1789,2398,939,1459,588,258,330
242635,30,2665,996,1669,2237,857,1380,428,139,289
242644,30,1092,371,721,908,307,601,184,64,120
242653,30,3549,1506,2043,2723,1136,1587,826,370,456
242662,30,2934,1081,1853,2283,828,1455,651,253,398
242680,30,1288,497,791,1047,397,650,241,100,141
242699,30,1491,440,1051,1203,361,842,288,79,209
242705,30,3784,2091,1693,3228,1771,1457,556,320,236
242750,30,90,29,61,90,29,61,,,
242820,30,948,724,224,948,724,224,,,
242945,30,138,40,98,109,31,78,29,9,20
242954,30,73,22,51,60,17,43,13,5,8
242972,30,23564,8252,15312,16166,5677,10489,7398,2575,4823
243106,30,2166,928,1238,1975,839,1136,191,89,102
243115,30,3085,1140,1945,2836,1043,1793,249,97,152
243133,30,3326,1667,1659,2878,1459,1419,448,208,240
243142,30,2281,824,1457,1799,632,1167,482,192,290
243151,30,2537,813,1724,2271,730,1541,266,83,183
243179,30,2804,941,1863,2566,857,1709,238,84,154
243188,30,452,214,238,411,195,216,41,19,22
243197,30,11050,6097,4953,10032,5474,4558,1018,623,395
243203,30,336,66,270,315,62,253,21,4,17
243212,30,2249,973,1276,2062,894,1168,187,79,108
243221,30,10133,3679,6454,8912,3189,5723,1221,490,731
243346,30,5495,1989,3506,3614,1281,2333,1881,708,1173
243443,30,3572,1263,2309,2984,1028,1956,588,235,353
243568,30,94,21,73,76,17,59,18,4,14
243577,30,3668,2702,966,1710,1206,504,1958,1496,462
243586,30,691,231,460,594,198,396,97,33,64
243601,30,8772,3568,5204,6016,2344,3672,2756,1224,1532
243638,30,1936,795,1141,1350,545,805,586,250,336
243647,30,523,238,285,321,154,167,202,84,118
243665,30,1330,369,961,875,247,628,455,122,333
243744,30,7645,3778,3867,7645,3778,3867,,,
243780,30,37658,21778,15880,35872,20785,15087,1786,993,793
243799,30,56,5,51,56,5,51,,,
243823,30,466,135,331,304,83,221,162,52,110
243832,30,1233,357,876,471,140,331,762,217,545
243841,30,463,85,378,377,71,306,86,14,72
244233,30,85,18,67,17,4,13,68,14,54
244279,30,194,5,189,194,5,189,,,
244437,30,12963,4695,8268,5156,2127,3029,7807,2568,5239
244446,30,2018,690,1328,512,198,314,1506,492,1014
244613,30,406,394,12,253,246,7,153,148,5
245281,30,74,36,38,74,36,38,,,
245625,30,896,328,568,375,152,223,521,176,345
245652,30,368,188,180,356,182,174,12,6,6
245777,30,40,40,0,40,40,0,,,
245838,30,102,32,70,48,11,37,54,21,33
245847,30,48,13,35,17,6,11,31,7,24
245883,30,98,20,78,11,5,6,87,15,72
245892,30,137,36,101,59,17,42,78,19,59
245953,30,1359,467,892,1155,409,746,204,58,146
245962,30,136,10,126,125,8,117,11,2,9
245980,30,29,11,18,29,11,18,,,
245999,30,734,366,368,286,126,160,448,240,208
246017,30,1122,635,487,198,120,78,924,515,409
246035,30,350,51,299,350,51,299,,,
246071,30,69,9,60,69,9,60,,,
246354,30,7624,2838,4786,1295,453,842,6329,2385,3944
246406,30,21,3,18,21,3,18,,,
246415,30,60,8,52,14,1,13,46,7,39
246460,30,156,16,140,156,16,140,,,
246813,30,3115,1067,2048,717,293,424,2398,774,1624
246895,30,661,229,432,340,137,203,321,92,229
246974,30,317,32,285,317,32,285,,,
247010,30,26,0,26,26,0,26,,,
247047,30,91,0,91,91,0,91,,,
247065,30,753,38,715,430,23,407,323,15,308
247153,30,241,56,185,241,56,185,,,
247162,30,8,2,6,,,,8,2,6
247409,30,67,3,64,67,3,64,,,
247603,30,1863,997,866,1123,634,489,740,363,377
247649,30,403,273,130,364,247,117,39,26,13
247773,30,54,54,0,54,54,0,,,
247825,30,5,4,1,1,1,0,4,3,1
247834,30,24159,11001,13158,10143,5181,4962,14016,5820,8196
247940,30,2359,976,1383,1136,543,593,1223,433,790
248192,30,24,0,24,24,0,24,,,
248527,30,70,0,70,70,0,70,,,
248606,30,351,219,132,116,35,81,235,184,51
248624,30,102,18,84,102,18,84,,,
248633,30,57,0,57,57,0,57,,,
248660,30,142,43,99,123,42,81,19,1,18
248703,30,187,3,184,121,2,119,66,1,65
248925,30,709,407,302,581,322,259,128,85,43
248934,30,12022,4673,7349,12022,4673,7349,,,
249061,30,49,0,49,23,0,23,26,0,26
249238,30,364,23,341,243,14,229,121,9,112
249609,30,172,107,65,172,107,65,,,
250027,30,283,93,190,276,93,183,7,0,7
250285,30,317,290,27,233,215,18,84,75,9
250744,30,428,49,379,428,49,379,,,
250902,30,82,10,72,42,5,37,40,5,35
250993,30,493,261,232,56,21,35,437,240,197
251260,30,3539,1539,2000,2127,1042,1085,1412,497,915
251312,30,486,69,417,294,46,248,192,23,169
260336,30,14,0,14,14,0,14,,,
260363,30,19,2,17,19,2,17,,,
260372,30,263,45,218,110,19,91,153,26,127
260664,30,283,214,69,283,214,69,,,
260691,30,820,240,580,820,240,580,,,
260789,30,670,121,549,670,121,549,,,
260813,30,222,23,199,222,23,199,,,
260929,30,202,22,180,200,22,178,2,0,2
260965,30,78,0,78,78,0,78,,,
260992,30,474,23,451,122,7,115,352,16,336
261436,30,889,57,832,889,57,832,,,
261676,30,29,1,28,29,1,28,,,
261685,30,33,2,31,33,2,31,,,
261719,30,165,2,163,165,2,163,,,
261773,30,39,9,30,37,7,30,2,2,0
261861,30,54,2,52,54,2,52,,,
262031,30,5305,2104,3201,3067,1341,1726,2238,763,1475
262086,30,5019,1654,3365,1775,679,1096,3244,975,2269
262129,30,632,206,426,615,199,416,17,7,10
262341,30,450,396,54,450,396,54,,,
262369,30,72,2,70,72,2,70,,,
262457,30,423,68,355,423,68,355,,,
262466,30,54,19,35,54,19,35,,,
362700,30,425,37,388,418,36,382,7,1,6
362782,30,267,7,260,82,3,79,185,4,181
363013,30,36,2,34,36,2,34,,,
363077,30,242,56,186,126,7,119,116,49,67
363147,30,429,13,416,429,13,416,,,
363165,30,2030,1046,984,1058,553,505,972,493,479
363439,30,17,1,16,17,1,16,,,
363633,30,468,162,306,266,105,161,202,57,145
363679,30,206,3,203,171,3,168,35,0,35
363712,30,52,52,0,52,52,0,,,
363882,30,98,1,97,98,1,97,,,
363907,30,369,235,134,230,149,81,139,86,53
363916,30,118,30,88,75,18,57,43,12,31
363934,30,806,648,158,441,358,83,365,290,75
364016,30,4413,1971,2442,1592,839,753,2821,1132,1689
364025,30,7317,3564,3753,2987,1528,1459,4330,2036,2294
364548,30,194,93,101,137,53,84,57,40,17
364575,30,30,1,29,30,1,29,,,
364627,30,80,37,43,51,15,36,29,22,7
364636,30,167,48,119,143,47,96,24,1,23
364751,30,26,1,25,26,1,25,,,
364760,30,73,6,67,36,3,33,37,3,34
364946,30,104,29,75,91,23,68,13,6,7
364964,30,35,1,34,35,1,34,,,
365091,30,363,21,342,363,21,342,,,
365125,30,157,4,153,157,4,153,,,
365198,30,196,52,144,78,5,73,118,47,71
365213,30,384,179,205,152,46,106,232,133,99
365240,30,25,20,5,25,20,5,,,
365374,30,604,352,252,212,100,112,392,252,140
365383,30,105,10,95,105,10,95,,,
365480,30,264,138,126,112,32,80,152,106,46
365505,30,26,4,22,26,4,22,,,
365693,30,154,5,149,154,5,149,,,
365763,30,35,9,26,35,9,26,,,
365824,30,122,4,118,122,4,118,,,
365833,30,127,6,121,127,6,121,,,
366003,30,220,79,141,108,26,82,112,53,59
366155,30,29,16,13,29,16,13,,,
366191,30,1331,1290,41,1331,1290,41,,,
366252,30,4201,2665,1536,3480,2433,1047,721,232,489
366261,30,272,90,182,254,84,170,18,6,12
366270,30,284,9,275,284,9,275,,,
366289,30,7,7,0,7,7,0,,,
366340,30,246,85,161,190,69,121,56,16,40
366395,30,14594,6509,8085,9178,4355,4823,5416,2154,3262
366401,30,6483,3059,3424,2175,1095,1080,4308,1964,2344
366438,30,43,3,40,25,2,23,18,1,17
366465,30,1825,564,1261,744,241,503,1081,323,758
366535,30,295,66,229,295,66,229,,,
366553,30,1294,344,950,462,92,370,832,252,580
366571,30,21,5,16,21,5,16,,,
366623,30,48,22,26,32,10,22,16,12,4
366632,30,8,0,8,8,0,8,,,
366711,30,14937,5734,9203,12112,4553,7559,2825,1181,1644
367051,30,78,2,76,46,2,44,32,0,32
367088,30,120,7,113,75,5,70,45,2,43
367103,30,100,69,31,100,69,31,,,
367112,30,205,35,170,188,31,157,17,4,13
367158,30,46,4,42,46,4,42,,,
367334,30,157,143,14,145,131,14,12,12,0
367361,30,79,51,28,77,50,27,2,1,1
367431,30,28,6,22,28,6,22,,,
367459,30,4872,2005,2867,1688,731,957,3184,1274,1910
367875,30,160,86,74,160,86,74,,,
367884,30,430,184,246,211,93,118,219,91,128
367972,30,105,2,103,105,2,103,,,
367981,30,72,2,70,39,2,37,33,0,33
368230,30,86,3,83,68,3,65,18,0,18
368364,30,330,171,159,95,55,40,235,116,119
368407,30,30,1,29,,,,30,1,29
368443,30,387,44,343,387,44,343,,,
368452,30,270,99,171,270,99,171,,,
368540,30,30,3,27,30,3,27,,,
368629,30,553,114,439,553,114,439,,,
368647,30,11,1,10,11,1,10,,,
368771,30,265,62,203,265,62,203,,,
368832,30,66,10,56,14,2,12,52,8,44
368911,30,959,243,716,235,71,164,724,172,552
369109,30,59,8,51,50,7,43,9,1,8
369400,30,1159,1121,38,1159,1121,38,,,
369419,30,665,318,347,665,318,347,,,
369446,30,75,3,72,48,3,45,27,0,27
369455,30,211,53,158,211,53,158,,,
369516,30,174,44,130,174,44,130,,,
369668,30,168,67,101,134,66,68,34,1,33
369686,30,89,26,63,89,26,63,,,
369695,30,62,7,55,62,7,55,,,
369783,30,327,20,307,327,20,307,,,
369950,30,165,139,26,165,139,26,,,
371052,30,301,58,243,301,58,243,,,
371690,30,1013,222,791,118,16,102,895,206,689
371830,30,76,50,26,72,48,24,4,2,2
371928,30,111,36,75,111,36,75,,,
371964,30,512,357,155,512,357,155,,,
372028,30,123,21,102,123,21,102,,,
372073,30,150,38,112,150,38,112,,,
372082,30,61,26,35,60,26,34,1,0,1
372240,30,18,2,16,17,2,15,1,0,1
372329,30,409,38,371,409,38,371,,,
372356,30,177,8,169,177,8,169,,,
372462,30,122,22,100,121,22,99,1,0,1
372718,30,308,53,255,292,51,241,16,2,14
372921,30,516,178,338,516,178,338,,,
373085,30,48,2,46,38,1,37,10,1,9
373216,30,109,11,98,109,11,98,,,
373456,30,22,0,22,19,0,19,3,0,3
373526,30,272,221,51,272,221,51,,,
373678,30,176,81,95,117,63,54,59,18,41
373696,30,45,31,14,45,31,14,,,
373711,30,76,3,73,76,3,73,,,
373784,30,528,268,260,528,268,260,,,
374316,30,57,45,12,40,31,9,17,14,3
374343,30,57,2,55,57,2,55,,,
374574,30,746,130,616,480,97,383,266,33,233
374592,30,66,7,59,66,7,59,,,
375106,30,125,107,18,107,92,15,18,15,3
375230,30,201,201,0,201,201,0,,,
375373,30,140,41,99,8,0,8,132,41,91
375407,30,106,25,81,85,20,65,21,5,16
375416,30,252,67,185,252,67,185,,,
375540,30,71,2,69,45,1,44,26,1,25
375568,30,51,26,25,10,7,3,41,19,22
375656,30,22,9,13,12,1,11,10,8,2
375683,30,236,165,71,163,111,52,73,54,19
375726,30,538,280,258,387,174,213,151,106,45
375939,30,110,14,96,110,14,96,,,
375966,30,135,14,121,78,7,71,57,7,50
375984,30,204,7,197,162,7,155,42,0,42
376224,30,162,24,138,128,18,110,34,6,28
376242,30,128,73,55,128,73,55,,,
376288,30,100,16,84,100,16,84,,,
376330,30,200,40,160,200,40,160,,,
376385,30,92,22,70,92,22,70,,,
376446,30,74,1,73,12,1,11,62,0,62
376631,30,23,7,16,21,6,15,2,1,1
376677,30,117,52,65,116,51,65,1,1,0
376695,30,1261,572,689,642,289,353,619,283,336
377111,30,264,91,173,264,91,173,,,
377193,30,25,2,23,9,1,8,16,1,15
377218,30,110,109,1,110,109,1,,,
377272,30,18,3,15,18,3,15,,,
377281,30,69,6,63,69,6,63,,,
377315,30,98,0,98,98,0,98,,,
377449,30,174,62,112,130,55,75,44,7,37
377458,30,222,90,132,166,74,92,56,16,40
377485,30,25,2,23,14,1,13,11,1,10
377546,30,103,40,63,93,39,54,10,1,9
377555,30,5432,2876,2556,4679,2462,2217,753,414,339
377564,30,4313,2104,2209,3825,1854,1971,488,250,238
377643,30,100,9,91,100,9,91,,,
377652,30,90,5,85,90,5,85,,,
377661,30,621,70,551,621,70,551,,,
377722,30,422,29,393,422,29,393,,,
377759,30,36,35,1,36,35,1,,,
378105,30,323,17,306,220,10,210,103,7,96
378576,30,262,60,202,43,20,23,219,40,179
378886,30,233,44,189,73,18,55,160,26,134
378956,30,762,719,43,762,719,43,,,
379621,30,78,7,71,57,6,51,21,1,20
379746,30,259,15,244,259,15,244,,,
379782,30,263,26,237,263,26,237,,,
380067,30,137,2,135,137,2,135,,,
380359,30,544,104,440,230,48,182,314,56,258
380368,30,412,142,270,210,84,126,202,58,144
380377,30,611,148,463,400,111,289,211,37,174
380438,30,681,100,581,681,100,581,,,
381255,30,87,68,19,87,68,19,,,
381282,30,94,32,62,94,32,62,,,
381325,30,116,20,96,116,20,96,,,
381370,30,323,12,311,171,5,166,152,7,145
381404,30,367,9,358,203,4,199,164,5,159
381486,30,15,1,14,15,1,14,,,
381699,30,30,0,30,23,0,23,7,0,7
381732,30,65,18,47,17,8,9,48,10,38
382258,30,146,28,118,96,12,84,50,16,34
382416,30,80,13,67,80,13,67,,,
382461,30,42,0,42,31,0,31,11,0,11
382780,30,173,5,168,169,5,164,4,0,4
382911,30,49,25,24,37,20,17,12,5,7
382957,30,455,119,336,445,117,328,10,2,8
383020,30,8,2,6,4,1,3,4,1,3
383084,30,748,200,548,568,145,423,180,55,125
383163,30,242,4,238,27,1,26,215,3,212
383190,30,1634,664,970,732,363,369,902,301,601
383279,30,162,25,137,80,17,63,82,8,74
383297,30,206,7,199,65,1,64,141,6,135
383312,30,80,40,40,80,40,40,,,
383330,30,92,13,79,92,13,79,,,
383367,30,233,69,164,184,67,117,49,2,47
383464,30,132,9,123,132,9,123,,,
383525,30,26,0,26,26,0,26,,,
383765,30,127,2,125,93,2,91,34,0,34
383996,30,345,141,204,119,42,77,226,99,127
384236,30,898,340,558,898,340,558,,,
384245,30,736,310,426,736,310,426,,,
384254,30,431,287,144,418,278,140,13,9,4
384333,30,6223,2338,3885,2148,881,1267,4075,1457,2618
384342,30,3023,1287,1736,1486,679,807,1537,608,929
384412,30,171,90,81,171,90,81,,,
384421,30,91,91,0,91,91,0,,,
385132,30,141,12,129,95,10,85,46,2,44
385503,30,241,17,224,241,17,224,,,
385619,30,2212,1239,973,2212,1239,973,,,
386153,30,475,0,475,475,0,475,,,
386472,30,727,115,612,509,83,426,218,32,186
387925,30,106,12,94,106,12,94,,,
388520,30,351,206,145,131,76,55,220,130,90
388663,30,79,3,76,79,3,76,,,
389860,30,238,128,110,132,42,90,106,86,20
390905,30,225,127,98,67,45,22,158,82,76
391005,30,108,5,103,108,5,103,,,
391759,30,29,0,29,,,,29,0,29
392257,30,2991,234,2757,2991,234,2757,,,
392354,30,9,4,5,9,4,5,,,
392415,30,327,82,245,327,82,245,,,
393524,30,48,1,47,48,1,47,,,
393649,30,1248,537,711,1248,537,711,,,
393861,30,357,58,299,340,56,284,17,2,15
395362,30,1087,353,734,288,91,197,799,262,537
395690,30,264,143,121,264,143,121,,,
397942,30,1077,344,733,1077,344,733,,,
399212,30,11327,7721,3606,2202,1111,1091,9125,6610,2515
399869,30,521,499,22,521,499,22,,,
399911,30,435,151,284,435,151,284,,,
400080,30,1100,761,339,1100,761,339,,,
400187,30,550,48,502,291,31,260,259,17,242
400558,30,47,21,26,47,21,26,,,
401223,30,179,39,140,121,26,95,58,13,45
401764,30,240,4,236,107,1,106,133,3,130
402563,30,178,8,170,178,8,170,,,
402800,30,134,0,134,121,0,121,13,0,13
403469,30,308,123,185,234,110,124,74,13,61
403478,30,437,188,249,343,165,178,94,23,71
403487,30,482,210,272,399,187,212,83,23,60
404055,30,301,39,262,301,39,262,,,
404338,30,17,11,6,17,11,6,,,
404426,30,2378,1064,1314,861,462,399,1517,602,915
404684,30,318,99,219,318,99,219,,,
404718,30,214,7,207,214,7,207,,,
404912,30,768,123,645,768,123,645,,,
404994,30,2741,873,1868,2365,792,1573,376,81,295
405012,30,66,1,65,66,1,65,,,
405058,30,155,155,0,155,155,0,,,
405076,30,518,86,432,518,86,432,,,
405854,30,225,225,0,225,225,0,,,
405872,30,2008,804,1204,855,406,449,1153,398,755
406024,30,2374,299,2075,1290,176,1114,1084,123,961
406033,30,3722,465,3257,2179,282,1897,1543,183,1360
406149,30,93,25,68,93,25,68,,,
406325,30,105,14,91,25,1,24,80,13,67
406361,30,19,1,18,19,1,18,,,
406422,30,74,5,69,32,2,30,42,3,39
406486,30,48,19,29,23,8,15,25,11,14
406547,30,147,17,130,42,6,36,105,11,94
407090,30,574,15,559,203,8,195,371,7,364
407142,30,89,1,88,89,1,88,,,
407151,30,53,0,53,53,0,53,,,
407179,30,79,0,79,51,0,51,28,0,28
407355,30,166,13,153,166,13,153,,,
407391,30,132,29,103,65,5,60,67,24,43
407407,30,74,16,58,51,14,37,23,2,21
407425,30,80,12,68,43,0,43,37,12,25
407434,30,55,0,55,55,0,55,,,
407461,30,86,58,28,86,58,28,,,
407470,30,126,3,123,100,3,97,26,0,26
407489,30,76,51,25,23,12,11,53,39,14
407513,30,184,82,102,80,17,63,104,65,39
407522,30,26,9,17,,,,26,9,17
407568,30,174,6,168,143,3,140,31,3,28
407577,30,75,30,45,62,22,40,13,8,5
407595,30,72,12,60,72,12,60,,,
407610,30,42,19,23,7,3,4,35,16,19
407629,30,12,2,10,12,2,10,,,
407683,30,78,4,74,28,1,27,50,3,47
407708,30,233,7,226,233,7,226,,,
407735,30,47,2,45,47,2,45,,,
407832,30,164,113,51,63,45,18,101,68,33
408066,30,175,47,128,135,38,97,40,9,31
408163,30,48,1,47,48,1,47,,,
408385,30,712,234,478,712,234,478,,,
408729,30,92,11,81,87,11,76,5,0,5
408844,30,2688,756,1932,1694,500,1194,994,256,738
408862,30,265,9,256,91,5,86,174,4,170
409032,30,52,1,51,52,1,51,,,
409120,30,99,28,71,99,28,71,,,
409193,30,155,154,1,155,154,1,,,
409315,30,19668,8218,11450,6552,2822,3730,13116,5396,7720
409537,30,23,10,13,,,,23,10,13
409591,30,119,34,85,57,18,39,62,16,46
409698,30,6588,2503,4085,5782,2107,3675,806,396,410
410797,30,275,156,119,275,156,119,,,
410964,30,41,1,40,35,1,34,6,0,6
411684,30,98,28,70,98,28,70,,,
411754,30,40,8,32,40,8,32,,,
412173,30,452,40,412,412,37,375,40,3,37
412535,30,39,3,36,38,3,35,1,0,1
412544,30,156,15,141,110,15,95,46,0,46
412599,30,379,121,258,379,121,258,,,
413176,30,32,17,15,32,17,15,,,
413413,30,12378,2380,9998,2326,431,1895,10052,1949,8103
413617,30,160,43,117,64,19,45,96,24,72
413626,30,156,65,91,82,39,43,74,26,48
413680,30,319,293,26,319,293,26,,,
413778,30,368,22,346,190,10,180,178,12,166
413820,30,6,0,6,6,0,6,,,
413893,30,1269,729,540,1269,729,540,,,
413945,30,50,6,44,50,6,44,,,
413972,30,27,2,25,27,2,25,,,
414063,30,109,3,106,92,3,89,17,0,17
414124,30,314,235,79,251,193,58,63,42,21
414461,30,2122,2020,102,1856,1766,90,266,254,12
414489,30,54,2,52,54,2,52,,,
414540,30,283,9,274,259,8,251,24,1,23
414595,30,215,43,172,26,9,17,189,34,155
414869,30,283,20,263,102,16,86,181,4,177
414878,30,282,106,176,156,53,103,126,53,73
414911,30,825,321,504,571,246,325,254,75,179
414939,30,281,22,259,281,22,259,,,
415039,30,48,1,47,27,1,26,21,0,21
415057,30,39,39,0,39,39,0,,,
415987,30,95,6,89,95,6,89,,,
416458,30,202,52,150,202,52,150,,,
416801,30,331,67,264,293,62,231,38,5,33
417008,30,136,5,131,136,5,131,,,
417062,30,45,0,45,31,0,31,14,0,14
417105,30,362,224,138,214,130,84,148,94,54
417123,30,60,13,47,28,9,19,32,4,28
417248,30,50,49,1,50,49,1,,,
417275,30,35,31,4,35,31,4,,,
417327,30,218,27,191,47,5,42,171,22,149
417442,30,52,5,47,52,5,47,,,
417503,30,265,3,262,173,3,170,92,0,92
417600,30,16,0,16,16,0,16,,,
417628,30,27,2,25,25,2,23,2,0,2
417637,30,56,21,35,56,21,35,,,
417646,30,23,1,22,23,1,22,,,
417655,30,28,0,28,28,0,28,,,
417682,30,26,3,23,26,3,23,,,
417716,30,183,11,172,183,11,172,,,
417725,30,42,0,42,42,0,42,,,
417734,30,150,23,127,58,13,45,92,10,82
417752,30,31,13,18,29,11,18,2,2,0
417831,30,122,84,38,122,84,38,,,
417840,30,400,17,383,400,17,383,,,
417868,30,46,15,31,28,6,22,18,9,9
417886,30,24,1,23,24,1,23,,,
417910,30,212,31,181,212,31,181,,,
417983,30,31,1,30,,,,31,1,30
417992,30,51,5,46,51,5,46,,,
418001,30,87,7,80,87,7,80,,,
418010,30,82,4,78,35,2,33,47,2,45
418029,30,39,2,37,39,2,37,,,
418038,30,146,13,133,146,13,133,,,
418056,30,22,7,15,22,7,15,,,
418065,30,266,28,238,195,24,171,71,4,67
418083,30,48,7,41,48,7,41,,,
418126,30,220,62,158,128,32,96,92,30,62
418171,30,76,76,0,76,76,0,,,
418199,30,36,33,3,36,33,3,,,
418205,30,248,131,117,177,121,56,71,10,61
418223,30,103,1,102,103,1,102,,,
418250,30,195,126,69,29,21,8,166,105,61
418269,30,280,165,115,280,165,115,,,
418278,30,66,38,28,40,17,23,26,21,5
418296,30,1571,779,792,392,132,260,1179,647,532
418302,30,169,65,104,112,19,93,57,46,11
418320,30,980,552,428,44,11,33,936,541,395
418348,30,111,88,23,59,49,10,52,39,13
418357,30,181,84,97,49,19,30,132,65,67
418409,30,223,110,113,159,70,89,64,40,24
418427,30,81,7,74,60,5,55,21,2,19
418445,30,18,0,18,18,0,18,,,
418454,30,127,48,79,120,41,79,7,7,0
418481,30,53,2,51,53,2,51,,,
418515,30,68,4,64,44,4,40,24,0,24
418524,30,47,2,45,47,2,45,,,
418533,30,353,45,308,269,28,241,84,17,67
418542,30,111,15,96,46,5,41,65,10,55
418560,30,109,19,90,19,1,18,90,18,72
418588,30,28,3,25,28,3,25,,,
418612,30,10,1,9,10,1,9,,,
418658,30,403,357,46,403,357,46,,,
418773,30,303,137,166,249,121,128,54,16,38
418782,30,211,202,9,211,202,9,,,
418889,30,58,51,7,37,30,7,21,21,0
418913,30,8,3,5,8,3,5,,,
418968,30,188,6,182,188,6,182,,,
419031,30,26,7,19,26,7,19,,,
419095,30,32,3,29,32,3,29,,,
419183,30,79,4,75,79,4,75,,,
419217,30,76,16,60,76,16,60,,,
419226,30,461,236,225,346,189,157,115,47,68
419235,30,143,36,107,143,36,107,,,
419244,30,183,146,37,99,80,19,84,66,18
419253,30,121,79,42,121,79,42,,,
419280,30,32,2,30,23,1,22,9,1,8
419332,30,2,2,0,2,2,0,,,
419341,30,8,2,6,8,2,6,,,
419420,30,33,14,19,33,14,19,,,
419484,30,25,2,23,25,2,23,,,
419633,30,85,9,76,85,9,76,,,
419703,30,460,432,28,460,432,28,,,
419712,30,116,108,8,116,108,8,,,
419721,30,224,215,9,224,215,9,,,
420024,30,204,20,184,164,13,151,40,7,33
420042,30,55,33,22,55,33,22,,,
420130,30,307,16,291,307,16,291,,,
420255,30,29,27,2,29,27,2,,,
420325,30,77,77,0,77,77,0,,,
420343,30,1000,965,35,780,754,26,220,211,9
420370,30,479,159,320,479,159,320,,,
420398,30,12720,5262,7458,2868,1253,1615,9852,4009,5843
420431,30,1381,471,910,321,104,217,1060,367,693
420440,30,846,272,574,285,105,180,561,167,394
420468,30,250,93,157,204,88,116,46,5,41
420538,30,853,270,583,505,175,330,348,95,253
420556,30,461,154,307,209,82,127,252,72,180
420723,30,231,96,135,99,39,60,132,57,75
420981,30,269,31,238,269,31,238,,,
421513,30,67,10,57,62,9,53,5,1,4
421610,30,119,10,109,119,10,109,,,
421665,30,45,1,44,9,0,9,36,1,35
421708,30,1084,137,947,704,85,619,380,52,328
421717,30,28,19,9,17,10,7,11,9,2
421771,30,38,0,38,29,0,29,9,0,9
421832,30,203,91,112,183,89,94,20,2,18
421841,30,246,97,149,246,97,149,,,
421878,30,369,41,328,251,25,226,118,16,102
421896,30,141,42,99,141,42,99,,,
422020,30,203,197,6,203,197,6,,,
422695,30,356,48,308,356,48,308,,,
422835,30,287,57,230,287,57,230,,,
423120,30,235,9,226,235,9,226,,,
423397,30,495,299,196,495,299,196,,,
423412,30,42,35,7,42,35,7,,,
423652,30,335,88,247,172,43,129,163,45,118
425250,30,113,14,99,63,8,55,50,6,44
425986,30,197,24,173,197,24,173,,,
426314,30,9143,7814,1329,2243,1870,373,6900,5944,956
427308,30,92,2,90,92,2,90,,,
427335,30,84,0,84,78,0,78,6,0,6
427894,30,82,80,2,82,80,2,,,
427973,30,224,197,27,153,133,20,71,64,7
427982,30,177,104,73,140,89,51,37,15,22
427991,30,325,159,166,285,129,156,40,30,10
428000,30,97,36,61,97,36,61,,,
428019,30,55,24,31,49,21,28,6,3,3
428055,30,191,40,151,191,40,151,,,
428125,30,47,33,14,45,31,14,2,2,0
428143,30,6,1,5,6,1,5,,,
428170,30,682,76,606,423,45,378,259,31,228
428259,30,77,14,63,26,6,20,51,8,43
428392,30,862,387,475,427,188,239,435,199,236
429012,30,158,136,22,158,136,22,,,
429128,30,283,11,272,28,1,27,255,10,245
430184,30,1422,366,1056,154,81,73,1268,285,983
430227,30,77,1,76,66,1,65,11,0,11
430245,30,616,118,498,616,118,498,,,
430306,30,45,5,40,31,4,27,14,1,13
430403,30,322,26,296,322,26,296,,,
430564,30,25,8,17,8,1,7,17,7,10
430582,30,417,194,223,417,194,223,,,
430670,30,63,16,47,63,16,47,,,
430704,30,27,5,22,25,5,20,2,0,2
430795,30,155,44,111,155,44,111,,,
430883,30,28,2,26,28,2,26,,,
430908,30,42,8,34,28,7,21,14,1,13
430935,30,656,509,147,439,347,92,217,162,55
430971,30,61,13,48,61,13,48,,,
431017,30,99,48,51,86,38,48,13,10,3
431071,30,22,3,19,13,1,12,9,2,7
431105,30,88,11,77,43,5,38,45,6,39
431123,30,170,164,6,170,164,6,,,
431141,30,1403,535,868,1361,531,830,42,4,38
431169,30,78,16,62,64,13,51,14,3,11
431187,30,77,68,9,77,68,9,,,
431196,30,112,9,103,112,9,103,,,
431266,30,100,3,97,42,1,41,58,2,56
431275,30,64,3,61,18,1,17,46,2,44
431284,30,100,3,97,91,1,90,9,2,7
431558,30,283,92,191,262,90,172,21,2,19
431600,30,148,19,129,123,17,106,25,2,23
431716,30,435,256,179,435,256,179,,,
431929,30,5,3,2,5,3,2,,,
431983,30,88,88,0,88,88,0,,,
432117,30,181,1,180,114,1,113,67,0,67
432269,30,39,32,7,39,32,7,,,
432384,30,502,109,393,502,109,393,,,
432524,30,107,33,74,107,33,74,,,
433004,30,369,87,282,369,87,282,,,
433013,30,699,250,449,699,250,449,,,
433040,30,25,2,23,25,2,23,,,
433068,30,455,278,177,371,210,161,84,68,16
433101,30,752,75,677,441,42,399,311,33,278
433138,30,130,30,100,113,21,92,17,9,8
433174,30,472,53,419,73,10,63,399,43,356
433387,30,107952,41445,66507,107952,41445,66507,,,
433420,30,292,248,44,292,248,44,,,
433536,30,372,43,329,189,23,166,183,20,163
433660,30,13884,5960,7924,11109,4696,6413,2775,1264,1511
434016,30,113,34,79,37,13,24,76,21,55
434061,30,4804,1831,2973,2679,1194,1485,2125,637,1488
434140,30,710,142,568,710,142,568,,,
434159,30,515,389,126,515,389,126,,,
434274,30,83,12,71,56,7,49,27,5,22
434283,30,30,3,27,28,2,26,2,1,1
434308,30,356,13,343,356,13,343,,,
434344,30,223,8,215,221,8,213,2,0,2
434362,30,35,34,1,35,34,1,,,
434432,30,14,3,11,14,3,11,,,
434496,30,81,0,81,81,0,81,,,
434539,30,55,18,37,7,2,5,48,16,32
434584,30,179,39,140,45,13,32,134,26,108
434672,30,14311,5159,9152,4083,1866,2217,10228,3293,6935
434751,30,96,30,66,57,23,34,39,7,32
434821,30,822,28,794,822,28,794,,,
434830,30,194,6,188,131,6,125,63,0,63
434900,30,335,78,257,190,39,151,145,39,106
434937,30,33,33,0,33,33,0,,,
435000,30,27,3,24,27,3,24,,,
436003,30,71,10,61,46,6,40,25,4,21
436030,30,231,100,131,136,59,77,95,41,54
436100,30,13,2,11,13,2,11,,,
436304,30,1656,924,732,911,565,346,745,359,386
436429,30,5827,3867,1960,5827,3867,1960,,,
436553,30,372,63,309,372,63,309,,,
436599,30,102,19,83,18,5,13,84,14,70
436614,30,46,27,19,24,11,13,22,16,6
436632,30,145,18,127,74,12,62,71,6,65
436641,30,89,31,58,89,31,58,,,
436650,30,174,18,156,174,18,156,,,
436775,30,129,6,123,129,6,123,,,
436818,30,783,342,441,720,312,408,63,30,33
436827,30,506,280,226,467,253,214,39,27,12
436836,30,2343,1185,1158,2182,1092,1090,161,93,68
437097,30,387,215,172,361,201,160,26,14,12
437103,30,6869,2228,4641,3283,1217,2066,3586,1011,2575
437237,30,58,50,8,58,50,8,,,
437316,30,343,52,291,339,51,288,4,1,3
437325,30,130,25,105,11,5,6,119,20,99
437556,30,1246,555,691,1197,554,643,49,1,48
437608,30,145,102,43,143,100,43,2,2,0
437635,30,688,70,618,688,70,618,,,
437723,30,73,18,55,73,18,55,,,
437732,30,103,9,94,78,6,72,25,3,22
437750,30,82,81,1,82,81,1,,,
437769,30,108,7,101,108,7,101,,,
437778,30,212,4,208,212,4,208,,,
437857,30,108,0,108,81,0,81,27,0,27
437936,30,619,66,553,619,66,553,,,
438179,30,248,35,213,248,35,213,,,
438221,30,171,15,156,164,15,149,7,0,7
438258,30,414,98,316,414,98,316,,,
438285,30,228,19,209,228,19,209,,,
438337,30,142,52,90,114,42,72,28,10,18
438498,30,1226,201,1025,255,49,206,971,152,819
438504,30,1366,1310,56,1366,1310,56,,,
438586,30,1086,331,755,863,256,607,223,75,148
438674,30,63,0,63,39,0,39,24,0,24
438708,30,187,41,146,105,26,79,82,15,67
438735,30,191,174,17,146,134,12,45,40,5
438984,30,35,12,23,35,12,23,,,
439020,30,7,3,4,5,1,4,2,2,0
439118,30,393,50,343,393,50,343,,,
439190,30,1353,689,664,780,401,379,573,288,285
439367,30,1132,312,820,1132,312,820,,,
439455,30,213,9,204,114,1,113,99,8,91
439473,30,213,91,122,115,51,64,98,40,58
439491,30,309,53,256,309,53,256,,,
439507,30,299,23,276,299,23,276,,,
439570,30,515,27,488,515,27,488,,,
439622,30,312,49,263,312,49,263,,,
439668,30,214,185,29,214,185,29,,,
439686,30,23,1,22,23,1,22,,,
439701,30,298,113,185,149,55,94,149,58,91
439738,30,387,76,311,387,76,311,,,
439747,30,158,32,126,114,25,89,44,7,37
439774,30,53,18,35,38,16,22,15,2,13
439783,30,84,30,54,70,25,45,14,5,9
439792,30,442,39,403,442,39,403,,,
439844,30,47,1,46,47,1,46,,,
439862,30,82,24,58,66,18,48,16,6,10
439871,30,140,4,136,123,4,119,17,0,17
439899,30,77,37,40,50,17,33,27,20,7
439932,30,66,10,56,66,10,56,,,
439969,30,76,26,50,76,26,50,,,
440059,30,716,660,56,554,508,46,162,152,10
440101,30,101,6,95,48,2,46,53,4,49
440226,30,50,0,50,50,0,50,,,
440262,30,423,401,22,337,322,15,86,79,7
440271,30,134,68,66,134,68,66,,,
440396,30,182,76,106,174,73,101,8,3,5
440402,30,1163,374,789,686,230,456,477,144,333
440651,30,574,151,423,354,90,264,220,61,159
440730,30,304,110,194,304,110,194,,,
440749,30,41,32,9,2,2,0,39,30,9
440776,30,48,9,39,48,9,39,,,
440794,30,316,79,237,302,76,226,14,3,11
440819,30,18,9,9,18,9,9,,,
440828,30,1039,528,511,566,293,273,473,235,238
440855,30,113,4,109,113,4,109,,,
440989,30,513,391,122,513,391,122,,,
441025,30,240,60,180,234,59,175,6,1,5
441052,30,1374,324,1050,1374,324,1050,,,
441070,30,117,40,77,20,8,12,97,32,65
441168,30,23,1,22,23,1,22,,,
441210,30,252,117,135,2,0,2,250,117,133
441229,30,1389,255,1134,1389,255,1134,,,
441256,30,23,0,23,23,0,23,,,
441371,30,5978,194,5784,5962,193,5769,16,1,15
441380,30,227,68,159,203,62,141,24,6,18
441414,30,145,39,106,29,12,17,116,27,89
441423,30,218,48,170,218,48,170,,,
441487,30,55,3,52,54,3,51,1,0,1
441496,30,163,141,22,134,115,19,29,26,3
441502,30,345,30,315,345,30,315,,,
441548,30,86,18,68,86,18,68,,,
441575,30,247,34,213,247,34,213,,,
441593,30,11,0,11,11,0,11,,,
441609,30,102,102,0,102,102,0,,,
441618,30,26,0,26,15,0,15,11,0,11
441636,30,476,68,408,416,58,358,60,10,50
441645,30,132,2,130,91,1,90,41,1,40
441663,30,293,23,270,293,23,270,,,
441672,30,34,4,30,34,4,30,,,
441690,30,136,77,59,61,37,24,75,40,35
441706,30,335,122,213,335,122,213,,,
441742,30,746,65,681,637,58,579,109,7,102
441760,30,2887,1291,1596,1253,684,569,1634,607,1027
441788,30,529,479,50,372,335,37,157,144,13
441830,30,43,13,30,43,13,30,,,
441858,30,117,5,112,115,5,110,2,0,2
441876,30,233,10,223,120,7,113,113,3,110
441900,30,4110,869,3241,1969,400,1569,2141,469,1672
441937,30,6459,2199,4260,4986,1647,3339,1473,552,921
441982,30,361,174,187,360,174,186,1,0,1
442073,30,792,155,637,514,115,399,278,40,238
442134,30,363,50,313,363,50,313,,,
442213,30,39,0,39,33,0,33,6,0,6
442240,30,403,76,327,230,41,189,173,35,138
442329,30,937,844,93,937,844,93,,,
442356,30,1543,166,1377,645,72,573,898,94,804
442383,30,115,21,94,115,21,94,,,
442426,30,416,36,380,268,21,247,148,15,133
442435,30,31,5,26,31,5,26,,,
442444,30,736,419,317,736,419,317,,,
442523,30,78,33,45,71,31,40,7,2,5
442569,30,4498,2037,2461,1360,607,753,3138,1430,1708
442602,30,490,76,414,490,76,414,,,
442611,30,1211,1144,67,1211,1144,67,,,
442639,30,80,57,23,80,57,23,,,
442657,30,246,18,228,246,18,228,,,
442781,30,636,123,513,195,37,158,441,86,355
442842,30,45,12,33,32,9,23,13,3,10
442879,30,900,65,835,670,48,622,230,17,213
442888,30,23,23,0,23,23,0,,,
442930,30,550,275,275,516,254,262,34,21,13
442949,30,3,0,3,,,,3,0,3
442976,30,93,3,90,93,3,90,,,
442985,30,250,28,222,250,28,222,,,
443021,30,57,47,10,57,47,10,,,
443049,30,139,82,57,73,45,28,66,37,29
443058,30,31,11,20,11,3,8,20,8,12
443100,30,59,40,19,59,40,19,,,
443137,30,331,58,273,331,58,273,,,
443146,30,64,53,11,50,40,10,14,13,1
443207,30,129,121,8,129,121,8,,,
443216,30,151,115,36,151,115,36,,,
443225,30,72,57,15,72,57,15,,,
443234,30,162,3,159,162,3,159,,,
443252,30,1635,993,642,1635,993,642,,,
443261,30,210,10,200,152,8,144,58,2,56
443289,30,168,26,142,168,26,142,,,
443298,30,27,23,4,27,23,4,,,
443322,30,30,5,25,30,5,25,,,
443331,30,2581,531,2050,2096,415,1681,485,116,369
443340,30,43,20,23,37,19,18,6,1,5
443377,30,54,48,6,54,48,6,,,
443410,30,1129,797,332,1041,729,312,88,68,20
443492,30,1041,470,571,788,383,405,253,87,166
443562,30,335,55,280,209,37,172,126,18,108
443571,30,105,56,49,105,56,49,,,
443599,30,793,57,736,163,17,146,630,40,590
443632,30,99,61,38,99,61,38,,,
443641,30,167,3,164,70,1,69,97,2,95
443650,30,1010,168,842,912,159,753,98,9,89
443669,30,114,7,107,114,7,107,,,
443696,30,55,12,43,55,12,43,,,
443748,30,700,164,536,682,161,521,18,3,15
443766,30,2569,449,2120,126,53,73,2443,396,2047
443784,30,1347,299,1048,73,27,46,1274,272,1002
443951,30,51,25,26,51,25,26,,,
443979,30,43,0,43,16,0,16,27,0,27
444051,30,86,3,83,70,3,67,16,0,16
444088,30,556,65,491,556,65,491,,,
444130,30,158,57,101,41,27,14,117,30,87
444194,30,61,3,58,61,3,58,,,
444219,30,8067,3563,4504,1771,814,957,6296,2749,3547
444228,30,32,0,32,32,0,32,,,
444255,30,63,12,51,63,12,51,,,
444264,30,12,3,9,11,3,8,1,0,1
444282,30,84,2,82,49,2,47,35,0,35
444291,30,90,3,87,57,1,56,33,2,31
444307,30,69,4,65,47,3,44,22,1,21
444325,30,105,14,91,89,12,77,16,2,14
444334,30,62,5,57,62,5,57,,,
444361,30,63,25,38,63,25,38,,,
444370,30,48,48,0,48,48,0,,,
444398,30,120,56,64,86,46,40,34,10,24
444404,30,15,10,5,8,5,3,7,5,2
444413,30,155,155,0,155,155,0,,,
444440,30,25,2,23,25,2,23,,,
444468,30,23,1,22,21,1,20,2,0,2
444486,30,340,17,323,304,14,290,36,3,33
444510,30,116,14,102,116,14,102,,,
444529,30,115,21,94,115,21,94,,,
444556,30,543,241,302,543,241,302,,,
444565,30,298,144,154,236,113,123,62,31,31
444583,30,364,171,193,364,171,193,,,
444635,30,90,9,81,6,0,6,84,9,75
444662,30,108,96,12,108,96,12,,,
444671,30,87,44,43,87,44,43,,,
444714,30,248,17,231,248,17,231,,,
444732,30,30,2,28,30,2,28,,,
444778,30,58,24,34,31,12,19,27,12,15
444787,30,2273,310,1963,1441,197,1244,832,113,719
444796,30,131,73,58,131,73,58,,,
444811,30,619,33,586,327,18,309,292,15,277
444857,30,141,3,138,60,1,59,81,2,79
444866,30,185,19,166,119,14,105,66,5,61
444893,30,341,13,328,341,13,328,,,
444936,30,135,47,88,133,47,86,2,0,2
444945,30,234,23,211,234,23,211,,,
444954,30,990,373,617,633,268,365,357,105,252
445027,30,11094,4019,7075,9919,3677,6242,1175,342,833
445133,30,149,53,96,104,41,63,45,12,33
445188,30,8321,3972,4349,8227,3919,4308,94,53,41
445203,30,223,34,189,223,34,189,,,
445212,30,225,34,191,126,19,107,99,15,84
445230,30,786,214,572,786,214,572,,,
445249,30,272,60,212,272,60,212,,,
445258,30,6,1,5,6,1,5,,,
445267,30,1502,298,1204,889,176,713,613,122,491
445364,30,361,36,325,361,36,325,,,
445461,30,746,275,471,724,269,455,22,6,16
445498,30,8,8,0,8,8,0,,,
445540,30,66,0,66,66,0,66,,,
445638,30,10,0,10,6,0,6,4,0,4
445647,30,167,2,165,94,1,93,73,1,72
445656,30,175,7,168,109,5,104,66,2,64
445692,30,517,438,79,470,398,72,47,40,7
445708,30,1262,438,824,1231,421,810,31,17,14
445735,30,559,142,417,559,142,417,,,
445744,30,481,89,392,481,89,392,,,
445762,30,244,224,20,195,179,16,49,45,4
445780,30,30,3,27,30,3,27,,,
445799,30,1031,978,53,1031,978,53,,,
445841,30,141,0,141,107,0,107,34,0,34
445850,30,145,0,145,97,0,97,48,0,48
445911,30,831,332,499,537,211,326,294,121,173
445948,30,1576,221,1355,1576,221,1355,,,
445957,30,319,62,257,,,,319,62,257
446048,30,1240,557,683,1230,551,679,10,6,4
446084,30,82,7,75,21,2,19,61,5,56
446093,30,104,9,95,88,7,81,16,2,14
446109,30,323,37,286,249,24,225,74,13,61
446118,30,649,118,531,649,118,531,,,
446127,30,200,5,195,200,5,195,,,
446163,30,483,442,41,331,309,22,152,133,19
446206,30,25,6,19,16,2,14,9,4,5
446224,30,12,6,6,,,,12,6,6
446233,30,144,88,56,135,85,50,9,3,6
446242,30,117,41,76,117,41,76,,,
446251,30,104,20,84,104,20,84,,,
446260,30,765,22,743,765,22,743,,,
446288,30,75,4,71,44,0,44,31,4,27
446303,30,45,1,44,29,0,29,16,1,15
446349,30,25,3,22,25,3,22,,,
446385,30,251,144,107,236,134,102,15,10,5
446394,30,20,6,14,3,2,1,17,4,13
446455,30,25,23,2,25,23,2,,,
446516,30,4,1,3,4,1,3,,,
446525,30,271,228,43,271,228,43,,,
446552,30,1568,803,765,1568,803,765,,,
446561,30,1710,400,1310,1710,400,1310,,,
446589,30,402,76,326,402,76,326,,,
446598,30,14,0,14,12,0,12,2,0,2
446604,30,2399,2399,0,2399,2399,0,,,
446640,30,631,427,204,588,402,186,43,25,18
446774,30,1489,542,947,659,264,395,830,278,552
447014,30,175,13,162,175,13,162,,,
447023,30,1637,695,942,1626,695,931,11,0,11
447050,30,175,43,132,50,13,37,125,30,95
447148,30,170,5,165,111,4,107,59,1,58
447166,30,56,5,51,33,5,28,23,0,23
447175,30,64,2,62,45,1,44,19,1,18
447263,30,1996,268,1728,1518,183,1335,478,85,393
447351,30,493,248,245,493,248,245,,,
447379,30,12,10,2,12,10,2,,,
447421,30,230,25,205,230,25,205,,,
447449,30,46,9,37,27,7,20,19,2,17
447458,30,253,204,49,253,204,49,,,
447467,30,70,3,67,70,3,67,,,
447582,30,773,241,532,544,196,348,229,45,184
447591,30,651,61,590,651,61,590,,,
447607,30,1514,776,738,1514,776,738,,,
447616,30,1182,628,554,1182,628,554,,,
447689,30,10377,4329,6048,6796,2838,3958,3581,1491,2090
447704,30,139,4,135,139,4,135,,,
447713,30,206,56,150,206,56,150,,,
447722,30,30,3,27,30,3,27,,,
447731,30,165,5,160,112,5,107,53,0,53
447759,30,198,49,149,173,45,128,25,4,21
447768,30,1526,299,1227,1526,299,1227,,,
447777,30,843,438,405,19,14,5,824,424,400
447795,30,42,8,34,42,8,34,,,
447810,30,219,21,198,219,21,198,,,
447847,30,128,120,8,128,120,8,,,
447865,30,8,3,5,4,2,2,4,1,3
447874,30,213,208,5,213,208,5,,,
447883,30,166,23,143,71,12,59,95,11,84
447892,30,127,12,115,77,9,68,50,3,47
447908,30,66,3,63,42,1,41,24,2,22
447917,30,50,10,40,50,10,40,,,
447935,30,286,14,272,286,14,272,,,
447953,30,416,210,206,352,180,172,64,30,34
447962,30,163,14,149,163,14,149,,,
447971,30,29,0,29,29,0,29,,,
447980,30,96,4,92,21,1,20,75,3,72
447999,30,181,46,135,181,46,135,,,
448026,30,128,5,123,93,4,89,35,1,34
448071,30,333,16,317,217,7,210,116,9,107
448123,30,208,17,191,208,17,191,,,
448196,30,102,9,93,97,9,88,5,0,5
448220,30,152,8,144,152,8,144,,,
448239,30,117,1,116,117,1,116,,,
448248,30,2481,1542,939,382,101,281,2099,1441,658
448257,30,17,0,17,2,0,2,15,0,15
448275,30,24,1,23,24,1,23,,,
448354,30,220,23,197,140,10,130,80,13,67
448372,30,196,91,105,196,91,105,,,
448424,30,71,5,66,32,1,31,39,4,35
448433,30,1232,1193,39,1232,1193,39,,,
448594,30,2796,1019,1777,1035,405,630,1761,614,1147
448600,30,257,16,241,257,16,241,,,
448619,30,654,43,611,323,27,296,331,16,315
448646,30,34,0,34,34,0,34,,,
448673,30,2613,256,2357,947,100,847,1666,156,1510
448770,30,284,271,13,267,256,11,17,15,2
448798,30,150,5,145,150,5,145,,,
448859,30,154,144,10,154,144,10,,,
448895,30,526,90,436,526,90,436,,,
449038,30,1276,301,975,137,63,74,1139,238,901
449074,30,576,80,496,576,80,496,,,
449083,30,123,122,1,123,122,1,,,
449092,30,133,132,1,133,132,1,,,
449135,30,206,62,144,144,48,96,62,14,48
449250,30,688,132,556,688,132,556,,,
449311,30,182,1,181,65,0,65,117,1,116
449320,30,673,650,23,471,457,14,202,193,9
449339,30,37245,23799,13446,2403,1188,1215,34842,22611,12231
449348,30,79,26,53,7,2,5,72,24,48
449357,30,62,3,59,62,3,59,,,
449384,30,272,174,98,253,160,93,19,14,5
449393,30,85,33,52,85,33,52,,,
449445,30,121,22,99,121,22,99,,,
449454,30,44,7,37,,,,44,7,37
449463,30,157,21,136,131,17,114,26,4,22
449472,30,66,2,64,66,2,64,,,
449490,30,164,40,124,164,40,124,,,
449506,30,63,36,27,63,36,27,,,
449524,30,298,24,274,298,24,274,,,
449533,30,83,7,76,83,7,76,,,
449597,30,4,0,4,4,0,4,,,
449603,30,191,120,71,191,120,71,,,
449612,30,93,53,40,93,53,40,,,
449658,30,117,117,0,117,117,0,,,
449676,30,273,129,144,273,129,144,,,
449685,30,230,19,211,230,19,211,,,
449700,30,382,73,309,382,73,309,,,
449719,30,45,6,39,45,6,39,,,
449728,30,160,3,157,160,3,157,,,
449764,30,243,108,135,199,98,101,44,10,34
449773,30,180,50,130,180,50,130,,,
449782,30,21,2,19,17,1,16,4,1,3
449807,30,70,1,69,70,1,69,,,
449816,30,321,191,130,48,28,20,273,163,110
449834,30,1,1,0,,,,1,1,0
449861,30,172,8,164,172,8,164,,,
449870,30,77,28,49,60,21,39,17,7,10
449889,30,73,19,54,73,19,54,,,
449898,30,491,91,400,324,62,262,167,29,138
449904,30,169,6,163,169,6,163,,,
449959,30,210,32,178,134,19,115,76,13,63
449968,30,261,52,209,176,34,142,85,18,67
449977,30,185,7,178,127,3,124,58,4,54
449986,30,346,77,269,206,37,169,140,40,100
449995,30,109,3,106,64,3,61,45,0,45
450021,30,160,31,129,160,31,129,,,
450058,30,904,163,741,904,163,741,,,
450067,30,562,152,410,558,152,406,4,0,4
450119,30,36,3,33,36,3,33,,,
450128,30,548,14,534,548,14,534,,,
450298,30,267,60,207,13,7,6,254,53,201
450377,30,1188,215,973,62,27,35,1126,188,938
450395,30,112,0,112,60,0,60,52,0,52
450401,30,418,35,383,418,35,383,,,
450571,30,496,43,453,255,19,236,241,24,217
450599,30,68,2,66,68,2,66,,,
450605,30,45,1,44,31,0,31,14,1,13
450614,30,110,3,107,85,3,82,25,0,25
450632,30,115,20,95,,,,115,20,95
450641,30,248,36,212,149,30,119,99,6,93
450650,30,196,14,182,74,3,71,122,11,111
450696,30,357,43,314,357,43,314,,,
450702,30,199,13,186,199,13,186,,,
450711,30,56,43,13,56,43,13,,,
450720,30,664,17,647,302,5,297,362,12,350
450933,30,11525,7505,4020,6338,3874,2464,5187,3631,1556
450951,30,158,91,67,158,91,67,,,
450960,30,279,25,254,228,20,208,51,5,46
450988,30,201,26,175,132,20,112,69,6,63
451042,30,11,0,11,7,0,7,4,0,4
451051,30,106,9,97,,,,106,9,97
451097,30,52,8,44,39,4,35,13,4,9
451103,30,393,79,314,108,18,90,285,61,224
451121,30,111,9,102,56,4,52,55,5,50
451149,30,645,44,601,645,44,601,,,
451158,30,636,31,605,636,31,605,,,
451167,30,137,54,83,79,39,40,58,15,43
451194,30,29,3,26,29,3,26,,,
451228,30,216,179,37,216,179,37,,,
451237,30,197,4,193,197,4,193,,,
451255,30,52,2,50,29,0,29,23,2,21
451264,30,125,15,110,125,15,110,,,
451282,30,111,4,107,80,3,77,31,1,30
451291,30,12,1,11,,,,12,1,11
451307,30,21,1,20,3,0,3,18,1,17
451316,30,58,11,47,58,11,47,,,
451334,30,285,114,171,206,84,122,79,30,49
451343,30,91,3,88,59,2,57,32,1,31
451352,30,231,25,206,170,20,150,61,5,56
451370,30,67,67,0,67,67,0,,,
451398,30,228,228,0,228,228,0,,,
451404,30,473,473,0,473,473,0,,,
451413,30,216,60,156,216,60,156,,,
451459,30,127,25,102,56,11,45,71,14,57
451468,30,406,7,399,406,7,399,,,
451477,30,2397,1960,437,2397,1960,437,,,
451495,30,296,60,236,296,60,236,,,
451501,30,258,82,176,258,82,176,,,
451529,30,57,3,54,13,0,13,44,3,41
451547,30,16,0,16,16,0,16,,,
451556,30,1419,501,918,1419,501,918,,,
451565,30,214,30,184,210,29,181,4,1,3
451574,30,144,2,142,126,2,124,18,0,18
451583,30,882,654,228,177,130,47,705,524,181
451626,30,59,12,47,49,12,37,10,0,10
451714,30,349,54,295,299,39,260,50,15,35
451741,30,108,30,78,82,23,59,26,7,19
451750,30,1228,268,960,751,224,527,477,44,433
451820,30,127,73,54,83,51,32,44,22,22
451857,30,99,12,87,99,12,87,,,
451866,30,341,45,296,341,45,296,,,
451918,30,115,10,105,115,10,105,,,
451927,30,371,189,182,350,180,170,21,9,12
452009,30,71,0,71,71,0,71,,,
452072,30,35,4,31,35,4,31,,,
452081,30,968,33,935,968,33,935,,,
452106,30,72,69,3,72,69,3,,,
452124,30,479,88,391,476,87,389,3,1,2
452373,30,265,13,252,265,13,252,,,
452771,30,15,2,13,,,,15,2,13
452780,30,13,0,13,,,,13,0,13
452887,30,73,71,2,73,71,2,,,
452948,30,952,86,866,481,37,444,471,49,422
453163,30,3022,473,2549,150,59,91,2872,414,2458
453215,30,551,117,434,29,8,21,522,109,413
453297,30,32,9,23,32,9,23,,,
453756,30,277,163,114,277,163,114,,,
453792,30,86,4,82,86,4,82,,,
454184,30,355,131,224,339,128,211,16,3,13
454227,30,13101,1374,11727,2889,300,2589,10212,1074,9138
454236,30,679,76,603,247,26,221,432,50,382
454245,30,797,135,662,254,38,216,543,97,446
454458,30,15,4,11,15,4,11,,,
454537,30,76,0,76,76,0,76,,,
454546,30,169,7,162,169,7,162,,,
454555,30,244,17,227,244,17,227,,,
454582,30,128,42,86,33,14,19,95,28,67
454607,30,311,6,305,311,6,305,,,
454616,30,122,104,18,122,104,18,,,
454652,30,146,2,144,146,2,144,,,
454689,30,3,1,2,3,1,2,,,
454698,30,323,93,230,323,93,230,,,
454722,30,35,8,27,32,5,27,3,3,0
454759,30,32,27,5,20,15,5,12,12,0
454768,30,275,45,230,157,31,126,118,14,104
454777,30,205,26,179,134,21,113,71,5,66
454786,30,734,426,308,167,96,71,567,330,237
454795,30,346,85,261,225,56,169,121,29,92
454801,30,179,39,140,179,39,140,,,
454810,30,9606,2767,6839,9606,2767,6839,,,
454829,30,6299,821,5478,1767,209,1558,4532,612,3920
454856,30,1046,132,914,1046,132,914,,,
454865,30,777,99,678,541,67,474,236,32,204
454874,30,52,5,47,34,4,30,18,1,17
454917,30,745,115,630,464,70,394,281,45,236
454926,30,266,19,247,236,17,219,30,2,28
454935,30,75,1,74,75,1,74,,,
454944,30,197,30,167,197,30,167,,,
454953,30,39,1,38,25,1,24,14,0,14
454962,30,54,0,54,31,0,31,23,0,23
454971,30,215,30,185,124,29,95,91,1,90
454980,30,118,2,116,36,1,35,82,1,81
454999,30,127,1,126,52,1,51,75,0,75
455008,30,210,7,203,98,6,92,112,1,111
455026,30,102,90,12,,,,102,90,12
455062,30,61,2,59,34,1,33,27,1,26
455071,30,100,20,80,,,,100,20,80
455080,30,250,27,223,249,27,222,1,0,1
455105,30,76,0,76,76,0,76,,,
455114,30,6261,2580,3681,2501,1225,1276,3760,1355,2405
455141,30,217,5,212,217,5,212,,,
455187,30,242,25,217,88,13,75,154,12,142
455196,30,2905,257,2648,2905,257,2648,,,
455202,30,403,48,355,224,12,212,179,36,143
455211,30,313,15,298,313,15,298,,,
455220,30,61,9,52,61,9,52,,,
455257,30,370,370,0,370,370,0,,,
455275,30,255,5,250,255,5,250,,,
455284,30,232,5,227,184,4,180,48,1,47
455327,30,37,1,36,34,1,33,3,0,3
455336,30,194,162,32,194,162,32,,,
455354,30,350,12,338,350,12,338,,,
455381,30,182,0,182,124,0,124,58,0,58
455460,30,141,31,110,141,31,110,,,
455479,30,668,60,608,574,54,520,94,6,88
455488,30,264,61,203,264,61,203,,,
455512,30,2554,891,1663,546,203,343,2008,688,1320
455558,30,91,22,69,91,22,69,,,
455628,30,539,156,383,539,156,383,,,
455664,30,223,29,194,15,4,11,208,25,183
455707,30,54,13,41,54,13,41,,,
455725,30,704,18,686,560,15,545,144,3,141
455734,30,244,53,191,244,53,191,,,
455761,30,325,35,290,213,29,184,112,6,106
455770,30,117,71,46,117,71,46,,,
455798,30,101,4,97,56,3,53,45,1,44
455831,30,188,21,167,188,21,167,,,
455859,30,268,4,264,231,4,227,37,0,37
455868,30,330,63,267,330,63,267,,,
455877,30,117,6,111,117,6,111,,,
455886,30,159,5,154,70,3,67,89,2,87
455895,30,365,28,337,172,4,168,193,24,169
455901,30,182,17,165,63,7,56,119,10,109
455910,30,54,14,40,54,14,40,,,
455929,30,65,1,64,65,1,64,,,
455965,30,144,13,131,144,13,131,,,
455974,30,114,15,99,114,15,99,,,
455983,30,234,75,159,226,73,153,8,2,6
456001,30,70,62,8,70,62,8,,,
456029,30,213,13,200,140,13,127,73,0,73
456038,30,383,38,345,383,38,345,,,
456065,30,155,6,149,152,6,146,3,0,3
456074,30,137,6,131,135,6,129,2,0,2
456135,30,89,0,89,53,0,53,36,0,36
456153,30,80,67,13,80,67,13,,,
456205,30,225,42,183,216,42,174,9,0,9
456214,30,409,291,118,409,291,118,,,
456287,30,114,1,113,114,1,113,,,
456454,30,490,149,341,419,138,281,71,11,60
456481,30,69,36,33,11,4,7,58,32,26
456490,30,128,88,40,36,26,10,92,62,30
456506,30,102,3,99,102,3,99,,,
456515,30,45,1,44,45,1,44,,,
456551,30,60,1,59,60,1,59,,,
456579,30,242,88,154,234,86,148,8,2,6
456588,30,47,3,44,33,3,30,14,0,14
456597,30,214,2,212,95,1,94,119,1,118
456621,30,270,69,201,19,11,8,251,58,193
456825,30,124,2,122,118,2,116,6,0,6
456852,30,295,69,226,295,69,226,,,
456922,30,273,57,216,258,54,204,15,3,12
456931,30,327,172,155,315,169,146,12,3,9
456959,30,631,132,499,605,127,478,26,5,21
456968,30,841,19,822,797,19,778,44,0,44
456977,30,39,24,15,39,24,15,,,
457031,30,58,1,57,44,1,43,14,0,14
457077,30,375,33,342,375,33,342,,,
457086,30,177,34,143,134,30,104,43,4,39
457101,30,349,89,260,349,89,260,,,
457110,30,486,73,413,486,73,413,,,
457129,30,1010,108,902,292,29,263,718,79,639
457192,30,29,14,15,29,14,15,,,
457208,30,47,41,6,47,41,6,,,
457226,30,38,26,12,15,10,5,23,16,7
457253,30,186,8,178,27,1,26,159,7,152
457299,30,286,41,245,264,37,227,22,4,18
457314,30,109,24,85,109,24,85,,,
457323,30,388,45,343,388,45,343,,,
457332,30,49,2,47,49,2,47,,,
457341,30,185,2,183,176,2,174,9,0,9
457350,30,66,0,66,,,,66,0,66
457378,30,250,115,135,109,36,73,141,79,62
457387,30,186,118,68,186,118,68,,,
457396,30,136,29,107,22,6,16,114,23,91
457402,30,119,105,14,100,90,10,19,15,4
457411,30,229,214,15,190,178,12,39,36,3
457420,30,190,12,178,120,10,110,70,2,68
457439,30,71,1,70,25,1,24,46,0,46
457448,30,81,5,76,81,5,76,,,
457466,30,43,31,12,43,31,12,,,
457475,30,99,4,95,99,4,95,,,
457484,30,107,49,58,56,24,32,51,25,26
457493,30,90,3,87,90,3,87,,,
457527,30,249,34,215,15,1,14,234,33,201
457536,30,649,135,514,649,135,514,,,
457545,30,107,5,102,87,3,84,20,2,18
457554,30,36,0,36,21,0,21,15,0,15
457563,30,244,4,240,244,4,240,,,
457572,30,124,5,119,124,5,119,,,
457581,30,195,3,192,172,3,169,23,0,23
457606,30,107,10,97,107,10,97,,,
457615,30,44,6,38,,,,44,6,38
457624,30,37,5,32,37,5,32,,,
457633,30,266,4,262,110,1,109,156,3,153
457642,30,82,1,81,82,1,81,,,
457679,30,18,2,16,18,2,16,,,
457688,30,41,15,26,14,6,8,27,9,18
457697,30,107,45,62,22,11,11,85,34,51
457721,30,14,0,14,14,0,14,,,
457749,30,89,6,83,89,6,83,,,
457767,30,125,81,44,125,81,44,,,
457776,30,170,13,157,165,12,153,5,1,4
457785,30,52,0,52,52,0,52,,,
457794,30,78,2,76,78,2,76,,,
457800,30,98,11,87,98,11,87,,,
457819,30,688,277,411,,,,688,277,411
457837,30,165,10,155,78,10,68,87,0,87
457855,30,47,4,43,39,3,36,8,1,7
457873,30,99,66,33,44,36,8,55,30,25
457916,30,80,0,80,41,0,41,39,0,39
457925,30,12,7,5,12,7,5,,,
457943,30,62,10,52,62,10,52,,,
457952,30,197,3,194,153,2,151,44,1,43
457989,30,48,1,47,48,1,47,,,
457998,30,72,12,60,38,1,37,34,11,23
458007,30,50,3,47,25,2,23,25,1,24
458034,30,85,12,73,85,12,73,,,
458043,30,110,0,110,71,0,71,39,0,39
458061,30,67,7,60,24,4,20,43,3,40
458070,30,291,8,283,271,8,263,20,0,20
458098,30,120,2,118,110,2,108,10,0,10
458104,30,198,2,196,2,0,2,196,2,194
458113,30,61,29,32,8,5,3,53,24,29
458122,30,10,0,10,10,0,10,,,
458131,30,114,7,107,114,7,107,,,
458140,30,52,38,14,52,38,14,,,
458168,30,67,4,63,67,4,63,,,
458210,30,2971,648,2323,2093,466,1627,878,182,696
458229,30,2500,525,1975,2043,436,1607,457,89,368
458274,30,205,7,198,149,6,143,56,1,55
458405,30,259,89,170,251,88,163,8,1,7
458423,30,83,20,63,83,20,63,,,
458441,30,335,51,284,327,51,276,8,0,8
458496,30,117,51,66,90,39,51,27,12,15
458681,30,308,57,251,308,57,251,,,
458803,30,154,3,151,117,3,114,37,0,37
458812,30,93,6,87,79,4,75,14,2,12
458821,30,59,2,57,59,2,57,,,
458830,30,142,5,137,108,4,104,34,1,33
458858,30,139,4,135,74,1,73,65,3,62
458867,30,170,6,164,125,5,120,45,1,44
458885,30,355,64,291,20,7,13,335,57,278
458919,30,4593,945,3648,411,201,210,4182,744,3438
458955,30,406,61,345,21,3,18,385,58,327
458964,30,1693,303,1390,139,61,78,1554,242,1312
458973,30,2268,554,1714,244,133,111,2024,421,1603
458982,30,242,118,124,174,87,87,68,31,37
459019,30,64,4,60,53,3,50,11,1,10
459046,30,51,3,48,35,2,33,16,1,15
459055,30,64,4,60,45,3,42,19,1,18
459064,30,70,5,65,46,3,43,24,2,22
459116,30,94,5,89,94,5,89,,,
459125,30,6,0,6,6,0,6,,,
459170,30,347,28,319,198,25,173,149,3,146
459189,30,175,2,173,31,2,29,144,0,144
459198,30,270,52,218,200,47,153,70,5,65
459204,30,3658,462,3196,3658,462,3196,,,
459213,30,2708,554,2154,2708,554,2154,,,
459231,30,228,26,202,228,26,202,,,
459259,30,268,43,225,174,28,146,94,15,79
459268,30,254,31,223,158,24,134,96,7,89
459277,30,356,19,337,356,19,337,,,
459286,30,222,31,191,179,28,151,43,3,40
459295,30,74,0,74,32,0,32,42,0,42
459301,30,112,6,106,89,3,86,23,3,20
459310,30,77,11,66,77,11,66,,,
459329,30,242,138,104,242,138,104,,,
459347,30,86,3,83,30,2,28,56,1,55
459374,30,123,2,121,41,0,41,82,2,80
459392,30,165,5,160,99,3,96,66,2,64
459408,30,46,8,38,32,3,29,14,5,9
459417,30,74,55,19,68,49,19,6,6,0
459426,30,177,5,172,177,5,172,,,
459462,30,337,288,49,337,288,49,,,
459499,30,29,5,24,29,5,24,,,
459514,30,79,14,65,79,14,65,,,
459523,30,19,1,18,19,1,18,,,
459532,30,75,0,75,2,0,2,73,0,73
459541,30,34,2,32,17,2,15,17,0,17
459550,30,130,2,128,116,2,114,14,0,14
459578,30,125,31,94,92,22,70,33,9,24
459727,30,425,129,296,247,70,177,178,59,119
459824,30,55,6,49,51,6,45,4,0,4
459842,30,644,82,562,360,56,304,284,26,258
459851,30,344,44,300,191,28,163,153,16,137
459949,30,6234,2237,3997,3445,1207,2238,2789,1030,1759
459958,30,300,60,240,300,60,240,,,
459967,30,615,219,396,615,219,396,,,
459985,30,509,255,254,509,255,254,,,
459994,30,7389,2311,5078,427,207,220,6962,2104,4858
460011,30,161,0,161,113,0,113,48,0,48
460020,30,438,88,350,438,88,350,,,
460093,30,45,1,44,45,1,44,,,
460109,30,121,2,119,121,2,119,,,
460118,30,102,1,101,102,1,101,,,
460127,30,80,4,76,80,4,76,,,
460136,30,922,131,791,922,131,791,,,
460145,30,373,220,153,373,220,153,,,
460172,30,642,591,51,640,589,51,2,2,0
460181,30,650,81,569,650,81,569,,,
460190,30,318,39,279,318,39,279,,,
460206,30,488,110,378,488,110,378,,,
460349,30,1559,451,1108,500,129,371,1059,322,737
460376,30,8,5,3,7,5,2,1,0,1
460385,30,41,6,35,41,6,35,,,
460394,30,6602,2590,4012,1338,575,763,5264,2015,3249
460464,30,6976,3170,3806,1502,787,715,5474,2383,3091
460482,30,184,18,166,184,18,166,,,
460516,30,130,7,123,130,7,123,,,
460525,30,113,8,105,113,8,105,,,
460534,30,393,13,380,393,13,380,,,
460543,30,1839,1759,80,1839,1759,80,,,
460677,30,377,84,293,309,69,240,68,15,53
460701,30,214,27,187,64,7,57,150,20,130
460738,30,953,126,827,136,18,118,817,108,709
460756,30,354,25,329,300,23,277,54,2,52
460765,30,41,0,41,41,0,41,,,
460808,30,25,5,20,25,5,20,,,
460817,30,175,50,125,170,50,120,5,0,5
460826,30,505,119,386,504,119,385,1,0,1
460835,30,310,92,218,306,91,215,4,1,3
460862,30,249,14,235,120,5,115,129,9,120
460871,30,715,77,638,275,28,247,440,49,391
460914,30,364,3,361,364,3,361,,,
460932,30,44,1,43,44,1,43,,,
460969,30,238,19,219,238,19,219,,,
460978,30,281,6,275,138,2,136,143,4,139
460987,30,111,2,109,111,2,109,,,
460996,30,161,1,160,106,0,106,55,1,54
461014,30,1199,85,1114,1199,85,1114,,,
461023,30,504,67,437,487,64,423,17,3,14
461032,30,132,68,64,48,24,24,84,44,40
461087,30,1039,521,518,162,61,101,877,460,417
461111,30,35,30,5,24,22,2,11,8,3
461148,30,967,534,433,967,534,433,,,
461175,30,237,15,222,175,13,162,62,2,60
461193,30,281,8,273,275,8,267,6,0,6
461218,30,676,51,625,676,51,625,,,
461245,30,92,37,55,43,18,25,49,19,30
461254,30,26,5,21,26,5,21,,,
461263,30,124,9,115,124,9,115,,,
461272,30,71,0,71,47,0,47,24,0,24
461281,30,85,7,78,66,6,60,19,1,18
461306,30,101,23,78,24,5,19,77,18,59
461315,30,73,18,55,35,13,22,38,5,33
461324,30,774,178,596,738,166,572,36,12,24
461333,30,6,5,1,,,,6,5,1
461342,30,147,0,147,95,0,95,52,0,52
461379,30,34,1,33,4,0,4,30,1,29
461388,30,58,17,41,58,17,41,,,
461412,30,120,36,84,,,,120,36,84
461421,30,233,12,221,231,12,219,2,0,2
461430,30,681,632,49,,,,681,632,49
461494,30,187,21,166,122,13,109,65,8,57
461500,30,12,4,8,4,2,2,8,2,6
461528,30,168,90,78,68,32,36,100,58,42
461537,30,39,1,38,32,1,31,7,0,7
461555,30,105,7,98,105,7,98,,,
461573,30,100,98,2,100,98,2,,,
461582,30,162,3,159,162,3,159,,,
461591,30,141,9,132,141,9,132,,,
461607,30,76,8,68,39,5,34,37,3,34
461625,30,21,20,1,21,20,1,,,
461643,30,20,2,18,20,2,18,,,
461652,30,71,5,66,71,5,66,,,
461689,30,385,33,352,385,33,352,,,
461704,30,170,13,157,170,13,157,,,
461713,30,52,0,52,19,0,19,33,0,33
461722,30,50,2,48,50,2,48,,,
461740,30,40,29,11,40,29,11,,,
461759,30,163,91,72,115,63,52,48,28,20
461768,30,235,6,229,235,6,229,,,
461786,30,27,0,27,27,0,27,,,
461795,30,389,303,86,363,283,80,26,20,6
461810,30,19,5,14,16,4,12,3,1,2
461829,30,79,9,70,79,9,70,,,
461838,30,241,5,236,96,3,93,145,2,143
461847,30,66,66,0,66,66,0,,,
461856,30,185,60,125,185,60,125,,,
461865,30,33,5,28,33,5,28,,,
461874,30,87,9,78,87,9,78,,,
461883,30,57,25,32,43,20,23,14,5,9
461892,30,110,11,99,110,11,99,,,
461908,30,107,2,105,106,1,105,1,1,0
461917,30,192,5,187,112,2,110,80,3,77
461926,30,156,2,154,119,2,117,37,0,37
461944,30,64,1,63,64,1,63,,,
461953,30,56,4,52,44,2,42,12,2,10
461962,30,197,134,63,166,104,62,31,30,1
461999,30,148,4,144,136,4,132,12,0,12
462008,30,293,25,268,185,20,165,108,5,103
462017,30,127,17,110,127,17,110,,,
462035,30,427,168,259,140,10,130,287,158,129
462053,30,91,7,84,91,7,84,,,
462062,30,114,3,111,67,2,65,47,1,46
462071,30,148,37,111,145,37,108,3,0,3
462336,30,87,3,84,86,3,83,1,0,1
462345,30,19,0,19,10,0,10,9,0,9
462354,30,292,147,145,266,126,140,26,21,5
463056,30,1524,731,793,1419,675,744,105,56,49
464226,30,830,515,315,745,451,294,85,64,21
466921,30,409,27,382,108,8,100,301,19,282
466930,30,1923,259,1664,496,68,428,1427,191,1236
467094,30,146,0,146,146,0,146,,,
467368,30,128,11,117,128,11,117,,,
467863,30,206,41,165,146,27,119,60,14,46
467872,30,233,4,229,175,3,172,58,1,57
467906,30,124,5,119,81,3,78,43,2,41
468246,30,139,7,132,139,7,132,,,
468255,30,25,2,23,25,2,23,,,
468291,30,75,5,70,75,5,70,,,
468769,30,132,124,8,132,124,8,,,
468848,30,840,385,455,840,385,455,,,
468893,30,126,4,122,116,4,112,10,0,10
468909,30,1048,417,631,1048,417,631,,,
468963,30,257,228,29,257,228,29,,,
469416,30,282,74,208,191,59,132,91,15,76
469610,30,27,5,22,27,5,22,,,
469629,30,143,124,19,143,124,19,,,
469911,30,54,3,51,54,3,51,,,
469957,30,121,11,110,121,11,110,,,
470038,30,1199,485,714,1199,485,714,,,
470047,30,41,7,34,41,7,34,,,
470296,30,19,0,19,19,0,19,,,
470393,30,123,8,115,51,5,46,72,3,69
474863,30,1363,269,1094,615,122,493,748,147,601
474915,30,491,15,476,284,8,276,207,7,200
474924,30,203,2,201,47,0,47,156,2,154
475015,30,163,4,159,163,4,159,,,
475024,30,266,97,169,266,97,169,,,
475033,30,170,29,141,,,,170,29,141
475060,30,249,22,227,242,20,222,7,2,5
475121,30,4748,966,3782,2972,667,2305,1776,299,1477
475176,30,595,275,320,595,275,320,,,
475200,30,227,62,165,36,7,29,191,55,136
475273,30,354,59,295,66,11,55,288,48,240
475282,30,81,22,59,81,22,59,,,
475325,30,211,12,199,211,12,199,,,
475398,30,77,40,37,8,4,4,69,36,33
475404,30,119,1,118,78,1,77,41,0,41
475413,30,65,7,58,43,6,37,22,1,21
475422,30,106,6,100,33,1,32,73,5,68
475431,30,60,4,56,60,4,56,,,
475468,30,282,7,275,112,5,107,170,2,168
475477,30,183,54,129,29,7,22,154,47,107
475486,30,329,43,286,329,43,286,,,
475547,30,125,20,105,76,13,63,49,7,42
475556,30,164,6,158,102,3,99,62,3,59
475565,30,867,437,430,772,391,381,95,46,49
475574,30,43,16,27,19,6,13,24,10,14
475608,30,137,93,44,74,48,26,63,45,18
475635,30,20,3,17,4,0,4,16,3,13
475653,30,32,4,28,27,2,25,5,2,3
475662,30,41,1,40,18,1,17,23,0,23
475705,30,20,7,13,20,7,13,,,
475714,30,452,362,90,375,302,73,77,60,17
475723,30,363,205,158,118,54,64,245,151,94
475732,30,1372,134,1238,334,27,307,1038,107,931
475741,30,244,18,226,87,2,85,157,16,141
475839,30,260,113,147,116,55,61,144,58,86
476063,30,257,240,17,257,240,17,,,
476179,30,160,9,151,113,8,105,47,1,46
476230,30,33,2,31,33,2,31,,,
476294,30,150,15,135,41,3,38,109,12,97
476355,30,46,23,23,46,23,23,,,
476489,30,78,68,10,78,68,10,,,
476498,30,150,95,55,150,95,55,,,
476513,30,59,1,58,59,1,58,,,
476540,30,145,4,141,125,2,123,20,2,18
476559,30,152,2,150,146,1,145,6,1,5
476568,30,14,11,3,14,11,3,,,
476595,30,78,13,65,78,13,65,,,
476601,30,81,81,0,81,81,0,,,
476610,30,47,32,15,47,32,15,,,
476629,30,151,5,146,151,5,146,,,
476683,30,329,17,312,329,17,312,,,
476692,30,36,36,0,36,36,0,,,
476708,30,145,111,34,109,84,25,36,27,9
476717,30,576,576,0,576,576,0,,,
476726,30,470,91,379,470,91,379,,,
476735,30,48,23,25,14,9,5,34,14,20
476753,30,217,7,210,126,5,121,91,2,89
476780,30,61,7,54,42,6,36,19,1,18
476799,30,399,59,340,399,59,340,,,
476805,30,54,1,53,54,1,53,,,
476814,30,588,409,179,,,,588,409,179
476841,30,247,31,216,129,18,111,118,13,105
476850,30,61,42,19,61,42,19,,,
476869,30,119,6,113,119,6,113,,,
476878,30,69,0,69,12,0,12,57,0,57
476887,30,617,15,602,525,14,511,92,1,91
476896,30,76,3,73,76,3,73,,,
476902,30,88,2,86,57,1,56,31,1,30
476939,30,690,64,626,690,64,626,,,
476948,30,385,311,74,385,311,74,,,
476957,30,11,1,10,9,1,8,2,0,2
476966,30,139,122,17,139,122,17,,,
476975,30,6531,3024,3507,1763,823,940,4768,2201,2567
476984,30,185,7,178,136,6,130,49,1,48
476993,30,218,2,216,218,2,216,,,
477002,30,56,3,53,55,3,52,1,0,1
477039,30,1022,133,889,627,73,554,395,60,335
478582,30,153,4,149,112,3,109,41,1,40
478591,30,159,3,156,111,0,111,48,3,45
478616,30,114,10,104,83,7,76,31,3,28
478917,30,55,3,52,55,3,52,,,
478953,30,200,6,194,200,6,194,,,
479062,30,66,63,3,52,49,3,14,14,0
479424,30,309,40,269,309,40,269,,,
479965,30,195,51,144,195,51,144,,,
479974,30,108,27,81,104,27,77,4,0,4
479983,30,101,15,86,101,15,86,,,
479992,30,24,24,0,12,12,0,12,12,0
480000,30,54,35,19,54,35,19,,,
480019,30,800,732,68,720,659,61,80,73,7
480028,30,136,110,26,132,107,25,4,3,1
480037,30,1701,1341,360,1701,1341,360,,,
480073,30,335,67,268,233,42,191,102,25,77
480091,30,6211,605,5606,4762,472,4290,1449,133,1316
480125,30,391,11,380,206,4,202,185,7,178
480161,30,11,0,11,11,0,11,,,
480198,30,251,70,181,161,47,114,90,23,67
480204,30,466,66,400,466,66,400,,,
480310,30,82,4,78,61,4,57,21,0,21
480347,30,36,3,33,36,3,33,,,
480471,30,686,193,493,686,193,493,,,
480523,30,112,3,109,112,3,109,,,
480532,30,28,1,27,28,1,27,,,
480550,30,51,2,49,51,2,49,,,
480569,30,936,388,548,562,220,342,374,168,206
480657,30,679,71,608,361,38,323,318,33,285
480693,30,62,20,42,59,19,40,3,1,2
480727,30,30,26,4,30,26,4,,,
480781,30,91,70,21,91,70,21,,,
480824,30,506,49,457,506,49,457,,,
480833,30,784,64,720,784,64,720,,,
480842,30,23,6,17,23,6,17,,,
480851,30,142,74,68,142,74,68,,,
480879,30,40,1,39,40,1,39,,,
480888,30,139,41,98,139,41,98,,,
480903,30,502,440,62,439,379,60,63,61,2
480912,30,7,2,5,7,2,5,,,
480921,30,84,66,18,84,66,18,,,
480930,30,117,6,111,83,5,78,34,1,33
480967,30,179,61,118,102,39,63,77,22,55
480976,30,59,3,56,59,3,56,,,
480985,30,252,1,251,252,1,251,,,
480994,30,100,3,97,74,3,71,26,0,26
481003,30,139,126,13,139,126,13,,,
481021,30,51,45,6,45,40,5,6,5,1
481049,30,26,3,23,26,3,23,,,
481058,30,68,25,43,42,15,27,26,10,16
481085,30,137,7,130,137,7,130,,,
481100,30,106,20,86,25,5,20,81,15,66
481128,30,115,9,106,96,6,90,19,3,16
481137,30,89,47,42,89,47,42,,,
481146,30,179,23,156,101,13,88,78,10,68
481155,30,218,87,131,218,87,131,,,
481182,30,36,4,32,36,4,32,,,
481191,30,206,16,190,206,16,190,,,
481207,30,125,34,91,125,34,91,,,
481225,30,17,10,7,15,10,5,2,0,2
481243,30,270,2,268,104,0,104,166,2,164
481252,30,59,8,51,59,8,51,,,
481289,30,76,17,59,76,17,59,,,
481298,30,44,4,40,44,4,40,,,
481313,30,80,1,79,49,1,48,31,0,31
481322,30,52,3,49,16,0,16,36,3,33
481331,30,93,77,16,91,75,16,2,2,0
481340,30,46,1,45,46,1,45,,,
481368,30,51,2,49,51,2,49,,,
481386,30,308,40,268,,,,308,40,268
481401,30,212,140,72,48,30,18,164,110,54
481410,30,77,77,0,77,77,0,,,
481429,30,158,13,145,158,13,145,,,
481438,30,69,69,0,69,69,0,,,
481447,30,31,3,28,18,2,16,13,1,12
481456,30,17,1,16,5,0,5,12,1,11
481465,30,52,1,51,47,1,46,5,0,5
481474,30,148,3,145,127,3,124,21,0,21
481483,30,164,4,160,98,2,96,66,2,64
481508,30,38,1,37,37,1,36,1,0,1
481517,30,90,5,85,50,4,46,40,1,39
481526,30,167,1,166,159,1,158,8,0,8
481571,30,3,0,3,3,0,3,,,
481678,30,68,2,66,43,0,43,25,2,23
481720,30,38,3,35,29,3,26,9,0,9
481739,30,69,7,62,44,6,38,25,1,24
481748,30,127,3,124,86,3,83,41,0,41
481775,30,198,57,141,198,57,141,,,
481845,30,78,4,74,54,3,51,24,1,23
481863,30,79,2,77,79,2,77,,,
481890,30,94,4,90,94,4,90,,,
481906,30,71,1,70,71,1,70,,,
481960,30,62,55,7,62,55,7,,,
482015,30,938,580,358,938,580,358,,,
482060,30,254,20,234,254,20,234,,,
482097,30,385,205,180,377,204,173,8,1,7
482149,30,5136,1757,3379,4324,1460,2864,812,297,515
482158,30,6745,2956,3789,4285,2039,2246,2460,917,1543
482167,30,202,4,198,77,4,73,125,0,125
482176,30,259,14,245,223,11,212,36,3,33
482185,30,89,66,23,89,66,23,,,
482194,30,103,21,82,85,18,67,18,3,15
482200,30,74,13,61,74,13,61,,,
482228,30,123,80,43,40,29,11,83,51,32
482246,30,20,16,4,20,16,4,,,
482255,30,286,253,33,230,206,24,56,47,9
482291,30,1204,512,692,1204,512,692,,,
482413,30,777,360,417,460,245,215,317,115,202
482422,30,103,69,34,44,25,19,59,44,15
482431,30,1457,868,589,828,502,326,629,366,263
482440,30,51,21,30,17,5,12,34,16,18
482459,30,457,222,235,202,85,117,255,137,118
482468,30,913,373,540,452,183,269,461,190,271
482477,30,19729,6787,12942,7830,2802,5028,11899,3985,7914
482538,30,23,19,4,11,8,3,12,11,1
482547,30,29,19,10,18,14,4,11,5,6
482556,30,116,67,49,65,33,32,51,34,17
482565,30,21,10,11,11,5,6,10,5,5
482574,30,385,176,209,186,94,92,199,82,117
482608,30,71,37,34,38,19,19,33,18,15
482617,30,16,6,10,11,4,7,5,2,3
482635,30,174,101,73,101,57,44,73,44,29
482653,30,88,45,43,45,25,20,43,20,23
482680,30,16515,7190,9325,11877,5240,6637,4638,1950,2688
482699,30,1490,518,972,987,390,597,503,128,375
482705,30,1928,752,1176,461,59,402,1467,693,774
482936,30,1469,1219,250,1291,1073,218,178,146,32
482963,30,341,30,311,341,30,311,,,
482981,30,169,137,32,140,110,30,29,27,2
482990,30,348,37,311,348,37,311,,,
483009,30,253,32,221,253,32,221,,,
483018,30,133,41,92,133,41,92,,,
483036,30,1771,726,1045,671,273,398,1100,453,647
483045,30,5531,1828,3703,1674,617,1057,3857,1211,2646
483054,30,98,77,21,98,77,21,,,
483106,30,184,32,152,136,22,114,48,10,38
483124,30,42511,15911,26600,16429,5422,11007,26082,10489,15593
483212,30,3026,1069,1957,1681,683,998,1345,386,959
483230,30,189,185,4,134,131,3,55,54,1
483258,30,28,23,5,28,23,5,,,
483276,30,59,52,7,59,52,7,,,
483328,30,126,12,114,79,10,69,47,2,45
483337,30,184,5,179,131,4,127,53,1,52
483346,30,53,3,50,53,3,50,,,
483355,30,147,6,141,147,6,141,,,
483364,30,112,5,107,112,5,107,,,
483373,30,113,15,98,59,10,49,54,5,49
483382,30,204,199,5,204,199,5,,,
483425,30,34,0,34,34,0,34,,,
483443,30,385,327,58,385,327,58,,,
483470,30,20,2,18,20,2,18,,,
483504,30,330,110,220,330,110,220,,,
483513,30,50,36,14,50,36,14,,,
483559,30,53,14,39,31,11,20,22,3,19
483577,30,33,1,32,16,0,16,17,1,16
483595,30,2961,716,2245,1640,397,1243,1321,319,1002
483647,30,34,2,32,34,2,32,,,
483708,30,279,52,227,87,9,78,192,43,149
483726,30,28,1,27,9,0,9,19,1,18
483735,30,67,4,63,37,3,34,30,1,29
483744,30,56,46,10,56,46,10,,,
483753,30,36,31,5,9,9,0,27,22,5
483780,30,95,66,29,80,57,23,15,9,6
483799,30,59,15,44,59,15,44,,,
483814,30,518,50,468,471,43,428,47,7,40
483823,30,675,502,173,675,502,173,,,
483841,30,25,4,21,25,4,21,,,
483850,30,7,1,6,7,1,6,,,
483869,30,81,23,58,81,23,58,,,
483878,30,198,24,174,198,24,174,,,
483887,30,49,11,38,49,11,38,,,
483896,30,244,8,236,43,0,43,201,8,193
483911,30,22,1,21,22,1,21,,,
483920,30,201,113,88,201,113,88,,,
483948,30,65,52,13,45,35,10,20,17,3
483957,30,55,14,41,55,14,41,,,
484002,30,1294,104,1190,1233,96,1137,61,8,53
484011,30,118,22,96,89,22,67,29,0,29
484020,30,53,41,12,31,25,6,22,16,6
484039,30,152,125,27,152,125,27,,,
484048,30,13,10,3,13,10,3,,,
484057,30,238,12,226,64,3,61,174,9,165
484066,30,218,16,202,218,16,202,,,
484075,30,44,35,9,30,23,7,14,12,2
484084,30,77,2,75,51,1,50,26,1,25
484093,30,152,4,148,106,2,104,46,2,44
484109,30,111,1,110,111,1,110,,,
484127,30,109,19,90,109,19,90,,,
484136,30,10,2,8,10,2,8,,,
484163,30,181,52,129,108,29,79,73,23,50
484172,30,16,2,14,16,2,14,,,
484190,30,32,24,8,32,24,8,,,
484206,30,237,7,230,116,5,111,121,2,119
484233,30,213,124,89,,,,213,124,89
484330,30,40,0,40,40,0,40,,,
484349,30,91,5,86,91,5,86,,,
484358,30,53,2,51,53,2,51,,,
484367,30,212,31,181,212,31,181,,,
484376,30,322,38,284,322,38,284,,,
484394,30,205,30,175,139,21,118,66,9,57
484473,30,4510,2125,2385,2454,1156,1298,2056,969,1087
484604,30,476,9,467,251,4,247,225,5,220
484613,30,63660,18817,44843,63660,18817,44843,,,
484631,30,1158,744,414,1158,744,414,,,
484710,30,76,49,27,76,49,27,,,
484756,30,126,55,71,126,55,71,,,
484826,30,44,0,44,44,0,44,,,
484835,30,84,21,63,84,21,63,,,
484844,30,604,265,339,604,265,339,,,
484862,30,1,0,1,,,,1,0,1
484871,30,114,114,0,114,114,0,,,
484899,30,212,3,209,212,3,209,,,
484905,30,3298,1062,2236,1827,589,1238,1471,473,998
484923,30,45,0,45,45,0,45,,,
484932,30,1542,622,920,973,363,610,569,259,310
484950,30,105,13,92,105,13,92,,,
484996,30,161,3,158,161,3,158,,,
485014,30,85,2,83,60,1,59,25,1,24
485032,30,206,9,197,124,7,117,82,2,80
485111,30,4469,1810,2659,2621,1160,1461,1848,650,1198
485139,30,262,217,45,262,217,45,,,
485166,30,122,19,103,122,19,103,,,
485236,30,99,2,97,31,1,30,68,1,67
485272,30,1123,148,975,565,88,477,558,60,498
485306,30,16,0,16,16,0,16,,,
485342,30,171,118,53,171,118,53,,,
485360,30,22,2,20,22,2,20,,,
485379,30,278,56,222,278,56,222,,,
485388,30,355,46,309,355,46,309,,,
485397,30,142,9,133,112,9,103,30,0,30
485412,30,96,14,82,96,14,82,,,
485458,30,1920,597,1323,481,157,324,1439,440,999
485476,30,82,3,79,82,3,79,,,
485485,30,147,18,129,147,18,129,,,
485494,30,90,74,16,90,74,16,,,
485500,30,253,238,15,16,16,0,237,222,15
485519,30,390,274,116,190,133,57,200,141,59
485546,30,133,63,70,2,1,1,131,62,69
485564,30,21,8,13,21,8,13,,,
485573,30,202,33,169,186,32,154,16,1,15
485591,30,40,0,40,40,0,40,,,
485607,30,32,3,29,23,2,21,9,1,8
485698,30,121,106,15,118,103,15,3,3,0
485704,30,5,0,5,2,0,2,3,0,3
485768,30,375,258,117,375,258,117,,,
485801,30,84,12,72,84,12,72,,,
485856,30,41,13,28,15,6,9,26,7,19
485874,30,167,6,161,99,4,95,68,2,66
485926,30,216,63,153,210,62,148,6,1,5
485953,30,59,51,8,59,51,8,,,
485962,30,37,25,12,18,12,6,19,13,6
485999,30,96,96,0,96,96,0,,,
486017,30,32,32,0,32,32,0,,,
486026,30,81,81,0,81,81,0,,,
486053,30,123,74,49,96,60,36,27,14,13
486105,30,7,0,7,7,0,7,,,
486123,30,26,10,16,26,10,16,,,
486141,30,12,0,12,12,0,12,,,
486150,30,133,52,81,96,40,56,37,12,25
486169,30,65,50,15,65,50,15,,,
486196,30,184,184,0,184,184,0,,,
486202,30,30,3,27,30,3,27,,,
486239,30,92,32,60,74,25,49,18,7,11
486248,30,118,35,83,118,35,83,,,
486257,30,308,127,181,215,90,125,93,37,56
486284,30,284,77,207,274,74,200,10,3,7
486309,30,4,1,3,4,1,3,,,
486345,30,175,173,2,77,76,1,98,97,1
486354,30,45,14,31,45,14,31,,,
486372,30,105,82,23,73,62,11,32,20,12
486381,30,208,23,185,208,23,185,,,
486390,30,89,45,44,89,45,44,,,
486406,30,17,4,13,17,4,13,,,
486415,30,261,64,197,261,64,197,,,
486424,30,142,4,138,131,1,130,11,3,8
486442,30,48,1,47,48,1,47,,,
486488,30,23,18,5,20,16,4,3,2,1
486497,30,42,40,2,40,38,2,2,2,0
486503,30,53,0,53,53,0,53,,,
486512,30,304,155,149,304,155,149,,,
486530,30,158,1,157,158,1,157,,,
486558,30,265,240,25,200,181,19,65,59,6
486567,30,232,13,219,228,12,216,4,1,3
486576,30,126,30,96,126,30,96,,,
486594,30,31,14,17,13,5,8,18,9,9
486619,30,135,5,130,103,5,98,32,0,32
486691,30,97,2,95,64,1,63,33,1,32
486707,30,84,2,82,84,2,82,,,
486716,30,92,2,90,92,2,90,,,
486752,30,96,4,92,96,4,92,,,
486770,30,123,30,93,123,30,93,,,
486798,30,1273,1154,119,1273,1154,119,,,
486813,30,542,111,431,542,111,431,,,
486822,30,821,101,720,821,101,720,,,
486840,30,37743,18936,18807,28289,13961,14328,9454,4975,4479
486859,30,33,0,33,33,0,33,,,
486868,30,8,0,8,8,0,8,,,
486877,30,8,0,8,8,0,8,,,
486886,30,30,0,30,15,0,15,15,0,15
486901,30,770,383,387,741,369,372,29,14,15
486938,30,543,95,448,246,35,211,297,60,237
486947,30,549,68,481,242,30,212,307,38,269
486956,30,1219,167,1052,543,72,471,676,95,581
486965,30,231,85,146,231,85,146,,,
486983,30,61,16,45,61,16,45,,,
487010,30,264,23,241,248,20,228,16,3,13
487047,30,56,2,54,56,2,54,,,
487065,30,77,6,71,77,6,71,,,
487083,30,29,0,29,29,0,29,,,
487092,30,1066,499,567,1066,499,567,,,
487162,30,2790,752,2038,1079,319,760,1711,433,1278
487232,30,119,0,119,119,0,119,,,
487302,30,561,118,443,560,118,442,1,0,1
487311,30,348,325,23,348,325,23,,,
487320,30,8747,6073,2674,4523,3521,1002,4224,2552,1672
487348,30,111,4,107,47,3,44,64,1,63
487375,30,938,118,820,604,74,530,334,44,290
487384,30,608,195,413,608,195,413,,,
487393,30,722,308,414,722,308,414,,,
487409,30,668,258,410,668,258,410,,,
487418,30,814,311,503,814,311,503,,,
487427,30,571,198,373,571,198,373,,,
487436,30,575,107,468,575,107,468,,,
487445,30,587,214,373,587,214,373,,,
487454,30,619,208,411,619,208,411,,,
487472,30,659,245,414,659,245,414,,,
487481,30,1441,311,1130,1441,311,1130,,,
487490,30,1109,216,893,1109,216,893,,,
487506,30,85,2,83,27,0,27,58,2,56
487524,30,2430,984,1446,2208,896,1312,222,88,134
487533,30,121,1,120,44,1,43,77,0,77
487588,30,362,27,335,362,27,335,,,
487597,30,1340,1286,54,1340,1286,54,,,
487603,30,592,234,358,353,142,211,239,92,147
487621,30,18,16,2,17,15,2,1,1,0
487658,30,90,67,23,90,67,23,,,
487676,30,197,12,185,160,8,152,37,4,33
487746,30,28,28,0,28,28,0,,,
487773,30,44,6,38,32,3,29,12,3,9
487791,30,505,463,42,298,275,23,207,188,19
487807,30,56,34,22,35,23,12,21,11,10
487816,30,16,0,16,16,0,16,,,
487852,30,13,4,9,,,,13,4,9
487861,30,329,38,291,248,30,218,81,8,73
487889,30,65,5,60,65,5,60,,,
487898,30,16,13,3,12,11,1,4,2,2
487904,30,25,19,6,25,19,6,,,
487922,30,65,0,65,48,0,48,17,0,17
487959,30,48,0,48,24,0,24,24,0,24
487968,30,55,3,52,55,3,52,,,
487977,30,2061,166,1895,1665,42,1623,396,124,272
487995,30,43,8,35,19,4,15,24,4,20
488004,30,20,20,0,20,20,0,,,
488013,30,83,2,81,83,2,81,,,
488022,30,72,40,32,44,23,21,28,17,11
488031,30,63,28,35,61,27,34,2,1,1
488059,30,175,61,114,175,61,114,,,
488068,30,56,8,48,18,5,13,38,3,35
488077,30,3009,2939,70,2196,2144,52,813,795,18
488101,30,113,113,0,113,113,0,,,
488110,30,39,0,39,29,0,29,10,0,10
488129,30,25,0,25,,,,25,0,25
488138,30,41,2,39,41,2,39,,,
488147,30,71,1,70,71,1,70,,,
488174,30,28,15,13,22,12,10,6,3,3
488183,30,19,2,17,19,2,17,,,
488192,30,75,74,1,,,,75,74,1
488217,30,175,5,170,175,5,170,,,
488226,30,19,9,10,19,9,10,,,
488253,30,83,58,25,55,35,20,28,23,5
488262,30,25,16,9,19,15,4,6,1,5
488271,30,95,3,92,95,3,92,,,
488280,30,34,23,11,34,23,11,,,
488299,30,74,34,40,21,7,14,53,27,26
488305,30,107,65,42,85,48,37,22,17,5
488314,30,54,54,0,54,54,0,,,
488332,30,197,27,170,197,27,170,,,
488350,30,99,99,0,99,99,0,,,
488369,30,51,43,8,51,43,8,,,
488378,30,83,3,80,82,3,79,1,0,1
488396,30,37,30,7,6,5,1,31,25,6
488411,30,124,1,123,124,1,123,,,
488420,30,145,13,132,,,,145,13,132
488439,30,104,81,23,58,44,14,46,37,9
488448,30,86,56,30,81,53,28,5,3,2
488563,30,10,8,2,10,8,2,,,
488590,30,13,4,9,13,4,9,,,
488651,30,181,20,161,109,14,95,72,6,66
488679,30,5668,1443,4225,5316,1346,3970,352,97,255
488730,30,5463,2315,3148,1007,476,531,4456,1839,2617
488749,30,131,19,112,119,16,103,12,3,9
488776,30,108,39,69,75,29,46,33,10,23
488785,30,242,127,115,231,120,111,11,7,4
488800,30,694,213,481,694,213,481,,,
488828,30,11,5,6,11,5,6,,,
488837,30,170,143,27,170,143,27,,,
488846,30,10823,6232,4591,4256,2532,1724,6567,3700,2867
488891,30,132,42,90,132,42,90,,,
488916,30,30,0,30,30,0,30,,,
488934,30,1183,753,430,663,364,299,520,389,131
488952,30,60,3,57,60,3,57,,,
488961,30,58,2,56,58,2,56,,,
488970,30,63,1,62,63,1,62,,,
488989,30,160,10,150,112,7,105,48,3,45
488998,30,123,22,101,121,22,99,2,0,2
489122,30,28,4,24,14,0,14,14,4,10
489131,30,45,10,35,29,6,23,16,4,12
489140,30,63,12,51,32,5,27,31,7,24
489159,30,170,1,169,97,0,97,73,1,72
489201,30,6006,2454,3552,1729,815,914,4277,1639,2638
489238,30,131,12,119,84,6,78,47,6,41
489247,30,55,9,46,21,4,17,34,5,29
489256,30,217,198,19,215,196,19,2,2,0
489283,30,609,89,520,609,89,520,,,
489344,30,251,22,229,90,8,82,161,14,147
489353,30,437,95,342,267,59,208,170,36,134
489371,30,199,178,21,199,178,21,,,
489779,30,32213,12745,19468,4851,1667,3184,27362,11078,16284
489812,30,50,0,50,50,0,50,,,
489830,30,67,2,65,67,2,65,,,
489937,30,471,233,238,376,201,175,95,32,63
490018,30,18,9,9,18,9,9,,,
490045,30,41,13,28,21,6,15,20,7,13
490054,30,238,85,153,151,66,85,87,19,68
490063,30,88,39,49,88,39,49,,,
490081,30,43,19,24,40,19,21,3,0,3
490090,30,13,9,4,8,4,4,5,5,0
490115,30,38,26,12,38,26,12,,,
490124,30,8,4,4,8,4,4,,,
490133,30,1299,798,501,1271,778,493,28,20,8
490142,30,28,3,25,14,3,11,14,0,14
490151,30,89,6,83,55,3,52,34,3,31
490160,30,101,16,85,101,16,85,,,
490197,30,48,9,39,48,9,39,,,
490203,30,129,6,123,54,2,52,75,4,71
490212,30,21,1,20,21,1,20,,,
490221,30,26,4,22,13,2,11,13,2,11
490230,30,234,106,128,231,104,127,3,2,1
490249,30,25,24,1,25,24,1,,,
490258,30,120,26,94,120,26,94,,,
490267,30,9,5,4,3,3,0,6,2,4
490276,30,119,119,0,119,119,0,,,
490285,30,618,490,128,618,490,128,,,
490294,30,152,48,104,132,38,94,20,10,10
490300,30,86,21,65,39,4,35,47,17,30
490319,30,18,18,0,18,18,0,,,
490328,30,67,67,0,67,67,0,,,
490337,30,106,28,78,43,14,29,63,14,49
490346,30,53,0,53,53,0,53,,,
490382,30,38,13,25,38,13,25,,,
490391,30,68,3,65,68,3,65,,,
490407,30,125,0,125,63,0,63,62,0,62
490416,30,20,18,2,20,18,2,,,
490425,30,185,1,184,185,1,184,,,
490434,30,37,0,37,37,0,37,,,
490443,30,107,0,107,107,0,107,,,
490452,30,58,13,45,19,3,16,39,10,29
490461,30,104,3,101,104,3,101,,,
490470,30,26,4,22,26,4,22,,,
490489,30,45,36,9,41,33,8,4,3,1
490498,30,34,26,8,34,26,8,,,
490504,30,36,36,0,36,36,0,,,
490513,30,35,35,0,33,33,0,2,2,0
490522,30,29,0,29,28,0,28,1,0,1
490531,30,32,25,7,15,13,2,17,12,5
490540,30,23,1,22,19,1,18,4,0,4
490559,30,455,23,432,455,23,432,,,
490674,30,5,0,5,5,0,5,,,
490692,30,55,47,8,55,47,8,,,
490717,30,80,5,75,80,5,75,,,
490735,30,144,20,124,144,20,124,,,
490744,30,25,20,5,25,20,5,,,
490753,30,2,0,2,2,0,2,,,
490805,30,6396,2759,3637,4667,2190,2477,1729,569,1160
490814,30,91,9,82,91,9,82,,,
490832,30,293,19,274,237,16,221,56,3,53
490841,30,263,8,255,263,8,255,,,
490869,30,411,44,367,411,44,367,,,
490878,30,430,91,339,430,91,339,,,
490896,30,159,8,151,97,6,91,62,2,60
490948,30,10,7,3,10,7,3,,,
490975,30,379,46,333,350,41,309,29,5,24
491057,30,208,208,0,208,208,0,,,
491066,30,70,0,70,32,0,32,38,0,38
491075,30,15,14,1,15,14,1,,,
491084,30,59,0,59,59,0,59,,,
491136,30,70,5,65,40,4,36,30,1,29
491145,30,102,3,99,75,2,73,27,1,26
491181,30,525,77,448,311,41,270,214,36,178
491190,30,2,2,0,2,2,0,,,
491215,30,52,50,2,52,50,2,,,
491224,30,96,8,88,66,5,61,30,3,27
491233,30,32,0,32,19,0,19,13,0,13
491242,30,61,29,32,61,29,32,,,
491251,30,103,50,53,103,50,53,,,
491260,30,41,0,41,17,0,17,24,0,24
491288,30,630,190,440,59,15,44,571,175,396
491297,30,131,54,77,7,3,4,124,51,73
491394,30,90,84,6,90,84,6,,,
491446,30,161,0,161,161,0,161,,,
491464,30,125,22,103,125,22,103,,,
491473,30,526,387,139,32,2,30,494,385,109
491507,30,66,7,59,66,7,59,,,
491525,30,72,47,25,55,36,19,17,11,6
491534,30,17,1,16,,,,17,1,16
491543,30,104,16,88,69,13,56,35,3,32
491552,30,22,0,22,22,0,22,,,
491570,30,32,0,32,32,0,32,,,
491589,30,31,23,8,6,4,2,25,19,6
491598,30,33,6,27,33,6,27,,,
491613,30,74,74,0,74,74,0,,,
491622,30,85,85,0,85,85,0,,,
491631,30,141,0,141,113,0,113,28,0,28
491640,30,169,169,0,169,169,0,,,
491659,30,81,37,44,81,37,44,,,
491668,30,164,2,162,164,2,162,,,
491677,30,34,21,13,22,14,8,12,7,5
491686,30,37,34,3,37,34,3,,,
491695,30,48,12,36,48,12,36,,,
491701,30,56,11,45,,,,56,11,45
491710,30,63,63,0,63,63,0,,,
491729,30,26,0,26,26,0,26,,,
491738,30,56,9,47,49,5,44,7,4,3
491747,30,19,8,11,19,8,11,,,
491756,30,101,86,15,101,86,15,,,
491765,30,98,98,0,98,98,0,,,
491774,30,137,18,119,91,11,80,46,7,39
491783,30,68,51,17,29,14,15,39,37,2
491792,30,108,3,105,108,3,105,,,
491817,30,225,0,225,167,0,167,58,0,58
491826,30,92,0,92,92,0,92,,,
491835,30,90,1,89,90,1,89,,,
491844,30,136,44,92,85,34,51,51,10,41
491853,30,47,0,47,47,0,47,,,
491871,30,17,0,17,9,0,9,8,0,8
491880,30,95,92,3,95,92,3,,,
491899,30,92,7,85,11,1,10,81,6,75
491905,30,118,3,115,118,3,115,,,
491914,30,167,167,0,167,167,0,,,
491923,30,289,3,286,284,2,282,5,1,4
491932,30,33,32,1,33,32,1,,,
491941,30,126,6,120,126,6,120,,,
491950,30,879,128,751,46,8,38,833,120,713
491969,30,21,3,18,21,3,18,,,
491978,30,45,17,28,11,5,6,34,12,22
491996,30,45,3,42,45,3,42,,,
492005,30,70,0,70,55,0,55,15,0,15
492032,30,32,0,32,,,,32,0,32
492069,30,91,56,35,84,54,30,7,2,5
492078,30,127,124,3,,,,127,124,3
492096,30,9,1,8,9,1,8,,,
492139,30,131,109,22,131,109,22,,,
492157,30,94,83,11,94,83,11,,,
492281,30,26,22,4,26,22,4,,,
492306,30,122,58,64,,,,122,58,64
492315,30,111,28,83,,,,111,28,83
492324,30,212,22,190,,,,212,22,190
492360,30,47,10,37,23,3,20,24,7,17
492379,30,16,15,1,16,15,1,,,
492421,30,13,13,0,13,13,0,,,
492449,30,537,102,435,537,102,435,,,
492476,30,168,42,126,36,12,24,132,30,102
492591,30,91,70,21,91,70,21,,,
492643,30,89,26,63,89,26,63,,,
492652,30,43,32,11,43,32,11,,,
492661,30,282,46,236,280,46,234,2,0,2
492689,30,266,47,219,202,39,163,64,8,56
492722,30,409,40,369,409,40,369,,,
492731,30,127,26,101,127,26,101,,,
492759,30,311,22,289,139,11,128,172,11,161
492801,30,791,292,499,443,161,282,348,131,217
492935,30,134,13,121,134,13,121,,,
492953,30,90,6,84,55,6,49,35,0,35
492962,30,3078,1120,1958,1333,460,873,1745,660,1085
493071,30,454,111,343,454,111,343,,,
493080,30,351,173,178,21,8,13,330,165,165
493132,30,1067,1033,34,1067,1033,34,,,
493150,30,148,12,136,148,12,136,,,
493372,30,16,2,14,16,2,14,,,
493451,30,76,14,62,76,14,62,,,
493479,30,10,5,5,10,5,5,,,
493488,30,17,2,15,17,2,15,,,
493503,30,25,14,11,25,14,11,,,
493512,30,151,93,58,151,93,58,,,
493521,30,46,34,12,45,33,12,1,1,0
493530,30,48,18,30,30,13,17,18,5,13
493549,30,137,128,9,137,128,9,,,
493558,30,17,17,0,17,17,0,,,
493567,30,85,3,82,,,,85,3,82
493576,30,12,0,12,12,0,12,,,
493585,30,44,5,39,44,5,39,,,
493594,30,36,36,0,36,36,0,,,
493600,30,176,176,0,176,176,0,,,
493619,30,30,12,18,19,11,8,11,1,10
493628,30,149,13,136,84,8,76,65,5,60
493637,30,61,1,60,61,1,60,,,
493646,30,229,0,229,229,0,229,,,
493655,30,17,11,6,17,11,6,,,
493664,30,62,62,0,61,61,0,1,1,0
493682,30,97,5,92,83,4,79,14,1,13
493691,30,38,1,37,29,1,28,9,0,9
493707,30,90,90,0,90,90,0,,,
493716,30,60,60,0,60,60,0,,,
493725,30,668,230,438,431,139,292,237,91,146
493734,30,10,8,2,10,8,2,,,
493743,30,210,153,57,122,93,29,88,60,28
493752,30,15,1,14,15,1,14,,,
493761,30,108,34,74,19,11,8,89,23,66
493770,30,24,1,23,24,1,23,,,
493789,30,136,0,136,57,0,57,79,0,79
493798,30,107,0,107,100,0,100,7,0,7
493804,30,84,69,15,84,69,15,,,
493813,30,121,7,114,121,7,114,,,
493822,30,178,40,138,124,28,96,54,12,42
493831,30,37,25,12,37,25,12,,,
493868,30,12,9,3,8,6,2,4,3,1
493895,30,147,130,17,38,35,3,109,95,14
493910,30,6,0,6,2,0,2,4,0,4
493992,30,247,78,169,247,78,169,,,
494001,30,86,5,81,17,2,15,69,3,66
494029,30,21,16,5,11,10,1,10,6,4
494162,30,225,16,209,112,6,106,113,10,103
494232,30,29,0,29,26,0,26,3,0,3
494250,30,351,26,325,351,26,325,,,
494269,30,33,29,4,5,4,1,28,25,3
494278,30,253,60,193,75,16,59,178,44,134
494287,30,311,96,215,96,26,70,215,70,145
494357,30,947,336,611,947,336,611,,,
494436,30,303,65,238,303,65,238,,,
494463,30,330,0,330,330,0,330,,,
494472,30,11,0,11,7,0,7,4,0,4
494524,30,96,4,92,89,1,88,7,3,4
494588,30,303,27,276,303,27,276,,,
494597,30,60,31,29,51,27,24,9,4,5
494603,30,251,145,106,171,99,72,80,46,34
494621,30,89,11,78,,,,89,11,78
494630,30,44,24,20,37,21,16,7,3,4
494649,30,28,0,28,17,0,17,11,0,11
494658,30,35,1,34,28,1,27,7,0,7
494685,30,442,182,260,372,148,224,70,34,36
494694,30,70,1,69,64,1,63,6,0,6
494700,30,59,1,58,57,1,56,2,0,2
494719,30,35,29,6,22,16,6,13,13,0
494728,30,49,38,11,46,36,10,3,2,1
494737,30,169,169,0,169,169,0,,,
494746,30,167,24,143,167,24,143,,,
494755,30,65,4,61,65,4,61,,,
494764,30,180,166,14,150,140,10,30,26,4
494807,30,47,6,41,47,6,41,,,
494843,30,603,41,562,603,41,562,,,
494852,30,497,112,385,497,112,385,,,
494898,30,82,13,69,82,13,69,,,
494904,30,131,55,76,52,25,27,79,30,49
494959,30,58,15,43,10,5,5,48,10,38
494977,30,49,5,44,49,5,44,,,
494986,30,42,2,40,29,2,27,13,0,13
494995,30,46,42,4,46,42,4,,,
495013,30,243,217,26,,,,243,217,26
495031,30,61,61,0,58,58,0,3,3,0
495040,30,50,2,48,50,2,48,,,
495059,30,50,23,27,49,23,26,1,0,1
495077,30,25,2,23,25,2,23,,,
495101,30,53,6,47,53,6,47,,,
495110,30,17,14,3,17,14,3,,,
495129,30,127,107,20,127,107,20,,,
495138,30,6,3,3,6,3,3,,,
495147,30,21,9,12,11,7,4,10,2,8
495165,30,29,5,24,29,5,24,,,
495174,30,26,8,18,,,,26,8,18
495183,30,187,82,105,187,82,105,,,
495208,30,19,14,5,19,14,5,,,
495217,30,10,8,2,10,8,2,,,
495226,30,4,0,4,4,0,4,,,
495235,30,17,2,15,10,1,9,7,1,6
495244,30,23,1,22,11,1,10,12,0,12
495253,30,47,10,37,45,10,35,2,0,2
495262,30,37,0,37,21,0,21,16,0,16
495271,30,24,6,18,,,,24,6,18
495280,30,23,12,11,12,6,6,11,6,5
495299,30,39,8,31,39,8,31,,,
495305,30,94,22,72,43,9,34,51,13,38
495341,30,48,35,13,47,34,13,1,1,0
495350,30,32,18,14,32,18,14,,,
495369,30,72,13,59,48,11,37,24,2,22
495378,30,91,5,86,11,0,11,80,5,75
495387,30,41,29,12,15,12,3,26,17,9
495396,30,27,1,26,27,1,26,,,
495411,30,116,7,109,112,5,107,4,2,2
495420,30,225,21,204,114,13,101,111,8,103
495439,30,237,18,219,112,9,103,125,9,116
495448,30,494,57,437,278,30,248,216,27,189
495457,30,418,39,379,257,23,234,161,16,145
495518,30,72,3,69,42,1,41,30,2,28
495730,30,77,0,77,62,0,62,15,0,15
495767,30,72229,38826,33403,64560,34767,29793,7669,4059,3610
495776,30,39,35,4,39,35,4,,,
495794,30,235,5,230,179,2,177,56,3,53
495837,30,121,6,115,121,6,115,,,
495916,30,9,2,7,6,1,5,3,1,2
495925,30,65,2,63,65,2,63,,,
495934,30,85,5,80,85,5,80,,,
495943,30,35,3,32,35,3,32,,,
495952,30,143,35,108,143,35,108,,,
495961,30,124,15,109,124,15,109,,,
495970,30,302,97,205,302,97,205,,,
495998,30,67,6,61,67,6,61,,,
496052,30,18,11,7,18,11,7,,,
496061,30,91,0,91,36,0,36,55,0,55
496186,30,121,112,9,121,112,9,,,
496265,30,57,47,10,57,47,10,,,
496283,30,105,11,94,105,11,94,,,
496292,30,6,6,0,6,6,0,,,
496326,30,148,15,133,148,15,133,,,
496371,30,10,10,0,10,10,0,,,
496399,30,22,5,17,22,5,17,,,
496478,30,80,59,21,,,,80,59,21
496511,30,17,0,17,15,0,15,2,0,2
496520,30,38,9,29,,,,38,9,29
496539,30,63,1,62,43,1,42,20,0,20
496593,30,243,138,105,243,138,105,,,
496618,30,76,4,72,76,4,72,,,
496627,30,191,91,100,191,91,100,,,
496636,30,143,22,121,143,22,121,,,
496645,30,278,175,103,37,2,35,241,173,68
496654,30,46,10,36,,,,46,10,36
496663,30,29,21,8,27,19,8,2,2,0
496672,30,35,4,31,21,4,17,14,0,14
496681,30,239,6,233,239,6,233,,,
496690,30,42,6,36,30,3,27,12,3,9
496706,30,105,64,41,105,64,41,,,
496715,30,65,21,44,57,19,38,8,2,6
496724,30,33,0,33,33,0,33,,,
496733,30,70,0,70,70,0,70,,,
496742,30,5,0,5,5,0,5,,,
496751,30,65,6,59,65,6,59,,,
496894,30,13,0,13,11,0,11,2,0,2
496919,30,955,351,604,955,351,604,,,
496955,30,361,144,217,361,144,217,,,
496964,30,18,10,8,18,10,8,,,
496973,30,68,5,63,34,2,32,34,3,31
496991,30,219,28,191,103,17,86,116,11,105
497000,30,252,56,196,252,56,196,,,
497037,30,415,74,341,314,57,257,101,17,84
497046,30,3280,1046,2234,484,162,322,2796,884,1912
497073,30,395,8,387,225,4,221,170,4,166
497116,30,68,8,60,31,5,26,37,3,34
497161,30,66,62,4,54,50,4,12,12,0
497189,30,12,0,12,12,0,12,,,
497198,30,76,1,75,50,1,49,26,0,26
497204,30,47,43,4,16,15,1,31,28,3
497213,30,25,10,15,14,6,8,11,4,7
497222,30,23,0,23,13,0,13,10,0,10
497268,30,186,21,165,107,12,95,79,9,70
497277,30,504,56,448,504,56,448,,,
497301,30,170,5,165,112,5,107,58,0,58
497310,30,97,0,97,97,0,97,,,
497329,30,83,14,69,83,14,69,,,
497338,30,36,4,32,36,4,32,,,
100654,31,1477,619,858,1417,604,813,60,15,45
100663,31,2415,835,1580,2361,816,1545,54,19,35
100706,31,1204,778,426,1191,772,419,13,6,7
100724,31,890,300,590,797,254,543,93,46,47
100751,31,7593,3221,4372,7540,3206,4334,53,15,38
100760,31,293,142,151,219,116,103,74,26,48
100830,31,539,191,348,517,181,336,22,10,12
100858,31,5311,2423,2888,5254,2384,2870,57,39,18
100937,31,244,123,121,244,123,121,,,
101028,31,271,142,129,172,80,92,99,62,37
101116,31,19,4,15,12,2,10,7,2,5
101143,31,416,222,194,340,180,160,76,42,34
101161,31,1375,544,831,1047,390,657,328,154,174
101189,31,213,117,96,207,113,94,6,4,2
101240,31,831,400,431,625,315,310,206,85,121
101277,31,39,0,39,39,0,39,,,
101286,31,799,311,488,514,207,307,285,104,181
101295,31,1280,483,797,961,385,576,319,98,221
101301,31,269,127,142,219,108,111,50,19,31
101365,31,116,40,76,32,7,25,84,33,51
101435,31,250,153,97,250,153,97,,,
101453,31,3,1,2,3,1,2,,,
101462,31,109,55,54,57,23,34,52,32,20
101471,31,245,177,68,178,125,53,67,52,15
101480,31,1818,695,1123,1782,682,1100,36,13,23
101505,31,1453,602,851,854,352,502,599,250,349
101514,31,1624,766,858,886,418,468,738,348,390
101569,31,670,299,371,426,188,238,244,111,133
101587,31,304,139,165,301,138,163,3,1,2
101602,31,430,174,256,383,153,230,47,21,26
101648,31,179,132,47,179,132,47,,,
101675,31,384,178,206,380,175,205,4,3,1
101693,31,253,88,165,250,87,163,3,1,2
101709,31,493,180,313,478,177,301,15,3,12
101736,31,591,257,334,408,178,230,183,79,104
101879,31,1013,376,637,985,366,619,28,10,18
101897,31,450,174,276,352,138,214,98,36,62
101912,31,284,122,162,280,120,160,4,2,2
101994,31,78,45,33,73,44,29,5,1,4
102030,31,474,207,267,342,158,184,132,49,83
102049,31,920,326,594,918,326,592,2,0,2
102058,31,4,3,1,1,1,0,3,2,1
102067,31,893,416,477,661,303,358,232,113,119
102076,31,558,212,346,488,188,300,70,24,46
102094,31,1778,669,1109,1751,656,1095,27,13,14
102234,31,216,103,113,215,103,112,1,0,1
102270,31,134,58,76,109,49,60,25,9,16
102298,31,311,173,138,216,138,78,95,35,60
102313,31,389,170,219,259,126,133,130,44,86
102368,31,1596,595,1001,1362,513,849,234,82,152
102377,31,551,194,357,545,194,351,6,0,6
102395,31,7,5,2,1,0,1,6,5,1
102429,31,655,313,342,451,192,259,204,121,83
102553,31,990,441,549,665,316,349,325,125,200
102580,31,6,5,1,6,5,1,,,
102614,31,678,314,364,538,277,261,140,37,103
102632,31,149,62,87,111,46,65,38,16,22
102669,31,40,6,34,35,6,29,5,0,5
102711,31,217,161,56,65,49,16,152,112,40
102845,31,494,142,352,494,142,352,,,
103501,31,211,26,185,211,26,185,,,
103741,31,61,4,57,52,4,48,9,0,9
103893,31,272,63,209,272,63,209,,,
103909,31,72,11,61,72,11,61,,,
103927,31,123,21,102,123,21,102,,,
103954,31,3,0,3,3,0,3,,,
103963,31,81,74,7,81,74,7,,,
104090,31,7,0,7,7,0,7,,,
104151,31,14250,6996,7254,14097,6917,7180,153,79,74
104160,31,2131,978,1153,514,235,279,1617,743,874
104179,31,8483,3366,5117,6012,2422,3590,2471,944,1527
104346,31,1651,679,972,395,195,200,1256,484,772
104391,31,44,3,41,44,3,41,,,
104425,31,715,310,405,528,219,309,187,91,96
104443,31,15,1,14,11,1,10,4,0,4
104568,31,264,7,257,154,5,149,110,2,108
104577,31,736,334,402,488,221,267,248,113,135
104586,31,749,535,214,744,531,213,5,4,1
104708,31,1892,954,938,1072,528,544,820,426,394
104717,31,7599,2857,4742,6722,2565,4157,877,292,585
105145,31,446,216,230,212,104,108,234,112,122
105154,31,1782,907,875,1010,511,499,772,396,376
105206,31,387,183,204,110,67,43,277,116,161
105215,31,337,313,24,337,313,24,,,
105297,31,89,32,57,64,24,40,25,8,17
105330,31,5297,1947,3350,4749,1681,3068,548,266,282
105349,31,86,43,43,25,13,12,61,30,31
105428,31,903,366,537,462,184,278,441,182,259
105525,31,2296,1076,1220,855,392,463,1441,684,757
105534,31,184,29,155,184,29,155,,,
105543,31,122,15,107,122,15,107,,,
105589,31,37,11,26,36,11,25,1,0,1
105659,31,343,312,31,343,312,31,,,
105668,31,284,146,138,96,57,39,188,89,99
105677,31,7,7,0,7,7,0,,,
105747,31,670,340,330,390,199,191,280,141,139
105792,31,455,213,242,273,145,128,182,68,114
105899,31,311,202,109,300,201,99,11,1,10
106041,31,835,795,40,835,795,40,,,
106111,31,19,0,19,8,0,8,11,0,11
106148,31,1142,560,582,500,256,244,642,304,338
106245,31,481,212,269,446,197,249,35,15,20
106306,31,148,133,15,128,114,14,20,19,1
106315,31,15,0,15,15,0,15,,,
106324,31,15,0,15,12,0,12,3,0,3
106342,31,138,90,48,138,90,48,,,
106351,31,8,7,1,8,7,1,,,
106360,31,4,0,4,4,0,4,,,
106397,31,6065,2534,3531,6012,2507,3505,53,27,26
106412,31,677,278,399,590,236,354,87,42,45
106449,31,583,253,330,533,235,298,50,18,32
106458,31,1301,528,773,1225,497,728,76,31,45
106467,31,1396,665,731,1337,646,691,59,19,40
106485,31,437,219,218,412,215,197,25,4,21
106494,31,12,0,12,12,0,12,,,
106625,31,287,122,165,244,105,139,43,17,26
106704,31,1854,670,1184,1844,663,1181,10,7,3
106713,31,138,83,55,136,82,54,2,1,1
106795,31,230,104,126,173,80,93,57,24,33
106810,31,52,27,25,52,27,25,,,
106883,31,141,51,90,122,42,80,19,9,10
106892,31,9,0,9,9,0,9,,,
106908,31,49,0,49,48,0,48,1,0,1
106980,31,581,258,323,502,223,279,79,35,44
106999,31,202,80,122,179,72,107,23,8,15
107044,31,748,315,433,744,313,431,4,2,2
107071,31,418,214,204,416,214,202,2,0,2
107080,31,315,155,160,315,155,160,,,
107099,31,11,0,11,11,0,11,,,
107141,31,333,152,181,329,151,178,4,1,3
107220,31,169,2,167,169,2,167,,,
107293,31,10,0,10,10,0,10,,,
107318,31,130,45,85,85,22,63,45,23,22
107327,31,199,95,104,163,82,81,36,13,23
107442,31,4,3,1,4,3,1,,,
107460,31,313,145,168,268,119,149,45,26,19
107488,31,152,103,49,152,103,49,,,
107512,31,485,228,257,485,228,257,,,
107521,31,75,28,47,53,18,35,22,10,12
107549,31,131,36,95,123,34,89,8,2,6
107558,31,201,93,108,201,93,108,,,
107585,31,479,221,258,390,184,206,89,37,52
107600,31,90,35,55,90,35,55,,,
107619,31,138,58,80,117,49,68,21,9,12
107637,31,132,55,77,39,16,23,93,39,54
107655,31,8,0,8,8,0,8,,,
107664,31,920,388,532,729,300,429,191,88,103
107725,31,176,67,109,123,56,67,53,11,42
107743,31,205,93,112,172,82,90,33,11,22
107789,31,35,0,35,35,0,35,,,
107831,31,5,0,5,5,0,5,,,
107840,31,70,24,46,56,19,37,14,5,9
107877,31,191,88,103,190,87,103,1,1,0
107974,31,219,94,125,172,77,95,47,17,30
107983,31,632,293,339,628,293,335,4,0,4
107992,31,242,110,132,201,86,115,41,24,17
108065,31,9,0,9,7,0,7,2,0,2
108092,31,813,325,488,748,291,457,65,34,31
108232,31,590,260,330,281,123,158,309,137,172
108667,31,585,317,268,129,80,49,456,237,219
108807,31,1101,581,520,691,368,323,410,213,197
108852,31,76,36,40,76,36,40,,,
108977,31,30,4,26,13,1,12,17,3,14
109040,31,99,16,83,99,16,83,,,
109208,31,3010,1638,1372,1032,508,524,1978,1130,848
109350,31,1924,903,1021,968,461,507,956,442,514
109651,31,273,104,169,273,104,169,,,
109721,31,122,31,91,122,31,91,,,
109730,31,11,10,1,11,10,1,,,
109785,31,634,208,426,624,205,419,10,3,7
109819,31,2767,1446,1321,1435,707,728,1332,739,593
109907,31,308,132,176,195,79,116,113,53,60
109934,31,40,3,37,40,3,37,,,
110060,31,65,56,9,62,54,8,3,2,1
110097,31,655,262,393,645,257,388,10,5,5
110194,31,162,161,1,162,161,1,,,
110219,31,267,89,178,267,89,178,,,
110246,31,1974,1041,933,965,499,466,1009,542,467
110334,31,1314,640,674,729,332,397,585,308,277
110361,31,1372,506,866,1332,489,843,40,17,23
110370,31,209,68,141,209,68,141,,,
110404,31,270,149,121,270,149,121,,,
110413,31,492,202,290,490,201,289,2,1,1
110422,31,4884,2417,2467,4859,2408,2451,25,9,16
110486,31,1165,402,763,1137,393,744,28,9,19
110495,31,951,325,626,874,293,581,77,32,45
110510,31,2001,784,1217,1908,755,1153,93,29,64
110529,31,3463,1910,1553,3386,1866,1520,77,44,33
110538,31,1929,862,1067,1877,836,1041,52,26,26
110547,31,2048,889,1159,1920,829,1091,128,60,68
110556,31,3451,1394,2057,3170,1271,1899,281,123,158
110565,31,4219,1633,2586,4064,1569,2495,155,64,91
110574,31,941,410,531,921,400,521,20,10,10
110583,31,4865,1888,2977,4740,1840,2900,125,48,77
110592,31,4095,1711,2384,3895,1605,2290,200,106,94
110608,31,4716,2178,2538,4617,2127,2490,99,51,48
110617,31,3581,1505,2076,3486,1451,2035,95,54,41
110635,31,6931,2956,3975,6892,2941,3951,39,15,24
110644,31,7482,3071,4411,7382,3018,4364,100,53,47
110653,31,6489,2603,3886,6473,2596,3877,16,7,9
110662,31,6584,2432,4152,6567,2427,4140,17,5,12
110671,31,5204,2439,2765,5154,2416,2738,50,23,27
110680,31,7542,3356,4186,7506,3334,4172,36,22,14
110705,31,4898,1951,2947,4884,1942,2942,14,9,5
110714,31,4188,1888,2300,4155,1880,2275,33,8,25
110875,31,10,0,10,8,0,8,2,0,2
110918,31,1,1,0,,,,1,1,0
111045,31,2,2,0,2,2,0,,,
111054,31,1,1,0,1,1,0,,,
111081,31,204,77,127,204,77,127,,,
111188,31,195,155,40,195,155,40,,,
111434,31,642,277,365,156,76,80,486,201,285
111461,31,2025,1045,980,1287,648,639,738,397,341
111513,31,26,0,26,23,0,23,3,0,3
111638,31,9,6,3,9,6,3,,,
111708,31,39,36,3,39,36,3,,,
111717,31,34,29,5,33,29,4,1,0,1
111726,31,36,26,10,36,26,10,,,
111744,31,31,31,0,31,31,0,,,
111762,31,22,14,8,22,14,8,,,
111799,31,29,6,23,29,6,23,,,
111887,31,3285,1724,1561,1891,955,936,1394,769,625
111896,31,691,458,233,168,102,66,523,356,167
111920,31,1605,845,760,771,392,379,834,453,381
111939,31,2840,1318,1522,1345,626,719,1495,692,803
111948,31,1658,604,1054,1645,597,1048,13,7,6
111966,31,16,3,13,15,3,12,1,0,1
112075,31,341,144,197,341,144,197,,,
112084,31,120,44,76,113,44,69,7,0,7
112172,31,1309,636,673,870,424,446,439,212,227
112181,31,17,0,17,17,0,17,,,
112190,31,2386,1203,1183,1035,569,466,1351,634,717
112260,31,358,177,181,358,177,181,,,
112288,31,391,24,367,391,24,367,,,
112367,31,65,9,56,19,1,18,46,8,38
112385,31,655,377,278,79,44,35,576,333,243
112394,31,18,15,3,16,13,3,2,2,0
112455,31,31,2,29,31,2,29,,,
112561,31,301,159,142,143,65,78,158,94,64
112570,31,69,37,32,66,36,30,3,1,2
112686,31,330,157,173,150,77,73,180,80,100
112826,31,599,320,279,271,149,122,328,171,157
113096,31,2479,1217,1262,1120,550,570,1359,667,692
113111,31,778,365,413,409,189,220,369,176,193
113193,31,865,457,408,509,283,226,356,174,182
113218,31,1017,515,502,366,183,183,651,332,319
113236,31,2177,1017,1160,1345,622,723,832,395,437
113333,31,3305,1758,1547,2520,1355,1165,785,403,382
113449,31,45,7,38,45,7,38,,,
113537,31,2,0,2,2,0,2,,,
113573,31,1758,824,934,1116,528,588,642,296,346
113582,31,4,1,3,3,1,2,1,0,1
113634,31,2317,1224,1093,1315,710,605,1002,514,488
113698,31,245,81,164,244,80,164,1,1,0
113856,31,2703,1341,1362,1270,644,626,1433,697,736
113980,31,4054,2124,1930,2133,1086,1047,1921,1038,883
114266,31,1112,554,558,576,276,300,536,278,258
114354,31,292,62,230,290,62,228,2,0,2
114433,31,271,143,128,186,93,93,85,50,35
114460,31,39,5,34,26,4,22,13,1,12
114637,31,2,1,1,2,1,1,,,
114716,31,1310,658,652,653,344,309,657,314,343
114761,31,8,0,8,8,0,8,,,
114789,31,2325,1057,1268,1219,528,691,1106,529,577
114813,31,200,74,126,195,71,124,5,3,2
114859,31,2765,1409,1356,1713,849,864,1052,560,492
114938,31,682,315,367,407,172,235,275,143,132
114947,31,34,23,11,34,23,11,,,
115001,31,1721,878,843,1070,561,509,651,317,334
115010,31,13,2,11,13,2,11,,,
115126,31,1678,792,886,939,442,497,739,350,389
115296,31,2017,916,1101,1107,491,616,910,425,485
115357,31,25,5,20,11,5,6,14,0,14
115393,31,1892,978,914,935,461,474,957,517,440
115409,31,225,115,110,225,115,110,,,
115658,31,11,0,11,5,0,5,6,0,6
115728,31,101,37,64,99,36,63,2,1,1
115755,31,629,254,375,609,244,365,20,10,10
115773,31,4,1,3,3,1,2,1,0,1
115861,31,1360,648,712,922,427,495,438,221,217
115931,31,137,102,35,137,102,35,,,
116226,31,1,0,1,,,,1,0,1
116350,31,16,4,12,16,4,12,,,
116439,31,1941,1047,894,1293,719,574,648,328,320
116563,31,4,1,3,4,1,3,,,
117052,31,711,397,314,381,213,168,330,184,146
117104,31,76,42,34,70,38,32,6,4,2
117140,31,680,277,403,672,275,397,8,2,6
117168,31,123,31,92,122,31,91,1,0,1
117195,31,274,187,87,89,52,37,185,135,50
117238,31,19,3,16,19,3,16,,,
117247,31,844,482,362,181,100,81,663,382,281
117274,31,252,193,59,120,82,38,132,111,21
117283,31,6,1,5,6,1,5,,,
117557,31,33,25,8,33,25,8,,,
117575,31,3,2,1,,,,3,2,1
117627,31,284,123,161,257,115,142,27,8,19
117645,31,3676,1833,1843,2413,1123,1290,1263,710,553
117672,31,7,2,5,,,,7,2,5
117690,31,949,466,483,465,234,231,484,232,252
117706,31,2348,1125,1223,1180,535,645,1168,590,578
117715,31,506,218,288,137,57,80,369,161,208
117724,31,1259,751,508,465,278,187,794,473,321
117733,31,1704,839,865,682,340,342,1022,499,523
117751,31,345,168,177,343,166,177,2,2,0
117788,31,1592,761,831,614,284,330,978,477,501
117867,31,1057,514,543,473,238,235,584,276,308
117894,31,1374,647,727,790,362,428,584,285,299
117946,31,1610,760,850,1606,759,847,4,1,3
117955,31,50,7,43,33,2,31,17,5,12
118134,31,21,1,20,7,1,6,14,0,14
118143,31,10,0,10,4,0,4,6,0,6
118161,31,12,1,11,12,1,11,,,
118198,31,176,29,147,176,29,147,,,
118347,31,617,303,314,252,139,113,365,164,201
118541,31,66,29,37,66,29,37,,,
118684,31,208,74,134,70,27,43,138,47,91
118693,31,148,91,57,148,91,57,,,
118718,31,1531,746,785,1015,494,521,516,252,264
118772,31,686,301,385,120,42,78,566,259,307
118888,31,38,0,38,38,0,38,,,
118912,31,1786,876,910,1039,506,533,747,370,377
118930,31,665,322,343,276,131,145,389,191,198
118958,31,26,10,16,12,3,9,14,7,7
118976,31,2584,1163,1421,1413,627,786,1171,536,635
118994,31,72,35,37,72,35,37,,,
119067,31,844,415,429,453,219,234,391,196,195
119137,31,2373,1224,1149,1434,739,695,939,485,454
119164,31,3701,1910,1791,2244,1152,1092,1457,758,699
119173,31,367,14,353,365,14,351,2,0,2
119216,31,3094,1458,1636,1458,644,814,1636,814,822
119270,31,110,86,24,92,73,19,18,13,5
119331,31,733,329,404,437,177,260,296,152,144
119553,31,277,70,207,277,70,207,,,
119605,31,38,20,18,11,5,6,27,15,12
119775,31,15,8,7,14,8,6,1,0,1
119951,31,43,2,41,43,2,41,,,
120069,31,56,3,53,56,3,53,,,
120078,31,84,10,74,84,10,74,,,
120087,31,33,4,29,33,4,29,,,
120166,31,1,1,0,1,1,0,,,
120254,31,535,225,310,535,225,310,,,
120290,31,1271,637,634,746,378,368,525,259,266
120342,31,3486,1728,1758,2188,1076,1112,1298,652,646
120403,31,263,67,196,261,66,195,2,1,1
120421,31,1095,533,562,503,244,259,592,289,303
120537,31,98,36,62,96,36,60,2,0,2
120661,31,166,38,128,166,38,128,,,
120768,31,1,0,1,,,,1,0,1
120865,31,130,60,70,128,59,69,2,1,1
120883,31,781,321,460,779,320,459,2,1,1
120953,31,469,405,64,63,39,24,406,366,40
120971,31,2353,1260,1093,1473,741,732,880,519,361
121044,31,3788,1887,1901,2408,1197,1211,1380,690,690
121150,31,1024,400,624,1023,400,623,1,0,1
121257,31,357,130,227,357,130,227,,,
121275,31,13,10,3,13,10,3,,,
121309,31,662,235,427,662,235,427,,,
121345,31,451,197,254,451,197,254,,,
121363,31,571,285,286,335,159,176,236,126,110
121433,31,22,1,21,22,1,21,,,
121619,31,3201,1840,1361,1144,593,551,2057,1247,810
121637,31,23,2,21,23,2,21,,,
121691,31,550,252,298,517,232,285,33,20,13
121707,31,454,259,195,216,113,103,238,146,92
121859,31,36,3,33,19,3,16,17,0,17
121868,31,34,1,33,19,0,19,15,1,14
121886,31,2351,1446,905,1110,596,514,1241,850,391
121901,31,3272,1484,1788,1818,810,1008,1454,674,780
122180,31,2856,1193,1663,1060,473,587,1796,720,1076
122205,31,2538,1292,1246,1340,728,612,1198,564,634
122339,31,1488,717,771,460,195,265,1028,522,506
122375,31,2195,1022,1173,903,421,482,1292,601,691
122384,31,1344,773,571,456,298,158,888,475,413
122409,31,5269,2074,3195,5233,2059,3174,36,15,21
122436,31,1166,476,690,1165,475,690,1,1,0
122506,31,46,28,18,46,28,18,,,
122597,31,3149,1289,1860,2952,1190,1762,197,99,98
122612,31,1452,461,991,1447,458,989,5,3,2
122658,31,2954,1393,1561,1609,790,819,1345,603,742
122685,31,140,48,92,140,48,92,,,
122694,31,57,20,37,57,20,37,,,
122728,31,176,76,100,170,73,97,6,3,3
122746,31,832,374,458,347,158,189,485,216,269
122755,31,4222,2288,1934,4009,2157,1852,213,131,82
122791,31,1118,562,556,424,220,204,694,342,352
122889,31,2619,1210,1409,1924,860,1064,695,350,345
122931,31,1554,818,736,1553,817,736,1,1,0
122977,31,4124,1896,2228,2722,1261,1461,1402,635,767
123013,31,1389,745,644,687,375,312,702,370,332
123165,31,316,0,316,316,0,316,,,
123217,31,1794,893,901,1221,605,616,573,288,285
123280,31,1,1,0,1,1,0,,,
123299,31,463,227,236,286,148,138,177,79,98
123341,31,2183,1080,1103,1419,691,728,764,389,375
123350,31,45,6,39,39,5,34,6,1,5
123457,31,119,58,61,119,58,61,,,
123484,31,206,133,73,137,95,42,69,38,31
123493,31,84,33,51,84,33,51,,,
123509,31,907,465,442,309,169,140,598,296,302
123527,31,1382,650,732,646,298,348,736,352,384
123554,31,421,192,229,415,189,226,6,3,3
123563,31,1174,577,597,661,290,371,513,287,226
123572,31,822,300,522,803,293,510,19,7,12
123642,31,7,1,6,4,1,3,3,0,3
123651,31,495,129,366,494,129,365,1,0,1
123679,31,196,48,148,176,44,132,20,4,16
123800,31,2515,1268,1247,1577,764,813,938,504,434
123952,31,30,15,15,30,15,15,,,
123961,31,3668,1737,1931,3664,1736,1928,4,1,3
124113,31,708,471,237,216,93,123,492,378,114
124292,31,131,63,68,131,63,68,,,
124487,31,3,2,1,,,,3,2,1
124681,31,233,90,143,233,90,143,,,
124706,31,182,36,146,182,36,146,,,
124937,31,170,44,126,170,44,126,,,
125028,31,1945,977,968,1045,489,556,900,488,412
125082,31,25,2,23,25,2,23,,,
125091,31,1652,776,876,810,372,438,842,404,438
125170,31,611,294,317,181,80,101,430,214,216
125231,31,105,26,79,1,0,1,104,26,78
125310,31,13,3,10,13,3,10,,,
125462,31,349,215,134,136,72,64,213,143,70
125471,31,1078,531,547,338,168,170,740,363,377
125499,31,1111,524,587,623,302,321,488,222,266
125532,31,164,12,152,164,12,152,,,
125727,31,333,117,216,331,116,215,2,1,1
125763,31,277,136,141,275,134,141,2,2,0
125897,31,116,46,70,115,45,70,1,1,0
126076,31,56,56,0,56,56,0,,,
126119,31,691,320,371,311,148,163,380,172,208
126164,31,10,0,10,10,0,10,,,
126182,31,318,180,138,295,163,132,23,17,6
126207,31,905,406,499,455,234,221,450,172,278
126289,31,1096,518,578,493,251,242,603,267,336
126359,31,52,11,41,52,11,41,,,
126562,31,1662,672,990,1540,631,909,122,41,81
126580,31,1429,671,758,1331,620,711,98,51,47
126605,31,49,41,8,49,41,8,,,
126614,31,6727,3655,3072,6648,3604,3044,79,51,28
126669,31,822,267,555,488,161,327,334,106,228
126678,31,619,264,355,619,264,355,,,
126687,31,174,26,148,174,26,148,,,
126711,31,408,238,170,280,182,98,128,56,72
126748,31,143,54,89,121,51,70,22,3,19
126775,31,1449,975,474,1448,974,474,1,1,0
126784,31,39,39,0,39,39,0,,,
126818,31,5044,2154,2890,4566,1908,2658,478,246,232
126827,31,1376,286,1090,885,181,704,491,105,386
126863,31,721,321,400,260,142,118,461,179,282
126915,31,113,43,70,61,21,40,52,22,30
126942,31,1137,433,704,440,178,262,697,255,442
126951,31,429,394,35,429,394,35,,,
127060,31,1621,702,919,1600,689,911,21,13,8
127158,31,2180,1732,448,682,478,204,1498,1254,244
127185,31,959,418,541,916,402,514,43,16,27
127200,31,2287,1070,1217,925,481,444,1362,589,773
127316,31,33,0,33,17,0,17,16,0,16
127389,31,184,82,102,168,79,89,16,3,13
127556,31,1855,867,988,1734,808,926,121,59,62
127565,31,2012,936,1076,1519,710,809,493,226,267
127617,31,118,49,69,45,25,20,73,24,49
127653,31,29,10,19,27,9,18,2,1,1
127714,31,19,11,8,,,,19,11,8
127732,31,376,191,185,347,179,168,29,12,17
127741,31,1256,378,878,1249,375,874,7,3,4
127778,31,198,115,83,174,106,68,24,9,15
127820,31,1910,851,1059,929,416,513,981,435,546
127884,31,536,206,330,225,110,115,311,96,215
127909,31,968,572,396,537,346,191,431,226,205
127918,31,436,146,290,436,146,290,,,
127945,31,187,42,145,131,28,103,56,14,42
127954,31,4,0,4,4,0,4,,,
128106,31,606,312,294,565,288,277,41,24,17
128151,31,357,192,165,356,192,164,1,0,1
128179,31,89,65,24,89,65,24,,,
128188,31,148,66,82,148,66,82,,,
128258,31,313,166,147,256,135,121,57,31,26
128328,31,1091,769,322,1091,769,322,,,
128337,31,52,1,51,38,1,37,14,0,14
128391,31,456,261,195,455,261,194,1,0,1
128498,31,188,89,99,187,89,98,1,0,1
128577,31,266,144,122,202,118,84,64,26,38
128586,31,23,23,0,23,23,0,,,
128744,31,238,76,162,235,75,160,3,1,2
128771,31,1093,603,490,1065,586,479,28,17,11
128780,31,28,6,22,2,0,2,26,6,20
128896,31,55,10,45,55,10,45,,,
128902,31,492,210,282,492,210,282,,,
129002,31,71,37,34,71,37,34,,,
129020,31,3663,1635,2028,3649,1628,2021,14,7,7
129154,31,321,89,232,85,46,39,236,43,193
129181,31,297,281,16,218,205,13,79,76,3
129215,31,784,313,471,783,312,471,1,1,0
129242,31,1256,548,708,1256,548,708,,,
129349,31,17,1,16,15,1,14,2,0,2
129367,31,383,119,264,213,69,144,170,50,120
129482,31,75,7,68,75,7,68,,,
129525,31,977,430,547,969,428,541,8,2,6
129534,31,36,26,10,17,16,1,19,10,9
129543,31,663,322,341,435,214,221,228,108,120
129695,31,932,443,489,568,264,304,364,179,185
129729,31,926,433,493,666,315,351,260,118,142
129756,31,474,203,271,371,167,204,103,36,67
129774,31,109,69,40,108,68,40,1,1,0
129808,31,689,304,385,514,231,283,175,73,102
129923,31,140,83,57,101,62,39,39,21,18
129932,31,297,262,35,246,214,32,51,48,3
129941,31,1277,506,771,1253,497,756,24,9,15
130004,31,700,356,344,435,225,210,265,131,134
130040,31,268,118,150,215,95,120,53,23,30
130110,31,38,10,28,25,5,20,13,5,8
130174,31,332,202,130,332,202,130,,,
130183,31,1850,704,1146,824,278,546,1026,426,600
130217,31,282,116,166,189,79,110,93,37,56
130226,31,1492,569,923,1492,569,923,,,
130253,31,1842,622,1220,1841,622,1219,1,0,1
130314,31,186,42,144,186,42,144,,,
130396,31,1067,497,570,652,314,338,415,183,232
130493,31,1022,374,648,1005,368,637,17,6,11
130509,31,158,16,142,70,9,61,88,7,81
130590,31,523,263,260,521,262,259,2,1,1
130606,31,689,328,361,481,233,248,208,95,113
130624,31,285,172,113,285,172,113,,,
130697,31,910,430,480,910,430,480,,,
130776,31,733,366,367,698,351,347,35,15,20
130794,31,1786,798,988,1786,798,988,,,
130873,31,197,36,161,197,36,161,,,
130907,31,2586,1007,1579,1592,636,956,994,371,623
130934,31,1023,335,688,925,311,614,98,24,74
130943,31,4617,1747,2870,4600,1738,2862,17,9,8
130989,31,128,63,65,125,62,63,3,1,2
131061,31,67,7,60,36,6,30,31,1,30
131113,31,649,257,392,224,99,125,425,158,267
131159,31,2372,813,1559,2365,809,1556,7,4,3
131283,31,691,309,382,691,309,382,,,
131399,31,293,119,174,178,80,98,115,39,76
131450,31,152,68,84,152,68,84,,,
131469,31,2571,938,1633,2563,934,1629,8,4,4
131496,31,1585,634,951,1581,631,950,4,3,1
131520,31,2768,708,2060,2763,706,2057,5,2,3
131803,31,13,7,6,1,1,0,12,6,6
131830,31,3,2,1,3,2,1,,,
131876,31,213,1,212,188,0,188,25,1,24
132374,31,865,730,135,865,730,135,,,
132408,31,26,10,16,23,7,16,3,3,0
132471,31,716,250,466,680,242,438,36,8,28
132602,31,812,306,506,808,304,504,4,2,2
132657,31,797,406,391,778,398,380,19,8,11
132675,31,40,26,14,35,21,14,5,5,0
132693,31,1802,796,1006,922,425,497,880,371,509
132709,31,4973,2324,2649,2773,1305,1468,2200,1019,1181
132842,31,18,2,16,6,0,6,12,2,10
132851,31,914,365,549,575,244,331,339,121,218
132879,31,33,20,13,33,20,13,,,
132903,31,7089,3238,3851,6712,3053,3659,377,185,192
132976,31,118,68,50,118,68,50,,,
133021,31,376,146,230,284,117,167,92,29,63
133155,31,412,158,254,256,106,150,156,52,104
133386,31,1656,701,955,1070,483,587,586,218,368
133465,31,8,3,5,5,3,2,3,0,3
133492,31,650,182,468,644,181,463,6,1,5
133508,31,2877,1170,1707,1822,777,1045,1055,393,662
133526,31,323,182,141,312,177,135,11,5,6
133553,31,1862,1375,487,1850,1368,482,12,7,5
133650,31,1167,348,819,1139,341,798,28,7,21
133669,31,3925,1680,2245,2508,981,1527,1417,699,718
133702,31,2307,1030,1277,1111,515,596,1196,515,681
133711,31,742,245,497,742,245,497,,,
133809,31,192,87,105,192,87,105,,,
133845,31,92,9,83,92,9,83,,,
133854,31,95,25,70,95,25,70,,,
133863,31,126,12,114,126,12,114,,,
133872,31,74,12,62,51,9,42,23,3,20
133881,31,756,530,226,752,528,224,4,2,2
133951,31,4061,1745,2316,2872,1131,1741,1189,614,575
133960,31,166,88,78,115,66,49,51,22,29
133979,31,336,174,162,315,154,161,21,20,1
133997,31,68,19,49,68,19,49,,,
134024,31,6,1,5,6,1,5,,,
134079,31,792,251,541,792,251,541,,,
134097,31,7617,3083,4534,7465,3026,4439,152,57,95
134130,31,6787,2871,3916,6760,2864,3896,27,7,20
134228,31,24,11,13,22,10,12,2,1,1
134237,31,4419,3189,1230,4419,3189,1230,,,
134291,31,410,348,62,400,338,62,10,10,0
134307,31,200,182,18,34,32,2,166,150,16
134343,31,853,350,503,686,288,398,167,62,105
134422,31,2,0,2,2,0,2,,,
134495,31,4446,2028,2418,2927,1399,1528,1519,629,890
134510,31,35,21,14,18,8,10,17,13,4
134529,31,117,12,105,117,12,105,,,
134574,31,44,5,39,44,5,39,,,
134608,31,2090,936,1154,1074,486,588,1016,450,566
134714,31,68,20,48,21,8,13,47,12,35
134811,31,72,33,39,51,23,28,21,10,11
134945,31,635,236,399,631,234,397,4,2,2
135081,31,2129,551,1578,1506,414,1092,623,137,486
135142,31,79,0,79,1,0,1,78,0,78
135160,31,493,185,308,285,107,178,208,78,130
135179,31,236,142,94,182,123,59,54,19,35
135188,31,786,314,472,416,184,232,370,130,240
135267,31,437,315,122,437,315,122,,,
135276,31,437,222,215,379,180,199,58,42,16
135294,31,144,68,76,97,67,30,47,1,46
135337,31,49,1,48,29,1,28,20,0,20
135364,31,7,5,2,,,,7,5,2
135391,31,1647,716,931,1118,522,596,529,194,335
135407,31,627,339,288,625,338,287,2,1,1
135522,31,192,126,66,192,126,66,,,
135559,31,17,2,15,8,1,7,9,1,8
135610,31,1,1,0,,,,1,1,0
135647,31,201,164,37,104,94,10,97,70,27
135717,31,9596,4364,5232,7040,3134,3906,2556,1230,1326
135726,31,2766,1293,1473,2759,1289,1470,7,4,3
135735,31,210,185,25,85,73,12,125,112,13
136109,31,27,2,25,20,2,18,7,0,7
136145,31,202,69,133,88,32,56,114,37,77
136172,31,2578,1064,1514,2424,985,1439,154,79,75
136215,31,1672,459,1213,1651,454,1197,21,5,16
136233,31,585,291,294,402,214,188,183,77,106
136303,31,75,11,64,65,9,56,10,2,8
136330,31,505,184,321,502,183,319,3,1,2
136358,31,4437,2036,2401,2136,1010,1126,2301,1026,1275
136400,31,1921,833,1088,1071,465,606,850,368,482
136473,31,1243,450,793,766,298,468,477,152,325
136491,31,153,90,63,121,73,48,32,17,15
136516,31,1174,459,715,653,254,399,521,205,316
136659,31,71,54,17,67,52,15,4,2,2
136765,31,327,160,167,283,138,145,44,22,22
136774,31,401,108,293,400,108,292,1,0,1
136826,31,157,70,87,89,42,47,68,28,40
136950,31,549,203,346,549,203,346,,,
137023,31,305,145,160,300,141,159,5,4,1
137032,31,823,320,503,821,319,502,2,1,1
137078,31,3000,1302,1698,1612,748,864,1388,554,834
137087,31,176,113,63,156,106,50,20,7,13
137096,31,2573,1236,1337,1549,809,740,1024,427,597
137120,31,405,210,195,336,179,157,69,31,38
137209,31,2292,1109,1183,1597,778,819,695,331,364
137245,31,611,275,336,611,275,336,,,
137272,31,11,9,2,11,9,2,,,
137281,31,837,350,487,517,232,285,320,118,202
137315,31,669,253,416,336,153,183,333,100,233
137351,31,6279,2681,3598,6096,2590,3506,183,91,92
137476,31,536,318,218,532,316,216,4,2,2
137546,31,637,256,381,637,256,381,,,
137564,31,1205,499,706,1102,446,656,103,53,50
137591,31,92,13,79,89,13,76,3,0,3
137713,31,163,59,104,113,43,70,50,16,34
137759,31,3078,1455,1623,2533,1208,1325,545,247,298
137777,31,10,10,0,10,10,0,,,
137801,31,110,62,48,110,62,48,,,
137847,31,3102,1128,1974,3092,1125,1967,10,3,7
137856,31,80,41,39,66,37,29,14,4,10
137865,31,120,66,54,108,56,52,12,10,2
137953,31,77,43,34,74,41,33,3,2,1
137962,31,34,28,6,34,28,6,,,
138187,31,7271,3193,4078,4266,1962,2304,3005,1231,1774
138275,31,227,131,96,227,131,96,,,
138284,31,307,166,141,230,124,106,77,42,35
138293,31,237,185,52,233,183,50,4,2,2
138309,31,369,54,315,171,26,145,198,28,170
138354,31,1187,546,641,1044,472,572,143,74,69
138372,31,191,103,88,136,49,87,55,54,1
138479,31,280,179,101,280,179,101,,,
138488,31,173,59,114,129,29,100,44,30,14
138497,31,316,170,146,316,170,146,,,
138558,31,865,374,491,794,346,448,71,28,43
138600,31,301,0,301,301,0,301,,,
138655,31,144,92,52,129,82,47,15,10,5
138664,31,29,8,21,29,8,21,,,
138682,31,399,166,233,143,64,79,256,102,154
138716,31,1046,309,737,899,259,640,147,50,97
138761,31,91,55,36,91,55,36,,,
138813,31,91,44,47,45,23,22,46,21,25
138822,31,125,6,119,125,6,119,,,
138840,31,492,224,268,195,102,93,297,122,175
138868,31,157,96,61,145,89,56,12,7,5
138901,31,244,107,137,179,79,100,65,28,37
138938,31,44,9,35,30,7,23,14,2,12
138947,31,1123,254,869,1108,252,856,15,2,13
138956,31,657,333,324,336,174,162,321,159,162
139144,31,729,260,469,729,260,469,,,
139153,31,7,3,4,2,1,1,5,2,3
139199,31,177,12,165,156,10,146,21,2,19
139205,31,209,133,76,201,125,76,8,8,0
139250,31,604,207,397,468,161,307,136,46,90
139278,31,866,375,491,433,176,257,433,199,234
139311,31,671,226,445,589,193,396,82,33,49
139357,31,401,159,242,148,59,89,253,100,153
139366,31,1205,503,702,1098,443,655,107,60,47
139384,31,729,322,407,252,120,132,477,202,275
139393,31,266,131,135,250,126,124,16,5,11
139463,31,837,349,488,730,301,429,107,48,59
139506,31,34,20,14,34,20,14,,,
139579,31,16,5,11,12,3,9,4,2,2
139621,31,674,329,345,552,257,295,122,72,50
139630,31,246,135,111,242,132,110,4,3,1
139658,31,1494,598,896,1494,598,896,,,
139700,31,971,405,566,656,260,396,315,145,170
139719,31,756,294,462,667,258,409,89,36,53
139755,31,3471,2011,1460,3460,2003,1457,11,8,3
139764,31,385,138,247,375,136,239,10,2,8
139861,31,1507,503,1004,1502,502,1000,5,1,4
139931,31,5571,2369,3202,5413,2296,3117,158,73,85
139940,31,6058,2374,3684,5774,2274,3500,284,100,184
139959,31,5819,2133,3686,5785,2122,3663,34,11,23
139968,31,584,290,294,441,216,225,143,74,69
139986,31,699,285,414,235,123,112,464,162,302
139995,31,184,80,104,184,80,104,,,
140003,31,16,4,12,12,4,8,4,0,4
140012,31,939,493,446,268,160,108,671,333,338
140234,31,130,89,41,129,89,40,1,0,1
140243,31,632,328,304,291,123,168,341,205,136
140252,31,173,97,76,170,96,74,3,1,2
140331,31,1363,709,654,622,354,268,741,355,386
140340,31,47,12,35,35,10,25,12,2,10
140447,31,969,351,618,947,347,600,22,4,18
140553,31,629,628,1,619,619,0,10,9,1
140678,31,397,228,169,254,156,98,143,72,71
140696,31,404,143,261,404,143,261,,,
140720,31,79,50,29,71,44,27,8,6,2
140818,31,249,93,156,246,92,154,3,1,2
140872,31,222,131,91,220,130,90,2,1,1
140942,31,520,246,274,210,99,111,310,147,163
140951,31,2685,778,1907,2541,732,1809,144,46,98
140960,31,794,272,522,752,253,499,42,19,23
140988,31,309,153,156,309,153,156,,,
141006,31,258,170,88,159,111,48,99,59,40
141015,31,25,8,17,25,8,17,,,
141060,31,794,0,794,794,0,794,,,
141167,31,94,56,38,91,54,37,3,2,1
141185,31,177,67,110,166,64,102,11,3,8
141237,31,241,117,124,239,116,123,2,1,1
141255,31,327,177,150,101,41,60,226,136,90
141264,31,1782,580,1202,1716,556,1160,66,24,42
141325,31,111,0,111,111,0,111,,,
141334,31,1543,609,934,1439,569,870,104,40,64
141361,31,304,150,154,303,149,154,1,1,0
141486,31,290,93,197,281,91,190,9,2,7
141565,31,459,166,293,394,147,247,65,19,46
141574,31,2939,1043,1896,2705,935,1770,234,108,126
141608,31,7,5,2,7,5,2,,,
141644,31,790,178,612,780,176,604,10,2,8
141680,31,450,331,119,242,176,66,208,155,53
141796,31,798,303,495,412,174,238,386,129,257
141802,31,217,87,130,101,46,55,116,41,75
141811,31,875,374,501,517,222,295,358,152,206
141839,31,441,172,269,270,95,175,171,77,94
141981,31,224,97,127,184,78,106,40,19,21
141990,31,223,71,152,137,40,97,86,31,55
142054,31,41,6,35,41,6,35,,,
142090,31,20,9,11,18,8,10,2,1,1
142115,31,3203,1352,1851,3085,1292,1793,118,60,58
142179,31,323,140,183,191,91,100,132,49,83
142276,31,1490,616,874,1398,573,825,92,43,49
142285,31,1656,803,853,1624,785,839,32,18,14
142294,31,295,142,153,295,142,153,,,
142328,31,464,179,285,435,169,266,29,10,19
142407,31,11,1,10,8,1,7,3,0,3
142416,31,9,1,8,9,1,8,,,
142443,31,866,407,459,613,325,288,253,82,171
142461,31,275,132,143,274,132,142,1,0,1
142489,31,9,0,9,9,0,9,,,
142522,31,4858,2087,2771,4057,1723,2334,801,364,437
142559,31,1054,399,655,697,281,416,357,118,239
142887,31,25,11,14,19,7,12,6,4,2
142957,31,1,1,0,1,1,0,,,
143048,31,668,135,533,663,135,528,5,0,5
143084,31,648,309,339,648,309,339,,,
143118,31,822,316,506,822,316,506,,,
143215,31,1162,604,558,795,420,375,367,184,183
143279,31,658,270,388,548,235,313,110,35,75
143288,31,77,41,36,76,40,36,1,1,0
143358,31,1042,492,550,1039,489,550,3,3,0
143376,31,15,2,13,8,2,6,7,0,7
143464,31,5,0,5,5,0,5,,,
143473,31,7,0,7,3,0,3,4,0,4
143482,31,11,0,11,3,0,3,8,0,8
143491,31,13,2,11,3,1,2,10,1,9
143552,31,4,0,4,,,,4,0,4
143613,31,293,149,144,228,123,105,65,26,39
144005,31,168,70,98,147,65,82,21,5,16
144050,31,2053,1067,986,2053,1067,986,,,
144157,31,218,128,90,141,84,57,77,44,33
144166,31,988,231,757,656,155,501,332,76,256
144175,31,190,98,92,116,58,58,74,40,34
144184,31,431,191,240,268,116,152,163,75,88
144193,31,555,312,243,322,194,128,233,118,115
144209,31,892,416,476,639,305,334,253,111,142
144218,31,1072,595,477,777,442,335,295,153,142
144281,31,1696,677,1019,1680,670,1010,16,7,9
144351,31,339,159,180,336,159,177,3,0,3
144564,31,301,141,160,208,94,114,93,47,46
144573,31,8,0,8,7,0,7,1,0,1
144740,31,2838,1169,1669,2822,1162,1660,16,7,9
144795,31,141,43,98,138,42,96,3,1,2
144865,31,3063,1544,1519,1893,995,898,1170,549,621
144883,31,265,108,157,265,108,157,,,
144892,31,778,329,449,771,327,444,7,2,5
144944,31,1216,640,576,805,416,389,411,224,187
144962,31,531,198,333,530,198,332,1,0,1
144971,31,119,78,41,119,78,41,,,
145099,31,51,4,47,51,4,47,,,
145239,31,24,2,22,24,2,22,,,
145309,31,18,3,15,18,3,15,,,
145336,31,194,81,113,189,78,111,5,3,2
145354,31,2,0,2,2,0,2,,,
145372,31,206,129,77,206,129,77,,,
145406,31,52,0,52,16,0,16,36,0,36
145424,31,17,0,17,3,0,3,14,0,14
145433,31,12,0,12,2,0,2,10,0,10
145497,31,4,1,3,2,0,2,2,1,1
145521,31,282,133,149,228,103,125,54,30,24
145600,31,4177,1844,2333,4024,1778,2246,153,66,87
145619,31,415,239,176,411,236,175,4,3,1
145637,31,8297,4459,3838,8273,4444,3829,24,15,9
145646,31,433,234,199,433,234,199,,,
145682,31,1122,532,590,759,384,375,363,148,215
145691,31,249,127,122,249,127,122,,,
145707,31,263,129,134,219,118,101,44,11,33
145725,31,505,343,162,499,337,162,6,6,0
145813,31,3374,1409,1965,3355,1398,1957,19,11,8
145831,31,504,239,265,351,172,179,153,67,86
146205,31,549,236,313,393,177,216,156,59,97
146278,31,470,201,269,377,175,202,93,26,67
146296,31,769,395,374,341,195,146,428,200,228
146339,31,188,103,85,188,103,85,,,
146348,31,421,195,226,287,141,146,134,54,80
146366,31,458,207,251,361,177,184,97,30,67
146418,31,443,222,221,327,171,156,116,51,65
146427,31,270,122,148,270,122,148,,,
146454,31,19,0,19,19,0,19,,,
146472,31,1776,906,870,1070,569,501,706,337,369
146481,31,417,200,217,416,200,216,1,0,1
146506,31,795,350,445,683,306,377,112,44,68
146603,31,530,245,285,427,198,229,103,47,56
146612,31,567,282,285,566,282,284,1,0,1
146667,31,81,43,38,78,41,37,3,2,1
146676,31,199,107,92,195,105,90,4,2,2
146685,31,970,435,535,656,335,321,314,100,214
146700,31,294,217,77,294,217,77,,,
146719,31,2867,845,2022,2862,844,2018,5,1,4
146807,31,4,0,4,1,0,1,3,0,3
146816,31,64,3,61,56,3,53,8,0,8
147004,31,742,374,368,380,199,181,362,175,187
147013,31,268,145,123,268,145,123,,,
147129,31,7,0,7,3,0,3,4,0,4
147244,31,409,210,199,409,210,199,,,
147341,31,179,99,80,179,99,80,,,
147369,31,170,90,80,154,81,73,16,9,7
147378,31,1708,867,841,1252,630,622,456,237,219
147396,31,28,24,4,28,24,4,,,
147411,31,612,306,306,410,211,199,202,95,107
147536,31,558,212,346,496,196,300,62,16,46
147642,31,15,2,13,10,1,9,5,1,4
147660,31,512,283,229,512,283,229,,,
147679,31,464,192,272,464,192,272,,,
147703,31,2285,1013,1272,2147,950,1197,138,63,75
147767,31,2086,927,1159,2086,927,1159,,,
147776,31,330,149,181,314,142,172,16,7,9
147800,31,1136,547,589,452,257,195,684,290,394
147819,31,29,1,28,29,1,28,,,
147828,31,660,298,362,660,298,362,,,
147916,31,844,493,351,618,379,239,226,114,112
148007,31,488,215,273,233,96,137,255,119,136
148016,31,79,45,34,79,45,34,,,
148098,31,5,0,5,5,0,5,,,
148131,31,232,146,86,232,146,86,,,
148256,31,410,204,206,344,180,164,66,24,42
148292,31,280,129,151,126,55,71,154,74,80
148380,31,1165,557,608,714,339,375,451,218,233
148405,31,202,109,93,202,109,93,,,
148487,31,507,241,266,506,241,265,1,0,1
148496,31,462,146,316,461,145,316,1,1,0
148584,31,204,84,120,202,83,119,2,1,1
148627,31,747,308,439,738,308,430,9,0,9
148654,31,264,98,166,260,97,163,4,1,3
148672,31,341,160,181,232,106,126,109,54,55
148821,31,188,89,99,139,71,68,49,18,31
148876,31,59,8,51,50,6,44,9,2,7
148937,31,235,109,126,201,101,100,34,8,26
148991,31,156,74,82,126,59,67,30,15,15
149028,31,1,1,0,1,1,0,,,
149204,31,4,0,4,4,0,4,,,
149222,31,1422,688,734,1387,664,723,35,24,11
149231,31,1992,754,1238,1936,734,1202,56,20,36
149310,31,127,74,53,127,74,53,,,
149329,31,14,14,0,14,14,0,,,
149365,31,268,96,172,142,61,81,126,35,91
149499,31,3,0,3,3,0,3,,,
149505,31,180,74,106,179,73,106,1,1,0
149514,31,96,62,34,91,58,33,5,4,1
149532,31,1335,764,571,856,455,401,479,309,170
149550,31,30,2,28,27,2,25,3,0,3
149639,31,20,5,15,20,5,15,,,
149727,31,1316,660,656,915,465,450,401,195,206
149772,31,920,359,561,905,353,552,15,6,9
149781,31,546,237,309,545,236,309,1,1,0
149842,31,2241,1183,1058,1619,879,740,622,304,318
150066,31,317,174,143,313,171,142,4,3,1
150136,31,3278,1238,2040,3248,1229,2019,30,9,21
150145,31,286,106,180,283,105,178,3,1,2
150163,31,1132,455,677,1130,455,675,2,0,2
150172,31,112,58,54,97,53,44,15,5,10
150251,31,4,0,4,3,0,3,1,0,1
150303,31,31,0,31,15,0,15,16,0,16
150400,31,500,246,254,500,246,254,,,
150428,31,5,0,5,5,0,5,,,
150455,31,171,86,85,171,86,85,,,
150534,31,327,123,204,327,123,204,,,
150604,31,255,149,106,253,148,105,2,1,1
150668,31,183,72,111,183,72,111,,,
150677,31,437,149,288,437,149,288,,,
150756,31,276,139,137,276,139,137,,,
150765,31,16,1,15,16,1,15,,,
150774,31,214,109,105,210,105,105,4,4,0
150853,31,13,1,12,11,0,11,2,1,1
150941,31,251,104,147,238,98,140,13,6,7
150987,31,10962,5216,5746,4167,1884,2283,6795,3332,3463
151102,31,1293,705,588,1242,676,566,51,29,22
151111,31,3496,1343,2153,3341,1265,2076,155,78,77
151263,31,1052,357,695,1049,355,694,3,2,1
151290,31,446,260,186,443,260,183,3,0,3
151306,31,1327,458,869,1306,448,858,21,10,11
151324,31,1430,611,819,1420,604,816,10,7,3
151333,31,587,211,376,572,206,366,15,5,10
151342,31,697,238,459,611,208,403,86,30,56
151351,31,9482,4711,4771,9450,4696,4754,32,15,17
151360,31,482,159,323,443,149,294,39,10,29
151379,31,588,236,352,539,214,325,49,22,27
151388,31,329,113,216,299,101,198,30,12,18
151467,31,55,11,44,55,11,44,,,
151564,31,45,2,43,11,1,10,34,1,33
151607,31,6,1,5,3,0,3,3,1,2
151652,31,110,3,107,59,2,57,51,1,50
151661,31,194,154,40,194,154,40,,,
151777,31,307,166,141,307,166,141,,,
151786,31,587,266,321,573,266,307,14,0,14
151801,31,565,214,351,565,214,351,,,
151810,31,22,5,17,6,1,5,16,4,12
151962,31,43,11,32,43,11,32,,,
152044,31,62,28,34,21,18,3,41,10,31
152080,31,2059,1055,1004,2059,1055,1004,,,
152099,31,168,80,88,154,70,84,14,10,4
152150,31,5,0,5,5,0,5,,,
152275,31,15,3,12,11,0,11,4,3,1
152309,31,19,5,14,16,3,13,3,2,1
152318,31,637,481,156,637,481,156,,,
152336,31,450,159,291,448,159,289,2,0,2
152381,31,194,41,153,182,39,143,12,2,10
152390,31,375,0,375,375,0,375,,,
152497,31,11,0,11,10,0,10,1,0,1
152530,31,398,182,216,398,182,216,,,
152567,31,643,405,238,643,405,238,,,
152600,31,601,247,354,600,247,353,1,0,1
152628,31,23,1,22,11,1,10,12,0,12
152637,31,1291,795,496,1182,734,448,109,61,48
152673,31,210,210,0,210,210,0,,,
152798,31,1,0,1,,,,1,0,1
152992,31,169,86,83,169,86,83,,,
153001,31,237,134,103,237,134,103,,,
153074,31,20,1,19,20,1,19,,,
153083,31,13,1,12,13,1,12,,,
153108,31,340,172,168,339,172,167,1,0,1
153126,31,183,112,71,183,112,71,,,
153144,31,397,158,239,397,158,239,,,
153162,31,366,192,174,366,192,174,,,
153214,31,2574,1246,1328,1695,891,804,879,355,524
153241,31,3,0,3,3,0,3,,,
153250,31,427,226,201,424,225,199,3,1,2
153269,31,787,286,501,787,286,501,,,
153278,31,330,206,124,328,206,122,2,0,2
153296,31,225,137,88,217,132,85,8,5,3
153302,31,48,18,30,47,18,29,1,0,1
153311,31,854,371,483,643,306,337,211,65,146
153320,31,84,41,43,80,39,41,4,2,2
153366,31,249,164,85,248,164,84,1,0,1
153375,31,291,161,130,290,161,129,1,0,1
153384,31,471,212,259,471,212,259,,,
153427,31,31,16,15,31,16,15,,,
153445,31,924,422,502,759,372,387,165,50,115
153463,31,8,0,8,8,0,8,,,
153472,31,602,318,284,548,297,251,54,21,33
153524,31,1106,695,411,976,647,329,130,48,82
153533,31,308,185,123,262,153,109,46,32,14
153597,31,40,2,38,40,2,38,,,
153603,31,5387,2896,2491,5336,2860,2476,51,36,15
153621,31,264,188,76,257,182,75,7,6,1
153630,31,1063,610,453,855,544,311,208,66,142
153658,31,4521,1816,2705,4491,1799,2692,30,17,13
153737,31,2163,1053,1110,1647,872,775,516,181,335
153746,31,7,1,6,7,1,6,,,
153764,31,17,0,17,17,0,17,,,
153773,31,30,0,30,30,0,30,,,
153782,31,5,0,5,5,0,5,,,
153825,31,296,187,109,295,186,109,1,1,0
153834,31,419,201,218,419,201,218,,,
153861,31,38,16,22,16,8,8,22,8,14
153922,31,301,158,143,254,144,110,47,14,33
153977,31,51,10,41,43,9,34,8,1,7
154004,31,370,196,174,370,196,174,,,
154013,31,222,89,133,217,85,132,5,4,1
154022,31,787,283,504,787,283,504,,,
154059,31,517,266,251,479,247,232,38,19,19
154095,31,1553,552,1001,1544,549,995,9,3,6
154101,31,268,134,134,268,134,134,,,
154110,31,498,217,281,360,187,173,138,30,108
154129,31,285,170,115,245,163,82,40,7,33
154165,31,4,0,4,4,0,4,,,
154208,31,39,0,39,4,0,4,35,0,35
154235,31,493,270,223,492,269,223,1,1,0
154262,31,19,0,19,12,0,12,7,0,7
154332,31,19,3,16,19,3,16,,,
154350,31,287,146,141,287,146,141,,,
154378,31,540,261,279,434,228,206,106,33,73
154396,31,287,134,153,259,126,133,28,8,20
154448,31,21,3,18,21,3,18,,,
154457,31,5,0,5,5,0,5,,,
154466,31,4,1,3,4,1,3,,,
154493,31,200,139,61,176,122,54,24,17,7
154518,31,191,132,59,187,131,56,4,1,3
154527,31,413,210,203,413,210,203,,,
154545,31,58,40,18,58,40,18,,,
154572,31,735,336,399,559,288,271,176,48,128
154590,31,320,202,118,319,201,118,1,1,0
154642,31,404,203,201,324,171,153,80,32,48
154688,31,219,113,106,217,113,104,2,0,2
154697,31,597,304,293,451,229,222,146,75,71
154712,31,603,305,298,603,305,298,,,
154721,31,256,174,82,256,174,82,,,
154749,31,150,86,64,150,86,64,,,
154800,31,1562,668,894,1109,477,632,453,191,262
154855,31,100,53,47,100,53,47,,,
154907,31,266,130,136,249,127,122,17,3,14
154925,31,394,258,136,362,241,121,32,17,15
154934,31,178,69,109,155,65,90,23,4,19
154952,31,564,245,319,472,212,260,92,33,59
154998,31,329,183,146,265,153,112,64,30,34
155007,31,53,21,32,44,14,30,9,7,2
155025,31,481,183,298,475,180,295,6,3,3
155052,31,113,72,41,87,54,33,26,18,8
155061,31,955,387,568,853,341,512,102,46,56
155070,31,18,9,9,16,8,8,2,1,1
155089,31,283,165,118,281,164,117,2,1,1
155098,31,341,212,129,284,176,108,57,36,21
155104,31,503,261,242,426,225,201,77,36,41
155140,31,167,70,97,160,70,90,7,0,7
155159,31,40,0,40,40,0,40,,,
155177,31,115,73,42,114,72,42,1,1,0
155186,31,566,270,296,385,195,190,181,75,106
155195,31,923,460,463,737,371,366,186,89,97
155201,31,207,116,91,179,104,75,28,12,16
155210,31,2124,1060,1064,1280,639,641,844,421,423
155283,31,146,13,133,128,13,115,18,0,18
155292,31,681,346,335,394,202,192,287,144,143
155308,31,31,28,3,31,28,3,,,
155317,31,4119,1871,2248,4045,1838,2207,74,33,41
155335,31,150,62,88,148,61,87,2,1,1
155353,31,55,49,6,55,49,6,,,
155399,31,2848,1401,1447,2803,1379,1424,45,22,23
155414,31,254,139,115,253,138,115,1,1,0
155423,31,239,160,79,167,118,49,72,42,30
155450,31,247,105,142,212,92,120,35,13,22
155487,31,107,71,36,70,52,18,37,19,18
155496,31,42,25,17,39,24,15,3,1,2
155511,31,271,183,88,271,183,88,,,
155520,31,209,138,71,209,138,71,,,
155566,31,287,136,151,238,108,130,49,28,21
155593,31,224,183,41,206,178,28,18,5,13
155618,31,142,112,30,142,112,30,,,
155627,31,231,143,88,213,129,84,18,14,4
155681,31,812,397,415,804,391,413,8,6,2
155715,31,247,187,60,238,183,55,9,4,5
155812,31,242,128,114,241,127,114,1,1,0
155830,31,97,58,39,79,53,26,18,5,13
155858,31,346,146,200,278,121,157,68,25,43
155900,31,204,137,67,203,136,67,1,1,0
155937,31,206,146,60,206,146,60,,,
155973,31,183,124,59,183,124,59,,,
156082,31,693,259,434,657,245,412,36,14,22
156107,31,425,285,140,269,208,61,156,77,79
156125,31,1814,851,963,1742,816,926,72,35,37
156134,31,121,80,41,121,80,41,,,
156189,31,203,102,101,203,102,101,,,
156213,31,263,110,153,258,109,149,5,1,4
156231,31,407,216,191,328,192,136,79,24,55
156277,31,1,0,1,1,0,1,,,
156286,31,593,201,392,591,200,391,2,1,1
156295,31,338,137,201,338,137,201,,,
156310,31,38,1,37,33,1,32,5,0,5
156338,31,631,262,369,364,147,217,267,115,152
156356,31,125,46,79,124,46,78,1,0,1
156365,31,681,369,312,661,365,296,20,4,16
156392,31,1633,764,869,1061,519,542,572,245,327
156408,31,377,176,201,377,176,201,,,
156417,31,9,7,2,6,5,1,3,2,1
156426,31,30,2,28,21,2,19,9,0,9
156471,31,993,68,925,481,34,447,512,34,478
156541,31,613,274,339,589,266,323,24,8,16
156620,31,2493,960,1533,2365,915,1450,128,45,83
156648,31,861,390,471,519,233,286,342,157,185
156745,31,481,205,276,481,205,276,,,
156754,31,3,0,3,3,0,3,,,
156790,31,346,159,187,267,118,149,79,41,38
156842,31,47,0,47,43,0,43,4,0,4
156851,31,170,55,115,106,35,71,64,20,44
156860,31,306,121,185,195,62,133,111,59,52
156921,31,1647,775,872,859,425,434,788,350,438
156967,31,4,1,3,4,1,3,,,
157021,31,31,2,29,3,2,1,28,0,28
157030,31,14,9,5,13,8,5,1,1,0
157058,31,476,187,289,396,150,246,80,37,43
157076,31,205,122,83,205,122,83,,,
157085,31,4721,1971,2750,4601,1897,2704,120,74,46
157100,31,189,138,51,180,133,47,9,5,4
157216,31,441,209,232,427,203,224,14,6,8
157289,31,2695,1196,1499,2451,1077,1374,244,119,125
157304,31,380,145,235,296,109,187,84,36,48
157331,31,445,200,245,294,132,162,151,68,83
157377,31,237,80,157,233,78,155,4,2,2
157386,31,1184,436,748,1174,434,740,10,2,8
157401,31,1395,548,847,1378,536,842,17,12,5
157438,31,550,270,280,232,135,97,318,135,183
157447,31,1690,706,984,1631,681,950,59,25,34
157483,31,764,322,442,594,253,341,170,69,101
157535,31,245,124,121,245,124,121,,,
157553,31,418,200,218,363,171,192,55,29,26
157614,31,33,0,33,23,0,23,10,0,10
157650,31,56,3,53,42,3,39,14,0,14
157669,31,22,0,22,22,0,22,,,
157678,31,49,0,49,49,0,49,,,
157711,31,793,331,462,571,243,328,222,88,134
157739,31,306,137,169,224,95,129,82,42,40
157748,31,193,117,76,159,92,67,34,25,9
157757,31,104,43,61,103,42,61,1,1,0
157793,31,250,106,144,174,68,106,76,38,38
157809,31,389,196,193,384,194,190,5,2,3
157818,31,286,124,162,286,124,162,,,
157863,31,140,80,60,140,80,60,,,
157951,31,2832,1019,1813,2794,1004,1790,38,15,23
158088,31,384,240,144,332,209,123,52,31,21
158246,31,54,23,31,54,23,31,,,
158343,31,24,11,13,13,5,8,11,6,5
158431,31,1142,465,677,729,305,424,413,160,253
158477,31,134,58,76,133,57,76,1,1,0
158538,31,1,0,1,1,0,1,,,
158617,31,297,114,183,297,114,183,,,
158662,31,1683,723,960,933,385,548,750,338,412
158778,31,12,1,11,12,1,11,,,
158787,31,15,0,15,15,0,15,,,
158802,31,309,59,250,309,59,250,,,
158884,31,246,127,119,161,90,71,85,37,48
159009,31,750,277,473,712,266,446,38,11,27
159027,31,5,0,5,5,0,5,,,
159197,31,136,118,18,136,118,18,,,
159328,31,20,1,19,20,1,19,,,
159382,31,410,161,249,371,147,224,39,14,25
159391,31,7045,2961,4084,7038,2957,4081,7,4,3
159407,31,768,218,550,663,195,468,105,23,82
159416,31,306,132,174,298,129,169,8,3,5
159513,31,18,0,18,18,0,18,,,
159522,31,59,2,57,59,2,57,,,
159531,31,4,0,4,4,0,4,,,
159568,31,261,166,95,260,165,95,1,1,0
159601,31,24,1,23,24,1,23,,,
159647,31,1871,1095,776,1866,1091,775,5,4,1
159656,31,928,303,625,922,301,621,6,2,4
159717,31,1020,459,561,995,448,547,25,11,14
159939,31,1151,536,615,1097,509,588,54,27,27
159948,31,83,32,51,19,3,16,64,29,35
159966,31,958,381,577,948,376,572,10,5,5
159993,31,1140,415,725,1119,408,711,21,7,14
160010,31,187,153,34,93,79,14,94,74,20
160038,31,1300,417,883,1246,403,843,54,14,40
160065,31,61,10,51,54,10,44,7,0,7
160074,31,97,12,85,91,12,79,6,0,6
160117,31,2,0,2,2,0,2,,,
160126,31,1,0,1,1,0,1,,,
160199,31,12,0,12,12,0,12,,,
160320,31,202,6,196,202,6,196,,,
160409,31,14,14,0,14,14,0,,,
160472,31,118,4,114,76,2,74,42,2,40
160481,31,364,133,231,232,88,144,132,45,87
160524,31,103,34,69,103,34,69,,,
160579,31,590,337,253,392,231,161,198,106,92
160597,31,3,3,0,2,2,0,1,1,0
160612,31,2226,897,1329,1555,662,893,671,235,436
160621,31,1614,548,1066,1543,514,1029,71,34,37
160630,31,111,33,78,94,28,66,17,5,12
160649,31,392,174,218,353,158,195,39,16,23
160658,31,2693,1099,1594,2632,1079,1553,61,20,41
160667,31,496,293,203,401,250,151,95,43,52
160755,31,2027,726,1301,2027,726,1301,,,
160904,31,989,225,764,984,225,759,5,0,5
160959,31,93,25,68,92,25,67,1,0,1
160977,31,553,255,298,553,255,298,,,
160995,31,256,65,191,256,65,191,,,
161004,31,517,262,255,517,262,255,,,
161022,31,11,1,10,6,1,5,5,0,5
161077,31,619,298,321,418,238,180,201,60,141
161086,31,667,305,362,667,305,362,,,
161138,31,298,181,117,204,132,72,94,49,45
161192,31,304,110,194,164,72,92,140,38,102
161208,31,13,12,1,13,12,1,,,
161217,31,322,121,201,233,88,145,89,33,56
161226,31,345,102,243,343,102,241,2,0,2
161235,31,99,46,53,96,45,51,3,1,2
161253,31,2316,1171,1145,2251,1139,1112,65,32,33
161299,31,207,161,46,206,160,46,1,1,0
161341,31,162,68,94,147,63,84,15,5,10
161457,31,595,192,403,592,190,402,3,2,1
161484,31,125,75,50,104,65,39,21,10,11
161493,31,74,5,69,62,4,58,12,1,11
161509,31,104,30,74,104,30,74,,,
161518,31,222,100,122,171,83,88,51,17,34
161527,31,137,14,123,88,4,84,49,10,39
161545,31,994,520,474,638,348,290,356,172,184
161554,31,895,343,552,861,325,536,34,18,16
161563,31,206,103,103,206,103,103,,,
161572,31,244,73,171,244,73,171,,,
161581,31,78,45,33,59,37,22,19,8,11
161688,31,323,124,199,250,97,153,73,27,46
161767,31,1715,831,884,981,494,487,734,337,397
161800,31,29,7,22,17,5,12,12,2,10
161855,31,10,0,10,6,0,6,4,0,4
161864,31,498,131,367,176,53,123,322,78,244
161873,31,66,25,41,60,23,37,6,2,4
162007,31,913,343,570,888,333,555,25,10,15
162061,31,45,39,6,40,34,6,5,5,0
162104,31,374,152,222,219,100,119,155,52,103
162122,31,1228,536,692,681,293,388,547,243,304
162168,31,358,144,214,197,86,111,161,58,103
162210,31,56,23,33,50,21,29,6,2,4
162283,31,177,53,124,172,52,120,5,1,4
162335,31,4,0,4,4,0,4,,,
162371,31,163,148,15,163,148,15,,,
162557,31,960,494,466,618,336,282,342,158,184
162584,31,587,295,292,583,294,289,4,1,3
162609,31,170,95,75,159,90,69,11,5,6
162654,31,264,101,163,264,101,163,,,
162690,31,620,249,371,444,183,261,176,66,110
162706,31,880,401,479,596,274,322,284,127,157
162760,31,324,122,202,323,121,202,1,1,0
162779,31,1298,623,675,666,371,295,632,252,380
162830,31,28,1,27,28,1,27,,,
162928,31,1420,606,814,1420,606,814,,,
163028,31,330,296,34,204,182,22,126,114,12
163046,31,954,436,518,953,436,517,1,0,1
163204,31,637,306,331,180,91,89,457,215,242
163268,31,2052,1149,903,2035,1136,899,17,13,4
163286,31,6072,2873,3199,6043,2859,3184,29,14,15
163295,31,311,69,242,310,69,241,1,0,1
163338,31,451,213,238,443,210,233,8,3,5
163347,31,99,11,88,99,11,88,,,
163408,31,34,7,27,23,2,21,11,5,6
163426,31,2434,1303,1131,1486,782,704,948,521,427
163453,31,2326,867,1459,2288,853,1435,38,14,24
163462,31,532,267,265,532,267,265,,,
163532,31,38,38,0,38,38,0,,,
163541,31,93,33,60,52,18,34,41,15,26
163578,31,90,0,90,90,0,90,,,
163657,31,1683,753,930,809,375,434,874,378,496
163815,31,18,1,17,9,0,9,9,1,8
163851,31,1217,520,697,1214,519,695,3,1,2
163912,31,381,177,204,381,177,204,,,
163976,31,140,73,67,140,73,67,,,
164076,31,2592,1004,1588,2569,993,1576,23,11,12
164155,31,1161,821,340,1161,821,340,,,
164173,31,628,251,377,627,250,377,1,1,0
164216,31,260,115,145,260,115,145,,,
164270,31,501,219,282,501,219,282,,,
164313,31,445,186,259,192,104,88,253,82,171
164368,31,155,86,69,155,86,69,,,
164447,31,342,188,154,340,187,153,2,1,1
164465,31,514,225,289,514,225,289,,,
164492,31,187,125,62,186,124,62,1,1,0
164535,31,19,4,15,19,4,15,,,
164562,31,415,183,232,415,183,232,,,
164580,31,650,351,299,649,350,299,1,1,0
164599,31,22,3,19,,,,22,3,19
164614,31,3,1,2,3,1,2,,,
164632,31,119,0,119,119,0,119,,,
164641,31,35,23,12,31,22,9,4,1,3
164739,31,1019,634,385,1019,634,385,,,
164748,31,1707,960,747,1556,860,696,151,100,51
164775,31,278,123,155,143,69,74,135,54,81
164845,31,36,2,34,28,1,27,8,1,7
164872,31,17,6,11,17,6,11,,,
164924,31,2516,1173,1343,2516,1173,1343,,,
164988,31,4011,1750,2261,4010,1750,2260,1,0,1
165015,31,941,385,556,939,385,554,2,0,2
165024,31,1382,601,781,1316,574,742,66,27,39
165033,31,1227,504,723,757,336,421,470,168,302
165060,31,3,1,2,3,1,2,,,
165112,31,1479,712,767,652,329,323,827,383,444
165167,31,12,6,6,4,2,2,8,4,4
165194,31,489,223,266,287,137,150,202,86,116
165255,31,86,2,84,38,1,37,48,1,47
165264,31,1,0,1,,,,1,0,1
165334,31,505,220,285,505,220,285,,,
165529,31,516,229,287,513,228,285,3,1,2
165556,31,113,11,102,81,9,72,32,2,30
165574,31,320,162,158,317,162,155,3,0,3
165608,31,20,0,20,12,0,12,8,0,8
165635,31,40,37,3,40,37,3,,,
165644,31,97,47,50,97,47,50,,,
165662,31,1058,322,736,1058,322,736,,,
165671,31,445,113,332,445,113,332,,,
165699,31,799,283,516,797,282,515,2,1,1
165750,31,48,24,24,48,24,24,,,
165802,31,197,88,109,197,88,109,,,
165820,31,567,301,266,559,295,264,8,6,2
165866,31,580,264,316,575,262,313,5,2,3
165884,31,217,195,22,164,146,18,53,49,4
165936,31,317,131,186,314,131,183,3,0,3
165981,31,221,86,135,91,41,50,130,45,85
166018,31,130,45,85,130,45,85,,,
166027,31,1949,923,1026,1949,923,1026,,,
166054,31,3,2,1,3,2,1,,,
166124,31,819,379,440,819,379,440,,,
166133,31,751,310,441,422,188,234,329,122,207
166391,31,304,118,186,303,118,185,1,0,1
166452,31,280,65,215,278,65,213,2,0,2
166489,31,11,5,6,11,5,6,,,
166498,31,29,2,27,13,2,11,16,0,16
166513,31,1907,1133,774,1867,1110,757,40,23,17
166629,31,4872,2238,2634,4848,2224,2624,24,14,10
166638,31,2246,933,1313,2179,901,1278,67,32,35
166647,31,731,355,376,407,220,187,324,135,189
166656,31,737,177,560,732,176,556,5,1,4
166674,31,387,98,289,384,97,287,3,1,2
166683,31,1177,604,573,1176,603,573,1,1,0
166692,31,321,282,39,321,282,39,,,
166805,31,12,8,4,6,5,1,6,3,3
166823,31,1004,470,534,583,303,280,421,167,254
166850,31,965,455,510,965,455,510,,,
166887,31,1041,508,533,572,290,282,469,218,251
166911,31,75,14,61,75,14,61,,,
166939,31,608,0,608,608,0,608,,,
166957,31,505,206,299,274,128,146,231,78,153
167039,31,7,1,6,7,1,6,,,
167057,31,90,48,42,85,44,41,5,4,1
167260,31,316,242,74,316,242,74,,,
167288,31,167,77,90,164,76,88,3,1,2
167297,31,15,11,4,15,11,4,,,
167312,31,802,329,473,459,195,264,343,134,209
167358,31,4492,1765,2727,4492,1765,2727,,,
167376,31,894,401,493,508,258,250,386,143,243
167394,31,184,53,131,183,53,130,1,0,1
167525,31,336,159,177,188,93,95,148,66,82
167534,31,1196,541,655,702,358,344,494,183,311
167598,31,220,55,165,219,54,165,1,1,0
167631,31,121,49,72,60,35,25,61,14,47
167729,31,939,319,620,898,296,602,41,23,18
167783,31,403,0,403,403,0,403,,,
167792,31,108,39,69,108,39,69,,,
167835,31,676,0,676,676,0,676,,,
167871,31,57,13,44,39,3,36,18,10,8
167899,31,507,254,253,507,254,253,,,
167905,31,809,369,440,412,215,197,397,154,243
167987,31,1265,639,626,1252,633,619,13,6,7
167996,31,640,298,342,628,290,338,12,8,4
168005,31,980,380,600,974,378,596,6,2,4
168032,31,12,0,12,12,0,12,,,
168148,31,1800,792,1008,1800,792,1008,,,
168218,31,603,0,603,603,0,603,,,
168227,31,917,717,200,915,716,199,2,1,1
168254,31,783,432,351,783,432,351,,,
168263,31,802,333,469,795,330,465,7,3,4
168281,31,493,183,310,493,183,310,,,
168342,31,574,264,310,574,264,310,,,
168421,31,1410,803,607,1410,803,607,,,
168430,31,756,303,453,752,303,449,4,0,4
168528,31,569,339,230,569,339,230,,,
168546,31,468,206,262,468,206,262,,,
168555,31,16,0,16,15,0,15,1,0,1
168573,31,233,229,4,233,229,4,,,
168591,31,319,143,176,319,143,176,,,
168607,31,244,148,96,164,109,55,80,39,41
168740,31,256,133,123,251,129,122,5,4,1
168786,31,216,84,132,215,84,131,1,0,1
168847,31,483,135,348,276,88,188,207,47,160
168883,31,366,162,204,243,118,125,123,44,79
168892,31,16,1,15,8,0,8,8,1,7
169080,31,762,364,398,735,341,394,27,23,4
169187,31,7,0,7,4,0,4,3,0,3
169248,31,1910,762,1148,1884,748,1136,26,14,12
169275,31,1077,424,653,436,190,246,641,234,407
169284,31,118,6,112,92,6,86,26,0,26
169327,31,200,135,65,136,100,36,64,35,29
169363,31,237,137,100,237,137,100,,,
169442,31,277,78,199,266,71,195,11,7,4
169479,31,521,262,259,414,218,196,107,44,63
169503,31,2,0,2,2,0,2,,,
169521,31,1078,489,589,537,255,282,541,234,307
169576,31,3,0,3,3,0,3,,,
169655,31,382,356,26,382,356,26,,,
169716,31,565,182,383,543,176,367,22,6,16
169761,31,172,29,143,172,29,143,,,
169798,31,2312,820,1492,2245,792,1453,67,28,39
169813,31,10,0,10,10,0,10,,,
169910,31,1408,697,711,1364,677,687,44,20,24
169974,31,182,100,82,114,67,47,68,33,35
169983,31,305,246,59,305,246,59,,,
169992,31,164,63,101,133,56,77,31,7,24
170000,31,105,45,60,89,38,51,16,7,9
170037,31,376,163,213,368,158,210,8,5,3
170055,31,3045,1371,1674,1483,713,770,1562,658,904
170082,31,3807,1395,2412,3785,1388,2397,22,7,15
170091,31,34,17,17,30,14,16,4,3,1
170240,31,2175,933,1242,1132,496,636,1043,437,606
170286,31,397,188,209,396,187,209,1,1,0
170301,31,847,330,517,834,317,517,13,13,0
170444,31,695,297,398,264,136,128,431,161,270
170532,31,382,176,206,382,176,206,,,
170541,31,1088,532,556,480,233,247,608,299,309
170550,31,531,199,332,234,100,134,297,99,198
170587,31,170,62,108,91,43,48,79,19,60
170611,31,45,1,44,32,1,31,13,0,13
170620,31,595,237,358,303,137,166,292,100,192
170639,31,373,168,205,362,164,198,11,4,7
170657,31,1779,818,961,981,454,527,798,364,434
170675,31,475,343,132,470,340,130,5,3,2
170736,31,10,1,9,2,0,2,8,1,7
170790,31,3444,1487,1957,1308,588,720,2136,899,1237
170806,31,253,121,132,253,121,132,,,
170967,31,162,71,91,156,69,87,6,2,4
170976,31,7290,3277,4013,7251,3251,4000,39,26,13
171012,31,7,5,2,7,5,2,,,
171100,31,9225,4300,4925,9041,4208,4833,184,92,92
171128,31,1479,1065,414,1475,1061,414,4,4,0
171137,31,1084,553,531,1052,537,515,32,16,16
171146,31,493,209,284,458,196,262,35,13,22
171155,31,429,207,222,263,139,124,166,68,98
171225,31,442,204,238,226,111,115,216,93,123
171234,31,238,81,157,98,29,69,140,52,88
171304,31,812,401,411,467,246,221,345,155,190
171395,31,256,90,166,170,61,109,86,29,57
171456,31,1496,617,879,1480,610,870,16,7,9
171483,31,670,295,375,385,173,212,285,122,163
171492,31,293,201,92,275,188,87,18,13,5
171535,31,2420,1208,1212,907,487,420,1513,721,792
171571,31,2025,868,1157,1957,834,1123,68,34,34
171599,31,210,139,71,207,137,70,3,2,1
171775,31,17,0,17,13,0,13,4,0,4
171881,31,13,7,6,11,6,5,2,1,1
171988,31,32,2,30,32,2,30,,,
171997,31,47,1,46,47,1,46,,,
172015,31,53,6,47,53,6,47,,,
172033,31,1,1,0,1,1,0,,,
172051,31,1336,444,892,1326,442,884,10,2,8
172200,31,1601,737,864,546,260,286,1055,477,578
172264,31,273,152,121,272,152,120,1,0,1
172291,31,560,225,335,325,147,178,235,78,157
172307,31,407,177,230,316,143,173,91,34,57
172334,31,231,87,144,231,87,144,,,
172422,31,37,29,8,37,29,8,,,
172440,31,136,98,38,136,98,38,,,
172495,31,30,1,29,30,1,29,,,
172617,31,1366,661,705,592,302,290,774,359,415
172635,31,1268,513,755,199,100,99,1069,413,656
172644,31,2732,1093,1639,2610,1044,1566,122,49,73
172671,31,177,79,98,93,43,50,84,36,48
172680,31,7,0,7,5,0,5,2,0,2
172699,31,2114,1043,1071,2086,1032,1054,28,11,17
172866,31,16,13,3,16,13,3,,,
172918,31,430,275,155,373,259,114,57,16,41
172954,31,252,163,89,153,124,29,99,39,60
172963,31,847,407,440,511,268,243,336,139,197
173045,31,541,252,289,538,250,288,3,2,1
173063,31,438,232,206,311,187,124,127,45,82
173115,31,111,67,44,84,61,23,27,6,21
173124,31,535,257,278,525,254,271,10,3,7
173142,31,199,84,115,198,84,114,1,0,1
173160,31,505,226,279,501,226,275,4,0,4
173203,31,421,233,188,346,205,141,75,28,47
173258,31,555,275,280,555,275,280,,,
173300,31,473,222,251,473,222,251,,,
173328,31,288,111,177,287,111,176,1,0,1
173416,31,487,337,150,364,277,87,123,60,63
173452,31,151,74,77,151,74,77,,,
173461,31,559,304,255,375,221,154,184,83,101
173470,31,4,0,4,4,0,4,,,
173559,31,771,411,360,549,342,207,222,69,153
173638,31,441,311,130,280,197,83,161,114,47
173647,31,551,254,297,551,254,297,,,
173665,31,467,160,307,467,160,307,,,
173708,31,484,355,129,274,217,57,210,138,72
173735,31,170,100,70,146,95,51,24,5,19
173744,31,81,3,78,81,3,78,,,
173799,31,455,224,231,272,140,132,183,84,99
173805,31,198,120,78,170,111,59,28,9,19
173902,31,601,271,330,601,271,330,,,
173911,31,362,181,181,238,139,99,124,42,82
173920,31,2112,927,1185,2073,909,1164,39,18,21
173957,31,22,7,15,22,7,15,,,
173993,31,173,122,51,157,114,43,16,8,8
174020,31,130,56,74,102,45,57,28,11,17
174066,31,6883,2915,3968,6840,2897,3943,43,18,25
174075,31,168,65,103,163,63,100,5,2,3
174127,31,163,47,116,163,47,116,,,
174136,31,710,340,370,375,181,194,335,159,176
174154,31,106,11,95,79,7,72,27,4,23
174190,31,60,4,56,42,0,42,18,4,14
174233,31,2029,998,1031,1999,978,1021,30,20,10
174251,31,293,132,161,290,132,158,3,0,3
174321,31,24,1,23,24,1,23,,,
174358,31,613,199,414,606,197,409,7,2,5
174376,31,591,294,297,308,158,150,283,136,147
174428,31,1340,654,686,790,395,395,550,259,291
174437,31,180,85,95,180,85,95,,,
174473,31,308,174,134,232,140,92,76,34,42
174491,31,396,174,222,388,173,215,8,1,7
174507,31,12,1,11,12,1,11,,,
174525,31,18,10,8,18,10,8,,,
174570,31,133,74,59,101,65,36,32,9,23
174604,31,48,22,26,47,22,25,1,0,1
174738,31,786,345,441,570,282,288,216,63,153
174747,31,389,0,389,389,0,389,,,
174756,31,600,295,305,355,190,165,245,105,140
174783,31,819,417,402,783,399,384,36,18,18
174792,31,410,410,0,410,410,0,,,
174817,31,234,107,127,234,107,127,,,
174844,31,755,319,436,755,319,436,,,
174862,31,164,96,68,151,91,60,13,5,8
174899,31,355,145,210,354,144,210,1,1,0
174914,31,1349,645,704,1348,644,704,1,1,0
174978,31,61,2,59,54,2,52,7,0,7
175005,31,313,3,310,302,0,302,11,3,8
175014,31,148,34,114,95,22,73,53,12,41
175041,31,872,423,449,491,273,218,381,150,231
175078,31,422,193,229,414,192,222,8,1,7
175120,31,291,206,85,291,206,85,,,
175157,31,132,96,36,131,96,35,1,0,1
175227,31,297,261,36,289,255,34,8,6,2
175236,31,508,270,238,385,227,158,123,43,80
175263,31,188,94,94,148,79,69,40,15,25
175272,31,1093,327,766,1081,323,758,12,4,8
175315,31,1083,530,553,634,340,294,449,190,259
175342,31,402,126,276,376,115,261,26,11,15
175421,31,196,79,117,186,76,110,10,3,7
175430,31,142,70,72,141,70,71,1,0,1
175494,31,21,5,16,21,5,16,,,
175519,31,354,166,188,317,148,169,37,18,19
175573,31,614,300,314,579,284,295,35,16,19
175616,31,264,130,134,250,118,132,14,12,2
175643,31,611,280,331,579,266,313,32,14,18
175652,31,614,313,301,577,293,284,37,20,17
175698,31,31,26,5,23,20,3,8,6,2
175722,31,4,0,4,4,0,4,,,
175786,31,1291,622,669,1029,491,538,262,131,131
175810,31,1124,492,632,1058,478,580,66,14,52
175829,31,1297,536,761,1136,464,672,161,72,89
175856,31,793,291,502,766,277,489,27,14,13
175883,31,817,361,456,720,321,399,97,40,57
175935,31,466,215,251,441,203,238,25,12,13
175980,31,231,126,105,231,126,105,,,
176008,31,500,214,286,478,204,274,22,10,12
176017,31,3580,1564,2016,3559,1553,2006,21,11,10
176035,31,171,24,147,167,24,143,4,0,4
176044,31,199,94,105,169,80,89,30,14,16
176053,31,434,180,254,433,179,254,1,1,0
176062,31,3,0,3,3,0,3,,,
176071,31,1888,814,1074,1567,685,882,321,129,192
176080,31,3388,1593,1795,3372,1585,1787,16,8,8
176169,31,990,454,536,960,440,520,30,14,16
176178,31,1508,662,846,1402,621,781,106,41,65
176239,31,877,427,450,822,403,419,55,24,31
176318,31,349,177,172,122,60,62,227,117,110
176336,31,11,10,1,11,10,1,,,
176354,31,515,260,255,504,256,248,11,4,7
176372,31,1587,505,1082,1561,496,1065,26,9,17
176406,31,98,49,49,98,49,49,,,
176433,31,1,0,1,1,0,1,,,
176451,31,11,5,6,1,0,1,10,5,5
176479,31,153,68,85,152,68,84,1,0,1
176628,31,217,100,117,217,100,117,,,
176664,31,44,34,10,43,33,10,1,1,0
176716,31,9,0,9,9,0,9,,,
176770,31,4,0,4,,,,4,0,4
176789,31,43,17,26,35,13,22,8,4,4
176798,31,75,20,55,31,3,28,44,17,27
176910,31,17,11,6,17,11,6,,,
176947,31,340,175,165,339,174,165,1,1,0
176965,31,1158,527,631,1124,512,612,34,15,19
176983,31,45,40,5,37,35,2,8,5,3
177038,31,8,3,5,4,1,3,4,2,2
177065,31,485,218,267,277,118,159,208,100,108
177083,31,3,3,0,3,3,0,,,
177117,31,129,0,129,129,0,129,,,
177135,31,842,363,479,698,295,403,144,68,76
177144,31,242,143,99,242,143,99,,,
177214,31,320,127,193,320,127,193,,,
177250,31,673,284,389,573,243,330,100,41,59
177302,31,55,51,4,55,51,4,,,
177339,31,348,163,185,337,159,178,11,4,7
177418,31,113,57,56,113,57,56,,,
177436,31,3,0,3,3,0,3,,,
177472,31,2372,1113,1259,1822,833,989,550,280,270
177542,31,130,66,64,123,64,59,7,2,5
177551,31,209,58,151,203,55,148,6,3,3
177588,31,8,0,8,8,0,8,,,
177603,31,9,0,9,9,0,9,,,
177676,31,899,396,503,756,347,409,143,49,94
177685,31,3,1,2,3,1,2,,,
177746,31,206,47,159,206,47,159,,,
177870,31,6,6,0,6,6,0,,,
177931,31,8,0,8,8,0,8,,,
177940,31,297,116,181,293,114,179,4,2,2
177968,31,730,319,411,719,312,407,11,7,4
177977,31,989,838,151,972,828,144,17,10,7
177986,31,19,5,14,12,3,9,7,2,5
177995,31,3149,1447,1702,2166,1015,1151,983,432,551
178059,31,834,284,550,610,231,379,224,53,171
178077,31,20,0,20,20,0,20,,,
178183,31,38,4,34,38,4,34,,,
178208,31,164,100,64,82,47,35,82,53,29
178217,31,540,204,336,495,191,304,45,13,32
178244,31,236,133,103,235,133,102,1,0,1
178341,31,578,247,331,531,223,308,47,24,23
178369,31,548,398,150,547,398,149,1,0,1
178387,31,574,212,362,538,204,334,36,8,28
178396,31,4843,2095,2748,4781,2063,2718,62,32,30
178402,31,1148,402,746,1118,387,731,30,15,15
178411,31,1188,903,285,1180,897,283,8,6,2
178420,31,296,137,159,271,128,143,25,9,16
178448,31,1074,418,656,855,334,521,219,84,135
178527,31,30,0,30,25,0,25,5,0,5
178615,31,665,267,398,660,264,396,5,3,2
178624,31,964,347,617,949,340,609,15,7,8
178679,31,116,67,49,114,66,48,2,1,1
178697,31,293,138,155,292,138,154,1,0,1
178721,31,321,167,154,254,122,132,67,45,22
178767,31,5,1,4,3,1,2,2,0,2
178828,31,15,9,6,15,9,6,,,
178891,31,596,564,32,501,473,28,95,91,4
179043,31,408,148,260,406,148,258,2,0,2
179052,31,20,15,5,20,15,5,,,
179159,31,1794,659,1135,1789,657,1132,5,2,3
179195,31,8,0,8,8,0,8,,,
179229,31,2,0,2,2,0,2,,,
179256,31,2,1,1,1,1,0,1,0,1
179265,31,77,25,52,77,25,52,,,
179308,31,2370,940,1430,1652,669,983,718,271,447
179326,31,298,112,186,278,108,170,20,4,16
179344,31,308,106,202,267,92,175,41,14,27
179511,31,44,0,44,27,0,27,17,0,17
179539,31,928,352,576,785,282,503,143,70,73
179548,31,102,0,102,99,0,99,3,0,3
179557,31,1487,569,918,1420,542,878,67,27,40
179566,31,2562,958,1604,2416,884,1532,146,74,72
179645,31,634,232,402,483,175,308,151,57,94
179715,31,399,126,273,344,114,230,55,12,43
179867,31,1980,910,1070,1970,907,1063,10,3,7
179894,31,360,136,224,346,131,215,14,5,9
179946,31,214,131,83,214,131,83,,,
179955,31,222,111,111,222,111,111,,,
179964,31,129,49,80,122,47,75,7,2,5
179991,31,22,0,22,22,0,22,,,
180054,31,32,5,27,27,4,23,5,1,4
180063,31,26,1,25,26,1,25,,,
180081,31,108,74,34,103,74,29,5,0,5
180090,31,45,2,43,45,2,43,,,
180106,31,280,115,165,280,115,165,,,
180151,31,132,69,63,122,63,59,10,6,4
180160,31,11,6,5,6,4,2,5,2,3
180179,31,559,222,337,473,203,270,86,19,67
180197,31,330,171,159,213,115,98,117,56,61
180203,31,18,8,10,18,8,10,,,
180212,31,59,28,31,43,21,22,16,7,9
180249,31,129,51,78,91,40,51,38,11,27
180258,31,103,51,52,96,47,49,7,4,3
180276,31,182,95,87,132,77,55,50,18,32
180328,31,62,23,39,51,18,33,11,5,6
180373,31,132,57,75,115,55,60,17,2,15
180416,31,325,194,131,321,191,130,4,3,1
180461,31,3866,2120,1746,3387,1854,1533,479,266,213
180489,31,1542,637,905,1419,580,839,123,57,66
180522,31,190,131,59,180,125,55,10,6,4
180595,31,220,103,117,219,103,116,1,0,1
180647,31,62,30,32,57,27,30,5,3,2
180692,31,229,86,143,223,86,137,6,0,6
180717,31,5,4,1,5,4,1,,,
180814,31,238,114,124,94,51,43,144,63,81
180832,31,27,3,24,22,2,20,5,1,4
180878,31,56,7,49,49,6,43,7,1,6
180902,31,835,407,428,580,318,262,255,89,166
180948,31,404,173,231,398,172,226,6,1,5
180957,31,15,13,2,15,13,2,,,
180984,31,315,159,156,315,159,156,,,
181002,31,1138,484,654,1138,484,654,,,
181020,31,237,139,98,236,138,98,1,1,0
181127,31,294,128,166,294,128,166,,,
181190,31,25,0,25,25,0,25,,,
181215,31,958,371,587,945,363,582,13,8,5
181297,31,50,1,49,47,1,46,3,0,3
181303,31,1061,595,466,532,316,216,529,279,250
181312,31,278,138,140,238,125,113,40,13,27
181330,31,341,178,163,341,178,163,,,
181394,31,2166,912,1254,2109,884,1225,57,28,29
181419,31,28,7,21,16,5,11,12,2,10
181446,31,405,191,214,405,191,214,,,
181464,31,4736,2217,2519,4709,2205,2504,27,12,15
181491,31,964,549,415,894,520,374,70,29,41
181534,31,289,135,154,276,131,145,13,4,9
181543,31,7,6,1,7,6,1,,,
181604,31,94,0,94,94,0,94,,,
181640,31,1570,935,635,1067,687,380,503,248,255
181738,31,117,55,62,117,55,62,,,
181765,31,107,42,65,107,42,65,,,
181783,31,791,334,457,786,333,453,5,1,4
181817,31,304,139,165,243,114,129,61,25,36
181853,31,112,59,53,112,59,53,,,
181880,31,63,0,63,63,0,63,,,
181941,31,75,57,18,75,57,18,,,
182005,31,4862,2194,2668,2799,1241,1558,2063,953,1110
182148,31,99,17,82,99,17,82,,,
182281,31,4125,1799,2326,3961,1727,2234,164,72,92
182290,31,3412,1573,1839,3358,1549,1809,54,24,30
182306,31,301,127,174,159,68,91,142,59,83
182458,31,76,41,35,76,41,35,,,
182500,31,1375,630,745,856,383,473,519,247,272
182564,31,461,196,265,294,122,172,167,74,93
182634,31,250,81,169,243,79,164,7,2,5
182670,31,1221,598,623,1221,598,623,,,
182704,31,8,0,8,8,0,8,,,
182722,31,11,4,7,10,4,6,1,0,1
182795,31,271,132,139,270,132,138,1,0,1
182892,31,33,2,31,24,2,22,9,0,9
182917,31,15,8,7,15,8,7,,,
182953,31,54,0,54,43,0,43,11,0,11
182980,31,211,112,99,187,99,88,24,13,11
182999,31,14,0,14,14,0,14,,,
183026,31,10607,3971,6636,2306,912,1394,8301,3059,5242
183035,31,6,0,6,6,0,6,,,
183044,31,2795,1163,1632,2795,1163,1632,,,
183062,31,749,345,404,746,343,403,3,2,1
183071,31,66,32,34,63,31,32,3,1,2
183080,31,936,490,446,929,488,441,7,2,5
183099,31,645,264,381,380,190,190,265,74,191
183105,31,148,79,69,89,57,32,59,22,37
183114,31,120,40,80,33,13,20,87,27,60
183123,31,145,91,54,89,60,29,56,31,25
183132,31,463,262,201,238,153,85,225,109,116
183141,31,289,138,151,170,91,79,119,47,72
183150,31,358,168,190,187,89,98,171,79,92
183202,31,6,0,6,6,0,6,,,
183211,31,321,104,217,315,104,211,6,0,6
183239,31,480,194,286,480,194,286,,,
183248,31,1,1,0,1,1,0,,,
183257,31,56,14,42,39,10,29,17,4,13
183275,31,21,12,9,21,12,9,,,
183488,31,93,9,84,82,9,73,11,0,11
183600,31,11,0,11,7,0,7,4,0,4
183655,31,964,407,557,656,286,370,308,121,187
183725,31,43,23,20,43,23,20,,,
183743,31,2184,1144,1040,1817,978,839,367,166,201
183789,31,264,92,172,230,82,148,34,10,24
183822,31,277,120,157,273,117,156,4,3,1
183859,31,1707,909,798,1290,695,595,417,214,203
183877,31,1438,674,764,1034,487,547,404,187,217
183910,31,349,185,164,349,185,164,,,
183938,31,992,495,497,713,356,357,279,139,140
183974,31,247,96,151,241,96,145,6,0,6
183983,31,54,51,3,54,51,3,,,
184056,31,131,41,90,111,30,81,20,11,9
184092,31,129,18,111,129,18,111,,,
184180,31,1315,774,541,911,537,374,404,237,167
184205,31,497,183,314,385,147,238,112,36,76
184348,31,359,146,213,359,146,213,,,
184427,31,131,124,7,61,60,1,70,64,6
184481,31,1111,492,619,834,368,466,277,124,153
184506,31,29,2,27,22,0,22,7,2,5
184603,31,463,229,234,449,222,227,14,7,7
184612,31,306,114,192,305,114,191,1,0,1
184694,31,488,233,255,483,231,252,5,2,3
184746,31,76,75,1,67,66,1,9,9,0
184773,31,208,64,144,198,64,134,10,0,10
184782,31,2191,1214,977,2174,1206,968,17,8,9
184791,31,1211,556,655,1010,475,535,201,81,120
184816,31,48,2,46,34,1,33,14,1,13
184959,31,85,13,72,62,10,52,23,3,20
184968,31,4,1,3,4,1,3,,,
184995,31,1470,632,838,1081,476,605,389,156,233
185129,31,761,362,399,754,362,392,7,0,7
185174,31,39,32,7,39,32,7,,,
185262,31,1502,620,882,1456,598,858,46,22,24
185396,31,599,582,17,563,548,15,36,34,2
185466,31,312,3,309,169,2,167,143,1,142
185509,31,1392,702,690,735,393,342,657,309,348
185536,31,2277,1139,1138,1617,821,796,660,318,342
185572,31,954,330,624,954,330,624,,,
185590,31,3491,1357,2134,3464,1345,2119,27,12,15
185679,31,9,2,7,3,0,3,6,2,4
185721,31,152,48,104,131,47,84,21,1,20
185767,31,1,0,1,1,0,1,,,
185828,31,1374,974,400,1235,875,360,139,99,40
185873,31,1823,840,983,1407,666,741,416,174,242
185970,31,11,0,11,9,0,9,2,0,2
186016,31,44,2,42,32,1,31,12,1,11
186034,31,561,261,300,349,167,182,212,94,118
186052,31,272,226,46,255,212,43,17,14,3
186131,31,1288,617,671,1288,617,671,,,
186186,31,58,58,0,58,58,0,,,
186201,31,900,353,547,893,348,545,7,5,2
186274,31,18,1,17,11,1,10,7,0,7
186283,31,637,256,381,635,254,381,2,2,0
186371,31,604,255,349,597,252,345,7,3,4
186380,31,7105,3488,3617,7095,3481,3614,10,7,3
186399,31,1300,638,662,1295,634,661,5,4,1
186432,31,404,150,254,400,150,250,4,0,4
186469,31,284,128,156,167,70,97,117,58,59
186584,31,1684,695,989,1681,694,987,3,1,2
186593,31,25,5,20,21,5,16,4,0,4
186618,31,107,50,57,107,50,57,,,
186645,31,1346,721,625,907,478,429,439,243,196
186867,31,1091,727,364,1091,727,364,,,
186876,31,1358,541,817,1357,540,817,1,1,0
186900,31,8,8,0,8,8,0,,,
187000,31,47,45,2,47,45,2,,,
187134,31,1476,608,868,1474,608,866,2,0,2
187198,31,1739,839,900,1293,655,638,446,184,262
187444,31,1000,436,564,989,431,558,11,5,6
187505,31,281,35,246,281,35,246,,,
187532,31,2920,1246,1674,1476,669,807,1444,577,867
187596,31,191,83,108,124,57,67,67,26,41
187620,31,1012,412,600,832,341,491,180,71,109
187639,31,263,91,172,162,59,103,101,32,69
187648,31,348,167,181,336,160,176,12,7,5
187666,31,336,151,185,261,118,143,75,33,42
187745,31,46,20,26,36,15,21,10,5,5
187897,31,153,79,74,146,76,70,7,3,4
187903,31,515,211,304,361,173,188,154,38,116
187912,31,189,158,31,189,158,31,,,
187958,31,205,84,121,130,51,79,75,33,42
187967,31,301,208,93,296,206,90,5,2,3
187976,31,102,49,53,40,24,16,62,25,37
187985,31,3077,1303,1774,2976,1256,1720,101,47,54
187994,31,109,40,69,73,31,42,36,9,27
188003,31,107,37,70,81,30,51,26,7,19
188021,31,75,19,56,42,11,31,33,8,25
188030,31,2013,814,1199,1994,805,1189,19,9,10
188049,31,216,82,134,122,38,84,94,44,50
188058,31,118,50,68,97,38,59,21,12,9
188100,31,533,212,321,278,124,154,255,88,167
188137,31,295,119,176,158,63,95,137,56,81
188182,31,131,88,43,116,74,42,15,14,1
188216,31,57,29,28,54,28,26,3,1,2
188225,31,110,40,70,47,17,30,63,23,40
188261,31,44,29,15,38,28,10,6,1,5
188289,31,21,0,21,21,0,21,,,
188304,31,229,99,130,206,99,107,23,0,23
188340,31,164,140,24,153,131,22,11,9,2
188429,31,1330,409,921,1316,406,910,14,3,11
188438,31,672,320,352,595,294,301,77,26,51
188517,31,65,29,36,64,29,35,1,0,1
188526,31,115,38,77,115,38,77,,,
188641,31,388,193,195,388,193,195,,,
188650,31,103,6,97,103,6,97,,,
188669,31,19,5,14,19,5,14,,,
188678,31,84,30,54,84,30,54,,,
188687,31,21,4,17,12,4,8,9,0,9
188696,31,71,11,60,71,11,60,,,
188854,31,444,114,330,444,114,330,,,
188890,31,468,450,18,406,390,16,62,60,2
188915,31,1,1,0,1,1,0,,,
188942,31,128,0,128,127,0,127,1,0,1
189088,31,473,173,300,473,173,300,,,
189097,31,769,0,769,760,0,760,9,0,9
189219,31,119,111,8,119,111,8,,,
189228,31,154,51,103,131,45,86,23,6,17
189255,31,88,2,86,57,2,55,31,0,31
189273,31,24,24,0,24,24,0,,,
189404,31,15,1,14,8,0,8,7,1,6
189413,31,66,19,47,66,19,47,,,
189468,31,205,6,199,123,6,117,82,0,82
189477,31,1,0,1,1,0,1,,,
189547,31,1178,511,667,1066,475,591,112,36,76
189565,31,64,28,36,63,28,35,1,0,1
189583,31,100,24,76,93,22,71,7,2,5
189592,31,44,23,21,44,23,21,,,
189705,31,456,201,255,455,200,255,1,1,0
189714,31,34,2,32,25,1,24,9,1,8
189811,31,19,2,17,19,2,17,,,
189839,31,391,156,235,306,129,177,85,27,58
189848,31,162,50,112,162,50,112,,,
189857,31,80,80,0,80,80,0,,,
189990,31,206,2,204,70,2,68,136,0,136
190008,31,1,0,1,1,0,1,,,
190044,31,740,495,245,740,495,245,,,
190053,31,98,50,48,91,48,43,7,2,5
190099,31,887,376,511,887,376,511,,,
190114,31,19,6,13,16,4,12,3,2,1
190150,31,1641,808,833,1592,782,810,49,26,23
190169,31,245,99,146,188,82,106,57,17,40
190239,31,39,1,38,26,1,25,13,0,13
190318,31,34,1,33,34,1,33,,,
190372,31,221,119,102,221,119,102,,,
190415,31,3718,1670,2048,3718,1670,2048,,,
190442,31,496,221,275,400,188,212,96,33,63
190451,31,7,2,5,7,2,5,,,
190503,31,720,309,411,719,309,410,1,0,1
190512,31,2532,1147,1385,2514,1140,1374,18,7,11
190521,31,4032,1842,2190,3346,1537,1809,686,305,381
190530,31,1403,708,695,1239,636,603,164,72,92
190549,31,1554,734,820,1533,725,808,21,9,12
190558,31,2241,1148,1093,2165,1101,1064,76,47,29
190567,31,2565,1143,1422,2438,1081,1357,127,62,65
190585,31,966,381,585,753,314,439,213,67,146
190594,31,3321,926,2395,3232,897,2335,89,29,60
190600,31,1770,552,1218,1750,540,1210,20,12,8
190619,31,1576,757,819,1443,695,748,133,62,71
190628,31,2250,1055,1195,1821,844,977,429,211,218
190637,31,1582,570,1012,1549,566,983,33,4,29
190646,31,634,222,412,613,215,398,21,7,14
190655,31,2590,1667,923,2391,1532,859,199,135,64
190664,31,2100,1054,1046,2041,1022,1019,59,32,27
190673,31,2268,1178,1090,1979,1036,943,289,142,147
190691,31,898,373,525,841,350,491,57,23,34
190707,31,2,1,1,2,1,1,,,
190716,31,246,87,159,243,86,157,3,1,2
190725,31,375,97,278,373,96,277,2,1,1
190752,31,22,22,0,22,22,0,,,
190761,31,176,59,117,176,59,117,,,
190840,31,1290,651,639,1074,564,510,216,87,129
190956,31,1,0,1,1,0,1,,,
190983,31,152,44,108,152,44,108,,,
191083,31,2035,1095,940,1662,925,737,373,170,203
191126,31,1262,190,1072,1233,183,1050,29,7,22
191199,31,1059,514,545,882,443,439,177,71,106
191205,31,106,79,27,103,77,26,3,2,1
191241,31,2879,1002,1877,2861,998,1863,18,4,14
191302,31,282,130,152,243,113,130,39,17,22
191311,31,16,10,6,16,10,6,,,
191339,31,589,264,325,522,239,283,67,25,42
191515,31,533,238,295,533,238,295,,,
191533,31,360,152,208,359,152,207,1,0,1
191597,31,11,2,9,11,2,9,,,
191612,31,419,190,229,386,170,216,33,20,13
191621,31,155,72,83,155,72,83,,,
191630,31,367,183,184,367,183,184,,,
191649,31,1659,657,1002,1655,656,999,4,1,3
191676,31,210,80,130,210,80,130,,,
191719,31,1734,1004,730,1540,917,623,194,87,107
191728,31,330,49,281,245,43,202,85,6,79
191931,31,697,318,379,697,318,379,,,
191940,31,92,14,78,92,14,78,,,
191959,31,26,17,9,26,17,9,,,
191968,31,1166,547,619,1163,546,617,3,1,2
191986,31,561,249,312,518,238,280,43,11,32
192004,31,78,18,60,78,18,60,,,
192022,31,513,217,296,467,202,265,46,15,31
192040,31,44,20,24,44,20,24,,,
192110,31,110,61,49,110,61,49,,,
192165,31,52,52,0,52,52,0,,,
192192,31,230,65,165,230,65,165,,,
192271,31,208,24,184,206,23,183,2,1,1
192323,31,613,209,404,612,209,403,1,0,1
192448,31,1198,452,746,1190,450,740,8,2,6
192484,31,31,1,30,19,0,19,12,1,11
192509,31,288,44,244,287,44,243,1,0,1
192624,31,30,30,0,30,30,0,,,
192688,31,44,7,37,44,7,37,,,
192703,31,777,391,386,765,385,380,12,6,6
192712,31,121,63,58,121,63,58,,,
192749,31,228,101,127,228,101,127,,,
192785,31,31,3,28,14,0,14,17,3,14
192800,31,4,0,4,4,0,4,,,
192819,31,1272,524,748,1272,524,748,,,
192864,31,454,84,370,445,84,361,9,0,9
192925,31,359,107,252,341,106,235,18,1,17
193016,31,851,265,586,846,264,582,5,1,4
193052,31,16,16,0,16,16,0,,,
193061,31,11,11,0,11,11,0,,,
193070,31,16,16,0,16,16,0,,,
193186,31,4,0,4,4,0,4,,,
193201,31,68,5,63,68,5,63,,,
193247,31,37,37,0,37,37,0,,,
193265,31,77,70,7,60,55,5,17,15,2
193283,31,940,457,483,852,426,426,88,31,57
193292,31,541,149,392,539,149,390,2,0,2
193308,31,889,419,470,786,389,397,103,30,73
193326,31,1868,940,928,1551,780,771,317,160,157
193353,31,258,90,168,253,88,165,5,2,3
193380,31,30,2,28,,,,30,2,28
193399,31,374,117,257,373,117,256,1,0,1
193478,31,2569,1441,1128,2236,1261,975,333,180,153
193584,31,503,128,375,501,127,374,2,1,1
193609,31,9,3,6,9,3,6,,,
193654,31,1902,414,1488,1869,403,1466,33,11,22
193672,31,5,4,1,5,4,1,,,
193858,31,98,6,92,98,6,92,,,
193900,31,6097,2330,3767,6078,2325,3753,19,5,14
193946,31,850,382,468,782,360,422,68,22,46
193973,31,625,243,382,624,243,381,1,0,1
193991,31,6,0,6,6,0,6,,,
194028,31,216,73,143,190,67,123,26,6,20
194091,31,952,600,352,877,549,328,75,51,24
194116,31,20,1,19,13,1,12,7,0,7
194161,31,98,50,48,85,41,44,13,9,4
194189,31,1,1,0,1,1,0,,,
194222,31,1355,662,693,1190,598,592,165,64,101
194240,31,986,454,532,797,392,405,189,62,127
194259,31,11,1,10,11,1,10,,,
194310,31,2203,627,1576,2182,618,1564,21,9,12
194392,31,242,155,87,242,155,87,,,
194435,31,8,0,8,8,0,8,,,
194499,31,226,45,181,226,45,181,,,
194569,31,2,1,1,2,1,1,,,
194578,31,1132,289,843,1126,286,840,6,3,3
194657,31,42,42,0,42,42,0,,,
194666,31,61,61,0,61,61,0,,,
194693,31,24,24,0,24,24,0,,,
194718,31,30,30,0,30,30,0,,,
194736,31,37,37,0,37,37,0,,,
194763,31,104,104,0,104,104,0,,,
194824,31,1322,934,388,1322,934,388,,,
194958,31,207,66,141,204,65,139,3,1,2
195003,31,3355,2253,1102,3353,2252,1101,2,1,1
195030,31,1623,794,829,1623,794,829,,,
195058,31,1187,612,575,999,524,475,188,88,100
195067,31,144,6,138,115,5,110,29,1,28
195128,31,263,96,167,262,95,167,1,1,0
195164,31,484,275,209,483,274,209,1,1,0
195173,31,409,146,263,408,146,262,1,0,1
195191,31,2,0,2,1,0,1,1,0,1
195216,31,602,299,303,602,299,303,,,
195234,31,310,100,210,309,99,210,1,1,0
195243,31,233,142,91,233,142,91,,,
195289,31,2,0,2,2,0,2,,,
195304,31,438,95,343,438,95,343,,,
195322,31,574,241,333,460,205,255,114,36,78
195474,31,1055,457,598,1055,457,598,,,
195526,31,719,312,407,717,311,406,2,1,1
195544,31,662,242,420,653,239,414,9,3,6
195702,31,1,0,1,,,,1,0,1
195720,31,596,258,338,596,258,338,,,
195784,31,29,2,27,29,2,27,,,
195809,31,2715,1217,1498,2703,1214,1489,12,3,9
195988,31,263,146,117,214,111,103,49,35,14
196006,31,1033,745,288,1028,745,283,5,0,5
196015,31,450,249,201,440,244,196,10,5,5
196024,31,543,320,223,542,319,223,1,1,0
196033,31,460,239,221,458,237,221,2,2,0
196042,31,1619,990,629,1561,953,608,58,37,21
196051,31,543,303,240,538,303,235,5,0,5
196060,31,3030,1264,1766,3019,1260,1759,11,4,7
196079,31,3089,1430,1659,3084,1427,1657,5,3,2
196088,31,4309,2266,2043,4285,2251,2034,24,15,9
196097,31,3416,1593,1823,3407,1588,1819,9,5,4
196103,31,304,136,168,289,131,158,15,5,10
196112,31,307,226,81,307,226,81,,,
196121,31,1002,408,594,984,401,583,18,7,11
196130,31,1344,651,693,1334,644,690,10,7,3
196149,31,1221,526,695,1221,526,695,,,
196158,31,806,333,473,805,333,472,1,0,1
196167,31,1007,349,658,1001,348,653,6,1,5
196176,31,1133,366,767,1124,364,760,9,2,7
196185,31,937,372,565,937,372,565,,,
196194,31,1168,561,607,1158,554,604,10,7,3
196200,31,416,168,248,416,168,248,,,
196219,31,680,283,397,678,281,397,2,2,0
196237,31,474,218,256,468,214,254,6,4,2
196246,31,920,370,550,915,368,547,5,2,3
196264,31,151,76,75,87,33,54,64,43,21
196291,31,275,244,31,275,244,31,,,
196389,31,346,58,288,341,56,285,5,2,3
196413,31,3765,1652,2113,3753,1649,2104,12,3,9
196431,31,44,44,0,43,43,0,1,1,0
196440,31,4,4,0,4,4,0,,,
196565,31,369,151,218,322,134,188,47,17,30
196583,31,1,1,0,1,1,0,,,
196592,31,544,217,327,493,203,290,51,14,37
196653,31,58,5,53,56,5,51,2,0,2
196680,31,202,82,120,,,,202,82,120
196699,31,403,200,203,340,168,172,63,32,31
196866,31,565,315,250,565,315,250,,,
197018,31,438,438,0,438,438,0,,,
197027,31,239,198,41,239,198,41,,,
197036,31,1181,894,287,1181,894,287,,,
197045,31,456,217,239,456,217,239,,,
197133,31,677,260,417,677,260,417,,,
197142,31,107,61,46,104,59,45,3,2,1
197151,31,771,223,548,769,223,546,2,0,2
197197,31,355,145,210,355,145,210,,,
197221,31,26,19,7,26,19,7,,,
197230,31,140,67,73,140,67,73,,,
197285,31,121,49,72,121,49,72,,,
197294,31,2051,1031,1020,1515,776,739,536,255,281
197337,31,9,0,9,8,0,8,1,0,1
197531,31,246,114,132,246,114,132,,,
197601,31,43,43,0,43,43,0,,,
197647,31,27,27,0,27,27,0,,,
197674,31,42,42,0,42,42,0,,,
197692,31,26,26,0,26,26,0,,,
197708,31,487,273,214,483,269,214,4,4,0
197735,31,227,227,0,227,227,0,,,
197744,31,10,10,0,10,10,0,,,
197814,31,327,142,185,160,74,86,167,68,99
197850,31,402,201,201,197,111,86,205,90,115
197869,31,4099,1760,2339,4079,1748,2331,20,12,8
197887,31,944,388,556,384,178,206,560,210,350
197911,31,262,141,121,262,141,121,,,
197966,31,265,95,170,115,42,73,150,53,97
197984,31,428,239,189,426,238,188,2,1,1
197993,31,27,0,27,26,0,26,1,0,1
198011,31,71,25,46,21,8,13,50,17,33
198039,31,406,180,226,177,82,95,229,98,131
198066,31,219,133,86,216,133,83,3,0,3
198084,31,304,144,160,171,86,85,133,58,75
198109,31,15,1,14,12,1,11,3,0,3
198118,31,520,253,267,304,155,149,216,98,118
198136,31,563,261,302,540,246,294,23,15,8
198154,31,1816,862,954,638,337,301,1178,525,653
198206,31,285,119,166,98,49,49,187,70,117
198215,31,264,156,108,264,156,108,,,
198233,31,497,254,243,252,134,118,245,120,125
198251,31,833,357,476,418,185,233,415,172,243
198260,31,1885,961,924,1245,623,622,640,338,302
198303,31,209,124,85,209,124,85,,,
198321,31,104,54,50,72,42,30,32,12,20
198330,31,642,321,321,396,188,208,246,133,113
198367,31,427,213,214,122,66,56,305,147,158
198376,31,557,244,313,319,161,158,238,83,155
198385,31,547,255,292,547,255,292,,,
198419,31,1744,777,967,1744,777,967,,,
198455,31,499,235,264,138,80,58,361,155,206
198464,31,4100,1635,2465,4017,1609,2408,83,26,57
198491,31,189,53,136,57,17,40,132,36,96
198507,31,324,141,183,324,141,183,,,
198516,31,1591,643,948,1590,642,948,1,1,0
198534,31,892,468,424,448,232,216,444,236,208
198543,31,632,214,418,548,188,360,84,26,58
198552,31,1346,613,733,766,380,386,580,233,347
198561,31,447,221,226,447,221,226,,,
198570,31,747,316,431,377,181,196,370,135,235
198598,31,162,107,55,162,107,55,,,
198613,31,247,144,103,247,144,103,,,
198622,31,1365,666,699,718,369,349,647,297,350
198640,31,85,29,56,37,14,23,48,15,33
198668,31,175,77,98,125,57,68,50,20,30
198677,31,5,3,2,3,2,1,2,1,1
198695,31,1441,623,818,1441,623,818,,,
198710,31,264,120,144,164,77,87,100,43,57
198729,31,183,75,108,113,51,62,70,24,46
198756,31,245,119,126,239,115,124,6,4,2
198774,31,546,272,274,336,186,150,210,86,124
198808,31,247,94,153,247,94,153,,,
198817,31,334,144,190,185,99,86,149,45,104
198835,31,383,171,212,363,168,195,20,3,17
198844,31,83,2,81,83,2,81,,,
198862,31,204,127,77,204,127,77,,,
198871,31,402,306,96,384,290,94,18,16,2
198899,31,301,162,139,296,160,136,5,2,3
198905,31,54,16,38,37,10,27,17,6,11
198914,31,95,43,52,61,25,36,34,18,16
198923,31,92,35,57,29,13,16,63,22,41
198950,31,344,0,344,342,0,342,2,0,2
198969,31,416,268,148,408,265,143,8,3,5
198978,31,357,106,251,355,106,249,2,0,2
198987,31,422,216,206,237,128,109,185,88,97
199005,31,13,0,13,13,0,13,,,
199023,31,52,31,21,24,18,6,28,13,15
199032,31,220,127,93,218,126,92,2,1,1
199069,31,239,114,125,231,112,119,8,2,6
199078,31,10,0,10,10,0,10,,,
199087,31,563,246,317,305,147,158,258,99,159
199102,31,2930,1021,1909,2879,1002,1877,51,19,32
199111,31,605,229,376,602,228,374,3,1,2
199120,31,4690,1736,2954,4678,1733,2945,12,3,9
199139,31,4256,2063,2193,4203,2035,2168,53,28,25
199148,31,2543,864,1679,2513,848,1665,30,16,14
199157,31,1130,341,789,1115,337,778,15,4,11
199184,31,208,77,131,208,77,131,,,
199193,31,5046,2383,2663,5027,2369,2658,19,14,5
199209,31,193,140,53,190,140,50,3,0,3
199218,31,2435,799,1636,2426,797,1629,9,2,7
199263,31,27,10,17,8,1,7,19,9,10
199272,31,128,60,68,128,60,68,,,
199281,31,896,400,496,867,387,480,29,13,16
199306,31,189,100,89,189,100,89,,,
199324,31,104,53,51,6,3,3,98,50,48
199333,31,931,412,519,510,247,263,421,165,256
199412,31,293,114,179,291,113,178,2,1,1
199421,31,405,162,243,177,79,98,228,83,145
199449,31,276,126,150,153,73,80,123,53,70
199458,31,42,31,11,41,31,10,1,0,1
199467,31,42,9,33,16,8,8,26,1,25
199476,31,284,88,196,149,56,93,135,32,103
199485,31,370,165,205,211,101,110,159,64,95
199494,31,1346,553,793,668,311,357,678,242,436
199582,31,774,456,318,472,292,180,302,164,138
199607,31,45,0,45,45,0,45,,,
199625,31,213,83,130,108,50,58,105,33,72
199634,31,604,243,361,342,153,189,262,90,172
199643,31,142,76,66,141,75,66,1,1,0
199689,31,7,0,7,7,0,7,,,
199698,31,261,134,127,256,131,125,5,3,2
199722,31,134,68,66,55,30,25,79,38,41
199731,31,271,104,167,107,47,60,164,57,107
199740,31,264,100,164,134,57,77,130,43,87
199759,31,53,32,21,24,16,8,29,16,13
199768,31,208,94,114,93,45,48,115,49,66
199786,31,587,238,349,304,139,165,283,99,184
199795,31,112,46,66,69,26,43,43,20,23
199838,31,262,111,151,138,65,73,124,46,78
199847,31,1412,613,799,1411,612,799,1,1,0
199856,31,3443,1837,1606,1763,970,793,1680,867,813
199865,31,225,84,141,225,84,141,,,
199892,31,349,167,182,144,82,62,205,85,120
199908,31,147,69,78,79,38,41,68,31,37
199926,31,404,207,197,282,156,126,122,51,71
199953,31,163,75,88,77,39,38,86,36,50
199962,31,777,328,449,772,325,447,5,3,2
199971,31,32,20,12,32,20,12,,,
199980,31,20,18,2,20,18,2,,,
199999,31,912,202,710,911,202,709,1,0,1
200004,31,1729,770,959,1701,761,940,28,9,19
200013,31,26,5,21,18,4,14,8,1,7
200022,31,773,432,341,702,402,300,71,30,41
200059,31,269,139,130,258,136,122,11,3,8
200086,31,33,17,16,32,17,15,1,0,1
200110,31,20,0,20,20,0,20,,,
200156,31,318,171,147,317,170,147,1,1,0
200192,31,173,89,84,166,86,80,7,3,4
200208,31,40,19,21,25,13,12,15,6,9
200217,31,516,203,313,510,198,312,6,5,1
200226,31,199,125,74,182,119,63,17,6,11
200253,31,374,164,210,352,158,194,22,6,16
200280,31,1755,884,871,1723,865,858,32,19,13
200305,31,692,484,208,614,437,177,78,47,31
200314,31,113,49,64,102,44,58,11,5,6
200332,31,2491,1171,1320,2450,1152,1298,41,19,22
200341,31,261,102,159,248,99,149,13,3,10
200466,31,50,21,29,50,21,29,,,
200484,31,22,6,16,20,6,14,2,0,2
200527,31,66,41,25,65,40,25,1,1,0
200554,31,114,48,66,110,44,66,4,4,0
200572,31,196,110,86,167,92,75,29,18,11
200590,31,16,11,5,8,5,3,8,6,2
200785,31,78,11,67,49,6,43,29,5,24
200800,31,2163,1106,1057,2113,1085,1028,50,21,29
200846,31,178,86,92,168,80,88,10,6,4
200873,31,22,8,14,21,8,13,1,0,1
201034,31,50,16,34,15,1,14,35,15,20
201061,31,64,18,46,64,18,46,,,
201098,31,21,10,11,13,5,8,8,5,3
201104,31,699,427,272,512,265,247,187,162,25
201131,31,92,33,59,48,1,47,44,32,12
201159,31,78,67,11,46,38,8,32,29,3
201177,31,26,1,25,21,1,20,5,0,5
201195,31,730,330,400,727,329,398,3,1,2
201283,31,121,60,61,108,53,55,13,7,6
201371,31,242,147,95,242,147,95,,,
201432,31,534,222,312,496,212,284,38,10,28
201441,31,2760,1152,1608,2737,1144,1593,23,8,15
201469,31,82,36,46,81,36,45,1,0,1
201478,31,1,0,1,1,0,1,,,
201496,31,255,158,97,255,158,97,,,
201539,31,18,3,15,17,2,15,1,1,0
201548,31,424,172,252,424,172,252,,,
201645,31,1606,786,820,1606,786,820,,,
201654,31,972,427,545,970,426,544,2,1,1
201672,31,284,66,218,143,31,112,141,35,106
201681,31,39,3,36,39,3,36,,,
201690,31,804,306,498,797,303,494,7,3,4
201751,31,13,4,9,8,2,6,5,2,3
201803,31,24,1,23,24,1,23,,,
201821,31,69,6,63,66,6,60,3,0,3
201885,31,5400,2696,2704,5347,2679,2668,53,17,36
201928,31,835,368,467,442,202,240,393,166,227
201946,31,435,201,234,336,158,178,99,43,56
201955,31,1195,480,715,1067,431,636,128,49,79
201964,31,149,62,87,126,57,69,23,5,18
201973,31,407,169,238,132,62,70,275,107,168
202046,31,138,33,105,138,33,105,,,
202073,31,45,22,23,45,22,23,,,
202134,31,1869,823,1046,1834,801,1033,35,22,13
202152,31,74,5,69,74,5,69,,,
202170,31,192,60,132,192,60,132,,,
202222,31,3568,1732,1836,1838,858,980,1730,874,856
202356,31,2264,1017,1247,1256,574,682,1008,443,565
202435,31,15,4,11,13,2,11,2,2,0
202453,31,41,37,4,37,33,4,4,4,0
202480,31,2126,1111,1015,2118,1105,1013,8,6,2
202514,31,160,105,55,159,104,55,1,1,0
202523,31,654,320,334,654,320,334,,,
202648,31,679,280,399,382,184,198,297,96,201
202657,31,114,41,73,22,4,18,92,37,55
202763,31,645,197,448,644,196,448,1,1,0
202806,31,266,115,151,13,9,4,253,106,147
202888,31,9,0,9,5,0,5,4,0,4
202903,31,48,20,28,42,17,25,6,3,3
202912,31,23,1,22,20,1,19,3,0,3
202949,31,87,81,6,87,81,6,,,
202985,31,14,0,14,12,0,12,2,0,2
203030,31,10,5,5,10,5,5,,,
203085,31,266,143,123,266,143,123,,,
203128,31,236,116,120,236,116,120,,,
203146,31,304,279,25,304,279,25,,,
203155,31,648,371,277,605,349,256,43,22,21
203234,31,62,5,57,62,5,57,,,
203289,31,17,12,5,17,12,5,,,
203331,31,4903,1419,3484,1054,338,716,3849,1081,2768
203368,31,586,331,255,586,331,255,,,
203386,31,159,8,151,159,8,151,,,
203438,31,15,1,14,6,1,5,9,0,9
203447,31,119,37,82,77,25,52,42,12,30
203456,31,35,11,24,14,3,11,21,8,13
203465,31,432,171,261,343,139,204,89,32,57
203474,31,216,76,140,176,57,119,40,19,21
203483,31,227,79,148,183,70,113,44,9,35
203492,31,123,31,92,67,13,54,56,18,38
203517,31,4050,1364,2686,3951,1322,2629,99,42,57
203526,31,263,116,147,171,73,98,92,43,49
203535,31,508,215,293,508,215,293,,,
203544,31,78,4,74,63,4,59,15,0,15
203580,31,187,115,72,186,115,71,1,0,1
203599,31,541,243,298,340,180,160,201,63,138
203614,31,201,46,155,201,46,155,,,
203678,31,288,91,197,154,53,101,134,38,96
203720,31,52,36,16,48,35,13,4,1,3
203739,31,15,2,13,8,1,7,7,1,6
203748,31,1202,504,698,643,256,387,559,248,311
203757,31,177,90,87,169,86,83,8,4,4
203775,31,222,87,135,222,87,135,,,
203845,31,328,171,157,328,171,157,,,
203881,31,371,237,134,96,36,60,275,201,74
203942,31,21,11,10,21,11,10,,,
203960,31,47,6,41,23,5,18,24,1,23
204006,31,457,226,231,396,196,200,61,30,31
204015,31,196,85,111,166,70,96,30,15,15
204024,31,4519,2126,2393,4509,2119,2390,10,7,3
204121,31,32,0,32,12,0,12,20,0,20
204158,31,51,26,25,51,26,25,,,
204176,31,33,4,29,19,3,16,14,1,13
204185,31,491,243,248,491,243,248,,,
204194,31,294,142,152,294,142,152,,,
204200,31,300,150,150,295,149,146,5,1,4
204255,31,257,114,143,192,93,99,65,21,44
204264,31,422,220,202,422,220,202,,,
204334,31,49,1,48,,,,49,1,48
204422,31,407,165,242,240,99,141,167,66,101
204431,31,26,5,21,26,5,21,,,
204440,31,244,111,133,143,69,74,101,42,59
204459,31,19,14,5,19,14,5,,,
204468,31,223,130,93,220,129,91,3,1,2
204486,31,886,772,114,877,766,111,9,6,3
204501,31,863,368,495,863,368,495,,,
204608,31,69,56,13,69,56,13,,,
204617,31,180,95,85,180,95,85,,,
204635,31,738,400,338,737,399,338,1,1,0
204662,31,208,84,124,202,81,121,6,3,3
204671,31,282,123,159,269,117,152,13,6,7
204680,31,365,197,168,360,194,166,5,3,2
204699,31,380,201,179,372,195,177,8,6,2
204705,31,1357,749,608,1296,714,582,61,35,26
204714,31,14,0,14,14,0,14,,,
204723,31,136,106,30,136,106,30,,,
204769,31,57,5,52,57,5,52,,,
204778,31,46,1,45,46,1,45,,,
204796,31,8423,3889,4534,8398,3873,4525,25,16,9
204802,31,61,26,35,57,25,32,4,1,3
204820,31,176,56,120,160,51,109,16,5,11
204839,31,150,52,98,143,48,95,7,4,3
204848,31,165,73,92,151,67,84,14,6,8
204857,31,3703,1652,2051,3664,1640,2024,39,12,27
204866,31,137,32,105,128,30,98,9,2,7
204884,31,23,2,21,23,2,21,,,
204893,31,4,1,3,4,1,3,,,
204909,31,364,153,211,364,153,211,,,
204936,31,570,242,328,568,241,327,2,1,1
204945,31,1089,463,626,696,293,403,393,170,223
204963,31,39,2,37,39,2,37,,,
204981,31,41,16,25,7,3,4,34,13,21
205027,31,1,1,0,1,1,0,,,
205054,31,46,7,39,46,7,39,,,
205124,31,24,24,0,24,24,0,,,
205142,31,12,1,11,12,1,11,,,
205179,31,25,11,14,25,11,14,,,
205203,31,208,122,86,176,106,70,32,16,16
205391,31,69,17,52,37,10,27,32,7,25
205443,31,552,250,302,531,244,287,21,6,15
205470,31,4636,2700,1936,1214,615,599,3422,2085,1337
205559,31,18,5,13,18,5,13,,,
205841,31,1581,710,871,908,439,469,673,271,402
205887,31,126,16,110,126,16,110,,,
205957,31,588,245,343,573,242,331,15,3,12
205966,31,193,66,127,104,36,68,89,30,59
206011,31,322,180,142,165,92,73,157,88,69
206039,31,20,0,20,12,0,12,8,0,8
206048,31,488,255,233,413,224,189,75,31,44
206084,31,2324,1026,1298,2273,998,1275,51,28,23
206154,31,1,0,1,1,0,1,,,
206172,31,11,1,10,11,1,10,,,
206181,31,14,6,8,4,3,1,10,3,7
206279,31,7,5,2,1,0,1,6,5,1
206321,31,15,5,10,10,1,9,5,4,1
206349,31,121,4,117,121,4,117,,,
206394,31,4,1,3,4,1,3,,,
206437,31,345,183,162,335,176,159,10,7,3
206446,31,234,96,138,169,78,91,65,18,47
206491,31,150,66,84,90,42,48,60,24,36
206507,31,226,104,122,226,104,122,,,
206525,31,358,177,181,358,177,181,,,
206589,31,583,259,324,575,252,323,8,7,1
206604,31,1132,477,655,1084,455,629,48,22,26
206613,31,266,126,140,252,121,131,14,5,9
206622,31,1185,515,670,1184,515,669,1,0,1
206695,31,1607,737,870,1572,715,857,35,22,13
206817,31,73,47,26,72,47,25,1,0,1
206835,31,200,113,87,196,112,84,4,1,3
206862,31,276,131,145,276,131,145,,,
206905,31,54,35,19,40,22,18,14,13,1
206914,31,495,181,314,450,172,278,45,9,36
206923,31,344,98,246,202,68,134,142,30,112
206932,31,141,16,125,130,15,115,11,1,10
206941,31,1792,685,1107,1657,634,1023,135,51,84
206996,31,423,157,266,323,129,194,100,28,72
207041,31,438,199,239,414,186,228,24,13,11
207050,31,271,107,164,210,87,123,61,20,41
207069,31,234,92,142,139,55,84,95,37,58
207087,31,7,2,5,7,2,5,,,
207102,31,15,3,12,15,3,12,,,
207157,31,38,28,10,35,27,8,3,1,2
207209,31,574,230,344,571,229,342,3,1,2
207236,31,154,46,108,96,34,62,58,12,46
207254,31,121,108,13,121,108,13,,,
207263,31,707,297,410,683,289,394,24,8,16
207281,31,531,256,275,469,229,240,62,27,35
207290,31,541,248,293,477,229,248,64,19,45
207306,31,277,114,163,274,113,161,3,1,2
207324,31,415,184,231,391,182,209,24,2,22
207351,31,246,154,92,216,145,71,30,9,21
207388,31,4268,1923,2345,3963,1807,2156,305,116,189
207397,31,672,284,388,285,124,161,387,160,227
207403,31,302,122,180,302,122,180,,,
207449,31,2388,951,1437,1013,414,599,1375,537,838
207458,31,264,82,182,264,82,182,,,
207500,31,4582,1977,2605,3903,1722,2181,679,255,424
207564,31,594,447,147,535,411,124,59,36,23
207582,31,743,285,458,677,254,423,66,31,35
207661,31,471,184,287,429,169,260,42,15,27
207670,31,1326,523,803,855,351,504,471,172,299
207704,31,32,2,30,13,1,12,19,1,18
207722,31,249,77,172,248,77,171,1,0,1
207740,31,358,161,197,298,134,164,60,27,33
207786,31,23,1,22,23,1,22,,,
207847,31,352,174,178,323,164,159,29,10,19
207856,31,116,68,48,109,63,46,7,5,2
207865,31,685,294,391,655,282,373,30,12,18
207935,31,3119,1290,1829,1844,793,1051,1275,497,778
207962,31,239,224,15,239,224,15,,,
207971,31,583,268,315,571,266,305,12,2,10
208035,31,277,128,149,228,120,108,49,8,41
208044,31,37,3,34,37,3,34,,,
208053,31,49,22,27,10,1,9,39,21,18
208275,31,297,130,167,238,111,127,59,19,40
208318,31,790,411,379,493,252,241,297,159,138
208390,31,1865,875,990,1161,516,645,704,359,345
208406,31,1249,617,632,509,257,252,740,360,380
208415,31,154,71,83,89,43,46,65,28,37
208433,31,31,0,31,31,0,31,,,
208479,31,96,16,80,96,16,80,,,
208512,31,135,45,90,135,45,90,,,
208637,31,19,2,17,,,,19,2,17
208646,31,267,117,150,244,108,136,23,9,14
208725,31,7,4,3,7,4,3,,,
208822,31,647,264,383,647,264,383,,,
208859,31,31,5,26,31,5,26,,,
209038,31,1386,679,707,840,421,419,546,258,288
209056,31,677,232,445,677,232,445,,,
209065,31,315,119,196,315,119,196,,,
209074,31,811,398,413,458,216,242,353,182,171
209083,31,37,9,28,37,9,28,,,
209153,31,24,3,21,24,3,21,,,
209205,31,10,1,9,10,1,9,,,
209241,31,2,2,0,2,2,0,,,
209250,31,613,300,313,391,207,184,222,93,129
209287,31,78,52,26,75,51,24,3,1,2
209409,31,85,43,42,85,43,42,,,
209506,31,443,234,209,403,218,185,40,16,24
209542,31,3965,2017,1948,3603,1855,1748,362,162,200
209551,31,4589,1929,2660,4525,1896,2629,64,33,31
209603,31,64,11,53,60,9,51,4,2,2
209612,31,363,166,197,363,166,197,,,
209667,31,41,4,37,41,4,37,,,
209676,31,73,14,59,73,14,59,,,
209694,31,32,0,32,32,0,32,,,
209700,31,40,7,33,40,7,33,,,
209719,31,55,0,55,55,0,55,,,
209746,31,4255,1986,2269,2190,1044,1146,2065,942,1123
209807,31,1741,690,1051,1604,628,976,137,62,75
209825,31,911,340,571,907,339,568,4,1,3
209922,31,502,182,320,502,182,320,,,
209940,31,769,333,436,339,129,210,430,204,226
210146,31,519,219,300,476,195,281,43,24,19
210155,31,453,217,236,376,190,186,77,27,50
210234,31,319,152,167,234,121,113,85,31,54
210270,31,589,209,380,332,123,209,257,86,171
210304,31,35,9,26,35,9,26,,,
210331,31,177,80,97,154,66,88,23,14,9
210340,31,3,1,2,3,1,2,,,
210401,31,260,109,151,259,108,151,1,1,0
210429,31,544,175,369,519,165,354,25,10,15
210492,31,72,41,31,67,38,29,5,3,2
210571,31,342,178,164,342,178,164,,,
210599,31,168,102,66,168,102,66,,,
210605,31,2582,1311,1271,1289,611,678,1293,700,593
210669,31,408,201,207,408,201,207,,,
210711,31,17,1,16,17,1,16,,,
210739,31,516,179,337,510,179,331,6,0,6
210748,31,24,0,24,12,0,12,12,0,12
210775,31,403,179,224,401,178,223,2,1,1
210784,31,44,1,43,39,1,38,5,0,5
211006,31,52,48,4,48,44,4,4,4,0
211024,31,86,50,36,80,46,34,6,4,2
211079,31,268,110,158,174,76,98,94,34,60
211088,31,389,135,254,389,135,254,,,
211130,31,21,15,6,21,15,6,,,
211158,31,1408,526,882,1390,520,870,18,6,12
211273,31,422,0,422,422,0,422,,,
211291,31,1027,492,535,1027,492,535,,,
211307,31,1330,648,682,822,427,395,508,221,287
211316,31,33,1,32,25,1,24,8,0,8
211334,31,13,0,13,13,0,13,,,
211343,31,584,263,321,449,216,233,135,47,88
211352,31,302,122,180,302,122,180,,,
211361,31,815,325,490,789,319,470,26,6,20
211431,31,185,25,160,181,23,158,4,2,2
211440,31,1896,912,984,1896,912,984,,,
211468,31,168,2,166,168,2,166,,,
211477,31,81,32,49,40,20,20,41,12,29
211556,31,365,89,276,365,89,276,,,
211583,31,188,113,75,184,112,72,4,1,3
211608,31,209,71,138,205,70,135,4,1,3
211635,31,5,1,4,5,1,4,,,
211644,31,522,176,346,488,164,324,34,12,22
211802,31,12,2,10,12,2,10,,,
211893,31,10,3,7,10,3,7,,,
211927,31,2137,940,1197,568,307,261,1569,633,936
211981,31,378,152,226,376,152,224,2,0,2
212009,31,677,286,391,677,286,391,,,
212045,31,76,18,58,76,18,58,,,
212054,31,2854,1372,1482,2831,1360,1471,23,12,11
212106,31,1233,444,789,1231,443,788,2,1,1
212115,31,679,330,349,673,326,347,6,4,2
212133,31,339,128,211,324,123,201,15,5,10
212160,31,652,246,406,639,242,397,13,4,9
212197,31,434,177,257,433,176,257,1,1,0
212230,31,24,4,20,24,4,20,,,
212267,31,51,1,50,36,1,35,15,0,15
212276,31,44,1,43,34,1,33,10,0,10
212294,31,27,0,27,23,0,23,4,0,4
212300,31,45,1,44,45,1,44,,,
212328,31,36,2,34,26,1,25,10,1,9
212337,31,32,1,31,18,0,18,14,1,13
212355,31,51,3,48,36,2,34,15,1,14
212382,31,53,1,52,36,0,36,17,1,16
212391,31,25,0,25,17,0,17,8,0,8
212434,31,80,74,6,80,74,6,,,
212577,31,509,220,289,509,220,289,,,
212601,31,644,285,359,638,283,355,6,2,4
212656,31,245,130,115,243,130,113,2,0,2
212674,31,623,302,321,623,302,321,,,
212753,31,55,4,51,40,4,36,15,0,15
212805,31,618,297,321,618,297,321,,,
212832,31,176,42,134,175,42,133,1,0,1
212869,31,148,40,108,110,32,78,38,8,30
212878,31,1611,648,963,863,358,505,748,290,458
212911,31,411,183,228,411,183,228,,,
212975,31,37,32,5,37,32,5,,,
212984,31,355,100,255,354,99,255,1,1,0
212993,31,23,10,13,20,7,13,3,3,0
213011,31,290,96,194,286,95,191,4,1,3
213020,31,1703,652,1051,1649,614,1035,54,38,16
213163,31,10,2,8,10,2,8,,,
213181,31,136,9,127,111,8,103,25,1,24
213233,31,188,156,32,183,152,31,5,4,1
213251,31,332,151,181,331,151,180,1,0,1
213303,31,216,131,85,206,128,78,10,3,7
213321,31,418,217,201,417,217,200,1,0,1
213330,31,7,0,7,7,0,7,,,
213349,31,1490,663,827,1487,662,825,3,1,2
213358,31,151,54,97,147,53,94,4,1,3
213367,31,483,184,299,482,183,299,1,1,0
213376,31,430,194,236,337,164,173,93,30,63
213385,31,782,413,369,782,413,369,,,
213400,31,152,62,90,146,61,85,6,1,5
213455,31,188,3,185,27,0,27,161,3,158
213473,31,16,3,13,13,3,10,3,0,3
213491,31,42,1,41,12,1,11,30,0,30
213507,31,474,231,243,474,231,243,,,
213525,31,1258,530,728,759,378,381,499,152,347
213534,31,71,25,46,69,23,46,2,2,0
213543,31,1519,793,726,1519,793,726,,,
213570,31,119,30,89,119,30,89,,,
213589,31,98,85,13,82,71,11,16,14,2
213598,31,477,150,327,474,150,324,3,0,3
213613,31,526,223,303,516,220,296,10,3,7
213622,31,6,0,6,6,0,6,,,
213659,31,824,321,503,507,220,287,317,101,216
213668,31,319,151,168,319,151,168,,,
213774,31,118,34,84,105,31,74,13,3,10
213783,31,380,160,220,374,157,217,6,3,3
213826,31,456,137,319,452,135,317,4,2,2
213914,31,85,8,77,85,8,77,,,
213987,31,629,272,357,614,267,347,15,5,10
213996,31,551,202,349,550,201,349,1,1,0
214023,31,3,1,2,2,0,2,1,1,0
214041,31,1226,513,713,1185,499,686,41,14,27
214069,31,361,143,218,361,143,218,,,
214111,31,1647,781,866,942,487,455,705,294,411
214148,31,100,0,100,99,0,99,1,0,1
214157,31,449,170,279,449,170,279,,,
214166,31,270,84,186,266,81,185,4,3,1
214175,31,450,188,262,450,188,262,,,
214272,31,359,141,218,358,141,217,1,0,1
214290,31,225,211,14,225,211,14,,,
214379,31,1729,793,936,1118,544,574,611,249,362
214476,31,2,1,1,2,1,1,,,
214528,31,37,35,2,37,35,2,,,
214582,31,162,15,147,49,9,40,113,6,107
214883,31,8,1,7,3,0,3,5,1,4
214892,31,45,25,20,45,25,20,,,
214944,31,217,183,34,193,160,33,24,23,1
214971,31,10,2,8,10,2,8,,,
215008,31,10,10,0,10,10,0,,,
215044,31,36,11,25,36,11,25,,,
215053,31,41,10,31,38,8,30,3,2,1
215062,31,2399,1097,1302,2338,1072,1266,61,25,36
215105,31,270,87,183,270,87,183,,,
215114,31,209,95,114,207,94,113,2,1,1
215132,31,311,104,207,309,104,205,2,0,2
215239,31,2028,767,1261,1019,372,647,1009,395,614
215266,31,311,142,169,310,142,168,1,0,1
215275,31,328,145,183,327,145,182,1,0,1
215284,31,465,270,195,465,270,195,,,
215293,31,4875,1973,2902,4869,1968,2901,6,5,1
215309,31,5,2,3,5,2,3,,,
215336,31,7,0,7,7,0,7,,,
215381,31,198,175,23,198,175,23,,,
215390,31,36,8,28,13,5,8,23,3,20
215415,31,314,220,94,314,220,94,,,
215442,31,601,194,407,601,194,407,,,
215530,31,31,0,31,26,0,26,5,0,5
215585,31,670,267,403,333,143,190,337,124,213
215594,31,26,1,25,18,1,17,8,0,8
215637,31,97,43,54,97,43,54,,,
215655,31,676,345,331,671,343,328,5,2,3
215682,31,160,143,17,160,143,17,,,
215691,31,107,67,40,100,66,34,7,1,6
215743,31,398,161,237,398,161,237,,,
215770,31,1038,498,540,1036,496,540,2,2,0
215798,31,376,217,159,375,216,159,1,1,0
215886,31,31,12,19,25,11,14,6,1,5
215929,31,825,365,460,813,353,460,12,12,0
215947,31,359,127,232,354,127,227,5,0,5
215974,31,8,1,7,8,1,7,,,
215992,31,56,24,32,56,24,32,,,
216010,31,1022,486,536,998,475,523,24,11,13
216038,31,1370,556,814,1369,555,814,1,1,0
216047,31,6,6,0,6,6,0,,,
216074,31,148,5,143,83,3,80,65,2,63
216083,31,104,48,56,103,47,56,1,1,0
216223,31,15,1,14,15,1,14,,,
216278,31,555,244,311,555,244,311,,,
216287,31,454,216,238,454,216,238,,,
216296,31,454,420,34,451,417,34,3,3,0
216311,31,34,34,0,34,34,0,,,
216339,31,4922,2066,2856,4881,2047,2834,41,19,22
216357,31,241,146,95,240,145,95,1,1,0
216366,31,684,168,516,683,168,515,1,0,1
216436,31,31,27,4,31,27,4,,,
216445,31,39,38,1,39,38,1,,,
216454,31,15,12,3,15,12,3,,,
216524,31,433,231,202,433,231,202,,,
216542,31,128,56,72,122,55,67,6,1,5
216551,31,37,27,10,32,23,9,5,4,1
216579,31,35,1,34,35,1,34,,,
216597,31,1772,782,990,1767,779,988,5,3,2
216667,31,328,168,160,328,168,160,,,
216694,31,294,131,163,294,131,163,,,
216746,31,20,20,0,19,19,0,1,1,0
216764,31,2628,1019,1609,2614,1016,1598,14,3,11
216773,31,13,3,10,13,3,10,,,
216782,31,172,10,162,85,4,81,87,6,81
216807,31,305,157,148,304,156,148,1,1,0
216825,31,789,332,457,456,229,227,333,103,230
216852,31,608,259,349,591,252,339,17,7,10
216931,31,556,252,304,541,247,294,15,5,10
216940,31,98,98,0,98,98,0,,,
217013,31,136,36,100,136,36,100,,,
217040,31,16,16,0,16,16,0,,,
217059,31,738,314,424,731,312,419,7,2,5
217077,31,144,40,104,144,40,104,,,
217156,31,1705,859,846,1705,859,846,,,
217165,31,671,437,234,671,437,234,,,
217235,31,1148,434,714,1137,428,709,11,6,5
217305,31,381,285,96,381,285,96,,,
217323,31,493,463,30,493,463,30,,,
217402,31,1040,489,551,1032,485,547,8,4,4
217420,31,609,210,399,583,200,383,26,10,16
217475,31,2853,1380,1473,2100,1045,1055,753,335,418
217484,31,3340,1365,1975,3323,1355,1968,17,10,7
217493,31,497,161,336,497,161,336,,,
217518,31,1003,498,505,999,495,504,4,3,1
217536,31,562,178,384,562,178,384,,,
217581,31,36,0,36,28,0,28,8,0,8
217606,31,33,17,16,25,15,10,8,2,6
217615,31,445,187,258,197,79,118,248,108,140
217624,31,129,85,44,124,80,44,5,5,0
217633,31,776,241,535,774,241,533,2,0,2
217688,31,690,253,437,676,248,428,14,5,9
217712,31,363,141,222,153,61,92,210,80,130
217721,31,582,276,306,582,276,306,,,
217749,31,590,266,324,571,259,312,19,7,12
217776,31,163,55,108,161,55,106,2,0,2
217794,31,22,2,20,19,2,17,3,0,3
217819,31,2473,718,1755,2464,715,1749,9,3,6
217828,31,23,0,23,17,0,17,6,0,6
217837,31,247,88,159,70,25,45,177,63,114
217864,31,566,497,69,565,496,69,1,1,0
217873,31,305,94,211,305,94,211,,,
217882,31,4593,1933,2660,4585,1929,2656,8,4,4
217891,31,33,13,20,33,13,20,,,
217907,31,213,100,113,211,99,112,2,1,1
217925,31,215,101,114,169,87,82,46,14,32
217934,31,207,52,155,191,45,146,16,7,9
217961,31,296,92,204,295,92,203,1,0,1
217989,31,106,61,45,96,55,41,10,6,4
217998,31,307,197,110,295,191,104,12,6,6
218025,31,554,283,271,372,204,168,182,79,103
218061,31,699,226,473,697,226,471,2,0,2
218070,31,653,282,371,653,282,371,,,
218113,31,1709,764,945,1384,629,755,325,135,190
218140,31,968,468,500,743,376,367,225,92,133
218159,31,11,1,10,10,1,9,1,0,1
218195,31,8,0,8,6,0,6,2,0,2
218229,31,899,265,634,892,262,630,7,3,4
218238,31,286,162,124,281,160,121,5,2,3
218353,31,1849,863,986,1295,633,662,554,230,324
218399,31,90,56,34,90,56,34,,,
218414,31,328,211,117,328,211,117,,,
218441,31,431,212,219,429,212,217,2,0,2
218487,31,211,90,121,158,69,89,53,21,32
218520,31,798,343,455,502,234,268,296,109,187
218539,31,215,107,108,215,107,108,,,
218645,31,526,189,337,524,189,335,2,0,2
218654,31,424,135,289,408,123,285,16,12,4
218663,31,6174,2477,3697,6165,2469,3696,9,8,1
218672,31,367,164,203,361,161,200,6,3,3
218681,31,132,72,60,125,68,57,7,4,3
218690,31,265,122,143,259,120,139,6,2,4
218706,31,147,71,76,145,71,74,2,0,2
218724,31,2519,1079,1440,2511,1076,1435,8,3,5
218733,31,586,271,315,526,239,287,60,32,28
218742,31,597,181,416,591,179,412,6,2,4
218821,31,507,224,283,500,222,278,7,2,5
218830,31,1318,640,678,872,452,420,446,188,258
218858,31,445,205,240,288,138,150,157,67,90
218885,31,2046,1076,970,1884,1011,873,162,65,97
218894,31,1866,831,1035,1145,505,640,721,326,395
218919,31,81,42,39,78,41,37,3,1,2
218955,31,86,26,60,33,7,26,53,19,34
218964,31,818,249,569,817,248,569,1,1,0
218973,31,459,235,224,459,235,224,,,
218991,31,799,407,392,615,320,295,184,87,97
219000,31,467,178,289,466,178,288,1,0,1
219037,31,42,1,41,42,1,41,,,
219046,31,452,159,293,429,151,278,23,8,15
219082,31,366,266,100,353,257,96,13,9,4
219091,31,169,90,79,167,89,78,2,1,1
219125,31,19,0,19,19,0,19,,,
219143,31,742,463,279,707,456,251,35,7,28
219189,31,430,324,106,418,320,98,12,4,8
219198,31,191,122,69,174,110,64,17,12,5
219204,31,140,67,73,6,3,3,134,64,70
219240,31,18,11,7,3,1,2,15,10,5
219259,31,337,144,193,320,140,180,17,4,13
219277,31,127,55,72,73,27,46,54,28,26
219295,31,99,71,28,94,68,26,5,3,2
219347,31,491,393,98,483,386,97,8,7,1
219356,31,2019,933,1086,1971,918,1053,48,15,33
219374,31,152,42,110,58,14,44,94,28,66
219383,31,309,105,204,303,103,200,6,2,4
219408,31,38,22,16,28,19,9,10,3,7
219426,31,922,471,451,676,406,270,246,65,181
219453,31,31,0,31,31,0,31,,,
219471,31,1231,423,808,1166,402,764,65,21,44
219480,31,193,118,75,155,105,50,38,13,25
219505,31,7,7,0,7,7,0,,,
219587,31,45,0,45,45,0,45,,,
219596,31,53,32,21,53,32,21,,,
219602,31,1429,611,818,1281,513,768,148,98,50
219639,31,68,10,58,63,9,54,5,1,4
219709,31,1834,636,1198,1827,634,1193,7,2,5
219718,31,522,341,181,485,317,168,37,24,13
219790,31,232,120,112,228,118,110,4,2,2
219806,31,395,180,215,394,180,214,1,0,1
219824,31,1294,516,778,1153,474,679,141,42,99
219833,31,271,130,141,271,130,141,,,
219851,31,33,1,32,33,1,32,,,
219879,31,707,325,382,604,279,325,103,46,57
219888,31,1453,608,845,1347,567,780,106,41,65
219903,31,379,22,357,379,22,357,,,
219921,31,46,21,25,41,16,25,5,5,0
219949,31,590,248,342,587,248,339,3,0,3
219976,31,663,259,404,660,256,404,3,3,0
219994,31,114,61,53,103,51,52,11,10,1
220002,31,10,1,9,10,1,9,,,
220057,31,556,186,370,486,159,327,70,27,43
220075,31,1856,696,1160,1832,685,1147,24,11,13
220118,31,26,1,25,26,1,25,,,
220127,31,104,72,32,101,69,32,3,3,0
220163,31,24,0,24,11,0,11,13,0,13
220181,31,295,98,197,289,95,194,6,3,3
220206,31,61,35,26,47,23,24,14,12,2
220215,31,371,153,218,369,153,216,2,0,2
220251,31,216,117,99,180,97,83,36,20,16
220279,31,72,53,19,62,45,17,10,8,2
220321,31,134,72,62,132,71,61,2,1,1
220394,31,62,29,33,62,29,33,,,
220400,31,825,243,582,731,221,510,94,22,72
220464,31,18,5,13,13,4,9,5,1,4
220473,31,149,74,75,141,69,72,8,5,3
220491,31,4,3,1,1,0,1,3,3,0
220516,31,185,97,88,182,94,88,3,3,0
220552,31,599,88,511,503,68,435,96,20,76
220598,31,299,174,125,296,172,124,3,2,1
220604,31,75,37,38,65,31,34,10,6,4
220613,31,620,216,404,617,215,402,3,1,2
220631,31,289,100,189,276,97,179,13,3,10
220640,31,108,64,44,86,46,40,22,18,4
220701,31,215,90,125,214,89,125,1,1,0
220710,31,274,139,135,274,139,135,,,
220756,31,20,16,4,19,15,4,1,1,0
220765,31,279,65,214,195,38,157,84,27,57
220853,31,147,82,65,126,66,60,21,16,5
220862,31,2593,1073,1520,2500,1035,1465,93,38,55
220978,31,2752,1297,1455,2707,1278,1429,45,19,26
221050,31,144,112,32,120,92,28,24,20,4
221096,31,1599,709,890,1439,646,793,160,63,97
221102,31,107,81,26,95,71,24,12,10,2
221148,31,292,273,19,292,273,19,,,
221184,31,1372,579,793,1116,479,637,256,100,156
221236,31,74,47,27,51,36,15,23,11,12
221281,31,35,19,16,34,18,16,1,1,0
221333,31,74,55,19,53,35,18,21,20,1
221351,31,592,240,352,592,240,352,,,
221388,31,34,11,23,31,9,22,3,2,1
221397,31,1007,388,619,933,364,569,74,24,50
221430,31,87,57,30,66,38,28,21,19,2
221485,31,1396,616,780,1106,491,615,290,125,165
221494,31,95,87,8,87,79,8,8,8,0
221519,31,474,223,251,474,223,251,,,
221582,31,29,17,12,23,12,11,6,5,1
221591,31,61,40,21,55,34,21,6,6,0
221607,31,40,29,11,32,24,8,8,5,3
221616,31,131,89,42,128,89,39,3,0,3
221625,31,162,101,61,156,95,61,6,6,0
221643,31,2218,1117,1101,2042,1043,999,176,74,102
221661,31,571,252,319,566,250,316,5,2,3
221731,31,183,61,122,182,60,122,1,1,0
221740,31,2074,771,1303,2057,764,1293,17,7,10
221759,31,5948,2450,3498,5926,2442,3484,22,8,14
221768,31,1042,379,663,1035,376,659,7,3,4
221829,31,123,5,118,123,5,118,,,
221838,31,1637,564,1073,1570,530,1040,67,34,33
221847,31,1661,903,758,1653,900,753,8,3,5
221892,31,425,153,272,425,153,272,,,
221908,31,1231,567,664,1138,527,611,93,40,53
221953,31,200,111,89,199,111,88,1,0,1
221971,31,360,143,217,347,135,212,13,8,5
221999,31,1626,810,816,1624,808,816,2,2,0
222053,31,1733,718,1015,1526,649,877,207,69,138
222062,31,1272,480,792,1203,461,742,69,19,50
222105,31,123,115,8,63,60,3,60,55,5
222178,31,833,313,520,833,313,520,,,
222567,31,577,292,285,303,148,155,274,144,130
222576,31,1362,552,810,971,396,575,391,156,235
222822,31,665,292,373,478,218,260,187,74,113
222831,31,1286,518,768,1270,511,759,16,7,9
222877,31,86,56,30,86,56,30,,,
222886,31,255,28,227,243,27,216,12,1,11
222938,31,56,29,27,26,12,14,30,17,13
222983,31,284,135,149,284,135,149,,,
222992,31,4191,1995,2196,2015,984,1031,2176,1011,1165
223056,31,10,0,10,10,0,10,,,
223117,31,15,13,2,,,,15,13,2
223232,31,4271,1732,2539,4258,1729,2529,13,3,10
223320,31,208,85,123,71,31,40,137,54,83
223427,31,4457,2503,1954,3076,1684,1392,1381,819,562
223463,31,160,56,104,160,56,104,,,
223472,31,33,3,30,33,3,30,,,
223506,31,707,360,347,246,127,119,461,233,228
223816,31,1228,603,625,332,138,194,896,465,431
223852,31,14,0,14,14,0,14,,,
223898,31,979,433,546,301,134,167,678,299,379
223922,31,795,301,494,309,126,183,486,175,311
224004,31,201,81,120,195,77,118,6,4,2
224013,31,1,0,1,1,0,1,,,
224110,31,1149,556,593,564,266,298,585,290,295
224147,31,1857,737,1120,1716,669,1047,141,68,73
224156,31,56,1,55,52,1,51,4,0,4
224226,31,686,274,412,679,270,409,7,4,3
224244,31,111,68,43,105,63,42,6,5,1
224271,31,130,32,98,130,32,98,,,
224323,31,476,194,282,476,194,282,,,
224350,31,794,382,412,295,144,151,499,238,261
224527,31,405,225,180,403,224,179,2,1,1
224545,31,230,103,127,225,101,124,5,2,3
224554,31,817,365,452,772,339,433,45,26,19
224615,31,6694,2982,3712,2381,1140,1241,4313,1842,2471
224642,31,3872,1808,2064,2309,1088,1221,1563,720,843
224660,31,73,43,30,70,41,29,3,2,1
224679,31,322,268,54,164,125,39,158,143,15
224758,31,19,2,17,16,2,14,3,0,3
224776,31,50,31,19,24,19,5,26,12,14
224828,31,11,0,11,7,0,7,4,0,4
224891,31,309,134,175,218,103,115,91,31,60
224961,31,267,110,157,170,72,98,97,38,59
225070,31,574,255,319,361,156,205,213,99,114
225201,31,141,104,37,141,104,37,,,
225247,31,388,181,207,388,181,207,,,
225308,31,612,275,337,424,200,224,188,75,113
225371,31,527,235,292,391,169,222,136,66,70
225399,31,802,296,506,758,282,476,44,14,30
225414,31,335,139,196,263,106,157,72,33,39
225423,31,7023,3270,3753,3646,1750,1896,3377,1520,1857
225432,31,1360,563,797,1137,492,645,223,71,152
225502,31,149,57,92,129,49,80,20,8,12
225511,31,5437,2424,3013,4998,2220,2778,439,204,235
225520,31,484,194,290,365,154,211,119,40,79
225548,31,235,123,112,227,119,108,8,4,4
225575,31,150,79,71,147,78,69,3,1,2
225627,31,966,350,616,963,349,614,3,1,2
225876,31,99,57,42,93,57,36,6,0,6
225885,31,119,65,54,118,65,53,1,0,1
225991,31,31,21,10,31,21,10,,,
226019,31,919,442,477,736,366,370,183,76,107
226091,31,1569,703,866,1363,604,759,206,99,107
226107,31,254,112,142,196,88,108,58,24,34
226116,31,306,120,186,218,89,129,88,31,57
226125,31,40,6,34,40,6,34,,,
226134,31,1265,608,657,815,379,436,450,229,221
226152,31,1139,488,651,1119,484,635,20,4,16
226204,31,1062,595,467,299,155,144,763,440,323
226231,31,328,206,122,316,203,113,12,3,9
226277,31,378,352,26,378,352,26,,,
226383,31,310,101,209,308,100,208,2,1,1
226408,31,652,291,361,414,191,223,238,100,138
226471,31,861,355,506,861,355,506,,,
226578,31,1134,380,754,532,197,335,602,183,419
226587,31,302,180,122,300,179,121,2,1,1
226806,31,788,351,437,481,208,273,307,143,164
226833,31,755,291,464,745,286,459,10,5,5
226860,31,25,1,24,25,1,24,,,
226879,31,24,4,20,11,0,11,13,4,9
226903,31,549,261,288,549,261,288,,,
227058,31,11,0,11,11,0,11,,,
227146,31,1098,494,604,821,376,445,277,118,159
227182,31,11294,4791,6503,6630,2964,3666,4664,1827,2837
227216,31,5563,2452,3111,5363,2355,3008,200,97,103
227225,31,495,192,303,422,159,263,73,33,40
227298,31,95,90,5,95,90,5,,,
227304,31,1054,457,597,660,298,362,394,159,235
227313,31,124,2,122,68,2,66,56,0,56
227322,31,181,6,175,105,3,102,76,3,73
227331,31,254,105,149,249,103,146,5,2,3
227368,31,5439,2245,3194,4241,1687,2554,1198,558,640
227377,31,966,430,536,563,285,278,403,145,258
227386,31,347,143,204,301,129,172,46,14,32
227401,31,703,302,401,531,230,301,172,72,100
227429,31,66,34,32,57,30,27,9,4,5
227526,31,1811,477,1334,1754,455,1299,57,22,35
227687,31,851,457,394,233,139,94,618,318,300
227748,31,27,25,2,27,25,2,,,
227757,31,1217,591,626,1217,591,626,,,
227845,31,613,226,387,609,223,386,4,3,1
227854,31,1446,696,750,385,194,191,1061,502,559
227863,31,443,176,267,436,174,262,7,2,5
227881,31,2909,1004,1905,2758,955,1803,151,49,102
227924,31,3065,1203,1862,1178,436,742,1887,767,1120
227979,31,6270,2960,3310,2618,1234,1384,3652,1726,1926
228042,31,251,118,133,251,118,133,,,
228088,31,8,0,8,8,0,8,,,
228149,31,606,217,389,605,216,389,1,1,0
228158,31,1444,665,779,1120,544,576,324,121,203
228200,31,86,37,49,72,36,36,14,1,13
228219,31,92,23,69,88,22,66,4,1,3
228246,31,1572,741,831,1568,740,828,4,1,3
228282,31,18,3,15,18,3,15,,,
228316,31,825,389,436,439,200,239,386,189,197
228325,31,282,137,145,281,137,144,1,0,1
228343,31,355,173,182,354,173,181,1,0,1
228431,31,1713,622,1091,1684,608,1076,29,14,15
228459,31,6650,2414,4236,6196,2199,3997,454,215,239
228468,31,132,56,76,130,55,75,2,1,1
228486,31,41,23,18,39,22,17,2,1,1
228501,31,196,124,72,192,122,70,4,2,2
228529,31,2150,752,1398,2003,697,1306,147,55,92
228547,31,4986,2208,2778,1583,775,808,3403,1433,1970
228608,31,522,191,331,250,93,157,272,98,174
228699,31,381,168,213,267,123,144,114,45,69
228705,31,936,491,445,897,467,430,39,24,15
228723,31,12323,6362,5961,11153,5636,5517,1170,726,444
228769,31,4579,1990,2589,4010,1711,2299,569,279,290
228778,31,9060,3686,5374,8915,3635,5280,145,51,94
228787,31,4042,2207,1835,3840,2092,1748,202,115,87
228796,31,3095,1407,1688,2717,1230,1487,378,177,201
228802,31,1169,430,739,1113,408,705,56,22,34
228875,31,2560,929,1631,2555,928,1627,5,1,4
228884,31,181,129,52,178,128,50,3,1,2
228981,31,313,162,151,313,162,151,,,
229018,31,386,205,181,353,185,168,33,20,13
229027,31,5522,2444,3078,4445,1962,2483,1077,482,595
229063,31,1294,445,849,1272,436,836,22,9,13
229115,31,6649,3153,3496,6490,3075,3415,159,78,81
229160,31,375,192,183,362,188,174,13,4,9
229179,31,1287,63,1224,1227,63,1164,60,0,60
229267,31,663,288,375,663,288,375,,,
229355,31,2932,1230,1702,2237,961,1276,695,269,426
229416,31,830,794,36,830,794,36,,,
229425,31,36,2,34,23,1,22,13,1,12
229504,31,297,121,176,169,69,100,128,52,76
229522,31,59,8,51,32,2,30,27,6,21
229540,31,518,202,316,246,110,136,272,92,180
229656,31,35,0,35,35,0,35,,,
229780,31,226,144,82,202,132,70,24,12,12
229799,31,985,394,591,535,206,329,450,188,262
229814,31,1291,539,752,1244,523,721,47,16,31
229832,31,180,107,73,142,86,56,38,21,17
229841,31,1308,575,733,1034,460,574,274,115,159
229887,31,195,120,75,171,105,66,24,15,9
230010,31,285,184,101,114,69,45,171,115,56
230038,31,5413,2275,3138,5269,2221,3048,144,54,90
230047,31,707,199,508,702,196,506,5,3,2
230056,31,34,4,30,30,4,26,4,0,4
230065,31,121,2,119,75,1,74,46,1,45
230144,31,24,0,24,24,0,24,,,
230162,31,732,414,318,94,50,44,638,364,274
230171,31,2559,966,1593,2338,852,1486,221,114,107
230199,31,39,3,36,39,3,36,,,
230205,31,34,4,30,27,3,24,7,1,6
230214,31,14,3,11,6,0,6,8,3,5
230366,31,19,5,14,19,5,14,,,
230418,31,1215,572,643,289,152,137,926,420,506
230490,31,398,215,183,81,25,56,317,190,127
230597,31,1787,842,945,1689,791,898,98,51,47
230603,31,2577,899,1678,2456,845,1611,121,54,67
230676,31,76,45,31,34,20,14,42,25,17
230728,31,4223,1754,2469,3809,1590,2219,414,164,250
230737,31,4511,2205,2306,3130,1487,1643,1381,718,663
230746,31,3514,1707,1807,1561,728,833,1953,979,974
230764,31,5361,2730,2631,5077,2591,2486,284,139,145
230782,31,2985,1243,1742,2304,957,1347,681,286,395
230807,31,169,62,107,167,60,107,2,2,0
230816,31,249,86,163,241,78,163,8,8,0
230834,31,390,206,184,389,206,183,1,0,1
230852,31,440,287,153,431,280,151,9,7,2
230861,31,813,260,553,216,82,134,597,178,419
230889,31,6,2,4,6,2,4,,,
230913,31,263,104,159,247,103,144,16,1,15
230959,31,680,322,358,680,322,358,,,
230995,31,572,423,149,564,417,147,8,6,2
231004,31,13,0,13,13,0,13,,,
231059,31,316,149,167,316,149,167,,,
231095,31,17,8,9,16,8,8,1,0,1
231165,31,142,94,48,137,91,46,5,3,2
231174,31,2932,962,1970,2923,954,1969,9,8,1
231280,31,8,0,8,8,0,8,,,
231411,31,159,141,18,159,141,18,,,
231420,31,230,151,79,227,148,79,3,3,0
231536,31,671,281,390,374,168,206,297,113,184
231554,31,116,76,40,116,76,40,,,
231581,31,398,184,214,398,184,214,,,
231624,31,1684,716,968,1682,715,967,2,1,1
231651,31,437,184,253,295,124,171,142,60,82
231688,31,3,1,2,1,0,1,2,1,1
231697,31,550,240,310,240,124,116,310,116,194
231712,31,1012,462,550,1012,462,550,,,
231721,31,5,1,4,,,,5,1,4
231785,31,114,55,59,111,55,56,3,0,3
231873,31,133,51,82,114,43,71,19,8,11
231882,31,374,167,207,247,123,124,127,44,83
232016,31,14,9,5,14,9,5,,,
232025,31,390,210,180,390,210,180,,,
232043,31,208,78,130,207,77,130,1,1,0
232052,31,112,44,68,56,24,32,56,20,36
232089,31,216,145,71,216,145,71,,,
232186,31,3986,2066,1920,3845,1985,1860,141,81,60
232195,31,1339,564,775,723,325,398,616,239,377
232256,31,222,220,2,222,220,2,,,
232265,31,615,171,444,613,169,444,2,2,0
232308,31,231,0,231,231,0,231,,,
232414,31,947,413,534,422,203,219,525,210,315
232423,31,4767,2024,2743,4762,2019,2743,5,5,0
232450,31,1255,601,654,673,324,349,582,277,305
232557,31,5461,2345,3116,4432,1843,2589,1029,502,527
232566,31,718,218,500,706,213,493,12,5,7
232575,31,910,394,516,500,229,271,410,165,245
232609,31,338,129,209,336,129,207,2,0,2
232618,31,3,0,3,1,0,1,2,0,2
232672,31,315,84,231,313,84,229,2,0,2
232681,31,654,224,430,629,222,407,25,2,23
232706,31,331,132,199,326,129,197,5,3,2
232788,31,294,136,158,213,109,104,81,27,54
232797,31,99,15,84,29,1,28,70,14,56
232867,31,574,302,272,471,247,224,103,55,48
232919,31,126,109,17,126,109,17,,,
232937,31,1113,398,715,1101,393,708,12,5,7
232946,31,8165,4165,4000,4729,2542,2187,3436,1623,1813
232982,31,2899,1364,1535,2811,1323,1488,88,41,47
233019,31,456,233,223,378,194,184,78,39,39
233037,31,173,91,82,112,65,47,61,26,35
233116,31,753,348,405,355,192,163,398,156,242
233277,31,1292,526,766,1291,526,765,1,0,1
233286,31,25,3,22,22,3,19,3,0,3
233295,31,345,157,188,343,155,188,2,2,0
233301,31,138,51,87,137,51,86,1,0,1
233310,31,296,113,183,148,57,91,148,56,92
233329,31,24,2,22,24,2,22,,,
233338,31,824,305,519,795,294,501,29,11,18
233374,31,874,390,484,871,387,484,3,3,0
233408,31,5,1,4,5,1,4,,,
233426,31,465,234,231,465,234,231,,,
233541,31,509,211,298,509,211,298,,,
233602,31,18,9,9,18,9,9,,,
233611,31,342,160,182,337,157,180,5,3,2
233639,31,334,116,218,158,44,114,176,72,104
233648,31,463,199,264,375,164,211,88,35,53
233666,31,39,1,38,28,1,27,11,0,11
233684,31,78,21,57,1,1,0,77,20,57
233718,31,177,0,177,177,0,177,,,
233754,31,951,431,520,507,247,260,444,184,260
233772,31,3094,1361,1733,1542,698,844,1552,663,889
233897,31,329,139,190,323,136,187,6,3,3
233903,31,476,225,251,322,165,157,154,60,94
233921,31,6758,3776,2982,6736,3764,2972,22,12,10
233949,31,1001,441,560,648,283,365,353,158,195
234030,31,4084,1369,2715,4041,1345,2696,43,24,19
234076,31,3889,1662,2227,3889,1662,2227,,,
234085,31,426,370,56,426,370,56,,,
234119,31,15,5,10,12,5,7,3,0,3
234137,31,145,135,10,122,113,9,23,22,1
234155,31,920,337,583,913,336,577,7,1,6
234164,31,313,168,145,291,160,131,22,8,14
234173,31,341,147,194,341,147,194,,,
234207,31,484,248,236,484,248,236,,,
234377,31,337,123,214,247,98,149,90,25,65
234669,31,2098,1010,1088,1426,682,744,672,328,344
234696,31,378,227,151,243,171,72,135,56,79
234711,31,437,217,220,380,186,194,57,31,26
234827,31,1371,657,714,1334,641,693,37,16,21
234845,31,346,147,199,275,117,158,71,30,41
234915,31,102,37,65,,,,102,37,65
234924,31,56,6,50,56,6,50,,,
234933,31,1383,640,743,877,414,463,506,226,280
234951,31,91,44,47,72,33,39,19,11,8
234979,31,1022,431,591,758,325,433,264,106,158
235024,31,98,35,63,97,35,62,1,0,1
235088,31,172,161,11,172,161,11,,,
235097,31,1305,519,786,1278,510,768,27,9,18
235103,31,549,285,264,367,194,173,182,91,91
235149,31,1495,646,849,1025,452,573,470,194,276
235158,31,11,2,9,11,2,9,,,
235167,31,234,94,140,218,89,129,16,5,11
235237,31,1207,490,717,847,349,498,360,141,219
235307,31,79,4,75,79,4,75,,,
235316,31,1311,587,724,1311,587,724,,,
235334,31,214,100,114,181,88,93,33,12,21
235343,31,1291,635,656,863,433,430,428,202,226
235352,31,12,2,10,12,2,10,,,
235422,31,125,45,80,81,23,58,44,22,22
235431,31,655,281,374,403,180,223,252,101,151
235501,31,121,71,50,121,71,50,,,
235583,31,38,1,37,38,1,37,,,
235671,31,153,78,75,142,76,66,11,2,9
235699,31,180,101,79,129,75,54,51,26,25
235750,31,397,146,251,275,117,158,122,29,93
236072,31,535,265,270,336,179,157,199,86,113
236133,31,157,57,100,157,57,100,,,
236188,31,912,440,472,622,286,336,290,154,136
236212,31,211,172,39,211,172,39,,,
236230,31,510,180,330,510,180,330,,,
236258,31,194,77,117,136,55,81,58,22,36
236328,31,409,207,202,409,207,202,,,
236382,31,150,71,79,114,57,57,36,14,22
236452,31,348,103,245,345,103,242,3,0,3
236504,31,395,243,152,310,195,115,85,48,37
236513,31,699,333,366,516,256,260,183,77,106
236577,31,579,182,397,575,181,394,4,1,3
236595,31,994,318,676,989,318,671,5,0,5
236610,31,370,168,202,242,113,129,128,55,73
236638,31,720,344,376,555,294,261,165,50,115
236656,31,539,221,318,401,176,225,138,45,93
236692,31,1027,483,544,827,415,412,200,68,132
236708,31,916,424,492,738,355,383,178,69,109
236744,31,16,1,15,16,1,15,,,
236753,31,935,412,523,666,296,370,269,116,153
236887,31,259,126,133,198,101,97,61,25,36
236896,31,279,150,129,276,147,129,3,3,0
236939,31,4007,1774,2233,3872,1718,2154,135,56,79
236948,31,7252,2901,4351,7166,2870,4296,86,31,55
236975,31,528,229,299,440,193,247,88,36,52
237011,31,2874,1172,1702,2813,1149,1664,61,23,38
237039,31,810,346,464,464,192,272,346,154,192
237057,31,477,233,244,477,233,244,,,
237066,31,534,233,301,532,233,299,2,0,2
237109,31,338,111,227,285,96,189,53,15,38
237118,31,262,182,80,262,182,80,,,
237127,31,42,2,40,42,2,40,,,
237136,31,27,13,14,26,12,14,1,1,0
237145,31,8,1,7,8,1,7,,,
237172,31,22,17,5,22,17,5,,,
237181,31,167,93,74,167,93,74,,,
237215,31,346,162,184,314,154,160,32,8,24
237242,31,47,22,25,43,19,24,4,3,1
237303,31,22,9,13,22,9,13,,,
237312,31,246,101,145,220,99,121,26,2,24
237321,31,12,1,11,12,1,11,,,
237330,31,395,192,203,390,189,201,5,3,2
237358,31,170,79,91,170,79,91,,,
237367,31,655,273,382,625,262,363,30,11,19
237385,31,356,206,150,318,169,149,38,37,1
237437,31,12,6,6,12,6,6,,,
237473,31,60,54,6,60,54,6,,,
237491,31,18,3,15,18,3,15,,,
237525,31,1592,659,933,1574,649,925,18,10,8
237543,31,39,12,27,24,6,18,15,6,9
237561,31,25,10,15,25,10,15,,,
237570,31,20,1,19,20,1,19,,,
237598,31,3,1,2,3,1,2,,,
237686,31,289,106,183,212,79,133,77,27,50
237701,31,383,184,199,377,180,197,6,4,2
237729,31,71,24,47,33,6,27,38,18,20
237783,31,283,167,116,228,130,98,55,37,18
237792,31,419,149,270,412,147,265,7,2,5
237817,31,406,143,263,373,131,242,33,12,21
237844,31,85,47,38,85,47,38,,,
237899,31,305,159,146,301,156,145,4,3,1
237932,31,378,134,244,375,134,241,3,0,3
237950,31,303,172,131,298,168,130,5,4,1
237969,31,302,148,154,302,148,154,,,
237987,31,42,9,33,42,9,33,,,
237996,31,78,13,65,78,13,65,,,
238005,31,39,2,37,39,2,37,,,
238014,31,223,101,122,174,80,94,49,21,28
238032,31,4313,2065,2248,4296,2058,2238,17,7,10
238078,31,151,107,44,151,107,44,,,
238096,31,1,0,1,1,0,1,,,
238175,31,29,0,29,29,0,29,,,
238193,31,113,0,113,111,0,111,2,0,2
238263,31,1368,738,630,654,413,241,714,325,389
238324,31,43,1,42,38,1,37,5,0,5
238333,31,290,148,142,290,148,142,,,
238397,31,550,226,324,193,105,88,357,121,236
238430,31,104,34,70,104,34,70,,,
238458,31,678,206,472,674,204,470,4,2,2
238476,31,763,327,436,754,323,431,9,4,5
238616,31,497,230,267,481,220,261,16,10,6
238661,31,257,95,162,255,93,162,2,2,0
238722,31,621,387,234,242,169,73,379,218,161
238759,31,1131,537,594,376,206,170,755,331,424
238810,31,5,0,5,3,0,3,2,0,2
238980,31,164,101,63,162,101,61,2,0,2
239008,31,351,188,163,173,96,77,178,92,86
239017,31,402,188,214,400,188,212,2,0,2
239071,31,147,59,88,131,53,78,16,6,10
239080,31,221,83,138,219,82,137,2,1,1
239105,31,1657,697,960,1653,695,958,4,2,2
239220,31,402,228,174,181,116,65,221,112,109
239248,31,1971,926,1045,899,506,393,1072,420,652
239309,31,221,41,180,221,41,180,,,
239318,31,649,502,147,647,501,146,2,1,1
239372,31,480,257,223,293,156,137,187,101,86
239390,31,190,0,190,190,0,190,,,
239442,31,210,80,130,81,32,49,129,48,81
239460,31,658,257,401,222,105,117,436,152,284
239488,31,1348,673,675,702,419,283,646,254,392
239512,31,124,59,65,124,59,65,,,
239628,31,247,129,118,247,129,118,,,
239716,31,584,262,322,584,262,322,,,
239877,31,19,1,18,18,1,17,1,0,1
239910,31,411,207,204,249,149,100,162,58,104
240107,31,261,68,193,261,68,193,,,
240116,31,1061,530,531,691,394,297,370,136,234
240125,31,735,476,259,293,175,118,442,301,141
240170,31,1061,553,508,648,373,275,413,180,233
240189,31,2127,1131,996,2077,1106,971,50,25,25
240198,31,484,274,210,309,183,126,175,91,84
240268,31,2253,825,1428,2233,818,1415,20,7,13
240277,31,1208,455,753,1147,440,707,61,15,46
240329,31,2217,880,1337,2210,877,1333,7,3,4
240338,31,274,109,165,274,109,165,,,
240365,31,1786,756,1030,1709,725,984,77,31,46
240374,31,467,177,290,443,165,278,24,12,12
240392,31,283,42,241,197,31,166,86,11,75
240417,31,1324,772,552,1292,753,539,32,19,13
240426,31,341,148,193,334,145,189,7,3,4
240444,31,8465,3787,4678,8442,3779,4663,23,8,15
240453,31,3358,1521,1837,3250,1475,1775,108,46,62
240462,31,1265,802,463,1242,792,450,23,10,13
240471,31,1016,332,684,995,324,671,21,8,13
240480,31,1810,783,1027,1767,762,1005,43,21,22
240505,31,650,272,378,545,228,317,105,44,61
240514,31,233,101,132,198,82,116,35,19,16
240596,31,190,85,105,178,78,100,12,7,5
240620,31,668,272,396,488,202,286,180,70,110
240657,31,285,127,158,258,114,144,27,13,14
240666,31,517,252,265,427,209,218,90,43,47
240693,31,385,171,214,315,141,174,70,30,40
240709,31,32,3,29,25,3,22,7,0,7
240718,31,320,306,14,320,306,14,,,
240727,31,1477,733,744,1451,722,729,26,11,15
240736,31,450,185,265,270,93,177,180,92,88
240745,31,362,166,196,193,88,105,169,78,91
240754,31,424,183,241,399,173,226,25,10,15
240790,31,309,157,152,283,141,142,26,16,10
240879,31,218,55,163,218,55,163,,,
241100,31,28,22,6,28,22,6,,,
241128,31,16,12,4,16,12,4,,,
241146,31,105,27,78,103,27,76,2,0,2
241182,31,64,18,46,64,18,46,,,
241191,31,81,36,45,71,31,40,10,5,5
241216,31,284,181,103,280,177,103,4,4,0
241225,31,103,32,71,96,28,68,7,4,3
241304,31,477,132,345,390,112,278,87,20,67
241331,31,118,12,106,110,12,98,8,0,8
241377,31,91,45,46,76,39,37,15,6,9
241386,31,15,9,6,11,8,3,4,1,3
241395,31,40,10,30,40,10,30,,,
241410,31,751,214,537,750,214,536,1,0,1
241517,31,32,8,24,32,8,24,,,
241614,31,22,11,11,6,3,3,16,8,8
241720,31,40,19,21,38,19,19,2,0,2
241739,31,758,254,504,621,208,413,137,46,91
241766,31,33,16,17,12,4,8,21,12,9
241836,31,158,49,109,105,41,64,53,8,45
241906,31,53,15,38,53,15,38,,,
241951,31,107,20,87,103,20,83,4,0,4
242042,31,110,80,30,108,79,29,2,1,1
242112,31,72,39,33,72,39,33,,,
242121,31,64,24,40,61,23,38,3,1,2
242130,31,70,29,41,63,24,39,7,5,2
242149,31,84,20,64,72,17,55,12,3,9
242413,31,5,0,5,5,0,5,,,
242556,31,83,59,24,79,56,23,4,3,1
242565,31,27,23,4,27,23,4,,,
242583,31,88,65,23,75,55,20,13,10,3
242617,31,518,226,292,502,215,287,16,11,5
242626,31,592,244,348,570,232,338,22,12,10
242635,31,381,151,230,377,149,228,4,2,2
242644,31,240,105,135,235,103,132,5,2,3
242653,31,417,170,247,399,163,236,18,7,11
242662,31,487,200,287,466,190,276,21,10,11
242680,31,232,105,127,227,104,123,5,1,4
242699,31,246,87,159,242,84,158,4,3,1
242705,31,721,368,353,708,362,346,13,6,7
242750,31,22,8,14,22,8,14,,,
242820,31,404,300,104,404,300,104,,,
242945,31,135,39,96,107,30,77,28,9,19
242954,31,70,21,49,58,16,42,12,5,7
242972,31,5673,2247,3426,4982,1964,3018,691,283,408
243106,31,545,201,344,545,201,344,,,
243115,31,706,287,419,706,287,419,,,
243133,31,817,453,364,815,452,363,2,1,1
243142,31,621,238,383,620,238,382,1,0,1
243151,31,577,175,402,576,175,401,1,0,1
243179,31,686,237,449,684,237,447,2,0,2
243188,31,124,58,66,124,58,66,,,
243197,31,1809,1006,803,1805,1002,803,4,4,0
243212,31,605,297,308,605,297,308,,,
243221,31,2143,792,1351,2134,790,1344,9,2,7
243346,31,856,330,526,726,272,454,130,58,72
243443,31,506,187,319,483,180,303,23,7,16
243568,31,7,0,7,7,0,7,,,
243577,31,488,353,135,471,340,131,17,13,4
243586,31,92,23,69,90,22,68,2,1,1
243601,31,1311,515,796,1189,460,729,122,55,67
243638,31,636,275,361,541,230,311,95,45,50
243647,31,123,65,58,115,62,53,8,3,5
243665,31,232,76,156,181,60,121,51,16,35
243744,31,2125,1031,1094,2125,1031,1094,,,
243780,31,10278,5972,4306,10219,5948,4271,59,24,35
243799,31,6,2,4,6,2,4,,,
243823,31,54,14,40,41,11,30,13,3,10
243832,31,138,35,103,73,15,58,65,20,45
243841,31,61,24,37,55,23,32,6,1,5
244233,31,10,0,10,2,0,2,8,0,8
244279,31,26,1,25,26,1,25,,,
244437,31,3004,1280,1724,2174,916,1258,830,364,466
244446,31,336,162,174,100,52,48,236,110,126
244613,31,237,230,7,153,148,5,84,82,2
245281,31,9,6,3,9,6,3,,,
245625,31,229,91,138,141,50,91,88,41,47
245652,31,119,61,58,119,61,58,,,
245777,31,8,8,0,8,8,0,,,
245953,31,164,55,109,137,50,87,27,5,22
245962,31,46,4,42,46,4,42,,,
245980,31,13,4,9,13,4,9,,,
245999,31,419,206,213,186,81,105,233,125,108
246017,31,714,401,313,152,102,50,562,299,263
246035,31,49,4,45,49,4,45,,,
246071,31,9,0,9,9,0,9,,,
246354,31,1782,707,1075,583,207,376,1199,500,699
246406,31,6,1,5,6,1,5,,,
246415,31,29,1,28,4,1,3,25,0,25
246460,31,82,10,72,82,10,72,,,
246813,31,441,187,254,142,67,75,299,120,179
246895,31,133,63,70,65,45,20,68,18,50
246974,31,66,2,64,66,2,64,,,
247010,31,15,0,15,15,0,15,,,
247047,31,43,0,43,43,0,43,,,
247065,31,56,1,55,43,1,42,13,0,13
247153,31,42,8,34,42,8,34,,,
247409,31,32,2,30,32,2,30,,,
247603,31,566,341,225,449,278,171,117,63,54
247649,31,98,65,33,92,63,29,6,2,4
247773,31,19,19,0,19,19,0,,,
247834,31,5258,2725,2533,3273,1810,1463,1985,915,1070
247940,31,652,321,331,428,223,205,224,98,126
248192,31,6,0,6,6,0,6,,,
248527,31,1,0,1,1,0,1,,,
248606,31,230,126,104,95,22,73,135,104,31
248624,31,20,3,17,20,3,17,,,
248633,31,9,0,9,9,0,9,,,
248660,31,1,0,1,1,0,1,,,
248703,31,113,3,110,70,2,68,43,1,42
248925,31,146,93,53,126,79,47,20,14,6
248934,31,1008,420,588,1008,420,588,,,
249061,31,13,0,13,5,0,5,8,0,8
249238,31,32,1,31,20,1,19,12,0,12
249609,31,48,37,11,48,37,11,,,
250027,31,114,34,80,111,34,77,3,0,3
250285,31,42,40,2,42,40,2,,,
250744,31,90,16,74,90,16,74,,,
250902,31,72,10,62,36,5,31,36,5,31
250993,31,65,41,24,21,9,12,44,32,12
251260,31,1099,536,563,944,468,476,155,68,87
251312,31,29,4,25,15,0,15,14,4,10
260336,31,2,0,2,2,0,2,,,
260363,31,12,2,10,12,2,10,,,
260372,31,44,9,35,13,3,10,31,6,25
260664,31,220,174,46,220,174,46,,,
260691,31,49,10,39,49,10,39,,,
260789,31,41,12,29,41,12,29,,,
260813,31,6,0,6,6,0,6,,,
260929,31,27,4,23,27,4,23,,,
260965,31,22,0,22,22,0,22,,,
260992,31,87,5,82,22,0,22,65,5,60
261436,31,135,7,128,135,7,128,,,
261676,31,16,1,15,16,1,15,,,
261685,31,23,0,23,23,0,23,,,
261719,31,13,1,12,13,1,12,,,
261773,31,9,5,4,8,4,4,1,1,0
261861,31,16,0,16,16,0,16,,,
262031,31,1192,583,609,959,472,487,233,111,122
262086,31,85,26,59,30,11,19,55,15,40
262129,31,160,47,113,160,47,113,,,
262341,31,359,318,41,359,318,41,,,
262369,31,55,1,54,55,1,54,,,
262457,31,61,12,49,61,12,49,,,
262466,31,1,0,1,1,0,1,,,
362700,31,24,0,24,24,0,24,,,
362782,31,88,2,86,27,0,27,61,2,59
363013,31,17,0,17,17,0,17,,,
363077,31,218,56,162,108,7,101,110,49,61
363147,31,47,0,47,47,0,47,,,
363165,31,1906,982,924,991,515,476,915,467,448
363439,31,1,0,1,1,0,1,,,
363633,31,140,68,72,120,57,63,20,11,9
363679,31,51,1,50,43,1,42,8,0,8
363712,31,5,5,0,5,5,0,,,
363882,31,38,0,38,38,0,38,,,
363907,31,39,25,14,34,21,13,5,4,1
363916,31,11,2,9,10,2,8,1,0,1
363934,31,160,128,32,100,84,16,60,44,16
364016,31,796,425,371,545,296,249,251,129,122
364025,31,1379,681,698,867,425,442,512,256,256
364548,31,137,70,67,89,36,53,48,34,14
364575,31,12,1,11,12,1,11,,,
364627,31,44,17,27,36,11,25,8,6,2
364636,31,68,28,40,55,28,27,13,0,13
364751,31,3,0,3,3,0,3,,,
364760,31,51,2,49,25,2,23,26,0,26
364946,31,21,10,11,14,6,8,7,4,3
364964,31,16,1,15,16,1,15,,,
365091,31,1,0,1,1,0,1,,,
365125,31,28,1,27,28,1,27,,,
365198,31,111,36,75,30,4,26,81,32,49
365213,31,185,92,93,66,29,37,119,63,56
365240,31,6,4,2,6,4,2,,,
365374,31,145,88,57,77,43,34,68,45,23
365383,31,7,1,6,7,1,6,,,
365480,31,85,53,32,32,14,18,53,39,14
365505,31,22,4,18,22,4,18,,,
365693,31,25,0,25,25,0,25,,,
365763,31,24,7,17,24,7,17,,,
365824,31,65,0,65,65,0,65,,,
365833,31,67,1,66,67,1,66,,,
366003,31,1,1,0,,,,1,1,0
366155,31,1,0,1,1,0,1,,,
366191,31,559,544,15,559,544,15,,,
366252,31,966,695,271,942,686,256,24,9,15
366261,31,55,16,39,55,16,39,,,
366270,31,15,1,14,15,1,14,,,
366289,31,6,6,0,6,6,0,,,
366340,31,38,18,20,31,15,16,7,3,4
366395,31,3354,1729,1625,2894,1517,1377,460,212,248
366401,31,1305,658,647,701,355,346,604,303,301
366438,31,15,0,15,9,0,9,6,0,6
366465,31,309,133,176,152,66,86,157,67,90
366535,31,117,30,87,117,30,87,,,
366553,31,278,87,191,57,10,47,221,77,144
366623,31,20,12,8,13,7,6,7,5,2
366632,31,5,0,5,5,0,5,,,
366711,31,2413,969,1444,2236,893,1343,177,76,101
367051,31,39,1,38,20,1,19,19,0,19
367088,31,16,0,16,9,0,9,7,0,7
367103,31,28,22,6,28,22,6,,,
367112,31,27,5,22,23,5,18,4,0,4
367158,31,16,2,14,16,2,14,,,
367334,31,125,112,13,118,105,13,7,7,0
367361,31,18,12,6,18,12,6,,,
367431,31,17,3,14,17,3,14,,,
367459,31,1296,574,722,684,299,385,612,275,337
367875,31,129,70,59,129,70,59,,,
367884,31,23,10,13,17,7,10,6,3,3
367981,31,4,0,4,2,0,2,2,0,2
368230,31,43,1,42,37,1,36,6,0,6
368364,31,193,96,97,59,39,20,134,57,77
368407,31,6,0,6,,,,6,0,6
368443,31,236,31,205,236,31,205,,,
368452,31,82,24,58,82,24,58,,,
368540,31,21,1,20,21,1,20,,,
368629,31,53,7,46,53,7,46,,,
368771,31,22,7,15,22,7,15,,,
368832,31,13,2,11,6,1,5,7,1,6
368911,31,121,62,59,38,21,17,83,41,42
369109,31,24,4,20,22,4,18,2,0,2
369400,31,489,477,12,489,477,12,,,
369419,31,487,213,274,487,213,274,,,
369446,31,46,3,43,22,3,19,24,0,24
369455,31,19,3,16,19,3,16,,,
369516,31,7,2,5,7,2,5,,,
369668,31,104,53,51,91,52,39,13,1,12
369686,31,69,24,45,69,24,45,,,
369695,31,18,3,15,18,3,15,,,
369783,31,81,5,76,81,5,76,,,
369950,31,18,14,4,18,14,4,,,
371052,31,55,6,49,55,6,49,,,
371690,31,233,90,143,1,0,1,232,90,142
371830,31,18,12,6,16,11,5,2,1,1
371928,31,42,13,29,42,13,29,,,
371964,31,44,36,8,44,36,8,,,
372028,31,47,6,41,47,6,41,,,
372073,31,45,15,30,45,15,30,,,
372082,31,34,13,21,33,13,20,1,0,1
372240,31,1,0,1,1,0,1,,,
372329,31,190,9,181,190,9,181,,,
372356,31,136,5,131,136,5,131,,,
372462,31,9,3,6,9,3,6,,,
372718,31,6,3,3,6,3,3,,,
372921,31,58,22,36,58,22,36,,,
373085,31,19,1,18,19,1,18,,,
373216,31,5,4,1,5,4,1,,,
373456,31,11,0,11,9,0,9,2,0,2
373526,31,174,146,28,174,146,28,,,
373678,31,33,15,18,21,12,9,12,3,9
373696,31,25,18,7,25,18,7,,,
373711,31,29,1,28,29,1,28,,,
373784,31,139,77,62,139,77,62,,,
374316,31,4,3,1,3,3,0,1,0,1
374343,31,20,0,20,20,0,20,,,
374574,31,164,33,131,132,23,109,32,10,22
374592,31,61,7,54,61,7,54,,,
375106,31,88,77,11,79,69,10,9,8,1
375230,31,38,38,0,38,38,0,,,
375373,31,19,10,9,1,0,1,18,10,8
375407,31,52,15,37,41,11,30,11,4,7
375416,31,87,19,68,87,19,68,,,
375540,31,61,1,60,39,1,38,22,0,22
375568,31,39,17,22,6,3,3,33,14,19
375656,31,15,8,7,7,0,7,8,8,0
375683,31,169,119,50,107,75,32,62,44,18
375726,31,188,124,64,97,55,42,91,69,22
375939,31,11,0,11,11,0,11,,,
375966,31,7,1,6,7,1,6,,,
375984,31,107,2,105,86,2,84,21,0,21
376224,31,31,7,24,31,7,24,,,
376242,31,87,54,33,87,54,33,,,
376288,31,32,5,27,32,5,27,,,
376330,31,22,9,13,22,9,13,,,
376385,31,43,15,28,43,15,28,,,
376446,31,10,1,9,2,1,1,8,0,8
376631,31,13,4,9,12,4,8,1,0,1
376677,31,2,0,2,2,0,2,,,
376695,31,435,207,228,290,146,144,145,61,84
377111,31,107,41,66,107,41,66,,,
377193,31,4,1,3,4,1,3,,,
377218,31,11,11,0,11,11,0,,,
377272,31,14,2,12,14,2,12,,,
377281,31,62,5,57,62,5,57,,,
377315,31,43,0,43,43,0,43,,,
377449,31,16,7,9,16,7,9,,,
377458,31,35,12,23,35,12,23,,,
377485,31,6,1,5,5,0,5,1,1,0
377546,31,34,15,19,34,15,19,,,
377555,31,900,504,396,868,485,383,32,19,13
377564,31,628,309,319,589,293,296,39,16,23
377643,31,10,1,9,10,1,9,,,
377652,31,9,1,8,9,1,8,,,
377661,31,36,7,29,36,7,29,,,
377722,31,62,1,61,62,1,61,,,
377759,31,25,24,1,25,24,1,,,
378105,31,57,1,56,44,1,43,13,0,13
378576,31,147,27,120,18,6,12,129,21,108
378886,31,72,16,56,19,7,12,53,9,44
378956,31,145,141,4,145,141,4,,,
379621,31,8,1,7,8,1,7,,,
379746,31,98,8,90,98,8,90,,,
379782,31,6,0,6,6,0,6,,,
380067,31,69,1,68,69,1,68,,,
380359,31,106,26,80,54,15,39,52,11,41
380368,31,83,36,47,64,29,35,19,7,12
380377,31,77,24,53,50,20,30,27,4,23
380438,31,12,0,12,12,0,12,,,
381255,31,21,16,5,21,16,5,,,
381282,31,27,10,17,27,10,17,,,
381325,31,20,3,17,20,3,17,,,
381370,31,270,11,259,154,5,149,116,6,110
381404,31,143,3,140,87,2,85,56,1,55
381486,31,5,0,5,5,0,5,,,
381699,31,18,0,18,14,0,14,4,0,4
381732,31,13,3,10,2,0,2,11,3,8
382258,31,84,14,70,45,3,42,39,11,28
382416,31,13,4,9,13,4,9,,,
382461,31,2,0,2,1,0,1,1,0,1
382780,31,131,5,126,128,5,123,3,0,3
382911,31,10,6,4,10,6,4,,,
382957,31,77,29,48,73,28,45,4,1,3
383084,31,673,167,506,510,120,390,163,47,116
383163,31,97,2,95,18,1,17,79,1,78
383190,31,385,185,200,228,116,112,157,69,88
383279,31,6,0,6,3,0,3,3,0,3
383297,31,3,0,3,1,0,1,2,0,2
383312,31,76,40,36,76,40,36,,,
383330,31,8,1,7,8,1,7,,,
383367,31,80,24,56,61,23,38,19,1,18
383464,31,114,9,105,114,9,105,,,
383525,31,6,0,6,6,0,6,,,
383765,31,67,1,66,51,1,50,16,0,16
383996,31,52,28,24,35,16,19,17,12,5
384236,31,184,73,111,184,73,111,,,
384245,31,147,67,80,147,67,80,,,
384254,31,101,72,29,98,69,29,3,3,0
384333,31,1064,471,593,636,276,360,428,195,233
384342,31,720,372,348,536,276,260,184,96,88
384412,31,72,44,28,72,44,28,,,
384421,31,28,28,0,28,28,0,,,
385132,31,36,4,32,31,4,27,5,0,5
385503,31,24,2,22,24,2,22,,,
385619,31,258,120,138,258,120,138,,,
386153,31,306,0,306,306,0,306,,,
386472,31,92,17,75,62,12,50,30,5,25
387925,31,31,6,25,31,6,25,,,
388520,31,117,79,38,13,7,6,104,72,32
388663,31,28,3,25,28,3,25,,,
389860,31,111,73,38,42,14,28,69,59,10
390905,31,120,65,55,26,16,10,94,49,45
391005,31,6,0,6,6,0,6,,,
391759,31,8,0,8,,,,8,0,8
392257,31,784,42,742,784,42,742,,,
392415,31,57,21,36,57,21,36,,,
393524,31,3,0,3,3,0,3,,,
393649,31,224,93,131,224,93,131,,,
393861,31,87,14,73,84,14,70,3,0,3
395362,31,156,73,83,43,14,29,113,59,54
395690,31,129,81,48,129,81,48,,,
397942,31,198,57,141,198,57,141,,,
399212,31,2049,1333,716,861,444,417,1188,889,299
399869,31,154,151,3,154,151,3,,,
399911,31,133,50,83,133,50,83,,,
400080,31,807,591,216,807,591,216,,,
400187,31,103,12,91,63,9,54,40,3,37
401223,31,9,3,6,7,2,5,2,1,1
401764,31,39,1,38,19,1,18,20,0,20
402563,31,13,2,11,13,2,11,,,
402800,31,11,0,11,10,0,10,1,0,1
403469,31,148,70,78,133,66,67,15,4,11
403478,31,225,116,109,196,105,91,29,11,18
403487,31,178,91,87,164,86,78,14,5,9
404055,31,31,5,26,31,5,26,,,
404338,31,2,2,0,2,2,0,,,
404426,31,450,248,202,280,156,124,170,92,78
404684,31,84,32,52,84,32,52,,,
404718,31,58,1,57,58,1,57,,,
404912,31,95,12,83,95,12,83,,,
404994,31,615,254,361,590,246,344,25,8,17
405012,31,37,1,36,37,1,36,,,
405058,31,41,41,0,41,41,0,,,
405076,31,466,78,388,466,78,388,,,
405854,31,28,28,0,28,28,0,,,
405872,31,484,229,255,341,160,181,143,69,74
406024,31,531,62,469,276,35,241,255,27,228
406033,31,1164,156,1008,796,110,686,368,46,322
406149,31,30,8,22,30,8,22,,,
406325,31,35,8,27,4,0,4,31,8,23
406361,31,9,1,8,9,1,8,,,
406422,31,24,2,22,24,2,22,,,
406486,31,16,7,9,7,2,5,9,5,4
406547,31,4,0,4,2,0,2,2,0,2
407090,31,82,4,78,32,2,30,50,2,48
407142,31,11,0,11,11,0,11,,,
407151,31,13,0,13,13,0,13,,,
407179,31,39,0,39,25,0,25,14,0,14
407355,31,20,0,20,20,0,20,,,
407391,31,92,25,67,38,5,33,54,20,34
407407,31,65,14,51,44,12,32,21,2,19
407425,31,65,12,53,32,0,32,33,12,21
407434,31,51,0,51,51,0,51,,,
407461,31,34,25,9,34,25,9,,,
407470,31,51,1,50,44,1,43,7,0,7
407489,31,43,31,12,12,6,6,31,25,6
407513,31,62,51,11,7,6,1,55,45,10
407522,31,25,9,16,,,,25,9,16
407568,31,25,1,24,24,1,23,1,0,1
407577,31,59,20,39,49,14,35,10,6,4
407595,31,58,12,46,58,12,46,,,
407610,31,5,2,3,2,0,2,3,2,1
407683,31,67,4,63,19,1,18,48,3,45
407708,31,107,3,104,107,3,104,,,
407735,31,21,1,20,21,1,20,,,
407832,31,70,52,18,26,21,5,44,31,13
408066,31,41,2,39,34,2,32,7,0,7
408163,31,9,0,9,9,0,9,,,
408385,31,531,186,345,531,186,345,,,
408729,31,61,5,56,57,5,52,4,0,4
408844,31,311,75,236,248,67,181,63,8,55
408862,31,69,2,67,34,2,32,35,0,35
409032,31,48,1,47,48,1,47,,,
409120,31,42,16,26,42,16,26,,,
409193,31,10,10,0,10,10,0,,,
409315,31,3791,1844,1947,1802,895,907,1989,949,1040
409537,31,12,7,5,,,,12,7,5
409591,31,71,24,47,30,13,17,41,11,30
409698,31,779,282,497,767,278,489,12,4,8
410797,31,120,69,51,120,69,51,,,
410964,31,11,1,10,8,1,7,3,0,3
411684,31,33,11,22,33,11,22,,,
412173,31,4,1,3,4,1,3,,,
412535,31,10,0,10,10,0,10,,,
412544,31,6,0,6,3,0,3,3,0,3
412599,31,130,48,82,130,48,82,,,
413176,31,8,5,3,8,5,3,,,
413413,31,59,12,47,14,4,10,45,8,37
413617,31,20,13,7,12,6,6,8,7,1
413626,31,32,14,18,21,7,14,11,7,4
413680,31,63,61,2,63,61,2,,,
413778,31,179,11,168,93,6,87,86,5,81
413820,31,5,0,5,5,0,5,,,
413893,31,277,173,104,277,173,104,,,
413945,31,11,1,10,11,1,10,,,
413972,31,9,0,9,9,0,9,,,
414063,31,36,1,35,34,1,33,2,0,2
414124,31,97,65,32,84,60,24,13,5,8
414461,31,824,793,31,822,791,31,2,2,0
414489,31,20,0,20,20,0,20,,,
414540,31,79,1,78,79,1,78,,,
414595,31,76,12,64,8,1,7,68,11,57
414869,31,16,0,16,6,0,6,10,0,10
414878,31,5,3,2,1,0,1,4,3,1
414911,31,218,96,122,183,82,101,35,14,21
414939,31,60,3,57,60,3,57,,,
415039,31,29,0,29,15,0,15,14,0,14
415057,31,25,25,0,25,25,0,,,
415987,31,75,4,71,75,4,71,,,
416458,31,56,14,42,56,14,42,,,
417008,31,24,0,24,24,0,24,,,
417062,31,7,0,7,4,0,4,3,0,3
417105,31,52,29,23,42,23,19,10,6,4
417123,31,32,8,24,14,5,9,18,3,15
417248,31,17,16,1,17,16,1,,,
417275,31,15,11,4,15,11,4,,,
417327,31,18,4,14,1,1,0,17,3,14
417442,31,11,1,10,11,1,10,,,
417503,31,8,0,8,4,0,4,4,0,4
417600,31,15,0,15,15,0,15,,,
417628,31,13,1,12,12,1,11,1,0,1
417637,31,17,16,1,17,16,1,,,
417646,31,10,0,10,10,0,10,,,
417655,31,22,0,22,22,0,22,,,
417682,31,4,2,2,4,2,2,,,
417716,31,12,1,11,12,1,11,,,
417725,31,10,0,10,10,0,10,,,
417734,31,12,2,10,6,1,5,6,1,5
417752,31,4,0,4,4,0,4,,,
417831,31,14,8,6,14,8,6,,,
417840,31,17,1,16,17,1,16,,,
417868,31,42,13,29,28,6,22,14,7,7
417886,31,4,1,3,4,1,3,,,
417910,31,40,6,34,40,6,34,,,
417983,31,23,1,22,,,,23,1,22
417992,31,11,1,10,11,1,10,,,
418001,31,3,0,3,3,0,3,,,
418010,31,31,2,29,19,1,18,12,1,11
418029,31,9,0,9,9,0,9,,,
418038,31,77,9,68,77,9,68,,,
418056,31,4,0,4,4,0,4,,,
418065,31,63,7,56,49,7,42,14,0,14
418083,31,9,1,8,9,1,8,,,
418126,31,12,2,10,10,1,9,2,1,1
418171,31,3,3,0,3,3,0,,,
418199,31,17,17,0,17,17,0,,,
418205,31,55,37,18,55,37,18,,,
418223,31,56,1,55,56,1,55,,,
418250,31,116,79,37,17,14,3,99,65,34
418269,31,66,41,25,66,41,25,,,
418278,31,43,23,20,30,12,18,13,11,2
418296,31,859,505,354,295,91,204,564,414,150
418302,31,73,36,37,42,12,30,31,24,7
418320,31,126,81,45,17,7,10,109,74,35
418348,31,79,62,17,40,34,6,39,28,11
418357,31,148,75,73,17,11,6,131,64,67
418409,31,138,82,56,79,45,34,59,37,22
418427,31,14,0,14,9,0,9,5,0,5
418445,31,10,0,10,10,0,10,,,
418454,31,65,35,30,58,28,30,7,7,0
418481,31,34,1,33,34,1,33,,,
418515,31,52,4,48,34,4,30,18,0,18
418524,31,30,2,28,30,2,28,,,
418533,31,52,10,42,45,8,37,7,2,5
418542,31,55,10,45,23,4,19,32,6,26
418560,31,28,10,18,4,0,4,24,10,14
418588,31,17,1,16,17,1,16,,,
418612,31,3,0,3,3,0,3,,,
418658,31,140,122,18,140,122,18,,,
418773,31,101,56,45,96,56,40,5,0,5
418782,31,128,122,6,128,122,6,,,
418889,31,12,10,2,8,6,2,4,4,0
418913,31,4,2,2,4,2,2,,,
418968,31,32,1,31,32,1,31,,,
419031,31,5,0,5,5,0,5,,,
419095,31,16,1,15,16,1,15,,,
419183,31,48,3,45,48,3,45,,,
419217,31,2,1,1,2,1,1,,,
419226,31,161,84,77,122,71,51,39,13,26
419235,31,41,6,35,41,6,35,,,
419244,31,33,25,8,15,12,3,18,13,5
419253,31,18,10,8,18,10,8,,,
419280,31,9,0,9,8,0,8,1,0,1
419332,31,1,1,0,1,1,0,,,
419341,31,5,2,3,5,2,3,,,
419420,31,22,13,9,22,13,9,,,
419484,31,9,1,8,9,1,8,,,
419633,31,26,2,24,26,2,24,,,
419703,31,259,241,18,259,241,18,,,
419712,31,67,62,5,67,62,5,,,
419721,31,120,117,3,120,117,3,,,
420024,31,27,1,26,27,1,26,,,
420130,31,17,3,14,17,3,14,,,
420255,31,8,7,1,8,7,1,,,
420325,31,20,20,0,20,20,0,,,
420343,31,269,263,6,215,210,5,54,53,1
420370,31,95,35,60,95,35,60,,,
420398,31,2714,1234,1480,1059,478,581,1655,756,899
420431,31,207,125,82,56,37,19,151,88,63
420440,31,231,93,138,133,59,74,98,34,64
420468,31,105,58,47,79,55,24,26,3,23
420538,31,196,80,116,136,60,76,60,20,40
420556,31,152,70,82,80,41,39,72,29,43
420723,31,63,29,34,42,18,24,21,11,10
420981,31,211,13,198,211,13,198,,,
421513,31,22,4,18,22,4,18,,,
421610,31,39,4,35,39,4,35,,,
421665,31,5,0,5,1,0,1,4,0,4
421708,31,22,6,16,11,5,6,11,1,10
421717,31,5,4,1,2,1,1,3,3,0
421771,31,22,0,22,17,0,17,5,0,5
421832,31,27,12,15,26,12,14,1,0,1
421841,31,102,39,63,102,39,63,,,
421878,31,24,6,18,12,2,10,12,4,8
421896,31,79,26,53,79,26,53,,,
422020,31,17,17,0,17,17,0,,,
422695,31,2,0,2,2,0,2,,,
422835,31,284,55,229,284,55,229,,,
423120,31,178,5,173,178,5,173,,,
423397,31,182,111,71,182,111,71,,,
423412,31,17,12,5,17,12,5,,,
423652,31,121,42,79,58,20,38,63,22,41
425250,31,25,1,24,16,0,16,9,1,8
425986,31,29,3,26,29,3,26,,,
426314,31,518,447,71,124,105,19,394,342,52
427308,31,5,0,5,5,0,5,,,
427335,31,73,0,73,68,0,68,5,0,5
427894,31,13,13,0,13,13,0,,,
427973,31,32,26,6,32,26,6,,,
427982,31,32,24,8,32,24,8,,,
427991,31,275,130,145,247,111,136,28,19,9
428019,31,36,15,21,34,13,21,2,2,0
428055,31,62,14,48,62,14,48,,,
428125,31,5,2,3,5,2,3,,,
428170,31,223,27,196,150,17,133,73,10,63
428392,31,231,115,116,138,65,73,93,50,43
429012,31,58,52,6,58,52,6,,,
429128,31,15,0,15,1,0,1,14,0,14
430184,31,34,16,18,2,2,0,32,14,18
430227,31,27,1,26,26,1,25,1,0,1
430245,31,517,101,416,517,101,416,,,
430306,31,32,4,28,21,3,18,11,1,10
430403,31,35,2,33,35,2,33,,,
430564,31,20,7,13,4,1,3,16,6,10
430582,31,252,122,130,252,122,130,,,
430670,31,17,6,11,17,6,11,,,
430795,31,140,43,97,140,43,97,,,
430883,31,2,0,2,2,0,2,,,
430908,31,20,5,15,14,5,9,6,0,6
430935,31,159,126,33,137,108,29,22,18,4
430971,31,25,9,16,25,9,16,,,
431017,31,53,33,20,43,26,17,10,7,3
431071,31,16,2,14,9,1,8,7,1,6
431105,31,72,8,64,32,5,27,40,3,37
431123,31,81,78,3,81,78,3,,,
431141,31,244,116,128,244,116,128,,,
431169,31,25,8,17,17,7,10,8,1,7
431187,31,57,48,9,57,48,9,,,
431196,31,17,0,17,17,0,17,,,
431266,31,55,2,53,,,,55,2,53
431275,31,13,0,13,4,0,4,9,0,9
431284,31,37,1,36,35,1,34,2,0,2
431558,31,233,82,151,220,80,140,13,2,11
431600,31,12,1,11,12,1,11,,,
431716,31,435,256,179,435,256,179,,,
431929,31,2,1,1,2,1,1,,,
432117,31,9,0,9,7,0,7,2,0,2
432269,31,8,7,1,8,7,1,,,
432384,31,36,6,30,36,6,30,,,
432524,31,64,21,43,64,21,43,,,
433013,31,21,11,10,21,11,10,,,
433040,31,18,1,17,18,1,17,,,
433068,31,142,90,52,117,70,47,25,20,5
433101,31,196,31,165,127,11,116,69,20,49
433138,31,51,15,36,38,9,29,13,6,7
433174,31,6,0,6,2,0,2,4,0,4
433387,31,1002,456,546,1002,456,546,,,
433420,31,35,30,5,35,30,5,,,
433536,31,22,3,19,13,3,10,9,0,9
433660,31,3125,1282,1843,3050,1248,1802,75,34,41
434016,31,30,10,20,11,5,6,19,5,14
434061,31,1121,554,567,824,433,391,297,121,176
434140,31,87,20,67,87,20,67,,,
434159,31,151,120,31,151,120,31,,,
434274,31,75,12,63,52,7,45,23,5,18
434283,31,15,2,13,14,2,12,1,0,1
434308,31,182,6,176,182,6,176,,,
434344,31,30,0,30,30,0,30,,,
434362,31,22,22,0,22,22,0,,,
434432,31,6,1,5,6,1,5,,,
434496,31,63,0,63,63,0,63,,,
434584,31,33,15,18,16,9,7,17,6,11
434672,31,3142,1419,1723,1573,777,796,1569,642,927
434751,31,18,8,10,10,6,4,8,2,6
434821,31,198,2,196,198,2,196,,,
434830,31,81,5,76,64,5,59,17,0,17
434900,31,60,23,37,46,17,29,14,6,8
434937,31,11,11,0,11,11,0,,,
436003,31,71,10,61,46,6,40,25,4,21
436030,31,97,42,55,57,24,33,40,18,22
436100,31,11,2,9,11,2,9,,,
436304,31,427,271,156,301,206,95,126,65,61
436429,31,1109,732,377,1109,732,377,,,
436553,31,20,10,10,20,10,10,,,
436599,31,21,2,19,,,,21,2,19
436614,31,10,4,6,5,1,4,5,3,2
436632,31,104,11,93,55,7,48,49,4,45
436641,31,22,8,14,22,8,14,,,
436650,31,32,4,28,32,4,28,,,
436775,31,41,2,39,41,2,39,,,
436818,31,272,134,138,269,133,136,3,1,2
436827,31,209,138,71,207,136,71,2,2,0
436836,31,764,410,354,754,404,350,10,6,4
437097,31,2,1,1,2,1,1,,,
437103,31,1503,656,847,964,430,534,539,226,313
437237,31,11,10,1,11,10,1,,,
437556,31,327,152,175,306,151,155,21,1,20
437608,31,43,30,13,42,29,13,1,1,0
437635,31,193,13,180,193,13,180,,,
437723,31,45,11,34,45,11,34,,,
437732,31,17,1,16,17,1,16,,,
437750,31,32,31,1,32,31,1,,,
437769,31,14,0,14,14,0,14,,,
437778,31,200,3,197,200,3,197,,,
437857,31,18,0,18,13,0,13,5,0,5
437936,31,61,5,56,61,5,56,,,
438179,31,45,5,40,45,5,40,,,
438221,31,28,2,26,26,2,24,2,0,2
438258,31,54,11,43,54,11,43,,,
438285,31,111,8,103,111,8,103,,,
438337,31,140,52,88,113,42,71,27,10,17
438498,31,114,19,95,20,2,18,94,17,77
438504,31,535,512,23,535,512,23,,,
438586,31,115,25,90,86,13,73,29,12,17
438674,31,4,0,4,3,0,3,1,0,1
438708,31,42,16,26,36,14,22,6,2,4
438735,31,15,15,0,15,15,0,,,
438984,31,13,5,8,13,5,8,,,
439118,31,41,2,39,41,2,39,,,
439190,31,297,156,141,219,117,102,78,39,39
439367,31,31,11,20,31,11,20,,,
439455,31,11,0,11,4,0,4,7,0,7
439473,31,77,32,45,52,21,31,25,11,14
439491,31,97,14,83,97,14,83,,,
439507,31,292,16,276,292,16,276,,,
439570,31,108,6,102,108,6,102,,,
439622,31,78,6,72,78,6,72,,,
439668,31,180,161,19,180,161,19,,,
439686,31,21,1,20,21,1,20,,,
439701,31,15,6,9,10,5,5,5,1,4
439738,31,41,10,31,41,10,31,,,
439747,31,74,14,60,41,9,32,33,5,28
439774,31,44,16,28,36,15,21,8,1,7
439792,31,37,5,32,37,5,32,,,
439844,31,23,0,23,23,0,23,,,
439862,31,8,4,4,8,4,4,,,
439871,31,9,0,9,8,0,8,1,0,1
439899,31,32,10,22,27,7,20,5,3,2
439932,31,52,9,43,52,9,43,,,
439969,31,59,18,41,59,18,41,,,
440059,31,121,109,12,121,109,12,,,
440101,31,43,0,43,23,0,23,20,0,20
440226,31,20,0,20,20,0,20,,,
440262,31,206,189,17,149,139,10,57,50,7
440271,31,42,26,16,42,26,16,,,
440396,31,72,31,41,72,31,41,,,
440402,31,336,148,188,238,108,130,98,40,58
440651,31,142,42,100,131,41,90,11,1,10
440730,31,100,43,57,100,43,57,,,
440749,31,4,3,1,,,,4,3,1
440776,31,16,4,12,16,4,12,,,
440794,31,54,20,34,54,20,34,,,
440828,31,158,72,86,123,57,66,35,15,20
440855,31,109,4,105,109,4,105,,,
440989,31,83,71,12,83,71,12,,,
441025,31,49,27,22,48,26,22,1,1,0
441052,31,57,12,45,57,12,45,,,
441070,31,31,8,23,6,2,4,25,6,19
441168,31,3,1,2,3,1,2,,,
441210,31,2,0,2,2,0,2,,,
441229,31,134,27,107,134,27,107,,,
441256,31,6,0,6,6,0,6,,,
441371,31,1321,50,1271,1321,50,1271,,,
441380,31,47,11,36,44,10,34,3,1,2
441414,31,75,12,63,10,3,7,65,9,56
441423,31,77,24,53,77,24,53,,,
441487,31,12,1,11,12,1,11,,,
441496,31,24,18,6,24,18,6,,,
441502,31,112,12,100,112,12,100,,,
441548,31,28,5,23,28,5,23,,,
441575,31,40,3,37,40,3,37,,,
441593,31,2,0,2,2,0,2,,,
441609,31,6,6,0,6,6,0,,,
441618,31,13,0,13,9,0,9,4,0,4
441636,31,71,10,61,60,9,51,11,1,10
441645,31,25,0,25,20,0,20,5,0,5
441663,31,69,6,63,69,6,63,,,
441672,31,33,4,29,33,4,29,,,
441690,31,16,11,5,10,7,3,6,4,2
441706,31,108,47,61,108,47,61,,,
441742,31,233,22,211,207,19,188,26,3,23
441760,31,602,303,299,364,203,161,238,100,138
441788,31,55,49,6,55,49,6,,,
441830,31,17,4,13,17,4,13,,,
441858,31,8,1,7,8,1,7,,,
441876,31,42,0,42,26,0,26,16,0,16
441900,31,347,72,275,285,59,226,62,13,49
441937,31,566,164,402,540,154,386,26,10,16
441982,31,91,42,49,91,42,49,,,
442073,31,150,36,114,117,34,83,33,2,31
442134,31,59,8,51,59,8,51,,,
442213,31,3,0,3,3,0,3,,,
442240,31,43,5,38,30,4,26,13,1,12
442329,31,330,304,26,330,304,26,,,
442356,31,101,4,97,82,2,80,19,2,17
442383,31,29,8,21,29,8,21,,,
442426,31,37,2,35,19,0,19,18,2,16
442435,31,5,0,5,5,0,5,,,
442444,31,74,42,32,74,42,32,,,
442523,31,34,16,18,34,16,18,,,
442569,31,618,150,468,148,45,103,470,105,365
442602,31,70,11,59,70,11,59,,,
442611,31,573,539,34,573,539,34,,,
442639,31,13,9,4,13,9,4,,,
442657,31,125,12,113,125,12,113,,,
442781,31,98,23,75,28,6,22,70,17,53
442842,31,16,6,10,14,4,10,2,2,0
442879,31,83,6,77,60,4,56,23,2,21
442888,31,22,22,0,22,22,0,,,
442930,31,111,65,46,107,61,46,4,4,0
442976,31,26,1,25,26,1,25,,,
442985,31,247,27,220,247,27,220,,,
443021,31,33,25,8,33,25,8,,,
443049,31,5,3,2,3,1,2,2,2,0
443058,31,2,1,1,1,0,1,1,1,0
443100,31,23,18,5,23,18,5,,,
443137,31,301,53,248,301,53,248,,,
443146,31,18,17,1,13,12,1,5,5,0
443207,31,18,17,1,18,17,1,,,
443216,31,50,38,12,50,38,12,,,
443225,31,13,11,2,13,11,2,,,
443234,31,102,2,100,102,2,100,,,
443252,31,1071,638,433,1071,638,433,,,
443261,31,78,2,76,61,1,60,17,1,16
443289,31,57,5,52,57,5,52,,,
443298,31,25,22,3,25,22,3,,,
443322,31,14,3,11,14,3,11,,,
443331,31,7,1,6,7,1,6,,,
443340,31,3,3,0,3,3,0,,,
443377,31,15,15,0,15,15,0,,,
443410,31,227,155,72,224,152,72,3,3,0
443492,31,298,139,159,261,128,133,37,11,26
443562,31,58,14,44,45,12,33,13,2,11
443571,31,91,50,41,91,50,41,,,
443599,31,39,3,36,5,1,4,34,2,32
443632,31,22,16,6,22,16,6,,,
443641,31,21,1,20,11,1,10,10,0,10
443650,31,449,114,335,446,113,333,3,1,2
443669,31,108,7,101,108,7,101,,,
443696,31,21,3,18,21,3,18,,,
443748,31,123,33,90,123,33,90,,,
443766,31,153,50,103,1,0,1,152,50,102
443784,31,91,29,62,,,,91,29,62
443951,31,6,2,4,6,2,4,,,
443979,31,20,0,20,11,0,11,9,0,9
444051,31,39,1,38,32,1,31,7,0,7
444088,31,21,2,19,21,2,19,,,
444194,31,3,1,2,3,1,2,,,
444219,31,1565,753,812,691,333,358,874,420,454
444228,31,12,0,12,12,0,12,,,
444255,31,23,5,18,23,5,18,,,
444264,31,4,1,3,4,1,3,,,
444282,31,31,0,31,20,0,20,11,0,11
444291,31,31,2,29,25,0,25,6,2,4
444307,31,37,3,34,26,2,24,11,1,10
444325,31,6,1,5,6,1,5,,,
444334,31,7,2,5,7,2,5,,,
444361,31,10,7,3,10,7,3,,,
444370,31,14,14,0,14,14,0,,,
444398,31,8,6,2,8,6,2,,,
444404,31,13,9,4,7,5,2,6,4,2
444413,31,54,54,0,54,54,0,,,
444440,31,15,0,15,15,0,15,,,
444468,31,10,1,9,9,1,8,1,0,1
444486,31,49,1,48,44,1,43,5,0,5
444510,31,7,0,7,7,0,7,,,
444529,31,70,14,56,70,14,56,,,
444556,31,114,48,66,114,48,66,,,
444565,31,1,0,1,1,0,1,,,
444583,31,204,101,103,204,101,103,,,
444635,31,26,4,22,5,0,5,21,4,17
444662,31,33,28,5,33,28,5,,,
444671,31,40,21,19,40,21,19,,,
444714,31,124,9,115,124,9,115,,,
444732,31,16,1,15,16,1,15,,,
444778,31,2,1,1,2,1,1,,,
444787,31,62,10,52,58,10,48,4,0,4
444796,31,18,8,10,18,8,10,,,
444811,31,261,13,248,127,6,121,134,7,127
444857,31,27,0,27,15,0,15,12,0,12
444866,31,87,14,73,60,11,49,27,3,24
444893,31,333,13,320,333,13,320,,,
444936,31,45,20,25,45,20,25,,,
444945,31,141,9,132,141,9,132,,,
444954,31,264,94,170,189,74,115,75,20,55
445027,31,1368,393,975,1138,330,808,230,63,167
445133,31,16,2,14,9,0,9,7,2,5
445188,31,2410,1191,1219,2400,1189,1211,10,2,8
445203,31,80,16,64,80,16,64,,,
445212,31,16,3,13,11,2,9,5,1,4
445230,31,148,26,122,148,26,122,,,
445249,31,69,24,45,69,24,45,,,
445267,31,4,0,4,3,0,3,1,0,1
445364,31,111,12,99,111,12,99,,,
445461,31,195,71,124,195,71,124,,,
445498,31,7,7,0,7,7,0,,,
445540,31,16,0,16,16,0,16,,,
445638,31,2,0,2,2,0,2,,,
445647,31,59,0,59,36,0,36,23,0,23
445656,31,57,3,54,37,3,34,20,0,20
445692,31,173,140,33,169,137,32,4,3,1
445708,31,421,144,277,420,143,277,1,1,0
445744,31,42,11,31,42,11,31,,,
445762,31,22,18,4,22,18,4,,,
445799,31,452,435,17,452,435,17,,,
445841,31,23,0,23,21,0,21,2,0,2
445850,31,9,0,9,4,0,4,5,0,5
445911,31,202,98,104,134,71,63,68,27,41
445948,31,381,49,332,381,49,332,,,
445957,31,171,30,141,,,,171,30,141
446048,31,377,178,199,376,178,198,1,0,1
446084,31,24,4,20,4,1,3,20,3,17
446093,31,60,5,55,53,4,49,7,1,6
446109,31,186,19,167,164,16,148,22,3,19
446118,31,109,19,90,109,19,90,,,
446127,31,46,2,44,46,2,44,,,
446163,31,351,321,30,230,215,15,121,106,15
446206,31,5,0,5,4,0,4,1,0,1
446233,31,25,19,6,24,19,5,1,0,1
446242,31,23,13,10,23,13,10,,,
446251,31,58,14,44,58,14,44,,,
446260,31,141,3,138,141,3,138,,,
446288,31,2,0,2,1,0,1,1,0,1
446303,31,4,1,3,3,0,3,1,1,0
446349,31,2,1,1,2,1,1,,,
446385,31,63,36,27,63,36,27,,,
446394,31,1,1,0,1,1,0,,,
446455,31,23,21,2,23,21,2,,,
446516,31,2,0,2,2,0,2,,,
446525,31,69,62,7,69,62,7,,,
446552,31,540,243,297,540,243,297,,,
446561,31,161,39,122,161,39,122,,,
446589,31,41,7,34,41,7,34,,,
446598,31,2,0,2,2,0,2,,,
446604,31,482,482,0,482,482,0,,,
446640,31,158,108,50,156,107,49,2,1,1
446774,31,293,132,161,198,93,105,95,39,56
447014,31,41,4,37,41,4,37,,,
447023,31,515,239,276,514,239,275,1,0,1
447148,31,56,0,56,42,0,42,14,0,14
447166,31,33,3,30,22,3,19,11,0,11
447175,31,38,1,37,27,1,26,11,0,11
447263,31,111,9,102,72,3,69,39,6,33
447351,31,80,45,35,80,45,35,,,
447421,31,5,0,5,5,0,5,,,
447449,31,32,4,28,17,2,15,15,2,13
447458,31,32,26,6,32,26,6,,,
447467,31,60,2,58,60,2,58,,,
447582,31,249,85,164,189,76,113,60,9,51
447591,31,213,24,189,213,24,189,,,
447607,31,251,117,134,251,117,134,,,
447616,31,198,98,100,198,98,100,,,
447689,31,2195,1011,1184,1770,808,962,425,203,222
447704,31,30,2,28,30,2,28,,,
447713,31,1,0,1,1,0,1,,,
447722,31,15,1,14,15,1,14,,,
447731,31,48,3,45,38,3,35,10,0,10
447759,31,23,5,18,15,3,12,8,2,6
447768,31,246,35,211,246,35,211,,,
447777,31,182,91,91,10,8,2,172,83,89
447795,31,40,8,32,40,8,32,,,
447810,31,22,0,22,22,0,22,,,
447847,31,29,27,2,29,27,2,,,
447865,31,4,1,3,1,0,1,3,1,2
447874,31,133,130,3,133,130,3,,,
447883,31,65,8,57,29,5,24,36,3,33
447892,31,41,3,38,31,3,28,10,0,10
447908,31,2,0,2,2,0,2,,,
447917,31,26,7,19,26,7,19,,,
447935,31,38,2,36,38,2,36,,,
447953,31,81,44,37,66,35,31,15,9,6
447962,31,47,4,43,47,4,43,,,
447971,31,12,0,12,12,0,12,,,
447980,31,16,1,15,10,0,10,6,1,5
447999,31,49,11,38,49,11,38,,,
448026,31,38,2,36,26,1,25,12,1,11
448071,31,108,4,104,70,2,68,38,2,36
448123,31,198,15,183,198,15,183,,,
448196,31,22,3,19,18,3,15,4,0,4
448220,31,36,1,35,36,1,35,,,
448248,31,1530,926,604,242,63,179,1288,863,425
448257,31,7,0,7,1,0,1,6,0,6
448275,31,7,1,6,7,1,6,,,
448354,31,20,1,19,19,1,18,1,0,1
448372,31,3,3,0,3,3,0,,,
448424,31,30,2,28,13,0,13,17,2,15
448433,31,497,482,15,497,482,15,,,
448594,31,483,211,272,303,129,174,180,82,98
448600,31,73,11,62,73,11,62,,,
448619,31,192,14,178,88,9,79,104,5,99
448646,31,27,0,27,27,0,27,,,
448673,31,135,16,119,78,10,68,57,6,51
448770,31,39,37,2,37,36,1,2,1,1
448798,31,73,5,68,73,5,68,,,
448859,31,33,29,4,33,29,4,,,
448895,31,503,83,420,503,83,420,,,
449038,31,53,17,36,2,1,1,51,16,35
449074,31,103,14,89,103,14,89,,,
449083,31,98,97,1,98,97,1,,,
449092,31,93,92,1,93,92,1,,,
449135,31,37,5,32,25,3,22,12,2,10
449250,31,176,30,146,176,30,146,,,
449311,31,18,0,18,8,0,8,10,0,10
449320,31,202,199,3,173,170,3,29,29,0
449339,31,1720,1219,501,60,32,28,1660,1187,473
449348,31,9,3,6,2,0,2,7,3,4
449357,31,1,0,1,1,0,1,,,
449384,31,15,8,7,15,8,7,,,
449393,31,26,10,16,26,10,16,,,
449445,31,20,2,18,20,2,18,,,
449454,31,6,3,3,,,,6,3,3
449463,31,73,9,64,59,8,51,14,1,13
449472,31,32,2,30,32,2,30,,,
449490,31,105,25,80,105,25,80,,,
449506,31,18,9,9,18,9,9,,,
449524,31,11,1,10,11,1,10,,,
449533,31,7,0,7,7,0,7,,,
449597,31,1,0,1,1,0,1,,,
449603,31,105,65,40,105,65,40,,,
449612,31,16,10,6,16,10,6,,,
449658,31,30,30,0,30,30,0,,,
449676,31,160,81,79,160,81,79,,,
449685,31,202,15,187,202,15,187,,,
449700,31,158,32,126,158,32,126,,,
449719,31,22,3,19,22,3,19,,,
449728,31,4,0,4,4,0,4,,,
449764,31,46,22,24,30,17,13,16,5,11
449773,31,163,48,115,163,48,115,,,
449782,31,18,2,16,15,1,14,3,1,2
449807,31,32,0,32,32,0,32,,,
449816,31,98,67,31,13,10,3,85,57,28
449861,31,66,2,64,66,2,64,,,
449870,31,7,2,5,6,2,4,1,0,1
449898,31,18,4,14,11,4,7,7,0,7
449904,31,156,6,150,156,6,150,,,
449959,31,26,4,22,19,1,18,7,3,4
449968,31,28,7,21,27,7,20,1,0,1
449977,31,29,2,27,18,1,17,11,1,10
449986,31,14,6,8,10,4,6,4,2,2
449995,31,5,0,5,3,0,3,2,0,2
450021,31,18,0,18,18,0,18,,,
450058,31,64,20,44,64,20,44,,,
450067,31,62,28,34,62,28,34,,,
450128,31,120,1,119,120,1,119,,,
450298,31,16,6,10,,,,16,6,10
450377,31,63,10,53,,,,63,10,53
450395,31,15,0,15,7,0,7,8,0,8
450401,31,394,33,361,394,33,361,,,
450571,31,31,4,27,14,1,13,17,3,14
450599,31,22,0,22,22,0,22,,,
450605,31,22,0,22,15,0,15,7,0,7
450614,31,33,1,32,26,1,25,7,0,7
450632,31,44,8,36,,,,44,8,36
450641,31,40,9,31,28,8,20,12,1,11
450650,31,100,6,94,43,0,43,57,6,51
450696,31,76,8,68,76,8,68,,,
450702,31,28,4,24,28,4,24,,,
450711,31,52,41,11,52,41,11,,,
450720,31,215,3,212,82,1,81,133,2,131
450933,31,248,160,88,192,118,74,56,42,14
450951,31,79,41,38,79,41,38,,,
450960,31,37,5,32,6,0,6,31,5,26
450988,31,31,7,24,23,6,17,8,1,7
451042,31,6,0,6,4,0,4,2,0,2
451051,31,29,4,25,,,,29,4,25
451097,31,36,6,30,30,4,26,6,2,4
451103,31,279,57,222,66,11,55,213,46,167
451121,31,7,0,7,4,0,4,3,0,3
451149,31,61,4,57,61,4,57,,,
451158,31,114,1,113,114,1,113,,,
451167,31,12,6,6,4,3,1,8,3,5
451194,31,4,1,3,4,1,3,,,
451228,31,47,40,7,47,40,7,,,
451237,31,49,2,47,49,2,47,,,
451255,31,15,1,14,10,0,10,5,1,4
451264,31,3,0,3,3,0,3,,,
451282,31,27,1,26,19,1,18,8,0,8
451291,31,4,1,3,,,,4,1,3
451307,31,14,1,13,2,0,2,12,1,11
451316,31,13,2,11,13,2,11,,,
451334,31,119,40,79,82,27,55,37,13,24
451343,31,10,0,10,6,0,6,4,0,4
451352,31,143,17,126,123,14,109,20,3,17
451370,31,10,10,0,10,10,0,,,
451398,31,48,48,0,48,48,0,,,
451404,31,162,162,0,162,162,0,,,
451413,31,20,3,17,20,3,17,,,
451459,31,94,18,76,43,9,34,51,9,42
451468,31,55,0,55,55,0,55,,,
451477,31,291,244,47,291,244,47,,,
451501,31,156,55,101,156,55,101,,,
451529,31,37,1,36,7,0,7,30,1,29
451547,31,10,0,10,10,0,10,,,
451556,31,887,318,569,887,318,569,,,
451565,31,33,6,27,33,6,27,,,
451574,31,49,0,49,36,0,36,13,0,13
451583,31,124,94,30,15,14,1,109,80,29
451626,31,6,2,4,5,2,3,1,0,1
451714,31,28,0,28,28,0,28,,,
451741,31,20,5,15,20,5,15,,,
451750,31,137,62,75,133,62,71,4,0,4
451820,31,13,3,10,7,2,5,6,1,5
451857,31,23,4,19,23,4,19,,,
451866,31,120,21,99,120,21,99,,,
451918,31,24,0,24,24,0,24,,,
451927,31,105,54,51,96,50,46,9,4,5
452009,31,17,0,17,17,0,17,,,
452072,31,15,1,14,15,1,14,,,
452081,31,276,10,266,276,10,266,,,
452106,31,17,16,1,17,16,1,,,
452124,31,50,17,33,50,17,33,,,
452373,31,11,0,11,11,0,11,,,
452771,31,14,1,13,,,,14,1,13
452780,31,10,0,10,,,,10,0,10
452887,31,17,17,0,17,17,0,,,
452948,31,286,28,258,143,13,130,143,15,128
453163,31,114,35,79,2,1,1,112,34,78
453215,31,20,6,14,1,0,1,19,6,13
453297,31,19,6,13,19,6,13,,,
453756,31,65,44,21,65,44,21,,,
453792,31,29,2,27,29,2,27,,,
454184,31,57,21,36,56,21,35,1,0,1
454227,31,16,5,11,13,4,9,3,1,2
454236,31,1,0,1,1,0,1,,,
454245,31,3,1,2,2,1,1,1,0,1
454458,31,1,0,1,1,0,1,,,
454537,31,55,0,55,55,0,55,,,
454546,31,157,7,150,157,7,150,,,
454555,31,229,17,212,229,17,212,,,
454607,31,40,0,40,40,0,40,,,
454616,31,30,25,5,30,25,5,,,
454652,31,12,0,12,12,0,12,,,
454698,31,58,19,39,58,19,39,,,
454722,31,2,0,2,2,0,2,,,
454759,31,4,4,0,3,3,0,1,1,0
454768,31,15,2,13,12,2,10,3,0,3
454777,31,10,2,8,8,2,6,2,0,2
454786,31,101,62,39,49,30,19,52,32,20
454795,31,37,13,24,32,11,21,5,2,3
454801,31,17,3,14,17,3,14,,,
454810,31,2006,566,1440,2006,566,1440,,,
454829,31,2679,328,2351,909,112,797,1770,216,1554
454865,31,181,29,152,147,24,123,34,5,29
454874,31,40,5,35,26,4,22,14,1,13
454917,31,228,29,199,147,17,130,81,12,69
454926,31,23,0,23,23,0,23,,,
454935,31,56,1,55,56,1,55,,,
454944,31,27,6,21,27,6,21,,,
454953,31,12,0,12,8,0,8,4,0,4
454962,31,27,0,27,18,0,18,9,0,9
454971,31,1,0,1,1,0,1,,,
454980,31,3,0,3,,,,3,0,3
454999,31,2,0,2,1,0,1,1,0,1
455008,31,5,1,4,4,1,3,1,0,1
455026,31,38,32,6,,,,38,32,6
455062,31,10,0,10,6,0,6,4,0,4
455071,31,23,8,15,,,,23,8,15
455080,31,2,0,2,2,0,2,,,
455105,31,3,0,3,3,0,3,,,
455114,31,1562,764,798,805,413,392,757,351,406
455141,31,32,0,32,32,0,32,,,
455187,31,51,12,39,30,8,22,21,4,17
455196,31,165,19,146,165,19,146,,,
455202,31,34,4,30,18,1,17,16,3,13
455211,31,52,2,50,52,2,50,,,
455220,31,50,7,43,50,7,43,,,
455257,31,60,60,0,60,60,0,,,
455275,31,30,0,30,30,0,30,,,
455284,31,36,0,36,30,0,30,6,0,6
455327,31,15,1,14,15,1,14,,,
455336,31,41,35,6,41,35,6,,,
455354,31,15,0,15,15,0,15,,,
455381,31,83,0,83,76,0,76,7,0,7
455460,31,32,9,23,32,9,23,,,
455479,31,22,3,19,21,3,18,1,0,1
455488,31,77,20,57,77,20,57,,,
455512,31,460,182,278,184,68,116,276,114,162
455558,31,44,8,36,44,8,36,,,
455628,31,76,27,49,76,27,49,,,
455664,31,16,1,15,2,0,2,14,1,13
455725,31,449,9,440,365,7,358,84,2,82
455734,31,71,18,53,71,18,53,,,
455761,31,54,8,46,42,8,34,12,0,12
455770,31,35,22,13,35,22,13,,,
455798,31,19,0,19,11,0,11,8,0,8
455831,31,12,3,9,12,3,9,,,
455859,31,46,1,45,37,1,36,9,0,9
455868,31,39,5,34,39,5,34,,,
455877,31,13,0,13,13,0,13,,,
455886,31,5,0,5,2,0,2,3,0,3
455895,31,8,1,7,6,1,5,2,0,2
455901,31,22,0,22,7,0,7,15,0,15
455910,31,34,12,22,34,12,22,,,
455929,31,13,0,13,13,0,13,,,
455965,31,28,1,27,28,1,27,,,
455974,31,81,6,75,81,6,75,,,
455983,31,110,29,81,105,28,77,5,1,4
456001,31,59,52,7,59,52,7,,,
456029,31,7,1,6,7,1,6,,,
456038,31,72,7,65,72,7,65,,,
456065,31,22,0,22,22,0,22,,,
456074,31,18,1,17,18,1,17,,,
456135,31,46,0,46,26,0,26,20,0,20
456153,31,17,15,2,17,15,2,,,
456205,31,31,15,16,31,15,16,,,
456214,31,67,49,18,67,49,18,,,
456287,31,46,0,46,46,0,46,,,
456454,31,37,20,17,33,19,14,4,1,3
456481,31,7,2,5,,,,7,2,5
456490,31,11,8,3,4,2,2,7,6,1
456506,31,46,1,45,46,1,45,,,
456515,31,23,1,22,23,1,22,,,
456551,31,27,0,27,27,0,27,,,
456579,31,59,31,28,59,31,28,,,
456588,31,18,2,16,8,2,6,10,0,10
456597,31,40,1,39,17,0,17,23,1,22
456621,31,9,4,5,,,,9,4,5
456825,31,10,0,10,10,0,10,,,
456852,31,31,5,26,31,5,26,,,
456922,31,64,19,45,60,19,41,4,0,4
456931,31,57,33,24,57,33,24,,,
456959,31,174,26,148,171,25,146,3,1,2
456968,31,77,0,77,75,0,75,2,0,2
456977,31,35,20,15,35,20,15,,,
457031,31,4,0,4,2,0,2,2,0,2
457077,31,347,31,316,347,31,316,,,
457086,31,3,2,1,3,2,1,,,
457101,31,37,12,25,37,12,25,,,
457110,31,25,4,21,25,4,21,,,
457129,31,5,1,4,3,0,3,2,1,1
457192,31,7,0,7,7,0,7,,,
457208,31,38,35,3,38,35,3,,,
457226,31,6,2,4,6,2,4,,,
457253,31,16,0,16,,,,16,0,16
457299,31,15,2,13,15,2,13,,,
457314,31,23,3,20,23,3,20,,,
457323,31,34,8,26,34,8,26,,,
457332,31,10,1,9,10,1,9,,,
457341,31,35,1,34,35,1,34,,,
457378,31,89,40,49,34,13,21,55,27,28
457387,31,44,31,13,44,31,13,,,
457396,31,60,13,47,11,3,8,49,10,39
457402,31,32,30,2,28,26,2,4,4,0
457411,31,30,28,2,30,28,2,,,
457420,31,3,0,3,3,0,3,,,
457439,31,22,0,22,9,0,9,13,0,13
457448,31,14,5,9,14,5,9,,,
457466,31,15,10,5,15,10,5,,,
457475,31,25,0,25,25,0,25,,,
457484,31,6,1,5,3,1,2,3,0,3
457493,31,17,1,16,17,1,16,,,
457536,31,38,9,29,38,9,29,,,
457545,31,13,1,12,9,0,9,4,1,3
457554,31,23,0,23,14,0,14,9,0,9
457563,31,40,0,40,40,0,40,,,
457572,31,16,0,16,16,0,16,,,
457581,31,23,1,22,23,1,22,,,
457606,31,86,9,77,86,9,77,,,
457615,31,2,0,2,,,,2,0,2
457624,31,11,3,8,11,3,8,,,
457633,31,65,2,63,34,1,33,31,1,30
457642,31,13,0,13,13,0,13,,,
457679,31,4,1,3,4,1,3,,,
457688,31,4,3,1,3,2,1,1,1,0
457697,31,12,5,7,1,0,1,11,5,6
457721,31,9,0,9,9,0,9,,,
457749,31,23,0,23,23,0,23,,,
457767,31,60,43,17,60,43,17,,,
457776,31,28,2,26,28,2,26,,,
457785,31,35,0,35,35,0,35,,,
457794,31,75,2,73,75,2,73,,,
457800,31,89,11,78,89,11,78,,,
457819,31,141,65,76,,,,141,65,76
457837,31,30,0,30,17,0,17,13,0,13
457855,31,5,0,5,5,0,5,,,
457873,31,14,7,7,,,,14,7,7
457916,31,53,0,53,28,0,28,25,0,25
457943,31,26,8,18,26,8,18,,,
457952,31,22,0,22,20,0,20,2,0,2
457989,31,28,1,27,28,1,27,,,
457998,31,9,0,9,6,0,6,3,0,3
458007,31,46,3,43,23,2,21,23,1,22
458034,31,18,3,15,18,3,15,,,
458043,31,22,0,22,20,0,20,2,0,2
458061,31,23,3,20,12,2,10,11,1,10
458070,31,37,2,35,35,2,33,2,0,2
458098,31,13,0,13,12,0,12,1,0,1
458104,31,1,0,1,1,0,1,,,
458113,31,14,12,2,,,,14,12,2
458122,31,2,0,2,2,0,2,,,
458131,31,102,7,95,102,7,95,,,
458140,31,10,7,3,10,7,3,,,
458168,31,15,0,15,15,0,15,,,
458210,31,6,1,5,6,1,5,,,
458229,31,9,2,7,9,2,7,,,
458274,31,17,1,16,12,1,11,5,0,5
458405,31,59,27,32,59,27,32,,,
458423,31,7,2,5,7,2,5,,,
458441,31,56,10,46,56,10,46,,,
458496,31,7,1,6,2,0,2,5,1,4
458681,31,18,6,12,18,6,12,,,
458803,31,57,2,55,43,2,41,14,0,14
458812,31,39,3,36,32,2,30,7,1,6
458821,31,24,0,24,24,0,24,,,
458830,31,62,3,59,46,2,44,16,1,15
458858,31,53,3,50,23,0,23,30,3,27
458867,31,77,3,74,57,2,55,20,1,19
458885,31,32,15,17,1,1,0,31,14,17
458919,31,182,54,128,5,0,5,177,54,123
458955,31,22,7,15,1,0,1,21,7,14
458964,31,75,17,58,1,0,1,74,17,57
458973,31,121,36,85,3,1,2,118,35,83
458982,31,20,9,11,10,5,5,10,4,6
459019,31,36,1,35,32,0,32,4,1,3
459046,31,21,0,21,14,0,14,7,0,7
459055,31,33,2,31,21,2,19,12,0,12
459064,31,27,1,26,18,1,17,9,0,9
459116,31,13,1,12,13,1,12,,,
459125,31,5,0,5,5,0,5,,,
459170,31,34,1,33,18,1,17,16,0,16
459189,31,2,0,2,,,,2,0,2
459198,31,11,5,6,10,5,5,1,0,1
459204,31,316,47,269,316,47,269,,,
459213,31,137,18,119,137,18,119,,,
459231,31,41,5,36,41,5,36,,,
459259,31,19,6,13,8,1,7,11,5,6
459268,31,10,2,8,6,1,5,4,1,3
459277,31,140,6,134,140,6,134,,,
459286,31,12,2,10,12,2,10,,,
459295,31,39,0,39,23,0,23,16,0,16
459301,31,9,0,9,8,0,8,1,0,1
459310,31,8,0,8,8,0,8,,,
459329,31,146,82,64,146,82,64,,,
459347,31,21,2,19,11,1,10,10,1,9
459374,31,66,1,65,18,0,18,48,1,47
459392,31,30,2,28,15,1,14,15,1,14
459408,31,14,1,13,11,1,10,3,0,3
459417,31,14,8,6,14,8,6,,,
459426,31,111,4,107,111,4,107,,,
459462,31,76,68,8,76,68,8,,,
459499,31,11,2,9,11,2,9,,,
459514,31,29,9,20,29,9,20,,,
459523,31,19,1,18,19,1,18,,,
459532,31,38,0,38,2,0,2,36,0,36
459541,31,6,0,6,4,0,4,2,0,2
459550,31,12,0,12,12,0,12,,,
459578,31,13,2,11,9,1,8,4,1,3
459727,31,34,5,29,29,4,25,5,1,4
459842,31,47,8,39,30,4,26,17,4,13
459851,31,37,5,32,23,3,20,14,2,12
459949,31,1058,373,685,936,323,613,122,50,72
459958,31,49,12,37,49,12,37,,,
459967,31,521,185,336,521,185,336,,,
459985,31,383,203,180,383,203,180,,,
459994,31,478,171,307,6,3,3,472,168,304
460011,31,16,0,16,12,0,12,4,0,4
460020,31,49,17,32,49,17,32,,,
460093,31,20,0,20,20,0,20,,,
460109,31,63,1,62,63,1,62,,,
460118,31,53,1,52,53,1,52,,,
460127,31,29,1,28,29,1,28,,,
460136,31,250,37,213,250,37,213,,,
460145,31,87,47,40,87,47,40,,,
460172,31,120,114,6,120,114,6,,,
460181,31,192,22,170,192,22,170,,,
460190,31,61,4,57,61,4,57,,,
460206,31,144,31,113,144,31,113,,,
460349,31,79,33,46,13,7,6,66,26,40
460385,31,24,3,21,24,3,21,,,
460394,31,1191,517,674,434,203,231,757,314,443
460464,31,1117,588,529,472,260,212,645,328,317
460482,31,56,10,46,56,10,46,,,
460516,31,127,7,120,127,7,120,,,
460525,31,104,8,96,104,8,96,,,
460534,31,354,12,342,354,12,342,,,
460543,31,847,816,31,847,816,31,,,
460677,31,52,11,41,51,10,41,1,1,0
460701,31,92,18,74,28,4,24,64,14,50
460756,31,264,20,244,221,18,203,43,2,41
460765,31,40,0,40,40,0,40,,,
460808,31,22,5,17,22,5,17,,,
460817,31,44,25,19,44,25,19,,,
460826,31,99,43,56,99,43,56,,,
460835,31,71,34,37,71,34,37,,,
460862,31,15,0,15,8,0,8,7,0,7
460871,31,4,0,4,4,0,4,,,
460914,31,35,0,35,35,0,35,,,
460932,31,37,0,37,37,0,37,,,
460969,31,32,1,31,32,1,31,,,
460978,31,137,4,133,79,2,77,58,2,56
460987,31,36,1,35,36,1,35,,,
460996,31,27,0,27,20,0,20,7,0,7
461014,31,220,10,210,220,10,210,,,
461023,31,46,6,40,43,5,38,3,1,2
461032,31,1,0,1,1,0,1,,,
461087,31,832,430,402,44,18,26,788,412,376
461111,31,19,16,3,12,10,2,7,6,1
461148,31,233,130,103,233,130,103,,,
461175,31,45,7,38,35,6,29,10,1,9
461193,31,74,0,74,74,0,74,,,
461218,31,69,9,60,69,9,60,,,
461245,31,68,27,41,32,15,17,36,12,24
461254,31,4,1,3,4,1,3,,,
461263,31,9,1,8,9,1,8,,,
461272,31,10,0,10,5,0,5,5,0,5
461306,31,53,14,39,3,0,3,50,14,36
461315,31,26,6,20,9,4,5,17,2,15
461333,31,5,4,1,,,,5,4,1
461342,31,83,0,83,56,0,56,27,0,27
461379,31,12,1,11,3,0,3,9,1,8
461388,31,19,4,15,19,4,15,,,
461412,31,74,23,51,,,,74,23,51
461421,31,37,1,36,37,1,36,,,
461430,31,189,180,9,,,,189,180,9
461494,31,30,3,27,23,1,22,7,2,5
461500,31,4,2,2,2,1,1,2,1,1
461528,31,12,8,4,7,3,4,5,5,0
461537,31,9,1,8,9,1,8,,,
461555,31,20,4,16,20,4,16,,,
461573,31,56,55,1,56,55,1,,,
461582,31,24,0,24,24,0,24,,,
461591,31,14,0,14,14,0,14,,,
461607,31,13,3,10,6,2,4,7,1,6
461625,31,5,4,1,5,4,1,,,
461652,31,18,0,18,18,0,18,,,
461689,31,66,4,62,66,4,62,,,
461704,31,97,6,91,97,6,91,,,
461713,31,27,0,27,8,0,8,19,0,19
461722,31,45,2,43,45,2,43,,,
461740,31,6,3,3,6,3,3,,,
461759,31,22,16,6,18,14,4,4,2,2
461768,31,49,0,49,49,0,49,,,
461786,31,27,0,27,27,0,27,,,
461795,31,93,75,18,89,72,17,4,3,1
461810,31,15,5,10,13,4,9,2,1,1
461829,31,51,6,45,51,6,45,,,
461838,31,121,0,121,50,0,50,71,0,71
461847,31,15,15,0,15,15,0,,,
461856,31,127,43,84,127,43,84,,,
461865,31,30,5,25,30,5,25,,,
461874,31,39,4,35,39,4,35,,,
461883,31,5,2,3,4,1,3,1,1,0
461892,31,39,3,36,39,3,36,,,
461908,31,29,0,29,29,0,29,,,
461917,31,49,0,49,18,0,18,31,0,31
461926,31,90,1,89,75,1,74,15,0,15
461944,31,13,1,12,13,1,12,,,
461953,31,3,0,3,3,0,3,,,
461962,31,163,122,41,133,92,41,30,30,0
461999,31,89,3,86,78,3,75,11,0,11
462008,31,9,1,8,9,1,8,,,
462017,31,47,4,43,47,4,43,,,
462035,31,240,102,138,76,4,72,164,98,66
462053,31,16,4,12,16,4,12,,,
462062,31,18,1,17,14,1,13,4,0,4
462071,31,13,5,8,13,5,8,,,
462336,31,8,0,8,8,0,8,,,
462345,31,13,0,13,6,0,6,7,0,7
462354,31,112,62,50,105,57,48,7,5,2
463056,31,555,286,269,544,279,265,11,7,4
464226,31,262,163,99,238,144,94,24,19,5
466921,31,3,0,3,3,0,3,,,
466930,31,7,2,5,6,2,4,1,0,1
467094,31,23,0,23,23,0,23,,,
467863,31,21,2,19,17,2,15,4,0,4
467872,31,19,0,19,14,0,14,5,0,5
467906,31,8,0,8,5,0,5,3,0,3
468246,31,31,1,30,31,1,30,,,
468255,31,2,1,1,2,1,1,,,
468291,31,15,0,15,15,0,15,,,
468769,31,41,40,1,41,40,1,,,
468848,31,174,94,80,174,94,80,,,
468893,31,10,0,10,10,0,10,,,
468909,31,192,76,116,192,76,116,,,
468963,31,210,186,24,210,186,24,,,
469416,31,24,7,17,17,5,12,7,2,5
469610,31,14,4,10,14,4,10,,,
469629,31,46,37,9,46,37,9,,,
469911,31,43,3,40,43,3,40,,,
469957,31,9,0,9,9,0,9,,,
470038,31,238,95,143,238,95,143,,,
470047,31,1,1,0,1,1,0,,,
470296,31,12,0,12,12,0,12,,,
470393,31,20,0,20,10,0,10,10,0,10
474863,31,31,3,28,20,2,18,11,1,10
474915,31,255,5,250,162,3,159,93,2,91
474924,31,111,1,110,20,0,20,91,1,90
475015,31,45,0,45,45,0,45,,,
475024,31,63,20,43,63,20,43,,,
475060,31,36,4,32,35,4,31,1,0,1
475121,31,285,102,183,238,74,164,47,28,19
475176,31,51,24,27,51,24,27,,,
475282,31,5,1,4,5,1,4,,,
475325,31,200,11,189,200,11,189,,,
475398,31,4,2,2,,,,4,2,2
475404,31,19,0,19,17,0,17,2,0,2
475413,31,40,3,37,29,3,26,11,0,11
475431,31,26,2,24,26,2,24,,,
475468,31,4,1,3,3,1,2,1,0,1
475477,31,11,0,11,3,0,3,8,0,8
475486,31,59,5,54,59,5,54,,,
475547,31,23,3,20,21,3,18,2,0,2
475556,31,17,1,16,10,0,10,7,1,6
475565,31,437,246,191,437,246,191,,,
475574,31,4,2,2,1,0,1,3,2,1
475608,31,13,8,5,11,7,4,2,1,1
475635,31,3,2,1,,,,3,2,1
475653,31,18,3,15,16,1,15,2,2,0
475662,31,11,1,10,3,1,2,8,0,8
475714,31,129,107,22,92,75,17,37,32,5
475723,31,252,151,101,82,36,46,170,115,55
475732,31,5,0,5,5,0,5,,,
475741,31,4,0,4,1,0,1,3,0,3
475839,31,32,15,17,17,11,6,15,4,11
476063,31,101,94,7,101,94,7,,,
476179,31,70,4,66,53,4,49,17,0,17
476230,31,18,2,16,18,2,16,,,
476294,31,11,0,11,,,,11,0,11
476489,31,15,12,3,15,12,3,,,
476498,31,34,23,11,34,23,11,,,
476513,31,9,0,9,9,0,9,,,
476540,31,1,0,1,1,0,1,,,
476568,31,13,10,3,13,10,3,,,
476595,31,44,5,39,44,5,39,,,
476601,31,30,30,0,30,30,0,,,
476610,31,3,2,1,3,2,1,,,
476629,31,25,0,25,25,0,25,,,
476683,31,20,1,19,20,1,19,,,
476692,31,17,17,0,17,17,0,,,
476708,31,21,17,4,7,6,1,14,11,3
476717,31,153,153,0,153,153,0,,,
476726,31,82,24,58,82,24,58,,,
476735,31,42,19,23,12,7,5,30,12,18
476753,31,40,1,39,12,1,11,28,0,28
476780,31,9,4,5,5,3,2,4,1,3
476799,31,44,6,38,44,6,38,,,
476805,31,7,0,7,7,0,7,,,
476814,31,156,102,54,,,,156,102,54
476841,31,16,0,16,11,0,11,5,0,5
476850,31,17,11,6,17,11,6,,,
476869,31,76,6,70,76,6,70,,,
476878,31,59,0,59,9,0,9,50,0,50
476887,31,524,15,509,518,14,504,6,1,5
476896,31,22,1,21,22,1,21,,,
476902,31,2,0,2,2,0,2,,,
476939,31,140,19,121,140,19,121,,,
476948,31,86,69,17,86,69,17,,,
476957,31,7,1,6,7,1,6,,,
476966,31,41,33,8,41,33,8,,,
476975,31,99,43,56,18,6,12,81,37,44
476984,31,20,0,20,16,0,16,4,0,4
476993,31,64,0,64,64,0,64,,,
477002,31,22,3,19,21,3,18,1,0,1
477039,31,3,0,3,2,0,2,1,0,1
478582,31,61,1,60,48,1,47,13,0,13
478591,31,105,1,104,80,0,80,25,1,24
478616,31,44,2,42,33,1,32,11,1,10
478917,31,29,2,27,29,2,27,,,
478953,31,39,2,37,39,2,37,,,
479062,31,15,15,0,15,15,0,,,
479424,31,44,7,37,44,7,37,,,
479965,31,1,0,1,1,0,1,,,
479974,31,22,1,21,18,1,17,4,0,4
479983,31,15,2,13,15,2,13,,,
480000,31,9,6,3,9,6,3,,,
480019,31,530,485,45,487,445,42,43,40,3
480028,31,28,27,1,28,27,1,,,
480037,31,385,316,69,385,316,69,,,
480073,31,17,7,10,11,4,7,6,3,3
480091,31,675,107,568,645,103,542,30,4,26
480125,31,188,3,185,95,0,95,93,3,90
480161,31,1,0,1,1,0,1,,,
480198,31,4,1,3,2,1,1,2,0,2
480204,31,46,10,36,46,10,36,,,
480310,31,36,0,36,27,0,27,9,0,9
480347,31,3,0,3,3,0,3,,,
480471,31,151,36,115,151,36,115,,,
480523,31,62,1,61,62,1,61,,,
480532,31,11,1,10,11,1,10,,,
480550,31,28,1,27,28,1,27,,,
480569,31,49,23,26,36,16,20,13,7,6
480657,31,35,7,28,20,4,16,15,3,12
480693,31,23,7,16,21,6,15,2,1,1
480727,31,28,24,4,28,24,4,,,
480781,31,13,10,3,13,10,3,,,
480824,31,173,18,155,173,18,155,,,
480833,31,252,23,229,252,23,229,,,
480842,31,10,4,6,10,4,6,,,
480851,31,26,20,6,26,20,6,,,
480879,31,7,0,7,7,0,7,,,
480888,31,38,6,32,38,6,32,,,
480903,31,225,194,31,184,155,29,41,39,2
480912,31,1,0,1,1,0,1,,,
480921,31,8,4,4,8,4,4,,,
480930,31,8,0,8,6,0,6,2,0,2
480967,31,80,29,51,42,18,24,38,11,27
480976,31,10,2,8,10,2,8,,,
480985,31,5,0,5,5,0,5,,,
480994,31,16,0,16,11,0,11,5,0,5
481003,31,73,67,6,73,67,6,,,
481021,31,34,28,6,32,27,5,2,1,1
481058,31,7,1,6,4,1,3,3,0,3
481100,31,91,18,73,19,4,15,72,14,58
481128,31,20,3,17,16,2,14,4,1,3
481137,31,35,16,19,35,16,19,,,
481146,31,127,17,110,68,9,59,59,8,51
481155,31,22,9,13,22,9,13,,,
481182,31,36,4,32,36,4,32,,,
481191,31,70,2,68,70,2,68,,,
481207,31,51,11,40,51,11,40,,,
481225,31,3,1,2,2,1,1,1,0,1
481243,31,30,0,30,16,0,16,14,0,14
481252,31,1,0,1,1,0,1,,,
481289,31,1,0,1,1,0,1,,,
481298,31,7,0,7,7,0,7,,,
481313,31,45,1,44,31,1,30,14,0,14
481322,31,31,2,29,10,0,10,21,2,19
481331,31,37,31,6,36,30,6,1,1,0
481340,31,33,0,33,33,0,33,,,
481368,31,2,0,2,2,0,2,,,
481386,31,308,40,268,,,,308,40,268
481401,31,32,16,16,5,4,1,27,12,15
481410,31,24,24,0,24,24,0,,,
481429,31,56,3,53,56,3,53,,,
481438,31,26,26,0,26,26,0,,,
481447,31,26,3,23,15,2,13,11,1,10
481456,31,4,1,3,,,,4,1,3
481465,31,7,1,6,7,1,6,,,
481474,31,2,0,2,1,0,1,1,0,1
481483,31,52,2,50,31,1,30,21,1,20
481508,31,13,1,12,13,1,12,,,
481517,31,6,0,6,3,0,3,3,0,3
481526,31,22,0,22,21,0,21,1,0,1
481571,31,2,0,2,2,0,2,,,
481678,31,34,0,34,25,0,25,9,0,9
481720,31,2,0,2,1,0,1,1,0,1
481739,31,29,3,26,24,2,22,5,1,4
481748,31,49,0,49,39,0,39,10,0,10
481775,31,28,7,21,28,7,21,,,
481845,31,35,0,35,24,0,24,11,0,11
481863,31,31,1,30,31,1,30,,,
481890,31,60,3,57,60,3,57,,,
481906,31,39,1,38,39,1,38,,,
481960,31,54,49,5,54,49,5,,,
482015,31,619,390,229,619,390,229,,,
482060,31,238,20,218,238,20,218,,,
482097,31,85,48,37,81,47,34,4,1,3
482149,31,1044,356,688,1018,351,667,26,5,21
482158,31,1024,544,480,867,479,388,157,65,92
482167,31,99,2,97,40,2,38,59,0,59
482176,31,42,2,40,34,1,33,8,1,7
482185,31,54,40,14,54,40,14,,,
482194,31,89,16,73,74,14,60,15,2,13
482200,31,21,3,18,21,3,18,,,
482228,31,11,8,3,5,3,2,6,5,1
482246,31,16,14,2,16,14,2,,,
482255,31,35,32,3,35,32,3,,,
482291,31,236,92,144,236,92,144,,,
482413,31,54,14,40,33,8,25,21,6,15
482422,31,5,4,1,2,2,0,3,2,1
482431,31,101,64,37,61,37,24,40,27,13
482459,31,31,16,15,21,10,11,10,6,4
482468,31,49,31,18,31,20,11,18,11,7
482477,31,1971,745,1226,934,318,616,1037,427,610
482538,31,1,0,1,1,0,1,,,
482547,31,1,1,0,1,1,0,,,
482556,31,8,5,3,7,4,3,1,1,0
482565,31,2,1,1,1,0,1,1,1,0
482574,31,20,9,11,14,8,6,6,1,5
482608,31,3,1,2,2,1,1,1,0,1
482635,31,9,4,5,6,4,2,3,0,3
482653,31,2,1,1,1,0,1,1,1,0
482680,31,4067,1852,2215,3759,1728,2031,308,124,184
482699,31,507,214,293,411,186,225,96,28,68
482936,31,532,440,92,496,411,85,36,29,7
482963,31,52,6,46,52,6,46,,,
482981,31,25,21,4,22,18,4,3,3,0
482990,31,61,7,54,61,7,54,,,
483009,31,251,31,220,251,31,220,,,
483018,31,30,7,23,30,7,23,,,
483036,31,33,16,17,11,7,4,22,9,13
483045,31,800,334,466,270,122,148,530,212,318
483054,31,13,13,0,13,13,0,,,
483106,31,24,1,23,19,1,18,5,0,5
483124,31,2580,796,1784,,,,2580,796,1784
483212,31,689,345,344,465,247,218,224,98,126
483230,31,26,26,0,25,25,0,1,1,0
483258,31,2,1,1,2,1,1,,,
483276,31,20,18,2,20,18,2,,,
483328,31,7,0,7,6,0,6,1,0,1
483337,31,16,0,16,12,0,12,4,0,4
483346,31,11,1,10,11,1,10,,,
483355,31,11,0,11,11,0,11,,,
483364,31,10,0,10,10,0,10,,,
483373,31,16,1,15,7,0,7,9,1,8
483382,31,108,108,0,108,108,0,,,
483425,31,6,0,6,6,0,6,,,
483443,31,65,54,11,65,54,11,,,
483470,31,10,1,9,10,1,9,,,
483504,31,74,22,52,74,22,52,,,
483513,31,17,10,7,17,10,7,,,
483559,31,24,6,18,15,5,10,9,1,8
483577,31,4,0,4,2,0,2,2,0,2
483595,31,817,167,650,349,63,286,468,104,364
483647,31,5,1,4,5,1,4,,,
483708,31,187,37,150,65,4,61,122,33,89
483726,31,10,0,10,2,0,2,8,0,8
483735,31,27,1,26,16,1,15,11,0,11
483744,31,5,4,1,5,4,1,,,
483753,31,25,23,2,7,7,0,18,16,2
483780,31,18,12,6,18,12,6,,,
483799,31,16,2,14,16,2,14,,,
483814,31,26,3,23,26,3,23,,,
483823,31,117,93,24,117,93,24,,,
483841,31,23,4,19,23,4,19,,,
483850,31,4,1,3,4,1,3,,,
483869,31,66,20,46,66,20,46,,,
483878,31,66,2,64,66,2,64,,,
483887,31,5,0,5,5,0,5,,,
483896,31,73,1,72,13,0,13,60,1,59
483911,31,13,0,13,13,0,13,,,
483920,31,108,66,42,108,66,42,,,
483948,31,17,13,4,13,9,4,4,4,0
483957,31,18,5,13,18,5,13,,,
484002,31,283,22,261,269,20,249,14,2,12
484011,31,17,1,16,14,1,13,3,0,3
484020,31,34,26,8,20,16,4,14,10,4
484039,31,37,30,7,37,30,7,,,
484048,31,4,2,2,4,2,2,,,
484057,31,75,4,71,27,2,25,48,2,46
484066,31,57,3,54,57,3,54,,,
484075,31,42,33,9,29,22,7,13,11,2
484084,31,25,1,24,10,0,10,15,1,14
484093,31,9,0,9,5,0,5,4,0,4
484109,31,17,0,17,17,0,17,,,
484127,31,35,4,31,35,4,31,,,
484136,31,8,1,7,8,1,7,,,
484163,31,139,38,101,82,20,62,57,18,39
484172,31,10,2,8,10,2,8,,,
484190,31,18,14,4,18,14,4,,,
484206,31,126,5,121,55,4,51,71,1,70
484233,31,83,42,41,,,,83,42,41
484330,31,15,0,15,15,0,15,,,
484349,31,54,4,50,54,4,50,,,
484358,31,28,1,27,28,1,27,,,
484367,31,70,14,56,70,14,56,,,
484376,31,88,12,76,88,12,76,,,
484394,31,18,2,16,15,2,13,3,0,3
484473,31,1060,557,503,979,525,454,81,32,49
484604,31,149,3,146,88,2,86,61,1,60
484613,31,1874,749,1125,1874,749,1125,,,
484826,31,2,0,2,2,0,2,,,
484835,31,4,0,4,4,0,4,,,
484844,31,185,84,101,185,84,101,,,
484871,31,31,31,0,31,31,0,,,
484899,31,90,1,89,90,1,89,,,
484905,31,366,127,239,291,92,199,75,35,40
484923,31,11,0,11,11,0,11,,,
484932,31,336,137,199,266,108,158,70,29,41
484950,31,25,2,23,25,2,23,,,
484996,31,88,2,86,88,2,86,,,
485014,31,39,1,38,29,1,28,10,0,10
485032,31,30,1,29,21,1,20,9,0,9
485111,31,936,520,416,782,446,336,154,74,80
485139,31,65,53,12,65,53,12,,,
485166,31,7,2,5,7,2,5,,,
485236,31,12,0,12,5,0,5,7,0,7
485272,31,11,3,8,8,2,6,3,1,2
485306,31,7,0,7,7,0,7,,,
485342,31,44,30,14,44,30,14,,,
485360,31,5,1,4,5,1,4,,,
485379,31,116,31,85,116,31,85,,,
485388,31,123,21,102,123,21,102,,,
485397,31,52,5,47,46,5,41,6,0,6
485412,31,20,4,16,20,4,16,,,
485458,31,269,112,157,61,33,28,208,79,129
485476,31,15,0,15,15,0,15,,,
485485,31,61,6,55,61,6,55,,,
485494,31,56,45,11,56,45,11,,,
485500,31,37,35,2,6,6,0,31,29,2
485519,31,20,16,4,5,4,1,15,12,3
485546,31,26,18,8,,,,26,18,8
485564,31,6,3,3,6,3,3,,,
485573,31,28,4,24,21,4,17,7,0,7
485591,31,10,0,10,10,0,10,,,
485607,31,16,3,13,11,2,9,5,1,4
485698,31,58,49,9,58,49,9,,,
485704,31,1,0,1,,,,1,0,1
485768,31,139,123,16,139,123,16,,,
485801,31,43,3,40,43,3,40,,,
485874,31,41,0,41,23,0,23,18,0,18
485926,31,63,16,47,61,15,46,2,1,1
485953,31,57,49,8,57,49,8,,,
485962,31,4,3,1,3,2,1,1,1,0
485999,31,24,24,0,24,24,0,,,
486017,31,4,4,0,4,4,0,,,
486026,31,19,19,0,19,19,0,,,
486053,31,30,13,17,22,10,12,8,3,5
486105,31,6,0,6,6,0,6,,,
486123,31,4,2,2,4,2,2,,,
486150,31,56,29,27,43,23,20,13,6,7
486169,31,32,25,7,32,25,7,,,
486196,31,75,75,0,75,75,0,,,
486202,31,5,1,4,5,1,4,,,
486239,31,7,3,4,6,2,4,1,1,0
486248,31,61,8,53,61,8,53,,,
486257,31,45,21,24,37,15,22,8,6,2
486284,31,67,17,50,64,17,47,3,0,3
486309,31,3,1,2,3,1,2,,,
486345,31,61,61,0,28,28,0,33,33,0
486354,31,11,5,6,11,5,6,,,
486372,31,11,8,3,8,7,1,3,1,2
486381,31,57,6,51,57,6,51,,,
486390,31,60,30,30,60,30,30,,,
486406,31,8,2,6,8,2,6,,,
486415,31,62,15,47,62,15,47,,,
486424,31,37,2,35,34,1,33,3,1,2
486442,31,4,0,4,4,0,4,,,
486488,31,2,2,0,2,2,0,,,
486497,31,3,2,1,3,2,1,,,
486503,31,16,0,16,16,0,16,,,
486512,31,94,62,32,94,62,32,,,
486530,31,19,1,18,19,1,18,,,
486558,31,38,36,2,38,36,2,,,
486567,31,39,2,37,39,2,37,,,
486576,31,91,20,71,91,20,71,,,
486594,31,8,4,4,6,3,3,2,1,1
486619,31,2,0,2,1,0,1,1,0,1
486691,31,35,2,33,28,1,27,7,1,6
486707,31,39,1,38,39,1,38,,,
486716,31,42,1,41,42,1,41,,,
486752,31,33,1,32,33,1,32,,,
486770,31,32,12,20,32,12,20,,,
486798,31,513,461,52,513,461,52,,,
486813,31,160,38,122,160,38,122,,,
486822,31,168,24,144,168,24,144,,,
486840,31,8628,4133,4495,8011,3803,4208,617,330,287
486859,31,9,0,9,9,0,9,,,
486868,31,7,0,7,7,0,7,,,
486877,31,5,0,5,5,0,5,,,
486886,31,25,0,25,12,0,12,13,0,13
486901,31,176,92,84,176,92,84,,,
486938,31,1,0,1,1,0,1,,,
486947,31,1,1,0,1,1,0,,,
486956,31,7,0,7,5,0,5,2,0,2
486965,31,73,24,49,73,24,49,,,
486983,31,20,5,15,20,5,15,,,
487047,31,29,1,28,29,1,28,,,
487065,31,17,0,17,17,0,17,,,
487083,31,4,0,4,4,0,4,,,
487092,31,593,283,310,593,283,310,,,
487162,31,275,109,166,130,46,84,145,63,82
487232,31,46,0,46,46,0,46,,,
487302,31,45,16,29,45,16,29,,,
487311,31,138,128,10,138,128,10,,,
487320,31,2344,1871,473,1779,1538,241,565,333,232
487348,31,20,0,20,5,0,5,15,0,15
487375,31,27,7,20,20,6,14,7,1,6
487384,31,116,37,79,116,37,79,,,
487393,31,123,55,68,123,55,68,,,
487409,31,114,43,71,114,43,71,,,
487418,31,169,73,96,169,73,96,,,
487427,31,175,57,118,175,57,118,,,
487436,31,167,36,131,167,36,131,,,
487445,31,108,51,57,108,51,57,,,
487454,31,143,55,88,143,55,88,,,
487472,31,148,46,102,148,46,102,,,
487481,31,353,97,256,353,97,256,,,
487490,31,307,52,255,307,52,255,,,
487506,31,52,1,51,21,0,21,31,1,30
487524,31,596,247,349,584,245,339,12,2,10
487533,31,23,0,23,10,0,10,13,0,13
487588,31,135,7,128,135,7,128,,,
487597,31,494,480,14,494,480,14,,,
487603,31,94,32,62,62,20,42,32,12,20
487621,31,1,1,0,1,1,0,,,
487658,31,27,22,5,27,22,5,,,
487676,31,21,0,21,11,0,11,10,0,10
487746,31,2,2,0,2,2,0,,,
487773,31,6,0,6,6,0,6,,,
487791,31,109,100,9,67,61,6,42,39,3
487807,31,11,6,5,10,5,5,1,1,0
487816,31,3,0,3,3,0,3,,,
487852,31,6,3,3,,,,6,3,3
487861,31,60,2,58,59,2,57,1,0,1
487889,31,59,3,56,59,3,56,,,
487898,31,14,12,2,11,10,1,3,2,1
487904,31,12,8,4,12,8,4,,,
487922,31,9,0,9,7,0,7,2,0,2
487959,31,4,0,4,2,0,2,2,0,2
487968,31,35,3,32,35,3,32,,,
487977,31,253,20,233,207,4,203,46,16,30
488013,31,18,0,18,18,0,18,,,
488022,31,5,2,3,3,1,2,2,1,1
488031,31,3,3,0,3,3,0,,,
488059,31,5,0,5,5,0,5,,,
488068,31,2,0,2,1,0,1,1,0,1
488077,31,986,968,18,675,663,12,311,305,6
488101,31,33,33,0,33,33,0,,,
488110,31,19,0,19,11,0,11,8,0,8
488129,31,21,0,21,,,,21,0,21
488138,31,7,1,6,7,1,6,,,
488147,31,28,1,27,28,1,27,,,
488174,31,1,1,0,1,1,0,,,
488183,31,3,0,3,3,0,3,,,
488192,31,36,36,0,,,,36,36,0
488217,31,29,2,27,29,2,27,,,
488253,31,25,22,3,16,14,2,9,8,1
488262,31,14,12,2,12,12,0,2,0,2
488271,31,49,1,48,49,1,48,,,
488280,31,6,5,1,6,5,1,,,
488299,31,72,32,40,20,6,14,52,26,26
488305,31,18,10,8,17,9,8,1,1,0
488314,31,11,11,0,11,11,0,,,
488332,31,1,0,1,1,0,1,,,
488350,31,44,44,0,44,44,0,,,
488369,31,6,6,0,6,6,0,,,
488378,31,62,3,59,62,3,59,,,
488396,31,17,14,3,3,2,1,14,12,2
488411,31,35,1,34,35,1,34,,,
488420,31,36,3,33,,,,36,3,33
488439,31,65,53,12,32,26,6,33,27,6
488448,31,15,11,4,14,11,3,1,0,1
488563,31,10,8,2,10,8,2,,,
488590,31,5,3,2,5,3,2,,,
488651,31,126,15,111,83,11,72,43,4,39
488679,31,621,158,463,611,154,457,10,4,6
488730,31,1301,630,671,530,265,265,771,365,406
488749,31,75,9,66,68,9,59,7,0,7
488776,31,4,3,1,4,3,1,,,
488785,31,39,20,19,39,20,19,,,
488837,31,121,98,23,121,98,23,,,
488846,31,2810,1509,1301,1437,802,635,1373,707,666
488891,31,67,14,53,67,14,53,,,
488916,31,19,0,19,19,0,19,,,
488934,31,326,230,96,138,91,47,188,139,49
488952,31,32,2,30,32,2,30,,,
488961,31,29,1,28,29,1,28,,,
488970,31,15,0,15,15,0,15,,,
488989,31,27,1,26,20,0,20,7,1,6
488998,31,22,4,18,22,4,18,,,
489122,31,16,1,15,12,0,12,4,1,3
489131,31,21,3,18,15,2,13,6,1,5
489140,31,19,5,14,12,2,10,7,3,4
489159,31,28,0,28,20,0,20,8,0,8
489201,31,1019,498,521,593,298,295,426,200,226
489238,31,38,2,36,28,1,27,10,1,9
489247,31,14,2,12,4,1,3,10,1,9
489256,31,207,190,17,206,189,17,1,1,0
489283,31,200,28,172,200,28,172,,,
489344,31,1,0,1,1,0,1,,,
489353,31,2,1,1,2,1,1,,,
489371,31,127,112,15,127,112,15,,,
489779,31,1162,552,610,10,8,2,1152,544,608
489812,31,19,0,19,19,0,19,,,
489830,31,10,0,10,10,0,10,,,
489937,31,95,49,46,90,46,44,5,3,2
490018,31,1,0,1,1,0,1,,,
490045,31,8,1,7,4,0,4,4,1,3
490054,31,63,37,26,59,36,23,4,1,3
490063,31,28,12,16,28,12,16,,,
490081,31,3,0,3,2,0,2,1,0,1
490090,31,12,8,4,7,3,4,5,5,0
490115,31,5,4,1,5,4,1,,,
490124,31,3,1,2,3,1,2,,,
490133,31,405,262,143,401,259,142,4,3,1
490151,31,61,3,58,35,1,34,26,2,24
490160,31,6,1,5,6,1,5,,,
490197,31,3,1,2,3,1,2,,,
490203,31,12,0,12,1,0,1,11,0,11
490221,31,22,2,20,11,1,10,11,1,10
490230,31,38,14,24,38,14,24,,,
490249,31,9,9,0,9,9,0,,,
490258,31,64,16,48,64,16,48,,,
490267,31,1,1,0,1,1,0,,,
490276,31,27,27,0,27,27,0,,,
490285,31,118,90,28,118,90,28,,,
490294,31,122,38,84,107,31,76,15,7,8
490300,31,15,1,14,12,1,11,3,0,3
490319,31,11,11,0,11,11,0,,,
490337,31,7,3,4,4,3,1,3,0,3
490346,31,53,0,53,53,0,53,,,
490382,31,16,9,7,16,9,7,,,
490391,31,28,0,28,28,0,28,,,
490407,31,46,0,46,25,0,25,21,0,21
490416,31,7,6,1,7,6,1,,,
490425,31,57,0,57,57,0,57,,,
490434,31,17,0,17,17,0,17,,,
490443,31,1,0,1,1,0,1,,,
490452,31,24,3,21,8,2,6,16,1,15
490461,31,75,2,73,75,2,73,,,
490470,31,14,1,13,14,1,13,,,
490489,31,6,4,2,5,4,1,1,0,1
490498,31,4,3,1,4,3,1,,,
490504,31,9,9,0,9,9,0,,,
490513,31,14,14,0,14,14,0,,,
490522,31,10,0,10,9,0,9,1,0,1
490531,31,15,13,2,8,7,1,7,6,1
490540,31,9,1,8,7,1,6,2,0,2
490559,31,305,17,288,305,17,288,,,
490674,31,4,0,4,4,0,4,,,
490692,31,4,3,1,4,3,1,,,
490717,31,21,3,18,21,3,18,,,
490735,31,74,13,61,74,13,61,,,
490744,31,4,2,2,4,2,2,,,
490805,31,1067,547,520,1040,534,506,27,13,14
490814,31,41,5,36,41,5,36,,,
490832,31,68,9,59,60,8,52,8,1,7
490841,31,112,7,105,112,7,105,,,
490869,31,63,9,54,63,9,54,,,
490878,31,51,10,41,51,10,41,,,
490896,31,54,2,52,27,1,26,27,1,26
490948,31,4,3,1,4,3,1,,,
490975,31,15,2,13,14,2,12,1,0,1
491057,31,20,20,0,20,20,0,,,
491066,31,37,0,37,11,0,11,26,0,26
491075,31,12,11,1,12,11,1,,,
491084,31,44,0,44,44,0,44,,,
491136,31,36,3,33,24,2,22,12,1,11
491145,31,47,2,45,38,2,36,9,0,9
491181,31,183,27,156,91,11,80,92,16,76
491215,31,20,20,0,20,20,0,,,
491224,31,1,0,1,,,,1,0,1
491233,31,5,0,5,3,0,3,2,0,2
491242,31,21,11,10,21,11,10,,,
491251,31,18,7,11,18,7,11,,,
491260,31,30,0,30,14,0,14,16,0,16
491288,31,11,3,8,2,0,2,9,3,6
491394,31,18,16,2,18,16,2,,,
491446,31,121,0,121,121,0,121,,,
491464,31,81,16,65,81,16,65,,,
491473,31,157,114,43,3,1,2,154,113,41
491507,31,2,0,2,2,0,2,,,
491525,31,20,9,11,18,8,10,2,1,1
491534,31,13,1,12,,,,13,1,12
491543,31,15,3,12,13,2,11,2,1,1
491552,31,20,0,20,20,0,20,,,
491570,31,31,0,31,31,0,31,,,
491589,31,5,2,3,1,0,1,4,2,2
491598,31,11,3,8,11,3,8,,,
491613,31,19,19,0,19,19,0,,,
491622,31,25,25,0,25,25,0,,,
491631,31,52,0,52,52,0,52,,,
491640,31,40,40,0,40,40,0,,,
491659,31,24,7,17,24,7,17,,,
491668,31,22,1,21,22,1,21,,,
491677,31,24,16,8,17,12,5,7,4,3
491686,31,5,5,0,5,5,0,,,
491695,31,8,1,7,8,1,7,,,
491701,31,21,5,16,,,,21,5,16
491710,31,11,11,0,11,11,0,,,
491729,31,5,0,5,5,0,5,,,
491738,31,14,5,9,9,1,8,5,4,1
491747,31,14,4,10,14,4,10,,,
491756,31,21,16,5,21,16,5,,,
491765,31,27,27,0,27,27,0,,,
491774,31,26,3,23,15,2,13,11,1,10
491783,31,57,42,15,23,10,13,34,32,2
491792,31,40,1,39,40,1,39,,,
491817,31,126,0,126,123,0,123,3,0,3
491826,31,11,0,11,11,0,11,,,
491835,31,45,1,44,45,1,44,,,
491844,31,76,27,49,52,22,30,24,5,19
491853,31,5,0,5,5,0,5,,,
491871,31,9,0,9,6,0,6,3,0,3
491880,31,11,11,0,11,11,0,,,
491899,31,31,4,27,2,0,2,29,4,25
491905,31,48,1,47,48,1,47,,,
491914,31,25,25,0,25,25,0,,,
491923,31,155,0,155,155,0,155,,,
491932,31,23,22,1,23,22,1,,,
491941,31,30,2,28,30,2,28,,,
491950,31,107,10,97,1,0,1,106,10,96
491969,31,5,1,4,5,1,4,,,
491978,31,12,7,5,5,2,3,7,5,2
491996,31,25,1,24,25,1,24,,,
492005,31,38,0,38,29,0,29,9,0,9
492032,31,22,0,22,,,,22,0,22
492069,31,15,8,7,15,8,7,,,
492078,31,120,118,2,,,,120,118,2
492096,31,4,0,4,4,0,4,,,
492139,31,86,75,11,86,75,11,,,
492157,31,58,53,5,58,53,5,,,
492281,31,17,13,4,17,13,4,,,
492306,31,122,58,64,,,,122,58,64
492315,31,93,27,66,,,,93,27,66
492324,31,69,11,58,,,,69,11,58
492360,31,5,0,5,3,0,3,2,0,2
492379,31,15,14,1,15,14,1,,,
492421,31,10,10,0,10,10,0,,,
492449,31,52,8,44,52,8,44,,,
492476,31,52,10,42,13,3,10,39,7,32
492591,31,29,21,8,29,21,8,,,
492643,31,31,7,24,31,7,24,,,
492652,31,16,11,5,16,11,5,,,
492661,31,19,4,15,19,4,15,,,
492722,31,121,13,108,121,13,108,,,
492731,31,25,7,18,25,7,18,,,
492759,31,6,0,6,6,0,6,,,
492801,31,62,33,29,33,21,12,29,12,17
492935,31,114,10,104,114,10,104,,,
492953,31,18,0,18,16,0,16,2,0,2
492962,31,371,114,257,164,46,118,207,68,139
493071,31,134,32,102,134,32,102,,,
493080,31,66,36,30,12,5,7,54,31,23
493132,31,420,408,12,420,408,12,,,
493150,31,16,2,14,16,2,14,,,
493451,31,18,1,17,18,1,17,,,
493479,31,7,4,3,7,4,3,,,
493488,31,2,0,2,2,0,2,,,
493503,31,8,5,3,8,5,3,,,
493512,31,11,9,2,11,9,2,,,
493521,31,36,26,10,36,26,10,,,
493530,31,29,10,19,20,9,11,9,1,8
493549,31,40,38,2,40,38,2,,,
493558,31,16,16,0,16,16,0,,,
493567,31,40,1,39,,,,40,1,39
493576,31,1,0,1,1,0,1,,,
493585,31,7,1,6,7,1,6,,,
493594,31,9,9,0,9,9,0,,,
493600,31,51,51,0,51,51,0,,,
493619,31,15,6,9,10,6,4,5,0,5
493628,31,4,1,3,1,0,1,3,1,2
493637,31,16,1,15,16,1,15,,,
493646,31,139,0,139,139,0,139,,,
493655,31,12,9,3,12,9,3,,,
493664,31,3,3,0,3,3,0,,,
493682,31,37,0,37,33,0,33,4,0,4
493691,31,16,1,15,13,1,12,3,0,3
493707,31,32,32,0,32,32,0,,,
493716,31,13,13,0,13,13,0,,,
493725,31,24,9,15,16,4,12,8,5,3
493734,31,9,7,2,9,7,2,,,
493743,31,205,151,54,118,91,27,87,60,27
493752,31,1,0,1,1,0,1,,,
493761,31,39,15,24,11,8,3,28,7,21
493770,31,14,0,14,14,0,14,,,
493789,31,86,0,86,41,0,41,45,0,45
493798,31,100,0,100,100,0,100,,,
493804,31,81,67,14,81,67,14,,,
493813,31,14,0,14,14,0,14,,,
493822,31,17,4,13,15,3,12,2,1,1
493831,31,4,0,4,4,0,4,,,
493868,31,9,6,3,6,4,2,3,2,1
493910,31,4,0,4,1,0,1,3,0,3
493992,31,132,44,88,132,44,88,,,
494001,31,16,0,16,4,0,4,12,0,12
494029,31,1,1,0,,,,1,1,0
494162,31,6,0,6,3,0,3,3,0,3
494232,31,11,0,11,11,0,11,,,
494250,31,23,4,19,23,4,19,,,
494269,31,2,2,0,1,1,0,1,1,0
494278,31,55,12,43,21,2,19,34,10,24
494287,31,37,10,27,13,5,8,24,5,19
494357,31,182,69,113,182,69,113,,,
494436,31,29,13,16,29,13,16,,,
494463,31,193,0,193,193,0,193,,,
494472,31,6,0,6,3,0,3,3,0,3
494524,31,12,1,11,12,1,11,,,
494588,31,96,12,84,96,12,84,,,
494597,31,11,6,5,11,6,5,,,
494603,31,71,37,34,45,24,21,26,13,13
494621,31,32,3,29,,,,32,3,29
494630,31,8,6,2,7,5,2,1,1,0
494649,31,4,0,4,1,0,1,3,0,3
494658,31,4,0,4,4,0,4,,,
494685,31,53,25,28,50,23,27,3,2,1
494694,31,8,0,8,7,0,7,1,0,1
494700,31,9,0,9,9,0,9,,,
494719,31,10,10,0,6,6,0,4,4,0
494728,31,20,17,3,19,16,3,1,1,0
494737,31,34,34,0,34,34,0,,,
494746,31,6,4,2,6,4,2,,,
494755,31,9,1,8,9,1,8,,,
494764,31,21,21,0,21,21,0,,,
494807,31,13,1,12,13,1,12,,,
494843,31,93,8,85,93,8,85,,,
494852,31,143,41,102,143,41,102,,,
494898,31,3,0,3,3,0,3,,,
494904,31,95,46,49,39,20,19,56,26,30
494959,31,7,4,3,3,3,0,4,1,3
494977,31,33,3,30,33,3,30,,,
494986,31,3,0,3,2,0,2,1,0,1
494995,31,31,29,2,31,29,2,,,
495013,31,133,123,10,,,,133,123,10
495031,31,5,5,0,5,5,0,,,
495040,31,24,1,23,24,1,23,,,
495059,31,21,9,12,21,9,12,,,
495077,31,9,0,9,9,0,9,,,
495101,31,31,5,26,31,5,26,,,
495110,31,7,6,1,7,6,1,,,
495129,31,53,49,4,53,49,4,,,
495138,31,5,3,2,5,3,2,,,
495147,31,5,2,3,4,2,2,1,0,1
495165,31,5,2,3,5,2,3,,,
495174,31,4,0,4,,,,4,0,4
495183,31,81,34,47,81,34,47,,,
495208,31,13,8,5,13,8,5,,,
495217,31,6,6,0,6,6,0,,,
495235,31,7,1,6,4,0,4,3,1,2
495244,31,22,0,22,10,0,10,12,0,12
495253,31,24,9,15,23,9,14,1,0,1
495262,31,17,0,17,11,0,11,6,0,6
495271,31,1,1,0,,,,1,1,0
495280,31,2,1,1,2,1,1,,,
495299,31,15,5,10,15,5,10,,,
495305,31,47,13,34,24,5,19,23,8,15
495341,31,3,3,0,3,3,0,,,
495350,31,1,1,0,1,1,0,,,
495369,31,9,1,8,7,1,6,2,0,2
495378,31,22,0,22,4,0,4,18,0,18
495387,31,15,8,7,4,3,1,11,5,6
495396,31,19,1,18,19,1,18,,,
495411,31,12,0,12,12,0,12,,,
495420,31,6,0,6,3,0,3,3,0,3
495439,31,15,1,14,7,0,7,8,1,7
495448,31,16,3,13,9,1,8,7,2,5
495457,31,47,3,44,35,2,33,12,1,11
495518,31,36,2,34,17,1,16,19,1,18
495730,31,13,0,13,11,0,11,2,0,2
495767,31,16049,8594,7455,15785,8463,7322,264,131,133
495776,31,9,9,0,9,9,0,,,
495794,31,12,0,12,12,0,12,,,
495837,31,35,2,33,35,2,33,,,
495925,31,8,0,8,8,0,8,,,
495934,31,12,0,12,12,0,12,,,
495943,31,3,1,2,3,1,2,,,
495952,31,19,2,17,19,2,17,,,
495961,31,12,1,11,12,1,11,,,
495970,31,81,29,52,81,29,52,,,
495998,31,10,0,10,10,0,10,,,
496052,31,6,3,3,6,3,3,,,
496061,31,68,0,68,30,0,30,38,0,38
496186,31,10,10,0,10,10,0,,,
496265,31,21,17,4,21,17,4,,,
496283,31,3,0,3,3,0,3,,,
496326,31,4,1,3,4,1,3,,,
496371,31,1,1,0,1,1,0,,,
496399,31,9,1,8,9,1,8,,,
496478,31,22,19,3,,,,22,19,3
496511,31,12,0,12,11,0,11,1,0,1
496520,31,12,4,8,,,,12,4,8
496539,31,10,0,10,10,0,10,,,
496593,31,16,12,4,16,12,4,,,
496618,31,23,1,22,23,1,22,,,
496627,31,31,10,21,31,10,21,,,
496636,31,23,0,23,23,0,23,,,
496645,31,162,112,50,16,0,16,146,112,34
496654,31,46,10,36,,,,46,10,36
496663,31,27,20,7,26,19,7,1,1,0
496672,31,2,0,2,1,0,1,1,0,1
496681,31,185,2,183,185,2,183,,,
496690,31,22,5,17,17,3,14,5,2,3
496706,31,7,0,7,7,0,7,,,
496715,31,50,20,30,48,18,30,2,2,0
496724,31,18,0,18,18,0,18,,,
496733,31,40,0,40,40,0,40,,,
496742,31,4,0,4,4,0,4,,,
496751,31,55,6,49,55,6,49,,,
496894,31,8,0,8,7,0,7,1,0,1
496919,31,223,65,158,223,65,158,,,
496955,31,215,81,134,215,81,134,,,
496964,31,6,3,3,6,3,3,,,
496973,31,18,2,16,17,2,15,1,0,1
496991,31,136,21,115,61,13,48,75,8,67
497000,31,70,21,49,70,21,49,,,
497037,31,32,2,30,23,1,22,9,1,8
497046,31,460,193,267,150,62,88,310,131,179
497073,31,152,5,147,88,4,84,64,1,63
497116,31,51,5,46,27,4,23,24,1,23
497161,31,40,40,0,33,33,0,7,7,0
497189,31,6,0,6,6,0,6,,,
497198,31,71,1,70,46,1,45,25,0,25
497204,31,43,40,3,15,15,0,28,25,3
497213,31,1,0,1,1,0,1,,,
497222,31,3,0,3,2,0,2,1,0,1
497268,31,20,0,20,11,0,11,9,0,9
497277,31,122,15,107,122,15,107,,,
497301,31,118,4,114,90,4,86,28,0,28
497310,31,25,0,25,25,0,25,,,
497329,31,33,5,28,33,5,28,,,
497338,31,4,0,4,4,0,4,,,
100654,34,3621,1451,2170,3112,1219,1893,509,232,277
100663,34,10869,4200,6669,8005,3108,4897,2864,1092,1772
100690,34,251,79,172,136,45,91,115,34,81
100706,34,6154,3602,2552,5026,2954,2072,1128,648,480
100724,34,2605,925,1680,2258,799,1459,347,126,221
100751,34,23132,10253,12879,20534,9160,11374,2598,1093,1505
100760,34,647,226,421,271,117,154,376,109,267
100812,34,2511,741,1770,1136,343,793,1375,398,977
100830,34,3203,1049,2154,2395,798,1597,808,251,557
100858,34,19471,10084,9387,17420,8906,8514,2051,1178,873
100937,34,804,390,414,795,381,414,9,9,0
101028,34,836,235,601,298,100,198,538,135,403
101116,34,318,48,270,205,34,171,113,14,99
101143,34,920,483,437,537,297,240,383,186,197
101161,34,3842,1330,2512,1750,720,1030,2092,610,1482
101189,34,1482,602,880,1088,461,627,394,141,253
101240,34,2682,916,1766,1209,517,692,1473,399,1074
101277,34,18,2,16,18,2,16,,,
101286,34,2392,639,1753,778,215,563,1614,424,1190
101295,34,3023,908,2115,1331,484,847,1692,424,1268
101301,34,673,186,487,259,128,131,414,58,356
101365,34,492,102,390,241,73,168,251,29,222
101435,34,588,309,279,542,298,244,46,11,35
101453,34,69,63,6,30,28,2,39,35,4
101462,34,579,233,346,193,91,102,386,142,244
101471,34,155,126,29,113,88,25,42,38,4
101480,34,5174,2048,3126,4329,1713,2616,845,335,510
101505,34,4690,1585,3105,1367,524,843,3323,1061,2262
101514,34,5171,2170,3001,1593,726,867,3578,1444,2134
101569,34,2109,641,1468,785,266,519,1324,375,949
101587,34,2006,564,1442,1453,370,1083,553,194,359
101602,34,699,220,479,367,141,226,332,79,253
101648,34,135,100,35,135,100,35,,,
101675,34,1133,529,604,1041,476,565,92,53,39
101693,34,859,294,565,795,275,520,64,19,45
101709,34,1691,608,1083,1482,533,949,209,75,134
101736,34,1504,520,984,485,226,259,1019,294,725
101879,34,4152,1502,2650,3495,1241,2254,657,261,396
101897,34,1115,338,777,482,157,325,633,181,452
101912,34,1069,465,604,975,423,552,94,42,52
101994,34,176,44,132,69,30,39,107,14,93
102030,34,1411,406,1005,544,215,329,867,191,676
102049,34,2684,874,1810,2631,859,1772,53,15,38
102058,34,18,13,5,8,5,3,10,8,2
102067,34,3125,1138,1987,994,463,531,2131,675,1456
102076,34,979,360,619,487,196,291,492,164,328
102094,34,6853,2672,4181,5638,2129,3509,1215,543,672
102234,34,773,307,466,733,290,443,40,17,23
102270,34,587,255,332,527,212,315,60,43,17
102298,34,833,391,442,788,364,424,45,27,18
102313,34,1133,432,701,475,218,257,658,214,444
102368,34,9320,3225,6095,6039,2112,3927,3281,1113,2168
102377,34,1633,622,1011,1523,576,947,110,46,64
102395,34,61,45,16,13,11,2,48,34,14
102429,34,1636,531,1105,595,256,339,1041,275,766
102553,34,6294,2427,3867,3039,1337,1702,3255,1090,2165
102580,34,31,20,11,18,14,4,13,6,7
102614,34,3430,1367,2063,1726,824,902,1704,543,1161
102632,34,850,256,594,341,130,211,509,126,383
102669,34,307,71,236,248,60,188,59,11,48
102711,34,42,32,10,18,14,4,24,18,6
102845,34,1721,428,1293,1721,428,1293,,,
103501,34,106,16,90,106,16,90,,,
103741,34,77,1,76,60,1,59,17,0,17
103893,34,1009,199,810,1009,199,810,,,
103909,34,519,55,464,519,55,464,,,
103927,34,394,59,335,394,59,335,,,
103954,34,45,3,42,45,3,42,,,
103963,34,317,285,32,316,285,31,1,0,1
104090,34,993,123,870,993,123,870,,,
104151,34,49966,25315,24651,44896,22405,22491,5070,2910,2160
104160,34,5257,2065,3192,1439,620,819,3818,1445,2373
104179,34,28077,12714,15363,23428,10327,13101,4649,2387,2262
104346,34,2737,939,1798,633,262,371,2104,677,1427
104391,34,12,0,12,12,0,12,,,
104425,34,2207,911,1296,817,296,521,1390,615,775
104443,34,28,1,27,22,1,21,6,0,6
104568,34,113,4,109,59,1,58,54,3,51
104577,34,2451,964,1487,676,305,371,1775,659,1116
104586,34,2266,1676,590,2147,1579,568,119,97,22
104708,34,8636,3659,4977,2390,1153,1237,6246,2506,3740
104717,34,56611,15912,40699,15568,6116,9452,41043,9796,31247
105145,34,3245,1002,2243,727,258,469,2518,744,1774
105154,34,10385,4681,5704,2975,1415,1560,7410,3266,4144
105206,34,2235,612,1623,477,177,300,1758,435,1323
105215,34,444,415,29,444,415,29,,,
105297,34,1135,256,879,588,137,451,547,119,428
105330,34,18475,6721,11754,15169,5633,9536,3306,1088,2218
105349,34,1038,305,733,195,70,125,843,235,608
105367,34,348,85,263,158,30,128,190,55,135
105428,34,5771,1899,3872,1496,556,940,4275,1343,2932
105525,34,10832,4318,6514,2103,970,1133,8729,3348,5381
105534,34,2301,419,1882,2301,419,1882,,,
105543,34,660,111,549,660,111,549,,,
105589,34,346,121,225,273,103,170,73,18,55
105659,34,664,622,42,664,622,42,,,
105668,34,3540,1221,2319,647,248,399,2893,973,1920
105677,34,5,5,0,5,5,0,,,
105747,34,4094,1692,2402,1130,525,605,2964,1167,1797
105792,34,1940,762,1178,578,234,344,1362,528,834
105899,34,701,418,283,576,354,222,125,64,61
106041,34,1151,1103,48,1151,1103,48,,,
106111,34,29,1,28,19,1,18,10,0,10
106148,34,2862,1036,1826,766,345,421,2096,691,1405
106245,34,4544,1589,2955,2499,978,1521,2045,611,1434
106263,34,1072,156,916,729,111,618,343,45,298
106306,34,266,191,75,216,153,63,50,38,12
106315,34,13,2,11,13,2,11,,,
106324,34,18,0,18,16,0,16,2,0,2
106342,34,438,249,189,434,247,187,4,2,2
106351,34,54,40,14,54,40,14,,,
106360,34,21,1,20,21,1,20,,,
106397,34,17936,8007,9929,15442,6920,8522,2494,1087,1407
106412,34,1767,721,1046,1498,619,879,269,102,167
106449,34,1204,400,804,745,274,471,459,126,333
106458,34,6177,2260,3917,4130,1676,2454,2047,584,1463
106467,34,5071,2187,2884,4022,1808,2214,1049,379,670
106485,34,1520,593,927,1216,515,701,304,78,226
106494,34,26,0,26,26,0,26,,,
106546,34,666,81,585,592,75,517,74,6,68
106625,34,781,217,564,436,138,298,345,79,266
106704,34,5909,2313,3596,4943,1928,3015,966,385,581
106713,34,408,216,192,361,198,163,47,18,29
106795,34,628,161,467,279,90,189,349,71,278
106810,34,118,68,50,118,68,50,,,
106883,34,465,116,349,261,75,186,204,41,163
106892,34,53,1,52,53,1,52,,,
106908,34,281,21,260,267,20,247,14,1,13
106980,34,1322,463,859,708,279,429,614,184,430
106999,34,496,131,365,327,86,241,169,45,124
107044,34,2514,1126,1388,2327,1021,1306,187,105,82
107071,34,1787,828,959,1576,738,838,211,90,121
107080,34,788,384,404,783,381,402,5,3,2
107099,34,74,3,71,74,3,71,,,
107123,34,66,8,58,66,8,58,,,
107141,34,1048,403,645,955,373,582,93,30,63
107220,34,27,0,27,27,0,27,,,
107293,34,43,0,43,43,0,43,,,
107318,34,395,138,257,141,31,110,254,107,147
107327,34,587,174,413,299,113,186,288,61,227
107442,34,29,19,10,29,19,10,,,
107460,34,848,296,552,458,193,265,390,103,287
107488,34,3,3,0,1,1,0,2,2,0
107512,34,1087,442,645,1066,432,634,21,10,11
107521,34,349,91,258,220,55,165,129,36,93
107549,34,496,118,378,341,85,256,155,33,122
107558,34,574,274,300,572,272,300,2,2,0
107585,34,1107,370,737,619,230,389,488,140,348
107600,34,619,221,398,523,186,337,96,35,61
107619,34,473,131,342,312,99,213,161,32,129
107637,34,676,159,517,188,59,129,488,100,388
107655,34,29,0,29,29,0,29,,,
107664,34,3190,985,2205,1546,523,1023,1644,462,1182
107725,34,584,123,461,288,71,217,296,52,244
107743,34,324,108,216,214,77,137,110,31,79
107789,34,83,2,81,83,2,81,,,
107831,34,79,1,78,79,1,78,,,
107840,34,175,51,124,146,45,101,29,6,23
107877,34,402,200,202,398,198,200,4,2,2
107974,34,670,150,520,276,72,204,394,78,316
107983,34,2163,949,1214,1999,878,1121,164,71,93
107992,34,483,221,262,279,131,148,204,90,114
108065,34,6,0,6,4,0,4,2,0,2
108092,34,3375,1321,2054,2501,963,1538,874,358,516
108232,34,4704,2039,2665,2353,1097,1256,2351,942,1409
108667,34,3044,1243,1801,383,196,187,2661,1047,1614
108807,34,6288,2706,3582,2123,911,1212,4165,1795,2370
108852,34,141,62,79,141,62,79,,,
108977,34,155,49,106,88,31,57,67,18,49
109040,34,1803,381,1422,1803,381,1422,,,
109086,34,1,1,0,1,1,0,,,
109208,34,19827,9351,10476,3376,1474,1902,16451,7877,8574
109350,34,7746,3138,4608,2192,962,1230,5554,2176,3378
109651,34,1753,740,1013,1455,625,830,298,115,183
109721,34,58,21,37,58,21,37,,,
109730,34,32,25,7,32,25,7,,,
109785,34,3303,1041,2262,2748,865,1883,555,176,379
109819,34,14133,6028,8105,4560,1835,2725,9573,4193,5380
109907,34,1763,499,1264,701,197,504,1062,302,760
109934,34,366,60,306,366,60,306,,,
110060,34,199,148,51,156,122,34,43,26,17
110097,34,2937,1103,1834,2644,997,1647,293,106,187
110194,34,79,79,0,79,79,0,,,
110219,34,1094,305,789,1094,305,789,,,
110246,34,6824,2818,4006,3071,1370,1701,3753,1448,2305
110316,34,84,16,68,76,14,62,8,2,6
110334,34,6721,2708,4013,2113,919,1194,4608,1789,2819
110361,34,6862,2500,4362,5978,2215,3763,884,285,599
110370,34,1030,383,647,969,362,607,61,21,40
110404,34,717,397,320,717,397,320,,,
110413,34,2096,965,1131,2026,929,1097,70,36,34
110422,34,16206,8397,7809,15064,7698,7366,1142,699,443
110468,34,227,74,153,,,,227,74,153
110486,34,7705,2645,5060,6250,2112,4138,1455,533,922
110495,34,8210,2692,5518,6468,2083,4385,1742,609,1133
110510,34,14594,5430,9164,11709,4242,7467,2885,1188,1697
110529,34,23339,12461,10878,19754,10308,9446,3585,2153,1432
110538,34,12414,5663,6751,11003,5020,5983,1411,643,768
110547,34,13166,4726,8440,9708,3435,6273,3458,1291,2167
110556,34,18375,7292,11083,15345,5955,9390,3030,1337,1693
110565,34,31283,12981,18302,23784,9735,14049,7499,3246,4253
110574,34,11106,4391,6715,8513,3317,5196,2593,1074,1519
110583,34,28900,12385,16515,23535,9849,13686,5365,2536,2829
110592,34,19411,7838,11573,15639,6168,9471,3772,1670,2102
110608,34,29720,13337,16383,23595,10193,13402,6125,3144,2981
110617,34,25789,11067,14722,19962,8237,11725,5827,2830,2997
110635,34,24880,11485,13395,23305,10755,12550,1575,730,845
110644,34,24155,9529,14626,23380,9165,14215,775,364,411
110653,34,22949,10761,12188,22269,10364,11905,680,397,283
110662,34,25538,10492,15046,24918,10168,14750,620,324,296
110671,34,17613,8288,9325,16915,7899,9016,698,389,309
110680,34,25797,12883,12914,24821,12346,12475,976,537,439
110705,34,18183,8165,10018,17574,7847,9727,609,318,291
110714,34,13676,7431,6245,12932,6997,5935,744,434,310
110778,34,8,2,6,7,2,5,1,0,1
110875,34,53,0,53,51,0,51,2,0,2
110918,34,13,9,4,7,5,2,6,4,2
111045,34,20,7,13,15,3,12,5,4,1
111054,34,93,20,73,93,20,73,,,
111081,34,755,323,432,734,312,422,21,11,10
111188,34,685,555,130,657,532,125,28,23,5
111434,34,3217,1207,2010,332,138,194,2885,1069,1816
111461,34,11346,5477,5869,3840,1755,2085,7506,3722,3784
111513,34,168,5,163,128,3,125,40,2,38
111638,34,237,90,147,237,90,147,,,
111708,34,159,122,37,159,122,37,,,
111717,34,142,105,37,137,103,34,5,2,3
111726,34,123,92,31,123,92,31,,,
111744,34,104,84,20,104,84,20,,,
111762,34,68,34,34,68,34,34,,,
111799,34,127,16,111,127,16,111,,,
111887,34,14152,6424,7728,4794,2020,2774,9358,4404,4954
111896,34,3015,1376,1639,629,317,312,2386,1059,1327
111920,34,8462,3924,4538,1976,857,1119,6486,3067,3419
111939,34,12427,4511,7916,3322,1278,2044,9105,3233,5872
111948,34,5811,2356,3455,5503,2210,3293,308,146,162
111966,34,239,84,155,149,68,81,90,16,74
112075,34,1239,484,755,1141,451,690,98,33,65
112084,34,318,153,165,272,134,138,46,19,27
112172,34,6951,2926,4025,2703,1169,1534,4248,1757,2491
112181,34,84,2,82,84,2,82,,,
112190,34,13833,6230,7603,4227,2130,2097,9606,4100,5506
112260,34,1056,519,537,1051,516,535,5,3,2
112288,34,39,1,38,39,1,38,,,
112367,34,275,29,246,95,9,86,180,20,160
112385,34,5064,2568,2496,479,199,280,4585,2369,2216
112394,34,402,295,107,324,238,86,78,57,21
112455,34,101,23,78,101,23,78,,,
112561,34,1208,524,684,341,142,199,867,382,485
112570,34,424,243,181,382,218,164,42,25,17
112686,34,2305,693,1612,585,223,362,1720,470,1250
112826,34,3830,1414,2416,1042,428,614,2788,986,1802
113096,34,10096,4050,6046,1801,788,1013,8295,3262,5033
113111,34,3703,1632,2071,1055,471,584,2648,1161,1487
113193,34,6096,2762,3334,2068,955,1113,4028,1807,2221
113218,34,5456,2246,3210,976,437,539,4480,1809,2671
113236,34,9913,3955,5958,3162,1329,1833,6751,2626,4125
113333,34,11401,5507,5894,5401,2890,2511,6000,2617,3383
113449,34,114,35,79,114,35,79,,,
113537,34,11,3,8,11,3,8,,,
113573,34,6876,2657,4219,2489,995,1494,4387,1662,2725
113582,34,115,12,103,77,9,68,38,3,35
113634,34,13009,6127,6882,4542,2265,2277,8467,3862,4605
113698,34,998,307,691,889,266,623,109,41,68
113856,34,22946,11006,11940,3631,1485,2146,19315,9521,9794
113980,34,12710,5525,7185,3866,1781,2085,8844,3744,5100
114266,34,5634,2415,3219,1347,618,729,4287,1797,2490
114354,34,1432,240,1192,1204,190,1014,228,50,178
114433,34,971,495,476,257,120,137,714,375,339
114460,34,258,36,222,157,26,131,101,10,91
114637,34,56,1,55,56,1,55,,,
114716,34,9283,4898,4385,2549,1171,1378,6734,3727,3007
114761,34,51,7,44,51,7,44,,,
114789,34,13229,5045,8184,3376,1395,1981,9853,3650,6203
114813,34,2468,652,1816,1198,350,848,1270,302,968
114859,34,13522,6026,7496,4815,2219,2596,8707,3807,4900
114938,34,3062,1407,1655,997,458,539,2065,949,1116
114947,34,70,24,46,70,24,46,,,
115001,34,8386,3548,4838,4434,1919,2515,3952,1629,2323
115010,34,292,60,232,292,60,232,,,
115083,34,679,490,189,499,382,117,180,108,72
115126,34,7152,2976,4176,1964,894,1070,5188,2082,3106
115296,34,9438,3616,5822,2677,1116,1561,6761,2500,4261
115357,34,91,22,69,45,11,34,46,11,35
115393,34,6743,3219,3524,2065,820,1245,4678,2399,2279
115409,34,680,340,340,677,339,338,3,1,2
115658,34,88,15,73,43,11,32,45,4,41
115728,34,491,162,329,393,133,260,98,29,69
115755,34,4707,1967,2740,4034,1641,2393,673,326,347
115773,34,193,43,150,95,26,69,98,17,81
115861,34,5025,2033,2992,2140,776,1364,2885,1257,1628
115931,34,556,403,153,556,403,153,,,
116226,34,109,1,108,46,0,46,63,1,62
116350,34,142,24,118,142,24,118,,,
116439,34,7199,3665,3534,2442,1345,1097,4757,2320,2437
116563,34,222,6,216,222,6,216,,,
116846,34,22,2,20,20,2,18,2,0,2
117052,34,3141,1286,1855,866,426,440,2275,860,1415
117104,34,343,148,195,288,119,169,55,29,26
117140,34,3006,1185,1821,2219,862,1357,787,323,464
117168,34,612,163,449,505,133,372,107,30,77
117195,34,1556,959,597,503,271,232,1053,688,365
117238,34,63,15,48,63,15,48,,,
117247,34,4878,2248,2630,1058,572,486,3820,1676,2144
117274,34,1140,873,267,335,215,120,805,658,147
117283,34,43,21,22,18,8,10,25,13,12
117557,34,135,106,29,128,102,26,7,4,3
117575,34,43,28,15,5,3,2,38,25,13
117627,34,986,402,584,884,369,515,102,33,69
117636,34,980,258,722,818,222,596,162,36,126
117645,34,16504,6791,9713,5704,2436,3268,10800,4355,6445
117672,34,123,20,103,1,0,1,122,20,102
117690,34,4538,1692,2846,919,413,506,3619,1279,2340
117706,34,10668,4479,6189,2495,1101,1394,8173,3378,4795
117715,34,3033,851,2182,371,94,277,2662,757,1905
117724,34,6608,3461,3147,1325,767,558,5283,2694,2589
117733,34,9497,3797,5700,1699,748,951,7798,3049,4749
117751,34,993,531,462,687,336,351,306,195,111
117788,34,8902,3672,5230,1755,777,978,7147,2895,4252
117803,34,180,53,127,,,,180,53,127
117867,34,5481,1997,3484,883,375,508,4598,1622,2976
117894,34,5545,2284,3261,1820,840,980,3725,1444,2281
117946,34,5389,2489,2900,5253,2415,2838,136,74,62
117955,34,222,47,175,137,30,107,85,17,68
118134,34,72,1,71,28,1,27,44,0,44
118143,34,93,4,89,14,2,12,79,2,77
118161,34,64,3,61,64,3,61,,,
118198,34,374,96,278,374,96,278,,,
118347,34,2967,1139,1828,736,319,417,2231,820,1411
118541,34,377,183,194,365,179,186,12,4,8
118684,34,2015,578,1437,605,191,414,1410,387,1023
118693,34,595,313,282,562,297,265,33,16,17
118718,34,6206,2267,3939,2693,1007,1686,3513,1260,2253
118772,34,4112,1272,2840,777,243,534,3335,1029,2306
118888,34,400,2,398,354,2,352,46,0,46
118912,34,8650,3272,5378,2880,1168,1712,5770,2104,3666
118930,34,4285,1852,2433,986,505,481,3299,1347,1952
118958,34,55,23,32,16,7,9,39,16,23
118976,34,10365,3711,6654,3217,1212,2005,7148,2499,4649
118994,34,274,165,109,274,165,109,,,
119058,34,13,9,4,13,9,4,,,
119067,34,4862,2142,2720,1397,621,776,3465,1521,1944
119137,34,8963,3957,5006,2799,1308,1491,6164,2649,3515
119164,34,19206,8602,10604,6053,2860,3193,13153,5742,7411
119173,34,1531,106,1425,1167,69,1098,364,37,327
119216,34,9358,3527,5831,2979,1218,1761,6379,2309,4070
119270,34,634,454,180,382,283,99,252,171,81
119331,34,3044,1187,1857,1004,426,578,2040,761,1279
119553,34,924,220,704,901,211,690,23,9,14
119605,34,7122,3432,3690,2892,1389,1503,4230,2043,2187
119775,34,286,169,117,244,143,101,42,26,16
119951,34,178,12,166,178,12,166,,,
120069,34,134,15,119,134,15,119,,,
120078,34,300,36,264,300,36,264,,,
120087,34,138,20,118,138,20,118,,,
120166,34,5,2,3,4,2,2,1,0,1
120254,34,1417,597,820,1395,588,807,22,9,13
120290,34,5658,2769,2889,2046,1067,979,3612,1702,1910
120342,34,12275,5893,6382,3951,2024,1927,8324,3869,4455
120403,34,928,294,634,892,278,614,36,16,20
120421,34,4694,2052,2642,961,437,524,3733,1615,2118
120537,34,521,239,282,420,198,222,101,41,60
120661,34,569,121,448,539,118,421,30,3,27
120698,34,64,14,50,55,14,41,9,0,9
120768,34,478,43,435,,,,478,43,435
120838,34,2,0,2,2,0,2,,,
120865,34,669,239,430,603,224,379,66,15,51
120883,34,2488,1230,1258,2373,1173,1200,115,57,58
120953,34,3265,2925,340,445,351,94,2820,2574,246
120971,34,11520,5882,5638,3541,1703,1838,7979,4179,3800
121044,34,15302,6787,8515,4669,2264,2405,10633,4523,6110
121150,34,2682,1169,1513,2404,1043,1361,278,126,152
121257,34,811,353,458,775,333,442,36,20,16
121275,34,51,36,15,51,36,15,,,
121309,34,2508,852,1656,1912,652,1260,596,200,396
121345,34,1293,595,698,1293,595,698,,,
121363,34,2154,690,1464,852,304,548,1302,386,916
121433,34,115,4,111,104,3,101,11,1,10
121619,34,17645,10662,6983,2501,1188,1313,15144,9474,5670
121637,34,93,13,80,93,13,80,,,
121691,34,2046,808,1238,1732,667,1065,314,141,173
121707,34,2493,1114,1379,714,352,362,1779,762,1017
121859,34,158,12,146,91,12,79,67,0,67
121868,34,153,2,151,92,1,91,61,1,60
121886,34,11609,6396,5213,2687,1234,1453,8922,5162,3760
121901,34,12244,4687,7557,3073,1268,1805,9171,3419,5752
122117,34,2,0,2,1,0,1,1,0,1
122180,34,13798,5218,8580,2982,1157,1825,10816,4061,6755
122205,34,12893,5537,7356,3833,1934,1899,9060,3603,5457
122296,34,677,140,537,574,125,449,103,15,88
122339,34,9364,3967,5397,1169,505,664,8195,3462,4733
122375,34,13022,5629,7393,2477,1254,1223,10545,4375,6170
122384,34,9537,5113,4424,1097,682,415,8440,4431,4009
122409,34,25722,11290,14432,22378,9648,12730,3344,1642,1702
122436,34,4435,1980,2455,4316,1912,2404,119,68,51
122454,34,26,12,14,25,12,13,1,0,1
122506,34,182,107,75,182,107,75,,,
122597,34,19414,8782,10632,15510,6803,8707,3904,1979,1925
122612,34,4485,1645,2840,4281,1541,2740,204,104,100
122658,34,10288,3957,6331,5075,2034,3041,5213,1923,3290
122685,34,1984,506,1478,1984,506,1478,,,
122694,34,731,203,528,731,203,528,,,
122728,34,1011,425,586,794,335,459,217,90,127
122746,34,5244,2075,3169,1178,514,664,4066,1561,2505
122755,34,23968,12120,11848,18933,9376,9557,5035,2744,2291
122791,34,4435,2177,2258,779,442,337,3656,1735,1921
122834,34,9,2,7,9,2,7,,,
122889,34,7951,3264,4687,3422,1557,1865,4529,1707,2822
122931,34,4333,2283,2050,4220,2213,2007,113,70,43
122977,34,17358,7380,9978,5963,2706,3257,11395,4674,6721
123013,34,11527,4866,6661,3473,1572,1901,8054,3294,4760
123165,34,775,0,775,771,0,771,4,0,4
123217,34,7752,3002,4750,3123,1273,1850,4629,1729,2900
123280,34,28,15,13,8,5,3,20,10,10
123299,34,4616,1576,3040,2159,779,1380,2457,797,1660
123341,34,10664,4587,6077,4045,1836,2209,6619,2751,3868
123350,34,77,5,72,44,5,39,33,0,33
123457,34,611,244,367,544,219,325,67,25,42
123484,34,843,411,432,375,174,201,468,237,231
123493,34,79,17,62,79,17,62,,,
123509,34,4757,2096,2661,848,441,407,3909,1655,2254
123527,34,7196,2627,4569,1542,612,930,5654,2015,3639
123554,34,1769,726,1043,1569,642,927,200,84,116
123563,34,5768,2331,3437,1734,714,1020,4034,1617,2417
123572,34,5738,2185,3553,4924,1822,3102,814,363,451
123642,34,265,18,247,172,13,159,93,5,88
123651,34,1477,493,984,1283,434,849,194,59,135
123679,34,538,162,376,477,151,326,61,11,50
123800,34,11770,5043,6727,4341,1805,2536,7429,3238,4191
123952,34,222,137,85,212,131,81,10,6,4
123961,34,16951,8237,8714,16446,7966,8480,505,271,234
124113,34,2500,1234,1266,599,175,424,1901,1059,842
124292,34,366,184,182,366,184,182,,,
124487,34,85,44,41,11,5,6,74,39,35
124681,34,875,334,541,875,334,541,,,
124706,34,562,125,437,562,125,437,,,
124937,34,544,176,368,489,171,318,55,5,50
125028,34,7863,3086,4777,1978,825,1153,5885,2261,3624
125082,34,69,12,57,68,11,57,1,1,0
125091,34,6619,2362,4257,2086,822,1264,4533,1540,2993
125170,34,3406,1365,2041,500,213,287,2906,1152,1754
125231,34,6981,1105,5876,1703,235,1468,5278,870,4408
125310,34,42,9,33,42,9,33,,,
125462,34,1650,772,878,287,135,152,1363,637,726
125471,34,6843,2566,4277,1199,521,678,5644,2045,3599
125499,34,4668,2029,2639,1394,680,714,3274,1349,1925
125532,34,1442,135,1307,1442,135,1307,,,
125727,34,905,372,533,902,371,531,3,1,2
125763,34,1044,442,602,998,414,584,46,28,18
125897,34,821,402,419,765,376,389,56,26,30
126076,34,86,86,0,86,86,0,,,
126119,34,3462,1190,2272,915,369,546,2547,821,1726
126164,34,43,1,42,43,1,42,,,
126182,34,1166,657,509,862,441,421,304,216,88
126207,34,2487,1015,1472,981,454,527,1506,561,945
126289,34,4178,1560,2618,1232,559,673,2946,1001,1945
126359,34,165,21,144,165,21,144,,,
126562,34,9380,4129,5251,6829,2995,3834,2551,1134,1417
126580,34,8205,3731,4474,6112,2785,3327,2093,946,1147
126605,34,267,237,30,267,237,30,,,
126614,34,23687,13025,10662,21741,11814,9927,1946,1211,735
126669,34,4173,1184,2989,1254,453,801,2919,731,2188
126678,34,1616,707,909,1568,684,884,48,23,25
126687,34,607,99,508,607,99,508,,,
126711,34,2332,873,1459,890,384,506,1442,489,953
126748,34,419,145,274,268,112,156,151,33,118
126775,34,3991,2747,1244,3727,2568,1159,264,179,85
126784,34,110,108,2,110,108,2,,,
126818,34,19300,9000,10300,15402,7094,8308,3898,1906,1992
126827,34,19632,6775,12857,12435,4169,8266,7197,2606,4591
126863,34,2892,1123,1769,831,390,441,2061,733,1328
126915,34,7,3,4,4,3,1,3,0,3
126942,34,3913,1378,2535,1254,463,791,2659,915,1744
126951,34,863,786,77,863,786,77,,,
127060,34,4150,1891,2259,3831,1739,2092,319,152,167
127158,34,2906,2736,170,441,365,76,2465,2371,94
127185,34,2301,1085,1216,1976,921,1055,325,164,161
127200,34,9149,3659,5490,2825,1313,1512,6324,2346,3978
127316,34,195,45,150,67,25,42,128,20,108
127389,34,224,80,144,126,56,70,98,24,74
127556,34,6049,2759,3290,4810,2214,2596,1239,545,694
127565,34,13613,6054,7559,8199,3741,4458,5414,2313,3101
127617,34,496,148,348,186,59,127,310,89,221
127653,34,288,74,214,260,64,196,28,10,18
127714,34,328,155,173,31,11,20,297,144,153
127732,34,542,222,320,315,142,173,227,80,147
127741,34,5427,1786,3641,4673,1589,3084,754,197,557
127778,34,556,202,354,306,141,165,250,61,189
127820,34,7303,2745,4558,2492,1084,1408,4811,1661,3150
127884,34,2755,811,1944,958,344,614,1797,467,1330
127909,34,3281,1568,1713,1105,596,509,2176,972,1204
127918,34,2180,812,1368,1480,476,1004,700,336,364
127945,34,1645,398,1247,941,233,708,704,165,539
127954,34,1,0,1,1,0,1,,,
128106,34,2486,1148,1338,1952,872,1080,534,276,258
128151,34,252,112,140,245,109,136,7,3,4
128179,34,583,420,163,583,420,163,,,
128188,34,639,267,372,639,267,372,,,
128258,34,701,279,422,347,160,187,354,119,235
128328,34,3090,2218,872,3090,2218,872,,,
128337,34,32,0,32,21,0,21,11,0,11
128391,34,1266,756,510,1164,690,474,102,66,36
128498,34,835,318,517,731,285,446,104,33,71
128577,34,687,293,394,234,123,111,453,170,283
128586,34,17,17,0,17,17,0,,,
128744,34,1495,422,1073,1187,369,818,308,53,255
128771,34,6523,3472,3051,5000,2635,2365,1523,837,686
128780,34,1444,363,1081,375,81,294,1069,282,787
128896,34,103,20,83,103,20,83,,,
128902,34,1319,524,795,1318,524,794,1,0,1
129002,34,247,113,134,204,94,110,43,19,24
129020,34,14699,7104,7595,14234,6821,7413,465,283,182
129154,34,2580,354,2226,326,75,251,2254,279,1975
129181,34,873,802,71,651,600,51,222,202,20
129215,34,2983,1285,1698,2679,1123,1556,304,162,142
129242,34,3292,1356,1936,3229,1324,1905,63,32,31
129349,34,163,3,160,156,3,153,7,0,7
129367,34,1816,421,1395,307,96,211,1509,325,1184
129482,34,332,24,308,332,24,308,,,
129525,34,2938,1337,1601,2712,1240,1472,226,97,129
129534,34,180,78,102,83,39,44,97,39,58
129543,34,2504,811,1693,718,258,460,1786,553,1233
129695,34,3053,1262,1791,882,381,501,2171,881,1290
129729,34,3371,1215,2156,1000,431,569,2371,784,1587
129756,34,1274,477,797,395,177,218,879,300,579
129774,34,399,223,176,385,216,169,14,7,7
129808,34,2120,734,1386,533,241,292,1587,493,1094
129923,34,428,193,235,228,105,123,200,88,112
129932,34,26,25,1,8,7,1,18,18,0
129941,34,3693,1658,2035,3465,1523,1942,228,135,93
130004,34,2857,1114,1743,746,336,410,2111,778,1333
130040,34,708,205,503,224,78,146,484,127,357
130110,34,133,48,85,83,32,51,50,16,34
130174,34,1301,588,713,1126,543,583,175,45,130
130183,34,10945,2836,8109,4153,1084,3069,6792,1752,5040
130217,34,693,246,447,206,79,127,487,167,320
130226,34,4751,1774,2977,4493,1685,2808,258,89,169
130253,34,4857,1563,3294,4229,1399,2830,628,164,464
130314,34,709,165,544,666,157,509,43,8,35
130396,34,4127,1408,2719,1096,467,629,3031,941,2090
130493,34,5562,2104,3458,4611,1732,2879,951,372,579
130509,34,408,26,382,164,13,151,244,13,231
130590,34,1620,819,801,1585,802,783,35,17,18
130606,34,2330,924,1406,838,349,489,1492,575,917
130624,34,764,456,308,764,456,308,,,
130697,34,2340,995,1345,2322,981,1341,18,14,4
130776,34,3295,1552,1743,2742,1300,1442,553,252,301
130794,34,4749,2376,2373,4745,2372,2373,4,4,0
130837,34,67,8,59,67,8,59,,,
130873,34,54,11,43,54,11,43,,,
130907,34,8251,2486,5765,1894,736,1158,6357,1750,4607
130934,34,3156,1049,2107,2825,938,1887,331,111,220
130943,34,14090,6048,8042,13386,5684,7702,704,364,340
130989,34,539,251,288,466,222,244,73,29,44
131061,34,77,4,73,39,2,37,38,2,36
131113,34,6977,2471,4506,2416,1004,1412,4561,1467,3094
131159,34,5786,2184,3602,5517,2060,3457,269,124,145
131283,34,2200,964,1236,2110,929,1181,90,35,55
131399,34,2517,930,1587,1150,509,641,1367,421,946
131450,34,846,388,458,759,353,406,87,35,52
131469,34,8358,3088,5270,7633,2788,4845,725,300,425
131496,34,5810,2528,3282,5613,2433,3180,197,95,102
131520,34,6134,1769,4365,5656,1593,4063,478,176,302
131803,34,355,82,273,27,16,11,328,66,262
131830,34,24,15,9,24,15,9,,,
131876,34,1170,27,1143,770,10,760,400,17,383
132374,34,1678,1460,218,1678,1460,218,,,
132408,34,226,119,107,157,83,74,69,36,33
132471,34,2216,733,1483,1889,598,1291,327,135,192
132602,34,1701,640,1061,1576,589,987,125,51,74
132657,34,1835,911,924,1661,827,834,174,84,90
132675,34,11,3,8,8,0,8,3,3,0
132693,34,8053,3078,4975,2282,1013,1269,5771,2065,3706
132709,34,20597,7984,12613,5476,2296,3180,15121,5688,9433
132842,34,160,28,132,95,17,78,65,11,54
132851,34,3420,1176,2244,1192,462,730,2228,714,1514
132879,34,115,68,47,101,61,40,14,7,7
132903,34,52620,23610,29010,35010,15696,19314,17610,7914,9696
132976,34,125,56,69,125,56,69,,,
133021,34,872,290,582,393,161,232,479,129,350
133155,34,328,173,155,191,126,65,137,47,90
133386,34,7534,2861,4673,2848,1296,1552,4686,1565,3121
133465,34,351,44,307,262,33,229,89,11,78
133492,34,1376,433,943,1331,415,916,45,18,27
133508,34,8432,2847,5585,2431,904,1527,6001,1943,4058
133526,34,756,375,381,699,354,345,57,21,36
133553,34,5037,3819,1218,4693,3535,1158,344,284,60
133650,34,5838,2030,3808,5055,1716,3339,783,314,469
133669,34,19770,8266,11504,12909,5444,7465,6861,2822,4039
133702,34,15022,5118,9904,4280,1616,2664,10742,3502,7240
133711,34,1881,624,1257,1808,592,1216,73,32,41
133809,34,336,170,166,330,167,163,6,3,3
133845,34,586,66,520,566,66,500,20,0,20
133854,34,254,54,200,254,54,200,,,
133863,34,312,39,273,312,39,273,,,
133872,34,984,149,835,333,57,276,651,92,559
133881,34,2463,1733,730,2328,1631,697,135,102,33
133942,34,53,4,49,53,4,49,,,
133951,34,35875,15571,20304,22582,9616,12966,13293,5955,7338
133960,34,666,252,414,221,125,96,445,127,318
133979,34,609,308,301,565,287,278,44,21,23
133997,34,285,116,169,285,116,169,,,
134024,34,20,8,12,20,8,12,,,
134079,34,1949,738,1211,1854,708,1146,95,30,65
134097,34,25751,11223,14528,22600,9636,12964,3151,1587,1564
134130,34,27257,11989,15268,24263,10350,13913,2994,1639,1355
134228,34,5,0,5,2,0,2,3,0,3
134237,34,19753,13604,6149,19753,13604,6149,,,
134291,34,193,158,35,187,153,34,6,5,1
134307,34,690,648,42,155,150,5,535,498,37
134343,34,2569,807,1762,891,301,590,1678,506,1172
134422,34,21,0,21,21,0,21,,,
134495,34,14720,5913,8807,5710,2635,3075,9010,3278,5732
134510,34,122,60,62,70,31,39,52,29,23
134529,34,207,16,191,207,16,191,,,
134574,34,71,9,62,71,9,62,,,
134608,34,8796,3191,5605,2615,1095,1520,6181,2096,4085
134714,34,118,10,108,30,3,27,88,7,81
134811,34,785,263,522,484,163,321,301,100,201
134945,34,1992,787,1205,1765,732,1033,227,55,172
135081,34,15387,4191,11196,8872,2608,6264,6515,1583,4932
135142,34,144,6,138,15,0,15,129,6,123
135160,34,1572,469,1103,552,187,365,1020,282,738
135179,34,424,237,187,265,147,118,159,90,69
135188,34,2294,824,1470,688,273,415,1606,551,1055
135267,34,267,167,100,264,165,99,3,2,1
135276,34,444,230,214,401,200,201,43,30,13
135294,34,314,146,168,251,144,107,63,2,61
135337,34,36,3,33,21,3,18,15,0,15
135364,34,194,130,64,27,17,10,167,113,54
135391,34,5553,1923,3630,1846,741,1105,3707,1182,2525
135407,34,417,238,179,416,238,178,1,0,1
135522,34,61,37,24,61,37,24,,,
135559,34,66,4,62,43,2,41,23,2,21
135610,34,79,31,48,34,15,19,45,16,29
135647,34,695,573,122,486,412,74,209,161,48
135717,34,30131,12057,18074,10936,4476,6460,19195,7581,11614
135726,34,9162,4256,4906,8736,4049,4687,426,207,219
135735,34,734,677,57,153,136,17,581,541,40
136109,34,107,1,106,55,1,54,52,0,52
136145,34,605,133,472,185,36,149,420,97,323
136172,34,11284,4885,6399,7973,3407,4566,3311,1478,1833
136215,34,4906,1375,3531,4157,1236,2921,749,139,610
136233,34,2569,931,1638,994,399,595,1575,532,1043
136303,34,64,7,57,58,7,51,6,0,6
136330,34,1769,620,1149,1631,571,1060,138,49,89
136358,34,16194,6169,10025,3819,1622,2197,12375,4547,7828
136400,34,5097,1922,3175,1836,748,1088,3261,1174,2087
136473,34,5549,1771,3778,2065,761,1304,3484,1010,2474
136491,34,491,290,201,395,266,129,96,24,72
136516,34,5772,1877,3895,1796,656,1140,3976,1221,2755
136659,34,106,80,26,101,75,26,5,5,0
136765,34,8,6,2,4,4,0,4,2,2
136774,34,1260,361,899,1235,357,878,25,4,21
136826,34,278,158,120,143,83,60,135,75,60
136950,34,1952,799,1153,1876,769,1107,76,30,46
137023,34,74,30,44,73,30,43,1,0,1
137032,34,5633,2196,3437,4069,1526,2543,1564,670,894
137078,34,17107,6138,10969,4590,1953,2637,12517,4185,8332
137087,34,479,238,241,450,233,217,29,5,24
137096,34,8646,3935,4711,3257,1637,1620,5389,2298,3091
137120,34,1084,615,469,530,288,242,554,327,227
137209,34,10691,4401,6290,3024,1505,1519,7667,2896,4771
137245,34,685,376,309,685,376,309,,,
137272,34,26,26,0,26,26,0,,,
137281,34,2981,959,2022,899,341,558,2082,618,1464
137315,34,1366,428,938,511,193,318,855,235,620
137351,34,30402,13150,17252,22702,9677,13025,7700,3473,4227
137476,34,1261,615,646,1071,567,504,190,48,142
137546,34,2189,966,1223,2132,935,1197,57,31,26
137564,34,4091,1670,2421,3432,1370,2062,659,300,359
137591,34,186,30,156,170,29,141,16,1,15
137713,34,36,10,26,5,0,5,31,10,21
137759,34,7575,3144,4431,3588,1598,1990,3987,1546,2441
137777,34,20,20,0,20,20,0,,,
137801,34,401,186,215,377,181,196,24,5,19
137847,34,6736,2728,4008,6417,2559,3858,319,169,150
137856,34,27,15,12,19,11,8,8,4,4
137865,34,209,111,98,204,106,98,5,5,0
137953,34,264,149,115,202,120,82,62,29,33
137962,34,165,92,73,126,71,55,39,21,18
138187,34,28860,11299,17561,8394,3546,4848,20466,7753,12713
138275,34,535,267,268,482,240,242,53,27,26
138284,34,40,20,20,31,17,14,9,3,6
138293,34,538,336,202,514,320,194,24,16,8
138309,34,7964,1082,6882,3965,563,3402,3999,519,3480
138354,34,7694,3221,4473,5126,2234,2892,2568,987,1581
138372,34,324,236,88,106,30,76,218,206,12
138479,34,344,229,115,344,229,115,,,
138488,34,185,105,80,85,22,63,100,83,17
138497,34,68,30,38,68,30,38,,,
138558,34,2458,994,1464,1596,756,840,862,238,624
138600,34,712,0,712,707,0,707,5,0,5
138655,34,558,383,175,528,363,165,30,20,10
138664,34,36,11,25,36,11,25,,,
138682,34,1664,437,1227,651,183,468,1013,254,759
138716,34,4530,1146,3384,2937,805,2132,1593,341,1252
138761,34,175,69,106,108,61,47,67,8,59
138813,34,489,245,244,313,154,159,176,91,85
138822,34,452,9,443,452,9,443,,,
138840,34,2696,845,1851,830,333,497,1866,512,1354
138868,34,637,284,353,510,250,260,127,34,93
138901,34,1223,404,819,444,141,303,779,263,516
138938,34,352,23,329,192,7,185,160,16,144
138947,34,2253,544,1709,2110,506,1604,143,38,105
138956,34,2659,1083,1576,902,375,527,1757,708,1049
139144,34,1441,529,912,1428,521,907,13,8,5
139153,34,174,98,76,75,38,37,99,60,39
139199,34,1133,82,1051,769,47,722,364,35,329
139205,34,388,240,148,344,210,134,44,30,14
139250,34,2146,630,1516,1172,360,812,974,270,704
139278,34,4023,1141,2882,1063,351,712,2960,790,2170
139311,34,4499,1273,3226,2747,770,1977,1752,503,1249
139357,34,2162,549,1613,617,191,426,1545,358,1187
139366,34,4781,1867,2914,3099,1137,1962,1682,730,952
139384,34,3500,1136,2364,1155,438,717,2345,698,1647
139393,34,574,262,312,554,249,305,20,13,7
139463,34,3332,1234,2098,1917,730,1187,1415,504,911
139506,34,79,52,27,79,52,27,,,
139579,34,223,58,165,148,40,108,75,18,57
139621,34,1008,413,595,658,280,378,350,133,217
139630,34,540,299,241,512,284,228,28,15,13
139658,34,5556,2373,3183,5480,2329,3151,76,44,32
139700,34,3720,1286,2434,1357,528,829,2363,758,1605
139719,34,1879,686,1193,1568,572,996,311,114,197
139746,34,67,14,53,67,14,53,,,
139755,34,13081,7900,5181,11718,7048,4670,1363,852,511
139764,34,1633,555,1078,1136,395,741,497,160,337
139861,34,3982,1461,2521,3525,1251,2274,457,210,247
139931,34,16833,7150,9683,13795,5860,7935,3038,1290,1748
139940,34,22357,8884,13473,16155,6357,9798,6202,2527,3675
139959,34,24213,10494,13719,22377,9563,12814,1836,931,905
139968,34,1962,568,1394,1114,362,752,848,206,642
139986,34,3425,823,2602,987,257,730,2438,566,1872
139995,34,136,58,78,136,58,78,,,
140003,34,156,29,127,75,17,58,81,12,69
140012,34,5744,2298,3446,1281,635,646,4463,1663,2800
140234,34,450,232,218,434,231,203,16,1,15
140243,34,3160,1172,1988,880,336,544,2280,836,1444
140252,34,735,343,392,576,289,287,159,54,105
140331,34,6229,2496,3733,1757,815,942,4472,1681,2791
140340,34,524,87,437,316,62,254,208,25,183
140447,34,3730,1323,2407,3226,1198,2028,504,125,379
140553,34,1925,1925,0,1578,1578,0,347,347,0
140678,34,1573,591,982,553,228,325,1020,363,657
140696,34,1004,378,626,957,358,599,47,20,27
140720,34,162,81,81,138,69,69,24,12,12
140818,34,964,310,654,869,293,576,95,17,78
140827,34,66,12,54,66,12,54,,,
140872,34,847,423,424,758,383,375,89,40,49
140942,34,2673,878,1795,818,348,470,1855,530,1325
140951,34,9857,3078,6779,7972,2471,5501,1885,607,1278
140960,34,2227,880,1347,1748,706,1042,479,174,305
140988,34,874,373,501,798,349,449,76,24,52
141006,34,1040,469,571,511,257,254,529,212,317
141015,34,119,50,69,116,47,69,3,3,0
141060,34,1623,0,1623,1569,0,1569,54,0,54
141167,34,594,241,353,376,167,209,218,74,144
141185,34,607,240,367,552,223,329,55,17,38
141237,34,597,282,315,560,263,297,37,19,18
141255,34,2023,641,1382,607,186,421,1416,455,961
141264,34,6639,2186,4453,4864,1616,3248,1775,570,1205
141325,34,463,0,463,335,0,335,128,0,128
141334,34,7029,2407,4622,5300,1832,3468,1729,575,1154
141361,34,588,251,337,583,248,335,5,3,2
141486,34,1246,327,919,1018,255,763,228,72,156
141565,34,2171,755,1416,1580,548,1032,591,207,384
141574,34,10900,4463,6437,8435,3377,5058,2465,1086,1379
141608,34,65,43,22,65,43,22,,,
141644,34,1936,727,1209,1488,485,1003,448,242,206
141680,34,1649,1000,649,635,403,232,1014,597,417
141796,34,3241,1156,2085,1145,459,686,2096,697,1399
141802,34,600,197,403,142,72,70,458,125,333
141811,34,3210,1139,2071,1245,510,735,1965,629,1336
141839,34,1474,427,1047,451,140,311,1023,287,736
141981,34,2427,825,1602,1453,512,941,974,313,661
141990,34,805,219,586,292,63,229,513,156,357
142054,34,448,63,385,448,63,385,,,
142090,34,68,41,27,56,35,21,12,6,6
142115,34,13872,5985,7887,10149,4421,5728,3723,1564,2159
142179,34,1003,310,693,408,160,248,595,150,445
142276,34,5352,2172,3180,3991,1637,2354,1361,535,826
142285,34,5205,2567,2638,4726,2325,2401,479,242,237
142294,34,823,408,415,809,397,412,14,11,3
142328,34,1977,673,1304,1453,546,907,524,127,397
142407,34,79,9,70,56,9,47,23,0,23
142416,34,2,0,2,2,0,2,,,
142443,34,2152,727,1425,846,390,456,1306,337,969
142461,34,897,363,534,768,319,449,129,44,85
142489,34,34,0,34,34,0,34,,,
142522,34,38674,16994,21680,13857,6798,7059,24817,10196,14621
142559,34,2496,802,1694,1034,398,636,1462,404,1058
142887,34,120,35,85,93,29,64,27,6,21
142957,34,4,3,1,2,2,0,2,1,1
143048,34,2127,558,1569,1852,485,1367,275,73,202
143084,34,1669,752,917,1650,739,911,19,13,6
143118,34,3254,1056,2198,2944,967,1977,310,89,221
143215,34,4576,1881,2695,1985,903,1082,2591,978,1613
143279,34,1650,523,1127,720,259,461,930,264,666
143288,34,307,135,172,302,132,170,5,3,2
143297,34,141,8,133,112,5,107,29,3,26
143358,34,3277,1647,1630,3175,1586,1589,102,61,41
143376,34,209,12,197,125,10,115,84,2,82
143464,34,111,3,108,86,3,83,25,0,25
143473,34,33,1,32,18,1,17,15,0,15
143482,34,21,0,21,10,0,10,11,0,11
143491,34,26,0,26,9,0,9,17,0,17
143552,34,43,1,42,21,0,21,22,1,21
143613,34,815,243,572,403,151,252,412,92,320
143978,34,30,5,25,23,4,19,7,1,6
144005,34,1328,387,941,807,252,555,521,135,386
144050,34,5505,2888,2617,5503,2887,2616,2,1,1
144157,34,863,323,540,361,157,204,502,166,336
144166,34,4236,892,3344,1589,373,1216,2647,519,2128
144175,34,775,259,516,312,127,185,463,132,331
144184,34,1701,631,1070,596,248,348,1105,383,722
144193,34,1648,865,783,726,488,238,922,377,545
144209,34,3324,1318,2006,1436,582,854,1888,736,1152
144218,34,3465,1552,1913,1375,686,689,2090,866,1224
144281,34,4762,1900,2862,4423,1746,2677,339,154,185
144351,34,1031,438,593,886,379,507,145,59,86
144485,34,149,102,47,149,102,47,,,
144564,34,963,371,592,459,170,289,504,201,303
144573,34,126,2,124,80,1,79,46,1,45
144740,34,11221,5308,5913,10014,4692,5322,1207,616,591
144795,34,295,67,228,260,59,201,35,8,27
144865,34,11738,5200,6538,4348,2065,2283,7390,3135,4255
144883,34,222,109,113,222,109,113,,,
144892,34,3838,1457,2381,3210,1258,1952,628,199,429
144944,34,5131,2264,2867,1562,764,798,3569,1500,2069
144962,34,2260,866,1394,2158,813,1345,102,53,49
144971,34,349,183,166,338,175,163,11,8,3
145099,34,232,17,215,232,17,215,,,
145239,34,284,46,238,284,46,238,,,
145309,34,30,12,18,30,12,18,,,
145336,34,2504,903,1601,1468,545,923,1036,358,678
145354,34,50,2,48,10,0,10,40,2,38
145372,34,622,324,298,571,307,264,51,17,34
145406,34,448,7,441,120,3,117,328,4,324
145424,34,58,2,56,18,2,16,40,0,40
145433,34,102,1,101,44,0,44,58,1,57
145497,34,77,12,65,64,9,55,13,3,10
145521,34,619,190,429,282,100,182,337,90,247
145600,34,17834,8462,9372,15886,7501,8385,1948,961,987
145619,34,1759,851,908,1424,711,713,335,140,195
145637,34,25592,13789,11803,24840,13283,11557,752,506,246
145646,34,1213,576,637,1209,575,634,4,1,3
145682,34,3678,1368,2310,1215,570,645,2463,798,1665
145691,34,839,392,447,817,384,433,22,8,14
145707,34,322,113,209,216,83,133,106,30,76
145725,34,2384,1616,768,2176,1450,726,208,166,42
145813,34,14258,6167,8091,13075,5570,7505,1183,597,586
145831,34,1349,586,763,542,250,292,807,336,471
146205,34,1608,610,998,834,337,497,774,273,501
146278,34,900,315,585,446,176,270,454,139,315
146296,34,8168,3468,4700,3273,1540,1733,4895,1928,2967
146339,34,735,324,411,658,306,352,77,18,59
146348,34,1416,501,915,534,213,321,882,288,594
146366,34,1282,390,892,733,235,498,549,155,394
146418,34,1288,504,784,524,237,287,764,267,497
146427,34,870,372,498,859,367,492,11,5,6
146454,34,29,0,29,29,0,29,,,
146472,34,7348,3112,4236,2325,1141,1184,5023,1971,3052
146481,34,1240,490,750,1224,481,743,16,9,7
146506,34,1644,603,1041,1001,393,608,643,210,433
146533,34,152,30,122,105,21,84,47,9,38
146603,34,1887,678,1209,837,358,479,1050,320,730
146612,34,3232,1584,1648,2686,1290,1396,546,294,252
146667,34,203,121,82,159,95,64,44,26,18
146676,34,596,285,311,452,246,206,144,39,105
146685,34,2989,1067,1922,1020,436,584,1969,631,1338
146700,34,890,635,255,890,635,255,,,
146719,34,8872,2887,5985,8327,2701,5626,545,186,359
146755,34,108,17,91,72,13,59,36,4,32
146807,34,70,7,63,23,3,20,47,4,43
146816,34,194,21,173,120,10,110,74,11,63
147004,34,3853,1701,2152,1600,807,793,2253,894,1359
147013,34,1168,572,596,988,509,479,180,63,117
147129,34,507,58,449,242,31,211,265,27,238
147244,34,1310,541,769,1246,523,723,64,18,46
147341,34,571,266,305,569,266,303,2,0,2
147369,34,1708,877,831,1354,664,690,354,213,141
147378,34,5735,2496,3239,2439,1145,1294,3296,1351,1945
147396,34,46,44,2,43,41,2,3,3,0
147411,34,2090,796,1294,584,267,317,1506,529,977
147536,34,2927,699,2228,2065,554,1511,862,145,717
147590,34,19,6,13,15,5,10,4,1,3
147642,34,40,4,36,15,1,14,25,3,22
147660,34,1872,872,1000,1836,854,982,36,18,18
147679,34,1370,552,818,1232,497,735,138,55,83
147703,34,9534,4554,4980,7847,3674,4173,1687,880,807
147767,34,6605,3125,3480,6326,3011,3315,279,114,165
147776,34,4217,1742,2475,2313,940,1373,1904,802,1102
147800,34,5726,2736,2990,1639,837,802,4087,1899,2188
147819,34,16,1,15,16,1,15,,,
147828,34,1939,813,1126,1834,785,1049,105,28,77
147916,34,2428,1123,1305,1097,541,556,1331,582,749
148007,34,1818,601,1217,531,203,328,1287,398,889
148016,34,239,124,115,235,121,114,4,3,1
148098,34,36,0,36,21,0,21,15,0,15
148131,34,734,343,391,707,330,377,27,13,14
148256,34,801,327,474,559,234,325,242,93,149
148292,34,1162,338,824,378,132,246,784,206,578
148380,34,3471,1496,1975,1338,634,704,2133,862,1271
148405,34,754,310,444,697,291,406,57,19,38
148487,34,2078,778,1300,1738,667,1071,340,111,229
148496,34,1572,487,1085,1447,450,997,125,37,88
148511,34,118,29,89,54,9,45,64,20,44
148575,34,272,42,230,216,33,183,56,9,47
148584,34,1315,387,928,1048,336,712,267,51,216
148593,34,93,9,84,86,9,77,7,0,7
148627,34,2340,832,1508,2106,734,1372,234,98,136
148654,34,2177,1052,1125,1455,651,804,722,401,321
148672,34,735,264,471,353,124,229,382,140,242
148821,34,479,137,342,250,71,179,229,66,163
148876,34,655,122,533,484,87,397,171,35,136
148937,34,399,170,229,236,116,120,163,54,109
148991,34,665,252,413,390,162,228,275,90,185
149028,34,188,21,167,142,20,122,46,1,45
149204,34,31,0,31,31,0,31,,,
149222,34,6551,3438,3113,5359,2749,2610,1192,689,503
149231,34,7911,3472,4439,6135,2763,3372,1776,709,1067
149310,34,104,45,59,104,45,59,,,
149329,34,59,59,0,59,59,0,,,
149365,34,1764,508,1256,523,183,340,1241,325,916
149499,34,6,0,6,6,0,6,,,
149505,34,652,219,433,552,192,360,100,27,73
149514,34,380,223,157,314,187,127,66,36,30
149532,34,5165,2375,2790,1548,696,852,3617,1679,1938
149550,34,121,17,104,94,15,79,27,2,25
149639,34,52,28,24,52,28,24,,,
149727,34,4275,1770,2505,1403,679,724,2872,1091,1781
149763,34,506,94,412,369,66,303,137,28,109
149772,34,4348,1940,2408,3669,1613,2056,679,327,352
149781,34,1755,797,958,1657,743,914,98,54,44
149842,34,6870,2879,3991,2275,1132,1143,4595,1747,2848
150066,34,820,348,472,747,331,416,73,17,56
150136,34,10618,4132,6486,9789,3822,5967,829,310,519
150145,34,858,314,544,737,284,453,121,30,91
150163,34,3256,1319,1937,3193,1277,1916,63,42,21
150172,34,410,229,181,266,135,131,144,94,50
150251,34,191,9,182,99,3,96,92,6,86
150303,34,265,5,260,83,3,80,182,2,180
150400,34,1208,601,607,1200,598,602,8,3,5
150428,34,4,0,4,4,0,4,,,
150455,34,482,212,270,482,212,270,,,
150534,34,1227,482,745,1179,468,711,48,14,34
150604,34,625,325,300,614,319,295,11,6,5
150668,34,542,212,330,499,198,301,43,14,29
150677,34,989,407,582,941,384,557,48,23,25
150756,34,724,349,375,719,346,373,5,3,2
150765,34,115,2,113,115,2,113,,,
150774,34,231,138,93,221,132,89,10,6,4
150853,34,211,1,210,114,1,113,97,0,97
150941,34,751,301,450,656,264,392,95,37,58
150987,34,40141,16362,23779,9974,3470,6504,30167,12892,17275
151102,34,4415,2193,2222,3492,1716,1776,923,477,446
151111,34,15211,6254,8957,12528,5074,7454,2683,1180,1503
151263,34,2902,1074,1828,2658,990,1668,244,84,160
151290,34,934,569,365,892,545,347,42,24,18
151306,34,4704,1653,3051,3888,1374,2514,816,279,537
151324,34,6223,2724,3499,4858,2107,2751,1365,617,748
151333,34,2025,708,1317,1653,575,1078,372,133,239
151342,34,3094,1091,2003,2252,781,1471,842,310,532
151351,34,24513,12330,12183,23629,11874,11755,884,456,428
151360,34,2459,622,1837,1755,445,1310,704,177,527
151379,34,2839,1141,1698,1868,717,1151,971,424,547
151388,34,2310,784,1526,1352,385,967,958,399,559
151467,34,169,25,144,169,25,144,,,
151564,34,7,0,7,5,0,5,2,0,2
151607,34,98,4,94,68,3,65,30,1,29
151652,34,128,3,125,75,2,73,53,1,52
151661,34,930,866,64,930,866,64,,,
151777,34,670,330,340,659,322,337,11,8,3
151786,34,2081,722,1359,1756,656,1100,325,66,259
151801,34,1703,611,1092,1657,595,1062,46,16,30
151810,34,158,43,115,79,21,58,79,22,57
151962,34,228,74,154,228,74,154,,,
152044,34,26,20,6,14,11,3,12,9,3
152080,34,6891,3561,3330,6874,3549,3325,17,12,5
152099,34,416,213,203,369,192,177,47,21,26
152150,34,48,3,45,33,2,31,15,1,14
152275,34,131,43,88,77,9,68,54,34,20
152309,34,90,35,55,72,28,44,18,7,11
152318,34,1438,1085,353,1417,1070,347,21,15,6
152336,34,1274,353,921,1068,336,732,206,17,189
152381,34,590,96,494,480,86,394,110,10,100
152390,34,1000,0,1000,992,0,992,8,0,8
152497,34,145,12,133,124,12,112,21,0,21
152530,34,1315,601,714,1268,575,693,47,26,21
152567,34,1611,1019,592,1572,994,578,39,25,14
152600,34,1892,807,1085,1863,795,1068,29,12,17
152628,34,19,0,19,9,0,9,10,0,10
152637,34,2845,1461,1384,1794,892,902,1051,569,482
152673,34,630,630,0,627,627,0,3,3,0
152798,34,313,25,288,280,24,256,33,1,32
152992,34,479,229,250,413,219,194,66,10,56
153001,34,1214,404,810,1038,358,680,176,46,130
153074,34,128,5,123,128,5,123,,,
153083,34,131,5,126,131,5,126,,,
153108,34,766,396,370,739,378,361,27,18,9
153126,34,519,275,244,506,269,237,13,6,7
153144,34,950,425,525,939,418,521,11,7,4
153162,34,679,356,323,671,349,322,8,7,1
153214,34,7601,3045,4556,3365,1531,1834,4236,1514,2722
153241,34,64,25,39,64,25,39,,,
153250,34,984,520,464,977,517,460,7,3,4
153269,34,2070,848,1222,1986,800,1186,84,48,36
153278,34,1252,715,537,961,604,357,291,111,180
153296,34,349,156,193,297,141,156,52,15,37
153302,34,128,62,66,113,54,59,15,8,7
153311,34,2581,793,1788,1201,425,776,1380,368,1012
153320,34,213,104,109,180,87,93,33,17,16
153366,34,673,280,393,629,276,353,44,4,40
153375,34,1241,574,667,1108,515,593,133,59,74
153384,34,1242,598,644,1238,597,641,4,1,3
153427,34,72,25,47,72,25,47,,,
153445,34,1790,685,1105,1059,474,585,731,211,520
153463,34,18,1,17,18,1,17,,,
153472,34,1212,495,717,916,418,498,296,77,219
153524,34,1832,833,999,1294,668,626,538,165,373
153533,34,612,301,311,438,243,195,174,58,116
153542,34,14,2,12,14,2,12,,,
153597,34,8,0,8,8,0,8,,,
153603,34,20150,11446,8704,19080,10746,8334,1070,700,370
153621,34,454,232,222,414,219,195,40,13,27
153630,34,2418,958,1460,1343,688,655,1075,270,805
153658,34,16677,7557,9120,15153,6851,8302,1524,706,818
153737,34,5615,2225,3390,2552,1153,1399,3063,1072,1991
153746,34,16,1,15,16,1,15,,,
153764,34,29,1,28,29,1,28,,,
153773,34,14,0,14,14,0,14,,,
153782,34,9,0,9,9,0,9,,,
153825,34,940,533,407,888,495,393,52,38,14
153834,34,1313,553,760,1293,538,755,20,15,5
153861,34,614,136,478,304,73,231,310,63,247
153922,34,502,176,326,308,129,179,194,47,147
153977,34,899,141,758,492,100,392,407,41,366
154004,34,818,407,411,788,395,393,30,12,18
154013,34,1058,352,706,796,271,525,262,81,181
154022,34,30747,10734,20013,30747,10734,20013,,,
154059,34,874,363,511,594,270,324,280,93,187
154095,34,6259,2490,3769,5726,2251,3475,533,239,294
154101,34,762,374,388,706,368,338,56,6,50
154110,34,1271,343,928,459,210,249,812,133,679
154129,34,494,209,285,295,173,122,199,36,163
154165,34,6,0,6,6,0,6,,,
154174,34,39,18,21,36,18,18,3,0,3
154208,34,94,2,92,11,0,11,83,2,81
154235,34,1727,736,991,1629,696,933,98,40,58
154262,34,183,19,164,79,10,69,104,9,95
154332,34,55,2,53,55,2,53,,,
154350,34,880,402,478,786,361,425,94,41,53
154378,34,955,309,646,627,218,409,328,91,237
154396,34,462,153,309,311,124,187,151,29,122
154448,34,119,1,118,119,1,118,,,
154457,34,9,0,9,9,0,9,,,
154466,34,37,3,34,37,3,34,,,
154493,34,2123,806,1317,1111,429,682,1012,377,635
154518,34,1843,1127,716,1263,715,548,580,412,168
154527,34,1092,512,580,1059,489,570,33,23,10
154545,34,38,30,8,38,30,8,,,
154572,34,1922,617,1305,904,391,513,1018,226,792
154590,34,943,466,477,887,443,444,56,23,33
154642,34,820,291,529,420,186,234,400,105,295
154688,34,987,416,571,762,337,425,225,79,146
154697,34,1560,575,985,761,290,471,799,285,514
154712,34,1470,716,754,1455,707,748,15,9,6
154721,34,434,231,203,431,230,201,3,1,2
154749,34,328,180,148,321,174,147,7,6,1
154800,34,4567,1635,2932,1781,699,1082,2786,936,1850
154855,34,397,171,226,375,159,216,22,12,10
154907,34,515,177,338,316,129,187,199,48,151
154925,34,496,256,240,417,218,199,79,38,41
154934,34,649,152,497,396,128,268,253,24,229
154952,34,1221,465,756,727,329,398,494,136,358
154998,34,700,297,403,406,210,196,294,87,207
155007,34,290,83,207,120,45,75,170,38,132
155025,34,2378,827,1551,2178,766,1412,200,61,139
155052,34,225,107,118,153,73,80,72,34,38
155061,34,10069,3898,6171,3898,1549,2349,6171,2349,3822
155070,34,144,65,79,123,56,67,21,9,12
155089,34,695,315,380,572,266,306,123,49,74
155098,34,649,295,354,447,214,233,202,81,121
155104,34,905,375,530,543,263,280,362,112,250
155140,34,533,185,348,472,166,306,61,19,42
155159,34,54,0,54,54,0,54,,,
155177,34,216,72,144,189,65,124,27,7,20
155186,34,945,402,543,485,231,254,460,171,289
155195,34,2214,806,1408,1031,436,595,1183,370,813
155201,34,311,177,134,253,155,98,58,22,36
155210,34,8459,3679,4780,2883,1325,1558,5576,2354,3222
155283,34,522,46,476,497,45,452,25,1,24
155292,34,2676,1013,1663,959,403,556,1717,610,1107
155308,34,96,73,23,93,72,21,3,1,2
155317,34,14308,6752,7556,12490,5948,6542,1818,804,1014
155335,34,715,255,460,667,227,440,48,28,20
155353,34,16,13,3,16,13,3,,,
155399,34,12536,6342,6194,11104,5700,5404,1432,642,790
155414,34,504,294,210,465,270,195,39,24,15
155423,34,988,580,408,758,496,262,230,84,146
155450,34,1154,428,726,345,111,234,809,317,492
155487,34,256,119,137,173,90,83,83,29,54
155496,34,130,76,54,104,64,40,26,12,14
155511,34,554,373,181,540,362,178,14,11,3
155520,34,799,329,470,690,298,392,109,31,78
155566,34,526,153,373,287,108,179,239,45,194
155593,34,233,124,109,189,110,79,44,14,30
155618,34,179,116,63,152,111,41,27,5,22
155627,34,556,332,224,515,299,216,41,33,8
155636,34,283,58,225,111,28,83,172,30,142
155681,34,3480,1751,1729,3210,1644,1566,270,107,163
155715,34,314,187,127,236,143,93,78,44,34
155812,34,549,268,281,497,244,253,52,24,28
155830,34,163,64,99,114,50,64,49,14,35
155858,34,614,202,412,337,134,203,277,68,209
155900,34,941,609,332,455,268,187,486,341,145
155937,34,393,227,166,328,192,136,65,35,30
155973,34,372,223,149,356,213,143,16,10,6
156082,34,3291,1227,2064,2480,935,1545,811,292,519
156107,34,1880,946,934,897,537,360,983,409,574
156125,34,8652,3830,4822,6733,2973,3760,1919,857,1062
156134,34,891,517,374,891,517,374,,,
156189,34,410,203,207,377,188,189,33,15,18
156213,34,1072,440,632,866,357,509,206,83,123
156231,34,1258,476,782,763,336,427,495,140,355
156277,34,26,2,24,26,2,24,,,
156286,34,1763,668,1095,1699,641,1058,64,27,37
156295,34,1116,454,662,1094,446,648,22,8,14
156310,34,237,4,233,212,4,208,25,0,25
156338,34,2199,833,1366,1029,440,589,1170,393,777
156356,34,577,201,376,492,186,306,85,15,70
156365,34,1971,733,1238,1716,669,1047,255,64,191
156392,34,5979,2256,3723,2566,1098,1468,3413,1158,2255
156408,34,938,459,479,938,459,479,,,
156417,34,96,79,17,62,50,12,34,29,5
156426,34,165,11,154,105,8,97,60,3,57
156471,34,2999,264,2735,1292,101,1191,1707,163,1544
156541,34,3766,1221,2545,3029,1014,2015,737,207,530
156620,34,8494,3527,4967,6882,2763,4119,1612,764,848
156648,34,2785,1060,1725,1163,473,690,1622,587,1035
156745,34,747,355,392,743,352,391,4,3,1
156754,34,42,1,41,42,1,41,,,
156790,34,1122,369,753,577,212,365,545,157,388
156842,34,160,8,152,110,5,105,50,3,47
156851,34,667,137,530,249,58,191,418,79,339
156860,34,1138,300,838,439,106,333,699,194,505
156921,34,5639,2238,3401,1849,801,1048,3790,1437,2353
156967,34,80,0,80,80,0,80,,,
157021,34,179,13,166,17,4,13,162,9,153
157030,34,55,33,22,40,21,19,15,12,3
157058,34,1184,488,696,934,387,547,250,101,149
157076,34,569,283,286,546,273,273,23,10,13
157085,34,16637,7228,9409,15181,6545,8636,1456,683,773
157100,34,325,206,119,321,205,116,4,1,3
157216,34,1272,472,800,1191,443,748,81,29,52
157289,34,11120,5087,6033,8929,4051,4878,2191,1036,1155
157304,34,1437,432,1005,523,147,376,914,285,629
157331,34,1510,418,1092,640,235,405,870,183,687
157377,34,931,304,627,744,268,476,187,36,151
157386,34,4026,1576,2450,3440,1383,2057,586,193,393
157401,34,5355,2029,3326,4513,1739,2774,842,290,552
157438,34,1970,814,1156,625,313,312,1345,501,844
157447,34,7292,2915,4377,5754,2325,3429,1538,590,948
157483,34,2197,645,1552,994,349,645,1203,296,907
157535,34,756,351,405,729,336,393,27,15,12
157553,34,1272,474,798,810,333,477,462,141,321
157614,34,67,0,67,33,0,33,34,0,34
157650,34,69,4,65,45,2,43,24,2,22
157669,34,65,1,64,65,1,64,,,
157678,34,62,1,61,62,1,61,,,
157711,34,2589,817,1772,1279,492,787,1310,325,985
157739,34,1075,318,757,598,176,422,477,142,335
157748,34,660,355,305,476,241,235,184,114,70
157757,34,579,159,420,475,142,333,104,17,87
157793,34,2054,661,1393,1155,373,782,899,288,611
157809,34,1057,498,559,927,448,479,130,50,80
157818,34,684,277,407,674,272,402,10,5,5
157863,34,636,334,302,601,323,278,35,11,24
157951,34,9694,3783,5911,8364,3274,5090,1330,509,821
158088,34,980,436,544,686,278,408,294,158,136
158246,34,107,40,67,107,40,67,,,
158325,34,110,14,96,110,14,96,,,
158343,34,24,11,13,13,5,8,11,6,5
158431,34,3962,1103,2859,1821,564,1257,2141,539,1602
158477,34,380,159,221,374,155,219,6,4,2
158538,34,56,1,55,56,1,55,,,
158617,34,178,67,111,178,67,111,,,
158662,34,9600,2617,6983,2986,946,2040,6614,1671,4943
158778,34,35,3,32,35,3,32,,,
158787,34,45,2,43,45,2,43,,,
158802,34,891,215,676,819,194,625,72,21,51
158884,34,1260,405,855,529,189,340,731,216,515
159009,34,3655,1315,2340,3124,1141,1983,531,174,357
159027,34,12,0,12,12,0,12,,,
159197,34,419,361,58,419,361,58,,,
159328,34,82,1,81,82,1,81,,,
159373,34,893,115,778,788,97,691,105,18,87
159382,34,2766,736,2030,1670,469,1201,1096,267,829
159391,34,19410,9139,10271,18166,8483,9683,1244,656,588
159407,34,1760,413,1347,906,245,661,854,168,686
159416,34,1890,714,1176,1372,531,841,518,183,335
159513,34,166,6,160,166,6,160,,,
159522,34,134,7,127,134,7,127,,,
159531,34,28,0,28,28,0,28,,,
159568,34,608,315,293,578,302,276,30,13,17
159601,34,14,1,13,14,1,13,,,
159647,34,5914,3252,2662,5450,3042,2408,464,210,254
159656,34,2302,786,1516,2111,715,1396,191,71,120
159717,34,4182,1548,2634,3637,1347,2290,545,201,344
159939,34,4478,2206,2272,3446,1693,1753,1032,513,519
159948,34,709,447,262,159,95,64,550,352,198
159966,34,4223,1509,2714,3626,1299,2327,597,210,387
159993,34,4236,1397,2839,3174,1134,2040,1062,263,799
160010,34,592,368,224,192,153,39,400,215,185
160038,34,6213,1613,4600,4232,1235,2997,1981,378,1603
160065,34,469,76,393,287,52,235,182,24,158
160074,34,832,133,699,403,67,336,429,66,363
160117,34,199,1,198,199,1,198,,,
160126,34,33,0,33,7,0,7,26,0,26
160199,34,32,0,32,32,0,32,,,
160320,34,2362,82,2280,2362,82,2280,,,
160409,34,100,100,0,98,98,0,2,2,0
160472,34,77,2,75,52,2,50,25,0,25
160481,34,1177,313,864,545,175,370,632,138,494
160524,34,176,45,131,176,45,131,,,
160579,34,2041,912,1129,1032,505,527,1009,407,602
160597,34,124,40,84,64,19,45,60,21,39
160612,34,7880,2839,5041,6761,2445,4316,1119,394,725
160621,34,4195,1372,2823,3483,1170,2313,712,202,510
160630,34,1182,264,918,833,194,639,349,70,279
160649,34,1521,379,1142,889,277,612,632,102,530
160658,34,9919,4219,5700,8213,3588,4625,1706,631,1075
160667,34,1438,626,812,932,404,528,506,222,284
160755,34,6488,2577,3911,6108,2427,3681,380,150,230
160904,34,1738,410,1328,1653,378,1275,85,32,53
160959,34,276,84,192,265,82,183,11,2,9
160977,34,1268,630,638,1268,630,638,,,
160995,34,255,36,219,255,36,219,,,
161004,34,1431,698,733,1431,698,733,,,
161022,34,224,21,203,105,9,96,119,12,107
161077,34,1392,505,887,485,224,261,907,281,626
161086,34,1595,760,835,1595,760,835,,,
161138,34,991,409,582,460,202,258,531,207,324
161192,34,989,284,705,269,89,180,720,195,525
161208,34,40,36,4,40,36,4,,,
161217,34,2698,759,1939,1179,326,853,1519,433,1086
161226,34,1035,335,700,941,305,636,94,30,64
161235,34,951,236,715,489,152,337,462,84,378
161253,34,6930,3596,3334,5893,3006,2887,1037,590,447
161299,34,661,548,113,625,516,109,36,32,4
161341,34,821,267,554,580,200,380,241,67,174
161457,34,1629,494,1135,1591,478,1113,38,16,22
161484,34,315,132,183,156,78,78,159,54,105
161493,34,91,1,90,67,0,67,24,1,23
161509,34,303,75,228,286,71,215,17,4,13
161518,34,844,287,557,565,204,361,279,83,196
161527,34,89,8,81,60,2,58,29,6,23
161545,34,3169,1350,1819,1126,561,565,2043,789,1254
161554,34,3773,1514,2259,2664,1053,1611,1109,461,648
161563,34,476,244,232,461,239,222,15,5,10
161572,34,1737,454,1283,1736,454,1282,1,0,1
161581,34,152,55,97,95,46,49,57,9,48
161688,34,1348,292,1056,487,156,331,861,136,725
161767,34,6859,2494,4365,1695,761,934,5164,1733,3431
161800,34,65,31,34,25,10,15,40,21,19
161855,34,18,1,17,15,1,14,3,0,3
161864,34,2673,620,2053,590,168,422,2083,452,1631
161873,34,1513,598,915,809,321,488,704,277,427
162007,34,4366,1708,2658,3450,1335,2115,916,373,543
162061,34,277,222,55,223,179,44,54,43,11
162104,34,982,320,662,270,115,155,712,205,507
162122,34,3921,1368,2553,1337,565,772,2584,803,1781
162168,34,983,289,694,205,81,124,778,208,570
162210,34,538,170,368,429,134,295,109,36,73
162283,34,1608,338,1270,1178,262,916,430,76,354
162335,34,45,0,45,45,0,45,,,
162371,34,480,432,48,480,432,48,,,
162557,34,2672,1021,1651,773,358,415,1899,663,1236
162584,34,2702,1181,1521,2167,1059,1108,535,122,413
162609,34,220,118,102,129,75,54,91,43,48
162654,34,790,265,525,769,256,513,21,9,12
162690,34,2055,662,1393,605,269,336,1450,393,1057
162706,34,2878,1106,1772,949,434,515,1929,672,1257
162760,34,878,308,570,836,292,544,42,16,26
162779,34,5890,2299,3591,1643,773,870,4247,1526,2721
162830,34,101,4,97,101,4,97,,,
162928,34,4307,2047,2260,4299,2040,2259,8,7,1
163028,34,779,669,110,530,456,74,249,213,36
163046,34,2814,1191,1623,2776,1169,1607,38,22,16
163204,34,42355,22982,19373,9722,4943,4779,32633,18039,14594
163259,34,912,168,744,724,139,585,188,29,159
163268,34,8695,4704,3991,7109,3853,3256,1586,851,735
163286,34,24296,12555,11741,22301,11456,10845,1995,1099,896
163295,34,1228,306,922,1175,294,881,53,12,41
163338,34,1307,592,715,1176,537,639,131,55,76
163347,34,411,28,383,411,28,383,,,
163408,34,83,20,63,49,7,42,34,13,21
163426,34,11216,5238,5978,3346,1635,1711,7870,3603,4267
163453,34,4701,1827,2874,3970,1510,2460,731,317,414
163462,34,1477,715,762,1373,657,716,104,58,46
163532,34,223,223,0,223,223,0,,,
163541,34,255,114,141,128,65,63,127,49,78
163578,34,691,28,663,531,19,512,160,9,151
163657,34,6714,2207,4507,1936,702,1234,4778,1505,3273
163815,34,44,1,43,19,0,19,25,1,24
163851,34,5238,2331,2907,4886,2145,2741,352,186,166
163912,34,1126,457,669,1088,443,645,38,14,24
163976,34,333,177,156,330,175,155,3,2,1
164076,34,15225,6205,9020,12941,5190,7751,2284,1015,1269
164155,34,3367,2409,958,3367,2409,958,,,
164173,34,2331,816,1515,1989,743,1246,342,73,269
164216,34,750,308,442,744,303,441,6,5,1
164270,34,1240,533,707,1231,528,703,9,5,4
164313,34,1552,463,1089,304,133,171,1248,330,918
164368,34,483,309,174,483,309,174,,,
164447,34,922,338,584,859,319,540,63,19,44
164465,34,1457,732,725,1457,732,725,,,
164492,34,889,497,392,735,375,360,154,122,32
164535,34,31,4,27,31,4,27,,,
164562,34,1481,648,833,1464,638,826,17,10,7
164580,34,1882,1093,789,1870,1086,784,12,7,5
164599,34,30,7,23,,,,30,7,23
164614,34,37,26,11,29,20,9,8,6,2
164632,34,1365,0,1365,847,0,847,518,0,518
164641,34,310,110,200,151,77,74,159,33,126
164739,34,2923,1763,1160,2837,1706,1131,86,57,29
164748,34,5419,3187,2232,3937,2214,1723,1482,973,509
164775,34,873,243,630,190,67,123,683,176,507
164845,34,51,2,49,39,1,38,12,1,11
164872,34,247,118,129,188,99,89,59,19,40
164924,34,7260,3424,3836,7110,3339,3771,150,85,65
164988,34,13490,5597,7893,13187,5449,7738,303,148,155
165015,34,2636,1068,1568,2626,1065,1561,10,3,7
165024,34,6760,2714,4046,5180,2086,3094,1580,628,952
165033,34,4104,1258,2846,1527,521,1006,2577,737,1840
165060,34,167,19,148,103,14,89,64,5,59
165112,34,6535,2580,3955,1805,855,950,4730,1725,3005
165167,34,791,162,629,170,44,126,621,118,503
165194,34,1651,554,1097,463,206,257,1188,348,840
165255,34,104,3,101,37,2,35,67,1,66
165264,34,1034,80,954,51,6,45,983,74,909
165334,34,1785,744,1041,1773,739,1034,12,5,7
165529,34,1509,586,923,1283,520,763,226,66,160
165556,34,323,45,278,238,29,209,85,16,69
165574,34,883,448,435,791,405,386,92,43,49
165608,34,37,5,32,27,4,23,10,1,9
165635,34,195,182,13,195,182,13,,,
165644,34,394,207,187,353,189,164,41,18,23
165662,34,3055,1142,1913,2995,1120,1875,60,22,38
165671,34,1347,291,1056,1299,280,1019,48,11,37
165699,34,2113,787,1326,1994,742,1252,119,45,74
165750,34,12,2,10,12,2,10,,,
165802,34,889,284,605,391,213,178,498,71,427
165820,34,2601,1152,1449,1938,928,1010,663,224,439
165866,34,2455,1060,1395,2149,939,1210,306,121,185
165884,34,202,160,42,118,87,31,84,73,11
165936,34,1019,397,622,977,379,598,42,18,24
165981,34,876,303,573,234,79,155,642,224,418
166018,34,335,132,203,335,132,203,,,
166027,34,5989,2981,3008,5427,2730,2697,562,251,311
166054,34,35,25,10,35,25,10,,,
166124,34,2186,996,1190,2186,996,1190,,,
166133,34,2478,812,1666,807,334,473,1671,478,1193
166391,34,990,349,641,964,338,626,26,11,15
166407,34,257,18,239,17,1,16,240,17,223
166452,34,1405,317,1088,992,229,763,413,88,325
166489,34,28,12,16,26,11,15,2,1,1
166498,34,37,3,34,16,3,13,21,0,21
166513,34,10639,6252,4387,8106,4755,3351,2533,1497,1036
166629,34,19075,9457,9618,17618,8835,8783,1457,622,835
166638,34,9703,4055,5648,7710,3179,4531,1993,876,1117
166647,34,2056,902,1154,675,338,337,1381,564,817
166656,34,2927,716,2211,2762,674,2088,165,42,123
166674,34,1336,357,979,1172,315,857,164,42,122
166683,34,3452,1797,1655,3403,1764,1639,49,33,16
166692,34,1110,961,149,1077,931,146,33,30,3
166717,34,37,9,28,17,5,12,20,4,16
166805,34,44,33,11,24,19,5,20,14,6
166823,34,3285,1201,2084,1151,517,634,2134,684,1450
166850,34,3036,1434,1602,2961,1398,1563,75,36,39
166869,34,190,20,170,190,20,170,,,
166887,34,3889,1382,2507,1137,497,640,2752,885,1867
166911,34,261,64,197,256,63,193,5,1,4
166939,34,1606,0,1606,1589,0,1589,17,0,17
166957,34,2117,592,1525,534,195,339,1583,397,1186
167039,34,6,0,6,6,0,6,,,
167057,34,315,175,140,307,169,138,8,6,2
167260,34,888,559,329,795,525,270,93,34,59
167288,34,684,262,422,595,233,362,89,29,60
167297,34,126,79,47,126,79,47,,,
167312,34,3275,1098,2177,983,397,586,2292,701,1591
167358,34,11153,5411,5742,11153,5411,5742,,,
167376,34,2990,974,2016,781,328,453,2209,646,1563
167394,34,831,183,648,702,157,545,129,26,103
167455,34,60,25,35,59,25,34,1,0,1
167525,34,2029,704,1325,706,287,419,1323,417,906
167534,34,4527,1559,2968,1475,585,890,3052,974,2078
167598,34,1017,172,845,797,142,655,220,30,190
167631,34,886,291,595,229,102,127,657,189,468
167677,34,13,13,0,13,13,0,,,
167729,34,4107,1408,2699,3300,1108,2192,807,300,507
167783,34,1343,0,1343,1234,0,1234,109,0,109
167792,34,194,68,126,191,66,125,3,2,1
167835,34,1890,2,1888,1878,1,1877,12,1,11
167871,34,99,33,66,32,4,28,67,29,38
167899,34,1549,761,788,1519,741,778,30,20,10
167905,34,2843,1038,1805,981,393,588,1862,645,1217
167987,34,4353,2081,2272,3642,1791,1851,711,290,421
167996,34,1731,736,995,1718,724,994,13,12,1
168005,34,3207,1344,1863,3052,1255,1797,155,89,66
168032,34,4,0,4,4,0,4,,,
168148,34,4828,2173,2655,4699,2109,2590,129,64,65
168218,34,1780,0,1780,1772,0,1772,8,0,8
168227,34,2949,2308,641,2730,2128,602,219,180,39
168254,34,1814,1067,747,1734,1028,706,80,39,41
168263,34,3172,1431,1741,2688,1228,1460,484,203,281
168281,34,1205,468,737,1204,467,737,1,1,0
168342,34,1555,766,789,1555,766,789,,,
168421,34,3724,2298,1426,3600,2201,1399,124,97,27
168430,34,3515,1333,2182,2820,1065,1755,695,268,427
168528,34,1168,588,580,1146,575,571,22,13,9
168546,34,1043,498,545,1030,490,540,13,8,5
168555,34,4,0,4,3,0,3,1,0,1
168573,34,590,574,16,590,574,16,,,
168591,34,991,414,577,979,406,573,12,8,4
168607,34,508,233,275,221,123,98,287,110,177
168740,34,1059,508,551,936,437,499,123,71,52
168786,34,939,408,531,843,382,461,96,26,70
168847,34,3630,923,2707,1364,348,1016,2266,575,1691
168883,34,858,266,592,365,133,232,493,133,360
168892,34,59,4,55,22,2,20,37,2,35
169080,34,2201,1041,1160,2050,934,1116,151,107,44
169187,34,121,23,98,30,10,20,91,13,78
169248,34,9413,3686,5727,7916,3149,4767,1497,537,960
169275,34,3799,1205,2594,1054,331,723,2745,874,1871
169284,34,141,7,134,103,5,98,38,2,36
169327,34,412,238,174,312,187,125,100,51,49
169363,34,623,306,317,596,296,300,27,10,17
169442,34,1154,460,694,946,365,581,208,95,113
169479,34,3380,1496,1884,1811,945,866,1569,551,1018
169503,34,238,7,231,238,7,231,,,
169521,34,4883,1700,3183,1307,495,812,3576,1205,2371
169576,34,90,3,87,90,3,87,,,
169655,34,1059,988,71,1059,988,71,,,
169716,34,1820,643,1177,1639,589,1050,181,54,127
169761,34,269,9,260,269,9,260,,,
169798,34,10032,3972,6060,6675,2657,4018,3357,1315,2042
169813,34,32,1,31,32,1,31,,,
169910,34,7402,3501,3901,5197,2534,2663,2205,967,1238
169974,34,471,200,271,178,71,107,293,129,164
169983,34,1191,938,253,1143,900,243,48,38,10
169992,34,415,131,284,200,81,119,215,50,165
170000,34,706,304,402,505,220,285,201,84,117
170037,34,1087,396,691,762,287,475,325,109,216
170055,34,8199,3394,4805,2003,891,1112,6196,2503,3693
170082,34,15432,6100,9332,13199,5087,8112,2233,1013,1220
170091,34,121,66,55,95,51,44,26,15,11
170240,34,7102,2815,4287,2176,877,1299,4926,1938,2988
170286,34,1098,571,527,1074,557,517,24,14,10
170301,34,2208,844,1364,2130,814,1316,78,30,48
170444,34,2294,696,1598,558,182,376,1736,514,1222
170532,34,844,363,481,837,360,477,7,3,4
170541,34,4486,1904,2582,1111,498,613,3375,1406,1969
170550,34,2135,524,1611,477,165,312,1658,359,1299
170587,34,768,209,559,320,94,226,448,115,333
170611,34,60,1,59,59,1,58,1,0,1
170620,34,1759,571,1188,421,146,275,1338,425,913
170639,34,1220,550,670,1036,473,563,184,77,107
170657,34,7120,3014,4106,2006,900,1106,5114,2114,3000
170675,34,1431,1017,414,1231,868,363,200,149,51
170736,34,13,0,13,3,0,3,10,0,10
170790,34,11826,4858,6968,3183,1355,1828,8643,3503,5140
170806,34,1701,538,1163,1217,398,819,484,140,344
170967,34,680,249,431,495,209,286,185,40,145
170976,34,24773,12368,12405,23403,11568,11835,1370,800,570
171012,34,128,102,26,128,102,26,,,
171100,34,29199,14304,14895,25945,12524,13421,3254,1780,1474
171128,34,4222,2985,1237,3995,2817,1178,227,168,59
171137,34,5109,2781,2328,3702,2012,1690,1407,769,638
171146,34,3879,1355,2524,2497,900,1597,1382,455,927
171155,34,1731,572,1159,660,265,395,1071,307,764
171225,34,1302,453,849,332,113,219,970,340,630
171234,34,853,285,568,231,70,161,622,215,407
171304,34,2145,780,1365,619,263,356,1526,517,1009
171395,34,750,213,537,294,91,203,456,122,334
171456,34,4834,2028,2806,4295,1789,2506,539,239,300
171483,34,2191,1040,1151,749,402,347,1442,638,804
171492,34,1799,1047,752,1061,667,394,738,380,358
171535,34,9558,3961,5597,2108,1007,1101,7450,2954,4496
171571,34,11513,4846,6667,8879,3612,5267,2634,1234,1400
171599,34,628,349,279,581,324,257,47,25,22
171775,34,37,0,37,21,0,21,16,0,16
171881,34,79,26,53,56,16,40,23,10,13
171988,34,55,2,53,55,2,53,,,
171997,34,67,2,65,67,2,65,,,
172015,34,58,2,56,58,2,56,,,
172033,34,154,103,51,47,46,1,107,57,50
172051,34,5186,1893,3293,4281,1511,2770,905,382,523
172200,34,5839,2285,3554,1275,576,699,4564,1709,2855
172264,34,1367,556,811,841,388,453,526,168,358
172291,34,1638,502,1136,628,205,423,1010,297,713
172307,34,882,281,601,369,145,224,513,136,377
172334,34,878,268,610,702,231,471,176,37,139
172422,34,81,66,15,81,66,15,,,
172440,34,264,145,119,249,139,110,15,6,9
172495,34,231,6,225,177,6,171,54,0,54
172608,34,634,343,291,63,45,18,571,298,273
172617,34,7038,2886,4152,1640,737,903,5398,2149,3249
172635,34,7768,2332,5436,865,344,521,6903,1988,4915
172644,34,13798,5642,8156,10267,4020,6247,3531,1622,1909
172671,34,506,155,351,94,33,61,412,122,290
172680,34,89,4,85,54,3,51,35,1,34
172699,34,12172,6135,6037,10041,5025,5016,2131,1110,1021
172866,34,66,62,4,66,62,4,,,
172918,34,825,358,467,505,259,246,320,99,221
172954,34,1241,518,723,649,325,324,592,193,399
172963,34,3441,1184,2257,1285,506,779,2156,678,1478
173045,34,1805,785,1020,1572,703,869,233,82,151
173063,34,1513,702,811,546,272,274,967,430,537
173115,34,456,118,338,162,84,78,294,34,260
173124,34,2973,1239,1734,1988,895,1093,985,344,641
173142,34,460,220,240,448,214,234,12,6,6
173160,34,1793,680,1113,1448,561,887,345,119,226
173203,34,1203,520,683,576,299,277,627,221,406
173258,34,1453,711,742,1453,711,742,,,
173300,34,1389,605,784,1359,587,772,30,18,12
173328,34,2697,921,1776,1726,608,1118,971,313,658
173416,34,1585,811,774,893,537,356,692,274,418
173452,34,585,289,296,501,258,243,84,31,53
173461,34,2160,905,1255,901,458,443,1259,447,812
173470,34,23,0,23,23,0,23,,,
173559,34,2404,858,1546,1116,503,613,1288,355,933
173638,34,1304,678,626,477,224,253,827,454,373
173647,34,1700,728,972,1673,710,963,27,18,9
173665,34,1320,487,833,1272,467,805,48,20,28
173708,34,2482,1555,927,999,693,306,1483,862,621
173735,34,479,164,315,210,125,85,269,39,230
173744,34,537,31,506,537,31,506,,,
173799,34,1967,719,1248,717,289,428,1250,430,820
173805,34,408,230,178,266,177,89,142,53,89
173902,34,1634,697,937,1600,679,921,34,18,16
173911,34,1608,650,958,716,348,368,892,302,590
173920,34,9388,4405,4983,7826,3787,4039,1562,618,944
173957,34,236,50,186,236,50,186,,,
173993,34,409,182,227,295,148,147,114,34,80
174020,34,5559,2314,3245,2544,1097,1447,3015,1217,1798
174066,34,23851,11231,12620,21735,10139,11596,2116,1092,1024
174075,34,1406,615,791,843,364,479,563,251,312
174127,34,504,163,341,499,160,339,5,3,2
174136,34,4096,1616,2480,1322,607,715,2774,1009,1765
174154,34,640,74,566,286,41,245,354,33,321
174190,34,129,14,115,84,5,79,45,9,36
174233,34,6055,3162,2893,5597,2916,2681,458,246,212
174251,34,896,374,522,824,342,482,72,32,40
174321,34,104,4,100,104,4,100,,,
174358,34,3165,1229,1936,2501,971,1530,664,258,406
174376,34,2974,1134,1840,862,359,503,2112,775,1337
174428,34,4817,2064,2753,1769,838,931,3048,1226,1822
174437,34,688,314,374,599,267,332,89,47,42
174473,34,1424,574,850,652,241,411,772,333,439
174491,34,1203,487,716,1054,428,626,149,59,90
174507,34,237,63,174,55,12,43,182,51,131
174525,34,62,39,23,44,27,17,18,12,6
174570,34,463,174,289,246,100,146,217,74,143
174604,34,71,35,36,51,30,21,20,5,15
174738,34,2598,876,1722,926,434,492,1672,442,1230
174747,34,1146,0,1146,1142,0,1142,4,0,4
174756,34,2483,927,1556,1165,522,643,1318,405,913
174783,34,5235,2549,2686,3947,1900,2047,1288,649,639
174792,34,1123,1123,0,1104,1104,0,19,19,0
174817,34,982,419,563,741,326,415,241,93,148
174844,34,2200,929,1271,2193,926,1267,7,3,4
174862,34,587,271,316,399,194,205,188,77,111
174899,34,1779,511,1268,1445,434,1011,334,77,257
174914,34,4681,2466,2215,4496,2361,2135,185,105,80
174978,34,83,2,81,62,1,61,21,1,20
175005,34,2233,107,2126,1469,30,1439,764,77,687
175014,34,3405,513,2892,1599,248,1351,1806,265,1541
175041,34,3023,1294,1729,1144,537,607,1879,757,1122
175078,34,1560,567,993,1049,437,612,511,130,381
175120,34,118,74,44,118,74,44,,,
175157,34,247,164,83,227,151,76,20,13,7
175227,34,1077,867,210,851,695,156,226,172,54
175236,34,1676,589,1087,940,394,546,736,195,541
175263,34,822,363,459,438,216,222,384,147,237
175272,34,4513,1539,2974,3819,1285,2534,694,254,440
175315,34,5187,2077,3110,1986,859,1127,3201,1218,1983
175342,34,2076,715,1361,1755,624,1131,321,91,230
175421,34,1436,451,985,918,335,583,518,116,402
175430,34,477,225,252,449,221,228,28,4,24
175494,34,38,7,31,38,7,31,,,
175519,34,954,347,607,785,296,489,169,51,118
175573,34,1393,518,875,1117,424,693,276,94,182
175616,34,1452,561,891,1229,481,748,223,80,143
175643,34,1043,378,665,871,339,532,172,39,133
175652,34,1951,814,1137,1438,641,797,513,173,340
175698,34,5,3,2,3,2,1,2,1,1
175722,34,29,0,29,29,0,29,,,
175786,34,6383,2148,4235,4050,1524,2526,2333,624,1709
175810,34,2854,794,2060,1928,555,1373,926,239,687
175829,34,2459,902,1557,1631,637,994,828,265,563
175856,34,3949,1367,2582,3274,1144,2130,675,223,452
175883,34,2674,974,1700,2079,783,1296,595,191,404
175935,34,1890,443,1447,1353,362,991,537,81,456
175980,34,464,221,243,459,219,240,5,2,3
176008,34,1267,392,875,1045,340,705,222,52,170
176017,34,12414,5209,7205,11411,4730,6681,1003,479,524
176035,34,1663,309,1354,1460,281,1179,203,28,175
176044,34,1117,463,654,941,404,537,176,59,117
176053,34,1810,719,1091,1644,664,980,166,55,111
176062,34,63,0,63,63,0,63,,,
176071,34,4745,1708,3037,2870,1167,1703,1875,541,1334
176080,34,15063,7562,7501,13389,6610,6779,1674,952,722
176169,34,1687,584,1103,1392,500,892,295,84,211
176178,34,3704,1285,2419,2621,935,1686,1083,350,733
176239,34,3318,1050,2268,2655,890,1765,663,160,503
176318,34,419,155,264,340,122,218,79,33,46
176336,34,75,56,19,71,52,19,4,4,0
176354,34,953,304,649,771,270,501,182,34,148
176372,34,9010,3241,5769,7455,2555,4900,1555,686,869
176406,34,465,165,300,429,148,281,36,17,19
176433,34,52,1,51,32,1,31,20,0,20
176451,34,9,4,5,,,,9,4,5
176479,34,1807,496,1311,1578,446,1132,229,50,179
176628,34,782,290,492,699,268,431,83,22,61
176664,34,192,101,91,160,83,77,32,18,14
176716,34,103,1,102,93,1,92,10,0,10
176770,34,745,100,645,367,56,311,378,44,334
176789,34,189,91,98,128,57,71,61,34,27
176798,34,164,45,119,105,30,75,59,15,44
176910,34,113,62,51,65,36,29,48,26,22
176947,34,803,386,417,793,381,412,10,5,5
176965,34,5249,2407,2842,4474,2044,2430,775,363,412
176983,34,5,4,1,3,3,0,2,1,1
177038,34,83,26,57,56,17,39,27,9,18
177065,34,5674,2241,3433,2392,877,1515,3282,1364,1918
177083,34,22,22,0,22,22,0,,,
177117,34,174,0,174,173,0,173,1,0,1
177135,34,1936,640,1296,996,390,606,940,250,690
177144,34,598,335,263,561,320,241,37,15,22
177214,34,1020,459,561,994,449,545,26,10,16
177250,34,1146,398,748,562,218,344,584,180,404
177302,34,335,264,71,335,264,71,,,
177339,34,1306,586,720,1084,471,613,222,115,107
177418,34,543,191,352,478,180,298,65,11,54
177436,34,32,4,28,32,4,28,,,
177472,34,6042,2328,3714,2928,1170,1758,3114,1158,1956
177542,34,413,184,229,354,157,197,59,27,32
177551,34,990,292,698,790,239,551,200,53,147
177588,34,40,3,37,40,3,37,,,
177603,34,63,0,63,62,0,62,1,0,1
177676,34,1685,567,1118,809,306,503,876,261,615
177685,34,131,9,122,131,9,122,,,
177719,34,566,69,497,498,63,435,68,6,62
177746,34,518,140,378,507,137,370,11,3,8
177870,34,2,2,0,2,2,0,,,
177931,34,21,1,20,21,1,20,,,
177940,34,1016,391,625,840,346,494,176,45,131
177968,34,3869,1704,2165,3239,1442,1797,630,262,368
177977,34,768,645,123,679,574,105,89,71,18
177986,34,320,96,224,161,45,116,159,51,108
177995,34,8635,3105,5530,3333,1370,1963,5302,1735,3567
178004,34,16,0,16,,,,16,0,16
178059,34,4793,1479,3314,2605,925,1680,2188,554,1634
178077,34,48,2,46,47,2,45,1,0,1
178183,34,185,14,171,185,14,171,,,
178208,34,708,483,225,351,267,84,357,216,141
178217,34,1002,334,668,691,233,458,311,101,210
178244,34,1255,549,706,1054,484,570,201,65,136
178341,34,3015,1163,1852,2200,830,1370,815,333,482
178369,34,899,491,408,852,472,380,47,19,28
178387,34,2402,934,1468,1993,762,1231,409,172,237
178396,34,18249,8495,9754,17050,7929,9121,1199,566,633
178402,34,5614,2359,3255,4595,1887,2708,1019,472,547
178411,34,4480,3475,1005,3874,2991,883,606,484,122
178420,34,5422,2396,3026,3782,1621,2161,1640,775,865
178448,34,2065,734,1331,1105,423,682,960,311,649
178527,34,14,2,12,8,1,7,6,1,5
178615,34,2653,1058,1595,2526,1009,1517,127,49,78
178624,34,3796,1590,2206,3426,1443,1983,370,147,223
178679,34,439,236,203,341,192,149,98,44,54
178697,34,1175,506,669,1159,501,658,16,5,11
178721,34,6810,3673,3137,3057,1435,1622,3753,2238,1515
178767,34,91,11,80,39,6,33,52,5,47
178828,34,13,0,13,13,0,13,,,
178891,34,1224,1109,115,828,750,78,396,359,37
178989,34,259,37,222,259,37,222,,,
179043,34,1513,505,1008,1366,484,882,147,21,126
179052,34,26,4,22,26,4,22,,,
179159,34,5483,2145,3338,4826,1816,3010,657,329,328
179195,34,25,0,25,25,0,25,,,
179229,34,19,4,15,19,4,15,,,
179256,34,58,31,27,47,25,22,11,6,5
179265,34,177,64,113,175,63,112,2,1,1
179308,34,9641,3015,6626,3110,1196,1914,6531,1819,4712
179326,34,1402,488,914,1048,408,640,354,80,274
179344,34,614,164,450,370,94,276,244,70,174
179511,34,75,1,74,44,1,43,31,0,31
179539,34,1730,571,1159,1042,342,700,688,229,459
179548,34,307,0,307,267,0,267,40,0,40
179557,34,5819,2333,3486,5042,1988,3054,777,345,432
179566,34,11648,4782,6866,9569,3817,5752,2079,965,1114
179645,34,1415,361,1054,878,240,638,537,121,416
179715,34,678,135,543,339,90,249,339,45,294
179867,34,5733,2728,3005,5353,2592,2761,380,136,244
179894,34,1967,882,1085,1535,666,869,432,216,216
179946,34,436,245,191,425,239,186,11,6,5
179955,34,557,275,282,548,272,276,9,3,6
179964,34,597,150,447,485,131,354,112,19,93
179991,34,16,0,16,16,0,16,,,
180054,34,251,76,175,176,57,119,75,19,56
180063,34,4,0,4,4,0,4,,,
180081,34,204,121,83,163,102,61,41,19,22
180090,34,36,0,36,36,0,36,,,
180106,34,804,306,498,782,295,487,22,11,11
180151,34,176,88,88,125,70,55,51,18,33
180160,34,118,39,79,48,18,30,70,21,49
180179,34,2259,780,1479,1449,572,877,810,208,602
180197,34,858,343,515,411,196,215,447,147,300
180203,34,87,37,50,71,30,41,16,7,9
180212,34,403,119,284,278,90,188,125,29,96
180249,34,619,140,479,318,84,234,301,56,245
180258,34,557,190,367,434,165,269,123,25,98
180276,34,455,171,284,190,96,94,265,75,190
180328,34,203,58,145,124,33,91,79,25,54
180373,34,251,67,184,150,45,105,101,22,79
180416,34,1142,701,441,1061,648,413,81,53,28
180461,34,10463,5571,4892,8906,4738,4168,1557,833,724
180489,34,5484,2320,3164,4335,1859,2476,1149,461,688
180522,34,648,327,321,522,286,236,126,41,85
180595,34,587,310,277,570,302,268,17,8,9
180647,34,499,143,356,406,122,284,93,21,72
180692,34,1054,355,699,790,292,498,264,63,201
180717,34,30,18,12,27,17,10,3,1,2
180814,34,8140,3653,4487,5635,2475,3160,2505,1178,1327
180832,34,589,70,519,298,35,263,291,35,256
180878,34,504,39,465,332,23,309,172,16,156
180902,34,2642,912,1730,1062,496,566,1580,416,1164
180948,34,1238,489,749,1043,417,626,195,72,123
180957,34,42,34,8,42,34,8,,,
180984,34,875,420,455,861,409,452,14,11,3
181002,34,3317,1331,1986,3221,1292,1929,96,39,57
181020,34,865,458,407,722,398,324,143,60,83
181127,34,629,297,332,624,294,330,5,3,2
181145,34,19,1,18,19,1,18,,,
181190,34,102,3,99,102,3,99,,,
181215,34,3331,1239,2092,2816,1086,1730,515,153,362
181297,34,807,80,727,525,56,469,282,24,258
181303,34,5406,2452,2954,1712,816,896,3694,1636,2058
181312,34,665,237,428,369,167,202,296,70,226
181330,34,859,427,432,841,422,419,18,5,13
181394,34,9844,4443,5401,7839,3414,4425,2005,1029,976
181419,34,190,50,140,58,17,41,132,33,99
181428,34,913,117,796,753,101,652,160,16,144
181446,34,1281,539,742,1184,504,680,97,35,62
181464,34,14712,7609,7103,13726,7033,6693,986,576,410
181491,34,1529,626,903,937,472,465,592,154,438
181534,34,1126,409,717,852,333,519,274,76,198
181543,34,17,11,6,9,8,1,8,3,5
181604,34,505,0,505,488,0,488,17,0,17
181640,34,4414,2027,2387,2098,1109,989,2316,918,1398
181738,34,457,197,260,436,190,246,21,7,14
181765,34,139,44,95,125,40,85,14,4,10
181783,34,2257,934,1323,2021,840,1181,236,94,142
181817,34,674,226,448,401,157,244,273,69,204
181853,34,323,174,149,305,174,131,18,0,18
181880,34,152,9,143,152,9,143,,,
181941,34,287,165,122,287,165,122,,,
182005,34,22955,9032,13923,6123,2563,3560,16832,6469,10363
182148,34,533,121,412,533,121,412,,,
182281,34,20710,8918,11792,15526,6541,8985,5184,2377,2807
182290,34,12862,6062,6800,10635,4985,5650,2227,1077,1150
182306,34,1653,536,1117,645,235,410,1008,301,707
182458,34,200,100,100,185,98,87,15,2,13
182500,34,4932,1983,2949,1519,637,882,3413,1346,2067
182564,34,1549,588,961,478,192,286,1071,396,675
182634,34,530,140,390,514,134,380,16,6,10
182670,34,3312,1698,1614,3311,1697,1614,1,1,0
182704,34,74,1,73,55,1,54,19,0,19
182722,34,147,18,129,107,17,90,40,1,39
182795,34,1006,465,541,789,387,402,217,78,139
182892,34,20,0,20,13,0,13,7,0,7
182917,34,52,26,26,52,26,26,,,
182953,34,30,3,27,24,2,22,6,1,5
182980,34,1050,456,594,976,428,548,74,28,46
182999,34,7,0,7,7,0,7,,,
183026,34,108641,39843,68798,33545,12749,20796,75096,27094,48002
183035,34,11,2,9,11,2,9,,,
183044,34,8634,3826,4808,8413,3699,4714,221,127,94
183062,34,2181,984,1197,2126,957,1169,55,27,28
183071,34,577,292,285,484,243,241,93,49,44
183080,34,2550,1276,1274,2436,1217,1219,114,59,55
183099,34,1766,606,1160,527,234,293,1239,372,867
183105,34,353,90,263,95,33,62,258,57,201
183114,34,534,107,427,92,27,65,442,80,362
183123,34,382,166,216,110,59,51,272,107,165
183132,34,1318,551,767,349,202,147,969,349,620
183141,34,744,330,414,187,109,78,557,221,336
183150,34,1036,369,667,272,131,141,764,238,526
183202,34,81,6,75,59,4,55,22,2,20
183211,34,1073,203,870,627,155,472,446,48,398
183239,34,1472,565,907,1459,561,898,13,4,9
183248,34,108,21,87,45,10,35,63,11,52
183257,34,1284,375,909,643,181,462,641,194,447
183275,34,68,29,39,68,29,39,,,
183488,34,414,14,400,305,9,296,109,5,104
183600,34,21,0,21,12,0,12,9,0,9
183655,34,3134,1040,2094,1031,395,636,2103,645,1458
183725,34,436,191,245,361,182,179,75,9,66
183743,34,7403,3339,4064,3658,1753,1905,3745,1586,2159
183789,34,1767,409,1358,1149,302,847,618,107,511
183804,34,3150,3150,0,3129,3129,0,21,21,0
183822,34,1017,383,634,944,358,586,73,25,48
183859,34,6177,2827,3350,2749,1383,1366,3428,1444,1984
183877,34,4462,1634,2828,1838,776,1062,2624,858,1766
183910,34,1275,435,840,1216,420,796,59,15,44
183938,34,5215,1848,3367,2140,839,1301,3075,1009,2066
183974,34,864,309,555,780,270,510,84,39,45
183983,34,22,20,2,22,20,2,,,
184056,34,487,103,384,285,73,212,202,30,172
184092,34,570,41,529,570,41,529,,,
184180,34,4163,2112,2051,1629,913,716,2534,1199,1335
184205,34,1440,460,980,600,213,387,840,247,593
184348,34,1161,488,673,1150,482,668,11,6,5
184427,34,209,196,13,122,118,4,87,78,9
184481,34,4428,1689,2739,2013,774,1239,2415,915,1500
184506,34,78,6,72,54,3,51,24,3,21
184603,34,2052,902,1150,1428,596,832,624,306,318
184612,34,1597,406,1191,1435,359,1076,162,47,115
184694,34,1742,717,1025,1662,674,988,80,43,37
184746,34,16,16,0,11,11,0,5,5,0
184773,34,1106,262,844,1004,238,766,102,24,78
184782,34,12734,6642,6092,10883,5750,5133,1851,892,959
184791,34,3495,1395,2100,1724,713,1011,1771,682,1089
184816,34,37,2,35,28,1,27,9,1,8
184959,34,593,84,509,258,34,224,335,50,285
184968,34,178,21,157,31,5,26,147,16,131
184995,34,4816,1761,3055,2280,876,1404,2536,885,1651
185129,34,4385,1799,2586,3610,1506,2104,775,293,482
185174,34,47,38,9,47,38,9,,,
185262,34,8789,3343,5446,6848,2604,4244,1941,739,1202
185396,34,951,915,36,736,712,24,215,203,12
185466,34,4,0,4,2,0,2,2,0,2
185509,34,4042,1693,2349,1081,556,525,2961,1137,1824
185536,34,5882,2565,3317,2231,975,1256,3651,1590,2061
185572,34,3103,1222,1881,2948,1151,1797,155,71,84
185590,34,12502,4828,7674,10871,4116,6755,1631,712,919
185679,34,628,80,548,48,11,37,580,69,511
185721,34,283,79,204,148,48,100,135,31,104
185767,34,198,20,178,100,10,90,98,10,88
185828,34,7003,5332,1671,6052,4555,1497,951,777,174
185873,34,4142,1712,2430,1819,816,1003,2323,896,1427
185970,34,132,9,123,93,7,86,39,2,37
186016,34,422,23,399,246,14,232,176,9,167
186034,34,4062,1461,2601,1323,570,753,2739,891,1848
186052,34,552,468,84,312,274,38,240,194,46
186131,34,3948,2006,1942,3948,2006,1942,,,
186186,34,158,158,0,158,158,0,,,
186201,34,3959,1705,2254,3557,1528,2029,402,177,225
186274,34,182,19,163,99,12,87,83,7,76
186283,34,2537,1073,1464,2361,994,1367,176,79,97
186371,34,4143,1523,2620,3455,1263,2192,688,260,428
186380,34,28722,14425,14297,27266,13694,13572,1456,731,725
186399,34,6766,3011,3755,5834,2567,3267,932,444,488
186405,34,15,4,11,15,4,11,,,
186423,34,73,7,66,73,7,66,,,
186432,34,1613,611,1002,1511,578,933,102,33,69
186469,34,594,200,394,318,125,193,276,75,201
186584,34,4240,2017,2223,4114,1938,2176,126,79,47
186593,34,126,19,107,84,10,74,42,9,33
186618,34,581,193,388,483,170,313,98,23,75
186645,34,4041,1992,2049,1481,776,705,2560,1216,1344
186867,34,2962,2104,858,2934,2080,854,28,24,4
186876,34,7001,2749,4252,6591,2573,4018,410,176,234
186900,34,68,68,0,68,68,0,,,
187000,34,283,271,12,242,232,10,41,39,2
187046,34,8615,5210,3405,76,19,57,8539,5191,3348
187134,34,5372,2340,3032,5219,2260,2959,153,80,73
187198,34,5852,1963,3889,2163,914,1249,3689,1049,2640
187444,34,6165,2489,3676,4713,1962,2751,1452,527,925
187505,34,451,82,369,451,82,369,,,
187532,34,12355,4493,7862,2999,1223,1776,9356,3270,6086
187596,34,733,248,485,402,149,253,331,99,232
187620,34,3695,1413,2282,1753,682,1071,1942,731,1211
187639,34,1014,232,782,333,81,252,681,151,530
187648,34,2513,956,1557,1639,594,1045,874,362,512
187666,34,833,285,548,349,134,215,484,151,333
187745,34,248,93,155,172,69,103,76,24,52
187897,34,1298,431,867,827,325,502,471,106,365
187903,34,1224,380,844,456,186,270,768,194,574
187912,34,185,145,40,185,145,40,,,
187958,34,1082,327,755,262,82,180,820,245,575
187967,34,900,626,274,838,576,262,62,50,12
187976,34,617,278,339,65,29,36,552,249,303
187985,34,12015,4946,7069,8403,3544,4859,3612,1402,2210
187994,34,352,124,228,139,54,85,213,70,143
188003,34,321,68,253,127,30,97,194,38,156
188021,34,189,48,141,85,27,58,104,21,83
188030,34,8661,3688,4973,7067,2976,4091,1594,712,882
188049,34,958,342,616,166,54,112,792,288,504
188058,34,758,300,458,394,135,259,364,165,199
188100,34,3378,977,2401,1068,408,660,2310,569,1741
188137,34,1855,569,1286,465,172,293,1390,397,993
188182,34,283,144,139,240,120,120,43,24,19
188216,34,287,75,212,174,57,117,113,18,95
188225,34,703,225,478,79,30,49,624,195,429
188261,34,277,204,73,60,28,32,217,176,41
188289,34,46,2,44,41,2,39,5,0,5
188304,34,1299,420,879,807,321,486,492,99,393
188340,34,1119,979,140,868,753,115,251,226,25
188429,34,3838,1182,2656,3606,1095,2511,232,87,145
188438,34,1303,472,831,709,307,402,594,165,429
188517,34,286,115,171,221,100,121,65,15,50
188526,34,524,187,337,521,186,335,3,1,2
188641,34,1072,517,555,1033,493,540,39,24,15
188650,34,37,0,37,37,0,37,,,
188669,34,16,1,15,16,1,15,,,
188678,34,97,36,61,97,36,61,,,
188687,34,391,115,276,67,17,50,324,98,226
188696,34,97,8,89,97,8,89,,,
188854,34,1212,363,849,1212,363,849,,,
188890,34,477,453,24,426,403,23,51,50,1
188915,34,34,8,26,18,6,12,16,2,14
188942,34,145,0,145,112,0,112,33,0,33
189088,34,1563,721,842,1465,648,817,98,73,25
189097,34,2238,0,2238,2198,0,2198,40,0,40
189219,34,40,36,4,40,36,4,,,
189228,34,1534,486,1048,1042,347,695,492,139,353
189255,34,47,0,47,30,0,30,17,0,17
189273,34,51,51,0,51,51,0,,,
189282,34,290,32,258,257,32,225,33,0,33
189404,34,139,2,137,48,1,47,91,1,90
189413,34,311,39,272,311,39,272,,,
189468,34,5,0,5,3,0,3,2,0,2
189477,34,109,3,106,72,2,70,37,1,36
189547,34,2244,817,1427,1406,542,864,838,275,563
189565,34,391,102,289,319,82,237,72,20,52
189583,34,537,116,421,369,81,288,168,35,133
189592,34,285,67,218,205,59,146,80,8,72
189705,34,1351,684,667,1314,665,649,37,19,18
189714,34,256,9,247,168,8,160,88,1,87
189811,34,794,165,629,794,165,629,,,
189839,34,885,310,575,497,178,319,388,132,256
189848,34,528,148,380,395,115,280,133,33,100
189857,34,497,497,0,497,497,0,,,
189990,34,384,5,379,93,1,92,291,4,287
190008,34,34,11,23,34,11,23,,,
190044,34,2050,1438,612,2038,1431,607,12,7,5
190053,34,340,135,205,165,71,94,175,64,111
190071,34,100,8,92,17,2,15,83,6,77
190099,34,2266,1040,1226,2255,1032,1223,11,8,3
190114,34,337,86,251,274,57,217,63,29,34
190150,34,7192,3664,3528,6582,3353,3229,610,311,299
190169,34,588,157,431,205,75,130,383,82,301
190239,34,65,0,65,46,0,46,19,0,19
190318,34,213,15,198,196,15,181,17,0,17
190372,34,648,345,303,646,343,303,2,2,0
190415,34,11733,5453,6280,11681,5419,6262,52,34,18
190442,34,980,335,645,493,182,311,487,153,334
190451,34,245,34,211,75,14,61,170,20,150
190503,34,2134,1140,994,2005,1064,941,129,76,53
190512,34,12951,6744,6207,9886,5148,4738,3065,1596,1469
190521,34,14223,5692,8531,8899,3667,5232,5324,2025,3299
190530,34,5199,2006,3193,3242,1251,1991,1957,755,1202
190549,34,11013,4665,6348,8306,3491,4815,2707,1174,1533
190558,34,8151,3611,4540,6201,2748,3453,1950,863,1087
190567,34,9296,4297,4999,7260,3259,4001,2036,1038,998
190576,34,2703,684,2019,732,178,554,1971,506,1465
190585,34,3964,1112,2852,1848,573,1275,2116,539,1577
190594,34,13972,4942,9030,10447,3639,6808,3525,1303,2222
190600,34,11064,4326,6738,8700,3323,5377,2364,1003,1361
190619,34,6172,2550,3622,4119,1713,2406,2053,837,1216
190628,34,9487,3767,5720,5429,2206,3223,4058,1561,2497
190637,34,10027,3113,6914,6369,2039,4330,3658,1074,2584
190646,34,3190,768,2422,2274,559,1715,916,209,707
190655,34,10900,5757,5143,6537,3700,2837,4363,2057,2306
190664,34,12759,5811,6948,9429,4224,5205,3330,1587,1743
190673,34,7465,3178,4287,4117,1843,2274,3348,1335,2013
190691,34,4697,1480,3217,3176,975,2201,1521,505,1016
190707,34,12,2,10,12,2,10,,,
190716,34,1142,263,879,832,203,629,310,60,250
190725,34,1346,362,984,1193,327,866,153,35,118
190752,34,32,32,0,32,32,0,,,
190761,34,955,323,632,889,308,581,66,15,51
190840,34,2698,1140,1558,1412,648,764,1286,492,794
190956,34,140,10,130,3,0,3,137,10,127
190983,34,480,150,330,458,144,314,22,6,16
191083,34,4333,1910,2423,2974,1360,1614,1359,550,809
191126,34,6398,1088,5310,5624,928,4696,774,160,614
191199,34,1916,724,1192,1105,438,667,811,286,525
191205,34,417,283,134,393,267,126,24,16,8
191241,34,6790,2967,3823,6542,2854,3688,248,113,135
191302,34,713,296,417,342,153,189,371,143,228
191311,34,65,25,40,65,25,40,,,
191339,34,1603,493,1110,861,321,540,742,172,570
191515,34,1516,704,812,1515,703,812,1,1,0
191533,34,799,335,464,776,320,456,23,15,8
191597,34,546,73,473,259,35,224,287,38,249
191612,34,906,345,561,648,239,409,258,106,152
191621,34,568,241,327,545,230,315,23,11,12
191630,34,1272,613,659,1254,603,651,18,10,8
191649,34,4345,1922,2423,4075,1786,2289,270,136,134
191676,34,631,230,401,597,217,380,34,13,21
191719,34,4369,2058,2311,2612,1361,1251,1757,697,1060
191728,34,685,149,536,453,104,349,232,45,187
191931,34,1970,947,1023,1921,913,1008,49,34,15
191940,34,121,8,113,121,8,113,,,
191959,34,26,23,3,26,23,3,,,
191968,34,3612,1591,2021,3553,1561,1992,59,30,29
191986,34,1141,394,747,757,293,464,384,101,283
192004,34,209,56,153,204,55,149,5,1,4
192022,34,1151,389,762,726,255,471,425,134,291
192040,34,100,43,57,100,43,57,,,
192110,34,377,198,179,377,198,179,,,
192165,34,123,123,0,123,123,0,,,
192192,34,888,222,666,803,202,601,85,20,65
192271,34,995,109,886,922,100,822,73,9,64
192323,34,1991,780,1211,1678,717,961,313,63,250
192448,34,4711,1420,3291,4143,1309,2834,568,111,457
192484,34,105,1,104,55,0,55,50,1,49
192509,34,651,102,549,587,95,492,64,7,57
192624,34,142,142,0,142,142,0,,,
192688,34,413,57,356,325,47,278,88,10,78
192703,34,2389,1411,978,2251,1303,948,138,108,30
192712,34,368,190,178,363,189,174,5,1,4
192749,34,1098,419,679,1061,405,656,37,14,23
192785,34,684,78,606,128,25,103,556,53,503
192800,34,16,0,16,3,0,3,13,0,13
192819,34,3825,1633,2192,3608,1511,2097,217,122,95
192864,34,1259,235,1024,1079,227,852,180,8,172
192925,34,917,231,686,798,219,579,119,12,107
192961,34,130,21,109,2,1,1,128,20,108
192970,34,18,5,13,18,5,13,,,
193016,34,5009,1490,3519,4193,1192,3001,816,298,518
193052,34,353,353,0,353,353,0,,,
193061,34,35,35,0,35,35,0,,,
193070,34,28,28,0,28,28,0,,,
193186,34,88,2,86,49,1,48,39,1,38
193201,34,408,41,367,408,41,367,,,
193247,34,88,88,0,88,88,0,,,
193265,34,13,12,1,12,11,1,1,1,0
193283,34,1916,816,1100,1268,579,689,648,237,411
193292,34,2707,756,1951,2110,633,1477,597,123,474
193308,34,5087,1762,3325,3201,1339,1862,1886,423,1463
193326,34,6134,2430,3704,3106,1310,1796,3028,1120,1908
193353,34,1302,353,949,1022,279,743,280,74,206
193380,34,86,15,71,,,,86,15,71
193399,34,1879,399,1480,1750,381,1369,129,18,111
193478,34,8506,3952,4554,4329,2131,2198,4177,1821,2356
193584,34,1547,411,1136,1494,394,1100,53,17,36
193609,34,72,25,47,72,25,47,,,
193654,34,5471,1377,4094,4923,1242,3681,548,135,413
193672,34,9,7,2,9,7,2,,,
193858,34,200,15,185,200,15,185,,,
193900,34,22459,9602,12857,21483,9156,12327,976,446,530
193946,34,2149,806,1343,1410,567,843,739,239,500
193973,34,2139,740,1399,2074,715,1359,65,25,40
193991,34,41,1,40,27,1,26,14,0,14
194028,34,548,163,385,340,107,233,208,56,152
194091,34,2393,1393,1000,2130,1223,907,263,170,93
194116,34,424,43,381,107,17,90,317,26,291
194161,34,877,356,521,697,266,431,180,90,90
194189,34,84,84,0,84,84,0,,,
194222,34,2871,1243,1628,1724,838,886,1147,405,742
194240,34,2716,955,1761,1142,468,674,1574,487,1087
194259,34,21,1,20,21,1,20,,,
194310,34,5617,2033,3584,5271,1866,3405,346,167,179
194392,34,465,304,161,455,298,157,10,6,4
194435,34,47,2,45,44,2,42,3,0,3
194499,34,647,130,517,647,130,517,,,
194569,34,93,55,38,60,32,28,33,23,10
194578,34,2737,786,1951,2641,746,1895,96,40,56
194657,34,125,125,0,125,125,0,,,
194666,34,346,346,0,346,346,0,,,
194693,34,27,27,0,27,27,0,,,
194718,34,19,19,0,19,19,0,,,
194736,34,120,120,0,120,120,0,,,
194763,34,311,311,0,311,311,0,,,
194824,34,4257,2918,1339,4242,2908,1334,15,10,5
194958,34,878,274,604,813,256,557,65,18,47
195003,34,9730,6388,3342,9380,6149,3231,350,239,111
195030,34,4794,2314,2480,4613,2268,2345,181,46,135
195058,34,3036,1311,1725,1564,793,771,1472,518,954
195067,34,163,14,149,120,13,107,43,1,42
195128,34,929,219,710,887,210,677,42,9,33
195164,34,1258,681,577,1241,673,568,17,8,9
195173,34,1955,694,1261,1855,645,1210,100,49,51
195191,34,385,51,334,253,25,228,132,26,106
195216,34,1625,731,894,1618,726,892,7,5,2
195234,34,1468,497,971,1411,470,941,57,27,30
195243,34,818,420,398,787,397,390,31,23,8
195289,34,142,19,123,7,2,5,135,17,118
195304,34,1061,231,830,1048,228,820,13,3,10
195322,34,995,400,595,546,245,301,449,155,294
195438,34,200,200,0,200,200,0,,,
195474,34,2399,1068,1331,2338,1040,1298,61,28,33
195526,34,1957,783,1174,1933,771,1162,24,12,12
195544,34,3091,919,2172,2697,825,1872,394,94,300
195702,34,136,16,120,75,12,63,61,4,57
195720,34,1990,826,1164,1895,792,1103,95,34,61
195784,34,681,80,601,681,80,601,,,
195809,34,7343,3255,4088,7172,3156,4016,171,99,72
195988,34,570,209,361,295,130,165,275,79,196
196006,34,2367,1391,976,2063,1304,759,304,87,217
196015,34,2328,966,1362,1911,819,1092,417,147,270
196024,34,1943,832,1111,1429,731,698,514,101,413
196033,34,1346,563,783,1224,506,718,122,57,65
196042,34,7299,4275,3024,5676,3339,2337,1623,936,687
196051,34,1396,592,804,1103,534,569,293,58,235
196060,34,9526,4572,4954,8768,4157,4611,758,415,343
196079,34,11214,5537,5677,10879,5327,5552,335,210,125
196088,34,16994,9288,7706,15466,8556,6910,1528,732,796
196097,34,14484,7180,7304,13226,6532,6694,1258,648,610
196103,34,1272,667,605,966,516,450,306,151,155
196112,34,1617,1118,499,1425,1011,414,192,107,85
196121,34,4666,1860,2806,3894,1590,2304,772,270,502
196130,34,4680,1953,2727,4040,1623,2417,640,330,310
196149,34,4753,2098,2655,4595,2000,2595,158,98,60
196158,34,2734,1140,1594,2644,1089,1555,90,51,39
196167,34,3441,1270,2171,3287,1196,2091,154,74,80
196176,34,5009,1886,3123,4495,1630,2865,514,256,258
196185,34,4437,1716,2721,4300,1648,2652,137,68,69
196194,34,4927,2319,2608,4511,2120,2391,416,199,217
196200,34,1930,713,1217,1834,670,1164,96,43,53
196219,34,2689,1099,1590,2452,977,1475,237,122,115
196237,34,3462,1345,2117,2916,1106,1810,546,239,307
196246,34,3366,1350,2016,2938,1197,1741,428,153,275
196255,34,193,40,153,174,39,135,19,1,18
196264,34,7138,2491,4647,3122,911,2211,4016,1580,2436
196291,34,1124,957,167,1025,863,162,99,94,5
196307,34,191,37,154,131,26,105,60,11,49
196389,34,554,124,430,544,122,422,10,2,8
196413,34,10750,4920,5830,10319,4696,5623,431,224,207
196431,34,340,340,0,339,339,0,1,1,0
196440,34,10,10,0,10,10,0,,,
196565,34,996,345,651,537,219,318,459,126,333
196583,34,38,38,0,38,38,0,,,
196592,34,3785,1119,2666,2831,869,1962,954,250,704
196653,34,990,119,871,368,53,315,622,66,556
196680,34,15058,7920,7138,,,,15058,7920,7138
196699,34,937,345,592,416,182,234,521,163,358
196866,34,1507,824,683,1500,817,683,7,7,0
197018,34,1547,1547,0,1547,1547,0,,,
197027,34,767,590,177,767,590,177,,,
197036,34,3167,2434,733,3167,2434,733,,,
197045,34,2354,954,1400,1917,794,1123,437,160,277
197133,34,1823,703,1120,1815,700,1115,8,3,5
197142,34,341,154,187,283,133,150,58,21,37
197151,34,2750,740,2010,2678,709,1969,72,31,41
197197,34,1207,421,786,1159,405,754,48,16,32
197221,34,79,59,20,79,59,20,,,
197230,34,201,67,134,195,64,131,6,3,3
197285,34,629,175,454,557,152,405,72,23,49
197294,34,5866,2622,3244,2699,1310,1389,3167,1312,1855
197337,34,56,0,56,51,0,51,5,0,5
197531,34,215,105,110,215,105,110,,,
197601,34,86,86,0,86,86,0,,,
197647,34,82,82,0,82,82,0,,,
197674,34,134,134,0,134,134,0,,,
197692,34,42,42,0,42,42,0,,,
197708,34,2096,1138,958,2053,1107,946,43,31,12
197735,34,517,517,0,517,517,0,,,
197744,34,164,164,0,164,164,0,,,
197814,34,928,230,698,343,95,248,585,135,450
197850,34,1095,321,774,279,108,171,816,213,603
197869,34,14387,6236,8151,13302,5757,7545,1085,479,606
197887,34,3167,1123,2044,1035,420,615,2132,703,1429
197911,34,783,365,418,748,359,389,35,6,29
197966,34,1136,334,802,287,83,204,849,251,598
197984,34,998,509,489,936,487,449,62,22,40
197993,34,180,0,180,155,0,155,25,0,25
198011,34,837,263,574,196,57,139,641,206,435
198039,34,1424,508,916,492,194,298,932,314,618
198066,34,550,320,230,527,305,222,23,15,8
198084,34,770,262,508,319,130,189,451,132,319
198109,34,423,27,396,133,8,125,290,19,271
198118,34,1675,612,1063,655,273,382,1020,339,681
198136,34,2750,1313,1437,2225,1004,1221,525,309,216
198154,34,7088,2811,4277,2643,1150,1493,4445,1661,2784
198206,34,917,255,662,278,81,197,639,174,465
198215,34,868,389,479,780,361,419,88,28,60
198233,34,2533,1052,1481,791,356,435,1742,696,1046
198251,34,2181,701,1480,771,312,459,1410,389,1021
198260,34,11564,4694,6870,4661,1921,2740,6903,2773,4130
198303,34,711,407,304,678,394,284,33,13,20
198321,34,1432,516,916,625,232,393,807,284,523
198330,34,2154,735,1419,1061,358,703,1093,377,716
198367,34,1568,614,954,507,248,259,1061,366,695
198376,34,1902,534,1368,843,278,565,1059,256,803
198385,34,1423,675,748,1423,675,748,,,
198419,34,5071,2520,2551,5045,2506,2539,26,14,12
198455,34,2777,998,1779,510,222,288,2267,776,1491
198464,34,17131,7319,9812,14211,6069,8142,2920,1250,1670
198491,34,1202,251,951,243,49,194,959,202,757
198507,34,1483,608,875,1294,551,743,189,57,132
198516,34,4711,1892,2819,4535,1819,2716,176,73,103
198534,34,7440,2543,4897,2926,1060,1866,4514,1483,3031
198543,34,4354,1255,3099,2953,882,2071,1401,373,1028
198552,34,5119,1697,3422,1835,723,1112,3284,974,2310
198561,34,1533,479,1054,1222,426,796,311,53,258
198570,34,2287,706,1581,658,244,414,1629,462,1167
198598,34,446,258,188,430,247,183,16,11,5
198613,34,778,357,421,734,342,392,44,15,29
198622,34,6915,2731,4184,2734,1152,1582,4181,1579,2602
198640,34,413,94,319,125,38,87,288,56,232
198668,34,649,204,445,280,101,179,369,103,266
198677,34,25,8,17,14,3,11,11,5,6
198695,34,3430,1532,1898,3408,1519,1889,22,13,9
198710,34,851,284,567,332,124,208,519,160,359
198729,34,844,233,611,257,79,178,587,154,433
198756,34,877,358,519,824,335,489,53,23,30
198774,34,2136,682,1454,889,296,593,1247,386,861
198808,34,622,208,414,593,200,393,29,8,21
198817,34,1120,325,795,367,136,231,753,189,564
198835,34,1075,449,626,1002,435,567,73,14,59
198844,34,52,2,50,50,2,48,2,0,2
198862,34,686,364,322,665,355,310,21,9,12
198871,34,99,67,32,90,62,28,9,5,4
198899,34,716,341,375,669,326,343,47,15,32
198905,34,326,80,246,201,49,152,125,31,94
198914,34,338,112,226,146,45,101,192,67,125
198923,34,339,137,202,228,103,125,111,34,77
198950,34,1067,0,1067,1030,0,1030,37,0,37
198969,34,1096,565,531,966,502,464,130,63,67
198978,34,1503,252,1251,1467,246,1221,36,6,30
198987,34,1422,529,893,572,217,355,850,312,538
199005,34,19,0,19,19,0,19,,,
199023,34,467,210,257,164,94,70,303,116,187
199032,34,631,337,294,525,291,234,106,46,60
199069,34,1652,554,1098,990,384,606,662,170,492
199078,34,165,22,143,155,21,134,10,1,9
199087,34,1187,455,732,403,147,256,784,308,476
199102,34,8397,3389,5008,7374,2895,4479,1023,494,529
199111,34,2479,1096,1383,2173,934,1239,306,162,144
199120,34,15032,6079,8953,14238,5719,8519,794,360,434
199139,34,19452,10380,9072,16352,8710,7642,3100,1670,1430
199148,34,12346,4071,8275,10011,3292,6719,2335,779,1556
199157,34,4193,1204,2989,3502,1048,2454,691,156,535
199184,34,727,287,440,703,275,428,24,12,12
199193,34,19953,10262,9691,18258,9287,8971,1695,975,720
199209,34,1169,516,653,999,470,529,170,46,124
199218,34,11726,4147,7579,9244,3544,5700,2482,603,1879
199263,34,171,38,133,33,5,28,138,33,105
199272,34,538,266,272,481,249,232,57,17,40
199281,34,5283,1925,3358,3853,1448,2405,1430,477,953
199306,34,555,215,340,530,202,328,25,13,12
199324,34,622,216,406,107,43,64,515,173,342
199333,34,4396,1474,2922,1745,679,1066,2651,795,1856
199412,34,1125,391,734,1047,369,678,78,22,56
199421,34,1004,303,701,359,113,246,645,190,455
199449,34,1053,300,753,396,130,266,657,170,487
199458,34,91,55,36,81,46,35,10,9,1
199467,34,520,124,396,117,31,86,403,93,310
199476,34,1097,271,826,514,138,376,583,133,450
199485,34,907,269,638,232,81,151,675,188,487
199494,34,3058,991,2067,1004,372,632,2054,619,1435
199582,34,465,245,220,390,207,183,75,38,37
199607,34,303,7,296,231,0,231,72,7,65
199625,34,670,171,499,228,71,157,442,100,342
199634,34,2004,663,1341,706,267,439,1298,396,902
199643,34,844,350,494,741,327,414,103,23,80
199689,34,183,9,174,148,4,144,35,5,30
199698,34,615,268,347,590,264,326,25,4,21
199722,34,721,233,488,221,97,124,500,136,364
199731,34,1379,404,975,434,137,297,945,267,678
199740,34,1374,295,1079,382,100,282,992,195,797
199759,34,476,334,142,263,174,89,213,160,53
199768,34,1474,522,952,542,217,325,932,305,627
199786,34,2069,771,1298,629,245,384,1440,526,914
199795,34,369,126,243,150,57,93,219,69,150
199838,34,1482,392,1090,464,152,312,1018,240,778
199847,34,4053,1884,2169,3976,1853,2123,77,31,46
199856,34,14884,6380,8504,4595,2185,2410,10289,4195,6094
199865,34,493,159,334,489,157,332,4,2,2
199883,34,144,13,131,144,13,131,,,
199892,34,2173,806,1367,546,226,320,1627,580,1047
199908,34,912,290,622,306,119,187,606,171,435
199926,34,917,330,587,383,166,217,534,164,370
199953,34,773,182,591,240,73,167,533,109,424
199962,34,1703,699,1004,1636,666,970,67,33,34
199971,34,33,15,18,33,15,18,,,
199980,34,6,5,1,6,5,1,,,
199999,34,3669,891,2778,3028,778,2250,641,113,528
200004,34,8251,3628,4623,6504,2932,3572,1747,696,1051
200013,34,549,81,468,292,34,258,257,47,210
200022,34,1840,1068,772,1107,635,472,733,433,300
200059,34,897,381,516,725,317,408,172,64,108
200086,34,122,34,88,92,25,67,30,9,21
200110,34,16,0,16,16,0,16,,,
200156,34,674,394,280,647,372,275,27,22,5
200192,34,377,154,223,235,106,129,142,48,94
200208,34,183,41,142,81,29,52,102,12,90
200217,34,1669,694,975,1344,559,785,325,135,190
200226,34,667,227,440,437,167,270,230,60,170
200253,34,1874,655,1219,1485,541,944,389,114,275
200280,34,7243,4164,3079,5247,2819,2428,1996,1345,651
200305,34,1086,621,465,849,536,313,237,85,152
200314,34,377,93,284,241,65,176,136,28,108
200332,34,7441,3773,3668,6537,3438,3099,904,335,569
200341,34,408,130,278,309,107,202,99,23,76
200466,34,166,54,112,134,47,87,32,7,25
200484,34,122,64,58,101,56,45,21,8,13
200527,34,317,127,190,287,116,171,30,11,19
200554,34,334,126,208,313,118,195,21,8,13
200572,34,746,340,406,554,266,288,192,74,118
200590,34,113,13,100,101,7,94,12,6,6
200785,34,332,32,300,150,17,133,182,15,167
200800,34,8933,4787,4146,7214,3883,3331,1719,904,815
200846,34,547,214,333,413,165,248,134,49,85
200873,34,52,23,29,41,18,23,11,5,6
201034,34,486,285,201,105,34,71,381,251,130
201061,34,169,50,119,157,45,112,12,5,7
201098,34,26,14,12,17,8,9,9,6,3
201104,34,2292,1042,1250,1632,671,961,660,371,289
201131,34,13,6,7,7,0,7,6,6,0
201140,34,35,32,3,,,,35,32,3
201159,34,21,15,6,11,8,3,10,7,3
201177,34,225,21,204,82,9,73,143,12,131
201195,34,2078,916,1162,1940,855,1085,138,61,77
201283,34,365,127,238,175,71,104,190,56,134
201371,34,476,247,229,458,241,217,18,6,12
201432,34,604,173,431,358,99,259,246,74,172
201441,34,10019,4438,5581,9106,3918,5188,913,520,393
201469,34,537,118,419,389,88,301,148,30,118
201478,34,189,54,135,142,10,132,47,44,3
201496,34,193,119,74,193,119,74,,,
201539,34,66,10,56,56,5,51,10,5,5
201548,34,1621,630,991,1566,604,962,55,26,29
201645,34,4091,2212,1879,4040,2183,1857,51,29,22
201654,34,2641,1209,1432,2606,1193,1413,35,16,19
201672,34,1386,312,1074,278,81,197,1108,231,877
201681,34,5,0,5,5,0,5,,,
201690,34,5213,1452,3761,2405,758,1647,2808,694,2114
201751,34,48,9,39,14,4,10,34,5,29
201803,34,28,3,25,28,3,25,,,
201821,34,801,60,741,542,39,503,259,21,238
201867,34,104,15,89,104,15,89,,,
201885,34,21788,10828,10960,18626,9650,8976,3162,1178,1984
201928,34,4715,1827,2888,1363,586,777,3352,1241,2111
201946,34,1698,575,1123,737,311,426,961,264,697
201955,34,2770,1001,1769,1684,659,1025,1086,342,744
201964,34,1006,400,606,720,316,404,286,84,202
201973,34,2923,846,2077,703,246,457,2220,600,1620
202046,34,436,120,316,432,117,315,4,3,1
202073,34,163,80,83,163,80,83,,,
202134,34,8339,3728,4611,6371,2892,3479,1968,836,1132
202152,34,105,7,98,105,7,98,,,
202170,34,783,231,552,770,225,545,13,6,7
202222,34,13343,6142,7201,3546,1650,1896,9797,4492,5305
202356,34,11012,3960,7052,2745,1169,1576,8267,2791,5476
202435,34,87,14,73,48,7,41,39,7,32
202453,34,32,23,9,26,19,7,6,4,2
202480,34,6429,3362,3067,6147,3213,2934,282,149,133
202514,34,356,206,150,336,196,140,20,10,10
202523,34,1658,781,877,1653,777,876,5,4,1
202648,34,1045,330,715,279,118,161,766,212,554
202657,34,257,71,186,29,8,21,228,63,165
202763,34,1559,517,1042,1483,493,990,76,24,52
202806,34,4178,1694,2484,1375,547,828,2803,1147,1656
202888,34,31,1,30,15,1,14,16,0,16
202903,34,173,92,81,105,54,51,68,38,30
202912,34,259,15,244,98,5,93,161,10,151
202949,34,79,69,10,79,69,10,,,
202985,34,40,4,36,32,4,28,8,0,8
203030,34,43,1,42,43,1,42,,,
203085,34,770,388,382,748,373,375,22,15,7
203128,34,613,285,328,544,257,287,69,28,41
203146,34,55,48,7,55,48,7,,,
203155,34,1042,554,488,744,438,306,298,116,182
203234,34,34,1,33,34,1,33,,,
203289,34,38,31,7,38,31,7,,,
203331,34,38652,12307,26345,12280,3918,8362,26372,8389,17983
203368,34,2023,1104,919,1980,1073,907,43,31,12
203386,34,2382,171,2211,1660,110,1550,722,61,661
203438,34,91,2,89,45,0,45,46,2,44
203447,34,1349,518,831,92,32,60,1257,486,771
203456,34,694,227,467,13,4,9,681,223,458
203465,34,3280,1248,2032,740,293,447,2540,955,1585
203474,34,1528,598,930,223,75,148,1305,523,782
203483,34,1400,571,829,245,96,149,1155,475,680
203492,34,1050,265,785,202,29,173,848,236,612
203517,34,16086,6212,9874,12911,4866,8045,3175,1346,1829
203526,34,1405,487,918,103,25,78,1302,462,840
203535,34,1360,638,722,1360,638,722,,,
203544,34,489,75,414,329,49,280,160,26,134
203580,34,457,247,210,422,235,187,35,12,23
203599,34,2983,1055,1928,791,358,433,2192,697,1495
203614,34,253,43,210,253,43,210,,,
203678,34,1102,264,838,294,100,194,808,164,644
203720,34,131,59,72,101,55,46,30,4,26
203739,34,39,5,34,20,4,16,19,1,18
203748,34,4717,1622,3095,1252,498,754,3465,1124,2341
203757,34,634,271,363,562,251,311,72,20,52
203775,34,660,275,385,569,237,332,91,38,53
203845,34,796,405,391,776,392,384,20,13,7
203881,34,1000,406,594,235,77,158,765,329,436
203942,34,13,5,8,13,5,8,,,
203960,34,1168,129,1039,283,38,245,885,91,794
204006,34,1660,815,845,1192,558,634,468,257,211
204015,34,956,461,495,708,331,377,248,130,118
204024,34,12349,6109,6240,12068,5944,6124,281,165,116
204121,34,35,0,35,16,0,16,19,0,19
204158,34,106,21,85,106,21,85,,,
204176,34,588,73,515,414,50,364,174,23,151
204185,34,1374,713,661,1361,708,653,13,5,8
204194,34,1196,456,740,1025,409,616,171,47,124
204200,34,787,356,431,714,331,383,73,25,48
204255,34,629,275,354,428,201,227,201,74,127
204264,34,1079,464,615,915,434,481,164,30,134
204334,34,82,2,80,1,0,1,81,2,79
204422,34,992,353,639,269,97,172,723,256,467
204431,34,19,4,15,19,4,15,,,
204440,34,722,297,425,211,99,112,511,198,313
204459,34,1,0,1,1,0,1,,,
204468,34,918,429,489,719,375,344,199,54,145
204486,34,1801,1505,296,1649,1400,249,152,105,47
204501,34,2079,856,1223,2042,844,1198,37,12,25
204608,34,401,363,38,401,363,38,,,
204617,34,643,316,327,571,285,286,72,31,41
204635,34,1449,837,612,1415,807,608,34,30,4
204662,34,251,118,133,209,93,116,42,25,17
204671,34,498,194,304,436,166,270,62,28,34
204680,34,455,180,275,378,150,228,77,30,47
204699,34,588,281,307,484,233,251,104,48,56
204705,34,1255,586,669,948,415,533,307,171,136
204714,34,70,7,63,70,7,63,,,
204723,34,163,124,39,163,124,39,,,
204769,34,100,2,98,100,2,98,,,
204778,34,43,1,42,43,1,42,,,
204796,34,37563,19210,18353,34507,17601,16906,3056,1609,1447
204802,34,207,71,136,157,45,112,50,26,24
204820,34,789,289,500,530,181,349,259,108,151
204839,34,568,178,390,450,137,313,118,41,77
204848,34,528,184,344,340,109,231,188,75,113
204857,34,14196,5448,8748,10604,4644,5960,3592,804,2788
204866,34,536,121,415,400,91,309,136,30,106
204884,34,110,6,104,110,6,104,,,
204893,34,31,5,26,8,3,5,23,2,21
204909,34,974,444,530,968,441,527,6,3,3
204936,34,1610,636,974,1515,600,915,95,36,59
204945,34,3410,1208,2202,1086,450,636,2324,758,1566
204963,34,2,0,2,1,0,1,1,0,1
204981,34,115,23,92,17,3,14,98,20,78
205027,34,31,31,0,31,31,0,,,
205054,34,303,22,281,303,22,281,,,
205090,34,74,4,70,9,2,7,65,2,63
205124,34,27,27,0,27,27,0,,,
205142,34,152,44,108,146,44,102,6,0,6
205179,34,466,82,384,446,79,367,20,3,17
205203,34,660,194,466,358,147,211,302,47,255
205391,34,126,30,96,71,16,55,55,14,41
205443,34,1985,885,1100,1596,729,867,389,156,233
205470,34,9698,4210,5488,2057,1041,1016,7641,3169,4472
205559,34,39,9,30,39,9,30,,,
205841,34,5411,2151,3260,1556,743,813,3855,1408,2447
205887,34,356,53,303,356,53,303,,,
205957,34,1855,773,1082,1716,717,999,139,56,83
205966,34,602,171,431,205,75,130,397,96,301
206011,34,786,417,369,278,137,141,508,280,228
206039,34,28,0,28,20,0,20,8,0,8
206048,34,1336,652,684,1097,568,529,239,84,155
206084,34,9692,4869,4823,8356,4187,4169,1336,682,654
206154,34,22,17,5,2,2,0,20,15,5
206172,34,6,1,5,6,1,5,,,
206181,34,146,24,122,52,4,48,94,20,74
206279,34,482,255,227,211,105,106,271,150,121
206321,34,67,22,45,45,2,43,22,20,2
206349,34,536,42,494,445,35,410,91,7,84
206394,34,43,9,34,24,6,18,19,3,16
206437,34,1158,497,661,1029,461,568,129,36,93
206446,34,723,219,504,287,123,164,436,96,340
206491,34,378,150,228,291,111,180,87,39,48
206507,34,801,357,444,756,341,415,45,16,29
206525,34,898,397,501,872,386,486,26,11,15
206589,34,1377,639,738,1371,635,736,6,4,2
206604,34,5747,2633,3114,4433,2029,2404,1314,604,710
206613,34,828,332,496,496,187,309,332,145,187
206622,34,3940,1712,2228,3695,1599,2096,245,113,132
206695,34,6699,3013,3686,5755,2625,3130,944,388,556
206817,34,193,90,103,173,84,89,20,6,14
206835,34,580,290,290,408,224,184,172,66,106
206862,34,1203,525,678,982,452,530,221,73,148
206905,34,20,1,19,20,1,19,,,
206914,34,2297,812,1485,1620,587,1033,677,225,452
206923,34,901,274,627,567,204,363,334,70,264
206932,34,292,31,261,283,29,254,9,2,7
206941,34,9628,3615,6013,6928,2555,4373,2700,1060,1640
206996,34,1077,279,798,645,183,462,432,96,336
207041,34,2114,867,1247,1748,745,1003,366,122,244
207050,34,732,225,507,414,153,261,318,72,246
207069,34,547,196,351,276,127,149,271,69,202
207087,34,18,0,18,18,0,18,,,
207102,34,47,9,38,47,9,38,,,
207157,34,241,129,112,197,112,85,44,17,27
207209,34,1240,442,798,1137,401,736,103,41,62
207236,34,1034,331,703,549,225,324,485,106,379
207254,34,563,500,63,563,500,63,,,
207263,34,4505,1578,2927,3134,1157,1977,1371,421,950
207281,34,1382,458,924,740,284,456,642,174,468
207290,34,981,416,565,745,354,391,236,62,174
207306,34,1131,471,660,941,401,540,190,70,120
207324,34,1321,604,717,1231,573,658,90,31,59
207342,34,853,101,752,822,94,728,31,7,24
207351,34,935,383,552,696,323,373,239,60,179
207388,34,15573,7620,7953,13766,6780,6986,1807,840,967
207397,34,3039,1016,2023,699,307,392,2340,709,1631
207403,34,1105,487,618,1030,432,598,75,55,20
207449,34,7371,2574,4797,2089,822,1267,5282,1752,3530
207458,34,1161,396,765,1117,376,741,44,20,24
207500,34,16218,8165,8053,14317,7172,7145,1901,993,908
207564,34,1393,934,459,815,619,196,578,315,263
207582,34,2443,936,1507,2071,792,1279,372,144,228
207661,34,2120,792,1328,1472,553,919,648,239,409
207670,34,3368,1072,2296,1346,509,837,2022,563,1459
207704,34,126,2,124,62,1,61,64,1,63
207722,34,592,223,369,532,201,331,60,22,38
207740,34,785,189,596,425,124,301,360,65,295
207786,34,1,0,1,1,0,1,,,
207847,34,2480,1083,1397,1745,797,948,735,286,449
207856,34,340,191,149,301,167,134,39,24,15
207865,34,2856,1098,1758,2366,949,1417,490,149,341
207935,34,8691,2985,5706,2592,1047,1545,6099,1938,4161
207962,34,467,398,69,467,398,69,,,
207971,34,2115,1097,1018,2027,1053,974,88,44,44
208035,34,660,165,495,265,107,158,395,58,337
208044,34,18,2,16,18,2,16,,,
208053,34,22,12,10,2,0,2,20,12,8
208275,34,624,213,411,334,142,192,290,71,219
208318,34,2669,1129,1540,1221,557,664,1448,572,876
208390,34,4659,1992,2667,1888,759,1129,2771,1233,1538
208406,34,3329,1688,1641,1066,484,582,2263,1204,1059
208415,34,349,124,225,142,46,96,207,78,129
208433,34,48,3,45,48,3,45,,,
208479,34,368,50,318,368,50,318,,,
208512,34,266,24,242,266,24,242,,,
208637,34,179,40,139,,,,179,40,139
208646,34,2130,859,1271,1267,512,755,863,347,516
208725,34,33,18,15,30,16,14,3,2,1
208822,34,1898,723,1175,1694,645,1049,204,78,126
208859,34,7,0,7,7,0,7,,,
209038,34,4546,2074,2472,1834,821,1013,2712,1253,1459
209056,34,1419,526,893,1411,519,892,8,7,1
209065,34,958,385,573,918,367,551,40,18,22
209074,34,3351,1441,1910,1106,502,604,2245,939,1306
209083,34,61,16,45,61,16,45,,,
209153,34,3,0,3,3,0,3,,,
209205,34,25,1,24,25,1,24,,,
209241,34,27,27,0,26,26,0,1,1,0
209250,34,2767,1051,1716,1266,529,737,1501,522,979
209287,34,256,136,120,214,122,92,42,14,28
209296,34,32,8,24,32,8,24,,,
209409,34,385,150,235,316,132,184,69,18,51
209490,34,783,147,636,483,94,389,300,53,247
209506,34,2814,1467,1347,1802,954,848,1012,513,499
209542,34,23073,12075,10998,15073,7972,7101,8000,4103,3897
209551,34,13900,6279,7621,12640,5693,6947,1260,586,674
209603,34,320,97,223,296,92,204,24,5,19
209612,34,1275,478,797,1221,449,772,54,29,25
209667,34,17,0,17,17,0,17,,,
209676,34,19,1,18,19,1,18,,,
209694,34,10,7,3,10,7,3,,,
209700,34,170,12,158,170,12,158,,,
209719,34,8,0,8,8,0,8,,,
209746,34,15354,6306,9048,5957,2549,3408,9397,3757,5640
209807,34,13933,6172,7761,10287,4495,5792,3646,1677,1969
209825,34,2654,1009,1645,2576,982,1594,78,27,51
209922,34,1019,451,568,1009,448,561,10,3,7
209940,34,2251,844,1407,705,279,426,1546,565,981
210146,34,2689,1071,1618,1981,818,1163,708,253,455
210155,34,740,240,500,383,152,231,357,88,269
210234,34,814,343,471,469,221,248,345,122,223
210270,34,1330,518,812,414,175,239,916,343,573
210304,34,371,126,245,348,115,233,23,11,12
210331,34,684,301,383,536,224,312,148,77,71
210340,34,43,6,37,43,6,37,,,
210401,34,926,395,531,900,383,517,26,12,14
210429,34,3043,991,2052,2527,821,1706,516,170,346
210492,34,169,81,88,159,76,83,10,5,5
210571,34,1024,435,589,967,412,555,57,23,34
210599,34,565,274,291,565,274,291,,,
210605,34,8035,3565,4470,2367,1112,1255,5668,2453,3215
210669,34,1130,513,617,1117,506,611,13,7,6
210711,34,22,0,22,22,0,22,,,
210739,34,1749,648,1101,1431,551,880,318,97,221
210748,34,68,1,67,27,1,26,41,0,41
210775,34,1622,510,1112,1240,437,803,382,73,309
210784,34,93,1,92,78,1,77,15,0,15
210809,34,6283,4409,1874,,,,6283,4409,1874
211006,34,326,303,23,317,295,22,9,8,1
211024,34,309,151,158,201,99,102,108,52,56
211079,34,965,392,573,374,191,183,591,201,390
211088,34,1313,435,878,1255,420,835,58,15,43
211130,34,4,0,4,4,0,4,,,
211158,34,5311,2098,3213,4845,1927,2918,466,171,295
211273,34,1000,0,1000,998,0,998,2,0,2
211291,34,2687,1262,1425,2686,1261,1425,1,1,0
211307,34,4183,1627,2556,1253,591,662,2930,1036,1894
211316,34,80,0,80,56,0,56,24,0,24
211334,34,13,0,13,13,0,13,,,
211343,34,1414,486,928,497,201,296,917,285,632
211352,34,990,399,591,933,365,568,57,34,23
211361,34,3499,1560,1939,2776,1232,1544,723,328,395
211431,34,1059,166,893,771,134,637,288,32,256
211440,34,4984,2539,2445,4847,2461,2386,137,78,59
211468,34,873,63,810,624,40,584,249,23,226
211477,34,777,244,533,165,69,96,612,175,437
211556,34,827,248,579,776,234,542,51,14,37
211583,34,823,313,510,672,284,388,151,29,122
211608,34,420,158,262,388,142,246,32,16,16
211635,34,100,12,88,100,12,88,,,
211644,34,2549,769,1780,1963,627,1336,586,142,444
211802,34,138,21,117,138,21,117,,,
211893,34,99,56,43,99,56,43,,,
211927,34,6569,2312,4257,1516,680,836,5053,1632,3421
211981,34,1266,517,749,1175,481,694,91,36,55
212009,34,1461,617,844,1447,611,836,14,6,8
212045,34,130,28,102,128,28,100,2,0,2
212054,34,11454,5956,5498,10293,5488,4805,1161,468,693
212106,34,3838,1403,2435,3769,1362,2407,69,41,28
212115,34,3596,1529,2067,3167,1350,1817,429,179,250
212133,34,1326,420,906,913,324,589,413,96,317
212160,34,2127,859,1268,1902,751,1151,225,108,117
212197,34,1233,501,732,1104,455,649,129,46,83
212230,34,13,1,12,13,1,12,,,
212267,34,22,0,22,16,0,16,6,0,6
212276,34,16,1,15,11,1,10,5,0,5
212294,34,30,1,29,28,1,27,2,0,2
212300,34,15,0,15,15,0,15,,,
212328,34,43,1,42,29,0,29,14,1,13
212337,34,48,1,47,33,0,33,15,1,14
212355,34,57,1,56,43,1,42,14,0,14
212382,34,69,1,68,42,1,41,27,0,27
212391,34,43,1,42,29,1,28,14,0,14
212434,34,147,136,11,147,136,11,,,
212577,34,1628,725,903,1618,720,898,10,5,5
212601,34,2037,797,1240,1984,781,1203,53,16,37
212656,34,827,422,405,749,390,359,78,32,46
212674,34,1776,872,904,1774,871,903,2,1,1
212753,34,31,0,31,21,0,21,10,0,10
212771,34,84,2,82,51,0,51,33,2,31
212805,34,1555,826,729,1539,812,727,16,14,2
212832,34,1308,294,1014,1146,260,886,162,34,128
212869,34,842,135,707,491,88,403,351,47,304
212878,34,9684,2950,6734,2718,1003,1715,6966,1947,5019
212911,34,1009,474,535,1008,474,534,1,0,1
212975,34,52,37,15,52,37,15,,,
212984,34,1786,425,1361,1459,349,1110,327,76,251
212993,34,48,17,31,46,17,29,2,0,2
213011,34,1073,297,776,712,223,489,361,74,287
213020,34,5286,2056,3230,4782,1831,2951,504,225,279
213163,34,261,37,224,261,37,224,,,
213181,34,207,12,195,137,9,128,70,3,67
213233,34,296,221,75,234,188,46,62,33,29
213251,34,864,390,474,862,390,472,2,0,2
213303,34,839,348,491,681,318,363,158,30,128
213321,34,1332,685,647,1278,654,624,54,31,23
213330,34,11,0,11,11,0,11,,,
213349,34,4994,2169,2825,4557,1970,2587,437,199,238
213358,34,781,304,477,651,263,388,130,41,89
213367,34,2173,750,1423,1816,679,1137,357,71,286
213376,34,1298,466,832,901,356,545,397,110,287
213385,34,1937,980,957,1924,970,954,13,10,3
213400,34,1198,582,616,592,282,310,606,300,306
213455,34,179,6,173,15,0,15,164,6,158
213473,34,115,19,96,79,11,68,36,8,28
213491,34,10,1,9,8,1,7,2,0,2
213507,34,1161,534,627,1132,521,611,29,13,16
213525,34,3551,1126,2425,1085,463,622,2466,663,1803
213534,34,263,77,186,242,74,168,21,3,18
213543,34,3927,2146,1781,3855,2102,1753,72,44,28
213570,34,441,93,348,441,93,348,,,
213589,34,240,219,21,153,141,12,87,78,9
213598,34,1286,445,841,1190,417,773,96,28,68
213613,34,1835,715,1120,1626,668,958,209,47,162
213622,34,108,14,94,92,12,80,16,2,14
213659,34,2668,868,1800,886,365,521,1782,503,1279
213668,34,762,337,425,757,334,423,5,3,2
213774,34,419,92,327,299,75,224,120,17,103
213783,34,1107,387,720,1006,356,650,101,31,70
213826,34,1263,410,853,1184,382,802,79,28,51
213914,34,195,9,186,195,9,186,,,
213932,34,141,20,121,141,20,121,,,
213987,34,1965,776,1189,1788,744,1044,177,32,145
213996,34,1799,716,1083,1754,697,1057,45,19,26
214023,34,5,2,3,5,2,3,,,
214041,34,4867,1977,2890,3687,1561,2126,1180,416,764
214069,34,1402,440,962,1056,365,691,346,75,271
214111,34,5973,2228,3745,1550,728,822,4423,1500,2923
214148,34,257,0,257,251,0,251,6,0,6
214157,34,1422,555,867,1348,530,818,74,25,49
214166,34,765,198,567,644,179,465,121,19,102
214175,34,1602,641,961,1557,618,939,45,23,22
214272,34,1323,465,858,999,350,649,324,115,209
214290,34,442,412,30,442,412,30,,,
214379,34,5444,1812,3632,1792,736,1056,3652,1076,2576
214476,34,27,4,23,25,3,22,2,1,1
214528,34,178,168,10,135,127,8,43,41,2
214582,34,386,42,344,285,33,252,101,9,92
214883,34,780,209,571,179,46,133,601,163,438
214892,34,221,83,138,221,83,138,,,
214944,34,349,301,48,194,174,20,155,127,28
214971,34,111,27,84,109,26,83,2,1,1
215008,34,51,49,2,51,49,2,,,
215044,34,70,19,51,70,19,51,,,
215053,34,181,53,128,173,52,121,8,1,7
215062,34,8245,3698,4547,7549,3432,4117,696,266,430
215105,34,1125,398,727,1110,392,718,15,6,9
215114,34,598,271,327,568,256,312,30,15,15
215132,34,1000,318,682,978,310,668,22,8,14
215239,34,8853,2695,6158,2593,923,1670,6260,1772,4488
215266,34,843,345,498,780,326,454,63,19,44
215275,34,989,420,569,930,388,542,59,32,27
215284,34,1651,924,727,1601,894,707,50,30,20
215293,34,15086,6875,8211,14335,6464,7871,751,411,340
215309,34,27,3,24,19,2,17,8,1,7
215336,34,27,0,27,27,0,27,,,
215381,34,411,385,26,411,385,26,,,
215390,34,155,57,98,32,19,13,123,38,85
215415,34,855,462,393,741,411,330,114,51,63
215442,34,1966,756,1210,1738,647,1091,228,109,119
215479,34,65,15,50,65,15,50,,,
215530,34,27,0,27,15,0,15,12,0,12
215585,34,2572,754,1818,517,199,318,2055,555,1500
215594,34,262,41,221,189,30,159,73,11,62
215637,34,148,55,93,148,55,93,,,
215655,34,2310,1303,1007,2114,1198,916,196,105,91
215682,34,324,287,37,324,287,37,,,
215691,34,318,119,199,255,99,156,63,20,43
215743,34,1301,467,834,1086,412,674,215,55,160
215770,34,3074,1453,1621,2823,1348,1475,251,105,146
215798,34,1007,559,448,979,535,444,28,24,4
215886,34,27,2,25,14,2,12,13,0,13
215929,34,2608,1068,1540,2532,1028,1504,76,40,36
215947,34,1276,451,825,1171,421,750,105,30,75
215974,34,319,63,256,183,40,143,136,23,113
215983,34,23,5,18,23,5,18,,,
215992,34,87,42,45,87,42,45,,,
216010,34,3654,1782,1872,3303,1595,1708,351,187,164
216038,34,5453,2458,2995,5040,2264,2776,413,194,219
216047,34,32,32,0,32,32,0,,,
216074,34,39,2,37,25,2,23,14,0,14
216083,34,170,53,117,134,44,90,36,9,27
216162,34,301,24,277,301,24,277,,,
216223,34,16,0,16,16,0,16,,,
216278,34,1557,683,874,1551,679,872,6,4,2
216287,34,1189,603,586,1189,603,586,,,
216296,34,721,635,86,698,614,84,23,21,2
216311,34,83,83,0,83,83,0,,,
216339,34,20674,9222,11452,18808,8248,10560,1866,974,892
216357,34,526,259,267,522,257,265,4,2,2
216366,34,3043,771,2272,2637,681,1956,406,90,316
216436,34,94,85,9,94,85,9,,,
216445,34,94,89,5,94,89,5,,,
216454,34,83,74,9,83,74,9,,,
216524,34,1101,569,532,1097,567,530,4,2,2
216542,34,345,162,183,303,141,162,42,21,21
216551,34,41,34,7,39,32,7,2,2,0
216579,34,50,1,49,50,1,49,,,
216597,34,5228,2415,2813,5041,2315,2726,187,100,87
216630,34,33,4,29,33,4,29,,,
216667,34,823,420,403,806,406,400,17,14,3
216694,34,871,357,514,838,351,487,33,6,27
216746,34,38,32,6,27,23,4,11,9,2
216764,34,11524,4620,6904,10055,4045,6010,1469,575,894
216773,34,104,16,88,104,16,88,,,
216782,34,112,3,109,52,0,52,60,3,57
216807,34,768,356,412,757,351,406,11,5,6
216825,34,2028,611,1417,782,281,501,1246,330,916
216852,34,2121,895,1226,1944,843,1101,177,52,125
216931,34,1578,722,856,1465,678,787,113,44,69
216940,34,145,145,0,145,145,0,,,
217013,34,527,103,424,409,97,312,118,6,112
217040,34,20,20,0,20,20,0,,,
217059,34,2714,1193,1521,2437,1046,1391,277,147,130
217077,34,302,94,208,302,94,208,,,
217156,34,5420,2619,2801,5371,2594,2777,49,25,24
217165,34,2389,1494,895,2365,1480,885,24,14,10
217235,34,3473,1398,2075,3191,1278,1913,282,120,162
217305,34,1358,788,570,1142,665,477,216,123,93
217323,34,130,116,14,130,116,14,,,
217402,34,3101,1380,1721,2962,1317,1645,139,63,76
217420,34,4519,1387,3132,3461,1072,2389,1058,315,743
217475,34,8283,3045,5238,2508,1084,1424,5775,1961,3814
217484,34,10510,4618,5892,9446,4141,5305,1064,477,587
217493,34,1547,523,1024,1547,523,1024,,,
217518,34,3087,1563,1524,2763,1393,1370,324,170,154
217536,34,1578,509,1069,1503,489,1014,75,20,55
217581,34,98,2,96,60,1,59,38,1,37
217606,34,176,99,77,130,71,59,46,28,18
217615,34,1205,385,820,400,148,252,805,237,568
217624,34,434,252,182,420,241,179,14,11,3
217633,34,2124,684,1440,1971,639,1332,153,45,108
217688,34,2024,713,1311,1802,633,1169,222,80,142
217712,34,1246,303,943,301,100,201,945,203,742
217721,34,1312,546,766,1301,542,759,11,4,7
217749,34,1837,838,999,1709,784,925,128,54,74
217776,34,778,254,524,557,206,351,221,48,173
217794,34,94,0,94,63,0,63,31,0,31
217819,34,7297,2561,4736,6720,2299,4421,577,262,315
217828,34,16,2,14,9,1,8,7,1,6
217837,34,770,179,591,181,52,129,589,127,462
217864,34,2116,1834,282,1947,1713,234,169,121,48
217873,34,1468,423,1045,1382,404,978,86,19,67
217882,34,16984,8588,8396,16249,8122,8127,735,466,269
217891,34,120,55,65,115,53,62,5,2,3
217907,34,621,239,382,591,232,359,30,7,23
217925,34,528,253,275,395,200,195,133,53,80
217934,34,838,109,729,536,49,487,302,60,242
217961,34,525,46,479,486,42,444,39,4,35
217989,34,212,53,159,123,40,83,89,13,76
217998,34,513,341,172,499,333,166,14,8,6
218025,34,1829,570,1259,616,274,342,1213,296,917
218061,34,2168,741,1427,1988,686,1302,180,55,125
218070,34,1646,639,1007,1628,626,1002,18,13,5
218113,34,6161,2258,3903,2561,1075,1486,3600,1183,2417
218140,34,4245,1361,2884,1996,781,1215,2249,580,1669
218159,34,105,2,103,81,1,80,24,1,23
218195,34,92,3,89,54,3,51,38,0,38
218229,34,2493,801,1692,2307,741,1566,186,60,126
218238,34,1393,636,757,1054,506,548,339,130,209
218335,34,334,31,303,325,31,294,9,0,9
218353,34,5792,1975,3817,2236,967,1269,3556,1008,2548
218399,34,320,128,192,312,124,188,8,4,4
218414,34,898,508,390,880,502,378,18,6,12
218441,34,1178,550,628,1121,524,597,57,26,31
218487,34,1300,300,1000,420,162,258,880,138,742
218520,34,2789,732,2057,899,303,596,1890,429,1461
218539,34,716,357,359,708,353,355,8,4,4
218645,34,2287,795,1492,1843,653,1190,444,142,302
218654,34,1423,431,992,1188,366,822,235,65,170
218663,34,20256,9367,10889,19258,8825,10433,998,542,456
218672,34,361,157,204,273,130,143,88,27,61
218681,34,273,110,163,201,89,112,72,21,51
218690,34,308,141,167,189,83,106,119,58,61
218706,34,117,50,67,93,41,52,24,9,15
218724,34,6865,3134,3731,6385,2881,3504,480,253,227
218733,34,1477,653,824,1307,566,741,170,87,83
218742,34,3899,1293,2606,3321,1064,2257,578,229,349
218821,34,532,245,287,508,233,275,24,12,12
218830,34,3656,1288,2368,1602,640,962,2054,648,1406
218858,34,1615,444,1171,418,167,251,1197,277,920
218885,34,2870,1182,1688,1252,622,630,1618,560,1058
218894,34,6889,2503,4386,2499,1024,1475,4390,1479,2911
218919,34,321,127,194,271,109,162,50,18,32
218955,34,304,40,264,62,9,53,242,31,211
218964,34,2947,982,1965,2720,893,1827,227,89,138
218973,34,1300,617,683,1286,605,681,14,12,2
218991,34,2416,858,1558,1109,471,638,1307,387,920
219000,34,1191,435,756,1145,413,732,46,22,24
219037,34,11,0,11,11,0,11,,,
219046,34,1590,531,1059,1237,420,817,353,111,242
219082,34,1544,1054,490,1040,742,298,504,312,192
219091,34,485,213,272,446,210,236,39,3,36
219125,34,69,4,65,61,3,58,8,1,7
219143,34,1061,505,556,799,440,359,262,65,197
219170,34,24,2,22,24,2,22,,,
219189,34,556,336,220,417,272,145,139,64,75
219198,34,475,226,249,401,188,213,74,38,36
219204,34,797,360,437,118,67,51,679,293,386
219240,34,18,11,7,7,2,5,11,9,2
219259,34,1007,402,605,789,331,458,218,71,147
219277,34,1226,335,891,554,163,391,672,172,500
219295,34,448,157,291,281,136,145,167,21,146
219338,34,17,1,16,17,1,16,,,
219347,34,1485,1130,355,1221,928,293,264,202,62
219356,34,6632,3091,3541,5563,2631,2932,1069,460,609
219374,34,374,74,300,140,30,110,234,44,190
219383,34,997,362,635,880,323,557,117,39,78
219392,34,28,7,21,28,7,21,,,
219408,34,93,34,59,52,23,29,41,11,30
219426,34,1153,491,662,603,334,269,550,157,393
219453,34,100,1,99,100,1,99,,,
219471,34,4097,1546,2551,3302,1254,2048,795,292,503
219480,34,633,238,395,422,186,236,211,52,159
219505,34,50,29,21,36,19,17,14,10,4
219587,34,34,0,34,34,0,34,,,
219596,34,168,116,52,168,116,52,,,
219602,34,6061,2332,3729,4210,1580,2630,1851,752,1099
219639,34,820,72,748,280,30,250,540,42,498
219709,34,5216,1819,3397,4957,1713,3244,259,106,153
219718,34,1850,896,954,1460,722,738,390,174,216
219790,34,637,294,343,506,251,255,131,43,88
219806,34,1206,503,703,1166,486,680,40,17,23
219824,34,3764,1293,2471,1876,731,1145,1888,562,1326
219833,34,990,433,557,942,404,538,48,29,19
219851,34,87,2,85,87,2,85,,,
219879,34,1424,578,846,732,343,389,692,235,457
219888,34,2812,1011,1801,1610,670,940,1202,341,861
219903,34,991,78,913,991,78,913,,,
219921,34,206,126,80,141,90,51,65,36,29
219949,34,1280,524,756,1186,490,696,94,34,60
219976,34,2282,898,1384,2101,820,1281,181,78,103
219994,34,508,308,200,473,277,196,35,31,4
220002,34,38,2,36,38,2,36,,,
220057,34,1425,376,1049,639,219,420,786,157,629
220075,34,7912,3024,4888,6538,2526,4012,1374,498,876
220118,34,190,11,179,190,11,179,,,
220127,34,351,188,163,325,166,159,26,22,4
220163,34,26,1,25,13,0,13,13,1,12
220181,34,619,207,412,585,196,389,34,11,23
220206,34,200,107,93,134,72,62,66,35,31
220215,34,1051,476,575,1004,459,545,47,17,30
220251,34,58,36,22,55,33,22,3,3,0
220279,34,207,146,61,148,101,47,59,45,14
220321,34,310,144,166,294,142,152,16,2,14
220394,34,139,83,56,136,81,55,3,2,1
220400,34,1951,534,1417,891,295,596,1060,239,821
220464,34,173,75,98,43,20,23,130,55,75
220473,34,508,245,263,429,199,230,79,46,33
220491,34,269,8,261,198,8,190,71,0,71
220516,34,1116,373,743,978,330,648,138,43,95
220552,34,3981,550,3431,2995,425,2570,986,125,861
220598,34,748,386,362,692,356,336,56,30,26
220604,34,538,178,360,464,153,311,74,25,49
220613,34,2792,1064,1728,2422,883,1539,370,181,189
220631,34,1286,343,943,933,305,628,353,38,315
220640,34,274,134,140,221,97,124,53,37,16
220701,34,526,234,292,501,225,276,25,9,16
220710,34,701,310,391,684,303,381,17,7,10
220756,34,68,55,13,66,53,13,2,2,0
220765,34,47,9,38,36,6,30,11,3,8
220853,34,689,476,213,552,367,185,137,109,28
220862,34,11998,4663,7335,8596,3421,5175,3402,1242,2160
220978,34,14961,6780,8181,12373,5614,6759,2588,1166,1422
221050,34,479,366,113,406,302,104,73,64,9
221096,34,2605,871,1734,1231,455,776,1374,416,958
221102,34,386,266,120,305,195,110,81,71,10
221148,34,1172,1099,73,1172,1099,73,,,
221184,34,4064,1373,2691,1586,607,979,2478,766,1712
221236,34,255,155,100,196,136,60,59,19,40
221281,34,126,61,65,111,54,57,15,7,8
221333,34,207,136,71,148,82,66,59,54,5
221351,34,1391,584,807,1386,580,806,5,4,1
221388,34,137,39,98,110,32,78,27,7,20
221397,34,2375,745,1630,1139,426,713,1236,319,917
221430,34,294,196,98,191,130,61,103,66,37
221485,34,4567,1442,3125,1892,681,1211,2675,761,1914
221494,34,336,256,80,279,228,51,57,28,29
221519,34,1251,591,660,1250,590,660,1,1,0
221582,34,138,81,57,124,74,50,14,7,7
221591,34,289,188,101,275,177,98,14,11,3
221607,34,296,224,72,153,99,54,143,125,18
221616,34,380,253,127,365,244,121,15,9,6
221625,34,565,314,251,542,300,242,23,14,9
221643,34,4652,2221,2431,2108,1047,1061,2544,1174,1370
221661,34,1732,787,945,1534,703,831,198,84,114
221731,34,779,284,495,712,257,455,67,27,40
221740,34,7896,3383,4513,6900,2924,3976,996,459,537
221759,34,19009,9024,9985,17926,8422,9504,1083,602,481
221768,34,3701,1483,2218,3309,1341,1968,392,142,250
221829,34,206,7,199,206,7,199,,,
221838,34,4218,1482,2736,3334,1172,2162,884,310,574
221847,34,6525,3478,3047,5894,3113,2781,631,365,266
221892,34,1389,522,867,1061,418,643,328,104,224
221908,34,3058,1401,1657,1630,730,900,1428,671,757
221953,34,865,399,466,780,365,415,85,34,51
221971,34,1490,494,996,1287,428,859,203,66,137
221999,34,5478,2664,2814,5418,2627,2791,60,37,23
222053,34,4063,1427,2636,2015,756,1259,2048,671,1377
222062,34,2489,830,1659,1398,542,856,1091,288,803
222105,34,215,199,16,90,83,7,125,116,9
222178,34,2298,913,1385,2199,867,1332,99,46,53
222567,34,2392,926,1466,459,186,273,1933,740,1193
222576,34,5844,1876,3968,2165,785,1380,3679,1091,2588
222628,34,159,54,105,37,21,16,122,33,89
222822,34,1999,583,1416,760,242,518,1239,341,898
222831,34,4132,1771,2361,3541,1464,2077,591,307,284
222877,34,127,72,55,122,72,50,5,0,5
222886,34,88,2,86,85,2,83,3,0,3
222938,34,324,140,184,217,101,116,107,39,68
222983,34,924,427,497,920,426,494,4,1,3
222992,34,22187,8828,13359,5124,2428,2696,17063,6400,10663
223056,34,31,2,29,31,2,29,,,
223083,34,508,86,422,127,21,106,381,65,316
223117,34,36,27,9,2,1,1,34,26,8
223232,34,10831,4282,6549,10583,4177,6406,248,105,143
223320,34,2164,738,1426,757,303,454,1407,435,972
223427,34,11029,5287,5742,5241,2646,2595,5788,2641,3147
223463,34,267,76,191,267,76,191,,,
223472,34,187,17,170,187,17,170,,,
223506,34,2198,1009,1189,317,153,164,1881,856,1025
223816,34,4198,1671,2527,533,187,346,3665,1484,2181
223852,34,9,1,8,9,1,8,,,
223898,34,2040,713,1327,777,286,491,1263,427,836
223922,34,577,269,308,262,118,144,315,151,164
224004,34,1506,473,1033,1219,402,817,287,71,216
224013,34,31,2,29,31,2,29,,,
224110,34,4548,1758,2790,1039,437,602,3509,1321,2188
224147,34,6112,2394,3718,4235,1598,2637,1877,796,1081
224156,34,327,7,320,322,7,315,5,0,5
224226,34,2031,884,1147,1621,715,906,410,169,241
224244,34,152,86,66,134,77,57,18,9,9
224271,34,465,125,340,464,124,340,1,1,0
224323,34,1020,455,565,989,442,547,31,13,18
224350,34,8985,3625,5360,1221,526,695,7764,3099,4665
224527,34,916,418,498,820,387,433,96,31,65
224545,34,1532,547,985,1092,414,678,440,133,307
224554,34,6700,2689,4011,4640,1877,2763,2060,812,1248
224615,34,35339,13343,21996,8349,3534,4815,26990,9809,17181
224642,34,20551,8210,12341,4359,1840,2519,16192,6370,9822
224660,34,493,245,248,377,199,178,116,46,70
224679,34,981,854,127,614,530,84,367,324,43
224758,34,15,1,14,10,0,10,5,1,4
224776,34,272,119,153,166,71,95,106,48,58
224828,34,48,0,48,35,0,35,13,0,13
224891,34,468,218,250,312,153,159,156,65,91
224961,34,1222,371,851,404,168,236,818,203,615
225070,34,2044,757,1287,881,321,560,1163,436,727
225201,34,703,446,257,703,446,257,,,
225247,34,1071,507,564,1023,485,538,48,22,26
225308,34,3985,1547,2438,1130,445,685,2855,1102,1753
225371,34,1446,501,945,597,248,349,849,253,596
225399,34,1971,664,1307,1406,475,931,565,189,376
225414,34,6412,2280,4132,3098,1107,1991,3314,1173,2141
225423,34,31158,11701,19457,8707,3650,5057,22451,8051,14400
225432,34,12155,4362,7793,5436,1972,3464,6719,2390,4329
225502,34,2807,970,1837,1244,461,783,1563,509,1054
225511,34,32116,15854,16262,22382,10776,11606,9734,5078,4656
225520,34,1306,345,961,576,189,387,730,156,574
225548,34,540,284,256,488,259,229,52,25,27
225575,34,840,318,522,765,290,475,75,28,47
225627,34,3723,1371,2352,2998,1065,1933,725,306,419
225876,34,128,59,69,113,56,57,15,3,12
225885,34,598,257,341,497,224,273,101,33,68
225991,34,86,49,37,86,49,37,,,
226019,34,2422,890,1532,1216,533,683,1206,357,849
226091,34,6312,2513,3799,3130,1327,1803,3182,1186,1996
226107,34,1204,311,893,571,158,413,633,153,480
226116,34,1968,701,1267,551,198,353,1417,503,914
226125,34,84,5,79,84,5,79,,,
226134,34,6748,2733,4015,1197,448,749,5551,2285,3266
226152,34,5213,1958,3255,4083,1537,2546,1130,421,709
226204,34,6056,3041,3015,715,386,329,5341,2655,2686
226231,34,1295,785,510,1028,685,343,267,100,167
226277,34,1009,933,76,1009,933,76,,,
226383,34,965,358,607,865,323,542,100,35,65
226408,34,2098,735,1363,522,200,322,1576,535,1041
226471,34,2315,757,1558,2128,692,1436,187,65,122
226578,34,4333,1218,3115,1554,519,1035,2779,699,2080
226587,34,813,383,430,696,338,358,117,45,72
226675,34,377,49,328,377,49,328,,,
226806,34,4030,1529,2501,921,338,583,3109,1191,1918
226833,34,4077,1412,2665,2872,1059,1813,1205,353,852
226860,34,31,1,30,31,1,30,,,
226879,34,192,30,162,98,14,84,94,16,78
226903,34,464,202,262,464,202,262,,,
227058,34,77,0,77,77,0,77,,,
227146,34,5467,1999,3468,1520,610,910,3947,1389,2558
227182,34,37799,14277,23522,10741,4582,6159,27058,9695,17363
227216,34,27027,12558,14469,20078,9161,10917,6949,3397,3552
227225,34,1300,401,899,708,227,481,592,174,418
227298,34,79,76,3,79,76,3,,,
227304,34,3483,1112,2371,1605,549,1056,1878,563,1315
227313,34,160,1,159,66,0,66,94,1,93
227322,34,157,1,156,81,1,80,76,0,76
227331,34,934,276,658,828,250,578,106,26,80
227368,34,20963,8505,12458,15389,6036,9353,5574,2469,3105
227377,34,2899,1212,1687,1191,541,650,1708,671,1037
227386,34,1192,286,906,578,182,396,614,104,510
227401,34,1715,574,1141,811,310,501,904,264,640
227429,34,318,132,186,272,112,160,46,20,26
227526,34,6633,2237,4396,5824,1940,3884,809,297,512
227687,34,1215,467,748,505,223,282,710,244,466
227748,34,217,195,22,164,151,13,53,44,9
227757,34,3023,1595,1428,2933,1552,1381,90,43,47
227845,34,2254,860,1394,2061,777,1284,193,83,110
227854,34,7454,2740,4714,807,359,448,6647,2381,4266
227863,34,2160,835,1325,1774,603,1171,386,232,154
227881,34,15379,5619,9760,11594,4249,7345,3785,1370,2415
227924,34,11676,4189,7487,1918,710,1208,9758,3479,6279
227979,34,17723,6714,11009,4379,1796,2583,13344,4918,8426
228042,34,716,317,399,655,308,347,61,9,52
228088,34,10,0,10,10,0,10,,,
228149,34,1477,643,834,1401,601,800,76,42,34
228158,34,5270,1999,3271,2726,1173,1553,2544,826,1718
228185,34,14,12,2,14,12,2,,,
228200,34,246,126,120,234,125,109,12,1,11
228219,34,352,101,251,335,96,239,17,5,12
228246,34,5322,2740,2582,5159,2660,2499,163,80,83
228282,34,1,1,0,1,1,0,,,
228316,34,2125,714,1411,597,214,383,1528,500,1028
228325,34,1187,573,614,988,489,499,199,84,115
228343,34,1145,523,622,1125,511,614,20,12,8
228431,34,7802,2845,4957,6632,2413,4219,1170,432,738
228459,34,26525,10980,15545,20331,8222,12109,6194,2758,3436
228468,34,557,217,340,507,194,313,50,23,27
228486,34,51,34,17,42,28,14,9,6,3
228501,34,1407,504,903,792,348,444,615,156,459
228529,34,9516,3485,6031,6564,2361,4203,2952,1124,1828
228547,34,30089,11768,18321,4145,1925,2220,25944,9843,16101
228608,34,2516,721,1795,899,287,612,1617,434,1183
228644,34,787,228,559,670,178,492,117,50,67
228653,34,672,124,548,541,96,445,131,28,103
228699,34,2291,825,1466,535,191,344,1756,634,1122
228705,34,3819,1889,1930,3100,1564,1536,719,325,394
228723,34,43683,23105,20578,38956,20417,18539,4727,2688,2039
228769,34,28080,10481,17599,14980,6572,8408,13100,3909,9191
228778,34,31446,13876,17570,29147,12670,16477,2299,1206,1093
228787,34,17374,9907,7467,14128,7974,6154,3246,1933,1313
228796,34,16913,7404,9509,10568,4662,5906,6345,2742,3603
228802,34,5583,2162,3421,3616,1489,2127,1967,673,1294
228875,34,7655,3129,4526,7464,3028,4436,191,101,90
228884,34,550,301,249,493,272,221,57,29,28
228981,34,1087,468,619,1037,450,587,50,18,32
229018,34,3057,1246,1811,1912,795,1117,1145,451,694
229027,34,23629,11466,12163,17508,8222,9286,6121,3244,2877
229063,34,4432,1604,2828,3605,1297,2308,827,307,520
229115,34,25765,13423,12342,22445,11585,10860,3320,1838,1482
229160,34,1079,465,614,937,427,510,142,38,104
229179,34,7748,734,7014,5319,495,4824,2429,239,2190
229267,34,1846,903,943,1808,882,926,38,21,17
229300,34,685,88,597,542,65,477,143,23,120
229337,34,1468,187,1281,1233,156,1077,235,31,204
229355,34,6356,2055,4301,2878,1069,1809,3478,986,2492
229416,34,1038,973,65,1038,973,65,,,
229425,34,119,0,119,25,0,25,94,0,94
229504,34,2042,651,1391,452,171,281,1590,480,1110
229522,34,38,7,31,18,3,15,20,4,16
229540,34,1996,582,1414,458,195,263,1538,387,1151
229656,34,229,6,223,193,3,190,36,3,33
229780,34,2167,984,1183,1182,543,639,985,441,544
229799,34,2888,818,2070,893,326,567,1995,492,1503
229814,34,5662,2294,3368,4088,1632,2456,1574,662,912
229832,34,347,178,169,195,85,110,152,93,59
229841,34,3610,1496,2114,1247,597,650,2363,899,1464
229887,34,470,191,279,413,172,241,57,19,38
230010,34,1277,714,563,414,179,235,863,535,328
230038,34,26229,13125,13104,23013,11518,11495,3216,1607,1609
230047,34,2154,869,1285,2025,819,1206,129,50,79
230056,34,93,17,76,78,11,67,15,6,9
230065,34,166,2,164,1,0,1,165,2,163
230144,34,4,0,4,4,0,4,,,
230162,34,1693,1032,661,318,115,203,1375,917,458
230171,34,6237,2624,3613,4625,1931,2694,1612,693,919
230199,34,22,7,15,22,7,15,,,
230205,34,37,4,33,36,3,33,1,1,0
230214,34,297,39,258,108,8,100,189,31,158
230366,34,266,27,239,266,27,239,,,
230418,34,1426,716,710,831,441,390,595,275,320
230490,34,1550,891,659,262,98,164,1288,793,495
230597,34,1885,901,984,1503,754,749,382,147,235
230603,34,6720,3070,3650,5605,2552,3053,1115,518,597
230676,34,169,101,68,46,24,22,123,77,46
230728,34,16293,7560,8733,12514,5912,6602,3779,1648,2131
230737,34,22978,12308,10670,14183,7522,6661,8795,4786,4009
230746,34,14859,6693,8166,4012,1868,2144,10847,4825,6022
230764,34,19489,10154,9335,15217,7899,7318,4272,2255,2017
230782,34,12959,5600,7359,7980,3495,4485,4979,2105,2874
230807,34,984,354,630,953,337,616,31,17,14
230816,34,486,183,303,454,153,301,32,30,2
230834,34,1227,530,697,1049,472,577,178,58,120
230852,34,2730,1628,1102,1787,1116,671,943,512,431
230861,34,2566,626,1940,413,145,268,2153,481,1672
230889,34,140,42,98,127,38,89,13,4,9
230913,34,1029,408,621,677,310,367,352,98,254
230959,34,2157,998,1159,2143,994,1149,14,4,10
230995,34,2352,1757,595,1821,1277,544,531,480,51
231004,34,32,5,27,32,5,27,,,
231059,34,1099,513,586,1079,500,579,20,13,7
231095,34,91,43,48,83,38,45,8,5,3
231165,34,1020,435,585,584,298,286,436,137,299
231174,34,8149,3231,4918,7856,3079,4777,293,152,141
231280,34,99,1,98,82,0,82,17,1,16
231411,34,307,283,24,307,283,24,,,
231420,34,864,435,429,750,382,368,114,53,61
231536,34,1757,675,1082,530,238,292,1227,437,790
231554,34,512,251,261,467,236,231,45,15,30
231581,34,1028,476,552,1017,469,548,11,7,4
231624,34,4837,1993,2844,4775,1965,2810,62,28,34
231651,34,3809,1443,2366,2012,781,1231,1797,662,1135
231688,34,17,0,17,10,0,10,7,0,7
231697,34,1447,554,893,446,195,251,1001,359,642
231712,34,3451,1569,1882,3375,1523,1852,76,46,30
231721,34,7,0,7,,,,7,0,7
231785,34,1125,166,959,624,126,498,501,40,461
231873,34,378,120,258,178,71,107,200,49,151
231882,34,938,312,626,426,201,225,512,111,401
232016,34,99,21,78,52,13,39,47,8,39
232025,34,682,323,359,658,308,350,24,15,9
232043,34,708,292,416,616,261,355,92,31,61
232052,34,281,95,186,77,30,47,204,65,139
232089,34,644,367,277,626,361,265,18,6,12
232186,34,22353,11222,11131,17171,8466,8705,5182,2756,2426
232195,34,3922,1320,2602,1239,503,736,2683,817,1866
232256,34,629,627,2,620,618,2,9,9,0
232265,34,2240,792,1448,2088,739,1349,152,53,99
232308,34,482,0,482,476,0,476,6,0,6
232414,34,4352,1552,2800,1260,506,754,3092,1046,2046
232423,34,14976,6296,8680,13934,5806,8128,1042,490,552
232450,34,4131,1627,2504,1207,504,703,2924,1123,1801
232557,34,42157,18093,24064,25713,10691,15022,16444,7402,9042
232566,34,2482,758,1724,2294,696,1598,188,62,126
232575,34,2270,689,1581,617,235,382,1653,454,1199
232609,34,1276,491,785,1242,474,768,34,17,17
232618,34,301,24,277,33,0,33,268,24,244
232672,34,1143,217,926,895,181,714,248,36,212
232681,34,2970,1061,1909,2471,877,1594,499,184,315
232706,34,1560,558,1002,1429,501,928,131,57,74
232724,34,19,0,19,19,0,19,,,
232788,34,974,297,677,483,166,317,491,131,360
232797,34,769,106,663,214,35,179,555,71,484
232867,34,1380,638,742,601,310,291,779,328,451
232885,34,260,26,234,231,26,205,29,0,29
232919,34,340,291,49,250,213,37,90,78,12
232937,34,3891,1218,2673,3419,1085,2334,472,133,339
232946,34,24737,11455,13282,8456,4193,4263,16281,7262,9019
232982,34,15530,6732,8798,11079,4838,6241,4451,1894,2557
233019,34,946,338,608,417,171,246,529,167,362
233037,34,445,121,324,149,67,82,296,54,242
233082,34,107,10,97,6,0,6,101,10,91
233116,34,2286,854,1432,503,258,245,1783,596,1187
233277,34,5145,1968,3177,4720,1790,2930,425,178,247
233286,34,121,14,107,76,5,71,45,9,36
233295,34,1145,523,622,1109,501,608,36,22,14
233301,34,337,130,207,333,126,207,4,4,0
233310,34,920,208,712,199,68,131,721,140,581
233329,34,417,28,389,417,28,389,,,
233338,34,419,166,253,371,145,226,48,21,27
233356,34,427,26,401,343,25,318,84,1,83
233374,34,2224,1059,1165,2101,1010,1091,123,49,74
233408,34,317,32,285,268,28,240,49,4,45
233426,34,1372,611,761,1346,593,753,26,18,8
233480,34,33,7,26,33,7,26,,,
233541,34,1613,647,966,1525,616,909,88,31,57
233602,34,43,26,17,40,23,17,3,3,0
233611,34,724,379,345,681,361,320,43,18,25
233639,34,1241,290,951,337,64,273,904,226,678
233648,34,1091,329,762,587,209,378,504,120,384
233666,34,5,0,5,3,0,3,2,0,2
233684,34,2516,838,1678,442,264,178,2074,574,1500
233718,34,274,0,274,270,0,270,4,0,4
233754,34,3376,1236,2140,1055,443,612,2321,793,1528
233772,34,10516,3845,6671,3545,1389,2156,6971,2456,4515
233897,34,773,382,391,739,366,373,34,16,18
233903,34,1242,417,825,503,204,299,739,213,526
233921,34,22941,13244,9697,22150,12706,9444,791,538,253
233949,34,2534,965,1569,875,348,527,1659,617,1042
234030,34,16834,6320,10514,14430,5328,9102,2404,992,1412
234076,34,13152,5797,7355,12483,5511,6972,669,286,383
234085,34,1226,1054,172,1226,1054,172,,,
234119,34,19,8,11,7,3,4,12,5,7
234137,34,72,51,21,59,45,14,13,6,7
234155,34,2966,1218,1748,2752,1127,1625,214,91,123
234164,34,877,423,454,795,388,407,82,35,47
234173,34,849,317,532,764,292,472,85,25,60
234207,34,1366,655,711,1363,653,710,3,2,1
234377,34,851,203,648,336,112,224,515,91,424
234669,34,7654,3301,4353,4055,1828,2227,3599,1473,2126
234696,34,1328,628,700,839,452,387,489,176,313
234711,34,1259,474,785,882,343,539,377,131,246
234827,34,8137,3820,4317,7012,3284,3728,1125,536,589
234845,34,1270,514,756,847,332,515,423,182,241
234915,34,902,399,503,112,58,54,790,341,449
234924,34,230,24,206,230,24,206,,,
234933,34,4491,1644,2847,2382,905,1477,2109,739,1370
234951,34,1093,466,627,832,371,461,261,95,166
234979,34,4279,1587,2692,2455,942,1513,1824,645,1179
235024,34,330,106,224,317,101,216,13,5,8
235088,34,75,72,3,75,72,3,,,
235097,34,6284,2744,3540,5504,2382,3122,780,362,418
235103,34,3290,1396,1894,1578,727,851,1712,669,1043
235149,34,4989,2028,2961,2471,1031,1440,2518,997,1521
235158,34,81,18,63,81,18,63,,,
235167,34,1585,614,971,1403,551,852,182,63,119
235237,34,5200,1689,3511,3106,1027,2079,2094,662,1432
235307,34,26,2,24,26,2,24,,,
235316,34,3651,1690,1961,3588,1659,1929,63,31,32
235334,34,1083,502,581,691,296,395,392,206,186
235343,34,5039,2407,2632,3016,1472,1544,2023,935,1088
235352,34,98,22,76,98,22,76,,,
235422,34,680,157,523,625,139,486,55,18,37
235431,34,3599,1299,2300,1908,691,1217,1691,608,1083
235501,34,37,21,16,37,21,16,,,
235547,34,67,12,55,46,10,36,21,2,19
235583,34,63,2,61,63,2,61,,,
235671,34,550,251,299,407,211,196,143,40,103
235699,34,1342,606,736,849,418,431,493,188,305
235750,34,1600,444,1156,922,260,662,678,184,494
236018,34,39,4,35,39,4,35,,,
236072,34,2379,945,1434,888,410,478,1491,535,956
236133,34,597,207,390,578,199,379,19,8,11
236188,34,3210,1223,1987,1927,748,1179,1283,475,808
236212,34,656,545,111,656,545,111,,,
236230,34,1821,660,1161,1761,631,1130,60,29,31
236258,34,997,381,616,567,195,372,430,186,244
236328,34,1457,587,870,1426,575,851,31,12,19
236382,34,906,402,504,544,244,300,362,158,204
236452,34,999,424,575,900,373,527,99,51,48
236504,34,1413,754,659,791,465,326,622,289,333
236513,34,2626,1001,1625,1625,644,981,1001,357,644
236577,34,2032,667,1365,1938,613,1325,94,54,40
236595,34,3239,1320,1919,3109,1258,1851,130,62,68
236610,34,2349,914,1435,1129,486,643,1220,428,792
236638,34,2267,803,1464,1380,527,853,887,276,611
236656,34,2911,1135,1776,1674,696,978,1237,439,798
236692,34,3762,1421,2341,2598,1053,1545,1164,368,796
236708,34,2730,1047,1683,1867,724,1143,863,323,540
236744,34,20,1,19,20,1,19,,,
236753,34,4010,1301,2709,2332,809,1523,1678,492,1186
236887,34,1604,719,885,1049,452,597,555,267,288
236896,34,1037,522,515,960,480,480,77,42,35
236939,34,19959,9250,10709,17337,8095,9242,2622,1155,1467
236948,34,24115,10770,13345,22349,9930,12419,1766,840,926
236975,34,1883,668,1215,1358,502,856,525,166,359
237011,34,11059,4764,6295,9600,4013,5587,1459,751,708
237039,34,2801,1177,1624,1412,631,781,1389,546,843
237057,34,1062,439,623,1047,432,615,15,7,8
237066,34,1759,707,1052,1718,687,1031,41,20,21
237109,34,2423,646,1777,1632,433,1199,791,213,578
237118,34,444,251,193,406,240,166,38,11,27
237127,34,9,0,9,9,0,9,,,
237136,34,140,75,65,110,48,62,30,27,3
237145,34,18,2,16,18,2,16,,,
237172,34,17,14,3,17,14,3,,,
237181,34,364,191,173,364,191,173,,,
237215,34,988,369,619,680,269,411,308,100,208
237242,34,33,31,2,33,31,2,,,
237303,34,30,10,20,30,10,20,,,
237312,34,1872,1149,723,903,412,491,969,737,232
237321,34,35,3,32,35,3,32,,,
237330,34,950,370,580,890,348,542,60,22,38
237358,34,489,191,298,483,190,293,6,1,5
237367,34,2253,922,1331,1850,791,1059,403,131,272
237385,34,826,502,324,652,360,292,174,142,32
237437,34,135,21,114,122,20,102,13,1,12
237473,34,91,52,39,91,52,39,,,
237491,34,1,0,1,1,0,1,,,
237525,34,5583,2346,3237,4948,2067,2881,635,279,356
237543,34,65,19,46,45,9,36,20,10,10
237561,34,44,12,32,44,12,32,,,
237570,34,56,1,55,56,1,55,,,
237598,34,17,0,17,17,0,17,,,
237686,34,1225,451,774,720,288,432,505,163,342
237701,34,615,310,305,505,241,264,110,69,41
237729,34,69,15,54,49,7,42,20,8,12
237783,34,499,201,298,470,191,279,29,10,19
237792,34,1880,762,1118,1628,658,970,252,104,148
237817,34,809,235,574,541,157,384,268,78,190
237844,34,15,9,6,15,9,6,,,
237899,34,1068,476,592,915,408,507,153,68,85
237905,34,55,12,43,55,12,43,,,
237932,34,1275,457,818,1199,433,766,76,24,52
237950,34,800,462,338,740,431,309,60,31,29
237969,34,676,308,368,666,303,363,10,5,5
237987,34,169,21,148,169,21,148,,,
237996,34,480,75,405,480,75,405,,,
238005,34,44,4,40,44,4,40,,,
238014,34,618,197,421,285,111,174,333,86,247
238032,34,14446,7025,7421,13667,6641,7026,779,384,395
238078,34,448,264,184,355,223,132,93,41,52
238096,34,15,1,14,15,1,14,,,
238175,34,95,2,93,95,2,93,,,
238193,34,745,16,729,581,10,571,164,6,158
238263,34,7168,2759,4409,2097,947,1150,5071,1812,3259
238324,34,313,25,288,205,21,184,108,4,104
238333,34,666,311,355,665,310,355,1,1,0
238397,34,1697,513,1184,376,133,243,1321,380,941
238430,34,498,181,317,360,138,222,138,43,95
238458,34,2121,636,1485,1995,592,1403,126,44,82
238476,34,1853,822,1031,1809,797,1012,44,25,19
238616,34,2131,782,1349,1706,670,1036,425,112,313
238661,34,890,244,646,788,216,572,102,28,74
238722,34,5137,2790,2347,1376,756,620,3761,2034,1727
238759,34,3554,1326,2228,771,339,432,2783,987,1796
238810,34,61,4,57,39,1,38,22,3,19
238980,34,1232,500,732,586,256,330,646,244,402
239008,34,1489,668,821,301,147,154,1188,521,667
239017,34,1066,486,580,1052,477,575,14,9,5
239071,34,416,172,244,338,138,200,78,34,44
239080,34,923,305,618,774,267,507,149,38,111
239105,34,5809,2558,3251,5707,2503,3204,102,55,47
239220,34,1760,759,1001,423,234,189,1337,525,812
239248,34,9039,3657,5382,2169,1001,1168,6870,2656,4214
239309,34,675,181,494,660,177,483,15,4,11
239318,34,1904,1359,545,1849,1317,532,55,42,13
239372,34,1927,648,1279,547,241,306,1380,407,973
239390,34,469,0,469,432,0,432,37,0,37
239442,34,597,176,421,137,45,92,460,131,329
239460,34,2497,919,1578,798,339,459,1699,580,1119
239488,34,5741,2016,3725,1400,642,758,4341,1374,2967
239512,34,396,185,211,391,182,209,5,3,2
239628,34,543,270,273,543,270,273,,,
239716,34,1335,539,796,1315,526,789,20,13,7
239877,34,26,0,26,25,0,25,1,0,1
239910,34,1010,274,736,430,148,282,580,126,454
240107,34,1378,308,1070,1075,247,828,303,61,242
240116,34,3044,1052,1992,1218,546,672,1826,506,1320
240125,34,3714,2019,1695,1157,628,529,2557,1391,1166
240170,34,2637,1104,1533,900,437,463,1737,667,1070
240189,34,7171,3677,3494,6294,3245,3049,877,432,445
240198,34,1699,526,1173,564,228,336,1135,298,837
240268,34,7380,2914,4466,6720,2664,4056,660,250,410
240277,34,5267,1909,3358,3707,1392,2315,1560,517,1043
240329,34,7013,3039,3974,6580,2800,3780,433,239,194
240338,34,702,307,395,664,289,375,38,18,20
240365,34,6633,2822,3811,5414,2200,3214,1219,622,597
240374,34,2777,1219,1558,2119,946,1173,658,273,385
240392,34,1378,204,1174,632,116,516,746,88,658
240417,34,5156,2982,2174,4041,2363,1678,1115,619,496
240426,34,1734,577,1157,1292,463,829,442,114,328
240444,34,25041,12120,12921,23442,11243,12199,1599,877,722
240453,34,14964,6897,8067,12419,5650,6769,2545,1247,1298
240462,34,4859,3120,1739,4218,2679,1539,641,441,200
240471,34,3714,1272,2442,3291,1112,2179,423,160,263
240480,34,5293,2340,2953,4633,2078,2555,660,262,398
240505,34,1708,580,1128,944,364,580,764,216,548
240514,34,728,288,440,320,117,203,408,171,237
240596,34,308,114,194,183,75,108,125,39,86
240620,34,1821,587,1234,841,314,527,980,273,707
240657,34,607,211,396,366,147,219,241,64,177
240666,34,1170,426,744,650,253,397,520,173,347
240693,34,1009,398,611,545,248,297,464,150,314
240709,34,11,1,10,9,1,8,2,0,2
240718,34,422,398,24,422,398,24,,,
240727,34,7223,3382,3841,5923,2876,3047,1300,506,794
240736,34,787,230,557,325,103,222,462,127,335
240745,34,1271,572,699,495,208,287,776,364,412
240754,34,2318,971,1347,1686,682,1004,632,289,343
240790,34,967,344,623,728,266,462,239,78,161
240879,34,2,1,1,2,1,1,,,
241100,34,193,97,96,160,78,82,33,19,14
241128,34,250,103,147,214,87,127,36,16,20
241146,34,110,21,89,108,19,89,2,2,0
241182,34,364,75,289,364,75,289,,,
241191,34,771,297,474,661,247,414,110,50,60
241216,34,1229,781,448,714,440,274,515,341,174
241225,34,639,193,446,439,134,305,200,59,141
241304,34,1740,434,1306,979,229,750,761,205,556
241331,34,548,64,484,374,44,330,174,20,154
241377,34,525,228,297,309,135,174,216,93,123
241386,34,111,19,92,65,10,55,46,9,37
241395,34,306,105,201,247,90,157,59,15,44
241410,34,3550,1303,2247,2990,1069,1921,560,234,326
241517,34,204,54,150,154,38,116,50,16,34
241614,34,294,165,129,162,102,60,132,63,69
241720,34,635,239,396,458,170,288,177,69,108
241739,34,5358,1588,3770,3026,933,2093,2332,655,1677
241766,34,282,197,85,189,133,56,93,64,29
241836,34,752,244,508,294,98,196,458,146,312
241906,34,147,44,103,147,44,103,,,
241951,34,378,114,264,233,74,159,145,40,105
242042,34,173,77,96,165,75,90,8,2,6
242112,34,433,201,232,318,161,157,115,40,75
242121,34,218,75,143,109,32,77,109,43,66
242130,34,205,50,155,139,36,103,66,14,52
242149,34,271,74,197,206,55,151,65,19,46
242413,34,61,0,61,61,0,61,,,
242556,34,161,105,56,133,86,47,28,19,9
242565,34,72,49,23,72,49,23,,,
242583,34,128,91,37,125,90,35,3,1,2
242617,34,2170,952,1218,1805,791,1014,365,161,204
242626,34,2394,953,1441,1828,707,1121,566,246,320
242635,34,2284,845,1439,1860,708,1152,424,137,287
242644,34,852,266,586,673,204,469,179,62,117
242653,34,3132,1336,1796,2324,973,1351,808,363,445
242662,34,2447,881,1566,1817,638,1179,630,243,387
242680,34,1056,392,664,820,293,527,236,99,137
242699,34,1245,353,892,961,277,684,284,76,208
242705,34,3063,1723,1340,2520,1409,1111,543,314,229
242750,34,68,21,47,68,21,47,,,
242820,34,544,424,120,544,424,120,,,
242945,34,3,1,2,2,1,1,1,0,1
242954,34,3,1,2,2,1,1,1,0,1
242972,34,17891,6005,11886,11184,3713,7471,6707,2292,4415
243106,34,1621,727,894,1430,638,792,191,89,102
243115,34,2379,853,1526,2130,756,1374,249,97,152
243133,34,2509,1214,1295,2063,1007,1056,446,207,239
243142,34,1660,586,1074,1179,394,785,481,192,289
243151,34,1960,638,1322,1695,555,1140,265,83,182
243179,34,2118,704,1414,1882,620,1262,236,84,152
243188,34,328,156,172,287,137,150,41,19,22
243197,34,9241,5091,4150,8227,4472,3755,1014,619,395
243203,34,336,66,270,315,62,253,21,4,17
243212,34,1644,676,968,1457,597,860,187,79,108
243221,34,7990,2887,5103,6778,2399,4379,1212,488,724
243346,34,4639,1659,2980,2888,1009,1879,1751,650,1101
243443,34,3066,1076,1990,2501,848,1653,565,228,337
243568,34,87,21,66,69,17,52,18,4,14
243577,34,3180,2349,831,1239,866,373,1941,1483,458
243586,34,599,208,391,504,176,328,95,32,63
243601,34,7461,3053,4408,4827,1884,2943,2634,1169,1465
243638,34,1300,520,780,809,315,494,491,205,286
243647,34,400,173,227,206,92,114,194,81,113
243665,34,1098,293,805,694,187,507,404,106,298
243744,34,5520,2747,2773,5520,2747,2773,,,
243780,34,27380,15806,11574,25653,14837,10816,1727,969,758
243799,34,50,3,47,50,3,47,,,
243823,34,412,121,291,263,72,191,149,49,100
243832,34,1095,322,773,398,125,273,697,197,500
243841,34,402,61,341,322,48,274,80,13,67
244233,34,75,18,57,15,4,11,60,14,46
244279,34,168,4,164,168,4,164,,,
244437,34,9959,3415,6544,2982,1211,1771,6977,2204,4773
244446,34,1682,528,1154,412,146,266,1270,382,888
244613,34,169,164,5,100,98,2,69,66,3
245281,34,65,30,35,65,30,35,,,
245625,34,667,237,430,234,102,132,433,135,298
245652,34,249,127,122,237,121,116,12,6,6
245777,34,32,32,0,32,32,0,,,
245838,34,102,32,70,48,11,37,54,21,33
245847,34,48,13,35,17,6,11,31,7,24
245883,34,98,20,78,11,5,6,87,15,72
245892,34,137,36,101,59,17,42,78,19,59
245953,34,1195,412,783,1018,359,659,177,53,124
245962,34,90,6,84,79,4,75,11,2,9
245980,34,16,7,9,16,7,9,,,
245999,34,315,160,155,100,45,55,215,115,100
246017,34,408,234,174,46,18,28,362,216,146
246035,34,301,47,254,301,47,254,,,
246071,34,60,9,51,60,9,51,,,
246354,34,5842,2131,3711,712,246,466,5130,1885,3245
246406,34,15,2,13,15,2,13,,,
246415,34,31,7,24,10,0,10,21,7,14
246460,34,74,6,68,74,6,68,,,
246813,34,2674,880,1794,575,226,349,2099,654,1445
246895,34,528,166,362,275,92,183,253,74,179
246974,34,251,30,221,251,30,221,,,
247010,34,11,0,11,11,0,11,,,
247047,34,48,0,48,48,0,48,,,
247065,34,697,37,660,387,22,365,310,15,295
247153,34,199,48,151,199,48,151,,,
247162,34,8,2,6,,,,8,2,6
247409,34,35,1,34,35,1,34,,,
247603,34,1297,656,641,674,356,318,623,300,323
247649,34,305,208,97,272,184,88,33,24,9
247773,34,35,35,0,35,35,0,,,
247825,34,5,4,1,1,1,0,4,3,1
247834,34,18901,8276,10625,6870,3371,3499,12031,4905,7126
247940,34,1707,655,1052,708,320,388,999,335,664
248192,34,18,0,18,18,0,18,,,
248527,34,69,0,69,69,0,69,,,
248606,34,121,93,28,21,13,8,100,80,20
248624,34,82,15,67,82,15,67,,,
248633,34,48,0,48,48,0,48,,,
248660,34,141,43,98,122,42,80,19,1,18
248703,34,74,0,74,51,0,51,23,0,23
248925,34,563,314,249,455,243,212,108,71,37
248934,34,11014,4253,6761,11014,4253,6761,,,
249061,34,36,0,36,18,0,18,18,0,18
249238,34,332,22,310,223,13,210,109,9,100
249609,34,124,70,54,124,70,54,,,
250027,34,169,59,110,165,59,106,4,0,4
250285,34,275,250,25,191,175,16,84,75,9
250744,34,338,33,305,338,33,305,,,
250902,34,10,0,10,6,0,6,4,0,4
250993,34,428,220,208,35,12,23,393,208,185
251260,34,2440,1003,1437,1183,574,609,1257,429,828
251312,34,457,65,392,279,46,233,178,19,159
260336,34,12,0,12,12,0,12,,,
260363,34,7,0,7,7,0,7,,,
260372,34,219,36,183,97,16,81,122,20,102
260664,34,63,40,23,63,40,23,,,
260691,34,771,230,541,771,230,541,,,
260789,34,629,109,520,629,109,520,,,
260813,34,216,23,193,216,23,193,,,
260929,34,175,18,157,173,18,155,2,0,2
260965,34,56,0,56,56,0,56,,,
260992,34,387,18,369,100,7,93,287,11,276
261436,34,754,50,704,754,50,704,,,
261676,34,13,0,13,13,0,13,,,
261685,34,10,2,8,10,2,8,,,
261719,34,152,1,151,152,1,151,,,
261773,34,30,4,26,29,3,26,1,1,0
261861,34,38,2,36,38,2,36,,,
262031,34,4113,1521,2592,2108,869,1239,2005,652,1353
262086,34,4934,1628,3306,1745,668,1077,3189,960,2229
262129,34,472,159,313,455,152,303,17,7,10
262341,34,91,78,13,91,78,13,,,
262369,34,17,1,16,17,1,16,,,
262457,34,362,56,306,362,56,306,,,
262466,34,53,19,34,53,19,34,,,
362700,34,401,37,364,394,36,358,7,1,6
362782,34,179,5,174,55,3,52,124,2,122
363013,34,19,2,17,19,2,17,,,
363077,34,24,0,24,18,0,18,6,0,6
363147,34,382,13,369,382,13,369,,,
363165,34,124,64,60,67,38,29,57,26,31
363439,34,16,1,15,16,1,15,,,
363633,34,328,94,234,146,48,98,182,46,136
363679,34,155,2,153,128,2,126,27,0,27
363712,34,47,47,0,47,47,0,,,
363882,34,60,1,59,60,1,59,,,
363907,34,330,210,120,196,128,68,134,82,52
363916,34,107,28,79,65,16,49,42,12,30
363934,34,646,520,126,341,274,67,305,246,59
364016,34,3617,1546,2071,1047,543,504,2570,1003,1567
364025,34,5938,2883,3055,2120,1103,1017,3818,1780,2038
364548,34,57,23,34,48,17,31,9,6,3
364575,34,18,0,18,18,0,18,,,
364627,34,36,20,16,15,4,11,21,16,5
364636,34,99,20,79,88,19,69,11,1,10
364751,34,23,1,22,23,1,22,,,
364760,34,22,4,18,11,1,10,11,3,8
364946,34,83,19,64,77,17,60,6,2,4
364964,34,19,0,19,19,0,19,,,
365091,34,362,21,341,362,21,341,,,
365125,34,129,3,126,129,3,126,,,
365198,34,85,16,69,48,1,47,37,15,22
365213,34,199,87,112,86,17,69,113,70,43
365240,34,19,16,3,19,16,3,,,
365374,34,459,264,195,135,57,78,324,207,117
365383,34,98,9,89,98,9,89,,,
365480,34,179,85,94,80,18,62,99,67,32
365505,34,4,0,4,4,0,4,,,
365693,34,129,5,124,129,5,124,,,
365763,34,11,2,9,11,2,9,,,
365824,34,57,4,53,57,4,53,,,
365833,34,60,5,55,60,5,55,,,
366003,34,219,78,141,108,26,82,111,52,59
366155,34,28,16,12,28,16,12,,,
366191,34,772,746,26,772,746,26,,,
366252,34,3235,1970,1265,2538,1747,791,697,223,474
366261,34,217,74,143,199,68,131,18,6,12
366270,34,269,8,261,269,8,261,,,
366289,34,1,1,0,1,1,0,,,
366340,34,208,67,141,159,54,105,49,13,36
366395,34,11240,4780,6460,6284,2838,3446,4956,1942,3014
366401,34,5178,2401,2777,1474,740,734,3704,1661,2043
366438,34,28,3,25,16,2,14,12,1,11
366465,34,1516,431,1085,592,175,417,924,256,668
366535,34,178,36,142,178,36,142,,,
366553,34,1016,257,759,405,82,323,611,175,436
366571,34,21,5,16,21,5,16,,,
366623,34,28,10,18,19,3,16,9,7,2
366632,34,3,0,3,3,0,3,,,
366711,34,12524,4765,7759,9876,3660,6216,2648,1105,1543
367051,34,39,1,38,26,1,25,13,0,13
367088,34,104,7,97,66,5,61,38,2,36
367103,34,72,47,25,72,47,25,,,
367112,34,178,30,148,165,26,139,13,4,9
367158,34,30,2,28,30,2,28,,,
367334,34,32,31,1,27,26,1,5,5,0
367361,34,61,39,22,59,38,21,2,1,1
367431,34,11,3,8,11,3,8,,,
367459,34,3576,1431,2145,1004,432,572,2572,999,1573
367875,34,31,16,15,31,16,15,,,
367884,34,407,174,233,194,86,108,213,88,125
367972,34,105,2,103,105,2,103,,,
367981,34,68,2,66,37,2,35,31,0,31
368230,34,43,2,41,31,2,29,12,0,12
368364,34,137,75,62,36,16,20,101,59,42
368407,34,24,1,23,,,,24,1,23
368443,34,151,13,138,151,13,138,,,
368452,34,188,75,113,188,75,113,,,
368540,34,9,2,7,9,2,7,,,
368629,34,500,107,393,500,107,393,,,
368647,34,11,1,10,11,1,10,,,
368771,34,243,55,188,243,55,188,,,
368832,34,53,8,45,8,1,7,45,7,38
368911,34,838,181,657,197,50,147,641,131,510
369109,34,35,4,31,28,3,25,7,1,6
369400,34,670,644,26,670,644,26,,,
369419,34,178,105,73,178,105,73,,,
369446,34,29,0,29,26,0,26,3,0,3
369455,34,192,50,142,192,50,142,,,
369516,34,167,42,125,167,42,125,,,
369668,34,64,14,50,43,14,29,21,0,21
369686,34,20,2,18,20,2,18,,,
369695,34,44,4,40,44,4,40,,,
369783,34,246,15,231,246,15,231,,,
369950,34,147,125,22,147,125,22,,,
371052,34,246,52,194,246,52,194,,,
371690,34,780,132,648,117,16,101,663,116,547
371830,34,58,38,20,56,37,19,2,1,1
371928,34,69,23,46,69,23,46,,,
371964,34,468,321,147,468,321,147,,,
372028,34,76,15,61,76,15,61,,,
372073,34,105,23,82,105,23,82,,,
372082,34,27,13,14,27,13,14,,,
372240,34,17,2,15,16,2,14,1,0,1
372329,34,219,29,190,219,29,190,,,
372356,34,41,3,38,41,3,38,,,
372462,34,113,19,94,112,19,93,1,0,1
372718,34,302,50,252,286,48,238,16,2,14
372921,34,458,156,302,458,156,302,,,
373085,34,29,1,28,19,0,19,10,1,9
373216,34,104,7,97,104,7,97,,,
373456,34,11,0,11,10,0,10,1,0,1
373526,34,98,75,23,98,75,23,,,
373678,34,143,66,77,96,51,45,47,15,32
373696,34,20,13,7,20,13,7,,,
373711,34,47,2,45,47,2,45,,,
373784,34,389,191,198,389,191,198,,,
374316,34,53,42,11,37,28,9,16,14,2
374343,34,37,2,35,37,2,35,,,
374574,34,582,97,485,348,74,274,234,23,211
374592,34,5,0,5,5,0,5,,,
375106,34,37,30,7,28,23,5,9,7,2
375230,34,163,163,0,163,163,0,,,
375373,34,121,31,90,7,0,7,114,31,83
375407,34,54,10,44,44,9,35,10,1,9
375416,34,165,48,117,165,48,117,,,
375540,34,10,1,9,6,0,6,4,1,3
375568,34,12,9,3,4,4,0,8,5,3
375656,34,7,1,6,5,1,4,2,0,2
375683,34,67,46,21,56,36,20,11,10,1
375726,34,350,156,194,290,119,171,60,37,23
375939,34,99,14,85,99,14,85,,,
375966,34,128,13,115,71,6,65,57,7,50
375984,34,97,5,92,76,5,71,21,0,21
376224,34,131,17,114,97,11,86,34,6,28
376242,34,41,19,22,41,19,22,,,
376288,34,68,11,57,68,11,57,,,
376330,34,178,31,147,178,31,147,,,
376385,34,49,7,42,49,7,42,,,
376446,34,64,0,64,10,0,10,54,0,54
376631,34,10,3,7,9,2,7,1,1,0
376677,34,115,52,63,114,51,63,1,1,0
376695,34,826,365,461,352,143,209,474,222,252
377111,34,157,50,107,157,50,107,,,
377193,34,21,1,20,5,0,5,16,1,15
377218,34,99,98,1,99,98,1,,,
377272,34,4,1,3,4,1,3,,,
377281,34,7,1,6,7,1,6,,,
377315,34,55,0,55,55,0,55,,,
377449,34,158,55,103,114,48,66,44,7,37
377458,34,187,78,109,131,62,69,56,16,40
377485,34,19,1,18,9,1,8,10,0,10
377546,34,69,25,44,59,24,35,10,1,9
377555,34,4532,2372,2160,3811,1977,1834,721,395,326
377564,34,3685,1795,1890,3236,1561,1675,449,234,215
377643,34,90,8,82,90,8,82,,,
377652,34,81,4,77,81,4,77,,,
377661,34,585,63,522,585,63,522,,,
377722,34,360,28,332,360,28,332,,,
377759,34,11,11,0,11,11,0,,,
378105,34,266,16,250,176,9,167,90,7,83
378576,34,115,33,82,25,14,11,90,19,71
378886,34,161,28,133,54,11,43,107,17,90
378956,34,617,578,39,617,578,39,,,
379621,34,70,6,64,49,5,44,21,1,20
379746,34,161,7,154,161,7,154,,,
379782,34,257,26,231,257,26,231,,,
380067,34,68,1,67,68,1,67,,,
380359,34,438,78,360,176,33,143,262,45,217
380368,34,329,106,223,146,55,91,183,51,132
380377,34,534,124,410,350,91,259,184,33,151
380438,34,669,100,569,669,100,569,,,
381255,34,66,52,14,66,52,14,,,
381282,34,67,22,45,67,22,45,,,
381325,34,96,17,79,96,17,79,,,
381370,34,53,1,52,17,0,17,36,1,35
381404,34,224,6,218,116,2,114,108,4,104
381486,34,10,1,9,10,1,9,,,
381699,34,12,0,12,9,0,9,3,0,3
381732,34,52,15,37,15,8,7,37,7,30
382258,34,62,14,48,51,9,42,11,5,6
382416,34,67,9,58,67,9,58,,,
382461,34,40,0,40,30,0,30,10,0,10
382780,34,42,0,42,41,0,41,1,0,1
382911,34,39,19,20,27,14,13,12,5,7
382957,34,378,90,288,372,89,283,6,1,5
383020,34,8,2,6,4,1,3,4,1,3
383084,34,75,33,42,58,25,33,17,8,9
383163,34,145,2,143,9,0,9,136,2,134
383190,34,1249,479,770,504,247,257,745,232,513
383279,34,156,25,131,77,17,60,79,8,71
383297,34,203,7,196,64,1,63,139,6,133
383312,34,4,0,4,4,0,4,,,
383330,34,84,12,72,84,12,72,,,
383367,34,153,45,108,123,44,79,30,1,29
383464,34,18,0,18,18,0,18,,,
383525,34,20,0,20,20,0,20,,,
383765,34,60,1,59,42,1,41,18,0,18
383996,34,293,113,180,84,26,58,209,87,122
384236,34,714,267,447,714,267,447,,,
384245,34,589,243,346,589,243,346,,,
384254,34,330,215,115,320,209,111,10,6,4
384333,34,5159,1867,3292,1512,605,907,3647,1262,2385
384342,34,2303,915,1388,950,403,547,1353,512,841
384412,34,99,46,53,99,46,53,,,
384421,34,63,63,0,63,63,0,,,
385132,34,105,8,97,64,6,58,41,2,39
385503,34,217,15,202,217,15,202,,,
385619,34,1954,1119,835,1954,1119,835,,,
386153,34,169,0,169,169,0,169,,,
386472,34,635,98,537,447,71,376,188,27,161
387925,34,75,6,69,75,6,69,,,
388520,34,234,127,107,118,69,49,116,58,58
388663,34,51,0,51,51,0,51,,,
389860,34,127,55,72,90,28,62,37,27,10
390905,34,105,62,43,41,29,12,64,33,31
391005,34,102,5,97,102,5,97,,,
391759,34,21,0,21,,,,21,0,21
392257,34,2207,192,2015,2207,192,2015,,,
392354,34,9,4,5,9,4,5,,,
392415,34,270,61,209,270,61,209,,,
393524,34,45,1,44,45,1,44,,,
393649,34,1024,444,580,1024,444,580,,,
393861,34,270,44,226,256,42,214,14,2,12
395362,34,931,280,651,245,77,168,686,203,483
395690,34,135,62,73,135,62,73,,,
397942,34,879,287,592,879,287,592,,,
399212,34,9278,6388,2890,1341,667,674,7937,5721,2216
399869,34,367,348,19,367,348,19,,,
399911,34,302,101,201,302,101,201,,,
400080,34,293,170,123,293,170,123,,,
400187,34,447,36,411,228,22,206,219,14,205
400558,34,47,21,26,47,21,26,,,
401223,34,170,36,134,114,24,90,56,12,44
401764,34,201,3,198,88,0,88,113,3,110
402563,34,165,6,159,165,6,159,,,
402800,34,123,0,123,111,0,111,12,0,12
403469,34,160,53,107,101,44,57,59,9,50
403478,34,212,72,140,147,60,87,65,12,53
403487,34,304,119,185,235,101,134,69,18,51
404055,34,270,34,236,270,34,236,,,
404338,34,15,9,6,15,9,6,,,
404426,34,1928,816,1112,581,306,275,1347,510,837
404684,34,234,67,167,234,67,167,,,
404718,34,156,6,150,156,6,150,,,
404912,34,673,111,562,673,111,562,,,
404994,34,2126,619,1507,1775,546,1229,351,73,278
405012,34,29,0,29,29,0,29,,,
405058,34,114,114,0,114,114,0,,,
405076,34,52,8,44,52,8,44,,,
405854,34,197,197,0,197,197,0,,,
405872,34,1524,575,949,514,246,268,1010,329,681
406024,34,1843,237,1606,1014,141,873,829,96,733
406033,34,2558,309,2249,1383,172,1211,1175,137,1038
406149,34,63,17,46,63,17,46,,,
406325,34,70,6,64,21,1,20,49,5,44
406361,34,10,0,10,10,0,10,,,
406422,34,50,3,47,8,0,8,42,3,39
406486,34,32,12,20,16,6,10,16,6,10
406547,34,143,17,126,40,6,34,103,11,92
407090,34,492,11,481,171,6,165,321,5,316
407142,34,78,1,77,78,1,77,,,
407151,34,40,0,40,40,0,40,,,
407179,34,40,0,40,26,0,26,14,0,14
407355,34,146,13,133,146,13,133,,,
407391,34,40,4,36,27,0,27,13,4,9
407407,34,9,2,7,7,2,5,2,0,2
407425,34,15,0,15,11,0,11,4,0,4
407434,34,4,0,4,4,0,4,,,
407461,34,52,33,19,52,33,19,,,
407470,34,75,2,73,56,2,54,19,0,19
407489,34,33,20,13,11,6,5,22,14,8
407513,34,122,31,91,73,11,62,49,20,29
407522,34,1,0,1,,,,1,0,1
407568,34,149,5,144,119,2,117,30,3,27
407577,34,16,10,6,13,8,5,3,2,1
407595,34,14,0,14,14,0,14,,,
407610,34,37,17,20,5,3,2,32,14,18
407629,34,12,2,10,12,2,10,,,
407683,34,11,0,11,9,0,9,2,0,2
407708,34,126,4,122,126,4,122,,,
407735,34,26,1,25,26,1,25,,,
407832,34,94,61,33,37,24,13,57,37,20
408066,34,134,45,89,101,36,65,33,9,24
408163,34,39,1,38,39,1,38,,,
408385,34,181,48,133,181,48,133,,,
408729,34,31,6,25,30,6,24,1,0,1
408844,34,2377,681,1696,1446,433,1013,931,248,683
408862,34,196,7,189,57,3,54,139,4,135
409032,34,4,0,4,4,0,4,,,
409120,34,57,12,45,57,12,45,,,
409193,34,145,144,1,145,144,1,,,
409315,34,15877,6374,9503,4750,1927,2823,11127,4447,6680
409537,34,11,3,8,,,,11,3,8
409591,34,48,10,38,27,5,22,21,5,16
409698,34,5809,2221,3588,5015,1829,3186,794,392,402
410797,34,155,87,68,155,87,68,,,
410964,34,30,0,30,27,0,27,3,0,3
411684,34,65,17,48,65,17,48,,,
411754,34,40,8,32,40,8,32,,,
412173,34,448,39,409,408,36,372,40,3,37
412535,34,29,3,26,28,3,25,1,0,1
412544,34,150,15,135,107,15,92,43,0,43
412599,34,249,73,176,249,73,176,,,
413176,34,24,12,12,24,12,12,,,
413413,34,12319,2368,9951,2312,427,1885,10007,1941,8066
413617,34,140,30,110,52,13,39,88,17,71
413626,34,124,51,73,61,32,29,63,19,44
413680,34,256,232,24,256,232,24,,,
413778,34,189,11,178,97,4,93,92,7,85
413820,34,1,0,1,1,0,1,,,
413893,34,992,556,436,992,556,436,,,
413945,34,39,5,34,39,5,34,,,
413972,34,18,2,16,18,2,16,,,
414063,34,73,2,71,58,2,56,15,0,15
414124,34,217,170,47,167,133,34,50,37,13
414461,34,1298,1227,71,1034,975,59,264,252,12
414489,34,34,2,32,34,2,32,,,
414540,34,204,8,196,180,7,173,24,1,23
414595,34,139,31,108,18,8,10,121,23,98
414869,34,267,20,247,96,16,80,171,4,167
414878,34,277,103,174,155,53,102,122,50,72
414911,34,607,225,382,388,164,224,219,61,158
414939,34,221,19,202,221,19,202,,,
415039,34,19,1,18,12,1,11,7,0,7
415057,34,14,14,0,14,14,0,,,
415987,34,20,2,18,20,2,18,,,
416458,34,146,38,108,146,38,108,,,
416801,34,331,67,264,293,62,231,38,5,33
417008,34,112,5,107,112,5,107,,,
417062,34,38,0,38,27,0,27,11,0,11
417105,34,310,195,115,172,107,65,138,88,50
417123,34,28,5,23,14,4,10,14,1,13
417248,34,33,33,0,33,33,0,,,
417275,34,20,20,0,20,20,0,,,
417327,34,200,23,177,46,4,42,154,19,135
417442,34,41,4,37,41,4,37,,,
417503,34,257,3,254,169,3,166,88,0,88
417600,34,1,0,1,1,0,1,,,
417628,34,14,1,13,13,1,12,1,0,1
417637,34,39,5,34,39,5,34,,,
417646,34,13,1,12,13,1,12,,,
417655,34,6,0,6,6,0,6,,,
417682,34,22,1,21,22,1,21,,,
417716,34,171,10,161,171,10,161,,,
417725,34,32,0,32,32,0,32,,,
417734,34,138,21,117,52,12,40,86,9,77
417752,34,27,13,14,25,11,14,2,2,0
417831,34,108,76,32,108,76,32,,,
417840,34,383,16,367,383,16,367,,,
417868,34,4,2,2,,,,4,2,2
417886,34,20,0,20,20,0,20,,,
417910,34,172,25,147,172,25,147,,,
417983,34,8,0,8,,,,8,0,8
417992,34,40,4,36,40,4,36,,,
418001,34,84,7,77,84,7,77,,,
418010,34,51,2,49,16,1,15,35,1,34
418029,34,30,2,28,30,2,28,,,
418038,34,69,4,65,69,4,65,,,
418056,34,18,7,11,18,7,11,,,
418065,34,203,21,182,146,17,129,57,4,53
418083,34,39,6,33,39,6,33,,,
418126,34,208,60,148,118,31,87,90,29,61
418171,34,73,73,0,73,73,0,,,
418199,34,19,16,3,19,16,3,,,
418205,34,193,94,99,122,84,38,71,10,61
418223,34,47,0,47,47,0,47,,,
418250,34,79,47,32,12,7,5,67,40,27
418269,34,214,124,90,214,124,90,,,
418278,34,23,15,8,10,5,5,13,10,3
418296,34,712,274,438,97,41,56,615,233,382
418302,34,96,29,67,70,7,63,26,22,4
418320,34,854,471,383,27,4,23,827,467,360
418348,34,32,26,6,19,15,4,13,11,2
418357,34,33,9,24,32,8,24,1,1,0
418409,34,85,28,57,80,25,55,5,3,2
418427,34,67,7,60,51,5,46,16,2,14
418445,34,8,0,8,8,0,8,,,
418454,34,62,13,49,62,13,49,,,
418481,34,19,1,18,19,1,18,,,
418515,34,16,0,16,10,0,10,6,0,6
418524,34,17,0,17,17,0,17,,,
418533,34,301,35,266,224,20,204,77,15,62
418542,34,56,5,51,23,1,22,33,4,29
418560,34,81,9,72,15,1,14,66,8,58
418588,34,11,2,9,11,2,9,,,
418612,34,7,1,6,7,1,6,,,
418658,34,263,235,28,263,235,28,,,
418773,34,202,81,121,153,65,88,49,16,33
418782,34,83,80,3,83,80,3,,,
418889,34,46,41,5,29,24,5,17,17,0
418913,34,4,1,3,4,1,3,,,
418968,34,156,5,151,156,5,151,,,
419031,34,21,7,14,21,7,14,,,
419095,34,16,2,14,16,2,14,,,
419183,34,31,1,30,31,1,30,,,
419217,34,74,15,59,74,15,59,,,
419226,34,300,152,148,224,118,106,76,34,42
419235,34,102,30,72,102,30,72,,,
419244,34,150,121,29,84,68,16,66,53,13
419253,34,103,69,34,103,69,34,,,
419280,34,23,2,21,15,1,14,8,1,7
419332,34,1,1,0,1,1,0,,,
419341,34,3,0,3,3,0,3,,,
419420,34,11,1,10,11,1,10,,,
419484,34,16,1,15,16,1,15,,,
419633,34,59,7,52,59,7,52,,,
419703,34,201,191,10,201,191,10,,,
419712,34,49,46,3,49,46,3,,,
419721,34,104,98,6,104,98,6,,,
420024,34,177,19,158,137,12,125,40,7,33
420042,34,55,33,22,55,33,22,,,
420130,34,290,13,277,290,13,277,,,
420255,34,21,20,1,21,20,1,,,
420325,34,57,57,0,57,57,0,,,
420343,34,731,702,29,565,544,21,166,158,8
420370,34,384,124,260,384,124,260,,,
420398,34,10006,4028,5978,1809,775,1034,8197,3253,4944
420431,34,1174,346,828,265,67,198,909,279,630
420440,34,615,179,436,152,46,106,463,133,330
420468,34,145,35,110,125,33,92,20,2,18
420538,34,657,190,467,369,115,254,288,75,213
420556,34,309,84,225,129,41,88,180,43,137
420723,34,168,67,101,57,21,36,111,46,65
420981,34,58,18,40,58,18,40,,,
421513,34,45,6,39,40,5,35,5,1,4
421610,34,80,6,74,80,6,74,,,
421665,34,40,1,39,8,0,8,32,1,31
421708,34,1062,131,931,693,80,613,369,51,318
421717,34,23,15,8,15,9,6,8,6,2
421771,34,16,0,16,12,0,12,4,0,4
421832,34,176,79,97,157,77,80,19,2,17
421841,34,144,58,86,144,58,86,,,
421878,34,345,35,310,239,23,216,106,12,94
421896,34,62,16,46,62,16,46,,,
422020,34,186,180,6,186,180,6,,,
422695,34,354,48,306,354,48,306,,,
422835,34,3,2,1,3,2,1,,,
423120,34,57,4,53,57,4,53,,,
423397,34,313,188,125,313,188,125,,,
423412,34,25,23,2,25,23,2,,,
423652,34,214,46,168,114,23,91,100,23,77
425250,34,88,13,75,47,8,39,41,5,36
425986,34,168,21,147,168,21,147,,,
426314,34,8625,7367,1258,2119,1765,354,6506,5602,904
427308,34,87,2,85,87,2,85,,,
427335,34,11,0,11,10,0,10,1,0,1
427894,34,69,67,2,69,67,2,,,
427973,34,192,171,21,121,107,14,71,64,7
427982,34,145,80,65,108,65,43,37,15,22
427991,34,50,29,21,38,18,20,12,11,1
428000,34,97,36,61,97,36,61,,,
428019,34,19,9,10,15,8,7,4,1,3
428055,34,129,26,103,129,26,103,,,
428125,34,42,31,11,40,29,11,2,2,0
428143,34,6,1,5,6,1,5,,,
428170,34,459,49,410,273,28,245,186,21,165
428259,34,77,14,63,26,6,20,51,8,43
428392,34,631,272,359,289,123,166,342,149,193
429012,34,100,84,16,100,84,16,,,
429128,34,268,11,257,27,1,26,241,10,231
430184,34,1388,350,1038,152,79,73,1236,271,965
430227,34,50,0,50,40,0,40,10,0,10
430245,34,99,17,82,99,17,82,,,
430306,34,13,1,12,10,1,9,3,0,3
430403,34,287,24,263,287,24,263,,,
430564,34,5,1,4,4,0,4,1,1,0
430582,34,165,72,93,165,72,93,,,
430670,34,46,10,36,46,10,36,,,
430704,34,27,5,22,25,5,20,2,0,2
430795,34,15,1,14,15,1,14,,,
430883,34,26,2,24,26,2,24,,,
430908,34,22,3,19,14,2,12,8,1,7
430935,34,497,383,114,302,239,63,195,144,51
430971,34,36,4,32,36,4,32,,,
431017,34,46,15,31,43,12,31,3,3,0
431071,34,6,1,5,4,0,4,2,1,1
431105,34,16,3,13,11,0,11,5,3,2
431123,34,89,86,3,89,86,3,,,
431141,34,1159,419,740,1117,415,702,42,4,38
431169,34,53,8,45,47,6,41,6,2,4
431187,34,20,20,0,20,20,0,,,
431196,34,95,9,86,95,9,86,,,
431266,34,45,1,44,42,1,41,3,0,3
431275,34,51,3,48,14,1,13,37,2,35
431284,34,63,2,61,56,0,56,7,2,5
431558,34,50,10,40,42,10,32,8,0,8
431600,34,136,18,118,111,16,95,25,2,23
431929,34,3,2,1,3,2,1,,,
431983,34,88,88,0,88,88,0,,,
432117,34,172,1,171,107,1,106,65,0,65
432269,34,31,25,6,31,25,6,,,
432384,34,466,103,363,466,103,363,,,
432524,34,43,12,31,43,12,31,,,
433004,34,369,87,282,369,87,282,,,
433013,34,678,239,439,678,239,439,,,
433040,34,7,1,6,7,1,6,,,
433068,34,313,188,125,254,140,114,59,48,11
433101,34,556,44,512,314,31,283,242,13,229
433138,34,79,15,64,75,12,63,4,3,1
433174,34,466,53,413,71,10,61,395,43,352
433387,34,106950,40989,65961,106950,40989,65961,,,
433420,34,257,218,39,257,218,39,,,
433536,34,350,40,310,176,20,156,174,20,154
433660,34,10759,4678,6081,8059,3448,4611,2700,1230,1470
434016,34,83,24,59,26,8,18,57,16,41
434061,34,3683,1277,2406,1855,761,1094,1828,516,1312
434140,34,623,122,501,623,122,501,,,
434159,34,364,269,95,364,269,95,,,
434274,34,8,0,8,4,0,4,4,0,4
434283,34,15,1,14,14,0,14,1,1,0
434308,34,174,7,167,174,7,167,,,
434344,34,193,8,185,191,8,183,2,0,2
434362,34,13,12,1,13,12,1,,,
434432,34,8,2,6,8,2,6,,,
434496,34,18,0,18,18,0,18,,,
434539,34,55,18,37,7,2,5,48,16,32
434584,34,146,24,122,29,4,25,117,20,97
434672,34,11169,3740,7429,2510,1089,1421,8659,2651,6008
434751,34,78,22,56,47,17,30,31,5,26
434821,34,624,26,598,624,26,598,,,
434830,34,113,1,112,67,1,66,46,0,46
434900,34,275,55,220,144,22,122,131,33,98
434937,34,22,22,0,22,22,0,,,
435000,34,27,3,24,27,3,24,,,
436030,34,134,58,76,79,35,44,55,23,32
436100,34,2,0,2,2,0,2,,,
436304,34,1229,653,576,610,359,251,619,294,325
436429,34,4718,3135,1583,4718,3135,1583,,,
436553,34,352,53,299,352,53,299,,,
436599,34,81,17,64,18,5,13,63,12,51
436614,34,36,23,13,19,10,9,17,13,4
436632,34,41,7,34,19,5,14,22,2,20
436641,34,67,23,44,67,23,44,,,
436650,34,142,14,128,142,14,128,,,
436775,34,88,4,84,88,4,84,,,
436818,34,511,208,303,451,179,272,60,29,31
436827,34,297,142,155,260,117,143,37,25,12
436836,34,1579,775,804,1428,688,740,151,87,64
437097,34,385,214,171,359,200,159,26,14,12
437103,34,5366,1572,3794,2319,787,1532,3047,785,2262
437237,34,47,40,7,47,40,7,,,
437316,34,343,52,291,339,51,288,4,1,3
437325,34,130,25,105,11,5,6,119,20,99
437556,34,919,403,516,891,403,488,28,0,28
437608,34,102,72,30,101,71,30,1,1,0
437635,34,495,57,438,495,57,438,,,
437723,34,28,7,21,28,7,21,,,
437732,34,86,8,78,61,5,56,25,3,22
437750,34,50,50,0,50,50,0,,,
437769,34,94,7,87,94,7,87,,,
437778,34,12,1,11,12,1,11,,,
437857,34,90,0,90,68,0,68,22,0,22
437936,34,558,61,497,558,61,497,,,
438179,34,203,30,173,203,30,173,,,
438221,34,143,13,130,138,13,125,5,0,5
438258,34,360,87,273,360,87,273,,,
438285,34,117,11,106,117,11,106,,,
438337,34,2,0,2,1,0,1,1,0,1
438498,34,1112,182,930,235,47,188,877,135,742
438504,34,831,798,33,831,798,33,,,
438586,34,971,306,665,777,243,534,194,63,131
438674,34,59,0,59,36,0,36,23,0,23
438708,34,145,25,120,69,12,57,76,13,63
438735,34,176,159,17,131,119,12,45,40,5
438984,34,22,7,15,22,7,15,,,
439020,34,7,3,4,5,1,4,2,2,0
439118,34,352,48,304,352,48,304,,,
439190,34,1056,533,523,561,284,277,495,249,246
439367,34,1101,301,800,1101,301,800,,,
439455,34,202,9,193,110,1,109,92,8,84
439473,34,136,59,77,63,30,33,73,29,44
439491,34,212,39,173,212,39,173,,,
439507,34,7,7,0,7,7,0,,,
439570,34,407,21,386,407,21,386,,,
439622,34,234,43,191,234,43,191,,,
439668,34,34,24,10,34,24,10,,,
439686,34,2,0,2,2,0,2,,,
439701,34,283,107,176,139,50,89,144,57,87
439738,34,346,66,280,346,66,280,,,
439747,34,84,18,66,73,16,57,11,2,9
439774,34,9,2,7,2,1,1,7,1,6
439783,34,84,30,54,70,25,45,14,5,9
439792,34,405,34,371,405,34,371,,,
439844,34,24,1,23,24,1,23,,,
439862,34,74,20,54,58,14,44,16,6,10
439871,34,131,4,127,115,4,111,16,0,16
439899,34,45,27,18,23,10,13,22,17,5
439932,34,14,1,13,14,1,13,,,
439969,34,17,8,9,17,8,9,,,
440059,34,595,551,44,433,399,34,162,152,10
440101,34,58,6,52,25,2,23,33,4,29
440226,34,30,0,30,30,0,30,,,
440262,34,217,212,5,188,183,5,29,29,0
440271,34,92,42,50,92,42,50,,,
440396,34,110,45,65,102,42,60,8,3,5
440402,34,827,226,601,448,122,326,379,104,275
440651,34,432,109,323,223,49,174,209,60,149
440730,34,204,67,137,204,67,137,,,
440749,34,37,29,8,2,2,0,35,27,8
440776,34,32,5,27,32,5,27,,,
440794,34,262,59,203,248,56,192,14,3,11
440819,34,18,9,9,18,9,9,,,
440828,34,881,456,425,443,236,207,438,220,218
440855,34,4,0,4,4,0,4,,,
440989,34,430,320,110,430,320,110,,,
441025,34,191,33,158,186,33,153,5,0,5
441052,34,1317,312,1005,1317,312,1005,,,
441070,34,86,32,54,14,6,8,72,26,46
441168,34,20,0,20,20,0,20,,,
441210,34,250,117,133,,,,250,117,133
441229,34,1255,228,1027,1255,228,1027,,,
441256,34,17,0,17,17,0,17,,,
441371,34,4657,144,4513,4641,143,4498,16,1,15
441380,34,180,57,123,159,52,107,21,5,16
441414,34,70,27,43,19,9,10,51,18,33
441423,34,141,24,117,141,24,117,,,
441487,34,43,2,41,42,2,40,1,0,1
441496,34,139,123,16,110,97,13,29,26,3
441502,34,233,18,215,233,18,215,,,
441548,34,58,13,45,58,13,45,,,
441575,34,207,31,176,207,31,176,,,
441593,34,9,0,9,9,0,9,,,
441609,34,96,96,0,96,96,0,,,
441618,34,13,0,13,6,0,6,7,0,7
441636,34,405,58,347,356,49,307,49,9,40
441645,34,107,2,105,71,1,70,36,1,35
441663,34,224,17,207,224,17,207,,,
441672,34,1,0,1,1,0,1,,,
441690,34,120,66,54,51,30,21,69,36,33
441706,34,227,75,152,227,75,152,,,
441742,34,513,43,470,430,39,391,83,4,79
441760,34,2285,988,1297,889,481,408,1396,507,889
441788,34,474,430,44,317,286,31,157,144,13
441830,34,26,9,17,26,9,17,,,
441858,34,109,4,105,107,4,103,2,0,2
441876,34,191,10,181,94,7,87,97,3,94
441900,34,3763,797,2966,1684,341,1343,2079,456,1623
441937,34,5893,2035,3858,4446,1493,2953,1447,542,905
441982,34,270,132,138,269,132,137,1,0,1
442073,34,642,119,523,397,81,316,245,38,207
442134,34,304,42,262,304,42,262,,,
442213,34,36,0,36,30,0,30,6,0,6
442240,34,360,71,289,200,37,163,160,34,126
442329,34,607,540,67,607,540,67,,,
442356,34,1442,162,1280,563,70,493,879,92,787
442383,34,86,13,73,86,13,73,,,
442426,34,379,34,345,249,21,228,130,13,117
442435,34,26,5,21,26,5,21,,,
442444,34,662,377,285,662,377,285,,,
442523,34,44,17,27,37,15,22,7,2,5
442569,34,3880,1887,1993,1212,562,650,2668,1325,1343
442602,34,420,65,355,420,65,355,,,
442611,34,638,605,33,638,605,33,,,
442639,34,67,48,19,67,48,19,,,
442657,34,121,6,115,121,6,115,,,
442781,34,538,100,438,167,31,136,371,69,302
442842,34,29,6,23,18,5,13,11,1,10
442879,34,817,59,758,610,44,566,207,15,192
442888,34,1,1,0,1,1,0,,,
442930,34,439,210,229,409,193,216,30,17,13
442949,34,3,0,3,,,,3,0,3
442976,34,67,2,65,67,2,65,,,
442985,34,3,1,2,3,1,2,,,
443021,34,24,22,2,24,22,2,,,
443049,34,134,79,55,70,44,26,64,35,29
443058,34,29,10,19,10,3,7,19,7,12
443100,34,36,22,14,36,22,14,,,
443137,34,30,5,25,30,5,25,,,
443146,34,46,36,10,37,28,9,9,8,1
443207,34,111,104,7,111,104,7,,,
443216,34,101,77,24,101,77,24,,,
443225,34,59,46,13,59,46,13,,,
443234,34,60,1,59,60,1,59,,,
443252,34,564,355,209,564,355,209,,,
443261,34,132,8,124,91,7,84,41,1,40
443289,34,111,21,90,111,21,90,,,
443298,34,2,1,1,2,1,1,,,
443322,34,16,2,14,16,2,14,,,
443331,34,2574,530,2044,2089,414,1675,485,116,369
443340,34,40,17,23,34,16,18,6,1,5
443377,34,39,33,6,39,33,6,,,
443410,34,902,642,260,817,577,240,85,65,20
443492,34,743,331,412,527,255,272,216,76,140
443562,34,277,41,236,164,25,139,113,16,97
443571,34,14,6,8,14,6,8,,,
443599,34,754,54,700,158,16,142,596,38,558
443632,34,77,45,32,77,45,32,,,
443641,34,146,2,144,59,0,59,87,2,85
443650,34,561,54,507,466,46,420,95,8,87
443669,34,6,0,6,6,0,6,,,
443696,34,34,9,25,34,9,25,,,
443748,34,577,131,446,559,128,431,18,3,15
443766,34,2416,399,2017,125,53,72,2291,346,1945
443784,34,1256,270,986,73,27,46,1183,243,940
443951,34,45,23,22,45,23,22,,,
443979,34,23,0,23,5,0,5,18,0,18
444051,34,47,2,45,38,2,36,9,0,9
444088,34,535,63,472,535,63,472,,,
444130,34,158,57,101,41,27,14,117,30,87
444194,34,58,2,56,58,2,56,,,
444219,34,6502,2810,3692,1080,481,599,5422,2329,3093
444228,34,20,0,20,20,0,20,,,
444255,34,40,7,33,40,7,33,,,
444264,34,8,2,6,7,2,5,1,0,1
444282,34,53,2,51,29,2,27,24,0,24
444291,34,59,1,58,32,1,31,27,0,27
444307,34,32,1,31,21,1,20,11,0,11
444325,34,99,13,86,83,11,72,16,2,14
444334,34,55,3,52,55,3,52,,,
444361,34,53,18,35,53,18,35,,,
444370,34,34,34,0,34,34,0,,,
444398,34,112,50,62,78,40,38,34,10,24
444404,34,2,1,1,1,0,1,1,1,0
444413,34,101,101,0,101,101,0,,,
444440,34,10,2,8,10,2,8,,,
444468,34,13,0,13,12,0,12,1,0,1
444486,34,291,16,275,260,13,247,31,3,28
444510,34,109,14,95,109,14,95,,,
444529,34,45,7,38,45,7,38,,,
444556,34,429,193,236,429,193,236,,,
444565,34,297,144,153,235,113,122,62,31,31
444583,34,160,70,90,160,70,90,,,
444635,34,64,5,59,1,0,1,63,5,58
444662,34,75,68,7,75,68,7,,,
444671,34,47,23,24,47,23,24,,,
444714,34,124,8,116,124,8,116,,,
444732,34,14,1,13,14,1,13,,,
444778,34,56,23,33,29,11,18,27,12,15
444787,34,2211,300,1911,1383,187,1196,828,113,715
444796,34,113,65,48,113,65,48,,,
444811,34,358,20,338,200,12,188,158,8,150
444857,34,114,3,111,45,1,44,69,2,67
444866,34,98,5,93,59,3,56,39,2,37
444893,34,8,0,8,8,0,8,,,
444936,34,90,27,63,88,27,61,2,0,2
444945,34,93,14,79,93,14,79,,,
444954,34,726,279,447,444,194,250,282,85,197
445027,34,9726,3626,6100,8781,3347,5434,945,279,666
445133,34,133,51,82,95,41,54,38,10,28
445188,34,5911,2781,3130,5827,2730,3097,84,51,33
445203,34,143,18,125,143,18,125,,,
445212,34,209,31,178,115,17,98,94,14,80
445230,34,638,188,450,638,188,450,,,
445249,34,203,36,167,203,36,167,,,
445258,34,6,1,5,6,1,5,,,
445267,34,1498,298,1200,886,176,710,612,122,490
445364,34,250,24,226,250,24,226,,,
445461,34,551,204,347,529,198,331,22,6,16
445498,34,1,1,0,1,1,0,,,
445540,34,50,0,50,50,0,50,,,
445638,34,8,0,8,4,0,4,4,0,4
445647,34,108,2,106,58,1,57,50,1,49
445656,34,118,4,114,72,2,70,46,2,44
445692,34,344,298,46,301,261,40,43,37,6
445708,34,841,294,547,811,278,533,30,16,14
445735,34,559,142,417,559,142,417,,,
445744,34,439,78,361,439,78,361,,,
445762,34,222,206,16,173,161,12,49,45,4
445780,34,30,3,27,30,3,27,,,
445799,34,579,543,36,579,543,36,,,
445841,34,118,0,118,86,0,86,32,0,32
445850,34,136,0,136,93,0,93,43,0,43
445911,34,629,234,395,403,140,263,226,94,132
445948,34,1195,172,1023,1195,172,1023,,,
445957,34,148,32,116,,,,148,32,116
446048,34,863,379,484,854,373,481,9,6,3
446084,34,58,3,55,17,1,16,41,2,39
446093,34,44,4,40,35,3,32,9,1,8
446109,34,137,18,119,85,8,77,52,10,42
446118,34,540,99,441,540,99,441,,,
446127,34,154,3,151,154,3,151,,,
446163,34,132,121,11,101,94,7,31,27,4
446206,34,20,6,14,12,2,10,8,4,4
446224,34,12,6,6,,,,12,6,6
446233,34,119,69,50,111,66,45,8,3,5
446242,34,94,28,66,94,28,66,,,
446251,34,46,6,40,46,6,40,,,
446260,34,624,19,605,624,19,605,,,
446288,34,73,4,69,43,0,43,30,4,26
446303,34,41,0,41,26,0,26,15,0,15
446349,34,23,2,21,23,2,21,,,
446385,34,188,108,80,173,98,75,15,10,5
446394,34,19,5,14,2,1,1,17,4,13
446455,34,2,2,0,2,2,0,,,
446516,34,2,1,1,2,1,1,,,
446525,34,202,166,36,202,166,36,,,
446552,34,1028,560,468,1028,560,468,,,
446561,34,1549,361,1188,1549,361,1188,,,
446589,34,361,69,292,361,69,292,,,
446598,34,12,0,12,10,0,10,2,0,2
446604,34,1917,1917,0,1917,1917,0,,,
446640,34,473,319,154,432,295,137,41,24,17
446774,34,1196,410,786,461,171,290,735,239,496
447014,34,134,9,125,134,9,125,,,
447023,34,1122,456,666,1112,456,656,10,0,10
447050,34,175,43,132,50,13,37,125,30,95
447148,34,114,5,109,69,4,65,45,1,44
447166,34,23,2,21,11,2,9,12,0,12
447175,34,26,1,25,18,0,18,8,1,7
447263,34,1885,259,1626,1446,180,1266,439,79,360
447351,34,413,203,210,413,203,210,,,
447379,34,12,10,2,12,10,2,,,
447421,34,225,25,200,225,25,200,,,
447449,34,14,5,9,10,5,5,4,0,4
447458,34,221,178,43,221,178,43,,,
447467,34,10,1,9,10,1,9,,,
447582,34,524,156,368,355,120,235,169,36,133
447591,34,438,37,401,438,37,401,,,
447607,34,1263,659,604,1263,659,604,,,
447616,34,984,530,454,984,530,454,,,
447689,34,8182,3318,4864,5026,2030,2996,3156,1288,1868
447704,34,109,2,107,109,2,107,,,
447713,34,205,56,149,205,56,149,,,
447722,34,15,2,13,15,2,13,,,
447731,34,117,2,115,74,2,72,43,0,43
447759,34,175,44,131,158,42,116,17,2,15
447768,34,1280,264,1016,1280,264,1016,,,
447777,34,661,347,314,9,6,3,652,341,311
447795,34,2,0,2,2,0,2,,,
447810,34,197,21,176,197,21,176,,,
447847,34,99,93,6,99,93,6,,,
447865,34,4,2,2,3,2,1,1,0,1
447874,34,80,78,2,80,78,2,,,
447883,34,101,15,86,42,7,35,59,8,51
447892,34,86,9,77,46,6,40,40,3,37
447908,34,64,3,61,40,1,39,24,2,22
447917,34,24,3,21,24,3,21,,,
447935,34,248,12,236,248,12,236,,,
447953,34,335,166,169,286,145,141,49,21,28
447962,34,116,10,106,116,10,106,,,
447971,34,17,0,17,17,0,17,,,
447980,34,80,3,77,11,1,10,69,2,67
447999,34,132,35,97,132,35,97,,,
448026,34,90,3,87,67,3,64,23,0,23
448071,34,225,12,213,147,5,142,78,7,71
448123,34,10,2,8,10,2,8,,,
448196,34,80,6,74,79,6,73,1,0,1
448220,34,116,7,109,116,7,109,,,
448239,34,117,1,116,117,1,116,,,
448248,34,951,616,335,140,38,102,811,578,233
448257,34,10,0,10,1,0,1,9,0,9
448275,34,17,0,17,17,0,17,,,
448354,34,200,22,178,121,9,112,79,13,66
448372,34,193,88,105,193,88,105,,,
448424,34,41,3,38,19,1,18,22,2,20
448433,34,735,711,24,735,711,24,,,
448594,34,2313,808,1505,732,276,456,1581,532,1049
448600,34,184,5,179,184,5,179,,,
448619,34,462,29,433,235,18,217,227,11,216
448646,34,7,0,7,7,0,7,,,
448673,34,2478,240,2238,869,90,779,1609,150,1459
448770,34,245,234,11,230,220,10,15,14,1
448798,34,77,0,77,77,0,77,,,
448859,34,121,115,6,121,115,6,,,
448895,34,23,7,16,23,7,16,,,
449038,34,1223,284,939,135,62,73,1088,222,866
449074,34,473,66,407,473,66,407,,,
449083,34,25,25,0,25,25,0,,,
449092,34,40,40,0,40,40,0,,,
449135,34,169,57,112,119,45,74,50,12,38
449250,34,512,102,410,512,102,410,,,
449311,34,164,1,163,57,0,57,107,1,106
449320,34,471,451,20,298,287,11,173,164,9
449339,34,35525,22580,12945,2343,1156,1187,33182,21424,11758
449348,34,70,23,47,5,2,3,65,21,44
449357,34,61,3,58,61,3,58,,,
449384,34,257,166,91,238,152,86,19,14,5
449393,34,59,23,36,59,23,36,,,
449445,34,101,20,81,101,20,81,,,
449454,34,38,4,34,,,,38,4,34
449463,34,84,12,72,72,9,63,12,3,9
449472,34,34,0,34,34,0,34,,,
449490,34,59,15,44,59,15,44,,,
449506,34,45,27,18,45,27,18,,,
449524,34,287,23,264,287,23,264,,,
449533,34,76,7,69,76,7,69,,,
449597,34,3,0,3,3,0,3,,,
449603,34,86,55,31,86,55,31,,,
449612,34,77,43,34,77,43,34,,,
449658,34,87,87,0,87,87,0,,,
449676,34,113,48,65,113,48,65,,,
449685,34,28,4,24,28,4,24,,,
449700,34,224,41,183,224,41,183,,,
449719,34,23,3,20,23,3,20,,,
449728,34,156,3,153,156,3,153,,,
449764,34,197,86,111,169,81,88,28,5,23
449773,34,17,2,15,17,2,15,,,
449782,34,3,0,3,2,0,2,1,0,1
449807,34,38,1,37,38,1,37,,,
449816,34,223,124,99,35,18,17,188,106,82
449834,34,1,1,0,,,,1,1,0
449861,34,106,6,100,106,6,100,,,
449870,34,70,26,44,54,19,35,16,7,9
449889,34,73,19,54,73,19,54,,,
449898,34,473,87,386,313,58,255,160,29,131
449904,34,13,0,13,13,0,13,,,
449959,34,184,28,156,115,18,97,69,10,59
449968,34,233,45,188,149,27,122,84,18,66
449977,34,156,5,151,109,2,107,47,3,44
449986,34,332,71,261,196,33,163,136,38,98
449995,34,104,3,101,61,3,58,43,0,43
450021,34,142,31,111,142,31,111,,,
450058,34,840,143,697,840,143,697,,,
450067,34,500,124,376,496,124,372,4,0,4
450119,34,36,3,33,36,3,33,,,
450128,34,428,13,415,428,13,415,,,
450298,34,251,54,197,13,7,6,238,47,191
450377,34,1125,205,920,62,27,35,1063,178,885
450395,34,97,0,97,53,0,53,44,0,44
450401,34,24,2,22,24,2,22,,,
450571,34,465,39,426,241,18,223,224,21,203
450599,34,46,2,44,46,2,44,,,
450605,34,23,1,22,16,0,16,7,1,6
450614,34,77,2,75,59,2,57,18,0,18
450632,34,71,12,59,,,,71,12,59
450641,34,208,27,181,121,22,99,87,5,82
450650,34,96,8,88,31,3,28,65,5,60
450696,34,281,35,246,281,35,246,,,
450702,34,171,9,162,171,9,162,,,
450711,34,4,2,2,4,2,2,,,
450720,34,449,14,435,220,4,216,229,10,219
450933,34,11277,7345,3932,6146,3756,2390,5131,3589,1542
450951,34,79,50,29,79,50,29,,,
450960,34,242,20,222,222,20,202,20,0,20
450988,34,170,19,151,109,14,95,61,5,56
451042,34,5,0,5,3,0,3,2,0,2
451051,34,77,5,72,,,,77,5,72
451097,34,16,2,14,9,0,9,7,2,5
451103,34,114,22,92,42,7,35,72,15,57
451121,34,104,9,95,52,4,48,52,5,47
451149,34,584,40,544,584,40,544,,,
451158,34,522,30,492,522,30,492,,,
451167,34,125,48,77,75,36,39,50,12,38
451194,34,25,2,23,25,2,23,,,
451228,34,169,139,30,169,139,30,,,
451237,34,148,2,146,148,2,146,,,
451255,34,37,1,36,19,0,19,18,1,17
451264,34,122,15,107,122,15,107,,,
451282,34,84,3,81,61,2,59,23,1,22
451291,34,8,0,8,,,,8,0,8
451307,34,7,0,7,1,0,1,6,0,6
451316,34,45,9,36,45,9,36,,,
451334,34,166,74,92,124,57,67,42,17,25
451343,34,81,3,78,53,2,51,28,1,27
451352,34,88,8,80,47,6,41,41,2,39
451370,34,57,57,0,57,57,0,,,
451398,34,180,180,0,180,180,0,,,
451404,34,311,311,0,311,311,0,,,
451413,34,196,57,139,196,57,139,,,
451459,34,33,7,26,13,2,11,20,5,15
451468,34,351,7,344,351,7,344,,,
451477,34,2106,1716,390,2106,1716,390,,,
451495,34,296,60,236,296,60,236,,,
451501,34,102,27,75,102,27,75,,,
451529,34,20,2,18,6,0,6,14,2,12
451547,34,6,0,6,6,0,6,,,
451556,34,532,183,349,532,183,349,,,
451565,34,181,24,157,177,23,154,4,1,3
451574,34,95,2,93,90,2,88,5,0,5
451583,34,758,560,198,162,116,46,596,444,152
451626,34,53,10,43,44,10,34,9,0,9
451714,34,321,54,267,271,39,232,50,15,35
451741,34,88,25,63,62,18,44,26,7,19
451750,34,1091,206,885,618,162,456,473,44,429
451820,34,114,70,44,76,49,27,38,21,17
451857,34,76,8,68,76,8,68,,,
451866,34,221,24,197,221,24,197,,,
451918,34,91,10,81,91,10,81,,,
451927,34,266,135,131,254,130,124,12,5,7
452009,34,54,0,54,54,0,54,,,
452072,34,20,3,17,20,3,17,,,
452081,34,692,23,669,692,23,669,,,
452106,34,55,53,2,55,53,2,,,
452124,34,429,71,358,426,70,356,3,1,2
452373,34,254,13,241,254,13,241,,,
452771,34,1,1,0,,,,1,1,0
452780,34,3,0,3,,,,3,0,3
452887,34,56,54,2,56,54,2,,,
452948,34,666,58,608,338,24,314,328,34,294
453163,34,2908,438,2470,148,58,90,2760,380,2380
453215,34,531,111,420,28,8,20,503,103,400
453297,34,13,3,10,13,3,10,,,
453756,34,212,119,93,212,119,93,,,
453792,34,57,2,55,57,2,55,,,
454184,34,298,110,188,283,107,176,15,3,12
454227,34,13085,1369,11716,2876,296,2580,10209,1073,9136
454236,34,678,76,602,246,26,220,432,50,382
454245,34,794,134,660,252,37,215,542,97,445
454458,34,14,4,10,14,4,10,,,
454537,34,21,0,21,21,0,21,,,
454546,34,12,0,12,12,0,12,,,
454555,34,15,0,15,15,0,15,,,
454582,34,128,42,86,33,14,19,95,28,67
454607,34,271,6,265,271,6,265,,,
454616,34,92,79,13,92,79,13,,,
454652,34,134,2,132,134,2,132,,,
454689,34,3,1,2,3,1,2,,,
454698,34,265,74,191,265,74,191,,,
454722,34,33,8,25,30,5,25,3,3,0
454759,34,28,23,5,17,12,5,11,11,0
454768,34,260,43,217,145,29,116,115,14,101
454777,34,195,24,171,126,19,107,69,5,64
454786,34,633,364,269,118,66,52,515,298,217
454795,34,309,72,237,193,45,148,116,27,89
454801,34,162,36,126,162,36,126,,,
454810,34,7600,2201,5399,7600,2201,5399,,,
454829,34,3620,493,3127,858,97,761,2762,396,2366
454856,34,1046,132,914,1046,132,914,,,
454865,34,596,70,526,394,43,351,202,27,175
454874,34,12,0,12,8,0,8,4,0,4
454917,34,517,86,431,317,53,264,200,33,167
454926,34,243,19,224,213,17,196,30,2,28
454935,34,19,0,19,19,0,19,,,
454944,34,170,24,146,170,24,146,,,
454953,34,27,1,26,17,1,16,10,0,10
454962,34,27,0,27,13,0,13,14,0,14
454971,34,214,30,184,123,29,94,91,1,90
454980,34,115,2,113,36,1,35,79,1,78
454999,34,125,1,124,51,1,50,74,0,74
455008,34,205,6,199,94,5,89,111,1,110
455026,34,64,58,6,,,,64,58,6
455062,34,51,2,49,28,1,27,23,1,22
455071,34,77,12,65,,,,77,12,65
455080,34,248,27,221,247,27,220,1,0,1
455105,34,73,0,73,73,0,73,,,
455114,34,4699,1816,2883,1696,812,884,3003,1004,1999
455141,34,185,5,180,185,5,180,,,
455187,34,191,13,178,58,5,53,133,8,125
455196,34,2740,238,2502,2740,238,2502,,,
455202,34,369,44,325,206,11,195,163,33,130
455211,34,261,13,248,261,13,248,,,
455220,34,11,2,9,11,2,9,,,
455257,34,310,310,0,310,310,0,,,
455275,34,225,5,220,225,5,220,,,
455284,34,196,5,191,154,4,150,42,1,41
455327,34,22,0,22,19,0,19,3,0,3
455336,34,153,127,26,153,127,26,,,
455354,34,335,12,323,335,12,323,,,
455381,34,99,0,99,48,0,48,51,0,51
455460,34,109,22,87,109,22,87,,,
455479,34,646,57,589,553,51,502,93,6,87
455488,34,187,41,146,187,41,146,,,
455512,34,2094,709,1385,362,135,227,1732,574,1158
455558,34,47,14,33,47,14,33,,,
455628,34,463,129,334,463,129,334,,,
455664,34,207,28,179,13,4,9,194,24,170
455707,34,54,13,41,54,13,41,,,
455725,34,255,9,246,195,8,187,60,1,59
455734,34,173,35,138,173,35,138,,,
455761,34,271,27,244,171,21,150,100,6,94
455770,34,82,49,33,82,49,33,,,
455798,34,82,4,78,45,3,42,37,1,36
455831,34,176,18,158,176,18,158,,,
455859,34,222,3,219,194,3,191,28,0,28
455868,34,291,58,233,291,58,233,,,
455877,34,104,6,98,104,6,98,,,
455886,34,154,5,149,68,3,65,86,2,84
455895,34,357,27,330,166,3,163,191,24,167
455901,34,160,17,143,56,7,49,104,10,94
455910,34,20,2,18,20,2,18,,,
455929,34,52,1,51,52,1,51,,,
455965,34,116,12,104,116,12,104,,,
455974,34,33,9,24,33,9,24,,,
455983,34,124,46,78,121,45,76,3,1,2
456001,34,11,10,1,11,10,1,,,
456029,34,206,12,194,133,12,121,73,0,73
456038,34,311,31,280,311,31,280,,,
456065,34,133,6,127,130,6,124,3,0,3
456074,34,119,5,114,117,5,112,2,0,2
456135,34,43,0,43,27,0,27,16,0,16
456153,34,63,52,11,63,52,11,,,
456205,34,194,27,167,185,27,158,9,0,9
456214,34,342,242,100,342,242,100,,,
456287,34,68,1,67,68,1,67,,,
456454,34,453,129,324,386,119,267,67,10,57
456481,34,62,34,28,11,4,7,51,30,21
456490,34,117,80,37,32,24,8,85,56,29
456506,34,56,2,54,56,2,54,,,
456515,34,22,0,22,22,0,22,,,
456551,34,33,1,32,33,1,32,,,
456579,34,183,57,126,175,55,120,8,2,6
456588,34,29,1,28,25,1,24,4,0,4
456597,34,174,1,173,78,1,77,96,0,96
456621,34,261,65,196,19,11,8,242,54,188
456825,34,114,2,112,108,2,106,6,0,6
456852,34,264,64,200,264,64,200,,,
456922,34,209,38,171,198,35,163,11,3,8
456931,34,270,139,131,258,136,122,12,3,9
456959,34,457,106,351,434,102,332,23,4,19
456968,34,764,19,745,722,19,703,42,0,42
456977,34,4,4,0,4,4,0,,,
457031,34,54,1,53,42,1,41,12,0,12
457077,34,28,2,26,28,2,26,,,
457086,34,174,32,142,131,28,103,43,4,39
457101,34,312,77,235,312,77,235,,,
457110,34,461,69,392,461,69,392,,,
457129,34,1005,107,898,289,29,260,716,78,638
457192,34,22,14,8,22,14,8,,,
457208,34,9,6,3,9,6,3,,,
457226,34,32,24,8,9,8,1,23,16,7
457253,34,170,8,162,27,1,26,143,7,136
457299,34,271,39,232,249,35,214,22,4,18
457314,34,86,21,65,86,21,65,,,
457323,34,354,37,317,354,37,317,,,
457332,34,39,1,38,39,1,38,,,
457341,34,150,1,149,141,1,140,9,0,9
457350,34,66,0,66,,,,66,0,66
457378,34,161,75,86,75,23,52,86,52,34
457387,34,142,87,55,142,87,55,,,
457396,34,76,16,60,11,3,8,65,13,52
457402,34,87,75,12,72,64,8,15,11,4
457411,34,199,186,13,160,150,10,39,36,3
457420,34,187,12,175,117,10,107,70,2,68
457439,34,49,1,48,16,1,15,33,0,33
457448,34,67,0,67,67,0,67,,,
457466,34,28,21,7,28,21,7,,,
457475,34,74,4,70,74,4,70,,,
457484,34,101,48,53,53,23,30,48,25,23
457493,34,73,2,71,73,2,71,,,
457527,34,249,34,215,15,1,14,234,33,201
457536,34,611,126,485,611,126,485,,,
457545,34,94,4,90,78,3,75,16,1,15
457554,34,13,0,13,7,0,7,6,0,6
457563,34,204,4,200,204,4,200,,,
457572,34,108,5,103,108,5,103,,,
457581,34,172,2,170,149,2,147,23,0,23
457606,34,21,1,20,21,1,20,,,
457615,34,42,6,36,,,,42,6,36
457624,34,26,2,24,26,2,24,,,
457633,34,201,2,199,76,0,76,125,2,123
457642,34,69,1,68,69,1,68,,,
457679,34,14,1,13,14,1,13,,,
457688,34,37,12,25,11,4,7,26,8,18
457697,34,95,40,55,21,11,10,74,29,45
457721,34,5,0,5,5,0,5,,,
457749,34,66,6,60,66,6,60,,,
457767,34,65,38,27,65,38,27,,,
457776,34,142,11,131,137,10,127,5,1,4
457785,34,17,0,17,17,0,17,,,
457794,34,3,0,3,3,0,3,,,
457800,34,9,0,9,9,0,9,,,
457819,34,547,212,335,,,,547,212,335
457837,34,135,10,125,61,10,51,74,0,74
457855,34,42,4,38,34,3,31,8,1,7
457873,34,85,59,26,44,36,8,41,23,18
457916,34,27,0,27,13,0,13,14,0,14
457925,34,12,7,5,12,7,5,,,
457943,34,36,2,34,36,2,34,,,
457952,34,175,3,172,133,2,131,42,1,41
457989,34,20,0,20,20,0,20,,,
457998,34,63,12,51,32,1,31,31,11,20
458007,34,4,0,4,2,0,2,2,0,2
458034,34,67,9,58,67,9,58,,,
458043,34,88,0,88,51,0,51,37,0,37
458061,34,44,4,40,12,2,10,32,2,30
458070,34,254,6,248,236,6,230,18,0,18
458098,34,107,2,105,98,2,96,9,0,9
458104,34,197,2,195,1,0,1,196,2,194
458113,34,47,17,30,8,5,3,39,12,27
458122,34,8,0,8,8,0,8,,,
458131,34,12,0,12,12,0,12,,,
458140,34,42,31,11,42,31,11,,,
458168,34,52,4,48,52,4,48,,,
458210,34,2965,647,2318,2087,465,1622,878,182,696
458229,34,2491,523,1968,2034,434,1600,457,89,368
458274,34,188,6,182,137,5,132,51,1,50
458405,34,200,62,138,192,61,131,8,1,7
458423,34,76,18,58,76,18,58,,,
458441,34,279,41,238,271,41,230,8,0,8
458496,34,110,50,60,88,39,49,22,11,11
458681,34,290,51,239,290,51,239,,,
458803,34,97,1,96,74,1,73,23,0,23
458812,34,54,3,51,47,2,45,7,1,6
458821,34,35,2,33,35,2,33,,,
458830,34,80,2,78,62,2,60,18,0,18
458858,34,86,1,85,51,1,50,35,0,35
458867,34,93,3,90,68,3,65,25,0,25
458885,34,323,49,274,19,6,13,304,43,261
458919,34,4411,891,3520,406,201,205,4005,690,3315
458955,34,384,54,330,20,3,17,364,51,313
458964,34,1618,286,1332,138,61,77,1480,225,1255
458973,34,2147,518,1629,241,132,109,1906,386,1520
458982,34,222,109,113,164,82,82,58,27,31
459019,34,28,3,25,21,3,18,7,0,7
459046,34,30,3,27,21,2,19,9,1,8
459055,34,31,2,29,24,1,23,7,1,6
459064,34,43,4,39,28,2,26,15,2,13
459116,34,81,4,77,81,4,77,,,
459125,34,1,0,1,1,0,1,,,
459170,34,313,27,286,180,24,156,133,3,130
459189,34,173,2,171,31,2,29,142,0,142
459198,34,259,47,212,190,42,148,69,5,64
459204,34,3342,415,2927,3342,415,2927,,,
459213,34,2571,536,2035,2571,536,2035,,,
459231,34,187,21,166,187,21,166,,,
459259,34,249,37,212,166,27,139,83,10,73
459268,34,244,29,215,152,23,129,92,6,86
459277,34,216,13,203,216,13,203,,,
459286,34,210,29,181,167,26,141,43,3,40
459295,34,35,0,35,9,0,9,26,0,26
459301,34,103,6,97,81,3,78,22,3,19
459310,34,69,11,58,69,11,58,,,
459329,34,96,56,40,96,56,40,,,
459347,34,65,1,64,19,1,18,46,0,46
459374,34,57,1,56,23,0,23,34,1,33
459392,34,135,3,132,84,2,82,51,1,50
459408,34,32,7,25,21,2,19,11,5,6
459417,34,60,47,13,54,41,13,6,6,0
459426,34,66,1,65,66,1,65,,,
459462,34,261,220,41,261,220,41,,,
459499,34,18,3,15,18,3,15,,,
459514,34,50,5,45,50,5,45,,,
459532,34,37,0,37,,,,37,0,37
459541,34,28,2,26,13,2,11,15,0,15
459550,34,118,2,116,104,2,102,14,0,14
459578,34,112,29,83,83,21,62,29,8,21
459727,34,391,124,267,218,66,152,173,58,115
459824,34,55,6,49,51,6,45,4,0,4
459842,34,597,74,523,330,52,278,267,22,245
459851,34,307,39,268,168,25,143,139,14,125
459949,34,5176,1864,3312,2509,884,1625,2667,980,1687
459958,34,251,48,203,251,48,203,,,
459967,34,94,34,60,94,34,60,,,
459985,34,126,52,74,126,52,74,,,
459994,34,6911,2140,4771,421,204,217,6490,1936,4554
460011,34,145,0,145,101,0,101,44,0,44
460020,34,389,71,318,389,71,318,,,
460093,34,25,1,24,25,1,24,,,
460109,34,58,1,57,58,1,57,,,
460118,34,49,0,49,49,0,49,,,
460127,34,51,3,48,51,3,48,,,
460136,34,672,94,578,672,94,578,,,
460145,34,286,173,113,286,173,113,,,
460172,34,522,477,45,520,475,45,2,2,0
460181,34,458,59,399,458,59,399,,,
460190,34,257,35,222,257,35,222,,,
460206,34,344,79,265,344,79,265,,,
460349,34,1480,418,1062,487,122,365,993,296,697
460376,34,8,5,3,7,5,2,1,0,1
460385,34,17,3,14,17,3,14,,,
460394,34,5411,2073,3338,904,372,532,4507,1701,2806
460464,34,5859,2582,3277,1030,527,503,4829,2055,2774
460482,34,128,8,120,128,8,120,,,
460516,34,3,0,3,3,0,3,,,
460525,34,9,0,9,9,0,9,,,
460534,34,39,1,38,39,1,38,,,
460543,34,992,943,49,992,943,49,,,
460677,34,325,73,252,258,59,199,67,14,53
460701,34,122,9,113,36,3,33,86,6,80
460738,34,953,126,827,136,18,118,817,108,709
460756,34,90,5,85,79,5,74,11,0,11
460765,34,1,0,1,1,0,1,,,
460808,34,3,0,3,3,0,3,,,
460817,34,131,25,106,126,25,101,5,0,5
460826,34,406,76,330,405,76,329,1,0,1
460835,34,239,58,181,235,57,178,4,1,3
460862,34,234,14,220,112,5,107,122,9,113
460871,34,711,77,634,271,28,243,440,49,391
460914,34,329,3,326,329,3,326,,,
460932,34,7,1,6,7,1,6,,,
460969,34,206,18,188,206,18,188,,,
460978,34,144,2,142,59,0,59,85,2,83
460987,34,75,1,74,75,1,74,,,
460996,34,134,1,133,86,0,86,48,1,47
461014,34,979,75,904,979,75,904,,,
461023,34,458,61,397,444,59,385,14,2,12
461032,34,131,68,63,47,24,23,84,44,40
461087,34,207,91,116,118,43,75,89,48,41
461111,34,16,14,2,12,12,0,4,2,2
461148,34,734,404,330,734,404,330,,,
461175,34,192,8,184,140,7,133,52,1,51
461193,34,207,8,199,201,8,193,6,0,6
461218,34,607,42,565,607,42,565,,,
461245,34,24,10,14,11,3,8,13,7,6
461254,34,22,4,18,22,4,18,,,
461263,34,115,8,107,115,8,107,,,
461272,34,61,0,61,42,0,42,19,0,19
461281,34,85,7,78,66,6,60,19,1,18
461306,34,48,9,39,21,5,16,27,4,23
461315,34,47,12,35,26,9,17,21,3,18
461324,34,774,178,596,738,166,572,36,12,24
461333,34,1,1,0,,,,1,1,0
461342,34,64,0,64,39,0,39,25,0,25
461379,34,22,0,22,1,0,1,21,0,21
461388,34,39,13,26,39,13,26,,,
461412,34,46,13,33,,,,46,13,33
461421,34,196,11,185,194,11,183,2,0,2
461430,34,492,452,40,,,,492,452,40
461494,34,157,18,139,99,12,87,58,6,52
461500,34,8,2,6,2,1,1,6,1,5
461528,34,156,82,74,61,29,32,95,53,42
461537,34,30,0,30,23,0,23,7,0,7
461555,34,85,3,82,85,3,82,,,
461573,34,44,43,1,44,43,1,,,
461582,34,138,3,135,138,3,135,,,
461591,34,127,9,118,127,9,118,,,
461607,34,63,5,58,33,3,30,30,2,28
461625,34,16,16,0,16,16,0,,,
461643,34,20,2,18,20,2,18,,,
461652,34,53,5,48,53,5,48,,,
461689,34,319,29,290,319,29,290,,,
461704,34,73,7,66,73,7,66,,,
461713,34,25,0,25,11,0,11,14,0,14
461722,34,5,0,5,5,0,5,,,
461740,34,34,26,8,34,26,8,,,
461759,34,141,75,66,97,49,48,44,26,18
461768,34,186,6,180,186,6,180,,,
461795,34,296,228,68,274,211,63,22,17,5
461810,34,4,0,4,3,0,3,1,0,1
461829,34,28,3,25,28,3,25,,,
461838,34,120,5,115,46,3,43,74,2,72
461847,34,51,51,0,51,51,0,,,
461856,34,58,17,41,58,17,41,,,
461865,34,3,0,3,3,0,3,,,
461874,34,48,5,43,48,5,43,,,
461883,34,52,23,29,39,19,20,13,4,9
461892,34,71,8,63,71,8,63,,,
461908,34,78,2,76,77,1,76,1,1,0
461917,34,143,5,138,94,2,92,49,3,46
461926,34,66,1,65,44,1,43,22,0,22
461944,34,51,0,51,51,0,51,,,
461953,34,53,4,49,41,2,39,12,2,10
461962,34,34,12,22,33,12,21,1,0,1
461999,34,59,1,58,58,1,57,1,0,1
462008,34,284,24,260,176,19,157,108,5,103
462017,34,80,13,67,80,13,67,,,
462035,34,187,66,121,64,6,58,123,60,63
462053,34,75,3,72,75,3,72,,,
462062,34,96,2,94,53,1,52,43,1,42
462071,34,135,32,103,132,32,100,3,0,3
462336,34,79,3,76,78,3,75,1,0,1
462345,34,6,0,6,4,0,4,2,0,2
462354,34,180,85,95,161,69,92,19,16,3
463056,34,969,445,524,875,396,479,94,49,45
464226,34,568,352,216,507,307,200,61,45,16
466921,34,406,27,379,105,8,97,301,19,282
466930,34,1916,257,1659,490,66,424,1426,191,1235
467094,34,123,0,123,123,0,123,,,
467368,34,128,11,117,128,11,117,,,
467863,34,185,39,146,129,25,104,56,14,42
467872,34,214,4,210,161,3,158,53,1,52
467906,34,116,5,111,76,3,73,40,2,38
468246,34,108,6,102,108,6,102,,,
468255,34,23,1,22,23,1,22,,,
468291,34,60,5,55,60,5,55,,,
468769,34,91,84,7,91,84,7,,,
468848,34,666,291,375,666,291,375,,,
468893,34,116,4,112,106,4,102,10,0,10
468909,34,856,341,515,856,341,515,,,
468963,34,47,42,5,47,42,5,,,
469416,34,258,67,191,174,54,120,84,13,71
469610,34,13,1,12,13,1,12,,,
469629,34,97,87,10,97,87,10,,,
469911,34,11,0,11,11,0,11,,,
469957,34,112,11,101,112,11,101,,,
470038,34,961,390,571,961,390,571,,,
470047,34,40,6,34,40,6,34,,,
470296,34,7,0,7,7,0,7,,,
470393,34,103,8,95,41,5,36,62,3,59
474863,34,1332,266,1066,595,120,475,737,146,591
474915,34,236,10,226,122,5,117,114,5,109
474924,34,92,1,91,27,0,27,65,1,64
475015,34,118,4,114,118,4,114,,,
475024,34,203,77,126,203,77,126,,,
475033,34,170,29,141,,,,170,29,141
475060,34,213,18,195,207,16,191,6,2,4
475121,34,4463,864,3599,2734,593,2141,1729,271,1458
475176,34,544,251,293,544,251,293,,,
475200,34,227,62,165,36,7,29,191,55,136
475273,34,354,59,295,66,11,55,288,48,240
475282,34,76,21,55,76,21,55,,,
475325,34,11,1,10,11,1,10,,,
475398,34,73,38,35,8,4,4,65,34,31
475404,34,100,1,99,61,1,60,39,0,39
475413,34,25,4,21,14,3,11,11,1,10
475422,34,106,6,100,33,1,32,73,5,68
475431,34,34,2,32,34,2,32,,,
475468,34,278,6,272,109,4,105,169,2,167
475477,34,172,54,118,26,7,19,146,47,99
475486,34,270,38,232,270,38,232,,,
475547,34,102,17,85,55,10,45,47,7,40
475556,34,147,5,142,92,3,89,55,2,53
475565,34,430,191,239,335,145,190,95,46,49
475574,34,39,14,25,18,6,12,21,8,13
475608,34,124,85,39,63,41,22,61,44,17
475635,34,17,1,16,4,0,4,13,1,12
475653,34,14,1,13,11,1,10,3,0,3
475662,34,30,0,30,15,0,15,15,0,15
475705,34,20,7,13,20,7,13,,,
475714,34,323,255,68,283,227,56,40,28,12
475723,34,111,54,57,36,18,18,75,36,39
475732,34,1367,134,1233,329,27,302,1038,107,931
475741,34,240,18,222,86,2,84,154,16,138
475839,34,228,98,130,99,44,55,129,54,75
476063,34,156,146,10,156,146,10,,,
476179,34,90,5,85,60,4,56,30,1,29
476230,34,15,0,15,15,0,15,,,
476294,34,139,15,124,41,3,38,98,12,86
476355,34,46,23,23,46,23,23,,,
476489,34,63,56,7,63,56,7,,,
476498,34,116,72,44,116,72,44,,,
476513,34,50,1,49,50,1,49,,,
476540,34,144,4,140,124,2,122,20,2,18
476559,34,152,2,150,146,1,145,6,1,5
476568,34,1,1,0,1,1,0,,,
476595,34,34,8,26,34,8,26,,,
476601,34,51,51,0,51,51,0,,,
476610,34,44,30,14,44,30,14,,,
476629,34,126,5,121,126,5,121,,,
476683,34,309,16,293,309,16,293,,,
476692,34,19,19,0,19,19,0,,,
476708,34,124,94,30,102,78,24,22,16,6
476717,34,423,423,0,423,423,0,,,
476726,34,388,67,321,388,67,321,,,
476735,34,6,4,2,2,2,0,4,2,2
476753,34,177,6,171,114,4,110,63,2,61
476780,34,52,3,49,37,3,34,15,0,15
476799,34,355,53,302,355,53,302,,,
476805,34,47,1,46,47,1,46,,,
476814,34,432,307,125,,,,432,307,125
476841,34,231,31,200,118,18,100,113,13,100
476850,34,44,31,13,44,31,13,,,
476869,34,43,0,43,43,0,43,,,
476878,34,10,0,10,3,0,3,7,0,7
476887,34,93,0,93,7,0,7,86,0,86
476896,34,54,2,52,54,2,52,,,
476902,34,86,2,84,55,1,54,31,1,30
476939,34,550,45,505,550,45,505,,,
476948,34,299,242,57,299,242,57,,,
476957,34,4,0,4,2,0,2,2,0,2
476966,34,98,89,9,98,89,9,,,
476975,34,6432,2981,3451,1745,817,928,4687,2164,2523
476984,34,165,7,158,120,6,114,45,1,44
476993,34,154,2,152,154,2,152,,,
477002,34,34,0,34,34,0,34,,,
477039,34,1019,133,886,625,73,552,394,60,334
478582,34,92,3,89,64,2,62,28,1,27
478591,34,54,2,52,31,0,31,23,2,21
478616,34,70,8,62,50,6,44,20,2,18
478917,34,26,1,25,26,1,25,,,
478953,34,161,4,157,161,4,157,,,
479062,34,51,48,3,37,34,3,14,14,0
479424,34,265,33,232,265,33,232,,,
479965,34,194,51,143,194,51,143,,,
479974,34,86,26,60,86,26,60,,,
479983,34,86,13,73,86,13,73,,,
479992,34,24,24,0,12,12,0,12,12,0
480000,34,45,29,16,45,29,16,,,
480019,34,270,247,23,233,214,19,37,33,4
480028,34,108,83,25,104,80,24,4,3,1
480037,34,1316,1025,291,1316,1025,291,,,
480073,34,318,60,258,222,38,184,96,22,74
480091,34,5536,498,5038,4117,369,3748,1419,129,1290
480125,34,203,8,195,111,4,107,92,4,88
480161,34,10,0,10,10,0,10,,,
480198,34,247,69,178,159,46,113,88,23,65
480204,34,420,56,364,420,56,364,,,
480310,34,46,4,42,34,4,30,12,0,12
480347,34,33,3,30,33,3,30,,,
480471,34,535,157,378,535,157,378,,,
480523,34,50,2,48,50,2,48,,,
480532,34,17,0,17,17,0,17,,,
480550,34,23,1,22,23,1,22,,,
480569,34,887,365,522,526,204,322,361,161,200
480657,34,644,64,580,341,34,307,303,30,273
480693,34,39,13,26,38,13,25,1,0,1
480727,34,2,2,0,2,2,0,,,
480781,34,78,60,18,78,60,18,,,
480824,34,333,31,302,333,31,302,,,
480833,34,532,41,491,532,41,491,,,
480842,34,13,2,11,13,2,11,,,
480851,34,116,54,62,116,54,62,,,
480879,34,33,1,32,33,1,32,,,
480888,34,101,35,66,101,35,66,,,
480903,34,277,246,31,255,224,31,22,22,0
480912,34,6,2,4,6,2,4,,,
480921,34,76,62,14,76,62,14,,,
480930,34,109,6,103,77,5,72,32,1,31
480967,34,99,32,67,60,21,39,39,11,28
480976,34,49,1,48,49,1,48,,,
480985,34,247,1,246,247,1,246,,,
480994,34,84,3,81,63,3,60,21,0,21
481003,34,66,59,7,66,59,7,,,
481021,34,17,17,0,13,13,0,4,4,0
481049,34,26,3,23,26,3,23,,,
481058,34,61,24,37,38,14,24,23,10,13
481085,34,137,7,130,137,7,130,,,
481100,34,15,2,13,6,1,5,9,1,8
481128,34,95,6,89,80,4,76,15,2,13
481137,34,54,31,23,54,31,23,,,
481146,34,52,6,46,33,4,29,19,2,17
481155,34,196,78,118,196,78,118,,,
481191,34,136,14,122,136,14,122,,,
481207,34,74,23,51,74,23,51,,,
481225,34,14,9,5,13,9,4,1,0,1
481243,34,240,2,238,88,0,88,152,2,150
481252,34,58,8,50,58,8,50,,,
481289,34,75,17,58,75,17,58,,,
481298,34,37,4,33,37,4,33,,,
481313,34,35,0,35,18,0,18,17,0,17
481322,34,21,1,20,6,0,6,15,1,14
481331,34,56,46,10,55,45,10,1,1,0
481340,34,13,1,12,13,1,12,,,
481368,34,49,2,47,49,2,47,,,
481401,34,180,124,56,43,26,17,137,98,39
481410,34,53,53,0,53,53,0,,,
481429,34,102,10,92,102,10,92,,,
481438,34,43,43,0,43,43,0,,,
481447,34,5,0,5,3,0,3,2,0,2
481456,34,13,0,13,5,0,5,8,0,8
481465,34,45,0,45,40,0,40,5,0,5
481474,34,146,3,143,126,3,123,20,0,20
481483,34,112,2,110,67,1,66,45,1,44
481508,34,25,0,25,24,0,24,1,0,1
481517,34,84,5,79,47,4,43,37,1,36
481526,34,145,1,144,138,1,137,7,0,7
481571,34,1,0,1,1,0,1,,,
481678,34,34,2,32,18,0,18,16,2,14
481720,34,36,3,33,28,3,25,8,0,8
481739,34,40,4,36,20,4,16,20,0,20
481748,34,78,3,75,47,3,44,31,0,31
481775,34,170,50,120,170,50,120,,,
481845,34,43,4,39,30,3,27,13,1,12
481863,34,48,1,47,48,1,47,,,
481890,34,34,1,33,34,1,33,,,
481906,34,32,0,32,32,0,32,,,
481960,34,8,6,2,8,6,2,,,
482015,34,319,190,129,319,190,129,,,
482060,34,16,0,16,16,0,16,,,
482097,34,300,157,143,296,157,139,4,0,4
482149,34,4092,1401,2691,3306,1109,2197,786,292,494
482158,34,5721,2412,3309,3418,1560,1858,2303,852,1451
482167,34,103,2,101,37,2,35,66,0,66
482176,34,217,12,205,189,10,179,28,2,26
482185,34,35,26,9,35,26,9,,,
482194,34,14,5,9,11,4,7,3,1,2
482200,34,53,10,43,53,10,43,,,
482228,34,112,72,40,35,26,9,77,46,31
482246,34,4,2,2,4,2,2,,,
482255,34,251,221,30,195,174,21,56,47,9
482291,34,968,420,548,968,420,548,,,
482413,34,723,346,377,427,237,190,296,109,187
482422,34,98,65,33,42,23,19,56,42,14
482431,34,1356,804,552,767,465,302,589,339,250
482440,34,51,21,30,17,5,12,34,16,18
482459,34,426,206,220,181,75,106,245,131,114
482468,34,864,342,522,421,163,258,443,179,264
482477,34,17758,6042,11716,6896,2484,4412,10862,3558,7304
482538,34,22,19,3,10,8,2,12,11,1
482547,34,28,18,10,17,13,4,11,5,6
482556,34,108,62,46,58,29,29,50,33,17
482565,34,19,9,10,10,5,5,9,4,5
482574,34,365,167,198,172,86,86,193,81,112
482608,34,68,36,32,36,18,18,32,18,14
482617,34,16,6,10,11,4,7,5,2,3
482635,34,165,97,68,95,53,42,70,44,26
482653,34,86,44,42,44,25,19,42,19,23
482680,34,12448,5338,7110,8118,3512,4606,4330,1826,2504
482699,34,983,304,679,576,204,372,407,100,307
482705,34,1928,752,1176,461,59,402,1467,693,774
482936,34,937,779,158,795,662,133,142,117,25
482963,34,289,24,265,289,24,265,,,
482981,34,144,116,28,118,92,26,26,24,2
482990,34,287,30,257,287,30,257,,,
483009,34,2,1,1,2,1,1,,,
483018,34,103,34,69,103,34,69,,,
483036,34,1738,710,1028,660,266,394,1078,444,634
483045,34,4731,1494,3237,1404,495,909,3327,999,2328
483054,34,85,64,21,85,64,21,,,
483106,34,160,31,129,117,21,96,43,10,33
483124,34,39931,15115,24816,16429,5422,11007,23502,9693,13809
483212,34,2337,724,1613,1216,436,780,1121,288,833
483230,34,163,159,4,109,106,3,54,53,1
483258,34,26,22,4,26,22,4,,,
483276,34,39,34,5,39,34,5,,,
483328,34,119,12,107,73,10,63,46,2,44
483337,34,168,5,163,119,4,115,49,1,48
483346,34,42,2,40,42,2,40,,,
483355,34,136,6,130,136,6,130,,,
483364,34,102,5,97,102,5,97,,,
483373,34,97,14,83,52,10,42,45,4,41
483382,34,96,91,5,96,91,5,,,
483425,34,28,0,28,28,0,28,,,
483443,34,320,273,47,320,273,47,,,
483470,34,10,1,9,10,1,9,,,
483504,34,256,88,168,256,88,168,,,
483513,34,33,26,7,33,26,7,,,
483559,34,29,8,21,16,6,10,13,2,11
483577,34,29,1,28,14,0,14,15,1,14
483595,34,2144,549,1595,1291,334,957,853,215,638
483647,34,29,1,28,29,1,28,,,
483708,34,92,15,77,22,5,17,70,10,60
483726,34,18,1,17,7,0,7,11,1,10
483735,34,40,3,37,21,2,19,19,1,18
483744,34,51,42,9,51,42,9,,,
483753,34,11,8,3,2,2,0,9,6,3
483780,34,77,54,23,62,45,17,15,9,6
483799,34,43,13,30,43,13,30,,,
483814,34,492,47,445,445,40,405,47,7,40
483823,34,558,409,149,558,409,149,,,
483841,34,2,0,2,2,0,2,,,
483850,34,3,0,3,3,0,3,,,
483869,34,15,3,12,15,3,12,,,
483878,34,132,22,110,132,22,110,,,
483887,34,44,11,33,44,11,33,,,
483896,34,171,7,164,30,0,30,141,7,134
483911,34,9,1,8,9,1,8,,,
483920,34,93,47,46,93,47,46,,,
483948,34,48,39,9,32,26,6,16,13,3
483957,34,37,9,28,37,9,28,,,
484002,34,1011,82,929,964,76,888,47,6,41
484011,34,101,21,80,75,21,54,26,0,26
484020,34,19,15,4,11,9,2,8,6,2
484039,34,115,95,20,115,95,20,,,
484048,34,9,8,1,9,8,1,,,
484057,34,163,8,155,37,1,36,126,7,119
484066,34,161,13,148,161,13,148,,,
484075,34,2,2,0,1,1,0,1,1,0
484084,34,52,1,51,41,1,40,11,0,11
484093,34,143,4,139,101,2,99,42,2,40
484109,34,94,1,93,94,1,93,,,
484127,34,74,15,59,74,15,59,,,
484136,34,2,1,1,2,1,1,,,
484163,34,42,14,28,26,9,17,16,5,11
484172,34,6,0,6,6,0,6,,,
484190,34,14,10,4,14,10,4,,,
484206,34,111,2,109,61,1,60,50,1,49
484233,34,130,82,48,,,,130,82,48
484330,34,25,0,25,25,0,25,,,
484349,34,37,1,36,37,1,36,,,
484358,34,25,1,24,25,1,24,,,
484367,34,142,17,125,142,17,125,,,
484376,34,234,26,208,234,26,208,,,
484394,34,187,28,159,124,19,105,63,9,54
484473,34,3450,1568,1882,1475,631,844,1975,937,1038
484604,34,327,6,321,163,2,161,164,4,160
484613,34,61786,18068,43718,61786,18068,43718,,,
484631,34,1158,744,414,1158,744,414,,,
484710,34,76,49,27,76,49,27,,,
484756,34,126,55,71,126,55,71,,,
484826,34,42,0,42,42,0,42,,,
484835,34,80,21,59,80,21,59,,,
484844,34,419,181,238,419,181,238,,,
484862,34,1,0,1,,,,1,0,1
484871,34,83,83,0,83,83,0,,,
484899,34,122,2,120,122,2,120,,,
484905,34,2932,935,1997,1536,497,1039,1396,438,958
484923,34,34,0,34,34,0,34,,,
484932,34,1206,485,721,707,255,452,499,230,269
484950,34,80,11,69,80,11,69,,,
484996,34,73,1,72,73,1,72,,,
485014,34,46,1,45,31,0,31,15,1,14
485032,34,176,8,168,103,6,97,73,2,71
485111,34,3533,1290,2243,1839,714,1125,1694,576,1118
485139,34,197,164,33,197,164,33,,,
485166,34,115,17,98,115,17,98,,,
485236,34,87,2,85,26,1,25,61,1,60
485272,34,1112,145,967,557,86,471,555,59,496
485306,34,9,0,9,9,0,9,,,
485342,34,127,88,39,127,88,39,,,
485360,34,17,1,16,17,1,16,,,
485379,34,162,25,137,162,25,137,,,
485388,34,232,25,207,232,25,207,,,
485397,34,90,4,86,66,4,62,24,0,24
485412,34,76,10,66,76,10,66,,,
485458,34,1651,485,1166,420,124,296,1231,361,870
485476,34,67,3,64,67,3,64,,,
485485,34,86,12,74,86,12,74,,,
485494,34,34,29,5,34,29,5,,,
485500,34,216,203,13,10,10,0,206,193,13
485519,34,370,258,112,185,129,56,185,129,56
485546,34,107,45,62,2,1,1,105,44,61
485564,34,15,5,10,15,5,10,,,
485573,34,174,29,145,165,28,137,9,1,8
485591,34,30,0,30,30,0,30,,,
485607,34,16,0,16,12,0,12,4,0,4
485698,34,63,57,6,60,54,6,3,3,0
485704,34,4,0,4,2,0,2,2,0,2
485768,34,236,135,101,236,135,101,,,
485801,34,41,9,32,41,9,32,,,
485856,34,41,13,28,15,6,9,26,7,19
485874,34,126,6,120,76,4,72,50,2,48
485926,34,153,47,106,149,47,102,4,0,4
485953,34,2,2,0,2,2,0,,,
485962,34,33,22,11,15,10,5,18,12,6
485999,34,72,72,0,72,72,0,,,
486017,34,28,28,0,28,28,0,,,
486026,34,62,62,0,62,62,0,,,
486053,34,93,61,32,74,50,24,19,11,8
486105,34,1,0,1,1,0,1,,,
486123,34,22,8,14,22,8,14,,,
486141,34,12,0,12,12,0,12,,,
486150,34,77,23,54,53,17,36,24,6,18
486169,34,33,25,8,33,25,8,,,
486196,34,109,109,0,109,109,0,,,
486202,34,25,2,23,25,2,23,,,
486239,34,85,29,56,68,23,45,17,6,11
486248,34,57,27,30,57,27,30,,,
486257,34,263,106,157,178,75,103,85,31,54
486284,34,217,60,157,210,57,153,7,3,4
486309,34,1,0,1,1,0,1,,,
486345,34,114,112,2,49,48,1,65,64,1
486354,34,34,9,25,34,9,25,,,
486372,34,94,74,20,65,55,10,29,19,10
486381,34,151,17,134,151,17,134,,,
486390,34,29,15,14,29,15,14,,,
486406,34,9,2,7,9,2,7,,,
486415,34,199,49,150,199,49,150,,,
486424,34,105,2,103,97,0,97,8,2,6
486442,34,44,1,43,44,1,43,,,
486488,34,21,16,5,18,14,4,3,2,1
486497,34,39,38,1,37,36,1,2,2,0
486503,34,37,0,37,37,0,37,,,
486512,34,210,93,117,210,93,117,,,
486530,34,139,0,139,139,0,139,,,
486558,34,227,204,23,162,145,17,65,59,6
486567,34,193,11,182,189,10,179,4,1,3
486576,34,35,10,25,35,10,25,,,
486594,34,23,10,13,7,2,5,16,8,8
486619,34,133,5,128,102,5,97,31,0,31
486691,34,62,0,62,36,0,36,26,0,26
486707,34,45,1,44,45,1,44,,,
486716,34,50,1,49,50,1,49,,,
486752,34,63,3,60,63,3,60,,,
486770,34,91,18,73,91,18,73,,,
486798,34,760,693,67,760,693,67,,,
486813,34,382,73,309,382,73,309,,,
486822,34,653,77,576,653,77,576,,,
486840,34,29115,14803,14312,20278,10158,10120,8837,4645,4192
486859,34,24,0,24,24,0,24,,,
486868,34,1,0,1,1,0,1,,,
486877,34,3,0,3,3,0,3,,,
486886,34,5,0,5,3,0,3,2,0,2
486901,34,594,291,303,565,277,288,29,14,15
486938,34,542,95,447,245,35,210,297,60,237
486947,34,548,67,481,241,29,212,307,38,269
486956,34,1212,167,1045,538,72,466,674,95,579
486965,34,158,61,97,158,61,97,,,
486983,34,41,11,30,41,11,30,,,
487010,34,264,23,241,248,20,228,16,3,13
487047,34,27,1,26,27,1,26,,,
487065,34,60,6,54,60,6,54,,,
487083,34,25,0,25,25,0,25,,,
487092,34,473,216,257,473,216,257,,,
487162,34,2515,643,1872,949,273,676,1566,370,1196
487232,34,73,0,73,73,0,73,,,
487302,34,516,102,414,515,102,413,1,0,1
487311,34,210,197,13,210,197,13,,,
487320,34,6403,4202,2201,2744,1983,761,3659,2219,1440
487348,34,91,4,87,42,3,39,49,1,48
487375,34,911,111,800,584,68,516,327,43,284
487384,34,492,158,334,492,158,334,,,
487393,34,599,253,346,599,253,346,,,
487409,34,554,215,339,554,215,339,,,
487418,34,645,238,407,645,238,407,,,
487427,34,396,141,255,396,141,255,,,
487436,34,408,71,337,408,71,337,,,
487445,34,479,163,316,479,163,316,,,
487454,34,476,153,323,476,153,323,,,
487472,34,511,199,312,511,199,312,,,
487481,34,1088,214,874,1088,214,874,,,
487490,34,802,164,638,802,164,638,,,
487506,34,33,1,32,6,0,6,27,1,26
487524,34,1834,737,1097,1624,651,973,210,86,124
487533,34,98,1,97,34,1,33,64,0,64
487588,34,227,20,207,227,20,207,,,
487597,34,846,806,40,846,806,40,,,
487603,34,498,202,296,291,122,169,207,80,127
487621,34,17,15,2,16,14,2,1,1,0
487658,34,63,45,18,63,45,18,,,
487676,34,176,12,164,149,8,141,27,4,23
487746,34,26,26,0,26,26,0,,,
487773,34,38,6,32,26,3,23,12,3,9
487791,34,396,363,33,231,214,17,165,149,16
487807,34,45,28,17,25,18,7,20,10,10
487816,34,13,0,13,13,0,13,,,
487852,34,7,1,6,,,,7,1,6
487861,34,269,36,233,189,28,161,80,8,72
487889,34,6,2,4,6,2,4,,,
487898,34,2,1,1,1,1,0,1,0,1
487904,34,13,11,2,13,11,2,,,
487922,34,56,0,56,41,0,41,15,0,15
487959,34,44,0,44,22,0,22,22,0,22
487968,34,20,0,20,20,0,20,,,
487977,34,1808,146,1662,1458,38,1420,350,108,242
487995,34,43,8,35,19,4,15,24,4,20
488004,34,20,20,0,20,20,0,,,
488013,34,65,2,63,65,2,63,,,
488022,34,67,38,29,41,22,19,26,16,10
488031,34,60,25,35,58,24,34,2,1,1
488059,34,170,61,109,170,61,109,,,
488068,34,54,8,46,17,5,12,37,3,34
488077,34,2023,1971,52,1521,1481,40,502,490,12
488101,34,80,80,0,80,80,0,,,
488110,34,20,0,20,18,0,18,2,0,2
488129,34,4,0,4,,,,4,0,4
488138,34,34,1,33,34,1,33,,,
488147,34,43,0,43,43,0,43,,,
488174,34,27,14,13,21,11,10,6,3,3
488183,34,16,2,14,16,2,14,,,
488192,34,39,38,1,,,,39,38,1
488217,34,146,3,143,146,3,143,,,
488226,34,19,9,10,19,9,10,,,
488253,34,58,36,22,39,21,18,19,15,4
488262,34,11,4,7,7,3,4,4,1,3
488271,34,46,2,44,46,2,44,,,
488280,34,28,18,10,28,18,10,,,
488299,34,2,2,0,1,1,0,1,1,0
488305,34,89,55,34,68,39,29,21,16,5
488314,34,43,43,0,43,43,0,,,
488332,34,196,27,169,196,27,169,,,
488350,34,55,55,0,55,55,0,,,
488369,34,45,37,8,45,37,8,,,
488378,34,21,0,21,20,0,20,1,0,1
488396,34,20,16,4,3,3,0,17,13,4
488411,34,89,0,89,89,0,89,,,
488420,34,109,10,99,,,,109,10,99
488439,34,39,28,11,26,18,8,13,10,3
488448,34,71,45,26,67,42,25,4,3,1
488590,34,8,1,7,8,1,7,,,
488651,34,55,5,50,26,3,23,29,2,27
488679,34,5047,1285,3762,4705,1192,3513,342,93,249
488730,34,4162,1685,2477,477,211,266,3685,1474,2211
488749,34,56,10,46,51,7,44,5,3,2
488776,34,104,36,68,71,26,45,33,10,23
488785,34,203,107,96,192,100,92,11,7,4
488800,34,694,213,481,694,213,481,,,
488828,34,11,5,6,11,5,6,,,
488837,34,49,45,4,49,45,4,,,
488846,34,8013,4723,3290,2819,1730,1089,5194,2993,2201
488891,34,65,28,37,65,28,37,,,
488916,34,11,0,11,11,0,11,,,
488934,34,857,523,334,525,273,252,332,250,82
488952,34,28,1,27,28,1,27,,,
488961,34,29,1,28,29,1,28,,,
488970,34,48,1,47,48,1,47,,,
488989,34,133,9,124,92,7,85,41,2,39
488998,34,101,18,83,99,18,81,2,0,2
489122,34,12,3,9,2,0,2,10,3,7
489131,34,24,7,17,14,4,10,10,3,7
489140,34,44,7,37,20,3,17,24,4,20
489159,34,142,1,141,77,0,77,65,1,64
489201,34,4987,1956,3031,1136,517,619,3851,1439,2412
489238,34,93,10,83,56,5,51,37,5,32
489247,34,41,7,34,17,3,14,24,4,20
489256,34,10,8,2,9,7,2,1,1,0
489283,34,409,61,348,409,61,348,,,
489344,34,250,22,228,89,8,81,161,14,147
489353,34,435,94,341,265,58,207,170,36,134
489371,34,72,66,6,72,66,6,,,
489779,34,31051,12193,18858,4841,1659,3182,26210,10534,15676
489812,34,31,0,31,31,0,31,,,
489830,34,57,2,55,57,2,55,,,
489937,34,376,184,192,286,155,131,90,29,61
490018,34,17,9,8,17,9,8,,,
490045,34,33,12,21,17,6,11,16,6,10
490054,34,175,48,127,92,30,62,83,18,65
490063,34,60,27,33,60,27,33,,,
490081,34,40,19,21,38,19,19,2,0,2
490090,34,1,1,0,1,1,0,,,
490115,34,33,22,11,33,22,11,,,
490124,34,5,3,2,5,3,2,,,
490133,34,894,536,358,870,519,351,24,17,7
490142,34,28,3,25,14,3,11,14,0,14
490151,34,28,3,25,20,2,18,8,1,7
490160,34,95,15,80,95,15,80,,,
490197,34,45,8,37,45,8,37,,,
490203,34,117,6,111,53,2,51,64,4,60
490212,34,21,1,20,21,1,20,,,
490221,34,4,2,2,2,1,1,2,1,1
490230,34,196,92,104,193,90,103,3,2,1
490249,34,16,15,1,16,15,1,,,
490258,34,56,10,46,56,10,46,,,
490267,34,8,4,4,2,2,0,6,2,4
490276,34,92,92,0,92,92,0,,,
490285,34,500,400,100,500,400,100,,,
490294,34,30,10,20,25,7,18,5,3,2
490300,34,71,20,51,27,3,24,44,17,27
490319,34,7,7,0,7,7,0,,,
490328,34,67,67,0,67,67,0,,,
490337,34,99,25,74,39,11,28,60,14,46
490382,34,22,4,18,22,4,18,,,
490391,34,40,3,37,40,3,37,,,
490407,34,79,0,79,38,0,38,41,0,41
490416,34,13,12,1,13,12,1,,,
490425,34,128,1,127,128,1,127,,,
490434,34,20,0,20,20,0,20,,,
490443,34,106,0,106,106,0,106,,,
490452,34,34,10,24,11,1,10,23,9,14
490461,34,29,1,28,29,1,28,,,
490470,34,12,3,9,12,3,9,,,
490489,34,39,32,7,36,29,7,3,3,0
490498,34,30,23,7,30,23,7,,,
490504,34,27,27,0,27,27,0,,,
490513,34,21,21,0,19,19,0,2,2,0
490522,34,19,0,19,19,0,19,,,
490531,34,17,12,5,7,6,1,10,6,4
490540,34,14,0,14,12,0,12,2,0,2
490559,34,150,6,144,150,6,144,,,
490674,34,1,0,1,1,0,1,,,
490692,34,51,44,7,51,44,7,,,
490717,34,59,2,57,59,2,57,,,
490735,34,70,7,63,70,7,63,,,
490744,34,21,18,3,21,18,3,,,
490753,34,2,0,2,2,0,2,,,
490805,34,5329,2212,3117,3627,1656,1971,1702,556,1146
490814,34,50,4,46,50,4,46,,,
490832,34,225,10,215,177,8,169,48,2,46
490841,34,151,1,150,151,1,150,,,
490869,34,348,35,313,348,35,313,,,
490878,34,379,81,298,379,81,298,,,
490896,34,105,6,99,70,5,65,35,1,34
490948,34,6,4,2,6,4,2,,,
490975,34,364,44,320,336,39,297,28,5,23
491057,34,188,188,0,188,188,0,,,
491066,34,33,0,33,21,0,21,12,0,12
491075,34,3,3,0,3,3,0,,,
491084,34,15,0,15,15,0,15,,,
491136,34,34,2,32,16,2,14,18,0,18
491145,34,55,1,54,37,0,37,18,1,17
491181,34,342,50,292,220,30,190,122,20,102
491190,34,2,2,0,2,2,0,,,
491215,34,32,30,2,32,30,2,,,
491224,34,95,8,87,66,5,61,29,3,26
491233,34,27,0,27,16,0,16,11,0,11
491242,34,40,18,22,40,18,22,,,
491251,34,85,43,42,85,43,42,,,
491260,34,11,0,11,3,0,3,8,0,8
491288,34,619,187,432,57,15,42,562,172,390
491297,34,131,54,77,7,3,4,124,51,73
491394,34,72,68,4,72,68,4,,,
491446,34,40,0,40,40,0,40,,,
491464,34,44,6,38,44,6,38,,,
491473,34,369,273,96,29,1,28,340,272,68
491507,34,64,7,57,64,7,57,,,
491525,34,52,38,14,37,28,9,15,10,5
491534,34,4,0,4,,,,4,0,4
491543,34,89,13,76,56,11,45,33,2,31
491552,34,2,0,2,2,0,2,,,
491570,34,1,0,1,1,0,1,,,
491589,34,26,21,5,5,4,1,21,17,4
491598,34,22,3,19,22,3,19,,,
491613,34,55,55,0,55,55,0,,,
491622,34,60,60,0,60,60,0,,,
491631,34,89,0,89,61,0,61,28,0,28
491640,34,129,129,0,129,129,0,,,
491659,34,57,30,27,57,30,27,,,
491668,34,142,1,141,142,1,141,,,
491677,34,10,5,5,5,2,3,5,3,2
491686,34,32,29,3,32,29,3,,,
491695,34,40,11,29,40,11,29,,,
491701,34,35,6,29,,,,35,6,29
491710,34,52,52,0,52,52,0,,,
491729,34,21,0,21,21,0,21,,,
491738,34,42,4,38,40,4,36,2,0,2
491747,34,5,4,1,5,4,1,,,
491756,34,80,70,10,80,70,10,,,
491765,34,71,71,0,71,71,0,,,
491774,34,111,15,96,76,9,67,35,6,29
491783,34,11,9,2,6,4,2,5,5,0
491792,34,68,2,66,68,2,66,,,
491817,34,99,0,99,44,0,44,55,0,55
491826,34,81,0,81,81,0,81,,,
491835,34,45,0,45,45,0,45,,,
491844,34,60,17,43,33,12,21,27,5,22
491853,34,42,0,42,42,0,42,,,
491871,34,8,0,8,3,0,3,5,0,5
491880,34,84,81,3,84,81,3,,,
491899,34,61,3,58,9,1,8,52,2,50
491905,34,70,2,68,70,2,68,,,
491914,34,142,142,0,142,142,0,,,
491923,34,134,3,131,129,2,127,5,1,4
491932,34,10,10,0,10,10,0,,,
491941,34,96,4,92,96,4,92,,,
491950,34,772,118,654,45,8,37,727,110,617
491969,34,16,2,14,16,2,14,,,
491978,34,33,10,23,6,3,3,27,7,20
491996,34,20,2,18,20,2,18,,,
492005,34,32,0,32,26,0,26,6,0,6
492032,34,10,0,10,,,,10,0,10
492069,34,76,48,28,69,46,23,7,2,5
492078,34,7,6,1,,,,7,6,1
492096,34,5,1,4,5,1,4,,,
492139,34,45,34,11,45,34,11,,,
492157,34,36,30,6,36,30,6,,,
492281,34,9,9,0,9,9,0,,,
492315,34,18,1,17,,,,18,1,17
492324,34,143,11,132,,,,143,11,132
492360,34,42,10,32,20,3,17,22,7,15
492379,34,1,1,0,1,1,0,,,
492421,34,3,3,0,3,3,0,,,
492449,34,485,94,391,485,94,391,,,
492476,34,116,32,84,23,9,14,93,23,70
492591,34,62,49,13,62,49,13,,,
492643,34,58,19,39,58,19,39,,,
492652,34,27,21,6,27,21,6,,,
492661,34,263,42,221,261,42,219,2,0,2
492689,34,266,47,219,202,39,163,64,8,56
492722,34,288,27,261,288,27,261,,,
492731,34,102,19,83,102,19,83,,,
492759,34,305,22,283,133,11,122,172,11,161
492801,34,729,259,470,410,140,270,319,119,200
492935,34,20,3,17,20,3,17,,,
492953,34,72,6,66,39,6,33,33,0,33
492962,34,2707,1006,1701,1169,414,755,1538,592,946
493071,34,320,79,241,320,79,241,,,
493080,34,285,137,148,9,3,6,276,134,142
493132,34,647,625,22,647,625,22,,,
493150,34,132,10,122,132,10,122,,,
493372,34,16,2,14,16,2,14,,,
493451,34,58,13,45,58,13,45,,,
493479,34,3,1,2,3,1,2,,,
493488,34,15,2,13,15,2,13,,,
493503,34,17,9,8,17,9,8,,,
493512,34,140,84,56,140,84,56,,,
493521,34,10,8,2,9,7,2,1,1,0
493530,34,19,8,11,10,4,6,9,4,5
493549,34,97,90,7,97,90,7,,,
493558,34,1,1,0,1,1,0,,,
493567,34,45,2,43,,,,45,2,43
493576,34,11,0,11,11,0,11,,,
493585,34,37,4,33,37,4,33,,,
493594,34,27,27,0,27,27,0,,,
493600,34,125,125,0,125,125,0,,,
493619,34,15,6,9,9,5,4,6,1,5
493628,34,145,12,133,83,8,75,62,4,58
493637,34,45,0,45,45,0,45,,,
493646,34,90,0,90,90,0,90,,,
493655,34,5,2,3,5,2,3,,,
493664,34,59,59,0,58,58,0,1,1,0
493682,34,60,5,55,50,4,46,10,1,9
493691,34,22,0,22,16,0,16,6,0,6
493707,34,58,58,0,58,58,0,,,
493716,34,47,47,0,47,47,0,,,
493725,34,644,221,423,415,135,280,229,86,143
493734,34,1,1,0,1,1,0,,,
493743,34,5,2,3,4,2,2,1,0,1
493752,34,14,1,13,14,1,13,,,
493761,34,69,19,50,8,3,5,61,16,45
493770,34,10,1,9,10,1,9,,,
493789,34,50,0,50,16,0,16,34,0,34
493798,34,7,0,7,,,,7,0,7
493804,34,3,2,1,3,2,1,,,
493813,34,107,7,100,107,7,100,,,
493822,34,161,36,125,109,25,84,52,11,41
493831,34,33,25,8,33,25,8,,,
493868,34,3,3,0,2,2,0,1,1,0
493895,34,147,130,17,38,35,3,109,95,14
493910,34,2,0,2,1,0,1,1,0,1
493992,34,115,34,81,115,34,81,,,
494001,34,70,5,65,13,2,11,57,3,54
494029,34,20,15,5,11,10,1,9,5,4
494162,34,219,16,203,109,6,103,110,10,100
494232,34,18,0,18,15,0,15,3,0,3
494250,34,328,22,306,328,22,306,,,
494269,34,31,27,4,4,3,1,27,24,3
494278,34,198,48,150,54,14,40,144,34,110
494287,34,274,86,188,83,21,62,191,65,126
494357,34,765,267,498,765,267,498,,,
494436,34,274,52,222,274,52,222,,,
494463,34,137,0,137,137,0,137,,,
494472,34,5,0,5,4,0,4,1,0,1
494524,34,84,3,81,77,0,77,7,3,4
494588,34,207,15,192,207,15,192,,,
494597,34,49,25,24,40,21,19,9,4,5
494603,34,180,108,72,126,75,51,54,33,21
494621,34,57,8,49,,,,57,8,49
494630,34,36,18,18,30,16,14,6,2,4
494649,34,24,0,24,16,0,16,8,0,8
494658,34,31,1,30,24,1,23,7,0,7
494685,34,389,157,232,322,125,197,67,32,35
494694,34,62,1,61,57,1,56,5,0,5
494700,34,50,1,49,48,1,47,2,0,2
494719,34,25,19,6,16,10,6,9,9,0
494728,34,29,21,8,27,20,7,2,1,1
494737,34,135,135,0,135,135,0,,,
494746,34,161,20,141,161,20,141,,,
494755,34,56,3,53,56,3,53,,,
494764,34,159,145,14,129,119,10,30,26,4
494807,34,34,5,29,34,5,29,,,
494843,34,510,33,477,510,33,477,,,
494852,34,354,71,283,354,71,283,,,
494898,34,79,13,66,79,13,66,,,
494904,34,36,9,27,13,5,8,23,4,19
494959,34,51,11,40,7,2,5,44,9,35
494977,34,16,2,14,16,2,14,,,
494986,34,39,2,37,27,2,25,12,0,12
494995,34,15,13,2,15,13,2,,,
495013,34,110,94,16,,,,110,94,16
495031,34,56,56,0,53,53,0,3,3,0
495040,34,26,1,25,26,1,25,,,
495059,34,29,14,15,28,14,14,1,0,1
495077,34,16,2,14,16,2,14,,,
495101,34,22,1,21,22,1,21,,,
495110,34,10,8,2,10,8,2,,,
495129,34,74,58,16,74,58,16,,,
495138,34,1,0,1,1,0,1,,,
495147,34,16,7,9,7,5,2,9,2,7
495165,34,24,3,21,24,3,21,,,
495174,34,22,8,14,,,,22,8,14
495183,34,106,48,58,106,48,58,,,
495208,34,6,6,0,6,6,0,,,
495217,34,4,2,2,4,2,2,,,
495226,34,4,0,4,4,0,4,,,
495235,34,10,1,9,6,1,5,4,0,4
495244,34,1,1,0,1,1,0,,,
495253,34,23,1,22,22,1,21,1,0,1
495262,34,20,0,20,10,0,10,10,0,10
495271,34,23,5,18,,,,23,5,18
495280,34,21,11,10,10,5,5,11,6,5
495299,34,24,3,21,24,3,21,,,
495305,34,47,9,38,19,4,15,28,5,23
495341,34,45,32,13,44,31,13,1,1,0
495350,34,31,17,14,31,17,14,,,
495369,34,63,12,51,41,10,31,22,2,20
495378,34,69,5,64,7,0,7,62,5,57
495387,34,26,21,5,11,9,2,15,12,3
495396,34,8,0,8,8,0,8,,,
495411,34,104,7,97,100,5,95,4,2,2
495420,34,219,21,198,111,13,98,108,8,100
495439,34,222,17,205,105,9,96,117,8,109
495448,34,478,54,424,269,29,240,209,25,184
495457,34,371,36,335,222,21,201,149,15,134
495518,34,36,1,35,25,0,25,11,1,10
495730,34,64,0,64,51,0,51,13,0,13
495767,34,56180,30232,25948,48775,26304,22471,7405,3928,3477
495776,34,30,26,4,30,26,4,,,
495794,34,223,5,218,167,2,165,56,3,53
495837,34,86,4,82,86,4,82,,,
495916,34,9,2,7,6,1,5,3,1,2
495925,34,57,2,55,57,2,55,,,
495934,34,73,5,68,73,5,68,,,
495943,34,32,2,30,32,2,30,,,
495952,34,124,33,91,124,33,91,,,
495961,34,112,14,98,112,14,98,,,
495970,34,221,68,153,221,68,153,,,
495998,34,57,6,51,57,6,51,,,
496052,34,12,8,4,12,8,4,,,
496061,34,23,0,23,6,0,6,17,0,17
496186,34,111,102,9,111,102,9,,,
496265,34,36,30,6,36,30,6,,,
496283,34,102,11,91,102,11,91,,,
496292,34,6,6,0,6,6,0,,,
496326,34,144,14,130,144,14,130,,,
496371,34,9,9,0,9,9,0,,,
496399,34,13,4,9,13,4,9,,,
496478,34,58,40,18,,,,58,40,18
496511,34,5,0,5,4,0,4,1,0,1
496520,34,26,5,21,,,,26,5,21
496539,34,53,1,52,33,1,32,20,0,20
496593,34,227,126,101,227,126,101,,,
496618,34,53,3,50,53,3,50,,,
496627,34,160,81,79,160,81,79,,,
496636,34,120,22,98,120,22,98,,,
496645,34,116,63,53,21,2,19,95,61,34
496663,34,2,1,1,1,0,1,1,1,0
496672,34,33,4,29,20,4,16,13,0,13
496681,34,54,4,50,54,4,50,,,
496690,34,20,1,19,13,0,13,7,1,6
496706,34,98,64,34,98,64,34,,,
496715,34,15,1,14,9,1,8,6,0,6
496724,34,15,0,15,15,0,15,,,
496733,34,30,0,30,30,0,30,,,
496742,34,1,0,1,1,0,1,,,
496751,34,10,0,10,10,0,10,,,
496894,34,5,0,5,4,0,4,1,0,1
496919,34,732,286,446,732,286,446,,,
496955,34,146,63,83,146,63,83,,,
496964,34,12,7,5,12,7,5,,,
496973,34,50,3,47,17,0,17,33,3,30
496991,34,83,7,76,42,4,38,41,3,38
497000,34,182,35,147,182,35,147,,,
497037,34,383,72,311,291,56,235,92,16,76
497046,34,2820,853,1967,334,100,234,2486,753,1733
497073,34,243,3,240,137,0,137,106,3,103
497116,34,17,3,14,4,1,3,13,2,11
497161,34,26,22,4,21,17,4,5,5,0
497189,34,6,0,6,6,0,6,,,
497198,34,5,0,5,4,0,4,1,0,1
497204,34,4,3,1,1,0,1,3,3,0
497213,34,24,10,14,13,6,7,11,4,7
497222,34,20,0,20,11,0,11,9,0,9
497268,34,166,21,145,96,12,84,70,9,61
497277,34,382,41,341,382,41,341,,,
497301,34,52,1,51,22,1,21,30,0,30
497310,34,72,0,72,72,0,72,,,
497329,34,50,9,41,50,9,41,,,
497338,34,32,4,28,32,4,28,,,
100654,35,207,94,113,180,82,98,27,12,15
100663,35,1234,476,758,815,322,493,419,154,265
100690,35,218,74,144,118,41,77,100,33,67
100706,35,627,306,321,455,221,234,172,85,87
100724,35,133,52,81,125,49,76,8,3,5
100751,35,1402,624,778,989,467,522,413,157,256
100760,35,88,23,65,35,12,23,53,11,42
100812,35,700,203,497,444,134,310,256,69,187
100830,35,377,130,247,300,110,190,77,20,57
100858,35,1147,625,522,1005,556,449,142,69,73
100937,35,22,14,8,22,14,8,,,
101028,35,151,40,111,56,17,39,95,23,72
101116,35,74,12,62,46,7,39,28,5,23
101143,35,104,46,58,66,32,34,38,14,24
101161,35,439,149,290,207,80,127,232,69,163
101189,35,268,108,160,174,71,103,94,37,57
101240,35,373,106,267,189,66,123,184,40,144
101286,35,255,69,186,108,38,70,147,31,116
101295,35,413,110,303,203,61,142,210,49,161
101301,35,77,24,53,35,21,14,42,3,39
101365,35,35,4,31,7,0,7,28,4,24
101435,35,46,22,24,46,22,24,,,
101453,35,13,11,2,5,5,0,8,6,2
101462,35,121,48,73,39,17,22,82,31,51
101480,35,554,205,349,461,191,270,93,14,79
101505,35,709,227,482,253,87,166,456,140,316
101514,35,484,201,283,194,95,99,290,106,184
101569,35,316,101,215,119,47,72,197,54,143
101587,35,463,119,344,420,101,319,43,18,25
101602,35,109,32,77,50,15,35,59,17,42
101648,35,1,1,0,1,1,0,,,
101675,35,127,70,57,115,60,55,12,10,2
101693,35,100,34,66,93,31,62,7,3,4
101709,35,168,65,103,153,61,92,15,4,11
101736,35,108,34,74,46,20,26,62,14,48
101879,35,558,213,345,452,178,274,106,35,71
101897,35,47,10,37,19,4,15,28,6,22
101912,35,45,23,22,44,23,21,1,0,1
101994,35,46,4,42,17,3,14,29,1,28
102030,35,187,60,127,93,35,58,94,25,69
102049,35,100,48,52,96,47,49,4,1,3
102067,35,464,197,267,127,70,57,337,127,210
102076,35,144,56,88,62,32,30,82,24,58
102094,35,746,254,492,613,210,403,133,44,89
102234,35,52,27,25,46,22,24,6,5,1
102270,35,57,16,41,52,16,36,5,0,5
102298,35,50,30,20,49,30,19,1,0,1
102313,35,182,51,131,76,29,47,106,22,84
102368,35,1036,335,701,594,194,400,442,141,301
102377,35,70,31,39,66,29,37,4,2,2
102395,35,10,7,3,2,2,0,8,5,3
102429,35,170,60,110,57,26,31,113,34,79
102553,35,405,159,246,222,107,115,183,52,131
102580,35,6,4,2,2,2,0,4,2,2
102614,35,390,174,216,215,106,109,175,68,107
102632,35,140,50,90,63,34,29,77,16,61
102669,35,103,24,79,80,23,57,23,1,22
102845,35,18,3,15,18,3,15,,,
103501,35,2,0,2,2,0,2,,,
103893,35,126,26,100,126,26,100,,,
103909,35,84,17,67,84,17,67,,,
103927,35,41,6,35,41,6,35,,,
104090,35,193,29,164,193,29,164,,,
104151,35,4779,2362,2417,4116,2021,2095,663,341,322
104160,35,246,107,139,72,34,38,174,73,101
104179,35,2639,1213,1426,1760,807,953,879,406,473
104346,35,857,259,598,180,71,109,677,188,489
104425,35,115,40,75,37,19,18,78,21,57
104577,35,206,108,98,58,28,30,148,80,68
104586,35,118,96,22,112,94,18,6,2,4
104708,35,1211,540,671,365,192,173,846,348,498
104717,35,10648,2970,7678,1874,872,1002,8774,2098,6676
105145,35,910,286,624,183,71,112,727,215,512
105154,35,1777,783,994,525,269,256,1252,514,738
105206,35,127,29,98,30,6,24,97,23,74
105215,35,98,94,4,98,94,4,,,
105297,35,48,10,38,33,5,28,15,5,10
105330,35,2053,716,1337,1427,553,874,626,163,463
105349,35,434,122,312,70,20,50,364,102,262
105367,35,51,7,44,38,2,36,13,5,8
105428,35,1056,372,684,320,132,188,736,240,496
105525,35,1049,432,617,228,119,109,821,313,508
105534,35,567,90,477,567,90,477,,,
105543,35,116,18,98,116,18,98,,,
105589,35,58,21,37,55,20,35,3,1,2
105668,35,981,377,604,213,113,100,768,264,504
105747,35,898,363,535,218,98,120,680,265,415
105792,35,396,151,245,99,40,59,297,111,186
105899,35,146,87,59,134,82,52,12,5,7
106041,35,211,195,16,211,195,16,,,
106148,35,216,98,118,84,48,36,132,50,82
106245,35,750,231,519,448,152,296,302,79,223
106263,35,509,67,442,360,48,312,149,19,130
106306,35,80,60,20,69,52,17,11,8,3
106342,35,33,23,10,33,23,10,,,
106397,35,1616,685,931,1189,586,603,427,99,328
106412,35,147,63,84,135,59,76,12,4,8
106449,35,104,43,61,79,38,41,25,5,20
106458,35,752,250,502,378,158,220,374,92,282
106467,35,264,119,145,210,107,103,54,12,42
106485,35,131,59,72,119,56,63,12,3,9
106546,35,229,28,201,199,27,172,30,1,29
106625,35,145,54,91,86,37,49,59,17,42
106704,35,485,197,288,432,183,249,53,14,39
106713,35,55,36,19,54,36,18,1,0,1
106795,35,36,19,17,19,11,8,17,8,9
106810,35,15,8,7,15,8,7,,,
106883,35,46,9,37,28,6,22,18,3,15
106980,35,101,49,52,57,32,25,44,17,27
106999,35,37,4,33,24,4,20,13,0,13
107044,35,116,44,72,107,40,67,9,4,5
107071,35,136,60,76,114,56,58,22,4,18
107080,35,16,6,10,16,6,10,,,
107141,35,71,29,42,57,23,34,14,6,8
107318,35,38,14,24,14,3,11,24,11,13
107327,35,40,11,29,20,9,11,20,2,18
107460,35,71,24,47,43,17,26,28,7,21
107512,35,45,21,24,44,21,23,1,0,1
107521,35,66,11,55,45,9,36,21,2,19
107549,35,51,16,35,35,15,20,16,1,15
107558,35,46,23,23,46,23,23,,,
107585,35,149,54,95,75,34,41,74,20,54
107600,35,51,13,38,44,10,34,7,3,4
107619,35,25,9,16,18,8,10,7,1,6
107637,35,80,17,63,28,6,22,52,11,41
107664,35,381,123,258,228,82,146,153,41,112
107725,35,45,9,36,13,4,9,32,5,27
107743,35,33,12,21,17,6,11,16,6,10
107877,35,42,24,18,42,24,18,,,
107974,35,155,42,113,66,24,42,89,18,71
107983,35,116,53,63,111,51,60,5,2,3
107992,35,106,58,48,55,28,27,51,30,21
108092,35,315,122,193,223,93,130,92,29,63
108232,35,734,329,405,344,173,171,390,156,234
108667,35,879,354,525,71,32,39,808,322,486
108807,35,415,251,164,124,82,42,291,169,122
108852,35,41,18,23,41,18,23,,,
109040,35,249,51,198,249,51,198,,,
109208,35,3715,1850,1865,390,190,200,3325,1660,1665
109350,35,493,243,250,135,74,61,358,169,189
109651,35,140,60,80,139,60,79,1,0,1
109785,35,230,97,133,206,89,117,24,8,16
109819,35,1063,582,481,275,138,137,788,444,344
109907,35,387,116,271,117,40,77,270,76,194
110060,35,21,21,0,21,21,0,,,
110097,35,401,167,234,328,143,185,73,24,49
110219,35,110,30,80,110,30,80,,,
110246,35,920,426,494,393,224,169,527,202,325
110316,35,51,8,43,47,7,40,4,1,3
110334,35,564,221,343,130,61,69,434,160,274
110361,35,994,319,675,848,282,566,146,37,109
110370,35,88,35,53,88,35,53,,,
110404,35,4,4,0,4,4,0,,,
110413,35,165,89,76,159,86,73,6,3,3
110422,35,852,453,399,820,434,386,32,19,13
110468,35,109,28,81,,,,109,28,81
110486,35,984,314,670,796,261,535,188,53,135
110495,35,1386,414,972,1105,336,769,281,78,203
110510,35,2829,998,1831,2092,736,1356,737,262,475
110529,35,3274,1642,1632,2893,1433,1460,381,209,172
110538,35,1458,618,840,1296,563,733,162,55,107
110547,35,2709,938,1771,1948,703,1245,761,235,526
110556,35,2688,1005,1683,2176,832,1344,512,173,339
110565,35,4188,1658,2530,3277,1329,1948,911,329,582
110574,35,2076,746,1330,1588,568,1020,488,178,310
110583,35,4500,1860,2640,3748,1545,2203,752,315,437
110592,35,3911,1488,2423,3063,1150,1913,848,338,510
110608,35,6089,2608,3481,4661,1965,2696,1428,643,785
110617,35,4453,1722,2731,3429,1318,2111,1024,404,620
110635,35,2679,1262,1417,2547,1200,1347,132,62,70
110644,35,2978,1275,1703,2905,1241,1664,73,34,39
110653,35,2878,1328,1550,2839,1310,1529,39,18,21
110662,35,3434,1419,2015,3382,1386,1996,52,33,19
110671,35,2056,1070,986,1979,1028,951,77,42,35
110680,35,3602,1726,1876,3524,1685,1839,78,41,37
110705,35,2099,973,1126,2026,931,1095,73,42,31
110714,35,1747,980,767,1677,940,737,70,40,30
110778,35,2,1,1,2,1,1,,,
110918,35,3,2,1,2,1,1,1,1,0
111045,35,7,2,5,7,2,5,,,
111081,35,78,37,41,78,37,41,,,
111188,35,70,56,14,68,55,13,2,1,1
111434,35,729,325,404,18,8,10,711,317,394
111461,35,832,361,471,196,98,98,636,263,373
111638,35,59,25,34,59,25,34,,,
111887,35,1575,687,888,418,161,257,1157,526,631
111896,35,600,232,368,79,52,27,521,180,341
111920,35,1056,526,530,175,81,94,881,445,436
111939,35,1310,467,843,343,128,215,967,339,628
111948,35,384,172,212,373,166,207,11,6,5
111966,35,95,34,61,55,27,28,40,7,33
112075,35,193,77,116,179,74,105,14,3,11
112084,35,59,26,33,57,26,31,2,0,2
112172,35,663,294,369,205,107,98,458,187,271
112190,35,1090,499,591,278,168,110,812,331,481
112260,35,21,11,10,21,11,10,,,
112385,35,1414,652,762,83,46,37,1331,606,725
112394,35,22,17,5,19,16,3,3,1,2
112561,35,152,75,77,32,16,16,120,59,61
112570,35,63,43,20,63,43,20,,,
112686,35,317,114,203,85,44,41,232,70,162
112826,35,631,241,390,86,40,46,545,201,344
113096,35,1967,765,1202,151,69,82,1816,696,1120
113111,35,504,219,285,94,47,47,410,172,238
113193,35,665,298,367,213,94,119,452,204,248
113218,35,1003,410,593,88,49,39,915,361,554
113236,35,1358,484,874,276,106,170,1082,378,704
113333,35,1005,424,581,312,166,146,693,258,435
113573,35,416,194,222,128,61,67,288,133,155
113582,35,19,1,18,13,1,12,6,0,6
113634,35,1365,586,779,269,134,135,1096,452,644
113698,35,64,18,46,60,17,43,4,1,3
113856,35,2971,1117,1854,272,129,143,2699,988,1711
113980,35,1105,412,693,342,135,207,763,277,486
114266,35,549,238,311,61,27,34,488,211,277
114354,35,272,42,230,259,39,220,13,3,10
114433,35,146,80,66,24,15,9,122,65,57
114716,35,1329,587,742,249,110,139,1080,477,603
114789,35,1676,667,1009,358,162,196,1318,505,813
114813,35,455,126,329,213,78,135,242,48,194
114859,35,1423,596,827,296,148,148,1127,448,679
114938,35,616,385,231,112,69,43,504,316,188
115001,35,644,285,359,248,118,130,396,167,229
115010,35,77,16,61,77,16,61,,,
115083,35,186,137,49,113,83,30,73,54,19
115126,35,1341,559,782,180,85,95,1161,474,687
115296,35,911,336,575,193,77,116,718,259,459
115393,35,770,476,294,81,32,49,689,444,245
115409,35,10,3,7,10,3,7,,,
115728,35,58,28,30,57,27,30,1,1,0
115755,35,758,322,436,675,280,395,83,42,41
115773,35,45,12,33,30,10,20,15,2,13
115861,35,110,51,59,36,15,21,74,36,38
115931,35,35,25,10,35,25,10,,,
116226,35,1,0,1,,,,1,0,1
116439,35,928,456,472,189,109,80,739,347,392
116846,35,10,1,9,10,1,9,,,
117052,35,451,183,268,72,49,23,379,134,245
117104,35,53,22,31,47,19,28,6,3,3
117140,35,293,125,168,208,91,117,85,34,51
117168,35,64,22,42,61,21,40,3,1,2
117195,35,330,222,108,74,45,29,256,177,79
117247,35,908,431,477,127,76,51,781,355,426
117274,35,198,164,34,65,51,14,133,113,20
117283,35,6,2,4,2,1,1,4,1,3
117557,35,16,16,0,16,16,0,,,
117575,35,3,2,1,1,1,0,2,1,1
117627,35,96,47,49,87,45,42,9,2,7
117636,35,235,66,169,203,60,143,32,6,26
117645,35,1883,795,1088,607,252,355,1276,543,733
117672,35,94,15,79,1,0,1,93,15,78
117690,35,1084,413,671,78,39,39,1006,374,632
117706,35,1419,565,854,144,57,87,1275,508,767
117715,35,947,305,642,41,13,28,906,292,614
117724,35,1530,825,705,217,126,91,1313,699,614
117733,35,1587,627,960,127,63,64,1460,564,896
117751,35,253,159,94,208,124,84,45,35,10
117788,35,2025,838,1187,222,115,107,1803,723,1080
117803,35,57,16,41,,,,57,16,41
117867,35,1264,446,818,77,34,43,1187,412,775
117894,35,564,252,312,128,78,50,436,174,262
117946,35,478,192,286,475,190,285,3,2,1
118198,35,313,67,246,313,67,246,,,
118347,35,304,102,202,66,25,41,238,77,161
118541,35,94,40,54,91,40,51,3,0,3
118684,35,235,51,184,71,15,56,164,36,128
118693,35,55,36,19,54,36,18,1,0,1
118718,35,451,159,292,160,60,100,291,99,192
118772,35,1135,428,707,161,69,92,974,359,615
118888,35,48,0,48,34,0,34,14,0,14
118912,35,1110,396,714,295,115,180,815,281,534
118930,35,683,299,384,143,81,62,540,218,322
118976,35,599,193,406,186,64,122,413,129,284
119058,35,4,2,2,4,2,2,,,
119067,35,705,386,319,168,89,79,537,297,240
119137,35,1040,403,637,135,56,79,905,347,558
119164,35,1512,679,833,541,259,282,971,420,551
119173,35,184,22,162,161,20,141,23,2,21
119216,35,1055,397,658,299,123,176,756,274,482
119270,35,93,70,23,71,55,16,22,15,7
119331,35,227,106,121,62,32,30,165,74,91
119605,35,2718,1346,1372,890,451,439,1828,895,933
119775,35,35,20,15,32,18,14,3,2,1
120078,35,29,6,23,29,6,23,,,
120166,35,5,2,3,4,2,2,1,0,1
120254,35,29,13,16,29,13,16,,,
120290,35,590,306,284,69,34,35,521,272,249
120342,35,1564,688,876,328,167,161,1236,521,715
120403,35,125,50,75,120,48,72,5,2,3
120421,35,791,362,429,61,30,31,730,332,398
120537,35,74,48,26,66,45,21,8,3,5
120698,35,29,11,18,29,11,18,,,
120768,35,101,13,88,,,,101,13,88
120865,35,82,28,54,77,27,50,5,1,4
120883,35,148,73,75,142,71,71,6,2,4
120953,35,340,315,25,43,42,1,297,273,24
120971,35,920,467,453,247,133,114,673,334,339
121044,35,1345,571,774,362,172,190,983,399,584
121150,35,149,63,86,107,44,63,42,19,23
121257,35,18,6,12,16,6,10,2,0,2
121275,35,29,20,9,29,20,9,,,
121309,35,311,126,185,152,64,88,159,62,97
121345,35,12,8,4,12,8,4,,,
121363,35,203,79,124,33,23,10,170,56,114
121619,35,1810,965,845,253,162,91,1557,803,754
121691,35,139,54,85,78,34,44,61,20,41
121707,35,308,158,150,100,55,45,208,103,105
121886,35,1013,592,421,215,112,103,798,480,318
121901,35,1563,609,954,373,174,199,1190,435,755
122180,35,2642,1055,1587,341,140,201,2301,915,1386
122205,35,1510,559,951,243,112,131,1267,447,820
122296,35,203,52,151,163,44,119,40,8,32
122339,35,2436,1083,1353,239,110,129,2197,973,1224
122375,35,2386,1046,1340,319,168,151,2067,878,1189
122384,35,2076,983,1093,203,136,67,1873,847,1026
122409,35,4038,1729,2309,3606,1546,2060,432,183,249
122436,35,342,199,143,337,195,142,5,4,1
122454,35,3,1,2,3,1,2,,,
122506,35,7,5,2,7,5,2,,,
122597,35,2987,1380,1607,2502,1147,1355,485,233,252
122612,35,348,135,213,324,127,197,24,8,16
122658,35,614,229,385,275,111,164,339,118,221
122685,35,242,72,170,242,72,170,,,
122694,35,85,25,60,85,25,60,,,
122728,35,217,103,114,177,89,88,40,14,26
122746,35,862,391,471,127,60,67,735,331,404
122755,35,3782,1897,1885,2997,1506,1491,785,391,394
122791,35,705,331,374,74,46,28,631,285,346
122889,35,886,354,532,350,153,197,536,201,335
122931,35,235,131,104,232,130,102,3,1,2
122977,35,1772,699,1073,501,230,271,1271,469,802
123013,35,669,312,357,134,61,73,535,251,284
123165,35,14,0,14,14,0,14,,,
123217,35,520,220,300,160,73,87,360,147,213
123280,35,1,1,0,1,1,0,,,
123299,35,311,119,192,129,59,70,182,60,122
123341,35,786,413,373,257,139,118,529,274,255
123457,35,136,61,75,122,56,66,14,5,9
123484,35,118,68,50,93,56,37,25,12,13
123509,35,723,306,417,53,23,30,670,283,387
123527,35,914,374,540,238,123,115,676,251,425
123554,35,125,50,75,109,43,66,16,7,9
123563,35,540,233,307,113,48,65,427,185,242
123572,35,882,336,546,744,290,454,138,46,92
123642,35,32,5,27,20,4,16,12,1,11
123651,35,146,70,76,108,57,51,38,13,25
123800,35,870,381,489,298,133,165,572,248,324
123952,35,32,18,14,32,18,14,,,
123961,35,1353,656,697,1343,655,688,10,1,9
124113,35,395,224,171,64,23,41,331,201,130
124292,35,19,9,10,19,9,10,,,
124487,35,3,2,1,,,,3,2,1
125028,35,1056,422,634,118,50,68,938,372,566
125091,35,545,246,299,180,92,88,365,154,211
125170,35,837,312,525,69,29,40,768,283,485
125231,35,1620,208,1412,525,78,447,1095,130,965
125462,35,357,212,145,42,32,10,315,180,135
125471,35,2035,778,1257,159,68,91,1876,710,1166
125499,35,642,268,374,90,41,49,552,227,325
125532,35,297,36,261,297,36,261,,,
125727,35,53,27,26,53,27,26,,,
125763,35,69,27,42,66,26,40,3,1,2
125897,35,109,48,61,106,48,58,3,0,3
126076,35,14,14,0,14,14,0,,,
126119,35,480,180,300,60,31,29,420,149,271
126182,35,164,112,52,114,72,42,50,40,10
126207,35,269,97,172,131,56,75,138,41,97
126289,35,951,350,601,333,153,180,618,197,421
126359,35,23,2,21,23,2,21,,,
126562,35,1462,593,869,1139,473,666,323,120,203
126580,35,1464,666,798,1124,515,609,340,151,189
126605,35,11,10,1,11,10,1,,,
126614,35,1563,955,608,1365,823,542,198,132,66
126669,35,710,177,533,97,42,55,613,135,478
126678,35,27,9,18,27,9,18,,,
126711,35,185,81,104,98,52,46,87,29,58
126748,35,160,63,97,98,51,47,62,12,50
126775,35,121,88,33,105,78,27,16,10,6
126784,35,12,12,0,12,12,0,,,
126818,35,1632,765,867,1246,595,651,386,170,216
126827,35,2217,295,1922,1535,202,1333,682,93,589
126863,35,393,180,213,161,89,72,232,91,141
126942,35,748,267,481,195,79,116,553,188,365
126951,35,5,4,1,5,4,1,,,
127060,35,226,106,120,198,92,106,28,14,14
127185,35,264,115,149,224,104,120,40,11,29
127200,35,1581,645,936,512,270,242,1069,375,694
127389,35,48,18,30,27,14,13,21,4,17
127556,35,508,249,259,388,196,192,120,53,67
127565,35,1829,761,1068,1111,485,626,718,276,442
127617,35,73,23,50,28,8,20,45,15,30
127653,35,90,18,72,77,14,63,13,4,9
127714,35,50,25,25,,,,50,25,25
127732,35,123,66,57,57,31,26,66,35,31
127741,35,584,205,379,459,184,275,125,21,104
127778,35,153,67,86,97,54,43,56,13,43
127820,35,1549,595,954,522,253,269,1027,342,685
127884,35,499,130,369,156,54,102,343,76,267
127909,35,709,336,373,224,127,97,485,209,276
127918,35,91,32,59,52,18,34,39,14,25
127945,35,219,46,173,117,26,91,102,20,82
128106,35,311,150,161,215,101,114,96,49,47
128179,35,93,67,26,93,67,26,,,
128188,35,99,30,69,99,30,69,,,
128258,35,134,72,62,60,37,23,74,35,39
128391,35,94,56,38,84,50,34,10,6,4
128498,35,57,26,31,54,25,29,3,1,2
128577,35,97,39,58,42,24,18,55,15,40
128586,35,1,1,0,1,1,0,,,
128744,35,177,40,137,154,37,117,23,3,20
128771,35,724,369,355,586,300,286,138,69,69
128780,35,392,73,319,98,20,78,294,53,241
128902,35,26,10,16,26,10,16,,,
129020,35,643,320,323,610,301,309,33,19,14
129154,35,607,95,512,119,32,87,488,63,425
129215,35,294,126,168,260,110,150,34,16,18
129242,35,33,12,21,33,12,21,,,
129367,35,263,66,197,59,24,35,204,42,162
129525,35,126,72,54,99,59,40,27,13,14
129534,35,21,8,13,8,5,3,13,3,10
129543,35,261,79,182,112,38,74,149,41,108
129695,35,419,156,263,156,66,90,263,90,173
129729,35,356,133,223,134,58,76,222,75,147
129756,35,172,52,120,64,19,45,108,33,75
129774,35,28,17,11,24,16,8,4,1,3
129808,35,172,59,113,60,29,31,112,30,82
129941,35,219,99,120,187,79,108,32,20,12
130004,35,259,103,156,79,44,35,180,59,121
130040,35,79,25,54,35,15,20,44,10,34
130110,35,69,28,41,53,23,30,16,5,11
130183,35,2404,647,1757,1158,295,863,1246,352,894
130217,35,74,33,41,32,14,18,42,19,23
130226,35,194,63,131,169,56,113,25,7,18
130253,35,168,65,103,131,60,71,37,5,32
130314,35,49,5,44,44,4,40,5,1,4
130396,35,463,151,312,160,64,96,303,87,216
130493,35,759,298,461,590,245,345,169,53,116
130590,35,23,18,5,22,18,4,1,0,1
130606,35,303,119,184,130,53,77,173,66,107
130697,35,33,11,22,33,11,22,,,
130776,35,314,151,163,267,134,133,47,17,30
130794,35,13,5,8,13,5,8,,,
130907,35,644,196,448,232,92,140,412,104,308
130934,35,156,57,99,129,46,83,27,11,16
130943,35,438,236,202,405,222,183,33,14,19
130989,35,64,29,35,54,24,30,10,5,5
131113,35,1204,413,791,500,184,316,704,229,475
131159,35,219,82,137,203,70,133,16,12,4
131283,35,62,34,28,62,34,28,,,
131399,35,158,65,93,96,45,51,62,20,42
131450,35,76,30,46,69,28,41,7,2,5
131469,35,560,208,352,410,161,249,150,47,103
131496,35,56,22,34,54,21,33,2,1,1
131520,35,159,44,115,148,39,109,11,5,6
131803,35,32,11,21,3,3,0,29,8,21
131876,35,102,1,101,44,1,43,58,0,58
132408,35,28,14,14,18,10,8,10,4,6
132471,35,243,87,156,197,69,128,46,18,28
132602,35,101,55,46,98,54,44,3,1,2
132657,35,136,66,70,121,59,62,15,7,8
132693,35,400,152,248,173,77,96,227,75,152
132709,35,948,395,553,331,148,183,617,247,370
132842,35,46,9,37,17,5,12,29,4,25
132851,35,255,102,153,129,55,74,126,47,79
132879,35,15,11,4,14,11,3,1,0,1
132903,35,7041,2909,4132,4418,1894,2524,2623,1015,1608
133021,35,55,23,32,27,16,11,28,7,21
133386,35,650,241,409,296,121,175,354,120,234
133465,35,77,9,68,39,3,36,38,6,32
133492,35,53,14,39,52,14,38,1,0,1
133508,35,598,259,339,264,139,125,334,120,214
133526,35,67,47,20,61,46,15,6,1,5
133553,35,246,190,56,238,182,56,8,8,0
133650,35,651,245,406,541,198,343,110,47,63
133669,35,2528,1052,1476,1360,574,786,1168,478,690
133702,35,1573,578,995,638,270,368,935,308,627
133711,35,194,68,126,193,68,125,1,0,1
133809,35,31,21,10,31,21,10,,,
133872,35,127,16,111,34,5,29,93,11,82
133881,35,157,108,49,150,102,48,7,6,1
133951,35,5635,2281,3354,3730,1504,2226,1905,777,1128
133960,35,90,48,42,33,23,10,57,25,32
133979,35,77,53,24,72,49,23,5,4,1
133997,35,21,10,11,21,10,11,,,
134079,35,93,39,54,91,38,53,2,1,1
134097,35,1987,965,1022,1708,833,875,279,132,147
134130,35,1553,718,835,1416,647,769,137,71,66
134237,35,3428,2255,1173,3428,2255,1173,,,
134343,35,131,37,94,67,27,40,64,10,54
134422,35,4,0,4,4,0,4,,,
134495,35,1627,662,965,840,407,433,787,255,532
134510,35,5,3,2,5,3,2,,,
134608,35,548,213,335,189,94,95,359,119,240
134811,35,356,124,232,192,67,125,164,57,107
134945,35,254,80,174,231,77,154,23,3,20
135081,35,257,75,182,173,51,122,84,24,60
135160,35,131,48,83,55,19,36,76,29,47
135188,35,149,51,98,53,27,26,96,24,72
135364,35,24,15,9,5,3,2,19,12,7
135391,35,424,155,269,175,81,94,249,74,175
135610,35,18,8,10,4,1,3,14,7,7
135717,35,981,352,629,569,221,348,412,131,281
135726,35,638,267,371,611,254,357,27,13,14
136145,35,70,15,55,20,6,14,50,9,41
136172,35,1346,548,798,956,393,563,390,155,235
136215,35,515,109,406,310,76,234,205,33,172
136233,35,225,95,130,121,53,68,104,42,62
136330,35,212,73,139,193,66,127,19,7,12
136358,35,1000,425,575,439,199,240,561,226,335
136473,35,132,47,85,61,29,32,71,18,53
136516,35,497,165,332,217,83,134,280,82,198
136774,35,61,21,40,60,21,39,1,0,1
136950,35,77,35,42,77,35,42,,,
137032,35,991,369,622,724,262,462,267,107,160
137078,35,1295,423,872,390,161,229,905,262,643
137096,35,1408,649,759,644,340,304,764,309,455
137209,35,1019,371,648,321,150,171,698,221,477
137281,35,172,61,111,74,37,37,98,24,74
137315,35,30,4,26,4,1,3,26,3,23
137351,35,4069,1634,2435,2819,1134,1685,1250,500,750
137476,35,284,105,179,228,90,138,56,15,41
137546,35,111,50,61,108,49,59,3,1,2
137564,35,413,154,259,355,136,219,58,18,40
137759,35,1018,459,559,716,339,377,302,120,182
137801,35,48,30,18,48,30,18,,,
137847,35,328,150,178,314,146,168,14,4,10
137953,35,32,20,12,31,20,11,1,0,1
137962,35,29,15,14,24,13,11,5,2,3
138187,35,2719,1087,1632,1163,544,619,1556,543,1013
138275,35,89,49,40,79,41,38,10,8,2
138293,35,85,48,37,84,47,37,1,1,0
138309,35,1527,214,1313,683,98,585,844,116,728
138354,35,1223,422,801,773,302,471,450,120,330
138558,35,231,91,140,151,77,74,80,14,66
138600,35,8,0,8,8,0,8,,,
138682,35,210,81,129,74,28,46,136,53,83
138716,35,338,65,273,176,50,126,162,15,147
138761,35,40,18,22,23,14,9,17,4,13
138813,35,99,46,53,59,29,30,40,17,23
138840,35,643,233,410,214,98,116,429,135,294
138868,35,86,47,39,78,46,32,8,1,7
138901,35,213,80,133,124,51,73,89,29,60
138947,35,137,40,97,133,40,93,4,0,4
138956,35,534,184,350,198,85,113,336,99,237
139144,35,32,16,16,32,16,16,,,
139153,35,5,3,2,2,1,1,3,2,1
139199,35,226,21,205,135,13,122,91,8,83
139205,35,152,106,46,128,89,39,24,17,7
139250,35,197,50,147,108,35,73,89,15,74
139278,35,678,215,463,236,97,139,442,118,324
139311,35,579,150,429,374,108,266,205,42,163
139357,35,369,81,288,98,31,67,271,50,221
139366,35,469,187,282,309,113,196,160,74,86
139384,35,456,129,327,149,50,99,307,79,228
139393,35,20,6,14,18,6,12,2,0,2
139463,35,347,135,212,247,106,141,100,29,71
139579,35,67,8,59,42,5,37,25,3,22
139621,35,100,58,42,68,41,27,32,17,15
139630,35,46,31,15,45,30,15,1,1,0
139658,35,664,269,395,660,267,393,4,2,2
139700,35,419,155,264,191,83,108,228,72,156
139719,35,139,57,82,114,50,64,25,7,18
139755,35,945,636,309,893,598,295,52,38,14
139764,35,207,58,149,132,38,94,75,20,55
139861,35,244,114,130,229,112,117,15,2,13
139931,35,1419,592,827,1124,496,628,295,96,199
139940,35,1357,499,858,930,355,575,427,144,283
139959,35,1735,901,834,1624,845,779,111,56,55
139968,35,198,58,140,118,43,75,80,15,65
139986,35,583,139,444,141,52,89,442,87,355
139995,35,23,5,18,23,5,18,,,
140012,35,982,349,633,204,101,103,778,248,530
140234,35,47,23,24,44,23,21,3,0,3
140243,35,725,272,453,249,102,147,476,170,306
140252,35,148,73,75,120,62,58,28,11,17
140331,35,1104,411,693,313,138,175,791,273,518
140340,35,58,8,50,42,5,37,16,3,13
140447,35,448,103,345,326,77,249,122,26,96
140553,35,243,243,0,67,67,0,176,176,0
140678,35,231,100,131,112,62,50,119,38,81
140696,35,37,14,23,34,13,21,3,1,2
140720,35,28,17,11,27,16,11,1,1,0
140818,35,148,26,122,129,24,105,19,2,17
140872,35,134,65,69,122,61,61,12,4,8
140942,35,543,180,363,185,81,104,358,99,259
140951,35,788,246,542,684,219,465,104,27,77
140960,35,144,63,81,124,57,67,20,6,14
140988,35,89,42,47,78,38,40,11,4,7
141006,35,176,97,79,113,69,44,63,28,35
141060,35,36,0,36,34,0,34,2,0,2
141167,35,6,1,5,,,,6,1,5
141185,35,73,28,45,57,23,34,16,5,11
141237,35,36,21,15,34,21,13,2,0,2
141255,35,393,164,229,119,44,75,274,120,154
141264,35,692,220,472,477,164,313,215,56,159
141325,35,38,0,38,25,0,25,13,0,13
141334,35,611,202,409,450,167,283,161,35,126
141361,35,54,30,24,54,30,24,,,
141486,35,128,24,104,114,21,93,14,3,11
141565,35,378,125,253,264,86,178,114,39,75
141574,35,1745,637,1108,1246,439,807,499,198,301
141644,35,283,127,156,188,83,105,95,44,51
141680,35,316,165,151,124,60,64,192,105,87
141796,35,638,203,435,234,96,138,404,107,297
141802,35,58,15,43,14,6,8,44,9,35
141811,35,464,162,302,187,77,110,277,85,192
141839,35,127,40,87,41,14,27,86,26,60
141981,35,513,188,325,297,111,186,216,77,139
141990,35,168,47,121,69,12,57,99,35,64
142054,35,69,11,58,69,11,58,,,
142090,35,13,6,7,11,6,5,2,0,2
142115,35,1630,709,921,1043,464,579,587,245,342
142179,35,90,25,65,38,17,21,52,8,44
142276,35,464,191,273,359,154,205,105,37,68
142285,35,524,257,267,455,227,228,69,30,39
142294,35,42,27,15,42,27,15,,,
142328,35,248,79,169,168,66,102,80,13,67
142443,35,192,73,119,98,50,48,94,23,71
142461,35,63,32,31,51,29,22,12,3,9
142522,35,1860,804,1056,305,142,163,1555,662,893
142559,35,253,82,171,127,49,78,126,33,93
142887,35,5,1,4,4,1,3,1,0,1
142957,35,2,1,1,1,1,0,1,0,1
143048,35,126,34,92,119,33,86,7,1,6
143084,35,48,21,27,48,21,27,,,
143118,35,543,161,382,468,144,324,75,17,58
143215,35,336,159,177,223,114,109,113,45,68
143279,35,120,37,83,55,23,32,65,14,51
143288,35,24,11,13,24,11,13,,,
143297,35,5,1,4,4,0,4,1,1,0
143358,35,139,83,56,132,79,53,7,4,3
143613,35,70,25,45,47,19,28,23,6,17
143978,35,16,2,14,13,2,11,3,0,3
144005,35,171,50,121,119,39,80,52,11,41
144050,35,113,64,49,113,64,49,,,
144157,35,126,66,60,90,52,38,36,14,22
144166,35,460,126,334,226,62,164,234,64,170
144175,35,129,69,60,70,45,25,59,24,35
144184,35,220,94,126,90,49,41,130,45,85
144193,35,150,74,76,85,51,34,65,23,42
144209,35,363,158,205,207,93,114,156,65,91
144218,35,271,114,157,132,60,72,139,54,85
144281,35,572,247,325,551,240,311,21,7,14
144351,35,128,53,75,111,47,64,17,6,11
144564,35,45,15,30,30,10,20,15,5,10
144740,35,1155,576,579,1044,523,521,111,53,58
144865,35,1687,753,934,606,315,291,1081,438,643
144883,35,9,6,3,9,6,3,,,
144892,35,639,249,390,495,203,292,144,46,98
144944,35,286,127,159,103,59,44,183,68,115
144962,35,378,141,237,371,138,233,7,3,4
144971,35,56,29,27,56,29,27,,,
145239,35,92,14,78,92,14,78,,,
145336,35,449,165,284,307,121,186,142,44,98
145372,35,86,33,53,75,30,45,11,3,8
145497,35,9,4,5,9,4,5,,,
145521,35,40,18,22,18,8,10,22,10,12
145600,35,2244,1017,1227,1917,882,1035,327,135,192
145619,35,325,165,160,261,150,111,64,15,49
145637,35,1266,671,595,1252,661,591,14,10,4
145646,35,40,19,21,40,19,21,,,
145682,35,119,46,73,60,31,29,59,15,44
145691,35,54,27,27,50,26,24,4,1,3
145707,35,2,0,2,1,0,1,1,0,1
145725,35,147,105,42,130,89,41,17,16,1
145813,35,1778,859,919,1648,796,852,130,63,67
145831,35,48,18,30,32,16,16,16,2,14
146205,35,55,21,34,29,16,13,26,5,21
146278,35,132,55,77,70,36,34,62,19,43
146296,35,232,84,148,108,45,63,124,39,85
146339,35,97,49,48,93,49,44,4,0,4
146348,35,91,43,48,58,35,23,33,8,25
146366,35,307,65,242,176,41,135,131,24,107
146418,35,87,33,54,50,22,28,37,11,26
146427,35,21,12,9,19,12,7,2,0,2
146472,35,303,122,181,136,64,72,167,58,109
146481,35,99,41,58,98,41,57,1,0,1
146506,35,91,32,59,55,24,31,36,8,28
146533,35,58,13,45,41,6,35,17,7,10
146603,35,130,61,69,83,43,40,47,18,29
146612,35,477,220,257,362,155,207,115,65,50
146667,35,29,19,10,21,13,8,8,6,2
146676,35,73,45,28,67,45,22,6,0,6
146685,35,234,93,141,133,58,75,101,35,66
146700,35,9,7,2,9,7,2,,,
146719,35,460,166,294,442,160,282,18,6,12
146755,35,32,6,26,10,3,7,22,3,19
146816,35,42,2,40,36,2,34,6,0,6
147004,35,610,218,392,176,91,85,434,127,307
147013,35,124,59,65,99,51,48,25,8,17
147129,35,114,14,100,77,10,67,37,4,33
147244,35,82,36,46,74,35,39,8,1,7
147341,35,22,9,13,22,9,13,,,
147369,35,261,136,125,207,105,102,54,31,23
147378,35,223,84,139,113,49,64,110,35,75
147396,35,5,5,0,4,4,0,1,1,0
147411,35,125,47,78,53,30,23,72,17,55
147536,35,497,91,406,344,74,270,153,17,136
147590,35,9,2,7,8,2,6,1,0,1
147660,35,226,89,137,223,88,135,3,1,2
147679,35,165,74,91,139,65,74,26,9,17
147703,35,1492,743,749,1201,607,594,291,136,155
147767,35,226,114,112,226,114,112,,,
147776,35,769,301,468,461,173,288,308,128,180
147800,35,398,212,186,119,49,70,279,163,116
147828,35,119,56,63,112,55,57,7,1,6
147916,35,156,80,76,96,52,44,60,28,32
148007,35,127,42,85,52,21,31,75,21,54
148016,35,14,8,6,14,8,6,,,
148131,35,108,47,61,108,47,61,,,
148256,35,33,17,16,24,15,9,9,2,7
148292,35,11,1,10,5,0,5,6,1,5
148380,35,163,63,100,88,35,53,75,28,47
148405,35,97,36,61,94,36,58,3,0,3
148487,35,351,117,234,306,104,202,45,13,32
148496,35,143,42,101,138,41,97,5,1,4
148511,35,48,9,39,28,4,24,20,5,15
148575,35,84,14,70,78,14,64,6,0,6
148584,35,207,53,154,158,42,116,49,11,38
148593,35,43,3,40,37,3,34,6,0,6
148627,35,261,93,168,228,79,149,33,14,19
148654,35,426,206,220,277,133,144,149,73,76
148672,35,29,7,22,10,4,6,19,3,16
148821,35,56,17,39,28,8,20,28,9,19
148876,35,18,3,15,13,1,12,5,2,3
148937,35,15,8,7,9,5,4,6,3,3
148991,35,13,5,8,4,1,3,9,4,5
149028,35,43,7,36,36,7,29,7,0,7
149222,35,1175,607,568,969,498,471,206,109,97
149231,35,1014,432,582,738,346,392,276,86,190
149365,35,86,31,55,48,23,25,38,8,30
149505,35,88,38,50,58,29,29,30,9,21
149514,35,42,27,15,37,24,13,5,3,2
149532,35,273,109,164,112,54,58,161,55,106
149639,35,8,5,3,8,5,3,,,
149727,35,189,85,104,92,51,41,97,34,63
149763,35,121,24,97,78,18,60,43,6,37
149772,35,648,283,365,539,236,303,109,47,62
149781,35,62,22,40,61,22,39,1,0,1
149842,35,382,172,210,171,88,83,211,84,127
150066,35,29,14,15,26,14,12,3,0,3
150136,35,581,236,345,526,220,306,55,16,39
150145,35,84,26,58,64,18,46,20,8,12
150163,35,63,35,28,63,35,28,,,
150172,35,69,56,13,38,32,6,31,24,7
150251,35,28,4,24,20,2,18,8,2,6
150400,35,9,5,4,9,5,4,,,
150455,35,6,4,2,6,4,2,,,
150534,35,55,20,35,55,20,35,,,
150604,35,22,17,5,20,16,4,2,1,1
150668,35,39,16,23,35,16,19,4,0,4
150677,35,81,34,47,79,34,45,2,0,2
150756,35,13,9,4,13,9,4,,,
150774,35,17,13,4,14,10,4,3,3,0
150941,35,43,18,25,32,13,19,11,5,6
150987,35,2258,863,1395,737,292,445,1521,571,950
151102,35,334,155,179,277,126,151,57,29,28
151111,35,1248,498,750,998,412,586,250,86,164
151263,35,219,89,130,196,79,117,23,10,13
151290,35,52,28,24,50,27,23,2,1,1
151306,35,461,170,291,368,149,219,93,21,72
151324,35,618,276,342,357,190,167,261,86,175
151333,35,165,58,107,127,45,82,38,13,25
151342,35,266,92,174,200,66,134,66,26,40
151351,35,603,317,286,588,310,278,15,7,8
151360,35,236,56,180,165,39,126,71,17,54
151379,35,231,99,132,156,66,90,75,33,42
151388,35,283,86,197,172,41,131,111,45,66
151467,35,32,4,28,32,4,28,,,
151661,35,7,4,3,7,4,3,,,
151777,35,28,10,18,28,10,18,,,
151786,35,252,75,177,180,61,119,72,14,58
151801,35,69,26,43,66,26,40,3,0,3
151810,35,18,5,13,6,2,4,12,3,9
151962,35,53,17,36,53,17,36,,,
152080,35,224,109,115,224,109,115,,,
152099,35,48,22,26,46,20,26,2,2,0
152318,35,16,14,2,16,14,2,,,
152336,35,129,24,105,104,23,81,25,1,24
152381,35,76,10,66,49,9,40,27,1,26
152390,35,15,0,15,15,0,15,,,
152530,35,40,23,17,40,23,17,,,
152567,35,66,29,37,66,29,37,,,
152600,35,122,39,83,121,39,82,1,0,1
152637,35,210,78,132,149,54,95,61,24,37
152673,35,8,8,0,8,8,0,,,
152798,35,166,16,150,152,15,137,14,1,13
152992,35,53,19,34,38,18,20,15,1,14
153001,35,180,37,143,145,30,115,35,7,28
153108,35,23,10,13,20,9,11,3,1,2
153126,35,81,58,23,81,58,23,,,
153144,35,39,25,14,39,25,14,,,
153162,35,37,19,18,37,19,18,,,
153214,35,1118,460,658,654,308,346,464,152,312
153241,35,7,2,5,7,2,5,,,
153250,35,31,17,14,29,15,14,2,2,0
153269,35,103,52,51,92,47,45,11,5,6
153278,35,91,48,43,59,42,17,32,6,26
153296,35,60,29,31,53,28,25,7,1,6
153302,35,19,12,7,18,11,7,1,1,0
153311,35,322,95,227,152,61,91,170,34,136
153320,35,18,8,10,14,6,8,4,2,2
153366,35,74,51,23,73,51,22,1,0,1
153375,35,194,99,95,177,90,87,17,9,8
153384,35,4,4,0,4,4,0,,,
153427,35,16,5,11,16,5,11,,,
153445,35,179,73,106,117,60,57,62,13,49
153472,35,197,80,117,167,73,94,30,7,23
153524,35,281,127,154,232,113,119,49,14,35
153533,35,24,7,17,11,4,7,13,3,10
153603,35,1354,726,628,1289,692,597,65,34,31
153621,35,89,52,37,79,49,30,10,3,7
153630,35,417,172,245,254,146,108,163,26,137
153658,35,1052,492,560,922,441,481,130,51,79
153737,35,324,131,193,169,83,86,155,48,107
153825,35,61,33,28,59,32,27,2,1,1
153834,35,25,14,11,25,14,11,,,
153861,35,195,42,153,86,27,59,109,15,94
153922,35,101,45,56,63,30,33,38,15,23
153977,35,369,72,297,265,62,203,104,10,94
154004,35,49,31,18,43,31,12,6,0,6
154013,35,148,57,91,109,50,59,39,7,32
154022,35,2924,1016,1908,2924,1016,1908,,,
154059,35,52,26,26,30,14,16,22,12,10
154095,35,616,283,333,583,262,321,33,21,12
154101,35,29,16,13,29,16,13,,,
154110,35,95,30,65,43,22,21,52,8,44
154129,35,50,22,28,39,21,18,11,1,10
154174,35,20,8,12,19,8,11,1,0,1
154235,35,173,69,104,158,63,95,15,6,9
154262,35,56,10,46,27,6,21,29,4,25
154350,35,66,28,38,54,24,30,12,4,8
154378,35,37,12,25,30,9,21,7,3,4
154396,35,66,20,46,41,17,24,25,3,22
154493,35,253,99,154,162,67,95,91,32,59
154518,35,180,114,66,142,88,54,38,26,12
154527,35,26,17,9,26,17,9,,,
154572,35,290,118,172,147,76,71,143,42,101
154590,35,131,67,64,130,67,63,1,0,1
154642,35,33,16,17,11,9,2,22,7,15
154688,35,90,35,55,72,26,46,18,9,9
154697,35,253,93,160,123,40,83,130,53,77
154712,35,66,35,31,66,35,31,,,
154721,35,58,34,24,56,34,22,2,0,2
154749,35,28,8,20,28,8,20,,,
154800,35,398,168,230,192,97,95,206,71,135
154855,35,60,29,31,59,28,31,1,1,0
154907,35,57,22,35,37,17,20,20,5,15
154925,35,53,31,22,51,30,21,2,1,1
154934,35,164,39,125,110,32,78,54,7,47
154952,35,198,82,116,132,59,73,66,23,43
154998,35,113,61,52,85,52,33,28,9,19
155007,35,57,14,43,9,5,4,48,9,39
155025,35,271,89,182,247,83,164,24,6,18
155052,35,74,32,42,53,25,28,21,7,14
155061,35,1166,414,752,475,182,293,691,232,459
155070,35,36,14,22,33,11,22,3,3,0
155089,35,100,49,51,84,45,39,16,4,12
155098,35,332,168,164,231,120,111,101,48,53
155104,35,118,65,53,68,48,20,50,17,33
155140,35,68,20,48,59,20,39,9,0,9
155177,35,44,10,34,31,9,22,13,1,12
155186,35,310,135,175,153,83,70,157,52,105
155195,35,351,134,217,145,60,85,206,74,132
155201,35,67,46,21,57,42,15,10,4,6
155210,35,915,363,552,311,124,187,604,239,365
155292,35,30,10,20,15,7,8,15,3,12
155308,35,19,14,5,19,14,5,,,
155317,35,1169,494,675,956,435,521,213,59,154
155335,35,137,51,86,125,44,81,12,7,5
155399,35,1154,540,614,965,482,483,189,58,131
155414,35,59,36,23,58,36,22,1,0,1
155450,35,87,38,49,48,23,25,39,15,24
155487,35,89,46,43,55,34,21,34,12,22
155496,35,29,20,9,29,20,9,,,
155511,35,52,29,23,52,29,23,,,
155520,35,199,64,135,161,57,104,38,7,31
155566,35,84,25,59,41,15,26,43,10,33
155593,35,77,34,43,56,31,25,21,3,18
155618,35,33,23,10,33,23,10,,,
155627,35,65,39,26,61,38,23,4,1,3
155636,35,70,18,52,39,12,27,31,6,25
155681,35,407,206,201,371,190,181,36,16,20
155715,35,71,49,22,60,44,16,11,5,6
155812,35,109,55,54,90,45,45,19,10,9
155830,35,51,25,26,40,22,18,11,3,8
155858,35,72,18,54,38,15,23,34,3,31
155900,35,154,106,48,67,42,25,87,64,23
155937,35,44,32,12,33,25,8,11,7,4
155973,35,45,27,18,45,27,18,,,
156082,35,486,155,331,366,121,245,120,34,86
156107,35,363,181,182,185,123,62,178,58,120
156125,35,1085,407,678,851,331,520,234,76,158
156134,35,131,70,61,131,70,61,,,
156189,35,21,13,8,21,13,8,,,
156213,35,79,30,49,52,17,35,27,13,14
156231,35,127,44,83,85,31,54,42,13,29
156286,35,168,59,109,146,53,93,22,6,16
156295,35,40,15,25,40,15,25,,,
156338,35,247,96,151,113,39,74,134,57,77
156356,35,43,12,31,39,12,27,4,0,4
156365,35,267,95,172,216,87,129,51,8,43
156392,35,699,284,415,349,151,198,350,133,217
156408,35,12,5,7,12,5,7,,,
156417,35,18,15,3,12,10,2,6,5,1
156471,35,1445,119,1326,543,38,505,902,81,821
156541,35,673,165,508,489,122,367,184,43,141
156620,35,922,391,531,651,261,390,271,130,141
156648,35,275,94,181,139,53,86,136,41,95
156745,35,49,37,12,49,37,12,,,
156790,35,50,23,27,31,17,14,19,6,13
156851,35,50,15,35,24,10,14,26,5,21
156860,35,202,70,132,83,25,58,119,45,74
156921,35,687,292,395,281,134,147,406,158,248
157021,35,38,2,36,4,2,2,34,0,34
157030,35,6,3,3,5,3,2,1,0,1
157058,35,119,49,70,88,32,56,31,17,14
157076,35,72,40,32,68,38,30,4,2,2
157085,35,916,418,498,740,352,388,176,66,110
157100,35,42,26,16,41,26,15,1,0,1
157216,35,133,35,98,121,34,87,12,1,11
157289,35,858,324,534,585,219,366,273,105,168
157304,35,203,64,139,34,13,21,169,51,118
157331,35,122,36,86,63,19,44,59,17,42
157377,35,123,44,79,98,42,56,25,2,23
157386,35,299,122,177,238,107,131,61,15,46
157401,35,690,243,447,429,164,265,261,79,182
157438,35,281,114,167,94,46,48,187,68,119
157447,35,689,232,457,423,167,256,266,65,201
157483,35,202,62,140,99,34,65,103,28,75
157535,35,77,40,37,75,39,36,2,1,1
157553,35,61,23,38,42,14,28,19,9,10
157711,35,244,72,172,154,47,107,90,25,65
157739,35,63,14,49,30,6,24,33,8,25
157748,35,1,1,0,1,1,0,,,
157757,35,82,22,60,61,20,41,21,2,19
157793,35,244,75,169,134,43,91,110,32,78
157809,35,54,28,26,44,22,22,10,6,4
157818,35,20,12,8,19,11,8,1,1,0
157863,35,73,45,28,71,45,26,2,0,2
157951,35,810,335,475,658,288,370,152,47,105
158088,35,181,48,133,153,44,109,28,4,24
158431,35,563,163,400,269,86,183,294,77,217
158477,35,23,18,5,23,18,5,,,
158662,35,1225,385,840,518,177,341,707,208,499
158802,35,64,22,42,64,22,42,,,
158884,35,302,107,195,132,61,71,170,46,124
159009,35,228,82,146,192,74,118,36,8,28
159373,35,216,23,193,206,22,184,10,1,9
159382,35,480,137,343,296,86,210,184,51,133
159391,35,923,471,452,839,425,414,84,46,38
159407,35,223,58,165,109,33,76,114,25,89
159416,35,313,123,190,203,86,117,110,37,73
159568,35,57,33,24,55,32,23,2,1,1
159647,35,222,113,109,199,106,93,23,7,16
159656,35,140,43,97,118,39,79,22,4,18
159717,35,241,84,157,211,79,132,30,5,25
159939,35,470,220,250,377,190,187,93,30,63
159948,35,8,5,3,4,1,3,4,4,0
159966,35,244,115,129,209,104,105,35,11,24
159993,35,322,123,199,211,106,105,111,17,94
160010,35,154,91,63,55,40,15,99,51,48
160038,35,457,106,351,266,67,199,191,39,152
160065,35,81,21,60,51,14,37,30,7,23
160074,35,170,37,133,72,12,60,98,25,73
160409,35,35,35,0,35,35,0,,,
160481,35,144,44,100,74,29,45,70,15,55
160524,35,17,1,16,17,1,16,,,
160579,35,283,127,156,155,80,75,128,47,81
160612,35,554,235,319,461,206,255,93,29,64
160621,35,305,102,203,251,88,163,54,14,40
160630,35,118,23,95,86,16,70,32,7,25
160649,35,392,122,270,282,93,189,110,29,81
160658,35,740,264,476,571,221,350,169,43,126
160667,35,307,107,200,215,81,134,92,26,66
160755,35,88,41,47,88,41,47,,,
160904,35,51,17,34,48,16,32,3,1,2
160959,35,23,5,18,23,5,18,,,
160977,35,3,1,2,3,1,2,,,
161004,35,2,1,1,2,1,1,,,
161022,35,100,8,92,24,0,24,76,8,68
161077,35,192,62,130,88,32,56,104,30,74
161086,35,5,2,3,5,2,3,,,
161138,35,188,83,105,107,53,54,81,30,51
161192,35,183,63,120,57,24,33,126,39,87
161208,35,31,27,4,31,27,4,,,
161217,35,490,151,339,241,69,172,249,82,167
161226,35,66,21,45,55,21,34,11,0,11
161235,35,289,72,217,152,51,101,137,21,116
161253,35,464,230,234,361,176,185,103,54,49
161299,35,21,21,0,21,21,0,,,
161341,35,165,60,105,101,36,65,64,24,40
161457,35,117,27,90,114,27,87,3,0,3
161484,35,51,25,26,27,18,9,24,7,17
161509,35,37,9,28,35,9,26,2,0,2
161518,35,33,16,17,33,16,17,,,
161545,35,389,157,232,153,79,74,236,78,158
161554,35,542,187,355,407,140,267,135,47,88
161563,35,15,10,5,15,10,5,,,
161572,35,598,137,461,598,137,461,,,
161581,35,23,13,10,17,11,6,6,2,4
161688,35,255,54,201,73,31,42,182,23,159
161767,35,383,126,257,101,43,58,282,83,199
161864,35,310,89,221,59,14,45,251,75,176
161873,35,253,80,173,159,55,104,94,25,69
162007,35,490,198,292,386,164,222,104,34,70
162061,35,28,21,7,22,18,4,6,3,3
162104,35,38,15,23,11,7,4,27,8,19
162122,35,366,141,225,138,63,75,228,78,150
162168,35,71,28,43,20,10,10,51,18,33
162210,35,57,14,43,48,11,37,9,3,6
162283,35,174,40,134,136,38,98,38,2,36
162557,35,267,104,163,85,43,42,182,61,121
162584,35,326,133,193,232,120,112,94,13,81
162609,35,43,24,19,30,20,10,13,4,9
162654,35,20,5,15,19,5,14,1,0,1
162690,35,84,38,46,33,20,13,51,18,33
162706,35,206,76,130,87,38,49,119,38,81
162760,35,97,33,64,91,33,58,6,0,6
162779,35,552,178,374,143,49,94,409,129,280
162928,35,68,31,37,68,31,37,,,
163028,35,9,9,0,8,8,0,1,1,0
163046,35,51,25,26,51,25,26,,,
163204,35,8187,4506,3681,1797,856,941,6390,3650,2740
163259,35,264,47,217,202,38,164,62,9,53
163268,35,975,461,514,802,381,421,173,80,93
163286,35,1952,955,997,1777,881,896,175,74,101
163295,35,61,15,46,60,14,46,1,1,0
163338,35,81,47,34,65,38,27,16,9,7
163426,35,579,282,297,191,104,87,388,178,210
163453,35,325,137,188,252,104,148,73,33,40
163462,35,66,39,27,57,35,22,9,4,5
163532,35,37,37,0,37,37,0,,,
163578,35,163,8,155,132,8,124,31,0,31
163657,35,510,180,330,185,76,109,325,104,221
163851,35,586,244,342,533,229,304,53,15,38
163912,35,84,34,50,82,34,48,2,0,2
163976,35,5,4,1,5,4,1,,,
164076,35,2015,847,1168,1728,749,979,287,98,189
164155,35,1,0,1,1,0,1,,,
164173,35,228,81,147,178,74,104,50,7,43
164216,35,14,10,4,14,10,4,,,
164270,35,52,21,31,52,21,31,,,
164313,35,187,63,124,50,24,26,137,39,98
164368,35,42,27,15,42,27,15,,,
164447,35,75,22,53,67,20,47,8,2,6
164465,35,19,9,10,19,9,10,,,
164492,35,85,40,45,80,39,41,5,1,4
164562,35,61,26,35,61,26,35,,,
164580,35,48,26,22,48,26,22,,,
164614,35,1,1,0,1,1,0,,,
164632,35,451,0,451,149,0,149,302,0,302
164641,35,66,23,43,34,18,16,32,5,27
164739,35,79,46,33,79,46,33,,,
164748,35,444,270,174,348,202,146,96,68,28
164775,35,180,51,129,36,9,27,144,42,102
164872,35,25,13,12,24,12,12,1,1,0
164924,35,98,58,40,74,38,36,24,20,4
164988,35,802,312,490,799,311,488,3,1,2
165015,35,44,22,22,44,22,22,,,
165024,35,774,318,456,586,254,332,188,64,124
165033,35,327,111,216,147,63,84,180,48,132
165112,35,625,255,370,220,107,113,405,148,257
165167,35,111,21,90,20,4,16,91,17,74
165194,35,186,66,120,60,30,30,126,36,90
165264,35,201,12,189,10,1,9,191,11,180
165334,35,229,174,55,228,174,54,1,0,1
165529,35,110,44,66,81,38,43,29,6,23
165574,35,49,32,17,46,31,15,3,1,2
165644,35,26,17,9,20,15,5,6,2,4
165662,35,183,69,114,180,69,111,3,0,3
165671,35,51,9,42,50,9,41,1,0,1
165699,35,80,26,54,58,23,35,22,3,19
165802,35,55,32,23,55,32,23,,,
165820,35,254,109,145,164,88,76,90,21,69
165866,35,233,98,135,176,86,90,57,12,45
165884,35,48,35,13,35,24,11,13,11,2
165936,35,65,28,37,64,28,36,1,0,1
165981,35,147,42,105,46,13,33,101,29,72
166018,35,45,21,24,45,21,24,,,
166027,35,14,9,5,14,9,5,,,
166054,35,8,7,1,8,7,1,,,
166124,35,40,23,17,40,23,17,,,
166133,35,232,90,142,90,38,52,142,52,90
166391,35,46,17,29,44,16,28,2,1,1
166407,35,105,7,98,14,1,13,91,6,85
166452,35,154,45,109,101,29,72,53,16,37
166489,35,2,2,0,2,2,0,,,
166513,35,1058,568,490,741,418,323,317,150,167
166629,35,1503,732,771,1255,650,605,248,82,166
166638,35,1166,501,665,939,420,519,227,81,146
166647,35,244,92,152,103,45,58,141,47,94
166656,35,467,94,373,427,89,338,40,5,35
166674,35,89,29,60,82,27,55,7,2,5
166683,35,20,14,6,20,14,6,,,
166692,35,30,24,6,30,24,6,,,
166717,35,16,4,12,10,4,6,6,0,6
166823,35,314,109,205,124,55,69,190,54,136
166850,35,88,42,46,78,40,38,10,2,8
166887,35,456,132,324,161,59,102,295,73,222
166911,35,13,5,8,13,5,8,,,
166939,35,54,0,54,53,0,53,1,0,1
166957,35,285,71,214,93,30,63,192,41,151
167057,35,10,5,5,10,5,5,,,
167260,35,64,35,29,54,34,20,10,1,9
167288,35,56,22,34,42,18,24,14,4,10
167312,35,376,129,247,145,53,92,231,76,155
167358,35,384,195,189,384,195,189,,,
167376,35,322,101,221,143,70,73,179,31,148
167394,35,192,34,158,152,26,126,40,8,32
167525,35,273,100,173,106,47,59,167,53,114
167534,35,401,129,272,182,71,111,219,58,161
167598,35,25,5,20,23,5,18,2,0,2
167631,35,25,7,18,3,2,1,22,5,17
167677,35,6,6,0,6,6,0,,,
167729,35,389,140,249,293,115,178,96,25,71
167783,35,99,0,99,74,0,74,25,0,25
167792,35,1,1,0,,,,1,1,0
167835,35,58,0,58,58,0,58,,,
167899,35,46,30,16,46,30,16,,,
167905,35,334,117,217,133,50,83,201,67,134
167987,35,415,180,235,298,147,151,117,33,84
167996,35,34,21,13,34,21,13,,,
168005,35,266,102,164,262,100,162,4,2,2
168148,35,39,14,25,39,14,25,,,
168218,35,9,0,9,9,0,9,,,
168227,35,88,70,18,87,69,18,1,1,0
168254,35,107,68,39,91,61,30,16,7,9
168263,35,297,123,174,222,102,120,75,21,54
168281,35,17,5,12,17,5,12,,,
168342,35,7,0,7,7,0,7,,,
168421,35,79,59,20,79,59,20,,,
168430,35,380,139,241,305,120,185,75,19,56
168528,35,47,30,17,45,29,16,2,1,1
168546,35,35,14,21,35,14,21,,,
168591,35,32,18,14,32,18,14,,,
168607,35,50,24,26,27,17,10,23,7,16
168740,35,99,48,51,86,43,43,13,5,8
168786,35,62,35,27,59,35,24,3,0,3
168847,35,509,118,391,147,46,101,362,72,290
168883,35,62,18,44,32,12,20,30,6,24
169080,35,59,38,21,47,28,19,12,10,2
169248,35,775,285,490,600,243,357,175,42,133
169275,35,315,97,218,112,31,81,203,66,137
169327,35,81,52,29,60,38,22,21,14,7
169363,35,46,23,23,46,23,23,,,
169442,35,114,42,72,91,36,55,23,6,17
169479,35,406,174,232,193,115,78,213,59,154
169521,35,324,125,199,130,51,79,194,74,120
169655,35,106,96,10,106,96,10,,,
169716,35,179,57,122,156,48,108,23,9,14
169798,35,942,408,534,602,273,329,340,135,205
169910,35,959,445,514,573,279,294,386,166,220
169974,35,56,32,24,16,12,4,40,20,20
169983,35,22,17,5,22,17,5,,,
169992,35,74,28,46,42,17,25,32,11,21
170000,35,91,41,50,53,27,26,38,14,24
170037,35,87,22,65,57,16,41,30,6,24
170055,35,1409,519,890,178,70,108,1231,449,782
170082,35,1203,522,681,1033,455,578,170,67,103
170091,35,13,4,9,12,4,8,1,0,1
170240,35,469,146,323,154,51,103,315,95,220
170286,35,22,7,15,21,6,15,1,1,0
170301,35,38,18,20,38,18,20,,,
170444,35,77,21,56,22,5,17,55,16,39
170532,35,10,5,5,10,5,5,,,
170541,35,513,217,296,151,70,81,362,147,215
170550,35,282,67,215,54,17,37,228,50,178
170587,35,77,24,53,23,9,14,54,15,39
170620,35,341,106,235,102,31,71,239,75,164
170639,35,143,69,74,107,56,51,36,13,23
170657,35,752,324,428,312,143,169,440,181,259
170675,35,92,71,21,85,67,18,7,4,3
170790,35,328,114,214,228,88,140,100,26,74
170806,35,311,90,221,179,57,122,132,33,99
170967,35,104,26,78,65,21,44,39,5,34
170976,35,1407,745,662,1339,705,634,68,40,28
171100,35,1276,642,634,1142,591,551,134,51,83
171128,35,151,107,44,142,103,39,9,4,5
171137,35,482,249,233,330,168,162,152,81,71
171146,35,475,141,334,309,93,216,166,48,118
171155,35,223,85,138,106,42,64,117,43,74
171225,35,91,22,69,31,9,22,60,13,47
171234,35,88,18,70,22,6,16,66,12,54
171304,35,237,82,155,71,38,33,166,44,122
171395,35,58,19,39,18,8,10,40,11,29
171456,35,360,161,199,324,148,176,36,13,23
171483,35,251,122,129,110,63,47,141,59,82
171492,35,337,187,150,189,116,73,148,71,77
171535,35,3239,1261,1978,746,351,395,2493,910,1583
171571,35,1336,470,866,1011,362,649,325,108,217
171599,35,137,81,56,107,67,40,30,14,16
171881,35,7,3,4,2,1,1,5,2,3
172033,35,23,16,7,10,10,0,13,6,7
172051,35,334,132,202,261,110,151,73,22,51
172200,35,933,282,651,209,97,112,724,185,539
172264,35,171,60,111,67,26,41,104,34,70
172291,35,140,40,100,48,18,30,92,22,70
172307,35,109,32,77,56,23,33,53,9,44
172334,35,74,24,50,39,18,21,35,6,29
172440,35,38,20,18,36,20,16,2,0,2
172608,35,141,82,59,23,17,6,118,65,53
172617,35,610,242,368,187,79,108,423,163,260
172635,35,491,200,291,88,45,43,403,155,248
172644,35,1501,589,912,1077,422,655,424,167,257
172671,35,22,7,15,5,2,3,17,5,12
172699,35,1092,519,573,907,442,465,185,77,108
172866,35,13,13,0,13,13,0,,,
172918,35,149,62,87,88,45,43,61,17,44
172954,35,397,163,234,220,104,116,177,59,118
172963,35,677,246,431,333,148,185,344,98,246
173045,35,162,70,92,141,65,76,21,5,16
173063,35,187,82,105,92,52,40,95,30,65
173115,35,130,35,95,50,23,27,80,12,68
173124,35,464,165,299,274,114,160,190,51,139
173142,35,30,16,14,30,16,14,,,
173160,35,96,33,63,47,18,29,49,15,34
173203,35,270,128,142,183,97,86,87,31,56
173258,35,12,6,6,12,6,6,,,
173300,35,47,22,25,46,22,24,1,0,1
173328,35,712,214,498,432,142,290,280,72,208
173416,35,457,218,239,257,151,106,200,67,133
173452,35,23,12,11,11,8,3,12,4,8
173461,35,402,190,212,193,113,80,209,77,132
173559,35,388,163,225,217,118,99,171,45,126
173638,35,213,113,100,116,69,47,97,44,53
173647,35,34,20,14,34,20,14,,,
173665,35,105,36,69,105,36,69,,,
173708,35,600,375,225,284,195,89,316,180,136
173735,35,156,52,104,90,39,51,66,13,53
173799,35,369,140,229,159,73,86,210,67,143
173805,35,119,74,45,87,60,27,32,14,18
173902,35,4,2,2,4,2,2,,,
173911,35,353,156,197,192,107,85,161,49,112
173920,35,1081,496,585,782,413,369,299,83,216
173957,35,168,32,136,168,32,136,,,
173993,35,94,39,55,67,33,34,27,6,21
174020,35,1289,544,745,659,294,365,630,250,380
174066,35,1900,899,1001,1751,834,917,149,65,84
174075,35,190,89,101,127,63,64,63,26,37
174127,35,39,14,25,39,14,25,,,
174136,35,810,343,467,343,152,191,467,191,276
174154,35,72,12,60,46,10,36,26,2,24
174233,35,414,214,200,384,206,178,30,8,22
174251,35,46,27,19,45,26,19,1,1,0
174358,35,369,162,207,279,132,147,90,30,60
174376,35,474,186,288,203,84,119,271,102,169
174428,35,830,342,488,423,192,231,407,150,257
174437,35,55,26,29,49,23,26,6,3,3
174473,35,236,86,150,131,53,78,105,33,72
174491,35,120,43,77,99,35,64,21,8,13
174507,35,60,11,49,18,2,16,42,9,33
174525,35,8,3,5,7,3,4,1,0,1
174570,35,134,50,84,82,39,43,52,11,41
174604,35,16,8,8,14,8,6,2,0,2
174738,35,371,105,266,170,75,95,201,30,171
174747,35,24,0,24,24,0,24,,,
174756,35,487,180,307,268,124,144,219,56,163
174783,35,650,298,352,485,227,258,165,71,94
174792,35,27,27,0,27,27,0,,,
174817,35,70,32,38,30,14,16,40,18,22
174844,35,38,15,23,38,15,23,,,
174862,35,86,47,39,43,25,18,43,22,21
174899,35,323,72,251,227,52,175,96,20,76
174914,35,165,100,65,163,100,63,2,0,2
175005,35,295,24,271,155,5,150,140,19,121
175014,35,708,111,597,260,43,217,448,68,380
175041,35,542,200,342,227,99,128,315,101,214
175078,35,277,77,200,131,49,82,146,28,118
175157,35,65,48,17,62,46,16,3,2,1
175227,35,227,170,57,198,146,52,29,24,5
175236,35,358,130,228,233,96,137,125,34,91
175263,35,206,106,100,137,78,59,69,28,41
175272,35,371,162,209,267,133,134,104,29,75
175315,35,1088,437,651,519,226,293,569,211,358
175342,35,213,68,145,182,61,121,31,7,24
175421,35,247,54,193,149,38,111,98,16,82
175430,35,102,58,44,100,57,43,2,1,1
175519,35,95,31,64,78,27,51,17,4,13
175573,35,174,64,110,147,55,92,27,9,18
175616,35,289,106,183,257,99,158,32,7,25
175643,35,192,81,111,166,74,92,26,7,19
175652,35,357,142,215,274,118,156,83,24,59
175786,35,567,142,425,260,76,184,307,66,241
175810,35,622,165,457,386,91,295,236,74,162
175829,35,148,50,98,69,30,39,79,20,59
175856,35,490,169,321,436,153,283,54,16,38
175883,35,383,144,239,326,129,197,57,15,42
175935,35,995,178,817,686,138,548,309,40,269
175980,35,22,19,3,22,19,3,,,
176008,35,539,131,408,416,101,315,123,30,93
176017,35,1358,538,820,1226,508,718,132,30,102
176035,35,540,79,461,499,75,424,41,4,37
176044,35,139,63,76,117,58,59,22,5,17
176053,35,233,100,133,208,94,114,25,6,19
176071,35,446,176,270,284,125,159,162,51,111
176080,35,1991,999,992,1798,904,894,193,95,98
176169,35,116,39,77,85,31,54,31,8,23
176178,35,17,6,11,7,2,5,10,4,6
176239,35,1314,275,1039,919,210,709,395,65,330
176318,35,87,36,51,70,32,38,17,4,13
176336,35,17,15,2,17,15,2,,,
176354,35,134,40,94,90,29,61,44,11,33
176372,35,1383,493,890,1230,434,796,153,59,94
176406,35,49,21,28,48,20,28,1,1,0
176451,35,9,4,5,,,,9,4,5
176479,35,333,104,229,295,91,204,38,13,25
176628,35,102,46,56,100,44,56,2,2,0
176664,35,43,20,23,38,17,21,5,3,2
176770,35,214,30,184,96,14,82,118,16,102
176789,35,24,13,11,14,7,7,10,6,4
176910,35,17,10,7,10,5,5,7,5,2
176947,35,87,55,32,83,53,30,4,2,2
176965,35,715,341,374,599,293,306,116,48,68
177038,35,18,7,11,9,5,4,9,2,7
177065,35,950,390,560,404,165,239,546,225,321
177083,35,3,3,0,3,3,0,,,
177117,35,11,0,11,11,0,11,,,
177135,35,267,101,166,128,60,68,139,41,98
177144,35,53,31,22,52,31,21,1,0,1
177214,35,72,31,41,71,30,41,1,1,0
177250,35,109,36,73,65,28,37,44,8,36
177339,35,124,69,55,68,39,29,56,30,26
177418,35,47,19,28,39,16,23,8,3,5
177472,35,814,319,495,414,177,237,400,142,258
177542,35,64,17,47,56,17,39,8,0,8
177551,35,72,26,46,61,22,39,11,4,7
177676,35,172,61,111,95,37,58,77,24,53
177719,35,189,24,165,177,23,154,12,1,11
177746,35,50,12,38,50,12,38,,,
177940,35,102,47,55,92,45,47,10,2,8
177968,35,483,227,256,410,196,214,73,31,42
177977,35,34,23,11,33,23,10,1,0,1
177986,35,117,40,77,63,23,40,54,17,37
177995,35,1254,434,820,512,228,284,742,206,536
178059,35,726,217,509,211,83,128,515,134,381
178183,35,30,1,29,30,1,29,,,
178208,35,165,116,49,81,61,20,84,55,29
178217,35,78,36,42,59,29,30,19,7,12
178244,35,265,114,151,217,101,116,48,13,35
178341,35,339,139,200,254,115,139,85,24,61
178369,35,142,77,65,122,70,52,20,7,13
178387,35,210,80,130,173,68,105,37,12,25
178396,35,1348,682,666,1207,618,589,141,64,77
178402,35,999,420,579,796,331,465,203,89,114
178411,35,234,180,54,192,145,47,42,35,7
178420,35,1045,428,617,791,324,467,254,104,150
178448,35,189,84,105,120,57,63,69,27,42
178615,35,97,48,49,94,48,46,3,0,3
178624,35,305,117,188,243,106,137,62,11,51
178679,35,41,25,16,32,19,13,9,6,3
178697,35,29,14,15,29,14,15,,,
178721,35,706,361,345,371,170,201,335,191,144
178767,35,7,0,7,3,0,3,4,0,4
178891,35,242,215,27,162,143,19,80,72,8
179043,35,132,30,102,109,30,79,23,0,23
179159,35,435,202,233,253,113,140,182,89,93
179256,35,12,8,4,11,7,4,1,1,0
179265,35,14,2,12,14,2,12,,,
179308,35,1052,278,774,427,138,289,625,140,485
179326,35,140,44,96,78,29,49,62,15,47
179344,35,51,22,29,28,12,16,23,10,13
179511,35,20,0,20,12,0,12,8,0,8
179539,35,188,72,116,114,47,67,74,25,49
179548,35,41,0,41,37,0,37,4,0,4
179557,35,511,227,284,454,205,249,57,22,35
179566,35,1308,562,746,1122,485,637,186,77,109
179645,35,96,33,63,60,23,37,36,10,26
179715,35,90,14,76,37,11,26,53,3,50
179867,35,190,94,96,109,68,41,81,26,55
179894,35,245,102,143,184,77,107,61,25,36
179946,35,14,10,4,14,10,4,,,
179955,35,43,22,21,43,22,21,,,
179964,35,94,19,75,66,18,48,28,1,27
180081,35,29,17,12,24,15,9,5,2,3
180106,35,39,11,28,37,11,26,2,0,2
180151,35,28,14,14,21,12,9,7,2,5
180179,35,308,127,181,214,101,113,94,26,68
180197,35,111,56,55,47,31,16,64,25,39
180203,35,8,4,4,7,4,3,1,0,1
180212,35,31,12,19,19,8,11,12,4,8
180249,35,109,23,86,61,16,45,48,7,41
180258,35,139,31,108,93,26,67,46,5,41
180276,35,77,29,48,40,23,17,37,6,31
180373,35,44,8,36,23,4,19,21,4,17
180416,35,69,42,27,61,39,22,8,3,5
180461,35,717,355,362,537,287,250,180,68,112
180489,35,646,267,379,499,210,289,147,57,90
180522,35,92,33,59,71,30,41,21,3,18
180595,35,36,17,19,34,17,17,2,0,2
180647,35,52,13,39,44,12,32,8,1,7
180692,35,129,39,90,79,29,50,50,10,40
180717,35,9,5,4,9,5,4,,,
180814,35,1878,846,1032,1007,435,572,871,411,460
180832,35,174,28,146,112,18,94,62,10,52
180878,35,51,6,45,22,1,21,29,5,24
180902,35,234,103,131,167,80,87,67,23,44
180948,35,148,52,96,119,43,76,29,9,20
180984,35,43,19,24,43,19,24,,,
181002,35,165,46,119,150,42,108,15,4,11
181020,35,60,33,27,42,26,16,18,7,11
181127,35,31,21,10,31,21,10,,,
181145,35,12,0,12,12,0,12,,,
181215,35,347,115,232,260,103,157,87,12,75
181297,35,227,27,200,157,22,135,70,5,65
181303,35,547,273,274,221,115,106,326,158,168
181312,35,89,43,46,54,29,25,35,14,21
181330,35,106,45,61,102,44,58,4,1,3
181394,35,1183,511,672,931,391,540,252,120,132
181419,35,27,14,13,16,8,8,11,6,5
181428,35,367,56,311,328,52,276,39,4,35
181446,35,72,33,39,70,33,37,2,0,2
181464,35,685,366,319,642,345,297,43,21,22
181491,35,157,60,97,95,48,47,62,12,50
181534,35,164,72,92,108,54,54,56,18,38
181543,35,1,1,0,1,1,0,,,
181604,35,71,0,71,69,0,69,2,0,2
181640,35,610,258,352,326,164,162,284,94,190
181738,35,40,14,26,38,13,25,2,1,1
181765,35,19,4,15,18,4,14,1,0,1
181783,35,192,77,115,145,58,87,47,19,28
181817,35,102,43,59,73,36,37,29,7,22
181853,35,35,26,9,35,26,9,,,
181941,35,43,26,17,43,26,17,,,
182005,35,1749,677,1072,665,285,380,1084,392,692
182148,35,30,10,20,30,10,20,,,
182281,35,2094,873,1221,1479,624,855,615,249,366
182290,35,1096,478,618,823,378,445,273,100,173
182306,35,77,26,51,21,7,14,56,19,37
182458,35,36,20,16,35,20,15,1,0,1
182500,35,423,177,246,129,54,75,294,123,171
182564,35,171,64,107,53,18,35,118,46,72
182634,35,45,13,32,42,11,31,3,2,1
182670,35,23,15,8,23,15,8,,,
182795,35,48,18,30,24,12,12,24,6,18
182917,35,1,1,0,1,1,0,,,
182980,35,85,49,36,74,45,29,11,4,7
183026,35,18936,7176,11760,5013,1960,3053,13923,5216,8707
183044,35,405,187,218,394,181,213,11,6,5
183062,35,121,61,60,119,60,59,2,1,1
183071,35,100,49,51,90,43,47,10,6,4
183080,35,173,98,75,169,96,73,4,2,2
183099,35,304,93,211,91,40,51,213,53,160
183105,35,90,26,64,39,13,26,51,13,38
183114,35,153,31,122,33,8,25,120,23,97
183123,35,68,32,36,25,13,12,43,19,24
183132,35,257,100,157,65,38,27,192,62,130
183141,35,111,44,67,26,17,9,85,27,58
183150,35,199,58,141,71,28,43,128,30,98
183211,35,141,31,110,58,23,35,83,8,75
183239,35,15,4,11,15,4,11,,,
183248,35,21,6,15,3,2,1,18,4,14
183257,35,264,69,195,180,50,130,84,19,65
183275,35,9,5,4,9,5,4,,,
183488,35,44,1,43,27,0,27,17,1,16
183655,35,181,70,111,87,35,52,94,35,59
183743,35,593,252,341,351,168,183,242,84,158
183789,35,243,46,197,177,40,137,66,6,60
183804,35,515,515,0,514,514,0,1,1,0
183822,35,93,41,52,84,39,45,9,2,7
183859,35,265,124,141,145,70,75,120,54,66
183877,35,293,80,213,94,34,60,199,46,153
183910,35,80,16,64,69,13,56,11,3,8
183938,35,440,190,250,210,108,102,230,82,148
183974,35,82,27,55,79,25,54,3,2,1
184180,35,355,158,197,159,88,71,196,70,126
184205,35,96,35,61,32,16,16,64,19,45
184348,35,83,42,41,83,42,41,,,
184481,35,209,88,121,111,53,58,98,35,63
184603,35,142,66,76,104,43,61,38,23,15
184612,35,171,41,130,160,37,123,11,4,7
184694,35,86,40,46,84,40,44,2,0,2
184773,35,152,27,125,140,25,115,12,2,10
184782,35,1614,763,851,1421,681,740,193,82,111
184791,35,388,134,254,184,75,109,204,59,145
184959,35,170,26,144,87,14,73,83,12,71
184995,35,208,79,129,118,47,71,90,32,58
185129,35,534,180,354,443,162,281,91,18,73
185262,35,1195,430,765,836,305,531,359,125,234
185509,35,89,27,62,25,9,16,64,18,46
185536,35,250,108,142,126,57,69,124,51,73
185572,35,203,95,108,192,91,101,11,4,7
185590,35,1173,500,673,1053,450,603,120,50,70
185721,35,55,10,45,42,8,34,13,2,11
185828,35,700,539,161,562,440,122,138,99,39
185873,35,178,81,97,84,51,33,94,30,64
186034,35,60,28,32,28,17,11,32,11,21
186131,35,13,6,7,13,6,7,,,
186186,35,57,57,0,57,57,0,,,
186201,35,356,173,183,316,157,159,40,16,24
186283,35,194,86,108,180,78,102,14,8,6
186371,35,625,206,419,521,185,336,104,21,83
186380,35,2411,1196,1215,2273,1154,1119,138,42,96
186399,35,851,366,485,754,330,424,97,36,61
186432,35,204,57,147,199,56,143,5,1,4
186469,35,93,37,56,53,28,25,40,9,31
186584,35,144,64,80,141,64,77,3,0,3
186618,35,86,23,63,63,19,44,23,4,19
186645,35,255,140,115,113,66,47,142,74,68
186867,35,27,23,4,27,23,4,,,
186876,35,943,360,583,919,352,567,24,8,16
186900,35,21,21,0,21,21,0,,,
187046,35,2071,1254,817,24,6,18,2047,1248,799
187134,35,208,116,92,199,111,88,9,5,4
187198,35,531,150,381,230,87,143,301,63,238
187444,35,739,245,494,483,193,290,256,52,204
187532,35,852,325,527,270,121,149,582,204,378
187596,35,82,23,59,31,9,22,51,14,37
187620,35,187,68,119,83,31,52,104,37,67
187639,35,120,30,90,45,12,33,75,18,57
187648,35,350,118,232,224,68,156,126,50,76
187666,35,60,28,32,29,15,14,31,13,18
187745,35,30,12,18,18,8,10,12,4,8
187897,35,238,66,172,149,51,98,89,15,74
187903,35,48,19,29,26,17,9,22,2,20
187912,35,26,21,5,26,21,5,,,
187958,35,52,14,38,9,3,6,43,11,32
187967,35,41,25,16,39,23,16,2,2,0
187976,35,43,22,21,4,3,1,39,19,20
187985,35,938,386,552,602,281,321,336,105,231
187994,35,21,11,10,8,4,4,13,7,6
188003,35,14,2,12,2,1,1,12,1,11
188021,35,20,4,16,6,2,4,14,2,12
188030,35,498,252,246,424,216,208,74,36,38
188049,35,53,21,32,6,2,4,47,19,28
188058,35,79,34,45,43,20,23,36,14,22
188100,35,318,61,257,85,16,69,233,45,188
188137,35,248,93,155,74,36,38,174,57,117
188182,35,173,77,96,145,65,80,28,12,16
188216,35,30,11,19,19,8,11,11,3,8
188225,35,68,25,43,10,6,4,58,19,39
188261,35,22,13,9,10,7,3,12,6,6
188304,35,159,58,101,114,53,61,45,5,40
188340,35,143,115,28,126,100,26,17,15,2
188429,35,312,99,213,284,92,192,28,7,21
188438,35,111,46,65,81,39,42,30,7,23
188517,35,62,27,35,59,26,33,3,1,2
188526,35,61,18,43,61,18,43,,,
188641,35,55,19,36,54,19,35,1,0,1
188678,35,21,7,14,21,7,14,,,
188687,35,53,13,40,30,6,24,23,7,16
188854,35,55,12,43,55,12,43,,,
188915,35,19,4,15,6,2,4,13,2,11
188942,35,81,0,81,76,0,76,5,0,5
189088,35,85,36,49,82,34,48,3,2,1
189097,35,112,0,112,110,0,110,2,0,2
189228,35,212,59,153,159,44,115,53,15,38
189273,35,6,6,0,6,6,0,,,
189282,35,115,13,102,82,13,69,33,0,33
189413,35,31,3,28,31,3,28,,,
189547,35,278,102,176,176,70,106,102,32,70
189565,35,94,31,63,88,28,60,6,3,3
189583,35,80,24,56,71,19,52,9,5,4
189592,35,72,23,49,64,21,43,8,2,6
189705,35,75,46,29,74,45,29,1,1,0
189811,35,134,23,111,134,23,111,,,
189839,35,134,40,94,78,24,54,56,16,40
189848,35,22,15,7,22,15,7,,,
189857,35,279,279,0,279,279,0,,,
190044,35,68,54,14,67,54,13,1,0,1
190053,35,43,20,23,23,13,10,20,7,13
190071,35,33,4,29,,,,33,4,29
190099,35,26,8,18,25,8,17,1,0,1
190114,35,61,16,45,48,6,42,13,10,3
190150,35,832,489,343,700,425,275,132,64,68
190169,35,78,27,51,37,17,20,41,10,31
190372,35,15,5,10,15,5,10,,,
190415,35,655,293,362,655,293,362,,,
190442,35,65,23,42,39,14,25,26,9,17
190451,35,55,13,42,12,6,6,43,7,36
190503,35,402,221,181,401,221,180,1,0,1
190512,35,1498,710,788,1132,535,597,366,175,191
190521,35,1218,444,774,721,279,442,497,165,332
190530,35,480,176,304,327,124,203,153,52,101
190549,35,1216,488,728,934,372,562,282,116,166
190558,35,484,224,260,342,168,174,142,56,86
190567,35,793,324,469,610,243,367,183,81,102
190576,35,805,199,606,284,83,201,521,116,405
190585,35,526,117,409,321,87,234,205,30,175
190594,35,1883,579,1304,1368,410,958,515,169,346
190600,35,1721,693,1028,1433,578,855,288,115,173
190619,35,650,257,393,491,199,292,159,58,101
190628,35,1110,394,716,681,252,429,429,142,287
190637,35,1639,507,1132,1081,340,741,558,167,391
190646,35,268,48,220,197,32,165,71,16,55
190655,35,1045,426,619,565,276,289,480,150,330
190664,35,1402,616,786,1092,480,612,310,136,174
190673,35,705,276,429,400,188,212,305,88,217
190691,35,499,157,342,335,106,229,164,51,113
190716,35,171,40,131,123,32,91,48,8,40
190725,35,288,67,221,256,63,193,32,4,28
190752,35,2,2,0,2,2,0,,,
190761,35,96,34,62,83,33,50,13,1,12
190840,35,165,70,95,119,52,67,46,18,28
190956,35,74,9,65,,,,74,9,65
190983,35,31,5,26,28,4,24,3,1,2
191083,35,277,112,165,213,92,121,64,20,44
191126,35,693,119,574,643,108,535,50,11,39
191199,35,237,93,144,153,65,88,84,28,56
191205,35,40,30,10,36,28,8,4,2,2
191241,35,312,154,158,291,149,142,21,5,16
191302,35,34,10,24,22,8,14,12,2,10
191339,35,231,79,152,123,51,72,108,28,80
191515,35,4,2,2,4,2,2,,,
191533,35,35,10,25,34,10,24,1,0,1
191597,35,207,23,184,75,10,65,132,13,119
191612,35,146,68,78,117,53,64,29,15,14
191621,35,64,21,43,58,21,37,6,0,6
191630,35,24,13,11,21,12,9,3,1,2
191649,35,249,117,132,209,100,109,40,17,23
191676,35,46,10,36,43,10,33,3,0,3
191719,35,574,254,320,431,211,220,143,43,100
191931,35,265,78,187,260,75,185,5,3,2
191968,35,75,35,40,75,35,40,,,
191986,35,135,53,82,109,49,60,26,4,22
192004,35,18,2,16,18,2,16,,,
192022,35,123,40,83,74,26,48,49,14,35
192040,35,2,0,2,2,0,2,,,
192110,35,10,6,4,10,6,4,,,
192192,35,102,18,84,78,11,67,24,7,17
192271,35,118,13,105,111,12,99,7,1,6
192323,35,152,68,84,104,53,51,48,15,33
192448,35,752,186,566,619,171,448,133,15,118
192509,35,46,7,39,40,7,33,6,0,6
192624,35,13,13,0,13,13,0,,,
192688,35,107,15,92,105,15,90,2,0,2
192703,35,111,79,32,104,74,30,7,5,2
192712,35,11,8,3,11,8,3,,,
192749,35,131,38,93,125,36,89,6,2,4
192785,35,151,21,130,37,10,27,114,11,103
192819,35,114,48,66,111,48,63,3,0,3
192864,35,96,28,68,90,28,62,6,0,6
192925,35,79,13,66,64,13,51,15,0,15
192961,35,23,5,18,,,,23,5,18
193016,35,611,163,448,566,149,417,45,14,31
193052,35,110,110,0,110,110,0,,,
193201,35,8,0,8,8,0,8,,,
193247,35,9,9,0,9,9,0,,,
193283,35,127,50,77,92,38,54,35,12,23
193292,35,224,80,144,175,70,105,49,10,39
193308,35,945,491,454,734,456,278,211,35,176
193326,35,671,269,402,399,182,217,272,87,185
193353,35,132,26,106,98,21,77,34,5,29
193399,35,465,51,414,450,49,401,15,2,13
193478,35,720,337,383,518,256,262,202,81,121
193584,35,86,24,62,84,24,60,2,0,2
193654,35,472,130,342,421,121,300,51,9,42
193900,35,1039,332,707,998,323,675,41,9,32
193946,35,300,113,187,205,79,126,95,34,61
193973,35,119,49,70,116,48,68,3,1,2
194028,35,88,23,65,57,17,40,31,6,25
194091,35,174,75,99,130,58,72,44,17,27
194116,35,119,12,107,20,5,15,99,7,92
194161,35,126,41,85,102,32,70,24,9,15
194222,35,262,128,134,175,93,82,87,35,52
194240,35,252,86,166,121,49,72,131,37,94
194310,35,470,165,305,432,151,281,38,14,24
194392,35,47,33,14,45,32,13,2,1,1
194499,35,118,24,94,118,24,94,,,
194569,35,50,29,21,42,24,18,8,5,3
194578,35,168,53,115,164,52,112,4,1,3
194657,35,6,6,0,6,6,0,,,
194666,35,31,31,0,31,31,0,,,
194824,35,67,49,18,67,49,18,,,
194958,35,117,28,89,98,24,74,19,4,15
195003,35,324,184,140,317,181,136,7,3,4
195030,35,109,52,57,109,52,57,,,
195058,35,110,52,58,61,34,27,49,18,31
195128,35,129,41,88,125,40,85,4,1,3
195164,35,47,22,25,47,22,25,,,
195173,35,147,52,95,142,51,91,5,1,4
195191,35,195,29,166,77,7,70,118,22,96
195216,35,21,11,10,21,11,10,,,
195234,35,99,28,71,97,26,71,2,2,0
195243,35,88,48,40,86,46,40,2,2,0
195289,35,52,6,46,5,2,3,47,4,43
195304,35,31,5,26,31,5,26,,,
195322,35,72,27,45,45,18,27,27,9,18
195438,35,114,114,0,114,114,0,,,
195474,35,132,61,71,128,59,69,4,2,2
195526,35,20,8,12,20,8,12,,,
195544,35,387,115,272,341,104,237,46,11,35
195702,35,79,9,70,38,7,31,41,2,39
195720,35,133,64,69,122,62,60,11,2,9
195784,35,113,13,100,113,13,100,,,
195809,35,281,128,153,278,128,150,3,0,3
195988,35,78,22,56,38,15,23,40,7,33
196006,35,273,135,138,235,124,111,38,11,27
196015,35,316,116,200,260,96,164,56,20,36
196024,35,272,90,182,148,72,76,124,18,106
196033,35,167,85,82,156,81,75,11,4,7
196042,35,927,518,409,752,450,302,175,68,107
196051,35,133,44,89,96,40,56,37,4,33
196060,35,1049,524,525,979,494,485,70,30,40
196079,35,936,461,475,929,456,473,7,5,2
196088,35,1488,772,716,1391,728,663,97,44,53
196097,35,1404,612,792,1281,561,720,123,51,72
196103,35,198,112,86,168,97,71,30,15,15
196112,35,266,152,114,243,143,100,23,9,14
196121,35,756,276,480,609,247,362,147,29,118
196130,35,450,203,247,400,182,218,50,21,29
196149,35,554,316,238,545,310,235,9,6,3
196158,35,216,94,122,212,91,121,4,3,1
196167,35,182,67,115,179,66,113,3,1,2
196176,35,639,245,394,578,213,365,61,32,29
196185,35,303,149,154,300,146,154,3,3,0
196194,35,546,262,284,492,242,250,54,20,34
196200,35,154,64,90,152,63,89,2,1,1
196219,35,224,108,116,203,100,103,21,8,13
196237,35,490,188,302,445,169,276,45,19,26
196246,35,316,138,178,272,128,144,44,10,34
196255,35,173,40,133,158,39,119,15,1,14
196264,35,1233,408,825,741,221,520,492,187,305
196291,35,61,47,14,59,46,13,2,1,1
196307,35,73,15,58,70,15,55,3,0,3
196413,35,279,143,136,227,118,109,52,25,27
196431,35,237,237,0,237,237,0,,,
196440,35,3,3,0,3,3,0,,,
196565,35,154,59,95,109,49,60,45,10,35
196583,35,5,5,0,5,5,0,,,
196592,35,479,148,331,394,131,263,85,17,68
196653,35,233,36,197,131,22,109,102,14,88
196680,35,1179,618,561,,,,1179,618,561
196699,35,62,23,39,33,10,23,29,13,16
196866,35,17,12,5,17,12,5,,,
197018,35,155,155,0,155,155,0,,,
197027,35,38,31,7,38,31,7,,,
197045,35,294,85,209,245,70,175,49,15,34
197133,35,15,3,12,15,3,12,,,
197142,35,57,26,31,45,21,24,12,5,7
197151,35,165,59,106,164,59,105,1,0,1
197197,35,57,28,29,57,28,29,,,
197221,35,2,0,2,2,0,2,,,
197230,35,13,5,8,13,5,8,,,
197285,35,95,24,71,88,24,64,7,0,7
197294,35,477,208,269,260,130,130,217,78,139
197647,35,22,22,0,22,22,0,,,
197674,35,25,25,0,25,25,0,,,
197708,35,36,20,16,36,20,16,,,
197735,35,47,47,0,47,47,0,,,
197744,35,17,17,0,17,17,0,,,
197814,35,356,79,277,131,38,93,225,41,184
197850,35,219,62,157,67,29,38,152,33,119
197869,35,1524,701,823,1360,655,705,164,46,118
197887,35,459,139,320,153,52,101,306,87,219
197911,35,94,49,45,94,49,45,,,
197966,35,104,15,89,25,5,20,79,10,69
197984,35,80,40,40,75,40,35,5,0,5
197993,35,14,0,14,14,0,14,,,
198011,35,52,13,39,5,2,3,47,11,36
198039,35,224,66,158,66,22,44,158,44,114
198066,35,50,35,15,49,34,15,1,1,0
198084,35,130,45,85,53,28,25,77,17,60
198109,35,198,14,184,121,7,114,77,7,70
198118,35,307,119,188,120,56,64,187,63,124
198136,35,270,142,128,199,99,100,71,43,28
198154,35,500,196,304,236,100,136,264,96,168
198206,35,120,33,87,35,9,26,85,24,61
198215,35,85,42,43,75,39,36,10,3,7
198233,35,208,77,131,76,37,39,132,40,92
198251,35,350,97,253,116,47,69,234,50,184
198260,35,808,363,445,434,189,245,374,174,200
198303,35,57,33,24,36,25,11,21,8,13
198321,35,106,28,78,36,13,23,70,15,55
198330,35,332,101,231,164,47,117,168,54,114
198367,35,267,94,173,110,42,68,157,52,105
198376,35,183,36,147,69,20,49,114,16,98
198385,35,11,5,6,11,5,6,,,
198419,35,50,22,28,50,22,28,,,
198455,35,158,51,107,32,11,21,126,40,86
198464,35,1777,813,964,1321,643,678,456,170,286
198491,35,389,48,341,82,12,70,307,36,271
198507,35,197,79,118,159,70,89,38,9,29
198516,35,85,40,45,85,40,45,,,
198534,35,1314,465,849,516,185,331,798,280,518
198543,35,778,218,560,523,152,371,255,66,189
198552,35,945,278,667,404,153,251,541,125,416
198561,35,224,49,175,152,43,109,72,6,66
198570,35,205,69,136,73,48,25,132,21,111
198598,35,49,33,16,46,32,14,3,1,2
198613,35,34,21,13,32,21,11,2,0,2
198622,35,1225,556,669,648,312,336,577,244,333
198640,35,38,10,28,19,5,14,19,5,14
198668,35,98,25,73,45,11,34,53,14,39
198677,35,9,2,7,9,2,7,,,
198695,35,71,38,33,71,38,33,,,
198710,35,87,26,61,33,13,20,54,13,41
198729,35,77,8,69,27,2,25,50,6,44
198756,35,75,39,36,69,34,35,6,5,1
198774,35,250,71,179,119,37,82,131,34,97
198808,35,116,27,89,113,26,87,3,1,2
198817,35,164,54,110,64,29,35,100,25,75
198835,35,70,29,41,50,25,25,20,4,16
198862,35,45,31,14,44,30,14,1,1,0
198871,35,37,23,14,36,23,13,1,0,1
198899,35,50,19,31,46,18,28,4,1,3
198905,35,41,10,31,29,5,24,12,5,7
198914,35,4,0,4,,,,4,0,4
198923,35,41,6,35,16,2,14,25,4,21
198950,35,45,0,45,42,0,42,3,0,3
198969,35,145,62,83,107,49,58,38,13,25
198978,35,3,0,3,3,0,3,,,
198987,35,68,25,43,26,9,17,42,16,26
199023,35,30,20,10,18,17,1,12,3,9
199032,35,59,42,17,56,39,17,3,3,0
199069,35,247,75,172,147,52,95,100,23,77
199087,35,23,8,15,11,4,7,12,4,8
199102,35,780,320,460,682,279,403,98,41,57
199111,35,297,135,162,262,119,143,35,16,19
199120,35,1039,450,589,998,432,566,41,18,23
199139,35,2605,1306,1299,2142,1106,1036,463,200,263
199148,35,1571,543,1028,1161,429,732,410,114,296
199157,35,470,138,332,356,117,239,114,21,93
199184,35,35,12,23,35,12,23,,,
199193,35,1404,718,686,1315,672,643,89,46,43
199209,35,115,42,73,88,35,53,27,7,20
199218,35,1984,632,1352,1373,551,822,611,81,530
199263,35,29,3,26,3,1,2,26,2,24
199272,35,61,30,31,53,30,23,8,0,8
199281,35,903,307,596,617,217,400,286,90,196
199306,35,44,17,27,39,16,23,5,1,4
199324,35,35,9,26,7,3,4,28,6,22
199333,35,838,299,539,367,150,217,471,149,322
199412,35,134,45,89,125,45,80,9,0,9
199421,35,54,9,45,14,5,9,40,4,36
199449,35,162,48,114,76,23,53,86,25,61
199458,35,16,9,7,16,9,7,,,
199467,35,22,4,18,8,2,6,14,2,12
199476,35,205,51,154,103,28,75,102,23,79
199485,35,78,27,51,20,12,8,58,15,43
199494,35,207,67,140,74,32,42,133,35,98
199607,35,20,1,19,11,0,11,9,1,8
199625,35,38,8,30,5,3,2,33,5,28
199634,35,219,70,149,80,37,43,139,33,106
199643,35,118,65,53,106,62,44,12,3,9
199698,35,104,45,59,104,45,59,,,
199722,35,23,9,14,8,4,4,15,5,10
199731,35,240,90,150,74,25,49,166,65,101
199740,35,223,41,182,60,15,45,163,26,137
199759,35,49,29,20,35,20,15,14,9,5
199768,35,132,44,88,43,16,27,89,28,61
199786,35,91,39,52,33,14,19,58,25,33
199795,35,35,8,27,17,4,13,18,4,14
199838,35,155,46,109,57,16,41,98,30,68
199847,35,22,13,9,22,13,9,,,
199856,35,2306,933,1373,819,364,455,1487,569,918
199865,35,41,11,30,41,11,30,,,
199892,35,163,44,119,65,17,48,98,27,71
199908,35,294,66,228,92,31,61,202,35,167
199926,35,54,17,37,26,10,16,28,7,21
199953,35,182,38,144,69,19,50,113,19,94
199962,35,88,39,49,84,39,45,4,0,4
199971,35,1,0,1,1,0,1,,,
199999,35,399,100,299,267,77,190,132,23,109
200004,35,1032,464,568,661,307,354,371,157,214
200013,35,96,13,83,48,5,43,48,8,40
200022,35,238,138,100,154,91,63,84,47,37
200059,35,149,64,85,124,56,68,25,8,17
200086,35,10,1,9,9,1,8,1,0,1
200156,35,46,28,18,44,27,17,2,1,1
200192,35,88,31,57,50,21,29,38,10,28
200208,35,15,5,10,11,5,6,4,0,4
200217,35,124,55,69,117,53,64,7,2,5
200226,35,122,38,84,81,27,54,41,11,30
200253,35,236,68,168,169,54,115,67,14,53
200280,35,893,492,401,511,273,238,382,219,163
200305,35,156,80,76,125,72,53,31,8,23
200314,35,86,24,62,52,16,36,34,8,26
200332,35,556,275,281,478,265,213,78,10,68
200341,35,52,22,30,37,18,19,15,4,11
200466,35,17,9,8,16,9,7,1,0,1
200484,35,18,10,8,12,7,5,6,3,3
200527,35,2,1,1,2,1,1,,,
200554,35,76,24,52,76,24,52,,,
200572,35,88,31,57,58,22,36,30,9,21
200590,35,56,8,48,49,4,45,7,4,3
200785,35,13,1,12,4,0,4,9,1,8
200800,35,406,211,195,330,174,156,76,37,39
200846,35,24,10,14,16,5,11,8,5,3
200873,35,2,2,0,2,2,0,,,
201061,35,20,7,13,19,7,12,1,0,1
201104,35,252,156,96,128,62,66,124,94,30
201140,35,1,1,0,,,,1,1,0
201177,35,33,2,31,15,0,15,18,2,16
201195,35,155,61,94,141,57,84,14,4,10
201283,35,41,10,31,20,7,13,21,3,18
201371,35,21,6,15,18,6,12,3,0,3
201432,35,66,19,47,40,14,26,26,5,21
201441,35,523,245,278,441,200,241,82,45,37
201469,35,151,30,121,134,26,108,17,4,13
201548,35,116,38,78,109,36,73,7,2,5
201645,35,74,31,43,71,31,40,3,0,3
201654,35,109,45,64,109,45,64,,,
201672,35,280,51,229,91,17,74,189,34,155
201690,35,1347,352,995,343,109,234,1004,243,761
201751,35,6,2,4,2,1,1,4,1,3
201821,35,127,10,117,81,6,75,46,4,42
201867,35,55,10,45,55,10,45,,,
201885,35,1205,478,727,794,389,405,411,89,322
201928,35,784,322,462,360,154,206,424,168,256
201946,35,420,115,305,171,58,113,249,57,192
201955,35,330,118,212,200,85,115,130,33,97
201964,35,79,36,43,54,27,27,25,9,16
201973,35,686,218,468,191,73,118,495,145,350
202046,35,19,6,13,18,5,13,1,1,0
202073,35,11,8,3,11,8,3,,,
202134,35,963,406,557,757,329,428,206,77,129
202170,35,75,32,43,75,32,43,,,
202222,35,1462,637,825,596,259,337,866,378,488
202356,35,1197,427,770,410,178,232,787,249,538
202435,35,19,0,19,14,0,14,5,0,5
202480,35,195,105,90,189,101,88,6,4,2
202514,35,30,25,5,30,25,5,,,
202523,35,19,9,10,19,9,10,,,
202648,35,115,36,79,34,17,17,81,19,62
202763,35,78,26,52,74,25,49,4,1,3
202806,35,1425,521,904,397,132,265,1028,389,639
202903,35,24,16,8,12,8,4,12,8,4
202912,35,77,3,74,43,2,41,34,1,33
203085,35,22,10,12,22,10,12,,,
203128,35,30,14,16,24,11,13,6,3,3
203155,35,165,98,67,124,79,45,41,19,22
203289,35,7,6,1,7,6,1,,,
203331,35,7238,2579,4659,1388,494,894,5850,2085,3765
203368,35,60,38,22,57,37,20,3,1,2
203386,35,581,46,535,493,30,463,88,16,72
203447,35,61,14,47,14,1,13,47,13,34
203456,35,40,12,28,1,0,1,39,12,27
203465,35,161,59,102,60,22,38,101,37,64
203474,35,78,33,45,21,6,15,57,27,30
203483,35,65,22,43,22,6,16,43,16,27
203492,35,52,8,44,24,3,21,28,5,23
203517,35,933,409,524,796,350,446,137,59,78
203526,35,80,23,57,14,3,11,66,20,46
203535,35,18,12,6,18,12,6,,,
203544,35,74,13,61,39,8,31,35,5,30
203580,35,35,16,19,33,16,17,2,0,2
203599,35,247,75,172,107,51,56,140,24,116
203678,35,109,27,82,60,19,41,49,8,41
203720,35,43,19,24,38,19,19,5,0,5
203748,35,389,133,256,107,52,55,282,81,201
203757,35,40,25,15,36,23,13,4,2,2
203775,35,44,21,23,31,15,16,13,6,7
203845,35,26,14,12,26,14,12,,,
203881,35,121,39,82,35,11,24,86,28,58
203960,35,269,27,242,46,5,41,223,22,201
204006,35,123,61,62,93,45,48,30,16,14
204015,35,94,42,52,59,24,35,35,18,17
204024,35,241,131,110,236,129,107,5,2,3
204176,35,137,17,120,65,9,56,72,8,64
204185,35,48,24,24,48,24,24,,,
204194,35,107,31,76,38,14,24,69,17,52
204200,35,58,25,33,50,23,27,8,2,6
204255,35,95,32,63,67,25,42,28,7,21
204264,35,100,32,68,54,26,28,46,6,40
204422,35,73,26,47,36,15,21,37,11,26
204440,35,47,26,21,26,17,9,21,9,12
204468,35,131,54,77,84,42,42,47,12,35
204486,35,116,87,29,113,86,27,3,1,2
204501,35,19,8,11,19,8,11,,,
204617,35,47,22,25,45,20,25,2,2,0
204635,35,42,25,17,42,25,17,,,
204662,35,24,13,11,19,9,10,5,4,1
204671,35,51,16,35,46,15,31,5,1,4
204680,35,65,26,39,48,21,27,17,5,12
204699,35,66,28,38,45,18,27,21,10,11
204705,35,139,66,73,100,49,51,39,17,22
204796,35,3702,1960,1742,3391,1826,1565,311,134,177
204802,35,13,4,9,8,1,7,5,3,2
204820,35,40,15,25,20,7,13,20,8,12
204839,35,52,16,36,41,12,29,11,4,7
204848,35,32,10,22,20,7,13,12,3,9
204857,35,924,274,650,415,198,217,509,76,433
204866,35,53,8,45,36,7,29,17,1,16
204884,35,53,1,52,53,1,52,,,
204909,35,20,11,9,20,11,9,,,
204936,35,85,33,52,83,32,51,2,1,1
204945,35,406,160,246,185,80,105,221,80,141
205027,35,10,10,0,10,10,0,,,
205054,35,39,1,38,39,1,38,,,
205124,35,3,3,0,3,3,0,,,
205179,35,49,7,42,49,7,42,,,
205203,35,157,45,112,75,37,38,82,8,74
205391,35,11,1,10,9,1,8,2,0,2
205443,35,138,56,82,112,47,65,26,9,17
205470,35,1713,967,746,341,168,173,1372,799,573
205559,35,8,1,7,8,1,7,,,
205841,35,718,304,414,289,150,139,429,154,275
205887,35,14,12,2,14,12,2,,,
205957,35,179,97,82,146,79,67,33,18,15
205966,35,88,21,67,35,14,21,53,7,46
206011,35,72,37,35,43,22,21,29,15,14
206048,35,115,49,66,88,43,45,27,6,21
206084,35,629,271,358,499,213,286,130,58,72
206154,35,3,3,0,2,2,0,1,1,0
206279,35,104,46,58,53,22,31,51,24,27
206349,35,77,9,68,62,7,55,15,2,13
206394,35,7,2,5,2,1,1,5,1,4
206437,35,64,29,35,46,22,24,18,7,11
206446,35,70,28,42,40,21,19,30,7,23
206491,35,32,15,17,29,13,16,3,2,1
206507,35,66,32,34,62,32,30,4,0,4
206525,35,25,12,13,23,11,12,2,1,1
206589,35,18,13,5,18,13,5,,,
206604,35,654,311,343,510,241,269,144,70,74
206613,35,164,70,94,31,14,17,133,56,77
206622,35,182,50,132,169,45,124,13,5,8
206695,35,372,147,225,275,123,152,97,24,73
206817,35,49,26,23,45,24,21,4,2,2
206835,35,83,46,37,53,29,24,30,17,13
206862,35,154,57,97,111,47,64,43,10,33
206914,35,266,81,185,190,55,135,76,26,50
206923,35,8,2,6,2,0,2,6,2,4
206932,35,20,4,16,18,4,14,2,0,2
206941,35,1209,480,729,857,360,497,352,120,232
207041,35,243,93,150,174,69,105,69,24,45
207050,35,55,27,28,29,18,11,26,9,17
207069,35,107,31,76,33,9,24,74,22,52
207157,35,32,18,14,31,17,14,1,1,0
207209,35,83,25,58,72,22,50,11,3,8
207236,35,209,60,149,95,36,59,114,24,90
207254,35,33,32,1,33,32,1,,,
207263,35,816,268,548,573,205,368,243,63,180
207281,35,95,27,68,40,14,26,55,13,42
207306,35,154,81,73,124,69,55,30,12,18
207324,35,197,68,129,154,62,92,43,6,37
207342,35,492,59,433,484,57,427,8,2,6
207351,35,300,90,210,185,74,111,115,16,99
207388,35,1603,734,869,1316,630,686,287,104,183
207397,35,489,162,327,104,44,60,385,118,267
207403,35,60,33,27,59,33,26,1,0,1
207449,35,1065,367,698,233,91,142,832,276,556
207458,35,110,47,63,106,46,60,4,1,3
207500,35,926,481,445,749,395,354,177,86,91
207564,35,338,171,167,150,95,55,188,76,112
207582,35,211,82,129,179,71,108,32,11,21
207661,35,251,100,151,178,72,106,73,28,45
207670,35,259,87,172,89,43,46,170,44,126
207722,35,98,36,62,88,35,53,10,1,9
207740,35,104,33,71,54,23,31,50,10,40
207847,35,20,9,11,13,6,7,7,3,4
207856,35,57,35,22,52,30,22,5,5,0
207865,35,235,93,142,197,87,110,38,6,32
207935,35,835,297,538,264,115,149,571,182,389
207971,35,96,48,48,89,45,44,7,3,4
208035,35,141,45,96,37,23,14,104,22,82
208275,35,38,9,29,25,7,18,13,2,11
208318,35,298,131,167,149,79,70,149,52,97
208390,35,173,66,107,98,43,55,75,23,52
208406,35,770,331,439,331,144,187,439,187,252
208415,35,16,7,9,9,3,6,7,4,3
208646,35,464,178,286,286,111,175,178,67,111
208725,35,3,2,1,3,2,1,,,
208822,35,203,51,152,165,40,125,38,11,27
209038,35,670,317,353,298,139,159,372,178,194
209056,35,41,11,30,41,11,30,,,
209065,35,59,23,36,59,23,36,,,
209074,35,726,311,415,216,92,124,510,219,291
209241,35,8,8,0,8,8,0,,,
209250,35,438,161,277,209,88,121,229,73,156
209287,35,47,31,16,39,29,10,8,2,6
209296,35,15,4,11,15,4,11,,,
209409,35,54,35,19,54,35,19,,,
209490,35,362,66,296,257,47,210,105,19,86
209506,35,501,226,275,311,145,166,190,81,109
209542,35,2581,1212,1369,1771,853,918,810,359,451
209551,35,1020,506,514,893,452,441,127,54,73
209603,35,48,15,33,46,15,31,2,0,2
209612,35,115,32,83,107,29,78,8,3,5
209746,35,1433,530,903,680,254,426,753,276,477
209807,35,2647,1131,1516,2112,919,1193,535,212,323
209825,35,60,23,37,60,23,37,,,
209922,35,15,3,12,15,3,12,,,
209940,35,123,41,82,58,21,37,65,20,45
210146,35,369,148,221,303,129,174,66,19,47
210155,35,80,31,49,49,25,24,31,6,25
210234,35,144,66,78,111,58,53,33,8,25
210270,35,100,42,58,39,18,21,61,24,37
210304,35,85,34,51,76,31,45,9,3,6
210331,35,61,37,24,48,32,16,13,5,8
210401,35,38,17,21,38,17,21,,,
210429,35,393,121,272,311,97,214,82,24,58
210492,35,19,11,8,19,11,8,,,
210571,35,63,29,34,44,24,20,19,5,14
210599,35,76,31,45,76,31,45,,,
210605,35,295,122,173,128,58,70,167,64,103
210669,35,6,5,1,6,5,1,,,
210739,35,95,40,55,74,35,39,21,5,16
210775,35,71,35,36,71,35,36,,,
211024,35,29,11,18,15,6,9,14,5,9
211079,35,83,43,40,39,28,11,44,15,29
211088,35,73,28,45,66,25,41,7,3,4
211158,35,295,120,175,262,107,155,33,13,20
211273,35,8,0,8,8,0,8,,,
211291,35,19,10,9,19,10,9,,,
211307,35,276,100,176,95,41,54,181,59,122
211343,35,180,81,99,99,53,46,81,28,53
211352,35,45,24,21,43,22,21,2,2,0
211361,35,444,190,254,318,138,180,126,52,74
211431,35,187,31,156,109,20,89,78,11,67
211440,35,83,51,32,82,51,31,1,0,1
211468,35,87,9,78,57,5,52,30,4,26
211477,35,161,55,106,65,30,35,96,25,71
211556,35,64,20,44,57,20,37,7,0,7
211583,35,119,38,81,93,35,58,26,3,23
211608,35,19,5,14,18,5,13,1,0,1
211644,35,221,58,163,118,39,79,103,19,84
211927,35,406,115,291,109,46,63,297,69,228
211981,35,124,55,69,122,54,68,2,1,1
212009,35,19,12,7,19,12,7,,,
212045,35,59,13,46,58,13,45,1,0,1
212054,35,580,231,349,501,204,297,79,27,52
212106,35,227,86,141,223,85,138,4,1,3
212115,35,346,137,209,304,128,176,42,9,33
212133,35,223,52,171,102,32,70,121,20,101
212160,35,172,77,95,146,62,84,26,15,11
212197,35,59,31,28,43,23,20,16,8,8
212434,35,3,3,0,3,3,0,,,
212577,35,14,6,8,14,6,8,,,
212601,35,76,36,40,71,35,36,5,1,4
212656,35,54,31,23,48,27,21,6,4,2
212674,35,17,6,11,17,6,11,,,
212771,35,32,1,31,20,0,20,12,1,11
212805,35,51,22,29,50,21,29,1,1,0
212832,35,144,33,111,140,32,108,4,1,3
212869,35,206,36,170,99,26,73,107,10,97
212878,35,791,257,534,326,121,205,465,136,329
212911,35,5,2,3,5,2,3,,,
212984,35,168,33,135,156,28,128,12,5,7
212993,35,15,8,7,15,8,7,,,
213011,35,85,24,61,48,18,30,37,6,31
213020,35,268,134,134,243,122,121,25,12,13
213181,35,65,4,61,43,3,40,22,1,21
213233,35,66,43,23,55,39,16,11,4,7
213251,35,21,12,9,21,12,9,,,
213303,35,74,33,41,56,30,26,18,3,15
213321,35,57,38,19,57,38,19,,,
213349,35,442,209,233,395,195,200,47,14,33
213358,35,101,35,66,68,26,42,33,9,24
213367,35,149,37,112,93,27,66,56,10,46
213376,35,167,48,119,109,38,71,58,10,48
213385,35,17,7,10,17,7,10,,,
213400,35,97,45,52,53,24,29,44,21,23
213507,35,39,21,18,36,19,17,3,2,1
213525,35,354,131,223,157,65,92,197,66,131
213534,35,2,1,1,2,1,1,,,
213543,35,35,18,17,35,18,17,,,
213570,35,11,1,10,11,1,10,,,
213589,35,7,6,1,6,5,1,1,1,0
213598,35,73,32,41,64,29,35,9,3,6
213613,35,127,56,71,109,55,54,18,1,17
213659,35,285,102,183,127,53,74,158,49,109
213668,35,18,10,8,17,10,7,1,0,1
213774,35,51,8,43,38,6,32,13,2,11
213783,35,85,30,55,76,28,48,9,2,7
213826,35,86,25,61,75,24,51,11,1,10
213914,35,59,6,53,59,6,53,,,
213987,35,122,53,69,99,48,51,23,5,18
213996,35,83,29,54,78,28,50,5,1,4
214023,35,3,0,3,3,0,3,,,
214041,35,421,155,266,286,119,167,135,36,99
214069,35,68,19,49,43,13,30,25,6,19
214111,35,563,193,370,198,91,107,365,102,263
214148,35,20,0,20,18,0,18,2,0,2
214157,35,84,33,51,84,33,51,,,
214166,35,91,15,76,79,14,65,12,1,11
214175,35,43,19,24,35,16,19,8,3,5
214272,35,96,38,58,69,20,49,27,18,9
214379,35,646,237,409,240,112,128,406,125,281
214582,35,23,7,16,12,6,6,11,1,10
214883,35,114,23,91,30,7,23,84,16,68
214892,35,27,11,16,27,11,16,,,
214944,35,4,2,2,,,,4,2,2
214971,35,8,2,6,8,2,6,,,
215053,35,20,7,13,19,7,12,1,0,1
215062,35,103,47,56,103,47,56,,,
215105,35,92,38,54,92,38,54,,,
215114,35,52,27,25,50,27,23,2,0,2
215132,35,24,5,19,24,5,19,,,
215239,35,333,107,226,138,44,94,195,63,132
215266,35,40,12,28,37,11,26,3,1,2
215275,35,93,42,51,79,35,44,14,7,7
215284,35,113,58,55,111,57,54,2,1,1
215293,35,1047,535,512,884,458,426,163,77,86
215309,35,10,1,9,9,1,8,1,0,1
215381,35,36,34,2,36,34,2,,,
215390,35,141,53,88,22,16,6,119,37,82
215415,35,173,81,92,160,73,87,13,8,5
215442,35,178,81,97,154,71,83,24,10,14
215585,35,272,98,174,77,34,43,195,64,131
215655,35,150,90,60,131,85,46,19,5,14
215691,35,43,16,27,34,14,20,9,2,7
215743,35,88,41,47,84,38,46,4,3,1
215770,35,92,44,48,83,42,41,9,2,7
215798,35,40,20,20,40,20,20,,,
215929,35,46,27,19,42,23,19,4,4,0
215947,35,83,34,49,65,31,34,18,3,15
215992,35,15,3,12,15,3,12,,,
216010,35,233,117,116,215,111,104,18,6,12
216038,35,466,248,218,394,213,181,72,35,37
216047,35,3,3,0,3,3,0,,,
216083,35,32,9,23,26,9,17,6,0,6
216278,35,17,9,8,17,9,8,,,
216287,35,7,5,2,7,5,2,,,
216296,35,110,94,16,110,94,16,,,
216311,35,1,1,0,1,1,0,,,
216339,35,1549,744,805,1399,666,733,150,78,72
216357,35,25,14,11,24,14,10,1,0,1
216366,35,769,143,626,653,115,538,116,28,88
216436,35,27,24,3,27,24,3,,,
216445,35,9,9,0,9,9,0,,,
216454,35,6,5,1,6,5,1,,,
216524,35,24,7,17,24,7,17,,,
216542,35,42,21,21,40,21,19,2,0,2
216551,35,11,8,3,9,6,3,2,2,0
216597,35,56,21,35,50,20,30,6,1,5
216667,35,15,10,5,15,10,5,,,
216694,35,34,17,17,33,16,17,1,1,0
216764,35,1177,474,703,929,411,518,248,63,185
216782,35,21,0,21,9,0,9,12,0,12
216807,35,26,16,10,22,13,9,4,3,1
216825,35,79,19,60,32,13,19,47,6,41
216852,35,128,38,90,121,37,84,7,1,6
216931,35,156,40,116,131,37,94,25,3,22
216940,35,2,2,0,2,2,0,,,
217013,35,46,9,37,29,8,21,17,1,16
217059,35,151,67,84,118,58,60,33,9,24
217077,35,40,8,32,40,8,32,,,
217156,35,88,59,29,88,59,29,,,
217165,35,82,55,27,81,55,26,1,0,1
217235,35,189,90,99,184,86,98,5,4,1
217305,35,118,52,66,118,52,66,,,
217402,35,95,50,45,56,32,24,39,18,21
217420,35,529,198,331,428,168,260,101,30,71
217475,35,572,214,358,193,86,107,379,128,251
217484,35,670,320,350,551,276,275,119,44,75
217493,35,25,10,15,25,10,15,,,
217518,35,164,89,75,120,66,54,44,23,21
217536,35,59,28,31,50,27,23,9,1,8
217606,35,13,6,7,10,5,5,3,1,2
217615,35,123,34,89,48,14,34,75,20,55
217624,35,37,19,18,37,19,18,,,
217633,35,146,52,94,121,45,76,25,7,18
217688,35,290,119,171,252,109,143,38,10,28
217712,35,144,41,103,43,15,28,101,26,75
217721,35,50,30,20,50,30,20,,,
217749,35,88,42,46,84,40,44,4,2,2
217776,35,90,33,57,61,24,37,29,9,20
217819,35,638,271,367,588,254,334,50,17,33
217837,35,104,19,85,27,8,19,77,11,66
217864,35,99,75,24,69,54,15,30,21,9
217873,35,73,25,48,63,24,39,10,1,9
217882,35,1509,759,750,1468,745,723,41,14,27
217891,35,25,11,14,25,11,14,,,
217907,35,58,20,38,56,20,36,2,0,2
217925,35,40,20,20,40,20,20,,,
217934,35,231,43,188,148,31,117,83,12,71
217961,35,79,36,43,76,35,41,3,1,2
217989,35,13,4,9,11,4,7,2,0,2
217998,35,112,97,15,107,93,14,5,4,1
218025,35,184,50,134,66,26,40,118,24,94
218061,35,194,88,106,179,83,96,15,5,10
218070,35,19,7,12,17,6,11,2,1,1
218113,35,463,154,309,262,96,166,201,58,143
218140,35,442,179,263,251,121,130,191,58,133
218229,35,256,93,163,219,82,137,37,11,26
218238,35,155,81,74,127,68,59,28,13,15
218335,35,143,13,130,143,13,130,,,
218353,35,910,293,617,446,178,268,464,115,349
218399,35,38,17,21,38,17,21,,,
218414,35,67,34,33,67,34,33,,,
218441,35,122,63,59,120,63,57,2,0,2
218487,35,228,51,177,98,31,67,130,20,110
218520,35,299,81,218,90,28,62,209,53,156
218539,35,34,26,8,34,26,8,,,
218645,35,354,120,234,264,94,170,90,26,64
218654,35,246,72,174,196,60,136,50,12,38
218663,35,1399,709,690,1303,667,636,96,42,54
218672,35,75,33,42,68,32,36,7,1,6
218681,35,49,20,29,35,15,20,14,5,9
218690,35,56,30,26,29,15,14,27,15,12
218706,35,19,9,10,15,7,8,4,2,2
218724,35,744,381,363,702,357,345,42,24,18
218733,35,96,44,52,84,38,46,12,6,6
218742,35,682,258,424,582,220,362,100,38,62
218821,35,58,27,31,54,25,29,4,2,2
218830,35,788,253,535,354,132,222,434,121,313
218858,35,54,14,40,22,6,16,32,8,24
218885,35,280,114,166,156,78,78,124,36,88
218894,35,1032,416,616,405,184,221,627,232,395
218919,35,30,13,17,28,12,16,2,1,1
218955,35,48,2,46,14,1,13,34,1,33
218964,35,245,102,143,228,92,136,17,10,7
218973,35,22,16,6,22,16,6,,,
218991,35,311,106,205,173,70,103,138,36,102
219000,35,69,21,48,67,21,46,2,0,2
219046,35,189,62,127,155,56,99,34,6,28
219082,35,188,128,60,125,91,34,63,37,26
219091,35,29,15,14,27,14,13,2,1,1
219143,35,273,99,174,192,78,114,81,21,60
219189,35,111,63,48,94,61,33,17,2,15
219198,35,62,32,30,45,21,24,17,11,6
219204,35,64,35,29,11,7,4,53,28,25
219240,35,2,1,1,,,,2,1,1
219259,35,78,31,47,58,26,32,20,5,15
219277,35,74,25,49,42,18,24,32,7,25
219295,35,84,35,49,61,33,28,23,2,21
219347,35,76,57,19,62,46,16,14,11,3
219356,35,422,193,229,322,164,158,100,29,71
219383,35,98,43,55,77,34,43,21,9,12
219408,35,9,5,4,7,4,3,2,1,1
219426,35,450,189,261,222,121,101,228,68,160
219471,35,328,143,185,247,114,133,81,29,52
219480,35,143,59,84,96,49,47,47,10,37
219505,35,10,7,3,9,7,2,1,0,1
219602,35,677,267,410,406,158,248,271,109,162
219639,35,160,12,148,69,7,62,91,5,86
219709,35,464,175,289,424,153,271,40,22,18
219718,35,616,352,264,463,270,193,153,82,71
219790,35,40,18,22,35,17,18,5,1,4
219806,35,92,45,47,91,45,46,1,0,1
219824,35,418,136,282,224,91,133,194,45,149
219833,35,78,31,47,76,29,47,2,2,0
219879,35,122,49,73,78,37,41,44,12,32
219888,35,272,121,151,154,92,62,118,29,89
219949,35,136,67,69,125,64,61,11,3,8
219976,35,218,99,119,198,90,108,20,9,11
220002,35,12,0,12,12,0,12,,,
220057,35,154,59,95,82,35,47,72,24,48
220075,35,1137,370,767,867,312,555,270,58,212
220118,35,150,8,142,150,8,142,,,
220181,35,15,5,10,14,5,9,1,0,1
220206,35,8,4,4,8,4,4,,,
220215,35,78,39,39,71,34,37,7,5,2
220400,35,225,66,159,133,38,95,92,28,64
220464,35,48,20,28,18,8,10,30,12,18
220473,35,48,22,26,35,17,18,13,5,8
220516,35,235,67,168,203,59,144,32,8,24
220552,35,1201,147,1054,880,111,769,321,36,285
220598,35,72,48,24,72,48,24,,,
220604,35,63,21,42,58,20,38,5,1,4
220613,35,221,92,129,198,85,113,23,7,16
220631,35,236,51,185,165,43,122,71,8,63
220701,35,81,45,36,75,43,32,6,2,4
220710,35,75,37,38,74,36,38,1,1,0
220862,35,1160,398,762,762,272,490,398,126,272
220978,35,1752,796,956,1500,699,801,252,97,155
221096,35,404,146,258,167,78,89,237,68,169
221148,35,8,7,1,8,7,1,,,
221184,35,508,157,351,223,86,137,285,71,214
221351,35,6,3,3,6,3,3,,,
221397,35,199,74,125,96,47,49,103,27,76
221485,35,383,142,241,194,79,115,189,63,126
221519,35,15,10,5,15,10,5,,,
221643,35,441,206,235,238,135,103,203,71,132
221661,35,127,55,72,114,53,61,13,2,11
221731,35,125,45,80,114,43,71,11,2,9
221740,35,814,381,433,703,334,369,111,47,64
221759,35,1483,681,802,1364,637,727,119,44,75
221768,35,353,151,202,297,132,165,56,19,37
221838,35,493,170,323,354,127,227,139,43,96
221847,35,726,351,375,662,325,337,64,26,38
221892,35,76,32,44,76,32,44,,,
221908,35,266,120,146,177,86,91,89,34,55
221953,35,104,59,45,99,57,42,5,2,3
221971,35,49,18,31,49,18,31,,,
221999,35,240,111,129,240,111,129,,,
222053,35,391,152,239,194,82,112,197,70,127
222062,35,182,63,119,110,43,67,72,20,52
222105,35,9,7,2,5,4,1,4,3,1
222178,35,110,59,51,108,59,49,2,0,2
222567,35,180,68,112,39,22,17,141,46,95
222576,35,231,87,144,81,34,47,150,53,97
222628,35,16,7,9,6,5,1,10,2,8
222822,35,116,32,84,43,17,26,73,15,58
222831,35,379,149,230,317,114,203,62,35,27
222877,35,41,22,19,41,22,19,,,
222938,35,63,29,34,33,19,14,30,10,20
222983,35,30,18,12,30,18,12,,,
222992,35,3344,1454,1890,1070,542,528,2274,912,1362
223083,35,141,23,118,29,5,24,112,18,94
223117,35,4,2,2,2,1,1,2,1,1
223232,35,364,154,210,356,153,203,8,1,7
223320,35,416,109,307,165,61,104,251,48,203
223427,35,3057,1521,1536,1718,875,843,1339,646,693
223463,35,15,3,12,15,3,12,,,
223472,35,38,5,33,38,5,33,,,
223506,35,181,83,98,44,24,20,137,59,78
223816,35,499,208,291,71,21,50,428,187,241
223898,35,263,107,156,130,55,75,133,52,81
223922,35,143,61,82,46,21,25,97,40,57
224004,35,221,66,155,138,49,89,83,17,66
224110,35,1456,561,895,293,127,166,1163,434,729
224147,35,743,297,446,427,173,254,316,124,192
224226,35,160,82,78,158,81,77,2,1,1
224244,35,40,20,20,38,20,18,2,0,2
224271,35,220,63,157,220,63,157,,,
224323,35,26,16,10,26,16,10,,,
224350,35,301,110,191,69,36,33,232,74,158
224527,35,116,50,66,97,48,49,19,2,17
224545,35,323,112,211,244,91,153,79,21,58
224554,35,1103,463,640,734,307,427,369,156,213
224615,35,2249,963,1286,777,406,371,1472,557,915
224642,35,954,398,556,387,175,212,567,223,344
224660,35,42,15,27,34,12,22,8,3,5
224679,35,33,26,7,16,11,5,17,15,2
224776,35,60,29,31,34,15,19,26,14,12
224891,35,41,15,26,34,13,21,7,2,5
224961,35,163,64,99,77,36,41,86,28,58
225070,35,199,92,107,159,74,85,40,18,22
225201,35,111,69,42,111,69,42,,,
225247,35,79,42,37,78,41,37,1,1,0
225308,35,495,153,342,215,90,125,280,63,217
225371,35,196,79,117,113,55,58,83,24,59
225399,35,241,93,148,122,49,73,119,44,75
225414,35,1316,427,889,765,257,508,551,170,381
225423,35,3747,1374,2373,1404,593,811,2343,781,1562
225432,35,2017,665,1352,896,309,587,1121,356,765
225502,35,437,160,277,180,75,105,257,85,172
225511,35,4490,2037,2453,3006,1371,1635,1484,666,818
225520,35,137,38,99,55,18,37,82,20,62
225548,35,81,43,38,74,41,33,7,2,5
225575,35,109,54,55,105,53,52,4,1,3
225627,35,358,149,209,281,111,170,77,38,39
225876,35,26,12,14,22,11,11,4,1,3
225885,35,55,32,23,44,29,15,11,3,8
225991,35,6,2,4,6,2,4,,,
226019,35,304,133,171,171,79,92,133,54,79
226091,35,620,231,389,264,127,137,356,104,252
226107,35,136,30,106,52,11,41,84,19,65
226116,35,183,57,126,86,29,57,97,28,69
226134,35,121,52,69,48,23,25,73,29,44
226152,35,487,179,308,357,144,213,130,35,95
226204,35,200,105,95,46,22,24,154,83,71
226231,35,113,61,52,90,57,33,23,4,19
226277,35,12,11,1,12,11,1,,,
226383,35,133,40,93,127,40,87,6,0,6
226408,35,324,104,220,115,41,74,209,63,146
226471,35,178,69,109,169,68,101,9,1,8
226578,35,314,112,202,160,63,97,154,49,105
226587,35,129,60,69,106,54,52,23,6,17
226806,35,216,63,153,61,20,41,155,43,112
226833,35,531,157,374,307,110,197,224,47,177
226879,35,43,7,36,16,2,14,27,5,22
227146,35,323,117,206,179,73,106,144,44,100
227182,35,3069,1169,1900,1280,582,698,1789,587,1202
227216,35,4112,1853,2259,2917,1330,1587,1195,523,672
227225,35,96,35,61,67,26,41,29,9,20
227304,35,520,179,341,209,79,130,311,100,211
227331,35,135,37,98,116,34,82,19,3,16
227368,35,1389,498,891,970,342,628,419,156,263
227377,35,138,44,94,55,22,33,83,22,61
227386,35,164,41,123,109,31,78,55,10,45
227401,35,244,82,162,119,53,66,125,29,96
227429,35,20,11,9,19,11,8,1,0,1
227526,35,562,221,341,488,187,301,74,34,40
227687,35,145,65,80,108,56,52,37,9,28
227757,35,29,17,12,29,17,12,,,
227845,35,231,101,130,215,90,125,16,11,5
227854,35,753,265,488,96,37,59,657,228,429
227863,35,290,128,162,249,108,141,41,20,21
227881,35,2383,819,1564,1634,598,1036,749,221,528
227924,35,1266,476,790,263,93,170,1003,383,620
227979,35,1099,417,682,373,161,212,726,256,470
228042,35,59,21,38,53,21,32,6,0,6
228149,35,92,40,52,89,39,50,3,1,2
228158,35,466,194,272,279,118,161,187,76,111
228246,35,281,141,140,277,141,136,4,0,4
228316,35,71,31,40,16,7,9,55,24,31
228325,35,150,90,60,135,82,53,15,8,7
228343,35,49,27,22,48,27,21,1,0,1
228431,35,867,332,535,735,286,449,132,46,86
228459,35,3112,1442,1670,2318,1101,1217,794,341,453
228468,35,64,25,39,62,24,38,2,1,1
228486,35,10,8,2,9,7,2,1,1,0
228501,35,205,75,130,122,50,72,83,25,58
228529,35,1339,532,807,820,327,493,519,205,314
228547,35,1386,544,842,342,159,183,1044,385,659
228608,35,1146,316,830,384,113,271,762,203,559
228644,35,337,103,234,311,90,221,26,13,13
228653,35,221,48,173,195,41,154,26,7,19
228699,35,101,27,74,51,17,34,50,10,40
228705,35,361,165,196,318,146,172,43,19,24
228723,35,2847,1352,1495,2737,1295,1442,110,57,53
228769,35,4628,1485,3143,2094,833,1261,2534,652,1882
228778,35,1948,848,1100,1884,822,1062,64,26,38
228787,35,1949,1071,878,1479,812,667,470,259,211
228796,35,1528,617,911,928,409,519,600,208,392
228802,35,964,356,608,556,250,306,408,106,302
228875,35,433,196,237,420,189,231,13,7,6
228884,35,75,52,23,75,52,23,,,
228981,35,47,18,29,43,17,26,4,1,3
229018,35,367,151,216,229,101,128,138,50,88
229027,35,3179,1494,1685,2382,1109,1273,797,385,412
229063,35,480,166,314,389,144,245,91,22,69
229115,35,2557,1307,1250,2246,1164,1082,311,143,168
229160,35,144,72,72,132,68,64,12,4,8
229179,35,1274,105,1169,798,66,732,476,39,437
229267,35,20,9,11,20,9,11,,,
229300,35,111,15,96,90,11,79,21,4,17
229337,35,263,26,237,248,23,225,15,3,12
229355,35,782,280,502,364,157,207,418,123,295
229504,35,146,63,83,81,40,41,65,23,42
229540,35,196,73,123,62,29,33,134,44,90
229780,35,238,117,121,129,65,64,109,52,57
229799,35,317,122,195,132,68,64,185,54,131
229814,35,911,344,567,634,246,388,277,98,179
229832,35,97,51,46,25,10,15,72,41,31
229841,35,277,116,161,93,57,36,184,59,125
229887,35,53,24,29,52,23,29,1,1,0
230038,35,807,418,389,697,369,328,110,49,61
230047,35,112,35,77,107,35,72,5,0,5
230056,35,14,3,11,11,3,8,3,0,3
230171,35,709,295,414,541,232,309,168,63,105
230366,35,55,5,50,55,5,50,,,
230418,35,622,250,372,346,146,200,276,104,172
230597,35,149,108,41,120,97,23,29,11,18
230603,35,687,339,348,484,250,234,203,89,114
230728,35,1271,518,753,946,417,529,325,101,224
230737,35,2715,1355,1360,1721,879,842,994,476,518
230746,35,2210,896,1314,782,338,444,1428,558,870
230764,35,1615,793,822,1233,617,616,382,176,206
230782,35,1028,383,645,617,242,375,411,141,270
230807,35,77,25,52,73,25,48,4,0,4
230816,35,16,3,13,16,3,13,,,
230834,35,114,42,72,103,38,65,11,4,7
230852,35,169,103,66,128,78,50,41,25,16
230861,35,512,132,380,97,34,63,415,98,317
230889,35,30,10,20,29,10,19,1,0,1
230913,35,102,21,81,46,13,33,56,8,48
230959,35,8,4,4,8,4,4,,,
230995,35,252,195,57,132,86,46,120,109,11
231059,35,20,9,11,20,9,11,,,
231095,35,21,9,12,21,9,12,,,
231165,35,322,92,230,260,76,184,62,16,46
231174,35,350,152,198,340,149,191,10,3,7
231411,35,3,3,0,3,3,0,,,
231420,35,107,39,68,92,33,59,15,6,9
231536,35,189,75,114,66,27,39,123,48,75
231554,35,44,20,24,43,20,23,1,0,1
231581,35,51,29,22,51,29,22,,,
231624,35,193,81,112,191,81,110,2,0,2
231651,35,842,278,564,350,126,224,492,152,340
231697,35,169,62,107,61,27,34,108,35,73
231712,35,137,67,70,137,67,70,,,
231785,35,254,44,210,180,38,142,74,6,68
231873,35,25,10,15,15,8,7,10,2,8
231882,35,63,17,46,28,12,16,35,5,30
232025,35,46,22,24,41,22,19,5,0,5
232043,35,58,26,32,44,21,23,14,5,9
232052,35,12,6,6,6,4,2,6,2,4
232089,35,46,32,14,42,31,11,4,1,3
232186,35,2641,1229,1412,2015,945,1070,626,284,342
232195,35,399,129,270,139,52,87,260,77,183
232256,35,13,13,0,13,13,0,,,
232265,35,68,30,38,52,22,30,16,8,8
232308,35,16,0,16,16,0,16,,,
232414,35,476,170,306,149,54,95,327,116,211
232423,35,767,350,417,681,325,356,86,25,61
232450,35,453,154,299,149,47,102,304,107,197
232557,35,5069,2207,2862,3050,1264,1786,2019,943,1076
232566,35,138,49,89,132,48,84,6,1,5
232575,35,199,57,142,60,23,37,139,34,105
232609,35,98,37,61,92,33,59,6,4,2
232618,35,91,3,88,7,0,7,84,3,81
232672,35,122,24,98,93,18,75,29,6,23
232681,35,243,99,144,183,79,104,60,20,40
232706,35,211,62,149,201,57,144,10,5,5
232788,35,102,36,66,58,20,38,44,16,28
232797,35,163,31,132,44,9,35,119,22,97
232867,35,117,64,53,60,36,24,57,28,29
232885,35,39,7,32,35,7,28,4,0,4
232937,35,353,114,239,291,99,192,62,15,47
232946,35,1388,559,829,533,251,282,855,308,547
232982,35,1800,704,1096,1251,507,744,549,197,352
233019,35,82,34,48,49,25,24,33,9,24
233037,35,79,28,51,36,18,18,43,10,33
233082,35,49,6,43,,,,49,6,43
233116,35,286,109,177,69,36,33,217,73,144
233277,35,579,235,344,516,224,292,63,11,52
233295,35,37,18,19,37,18,19,,,
233301,35,21,9,12,21,9,12,,,
233310,35,62,20,42,19,7,12,43,13,30
233329,35,48,2,46,48,2,46,,,
233338,35,59,31,28,50,25,25,9,6,3
233356,35,92,3,89,85,3,82,7,0,7
233374,35,63,26,37,41,22,19,22,4,18
233426,35,65,37,28,65,37,28,,,
233541,35,111,49,62,105,46,59,6,3,3
233602,35,4,2,2,4,2,2,,,
233611,35,75,36,39,71,34,37,4,2,2
233639,35,73,25,48,23,7,16,50,18,32
233648,35,92,28,64,46,20,26,46,8,38
233684,35,375,137,238,80,53,27,295,84,211
233718,35,23,0,23,23,0,23,,,
233754,35,386,134,252,125,48,77,261,86,175
233772,35,1084,355,729,407,144,263,677,211,466
233897,35,74,41,33,71,40,31,3,1,2
233903,35,168,48,120,80,30,50,88,18,70
233921,35,893,554,339,876,543,333,17,11,6
233949,35,235,89,146,81,31,50,154,58,96
234030,35,1592,606,986,1297,511,786,295,95,200
234076,35,765,373,392,656,339,317,109,34,75
234085,35,31,28,3,31,28,3,,,
234137,35,10,6,4,9,5,4,1,1,0
234155,35,298,108,190,265,97,168,33,11,22
234164,35,72,34,38,62,30,32,10,4,6
234173,35,74,18,56,61,15,46,13,3,10
234207,35,9,3,6,9,3,6,,,
234377,35,85,14,71,46,7,39,39,7,32
234669,35,787,288,499,272,107,165,515,181,334
234696,35,269,123,146,146,75,71,123,48,75
234711,35,80,35,45,51,26,25,29,9,20
234827,35,957,412,545,837,356,481,120,56,64
234845,35,243,95,148,144,59,85,99,36,63
234915,35,128,44,84,38,8,30,90,36,54
234933,35,620,198,422,258,94,164,362,104,258
234951,35,50,13,37,42,12,30,8,1,7
234979,35,258,111,147,174,78,96,84,33,51
235024,35,34,13,21,32,13,19,2,0,2
235097,35,858,341,517,775,318,457,83,23,60
235103,35,837,278,559,334,138,196,503,140,363
235149,35,407,175,232,150,59,91,257,116,141
235167,35,314,127,187,276,112,164,38,15,23
235237,35,1128,323,805,528,170,358,600,153,447
235316,35,163,87,76,159,83,76,4,4,0
235334,35,86,41,45,44,12,32,42,29,13
235343,35,426,179,247,217,99,118,209,80,129
235422,35,152,31,121,143,31,112,9,0,9
235431,35,703,227,476,267,93,174,436,134,302
235547,35,41,7,34,25,5,20,16,2,14
235671,35,64,25,39,52,22,30,12,3,9
235699,35,186,85,101,125,63,62,61,22,39
235750,35,308,61,247,108,23,85,200,38,162
236072,35,900,344,556,291,130,161,609,214,395
236133,35,64,22,42,61,22,39,3,0,3
236188,35,510,185,325,224,92,132,286,93,193
236212,35,60,49,11,60,49,11,,,
236230,35,90,29,61,89,29,60,1,0,1
236258,35,165,55,110,74,26,48,91,29,62
236328,35,35,20,15,35,20,15,,,
236382,35,152,48,104,97,26,71,55,22,33
236452,35,121,63,58,102,56,46,19,7,12
236504,35,345,187,158,178,112,66,167,75,92
236513,35,868,306,562,498,185,313,370,121,249
236577,35,190,69,121,186,66,120,4,3,1
236595,35,345,136,209,338,132,206,7,4,3
236610,35,377,155,222,177,82,95,200,73,127
236638,35,272,96,176,164,64,100,108,32,76
236656,35,235,90,145,143,66,77,92,24,68
236692,35,580,184,396,386,134,252,194,50,144
236708,35,472,187,285,304,123,181,168,64,104
236753,35,766,213,553,392,105,287,374,108,266
236887,35,146,61,85,98,41,57,48,20,28
236896,35,49,20,29,47,18,29,2,2,0
236939,35,2389,1109,1280,1985,934,1051,404,175,229
236948,35,1551,723,828,1391,658,733,160,65,95
236975,35,242,59,183,138,39,99,104,20,84
237011,35,1098,444,654,1013,409,604,85,35,50
237039,35,298,119,179,133,59,74,165,60,105
237057,35,22,12,10,22,12,10,,,
237066,35,91,44,47,90,43,47,1,1,0
237109,35,154,39,115,114,28,86,40,11,29
237118,35,56,32,24,46,30,16,10,2,8
237136,35,13,7,6,12,6,6,1,1,0
237181,35,25,14,11,25,14,11,,,
237215,35,145,72,73,122,65,57,23,7,16
237312,35,293,205,88,96,52,44,197,153,44
237330,35,101,47,54,93,44,49,8,3,5
237358,35,40,22,18,40,22,18,,,
237367,35,191,72,119,135,59,76,56,13,43
237385,35,88,65,23,69,47,22,19,18,1
237437,35,21,3,18,19,3,16,2,0,2
237525,35,445,217,228,386,188,198,59,29,30
237686,35,132,51,81,87,33,54,45,18,27
237701,35,37,22,15,34,21,13,3,1,2
237783,35,94,38,56,87,34,53,7,4,3
237792,35,250,103,147,211,89,122,39,14,25
237817,35,44,18,26,35,15,20,9,3,6
237899,35,118,48,70,104,45,59,14,3,11
237932,35,107,48,59,94,46,48,13,2,11
237950,35,60,34,26,57,32,25,3,2,1
237969,35,34,18,16,34,18,16,,,
237987,35,67,11,56,67,11,56,,,
237996,35,126,12,114,126,12,114,,,
238014,35,99,33,66,56,22,34,43,11,32
238032,35,607,297,310,572,288,284,35,9,26
238078,35,64,50,14,61,49,12,3,1,2
238193,35,89,5,84,64,4,60,25,1,24
238263,35,556,242,314,186,83,103,370,159,211
238324,35,84,7,77,64,7,57,20,0,20
238333,35,18,10,8,18,10,8,,,
238397,35,44,11,33,12,4,8,32,7,25
238430,35,35,16,19,24,11,13,11,5,6
238458,35,108,37,71,93,33,60,15,4,11
238476,35,82,49,33,79,47,32,3,2,1
238616,35,146,46,100,98,31,67,48,15,33
238661,35,74,28,46,66,26,40,8,2,6
238722,35,1602,680,922,457,221,236,1145,459,686
238759,35,188,73,115,57,21,36,131,52,79
238980,35,137,47,90,59,23,36,78,24,54
239008,35,202,82,120,62,32,30,140,50,90
239017,35,15,9,6,15,9,6,,,
239071,35,23,9,14,21,7,14,2,2,0
239080,35,83,32,51,58,28,30,25,4,21
239105,35,138,76,62,131,72,59,7,4,3
239220,35,244,109,135,74,54,20,170,55,115
239248,35,1326,580,746,468,234,234,858,346,512
239309,35,32,10,22,32,10,22,,,
239318,35,161,99,62,158,98,60,3,1,2
239372,35,243,88,155,101,47,54,142,41,101
239390,35,50,0,50,49,0,49,1,0,1
239442,35,75,26,49,19,6,13,56,20,36
239460,35,1195,451,744,381,162,219,814,289,525
239488,35,287,101,186,110,47,63,177,54,123
239512,35,28,14,14,28,14,14,,,
239628,35,9,5,4,9,5,4,,,
239716,35,24,12,12,23,12,11,1,0,1
239910,35,506,96,410,173,56,117,333,40,293
240107,35,201,34,167,135,25,110,66,9,57
240116,35,267,86,181,112,44,68,155,42,113
240125,35,242,113,129,114,62,52,128,51,77
240170,35,212,82,130,110,53,57,102,29,73
240189,35,491,267,224,404,222,182,87,45,42
240198,35,311,119,192,143,67,76,168,52,116
240268,35,368,172,196,320,164,156,48,8,40
240277,35,574,235,339,382,163,219,192,72,120
240329,35,375,183,192,342,163,179,33,20,13
240338,35,29,10,19,25,9,16,4,1,3
240365,35,446,197,249,350,153,197,96,44,52
240374,35,225,113,112,178,97,81,47,16,31
240392,35,61,7,54,30,4,26,31,3,28
240417,35,437,230,207,295,172,123,142,58,84
240426,35,266,75,191,197,59,138,69,16,53
240444,35,1146,549,597,1080,523,557,66,26,40
240453,35,1219,575,644,1035,496,539,184,79,105
240462,35,253,164,89,219,141,78,34,23,11
240471,35,252,91,161,231,83,148,21,8,13
240480,35,416,190,226,346,166,180,70,24,46
240505,35,200,90,110,108,59,49,92,31,61
240514,35,73,33,40,31,11,20,42,22,20
240596,35,30,13,17,24,12,12,6,1,5
240620,35,225,78,147,100,40,60,125,38,87
240657,35,80,24,56,50,19,31,30,5,25
240666,35,123,36,87,85,29,56,38,7,31
240693,35,78,35,43,44,19,25,34,16,18
240727,35,874,355,519,654,299,355,220,56,164
240736,35,10,4,6,7,3,4,3,1,2
240745,35,18,5,13,8,3,5,10,2,8
240754,35,110,46,64,82,31,51,28,15,13
240790,35,14,3,11,11,2,9,3,1,2
241100,35,4,2,2,4,2,2,,,
241128,35,59,20,39,59,20,39,,,
241191,35,34,16,18,29,12,17,5,4,1
241216,35,70,47,23,67,46,21,3,1,2
241225,35,33,13,20,27,9,18,6,4,2
241304,35,378,90,288,263,60,203,115,30,85
241331,35,170,19,151,58,6,52,112,13,99
241377,35,32,17,15,18,7,11,14,10,4
241386,35,5,0,5,5,0,5,,,
241395,35,20,10,10,19,9,10,1,1,0
241410,35,82,30,52,78,29,49,4,1,3
241517,35,54,14,40,42,11,31,12,3,9
241614,35,8,4,4,2,1,1,6,3,3
241720,35,85,24,61,79,24,55,6,0,6
241739,35,352,115,237,214,71,143,138,44,94
241766,35,25,16,9,,,,25,16,9
241836,35,95,31,64,25,9,16,70,22,48
241951,35,48,13,35,43,11,32,5,2,3
242112,35,148,76,72,130,73,57,18,3,15
242121,35,7,3,4,6,3,3,1,0,1
242130,35,27,5,22,23,4,19,4,1,3
242149,35,33,7,26,29,6,23,4,1,3
242617,35,59,29,30,54,25,29,5,4,1
242626,35,106,44,62,92,39,53,14,5,9
242635,35,96,44,52,83,44,39,13,0,13
242644,35,25,7,18,25,7,18,,,
242653,35,209,96,113,182,83,99,27,13,14
242662,35,117,42,75,93,33,60,24,9,15
242680,35,36,9,27,32,8,24,4,1,3
242699,35,130,33,97,90,24,66,40,9,31
242705,35,121,74,47,108,65,43,13,9,4
242972,35,3665,1030,2635,2237,606,1631,1428,424,1004
243106,35,24,13,11,24,13,11,,,
243115,35,24,6,18,23,6,17,1,0,1
243133,35,27,9,18,22,7,15,5,2,3
243142,35,122,40,82,101,35,66,21,5,16
243151,35,33,7,26,32,7,25,1,0,1
243179,35,28,8,20,26,7,19,2,1,1
243188,35,18,8,10,17,8,9,1,0,1
243197,35,126,71,55,113,64,49,13,7,6
243203,35,146,26,120,146,26,120,,,
243212,35,36,14,22,36,14,22,,,
243221,35,163,63,100,153,61,92,10,2,8
243346,35,180,64,116,111,39,72,69,25,44
243443,35,247,85,162,193,68,125,54,17,37
243568,35,15,3,12,11,3,8,4,0,4
243577,35,175,124,51,94,63,31,81,61,20
243586,35,23,6,17,22,6,16,1,0,1
243601,35,349,150,199,260,110,150,89,40,49
243647,35,1,1,0,,,,1,1,0
243665,35,60,13,47,41,12,29,19,1,18
243744,35,64,36,28,64,36,28,,,
243780,35,1000,522,478,850,487,363,150,35,115
243823,35,174,50,124,101,25,76,73,25,48
243832,35,245,75,170,54,16,38,191,59,132
243841,35,154,24,130,142,24,118,12,0,12
244233,35,6,0,6,,,,6,0,6
244279,35,21,1,20,21,1,20,,,
244437,35,872,257,615,338,116,222,534,141,393
244446,35,410,132,278,119,58,61,291,74,217
245625,35,79,26,53,27,12,15,52,14,38
245652,35,9,5,4,9,5,4,,,
245777,35,5,5,0,5,5,0,,,
245838,35,14,4,10,10,2,8,4,2,2
245847,35,21,5,16,10,3,7,11,2,9
245883,35,17,2,15,2,0,2,15,2,13
245892,35,21,7,14,10,2,8,11,5,6
245953,35,245,83,162,194,69,125,51,14,37
246354,35,509,209,300,67,25,42,442,184,258
246813,35,533,185,348,149,69,80,384,116,268
246974,35,53,7,46,53,7,46,,,
247065,35,77,6,71,56,4,52,21,2,19
247603,35,136,72,64,63,41,22,73,31,42
247649,35,65,42,23,60,39,21,5,3,2
247825,35,1,1,0,1,1,0,,,
247834,35,1658,667,991,638,286,352,1020,381,639
247940,35,167,60,107,74,27,47,93,33,60
248934,35,1339,540,799,1339,540,799,,,
249609,35,21,12,9,21,12,9,,,
250027,35,50,13,37,46,13,33,4,0,4
251260,35,330,153,177,178,96,82,152,57,95
251312,35,118,18,100,65,11,54,53,7,46
260372,35,8,1,7,3,0,3,5,1,4
260691,35,149,50,99,149,50,99,,,
260789,35,121,31,90,121,31,90,,,
260813,35,15,1,14,15,1,14,,,
260992,35,26,0,26,1,0,1,25,0,25
261861,35,3,0,3,3,0,3,,,
262031,35,481,203,278,371,162,209,110,41,69
262086,35,940,256,684,281,98,183,659,158,501
262129,35,31,13,18,31,13,18,,,
262457,35,48,9,39,48,9,39,,,
363439,35,3,0,3,3,0,3,,,
363633,35,1,0,1,,,,1,0,1
363712,35,35,35,0,35,35,0,,,
363907,35,24,16,8,18,14,4,6,2,4
363916,35,6,2,4,5,2,3,1,0,1
363934,35,71,54,17,27,22,5,44,32,12
364016,35,662,285,377,197,110,87,465,175,290
364025,35,907,421,486,341,170,171,566,251,315
366003,35,8,4,4,1,1,0,7,3,4
366252,35,281,171,110,214,149,65,67,22,45
366261,35,20,10,10,10,5,5,10,5,5
366270,35,77,1,76,77,1,76,,,
366395,35,653,300,353,486,239,247,167,61,106
366401,35,645,302,343,83,50,33,562,252,310
366465,35,402,126,276,152,60,92,250,66,184
366535,35,14,6,8,14,6,8,,,
366553,35,194,47,147,63,10,53,131,37,94
366711,35,2022,807,1215,1580,627,953,442,180,262
367459,35,377,158,219,122,67,55,255,91,164
367884,35,35,12,23,12,7,5,23,5,18
368452,35,44,17,27,44,17,27,,,
368629,35,106,15,91,106,15,91,,,
368911,35,142,42,100,39,12,27,103,30,73
369400,35,153,146,7,153,146,7,,,
369455,35,72,23,49,72,23,49,,,
369516,35,30,17,13,30,17,13,,,
369668,35,8,8,0,8,8,0,,,
372073,35,66,16,50,66,16,50,,,
372921,35,63,22,41,63,22,41,,,
375230,35,35,35,0,35,35,0,,,
375416,35,4,0,4,4,0,4,,,
375939,35,9,3,6,9,3,6,,,
376224,35,16,3,13,12,1,11,4,2,2
376385,35,8,4,4,8,4,4,,,
376695,35,3,1,2,1,1,0,2,0,2
377111,35,13,3,10,13,3,10,,,
377218,35,27,27,0,27,27,0,,,
377546,35,15,2,13,10,2,8,5,0,5
377555,35,654,289,365,557,244,313,97,45,52
377564,35,786,396,390,693,342,351,93,54,39
377661,35,98,9,89,98,9,89,,,
378105,35,23,3,20,19,1,18,4,2,2
378576,35,1,0,1,,,,1,0,1
379782,35,40,4,36,40,4,36,,,
380359,35,33,4,29,13,3,10,20,1,19
380368,35,58,25,33,35,19,16,23,6,17
380377,35,28,7,21,23,7,16,5,0,5
380438,35,96,13,83,96,13,83,,,
382911,35,2,0,2,1,0,1,1,0,1
382957,35,25,8,17,25,8,17,,,
383190,35,154,60,94,56,30,26,98,30,68
383996,35,43,15,28,8,2,6,35,13,22
384254,35,32,20,12,31,20,11,1,0,1
384333,35,751,258,493,241,83,158,510,175,335
384342,35,269,116,153,164,74,90,105,42,63
384412,35,37,19,18,37,19,18,,,
385503,35,32,2,30,32,2,30,,,
385619,35,803,470,333,803,470,333,,,
386153,35,92,0,92,92,0,92,,,
386472,35,31,2,29,19,1,18,12,1,11
388520,35,153,81,72,80,48,32,73,33,40
392415,35,22,9,13,22,9,13,,,
395362,35,146,51,95,33,9,24,113,42,71
399212,35,1686,1205,481,102,53,49,1584,1152,432
399869,35,37,36,1,37,36,1,,,
401223,35,29,7,22,21,5,16,8,2,6
403478,35,7,0,7,5,0,5,2,0,2
403487,35,33,16,17,30,14,16,3,2,1
404055,35,35,3,32,35,3,32,,,
404338,35,2,1,1,2,1,1,,,
404426,35,326,170,156,125,74,51,201,96,105
404912,35,136,35,101,136,35,101,,,
404994,35,203,101,102,177,96,81,26,5,21
405058,35,5,5,0,5,5,0,,,
405854,35,2,2,0,2,2,0,,,
405872,35,141,59,82,70,35,35,71,24,47
406024,35,671,85,586,315,50,265,356,35,321
406033,35,619,74,545,247,33,214,372,41,331
407610,35,2,0,2,1,0,1,1,0,1
407629,35,12,2,10,12,2,10,,,
408729,35,4,0,4,3,0,3,1,0,1
408844,35,161,54,107,108,38,70,53,16,37
409315,35,442,200,242,135,60,75,307,140,167
409698,35,1087,401,686,909,331,578,178,70,108
412173,35,40,5,35,40,5,35,,,
412599,35,3,0,3,3,0,3,,,
413413,35,4032,683,3349,805,144,661,3227,539,2688
413617,35,7,0,7,6,0,6,1,0,1
413626,35,36,16,20,15,11,4,21,5,16
413680,35,5,5,0,5,5,0,,,
414461,35,173,165,8,92,86,6,81,79,2
414878,35,21,10,11,6,1,5,15,9,6
414911,35,41,18,23,35,15,20,6,3,3
414939,35,17,1,16,17,1,16,,,
416458,35,2,0,2,2,0,2,,,
416801,35,97,18,79,91,17,74,6,1,5
417734,35,54,12,42,28,8,20,26,4,22
417752,35,2,1,1,2,1,1,,,
418126,35,53,17,36,34,10,24,19,7,12
418533,35,97,11,86,67,4,63,30,7,23
418889,35,33,29,4,16,12,4,17,17,0
419244,35,29,24,5,16,13,3,13,11,2
420042,35,1,0,1,1,0,1,,,
420325,35,15,15,0,15,15,0,,,
420370,35,43,11,32,43,11,32,,,
420398,35,851,359,492,132,60,72,719,299,420
420431,35,232,76,156,44,16,28,188,60,128
420440,35,78,24,54,26,4,22,52,20,32
420538,35,49,11,38,19,4,15,30,7,23
420556,35,2,1,1,1,1,0,1,0,1
420723,35,19,8,11,6,3,3,13,5,8
421708,35,164,30,134,95,18,77,69,12,57
421832,35,11,4,7,9,4,5,2,0,2
421841,35,32,14,18,32,14,18,,,
421878,35,55,10,45,45,7,38,10,3,7
422020,35,17,17,0,17,17,0,,,
422695,35,48,3,45,48,3,45,,,
423120,35,41,2,39,41,2,39,,,
423652,35,26,5,21,22,4,18,4,1,3
425250,35,24,3,21,15,3,12,9,0,9
426314,35,806,679,127,142,111,31,664,568,96
428170,35,26,4,22,17,3,14,9,1,8
428259,35,5,0,5,3,0,3,2,0,2
428392,35,44,25,19,27,15,12,17,10,7
429128,35,6,1,5,,,,6,1,5
430184,35,148,35,113,26,14,12,122,21,101
430670,35,4,2,2,4,2,2,,,
430704,35,11,1,10,11,1,10,,,
430935,35,127,94,33,99,76,23,28,18,10
431141,35,59,30,29,59,30,29,,,
431983,35,1,1,0,1,1,0,,,
432384,35,78,21,57,78,21,57,,,
432524,35,7,3,4,7,3,4,,,
433004,35,33,9,24,33,9,24,,,
433013,35,79,27,52,79,27,52,,,
433174,35,125,17,108,39,7,32,86,10,76
433387,35,39310,14731,24579,39310,14731,24579,,,
433420,35,26,20,6,26,20,6,,,
433536,35,24,1,23,9,0,9,15,1,14
433660,35,1159,502,657,833,355,478,326,147,179
434016,35,3,0,3,3,0,3,,,
434061,35,642,262,380,351,159,192,291,103,188
434140,35,152,28,124,152,28,124,,,
434159,35,6,5,1,6,5,1,,,
434432,35,6,1,5,6,1,5,,,
434584,35,10,2,8,2,1,1,8,1,7
434672,35,1206,463,743,395,182,213,811,281,530
434751,35,6,2,4,2,1,1,4,1,3
434937,35,6,6,0,6,6,0,,,
435000,35,5,1,4,5,1,4,,,
436304,35,212,99,113,101,61,40,111,38,73
436429,35,329,196,133,329,196,133,,,
436614,35,5,4,1,4,3,1,1,1,0
436818,35,29,11,18,27,11,16,2,0,2
436827,35,29,11,18,22,7,15,7,4,3
436836,35,112,51,61,102,49,53,10,2,8
437097,35,86,51,35,81,48,33,5,3,2
437103,35,929,275,654,465,148,317,464,127,337
437316,35,129,24,105,129,24,105,,,
437325,35,37,7,30,1,1,0,36,6,30
437732,35,26,2,24,23,2,21,3,0,3
437936,35,102,9,93,102,9,93,,,
438179,35,35,6,29,35,6,29,,,
438258,35,80,21,59,80,21,59,,,
438498,35,192,30,162,28,5,23,164,25,139
438504,35,137,131,6,137,131,6,,,
438586,35,224,41,183,182,34,148,42,7,35
438708,35,26,7,19,13,3,10,13,4,9
439118,35,69,7,62,69,7,62,,,
439190,35,200,110,90,94,53,41,106,57,49
439367,35,146,45,101,146,45,101,,,
439570,35,62,4,58,62,4,58,,,
439701,35,42,18,24,25,9,16,17,9,8
439738,35,56,6,50,56,6,50,,,
439792,35,55,6,49,55,6,49,,,
439862,35,2,0,2,2,0,2,,,
439871,35,20,1,19,19,1,18,1,0,1
439899,35,11,7,4,3,1,2,8,6,2
440396,35,9,6,3,9,6,3,,,
440402,35,104,26,78,45,11,34,59,15,44
440651,35,43,13,30,14,7,7,29,6,23
440794,35,42,13,29,41,13,28,1,0,1
440828,35,183,89,94,101,48,53,82,41,41
441025,35,16,13,3,16,13,3,,,
441052,35,128,23,105,128,23,105,,,
441229,35,162,38,124,162,38,124,,,
441371,35,2251,72,2179,2251,72,2179,,,
441423,35,3,0,3,3,0,3,,,
441487,35,16,1,15,15,1,14,1,0,1
441609,35,23,23,0,23,23,0,,,
441636,35,116,21,95,96,17,79,20,4,16
441690,35,23,12,11,16,8,8,7,4,3
441760,35,318,134,184,168,95,73,150,39,111
441858,35,23,0,23,23,0,23,,,
441900,35,671,158,513,263,64,199,408,94,314
441937,35,1115,340,775,856,259,597,259,81,178
441982,35,1,1,0,1,1,0,,,
442134,35,53,7,46,53,7,46,,,
442356,35,265,25,240,114,15,99,151,10,141
442383,35,45,4,41,45,4,41,,,
442426,35,110,11,99,66,5,61,44,6,38
442444,35,59,44,15,59,44,15,,,
442523,35,1,0,1,1,0,1,,,
442569,35,657,206,451,159,61,98,498,145,353
442602,35,48,8,40,48,8,40,,,
442639,35,22,17,5,22,17,5,,,
442781,35,92,14,78,39,8,31,53,6,47
442879,35,687,52,635,503,38,465,184,14,170
442930,35,107,59,48,100,54,46,7,5,2
443049,35,49,30,19,25,17,8,24,13,11
443058,35,5,3,2,2,1,1,3,2,1
443261,35,3,0,3,1,0,1,2,0,2
443331,35,223,43,180,147,33,114,76,10,66
443340,35,5,2,3,2,1,1,3,1,2
443377,35,7,5,2,7,5,2,,,
443410,35,135,93,42,129,87,42,6,6,0
443492,35,153,65,88,113,53,60,40,12,28
443599,35,196,18,178,59,6,53,137,12,125
443650,35,9,2,7,9,2,7,,,
443748,35,102,29,73,101,29,72,1,0,1
443766,35,420,89,331,24,13,11,396,76,320
443784,35,226,64,162,12,7,5,214,57,157
444088,35,101,14,87,101,14,87,,,
444130,35,24,5,19,,,,24,5,19
444219,35,1716,697,1019,126,50,76,1590,647,943
444255,35,11,3,8,11,3,8,,,
444325,35,8,2,6,8,2,6,,,
444398,35,7,6,1,5,5,0,2,1,1
444413,35,5,5,0,5,5,0,,,
444556,35,43,17,26,43,17,26,,,
444565,35,52,22,30,40,19,21,12,3,9
444778,35,5,3,2,4,2,2,1,1,0
444787,35,586,93,493,326,56,270,260,37,223
444954,35,163,62,101,105,44,61,58,18,40
445027,35,1964,458,1506,1748,415,1333,216,43,173
445133,35,43,10,33,30,9,21,13,1,12
445188,35,268,138,130,264,134,130,4,4,0
445203,35,8,1,7,8,1,7,,,
445230,35,86,26,60,86,26,60,,,
445249,35,12,1,11,12,1,11,,,
445267,35,379,65,314,214,34,180,165,31,134
445461,35,26,12,14,24,12,12,2,0,2
445692,35,17,12,5,14,10,4,3,2,1
445708,35,38,14,24,38,14,24,,,
445735,35,257,70,187,257,70,187,,,
445744,35,51,4,47,51,4,47,,,
445948,35,117,17,100,117,17,100,,,
446048,35,120,64,56,119,64,55,1,0,1
446109,35,111,15,96,62,6,56,49,9,40
446118,35,2,0,2,2,0,2,,,
446127,35,61,3,58,61,3,58,,,
446163,35,10,10,0,6,6,0,4,4,0
446233,35,15,10,5,15,10,5,,,
446385,35,29,16,13,28,15,13,1,1,0
446525,35,2,1,1,2,1,1,,,
446561,35,87,33,54,87,33,54,,,
446589,35,23,5,18,23,5,18,,,
446604,35,239,239,0,239,239,0,,,
446640,35,116,84,32,88,69,19,28,15,13
446774,35,185,63,122,76,28,48,109,35,74
447014,35,43,4,39,43,4,39,,,
447050,35,28,6,22,16,5,11,12,1,11
447263,35,374,56,318,155,20,135,219,36,183
447351,35,36,17,19,36,17,19,,,
447421,35,31,3,28,31,3,28,,,
447458,35,11,8,3,11,8,3,,,
447582,35,128,25,103,82,19,63,46,6,40
447689,35,571,206,365,372,147,225,199,59,140
447713,35,22,6,16,22,6,16,,,
447759,35,21,3,18,20,2,18,1,1,0
447768,35,53,3,50,53,3,50,,,
447847,35,12,11,1,12,11,1,,,
447935,35,77,8,69,77,8,69,,,
447953,35,49,22,27,41,18,23,8,4,4
448354,35,48,3,45,27,0,27,21,3,18
448372,35,16,6,10,16,6,10,,,
448433,35,115,110,5,115,110,5,,,
448594,35,332,139,193,85,43,42,247,96,151
448600,35,12,0,12,12,0,12,,,
448673,35,620,71,549,285,36,249,335,35,300
448859,35,24,22,2,24,22,2,,,
449038,35,245,61,184,34,16,18,211,45,166
449074,35,94,14,80,94,14,80,,,
449339,35,5466,3362,2104,444,219,225,5022,3143,1879
449348,35,6,4,2,1,1,0,5,3,2
449384,35,51,31,20,49,30,19,2,1,1
449506,35,14,4,10,14,4,10,,,
449524,35,57,5,52,57,5,52,,,
449612,35,17,8,9,17,8,9,,,
449658,35,6,6,0,6,6,0,,,
449728,35,73,2,71,73,2,71,,,
449764,35,24,7,17,21,7,14,3,0,3
449834,35,1,1,0,,,,1,1,0
449861,35,38,3,35,38,3,35,,,
449870,35,6,4,2,6,4,2,,,
449889,35,20,4,16,20,4,16,,,
449898,35,123,22,101,70,14,56,53,8,45
450058,35,103,18,85,103,18,85,,,
450067,35,59,7,52,59,7,52,,,
450298,35,44,10,34,3,1,2,41,9,32
450377,35,284,47,237,16,9,7,268,38,230
450571,35,80,7,73,45,6,39,35,1,34
450696,35,46,8,38,46,8,38,,,
450702,35,40,3,37,40,3,37,,,
450933,35,1236,834,402,788,515,273,448,319,129
450960,35,1,1,0,1,1,0,,,
451103,35,110,20,90,40,6,34,70,14,56
451228,35,7,6,1,7,6,1,,,
451370,35,10,10,0,10,10,0,,,
451398,35,10,10,0,10,10,0,,,
451404,35,57,57,0,57,57,0,,,
451477,35,77,68,9,77,68,9,,,
451556,35,292,94,198,292,94,198,,,
451741,35,23,7,16,20,6,14,3,1,2
451750,35,320,86,234,259,76,183,61,10,51
451820,35,14,7,7,7,5,2,7,2,5
451857,35,3,0,3,3,0,3,,,
451866,35,9,1,8,9,1,8,,,
451927,35,6,2,4,6,2,4,,,
452124,35,47,7,40,47,7,40,,,
452373,35,99,6,93,99,6,93,,,
452948,35,241,10,231,88,4,84,153,6,147
453163,35,398,69,329,25,15,10,373,54,319
453215,35,81,21,60,6,5,1,75,16,59
454184,35,15,3,12,14,3,11,1,0,1
454227,35,2786,293,2493,914,95,819,1872,198,1674
454236,35,92,12,80,44,7,37,48,5,43
454245,35,151,30,121,85,15,70,66,15,51
454582,35,16,5,11,7,4,3,9,1,8
454616,35,35,32,3,35,32,3,,,
454698,35,24,5,19,24,5,19,,,
454786,35,24,15,9,11,7,4,13,8,5
454810,35,15,7,8,15,7,8,,,
454829,35,3445,463,2982,747,84,663,2698,379,2319
454856,35,169,19,150,169,19,150,,,
454865,35,433,58,375,274,36,238,159,22,137
455114,35,497,199,298,226,112,114,271,87,184
455196,35,701,61,640,701,61,640,,,
455257,35,12,12,0,12,12,0,,,
455336,35,3,2,1,3,2,1,,,
455479,35,128,15,113,117,15,102,11,0,11
455512,35,383,134,249,33,12,21,350,122,228
455628,35,80,14,66,80,14,66,,,
455664,35,48,6,42,7,2,5,41,4,37
455770,35,15,10,5,15,10,5,,,
455868,35,20,4,16,20,4,16,,,
455983,35,5,2,3,5,2,3,,,
456038,35,66,8,58,66,8,58,,,
456153,35,4,2,2,4,2,2,,,
456205,35,7,6,1,7,6,1,,,
456214,35,54,41,13,54,41,13,,,
456454,35,42,16,26,32,15,17,10,1,9
456481,35,4,2,2,1,1,0,3,1,2
456490,35,4,4,0,2,2,0,2,2,0
456579,35,9,9,0,9,9,0,,,
456621,35,52,13,39,1,1,0,51,12,39
456852,35,26,6,20,26,6,20,,,
456959,35,43,13,30,38,13,25,5,0,5
457101,35,68,17,51,68,17,51,,,
457110,35,70,13,57,70,13,57,,,
457129,35,220,20,200,70,4,66,150,16,134
457226,35,4,2,2,,,,4,2,2
457299,35,73,7,66,61,7,54,12,0,12
457402,35,44,42,2,37,35,2,7,7,0
457484,35,18,8,10,10,5,5,8,3,5
457527,35,64,9,55,10,0,10,54,9,45
457536,35,89,16,73,89,16,73,,,
457688,35,6,2,4,2,0,2,4,2,2
457697,35,40,15,25,4,1,3,36,14,22
458034,35,12,1,11,12,1,11,,,
458113,35,6,1,5,,,,6,1,5
458140,35,36,25,11,36,25,11,,,
458210,35,293,63,230,148,38,110,145,25,120
458229,35,213,38,175,177,29,148,36,9,27
458405,35,9,5,4,9,5,4,,,
458441,35,1,1,0,1,1,0,,,
458496,35,13,6,7,6,3,3,7,3,4
458681,35,33,5,28,33,5,28,,,
458885,35,86,16,70,2,1,1,84,15,69
458919,35,728,171,557,102,59,43,626,112,514
458955,35,106,16,90,4,2,2,102,14,88
458964,35,232,45,187,29,15,14,203,30,173
458973,35,415,127,288,68,44,24,347,83,264
458982,35,29,15,14,17,7,10,12,8,4
459204,35,619,79,540,619,79,540,,,
459213,35,248,61,187,248,61,187,,,
459259,35,51,7,44,31,4,27,20,3,17
459268,35,48,9,39,29,7,22,19,2,17
459310,35,9,1,8,9,1,8,,,
459417,35,8,6,2,8,6,2,,,
459514,35,1,0,1,1,0,1,,,
459727,35,49,20,29,21,7,14,28,13,15
459824,35,6,1,5,5,1,4,1,0,1
459842,35,48,7,41,23,5,18,25,2,23
459851,35,31,5,26,17,4,13,14,1,13
459949,35,808,298,510,406,164,242,402,134,268
459958,35,29,2,27,29,2,27,,,
459994,35,1870,596,1274,121,62,59,1749,534,1215
460020,35,61,9,52,61,9,52,,,
460136,35,102,23,79,102,23,79,,,
460349,35,280,68,212,61,11,50,219,57,162
460394,35,1132,411,721,153,80,73,979,331,648
460464,35,1137,437,700,98,48,50,1039,389,650
460543,35,137,127,10,137,127,10,,,
460677,35,86,14,72,76,9,67,10,5,5
460738,35,186,26,160,36,4,32,150,22,128
460756,35,40,2,38,38,2,36,2,0,2
460817,35,4,3,1,4,3,1,,,
460826,35,12,7,5,12,7,5,,,
460835,35,7,3,4,7,3,4,,,
460871,35,157,17,140,90,3,87,67,14,53
461014,35,32,1,31,32,1,31,,,
461023,35,88,8,80,85,8,77,3,0,3
461032,35,14,10,4,5,3,2,9,7,2
461148,35,165,81,84,165,81,84,,,
461218,35,109,5,104,109,5,104,,,
461263,35,19,0,19,19,0,19,,,
461281,35,20,0,20,16,0,16,4,0,4
461324,35,2,0,2,2,0,2,,,
461528,35,34,17,17,14,8,6,20,9,11
461643,35,13,1,12,13,1,12,,,
461689,35,63,12,51,63,12,51,,,
461759,35,15,9,6,10,7,3,5,2,3
461795,35,69,58,11,63,53,10,6,5,1
461847,35,6,6,0,6,6,0,,,
461953,35,12,2,10,7,1,6,5,1,4
462354,35,7,5,2,7,5,2,,,
463056,35,43,20,23,35,14,21,8,6,2
464226,35,102,72,30,92,62,30,10,10,0
466921,35,80,8,72,35,3,32,45,5,40
466930,35,440,58,382,162,24,138,278,34,244
474863,35,271,60,211,168,35,133,103,25,78
475033,35,166,29,137,,,,166,29,137
475121,35,2077,406,1671,1376,323,1053,701,83,618
475176,35,63,33,30,63,33,30,,,
475200,35,40,12,28,2,0,2,38,12,26
475273,35,52,5,47,17,1,16,35,4,31
475398,35,17,12,5,2,1,1,15,11,4
475422,35,56,3,53,20,0,20,36,3,33
475565,35,1,1,0,1,1,0,,,
475608,35,9,6,3,4,3,1,5,3,2
475635,35,1,0,1,,,,1,0,1
475714,35,131,113,18,117,101,16,14,12,2
475732,35,276,20,256,105,6,99,171,14,157
475741,35,48,3,45,23,0,23,25,3,22
475839,35,147,73,74,74,36,38,73,37,36
476601,35,2,2,0,2,2,0,,,
476683,35,231,14,217,231,14,217,,,
476692,35,3,3,0,3,3,0,,,
476726,35,124,28,96,124,28,96,,,
476939,35,33,4,29,33,4,29,,,
476948,35,11,6,5,11,6,5,,,
476975,35,1435,673,762,316,142,174,1119,531,588
477039,35,123,16,107,102,11,91,21,5,16
480028,35,80,62,18,79,61,18,1,1,0
480073,35,55,10,45,32,6,26,23,4,19
480091,35,1666,163,1503,1567,145,1422,99,18,81
480198,35,28,9,19,8,5,3,20,4,16
480204,35,90,9,81,90,9,81,,,
480569,35,116,46,70,70,24,46,46,22,24
480657,35,146,10,136,62,3,59,84,7,77
480781,35,19,17,2,19,17,2,,,
480912,35,2,0,2,2,0,2,,,
480967,35,6,2,4,3,2,1,3,0,3
480985,35,45,0,45,45,0,45,,,
481155,35,40,21,19,40,21,19,,,
481225,35,4,3,1,3,3,0,1,0,1
481252,35,13,1,12,13,1,12,,,
481401,35,5,3,2,,,,5,3,2
481438,35,1,1,0,1,1,0,,,
481720,35,11,0,11,7,0,7,4,0,4
481775,35,16,4,12,16,4,12,,,
482149,35,480,144,336,412,121,291,68,23,45
482158,35,733,271,462,440,189,251,293,82,211
482228,35,13,9,4,4,3,1,9,6,3
482413,35,138,54,84,91,38,53,47,16,31
482422,35,17,9,8,9,4,5,8,5,3
482431,35,307,175,132,205,123,82,102,52,50
482440,35,5,1,4,3,1,2,2,0,2
482459,35,72,32,40,36,17,19,36,15,21
482468,35,195,73,122,115,43,72,80,30,50
482477,35,4993,1544,3449,2500,771,1729,2493,773,1720
482538,35,3,3,0,3,3,0,,,
482547,35,1,1,0,1,1,0,,,
482556,35,20,11,9,15,8,7,5,3,2
482565,35,3,1,2,3,1,2,,,
482574,35,70,24,46,29,12,17,41,12,29
482608,35,7,2,5,4,1,3,3,1,2
482617,35,4,1,3,3,1,2,1,0,1
482635,35,33,13,20,27,12,15,6,1,5
482653,35,16,8,8,11,6,5,5,2,3
482680,35,782,376,406,620,313,307,162,63,99
482699,35,71,26,45,47,22,25,24,4,20
482705,35,492,172,320,149,15,134,343,157,186
482936,35,69,53,16,59,48,11,10,5,5
482990,35,50,4,46,50,4,46,,,
483018,35,11,3,8,11,3,8,,,
483036,35,430,174,256,175,69,106,255,105,150
483045,35,964,374,590,257,128,129,707,246,461
483124,35,10747,3863,6884,4206,1363,2843,6541,2500,4041
483212,35,415,137,278,238,89,149,177,48,129
483373,35,24,2,22,10,0,10,14,2,12
483595,35,637,160,477,274,70,204,363,90,273
483814,35,66,8,58,66,8,58,,,
484002,35,4,2,2,2,1,1,2,1,1
484066,35,41,2,39,41,2,39,,,
484473,35,639,287,352,323,145,178,316,142,174
484613,35,6923,2008,4915,6923,2008,4915,,,
484631,35,13,4,9,13,4,9,,,
484756,35,3,0,3,3,0,3,,,
484835,35,34,10,24,34,10,24,,,
484844,35,7,2,5,7,2,5,,,
484871,35,1,1,0,1,1,0,,,
484905,35,666,210,456,364,110,254,302,100,202
484932,35,235,79,156,149,45,104,86,34,52
485111,35,544,204,340,277,103,174,267,101,166
485139,35,4,4,0,4,4,0,,,
485272,35,91,10,81,32,4,28,59,6,53
485458,35,370,92,278,76,33,43,294,59,235
485519,35,44,36,8,22,18,4,22,18,4
485546,35,2,1,1,,,,2,1,1
485768,35,20,13,7,20,13,7,,,
485999,35,7,7,0,7,7,0,,,
486017,35,6,6,0,6,6,0,,,
486053,35,16,13,3,11,11,0,5,2,3
486123,35,3,1,2,3,1,2,,,
486196,35,3,3,0,3,3,0,,,
486239,35,15,7,8,14,7,7,1,0,1
486257,35,57,21,36,35,13,22,22,8,14
486284,35,26,5,21,22,4,18,4,1,3
486372,35,10,8,2,7,6,1,3,2,1
486424,35,29,0,29,29,0,29,,,
486488,35,4,4,0,4,4,0,,,
486594,35,10,4,6,4,1,3,6,3,3
486813,35,44,4,40,44,4,40,,,
486822,35,96,12,84,96,12,84,,,
486840,35,2650,1323,1327,1861,940,921,789,383,406
486901,35,40,17,23,38,15,23,2,2,0
486938,35,91,18,73,68,14,54,23,4,19
486947,35,89,13,76,43,6,37,46,7,39
486956,35,224,37,187,137,17,120,87,20,67
486965,35,9,4,5,9,4,5,,,
487010,35,175,14,161,172,14,158,3,0,3
487162,35,484,118,366,171,39,132,313,79,234
487302,35,84,12,72,84,12,72,,,
487311,35,27,25,2,27,25,2,,,
487320,35,899,633,266,557,434,123,342,199,143
487375,35,117,11,106,32,3,29,85,8,77
487384,35,38,15,23,38,15,23,,,
487393,35,65,25,40,65,25,40,,,
487409,35,45,17,28,45,17,28,,,
487418,35,41,15,26,41,15,26,,,
487427,35,16,7,9,16,7,9,,,
487436,35,50,7,43,50,7,43,,,
487445,35,32,11,21,32,11,21,,,
487454,35,35,2,33,35,2,33,,,
487472,35,44,17,27,44,17,27,,,
487490,35,50,12,38,50,12,38,,,
487524,35,107,39,68,76,28,48,31,11,20
487597,35,150,140,10,150,140,10,,,
487603,35,87,27,60,57,19,38,30,8,22
487658,35,19,14,5,19,14,5,,,
487746,35,6,6,0,6,6,0,,,
487977,35,443,22,421,366,5,361,77,17,60
487995,35,11,4,7,5,1,4,6,3,3
488004,35,7,7,0,7,7,0,,,
488031,35,11,4,7,11,4,7,,,
488059,35,17,7,10,17,7,10,,,
488068,35,8,1,7,4,1,3,4,0,4
488077,35,1545,1509,36,1154,1125,29,391,384,7
488101,35,20,20,0,20,20,0,,,
488305,35,13,9,4,10,7,3,3,2,1
488314,35,1,1,0,1,1,0,,,
488332,35,125,21,104,125,21,104,,,
488350,35,2,2,0,2,2,0,,,
488448,35,23,13,10,21,11,10,2,2,0
488679,35,1079,245,834,1056,242,814,23,3,20
488730,35,411,180,231,73,39,34,338,141,197
488776,35,39,15,24,23,9,14,16,6,10
488785,35,40,25,15,40,25,15,,,
488800,35,310,92,218,310,92,218,,,
488846,35,182,100,82,100,55,45,82,45,37
489201,35,1132,383,749,122,49,73,1010,334,676
489344,35,39,5,34,25,3,22,14,2,12
489353,35,95,20,75,64,15,49,31,5,26
489779,35,5016,1882,3134,311,98,213,4705,1784,2921
489812,35,3,0,3,3,0,3,,,
489937,35,90,41,49,61,34,27,29,7,22
490045,35,5,2,3,3,2,1,2,0,2
490054,35,30,5,25,14,2,12,16,3,13
490124,35,5,3,2,5,3,2,,,
490133,35,160,98,62,153,93,60,7,5,2
490203,35,44,1,43,38,1,37,6,0,6
490230,35,15,7,8,15,7,8,,,
490276,35,52,52,0,52,52,0,,,
490285,35,192,152,40,192,152,40,,,
490328,35,3,3,0,3,3,0,,,
490498,35,7,4,3,7,4,3,,,
490513,35,1,1,0,1,1,0,,,
490753,35,2,0,2,2,0,2,,,
490805,35,510,154,356,276,112,164,234,42,192
490878,35,58,10,48,58,10,48,,,
490975,35,41,11,30,35,9,26,6,2,4
491057,35,79,79,0,79,79,0,,,
491181,35,121,12,109,70,5,65,51,7,44
491190,35,2,2,0,2,2,0,,,
491288,35,176,58,118,11,3,8,165,55,110
491297,35,47,20,27,1,1,0,46,19,27
491446,35,7,0,7,7,0,7,,,
491525,35,5,3,2,2,1,1,3,2,1
491631,35,23,0,23,23,0,23,,,
491640,35,5,5,0,5,5,0,,,
491710,35,6,6,0,6,6,0,,,
491817,35,57,0,57,25,0,25,32,0,32
491844,35,3,2,1,3,2,1,,,
491914,35,15,15,0,15,15,0,,,
491941,35,19,0,19,19,0,19,,,
492069,35,28,19,9,27,19,8,1,0,1
492449,35,112,28,84,112,28,84,,,
492476,35,15,5,10,2,0,2,13,5,8
492689,35,86,15,71,79,15,64,7,0,7
492759,35,78,5,73,52,4,48,26,1,25
492801,35,106,41,65,63,26,37,43,15,28
492962,35,401,142,259,126,51,75,275,91,184
493080,35,59,25,34,7,2,5,52,23,29
493512,35,92,41,51,92,41,51,,,
493521,35,8,6,2,8,6,2,,,
493594,35,7,7,0,7,7,0,,,
493600,35,13,13,0,13,13,0,,,
493619,35,11,6,5,9,5,4,2,1,1
493646,35,7,0,7,7,0,7,,,
493664,35,7,7,0,7,7,0,,,
493707,35,1,1,0,1,1,0,,,
493716,35,2,2,0,2,2,0,,,
493725,35,145,43,102,85,27,58,60,16,44
493798,35,1,0,1,,,,1,0,1
493822,35,52,11,41,47,10,37,5,1,4
493895,35,116,103,13,13,13,0,103,90,13
494162,35,48,3,45,21,1,20,27,2,25
494250,35,88,4,84,88,4,84,,,
494269,35,3,3,0,2,2,0,1,1,0
494278,35,63,13,50,19,4,15,44,9,35
494287,35,62,18,44,20,7,13,42,11,31
494436,35,53,15,38,53,15,38,,,
494588,35,37,1,36,37,1,36,,,
494597,35,18,12,6,18,12,6,,,
494621,35,15,3,12,,,,15,3,12
494630,35,3,2,1,3,2,1,,,
494685,35,111,44,67,93,36,57,18,8,10
494737,35,37,37,0,37,37,0,,,
494746,35,63,8,55,63,8,55,,,
494755,35,31,2,29,31,2,29,,,
494807,35,1,0,1,1,0,1,,,
494843,35,48,3,45,48,3,45,,,
494852,35,2,0,2,2,0,2,,,
494959,35,8,2,6,2,1,1,6,1,5
494986,35,8,0,8,7,0,7,1,0,1
495031,35,8,8,0,8,8,0,,,
495147,35,2,1,1,1,1,0,1,0,1
495280,35,4,1,3,4,1,3,,,
495420,35,56,8,48,22,4,18,34,4,30
495439,35,38,2,36,27,2,25,11,0,11
495448,35,108,15,93,61,11,50,47,4,43
495457,35,114,11,103,76,6,70,38,5,33
495767,35,2655,1355,1300,1962,1030,932,693,325,368
495952,35,26,7,19,26,7,19,,,
495961,35,31,4,27,31,4,27,,,
496186,35,25,23,2,25,23,2,,,
496283,35,38,5,33,38,5,33,,,
496326,35,43,6,37,43,6,37,,,
496399,35,5,1,4,5,1,4,,,
496627,35,20,12,8,20,12,8,,,
496636,35,84,16,68,84,16,68,,,
496681,35,45,2,43,45,2,43,,,
496706,35,45,31,14,45,31,14,,,
496973,35,24,2,22,8,0,8,16,2,14
496991,35,79,7,72,42,4,38,37,3,34
497000,35,13,9,4,13,9,4,,,
497037,35,65,9,56,51,8,43,14,1,13
497046,35,1291,436,855,75,21,54,1216,415,801
497116,35,17,3,14,4,1,3,13,2,11
497213,35,4,1,3,2,0,2,2,1,1
497268,35,56,7,49,32,3,29,24,4,20
497277,35,35,2,33,35,2,33,,,
497338,35,32,4,28,32,4,28,,,
100654,36,3414,1357,2057,2932,1137,1795,482,220,262
100663,36,9635,3724,5911,7190,2786,4404,2445,938,1507
100690,36,33,5,28,18,4,14,15,1,14
100706,36,5527,3296,2231,4571,2733,1838,956,563,393
100724,36,2472,873,1599,2133,750,1383,339,123,216
100751,36,21730,9629,12101,19545,8693,10852,2185,936,1249
100760,36,559,203,356,236,105,131,323,98,225
100812,36,1811,538,1273,692,209,483,1119,329,790
100830,36,2826,919,1907,2095,688,1407,731,231,500
100858,36,18324,9459,8865,16415,8350,8065,1909,1109,800
100937,36,782,376,406,773,367,406,9,9,0
101028,36,685,195,490,242,83,159,443,112,331
101116,36,244,36,208,159,27,132,85,9,76
101143,36,816,437,379,471,265,206,345,172,173
101161,36,3403,1181,2222,1543,640,903,1860,541,1319
101189,36,1214,494,720,914,390,524,300,104,196
101240,36,2309,810,1499,1020,451,569,1289,359,930
101277,36,18,2,16,18,2,16,,,
101286,36,2137,570,1567,670,177,493,1467,393,1074
101295,36,2610,798,1812,1128,423,705,1482,375,1107
101301,36,596,162,434,224,107,117,372,55,317
101365,36,457,98,359,234,73,161,223,25,198
101435,36,542,287,255,496,276,220,46,11,35
101453,36,56,52,4,25,23,2,31,29,2
101462,36,458,185,273,154,74,80,304,111,193
101471,36,155,126,29,113,88,25,42,38,4
101480,36,4620,1843,2777,3868,1522,2346,752,321,431
101505,36,3981,1358,2623,1114,437,677,2867,921,1946
101514,36,4687,1969,2718,1399,631,768,3288,1338,1950
101569,36,1793,540,1253,666,219,447,1127,321,806
101587,36,1543,445,1098,1033,269,764,510,176,334
101602,36,590,188,402,317,126,191,273,62,211
101648,36,134,99,35,134,99,35,,,
101675,36,1006,459,547,926,416,510,80,43,37
101693,36,759,260,499,702,244,458,57,16,41
101709,36,1523,543,980,1329,472,857,194,71,123
101736,36,1396,486,910,439,206,233,957,280,677
101879,36,3594,1289,2305,3043,1063,1980,551,226,325
101897,36,1068,328,740,463,153,310,605,175,430
101912,36,1024,442,582,931,400,531,93,42,51
101994,36,130,40,90,52,27,25,78,13,65
102030,36,1224,346,878,451,180,271,773,166,607
102049,36,2584,826,1758,2535,812,1723,49,14,35
102058,36,18,13,5,8,5,3,10,8,2
102067,36,2661,941,1720,867,393,474,1794,548,1246
102076,36,835,304,531,425,164,261,410,140,270
102094,36,6107,2418,3689,5025,1919,3106,1082,499,583
102234,36,721,280,441,687,268,419,34,12,22
102270,36,530,239,291,475,196,279,55,43,12
102298,36,783,361,422,739,334,405,44,27,17
102313,36,951,381,570,399,189,210,552,192,360
102368,36,8284,2890,5394,5445,1918,3527,2839,972,1867
102377,36,1563,591,972,1457,547,910,106,44,62
102395,36,51,38,13,11,9,2,40,29,11
102429,36,1466,471,995,538,230,308,928,241,687
102553,36,5889,2268,3621,2817,1230,1587,3072,1038,2034
102580,36,25,16,9,16,12,4,9,4,5
102614,36,3040,1193,1847,1511,718,793,1529,475,1054
102632,36,710,206,504,278,96,182,432,110,322
102669,36,204,47,157,168,37,131,36,10,26
102711,36,42,32,10,18,14,4,24,18,6
102845,36,1703,425,1278,1703,425,1278,,,
103501,36,104,16,88,104,16,88,,,
103741,36,77,1,76,60,1,59,17,0,17
103893,36,883,173,710,883,173,710,,,
103909,36,435,38,397,435,38,397,,,
103927,36,353,53,300,353,53,300,,,
103954,36,45,3,42,45,3,42,,,
103963,36,317,285,32,316,285,31,1,0,1
104090,36,800,94,706,800,94,706,,,
104151,36,45187,22953,22234,40780,20384,20396,4407,2569,1838
104160,36,5011,1958,3053,1367,586,781,3644,1372,2272
104179,36,25438,11501,13937,21668,9520,12148,3770,1981,1789
104346,36,1880,680,1200,453,191,262,1427,489,938
104391,36,12,0,12,12,0,12,,,
104425,36,2092,871,1221,780,277,503,1312,594,718
104443,36,28,1,27,22,1,21,6,0,6
104568,36,113,4,109,59,1,58,54,3,51
104577,36,2245,856,1389,618,277,341,1627,579,1048
104586,36,2148,1580,568,2035,1485,550,113,95,18
104708,36,7425,3119,4306,2025,961,1064,5400,2158,3242
104717,36,45963,12942,33021,13694,5244,8450,32269,7698,24571
105145,36,2335,716,1619,544,187,357,1791,529,1262
105154,36,8608,3898,4710,2450,1146,1304,6158,2752,3406
105206,36,2108,583,1525,447,171,276,1661,412,1249
105215,36,346,321,25,346,321,25,,,
105297,36,1087,246,841,555,132,423,532,114,418
105330,36,16422,6005,10417,13742,5080,8662,2680,925,1755
105349,36,604,183,421,125,50,75,479,133,346
105367,36,297,78,219,120,28,92,177,50,127
105428,36,4715,1527,3188,1176,424,752,3539,1103,2436
105525,36,9783,3886,5897,1875,851,1024,7908,3035,4873
105534,36,1734,329,1405,1734,329,1405,,,
105543,36,544,93,451,544,93,451,,,
105589,36,288,100,188,218,83,135,70,17,53
105659,36,664,622,42,664,622,42,,,
105668,36,2559,844,1715,434,135,299,2125,709,1416
105677,36,5,5,0,5,5,0,,,
105747,36,3196,1329,1867,912,427,485,2284,902,1382
105792,36,1544,611,933,479,194,285,1065,417,648
105899,36,555,331,224,442,272,170,113,59,54
106041,36,940,908,32,940,908,32,,,
106111,36,29,1,28,19,1,18,10,0,10
106148,36,2646,938,1708,682,297,385,1964,641,1323
106245,36,3794,1358,2436,2051,826,1225,1743,532,1211
106263,36,563,89,474,369,63,306,194,26,168
106306,36,186,131,55,147,101,46,39,30,9
106315,36,13,2,11,13,2,11,,,
106324,36,18,0,18,16,0,16,2,0,2
106342,36,405,226,179,401,224,177,4,2,2
106351,36,54,40,14,54,40,14,,,
106360,36,21,1,20,21,1,20,,,
106397,36,16320,7322,8998,14253,6334,7919,2067,988,1079
106412,36,1620,658,962,1363,560,803,257,98,159
106449,36,1100,357,743,666,236,430,434,121,313
106458,36,5425,2010,3415,3752,1518,2234,1673,492,1181
106467,36,4807,2068,2739,3812,1701,2111,995,367,628
106485,36,1389,534,855,1097,459,638,292,75,217
106494,36,26,0,26,26,0,26,,,
106546,36,437,53,384,393,48,345,44,5,39
106625,36,636,163,473,350,101,249,286,62,224
106704,36,5424,2116,3308,4511,1745,2766,913,371,542
106713,36,353,180,173,307,162,145,46,18,28
106795,36,592,142,450,260,79,181,332,63,269
106810,36,103,60,43,103,60,43,,,
106883,36,419,107,312,233,69,164,186,38,148
106892,36,53,1,52,53,1,52,,,
106908,36,281,21,260,267,20,247,14,1,13
106980,36,1221,414,807,651,247,404,570,167,403
106999,36,459,127,332,303,82,221,156,45,111
107044,36,2398,1082,1316,2220,981,1239,178,101,77
107071,36,1651,768,883,1462,682,780,189,86,103
107080,36,772,378,394,767,375,392,5,3,2
107099,36,74,3,71,74,3,71,,,
107123,36,66,8,58,66,8,58,,,
107141,36,977,374,603,898,350,548,79,24,55
107220,36,27,0,27,27,0,27,,,
107293,36,43,0,43,43,0,43,,,
107318,36,357,124,233,127,28,99,230,96,134
107327,36,547,163,384,279,104,175,268,59,209
107442,36,29,19,10,29,19,10,,,
107460,36,777,272,505,415,176,239,362,96,266
107488,36,3,3,0,1,1,0,2,2,0
107512,36,1042,421,621,1022,411,611,20,10,10
107521,36,283,80,203,175,46,129,108,34,74
107549,36,445,102,343,306,70,236,139,32,107
107558,36,528,251,277,526,249,277,2,2,0
107585,36,958,316,642,544,196,348,414,120,294
107600,36,568,208,360,479,176,303,89,32,57
107619,36,448,122,326,294,91,203,154,31,123
107637,36,596,142,454,160,53,107,436,89,347
107655,36,29,0,29,29,0,29,,,
107664,36,2809,862,1947,1318,441,877,1491,421,1070
107725,36,539,114,425,275,67,208,264,47,217
107743,36,291,96,195,197,71,126,94,25,69
107789,36,83,2,81,83,2,81,,,
107831,36,79,1,78,79,1,78,,,
107840,36,175,51,124,146,45,101,29,6,23
107877,36,360,176,184,356,174,182,4,2,2
107974,36,515,108,407,210,48,162,305,60,245
107983,36,2047,896,1151,1888,827,1061,159,69,90
107992,36,377,163,214,224,103,121,153,60,93
108065,36,6,0,6,4,0,4,2,0,2
108092,36,3060,1199,1861,2278,870,1408,782,329,453
108232,36,3970,1710,2260,2009,924,1085,1961,786,1175
108667,36,2165,889,1276,312,164,148,1853,725,1128
108807,36,5873,2455,3418,1999,829,1170,3874,1626,2248
108852,36,100,44,56,100,44,56,,,
108977,36,155,49,106,88,31,57,67,18,49
109040,36,1554,330,1224,1554,330,1224,,,
109086,36,1,1,0,1,1,0,,,
109208,36,16112,7501,8611,2986,1284,1702,13126,6217,6909
109350,36,7253,2895,4358,2057,888,1169,5196,2007,3189
109651,36,1613,680,933,1316,565,751,297,115,182
109721,36,58,21,37,58,21,37,,,
109730,36,32,25,7,32,25,7,,,
109785,36,3073,944,2129,2542,776,1766,531,168,363
109819,36,13070,5446,7624,4285,1697,2588,8785,3749,5036
109907,36,1376,383,993,584,157,427,792,226,566
109934,36,366,60,306,366,60,306,,,
110060,36,178,127,51,135,101,34,43,26,17
110097,36,2536,936,1600,2316,854,1462,220,82,138
110194,36,79,79,0,79,79,0,,,
110219,36,984,275,709,984,275,709,,,
110246,36,5904,2392,3512,2678,1146,1532,3226,1246,1980
110316,36,33,8,25,29,7,22,4,1,3
110334,36,6157,2487,3670,1983,858,1125,4174,1629,2545
110361,36,5868,2181,3687,5130,1933,3197,738,248,490
110370,36,942,348,594,881,327,554,61,21,40
110404,36,713,393,320,713,393,320,,,
110413,36,1931,876,1055,1867,843,1024,64,33,31
110422,36,15354,7944,7410,14244,7264,6980,1110,680,430
110468,36,118,46,72,,,,118,46,72
110486,36,6721,2331,4390,5454,1851,3603,1267,480,787
110495,36,6824,2278,4546,5363,1747,3616,1461,531,930
110510,36,11765,4432,7333,9617,3506,6111,2148,926,1222
110529,36,20065,10819,9246,16861,8875,7986,3204,1944,1260
110538,36,10956,5045,5911,9707,4457,5250,1249,588,661
110547,36,10457,3788,6669,7760,2732,5028,2697,1056,1641
110556,36,15687,6287,9400,13169,5123,8046,2518,1164,1354
110565,36,27095,11323,15772,20507,8406,12101,6588,2917,3671
110574,36,9030,3645,5385,6925,2749,4176,2105,896,1209
110583,36,24400,10525,13875,19787,8304,11483,4613,2221,2392
110592,36,15500,6350,9150,12576,5018,7558,2924,1332,1592
110608,36,23631,10729,12902,18934,8228,10706,4697,2501,2196
110617,36,21336,9345,11991,16533,6919,9614,4803,2426,2377
110635,36,22201,10223,11978,20758,9555,11203,1443,668,775
110644,36,21177,8254,12923,20475,7924,12551,702,330,372
110653,36,20071,9433,10638,19430,9054,10376,641,379,262
110662,36,22104,9073,13031,21536,8782,12754,568,291,277
110671,36,15557,7218,8339,14936,6871,8065,621,347,274
110680,36,22195,11157,11038,21297,10661,10636,898,496,402
110705,36,16084,7192,8892,15548,6916,8632,536,276,260
110714,36,11929,6451,5478,11255,6057,5198,674,394,280
110778,36,6,1,5,5,1,4,1,0,1
110875,36,53,0,53,51,0,51,2,0,2
110918,36,10,7,3,5,4,1,5,3,2
111045,36,13,5,8,8,1,7,5,4,1
111054,36,93,20,73,93,20,73,,,
111081,36,677,286,391,656,275,381,21,11,10
111188,36,615,499,116,589,477,112,26,22,4
111434,36,2488,882,1606,314,130,184,2174,752,1422
111461,36,10514,5116,5398,3644,1657,1987,6870,3459,3411
111513,36,168,5,163,128,3,125,40,2,38
111638,36,178,65,113,178,65,113,,,
111708,36,159,122,37,159,122,37,,,
111717,36,142,105,37,137,103,34,5,2,3
111726,36,123,92,31,123,92,31,,,
111744,36,104,84,20,104,84,20,,,
111762,36,68,34,34,68,34,34,,,
111799,36,127,16,111,127,16,111,,,
111887,36,12577,5737,6840,4376,1859,2517,8201,3878,4323
111896,36,2415,1144,1271,550,265,285,1865,879,986
111920,36,7406,3398,4008,1801,776,1025,5605,2622,2983
111939,36,11117,4044,7073,2979,1150,1829,8138,2894,5244
111948,36,5427,2184,3243,5130,2044,3086,297,140,157
111966,36,144,50,94,94,41,53,50,9,41
112075,36,1046,407,639,962,377,585,84,30,54
112084,36,259,127,132,215,108,107,44,19,25
112172,36,6288,2632,3656,2498,1062,1436,3790,1570,2220
112181,36,84,2,82,84,2,82,,,
112190,36,12743,5731,7012,3949,1962,1987,8794,3769,5025
112260,36,1035,508,527,1030,505,525,5,3,2
112288,36,39,1,38,39,1,38,,,
112367,36,275,29,246,95,9,86,180,20,160
112385,36,3650,1916,1734,396,153,243,3254,1763,1491
112394,36,380,278,102,305,222,83,75,56,19
112455,36,101,23,78,101,23,78,,,
112561,36,1056,449,607,309,126,183,747,323,424
112570,36,361,200,161,319,175,144,42,25,17
112686,36,1988,579,1409,500,179,321,1488,400,1088
112826,36,3199,1173,2026,956,388,568,2243,785,1458
113096,36,8129,3285,4844,1650,719,931,6479,2566,3913
113111,36,3199,1413,1786,961,424,537,2238,989,1249
113193,36,5431,2464,2967,1855,861,994,3576,1603,1973
113218,36,4453,1836,2617,888,388,500,3565,1448,2117
113236,36,8555,3471,5084,2886,1223,1663,5669,2248,3421
113333,36,10396,5083,5313,5089,2724,2365,5307,2359,2948
113449,36,114,35,79,114,35,79,,,
113537,36,11,3,8,11,3,8,,,
113573,36,6460,2463,3997,2361,934,1427,4099,1529,2570
113582,36,96,11,85,64,8,56,32,3,29
113634,36,11644,5541,6103,4273,2131,2142,7371,3410,3961
113698,36,934,289,645,829,249,580,105,40,65
113856,36,19975,9889,10086,3359,1356,2003,16616,8533,8083
113980,36,11605,5113,6492,3524,1646,1878,8081,3467,4614
114266,36,5085,2177,2908,1286,591,695,3799,1586,2213
114354,36,1160,198,962,945,151,794,215,47,168
114433,36,825,415,410,233,105,128,592,310,282
114460,36,258,36,222,157,26,131,101,10,91
114637,36,56,1,55,56,1,55,,,
114716,36,7954,4311,3643,2300,1061,1239,5654,3250,2404
114761,36,51,7,44,51,7,44,,,
114789,36,11553,4378,7175,3018,1233,1785,8535,3145,5390
114813,36,2013,526,1487,985,272,713,1028,254,774
114859,36,12099,5430,6669,4519,2071,2448,7580,3359,4221
114938,36,2446,1022,1424,885,389,496,1561,633,928
114947,36,70,24,46,70,24,46,,,
115001,36,7742,3263,4479,4186,1801,2385,3556,1462,2094
115010,36,215,44,171,215,44,171,,,
115083,36,493,353,140,386,299,87,107,54,53
115126,36,5811,2417,3394,1784,809,975,4027,1608,2419
115296,36,8527,3280,5247,2484,1039,1445,6043,2241,3802
115357,36,91,22,69,45,11,34,46,11,35
115393,36,5973,2743,3230,1984,788,1196,3989,1955,2034
115409,36,670,337,333,667,336,331,3,1,2
115658,36,88,15,73,43,11,32,45,4,41
115728,36,433,134,299,336,106,230,97,28,69
115755,36,3949,1645,2304,3359,1361,1998,590,284,306
115773,36,148,31,117,65,16,49,83,15,68
115861,36,4915,1982,2933,2104,761,1343,2811,1221,1590
115931,36,521,378,143,521,378,143,,,
116226,36,108,1,107,46,0,46,62,1,61
116350,36,142,24,118,142,24,118,,,
116439,36,6271,3209,3062,2253,1236,1017,4018,1973,2045
116563,36,222,6,216,222,6,216,,,
116846,36,12,1,11,10,1,9,2,0,2
117052,36,2690,1103,1587,794,377,417,1896,726,1170
117104,36,290,126,164,241,100,141,49,26,23
117140,36,2713,1060,1653,2011,771,1240,702,289,413
117168,36,548,141,407,444,112,332,104,29,75
117195,36,1226,737,489,429,226,203,797,511,286
117238,36,63,15,48,63,15,48,,,
117247,36,3970,1817,2153,931,496,435,3039,1321,1718
117274,36,942,709,233,270,164,106,672,545,127
117283,36,37,19,18,16,7,9,21,12,9
117557,36,119,90,29,112,86,26,7,4,3
117575,36,40,26,14,4,2,2,36,24,12
117627,36,890,355,535,797,324,473,93,31,62
117636,36,745,192,553,615,162,453,130,30,100
117645,36,14621,5996,8625,5097,2184,2913,9524,3812,5712
117672,36,29,5,24,,,,29,5,24
117690,36,3454,1279,2175,841,374,467,2613,905,1708
117706,36,9249,3914,5335,2351,1044,1307,6898,2870,4028
117715,36,2086,546,1540,330,81,249,1756,465,1291
117724,36,5078,2636,2442,1108,641,467,3970,1995,1975
117733,36,7910,3170,4740,1572,685,887,6338,2485,3853
117751,36,740,372,368,479,212,267,261,160,101
117788,36,6877,2834,4043,1533,662,871,5344,2172,3172
117803,36,123,37,86,,,,123,37,86
117867,36,4217,1551,2666,806,341,465,3411,1210,2201
117894,36,4981,2032,2949,1692,762,930,3289,1270,2019
117946,36,4911,2297,2614,4778,2225,2553,133,72,61
117955,36,222,47,175,137,30,107,85,17,68
118134,36,72,1,71,28,1,27,44,0,44
118143,36,93,4,89,14,2,12,79,2,77
118161,36,64,3,61,64,3,61,,,
118198,36,61,29,32,61,29,32,,,
118347,36,2663,1037,1626,670,294,376,1993,743,1250
118541,36,283,143,140,274,139,135,9,4,5
118684,36,1780,527,1253,534,176,358,1246,351,895
118693,36,540,277,263,508,261,247,32,16,16
118718,36,5755,2108,3647,2533,947,1586,3222,1161,2061
118772,36,2977,844,2133,616,174,442,2361,670,1691
118888,36,352,2,350,320,2,318,32,0,32
118912,36,7540,2876,4664,2585,1053,1532,4955,1823,3132
118930,36,3602,1553,2049,843,424,419,2759,1129,1630
118958,36,55,23,32,16,7,9,39,16,23
118976,36,9766,3518,6248,3031,1148,1883,6735,2370,4365
118994,36,274,165,109,274,165,109,,,
119058,36,9,7,2,9,7,2,,,
119067,36,4157,1756,2401,1229,532,697,2928,1224,1704
119137,36,7923,3554,4369,2664,1252,1412,5259,2302,2957
119164,36,17694,7923,9771,5512,2601,2911,12182,5322,6860
119173,36,1347,84,1263,1006,49,957,341,35,306
119216,36,8303,3130,5173,2680,1095,1585,5623,2035,3588
119270,36,541,384,157,311,228,83,230,156,74
119331,36,2817,1081,1736,942,394,548,1875,687,1188
119553,36,924,220,704,901,211,690,23,9,14
119605,36,4404,2086,2318,2002,938,1064,2402,1148,1254
119775,36,251,149,102,212,125,87,39,24,15
119951,36,178,12,166,178,12,166,,,
120069,36,134,15,119,134,15,119,,,
120078,36,271,30,241,271,30,241,,,
120087,36,138,20,118,138,20,118,,,
120254,36,1388,584,804,1366,575,791,22,9,13
120290,36,5068,2463,2605,1977,1033,944,3091,1430,1661
120342,36,10711,5205,5506,3623,1857,1766,7088,3348,3740
120403,36,803,244,559,772,230,542,31,14,17
120421,36,3903,1690,2213,900,407,493,3003,1283,1720
120537,36,447,191,256,354,153,201,93,38,55
120661,36,569,121,448,539,118,421,30,3,27
120698,36,35,3,32,26,3,23,9,0,9
120768,36,377,30,347,,,,377,30,347
120838,36,2,0,2,2,0,2,,,
120865,36,587,211,376,526,197,329,61,14,47
120883,36,2340,1157,1183,2231,1102,1129,109,55,54
120953,36,2925,2610,315,402,309,93,2523,2301,222
120971,36,10600,5415,5185,3294,1570,1724,7306,3845,3461
121044,36,13957,6216,7741,4307,2092,2215,9650,4124,5526
121150,36,2533,1106,1427,2297,999,1298,236,107,129
121257,36,793,347,446,759,327,432,34,20,14
121275,36,22,16,6,22,16,6,,,
121309,36,2197,726,1471,1760,588,1172,437,138,299
121345,36,1281,587,694,1281,587,694,,,
121363,36,1951,611,1340,819,281,538,1132,330,802
121433,36,115,4,111,104,3,101,11,1,10
121619,36,15835,9697,6138,2248,1026,1222,13587,8671,4916
121637,36,93,13,80,93,13,80,,,
121691,36,1907,754,1153,1654,633,1021,253,121,132
121707,36,2185,956,1229,614,297,317,1571,659,912
121859,36,158,12,146,91,12,79,67,0,67
121868,36,153,2,151,92,1,91,61,1,60
121886,36,10596,5804,4792,2472,1122,1350,8124,4682,3442
121901,36,10681,4078,6603,2700,1094,1606,7981,2984,4997
122117,36,2,0,2,1,0,1,1,0,1
122180,36,11156,4163,6993,2641,1017,1624,8515,3146,5369
122205,36,11383,4978,6405,3590,1822,1768,7793,3156,4637
122296,36,474,88,386,411,81,330,63,7,56
122339,36,6928,2884,4044,930,395,535,5998,2489,3509
122375,36,10636,4583,6053,2158,1086,1072,8478,3497,4981
122384,36,7461,4130,3331,894,546,348,6567,3584,2983
122409,36,21684,9561,12123,18772,8102,10670,2912,1459,1453
122436,36,4093,1781,2312,3979,1717,2262,114,64,50
122454,36,23,11,12,22,11,11,1,0,1
122506,36,175,102,73,175,102,73,,,
122597,36,16427,7402,9025,13008,5656,7352,3419,1746,1673
122612,36,4137,1510,2627,3957,1414,2543,180,96,84
122658,36,9674,3728,5946,4800,1923,2877,4874,1805,3069
122685,36,1742,434,1308,1742,434,1308,,,
122694,36,646,178,468,646,178,468,,,
122728,36,794,322,472,617,246,371,177,76,101
122746,36,4382,1684,2698,1051,454,597,3331,1230,2101
122755,36,20186,10223,9963,15936,7870,8066,4250,2353,1897
122791,36,3730,1846,1884,705,396,309,3025,1450,1575
122834,36,9,2,7,9,2,7,,,
122889,36,7065,2910,4155,3072,1404,1668,3993,1506,2487
122931,36,4098,2152,1946,3988,2083,1905,110,69,41
122977,36,15586,6681,8905,5462,2476,2986,10124,4205,5919
123013,36,10858,4554,6304,3339,1511,1828,7519,3043,4476
123165,36,761,0,761,757,0,757,4,0,4
123217,36,7232,2782,4450,2963,1200,1763,4269,1582,2687
123280,36,27,14,13,7,4,3,20,10,10
123299,36,4305,1457,2848,2030,720,1310,2275,737,1538
123341,36,9878,4174,5704,3788,1697,2091,6090,2477,3613
123350,36,77,5,72,44,5,39,33,0,33
123457,36,475,183,292,422,163,259,53,20,33
123484,36,725,343,382,282,118,164,443,225,218
123493,36,79,17,62,79,17,62,,,
123509,36,4034,1790,2244,795,418,377,3239,1372,1867
123527,36,6282,2253,4029,1304,489,815,4978,1764,3214
123554,36,1644,676,968,1460,599,861,184,77,107
123563,36,5228,2098,3130,1621,666,955,3607,1432,2175
123572,36,4856,1849,3007,4180,1532,2648,676,317,359
123642,36,233,13,220,152,9,143,81,4,77
123651,36,1331,423,908,1175,377,798,156,46,110
123679,36,538,162,376,477,151,326,61,11,50
123800,36,10900,4662,6238,4043,1672,2371,6857,2990,3867
123952,36,190,119,71,180,113,67,10,6,4
123961,36,15598,7581,8017,15103,7311,7792,495,270,225
124113,36,2105,1010,1095,535,152,383,1570,858,712
124292,36,347,175,172,347,175,172,,,
124487,36,82,42,40,11,5,6,71,37,34
124681,36,875,334,541,875,334,541,,,
124706,36,562,125,437,562,125,437,,,
124937,36,544,176,368,489,171,318,55,5,50
125028,36,6807,2664,4143,1860,775,1085,4947,1889,3058
125082,36,69,12,57,68,11,57,1,1,0
125091,36,6074,2116,3958,1906,730,1176,4168,1386,2782
125170,36,2569,1053,1516,431,184,247,2138,869,1269
125231,36,5361,897,4464,1178,157,1021,4183,740,3443
125310,36,42,9,33,42,9,33,,,
125462,36,1293,560,733,245,103,142,1048,457,591
125471,36,4808,1788,3020,1040,453,587,3768,1335,2433
125499,36,4026,1761,2265,1304,639,665,2722,1122,1600
125532,36,1145,99,1046,1145,99,1046,,,
125727,36,852,345,507,849,344,505,3,1,2
125763,36,975,415,560,932,388,544,43,27,16
125897,36,712,354,358,659,328,331,53,26,27
126076,36,72,72,0,72,72,0,,,
126119,36,2982,1010,1972,855,338,517,2127,672,1455
126164,36,43,1,42,43,1,42,,,
126182,36,1002,545,457,748,369,379,254,176,78
126207,36,2218,918,1300,850,398,452,1368,520,848
126289,36,3227,1210,2017,899,406,493,2328,804,1524
126359,36,142,19,123,142,19,123,,,
126562,36,7918,3536,4382,5690,2522,3168,2228,1014,1214
126580,36,6741,3065,3676,4988,2270,2718,1753,795,958
126605,36,256,227,29,256,227,29,,,
126614,36,22124,12070,10054,20376,10991,9385,1748,1079,669
126669,36,3463,1007,2456,1157,411,746,2306,596,1710
126678,36,1589,698,891,1541,675,866,48,23,25
126687,36,607,99,508,607,99,508,,,
126711,36,2147,792,1355,792,332,460,1355,460,895
126748,36,259,82,177,170,61,109,89,21,68
126775,36,3870,2659,1211,3622,2490,1132,248,169,79
126784,36,98,96,2,98,96,2,,,
126818,36,17668,8235,9433,14156,6499,7657,3512,1736,1776
126827,36,17415,6480,10935,10900,3967,6933,6515,2513,4002
126863,36,2499,943,1556,670,301,369,1829,642,1187
126915,36,7,3,4,4,3,1,3,0,3
126942,36,3165,1111,2054,1059,384,675,2106,727,1379
126951,36,858,782,76,858,782,76,,,
127060,36,3924,1785,2139,3633,1647,1986,291,138,153
127158,36,2906,2736,170,441,365,76,2465,2371,94
127185,36,2037,970,1067,1752,817,935,285,153,132
127200,36,7568,3014,4554,2313,1043,1270,5255,1971,3284
127316,36,195,45,150,67,25,42,128,20,108
127389,36,176,62,114,99,42,57,77,20,57
127556,36,5541,2510,3031,4422,2018,2404,1119,492,627
127565,36,11784,5293,6491,7088,3256,3832,4696,2037,2659
127617,36,423,125,298,158,51,107,265,74,191
127653,36,198,56,142,183,50,133,15,6,9
127714,36,278,130,148,31,11,20,247,119,128
127732,36,419,156,263,258,111,147,161,45,116
127741,36,4843,1581,3262,4214,1405,2809,629,176,453
127778,36,403,135,268,209,87,122,194,48,146
127820,36,5754,2150,3604,1970,831,1139,3784,1319,2465
127884,36,2256,681,1575,802,290,512,1454,391,1063
127909,36,2572,1232,1340,881,469,412,1691,763,928
127918,36,2089,780,1309,1428,458,970,661,322,339
127945,36,1426,352,1074,824,207,617,602,145,457
127954,36,1,0,1,1,0,1,,,
128106,36,2175,998,1177,1737,771,966,438,227,211
128151,36,252,112,140,245,109,136,7,3,4
128179,36,490,353,137,490,353,137,,,
128188,36,540,237,303,540,237,303,,,
128258,36,567,207,360,287,123,164,280,84,196
128328,36,3090,2218,872,3090,2218,872,,,
128337,36,32,0,32,21,0,21,11,0,11
128391,36,1172,700,472,1080,640,440,92,60,32
128498,36,778,292,486,677,260,417,101,32,69
128577,36,590,254,336,192,99,93,398,155,243
128586,36,16,16,0,16,16,0,,,
128744,36,1318,382,936,1033,332,701,285,50,235
128771,36,5799,3103,2696,4414,2335,2079,1385,768,617
128780,36,1052,290,762,277,61,216,775,229,546
128896,36,103,20,83,103,20,83,,,
128902,36,1293,514,779,1292,514,778,1,0,1
129002,36,247,113,134,204,94,110,43,19,24
129020,36,14056,6784,7272,13624,6520,7104,432,264,168
129154,36,1973,259,1714,207,43,164,1766,216,1550
129181,36,873,802,71,651,600,51,222,202,20
129215,36,2689,1159,1530,2419,1013,1406,270,146,124
129242,36,3259,1344,1915,3196,1312,1884,63,32,31
129349,36,163,3,160,156,3,153,7,0,7
129367,36,1553,355,1198,248,72,176,1305,283,1022
129482,36,332,24,308,332,24,308,,,
129525,36,2812,1265,1547,2613,1181,1432,199,84,115
129534,36,159,70,89,75,34,41,84,36,48
129543,36,2243,732,1511,606,220,386,1637,512,1125
129695,36,2634,1106,1528,726,315,411,1908,791,1117
129729,36,3015,1082,1933,866,373,493,2149,709,1440
129756,36,1102,425,677,331,158,173,771,267,504
129774,36,371,206,165,361,200,161,10,6,4
129808,36,1948,675,1273,473,212,261,1475,463,1012
129923,36,428,193,235,228,105,123,200,88,112
129932,36,26,25,1,8,7,1,18,18,0
129941,36,3474,1559,1915,3278,1444,1834,196,115,81
130004,36,2598,1011,1587,667,292,375,1931,719,1212
130040,36,629,180,449,189,63,126,440,117,323
130110,36,64,20,44,30,9,21,34,11,23
130174,36,1301,588,713,1126,543,583,175,45,130
130183,36,8541,2189,6352,2995,789,2206,5546,1400,4146
130217,36,619,213,406,174,65,109,445,148,297
130226,36,4557,1711,2846,4324,1629,2695,233,82,151
130253,36,4689,1498,3191,4098,1339,2759,591,159,432
130314,36,660,160,500,622,153,469,38,7,31
130396,36,3664,1257,2407,936,403,533,2728,854,1874
130493,36,4803,1806,2997,4021,1487,2534,782,319,463
130509,36,408,26,382,164,13,151,244,13,231
130590,36,1597,801,796,1563,784,779,34,17,17
130606,36,2027,805,1222,708,296,412,1319,509,810
130624,36,764,456,308,764,456,308,,,
130697,36,2307,984,1323,2289,970,1319,18,14,4
130776,36,2981,1401,1580,2475,1166,1309,506,235,271
130794,36,4736,2371,2365,4732,2367,2365,4,4,0
130837,36,67,8,59,67,8,59,,,
130873,36,54,11,43,54,11,43,,,
130907,36,7607,2290,5317,1662,644,1018,5945,1646,4299
130934,36,3000,992,2008,2696,892,1804,304,100,204
130943,36,13652,5812,7840,12981,5462,7519,671,350,321
130989,36,475,222,253,412,198,214,63,24,39
131061,36,77,4,73,39,2,37,38,2,36
131113,36,5773,2058,3715,1916,820,1096,3857,1238,2619
131159,36,5567,2102,3465,5314,1990,3324,253,112,141
131283,36,2138,930,1208,2048,895,1153,90,35,55
131399,36,2359,865,1494,1054,464,590,1305,401,904
131450,36,770,358,412,690,325,365,80,33,47
131469,36,7798,2880,4918,7223,2627,4596,575,253,322
131496,36,5754,2506,3248,5559,2412,3147,195,94,101
131520,36,5975,1725,4250,5508,1554,3954,467,171,296
131803,36,323,71,252,24,13,11,299,58,241
131830,36,24,15,9,24,15,9,,,
131876,36,1068,26,1042,726,9,717,342,17,325
132374,36,1678,1460,218,1678,1460,218,,,
132408,36,198,105,93,139,73,66,59,32,27
132471,36,1973,646,1327,1692,529,1163,281,117,164
132602,36,1600,585,1015,1478,535,943,122,50,72
132657,36,1699,845,854,1540,768,772,159,77,82
132675,36,11,3,8,8,0,8,3,3,0
132693,36,7653,2926,4727,2109,936,1173,5544,1990,3554
132709,36,19649,7589,12060,5145,2148,2997,14504,5441,9063
132842,36,114,19,95,78,12,66,36,7,29
132851,36,3165,1074,2091,1063,407,656,2102,667,1435
132879,36,100,57,43,87,50,37,13,7,6
132903,36,45579,20701,24878,30592,13802,16790,14987,6899,8088
132976,36,125,56,69,125,56,69,,,
133021,36,817,267,550,366,145,221,451,122,329
133155,36,328,173,155,191,126,65,137,47,90
133386,36,6884,2620,4264,2552,1175,1377,4332,1445,2887
133465,36,274,35,239,223,30,193,51,5,46
133492,36,1323,419,904,1279,401,878,44,18,26
133508,36,7834,2588,5246,2167,765,1402,5667,1823,3844
133526,36,689,328,361,638,308,330,51,20,31
133553,36,4791,3629,1162,4455,3353,1102,336,276,60
133650,36,5187,1785,3402,4514,1518,2996,673,267,406
133669,36,17242,7214,10028,11549,4870,6679,5693,2344,3349
133702,36,13449,4540,8909,3642,1346,2296,9807,3194,6613
133711,36,1687,556,1131,1615,524,1091,72,32,40
133809,36,305,149,156,299,146,153,6,3,3
133845,36,586,66,520,566,66,500,20,0,20
133854,36,254,54,200,254,54,200,,,
133863,36,312,39,273,312,39,273,,,
133872,36,857,133,724,299,52,247,558,81,477
133881,36,2306,1625,681,2178,1529,649,128,96,32
133942,36,53,4,49,53,4,49,,,
133951,36,30240,13290,16950,18852,8112,10740,11388,5178,6210
133960,36,576,204,372,188,102,86,388,102,286
133979,36,532,255,277,493,238,255,39,17,22
133997,36,264,106,158,264,106,158,,,
134024,36,20,8,12,20,8,12,,,
134079,36,1856,699,1157,1763,670,1093,93,29,64
134097,36,23764,10258,13506,20892,8803,12089,2872,1455,1417
134130,36,25704,11271,14433,22847,9703,13144,2857,1568,1289
134228,36,5,0,5,2,0,2,3,0,3
134237,36,16325,11349,4976,16325,11349,4976,,,
134291,36,193,158,35,187,153,34,6,5,1
134307,36,690,648,42,155,150,5,535,498,37
134343,36,2438,770,1668,824,274,550,1614,496,1118
134422,36,17,0,17,17,0,17,,,
134495,36,13093,5251,7842,4870,2228,2642,8223,3023,5200
134510,36,117,57,60,65,28,37,52,29,23
134529,36,207,16,191,207,16,191,,,
134574,36,71,9,62,71,9,62,,,
134608,36,8248,2978,5270,2426,1001,1425,5822,1977,3845
134714,36,118,10,108,30,3,27,88,7,81
134811,36,429,139,290,292,96,196,137,43,94
134945,36,1738,707,1031,1534,655,879,204,52,152
135081,36,15130,4116,11014,8699,2557,6142,6431,1559,4872
135142,36,144,6,138,15,0,15,129,6,123
135160,36,1441,421,1020,497,168,329,944,253,691
135179,36,424,237,187,265,147,118,159,90,69
135188,36,2145,773,1372,635,246,389,1510,527,983
135267,36,267,167,100,264,165,99,3,2,1
135276,36,444,230,214,401,200,201,43,30,13
135294,36,314,146,168,251,144,107,63,2,61
135337,36,36,3,33,21,3,18,15,0,15
135364,36,170,115,55,22,14,8,148,101,47
135391,36,5129,1768,3361,1671,660,1011,3458,1108,2350
135407,36,417,238,179,416,238,178,1,0,1
135522,36,61,37,24,61,37,24,,,
135559,36,66,4,62,43,2,41,23,2,21
135610,36,61,23,38,30,14,16,31,9,22
135647,36,695,573,122,486,412,74,209,161,48
135717,36,29150,11705,17445,10367,4255,6112,18783,7450,11333
135726,36,8524,3989,4535,8125,3795,4330,399,194,205
135735,36,734,677,57,153,136,17,581,541,40
136109,36,107,1,106,55,1,54,52,0,52
136145,36,535,118,417,165,30,135,370,88,282
136172,36,9938,4337,5601,7017,3014,4003,2921,1323,1598
136215,36,4391,1266,3125,3847,1160,2687,544,106,438
136233,36,2344,836,1508,873,346,527,1471,490,981
136303,36,64,7,57,58,7,51,6,0,6
136330,36,1557,547,1010,1438,505,933,119,42,77
136358,36,15194,5744,9450,3380,1423,1957,11814,4321,7493
136400,36,5097,1922,3175,1836,748,1088,3261,1174,2087
136473,36,5417,1724,3693,2004,732,1272,3413,992,2421
136491,36,491,290,201,395,266,129,96,24,72
136516,36,5275,1712,3563,1579,573,1006,3696,1139,2557
136659,36,106,80,26,101,75,26,5,5,0
136765,36,8,6,2,4,4,0,4,2,2
136774,36,1199,340,859,1175,336,839,24,4,20
136826,36,278,158,120,143,83,60,135,75,60
136950,36,1875,764,1111,1799,734,1065,76,30,46
137023,36,74,30,44,73,30,43,1,0,1
137032,36,4642,1827,2815,3345,1264,2081,1297,563,734
137078,36,15812,5715,10097,4200,1792,2408,11612,3923,7689
137087,36,479,238,241,450,233,217,29,5,24
137096,36,7238,3286,3952,2613,1297,1316,4625,1989,2636
137120,36,1084,615,469,530,288,242,554,327,227
137209,36,9672,4030,5642,2703,1355,1348,6969,2675,4294
137245,36,685,376,309,685,376,309,,,
137272,36,26,26,0,26,26,0,,,
137281,36,2809,898,1911,825,304,521,1984,594,1390
137315,36,1336,424,912,507,192,315,829,232,597
137351,36,26333,11516,14817,19883,8543,11340,6450,2973,3477
137476,36,977,510,467,843,477,366,134,33,101
137546,36,2078,916,1162,2024,886,1138,54,30,24
137564,36,3678,1516,2162,3077,1234,1843,601,282,319
137591,36,186,30,156,170,29,141,16,1,15
137713,36,36,10,26,5,0,5,31,10,21
137759,36,6557,2685,3872,2872,1259,1613,3685,1426,2259
137777,36,20,20,0,20,20,0,,,
137801,36,353,156,197,329,151,178,24,5,19
137847,36,6408,2578,3830,6103,2413,3690,305,165,140
137856,36,27,15,12,19,11,8,8,4,4
137865,36,209,111,98,204,106,98,5,5,0
137953,36,232,129,103,171,100,71,61,29,32
137962,36,136,77,59,102,58,44,34,19,15
138187,36,26141,10212,15929,7231,3002,4229,18910,7210,11700
138275,36,446,218,228,403,199,204,43,19,24
138284,36,40,20,20,31,17,14,9,3,6
138293,36,453,288,165,430,273,157,23,15,8
138309,36,6437,868,5569,3282,465,2817,3155,403,2752
138354,36,6471,2799,3672,4353,1932,2421,2118,867,1251
138372,36,324,236,88,106,30,76,218,206,12
138479,36,344,229,115,344,229,115,,,
138488,36,185,105,80,85,22,63,100,83,17
138497,36,68,30,38,68,30,38,,,
138558,36,2227,903,1324,1445,679,766,782,224,558
138600,36,704,0,704,699,0,699,5,0,5
138655,36,558,383,175,528,363,165,30,20,10
138664,36,36,11,25,36,11,25,,,
138682,36,1454,356,1098,577,155,422,877,201,676
138716,36,4192,1081,3111,2761,755,2006,1431,326,1105
138761,36,135,51,84,85,47,38,50,4,46
138813,36,390,199,191,254,125,129,136,74,62
138822,36,452,9,443,452,9,443,,,
138840,36,2053,612,1441,616,235,381,1437,377,1060
138868,36,551,237,314,432,204,228,119,33,86
138901,36,1010,324,686,320,90,230,690,234,456
138938,36,352,23,329,192,7,185,160,16,144
138947,36,2116,504,1612,1977,466,1511,139,38,101
138956,36,2125,899,1226,704,290,414,1421,609,812
139144,36,1409,513,896,1396,505,891,13,8,5
139153,36,169,95,74,73,37,36,96,58,38
139199,36,907,61,846,634,34,600,273,27,246
139205,36,236,134,102,216,121,95,20,13,7
139250,36,1949,580,1369,1064,325,739,885,255,630
139278,36,3345,926,2419,827,254,573,2518,672,1846
139311,36,3920,1123,2797,2373,662,1711,1547,461,1086
139357,36,1793,468,1325,519,160,359,1274,308,966
139366,36,4312,1680,2632,2790,1024,1766,1522,656,866
139384,36,3044,1007,2037,1006,388,618,2038,619,1419
139393,36,554,256,298,536,243,293,18,13,5
139463,36,2985,1099,1886,1670,624,1046,1315,475,840
139506,36,79,52,27,79,52,27,,,
139579,36,156,50,106,106,35,71,50,15,35
139621,36,908,355,553,590,239,351,318,116,202
139630,36,494,268,226,467,254,213,27,14,13
139658,36,4892,2104,2788,4820,2062,2758,72,42,30
139700,36,3301,1131,2170,1166,445,721,2135,686,1449
139719,36,1740,629,1111,1454,522,932,286,107,179
139746,36,67,14,53,67,14,53,,,
139755,36,12136,7264,4872,10825,6450,4375,1311,814,497
139764,36,1426,497,929,1004,357,647,422,140,282
139861,36,3738,1347,2391,3296,1139,2157,442,208,234
139931,36,15414,6558,8856,12671,5364,7307,2743,1194,1549
139940,36,21000,8385,12615,15225,6002,9223,5775,2383,3392
139959,36,22478,9593,12885,20753,8718,12035,1725,875,850
139968,36,1764,510,1254,996,319,677,768,191,577
139986,36,2842,684,2158,846,205,641,1996,479,1517
139995,36,113,53,60,113,53,60,,,
140003,36,156,29,127,75,17,58,81,12,69
140012,36,4762,1949,2813,1077,534,543,3685,1415,2270
140234,36,403,209,194,390,208,182,13,1,12
140243,36,2435,900,1535,631,234,397,1804,666,1138
140252,36,587,270,317,456,227,229,131,43,88
140331,36,5125,2085,3040,1444,677,767,3681,1408,2273
140340,36,466,79,387,274,57,217,192,22,170
140447,36,3282,1220,2062,2900,1121,1779,382,99,283
140553,36,1682,1682,0,1511,1511,0,171,171,0
140678,36,1342,491,851,441,166,275,901,325,576
140696,36,967,364,603,923,345,578,44,19,25
140720,36,134,64,70,111,53,58,23,11,12
140818,36,816,284,532,740,269,471,76,15,61
140827,36,66,12,54,66,12,54,,,
140872,36,713,358,355,636,322,314,77,36,41
140942,36,2130,698,1432,633,267,366,1497,431,1066
140951,36,9069,2832,6237,7288,2252,5036,1781,580,1201
140960,36,2083,817,1266,1624,649,975,459,168,291
140988,36,785,331,454,720,311,409,65,20,45
141006,36,864,372,492,398,188,210,466,184,282
141015,36,119,50,69,116,47,69,3,3,0
141060,36,1587,0,1587,1535,0,1535,52,0,52
141167,36,588,240,348,376,167,209,212,73,139
141185,36,534,212,322,495,200,295,39,12,27
141237,36,561,261,300,526,242,284,35,19,16
141255,36,1630,477,1153,488,142,346,1142,335,807
141264,36,5947,1966,3981,4387,1452,2935,1560,514,1046
141325,36,425,0,425,310,0,310,115,0,115
141334,36,6418,2205,4213,4850,1665,3185,1568,540,1028
141361,36,534,221,313,529,218,311,5,3,2
141486,36,1118,303,815,904,234,670,214,69,145
141565,36,1793,630,1163,1316,462,854,477,168,309
141574,36,9155,3826,5329,7189,2938,4251,1966,888,1078
141608,36,65,43,22,65,43,22,,,
141644,36,1653,600,1053,1300,402,898,353,198,155
141680,36,1333,835,498,511,343,168,822,492,330
141796,36,2603,953,1650,911,363,548,1692,590,1102
141802,36,542,182,360,128,66,62,414,116,298
141811,36,2746,977,1769,1058,433,625,1688,544,1144
141839,36,1347,387,960,410,126,284,937,261,676
141981,36,1914,637,1277,1156,401,755,758,236,522
141990,36,637,172,465,223,51,172,414,121,293
142054,36,379,52,327,379,52,327,,,
142090,36,55,35,20,45,29,16,10,6,4
142115,36,12242,5276,6966,9106,3957,5149,3136,1319,1817
142179,36,913,285,628,370,143,227,543,142,401
142276,36,4888,1981,2907,3632,1483,2149,1256,498,758
142285,36,4681,2310,2371,4271,2098,2173,410,212,198
142294,36,781,381,400,767,370,397,14,11,3
142328,36,1729,594,1135,1285,480,805,444,114,330
142407,36,79,9,70,56,9,47,23,0,23
142416,36,2,0,2,2,0,2,,,
142443,36,1960,654,1306,748,340,408,1212,314,898
142461,36,834,331,503,717,290,427,117,41,76
142489,36,34,0,34,34,0,34,,,
142522,36,36814,16190,20624,13552,6656,6896,23262,9534,13728
142559,36,2243,720,1523,907,349,558,1336,371,965
142887,36,115,34,81,89,28,61,26,6,20
142957,36,2,2,0,1,1,0,1,1,0
143048,36,2001,524,1477,1733,452,1281,268,72,196
143084,36,1621,731,890,1602,718,884,19,13,6
143118,36,2711,895,1816,2476,823,1653,235,72,163
143215,36,4240,1722,2518,1762,789,973,2478,933,1545
143279,36,1530,486,1044,665,236,429,865,250,615
143288,36,283,124,159,278,121,157,5,3,2
143297,36,136,7,129,108,5,103,28,2,26
143358,36,3138,1564,1574,3043,1507,1536,95,57,38
143376,36,209,12,197,125,10,115,84,2,82
143464,36,111,3,108,86,3,83,25,0,25
143473,36,33,1,32,18,1,17,15,0,15
143482,36,21,0,21,10,0,10,11,0,11
143491,36,26,0,26,9,0,9,17,0,17
143552,36,43,1,42,21,0,21,22,1,21
143613,36,745,218,527,356,132,224,389,86,303
143978,36,14,3,11,10,2,8,4,1,3
144005,36,1157,337,820,688,213,475,469,124,345
144050,36,5392,2824,2568,5390,2823,2567,2,1,1
144157,36,737,257,480,271,105,166,466,152,314
144166,36,3776,766,3010,1363,311,1052,2413,455,1958
144175,36,646,190,456,242,82,160,404,108,296
144184,36,1481,537,944,506,199,307,975,338,637
144193,36,1498,791,707,641,437,204,857,354,503
144209,36,2961,1160,1801,1229,489,740,1732,671,1061
144218,36,3194,1438,1756,1243,626,617,1951,812,1139
144281,36,4190,1653,2537,3872,1506,2366,318,147,171
144351,36,903,385,518,775,332,443,128,53,75
144485,36,149,102,47,149,102,47,,,
144564,36,918,356,562,429,160,269,489,196,293
144573,36,126,2,124,80,1,79,46,1,45
144740,36,10066,4732,5334,8970,4169,4801,1096,563,533
144795,36,295,67,228,260,59,201,35,8,27
144865,36,10051,4447,5604,3742,1750,1992,6309,2697,3612
144883,36,213,103,110,213,103,110,,,
144892,36,3199,1208,1991,2715,1055,1660,484,153,331
144944,36,4845,2137,2708,1459,705,754,3386,1432,1954
144962,36,1882,725,1157,1787,675,1112,95,50,45
144971,36,293,154,139,282,146,136,11,8,3
145099,36,232,17,215,232,17,215,,,
145239,36,192,32,160,192,32,160,,,
145309,36,30,12,18,30,12,18,,,
145336,36,2055,738,1317,1161,424,737,894,314,580
145354,36,50,2,48,10,0,10,40,2,38
145372,36,536,291,245,496,277,219,40,14,26
145406,36,448,7,441,120,3,117,328,4,324
145424,36,58,2,56,18,2,16,40,0,40
145433,36,102,1,101,44,0,44,58,1,57
145497,36,68,8,60,55,5,50,13,3,10
145521,36,579,172,407,264,92,172,315,80,235
145600,36,15590,7445,8145,13969,6619,7350,1621,826,795
145619,36,1434,686,748,1163,561,602,271,125,146
145637,36,24326,13118,11208,23588,12622,10966,738,496,242
145646,36,1173,557,616,1169,556,613,4,1,3
145682,36,3559,1322,2237,1155,539,616,2404,783,1621
145691,36,785,365,420,767,358,409,18,7,11
145707,36,320,113,207,215,83,132,105,30,75
145725,36,2237,1511,726,2046,1361,685,191,150,41
145813,36,12480,5308,7172,11427,4774,6653,1053,534,519
145831,36,1301,568,733,510,234,276,791,334,457
146205,36,1553,589,964,805,321,484,748,268,480
146278,36,768,260,508,376,140,236,392,120,272
146296,36,7936,3384,4552,3165,1495,1670,4771,1889,2882
146339,36,638,275,363,565,257,308,73,18,55
146348,36,1325,458,867,476,178,298,849,280,569
146366,36,975,325,650,557,194,363,418,131,287
146418,36,1201,471,730,474,215,259,727,256,471
146427,36,849,360,489,840,355,485,9,5,4
146454,36,29,0,29,29,0,29,,,
146472,36,7045,2990,4055,2189,1077,1112,4856,1913,2943
146481,36,1141,449,692,1126,440,686,15,9,6
146506,36,1553,571,982,946,369,577,607,202,405
146533,36,94,17,77,64,15,49,30,2,28
146603,36,1757,617,1140,754,315,439,1003,302,701
146612,36,2755,1364,1391,2324,1135,1189,431,229,202
146667,36,174,102,72,138,82,56,36,20,16
146676,36,523,240,283,385,201,184,138,39,99
146685,36,2755,974,1781,887,378,509,1868,596,1272
146700,36,881,628,253,881,628,253,,,
146719,36,8412,2721,5691,7885,2541,5344,527,180,347
146755,36,76,11,65,62,10,52,14,1,13
146807,36,70,7,63,23,3,20,47,4,43
146816,36,152,19,133,84,8,76,68,11,57
147004,36,3243,1483,1760,1424,716,708,1819,767,1052
147013,36,1044,513,531,889,458,431,155,55,100
147129,36,393,44,349,165,21,144,228,23,205
147244,36,1228,505,723,1172,488,684,56,17,39
147341,36,549,257,292,547,257,290,2,0,2
147369,36,1447,741,706,1147,559,588,300,182,118
147378,36,5512,2412,3100,2326,1096,1230,3186,1316,1870
147396,36,41,39,2,39,37,2,2,2,0
147411,36,1965,749,1216,531,237,294,1434,512,922
147536,36,2430,608,1822,1721,480,1241,709,128,581
147590,36,10,4,6,7,3,4,3,1,2
147642,36,40,4,36,15,1,14,25,3,22
147660,36,1646,783,863,1613,766,847,33,17,16
147679,36,1205,478,727,1093,432,661,112,46,66
147703,36,8042,3811,4231,6646,3067,3579,1396,744,652
147767,36,6379,3011,3368,6100,2897,3203,279,114,165
147776,36,3448,1441,2007,1852,767,1085,1596,674,922
147800,36,5328,2524,2804,1520,788,732,3808,1736,2072
147819,36,16,1,15,16,1,15,,,
147828,36,1820,757,1063,1722,730,992,98,27,71
147916,36,2272,1043,1229,1001,489,512,1271,554,717
148007,36,1691,559,1132,479,182,297,1212,377,835
148016,36,225,116,109,221,113,108,4,3,1
148098,36,36,0,36,21,0,21,15,0,15
148131,36,626,296,330,599,283,316,27,13,14
148256,36,768,310,458,535,219,316,233,91,142
148292,36,1151,337,814,373,132,241,778,205,573
148380,36,3308,1433,1875,1250,599,651,2058,834,1224
148405,36,657,274,383,603,255,348,54,19,35
148487,36,1727,661,1066,1432,563,869,295,98,197
148496,36,1429,445,984,1309,409,900,120,36,84
148511,36,70,20,50,26,5,21,44,15,29
148575,36,188,28,160,138,19,119,50,9,41
148584,36,1108,334,774,890,294,596,218,40,178
148593,36,50,6,44,49,6,43,1,0,1
148627,36,2079,739,1340,1878,655,1223,201,84,117
148654,36,1751,846,905,1178,518,660,573,328,245
148672,36,706,257,449,343,120,223,363,137,226
148821,36,423,120,303,222,63,159,201,57,144
148876,36,637,119,518,471,86,385,166,33,133
148937,36,384,162,222,227,111,116,157,51,106
148991,36,652,247,405,386,161,225,266,86,180
149028,36,145,14,131,106,13,93,39,1,38
149204,36,31,0,31,31,0,31,,,
149222,36,5376,2831,2545,4390,2251,2139,986,580,406
149231,36,6897,3040,3857,5397,2417,2980,1500,623,877
149310,36,104,45,59,104,45,59,,,
149329,36,59,59,0,59,59,0,,,
149365,36,1678,477,1201,475,160,315,1203,317,886
149499,36,6,0,6,6,0,6,,,
149505,36,564,181,383,494,163,331,70,18,52
149514,36,338,196,142,277,163,114,61,33,28
149532,36,4892,2266,2626,1436,642,794,3456,1624,1832
149550,36,121,17,104,94,15,79,27,2,25
149639,36,44,23,21,44,23,21,,,
149727,36,4086,1685,2401,1311,628,683,2775,1057,1718
149763,36,385,70,315,291,48,243,94,22,72
149772,36,3700,1657,2043,3130,1377,1753,570,280,290
149781,36,1693,775,918,1596,721,875,97,54,43
149842,36,6488,2707,3781,2104,1044,1060,4384,1663,2721
150066,36,791,334,457,721,317,404,70,17,53
150136,36,10037,3896,6141,9263,3602,5661,774,294,480
150145,36,774,288,486,673,266,407,101,22,79
150163,36,3193,1284,1909,3130,1242,1888,63,42,21
150172,36,341,173,168,228,103,125,113,70,43
150251,36,163,5,158,79,1,78,84,4,80
150303,36,265,5,260,83,3,80,182,2,180
150400,36,1199,596,603,1191,593,598,8,3,5
150428,36,4,0,4,4,0,4,,,
150455,36,476,208,268,476,208,268,,,
150534,36,1172,462,710,1124,448,676,48,14,34
150604,36,603,308,295,594,303,291,9,5,4
150668,36,503,196,307,464,182,282,39,14,25
150677,36,908,373,535,862,350,512,46,23,23
150756,36,711,340,371,706,337,369,5,3,2
150765,36,115,2,113,115,2,113,,,
150774,36,214,125,89,207,122,85,7,3,4
150853,36,211,1,210,114,1,113,97,0,97
150941,36,708,283,425,624,251,373,84,32,52
150987,36,37883,15499,22384,9237,3178,6059,28646,12321,16325
151102,36,4081,2038,2043,3215,1590,1625,866,448,418
151111,36,13963,5756,8207,11530,4662,6868,2433,1094,1339
151263,36,2683,985,1698,2462,911,1551,221,74,147
151290,36,882,541,341,842,518,324,40,23,17
151306,36,4243,1483,2760,3520,1225,2295,723,258,465
151324,36,5605,2448,3157,4501,1917,2584,1104,531,573
151333,36,1860,650,1210,1526,530,996,334,120,214
151342,36,2828,999,1829,2052,715,1337,776,284,492
151351,36,23910,12013,11897,23041,11564,11477,869,449,420
151360,36,2223,566,1657,1590,406,1184,633,160,473
151379,36,2608,1042,1566,1712,651,1061,896,391,505
151388,36,2027,698,1329,1180,344,836,847,354,493
151467,36,137,21,116,137,21,116,,,
151564,36,7,0,7,5,0,5,2,0,2
151607,36,98,4,94,68,3,65,30,1,29
151652,36,128,3,125,75,2,73,53,1,52
151661,36,923,862,61,923,862,61,,,
151777,36,642,320,322,631,312,319,11,8,3
151786,36,1829,647,1182,1576,595,981,253,52,201
151801,36,1634,585,1049,1591,569,1022,43,16,27
151810,36,140,38,102,73,19,54,67,19,48
151962,36,175,57,118,175,57,118,,,
152044,36,26,20,6,14,11,3,12,9,3
152080,36,6667,3452,3215,6650,3440,3210,17,12,5
152099,36,368,191,177,323,172,151,45,19,26
152150,36,48,3,45,33,2,31,15,1,14
152275,36,131,43,88,77,9,68,54,34,20
152309,36,90,35,55,72,28,44,18,7,11
152318,36,1422,1071,351,1401,1056,345,21,15,6
152336,36,1145,329,816,964,313,651,181,16,165
152381,36,514,86,428,431,77,354,83,9,74
152390,36,985,0,985,977,0,977,8,0,8
152497,36,145,12,133,124,12,112,21,0,21
152530,36,1275,578,697,1228,552,676,47,26,21
152567,36,1545,990,555,1506,965,541,39,25,14
152600,36,1770,768,1002,1742,756,986,28,12,16
152628,36,19,0,19,9,0,9,10,0,10
152637,36,2635,1383,1252,1645,838,807,990,545,445
152673,36,622,622,0,619,619,0,3,3,0
152798,36,147,9,138,128,9,119,19,0,19
152992,36,426,210,216,375,201,174,51,9,42
153001,36,1034,367,667,893,328,565,141,39,102
153074,36,128,5,123,128,5,123,,,
153083,36,131,5,126,131,5,126,,,
153108,36,743,386,357,719,369,350,24,17,7
153126,36,438,217,221,425,211,214,13,6,7
153144,36,911,400,511,900,393,507,11,7,4
153162,36,642,337,305,634,330,304,8,7,1
153214,36,6483,2585,3898,2711,1223,1488,3772,1362,2410
153241,36,57,23,34,57,23,34,,,
153250,36,953,503,450,948,502,446,5,1,4
153269,36,1967,796,1171,1894,753,1141,73,43,30
153278,36,1161,667,494,902,562,340,259,105,154
153296,36,289,127,162,244,113,131,45,14,31
153302,36,109,50,59,95,43,52,14,7,7
153311,36,2259,698,1561,1049,364,685,1210,334,876
153320,36,195,96,99,166,81,85,29,15,14
153366,36,599,229,370,556,225,331,43,4,39
153375,36,1047,475,572,931,425,506,116,50,66
153384,36,1238,594,644,1234,593,641,4,1,3
153427,36,56,20,36,56,20,36,,,
153445,36,1611,612,999,942,414,528,669,198,471
153463,36,18,1,17,18,1,17,,,
153472,36,1015,415,600,749,345,404,266,70,196
153524,36,1551,706,845,1062,555,507,489,151,338
153533,36,588,294,294,427,239,188,161,55,106
153542,36,14,2,12,14,2,12,,,
153597,36,8,0,8,8,0,8,,,
153603,36,18796,10720,8076,17791,10054,7737,1005,666,339
153621,36,365,180,185,335,170,165,30,10,20
153630,36,2001,786,1215,1089,542,547,912,244,668
153658,36,15625,7065,8560,14231,6410,7821,1394,655,739
153737,36,5291,2094,3197,2383,1070,1313,2908,1024,1884
153746,36,16,1,15,16,1,15,,,
153764,36,29,1,28,29,1,28,,,
153773,36,14,0,14,14,0,14,,,
153782,36,9,0,9,9,0,9,,,
153825,36,879,500,379,829,463,366,50,37,13
153834,36,1288,539,749,1268,524,744,20,15,5
153861,36,419,94,325,218,46,172,201,48,153
153922,36,401,131,270,245,99,146,156,32,124
153977,36,530,69,461,227,38,189,303,31,272
154004,36,769,376,393,745,364,381,24,12,12
154013,36,910,295,615,687,221,466,223,74,149
154022,36,27823,9718,18105,27823,9718,18105,,,
154059,36,822,337,485,564,256,308,258,81,177
154095,36,5643,2207,3436,5143,1989,3154,500,218,282
154101,36,733,358,375,677,352,325,56,6,50
154110,36,1176,313,863,416,188,228,760,125,635
154129,36,444,187,257,256,152,104,188,35,153
154165,36,6,0,6,6,0,6,,,
154174,36,19,10,9,17,10,7,2,0,2
154208,36,94,2,92,11,0,11,83,2,81
154235,36,1554,667,887,1471,633,838,83,34,49
154262,36,127,9,118,52,4,48,75,5,70
154332,36,55,2,53,55,2,53,,,
154350,36,814,374,440,732,337,395,82,37,45
154378,36,918,297,621,597,209,388,321,88,233
154396,36,396,133,263,270,107,163,126,26,100
154448,36,119,1,118,119,1,118,,,
154457,36,9,0,9,9,0,9,,,
154466,36,37,3,34,37,3,34,,,
154493,36,1870,707,1163,949,362,587,921,345,576
154518,36,1663,1013,650,1121,627,494,542,386,156
154527,36,1066,495,571,1033,472,561,33,23,10
154545,36,38,30,8,38,30,8,,,
154572,36,1632,499,1133,757,315,442,875,184,691
154590,36,812,399,413,757,376,381,55,23,32
154642,36,787,275,512,409,177,232,378,98,280
154688,36,897,381,516,690,311,379,207,70,137
154697,36,1307,482,825,638,250,388,669,232,437
154712,36,1404,681,723,1389,672,717,15,9,6
154721,36,376,197,179,375,196,179,1,1,0
154749,36,300,172,128,293,166,127,7,6,1
154800,36,4169,1467,2702,1589,602,987,2580,865,1715
154855,36,337,142,195,316,131,185,21,11,10
154907,36,458,155,303,279,112,167,179,43,136
154925,36,443,225,218,366,188,178,77,37,40
154934,36,485,113,372,286,96,190,199,17,182
154952,36,1023,383,640,595,270,325,428,113,315
154998,36,587,236,351,321,158,163,266,78,188
155007,36,233,69,164,111,40,71,122,29,93
155025,36,2107,738,1369,1931,683,1248,176,55,121
155052,36,151,75,76,100,48,52,51,27,24
155061,36,8903,3484,5419,3423,1367,2056,5480,2117,3363
155070,36,108,51,57,90,45,45,18,6,12
155089,36,595,266,329,488,221,267,107,45,62
155098,36,317,127,190,216,94,122,101,33,68
155104,36,787,310,477,475,215,260,312,95,217
155140,36,465,165,300,413,146,267,52,19,33
155159,36,54,0,54,54,0,54,,,
155177,36,172,62,110,158,56,102,14,6,8
155186,36,635,267,368,332,148,184,303,119,184
155195,36,1863,672,1191,886,376,510,977,296,681
155201,36,244,131,113,196,113,83,48,18,30
155210,36,7544,3316,4228,2572,1201,1371,4972,2115,2857
155283,36,522,46,476,497,45,452,25,1,24
155292,36,2646,1003,1643,944,396,548,1702,607,1095
155308,36,77,59,18,74,58,16,3,1,2
155317,36,13139,6258,6881,11534,5513,6021,1605,745,860
155335,36,578,204,374,542,183,359,36,21,15
155353,36,16,13,3,16,13,3,,,
155399,36,11382,5802,5580,10139,5218,4921,1243,584,659
155414,36,445,258,187,407,234,173,38,24,14
155423,36,988,580,408,758,496,262,230,84,146
155450,36,1067,390,677,297,88,209,770,302,468
155487,36,167,73,94,118,56,62,49,17,32
155496,36,101,56,45,75,44,31,26,12,14
155511,36,502,344,158,488,333,155,14,11,3
155520,36,600,265,335,529,241,288,71,24,47
155566,36,442,128,314,246,93,153,196,35,161
155593,36,156,90,66,133,79,54,23,11,12
155618,36,146,93,53,119,88,31,27,5,22
155627,36,491,293,198,454,261,193,37,32,5
155636,36,213,40,173,72,16,56,141,24,117
155681,36,3073,1545,1528,2839,1454,1385,234,91,143
155715,36,243,138,105,176,99,77,67,39,28
155812,36,440,213,227,407,199,208,33,14,19
155830,36,112,39,73,74,28,46,38,11,27
155858,36,542,184,358,299,119,180,243,65,178
155900,36,787,503,284,388,226,162,399,277,122
155937,36,349,195,154,295,167,128,54,28,26
155973,36,327,196,131,311,186,125,16,10,6
156082,36,2805,1072,1733,2114,814,1300,691,258,433
156107,36,1517,765,752,712,414,298,805,351,454
156125,36,7567,3423,4144,5882,2642,3240,1685,781,904
156134,36,760,447,313,760,447,313,,,
156189,36,389,190,199,356,175,181,33,15,18
156213,36,993,410,583,814,340,474,179,70,109
156231,36,1131,432,699,678,305,373,453,127,326
156277,36,26,2,24,26,2,24,,,
156286,36,1595,609,986,1553,588,965,42,21,21
156295,36,1076,439,637,1054,431,623,22,8,14
156310,36,237,4,233,212,4,208,25,0,25
156338,36,1952,737,1215,916,401,515,1036,336,700
156356,36,534,189,345,453,174,279,81,15,66
156365,36,1704,638,1066,1500,582,918,204,56,148
156392,36,5280,1972,3308,2217,947,1270,3063,1025,2038
156408,36,926,454,472,926,454,472,,,
156417,36,78,64,14,50,40,10,28,24,4
156426,36,165,11,154,105,8,97,60,3,57
156471,36,1554,145,1409,749,63,686,805,82,723
156541,36,3093,1056,2037,2540,892,1648,553,164,389
156620,36,7572,3136,4436,6231,2502,3729,1341,634,707
156648,36,2510,966,1544,1024,420,604,1486,546,940
156745,36,698,318,380,694,315,379,4,3,1
156754,36,42,1,41,42,1,41,,,
156790,36,1072,346,726,546,195,351,526,151,375
156842,36,160,8,152,110,5,105,50,3,47
156851,36,617,122,495,225,48,177,392,74,318
156860,36,936,230,706,356,81,275,580,149,431
156921,36,4952,1946,3006,1568,667,901,3384,1279,2105
156967,36,80,0,80,80,0,80,,,
157021,36,141,11,130,13,2,11,128,9,119
157030,36,49,30,19,35,18,17,14,12,2
157058,36,1065,439,626,846,355,491,219,84,135
157076,36,497,243,254,478,235,243,19,8,11
157085,36,15721,6810,8911,14441,6193,8248,1280,617,663
157100,36,283,180,103,280,179,101,3,1,2
157216,36,1139,437,702,1070,409,661,69,28,41
157289,36,10262,4763,5499,8344,3832,4512,1918,931,987
157304,36,1234,368,866,489,134,355,745,234,511
157331,36,1388,382,1006,577,216,361,811,166,645
157377,36,808,260,548,646,226,420,162,34,128
157386,36,3727,1454,2273,3202,1276,1926,525,178,347
157401,36,4665,1786,2879,4084,1575,2509,581,211,370
157438,36,1689,700,989,531,267,264,1158,433,725
157447,36,6603,2683,3920,5331,2158,3173,1272,525,747
157483,36,1995,583,1412,895,315,580,1100,268,832
157535,36,679,311,368,654,297,357,25,14,11
157553,36,1211,451,760,768,319,449,443,132,311
157614,36,67,0,67,33,0,33,34,0,34
157650,36,69,4,65,45,2,43,24,2,22
157669,36,65,1,64,65,1,64,,,
157678,36,62,1,61,62,1,61,,,
157711,36,2345,745,1600,1125,445,680,1220,300,920
157739,36,1012,304,708,568,170,398,444,134,310
157748,36,659,354,305,475,240,235,184,114,70
157757,36,497,137,360,414,122,292,83,15,68
157793,36,1810,586,1224,1021,330,691,789,256,533
157809,36,1003,470,533,883,426,457,120,44,76
157818,36,664,265,399,655,261,394,9,4,5
157863,36,563,289,274,530,278,252,33,11,22
157951,36,8884,3448,5436,7706,2986,4720,1178,462,716
158088,36,799,388,411,533,234,299,266,154,112
158246,36,107,40,67,107,40,67,,,
158325,36,110,14,96,110,14,96,,,
158343,36,24,11,13,13,5,8,11,6,5
158431,36,3399,940,2459,1552,478,1074,1847,462,1385
158477,36,357,141,216,351,137,214,6,4,2
158538,36,56,1,55,56,1,55,,,
158617,36,178,67,111,178,67,111,,,
158662,36,8375,2232,6143,2468,769,1699,5907,1463,4444
158778,36,35,3,32,35,3,32,,,
158787,36,45,2,43,45,2,43,,,
158802,36,827,193,634,755,172,583,72,21,51
158884,36,958,298,660,397,128,269,561,170,391
159009,36,3427,1233,2194,2932,1067,1865,495,166,329
159027,36,12,0,12,12,0,12,,,
159197,36,419,361,58,419,361,58,,,
159328,36,82,1,81,82,1,81,,,
159373,36,677,92,585,582,75,507,95,17,78
159382,36,2286,599,1687,1374,383,991,912,216,696
159391,36,18487,8668,9819,17327,8058,9269,1160,610,550
159407,36,1537,355,1182,797,212,585,740,143,597
159416,36,1577,591,986,1169,445,724,408,146,262
159513,36,166,6,160,166,6,160,,,
159522,36,134,7,127,134,7,127,,,
159531,36,28,0,28,28,0,28,,,
159568,36,551,282,269,523,270,253,28,12,16
159601,36,14,1,13,14,1,13,,,
159647,36,5692,3139,2553,5251,2936,2315,441,203,238
159656,36,2162,743,1419,1993,676,1317,169,67,102
159717,36,3941,1464,2477,3426,1268,2158,515,196,319
159939,36,4008,1986,2022,3069,1503,1566,939,483,456
159948,36,701,442,259,155,94,61,546,348,198
159966,36,3979,1394,2585,3417,1195,2222,562,199,363
159993,36,3914,1274,2640,2963,1028,1935,951,246,705
160010,36,438,277,161,137,113,24,301,164,137
160038,36,5756,1507,4249,3966,1168,2798,1790,339,1451
160065,36,388,55,333,236,38,198,152,17,135
160074,36,662,96,566,331,55,276,331,41,290
160117,36,199,1,198,199,1,198,,,
160126,36,33,0,33,7,0,7,26,0,26
160199,36,32,0,32,32,0,32,,,
160320,36,2362,82,2280,2362,82,2280,,,
160409,36,65,65,0,63,63,0,2,2,0
160472,36,77,2,75,52,2,50,25,0,25
160481,36,1033,269,764,471,146,325,562,123,439
160524,36,159,44,115,159,44,115,,,
160579,36,1758,785,973,877,425,452,881,360,521
160597,36,124,40,84,64,19,45,60,21,39
160612,36,7326,2604,4722,6300,2239,4061,1026,365,661
160621,36,3890,1270,2620,3232,1082,2150,658,188,470
160630,36,1064,241,823,747,178,569,317,63,254
160649,36,1129,257,872,607,184,423,522,73,449
160658,36,9179,3955,5224,7642,3367,4275,1537,588,949
160667,36,1131,519,612,717,323,394,414,196,218
160755,36,6400,2536,3864,6020,2386,3634,380,150,230
160904,36,1687,393,1294,1605,362,1243,82,31,51
160959,36,253,79,174,242,77,165,11,2,9
160977,36,1265,629,636,1265,629,636,,,
160995,36,255,36,219,255,36,219,,,
161004,36,1429,697,732,1429,697,732,,,
161022,36,124,13,111,81,9,72,43,4,39
161077,36,1200,443,757,397,192,205,803,251,552
161086,36,1590,758,832,1590,758,832,,,
161138,36,803,326,477,353,149,204,450,177,273
161192,36,806,221,585,212,65,147,594,156,438
161208,36,9,9,0,9,9,0,,,
161217,36,2208,608,1600,938,257,681,1270,351,919
161226,36,969,314,655,886,284,602,83,30,53
161235,36,662,164,498,337,101,236,325,63,262
161253,36,6466,3366,3100,5532,2830,2702,934,536,398
161299,36,640,527,113,604,495,109,36,32,4
161341,36,656,207,449,479,164,315,177,43,134
161457,36,1512,467,1045,1477,451,1026,35,16,19
161484,36,264,107,157,129,60,69,135,47,88
161493,36,91,1,90,67,0,67,24,1,23
161509,36,266,66,200,251,62,189,15,4,11
161518,36,811,271,540,532,188,344,279,83,196
161527,36,89,8,81,60,2,58,29,6,23
161545,36,2780,1193,1587,973,482,491,1807,711,1096
161554,36,3231,1327,1904,2257,913,1344,974,414,560
161563,36,461,234,227,446,229,217,15,5,10
161572,36,1139,317,822,1138,317,821,1,0,1
161581,36,129,42,87,78,35,43,51,7,44
161688,36,1093,238,855,414,125,289,679,113,566
161767,36,6476,2368,4108,1594,718,876,4882,1650,3232
161800,36,65,31,34,25,10,15,40,21,19
161855,36,18,1,17,15,1,14,3,0,3
161864,36,2363,531,1832,531,154,377,1832,377,1455
161873,36,1260,518,742,650,266,384,610,252,358
162007,36,3876,1510,2366,3064,1171,1893,812,339,473
162061,36,249,201,48,201,161,40,48,40,8
162104,36,944,305,639,259,108,151,685,197,488
162122,36,3555,1227,2328,1199,502,697,2356,725,1631
162168,36,912,261,651,185,71,114,727,190,537
162210,36,481,156,325,381,123,258,100,33,67
162283,36,1434,298,1136,1042,224,818,392,74,318
162335,36,45,0,45,45,0,45,,,
162371,36,480,432,48,480,432,48,,,
162557,36,2405,917,1488,688,315,373,1717,602,1115
162584,36,2376,1048,1328,1935,939,996,441,109,332
162609,36,177,94,83,99,55,44,78,39,39
162654,36,770,260,510,750,251,499,20,9,11
162690,36,1971,624,1347,572,249,323,1399,375,1024
162706,36,2672,1030,1642,862,396,466,1810,634,1176
162760,36,781,275,506,745,259,486,36,16,20
162779,36,5338,2121,3217,1500,724,776,3838,1397,2441
162830,36,101,4,97,101,4,97,,,
162928,36,4239,2016,2223,4231,2009,2222,8,7,1
163028,36,770,660,110,522,448,74,248,212,36
163046,36,2763,1166,1597,2725,1144,1581,38,22,16
163204,36,34168,18476,15692,7925,4087,3838,26243,14389,11854
163259,36,648,121,527,522,101,421,126,20,106
163268,36,7720,4243,3477,6307,3472,2835,1413,771,642
163286,36,22344,11600,10744,20524,10575,9949,1820,1025,795
163295,36,1167,291,876,1115,280,835,52,11,41
163338,36,1226,545,681,1111,499,612,115,46,69
163347,36,411,28,383,411,28,383,,,
163408,36,83,20,63,49,7,42,34,13,21
163426,36,10637,4956,5681,3155,1531,1624,7482,3425,4057
163453,36,4376,1690,2686,3718,1406,2312,658,284,374
163462,36,1411,676,735,1316,622,694,95,54,41
163532,36,186,186,0,186,186,0,,,
163541,36,255,114,141,128,65,63,127,49,78
163578,36,528,20,508,399,11,388,129,9,120
163657,36,6204,2027,4177,1751,626,1125,4453,1401,3052
163815,36,44,1,43,19,0,19,25,1,24
163851,36,4652,2087,2565,4353,1916,2437,299,171,128
163912,36,1042,423,619,1006,409,597,36,14,22
163976,36,328,173,155,325,171,154,3,2,1
164076,36,13210,5358,7852,11213,4441,6772,1997,917,1080
164155,36,3366,2409,957,3366,2409,957,,,
164173,36,2103,735,1368,1811,669,1142,292,66,226
164216,36,736,298,438,730,293,437,6,5,1
164270,36,1188,512,676,1179,507,672,9,5,4
164313,36,1365,400,965,254,109,145,1111,291,820
164368,36,441,282,159,441,282,159,,,
164447,36,847,316,531,792,299,493,55,17,38
164465,36,1438,723,715,1438,723,715,,,
164492,36,804,457,347,655,336,319,149,121,28
164535,36,31,4,27,31,4,27,,,
164562,36,1420,622,798,1403,612,791,17,10,7
164580,36,1834,1067,767,1822,1060,762,12,7,5
164599,36,30,7,23,,,,30,7,23
164614,36,36,25,11,28,19,9,8,6,2
164632,36,914,0,914,698,0,698,216,0,216
164641,36,244,87,157,117,59,58,127,28,99
164739,36,2844,1717,1127,2758,1660,1098,86,57,29
164748,36,4975,2917,2058,3589,2012,1577,1386,905,481
164775,36,693,192,501,154,58,96,539,134,405
164845,36,51,2,49,39,1,38,12,1,11
164872,36,222,105,117,164,87,77,58,18,40
164924,36,7162,3366,3796,7036,3301,3735,126,65,61
164988,36,12688,5285,7403,12388,5138,7250,300,147,153
165015,36,2592,1046,1546,2582,1043,1539,10,3,7
165024,36,5986,2396,3590,4594,1832,2762,1392,564,828
165033,36,3777,1147,2630,1380,458,922,2397,689,1708
165060,36,167,19,148,103,14,89,64,5,59
165112,36,5910,2325,3585,1585,748,837,4325,1577,2748
165167,36,680,141,539,150,40,110,530,101,429
165194,36,1465,488,977,403,176,227,1062,312,750
165255,36,104,3,101,37,2,35,67,1,66
165264,36,833,68,765,41,5,36,792,63,729
165334,36,1556,570,986,1545,565,980,11,5,6
165529,36,1399,542,857,1202,482,720,197,60,137
165556,36,323,45,278,238,29,209,85,16,69
165574,36,834,416,418,745,374,371,89,42,47
165608,36,37,5,32,27,4,23,10,1,9
165635,36,195,182,13,195,182,13,,,
165644,36,368,190,178,333,174,159,35,16,19
165662,36,2872,1073,1799,2815,1051,1764,57,22,35
165671,36,1296,282,1014,1249,271,978,47,11,36
165699,36,2033,761,1272,1936,719,1217,97,42,55
165750,36,12,2,10,12,2,10,,,
165802,36,834,252,582,336,181,155,498,71,427
165820,36,2347,1043,1304,1774,840,934,573,203,370
165866,36,2222,962,1260,1973,853,1120,249,109,140
165884,36,154,125,29,83,63,20,71,62,9
165936,36,954,369,585,913,351,562,41,18,23
165981,36,729,261,468,188,66,122,541,195,346
166018,36,290,111,179,290,111,179,,,
166027,36,5975,2972,3003,5413,2721,2692,562,251,311
166054,36,27,18,9,27,18,9,,,
166124,36,2146,973,1173,2146,973,1173,,,
166133,36,2246,722,1524,717,296,421,1529,426,1103
166391,36,944,332,612,920,322,598,24,10,14
166407,36,152,11,141,3,0,3,149,11,138
166452,36,1251,272,979,891,200,691,360,72,288
166489,36,26,10,16,24,9,15,2,1,1
166498,36,37,3,34,16,3,13,21,0,21
166513,36,9581,5684,3897,7365,4337,3028,2216,1347,869
166629,36,17572,8725,8847,16363,8185,8178,1209,540,669
166638,36,8537,3554,4983,6771,2759,4012,1766,795,971
166647,36,1812,810,1002,572,293,279,1240,517,723
166656,36,2460,622,1838,2335,585,1750,125,37,88
166674,36,1247,328,919,1090,288,802,157,40,117
166683,36,3432,1783,1649,3383,1750,1633,49,33,16
166692,36,1080,937,143,1047,907,140,33,30,3
166717,36,21,5,16,7,1,6,14,4,10
166805,36,44,33,11,24,19,5,20,14,6
166823,36,2971,1092,1879,1027,462,565,1944,630,1314
166850,36,2948,1392,1556,2883,1358,1525,65,34,31
166869,36,190,20,170,190,20,170,,,
166887,36,3433,1250,2183,976,438,538,2457,812,1645
166911,36,248,59,189,243,58,185,5,1,4
166939,36,1552,0,1552,1536,0,1536,16,0,16
166957,36,1832,521,1311,441,165,276,1391,356,1035
167039,36,6,0,6,6,0,6,,,
167057,36,305,170,135,297,164,133,8,6,2
167260,36,824,524,300,741,491,250,83,33,50
167288,36,628,240,388,553,215,338,75,25,50
167297,36,126,79,47,126,79,47,,,
167312,36,2899,969,1930,838,344,494,2061,625,1436
167358,36,10769,5216,5553,10769,5216,5553,,,
167376,36,2668,873,1795,638,258,380,2030,615,1415
167394,36,639,149,490,550,131,419,89,18,71
167455,36,60,25,35,59,25,34,1,0,1
167525,36,1756,604,1152,600,240,360,1156,364,792
167534,36,4126,1430,2696,1293,514,779,2833,916,1917
167598,36,992,167,825,774,137,637,218,30,188
167631,36,861,284,577,226,100,126,635,184,451
167677,36,7,7,0,7,7,0,,,
167729,36,3718,1268,2450,3007,993,2014,711,275,436
167783,36,1244,0,1244,1160,0,1160,84,0,84
167792,36,193,67,126,191,66,125,2,1,1
167835,36,1832,2,1830,1820,1,1819,12,1,11
167871,36,99,33,66,32,4,28,67,29,38
167899,36,1503,731,772,1473,711,762,30,20,10
167905,36,2509,921,1588,848,343,505,1661,578,1083
167987,36,3938,1901,2037,3344,1644,1700,594,257,337
167996,36,1697,715,982,1684,703,981,13,12,1
168005,36,2941,1242,1699,2790,1155,1635,151,87,64
168032,36,4,0,4,4,0,4,,,
168148,36,4789,2159,2630,4660,2095,2565,129,64,65
168218,36,1771,0,1771,1763,0,1763,8,0,8
168227,36,2861,2238,623,2643,2059,584,218,179,39
168254,36,1707,999,708,1643,967,676,64,32,32
168263,36,2875,1308,1567,2466,1126,1340,409,182,227
168281,36,1188,463,725,1187,462,725,1,1,0
168342,36,1548,766,782,1548,766,782,,,
168421,36,3645,2239,1406,3521,2142,1379,124,97,27
168430,36,3135,1194,1941,2515,945,1570,620,249,371
168528,36,1121,558,563,1101,546,555,20,12,8
168546,36,1008,484,524,995,476,519,13,8,5
168555,36,4,0,4,3,0,3,1,0,1
168573,36,590,574,16,590,574,16,,,
168591,36,959,396,563,947,388,559,12,8,4
168607,36,458,209,249,194,106,88,264,103,161
168740,36,960,460,500,850,394,456,110,66,44
168786,36,877,373,504,784,347,437,93,26,67
168847,36,3121,805,2316,1217,302,915,1904,503,1401
168883,36,796,248,548,333,121,212,463,127,336
168892,36,59,4,55,22,2,20,37,2,35
169080,36,2142,1003,1139,2003,906,1097,139,97,42
169187,36,121,23,98,30,10,20,91,13,78
169248,36,8638,3401,5237,7316,2906,4410,1322,495,827
169275,36,3484,1108,2376,942,300,642,2542,808,1734
169284,36,141,7,134,103,5,98,38,2,36
169327,36,331,186,145,252,149,103,79,37,42
169363,36,577,283,294,550,273,277,27,10,17
169442,36,1040,418,622,855,329,526,185,89,96
169479,36,2974,1322,1652,1618,830,788,1356,492,864
169503,36,238,7,231,238,7,231,,,
169521,36,4559,1575,2984,1177,444,733,3382,1131,2251
169576,36,90,3,87,90,3,87,,,
169655,36,953,892,61,953,892,61,,,
169716,36,1641,586,1055,1483,541,942,158,45,113
169761,36,269,9,260,269,9,260,,,
169798,36,9090,3564,5526,6073,2384,3689,3017,1180,1837
169813,36,32,1,31,32,1,31,,,
169910,36,6443,3056,3387,4624,2255,2369,1819,801,1018
169974,36,415,168,247,162,59,103,253,109,144
169983,36,1169,921,248,1121,883,238,48,38,10
169992,36,341,103,238,158,64,94,183,39,144
170000,36,615,263,352,452,193,259,163,70,93
170037,36,1000,374,626,705,271,434,295,103,192
170055,36,6790,2875,3915,1825,821,1004,4965,2054,2911
170082,36,14229,5578,8651,12166,4632,7534,2063,946,1117
170091,36,108,62,46,83,47,36,25,15,10
170240,36,6633,2669,3964,2022,826,1196,4611,1843,2768
170286,36,1076,564,512,1053,551,502,23,13,10
170301,36,2170,826,1344,2092,796,1296,78,30,48
170444,36,2217,675,1542,536,177,359,1681,498,1183
170532,36,834,358,476,827,355,472,7,3,4
170541,36,3973,1687,2286,960,428,532,3013,1259,1754
170550,36,1853,457,1396,423,148,275,1430,309,1121
170587,36,691,185,506,297,85,212,394,100,294
170611,36,60,1,59,59,1,58,1,0,1
170620,36,1418,465,953,319,115,204,1099,350,749
170639,36,1077,481,596,929,417,512,148,64,84
170657,36,6368,2690,3678,1694,757,937,4674,1933,2741
170675,36,1339,946,393,1146,801,345,193,145,48
170736,36,13,0,13,3,0,3,10,0,10
170790,36,11498,4744,6754,2955,1267,1688,8543,3477,5066
170806,36,1390,448,942,1038,341,697,352,107,245
170967,36,576,223,353,430,188,242,146,35,111
170976,36,23366,11623,11743,22064,10863,11201,1302,760,542
171012,36,128,102,26,128,102,26,,,
171100,36,27923,13662,14261,24803,11933,12870,3120,1729,1391
171128,36,4071,2878,1193,3853,2714,1139,218,164,54
171137,36,4627,2532,2095,3372,1844,1528,1255,688,567
171146,36,3404,1214,2190,2188,807,1381,1216,407,809
171155,36,1508,487,1021,554,223,331,954,264,690
171225,36,1211,431,780,301,104,197,910,327,583
171234,36,765,267,498,209,64,145,556,203,353
171304,36,1908,698,1210,548,225,323,1360,473,887
171395,36,692,194,498,276,83,193,416,111,305
171456,36,4474,1867,2607,3971,1641,2330,503,226,277
171483,36,1940,918,1022,639,339,300,1301,579,722
171492,36,1462,860,602,872,551,321,590,309,281
171535,36,6319,2700,3619,1362,656,706,4957,2044,2913
171571,36,10177,4376,5801,7868,3250,4618,2309,1126,1183
171599,36,491,268,223,474,257,217,17,11,6
171775,36,37,0,37,21,0,21,16,0,16
171881,36,72,23,49,54,15,39,18,8,10
171988,36,55,2,53,55,2,53,,,
171997,36,67,2,65,67,2,65,,,
172015,36,58,2,56,58,2,56,,,
172033,36,131,87,44,37,36,1,94,51,43
172051,36,4852,1761,3091,4020,1401,2619,832,360,472
172200,36,4906,2003,2903,1066,479,587,3840,1524,2316
172264,36,1196,496,700,774,362,412,422,134,288
172291,36,1498,462,1036,580,187,393,918,275,643
172307,36,773,249,524,313,122,191,460,127,333
172334,36,804,244,560,663,213,450,141,31,110
172422,36,81,66,15,81,66,15,,,
172440,36,226,125,101,213,119,94,13,6,7
172495,36,231,6,225,177,6,171,54,0,54
172608,36,493,261,232,40,28,12,453,233,220
172617,36,6428,2644,3784,1453,658,795,4975,1986,2989
172635,36,7277,2132,5145,777,299,478,6500,1833,4667
172644,36,12297,5053,7244,9190,3598,5592,3107,1455,1652
172671,36,484,148,336,89,31,58,395,117,278
172680,36,89,4,85,54,3,51,35,1,34
172699,36,11080,5616,5464,9134,4583,4551,1946,1033,913
172866,36,53,49,4,53,49,4,,,
172918,36,676,296,380,417,214,203,259,82,177
172954,36,844,355,489,429,221,208,415,134,281
172963,36,2764,938,1826,952,358,594,1812,580,1232
173045,36,1643,715,928,1431,638,793,212,77,135
173063,36,1326,620,706,454,220,234,872,400,472
173115,36,326,83,243,112,61,51,214,22,192
173124,36,2509,1074,1435,1714,781,933,795,293,502
173142,36,430,204,226,418,198,220,12,6,6
173160,36,1697,647,1050,1401,543,858,296,104,192
173203,36,933,392,541,393,202,191,540,190,350
173258,36,1441,705,736,1441,705,736,,,
173300,36,1342,583,759,1313,565,748,29,18,11
173328,36,1985,707,1278,1294,466,828,691,241,450
173416,36,1128,593,535,636,386,250,492,207,285
173452,36,562,277,285,490,250,240,72,27,45
173461,36,1758,715,1043,708,345,363,1050,370,680
173470,36,23,0,23,23,0,23,,,
173559,36,2016,695,1321,899,385,514,1117,310,807
173638,36,1091,565,526,361,155,206,730,410,320
173647,36,1666,708,958,1639,690,949,27,18,9
173665,36,1215,451,764,1167,431,736,48,20,28
173708,36,1882,1180,702,715,498,217,1167,682,485
173735,36,323,112,211,120,86,34,203,26,177
173744,36,537,31,506,537,31,506,,,
173799,36,1598,579,1019,558,216,342,1040,363,677
173805,36,289,156,133,179,117,62,110,39,71
173902,36,1630,695,935,1596,677,919,34,18,16
173911,36,1255,494,761,524,241,283,731,253,478
173920,36,8307,3909,4398,7044,3374,3670,1263,535,728
173957,36,68,18,50,68,18,50,,,
173993,36,315,143,172,228,115,113,87,28,59
174020,36,4270,1770,2500,1885,803,1082,2385,967,1418
174066,36,21951,10332,11619,19984,9305,10679,1967,1027,940
174075,36,1216,526,690,716,301,415,500,225,275
174127,36,465,149,316,460,146,314,5,3,2
174136,36,3286,1273,2013,979,455,524,2307,818,1489
174154,36,568,62,506,240,31,209,328,31,297
174190,36,129,14,115,84,5,79,45,9,36
174233,36,5641,2948,2693,5213,2710,2503,428,238,190
174251,36,850,347,503,779,316,463,71,31,40
174321,36,104,4,100,104,4,100,,,
174358,36,2796,1067,1729,2222,839,1383,574,228,346
174376,36,2500,948,1552,659,275,384,1841,673,1168
174428,36,3987,1722,2265,1346,646,700,2641,1076,1565
174437,36,633,288,345,550,244,306,83,44,39
174473,36,1188,488,700,521,188,333,667,300,367
174491,36,1083,444,639,955,393,562,128,51,77
174507,36,177,52,125,37,10,27,140,42,98
174525,36,54,36,18,37,24,13,17,12,5
174570,36,329,124,205,164,61,103,165,63,102
174604,36,55,27,28,37,22,15,18,5,13
174738,36,2227,771,1456,756,359,397,1471,412,1059
174747,36,1122,0,1122,1118,0,1118,4,0,4
174756,36,1996,747,1249,897,398,499,1099,349,750
174783,36,4585,2251,2334,3462,1673,1789,1123,578,545
174792,36,1096,1096,0,1077,1077,0,19,19,0
174817,36,912,387,525,711,312,399,201,75,126
174844,36,2162,914,1248,2155,911,1244,7,3,4
174862,36,501,224,277,356,169,187,145,55,90
174899,36,1456,439,1017,1218,382,836,238,57,181
174914,36,4516,2366,2150,4333,2261,2072,183,105,78
174978,36,83,2,81,62,1,61,21,1,20
175005,36,1938,83,1855,1314,25,1289,624,58,566
175014,36,2697,402,2295,1339,205,1134,1358,197,1161
175041,36,2481,1094,1387,917,438,479,1564,656,908
175078,36,1283,490,793,918,388,530,365,102,263
175120,36,118,74,44,118,74,44,,,
175157,36,182,116,66,165,105,60,17,11,6
175227,36,850,697,153,653,549,104,197,148,49
175236,36,1318,459,859,707,298,409,611,161,450
175263,36,616,257,359,301,138,163,315,119,196
175272,36,4142,1377,2765,3552,1152,2400,590,225,365
175315,36,4099,1640,2459,1467,633,834,2632,1007,1625
175342,36,1863,647,1216,1573,563,1010,290,84,206
175421,36,1189,397,792,769,297,472,420,100,320
175430,36,375,167,208,349,164,185,26,3,23
175494,36,38,7,31,38,7,31,,,
175519,36,859,316,543,707,269,438,152,47,105
175573,36,1219,454,765,970,369,601,249,85,164
175616,36,1163,455,708,972,382,590,191,73,118
175643,36,851,297,554,705,265,440,146,32,114
175652,36,1594,672,922,1164,523,641,430,149,281
175698,36,5,3,2,3,2,1,2,1,1
175722,36,29,0,29,29,0,29,,,
175786,36,5816,2006,3810,3790,1448,2342,2026,558,1468
175810,36,2232,629,1603,1542,464,1078,690,165,525
175829,36,2311,852,1459,1562,607,955,749,245,504
175856,36,3459,1198,2261,2838,991,1847,621,207,414
175883,36,2291,830,1461,1753,654,1099,538,176,362
175935,36,895,265,630,667,224,443,228,41,187
175980,36,442,202,240,437,200,237,5,2,3
176008,36,728,261,467,629,239,390,99,22,77
176017,36,11056,4671,6385,10185,4222,5963,871,449,422
176035,36,1123,230,893,961,206,755,162,24,138
176044,36,978,400,578,824,346,478,154,54,100
176053,36,1577,619,958,1436,570,866,141,49,92
176062,36,63,0,63,63,0,63,,,
176071,36,4299,1532,2767,2586,1042,1544,1713,490,1223
176080,36,13072,6563,6509,11591,5706,5885,1481,857,624
176169,36,1571,545,1026,1307,469,838,264,76,188
176178,36,3687,1279,2408,2614,933,1681,1073,346,727
176239,36,2004,775,1229,1736,680,1056,268,95,173
176318,36,332,119,213,270,90,180,62,29,33
176336,36,58,41,17,54,37,17,4,4,0
176354,36,819,264,555,681,241,440,138,23,115
176372,36,7627,2748,4879,6225,2121,4104,1402,627,775
176406,36,416,144,272,381,128,253,35,16,19
176433,36,52,1,51,32,1,31,20,0,20
176479,36,1474,392,1082,1283,355,928,191,37,154
176628,36,680,244,436,599,224,375,81,20,61
176664,36,149,81,68,122,66,56,27,15,12
176716,36,103,1,102,93,1,92,10,0,10
176770,36,531,70,461,271,42,229,260,28,232
176789,36,165,78,87,114,50,64,51,28,23
176798,36,164,45,119,105,30,75,59,15,44
176910,36,96,52,44,55,31,24,41,21,20
176947,36,716,331,385,710,328,382,6,3,3
176965,36,4534,2066,2468,3875,1751,2124,659,315,344
176983,36,5,4,1,3,3,0,2,1,1
177038,36,65,19,46,47,12,35,18,7,11
177065,36,4724,1851,2873,1988,712,1276,2736,1139,1597
177083,36,19,19,0,19,19,0,,,
177117,36,163,0,163,162,0,162,1,0,1
177135,36,1669,539,1130,868,330,538,801,209,592
177144,36,545,304,241,509,289,220,36,15,21
177214,36,948,428,520,923,419,504,25,9,16
177250,36,1037,362,675,497,190,307,540,172,368
177302,36,335,264,71,335,264,71,,,
177339,36,1182,517,665,1016,432,584,166,85,81
177418,36,496,172,324,439,164,275,57,8,49
177436,36,32,4,28,32,4,28,,,
177472,36,5228,2009,3219,2514,993,1521,2714,1016,1698
177542,36,349,167,182,298,140,158,51,27,24
177551,36,918,266,652,729,217,512,189,49,140
177588,36,40,3,37,40,3,37,,,
177603,36,63,0,63,62,0,62,1,0,1
177676,36,1513,506,1007,714,269,445,799,237,562
177685,36,131,9,122,131,9,122,,,
177719,36,377,45,332,321,40,281,56,5,51
177746,36,468,128,340,457,125,332,11,3,8
177870,36,2,2,0,2,2,0,,,
177931,36,21,1,20,21,1,20,,,
177940,36,914,344,570,748,301,447,166,43,123
177968,36,3386,1477,1909,2829,1246,1583,557,231,326
177977,36,734,622,112,646,551,95,88,71,17
177986,36,203,56,147,98,22,76,105,34,71
177995,36,7381,2671,4710,2821,1142,1679,4560,1529,3031
178004,36,16,0,16,,,,16,0,16
178059,36,4067,1262,2805,2394,842,1552,1673,420,1253
178077,36,48,2,46,47,2,45,1,0,1
178183,36,155,13,142,155,13,142,,,
178208,36,543,367,176,270,206,64,273,161,112
178217,36,924,298,626,632,204,428,292,94,198
178244,36,990,435,555,837,383,454,153,52,101
178341,36,2676,1024,1652,1946,715,1231,730,309,421
178369,36,757,414,343,730,402,328,27,12,15
178387,36,2192,854,1338,1820,694,1126,372,160,212
178396,36,16901,7813,9088,15843,7311,8532,1058,502,556
178402,36,4615,1939,2676,3799,1556,2243,816,383,433
178411,36,4246,3295,951,3682,2846,836,564,449,115
178420,36,4377,1968,2409,2991,1297,1694,1386,671,715
178448,36,1876,650,1226,985,366,619,891,284,607
178527,36,14,2,12,8,1,7,6,1,5
178615,36,2556,1010,1546,2432,961,1471,124,49,75
178624,36,3491,1473,2018,3183,1337,1846,308,136,172
178679,36,398,211,187,309,173,136,89,38,51
178697,36,1146,492,654,1130,487,643,16,5,11
178721,36,6104,3312,2792,2686,1265,1421,3418,2047,1371
178767,36,84,11,73,36,6,30,48,5,43
178828,36,13,0,13,13,0,13,,,
178891,36,982,894,88,666,607,59,316,287,29
178989,36,259,37,222,259,37,222,,,
179043,36,1381,475,906,1257,454,803,124,21,103
179052,36,26,4,22,26,4,22,,,
179159,36,5048,1943,3105,4573,1703,2870,475,240,235
179195,36,25,0,25,25,0,25,,,
179229,36,19,4,15,19,4,15,,,
179256,36,46,23,23,36,18,18,10,5,5
179265,36,163,62,101,161,61,100,2,1,1
179308,36,8589,2737,5852,2683,1058,1625,5906,1679,4227
179326,36,1262,444,818,970,379,591,292,65,227
179344,36,563,142,421,342,82,260,221,60,161
179511,36,55,1,54,32,1,31,23,0,23
179539,36,1542,499,1043,928,295,633,614,204,410
179548,36,266,0,266,230,0,230,36,0,36
179557,36,5308,2106,3202,4588,1783,2805,720,323,397
179566,36,10340,4220,6120,8447,3332,5115,1893,888,1005
179645,36,1319,328,991,818,217,601,501,111,390
179715,36,588,121,467,302,79,223,286,42,244
179867,36,5543,2634,2909,5244,2524,2720,299,110,189
179894,36,1722,780,942,1351,589,762,371,191,180
179946,36,422,235,187,411,229,182,11,6,5
179955,36,514,253,261,505,250,255,9,3,6
179964,36,503,131,372,419,113,306,84,18,66
179991,36,16,0,16,16,0,16,,,
180054,36,251,76,175,176,57,119,75,19,56
180063,36,4,0,4,4,0,4,,,
180081,36,175,104,71,139,87,52,36,17,19
180090,36,36,0,36,36,0,36,,,
180106,36,765,295,470,745,284,461,20,11,9
180151,36,148,74,74,104,58,46,44,16,28
180160,36,118,39,79,48,18,30,70,21,49
180179,36,1951,653,1298,1235,471,764,716,182,534
180197,36,747,287,460,364,165,199,383,122,261
180203,36,79,33,46,64,26,38,15,7,8
180212,36,372,107,265,259,82,177,113,25,88
180249,36,510,117,393,257,68,189,253,49,204
180258,36,418,159,259,341,139,202,77,20,57
180276,36,378,142,236,150,73,77,228,69,159
180328,36,203,58,145,124,33,91,79,25,54
180373,36,207,59,148,127,41,86,80,18,62
180416,36,1073,659,414,1000,609,391,73,50,23
180461,36,9746,5216,4530,8369,4451,3918,1377,765,612
180489,36,4838,2053,2785,3836,1649,2187,1002,404,598
180522,36,556,294,262,451,256,195,105,38,67
180595,36,551,293,258,536,285,251,15,8,7
180647,36,447,130,317,362,110,252,85,20,65
180692,36,925,316,609,711,263,448,214,53,161
180717,36,21,13,8,18,12,6,3,1,2
180814,36,6262,2807,3455,4628,2040,2588,1634,767,867
180832,36,415,42,373,186,17,169,229,25,204
180878,36,453,33,420,310,22,288,143,11,132
180902,36,2408,809,1599,895,416,479,1513,393,1120
180948,36,1090,437,653,924,374,550,166,63,103
180957,36,42,34,8,42,34,8,,,
180984,36,832,401,431,818,390,428,14,11,3
181002,36,3152,1285,1867,3071,1250,1821,81,35,46
181020,36,805,425,380,680,372,308,125,53,72
181127,36,598,276,322,593,273,320,5,3,2
181145,36,7,1,6,7,1,6,,,
181190,36,102,3,99,102,3,99,,,
181215,36,2984,1124,1860,2556,983,1573,428,141,287
181297,36,580,53,527,368,34,334,212,19,193
181303,36,4859,2179,2680,1491,701,790,3368,1478,1890
181312,36,576,194,382,315,138,177,261,56,205
181330,36,753,382,371,739,378,361,14,4,10
181394,36,8661,3932,4729,6908,3023,3885,1753,909,844
181419,36,163,36,127,42,9,33,121,27,94
181428,36,546,61,485,425,49,376,121,12,109
181446,36,1209,506,703,1114,471,643,95,35,60
181464,36,14027,7243,6784,13084,6688,6396,943,555,388
181491,36,1372,566,806,842,424,418,530,142,388
181534,36,962,337,625,744,279,465,218,58,160
181543,36,16,10,6,8,7,1,8,3,5
181604,36,434,0,434,419,0,419,15,0,15
181640,36,3804,1769,2035,1772,945,827,2032,824,1208
181738,36,417,183,234,398,177,221,19,6,13
181765,36,120,40,80,107,36,71,13,4,9
181783,36,2065,857,1208,1876,782,1094,189,75,114
181817,36,572,183,389,328,121,207,244,62,182
181853,36,288,148,140,270,148,122,18,0,18
181880,36,152,9,143,152,9,143,,,
181941,36,244,139,105,244,139,105,,,
182005,36,21206,8355,12851,5458,2278,3180,15748,6077,9671
182148,36,503,111,392,503,111,392,,,
182281,36,18616,8045,10571,14047,5917,8130,4569,2128,2441
182290,36,11766,5584,6182,9812,4607,5205,1954,977,977
182306,36,1576,510,1066,624,228,396,952,282,670
182458,36,164,80,84,150,78,72,14,2,12
182500,36,4509,1806,2703,1390,583,807,3119,1223,1896
182564,36,1378,524,854,425,174,251,953,350,603
182634,36,485,127,358,472,123,349,13,4,9
182670,36,3289,1683,1606,3288,1682,1606,1,1,0
182704,36,74,1,73,55,1,54,19,0,19
182722,36,147,18,129,107,17,90,40,1,39
182795,36,958,447,511,765,375,390,193,72,121
182892,36,20,0,20,13,0,13,7,0,7
182917,36,51,25,26,51,25,26,,,
182953,36,30,3,27,24,2,22,6,1,5
182980,36,965,407,558,902,383,519,63,24,39
182999,36,7,0,7,7,0,7,,,
183026,36,89705,32667,57038,28532,10789,17743,61173,21878,39295
183035,36,11,2,9,11,2,9,,,
183044,36,8229,3639,4590,8019,3518,4501,210,121,89
183062,36,2060,923,1137,2007,897,1110,53,26,27
183071,36,477,243,234,394,200,194,83,43,40
183080,36,2377,1178,1199,2267,1121,1146,110,57,53
183099,36,1462,513,949,436,194,242,1026,319,707
183105,36,263,64,199,56,20,36,207,44,163
183114,36,381,76,305,59,19,40,322,57,265
183123,36,314,134,180,85,46,39,229,88,141
183132,36,1061,451,610,284,164,120,777,287,490
183141,36,633,286,347,161,92,69,472,194,278
183150,36,837,311,526,201,103,98,636,208,428
183202,36,81,6,75,59,4,55,22,2,20
183211,36,932,172,760,569,132,437,363,40,323
183239,36,1457,561,896,1444,557,887,13,4,9
183248,36,87,15,72,42,8,34,45,7,38
183257,36,1020,306,714,463,131,332,557,175,382
183275,36,59,24,35,59,24,35,,,
183488,36,370,13,357,278,9,269,92,4,88
183600,36,21,0,21,12,0,12,9,0,9
183655,36,2953,970,1983,944,360,584,2009,610,1399
183725,36,436,191,245,361,182,179,75,9,66
183743,36,6810,3087,3723,3307,1585,1722,3503,1502,2001
183789,36,1524,363,1161,972,262,710,552,101,451
183804,36,2635,2635,0,2615,2615,0,20,20,0
183822,36,924,342,582,860,319,541,64,23,41
183859,36,5912,2703,3209,2604,1313,1291,3308,1390,1918
183877,36,4169,1554,2615,1744,742,1002,2425,812,1613
183910,36,1195,419,776,1147,407,740,48,12,36
183938,36,4775,1658,3117,1930,731,1199,2845,927,1918
183974,36,782,282,500,701,245,456,81,37,44
183983,36,22,20,2,22,20,2,,,
184056,36,487,103,384,285,73,212,202,30,172
184092,36,570,41,529,570,41,529,,,
184180,36,3808,1954,1854,1470,825,645,2338,1129,1209
184205,36,1344,425,919,568,197,371,776,228,548
184348,36,1078,446,632,1067,440,627,11,6,5
184427,36,209,196,13,122,118,4,87,78,9
184481,36,4219,1601,2618,1902,721,1181,2317,880,1437
184506,36,78,6,72,54,3,51,24,3,21
184603,36,1910,836,1074,1324,553,771,586,283,303
184612,36,1426,365,1061,1275,322,953,151,43,108
184694,36,1656,677,979,1578,634,944,78,43,35
184746,36,16,16,0,11,11,0,5,5,0
184773,36,954,235,719,864,213,651,90,22,68
184782,36,11120,5879,5241,9462,5069,4393,1658,810,848
184791,36,3107,1261,1846,1540,638,902,1567,623,944
184816,36,37,2,35,28,1,27,9,1,8
184959,36,423,58,365,171,20,151,252,38,214
184968,36,178,21,157,31,5,26,147,16,131
184995,36,4608,1682,2926,2162,829,1333,2446,853,1593
185129,36,3851,1619,2232,3167,1344,1823,684,275,409
185174,36,47,38,9,47,38,9,,,
185262,36,7594,2913,4681,6012,2299,3713,1582,614,968
185396,36,951,915,36,736,712,24,215,203,12
185466,36,4,0,4,2,0,2,2,0,2
185509,36,3953,1666,2287,1056,547,509,2897,1119,1778
185536,36,5632,2457,3175,2105,918,1187,3527,1539,1988
185572,36,2900,1127,1773,2756,1060,1696,144,67,77
185590,36,11329,4328,7001,9818,3666,6152,1511,662,849
185679,36,628,80,548,48,11,37,580,69,511
185721,36,228,69,159,106,40,66,122,29,93
185767,36,198,20,178,100,10,90,98,10,88
185828,36,6303,4793,1510,5490,4115,1375,813,678,135
185873,36,3964,1631,2333,1735,765,970,2229,866,1363
185970,36,132,9,123,93,7,86,39,2,37
186016,36,422,23,399,246,14,232,176,9,167
186034,36,4002,1433,2569,1295,553,742,2707,880,1827
186052,36,552,468,84,312,274,38,240,194,46
186131,36,3935,2000,1935,3935,2000,1935,,,
186186,36,101,101,0,101,101,0,,,
186201,36,3603,1532,2071,3241,1371,1870,362,161,201
186274,36,182,19,163,99,12,87,83,7,76
186283,36,2343,987,1356,2181,916,1265,162,71,91
186371,36,3518,1317,2201,2934,1078,1856,584,239,345
186380,36,26311,13229,13082,24993,12540,12453,1318,689,629
186399,36,5915,2645,3270,5080,2237,2843,835,408,427
186405,36,15,4,11,15,4,11,,,
186423,36,73,7,66,73,7,66,,,
186432,36,1409,554,855,1312,522,790,97,32,65
186469,36,501,163,338,265,97,168,236,66,170
186584,36,4096,1953,2143,3973,1874,2099,123,79,44
186593,36,126,19,107,84,10,74,42,9,33
186618,36,495,170,325,420,151,269,75,19,56
186645,36,3786,1852,1934,1368,710,658,2418,1142,1276
186867,36,2935,2081,854,2907,2057,850,28,24,4
186876,36,6058,2389,3669,5672,2221,3451,386,168,218
186900,36,47,47,0,47,47,0,,,
187000,36,283,271,12,242,232,10,41,39,2
187046,36,6544,3956,2588,52,13,39,6492,3943,2549
187134,36,5164,2224,2940,5020,2149,2871,144,75,69
187198,36,5321,1813,3508,1933,827,1106,3388,986,2402
187444,36,5426,2244,3182,4230,1769,2461,1196,475,721
187505,36,451,82,369,451,82,369,,,
187532,36,11503,4168,7335,2729,1102,1627,8774,3066,5708
187596,36,651,225,426,371,140,231,280,85,195
187620,36,3508,1345,2163,1670,651,1019,1838,694,1144
187639,36,894,202,692,288,69,219,606,133,473
187648,36,2163,838,1325,1415,526,889,748,312,436
187666,36,773,257,516,320,119,201,453,138,315
187745,36,218,81,137,154,61,93,64,20,44
187897,36,1060,365,695,678,274,404,382,91,291
187903,36,1176,361,815,430,169,261,746,192,554
187912,36,159,124,35,159,124,35,,,
187958,36,1030,313,717,253,79,174,777,234,543
187967,36,859,601,258,799,553,246,60,48,12
187976,36,574,256,318,61,26,35,513,230,283
187985,36,11077,4560,6517,7801,3263,4538,3276,1297,1979
187994,36,331,113,218,131,50,81,200,63,137
188003,36,307,66,241,125,29,96,182,37,145
188021,36,169,44,125,79,25,54,90,19,71
188030,36,8163,3436,4727,6643,2760,3883,1520,676,844
188049,36,905,321,584,160,52,108,745,269,476
188058,36,679,266,413,351,115,236,328,151,177
188100,36,3060,916,2144,983,392,591,2077,524,1553
188137,36,1607,476,1131,391,136,255,1216,340,876
188182,36,110,67,43,95,55,40,15,12,3
188216,36,257,64,193,155,49,106,102,15,87
188225,36,635,200,435,69,24,45,566,176,390
188261,36,255,191,64,50,21,29,205,170,35
188289,36,46,2,44,41,2,39,5,0,5
188304,36,1140,362,778,693,268,425,447,94,353
188340,36,976,864,112,742,653,89,234,211,23
188429,36,3526,1083,2443,3322,1003,2319,204,80,124
188438,36,1192,426,766,628,268,360,564,158,406
188517,36,224,88,136,162,74,88,62,14,48
188526,36,463,169,294,460,168,292,3,1,2
188641,36,1017,498,519,979,474,505,38,24,14
188650,36,37,0,37,37,0,37,,,
188669,36,16,1,15,16,1,15,,,
188678,36,76,29,47,76,29,47,,,
188687,36,338,102,236,37,11,26,301,91,210
188696,36,97,8,89,97,8,89,,,
188854,36,1157,351,806,1157,351,806,,,
188890,36,477,453,24,426,403,23,51,50,1
188915,36,15,4,11,12,4,8,3,0,3
188942,36,64,0,64,36,0,36,28,0,28
189088,36,1478,685,793,1383,614,769,95,71,24
189097,36,2126,0,2126,2088,0,2088,38,0,38
189219,36,40,36,4,40,36,4,,,
189228,36,1322,427,895,883,303,580,439,124,315
189255,36,47,0,47,30,0,30,17,0,17
189273,36,45,45,0,45,45,0,,,
189282,36,175,19,156,175,19,156,,,
189404,36,139,2,137,48,1,47,91,1,90
189413,36,280,36,244,280,36,244,,,
189468,36,5,0,5,3,0,3,2,0,2
189477,36,109,3,106,72,2,70,37,1,36
189547,36,1966,715,1251,1230,472,758,736,243,493
189565,36,297,71,226,231,54,177,66,17,49
189583,36,457,92,365,298,62,236,159,30,129
189592,36,213,44,169,141,38,103,72,6,66
189705,36,1276,638,638,1240,620,620,36,18,18
189714,36,256,9,247,168,8,160,88,1,87
189811,36,660,142,518,660,142,518,,,
189839,36,751,270,481,419,154,265,332,116,216
189848,36,506,133,373,373,100,273,133,33,100
189857,36,218,218,0,218,218,0,,,
189990,36,384,5,379,93,1,92,291,4,287
190008,36,34,11,23,34,11,23,,,
190044,36,1982,1384,598,1971,1377,594,11,7,4
190053,36,297,115,182,142,58,84,155,57,98
190071,36,67,4,63,17,2,15,50,2,48
190099,36,2240,1032,1208,2230,1024,1206,10,8,2
190114,36,276,70,206,226,51,175,50,19,31
190150,36,6360,3175,3185,5882,2928,2954,478,247,231
190169,36,510,130,380,168,58,110,342,72,270
190239,36,65,0,65,46,0,46,19,0,19
190318,36,213,15,198,196,15,181,17,0,17
190372,36,633,340,293,631,338,293,2,2,0
190415,36,11078,5160,5918,11026,5126,5900,52,34,18
190442,36,915,312,603,454,168,286,461,144,317
190451,36,190,21,169,63,8,55,127,13,114
190503,36,1732,919,813,1604,843,761,128,76,52
190512,36,11453,6034,5419,8754,4613,4141,2699,1421,1278
190521,36,13005,5248,7757,8178,3388,4790,4827,1860,2967
190530,36,4719,1830,2889,2915,1127,1788,1804,703,1101
190549,36,9797,4177,5620,7372,3119,4253,2425,1058,1367
190558,36,7667,3387,4280,5859,2580,3279,1808,807,1001
190567,36,8503,3973,4530,6650,3016,3634,1853,957,896
190576,36,1898,485,1413,448,95,353,1450,390,1060
190585,36,3438,995,2443,1527,486,1041,1911,509,1402
190594,36,12089,4363,7726,9079,3229,5850,3010,1134,1876
190600,36,9343,3633,5710,7267,2745,4522,2076,888,1188
190619,36,5522,2293,3229,3628,1514,2114,1894,779,1115
190628,36,8377,3373,5004,4748,1954,2794,3629,1419,2210
190637,36,8388,2606,5782,5288,1699,3589,3100,907,2193
190646,36,2922,720,2202,2077,527,1550,845,193,652
190655,36,9855,5331,4524,5972,3424,2548,3883,1907,1976
190664,36,11357,5195,6162,8337,3744,4593,3020,1451,1569
190673,36,6760,2902,3858,3717,1655,2062,3043,1247,1796
190691,36,4198,1323,2875,2841,869,1972,1357,454,903
190707,36,12,2,10,12,2,10,,,
190716,36,971,223,748,709,171,538,262,52,210
190725,36,1058,295,763,937,264,673,121,31,90
190752,36,30,30,0,30,30,0,,,
190761,36,859,289,570,806,275,531,53,14,39
190840,36,2533,1070,1463,1293,596,697,1240,474,766
190956,36,66,1,65,3,0,3,63,1,62
190983,36,449,145,304,430,140,290,19,5,14
191083,36,4056,1798,2258,2761,1268,1493,1295,530,765
191126,36,5705,969,4736,4981,820,4161,724,149,575
191199,36,1679,631,1048,952,373,579,727,258,469
191205,36,377,253,124,357,239,118,20,14,6
191241,36,6478,2813,3665,6251,2705,3546,227,108,119
191302,36,679,286,393,320,145,175,359,141,218
191311,36,65,25,40,65,25,40,,,
191339,36,1372,414,958,738,270,468,634,144,490
191515,36,1512,702,810,1511,701,810,1,1,0
191533,36,764,325,439,742,310,432,22,15,7
191597,36,339,50,289,184,25,159,155,25,130
191612,36,760,277,483,531,186,345,229,91,138
191621,36,504,220,284,487,209,278,17,11,6
191630,36,1248,600,648,1233,591,642,15,9,6
191649,36,4096,1805,2291,3866,1686,2180,230,119,111
191676,36,585,220,365,554,207,347,31,13,18
191719,36,3795,1804,1991,2181,1150,1031,1614,654,960
191728,36,685,149,536,453,104,349,232,45,187
191931,36,1705,869,836,1661,838,823,44,31,13
191940,36,121,8,113,121,8,113,,,
191959,36,26,23,3,26,23,3,,,
191968,36,3537,1556,1981,3478,1526,1952,59,30,29
191986,36,1006,341,665,648,244,404,358,97,261
192004,36,191,54,137,186,53,133,5,1,4
192022,36,1028,349,679,652,229,423,376,120,256
192040,36,98,43,55,98,43,55,,,
192110,36,367,192,175,367,192,175,,,
192165,36,123,123,0,123,123,0,,,
192192,36,786,204,582,725,191,534,61,13,48
192271,36,877,96,781,811,88,723,66,8,58
192323,36,1839,712,1127,1574,664,910,265,48,217
192448,36,3959,1234,2725,3524,1138,2386,435,96,339
192484,36,105,1,104,55,0,55,50,1,49
192509,36,605,95,510,547,88,459,58,7,51
192624,36,129,129,0,129,129,0,,,
192688,36,306,42,264,220,32,188,86,10,76
192703,36,2278,1332,946,2147,1229,918,131,103,28
192712,36,357,182,175,352,181,171,5,1,4
192749,36,967,381,586,936,369,567,31,12,19
192785,36,533,57,476,91,15,76,442,42,400
192800,36,16,0,16,3,0,3,13,0,13
192819,36,3711,1585,2126,3497,1463,2034,214,122,92
192864,36,1163,207,956,989,199,790,174,8,166
192925,36,838,218,620,734,206,528,104,12,92
192961,36,107,16,91,2,1,1,105,15,90
192970,36,18,5,13,18,5,13,,,
193016,36,4398,1327,3071,3627,1043,2584,771,284,487
193052,36,243,243,0,243,243,0,,,
193061,36,35,35,0,35,35,0,,,
193070,36,28,28,0,28,28,0,,,
193186,36,88,2,86,49,1,48,39,1,38
193201,36,400,41,359,400,41,359,,,
193247,36,79,79,0,79,79,0,,,
193265,36,13,12,1,12,11,1,1,1,0
193283,36,1789,766,1023,1176,541,635,613,225,388
193292,36,2483,676,1807,1935,563,1372,548,113,435
193308,36,4142,1271,2871,2467,883,1584,1675,388,1287
193326,36,5463,2161,3302,2707,1128,1579,2756,1033,1723
193353,36,1170,327,843,924,258,666,246,69,177
193380,36,86,15,71,,,,86,15,71
193399,36,1414,348,1066,1300,332,968,114,16,98
193478,36,7786,3615,4171,3811,1875,1936,3975,1740,2235
193584,36,1461,387,1074,1410,370,1040,51,17,34
193609,36,72,25,47,72,25,47,,,
193654,36,4999,1247,3752,4502,1121,3381,497,126,371
193672,36,9,7,2,9,7,2,,,
193858,36,200,15,185,200,15,185,,,
193900,36,21420,9270,12150,20485,8833,11652,935,437,498
193946,36,1849,693,1156,1205,488,717,644,205,439
193973,36,2020,691,1329,1958,667,1291,62,24,38
193991,36,41,1,40,27,1,26,14,0,14
194028,36,460,140,320,283,90,193,177,50,127
194091,36,2219,1318,901,2000,1165,835,219,153,66
194116,36,305,31,274,87,12,75,218,19,199
194161,36,751,315,436,595,234,361,156,81,75
194189,36,84,84,0,84,84,0,,,
194222,36,2609,1115,1494,1549,745,804,1060,370,690
194240,36,2464,869,1595,1021,419,602,1443,450,993
194259,36,21,1,20,21,1,20,,,
194310,36,5147,1868,3279,4839,1715,3124,308,153,155
194392,36,418,271,147,410,266,144,8,5,3
194435,36,47,2,45,44,2,42,3,0,3
194499,36,529,106,423,529,106,423,,,
194569,36,43,26,17,18,8,10,25,18,7
194578,36,2569,733,1836,2477,694,1783,92,39,53
194657,36,119,119,0,119,119,0,,,
194666,36,315,315,0,315,315,0,,,
194693,36,27,27,0,27,27,0,,,
194718,36,19,19,0,19,19,0,,,
194736,36,120,120,0,120,120,0,,,
194763,36,311,311,0,311,311,0,,,
194824,36,4190,2869,1321,4175,2859,1316,15,10,5
194958,36,761,246,515,715,232,483,46,14,32
195003,36,9406,6204,3202,9063,5968,3095,343,236,107
195030,36,4685,2262,2423,4504,2216,2288,181,46,135
195058,36,2926,1259,1667,1503,759,744,1423,500,923
195067,36,163,14,149,120,13,107,43,1,42
195128,36,800,178,622,762,170,592,38,8,30
195164,36,1211,659,552,1194,651,543,17,8,9
195173,36,1808,642,1166,1713,594,1119,95,48,47
195191,36,190,22,168,176,18,158,14,4,10
195216,36,1604,720,884,1597,715,882,7,5,2
195234,36,1369,469,900,1314,444,870,55,25,30
195243,36,730,372,358,701,351,350,29,21,8
195289,36,90,13,77,2,0,2,88,13,75
195304,36,1030,226,804,1017,223,794,13,3,10
195322,36,923,373,550,501,227,274,422,146,276
195438,36,86,86,0,86,86,0,,,
195474,36,2267,1007,1260,2210,981,1229,57,26,31
195526,36,1937,775,1162,1913,763,1150,24,12,12
195544,36,2704,804,1900,2356,721,1635,348,83,265
195702,36,57,7,50,37,5,32,20,2,18
195720,36,1857,762,1095,1773,730,1043,84,32,52
195784,36,568,67,501,568,67,501,,,
195809,36,7062,3127,3935,6894,3028,3866,168,99,69
195988,36,492,187,305,257,115,142,235,72,163
196006,36,2094,1256,838,1828,1180,648,266,76,190
196015,36,2012,850,1162,1651,723,928,361,127,234
196024,36,1671,742,929,1281,659,622,390,83,307
196033,36,1179,478,701,1068,425,643,111,53,58
196042,36,6372,3757,2615,4924,2889,2035,1448,868,580
196051,36,1263,548,715,1007,494,513,256,54,202
196060,36,8477,4048,4429,7789,3663,4126,688,385,303
196079,36,10278,5076,5202,9950,4871,5079,328,205,123
196088,36,15506,8516,6990,14075,7828,6247,1431,688,743
196097,36,13080,6568,6512,11945,5971,5974,1135,597,538
196103,36,1074,555,519,798,419,379,276,136,140
196112,36,1351,966,385,1182,868,314,169,98,71
196121,36,3910,1584,2326,3285,1343,1942,625,241,384
196130,36,4230,1750,2480,3640,1441,2199,590,309,281
196149,36,4199,1782,2417,4050,1690,2360,149,92,57
196158,36,2518,1046,1472,2432,998,1434,86,48,38
196167,36,3259,1203,2056,3108,1130,1978,151,73,78
196176,36,4370,1641,2729,3917,1417,2500,453,224,229
196185,36,4134,1567,2567,4000,1502,2498,134,65,69
196194,36,4381,2057,2324,4019,1878,2141,362,179,183
196200,36,1776,649,1127,1682,607,1075,94,42,52
196219,36,2465,991,1474,2249,877,1372,216,114,102
196237,36,2972,1157,1815,2471,937,1534,501,220,281
196246,36,3050,1212,1838,2666,1069,1597,384,143,241
196255,36,20,0,20,16,0,16,4,0,4
196264,36,5905,2083,3822,2381,690,1691,3524,1393,2131
196291,36,1063,910,153,966,817,149,97,93,4
196307,36,118,22,96,61,11,50,57,11,46
196389,36,554,124,430,544,122,422,10,2,8
196413,36,10471,4777,5694,10092,4578,5514,379,199,180
196431,36,103,103,0,102,102,0,1,1,0
196440,36,7,7,0,7,7,0,,,
196565,36,842,286,556,428,170,258,414,116,298
196583,36,33,33,0,33,33,0,,,
196592,36,3306,971,2335,2437,738,1699,869,233,636
196653,36,757,83,674,237,31,206,520,52,468
196680,36,13879,7302,6577,,,,13879,7302,6577
196699,36,875,322,553,383,172,211,492,150,342
196866,36,1490,812,678,1483,805,678,7,7,0
197018,36,1392,1392,0,1392,1392,0,,,
197027,36,729,559,170,729,559,170,,,
197036,36,3167,2434,733,3167,2434,733,,,
197045,36,2060,869,1191,1672,724,948,388,145,243
197133,36,1808,700,1108,1800,697,1103,8,3,5
197142,36,284,128,156,238,112,126,46,16,30
197151,36,2585,681,1904,2514,650,1864,71,31,40
197197,36,1150,393,757,1102,377,725,48,16,32
197221,36,77,59,18,77,59,18,,,
197230,36,188,62,126,182,59,123,6,3,3
197285,36,534,151,383,469,128,341,65,23,42
197294,36,5389,2414,2975,2439,1180,1259,2950,1234,1716
197337,36,56,0,56,51,0,51,5,0,5
197531,36,215,105,110,215,105,110,,,
197601,36,86,86,0,86,86,0,,,
197647,36,60,60,0,60,60,0,,,
197674,36,109,109,0,109,109,0,,,
197692,36,42,42,0,42,42,0,,,
197708,36,2060,1118,942,2017,1087,930,43,31,12
197735,36,470,470,0,470,470,0,,,
197744,36,147,147,0,147,147,0,,,
197814,36,572,151,421,212,57,155,360,94,266
197850,36,876,259,617,212,79,133,664,180,484
197869,36,12863,5535,7328,11942,5102,6840,921,433,488
197887,36,2708,984,1724,882,368,514,1826,616,1210
197911,36,689,316,373,654,310,344,35,6,29
197966,36,1032,319,713,262,78,184,770,241,529
197984,36,918,469,449,861,447,414,57,22,35
197993,36,166,0,166,141,0,141,25,0,25
198011,36,785,250,535,191,55,136,594,195,399
198039,36,1200,442,758,426,172,254,774,270,504
198066,36,500,285,215,478,271,207,22,14,8
198084,36,640,217,423,266,102,164,374,115,259
198109,36,225,13,212,12,1,11,213,12,201
198118,36,1368,493,875,535,217,318,833,276,557
198136,36,2480,1171,1309,2026,905,1121,454,266,188
198154,36,6588,2615,3973,2407,1050,1357,4181,1565,2616
198206,36,797,222,575,243,72,171,554,150,404
198215,36,783,347,436,705,322,383,78,25,53
198233,36,2325,975,1350,715,319,396,1610,656,954
198251,36,1831,604,1227,655,265,390,1176,339,837
198260,36,10756,4331,6425,4227,1732,2495,6529,2599,3930
198303,36,654,374,280,642,369,273,12,5,7
198321,36,1326,488,838,589,219,370,737,269,468
198330,36,1822,634,1188,897,311,586,925,323,602
198367,36,1301,520,781,397,206,191,904,314,590
198376,36,1719,498,1221,774,258,516,945,240,705
198385,36,1412,670,742,1412,670,742,,,
198419,36,5021,2498,2523,4995,2484,2511,26,14,12
198455,36,2619,947,1672,478,211,267,2141,736,1405
198464,36,15354,6506,8848,12890,5426,7464,2464,1080,1384
198491,36,813,203,610,161,37,124,652,166,486
198507,36,1286,529,757,1135,481,654,151,48,103
198516,36,4626,1852,2774,4450,1779,2671,176,73,103
198534,36,6126,2078,4048,2410,875,1535,3716,1203,2513
198543,36,3576,1037,2539,2430,730,1700,1146,307,839
198552,36,4174,1419,2755,1431,570,861,2743,849,1894
198561,36,1309,430,879,1070,383,687,239,47,192
198570,36,2082,637,1445,585,196,389,1497,441,1056
198598,36,397,225,172,384,215,169,13,10,3
198613,36,744,336,408,702,321,381,42,15,27
198622,36,5690,2175,3515,2086,840,1246,3604,1335,2269
198640,36,375,84,291,106,33,73,269,51,218
198668,36,551,179,372,235,90,145,316,89,227
198677,36,16,6,10,5,1,4,11,5,6
198695,36,3359,1494,1865,3337,1481,1856,22,13,9
198710,36,764,258,506,299,111,188,465,147,318
198729,36,767,225,542,230,77,153,537,148,389
198756,36,802,319,483,755,301,454,47,18,29
198774,36,1886,611,1275,770,259,511,1116,352,764
198808,36,506,181,325,480,174,306,26,7,19
198817,36,956,271,685,303,107,196,653,164,489
198835,36,1005,420,585,952,410,542,53,10,43
198844,36,52,2,50,50,2,48,2,0,2
198862,36,641,333,308,621,325,296,20,8,12
198871,36,62,44,18,54,39,15,8,5,3
198899,36,666,322,344,623,308,315,43,14,29
198905,36,285,70,215,172,44,128,113,26,87
198914,36,334,112,222,146,45,101,188,67,121
198923,36,298,131,167,212,101,111,86,30,56
198950,36,1022,0,1022,988,0,988,34,0,34
198969,36,951,503,448,859,453,406,92,50,42
198978,36,1500,252,1248,1464,246,1218,36,6,30
198987,36,1354,504,850,546,208,338,808,296,512
199005,36,19,0,19,19,0,19,,,
199023,36,437,190,247,146,77,69,291,113,178
199032,36,572,295,277,469,252,217,103,43,60
199069,36,1405,479,926,843,332,511,562,147,415
199078,36,165,22,143,155,21,134,10,1,9
199087,36,1164,447,717,392,143,249,772,304,468
199102,36,7617,3069,4548,6692,2616,4076,925,453,472
199111,36,2182,961,1221,1911,815,1096,271,146,125
199120,36,13993,5629,8364,13240,5287,7953,753,342,411
199139,36,16847,9074,7773,14210,7604,6606,2637,1470,1167
199148,36,10775,3528,7247,8850,2863,5987,1925,665,1260
199157,36,3723,1066,2657,3146,931,2215,577,135,442
199184,36,692,275,417,668,263,405,24,12,12
199193,36,18549,9544,9005,16943,8615,8328,1606,929,677
199209,36,1054,474,580,911,435,476,143,39,104
199218,36,9742,3515,6227,7871,2993,4878,1871,522,1349
199263,36,142,35,107,30,4,26,112,31,81
199272,36,477,236,241,428,219,209,49,17,32
199281,36,4380,1618,2762,3236,1231,2005,1144,387,757
199306,36,511,198,313,491,186,305,20,12,8
199324,36,587,207,380,100,40,60,487,167,320
199333,36,3558,1175,2383,1378,529,849,2180,646,1534
199412,36,991,346,645,922,324,598,69,22,47
199421,36,950,294,656,345,108,237,605,186,419
199449,36,891,252,639,320,107,213,571,145,426
199458,36,75,46,29,65,37,28,10,9,1
199467,36,498,120,378,109,29,80,389,91,298
199476,36,892,220,672,411,110,301,481,110,371
199485,36,829,242,587,212,69,143,617,173,444
199494,36,2851,924,1927,930,340,590,1921,584,1337
199582,36,465,245,220,390,207,183,75,38,37
199607,36,283,6,277,220,0,220,63,6,57
199625,36,632,163,469,223,68,155,409,95,314
199634,36,1785,593,1192,626,230,396,1159,363,796
199643,36,726,285,441,635,265,370,91,20,71
199689,36,183,9,174,148,4,144,35,5,30
199698,36,511,223,288,486,219,267,25,4,21
199722,36,698,224,474,213,93,120,485,131,354
199731,36,1139,314,825,360,112,248,779,202,577
199740,36,1151,254,897,322,85,237,829,169,660
199759,36,427,305,122,228,154,74,199,151,48
199768,36,1342,478,864,499,201,298,843,277,566
199786,36,1978,732,1246,596,231,365,1382,501,881
199795,36,334,118,216,133,53,80,201,65,136
199838,36,1327,346,981,407,136,271,920,210,710
199847,36,4031,1871,2160,3954,1840,2114,77,31,46
199856,36,12578,5447,7131,3776,1821,1955,8802,3626,5176
199865,36,452,148,304,448,146,302,4,2,2
199883,36,144,13,131,144,13,131,,,
199892,36,2010,762,1248,481,209,272,1529,553,976
199908,36,618,224,394,214,88,126,404,136,268
199926,36,863,313,550,357,156,201,506,157,349
199953,36,591,144,447,171,54,117,420,90,330
199962,36,1615,660,955,1552,627,925,63,33,30
199971,36,32,15,17,32,15,17,,,
199980,36,6,5,1,6,5,1,,,
199999,36,3270,791,2479,2761,701,2060,509,90,419
200004,36,7219,3164,4055,5843,2625,3218,1376,539,837
200013,36,453,68,385,244,29,215,209,39,170
200022,36,1602,930,672,953,544,409,649,386,263
200059,36,748,317,431,601,261,340,147,56,91
200086,36,112,33,79,83,24,59,29,9,20
200110,36,16,0,16,16,0,16,,,
200156,36,628,366,262,603,345,258,25,21,4
200192,36,289,123,166,185,85,100,104,38,66
200208,36,168,36,132,70,24,46,98,12,86
200217,36,1545,639,906,1227,506,721,318,133,185
200226,36,545,189,356,356,140,216,189,49,140
200253,36,1638,587,1051,1316,487,829,322,100,222
200280,36,6350,3672,2678,4736,2546,2190,1614,1126,488
200305,36,930,541,389,724,464,260,206,77,129
200314,36,291,69,222,189,49,140,102,20,82
200332,36,6885,3498,3387,6059,3173,2886,826,325,501
200341,36,356,108,248,272,89,183,84,19,65
200466,36,149,45,104,118,38,80,31,7,24
200484,36,104,54,50,89,49,40,15,5,10
200527,36,315,126,189,285,115,170,30,11,19
200554,36,258,102,156,237,94,143,21,8,13
200572,36,658,309,349,496,244,252,162,65,97
200590,36,57,5,52,52,3,49,5,2,3
200785,36,319,31,288,146,17,129,173,14,159
200800,36,8527,4576,3951,6884,3709,3175,1643,867,776
200846,36,523,204,319,397,160,237,126,44,82
200873,36,50,21,29,39,16,23,11,5,6
201034,36,486,285,201,105,34,71,381,251,130
201061,36,149,43,106,138,38,100,11,5,6
201098,36,26,14,12,17,8,9,9,6,3
201104,36,2040,886,1154,1504,609,895,536,277,259
201131,36,13,6,7,7,0,7,6,6,0
201140,36,34,31,3,,,,34,31,3
201159,36,21,15,6,11,8,3,10,7,3
201177,36,192,19,173,67,9,58,125,10,115
201195,36,1923,855,1068,1799,798,1001,124,57,67
201283,36,324,117,207,155,64,91,169,53,116
201371,36,455,241,214,440,235,205,15,6,9
201432,36,538,154,384,318,85,233,220,69,151
201441,36,9496,4193,5303,8665,3718,4947,831,475,356
201469,36,386,88,298,255,62,193,131,26,105
201478,36,189,54,135,142,10,132,47,44,3
201496,36,193,119,74,193,119,74,,,
201539,36,66,10,56,56,5,51,10,5,5
201548,36,1505,592,913,1457,568,889,48,24,24
201645,36,4017,2181,1836,3969,2152,1817,48,29,19
201654,36,2532,1164,1368,2497,1148,1349,35,16,19
201672,36,1106,261,845,187,64,123,919,197,722
201681,36,5,0,5,5,0,5,,,
201690,36,3866,1100,2766,2062,649,1413,1804,451,1353
201751,36,42,7,35,12,3,9,30,4,26
201803,36,28,3,25,28,3,25,,,
201821,36,674,50,624,461,33,428,213,17,196
201867,36,49,5,44,49,5,44,,,
201885,36,20583,10350,10233,17832,9261,8571,2751,1089,1662
201928,36,3931,1505,2426,1003,432,571,2928,1073,1855
201946,36,1278,460,818,566,253,313,712,207,505
201955,36,2440,883,1557,1484,574,910,956,309,647
201964,36,927,364,563,666,289,377,261,75,186
201973,36,2237,628,1609,512,173,339,1725,455,1270
202046,36,417,114,303,414,112,302,3,2,1
202073,36,152,72,80,152,72,80,,,
202134,36,7376,3322,4054,5614,2563,3051,1762,759,1003
202152,36,105,7,98,105,7,98,,,
202170,36,708,199,509,695,193,502,13,6,7
202222,36,11881,5505,6376,2950,1391,1559,8931,4114,4817
202356,36,9815,3533,6282,2335,991,1344,7480,2542,4938
202435,36,68,14,54,34,7,27,34,7,27
202453,36,32,23,9,26,19,7,6,4,2
202480,36,6234,3257,2977,5958,3112,2846,276,145,131
202514,36,326,181,145,306,171,135,20,10,10
202523,36,1639,772,867,1634,768,866,5,4,1
202648,36,930,294,636,245,101,144,685,193,492
202657,36,257,71,186,29,8,21,228,63,165
202763,36,1481,491,990,1409,468,941,72,23,49
202806,36,2753,1173,1580,978,415,563,1775,758,1017
202888,36,31,1,30,15,1,14,16,0,16
202903,36,149,76,73,93,46,47,56,30,26
202912,36,182,12,170,55,3,52,127,9,118
202949,36,79,69,10,79,69,10,,,
202985,36,40,4,36,32,4,28,8,0,8
203030,36,43,1,42,43,1,42,,,
203085,36,748,378,370,726,363,363,22,15,7
203128,36,583,271,312,520,246,274,63,25,38
203146,36,55,48,7,55,48,7,,,
203155,36,877,456,421,620,359,261,257,97,160
203234,36,34,1,33,34,1,33,,,
203289,36,31,25,6,31,25,6,,,
203331,36,31414,9728,21686,10892,3424,7468,20522,6304,14218
203368,36,1963,1066,897,1923,1036,887,40,30,10
203386,36,1801,125,1676,1167,80,1087,634,45,589
203438,36,91,2,89,45,0,45,46,2,44
203447,36,1288,504,784,78,31,47,1210,473,737
203456,36,654,215,439,12,4,8,642,211,431
203465,36,3119,1189,1930,680,271,409,2439,918,1521
203474,36,1450,565,885,202,69,133,1248,496,752
203483,36,1335,549,786,223,90,133,1112,459,653
203492,36,998,257,741,178,26,152,820,231,589
203517,36,15153,5803,9350,12115,4516,7599,3038,1287,1751
203526,36,1325,464,861,89,22,67,1236,442,794
203535,36,1342,626,716,1342,626,716,,,
203544,36,415,62,353,290,41,249,125,21,104
203580,36,422,231,191,389,219,170,33,12,21
203599,36,2736,980,1756,684,307,377,2052,673,1379
203614,36,253,43,210,253,43,210,,,
203678,36,993,237,756,234,81,153,759,156,603
203720,36,88,40,48,63,36,27,25,4,21
203739,36,39,5,34,20,4,16,19,1,18
203748,36,4328,1489,2839,1145,446,699,3183,1043,2140
203757,36,594,246,348,526,228,298,68,18,50
203775,36,616,254,362,538,222,316,78,32,46
203845,36,770,391,379,750,378,372,20,13,7
203881,36,879,367,512,200,66,134,679,301,378
203942,36,13,5,8,13,5,8,,,
203960,36,899,102,797,237,33,204,662,69,593
204006,36,1537,754,783,1099,513,586,438,241,197
204015,36,862,419,443,649,307,342,213,112,101
204024,36,12108,5978,6130,11832,5815,6017,276,163,113
204121,36,35,0,35,16,0,16,19,0,19
204158,36,106,21,85,106,21,85,,,
204176,36,451,56,395,349,41,308,102,15,87
204185,36,1326,689,637,1313,684,629,13,5,8
204194,36,1089,425,664,987,395,592,102,30,72
204200,36,729,331,398,664,308,356,65,23,42
204255,36,534,243,291,361,176,185,173,67,106
204264,36,979,432,547,861,408,453,118,24,94
204334,36,82,2,80,1,0,1,81,2,79
204422,36,919,327,592,233,82,151,686,245,441
204431,36,19,4,15,19,4,15,,,
204440,36,675,271,404,185,82,103,490,189,301
204459,36,1,0,1,1,0,1,,,
204468,36,787,375,412,635,333,302,152,42,110
204486,36,1685,1418,267,1536,1314,222,149,104,45
204501,36,2060,848,1212,2023,836,1187,37,12,25
204608,36,401,363,38,401,363,38,,,
204617,36,596,294,302,526,265,261,70,29,41
204635,36,1407,812,595,1373,782,591,34,30,4
204662,36,227,105,122,190,84,106,37,21,16
204671,36,447,178,269,390,151,239,57,27,30
204680,36,390,154,236,330,129,201,60,25,35
204699,36,522,253,269,439,215,224,83,38,45
204705,36,1116,520,596,848,366,482,268,154,114
204714,36,70,7,63,70,7,63,,,
204723,36,163,124,39,163,124,39,,,
204769,36,100,2,98,100,2,98,,,
204778,36,43,1,42,43,1,42,,,
204796,36,33861,17250,16611,31116,15775,15341,2745,1475,1270
204802,36,194,67,127,149,44,105,45,23,22
204820,36,749,274,475,510,174,336,239,100,139
204839,36,516,162,354,409,125,284,107,37,70
204848,36,496,174,322,320,102,218,176,72,104
204857,36,13272,5174,8098,10189,4446,5743,3083,728,2355
204866,36,483,113,370,364,84,280,119,29,90
204884,36,57,5,52,57,5,52,,,
204893,36,31,5,26,8,3,5,23,2,21
204909,36,954,433,521,948,430,518,6,3,3
204936,36,1525,603,922,1432,568,864,93,35,58
204945,36,3004,1048,1956,901,370,531,2103,678,1425
204963,36,2,0,2,1,0,1,1,0,1
204981,36,115,23,92,17,3,14,98,20,78
205027,36,21,21,0,21,21,0,,,
205054,36,264,21,243,264,21,243,,,
205090,36,74,4,70,9,2,7,65,2,63
205124,36,24,24,0,24,24,0,,,
205142,36,152,44,108,146,44,102,6,0,6
205179,36,417,75,342,397,72,325,20,3,17
205203,36,503,149,354,283,110,173,220,39,181
205391,36,115,29,86,62,15,47,53,14,39
205443,36,1847,829,1018,1484,682,802,363,147,216
205470,36,7985,3243,4742,1716,873,843,6269,2370,3899
205559,36,31,8,23,31,8,23,,,
205841,36,4693,1847,2846,1267,593,674,3426,1254,2172
205887,36,342,41,301,342,41,301,,,
205957,36,1676,676,1000,1570,638,932,106,38,68
205966,36,514,150,364,170,61,109,344,89,255
206011,36,714,380,334,235,115,120,479,265,214
206039,36,28,0,28,20,0,20,8,0,8
206048,36,1221,603,618,1009,525,484,212,78,134
206084,36,9063,4598,4465,7857,3974,3883,1206,624,582
206154,36,19,14,5,,,,19,14,5
206172,36,6,1,5,6,1,5,,,
206181,36,146,24,122,52,4,48,94,20,74
206279,36,378,209,169,158,83,75,220,126,94
206321,36,67,22,45,45,2,43,22,20,2
206349,36,459,33,426,383,28,355,76,5,71
206394,36,36,7,29,22,5,17,14,2,12
206437,36,1094,468,626,983,439,544,111,29,82
206446,36,653,191,462,247,102,145,406,89,317
206491,36,346,135,211,262,98,164,84,37,47
206507,36,735,325,410,694,309,385,41,16,25
206525,36,873,385,488,849,375,474,24,10,14
206589,36,1359,626,733,1353,622,731,6,4,2
206604,36,5093,2322,2771,3923,1788,2135,1170,534,636
206613,36,664,262,402,465,173,292,199,89,110
206622,36,3758,1662,2096,3526,1554,1972,232,108,124
206695,36,6327,2866,3461,5480,2502,2978,847,364,483
206817,36,144,64,80,128,60,68,16,4,12
206835,36,497,244,253,355,195,160,142,49,93
206862,36,1049,468,581,871,405,466,178,63,115
206905,36,20,1,19,20,1,19,,,
206914,36,2031,731,1300,1430,532,898,601,199,402
206923,36,893,272,621,565,204,361,328,68,260
206932,36,272,27,245,265,25,240,7,2,5
206941,36,8419,3135,5284,6071,2195,3876,2348,940,1408
206996,36,1077,279,798,645,183,462,432,96,336
207041,36,1871,774,1097,1574,676,898,297,98,199
207050,36,677,198,479,385,135,250,292,63,229
207069,36,440,165,275,243,118,125,197,47,150
207087,36,18,0,18,18,0,18,,,
207102,36,47,9,38,47,9,38,,,
207157,36,209,111,98,166,95,71,43,16,27
207209,36,1157,417,740,1065,379,686,92,38,54
207236,36,825,271,554,454,189,265,371,82,289
207254,36,530,468,62,530,468,62,,,
207263,36,3689,1310,2379,2561,952,1609,1128,358,770
207281,36,1287,431,856,700,270,430,587,161,426
207290,36,981,416,565,745,354,391,236,62,174
207306,36,977,390,587,817,332,485,160,58,102
207324,36,1124,536,588,1077,511,566,47,25,22
207342,36,361,42,319,338,37,301,23,5,18
207351,36,635,293,342,511,249,262,124,44,80
207388,36,13970,6886,7084,12450,6150,6300,1520,736,784
207397,36,2550,854,1696,595,263,332,1955,591,1364
207403,36,1045,454,591,971,399,572,74,55,19
207449,36,6306,2207,4099,1856,731,1125,4450,1476,2974
207458,36,1051,349,702,1011,330,681,40,19,21
207500,36,15292,7684,7608,13568,6777,6791,1724,907,817
207564,36,1055,763,292,665,524,141,390,239,151
207582,36,2232,854,1378,1892,721,1171,340,133,207
207661,36,1869,692,1177,1294,481,813,575,211,364
207670,36,3109,985,2124,1257,466,791,1852,519,1333
207704,36,126,2,124,62,1,61,64,1,63
207722,36,494,187,307,444,166,278,50,21,29
207740,36,681,156,525,371,101,270,310,55,255
207786,36,1,0,1,1,0,1,,,
207847,36,2460,1074,1386,1732,791,941,728,283,445
207856,36,283,156,127,249,137,112,34,19,15
207865,36,2621,1005,1616,2169,862,1307,452,143,309
207935,36,7856,2688,5168,2328,932,1396,5528,1756,3772
207962,36,467,398,69,467,398,69,,,
207971,36,2019,1049,970,1938,1008,930,81,41,40
208035,36,519,120,399,228,84,144,291,36,255
208044,36,18,2,16,18,2,16,,,
208053,36,22,12,10,2,0,2,20,12,8
208275,36,586,204,382,309,135,174,277,69,208
208318,36,2371,998,1373,1072,478,594,1299,520,779
208390,36,4486,1926,2560,1790,716,1074,2696,1210,1486
208406,36,2559,1357,1202,735,340,395,1824,1017,807
208415,36,333,117,216,133,43,90,200,74,126
208433,36,48,3,45,48,3,45,,,
208479,36,368,50,318,368,50,318,,,
208512,36,266,24,242,266,24,242,,,
208637,36,179,40,139,,,,179,40,139
208646,36,1666,681,985,981,401,580,685,280,405
208725,36,30,16,14,27,14,13,3,2,1
208822,36,1695,672,1023,1529,605,924,166,67,99
208859,36,7,0,7,7,0,7,,,
209038,36,3876,1757,2119,1536,682,854,2340,1075,1265
209056,36,1378,515,863,1370,508,862,8,7,1
209065,36,899,362,537,859,344,515,40,18,22
209074,36,2625,1130,1495,890,410,480,1735,720,1015
209083,36,61,16,45,61,16,45,,,
209153,36,3,0,3,3,0,3,,,
209205,36,25,1,24,25,1,24,,,
209241,36,19,19,0,18,18,0,1,1,0
209250,36,2329,890,1439,1057,441,616,1272,449,823
209287,36,209,105,104,175,93,82,34,12,22
209296,36,17,4,13,17,4,13,,,
209409,36,331,115,216,262,97,165,69,18,51
209490,36,421,81,340,226,47,179,195,34,161
209506,36,2313,1241,1072,1491,809,682,822,432,390
209542,36,20492,10863,9629,13302,7119,6183,7190,3744,3446
209551,36,12880,5773,7107,11747,5241,6506,1133,532,601
209603,36,272,82,190,250,77,173,22,5,17
209612,36,1160,446,714,1114,420,694,46,26,20
209667,36,17,0,17,17,0,17,,,
209676,36,19,1,18,19,1,18,,,
209694,36,10,7,3,10,7,3,,,
209700,36,170,12,158,170,12,158,,,
209719,36,8,0,8,8,0,8,,,
209746,36,13921,5776,8145,5277,2295,2982,8644,3481,5163
209807,36,11286,5041,6245,8175,3576,4599,3111,1465,1646
209825,36,2594,986,1608,2516,959,1557,78,27,51
209922,36,1004,448,556,994,445,549,10,3,7
209940,36,2128,803,1325,647,258,389,1481,545,936
210146,36,2320,923,1397,1678,689,989,642,234,408
210155,36,660,209,451,334,127,207,326,82,244
210234,36,670,277,393,358,163,195,312,114,198
210270,36,1230,476,754,375,157,218,855,319,536
210304,36,286,92,194,272,84,188,14,8,6
210331,36,623,264,359,488,192,296,135,72,63
210340,36,43,6,37,43,6,37,,,
210401,36,888,378,510,862,366,496,26,12,14
210429,36,2650,870,1780,2216,724,1492,434,146,288
210492,36,150,70,80,140,65,75,10,5,5
210571,36,961,406,555,923,388,535,38,18,20
210599,36,489,243,246,489,243,246,,,
210605,36,7740,3443,4297,2239,1054,1185,5501,2389,3112
210669,36,1124,508,616,1111,501,610,13,7,6
210711,36,22,0,22,22,0,22,,,
210739,36,1654,608,1046,1357,516,841,297,92,205
210748,36,68,1,67,27,1,26,41,0,41
210775,36,1551,475,1076,1169,402,767,382,73,309
210784,36,93,1,92,78,1,77,15,0,15
210809,36,6283,4409,1874,,,,6283,4409,1874
211006,36,326,303,23,317,295,22,9,8,1
211024,36,280,140,140,186,93,93,94,47,47
211079,36,882,349,533,335,163,172,547,186,361
211088,36,1240,407,833,1189,395,794,51,12,39
211130,36,4,0,4,4,0,4,,,
211158,36,5016,1978,3038,4583,1820,2763,433,158,275
211273,36,992,0,992,990,0,990,2,0,2
211291,36,2668,1252,1416,2667,1251,1416,1,1,0
211307,36,3907,1527,2380,1158,550,608,2749,977,1772
211316,36,80,0,80,56,0,56,24,0,24
211334,36,13,0,13,13,0,13,,,
211343,36,1234,405,829,398,148,250,836,257,579
211352,36,945,375,570,890,343,547,55,32,23
211361,36,3055,1370,1685,2458,1094,1364,597,276,321
211431,36,872,135,737,662,114,548,210,21,189
211440,36,4901,2488,2413,4765,2410,2355,136,78,58
211468,36,786,54,732,567,35,532,219,19,200
211477,36,616,189,427,100,39,61,516,150,366
211556,36,763,228,535,719,214,505,44,14,30
211583,36,704,275,429,579,249,330,125,26,99
211608,36,401,153,248,370,137,233,31,16,15
211635,36,100,12,88,100,12,88,,,
211644,36,2328,711,1617,1845,588,1257,483,123,360
211802,36,138,21,117,138,21,117,,,
211893,36,99,56,43,99,56,43,,,
211927,36,6163,2197,3966,1407,634,773,4756,1563,3193
211981,36,1142,462,680,1053,427,626,89,35,54
212009,36,1442,605,837,1428,599,829,14,6,8
212045,36,71,15,56,70,15,55,1,0,1
212054,36,10874,5725,5149,9792,5284,4508,1082,441,641
212106,36,3611,1317,2294,3546,1277,2269,65,40,25
212115,36,3250,1392,1858,2863,1222,1641,387,170,217
212133,36,1103,368,735,811,292,519,292,76,216
212160,36,1955,782,1173,1756,689,1067,199,93,106
212197,36,1174,470,704,1061,432,629,113,38,75
212230,36,13,1,12,13,1,12,,,
212267,36,22,0,22,16,0,16,6,0,6
212276,36,16,1,15,11,1,10,5,0,5
212294,36,30,1,29,28,1,27,2,0,2
212300,36,15,0,15,15,0,15,,,
212328,36,43,1,42,29,0,29,14,1,13
212337,36,48,1,47,33,0,33,15,1,14
212355,36,57,1,56,43,1,42,14,0,14
212382,36,69,1,68,42,1,41,27,0,27
212391,36,43,1,42,29,1,28,14,0,14
212434,36,144,133,11,144,133,11,,,
212577,36,1614,719,895,1604,714,890,10,5,5
212601,36,1961,761,1200,1913,746,1167,48,15,33
212656,36,773,391,382,701,363,338,72,28,44
212674,36,1759,866,893,1757,865,892,2,1,1
212753,36,31,0,31,21,0,21,10,0,10
212771,36,52,1,51,31,0,31,21,1,20
212805,36,1504,804,700,1489,791,698,15,13,2
212832,36,1164,261,903,1006,228,778,158,33,125
212869,36,636,99,537,392,62,330,244,37,207
212878,36,8893,2693,6200,2392,882,1510,6501,1811,4690
212911,36,1004,472,532,1003,472,531,1,0,1
212975,36,52,37,15,52,37,15,,,
212984,36,1618,392,1226,1303,321,982,315,71,244
212993,36,33,9,24,31,9,22,2,0,2
213011,36,988,273,715,664,205,459,324,68,256
213020,36,5018,1922,3096,4539,1709,2830,479,213,266
213163,36,261,37,224,261,37,224,,,
213181,36,142,8,134,94,6,88,48,2,46
213233,36,230,178,52,179,149,30,51,29,22
213251,36,843,378,465,841,378,463,2,0,2
213303,36,765,315,450,625,288,337,140,27,113
213321,36,1275,647,628,1221,616,605,54,31,23
213330,36,11,0,11,11,0,11,,,
213349,36,4552,1960,2592,4162,1775,2387,390,185,205
213358,36,680,269,411,583,237,346,97,32,65
213367,36,2024,713,1311,1723,652,1071,301,61,240
213376,36,1131,418,713,792,318,474,339,100,239
213385,36,1920,973,947,1907,963,944,13,10,3
213400,36,1101,537,564,539,258,281,562,279,283
213455,36,179,6,173,15,0,15,164,6,158
213473,36,115,19,96,79,11,68,36,8,28
213491,36,10,1,9,8,1,7,2,0,2
213507,36,1122,513,609,1096,502,594,26,11,15
213525,36,3197,995,2202,928,398,530,2269,597,1672
213534,36,261,76,185,240,73,167,21,3,18
213543,36,3892,2128,1764,3820,2084,1736,72,44,28
213570,36,430,92,338,430,92,338,,,
213589,36,233,213,20,147,136,11,86,77,9
213598,36,1213,413,800,1126,388,738,87,25,62
213613,36,1708,659,1049,1517,613,904,191,46,145
213622,36,108,14,94,92,12,80,16,2,14
213659,36,2383,766,1617,759,312,447,1624,454,1170
213668,36,744,327,417,740,324,416,4,3,1
213774,36,368,84,284,261,69,192,107,15,92
213783,36,1022,357,665,930,328,602,92,29,63
213826,36,1177,385,792,1109,358,751,68,27,41
213914,36,136,3,133,136,3,133,,,
213932,36,141,20,121,141,20,121,,,
213987,36,1843,723,1120,1689,696,993,154,27,127
213996,36,1716,687,1029,1676,669,1007,40,18,22
214023,36,2,2,0,2,2,0,,,
214041,36,4446,1822,2624,3401,1442,1959,1045,380,665
214069,36,1334,421,913,1013,352,661,321,69,252
214111,36,5410,2035,3375,1352,637,715,4058,1398,2660
214148,36,237,0,237,233,0,233,4,0,4
214157,36,1338,522,816,1264,497,767,74,25,49
214166,36,674,183,491,565,165,400,109,18,91
214175,36,1559,622,937,1522,602,920,37,20,17
214272,36,1227,427,800,930,330,600,297,97,200
214290,36,442,412,30,442,412,30,,,
214379,36,4798,1575,3223,1552,624,928,3246,951,2295
214476,36,27,4,23,25,3,22,2,1,1
214528,36,178,168,10,135,127,8,43,41,2
214582,36,363,35,328,273,27,246,90,8,82
214883,36,666,186,480,149,39,110,517,147,370
214892,36,194,72,122,194,72,122,,,
214944,36,345,299,46,194,174,20,151,125,26
214971,36,103,25,78,101,24,77,2,1,1
215008,36,51,49,2,51,49,2,,,
215044,36,70,19,51,70,19,51,,,
215053,36,161,46,115,154,45,109,7,1,6
215062,36,8142,3651,4491,7446,3385,4061,696,266,430
215105,36,1033,360,673,1018,354,664,15,6,9
215114,36,546,244,302,518,229,289,28,15,13
215132,36,976,313,663,954,305,649,22,8,14
215239,36,8520,2588,5932,2455,879,1576,6065,1709,4356
215266,36,803,333,470,743,315,428,60,18,42
215275,36,896,378,518,851,353,498,45,25,20
215284,36,1538,866,672,1490,837,653,48,29,19
215293,36,14039,6340,7699,13451,6006,7445,588,334,254
215309,36,17,2,15,10,1,9,7,1,6
215336,36,27,0,27,27,0,27,,,
215381,36,375,351,24,375,351,24,,,
215390,36,14,4,10,10,3,7,4,1,3
215415,36,682,381,301,581,338,243,101,43,58
215442,36,1788,675,1113,1584,576,1008,204,99,105
215479,36,65,15,50,65,15,50,,,
215530,36,27,0,27,15,0,15,12,0,12
215585,36,2300,656,1644,440,165,275,1860,491,1369
215594,36,262,41,221,189,30,159,73,11,62
215637,36,148,55,93,148,55,93,,,
215655,36,2160,1213,947,1983,1113,870,177,100,77
215682,36,324,287,37,324,287,37,,,
215691,36,275,103,172,221,85,136,54,18,36
215743,36,1213,426,787,1002,374,628,211,52,159
215770,36,2982,1409,1573,2740,1306,1434,242,103,139
215798,36,967,539,428,939,515,424,28,24,4
215886,36,27,2,25,14,2,12,13,0,13
215929,36,2562,1041,1521,2490,1005,1485,72,36,36
215947,36,1193,417,776,1106,390,716,87,27,60
215974,36,319,63,256,183,40,143,136,23,113
215983,36,23,5,18,23,5,18,,,
215992,36,72,39,33,72,39,33,,,
216010,36,3421,1665,1756,3088,1484,1604,333,181,152
216038,36,4987,2210,2777,4646,2051,2595,341,159,182
216047,36,29,29,0,29,29,0,,,
216074,36,39,2,37,25,2,23,14,0,14
216083,36,138,44,94,108,35,73,30,9,21
216162,36,301,24,277,301,24,277,,,
216223,36,16,0,16,16,0,16,,,
216278,36,1540,674,866,1534,670,864,6,4,2
216287,36,1182,598,584,1182,598,584,,,
216296,36,611,541,70,588,520,68,23,21,2
216311,36,82,82,0,82,82,0,,,
216339,36,19125,8478,10647,17409,7582,9827,1716,896,820
216357,36,501,245,256,498,243,255,3,2,1
216366,36,2274,628,1646,1984,566,1418,290,62,228
216436,36,67,61,6,67,61,6,,,
216445,36,85,80,5,85,80,5,,,
216454,36,77,69,8,77,69,8,,,
216524,36,1077,562,515,1073,560,513,4,2,2
216542,36,303,141,162,263,120,143,40,21,19
216551,36,30,26,4,30,26,4,,,
216579,36,50,1,49,50,1,49,,,
216597,36,5172,2394,2778,4991,2295,2696,181,99,82
216630,36,33,4,29,33,4,29,,,
216667,36,808,410,398,791,396,395,17,14,3
216694,36,837,340,497,805,335,470,32,5,27
216746,36,38,32,6,27,23,4,11,9,2
216764,36,10347,4146,6201,9126,3634,5492,1221,512,709
216773,36,104,16,88,104,16,88,,,
216782,36,91,3,88,43,0,43,48,3,45
216807,36,742,340,402,735,338,397,7,2,5
216825,36,1949,592,1357,750,268,482,1199,324,875
216852,36,1993,857,1136,1823,806,1017,170,51,119
216931,36,1422,682,740,1334,641,693,88,41,47
216940,36,143,143,0,143,143,0,,,
217013,36,481,94,387,380,89,291,101,5,96
217040,36,20,20,0,20,20,0,,,
217059,36,2563,1126,1437,2319,988,1331,244,138,106
217077,36,262,86,176,262,86,176,,,
217156,36,5332,2560,2772,5283,2535,2748,49,25,24
217165,36,2307,1439,868,2284,1425,859,23,14,9
217235,36,3284,1308,1976,3007,1192,1815,277,116,161
217305,36,1240,736,504,1024,613,411,216,123,93
217323,36,130,116,14,130,116,14,,,
217402,36,3006,1330,1676,2906,1285,1621,100,45,55
217420,36,3990,1189,2801,3033,904,2129,957,285,672
217475,36,7711,2831,4880,2315,998,1317,5396,1833,3563
217484,36,9840,4298,5542,8895,3865,5030,945,433,512
217493,36,1522,513,1009,1522,513,1009,,,
217518,36,2923,1474,1449,2643,1327,1316,280,147,133
217536,36,1519,481,1038,1453,462,991,66,19,47
217581,36,98,2,96,60,1,59,38,1,37
217606,36,163,93,70,120,66,54,43,27,16
217615,36,1082,351,731,352,134,218,730,217,513
217624,36,397,233,164,383,222,161,14,11,3
217633,36,1978,632,1346,1850,594,1256,128,38,90
217688,36,1734,594,1140,1550,524,1026,184,70,114
217712,36,1102,262,840,258,85,173,844,177,667
217721,36,1262,516,746,1251,512,739,11,4,7
217749,36,1749,796,953,1625,744,881,124,52,72
217776,36,688,221,467,496,182,314,192,39,153
217794,36,94,0,94,63,0,63,31,0,31
217819,36,6659,2290,4369,6132,2045,4087,527,245,282
217828,36,16,2,14,9,1,8,7,1,6
217837,36,666,160,506,154,44,110,512,116,396
217864,36,2017,1759,258,1878,1659,219,139,100,39
217873,36,1395,398,997,1319,380,939,76,18,58
217882,36,15475,7829,7646,14781,7377,7404,694,452,242
217891,36,95,44,51,90,42,48,5,2,3
217907,36,563,219,344,535,212,323,28,7,21
217925,36,488,233,255,355,180,175,133,53,80
217934,36,607,66,541,388,18,370,219,48,171
217961,36,446,10,436,410,7,403,36,3,33
217989,36,199,49,150,112,36,76,87,13,74
217998,36,401,244,157,392,240,152,9,4,5
218025,36,1645,520,1125,550,248,302,1095,272,823
218061,36,1974,653,1321,1809,603,1206,165,50,115
218070,36,1627,632,995,1611,620,991,16,12,4
218113,36,5698,2104,3594,2299,979,1320,3399,1125,2274
218140,36,3803,1182,2621,1745,660,1085,2058,522,1536
218159,36,105,2,103,81,1,80,24,1,23
218195,36,92,3,89,54,3,51,38,0,38
218229,36,2237,708,1529,2088,659,1429,149,49,100
218238,36,1238,555,683,927,438,489,311,117,194
218335,36,191,18,173,182,18,164,9,0,9
218353,36,4882,1682,3200,1790,789,1001,3092,893,2199
218399,36,282,111,171,274,107,167,8,4,4
218414,36,831,474,357,813,468,345,18,6,12
218441,36,1056,487,569,1001,461,540,55,26,29
218487,36,1072,249,823,322,131,191,750,118,632
218520,36,2490,651,1839,809,275,534,1681,376,1305
218539,36,682,331,351,674,327,347,8,4,4
218645,36,1933,675,1258,1579,559,1020,354,116,238
218654,36,1177,359,818,992,306,686,185,53,132
218663,36,18857,8658,10199,17955,8158,9797,902,500,402
218672,36,286,124,162,205,98,107,81,26,55
218681,36,224,90,134,166,74,92,58,16,42
218690,36,252,111,141,160,68,92,92,43,49
218706,36,98,41,57,78,34,44,20,7,13
218724,36,6121,2753,3368,5683,2524,3159,438,229,209
218733,36,1381,609,772,1223,528,695,158,81,77
218742,36,3217,1035,2182,2739,844,1895,478,191,287
218821,36,474,218,256,454,208,246,20,10,10
218830,36,2868,1035,1833,1248,508,740,1620,527,1093
218858,36,1561,430,1131,396,161,235,1165,269,896
218885,36,2590,1068,1522,1096,544,552,1494,524,970
218894,36,5857,2087,3770,2094,840,1254,3763,1247,2516
218919,36,291,114,177,243,97,146,48,17,31
218955,36,256,38,218,48,8,40,208,30,178
218964,36,2702,880,1822,2492,801,1691,210,79,131
218973,36,1278,601,677,1264,589,675,14,12,2
218991,36,2105,752,1353,936,401,535,1169,351,818
219000,36,1122,414,708,1078,392,686,44,22,22
219037,36,11,0,11,11,0,11,,,
219046,36,1401,469,932,1082,364,718,319,105,214
219082,36,1356,926,430,915,651,264,441,275,166
219091,36,456,198,258,419,196,223,37,2,35
219125,36,69,4,65,61,3,58,8,1,7
219143,36,788,406,382,607,362,245,181,44,137
219170,36,24,2,22,24,2,22,,,
219189,36,445,273,172,323,211,112,122,62,60
219198,36,413,194,219,356,167,189,57,27,30
219204,36,733,325,408,107,60,47,626,265,361
219240,36,16,10,6,7,2,5,9,8,1
219259,36,929,371,558,731,305,426,198,66,132
219277,36,1152,310,842,512,145,367,640,165,475
219295,36,364,122,242,220,103,117,144,19,125
219338,36,17,1,16,17,1,16,,,
219347,36,1409,1073,336,1159,882,277,250,191,59
219356,36,6210,2898,3312,5241,2467,2774,969,431,538
219374,36,374,74,300,140,30,110,234,44,190
219383,36,899,319,580,803,289,514,96,30,66
219392,36,28,7,21,28,7,21,,,
219408,36,84,29,55,45,19,26,39,10,29
219426,36,703,302,401,381,213,168,322,89,233
219453,36,100,1,99,100,1,99,,,
219471,36,3769,1403,2366,3055,1140,1915,714,263,451
219480,36,490,179,311,326,137,189,164,42,122
219505,36,40,22,18,27,12,15,13,10,3
219587,36,34,0,34,34,0,34,,,
219596,36,168,116,52,168,116,52,,,
219602,36,5384,2065,3319,3804,1422,2382,1580,643,937
219639,36,660,60,600,211,23,188,449,37,412
219709,36,4752,1644,3108,4533,1560,2973,219,84,135
219718,36,1234,544,690,997,452,545,237,92,145
219790,36,597,276,321,471,234,237,126,42,84
219806,36,1114,458,656,1075,441,634,39,17,22
219824,36,3346,1157,2189,1652,640,1012,1694,517,1177
219833,36,912,402,510,866,375,491,46,27,19
219851,36,87,2,85,87,2,85,,,
219879,36,1302,529,773,654,306,348,648,223,425
219888,36,2540,890,1650,1456,578,878,1084,312,772
219903,36,991,78,913,991,78,913,,,
219921,36,206,126,80,141,90,51,65,36,29
219949,36,1144,457,687,1061,426,635,83,31,52
219976,36,2064,799,1265,1903,730,1173,161,69,92
219994,36,508,308,200,473,277,196,35,31,4
220002,36,26,2,24,26,2,24,,,
220057,36,1271,317,954,557,184,373,714,133,581
220075,36,6775,2654,4121,5671,2214,3457,1104,440,664
220118,36,40,3,37,40,3,37,,,
220127,36,351,188,163,325,166,159,26,22,4
220163,36,26,1,25,13,0,13,13,1,12
220181,36,604,202,402,571,191,380,33,11,22
220206,36,192,103,89,126,68,58,66,35,31
220215,36,973,437,536,933,425,508,40,12,28
220251,36,58,36,22,55,33,22,3,3,0
220279,36,207,146,61,148,101,47,59,45,14
220321,36,310,144,166,294,142,152,16,2,14
220394,36,139,83,56,136,81,55,3,2,1
220400,36,1726,468,1258,758,257,501,968,211,757
220464,36,125,55,70,25,12,13,100,43,57
220473,36,460,223,237,394,182,212,66,41,25
220491,36,269,8,261,198,8,190,71,0,71
220516,36,881,306,575,775,271,504,106,35,71
220552,36,2780,403,2377,2115,314,1801,665,89,576
220598,36,676,338,338,620,308,312,56,30,26
220604,36,475,157,318,406,133,273,69,24,45
220613,36,2571,972,1599,2224,798,1426,347,174,173
220631,36,1050,292,758,768,262,506,282,30,252
220640,36,274,134,140,221,97,124,53,37,16
220701,36,445,189,256,426,182,244,19,7,12
220710,36,626,273,353,610,267,343,16,6,10
220756,36,68,55,13,66,53,13,2,2,0
220765,36,47,9,38,36,6,30,11,3,8
220853,36,689,476,213,552,367,185,137,109,28
220862,36,10838,4265,6573,7834,3149,4685,3004,1116,1888
220978,36,13209,5984,7225,10873,4915,5958,2336,1069,1267
221050,36,479,366,113,406,302,104,73,64,9
221096,36,2201,725,1476,1064,377,687,1137,348,789
221102,36,386,266,120,305,195,110,81,71,10
221148,36,1164,1092,72,1164,1092,72,,,
221184,36,3556,1216,2340,1363,521,842,2193,695,1498
221236,36,255,155,100,196,136,60,59,19,40
221281,36,126,61,65,111,54,57,15,7,8
221333,36,207,136,71,148,82,66,59,54,5
221351,36,1385,581,804,1380,577,803,5,4,1
221388,36,137,39,98,110,32,78,27,7,20
221397,36,2176,671,1505,1043,379,664,1133,292,841
221430,36,294,196,98,191,130,61,103,66,37
221485,36,4184,1300,2884,1698,602,1096,2486,698,1788
221494,36,336,256,80,279,228,51,57,28,29
221519,36,1236,581,655,1235,580,655,1,1,0
221582,36,138,81,57,124,74,50,14,7,7
221591,36,289,188,101,275,177,98,14,11,3
221607,36,296,224,72,153,99,54,143,125,18
221616,36,380,253,127,365,244,121,15,9,6
221625,36,565,314,251,542,300,242,23,14,9
221643,36,4211,2015,2196,1870,912,958,2341,1103,1238
221661,36,1605,732,873,1420,650,770,185,82,103
221731,36,654,239,415,598,214,384,56,25,31
221740,36,7082,3002,4080,6197,2590,3607,885,412,473
221759,36,17526,8343,9183,16562,7785,8777,964,558,406
221768,36,3348,1332,2016,3012,1209,1803,336,123,213
221829,36,206,7,199,206,7,199,,,
221838,36,3725,1312,2413,2980,1045,1935,745,267,478
221847,36,5799,3127,2672,5232,2788,2444,567,339,228
221892,36,1313,490,823,985,386,599,328,104,224
221908,36,2792,1281,1511,1453,644,809,1339,637,702
221953,36,761,340,421,681,308,373,80,32,48
221971,36,1441,476,965,1238,410,828,203,66,137
221999,36,5238,2553,2685,5178,2516,2662,60,37,23
222053,36,3672,1275,2397,1821,674,1147,1851,601,1250
222062,36,2307,767,1540,1288,499,789,1019,268,751
222105,36,206,192,14,85,79,6,121,113,8
222178,36,2188,854,1334,2091,808,1283,97,46,51
222567,36,2212,858,1354,420,164,256,1792,694,1098
222576,36,5613,1789,3824,2084,751,1333,3529,1038,2491
222628,36,143,47,96,31,16,15,112,31,81
222822,36,1883,551,1332,717,225,492,1166,326,840
222831,36,3753,1622,2131,3224,1350,1874,529,272,257
222877,36,86,50,36,81,50,31,5,0,5
222886,36,88,2,86,85,2,83,3,0,3
222938,36,261,111,150,184,82,102,77,29,48
222983,36,894,409,485,890,408,482,4,1,3
222992,36,18843,7374,11469,4054,1886,2168,14789,5488,9301
223056,36,31,2,29,31,2,29,,,
223083,36,367,63,304,98,16,82,269,47,222
223117,36,32,25,7,,,,32,25,7
223232,36,10467,4128,6339,10227,4024,6203,240,104,136
223320,36,1748,629,1119,592,242,350,1156,387,769
223427,36,7972,3766,4206,3523,1771,1752,4449,1995,2454
223463,36,252,73,179,252,73,179,,,
223472,36,149,12,137,149,12,137,,,
223506,36,2017,926,1091,273,129,144,1744,797,947
223816,36,3699,1463,2236,462,166,296,3237,1297,1940
223852,36,9,1,8,9,1,8,,,
223898,36,1777,606,1171,647,231,416,1130,375,755
223922,36,434,208,226,216,97,119,218,111,107
224004,36,1285,407,878,1081,353,728,204,54,150
224013,36,31,2,29,31,2,29,,,
224110,36,3092,1197,1895,746,310,436,2346,887,1459
224147,36,5369,2097,3272,3808,1425,2383,1561,672,889
224156,36,327,7,320,322,7,315,5,0,5
224226,36,1871,802,1069,1463,634,829,408,168,240
224244,36,112,66,46,96,57,39,16,9,7
224271,36,245,62,183,244,61,183,1,1,0
224323,36,994,439,555,963,426,537,31,13,18
224350,36,8684,3515,5169,1152,490,662,7532,3025,4507
224527,36,800,368,432,723,339,384,77,29,48
224545,36,1209,435,774,848,323,525,361,112,249
224554,36,5597,2226,3371,3906,1570,2336,1691,656,1035
224615,36,33090,12380,20710,7572,3128,4444,25518,9252,16266
224642,36,19597,7812,11785,3972,1665,2307,15625,6147,9478
224660,36,451,230,221,343,187,156,108,43,65
224679,36,948,828,120,598,519,79,350,309,41
224758,36,15,1,14,10,0,10,5,1,4
224776,36,212,90,122,132,56,76,80,34,46
224828,36,48,0,48,35,0,35,13,0,13
224891,36,427,203,224,278,140,138,149,63,86
224961,36,1059,307,752,327,132,195,732,175,557
225070,36,1845,665,1180,722,247,475,1123,418,705
225201,36,592,377,215,592,377,215,,,
225247,36,992,465,527,945,444,501,47,21,26
225308,36,3490,1394,2096,915,355,560,2575,1039,1536
225371,36,1250,422,828,484,193,291,766,229,537
225399,36,1730,571,1159,1284,426,858,446,145,301
225414,36,5096,1853,3243,2333,850,1483,2763,1003,1760
225423,36,27411,10327,17084,7303,3057,4246,20108,7270,12838
225432,36,10138,3697,6441,4540,1663,2877,5598,2034,3564
225502,36,2370,810,1560,1064,386,678,1306,424,882
225511,36,27626,13817,13809,19376,9405,9971,8250,4412,3838
225520,36,1169,307,862,521,171,350,648,136,512
225548,36,459,241,218,414,218,196,45,23,22
225575,36,731,264,467,660,237,423,71,27,44
225627,36,3365,1222,2143,2717,954,1763,648,268,380
225876,36,102,47,55,91,45,46,11,2,9
225885,36,543,225,318,453,195,258,90,30,60
225991,36,80,47,33,80,47,33,,,
226019,36,2118,757,1361,1045,454,591,1073,303,770
226091,36,5692,2282,3410,2866,1200,1666,2826,1082,1744
226107,36,1068,281,787,519,147,372,549,134,415
226116,36,1785,644,1141,465,169,296,1320,475,845
226125,36,84,5,79,84,5,79,,,
226134,36,6627,2681,3946,1149,425,724,5478,2256,3222
226152,36,4726,1779,2947,3726,1393,2333,1000,386,614
226204,36,5856,2936,2920,669,364,305,5187,2572,2615
226231,36,1182,724,458,938,628,310,244,96,148
226277,36,997,922,75,997,922,75,,,
226383,36,832,318,514,738,283,455,94,35,59
226408,36,1774,631,1143,407,159,248,1367,472,895
226471,36,2137,688,1449,1959,624,1335,178,64,114
226578,36,4019,1106,2913,1394,456,938,2625,650,1975
226587,36,684,323,361,590,284,306,94,39,55
226675,36,377,49,328,377,49,328,,,
226806,36,3814,1466,2348,860,318,542,2954,1148,1806
226833,36,3546,1255,2291,2565,949,1616,981,306,675
226860,36,31,1,30,31,1,30,,,
226879,36,149,23,126,82,12,70,67,11,56
226903,36,464,202,262,464,202,262,,,
227058,36,77,0,77,77,0,77,,,
227146,36,5144,1882,3262,1341,537,804,3803,1345,2458
227182,36,34730,13108,21622,9461,4000,5461,25269,9108,16161
227216,36,22915,10705,12210,17161,7831,9330,5754,2874,2880
227225,36,1204,366,838,641,201,440,563,165,398
227298,36,79,76,3,79,76,3,,,
227304,36,2963,933,2030,1396,470,926,1567,463,1104
227313,36,160,1,159,66,0,66,94,1,93
227322,36,157,1,156,81,1,80,76,0,76
227331,36,799,239,560,712,216,496,87,23,64
227368,36,19574,8007,11567,14419,5694,8725,5155,2313,2842
227377,36,2761,1168,1593,1136,519,617,1625,649,976
227386,36,1028,245,783,469,151,318,559,94,465
227401,36,1471,492,979,692,257,435,779,235,544
227429,36,298,121,177,253,101,152,45,20,25
227526,36,6071,2016,4055,5336,1753,3583,735,263,472
227687,36,1070,402,668,397,167,230,673,235,438
227748,36,217,195,22,164,151,13,53,44,9
227757,36,2994,1578,1416,2904,1535,1369,90,43,47
227845,36,2023,759,1264,1846,687,1159,177,72,105
227854,36,6701,2475,4226,711,322,389,5990,2153,3837
227863,36,1870,707,1163,1525,495,1030,345,212,133
227881,36,12996,4800,8196,9960,3651,6309,3036,1149,1887
227924,36,10410,3713,6697,1655,617,1038,8755,3096,5659
227979,36,16624,6297,10327,4006,1635,2371,12618,4662,7956
228042,36,657,296,361,602,287,315,55,9,46
228088,36,10,0,10,10,0,10,,,
228149,36,1385,603,782,1312,562,750,73,41,32
228158,36,4804,1805,2999,2447,1055,1392,2357,750,1607
228185,36,14,12,2,14,12,2,,,
228200,36,246,126,120,234,125,109,12,1,11
228219,36,352,101,251,335,96,239,17,5,12
228246,36,5041,2599,2442,4882,2519,2363,159,80,79
228282,36,1,1,0,1,1,0,,,
228316,36,2054,683,1371,581,207,374,1473,476,997
228325,36,1037,483,554,853,407,446,184,76,108
228343,36,1096,496,600,1077,484,593,19,12,7
228431,36,6935,2513,4422,5897,2127,3770,1038,386,652
228459,36,23413,9538,13875,18013,7121,10892,5400,2417,2983
228468,36,493,192,301,445,170,275,48,22,26
228486,36,41,26,15,33,21,12,8,5,3
228501,36,1202,429,773,670,298,372,532,131,401
228529,36,8177,2953,5224,5744,2034,3710,2433,919,1514
228547,36,28703,11224,17479,3803,1766,2037,24900,9458,15442
228608,36,1370,405,965,515,174,341,855,231,624
228644,36,450,125,325,359,88,271,91,37,54
228653,36,451,76,375,346,55,291,105,21,84
228699,36,2190,798,1392,484,174,310,1706,624,1082
228705,36,3458,1724,1734,2782,1418,1364,676,306,370
228723,36,40836,21753,19083,36219,19122,17097,4617,2631,1986
228769,36,23452,8996,14456,12886,5739,7147,10566,3257,7309
228778,36,29498,13028,16470,27263,11848,15415,2235,1180,1055
228787,36,15425,8836,6589,12649,7162,5487,2776,1674,1102
228796,36,15385,6787,8598,9640,4253,5387,5745,2534,3211
228802,36,4619,1806,2813,3060,1239,1821,1559,567,992
228875,36,7222,2933,4289,7044,2839,4205,178,94,84
228884,36,475,249,226,418,220,198,57,29,28
228981,36,1040,450,590,994,433,561,46,17,29
229018,36,2690,1095,1595,1683,694,989,1007,401,606
229027,36,20450,9972,10478,15126,7113,8013,5324,2859,2465
229063,36,3952,1438,2514,3216,1153,2063,736,285,451
229115,36,23208,12116,11092,20199,10421,9778,3009,1695,1314
229160,36,935,393,542,805,359,446,130,34,96
229179,36,6474,629,5845,4521,429,4092,1953,200,1753
229267,36,1826,894,932,1788,873,915,38,21,17
229300,36,574,73,501,452,54,398,122,19,103
229337,36,1205,161,1044,985,133,852,220,28,192
229355,36,5574,1775,3799,2514,912,1602,3060,863,2197
229416,36,1038,973,65,1038,973,65,,,
229425,36,119,0,119,25,0,25,94,0,94
229504,36,1896,588,1308,371,131,240,1525,457,1068
229522,36,38,7,31,18,3,15,20,4,16
229540,36,1800,509,1291,396,166,230,1404,343,1061
229656,36,229,6,223,193,3,190,36,3,33
229780,36,1929,867,1062,1053,478,575,876,389,487
229799,36,2571,696,1875,761,258,503,1810,438,1372
229814,36,4751,1950,2801,3454,1386,2068,1297,564,733
229832,36,250,127,123,170,75,95,80,52,28
229841,36,3333,1380,1953,1154,540,614,2179,840,1339
229887,36,417,167,250,361,149,212,56,18,38
230010,36,1277,714,563,414,179,235,863,535,328
230038,36,25422,12707,12715,22316,11149,11167,3106,1558,1548
230047,36,2042,834,1208,1918,784,1134,124,50,74
230056,36,79,14,65,67,8,59,12,6,6
230065,36,166,2,164,1,0,1,165,2,163
230144,36,4,0,4,4,0,4,,,
230162,36,1693,1032,661,318,115,203,1375,917,458
230171,36,5528,2329,3199,4084,1699,2385,1444,630,814
230199,36,22,7,15,22,7,15,,,
230205,36,37,4,33,36,3,33,1,1,0
230214,36,297,39,258,108,8,100,189,31,158
230366,36,211,22,189,211,22,189,,,
230418,36,804,466,338,485,295,190,319,171,148
230490,36,1550,891,659,262,98,164,1288,793,495
230597,36,1736,793,943,1383,657,726,353,136,217
230603,36,6033,2731,3302,5121,2302,2819,912,429,483
230676,36,169,101,68,46,24,22,123,77,46
230728,36,15022,7042,7980,11568,5495,6073,3454,1547,1907
230737,36,20263,10953,9310,12462,6643,5819,7801,4310,3491
230746,36,12649,5797,6852,3230,1530,1700,9419,4267,5152
230764,36,17874,9361,8513,13984,7282,6702,3890,2079,1811
230782,36,11931,5217,6714,7363,3253,4110,4568,1964,2604
230807,36,907,329,578,880,312,568,27,17,10
230816,36,470,180,290,438,150,288,32,30,2
230834,36,1113,488,625,946,434,512,167,54,113
230852,36,2561,1525,1036,1659,1038,621,902,487,415
230861,36,2054,494,1560,316,111,205,1738,383,1355
230889,36,110,32,78,98,28,70,12,4,8
230913,36,927,387,540,631,297,334,296,90,206
230959,36,2149,994,1155,2135,990,1145,14,4,10
230995,36,2100,1562,538,1689,1191,498,411,371,40
231004,36,32,5,27,32,5,27,,,
231059,36,1079,504,575,1059,491,568,20,13,7
231095,36,70,34,36,62,29,33,8,5,3
231165,36,698,343,355,324,222,102,374,121,253
231174,36,7799,3079,4720,7516,2930,4586,283,149,134
231280,36,99,1,98,82,0,82,17,1,16
231411,36,304,280,24,304,280,24,,,
231420,36,757,396,361,658,349,309,99,47,52
231536,36,1568,600,968,464,211,253,1104,389,715
231554,36,468,231,237,424,216,208,44,15,29
231581,36,977,447,530,966,440,526,11,7,4
231624,36,4644,1912,2732,4584,1884,2700,60,28,32
231651,36,2967,1165,1802,1662,655,1007,1305,510,795
231688,36,17,0,17,10,0,10,7,0,7
231697,36,1278,492,786,385,168,217,893,324,569
231712,36,3314,1502,1812,3238,1456,1782,76,46,30
231721,36,7,0,7,,,,7,0,7
231785,36,871,122,749,444,88,356,427,34,393
231873,36,353,110,243,163,63,100,190,47,143
231882,36,875,295,580,398,189,209,477,106,371
232016,36,99,21,78,52,13,39,47,8,39
232025,36,636,301,335,617,286,331,19,15,4
232043,36,650,266,384,572,240,332,78,26,52
232052,36,269,89,180,71,26,45,198,63,135
232089,36,598,335,263,584,330,254,14,5,9
232186,36,19712,9993,9719,15156,7521,7635,4556,2472,2084
232195,36,3523,1191,2332,1100,451,649,2423,740,1683
232256,36,616,614,2,607,605,2,9,9,0
232265,36,2172,762,1410,2036,717,1319,136,45,91
232308,36,466,0,466,460,0,460,6,0,6
232414,36,3876,1382,2494,1111,452,659,2765,930,1835
232423,36,14209,5946,8263,13253,5481,7772,956,465,491
232450,36,3678,1473,2205,1058,457,601,2620,1016,1604
232557,36,37088,15886,21202,22663,9427,13236,14425,6459,7966
232566,36,2344,709,1635,2162,648,1514,182,61,121
232575,36,2071,632,1439,557,212,345,1514,420,1094
232609,36,1178,454,724,1150,441,709,28,13,15
232618,36,210,21,189,26,0,26,184,21,163
232672,36,1021,193,828,802,163,639,219,30,189
232681,36,2727,962,1765,2288,798,1490,439,164,275
232706,36,1349,496,853,1228,444,784,121,52,69
232724,36,19,0,19,19,0,19,,,
232788,36,872,261,611,425,146,279,447,115,332
232797,36,606,75,531,170,26,144,436,49,387
232867,36,1263,574,689,541,274,267,722,300,422
232885,36,221,19,202,196,19,177,25,0,25
232919,36,340,291,49,250,213,37,90,78,12
232937,36,3538,1104,2434,3128,986,2142,410,118,292
232946,36,23349,10896,12453,7923,3942,3981,15426,6954,8472
232982,36,13730,6028,7702,9828,4331,5497,3902,1697,2205
233019,36,864,304,560,368,146,222,496,158,338
233037,36,366,93,273,113,49,64,253,44,209
233082,36,58,4,54,6,0,6,52,4,48
233116,36,2000,745,1255,434,222,212,1566,523,1043
233277,36,4566,1733,2833,4204,1566,2638,362,167,195
233286,36,121,14,107,76,5,71,45,9,36
233295,36,1108,505,603,1072,483,589,36,22,14
233301,36,316,121,195,312,117,195,4,4,0
233310,36,858,188,670,180,61,119,678,127,551
233329,36,369,26,343,369,26,343,,,
233338,36,360,135,225,321,120,201,39,15,24
233356,36,335,23,312,258,22,236,77,1,76
233374,36,2161,1033,1128,2060,988,1072,101,45,56
233408,36,317,32,285,268,28,240,49,4,45
233426,36,1307,574,733,1281,556,725,26,18,8
233480,36,33,7,26,33,7,26,,,
233541,36,1502,598,904,1420,570,850,82,28,54
233602,36,39,24,15,36,21,15,3,3,0
233611,36,649,343,306,610,327,283,39,16,23
233639,36,1168,265,903,314,57,257,854,208,646
233648,36,999,301,698,541,189,352,458,112,346
233666,36,5,0,5,3,0,3,2,0,2
233684,36,2141,701,1440,362,211,151,1779,490,1289
233718,36,251,0,251,247,0,247,4,0,4
233754,36,2990,1102,1888,930,395,535,2060,707,1353
233772,36,9432,3490,5942,3138,1245,1893,6294,2245,4049
233897,36,699,341,358,668,326,342,31,15,16
233903,36,1074,369,705,423,174,249,651,195,456
233921,36,22048,12690,9358,21274,12163,9111,774,527,247
233949,36,2299,876,1423,794,317,477,1505,559,946
234030,36,15242,5714,9528,13133,4817,8316,2109,897,1212
234076,36,12387,5424,6963,11827,5172,6655,560,252,308
234085,36,1195,1026,169,1195,1026,169,,,
234119,36,19,8,11,7,3,4,12,5,7
234137,36,62,45,17,50,40,10,12,5,7
234155,36,2668,1110,1558,2487,1030,1457,181,80,101
234164,36,805,389,416,733,358,375,72,31,41
234173,36,775,299,476,703,277,426,72,22,50
234207,36,1357,652,705,1354,650,704,3,2,1
234377,36,766,189,577,290,105,185,476,84,392
234669,36,6867,3013,3854,3783,1721,2062,3084,1292,1792
234696,36,1059,505,554,693,377,316,366,128,238
234711,36,1179,439,740,831,317,514,348,122,226
234827,36,7180,3408,3772,6175,2928,3247,1005,480,525
234845,36,1027,419,608,703,273,430,324,146,178
234915,36,774,355,419,74,50,24,700,305,395
234924,36,230,24,206,230,24,206,,,
234933,36,3871,1446,2425,2124,811,1313,1747,635,1112
234951,36,1043,453,590,790,359,431,253,94,159
234979,36,4021,1476,2545,2281,864,1417,1740,612,1128
235024,36,296,93,203,285,88,197,11,5,6
235088,36,75,72,3,75,72,3,,,
235097,36,5426,2403,3023,4729,2064,2665,697,339,358
235103,36,2453,1118,1335,1244,589,655,1209,529,680
235149,36,4582,1853,2729,2321,972,1349,2261,881,1380
235158,36,81,18,63,81,18,63,,,
235167,36,1271,487,784,1127,439,688,144,48,96
235237,36,4072,1366,2706,2578,857,1721,1494,509,985
235307,36,26,2,24,26,2,24,,,
235316,36,3488,1603,1885,3429,1576,1853,59,27,32
235334,36,997,461,536,647,284,363,350,177,173
235343,36,4613,2228,2385,2799,1373,1426,1814,855,959
235352,36,98,22,76,98,22,76,,,
235422,36,528,126,402,482,108,374,46,18,28
235431,36,2896,1072,1824,1641,598,1043,1255,474,781
235501,36,37,21,16,37,21,16,,,
235547,36,26,5,21,21,5,16,5,0,5
235583,36,63,2,61,63,2,61,,,
235671,36,486,226,260,355,189,166,131,37,94
235699,36,1156,521,635,724,355,369,432,166,266
235750,36,1292,383,909,814,237,577,478,146,332
236018,36,39,4,35,39,4,35,,,
236072,36,1479,601,878,597,280,317,882,321,561
236133,36,533,185,348,517,177,340,16,8,8
236188,36,2700,1038,1662,1703,656,1047,997,382,615
236212,36,596,496,100,596,496,100,,,
236230,36,1731,631,1100,1672,602,1070,59,29,30
236258,36,832,326,506,493,169,324,339,157,182
236328,36,1422,567,855,1391,555,836,31,12,19
236382,36,754,354,400,447,218,229,307,136,171
236452,36,878,361,517,798,317,481,80,44,36
236504,36,1068,567,501,613,353,260,455,214,241
236513,36,1758,695,1063,1127,459,668,631,236,395
236577,36,1842,598,1244,1752,547,1205,90,51,39
236595,36,2894,1184,1710,2771,1126,1645,123,58,65
236610,36,1972,759,1213,952,404,548,1020,355,665
236638,36,1995,707,1288,1216,463,753,779,244,535
236656,36,2676,1045,1631,1531,630,901,1145,415,730
236692,36,3182,1237,1945,2212,919,1293,970,318,652
236708,36,2258,860,1398,1563,601,962,695,259,436
236744,36,20,1,19,20,1,19,,,
236753,36,3244,1088,2156,1940,704,1236,1304,384,920
236887,36,1458,658,800,951,411,540,507,247,260
236896,36,988,502,486,913,462,451,75,40,35
236939,36,17570,8141,9429,15352,7161,8191,2218,980,1238
236948,36,22564,10047,12517,20958,9272,11686,1606,775,831
236975,36,1641,609,1032,1220,463,757,421,146,275
237011,36,9961,4320,5641,8587,3604,4983,1374,716,658
237039,36,2503,1058,1445,1279,572,707,1224,486,738
237057,36,1040,427,613,1025,420,605,15,7,8
237066,36,1668,663,1005,1628,644,984,40,19,21
237109,36,2269,607,1662,1518,405,1113,751,202,549
237118,36,388,219,169,360,210,150,28,9,19
237127,36,9,0,9,9,0,9,,,
237136,36,127,68,59,98,42,56,29,26,3
237145,36,18,2,16,18,2,16,,,
237172,36,17,14,3,17,14,3,,,
237181,36,339,177,162,339,177,162,,,
237215,36,843,297,546,558,204,354,285,93,192
237242,36,33,31,2,33,31,2,,,
237303,36,30,10,20,30,10,20,,,
237312,36,1579,944,635,807,360,447,772,584,188
237321,36,35,3,32,35,3,32,,,
237330,36,849,323,526,797,304,493,52,19,33
237358,36,449,169,280,443,168,275,6,1,5
237367,36,2062,850,1212,1715,732,983,347,118,229
237385,36,738,437,301,583,313,270,155,124,31
237437,36,114,18,96,103,17,86,11,1,10
237473,36,91,52,39,91,52,39,,,
237491,36,1,0,1,1,0,1,,,
237525,36,5138,2129,3009,4562,1879,2683,576,250,326
237543,36,65,19,46,45,9,36,20,10,10
237561,36,44,12,32,44,12,32,,,
237570,36,56,1,55,56,1,55,,,
237598,36,17,0,17,17,0,17,,,
237686,36,1093,400,693,633,255,378,460,145,315
237701,36,578,288,290,471,220,251,107,68,39
237729,36,69,15,54,49,7,42,20,8,12
237783,36,405,163,242,383,157,226,22,6,16
237792,36,1630,659,971,1417,569,848,213,90,123
237817,36,765,217,548,506,142,364,259,75,184
237844,36,15,9,6,15,9,6,,,
237899,36,950,428,522,811,363,448,139,65,74
237905,36,55,12,43,55,12,43,,,
237932,36,1168,409,759,1105,387,718,63,22,41
237950,36,740,428,312,683,399,284,57,29,28
237969,36,642,290,352,632,285,347,10,5,5
237987,36,102,10,92,102,10,92,,,
237996,36,354,63,291,354,63,291,,,
238005,36,44,4,40,44,4,40,,,
238014,36,519,164,355,229,89,140,290,75,215
238032,36,13839,6728,7111,13095,6353,6742,744,375,369
238078,36,384,214,170,294,174,120,90,40,50
238096,36,15,1,14,15,1,14,,,
238175,36,95,2,93,95,2,93,,,
238193,36,656,11,645,517,6,511,139,5,134
238263,36,6612,2517,4095,1911,864,1047,4701,1653,3048
238324,36,229,18,211,141,14,127,88,4,84
238333,36,648,301,347,647,300,347,1,1,0
238397,36,1653,502,1151,364,129,235,1289,373,916
238430,36,463,165,298,336,127,209,127,38,89
238458,36,2013,599,1414,1902,559,1343,111,40,71
238476,36,1771,773,998,1730,750,980,41,23,18
238616,36,1985,736,1249,1608,639,969,377,97,280
238661,36,816,216,600,722,190,532,94,26,68
238722,36,3535,2110,1425,919,535,384,2616,1575,1041
238759,36,3366,1253,2113,714,318,396,2652,935,1717
238810,36,61,4,57,39,1,38,22,3,19
238980,36,1095,453,642,527,233,294,568,220,348
239008,36,1287,586,701,239,115,124,1048,471,577
239017,36,1051,477,574,1037,468,569,14,9,5
239071,36,393,163,230,317,131,186,76,32,44
239080,36,840,273,567,716,239,477,124,34,90
239105,36,5671,2482,3189,5576,2431,3145,95,51,44
239220,36,1516,650,866,349,180,169,1167,470,697
239248,36,7713,3077,4636,1701,767,934,6012,2310,3702
239309,36,643,171,472,628,167,461,15,4,11
239318,36,1743,1260,483,1691,1219,472,52,41,11
239372,36,1684,560,1124,446,194,252,1238,366,872
239390,36,419,0,419,383,0,383,36,0,36
239442,36,522,150,372,118,39,79,404,111,293
239460,36,1302,468,834,417,177,240,885,291,594
239488,36,5454,1915,3539,1290,595,695,4164,1320,2844
239512,36,368,171,197,363,168,195,5,3,2
239628,36,534,265,269,534,265,269,,,
239716,36,1311,527,784,1292,514,778,19,13,6
239877,36,26,0,26,25,0,25,1,0,1
239910,36,504,178,326,257,92,165,247,86,161
240107,36,1177,274,903,940,222,718,237,52,185
240116,36,2777,966,1811,1106,502,604,1671,464,1207
240125,36,3472,1906,1566,1043,566,477,2429,1340,1089
240170,36,2425,1022,1403,790,384,406,1635,638,997
240189,36,6680,3410,3270,5890,3023,2867,790,387,403
240198,36,1388,407,981,421,161,260,967,246,721
240268,36,7012,2742,4270,6400,2500,3900,612,242,370
240277,36,4693,1674,3019,3325,1229,2096,1368,445,923
240329,36,6638,2856,3782,6238,2637,3601,400,219,181
240338,36,673,297,376,639,280,359,34,17,17
240365,36,6187,2625,3562,5064,2047,3017,1123,578,545
240374,36,2552,1106,1446,1941,849,1092,611,257,354
240392,36,1317,197,1120,602,112,490,715,85,630
240417,36,4719,2752,1967,3746,2191,1555,973,561,412
240426,36,1468,502,966,1095,404,691,373,98,275
240444,36,23895,11571,12324,22362,10720,11642,1533,851,682
240453,36,13745,6322,7423,11384,5154,6230,2361,1168,1193
240462,36,4606,2956,1650,3999,2538,1461,607,418,189
240471,36,3462,1181,2281,3060,1029,2031,402,152,250
240480,36,4877,2150,2727,4287,1912,2375,590,238,352
240505,36,1508,490,1018,836,305,531,672,185,487
240514,36,655,255,400,289,106,183,366,149,217
240596,36,278,101,177,159,63,96,119,38,81
240620,36,1596,509,1087,741,274,467,855,235,620
240657,36,527,187,340,316,128,188,211,59,152
240666,36,1047,390,657,565,224,341,482,166,316
240693,36,931,363,568,501,229,272,430,134,296
240709,36,11,1,10,9,1,8,2,0,2
240718,36,422,398,24,422,398,24,,,
240727,36,6349,3027,3322,5269,2577,2692,1080,450,630
240736,36,777,226,551,318,100,218,459,126,333
240745,36,1253,567,686,487,205,282,766,362,404
240754,36,2208,925,1283,1604,651,953,604,274,330
240790,36,953,341,612,717,264,453,236,77,159
240879,36,2,1,1,2,1,1,,,
241100,36,189,95,94,156,76,80,33,19,14
241128,36,191,83,108,155,67,88,36,16,20
241146,36,110,21,89,108,19,89,2,2,0
241182,36,364,75,289,364,75,289,,,
241191,36,737,281,456,632,235,397,105,46,59
241216,36,1159,734,425,647,394,253,512,340,172
241225,36,606,180,426,412,125,287,194,55,139
241304,36,1362,344,1018,716,169,547,646,175,471
241331,36,378,45,333,316,38,278,62,7,55
241377,36,493,211,282,291,128,163,202,83,119
241386,36,106,19,87,60,10,50,46,9,37
241395,36,286,95,191,228,81,147,58,14,44
241410,36,3468,1273,2195,2912,1040,1872,556,233,323
241517,36,150,40,110,112,27,85,38,13,25
241614,36,286,161,125,160,101,59,126,60,66
241720,36,550,215,335,379,146,233,171,69,102
241739,36,5006,1473,3533,2812,862,1950,2194,611,1583
241766,36,257,181,76,189,133,56,68,48,20
241836,36,657,213,444,269,89,180,388,124,264
241906,36,147,44,103,147,44,103,,,
241951,36,330,101,229,190,63,127,140,38,102
242042,36,173,77,96,165,75,90,8,2,6
242112,36,285,125,160,188,88,100,97,37,60
242121,36,211,72,139,103,29,74,108,43,65
242130,36,178,45,133,116,32,84,62,13,49
242149,36,238,67,171,177,49,128,61,18,43
242413,36,61,0,61,61,0,61,,,
242556,36,161,105,56,133,86,47,28,19,9
242565,36,72,49,23,72,49,23,,,
242583,36,128,91,37,125,90,35,3,1,2
242617,36,2111,923,1188,1751,766,985,360,157,203
242626,36,2288,909,1379,1736,668,1068,552,241,311
242635,36,2188,801,1387,1777,664,1113,411,137,274
242644,36,827,259,568,648,197,451,179,62,117
242653,36,2923,1240,1683,2142,890,1252,781,350,431
242662,36,2330,839,1491,1724,605,1119,606,234,372
242680,36,1020,383,637,788,285,503,232,98,134
242699,36,1115,320,795,871,253,618,244,67,177
242705,36,2942,1649,1293,2412,1344,1068,530,305,225
242750,36,68,21,47,68,21,47,,,
242820,36,544,424,120,544,424,120,,,
242945,36,3,1,2,2,1,1,1,0,1
242954,36,3,1,2,2,1,1,1,0,1
242972,36,14226,4975,9251,8947,3107,5840,5279,1868,3411
243106,36,1597,714,883,1406,625,781,191,89,102
243115,36,2355,847,1508,2107,750,1357,248,97,151
243133,36,2482,1205,1277,2041,1000,1041,441,205,236
243142,36,1538,546,992,1078,359,719,460,187,273
243151,36,1927,631,1296,1663,548,1115,264,83,181
243179,36,2090,696,1394,1856,613,1243,234,83,151
243188,36,310,148,162,270,129,141,40,19,21
243197,36,9115,5020,4095,8114,4408,3706,1001,612,389
243203,36,190,40,150,169,36,133,21,4,17
243212,36,1608,662,946,1421,583,838,187,79,108
243221,36,7827,2824,5003,6625,2338,4287,1202,486,716
243346,36,4459,1595,2864,2777,970,1807,1682,625,1057
243443,36,2819,991,1828,2308,780,1528,511,211,300
243568,36,72,18,54,58,14,44,14,4,10
243577,36,3005,2225,780,1145,803,342,1860,1422,438
243586,36,576,202,374,482,170,312,94,32,62
243601,36,7112,2903,4209,4567,1774,2793,2545,1129,1416
243638,36,1300,520,780,809,315,494,491,205,286
243647,36,399,172,227,206,92,114,193,80,113
243665,36,1038,280,758,653,175,478,385,105,280
243744,36,5456,2711,2745,5456,2711,2745,,,
243780,36,26380,15284,11096,24803,14350,10453,1577,934,643
243799,36,50,3,47,50,3,47,,,
243823,36,238,71,167,162,47,115,76,24,52
243832,36,850,247,603,344,109,235,506,138,368
243841,36,248,37,211,180,24,156,68,13,55
244233,36,69,18,51,15,4,11,54,14,40
244279,36,147,3,144,147,3,144,,,
244437,36,9087,3158,5929,2644,1095,1549,6443,2063,4380
244446,36,1272,396,876,293,88,205,979,308,671
244613,36,169,164,5,100,98,2,69,66,3
245281,36,65,30,35,65,30,35,,,
245625,36,588,211,377,207,90,117,381,121,260
245652,36,240,122,118,228,116,112,12,6,6
245777,36,27,27,0,27,27,0,,,
245838,36,88,28,60,38,9,29,50,19,31
245847,36,27,8,19,7,3,4,20,5,15
245883,36,81,18,63,9,5,4,72,13,59
245892,36,116,29,87,49,15,34,67,14,53
245953,36,950,329,621,824,290,534,126,39,87
245962,36,90,6,84,79,4,75,11,2,9
245980,36,16,7,9,16,7,9,,,
245999,36,315,160,155,100,45,55,215,115,100
246017,36,408,234,174,46,18,28,362,216,146
246035,36,301,47,254,301,47,254,,,
246071,36,60,9,51,60,9,51,,,
246354,36,5333,1922,3411,645,221,424,4688,1701,2987
246406,36,15,2,13,15,2,13,,,
246415,36,31,7,24,10,0,10,21,7,14
246460,36,74,6,68,74,6,68,,,
246813,36,2141,695,1446,426,157,269,1715,538,1177
246895,36,528,166,362,275,92,183,253,74,179
246974,36,198,23,175,198,23,175,,,
247010,36,11,0,11,11,0,11,,,
247047,36,48,0,48,48,0,48,,,
247065,36,620,31,589,331,18,313,289,13,276
247153,36,199,48,151,199,48,151,,,
247162,36,8,2,6,,,,8,2,6
247409,36,35,1,34,35,1,34,,,
247603,36,1161,584,577,611,315,296,550,269,281
247649,36,240,166,74,212,145,67,28,21,7
247773,36,35,35,0,35,35,0,,,
247825,36,4,3,1,,,,4,3,1
247834,36,17243,7609,9634,6232,3085,3147,11011,4524,6487
247940,36,1540,595,945,634,293,341,906,302,604
248192,36,18,0,18,18,0,18,,,
248527,36,69,0,69,69,0,69,,,
248606,36,121,93,28,21,13,8,100,80,20
248624,36,82,15,67,82,15,67,,,
248633,36,48,0,48,48,0,48,,,
248660,36,141,43,98,122,42,80,19,1,18
248703,36,74,0,74,51,0,51,23,0,23
248925,36,563,314,249,455,243,212,108,71,37
248934,36,9675,3713,5962,9675,3713,5962,,,
249061,36,36,0,36,18,0,18,18,0,18
249238,36,332,22,310,223,13,210,109,9,100
249609,36,103,58,45,103,58,45,,,
250027,36,119,46,73,119,46,73,,,
250285,36,275,250,25,191,175,16,84,75,9
250744,36,338,33,305,338,33,305,,,
250902,36,10,0,10,6,0,6,4,0,4
250993,36,428,220,208,35,12,23,393,208,185
251260,36,2110,850,1260,1005,478,527,1105,372,733
251312,36,339,47,292,214,35,179,125,12,113
260336,36,12,0,12,12,0,12,,,
260363,36,7,0,7,7,0,7,,,
260372,36,211,35,176,94,16,78,117,19,98
260664,36,63,40,23,63,40,23,,,
260691,36,622,180,442,622,180,442,,,
260789,36,508,78,430,508,78,430,,,
260813,36,201,22,179,201,22,179,,,
260929,36,175,18,157,173,18,155,2,0,2
260965,36,56,0,56,56,0,56,,,
260992,36,361,18,343,99,7,92,262,11,251
261436,36,754,50,704,754,50,704,,,
261676,36,13,0,13,13,0,13,,,
261685,36,10,2,8,10,2,8,,,
261719,36,152,1,151,152,1,151,,,
261773,36,30,4,26,29,3,26,1,1,0
261861,36,35,2,33,35,2,33,,,
262031,36,3632,1318,2314,1737,707,1030,1895,611,1284
262086,36,3994,1372,2622,1464,570,894,2530,802,1728
262129,36,441,146,295,424,139,285,17,7,10
262341,36,91,78,13,91,78,13,,,
262369,36,17,1,16,17,1,16,,,
262457,36,314,47,267,314,47,267,,,
262466,36,53,19,34,53,19,34,,,
362700,36,401,37,364,394,36,358,7,1,6
362782,36,179,5,174,55,3,52,124,2,122
363013,36,19,2,17,19,2,17,,,
363077,36,24,0,24,18,0,18,6,0,6
363147,36,382,13,369,382,13,369,,,
363165,36,124,64,60,67,38,29,57,26,31
363439,36,13,1,12,13,1,12,,,
363633,36,327,94,233,146,48,98,181,46,135
363679,36,155,2,153,128,2,126,27,0,27
363712,36,12,12,0,12,12,0,,,
363882,36,60,1,59,60,1,59,,,
363907,36,306,194,112,178,114,64,128,80,48
363916,36,101,26,75,60,14,46,41,12,29
363934,36,575,466,109,314,252,62,261,214,47
364016,36,2955,1261,1694,850,433,417,2105,828,1277
364025,36,5031,2462,2569,1779,933,846,3252,1529,1723
364548,36,57,23,34,48,17,31,9,6,3
364575,36,18,0,18,18,0,18,,,
364627,36,36,20,16,15,4,11,21,16,5
364636,36,99,20,79,88,19,69,11,1,10
364751,36,23,1,22,23,1,22,,,
364760,36,22,4,18,11,1,10,11,3,8
364946,36,83,19,64,77,17,60,6,2,4
364964,36,19,0,19,19,0,19,,,
365091,36,362,21,341,362,21,341,,,
365125,36,129,3,126,129,3,126,,,
365198,36,85,16,69,48,1,47,37,15,22
365213,36,199,87,112,86,17,69,113,70,43
365240,36,19,16,3,19,16,3,,,
365374,36,459,264,195,135,57,78,324,207,117
365383,36,98,9,89,98,9,89,,,
365480,36,179,85,94,80,18,62,99,67,32
365505,36,4,0,4,4,0,4,,,
365693,36,129,5,124,129,5,124,,,
365763,36,11,2,9,11,2,9,,,
365824,36,57,4,53,57,4,53,,,
365833,36,60,5,55,60,5,55,,,
366003,36,211,74,137,107,25,82,104,49,55
366155,36,28,16,12,28,16,12,,,
366191,36,772,746,26,772,746,26,,,
366252,36,2954,1799,1155,2324,1598,726,630,201,429
366261,36,197,64,133,189,63,126,8,1,7
366270,36,192,7,185,192,7,185,,,
366289,36,1,1,0,1,1,0,,,
366340,36,208,67,141,159,54,105,49,13,36
366395,36,10587,4480,6107,5798,2599,3199,4789,1881,2908
366401,36,4533,2099,2434,1391,690,701,3142,1409,1733
366438,36,28,3,25,16,2,14,12,1,11
366465,36,1114,305,809,440,115,325,674,190,484
366535,36,164,30,134,164,30,134,,,
366553,36,822,210,612,342,72,270,480,138,342
366571,36,21,5,16,21,5,16,,,
366623,36,28,10,18,19,3,16,9,7,2
366632,36,3,0,3,3,0,3,,,
366711,36,10502,3958,6544,8296,3033,5263,2206,925,1281
367051,36,39,1,38,26,1,25,13,0,13
367088,36,104,7,97,66,5,61,38,2,36
367103,36,72,47,25,72,47,25,,,
367112,36,178,30,148,165,26,139,13,4,9
367158,36,30,2,28,30,2,28,,,
367334,36,32,31,1,27,26,1,5,5,0
367361,36,61,39,22,59,38,21,2,1,1
367431,36,11,3,8,11,3,8,,,
367459,36,3199,1273,1926,882,365,517,2317,908,1409
367875,36,31,16,15,31,16,15,,,
367884,36,372,162,210,182,79,103,190,83,107
367972,36,105,2,103,105,2,103,,,
367981,36,68,2,66,37,2,35,31,0,31
368230,36,43,2,41,31,2,29,12,0,12
368364,36,137,75,62,36,16,20,101,59,42
368407,36,24,1,23,,,,24,1,23
368443,36,151,13,138,151,13,138,,,
368452,36,144,58,86,144,58,86,,,
368540,36,9,2,7,9,2,7,,,
368629,36,394,92,302,394,92,302,,,
368647,36,11,1,10,11,1,10,,,
368771,36,243,55,188,243,55,188,,,
368832,36,53,8,45,8,1,7,45,7,38
368911,36,696,139,557,158,38,120,538,101,437
369109,36,35,4,31,28,3,25,7,1,6
369400,36,517,498,19,517,498,19,,,
369419,36,178,105,73,178,105,73,,,
369446,36,29,0,29,26,0,26,3,0,3
369455,36,120,27,93,120,27,93,,,
369516,36,137,25,112,137,25,112,,,
369668,36,56,6,50,35,6,29,21,0,21
369686,36,20,2,18,20,2,18,,,
369695,36,44,4,40,44,4,40,,,
369783,36,246,15,231,246,15,231,,,
369950,36,147,125,22,147,125,22,,,
371052,36,246,52,194,246,52,194,,,
371690,36,780,132,648,117,16,101,663,116,547
371830,36,58,38,20,56,37,19,2,1,1
371928,36,69,23,46,69,23,46,,,
371964,36,468,321,147,468,321,147,,,
372028,36,76,15,61,76,15,61,,,
372073,36,39,7,32,39,7,32,,,
372082,36,27,13,14,27,13,14,,,
372240,36,17,2,15,16,2,14,1,0,1
372329,36,219,29,190,219,29,190,,,
372356,36,41,3,38,41,3,38,,,
372462,36,113,19,94,112,19,93,1,0,1
372718,36,302,50,252,286,48,238,16,2,14
372921,36,395,134,261,395,134,261,,,
373085,36,29,1,28,19,0,19,10,1,9
373216,36,104,7,97,104,7,97,,,
373456,36,11,0,11,10,0,10,1,0,1
373526,36,98,75,23,98,75,23,,,
373678,36,143,66,77,96,51,45,47,15,32
373696,36,20,13,7,20,13,7,,,
373711,36,47,2,45,47,2,45,,,
373784,36,389,191,198,389,191,198,,,
374316,36,53,42,11,37,28,9,16,14,2
374343,36,37,2,35,37,2,35,,,
374574,36,582,97,485,348,74,274,234,23,211
374592,36,5,0,5,5,0,5,,,
375106,36,37,30,7,28,23,5,9,7,2
375230,36,128,128,0,128,128,0,,,
375373,36,121,31,90,7,0,7,114,31,83
375407,36,54,10,44,44,9,35,10,1,9
375416,36,161,48,113,161,48,113,,,
375540,36,10,1,9,6,0,6,4,1,3
375568,36,12,9,3,4,4,0,8,5,3
375656,36,7,1,6,5,1,4,2,0,2
375683,36,67,46,21,56,36,20,11,10,1
375726,36,350,156,194,290,119,171,60,37,23
375939,36,90,11,79,90,11,79,,,
375966,36,128,13,115,71,6,65,57,7,50
375984,36,97,5,92,76,5,71,21,0,21
376224,36,115,14,101,85,10,75,30,4,26
376242,36,41,19,22,41,19,22,,,
376288,36,68,11,57,68,11,57,,,
376330,36,178,31,147,178,31,147,,,
376385,36,41,3,38,41,3,38,,,
376446,36,64,0,64,10,0,10,54,0,54
376631,36,10,3,7,9,2,7,1,1,0
376677,36,115,52,63,114,51,63,1,1,0
376695,36,823,364,459,351,142,209,472,222,250
377111,36,144,47,97,144,47,97,,,
377193,36,21,1,20,5,0,5,16,1,15
377218,36,72,71,1,72,71,1,,,
377272,36,4,1,3,4,1,3,,,
377281,36,7,1,6,7,1,6,,,
377315,36,55,0,55,55,0,55,,,
377449,36,158,55,103,114,48,66,44,7,37
377458,36,187,78,109,131,62,69,56,16,40
377485,36,19,1,18,9,1,8,10,0,10
377546,36,54,23,31,49,22,27,5,1,4
377555,36,3878,2083,1795,3254,1733,1521,624,350,274
377564,36,2899,1399,1500,2543,1219,1324,356,180,176
377643,36,90,8,82,90,8,82,,,
377652,36,81,4,77,81,4,77,,,
377661,36,487,54,433,487,54,433,,,
377722,36,360,28,332,360,28,332,,,
377759,36,11,11,0,11,11,0,,,
378105,36,243,13,230,157,8,149,86,5,81
378576,36,114,33,81,25,14,11,89,19,70
378886,36,161,28,133,54,11,43,107,17,90
378956,36,617,578,39,617,578,39,,,
379621,36,70,6,64,49,5,44,21,1,20
379746,36,161,7,154,161,7,154,,,
379782,36,217,22,195,217,22,195,,,
380067,36,68,1,67,68,1,67,,,
380359,36,405,74,331,163,30,133,242,44,198
380368,36,271,81,190,111,36,75,160,45,115
380377,36,506,117,389,327,84,243,179,33,146
380438,36,573,87,486,573,87,486,,,
381255,36,66,52,14,66,52,14,,,
381282,36,67,22,45,67,22,45,,,
381325,36,96,17,79,96,17,79,,,
381370,36,53,1,52,17,0,17,36,1,35
381404,36,224,6,218,116,2,114,108,4,104
381486,36,10,1,9,10,1,9,,,
381699,36,12,0,12,9,0,9,3,0,3
381732,36,52,15,37,15,8,7,37,7,30
382258,36,62,14,48,51,9,42,11,5,6
382416,36,67,9,58,67,9,58,,,
382461,36,40,0,40,30,0,30,10,0,10
382780,36,42,0,42,41,0,41,1,0,1
382911,36,37,19,18,26,14,12,11,5,6
382957,36,353,82,271,347,81,266,6,1,5
383020,36,8,2,6,4,1,3,4,1,3
383084,36,75,33,42,58,25,33,17,8,9
383163,36,145,2,143,9,0,9,136,2,134
383190,36,1095,419,676,448,217,231,647,202,445
383279,36,156,25,131,77,17,60,79,8,71
383297,36,203,7,196,64,1,63,139,6,133
383312,36,4,0,4,4,0,4,,,
383330,36,84,12,72,84,12,72,,,
383367,36,153,45,108,123,44,79,30,1,29
383464,36,18,0,18,18,0,18,,,
383525,36,20,0,20,20,0,20,,,
383765,36,60,1,59,42,1,41,18,0,18
383996,36,250,98,152,76,24,52,174,74,100
384236,36,714,267,447,714,267,447,,,
384245,36,589,243,346,589,243,346,,,
384254,36,298,195,103,289,189,100,9,6,3
384333,36,4408,1609,2799,1271,522,749,3137,1087,2050
384342,36,2034,799,1235,786,329,457,1248,470,778
384412,36,62,27,35,62,27,35,,,
384421,36,63,63,0,63,63,0,,,
385132,36,105,8,97,64,6,58,41,2,39
385503,36,185,13,172,185,13,172,,,
385619,36,1151,649,502,1151,649,502,,,
386153,36,77,0,77,77,0,77,,,
386472,36,604,96,508,428,70,358,176,26,150
387925,36,75,6,69,75,6,69,,,
388520,36,81,46,35,38,21,17,43,25,18
388663,36,51,0,51,51,0,51,,,
389860,36,127,55,72,90,28,62,37,27,10
390905,36,105,62,43,41,29,12,64,33,31
391005,36,102,5,97,102,5,97,,,
391759,36,21,0,21,,,,21,0,21
392257,36,2207,192,2015,2207,192,2015,,,
392354,36,9,4,5,9,4,5,,,
392415,36,248,52,196,248,52,196,,,
393524,36,45,1,44,45,1,44,,,
393649,36,1024,444,580,1024,444,580,,,
393861,36,270,44,226,256,42,214,14,2,12
395362,36,785,229,556,212,68,144,573,161,412
395690,36,135,62,73,135,62,73,,,
397942,36,879,287,592,879,287,592,,,
399212,36,7592,5183,2409,1239,614,625,6353,4569,1784
399869,36,330,312,18,330,312,18,,,
399911,36,302,101,201,302,101,201,,,
400080,36,293,170,123,293,170,123,,,
400187,36,447,36,411,228,22,206,219,14,205
400558,36,47,21,26,47,21,26,,,
401223,36,141,29,112,93,19,74,48,10,38
401764,36,201,3,198,88,0,88,113,3,110
402563,36,165,6,159,165,6,159,,,
402800,36,123,0,123,111,0,111,12,0,12
403469,36,160,53,107,101,44,57,59,9,50
403478,36,205,72,133,142,60,82,63,12,51
403487,36,271,103,168,205,87,118,66,16,50
404055,36,235,31,204,235,31,204,,,
404338,36,13,8,5,13,8,5,,,
404426,36,1602,646,956,456,232,224,1146,414,732
404684,36,234,67,167,234,67,167,,,
404718,36,156,6,150,156,6,150,,,
404912,36,537,76,461,537,76,461,,,
404994,36,1923,518,1405,1598,450,1148,325,68,257
405012,36,29,0,29,29,0,29,,,
405058,36,109,109,0,109,109,0,,,
405076,36,52,8,44,52,8,44,,,
405854,36,195,195,0,195,195,0,,,
405872,36,1383,516,867,444,211,233,939,305,634
406024,36,1172,152,1020,699,91,608,473,61,412
406033,36,1939,235,1704,1136,139,997,803,96,707
406149,36,63,17,46,63,17,46,,,
406325,36,70,6,64,21,1,20,49,5,44
406361,36,10,0,10,10,0,10,,,
406422,36,50,3,47,8,0,8,42,3,39
406486,36,32,12,20,16,6,10,16,6,10
406547,36,143,17,126,40,6,34,103,11,92
407090,36,492,11,481,171,6,165,321,5,316
407142,36,78,1,77,78,1,77,,,
407151,36,40,0,40,40,0,40,,,
407179,36,40,0,40,26,0,26,14,0,14
407355,36,146,13,133,146,13,133,,,
407391,36,40,4,36,27,0,27,13,4,9
407407,36,9,2,7,7,2,5,2,0,2
407425,36,15,0,15,11,0,11,4,0,4
407434,36,4,0,4,4,0,4,,,
407461,36,52,33,19,52,33,19,,,
407470,36,75,2,73,56,2,54,19,0,19
407489,36,33,20,13,11,6,5,22,14,8
407513,36,122,31,91,73,11,62,49,20,29
407522,36,1,0,1,,,,1,0,1
407568,36,149,5,144,119,2,117,30,3,27
407577,36,16,10,6,13,8,5,3,2,1
407595,36,14,0,14,14,0,14,,,
407610,36,35,17,18,4,3,1,31,14,17
407683,36,11,0,11,9,0,9,2,0,2
407708,36,126,4,122,126,4,122,,,
407735,36,26,1,25,26,1,25,,,
407832,36,94,61,33,37,24,13,57,37,20
408066,36,134,45,89,101,36,65,33,9,24
408163,36,39,1,38,39,1,38,,,
408385,36,181,48,133,181,48,133,,,
408729,36,27,6,21,27,6,21,,,
408844,36,2216,627,1589,1338,395,943,878,232,646
408862,36,196,7,189,57,3,54,139,4,135
409032,36,4,0,4,4,0,4,,,
409120,36,57,12,45,57,12,45,,,
409193,36,145,144,1,145,144,1,,,
409315,36,15435,6174,9261,4615,1867,2748,10820,4307,6513
409537,36,11,3,8,,,,11,3,8
409591,36,48,10,38,27,5,22,21,5,16
409698,36,4722,1820,2902,4106,1498,2608,616,322,294
410797,36,155,87,68,155,87,68,,,
410964,36,30,0,30,27,0,27,3,0,3
411684,36,65,17,48,65,17,48,,,
411754,36,40,8,32,40,8,32,,,
412173,36,408,34,374,368,31,337,40,3,37
412535,36,29,3,26,28,3,25,1,0,1
412544,36,150,15,135,107,15,92,43,0,43
412599,36,246,73,173,246,73,173,,,
413176,36,24,12,12,24,12,12,,,
413413,36,8287,1685,6602,1507,283,1224,6780,1402,5378
413617,36,133,30,103,46,13,33,87,17,70
413626,36,88,35,53,46,21,25,42,14,28
413680,36,251,227,24,251,227,24,,,
413778,36,189,11,178,97,4,93,92,7,85
413820,36,1,0,1,1,0,1,,,
413893,36,992,556,436,992,556,436,,,
413945,36,39,5,34,39,5,34,,,
413972,36,18,2,16,18,2,16,,,
414063,36,73,2,71,58,2,56,15,0,15
414124,36,217,170,47,167,133,34,50,37,13
414461,36,1125,1062,63,942,889,53,183,173,10
414489,36,34,2,32,34,2,32,,,
414540,36,204,8,196,180,7,173,24,1,23
414595,36,139,31,108,18,8,10,121,23,98
414869,36,267,20,247,96,16,80,171,4,167
414878,36,256,93,163,149,52,97,107,41,66
414911,36,566,207,359,353,149,204,213,58,155
414939,36,204,18,186,204,18,186,,,
415039,36,19,1,18,12,1,11,7,0,7
415057,36,14,14,0,14,14,0,,,
415987,36,20,2,18,20,2,18,,,
416458,36,144,38,106,144,38,106,,,
416801,36,234,49,185,202,45,157,32,4,28
417008,36,112,5,107,112,5,107,,,
417062,36,38,0,38,27,0,27,11,0,11
417105,36,310,195,115,172,107,65,138,88,50
417123,36,28,5,23,14,4,10,14,1,13
417248,36,33,33,0,33,33,0,,,
417275,36,20,20,0,20,20,0,,,
417327,36,200,23,177,46,4,42,154,19,135
417442,36,41,4,37,41,4,37,,,
417503,36,257,3,254,169,3,166,88,0,88
417600,36,1,0,1,1,0,1,,,
417628,36,14,1,13,13,1,12,1,0,1
417637,36,39,5,34,39,5,34,,,
417646,36,13,1,12,13,1,12,,,
417655,36,6,0,6,6,0,6,,,
417682,36,22,1,21,22,1,21,,,
417716,36,171,10,161,171,10,161,,,
417725,36,32,0,32,32,0,32,,,
417734,36,84,9,75,24,4,20,60,5,55
417752,36,25,12,13,23,10,13,2,2,0
417831,36,108,76,32,108,76,32,,,
417840,36,383,16,367,383,16,367,,,
417868,36,4,2,2,,,,4,2,2
417886,36,20,0,20,20,0,20,,,
417910,36,172,25,147,172,25,147,,,
417983,36,8,0,8,,,,8,0,8
417992,36,40,4,36,40,4,36,,,
418001,36,84,7,77,84,7,77,,,
418010,36,51,2,49,16,1,15,35,1,34
418029,36,30,2,28,30,2,28,,,
418038,36,69,4,65,69,4,65,,,
418056,36,18,7,11,18,7,11,,,
418065,36,203,21,182,146,17,129,57,4,53
418083,36,39,6,33,39,6,33,,,
418126,36,155,43,112,84,21,63,71,22,49
418171,36,73,73,0,73,73,0,,,
418199,36,19,16,3,19,16,3,,,
418205,36,193,94,99,122,84,38,71,10,61
418223,36,47,0,47,47,0,47,,,
418250,36,79,47,32,12,7,5,67,40,27
418269,36,214,124,90,214,124,90,,,
418278,36,23,15,8,10,5,5,13,10,3
418296,36,712,274,438,97,41,56,615,233,382
418302,36,96,29,67,70,7,63,26,22,4
418320,36,854,471,383,27,4,23,827,467,360
418348,36,32,26,6,19,15,4,13,11,2
418357,36,33,9,24,32,8,24,1,1,0
418409,36,85,28,57,80,25,55,5,3,2
418427,36,67,7,60,51,5,46,16,2,14
418445,36,8,0,8,8,0,8,,,
418454,36,62,13,49,62,13,49,,,
418481,36,19,1,18,19,1,18,,,
418515,36,16,0,16,10,0,10,6,0,6
418524,36,17,0,17,17,0,17,,,
418533,36,204,24,180,157,16,141,47,8,39
418542,36,56,5,51,23,1,22,33,4,29
418560,36,81,9,72,15,1,14,66,8,58
418588,36,11,2,9,11,2,9,,,
418612,36,7,1,6,7,1,6,,,
418658,36,263,235,28,263,235,28,,,
418773,36,202,81,121,153,65,88,49,16,33
418782,36,83,80,3,83,80,3,,,
418889,36,13,12,1,13,12,1,,,
418913,36,4,1,3,4,1,3,,,
418968,36,156,5,151,156,5,151,,,
419031,36,21,7,14,21,7,14,,,
419095,36,16,2,14,16,2,14,,,
419183,36,31,1,30,31,1,30,,,
419217,36,74,15,59,74,15,59,,,
419226,36,300,152,148,224,118,106,76,34,42
419235,36,102,30,72,102,30,72,,,
419244,36,121,97,24,68,55,13,53,42,11
419253,36,103,69,34,103,69,34,,,
419280,36,23,2,21,15,1,14,8,1,7
419332,36,1,1,0,1,1,0,,,
419341,36,3,0,3,3,0,3,,,
419420,36,11,1,10,11,1,10,,,
419484,36,16,1,15,16,1,15,,,
419633,36,59,7,52,59,7,52,,,
419703,36,201,191,10,201,191,10,,,
419712,36,49,46,3,49,46,3,,,
419721,36,104,98,6,104,98,6,,,
420024,36,177,19,158,137,12,125,40,7,33
420042,36,54,33,21,54,33,21,,,
420130,36,290,13,277,290,13,277,,,
420255,36,21,20,1,21,20,1,,,
420325,36,42,42,0,42,42,0,,,
420343,36,731,702,29,565,544,21,166,158,8
420370,36,341,113,228,341,113,228,,,
420398,36,9155,3669,5486,1677,715,962,7478,2954,4524
420431,36,942,270,672,221,51,170,721,219,502
420440,36,537,155,382,126,42,84,411,113,298
420468,36,145,35,110,125,33,92,20,2,18
420538,36,608,179,429,350,111,239,258,68,190
420556,36,307,83,224,128,40,88,179,43,136
420723,36,149,59,90,51,18,33,98,41,57
420981,36,58,18,40,58,18,40,,,
421513,36,45,6,39,40,5,35,5,1,4
421610,36,80,6,74,80,6,74,,,
421665,36,40,1,39,8,0,8,32,1,31
421708,36,898,101,797,598,62,536,300,39,261
421717,36,23,15,8,15,9,6,8,6,2
421771,36,16,0,16,12,0,12,4,0,4
421832,36,165,75,90,148,73,75,17,2,15
421841,36,112,44,68,112,44,68,,,
421878,36,290,25,265,194,16,178,96,9,87
421896,36,62,16,46,62,16,46,,,
422020,36,169,163,6,169,163,6,,,
422695,36,306,45,261,306,45,261,,,
422835,36,3,2,1,3,2,1,,,
423120,36,16,2,14,16,2,14,,,
423397,36,313,188,125,313,188,125,,,
423412,36,25,23,2,25,23,2,,,
423652,36,188,41,147,92,19,73,96,22,74
425250,36,64,10,54,32,5,27,32,5,27
425986,36,168,21,147,168,21,147,,,
426314,36,7819,6688,1131,1977,1654,323,5842,5034,808
427308,36,87,2,85,87,2,85,,,
427335,36,11,0,11,10,0,10,1,0,1
427894,36,69,67,2,69,67,2,,,
427973,36,192,171,21,121,107,14,71,64,7
427982,36,145,80,65,108,65,43,37,15,22
427991,36,50,29,21,38,18,20,12,11,1
428000,36,97,36,61,97,36,61,,,
428019,36,19,9,10,15,8,7,4,1,3
428055,36,129,26,103,129,26,103,,,
428125,36,42,31,11,40,29,11,2,2,0
428143,36,6,1,5,6,1,5,,,
428170,36,433,45,388,256,25,231,177,20,157
428259,36,72,14,58,23,6,17,49,8,41
428392,36,587,247,340,262,108,154,325,139,186
429012,36,100,84,16,100,84,16,,,
429128,36,262,10,252,27,1,26,235,9,226
430184,36,1240,315,925,126,65,61,1114,250,864
430227,36,50,0,50,40,0,40,10,0,10
430245,36,99,17,82,99,17,82,,,
430306,36,13,1,12,10,1,9,3,0,3
430403,36,287,24,263,287,24,263,,,
430564,36,5,1,4,4,0,4,1,1,0
430582,36,165,72,93,165,72,93,,,
430670,36,42,8,34,42,8,34,,,
430704,36,16,4,12,14,4,10,2,0,2
430795,36,15,1,14,15,1,14,,,
430883,36,26,2,24,26,2,24,,,
430908,36,22,3,19,14,2,12,8,1,7
430935,36,370,289,81,203,163,40,167,126,41
430971,36,36,4,32,36,4,32,,,
431017,36,46,15,31,43,12,31,3,3,0
431071,36,6,1,5,4,0,4,2,1,1
431105,36,16,3,13,11,0,11,5,3,2
431123,36,89,86,3,89,86,3,,,
431141,36,1100,389,711,1058,385,673,42,4,38
431169,36,53,8,45,47,6,41,6,2,4
431187,36,20,20,0,20,20,0,,,
431196,36,95,9,86,95,9,86,,,
431266,36,45,1,44,42,1,41,3,0,3
431275,36,51,3,48,14,1,13,37,2,35
431284,36,63,2,61,56,0,56,7,2,5
431558,36,50,10,40,42,10,32,8,0,8
431600,36,136,18,118,111,16,95,25,2,23
431929,36,3,2,1,3,2,1,,,
431983,36,87,87,0,87,87,0,,,
432117,36,172,1,171,107,1,106,65,0,65
432269,36,31,25,6,31,25,6,,,
432384,36,388,82,306,388,82,306,,,
432524,36,36,9,27,36,9,27,,,
433004,36,336,78,258,336,78,258,,,
433013,36,599,212,387,599,212,387,,,
433040,36,7,1,6,7,1,6,,,
433068,36,313,188,125,254,140,114,59,48,11
433101,36,556,44,512,314,31,283,242,13,229
433138,36,79,15,64,75,12,63,4,3,1
433174,36,341,36,305,32,3,29,309,33,276
433387,36,67640,26258,41382,67640,26258,41382,,,
433420,36,231,198,33,231,198,33,,,
433536,36,326,39,287,167,20,147,159,19,140
433660,36,9600,4176,5424,7226,3093,4133,2374,1083,1291
434016,36,80,24,56,23,8,15,57,16,41
434061,36,3041,1015,2026,1504,602,902,1537,413,1124
434140,36,471,94,377,471,94,377,,,
434159,36,358,264,94,358,264,94,,,
434274,36,8,0,8,4,0,4,4,0,4
434283,36,15,1,14,14,0,14,1,1,0
434308,36,174,7,167,174,7,167,,,
434344,36,193,8,185,191,8,183,2,0,2
434362,36,13,12,1,13,12,1,,,
434432,36,2,1,1,2,1,1,,,
434496,36,18,0,18,18,0,18,,,
434539,36,55,18,37,7,2,5,48,16,32
434584,36,136,22,114,27,3,24,109,19,90
434672,36,9963,3277,6686,2115,907,1208,7848,2370,5478
434751,36,72,20,52,45,16,29,27,4,23
434821,36,624,26,598,624,26,598,,,
434830,36,113,1,112,67,1,66,46,0,46
434900,36,275,55,220,144,22,122,131,33,98
434937,36,16,16,0,16,16,0,,,
435000,36,22,2,20,22,2,20,,,
436030,36,134,58,76,79,35,44,55,23,32
436100,36,2,0,2,2,0,2,,,
436304,36,1017,554,463,509,298,211,508,256,252
436429,36,4389,2939,1450,4389,2939,1450,,,
436553,36,352,53,299,352,53,299,,,
436599,36,81,17,64,18,5,13,63,12,51
436614,36,31,19,12,15,7,8,16,12,4
436632,36,41,7,34,19,5,14,22,2,20
436641,36,67,23,44,67,23,44,,,
436650,36,142,14,128,142,14,128,,,
436775,36,88,4,84,88,4,84,,,
436818,36,482,197,285,424,168,256,58,29,29
436827,36,268,131,137,238,110,128,30,21,9
436836,36,1467,724,743,1326,639,687,141,85,56
437097,36,299,163,136,278,152,126,21,11,10
437103,36,4437,1297,3140,1854,639,1215,2583,658,1925
437237,36,47,40,7,47,40,7,,,
437316,36,214,28,186,210,27,183,4,1,3
437325,36,93,18,75,10,4,6,83,14,69
437556,36,919,403,516,891,403,488,28,0,28
437608,36,102,72,30,101,71,30,1,1,0
437635,36,495,57,438,495,57,438,,,
437723,36,28,7,21,28,7,21,,,
437732,36,60,6,54,38,3,35,22,3,19
437750,36,50,50,0,50,50,0,,,
437769,36,94,7,87,94,7,87,,,
437778,36,12,1,11,12,1,11,,,
437857,36,90,0,90,68,0,68,22,0,22
437936,36,456,52,404,456,52,404,,,
438179,36,168,24,144,168,24,144,,,
438221,36,143,13,130,138,13,125,5,0,5
438258,36,280,66,214,280,66,214,,,
438285,36,117,11,106,117,11,106,,,
438337,36,2,0,2,1,0,1,1,0,1
438498,36,920,152,768,207,42,165,713,110,603
438504,36,694,667,27,694,667,27,,,
438586,36,747,265,482,595,209,386,152,56,96
438674,36,59,0,59,36,0,36,23,0,23
438708,36,119,18,101,56,9,47,63,9,54
438735,36,176,159,17,131,119,12,45,40,5
438984,36,22,7,15,22,7,15,,,
439020,36,7,3,4,5,1,4,2,2,0
439118,36,283,41,242,283,41,242,,,
439190,36,856,423,433,467,231,236,389,192,197
439367,36,955,256,699,955,256,699,,,
439455,36,202,9,193,110,1,109,92,8,84
439473,36,136,59,77,63,30,33,73,29,44
439491,36,212,39,173,212,39,173,,,
439507,36,7,7,0,7,7,0,,,
439570,36,345,17,328,345,17,328,,,
439622,36,234,43,191,234,43,191,,,
439668,36,34,24,10,34,24,10,,,
439686,36,2,0,2,2,0,2,,,
439701,36,241,89,152,114,41,73,127,48,79
439738,36,290,60,230,290,60,230,,,
439747,36,84,18,66,73,16,57,11,2,9
439774,36,9,2,7,2,1,1,7,1,6
439783,36,84,30,54,70,25,45,14,5,9
439792,36,350,28,322,350,28,322,,,
439844,36,24,1,23,24,1,23,,,
439862,36,72,20,52,56,14,42,16,6,10
439871,36,111,3,108,96,3,93,15,0,15
439899,36,34,20,14,20,9,11,14,11,3
439932,36,14,1,13,14,1,13,,,
439969,36,17,8,9,17,8,9,,,
440059,36,595,551,44,433,399,34,162,152,10
440101,36,58,6,52,25,2,23,33,4,29
440226,36,30,0,30,30,0,30,,,
440262,36,217,212,5,188,183,5,29,29,0
440271,36,92,42,50,92,42,50,,,
440396,36,101,39,62,93,36,57,8,3,5
440402,36,723,200,523,403,111,292,320,89,231
440651,36,389,96,293,209,42,167,180,54,126
440730,36,204,67,137,204,67,137,,,
440749,36,37,29,8,2,2,0,35,27,8
440776,36,32,5,27,32,5,27,,,
440794,36,220,46,174,207,43,164,13,3,10
440819,36,18,9,9,18,9,9,,,
440828,36,698,367,331,342,188,154,356,179,177
440855,36,4,0,4,4,0,4,,,
440989,36,430,320,110,430,320,110,,,
441025,36,175,20,155,170,20,150,5,0,5
441052,36,1189,289,900,1189,289,900,,,
441070,36,86,32,54,14,6,8,72,26,46
441168,36,20,0,20,20,0,20,,,
441210,36,250,117,133,,,,250,117,133
441229,36,1093,190,903,1093,190,903,,,
441256,36,17,0,17,17,0,17,,,
441371,36,2406,72,2334,2390,71,2319,16,1,15
441380,36,180,57,123,159,52,107,21,5,16
441414,36,70,27,43,19,9,10,51,18,33
441423,36,138,24,114,138,24,114,,,
441487,36,27,1,26,27,1,26,,,
441496,36,139,123,16,110,97,13,29,26,3
441502,36,233,18,215,233,18,215,,,
441548,36,58,13,45,58,13,45,,,
441575,36,207,31,176,207,31,176,,,
441593,36,9,0,9,9,0,9,,,
441609,36,73,73,0,73,73,0,,,
441618,36,13,0,13,6,0,6,7,0,7
441636,36,289,37,252,260,32,228,29,5,24
441645,36,107,2,105,71,1,70,36,1,35
441663,36,224,17,207,224,17,207,,,
441672,36,1,0,1,1,0,1,,,
441690,36,97,54,43,35,22,13,62,32,30
441706,36,227,75,152,227,75,152,,,
441742,36,513,43,470,430,39,391,83,4,79
441760,36,1967,854,1113,721,386,335,1246,468,778
441788,36,474,430,44,317,286,31,157,144,13
441830,36,26,9,17,26,9,17,,,
441858,36,86,4,82,84,4,80,2,0,2
441876,36,191,10,181,94,7,87,97,3,94
441900,36,3092,639,2453,1421,277,1144,1671,362,1309
441937,36,4778,1695,3083,3590,1234,2356,1188,461,727
441982,36,269,131,138,268,131,137,1,0,1
442073,36,642,119,523,397,81,316,245,38,207
442134,36,251,35,216,251,35,216,,,
442213,36,36,0,36,30,0,30,6,0,6
442240,36,360,71,289,200,37,163,160,34,126
442329,36,607,540,67,607,540,67,,,
442356,36,1177,137,1040,449,55,394,728,82,646
442383,36,41,9,32,41,9,32,,,
442426,36,269,23,246,183,16,167,86,7,79
442435,36,26,5,21,26,5,21,,,
442444,36,603,333,270,603,333,270,,,
442523,36,43,17,26,36,15,21,7,2,5
442569,36,3223,1681,1542,1053,501,552,2170,1180,990
442602,36,372,57,315,372,57,315,,,
442611,36,638,605,33,638,605,33,,,
442639,36,45,31,14,45,31,14,,,
442657,36,121,6,115,121,6,115,,,
442781,36,446,86,360,128,23,105,318,63,255
442842,36,29,6,23,18,5,13,11,1,10
442879,36,130,7,123,107,6,101,23,1,22
442888,36,1,1,0,1,1,0,,,
442930,36,332,151,181,309,139,170,23,12,11
442949,36,3,0,3,,,,3,0,3
442976,36,67,2,65,67,2,65,,,
442985,36,3,1,2,3,1,2,,,
443021,36,24,22,2,24,22,2,,,
443049,36,85,49,36,45,27,18,40,22,18
443058,36,24,7,17,8,2,6,16,5,11
443100,36,36,22,14,36,22,14,,,
443137,36,30,5,25,30,5,25,,,
443146,36,46,36,10,37,28,9,9,8,1
443207,36,111,104,7,111,104,7,,,
443216,36,101,77,24,101,77,24,,,
443225,36,59,46,13,59,46,13,,,
443234,36,60,1,59,60,1,59,,,
443252,36,564,355,209,564,355,209,,,
443261,36,129,8,121,90,7,83,39,1,38
443289,36,111,21,90,111,21,90,,,
443298,36,2,1,1,2,1,1,,,
443322,36,16,2,14,16,2,14,,,
443331,36,2351,487,1864,1942,381,1561,409,106,303
443340,36,35,15,20,32,15,17,3,0,3
443377,36,32,28,4,32,28,4,,,
443410,36,767,549,218,688,490,198,79,59,20
443492,36,590,266,324,414,202,212,176,64,112
443562,36,277,41,236,164,25,139,113,16,97
443571,36,14,6,8,14,6,8,,,
443599,36,558,36,522,99,10,89,459,26,433
443632,36,77,45,32,77,45,32,,,
443641,36,146,2,144,59,0,59,87,2,85
443650,36,552,52,500,457,44,413,95,8,87
443669,36,6,0,6,6,0,6,,,
443696,36,34,9,25,34,9,25,,,
443748,36,475,102,373,458,99,359,17,3,14
443766,36,1996,310,1686,101,40,61,1895,270,1625
443784,36,1030,206,824,61,20,41,969,186,783
443951,36,45,23,22,45,23,22,,,
443979,36,23,0,23,5,0,5,18,0,18
444051,36,47,2,45,38,2,36,9,0,9
444088,36,434,49,385,434,49,385,,,
444130,36,134,52,82,41,27,14,93,25,68
444194,36,58,2,56,58,2,56,,,
444219,36,4786,2113,2673,954,431,523,3832,1682,2150
444228,36,20,0,20,20,0,20,,,
444255,36,29,4,25,29,4,25,,,
444264,36,8,2,6,7,2,5,1,0,1
444282,36,53,2,51,29,2,27,24,0,24
444291,36,59,1,58,32,1,31,27,0,27
444307,36,32,1,31,21,1,20,11,0,11
444325,36,91,11,80,75,9,66,16,2,14
444334,36,55,3,52,55,3,52,,,
444361,36,53,18,35,53,18,35,,,
444370,36,34,34,0,34,34,0,,,
444398,36,105,44,61,73,35,38,32,9,23
444404,36,2,1,1,1,0,1,1,1,0
444413,36,96,96,0,96,96,0,,,
444440,36,10,2,8,10,2,8,,,
444468,36,13,0,13,12,0,12,1,0,1
444486,36,291,16,275,260,13,247,31,3,28
444510,36,109,14,95,109,14,95,,,
444529,36,45,7,38,45,7,38,,,
444556,36,386,176,210,386,176,210,,,
444565,36,245,122,123,195,94,101,50,28,22
444583,36,160,70,90,160,70,90,,,
444635,36,64,5,59,1,0,1,63,5,58
444662,36,75,68,7,75,68,7,,,
444671,36,47,23,24,47,23,24,,,
444714,36,124,8,116,124,8,116,,,
444732,36,14,1,13,14,1,13,,,
444778,36,51,20,31,25,9,16,26,11,15
444787,36,1625,207,1418,1057,131,926,568,76,492
444796,36,113,65,48,113,65,48,,,
444811,36,358,20,338,200,12,188,158,8,150
444857,36,114,3,111,45,1,44,69,2,67
444866,36,98,5,93,59,3,56,39,2,37
444893,36,8,0,8,8,0,8,,,
444936,36,90,27,63,88,27,61,2,0,2
444945,36,93,14,79,93,14,79,,,
444954,36,563,217,346,339,150,189,224,67,157
445027,36,7762,3168,4594,7033,2932,4101,729,236,493
445133,36,90,41,49,65,32,33,25,9,16
445188,36,5643,2643,3000,5563,2596,2967,80,47,33
445203,36,135,17,118,135,17,118,,,
445212,36,209,31,178,115,17,98,94,14,80
445230,36,552,162,390,552,162,390,,,
445249,36,191,35,156,191,35,156,,,
445258,36,6,1,5,6,1,5,,,
445267,36,1119,233,886,672,142,530,447,91,356
445364,36,250,24,226,250,24,226,,,
445461,36,525,192,333,505,186,319,20,6,14
445498,36,1,1,0,1,1,0,,,
445540,36,50,0,50,50,0,50,,,
445638,36,8,0,8,4,0,4,4,0,4
445647,36,108,2,106,58,1,57,50,1,49
445656,36,118,4,114,72,2,70,46,2,44
445692,36,327,286,41,287,251,36,40,35,5
445708,36,803,280,523,773,264,509,30,16,14
445735,36,302,72,230,302,72,230,,,
445744,36,388,74,314,388,74,314,,,
445762,36,222,206,16,173,161,12,49,45,4
445780,36,30,3,27,30,3,27,,,
445799,36,579,543,36,579,543,36,,,
445841,36,118,0,118,86,0,86,32,0,32
445850,36,136,0,136,93,0,93,43,0,43
445911,36,629,234,395,403,140,263,226,94,132
445948,36,1078,155,923,1078,155,923,,,
445957,36,148,32,116,,,,148,32,116
446048,36,743,315,428,735,309,426,8,6,2
446084,36,58,3,55,17,1,16,41,2,39
446093,36,44,4,40,35,3,32,9,1,8
446109,36,26,3,23,23,2,21,3,1,2
446118,36,538,99,439,538,99,439,,,
446127,36,93,0,93,93,0,93,,,
446163,36,122,111,11,95,88,7,27,23,4
446206,36,20,6,14,12,2,10,8,4,4
446224,36,12,6,6,,,,12,6,6
446233,36,104,59,45,96,56,40,8,3,5
446242,36,94,28,66,94,28,66,,,
446251,36,46,6,40,46,6,40,,,
446260,36,624,19,605,624,19,605,,,
446288,36,73,4,69,43,0,43,30,4,26
446303,36,41,0,41,26,0,26,15,0,15
446349,36,23,2,21,23,2,21,,,
446385,36,159,92,67,145,83,62,14,9,5
446394,36,19,5,14,2,1,1,17,4,13
446455,36,2,2,0,2,2,0,,,
446516,36,2,1,1,2,1,1,,,
446525,36,200,165,35,200,165,35,,,
446552,36,1028,560,468,1028,560,468,,,
446561,36,1462,328,1134,1462,328,1134,,,
446589,36,338,64,274,338,64,274,,,
446598,36,12,0,12,10,0,10,2,0,2
446604,36,1678,1678,0,1678,1678,0,,,
446640,36,357,235,122,344,226,118,13,9,4
446774,36,1011,347,664,385,143,242,626,204,422
447014,36,91,5,86,91,5,86,,,
447023,36,1122,456,666,1112,456,656,10,0,10
447050,36,147,37,110,34,8,26,113,29,84
447148,36,114,5,109,69,4,65,45,1,44
447166,36,23,2,21,11,2,9,12,0,12
447175,36,26,1,25,18,0,18,8,1,7
447263,36,1511,203,1308,1291,160,1131,220,43,177
447351,36,377,186,191,377,186,191,,,
447379,36,12,10,2,12,10,2,,,
447421,36,194,22,172,194,22,172,,,
447449,36,14,5,9,10,5,5,4,0,4
447458,36,210,170,40,210,170,40,,,
447467,36,10,1,9,10,1,9,,,
447582,36,396,131,265,273,101,172,123,30,93
447591,36,438,37,401,438,37,401,,,
447607,36,1263,659,604,1263,659,604,,,
447616,36,984,530,454,984,530,454,,,
447689,36,7611,3112,4499,4654,1883,2771,2957,1229,1728
447704,36,109,2,107,109,2,107,,,
447713,36,183,50,133,183,50,133,,,
447722,36,15,2,13,15,2,13,,,
447731,36,117,2,115,74,2,72,43,0,43
447759,36,154,41,113,138,40,98,16,1,15
447768,36,1227,261,966,1227,261,966,,,
447777,36,661,347,314,9,6,3,652,341,311
447795,36,2,0,2,2,0,2,,,
447810,36,197,21,176,197,21,176,,,
447847,36,87,82,5,87,82,5,,,
447865,36,4,2,2,3,2,1,1,0,1
447874,36,80,78,2,80,78,2,,,
447883,36,101,15,86,42,7,35,59,8,51
447892,36,86,9,77,46,6,40,40,3,37
447908,36,64,3,61,40,1,39,24,2,22
447917,36,24,3,21,24,3,21,,,
447935,36,171,4,167,171,4,167,,,
447953,36,286,144,142,245,127,118,41,17,24
447962,36,116,10,106,116,10,106,,,
447971,36,17,0,17,17,0,17,,,
447980,36,80,3,77,11,1,10,69,2,67
447999,36,132,35,97,132,35,97,,,
448026,36,90,3,87,67,3,64,23,0,23
448071,36,225,12,213,147,5,142,78,7,71
448123,36,10,2,8,10,2,8,,,
448196,36,80,6,74,79,6,73,1,0,1
448220,36,116,7,109,116,7,109,,,
448239,36,117,1,116,117,1,116,,,
448248,36,951,616,335,140,38,102,811,578,233
448257,36,10,0,10,1,0,1,9,0,9
448275,36,17,0,17,17,0,17,,,
448354,36,152,19,133,94,9,85,58,10,48
448372,36,177,82,95,177,82,95,,,
448424,36,41,3,38,19,1,18,22,2,20
448433,36,620,601,19,620,601,19,,,
448594,36,1981,669,1312,647,233,414,1334,436,898
448600,36,172,5,167,172,5,167,,,
448619,36,462,29,433,235,18,217,227,11,216
448646,36,7,0,7,7,0,7,,,
448673,36,1858,169,1689,584,54,530,1274,115,1159
448770,36,245,234,11,230,220,10,15,14,1
448798,36,77,0,77,77,0,77,,,
448859,36,97,93,4,97,93,4,,,
448895,36,23,7,16,23,7,16,,,
449038,36,978,223,755,101,46,55,877,177,700
449074,36,379,52,327,379,52,327,,,
449083,36,25,25,0,25,25,0,,,
449092,36,40,40,0,40,40,0,,,
449135,36,169,57,112,119,45,74,50,12,38
449250,36,512,102,410,512,102,410,,,
449311,36,164,1,163,57,0,57,107,1,106
449320,36,471,451,20,298,287,11,173,164,9
449339,36,30059,19218,10841,1899,937,962,28160,18281,9879
449348,36,64,19,45,4,1,3,60,18,42
449357,36,61,3,58,61,3,58,,,
449384,36,206,135,71,189,122,67,17,13,4
449393,36,59,23,36,59,23,36,,,
449445,36,101,20,81,101,20,81,,,
449454,36,38,4,34,,,,38,4,34
449463,36,84,12,72,72,9,63,12,3,9
449472,36,34,0,34,34,0,34,,,
449490,36,59,15,44,59,15,44,,,
449506,36,31,23,8,31,23,8,,,
449524,36,230,18,212,230,18,212,,,
449533,36,76,7,69,76,7,69,,,
449597,36,3,0,3,3,0,3,,,
449603,36,86,55,31,86,55,31,,,
449612,36,60,35,25,60,35,25,,,
449658,36,81,81,0,81,81,0,,,
449676,36,113,48,65,113,48,65,,,
449685,36,28,4,24,28,4,24,,,
449700,36,224,41,183,224,41,183,,,
449719,36,23,3,20,23,3,20,,,
449728,36,83,1,82,83,1,82,,,
449764,36,173,79,94,148,74,74,25,5,20
449773,36,17,2,15,17,2,15,,,
449782,36,3,0,3,2,0,2,1,0,1
449807,36,38,1,37,38,1,37,,,
449816,36,223,124,99,35,18,17,188,106,82
449861,36,68,3,65,68,3,65,,,
449870,36,64,22,42,48,15,33,16,7,9
449889,36,53,15,38,53,15,38,,,
449898,36,350,65,285,243,44,199,107,21,86
449904,36,13,0,13,13,0,13,,,
449959,36,184,28,156,115,18,97,69,10,59
449968,36,233,45,188,149,27,122,84,18,66
449977,36,156,5,151,109,2,107,47,3,44
449986,36,332,71,261,196,33,163,136,38,98
449995,36,104,3,101,61,3,58,43,0,43
450021,36,142,31,111,142,31,111,,,
450058,36,737,125,612,737,125,612,,,
450067,36,441,117,324,437,117,320,4,0,4
450119,36,36,3,33,36,3,33,,,
450128,36,428,13,415,428,13,415,,,
450298,36,207,44,163,10,6,4,197,38,159
450377,36,841,158,683,46,18,28,795,140,655
450395,36,97,0,97,53,0,53,44,0,44
450401,36,24,2,22,24,2,22,,,
450571,36,385,32,353,196,12,184,189,20,169
450599,36,46,2,44,46,2,44,,,
450605,36,23,1,22,16,0,16,7,1,6
450614,36,77,2,75,59,2,57,18,0,18
450632,36,71,12,59,,,,71,12,59
450641,36,208,27,181,121,22,99,87,5,82
450650,36,96,8,88,31,3,28,65,5,60
450696,36,235,27,208,235,27,208,,,
450702,36,131,6,125,131,6,125,,,
450711,36,4,2,2,4,2,2,,,
450720,36,449,14,435,220,4,216,229,10,219
450933,36,10041,6511,3530,5358,3241,2117,4683,3270,1413
450951,36,79,50,29,79,50,29,,,
450960,36,241,19,222,221,19,202,20,0,20
450988,36,170,19,151,109,14,95,61,5,56
451042,36,5,0,5,3,0,3,2,0,2
451051,36,77,5,72,,,,77,5,72
451097,36,16,2,14,9,0,9,7,2,5
451103,36,4,2,2,2,1,1,2,1,1
451121,36,104,9,95,52,4,48,52,5,47
451149,36,584,40,544,584,40,544,,,
451158,36,522,30,492,522,30,492,,,
451167,36,125,48,77,75,36,39,50,12,38
451194,36,25,2,23,25,2,23,,,
451228,36,162,133,29,162,133,29,,,
451237,36,148,2,146,148,2,146,,,
451255,36,37,1,36,19,0,19,18,1,17
451264,36,122,15,107,122,15,107,,,
451282,36,84,3,81,61,2,59,23,1,22
451291,36,8,0,8,,,,8,0,8
451307,36,7,0,7,1,0,1,6,0,6
451316,36,45,9,36,45,9,36,,,
451334,36,166,74,92,124,57,67,42,17,25
451343,36,81,3,78,53,2,51,28,1,27
451352,36,88,8,80,47,6,41,41,2,39
451370,36,47,47,0,47,47,0,,,
451398,36,170,170,0,170,170,0,,,
451404,36,254,254,0,254,254,0,,,
451413,36,196,57,139,196,57,139,,,
451459,36,33,7,26,13,2,11,20,5,15
451468,36,351,7,344,351,7,344,,,
451477,36,2029,1648,381,2029,1648,381,,,
451495,36,296,60,236,296,60,236,,,
451501,36,102,27,75,102,27,75,,,
451529,36,20,2,18,6,0,6,14,2,12
451547,36,6,0,6,6,0,6,,,
451556,36,240,89,151,240,89,151,,,
451565,36,181,24,157,177,23,154,4,1,3
451574,36,95,2,93,90,2,88,5,0,5
451583,36,758,560,198,162,116,46,596,444,152
451626,36,53,10,43,44,10,34,9,0,9
451714,36,321,54,267,271,39,232,50,15,35
451741,36,65,18,47,42,12,30,23,6,17
451750,36,771,120,651,359,86,273,412,34,378
451820,36,100,63,37,69,44,25,31,19,12
451857,36,73,8,65,73,8,65,,,
451866,36,212,23,189,212,23,189,,,
451918,36,91,10,81,91,10,81,,,
451927,36,260,133,127,248,128,120,12,5,7
452009,36,54,0,54,54,0,54,,,
452072,36,20,3,17,20,3,17,,,
452081,36,692,23,669,692,23,669,,,
452106,36,55,53,2,55,53,2,,,
452124,36,382,64,318,379,63,316,3,1,2
452373,36,155,7,148,155,7,148,,,
452771,36,1,1,0,,,,1,1,0
452780,36,3,0,3,,,,3,0,3
452887,36,56,54,2,56,54,2,,,
452948,36,425,48,377,250,20,230,175,28,147
453163,36,2510,369,2141,123,43,80,2387,326,2061
453215,36,450,90,360,22,3,19,428,87,341
453297,36,13,3,10,13,3,10,,,
453756,36,212,119,93,212,119,93,,,
453792,36,57,2,55,57,2,55,,,
454184,36,283,107,176,269,104,165,14,3,11
454227,36,10299,1076,9223,1962,201,1761,8337,875,7462
454236,36,586,64,522,202,19,183,384,45,339
454245,36,643,104,539,167,22,145,476,82,394
454458,36,14,4,10,14,4,10,,,
454537,36,21,0,21,21,0,21,,,
454546,36,12,0,12,12,0,12,,,
454555,36,15,0,15,15,0,15,,,
454582,36,112,37,75,26,10,16,86,27,59
454607,36,271,6,265,271,6,265,,,
454616,36,57,47,10,57,47,10,,,
454652,36,134,2,132,134,2,132,,,
454689,36,3,1,2,3,1,2,,,
454698,36,241,69,172,241,69,172,,,
454722,36,33,8,25,30,5,25,3,3,0
454759,36,28,23,5,17,12,5,11,11,0
454768,36,260,43,217,145,29,116,115,14,101
454777,36,195,24,171,126,19,107,69,5,64
454786,36,609,349,260,107,59,48,502,290,212
454795,36,309,72,237,193,45,148,116,27,89
454801,36,162,36,126,162,36,126,,,
454810,36,7585,2194,5391,7585,2194,5391,,,
454829,36,175,30,145,111,13,98,64,17,47
454856,36,877,113,764,877,113,764,,,
454865,36,163,12,151,120,7,113,43,5,38
454874,36,12,0,12,8,0,8,4,0,4
454917,36,517,86,431,317,53,264,200,33,167
454926,36,243,19,224,213,17,196,30,2,28
454935,36,19,0,19,19,0,19,,,
454944,36,170,24,146,170,24,146,,,
454953,36,27,1,26,17,1,16,10,0,10
454962,36,27,0,27,13,0,13,14,0,14
454971,36,214,30,184,123,29,94,91,1,90
454980,36,115,2,113,36,1,35,79,1,78
454999,36,125,1,124,51,1,50,74,0,74
455008,36,205,6,199,94,5,89,111,1,110
455026,36,64,58,6,,,,64,58,6
455062,36,51,2,49,28,1,27,23,1,22
455071,36,77,12,65,,,,77,12,65
455080,36,248,27,221,247,27,220,1,0,1
455105,36,73,0,73,73,0,73,,,
455114,36,4202,1617,2585,1470,700,770,2732,917,1815
455141,36,185,5,180,185,5,180,,,
455187,36,191,13,178,58,5,53,133,8,125
455196,36,2039,177,1862,2039,177,1862,,,
455202,36,369,44,325,206,11,195,163,33,130
455211,36,261,13,248,261,13,248,,,
455220,36,11,2,9,11,2,9,,,
455257,36,298,298,0,298,298,0,,,
455275,36,225,5,220,225,5,220,,,
455284,36,196,5,191,154,4,150,42,1,41
455327,36,22,0,22,19,0,19,3,0,3
455336,36,150,125,25,150,125,25,,,
455354,36,335,12,323,335,12,323,,,
455381,36,99,0,99,48,0,48,51,0,51
455460,36,109,22,87,109,22,87,,,
455479,36,518,42,476,436,36,400,82,6,76
455488,36,187,41,146,187,41,146,,,
455512,36,1711,575,1136,329,123,206,1382,452,930
455558,36,47,14,33,47,14,33,,,
455628,36,383,115,268,383,115,268,,,
455664,36,159,22,137,6,2,4,153,20,133
455707,36,54,13,41,54,13,41,,,
455725,36,255,9,246,195,8,187,60,1,59
455734,36,173,35,138,173,35,138,,,
455761,36,271,27,244,171,21,150,100,6,94
455770,36,67,39,28,67,39,28,,,
455798,36,82,4,78,45,3,42,37,1,36
455831,36,176,18,158,176,18,158,,,
455859,36,222,3,219,194,3,191,28,0,28
455868,36,271,54,217,271,54,217,,,
455877,36,104,6,98,104,6,98,,,
455886,36,154,5,149,68,3,65,86,2,84
455895,36,357,27,330,166,3,163,191,24,167
455901,36,160,17,143,56,7,49,104,10,94
455910,36,20,2,18,20,2,18,,,
455929,36,52,1,51,52,1,51,,,
455965,36,116,12,104,116,12,104,,,
455974,36,33,9,24,33,9,24,,,
455983,36,119,44,75,116,43,73,3,1,2
456001,36,11,10,1,11,10,1,,,
456029,36,206,12,194,133,12,121,73,0,73
456038,36,245,23,222,245,23,222,,,
456065,36,133,6,127,130,6,124,3,0,3
456074,36,119,5,114,117,5,112,2,0,2
456135,36,43,0,43,27,0,27,16,0,16
456153,36,59,50,9,59,50,9,,,
456205,36,187,21,166,178,21,157,9,0,9
456214,36,288,201,87,288,201,87,,,
456287,36,68,1,67,68,1,67,,,
456454,36,411,113,298,354,104,250,57,9,48
456481,36,58,32,26,10,3,7,48,29,19
456490,36,113,76,37,30,22,8,83,54,29
456506,36,56,2,54,56,2,54,,,
456515,36,22,0,22,22,0,22,,,
456551,36,33,1,32,33,1,32,,,
456579,36,174,48,126,166,46,120,8,2,6
456588,36,29,1,28,25,1,24,4,0,4
456597,36,174,1,173,78,1,77,96,0,96
456621,36,209,52,157,18,10,8,191,42,149
456825,36,114,2,112,108,2,106,6,0,6
456852,36,238,58,180,238,58,180,,,
456922,36,209,38,171,198,35,163,11,3,8
456931,36,270,139,131,258,136,122,12,3,9
456959,36,414,93,321,396,89,307,18,4,14
456968,36,764,19,745,722,19,703,42,0,42
456977,36,4,4,0,4,4,0,,,
457031,36,54,1,53,42,1,41,12,0,12
457077,36,28,2,26,28,2,26,,,
457086,36,174,32,142,131,28,103,43,4,39
457101,36,244,60,184,244,60,184,,,
457110,36,391,56,335,391,56,335,,,
457129,36,785,87,698,219,25,194,566,62,504
457192,36,22,14,8,22,14,8,,,
457208,36,9,6,3,9,6,3,,,
457226,36,28,22,6,9,8,1,19,14,5
457253,36,170,8,162,27,1,26,143,7,136
457299,36,198,32,166,188,28,160,10,4,6
457314,36,86,21,65,86,21,65,,,
457323,36,354,37,317,354,37,317,,,
457332,36,39,1,38,39,1,38,,,
457341,36,150,1,149,141,1,140,9,0,9
457350,36,66,0,66,,,,66,0,66
457378,36,161,75,86,75,23,52,86,52,34
457387,36,142,87,55,142,87,55,,,
457396,36,76,16,60,11,3,8,65,13,52
457402,36,43,33,10,35,29,6,8,4,4
457411,36,199,186,13,160,150,10,39,36,3
457420,36,187,12,175,117,10,107,70,2,68
457439,36,49,1,48,16,1,15,33,0,33
457448,36,67,0,67,67,0,67,,,
457466,36,28,21,7,28,21,7,,,
457475,36,74,4,70,74,4,70,,,
457484,36,83,40,43,43,18,25,40,22,18
457493,36,73,2,71,73,2,71,,,
457527,36,185,25,160,5,1,4,180,24,156
457536,36,522,110,412,522,110,412,,,
457545,36,94,4,90,78,3,75,16,1,15
457554,36,13,0,13,7,0,7,6,0,6
457563,36,204,4,200,204,4,200,,,
457572,36,108,5,103,108,5,103,,,
457581,36,172,2,170,149,2,147,23,0,23
457606,36,21,1,20,21,1,20,,,
457615,36,42,6,36,,,,42,6,36
457624,36,26,2,24,26,2,24,,,
457633,36,201,2,199,76,0,76,125,2,123
457642,36,69,1,68,69,1,68,,,
457679,36,14,1,13,14,1,13,,,
457688,36,31,10,21,9,4,5,22,6,16
457697,36,55,25,30,17,10,7,38,15,23
457721,36,5,0,5,5,0,5,,,
457749,36,66,6,60,66,6,60,,,
457767,36,65,38,27,65,38,27,,,
457776,36,142,11,131,137,10,127,5,1,4
457785,36,17,0,17,17,0,17,,,
457794,36,3,0,3,3,0,3,,,
457800,36,9,0,9,9,0,9,,,
457819,36,547,212,335,,,,547,212,335
457837,36,135,10,125,61,10,51,74,0,74
457855,36,42,4,38,34,3,31,8,1,7
457873,36,85,59,26,44,36,8,41,23,18
457916,36,27,0,27,13,0,13,14,0,14
457925,36,12,7,5,12,7,5,,,
457943,36,36,2,34,36,2,34,,,
457952,36,175,3,172,133,2,131,42,1,41
457989,36,20,0,20,20,0,20,,,
457998,36,63,12,51,32,1,31,31,11,20
458007,36,4,0,4,2,0,2,2,0,2
458034,36,55,8,47,55,8,47,,,
458043,36,88,0,88,51,0,51,37,0,37
458061,36,44,4,40,12,2,10,32,2,30
458070,36,254,6,248,236,6,230,18,0,18
458098,36,107,2,105,98,2,96,9,0,9
458104,36,197,2,195,1,0,1,196,2,194
458113,36,41,16,25,8,5,3,33,11,22
458122,36,8,0,8,8,0,8,,,
458131,36,12,0,12,12,0,12,,,
458140,36,6,6,0,6,6,0,,,
458168,36,52,4,48,52,4,48,,,
458210,36,2672,584,2088,1939,427,1512,733,157,576
458229,36,2278,485,1793,1857,405,1452,421,80,341
458274,36,188,6,182,137,5,132,51,1,50
458405,36,191,57,134,183,56,127,8,1,7
458423,36,76,18,58,76,18,58,,,
458441,36,278,40,238,270,40,230,8,0,8
458496,36,97,44,53,82,36,46,15,8,7
458681,36,257,46,211,257,46,211,,,
458803,36,97,1,96,74,1,73,23,0,23
458812,36,54,3,51,47,2,45,7,1,6
458821,36,35,2,33,35,2,33,,,
458830,36,80,2,78,62,2,60,18,0,18
458858,36,86,1,85,51,1,50,35,0,35
458867,36,93,3,90,68,3,65,25,0,25
458885,36,237,33,204,17,5,12,220,28,192
458919,36,3683,720,2963,304,142,162,3379,578,2801
458955,36,278,38,240,16,1,15,262,37,225
458964,36,1386,241,1145,109,46,63,1277,195,1082
458973,36,1732,391,1341,173,88,85,1559,303,1256
458982,36,193,94,99,147,75,72,46,19,27
459019,36,28,3,25,21,3,18,7,0,7
459046,36,30,3,27,21,2,19,9,1,8
459055,36,31,2,29,24,1,23,7,1,6
459064,36,43,4,39,28,2,26,15,2,13
459116,36,81,4,77,81,4,77,,,
459125,36,1,0,1,1,0,1,,,
459170,36,313,27,286,180,24,156,133,3,130
459189,36,173,2,171,31,2,29,142,0,142
459198,36,259,47,212,190,42,148,69,5,64
459204,36,2723,336,2387,2723,336,2387,,,
459213,36,2323,475,1848,2323,475,1848,,,
459231,36,187,21,166,187,21,166,,,
459259,36,198,30,168,135,23,112,63,7,56
459268,36,196,20,176,123,16,107,73,4,69
459277,36,216,13,203,216,13,203,,,
459286,36,210,29,181,167,26,141,43,3,40
459295,36,35,0,35,9,0,9,26,0,26
459301,36,103,6,97,81,3,78,22,3,19
459310,36,60,10,50,60,10,50,,,
459329,36,96,56,40,96,56,40,,,
459347,36,65,1,64,19,1,18,46,0,46
459374,36,57,1,56,23,0,23,34,1,33
459392,36,135,3,132,84,2,82,51,1,50
459408,36,32,7,25,21,2,19,11,5,6
459417,36,52,41,11,46,35,11,6,6,0
459426,36,66,1,65,66,1,65,,,
459462,36,261,220,41,261,220,41,,,
459499,36,18,3,15,18,3,15,,,
459514,36,49,5,44,49,5,44,,,
459532,36,37,0,37,,,,37,0,37
459541,36,28,2,26,13,2,11,15,0,15
459550,36,118,2,116,104,2,102,14,0,14
459578,36,112,29,83,83,21,62,29,8,21
459727,36,342,104,238,197,59,138,145,45,100
459824,36,49,5,44,46,5,41,3,0,3
459842,36,549,67,482,307,47,260,242,20,222
459851,36,276,34,242,151,21,130,125,13,112
459949,36,4368,1566,2802,2103,720,1383,2265,846,1419
459958,36,222,46,176,222,46,176,,,
459967,36,94,34,60,94,34,60,,,
459985,36,126,52,74,126,52,74,,,
459994,36,5041,1544,3497,300,142,158,4741,1402,3339
460011,36,145,0,145,101,0,101,44,0,44
460020,36,328,62,266,328,62,266,,,
460093,36,25,1,24,25,1,24,,,
460109,36,58,1,57,58,1,57,,,
460118,36,49,0,49,49,0,49,,,
460127,36,51,3,48,51,3,48,,,
460136,36,570,71,499,570,71,499,,,
460145,36,286,173,113,286,173,113,,,
460172,36,522,477,45,520,475,45,2,2,0
460181,36,458,59,399,458,59,399,,,
460190,36,257,35,222,257,35,222,,,
460206,36,344,79,265,344,79,265,,,
460349,36,1200,350,850,426,111,315,774,239,535
460376,36,8,5,3,7,5,2,1,0,1
460385,36,17,3,14,17,3,14,,,
460394,36,4279,1662,2617,751,292,459,3528,1370,2158
460464,36,4722,2145,2577,932,479,453,3790,1666,2124
460482,36,128,8,120,128,8,120,,,
460516,36,3,0,3,3,0,3,,,
460525,36,9,0,9,9,0,9,,,
460534,36,39,1,38,39,1,38,,,
460543,36,855,816,39,855,816,39,,,
460677,36,239,59,180,182,50,132,57,9,48
460701,36,122,9,113,36,3,33,86,6,80
460738,36,767,100,667,100,14,86,667,86,581
460756,36,50,3,47,41,3,38,9,0,9
460765,36,1,0,1,1,0,1,,,
460808,36,3,0,3,3,0,3,,,
460817,36,127,22,105,122,22,100,5,0,5
460826,36,394,69,325,393,69,324,1,0,1
460835,36,232,55,177,228,54,174,4,1,3
460862,36,234,14,220,112,5,107,122,9,113
460871,36,554,60,494,181,25,156,373,35,338
460914,36,329,3,326,329,3,326,,,
460932,36,7,1,6,7,1,6,,,
460969,36,206,18,188,206,18,188,,,
460978,36,144,2,142,59,0,59,85,2,83
460987,36,75,1,74,75,1,74,,,
460996,36,134,1,133,86,0,86,48,1,47
461014,36,947,74,873,947,74,873,,,
461023,36,370,53,317,359,51,308,11,2,9
461032,36,117,58,59,42,21,21,75,37,38
461087,36,207,91,116,118,43,75,89,48,41
461111,36,16,14,2,12,12,0,4,2,2
461148,36,569,323,246,569,323,246,,,
461175,36,192,8,184,140,7,133,52,1,51
461193,36,207,8,199,201,8,193,6,0,6
461218,36,498,37,461,498,37,461,,,
461245,36,24,10,14,11,3,8,13,7,6
461254,36,22,4,18,22,4,18,,,
461263,36,96,8,88,96,8,88,,,
461272,36,61,0,61,42,0,42,19,0,19
461281,36,65,7,58,50,6,44,15,1,14
461306,36,48,9,39,21,5,16,27,4,23
461315,36,47,12,35,26,9,17,21,3,18
461324,36,772,178,594,736,166,570,36,12,24
461333,36,1,1,0,,,,1,1,0
461342,36,64,0,64,39,0,39,25,0,25
461379,36,22,0,22,1,0,1,21,0,21
461388,36,39,13,26,39,13,26,,,
461412,36,46,13,33,,,,46,13,33
461421,36,196,11,185,194,11,183,2,0,2
461430,36,492,452,40,,,,492,452,40
461494,36,157,18,139,99,12,87,58,6,52
461500,36,8,2,6,2,1,1,6,1,5
461528,36,122,65,57,47,21,26,75,44,31
461537,36,30,0,30,23,0,23,7,0,7
461555,36,85,3,82,85,3,82,,,
461573,36,44,43,1,44,43,1,,,
461582,36,138,3,135,138,3,135,,,
461591,36,127,9,118,127,9,118,,,
461607,36,63,5,58,33,3,30,30,2,28
461625,36,16,16,0,16,16,0,,,
461643,36,7,1,6,7,1,6,,,
461652,36,53,5,48,53,5,48,,,
461689,36,256,17,239,256,17,239,,,
461704,36,73,7,66,73,7,66,,,
461713,36,25,0,25,11,0,11,14,0,14
461722,36,5,0,5,5,0,5,,,
461740,36,34,26,8,34,26,8,,,
461759,36,126,66,60,87,42,45,39,24,15
461768,36,186,6,180,186,6,180,,,
461795,36,227,170,57,211,158,53,16,12,4
461810,36,4,0,4,3,0,3,1,0,1
461829,36,28,3,25,28,3,25,,,
461838,36,120,5,115,46,3,43,74,2,72
461847,36,45,45,0,45,45,0,,,
461856,36,58,17,41,58,17,41,,,
461865,36,3,0,3,3,0,3,,,
461874,36,48,5,43,48,5,43,,,
461883,36,52,23,29,39,19,20,13,4,9
461892,36,71,8,63,71,8,63,,,
461908,36,78,2,76,77,1,76,1,1,0
461917,36,143,5,138,94,2,92,49,3,46
461926,36,66,1,65,44,1,43,22,0,22
461944,36,51,0,51,51,0,51,,,
461953,36,41,2,39,34,1,33,7,1,6
461962,36,34,12,22,33,12,21,1,0,1
461999,36,59,1,58,58,1,57,1,0,1
462008,36,284,24,260,176,19,157,108,5,103
462017,36,80,13,67,80,13,67,,,
462035,36,187,66,121,64,6,58,123,60,63
462053,36,75,3,72,75,3,72,,,
462062,36,96,2,94,53,1,52,43,1,42
462071,36,135,32,103,132,32,100,3,0,3
462336,36,79,3,76,78,3,75,1,0,1
462345,36,6,0,6,4,0,4,2,0,2
462354,36,173,80,93,154,64,90,19,16,3
463056,36,926,425,501,840,382,458,86,43,43
464226,36,466,280,186,415,245,170,51,35,16
466921,36,326,19,307,70,5,65,256,14,242
466930,36,1476,199,1277,328,42,286,1148,157,991
467094,36,123,0,123,123,0,123,,,
467368,36,128,11,117,128,11,117,,,
467863,36,185,39,146,129,25,104,56,14,42
467872,36,214,4,210,161,3,158,53,1,52
467906,36,116,5,111,76,3,73,40,2,38
468246,36,108,6,102,108,6,102,,,
468255,36,23,1,22,23,1,22,,,
468291,36,60,5,55,60,5,55,,,
468769,36,91,84,7,91,84,7,,,
468848,36,666,291,375,666,291,375,,,
468893,36,116,4,112,106,4,102,10,0,10
468909,36,856,341,515,856,341,515,,,
468963,36,47,42,5,47,42,5,,,
469416,36,258,67,191,174,54,120,84,13,71
469610,36,13,1,12,13,1,12,,,
469629,36,97,87,10,97,87,10,,,
469911,36,11,0,11,11,0,11,,,
469957,36,112,11,101,112,11,101,,,
470038,36,961,390,571,961,390,571,,,
470047,36,40,6,34,40,6,34,,,
470296,36,7,0,7,7,0,7,,,
470393,36,103,8,95,41,5,36,62,3,59
474863,36,1061,206,855,427,85,342,634,121,513
474915,36,236,10,226,122,5,117,114,5,109
474924,36,92,1,91,27,0,27,65,1,64
475015,36,118,4,114,118,4,114,,,
475024,36,203,77,126,203,77,126,,,
475033,36,4,0,4,,,,4,0,4
475060,36,213,18,195,207,16,191,6,2,4
475121,36,2386,458,1928,1358,270,1088,1028,188,840
475176,36,481,218,263,481,218,263,,,
475200,36,187,50,137,34,7,27,153,43,110
475273,36,302,54,248,49,10,39,253,44,209
475282,36,76,21,55,76,21,55,,,
475325,36,11,1,10,11,1,10,,,
475398,36,56,26,30,6,3,3,50,23,27
475404,36,100,1,99,61,1,60,39,0,39
475413,36,25,4,21,14,3,11,11,1,10
475422,36,50,3,47,13,1,12,37,2,35
475431,36,34,2,32,34,2,32,,,
475468,36,278,6,272,109,4,105,169,2,167
475477,36,172,54,118,26,7,19,146,47,99
475486,36,270,38,232,270,38,232,,,
475547,36,102,17,85,55,10,45,47,7,40
475556,36,147,5,142,92,3,89,55,2,53
475565,36,429,190,239,334,144,190,95,46,49
475574,36,39,14,25,18,6,12,21,8,13
475608,36,115,79,36,59,38,21,56,41,15
475635,36,16,1,15,4,0,4,12,1,11
475653,36,14,1,13,11,1,10,3,0,3
475662,36,30,0,30,15,0,15,15,0,15
475705,36,20,7,13,20,7,13,,,
475714,36,192,142,50,166,126,40,26,16,10
475723,36,111,54,57,36,18,18,75,36,39
475732,36,1091,114,977,224,21,203,867,93,774
475741,36,192,15,177,63,2,61,129,13,116
475839,36,81,25,56,25,8,17,56,17,39
476063,36,156,146,10,156,146,10,,,
476179,36,90,5,85,60,4,56,30,1,29
476230,36,15,0,15,15,0,15,,,
476294,36,139,15,124,41,3,38,98,12,86
476355,36,46,23,23,46,23,23,,,
476489,36,63,56,7,63,56,7,,,
476498,36,116,72,44,116,72,44,,,
476513,36,50,1,49,50,1,49,,,
476540,36,144,4,140,124,2,122,20,2,18
476559,36,152,2,150,146,1,145,6,1,5
476568,36,1,1,0,1,1,0,,,
476595,36,34,8,26,34,8,26,,,
476601,36,49,49,0,49,49,0,,,
476610,36,44,30,14,44,30,14,,,
476629,36,126,5,121,126,5,121,,,
476683,36,78,2,76,78,2,76,,,
476692,36,16,16,0,16,16,0,,,
476708,36,124,94,30,102,78,24,22,16,6
476717,36,423,423,0,423,423,0,,,
476726,36,264,39,225,264,39,225,,,
476735,36,6,4,2,2,2,0,4,2,2
476753,36,177,6,171,114,4,110,63,2,61
476780,36,52,3,49,37,3,34,15,0,15
476799,36,355,53,302,355,53,302,,,
476805,36,47,1,46,47,1,46,,,
476814,36,432,307,125,,,,432,307,125
476841,36,231,31,200,118,18,100,113,13,100
476850,36,44,31,13,44,31,13,,,
476869,36,43,0,43,43,0,43,,,
476878,36,10,0,10,3,0,3,7,0,7
476887,36,93,0,93,7,0,7,86,0,86
476896,36,54,2,52,54,2,52,,,
476902,36,86,2,84,55,1,54,31,1,30
476939,36,517,41,476,517,41,476,,,
476948,36,288,236,52,288,236,52,,,
476957,36,4,0,4,2,0,2,2,0,2
476966,36,98,89,9,98,89,9,,,
476975,36,4997,2308,2689,1429,675,754,3568,1633,1935
476984,36,165,7,158,120,6,114,45,1,44
476993,36,154,2,152,154,2,152,,,
477002,36,34,0,34,34,0,34,,,
477039,36,896,117,779,523,62,461,373,55,318
478582,36,92,3,89,64,2,62,28,1,27
478591,36,54,2,52,31,0,31,23,2,21
478616,36,70,8,62,50,6,44,20,2,18
478917,36,26,1,25,26,1,25,,,
478953,36,161,4,157,161,4,157,,,
479062,36,51,48,3,37,34,3,14,14,0
479424,36,265,33,232,265,33,232,,,
479965,36,194,51,143,194,51,143,,,
479974,36,86,26,60,86,26,60,,,
479983,36,86,13,73,86,13,73,,,
479992,36,24,24,0,12,12,0,12,12,0
480000,36,45,29,16,45,29,16,,,
480019,36,270,247,23,233,214,19,37,33,4
480028,36,28,21,7,25,19,6,3,2,1
480037,36,1316,1025,291,1316,1025,291,,,
480073,36,263,50,213,190,32,158,73,18,55
480091,36,3870,335,3535,2550,224,2326,1320,111,1209
480125,36,203,8,195,111,4,107,92,4,88
480161,36,10,0,10,10,0,10,,,
480198,36,219,60,159,151,41,110,68,19,49
480204,36,330,47,283,330,47,283,,,
480310,36,46,4,42,34,4,30,12,0,12
480347,36,33,3,30,33,3,30,,,
480471,36,535,157,378,535,157,378,,,
480523,36,50,2,48,50,2,48,,,
480532,36,17,0,17,17,0,17,,,
480550,36,23,1,22,23,1,22,,,
480569,36,771,319,452,456,180,276,315,139,176
480657,36,498,54,444,279,31,248,219,23,196
480693,36,39,13,26,38,13,25,1,0,1
480727,36,2,2,0,2,2,0,,,
480781,36,59,43,16,59,43,16,,,
480824,36,333,31,302,333,31,302,,,
480833,36,532,41,491,532,41,491,,,
480842,36,13,2,11,13,2,11,,,
480851,36,116,54,62,116,54,62,,,
480879,36,33,1,32,33,1,32,,,
480888,36,101,35,66,101,35,66,,,
480903,36,277,246,31,255,224,31,22,22,0
480912,36,4,2,2,4,2,2,,,
480921,36,76,62,14,76,62,14,,,
480930,36,109,6,103,77,5,72,32,1,31
480967,36,93,30,63,57,19,38,36,11,25
480976,36,49,1,48,49,1,48,,,
480985,36,202,1,201,202,1,201,,,
480994,36,84,3,81,63,3,60,21,0,21
481003,36,66,59,7,66,59,7,,,
481021,36,17,17,0,13,13,0,4,4,0
481049,36,26,3,23,26,3,23,,,
481058,36,61,24,37,38,14,24,23,10,13
481085,36,137,7,130,137,7,130,,,
481100,36,15,2,13,6,1,5,9,1,8
481128,36,95,6,89,80,4,76,15,2,13
481137,36,54,31,23,54,31,23,,,
481146,36,52,6,46,33,4,29,19,2,17
481155,36,156,57,99,156,57,99,,,
481191,36,136,14,122,136,14,122,,,
481207,36,74,23,51,74,23,51,,,
481225,36,10,6,4,10,6,4,,,
481243,36,240,2,238,88,0,88,152,2,150
481252,36,45,7,38,45,7,38,,,
481289,36,75,17,58,75,17,58,,,
481298,36,37,4,33,37,4,33,,,
481313,36,35,0,35,18,0,18,17,0,17
481322,36,21,1,20,6,0,6,15,1,14
481331,36,56,46,10,55,45,10,1,1,0
481340,36,13,1,12,13,1,12,,,
481368,36,49,2,47,49,2,47,,,
481401,36,175,121,54,43,26,17,132,95,37
481410,36,53,53,0,53,53,0,,,
481429,36,102,10,92,102,10,92,,,
481438,36,42,42,0,42,42,0,,,
481447,36,5,0,5,3,0,3,2,0,2
481456,36,13,0,13,5,0,5,8,0,8
481465,36,45,0,45,40,0,40,5,0,5
481474,36,146,3,143,126,3,123,20,0,20
481483,36,112,2,110,67,1,66,45,1,44
481508,36,25,0,25,24,0,24,1,0,1
481517,36,84,5,79,47,4,43,37,1,36
481526,36,145,1,144,138,1,137,7,0,7
481571,36,1,0,1,1,0,1,,,
481678,36,34,2,32,18,0,18,16,2,14
481720,36,25,3,22,21,3,18,4,0,4
481739,36,40,4,36,20,4,16,20,0,20
481748,36,78,3,75,47,3,44,31,0,31
481775,36,154,46,108,154,46,108,,,
481845,36,43,4,39,30,3,27,13,1,12
481863,36,48,1,47,48,1,47,,,
481890,36,34,1,33,34,1,33,,,
481906,36,32,0,32,32,0,32,,,
481960,36,8,6,2,8,6,2,,,
482015,36,319,190,129,319,190,129,,,
482060,36,16,0,16,16,0,16,,,
482097,36,300,157,143,296,157,139,4,0,4
482149,36,3612,1257,2355,2894,988,1906,718,269,449
482158,36,4988,2141,2847,2978,1371,1607,2010,770,1240
482167,36,103,2,101,37,2,35,66,0,66
482176,36,217,12,205,189,10,179,28,2,26
482185,36,35,26,9,35,26,9,,,
482194,36,14,5,9,11,4,7,3,1,2
482200,36,53,10,43,53,10,43,,,
482228,36,99,63,36,31,23,8,68,40,28
482246,36,4,2,2,4,2,2,,,
482255,36,251,221,30,195,174,21,56,47,9
482291,36,968,420,548,968,420,548,,,
482413,36,585,292,293,336,199,137,249,93,156
482422,36,81,56,25,33,19,14,48,37,11
482431,36,1049,629,420,562,342,220,487,287,200
482440,36,46,20,26,14,4,10,32,16,16
482459,36,354,174,180,145,58,87,209,116,93
482468,36,669,269,400,306,120,186,363,149,214
482477,36,12765,4498,8267,4396,1713,2683,8369,2785,5584
482538,36,19,16,3,7,5,2,12,11,1
482547,36,27,17,10,16,12,4,11,5,6
482556,36,88,51,37,43,21,22,45,30,15
482565,36,16,8,8,7,4,3,9,4,5
482574,36,295,143,152,143,74,69,152,69,83
482608,36,61,34,27,32,17,15,29,17,12
482617,36,12,5,7,8,3,5,4,2,2
482635,36,132,84,48,68,41,27,64,43,21
482653,36,70,36,34,33,19,14,37,17,20
482680,36,11666,4962,6704,7498,3199,4299,4168,1763,2405
482699,36,912,278,634,529,182,347,383,96,287
482705,36,1436,580,856,312,44,268,1124,536,588
482936,36,868,726,142,736,614,122,132,112,20
482963,36,289,24,265,289,24,265,,,
482981,36,144,116,28,118,92,26,26,24,2
482990,36,237,26,211,237,26,211,,,
483009,36,2,1,1,2,1,1,,,
483018,36,92,31,61,92,31,61,,,
483036,36,1308,536,772,485,197,288,823,339,484
483045,36,3767,1120,2647,1147,367,780,2620,753,1867
483054,36,85,64,21,85,64,21,,,
483106,36,160,31,129,117,21,96,43,10,33
483124,36,29184,11252,17932,12223,4059,8164,16961,7193,9768
483212,36,1922,587,1335,978,347,631,944,240,704
483230,36,163,159,4,109,106,3,54,53,1
483258,36,26,22,4,26,22,4,,,
483276,36,39,34,5,39,34,5,,,
483328,36,119,12,107,73,10,63,46,2,44
483337,36,168,5,163,119,4,115,49,1,48
483346,36,42,2,40,42,2,40,,,
483355,36,136,6,130,136,6,130,,,
483364,36,102,5,97,102,5,97,,,
483373,36,73,12,61,42,10,32,31,2,29
483382,36,96,91,5,96,91,5,,,
483425,36,28,0,28,28,0,28,,,
483443,36,320,273,47,320,273,47,,,
483470,36,10,1,9,10,1,9,,,
483504,36,256,88,168,256,88,168,,,
483513,36,33,26,7,33,26,7,,,
483559,36,29,8,21,16,6,10,13,2,11
483577,36,29,1,28,14,0,14,15,1,14
483595,36,1507,389,1118,1017,264,753,490,125,365
483647,36,29,1,28,29,1,28,,,
483708,36,92,15,77,22,5,17,70,10,60
483726,36,18,1,17,7,0,7,11,1,10
483735,36,40,3,37,21,2,19,19,1,18
483744,36,51,42,9,51,42,9,,,
483753,36,11,8,3,2,2,0,9,6,3
483780,36,77,54,23,62,45,17,15,9,6
483799,36,43,13,30,43,13,30,,,
483814,36,426,39,387,379,32,347,47,7,40
483823,36,558,409,149,558,409,149,,,
483841,36,2,0,2,2,0,2,,,
483850,36,3,0,3,3,0,3,,,
483869,36,15,3,12,15,3,12,,,
483878,36,132,22,110,132,22,110,,,
483887,36,44,11,33,44,11,33,,,
483896,36,171,7,164,30,0,30,141,7,134
483911,36,9,1,8,9,1,8,,,
483920,36,93,47,46,93,47,46,,,
483948,36,48,39,9,32,26,6,16,13,3
483957,36,37,9,28,37,9,28,,,
484002,36,1007,80,927,962,75,887,45,5,40
484011,36,101,21,80,75,21,54,26,0,26
484020,36,19,15,4,11,9,2,8,6,2
484039,36,115,95,20,115,95,20,,,
484048,36,9,8,1,9,8,1,,,
484057,36,163,8,155,37,1,36,126,7,119
484066,36,120,11,109,120,11,109,,,
484075,36,2,2,0,1,1,0,1,1,0
484084,36,52,1,51,41,1,40,11,0,11
484093,36,143,4,139,101,2,99,42,2,40
484109,36,94,1,93,94,1,93,,,
484127,36,74,15,59,74,15,59,,,
484136,36,2,1,1,2,1,1,,,
484163,36,42,14,28,26,9,17,16,5,11
484172,36,6,0,6,6,0,6,,,
484190,36,14,10,4,14,10,4,,,
484206,36,111,2,109,61,1,60,50,1,49
484233,36,130,82,48,,,,130,82,48
484330,36,25,0,25,25,0,25,,,
484349,36,37,1,36,37,1,36,,,
484358,36,25,1,24,25,1,24,,,
484367,36,142,17,125,142,17,125,,,
484376,36,234,26,208,234,26,208,,,
484394,36,187,28,159,124,19,105,63,9,54
484473,36,2811,1281,1530,1152,486,666,1659,795,864
484604,36,327,6,321,163,2,161,164,4,160
484613,36,54863,16060,38803,54863,16060,38803,,,
484631,36,1145,740,405,1145,740,405,,,
484710,36,76,49,27,76,49,27,,,
484756,36,123,55,68,123,55,68,,,
484826,36,42,0,42,42,0,42,,,
484835,36,46,11,35,46,11,35,,,
484844,36,412,179,233,412,179,233,,,
484862,36,1,0,1,,,,1,0,1
484871,36,82,82,0,82,82,0,,,
484899,36,122,2,120,122,2,120,,,
484905,36,2266,725,1541,1172,387,785,1094,338,756
484923,36,34,0,34,34,0,34,,,
484932,36,971,406,565,558,210,348,413,196,217
484950,36,80,11,69,80,11,69,,,
484996,36,73,1,72,73,1,72,,,
485014,36,46,1,45,31,0,31,15,1,14
485032,36,176,8,168,103,6,97,73,2,71
485111,36,2989,1086,1903,1562,611,951,1427,475,952
485139,36,193,160,33,193,160,33,,,
485166,36,115,17,98,115,17,98,,,
485236,36,87,2,85,26,1,25,61,1,60
485272,36,1021,135,886,525,82,443,496,53,443
485306,36,9,0,9,9,0,9,,,
485342,36,127,88,39,127,88,39,,,
485360,36,17,1,16,17,1,16,,,
485379,36,162,25,137,162,25,137,,,
485388,36,232,25,207,232,25,207,,,
485397,36,90,4,86,66,4,62,24,0,24
485412,36,76,10,66,76,10,66,,,
485458,36,1281,393,888,344,91,253,937,302,635
485476,36,67,3,64,67,3,64,,,
485485,36,86,12,74,86,12,74,,,
485494,36,34,29,5,34,29,5,,,
485500,36,216,203,13,10,10,0,206,193,13
485519,36,326,222,104,163,111,52,163,111,52
485546,36,105,44,61,2,1,1,103,43,60
485564,36,15,5,10,15,5,10,,,
485573,36,174,29,145,165,28,137,9,1,8
485591,36,30,0,30,30,0,30,,,
485607,36,16,0,16,12,0,12,4,0,4
485698,36,63,57,6,60,54,6,3,3,0
485704,36,4,0,4,2,0,2,2,0,2
485768,36,216,122,94,216,122,94,,,
485801,36,41,9,32,41,9,32,,,
485856,36,41,13,28,15,6,9,26,7,19
485874,36,126,6,120,76,4,72,50,2,48
485926,36,153,47,106,149,47,102,4,0,4
485953,36,2,2,0,2,2,0,,,
485962,36,33,22,11,15,10,5,18,12,6
485999,36,65,65,0,65,65,0,,,
486017,36,22,22,0,22,22,0,,,
486026,36,62,62,0,62,62,0,,,
486053,36,77,48,29,63,39,24,14,9,5
486105,36,1,0,1,1,0,1,,,
486123,36,19,7,12,19,7,12,,,
486141,36,12,0,12,12,0,12,,,
486150,36,77,23,54,53,17,36,24,6,18
486169,36,33,25,8,33,25,8,,,
486196,36,106,106,0,106,106,0,,,
486202,36,25,2,23,25,2,23,,,
486239,36,70,22,48,54,16,38,16,6,10
486248,36,57,27,30,57,27,30,,,
486257,36,206,85,121,143,62,81,63,23,40
486284,36,191,55,136,188,53,135,3,2,1
486309,36,1,0,1,1,0,1,,,
486345,36,114,112,2,49,48,1,65,64,1
486354,36,34,9,25,34,9,25,,,
486372,36,84,66,18,58,49,9,26,17,9
486381,36,151,17,134,151,17,134,,,
486390,36,29,15,14,29,15,14,,,
486406,36,9,2,7,9,2,7,,,
486415,36,199,49,150,199,49,150,,,
486424,36,76,2,74,68,0,68,8,2,6
486442,36,44,1,43,44,1,43,,,
486488,36,17,12,5,14,10,4,3,2,1
486497,36,39,38,1,37,36,1,2,2,0
486503,36,37,0,37,37,0,37,,,
486512,36,210,93,117,210,93,117,,,
486530,36,139,0,139,139,0,139,,,
486558,36,227,204,23,162,145,17,65,59,6
486567,36,193,11,182,189,10,179,4,1,3
486576,36,35,10,25,35,10,25,,,
486594,36,13,6,7,3,1,2,10,5,5
486619,36,133,5,128,102,5,97,31,0,31
486691,36,62,0,62,36,0,36,26,0,26
486707,36,45,1,44,45,1,44,,,
486716,36,50,1,49,50,1,49,,,
486752,36,63,3,60,63,3,60,,,
486770,36,91,18,73,91,18,73,,,
486798,36,760,693,67,760,693,67,,,
486813,36,338,69,269,338,69,269,,,
486822,36,557,65,492,557,65,492,,,
486840,36,26465,13480,12985,18417,9218,9199,8048,4262,3786
486859,36,24,0,24,24,0,24,,,
486868,36,1,0,1,1,0,1,,,
486877,36,3,0,3,3,0,3,,,
486886,36,5,0,5,3,0,3,2,0,2
486901,36,554,274,280,527,262,265,27,12,15
486938,36,451,77,374,177,21,156,274,56,218
486947,36,459,54,405,198,23,175,261,31,230
486956,36,988,130,858,401,55,346,587,75,512
486965,36,149,57,92,149,57,92,,,
486983,36,41,11,30,41,11,30,,,
487010,36,89,9,80,76,6,70,13,3,10
487047,36,27,1,26,27,1,26,,,
487065,36,60,6,54,60,6,54,,,
487083,36,25,0,25,25,0,25,,,
487092,36,473,216,257,473,216,257,,,
487162,36,2031,525,1506,778,234,544,1253,291,962
487232,36,73,0,73,73,0,73,,,
487302,36,432,90,342,431,90,341,1,0,1
487311,36,183,172,11,183,172,11,,,
487320,36,5504,3569,1935,2187,1549,638,3317,2020,1297
487348,36,91,4,87,42,3,39,49,1,48
487375,36,794,100,694,552,65,487,242,35,207
487384,36,454,143,311,454,143,311,,,
487393,36,534,228,306,534,228,306,,,
487409,36,509,198,311,509,198,311,,,
487418,36,604,223,381,604,223,381,,,
487427,36,380,134,246,380,134,246,,,
487436,36,358,64,294,358,64,294,,,
487445,36,447,152,295,447,152,295,,,
487454,36,441,151,290,441,151,290,,,
487472,36,467,182,285,467,182,285,,,
487481,36,1088,214,874,1088,214,874,,,
487490,36,752,152,600,752,152,600,,,
487506,36,33,1,32,6,0,6,27,1,26
487524,36,1727,698,1029,1548,623,925,179,75,104
487533,36,98,1,97,34,1,33,64,0,64
487588,36,227,20,207,227,20,207,,,
487597,36,696,666,30,696,666,30,,,
487603,36,411,175,236,234,103,131,177,72,105
487621,36,17,15,2,16,14,2,1,1,0
487658,36,44,31,13,44,31,13,,,
487676,36,176,12,164,149,8,141,27,4,23
487746,36,20,20,0,20,20,0,,,
487773,36,38,6,32,26,3,23,12,3,9
487791,36,396,363,33,231,214,17,165,149,16
487807,36,45,28,17,25,18,7,20,10,10
487816,36,13,0,13,13,0,13,,,
487852,36,7,1,6,,,,7,1,6
487861,36,269,36,233,189,28,161,80,8,72
487889,36,6,2,4,6,2,4,,,
487898,36,2,1,1,1,1,0,1,0,1
487904,36,13,11,2,13,11,2,,,
487922,36,56,0,56,41,0,41,15,0,15
487959,36,44,0,44,22,0,22,22,0,22
487968,36,20,0,20,20,0,20,,,
487977,36,1365,124,1241,1092,33,1059,273,91,182
487995,36,32,4,28,14,3,11,18,1,17
488004,36,13,13,0,13,13,0,,,
488013,36,65,2,63,65,2,63,,,
488022,36,67,38,29,41,22,19,26,16,10
488031,36,49,21,28,47,20,27,2,1,1
488059,36,153,54,99,153,54,99,,,
488068,36,46,7,39,13,4,9,33,3,30
488077,36,478,462,16,367,356,11,111,106,5
488101,36,60,60,0,60,60,0,,,
488110,36,20,0,20,18,0,18,2,0,2
488129,36,4,0,4,,,,4,0,4
488138,36,34,1,33,34,1,33,,,
488147,36,43,0,43,43,0,43,,,
488174,36,27,14,13,21,11,10,6,3,3
488183,36,16,2,14,16,2,14,,,
488192,36,39,38,1,,,,39,38,1
488217,36,146,3,143,146,3,143,,,
488226,36,19,9,10,19,9,10,,,
488253,36,58,36,22,39,21,18,19,15,4
488262,36,11,4,7,7,3,4,4,1,3
488271,36,46,2,44,46,2,44,,,
488280,36,28,18,10,28,18,10,,,
488299,36,2,2,0,1,1,0,1,1,0
488305,36,76,46,30,58,32,26,18,14,4
488314,36,42,42,0,42,42,0,,,
488332,36,71,6,65,71,6,65,,,
488350,36,53,53,0,53,53,0,,,
488369,36,45,37,8,45,37,8,,,
488378,36,21,0,21,20,0,20,1,0,1
488396,36,20,16,4,3,3,0,17,13,4
488411,36,89,0,89,89,0,89,,,
488420,36,109,10,99,,,,109,10,99
488439,36,39,28,11,26,18,8,13,10,3
488448,36,48,32,16,46,31,15,2,1,1
488590,36,8,1,7,8,1,7,,,
488651,36,55,5,50,26,3,23,29,2,27
488679,36,3968,1040,2928,3649,950,2699,319,90,229
488730,36,3751,1505,2246,404,172,232,3347,1333,2014
488749,36,56,10,46,51,7,44,5,3,2
488776,36,65,21,44,48,17,31,17,4,13
488785,36,163,82,81,152,75,77,11,7,4
488800,36,384,121,263,384,121,263,,,
488828,36,11,5,6,11,5,6,,,
488837,36,49,45,4,49,45,4,,,
488846,36,7831,4623,3208,2719,1675,1044,5112,2948,2164
488891,36,65,28,37,65,28,37,,,
488916,36,11,0,11,11,0,11,,,
488934,36,857,523,334,525,273,252,332,250,82
488952,36,28,1,27,28,1,27,,,
488961,36,29,1,28,29,1,28,,,
488970,36,48,1,47,48,1,47,,,
488989,36,133,9,124,92,7,85,41,2,39
488998,36,101,18,83,99,18,81,2,0,2
489122,36,12,3,9,2,0,2,10,3,7
489131,36,24,7,17,14,4,10,10,3,7
489140,36,44,7,37,20,3,17,24,4,20
489159,36,142,1,141,77,0,77,65,1,64
489201,36,3855,1573,2282,1014,468,546,2841,1105,1736
489238,36,93,10,83,56,5,51,37,5,32
489247,36,41,7,34,17,3,14,24,4,20
489256,36,10,8,2,9,7,2,1,1,0
489283,36,409,61,348,409,61,348,,,
489344,36,211,17,194,64,5,59,147,12,135
489353,36,340,74,266,201,43,158,139,31,108
489371,36,72,66,6,72,66,6,,,
489779,36,26035,10311,15724,4530,1561,2969,21505,8750,12755
489812,36,28,0,28,28,0,28,,,
489830,36,57,2,55,57,2,55,,,
489937,36,286,143,143,225,121,104,61,22,39
490018,36,17,9,8,17,9,8,,,
490045,36,28,10,18,14,4,10,14,6,8
490054,36,145,43,102,78,28,50,67,15,52
490063,36,60,27,33,60,27,33,,,
490081,36,40,19,21,38,19,19,2,0,2
490090,36,1,1,0,1,1,0,,,
490115,36,33,22,11,33,22,11,,,
490133,36,734,438,296,717,426,291,17,12,5
490142,36,28,3,25,14,3,11,14,0,14
490151,36,28,3,25,20,2,18,8,1,7
490160,36,95,15,80,95,15,80,,,
490197,36,45,8,37,45,8,37,,,
490203,36,73,5,68,15,1,14,58,4,54
490212,36,21,1,20,21,1,20,,,
490221,36,4,2,2,2,1,1,2,1,1
490230,36,181,85,96,178,83,95,3,2,1
490249,36,16,15,1,16,15,1,,,
490258,36,56,10,46,56,10,46,,,
490267,36,8,4,4,2,2,0,6,2,4
490276,36,40,40,0,40,40,0,,,
490285,36,308,248,60,308,248,60,,,
490294,36,30,10,20,25,7,18,5,3,2
490300,36,71,20,51,27,3,24,44,17,27
490319,36,7,7,0,7,7,0,,,
490328,36,64,64,0,64,64,0,,,
490337,36,99,25,74,39,11,28,60,14,46
490382,36,22,4,18,22,4,18,,,
490391,36,40,3,37,40,3,37,,,
490407,36,79,0,79,38,0,38,41,0,41
490416,36,13,12,1,13,12,1,,,
490425,36,128,1,127,128,1,127,,,
490434,36,20,0,20,20,0,20,,,
490443,36,106,0,106,106,0,106,,,
490452,36,34,10,24,11,1,10,23,9,14
490461,36,29,1,28,29,1,28,,,
490470,36,12,3,9,12,3,9,,,
490489,36,39,32,7,36,29,7,3,3,0
490498,36,23,19,4,23,19,4,,,
490504,36,27,27,0,27,27,0,,,
490513,36,20,20,0,18,18,0,2,2,0
490522,36,19,0,19,19,0,19,,,
490531,36,17,12,5,7,6,1,10,6,4
490540,36,14,0,14,12,0,12,2,0,2
490559,36,150,6,144,150,6,144,,,
490674,36,1,0,1,1,0,1,,,
490692,36,51,44,7,51,44,7,,,
490717,36,59,2,57,59,2,57,,,
490735,36,70,7,63,70,7,63,,,
490744,36,21,18,3,21,18,3,,,
490805,36,4819,2058,2761,3351,1544,1807,1468,514,954
490814,36,50,4,46,50,4,46,,,
490832,36,225,10,215,177,8,169,48,2,46
490841,36,151,1,150,151,1,150,,,
490869,36,348,35,313,348,35,313,,,
490878,36,321,71,250,321,71,250,,,
490896,36,105,6,99,70,5,65,35,1,34
490948,36,6,4,2,6,4,2,,,
490975,36,323,33,290,301,30,271,22,3,19
491057,36,109,109,0,109,109,0,,,
491066,36,33,0,33,21,0,21,12,0,12
491075,36,3,3,0,3,3,0,,,
491084,36,15,0,15,15,0,15,,,
491136,36,34,2,32,16,2,14,18,0,18
491145,36,55,1,54,37,0,37,18,1,17
491181,36,221,38,183,150,25,125,71,13,58
491215,36,32,30,2,32,30,2,,,
491224,36,95,8,87,66,5,61,29,3,26
491233,36,27,0,27,16,0,16,11,0,11
491242,36,40,18,22,40,18,22,,,
491251,36,85,43,42,85,43,42,,,
491260,36,11,0,11,3,0,3,8,0,8
491288,36,443,129,314,46,12,34,397,117,280
491297,36,84,34,50,6,2,4,78,32,46
491394,36,72,68,4,72,68,4,,,
491446,36,33,0,33,33,0,33,,,
491464,36,44,6,38,44,6,38,,,
491473,36,369,273,96,29,1,28,340,272,68
491507,36,64,7,57,64,7,57,,,
491525,36,47,35,12,35,27,8,12,8,4
491534,36,4,0,4,,,,4,0,4
491543,36,89,13,76,56,11,45,33,2,31
491552,36,2,0,2,2,0,2,,,
491570,36,1,0,1,1,0,1,,,
491589,36,26,21,5,5,4,1,21,17,4
491598,36,22,3,19,22,3,19,,,
491613,36,55,55,0,55,55,0,,,
491622,36,60,60,0,60,60,0,,,
491631,36,66,0,66,38,0,38,28,0,28
491640,36,124,124,0,124,124,0,,,
491659,36,57,30,27,57,30,27,,,
491668,36,142,1,141,142,1,141,,,
491677,36,10,5,5,5,2,3,5,3,2
491686,36,32,29,3,32,29,3,,,
491695,36,40,11,29,40,11,29,,,
491701,36,35,6,29,,,,35,6,29
491710,36,46,46,0,46,46,0,,,
491729,36,21,0,21,21,0,21,,,
491738,36,42,4,38,40,4,36,2,0,2
491747,36,5,4,1,5,4,1,,,
491756,36,80,70,10,80,70,10,,,
491765,36,71,71,0,71,71,0,,,
491774,36,111,15,96,76,9,67,35,6,29
491783,36,11,9,2,6,4,2,5,5,0
491792,36,68,2,66,68,2,66,,,
491817,36,42,0,42,19,0,19,23,0,23
491826,36,81,0,81,81,0,81,,,
491835,36,45,0,45,45,0,45,,,
491844,36,57,15,42,30,10,20,27,5,22
491853,36,42,0,42,42,0,42,,,
491871,36,8,0,8,3,0,3,5,0,5
491880,36,84,81,3,84,81,3,,,
491899,36,61,3,58,9,1,8,52,2,50
491905,36,70,2,68,70,2,68,,,
491914,36,127,127,0,127,127,0,,,
491923,36,134,3,131,129,2,127,5,1,4
491932,36,10,10,0,10,10,0,,,
491941,36,77,4,73,77,4,73,,,
491950,36,772,118,654,45,8,37,727,110,617
491969,36,16,2,14,16,2,14,,,
491978,36,33,10,23,6,3,3,27,7,20
491996,36,20,2,18,20,2,18,,,
492005,36,32,0,32,26,0,26,6,0,6
492032,36,10,0,10,,,,10,0,10
492069,36,48,29,19,42,27,15,6,2,4
492078,36,7,6,1,,,,7,6,1
492096,36,5,1,4,5,1,4,,,
492139,36,45,34,11,45,34,11,,,
492157,36,36,30,6,36,30,6,,,
492281,36,9,9,0,9,9,0,,,
492315,36,18,1,17,,,,18,1,17
492324,36,143,11,132,,,,143,11,132
492360,36,42,10,32,20,3,17,22,7,15
492379,36,1,1,0,1,1,0,,,
492421,36,3,3,0,3,3,0,,,
492449,36,373,66,307,373,66,307,,,
492476,36,101,27,74,21,9,12,80,18,62
492591,36,62,49,13,62,49,13,,,
492643,36,58,19,39,58,19,39,,,
492652,36,27,21,6,27,21,6,,,
492661,36,263,42,221,261,42,219,2,0,2
492689,36,180,32,148,123,24,99,57,8,49
492722,36,288,27,261,288,27,261,,,
492731,36,102,19,83,102,19,83,,,
492759,36,227,17,210,81,7,74,146,10,136
492801,36,623,218,405,347,114,233,276,104,172
492935,36,20,3,17,20,3,17,,,
492953,36,72,6,66,39,6,33,33,0,33
492962,36,2306,864,1442,1043,363,680,1263,501,762
493071,36,320,79,241,320,79,241,,,
493080,36,226,112,114,2,1,1,224,111,113
493132,36,647,625,22,647,625,22,,,
493150,36,132,10,122,132,10,122,,,
493372,36,16,2,14,16,2,14,,,
493451,36,58,13,45,58,13,45,,,
493479,36,3,1,2,3,1,2,,,
493488,36,15,2,13,15,2,13,,,
493503,36,17,9,8,17,9,8,,,
493512,36,48,43,5,48,43,5,,,
493521,36,2,2,0,1,1,0,1,1,0
493530,36,19,8,11,10,4,6,9,4,5
493549,36,97,90,7,97,90,7,,,
493558,36,1,1,0,1,1,0,,,
493567,36,45,2,43,,,,45,2,43
493576,36,11,0,11,11,0,11,,,
493585,36,37,4,33,37,4,33,,,
493594,36,20,20,0,20,20,0,,,
493600,36,112,112,0,112,112,0,,,
493619,36,4,0,4,,,,4,0,4
493628,36,145,12,133,83,8,75,62,4,58
493637,36,45,0,45,45,0,45,,,
493646,36,83,0,83,83,0,83,,,
493655,36,5,2,3,5,2,3,,,
493664,36,52,52,0,51,51,0,1,1,0
493682,36,60,5,55,50,4,46,10,1,9
493691,36,22,0,22,16,0,16,6,0,6
493707,36,57,57,0,57,57,0,,,
493716,36,45,45,0,45,45,0,,,
493725,36,499,178,321,330,108,222,169,70,99
493734,36,1,1,0,1,1,0,,,
493743,36,5,2,3,4,2,2,1,0,1
493752,36,14,1,13,14,1,13,,,
493761,36,69,19,50,8,3,5,61,16,45
493770,36,10,1,9,10,1,9,,,
493789,36,50,0,50,16,0,16,34,0,34
493798,36,6,0,6,,,,6,0,6
493804,36,3,2,1,3,2,1,,,
493813,36,107,7,100,107,7,100,,,
493822,36,109,25,84,62,15,47,47,10,37
493831,36,33,25,8,33,25,8,,,
493868,36,3,3,0,2,2,0,1,1,0
493895,36,31,27,4,25,22,3,6,5,1
493910,36,2,0,2,1,0,1,1,0,1
493992,36,115,34,81,115,34,81,,,
494001,36,70,5,65,13,2,11,57,3,54
494029,36,20,15,5,11,10,1,9,5,4
494162,36,171,13,158,88,5,83,83,8,75
494232,36,18,0,18,15,0,15,3,0,3
494250,36,240,18,222,240,18,222,,,
494269,36,28,24,4,2,1,1,26,23,3
494278,36,135,35,100,35,10,25,100,25,75
494287,36,212,68,144,63,14,49,149,54,95
494357,36,765,267,498,765,267,498,,,
494436,36,221,37,184,221,37,184,,,
494463,36,137,0,137,137,0,137,,,
494472,36,5,0,5,4,0,4,1,0,1
494524,36,84,3,81,77,0,77,7,3,4
494588,36,170,14,156,170,14,156,,,
494597,36,31,13,18,22,9,13,9,4,5
494603,36,180,108,72,126,75,51,54,33,21
494621,36,42,5,37,,,,42,5,37
494630,36,33,16,17,27,14,13,6,2,4
494649,36,24,0,24,16,0,16,8,0,8
494658,36,31,1,30,24,1,23,7,0,7
494685,36,278,113,165,229,89,140,49,24,25
494694,36,62,1,61,57,1,56,5,0,5
494700,36,50,1,49,48,1,47,2,0,2
494719,36,25,19,6,16,10,6,9,9,0
494728,36,29,21,8,27,20,7,2,1,1
494737,36,98,98,0,98,98,0,,,
494746,36,98,12,86,98,12,86,,,
494755,36,25,1,24,25,1,24,,,
494764,36,159,145,14,129,119,10,30,26,4
494807,36,33,5,28,33,5,28,,,
494843,36,462,30,432,462,30,432,,,
494852,36,352,71,281,352,71,281,,,
494898,36,79,13,66,79,13,66,,,
494904,36,36,9,27,13,5,8,23,4,19
494959,36,43,9,34,5,1,4,38,8,30
494977,36,16,2,14,16,2,14,,,
494986,36,31,2,29,20,2,18,11,0,11
494995,36,15,13,2,15,13,2,,,
495013,36,110,94,16,,,,110,94,16
495031,36,48,48,0,45,45,0,3,3,0
495040,36,26,1,25,26,1,25,,,
495059,36,29,14,15,28,14,14,1,0,1
495077,36,16,2,14,16,2,14,,,
495101,36,22,1,21,22,1,21,,,
495110,36,10,8,2,10,8,2,,,
495129,36,74,58,16,74,58,16,,,
495138,36,1,0,1,1,0,1,,,
495147,36,14,6,8,6,4,2,8,2,6
495165,36,24,3,21,24,3,21,,,
495174,36,22,8,14,,,,22,8,14
495183,36,106,48,58,106,48,58,,,
495208,36,6,6,0,6,6,0,,,
495217,36,4,2,2,4,2,2,,,
495226,36,4,0,4,4,0,4,,,
495235,36,10,1,9,6,1,5,4,0,4
495244,36,1,1,0,1,1,0,,,
495253,36,23,1,22,22,1,21,1,0,1
495262,36,20,0,20,10,0,10,10,0,10
495271,36,23,5,18,,,,23,5,18
495280,36,17,10,7,6,4,2,11,6,5
495299,36,24,3,21,24,3,21,,,
495305,36,47,9,38,19,4,15,28,5,23
495341,36,45,32,13,44,31,13,1,1,0
495350,36,31,17,14,31,17,14,,,
495369,36,63,12,51,41,10,31,22,2,20
495378,36,69,5,64,7,0,7,62,5,57
495387,36,26,21,5,11,9,2,15,12,3
495396,36,8,0,8,8,0,8,,,
495411,36,104,7,97,100,5,95,4,2,2
495420,36,163,13,150,89,9,80,74,4,70
495439,36,184,15,169,78,7,71,106,8,98
495448,36,370,39,331,208,18,190,162,21,141
495457,36,257,25,232,146,15,131,111,10,101
495518,36,36,1,35,25,0,25,11,1,10
495730,36,64,0,64,51,0,51,13,0,13
495767,36,53525,28877,24648,46813,25274,21539,6712,3603,3109
495776,36,30,26,4,30,26,4,,,
495794,36,223,5,218,167,2,165,56,3,53
495837,36,86,4,82,86,4,82,,,
495916,36,9,2,7,6,1,5,3,1,2
495925,36,57,2,55,57,2,55,,,
495934,36,73,5,68,73,5,68,,,
495943,36,32,2,30,32,2,30,,,
495952,36,98,26,72,98,26,72,,,
495961,36,81,10,71,81,10,71,,,
495970,36,221,68,153,221,68,153,,,
495998,36,57,6,51,57,6,51,,,
496052,36,12,8,4,12,8,4,,,
496061,36,23,0,23,6,0,6,17,0,17
496186,36,86,79,7,86,79,7,,,
496265,36,36,30,6,36,30,6,,,
496283,36,64,6,58,64,6,58,,,
496292,36,6,6,0,6,6,0,,,
496326,36,101,8,93,101,8,93,,,
496371,36,9,9,0,9,9,0,,,
496399,36,8,3,5,8,3,5,,,
496478,36,58,40,18,,,,58,40,18
496511,36,5,0,5,4,0,4,1,0,1
496520,36,26,5,21,,,,26,5,21
496539,36,53,1,52,33,1,32,20,0,20
496593,36,227,126,101,227,126,101,,,
496618,36,53,3,50,53,3,50,,,
496627,36,140,69,71,140,69,71,,,
496636,36,36,6,30,36,6,30,,,
496645,36,116,63,53,21,2,19,95,61,34
496663,36,2,1,1,1,0,1,1,1,0
496672,36,33,4,29,20,4,16,13,0,13
496681,36,9,2,7,9,2,7,,,
496690,36,20,1,19,13,0,13,7,1,6
496706,36,53,33,20,53,33,20,,,
496715,36,15,1,14,9,1,8,6,0,6
496724,36,15,0,15,15,0,15,,,
496733,36,30,0,30,30,0,30,,,
496742,36,1,0,1,1,0,1,,,
496751,36,10,0,10,10,0,10,,,
496894,36,5,0,5,4,0,4,1,0,1
496919,36,732,286,446,732,286,446,,,
496955,36,146,63,83,146,63,83,,,
496964,36,12,7,5,12,7,5,,,
496973,36,26,1,25,9,0,9,17,1,16
496991,36,4,0,4,,,,4,0,4
497000,36,169,26,143,169,26,143,,,
497037,36,318,63,255,240,48,192,78,15,63
497046,36,1529,417,1112,259,79,180,1270,338,932
497073,36,243,3,240,137,0,137,106,3,103
497161,36,26,22,4,21,17,4,5,5,0
497189,36,6,0,6,6,0,6,,,
497198,36,5,0,5,4,0,4,1,0,1
497204,36,4,3,1,1,0,1,3,3,0
497213,36,20,9,11,11,6,5,9,3,6
497222,36,20,0,20,11,0,11,9,0,9
497268,36,110,14,96,64,9,55,46,5,41
497277,36,347,39,308,347,39,308,,,
497301,36,52,1,51,22,1,21,30,0,30
497310,36,72,0,72,72,0,72,,,
497329,36,50,9,41,50,9,41,,,
100654,40,9,2,7,,,,9,2,7
100663,40,263,94,169,35,19,16,228,75,153
100706,40,211,95,116,6,1,5,205,94,111
100724,40,4,0,4,,,,4,0,4
100751,40,960,306,654,50,25,25,910,281,629
100760,40,638,278,360,4,2,2,634,276,358
100812,40,48,28,20,,,,48,28,20
100830,40,344,109,235,105,34,71,239,75,164
100858,40,149,95,54,41,29,12,108,66,42
100937,40,10,2,8,2,0,2,8,2,6
101028,40,253,94,159,28,12,16,225,82,143
101116,40,4,3,1,,,,4,3,1
101143,40,460,240,220,36,23,13,424,217,207
101161,40,1831,1073,758,29,12,17,1802,1061,741
101189,40,224,104,120,3,3,0,221,101,120
101240,40,795,394,401,20,8,12,775,386,389
101286,40,708,305,403,6,4,2,702,301,401
101295,40,901,367,534,92,40,52,809,327,482
101301,40,685,349,336,2,1,1,683,348,335
101435,40,1,0,1,,,,1,0,1
101453,40,12,5,7,1,0,1,11,5,6
101462,40,184,86,98,5,4,1,179,82,97
101480,40,1075,447,628,162,125,37,913,322,591
101505,40,2376,899,1477,26,9,17,2350,890,1460
101514,40,1907,994,913,24,15,9,1883,979,904
101569,40,315,106,209,3,1,2,312,105,207
101587,40,12,7,5,,,,12,7,5
101602,40,687,427,260,13,8,5,674,419,255
101675,40,3,2,1,,,,3,2,1
101693,40,542,214,328,,,,542,214,328
101709,40,31,9,22,5,1,4,26,8,18
101736,40,1276,675,601,7,3,4,1269,672,597
101879,40,919,337,582,50,18,32,869,319,550
101897,40,924,312,612,51,13,38,873,299,574
101912,40,25,9,16,,,,25,9,16
101994,40,120,56,64,2,0,2,118,56,62
102030,40,594,209,385,1,1,0,593,208,385
102049,40,3,3,0,,,,3,3,0
102067,40,641,240,401,16,4,12,625,236,389
102076,40,708,297,411,22,8,14,686,289,397
102094,40,202,77,125,11,4,7,191,73,118
102234,40,1,0,1,,,,1,0,1
102270,40,7,7,0,7,7,0,,,
102313,40,324,129,195,24,12,12,300,117,183
102368,40,381,155,226,73,26,47,308,129,179
102395,40,3,2,1,,,,3,2,1
102429,40,1080,493,587,15,7,8,1065,486,579
102553,40,2975,1101,1874,348,150,198,2627,951,1676
102580,40,7,3,4,,,,7,3,4
102614,40,1736,564,1172,81,34,47,1655,530,1125
102632,40,758,300,458,25,10,15,733,290,443
102669,40,29,5,24,11,2,9,18,3,15
104151,40,500,211,289,77,28,49,423,183,240
104160,40,693,329,364,59,30,29,634,299,335
104179,40,874,493,381,58,23,35,816,470,346
104346,40,453,155,298,2,1,1,451,154,297
104425,40,551,251,300,38,15,23,513,236,277
104577,40,1396,503,893,151,58,93,1245,445,800
104586,40,18,15,3,1,1,0,17,14,3
104708,40,3354,1432,1922,192,99,93,3162,1333,1829
104717,40,1660,502,1158,3,2,1,1657,500,1157
105145,40,982,382,600,46,25,21,936,357,579
105154,40,4327,1807,2520,279,142,137,4048,1665,2383
105206,40,1171,449,722,142,44,98,1029,405,624
105297,40,91,31,60,,,,91,31,60
105330,40,390,282,108,,,,390,282,108
105349,40,1662,744,918,215,120,95,1447,624,823
105367,40,13,3,10,3,1,2,10,2,8
105428,40,2376,924,1452,104,39,65,2272,885,1387
105525,40,1872,840,1032,161,89,72,1711,751,960
105589,40,5,0,5,2,0,2,3,0,3
105668,40,11858,4996,6862,1331,528,803,10527,4468,6059
105747,40,2556,1096,1460,123,53,70,2433,1043,1390
105792,40,1202,438,764,40,14,26,1162,424,738
105899,40,41,19,22,,,,41,19,22
106148,40,3546,1458,2088,87,45,42,3459,1413,2046
106245,40,944,389,555,102,41,61,842,348,494
106263,40,12,5,7,3,1,2,9,4,5
106342,40,3,3,0,1,1,0,2,2,0
106397,40,264,148,116,41,24,17,223,124,99
106412,40,40,20,20,5,2,3,35,18,17
106449,40,989,447,542,17,5,12,972,442,530
106458,40,763,338,425,46,18,28,717,320,397
106467,40,2434,1049,1385,39,15,24,2395,1034,1361
106485,40,311,140,171,,,,311,140,171
106625,40,312,122,190,13,4,9,299,118,181
106704,40,481,232,249,34,17,17,447,215,232
106713,40,76,33,43,,,,76,33,43
106795,40,502,251,251,40,13,27,462,238,224
106810,40,27,16,11,,,,27,16,11
106883,40,450,186,264,8,4,4,442,182,260
106980,40,422,195,227,14,3,11,408,192,216
106999,40,362,136,226,14,5,9,348,131,217
107044,40,422,171,251,1,0,1,421,171,250
107071,40,23,13,10,,,,23,13,10
107080,40,8,4,4,3,1,2,5,3,2
107141,40,393,169,224,1,1,0,392,168,224
107318,40,552,242,310,7,2,5,545,240,305
107327,40,671,295,376,19,15,4,652,280,372
107460,40,631,328,303,24,7,17,607,321,286
107512,40,144,76,68,,,,144,76,68
107521,40,1173,631,542,8,3,5,1165,628,537
107549,40,380,152,228,16,4,12,364,148,216
107558,40,9,3,6,3,1,2,6,2,4
107585,40,367,159,208,16,3,13,351,156,195
107600,40,1,0,1,,,,1,0,1
107619,40,678,285,393,63,20,43,615,265,350
107637,40,189,87,102,41,32,9,148,55,93
107664,40,308,99,209,38,21,17,270,78,192
107725,40,431,186,245,59,25,34,372,161,211
107743,40,189,52,137,19,6,13,170,46,124
107877,40,11,2,9,,,,11,2,9
107974,40,243,133,110,2,0,2,241,133,108
107983,40,365,130,235,10,3,7,355,127,228
107992,40,259,114,145,,,,259,114,145
108092,40,1215,573,642,117,54,63,1098,519,579
108232,40,69,28,41,5,3,2,64,25,39
108667,40,1354,547,807,83,46,37,1271,501,770
108807,40,2447,1123,1324,58,29,29,2389,1094,1295
109086,40,10,4,6,10,4,6,,,
109208,40,3012,1153,1859,252,91,161,2760,1062,1698
109350,40,1435,592,843,39,17,22,1396,575,821
109651,40,2,1,1,2,1,1,,,
109785,40,2,2,0,1,1,0,1,1,0
109819,40,7579,3132,4447,145,60,85,7434,3072,4362
109907,40,270,99,171,14,2,12,256,97,159
110097,40,4,2,2,,,,4,2,2
110246,40,739,344,395,60,28,32,679,316,363
110334,40,1040,434,606,91,44,47,949,390,559
110361,40,18,7,11,4,2,2,14,5,9
110370,40,10,2,8,,,,10,2,8
110413,40,4,3,1,1,1,0,3,2,1
110422,40,38,11,27,37,11,26,1,0,1
110468,40,151,65,86,,,,151,65,86
110486,40,497,200,297,,,,497,200,297
110495,40,37,10,27,13,3,10,24,7,17
110510,40,263,119,144,32,16,16,231,103,128
110529,40,172,66,106,,,,172,66,106
110538,40,119,61,58,28,11,17,91,50,41
110547,40,24,8,16,19,6,13,5,2,3
110556,40,361,166,195,1,0,1,360,166,194
110565,40,98,39,59,26,14,12,72,25,47
110574,40,67,26,41,13,9,4,54,17,37
110583,40,132,59,73,78,34,44,54,25,29
110592,40,30,11,19,24,9,15,6,2,4
110608,40,60,19,41,30,12,18,30,7,23
110617,40,81,31,50,25,15,10,56,16,40
110635,40,3,1,2,3,1,2,,,
110644,40,20,10,10,20,10,10,,,
110653,40,11,5,6,11,5,6,,,
110671,40,51,20,31,2,1,1,49,19,30
110680,40,4,3,1,,,,4,3,1
110705,40,10,0,10,,,,10,0,10
111045,40,13,4,9,5,3,2,8,1,7
111081,40,6,1,5,,,,6,1,5
111434,40,986,377,609,17,8,9,969,369,600
111461,40,2072,893,1179,69,40,29,2003,853,1150
111887,40,1219,444,775,50,20,30,1169,424,745
111896,40,1156,418,738,25,15,10,1131,403,728
111920,40,1004,407,597,44,24,20,960,383,577
111939,40,3421,1344,2077,259,102,157,3162,1242,1920
111948,40,245,121,124,8,1,7,237,120,117
112075,40,4,2,2,2,1,1,2,1,1
112084,40,11,5,6,,,,11,5,6
112172,40,1722,660,1062,103,44,59,1619,616,1003
112190,40,1228,540,688,55,41,14,1173,499,674
112260,40,2,0,2,2,0,2,,,
112385,40,1073,518,555,33,18,15,1040,500,540
112394,40,5,2,3,,,,5,2,3
112561,40,554,280,274,25,8,17,529,272,257
112686,40,1601,611,990,7,2,5,1594,609,985
112826,40,1202,493,709,40,16,24,1162,477,685
113096,40,1224,502,722,67,28,39,1157,474,683
113111,40,779,299,480,77,37,40,702,262,440
113193,40,2700,1413,1287,36,21,15,2664,1392,1272
113218,40,1336,551,785,37,18,19,1299,533,766
113236,40,1316,586,730,52,33,19,1264,553,711
113333,40,2000,968,1032,257,146,111,1743,822,921
113573,40,1595,724,871,122,44,78,1473,680,793
113634,40,1797,752,1045,77,47,30,1720,705,1015
113698,40,6,1,5,1,0,1,5,1,4
113856,40,3857,1557,2300,132,50,82,3725,1507,2218
113980,40,2911,1406,1505,664,331,333,2247,1075,1172
114266,40,1339,561,778,100,45,55,1239,516,723
114433,40,134,64,70,,,,134,64,70
114716,40,1845,946,899,136,56,80,1709,890,819
114789,40,4881,2041,2840,984,418,566,3897,1623,2274
114813,40,18,7,11,2,1,1,16,6,10
114859,40,1526,646,880,83,38,45,1443,608,835
114938,40,794,340,454,56,40,16,738,300,438
115001,40,1291,532,759,104,38,66,1187,494,693
115083,40,12,11,1,4,4,0,8,7,1
115126,40,1359,617,742,60,29,31,1299,588,711
115296,40,1568,639,929,132,42,90,1436,597,839
115393,40,1173,517,656,47,17,30,1126,500,626
115728,40,4,0,4,,,,4,0,4
115755,40,18,5,13,,,,18,5,13
115773,40,2,0,2,,,,2,0,2
115861,40,840,326,514,245,87,158,595,239,356
116439,40,1905,909,996,78,38,40,1827,871,956
116846,40,26,5,21,,,,26,5,21
117052,40,2477,1173,1304,413,234,179,2064,939,1125
117104,40,1,0,1,,,,1,0,1
117140,40,5,3,2,,,,5,3,2
117195,40,194,95,99,14,5,9,180,90,90
117247,40,2446,1086,1360,167,81,86,2279,1005,1274
117274,40,218,112,106,8,5,3,210,107,103
117627,40,81,31,50,3,0,3,78,31,47
117636,40,93,15,78,1,0,1,92,15,77
117645,40,1581,730,851,125,68,57,1456,662,794
117672,40,415,127,288,3,1,2,412,126,286
117690,40,1328,523,805,36,14,22,1292,509,783
117706,40,2132,902,1230,69,35,34,2063,867,1196
117715,40,1026,356,670,20,4,16,1006,352,654
117724,40,1955,904,1051,109,62,47,1846,842,1004
117733,40,2817,1274,1543,52,29,23,2765,1245,1520
117751,40,244,125,119,,,,244,125,119
117788,40,2253,929,1324,110,46,64,2143,883,1260
117867,40,2302,907,1395,68,28,40,2234,879,1355
117894,40,940,378,562,38,14,24,902,364,538
117946,40,128,68,60,86,46,40,42,22,20
118198,40,5,1,4,5,1,4,,,
118347,40,629,271,358,13,8,5,616,263,353
118684,40,1046,422,624,22,1,21,1024,421,603
118693,40,2,1,1,2,1,1,,,
118718,40,1545,590,955,71,23,48,1474,567,907
118772,40,1491,552,939,83,25,58,1408,527,881
118888,40,8,0,8,3,0,3,5,0,5
118912,40,689,292,397,14,4,10,675,288,387
118930,40,960,370,590,54,21,33,906,349,557
118976,40,1693,642,1051,140,46,94,1553,596,957
119067,40,1122,430,692,51,22,29,1071,408,663
119137,40,1373,600,773,21,8,13,1352,592,760
119164,40,2633,1144,1489,189,97,92,2444,1047,1397
119173,40,32,6,26,,,,32,6,26
119216,40,1583,624,959,113,50,63,1470,574,896
119270,40,22,17,5,1,1,0,21,16,5
119331,40,704,322,382,79,42,37,625,280,345
119605,40,488,149,339,29,9,20,459,140,319
120254,40,12,4,8,8,2,6,4,2,2
120290,40,1338,688,650,66,38,28,1272,650,622
120342,40,1018,463,555,85,53,32,933,410,523
120403,40,6,4,2,6,4,2,,,
120421,40,649,280,369,12,9,3,637,271,366
120838,40,6,6,0,6,6,0,,,
120865,40,26,6,20,2,1,1,24,5,19
120883,40,37,31,6,34,28,6,3,3,0
120953,40,418,311,107,22,7,15,396,304,92
120971,40,3693,1808,1885,317,158,159,3376,1650,1726
121044,40,2102,1002,1100,88,45,43,2014,957,1057
121150,40,2,1,1,,,,2,1,1
121309,40,4,3,1,,,,4,3,1
121345,40,17,7,10,9,3,6,8,4,4
121363,40,898,313,585,29,13,16,869,300,569
121619,40,3090,1527,1563,70,26,44,3020,1501,1519
121691,40,48,4,44,,,,48,4,44
121707,40,739,335,404,41,13,28,698,322,376
121886,40,1633,689,944,89,41,48,1544,648,896
121901,40,2444,838,1606,147,54,93,2297,784,1513
122180,40,1679,661,1018,49,16,33,1630,645,985
122205,40,1961,878,1083,104,50,54,1857,828,1029
122296,40,51,10,41,,,,51,10,41
122339,40,2104,809,1295,58,14,44,2046,795,1251
122375,40,2811,1245,1566,173,74,99,2638,1171,1467
122384,40,2220,1022,1198,137,65,72,2083,957,1126
122409,40,330,135,195,199,70,129,131,65,66
122436,40,101,45,56,63,24,39,38,21,17
122454,40,16,9,7,,,,16,9,7
122597,40,861,359,502,167,65,102,694,294,400
122612,40,32,16,16,11,5,6,21,11,10
122658,40,3398,1356,2042,246,93,153,3152,1263,1889
122685,40,116,16,100,116,16,100,,,
122694,40,25,3,22,25,3,22,,,
122728,40,23,12,11,,,,23,12,11
122746,40,1250,505,745,42,26,16,1208,479,729
122755,40,98,44,54,73,34,39,25,10,15
122791,40,1341,640,701,34,23,11,1307,617,690
122889,40,2176,1002,1174,168,78,90,2008,924,1084
122931,40,8,4,4,6,3,3,2,1,1
122977,40,1926,806,1120,127,64,63,1799,742,1057
123013,40,2051,865,1186,76,34,42,1975,831,1144
123165,40,4,0,4,3,0,3,1,0,1
123217,40,2382,867,1515,138,56,82,2244,811,1433
123299,40,1996,851,1145,74,31,43,1922,820,1102
123341,40,2926,1305,1621,89,30,59,2837,1275,1562
123457,40,15,9,6,,,,15,9,6
123484,40,280,112,168,11,7,4,269,105,164
123509,40,2112,1051,1061,36,19,17,2076,1032,1044
123527,40,1335,520,815,203,92,111,1132,428,704
123554,40,9,6,3,5,4,1,4,2,2
123563,40,1163,503,660,41,16,25,1122,487,635
123572,40,27,10,17,5,2,3,22,8,14
123651,40,3,0,3,,,,3,0,3
123800,40,1700,691,1009,83,32,51,1617,659,958
123952,40,4,2,2,4,2,2,,,
123961,40,171,100,71,96,54,42,75,46,29
124113,40,735,234,501,37,5,32,698,229,469
124487,40,4,1,3,1,0,1,3,1,2
125028,40,933,378,555,21,10,11,912,368,544
125091,40,2252,834,1418,108,56,52,2144,778,1366
125170,40,1467,637,830,109,45,64,1358,592,766
125231,40,33,14,19,,,,33,14,19
125462,40,1802,807,995,11,6,5,1791,801,990
125471,40,1560,638,922,26,9,17,1534,629,905
125499,40,938,393,545,18,6,12,920,387,533
125532,40,35,18,17,35,18,17,,,
125763,40,4,1,3,3,0,3,1,1,0
126119,40,1090,429,661,33,16,17,1057,413,644
126182,40,351,131,220,16,7,9,335,124,211
126207,40,3548,1680,1868,505,209,296,3043,1471,1572
126289,40,6623,3135,3488,425,160,265,6198,2975,3223
126562,40,3247,1311,1936,45,18,27,3202,1293,1909
126580,40,368,183,185,18,12,6,350,171,179
126614,40,472,253,219,74,46,28,398,207,191
126669,40,2193,927,1266,179,83,96,2014,844,1170
126678,40,6,3,3,3,2,1,3,1,2
126711,40,2394,1025,1369,203,91,112,2191,934,1257
126748,40,588,282,306,46,21,25,542,261,281
126775,40,47,30,17,25,17,8,22,13,9
126818,40,610,214,396,48,24,24,562,190,372
126827,40,152,11,141,,,,152,11,141
126863,40,4226,1863,2363,209,77,132,4017,1786,2231
126915,40,85,27,58,,,,85,27,58
126942,40,2041,805,1236,72,29,43,1969,776,1193
127060,40,96,36,60,5,3,2,91,33,58
127185,40,189,70,119,22,8,14,167,62,105
127200,40,7101,3230,3871,555,262,293,6546,2968,3578
127389,40,288,116,172,56,18,38,232,98,134
127556,40,808,372,436,70,32,38,738,340,398
127565,40,890,296,594,133,47,86,757,249,508
127617,40,751,301,450,85,35,50,666,266,400
127653,40,8,2,6,,,,8,2,6
127714,40,241,134,107,,,,241,134,107
127732,40,474,168,306,48,15,33,426,153,273
127741,40,674,259,415,26,12,14,648,247,401
127778,40,397,152,245,21,8,13,376,144,232
127820,40,2632,1117,1515,541,208,333,2091,909,1182
127884,40,2647,1433,1214,406,270,136,2241,1163,1078
127909,40,1689,719,970,200,82,118,1489,637,852
127918,40,129,30,99,,,,129,30,99
127945,40,5,0,5,,,,5,0,5
128106,40,836,352,484,72,27,45,764,325,439
128151,40,317,183,134,317,183,134,,,
128258,40,486,217,269,12,6,6,474,211,263
128391,40,1519,648,871,26,15,11,1493,633,860
128498,40,8,4,4,,,,8,4,4
128577,40,267,120,147,1,0,1,266,120,146
128744,40,140,37,103,,,,140,37,103
128771,40,132,71,61,6,2,4,126,69,57
128780,40,54,6,48,,,,54,6,48
128902,40,18,10,8,1,0,1,17,10,7
129020,40,205,105,100,68,32,36,137,73,64
129154,40,255,114,141,,,,255,114,141
129215,40,378,136,242,14,6,8,364,130,234
129242,40,55,33,22,1,1,0,54,32,22
129367,40,275,88,187,5,3,2,270,85,185
129525,40,88,42,46,,,,88,42,46
129534,40,62,35,27,1,1,0,61,34,27
129543,40,437,180,257,1,0,1,436,180,256
129695,40,509,186,323,10,4,6,499,182,317
129729,40,376,146,230,10,7,3,366,139,227
129756,40,240,88,152,4,2,2,236,86,150
129774,40,18,11,7,,,,18,11,7
129808,40,210,85,125,13,4,9,197,81,116
129941,40,53,32,21,,,,53,32,21
130004,40,549,226,323,57,31,26,492,195,297
130040,40,152,44,108,,,,152,44,108
130110,40,41,23,18,16,6,10,25,17,8
130183,40,199,103,96,9,2,7,190,101,89
130217,40,143,51,92,10,1,9,133,50,83
130226,40,55,21,34,,,,55,21,34
130253,40,62,16,46,1,0,1,61,16,45
130314,40,11,0,11,,,,11,0,11
130396,40,509,237,272,26,16,10,483,221,262
130493,40,216,74,142,28,5,23,188,69,119
130590,40,16,14,2,12,11,1,4,3,1
130606,40,301,138,163,3,2,1,298,136,162
130697,40,135,58,77,6,2,4,129,56,73
130776,40,144,69,75,,,,144,69,75
130794,40,1,0,1,1,0,1,,,
130907,40,1565,497,1068,38,19,19,1527,478,1049
130934,40,220,58,162,16,3,13,204,55,149
130943,40,703,343,360,20,12,8,683,331,352
130989,40,4,2,2,1,1,0,3,1,2
131113,40,706,293,413,4,3,1,702,290,412
131159,40,305,150,155,242,124,118,63,26,37
131283,40,38,19,19,4,4,0,34,15,19
131399,40,137,42,95,4,3,1,133,39,94
131450,40,14,6,8,,,,14,6,8
131469,40,573,146,427,88,30,58,485,116,369
131496,40,203,92,111,19,9,10,184,83,101
131520,40,62,30,32,,,,62,30,32
131876,40,58,12,46,38,8,30,20,4,16
132374,40,247,128,119,247,128,119,,,
132408,40,170,67,103,11,2,9,159,65,94
132471,40,400,165,235,11,5,6,389,160,229
132657,40,8,2,6,,,,8,2,6
132693,40,2822,1071,1751,431,145,286,2391,926,1465
132709,40,5377,1809,3568,1115,374,741,4262,1435,2827
132842,40,1,1,0,,,,1,1,0
132851,40,997,365,632,258,91,167,739,274,465
132879,40,1,0,1,,,,1,0,1
132903,40,286,147,139,121,53,68,165,94,71
132976,40,238,125,113,238,125,113,,,
133021,40,508,205,303,23,9,14,485,196,289
133386,40,2423,876,1547,467,179,288,1956,697,1259
133492,40,10,4,6,6,1,5,4,3,1
133508,40,3447,1117,2330,1299,429,870,2148,688,1460
133553,40,2017,1371,646,14,8,6,2003,1363,640
133650,40,296,130,166,24,11,13,272,119,153
133669,40,1104,439,665,503,215,288,601,224,377
133702,40,3388,1251,2137,504,179,325,2884,1072,1812
133711,40,7,3,4,,,,7,3,4
133809,40,7,1,6,,,,7,1,6
133872,40,86,35,51,7,1,6,79,34,45
133881,40,272,159,113,5,3,2,267,156,111
133951,40,6479,2844,3635,753,403,350,5726,2441,3285
133960,40,33,17,16,1,0,1,32,17,15
133979,40,47,18,29,,,,47,18,29
134079,40,70,17,53,1,0,1,69,17,52
134097,40,225,102,123,88,32,56,137,70,67
134130,40,832,380,452,314,143,171,518,237,281
134237,40,15,10,5,15,10,5,,,
134343,40,955,347,608,33,15,18,922,332,590
134422,40,1,0,1,,,,1,0,1
134495,40,32,7,25,15,2,13,17,5,12
134510,40,1,0,1,,,,1,0,1
134608,40,3575,1379,2196,598,235,363,2977,1144,1833
134811,40,37,12,25,,,,37,12,25
134945,40,19,13,6,2,1,1,17,12,5
135081,40,474,148,326,141,4,137,333,144,189
135160,40,727,265,462,107,30,77,620,235,385
135179,40,32,25,7,7,1,6,25,24,1
135188,40,1262,453,809,286,86,200,976,367,609
135276,40,587,338,249,25,5,20,562,333,229
135364,40,2,0,2,,,,2,0,2
135391,40,1224,435,789,529,187,342,695,248,447
135522,40,4,3,1,4,3,1,,,
135610,40,3,2,1,,,,3,2,1
135717,40,4275,1477,2798,589,223,366,3686,1254,2432
135726,40,161,67,94,40,21,19,121,46,75
135735,40,1386,870,516,,,,1386,870,516
136145,40,375,137,238,83,28,55,292,109,183
136172,40,305,113,192,49,18,31,256,95,161
136215,40,59,11,48,2,0,2,57,11,46
136233,40,1543,576,967,550,214,336,993,362,631
136303,40,104,4,100,,,,104,4,100
136330,40,563,245,318,3,0,3,560,245,315
136358,40,3520,1247,2273,388,139,249,3132,1108,2024
136400,40,2239,756,1483,55,15,40,2184,741,1443
136473,40,1812,675,1137,343,119,224,1469,556,913
136516,40,2098,775,1323,699,269,430,1399,506,893
136659,40,251,161,90,,,,251,161,90
136774,40,2,0,2,,,,2,0,2
136950,40,9,1,8,2,0,2,7,1,6
137032,40,284,106,178,50,15,35,234,91,143
137078,40,4436,1799,2637,1024,395,629,3412,1404,2008
137096,40,1611,616,995,541,215,326,1070,401,669
137209,40,2332,986,1346,229,129,100,2103,857,1246
137245,40,196,114,82,196,114,82,,,
137281,40,2500,942,1558,265,86,179,2235,856,1379
137315,40,742,290,452,197,61,136,545,229,316
137351,40,1330,606,724,399,223,176,931,383,548
137476,40,1786,766,1020,11,4,7,1775,762,1013
137546,40,50,27,23,12,4,8,38,23,15
137564,40,2822,1230,1592,55,24,31,2767,1206,1561
137759,40,1282,453,829,157,64,93,1125,389,736
137856,40,71,49,22,4,4,0,67,45,22
137953,40,14,7,7,,,,14,7,7
137962,40,5,1,4,1,1,0,4,0,4
138187,40,7468,2868,4600,1921,715,1206,5547,2153,3394
138275,40,20,7,13,1,0,1,19,7,12
138293,40,1,1,0,,,,1,1,0
138309,40,1,0,1,,,,1,0,1
138354,40,438,129,309,71,30,41,367,99,268
138372,40,1109,710,399,,,,1109,710,399
138479,40,209,127,82,209,127,82,,,
138488,40,252,48,204,,,,252,48,204
138558,40,491,159,332,17,1,16,474,158,316
138600,40,50,14,36,42,12,30,8,2,6
138682,40,307,104,203,37,17,20,270,87,183
138716,40,248,66,182,44,13,31,204,53,151
138761,40,6,1,5,1,0,1,5,1,4
138813,40,6,0,6,,,,6,0,6
138840,40,195,55,140,14,9,5,181,46,135
138868,40,847,387,460,54,22,32,793,365,428
138901,40,138,37,101,10,3,7,128,34,94
138947,40,14,5,9,6,4,2,8,1,7
138956,40,389,160,229,36,16,20,353,144,209
139144,40,2,0,2,,,,2,0,2
139199,40,117,31,86,2,0,2,115,31,84
139205,40,296,159,137,4,1,3,292,158,134
139250,40,482,162,320,21,7,14,461,155,306
139278,40,1311,509,802,239,93,146,1072,416,656
139311,40,975,308,667,99,37,62,876,271,605
139357,40,364,152,212,26,11,15,338,141,197
139366,40,417,167,250,77,33,44,340,134,206
139384,40,2097,875,1222,113,60,53,1984,815,1169
139393,40,32,14,18,,,,32,14,18
139463,40,356,138,218,58,23,35,298,115,183
139621,40,326,110,216,5,2,3,321,108,213
139630,40,132,59,73,4,2,2,128,57,71
139658,40,80,39,41,54,33,21,26,6,20
139700,40,549,176,373,29,7,22,520,169,351
139719,40,31,6,25,1,0,1,30,6,24
139755,40,895,593,302,60,37,23,835,556,279
139764,40,448,188,260,10,5,5,438,183,255
139861,40,97,48,49,18,8,10,79,40,39
139931,40,1123,383,740,99,34,65,1024,349,675
139940,40,570,193,377,63,19,44,507,174,333
139959,40,134,51,83,61,28,33,73,23,50
139968,40,555,177,378,25,7,18,530,170,360
139986,40,872,296,576,61,21,40,811,275,536
140012,40,1321,484,837,100,42,58,1221,442,779
140234,40,3,0,3,,,,3,0,3
140243,40,1276,492,784,67,32,35,1209,460,749
140252,40,13,6,7,,,,13,6,7
140331,40,1388,580,808,200,82,118,1188,498,690
140340,40,1,1,0,,,,1,1,0
140447,40,242,36,206,58,10,48,184,26,158
140678,40,690,262,428,10,5,5,680,257,423
140696,40,38,13,25,14,3,11,24,10,14
140720,40,10,3,7,,,,10,3,7
140818,40,42,13,29,2,0,2,40,13,27
140872,40,30,13,17,17,6,11,13,7,6
140942,40,389,193,196,87,47,40,302,146,156
140951,40,230,72,158,23,19,4,207,53,154
140960,40,117,38,79,2,1,1,115,37,78
140988,40,149,64,85,6,3,3,143,61,82
141006,40,313,123,190,9,2,7,304,121,183
141167,40,75,36,39,4,0,4,71,36,35
141185,40,951,370,581,99,40,59,852,330,522
141237,40,1767,794,973,35,17,18,1732,777,955
141255,40,1217,435,782,26,7,19,1191,428,763
141264,40,339,129,210,25,8,17,314,121,193
141325,40,121,43,78,9,0,9,112,43,69
141334,40,966,307,659,42,14,28,924,293,631
141361,40,496,174,322,16,4,12,480,170,310
141486,40,13,2,11,9,1,8,4,1,3
141565,40,133,52,81,1,1,0,132,51,81
141574,40,281,87,194,139,35,104,142,52,90
141644,40,1340,524,816,280,91,189,1060,433,627
141680,40,1111,410,701,7,2,5,1104,408,696
141796,40,2061,667,1394,60,25,35,2001,642,1359
141802,40,526,233,293,3,1,2,523,232,291
141811,40,2328,765,1563,71,26,45,2257,739,1518
141839,40,809,265,544,16,6,10,793,259,534
141981,40,357,77,280,4,0,4,353,77,276
141990,40,1358,489,869,30,9,21,1328,480,848
142090,40,1,1,0,,,,1,1,0
142115,40,5329,2228,3101,36,18,18,5293,2210,3083
142179,40,830,345,485,20,7,13,810,338,472
142276,40,2976,1250,1726,116,55,61,2860,1195,1665
142285,40,1770,745,1025,22,11,11,1748,734,1014
142294,40,1,0,1,,,,1,0,1
142328,40,1268,449,819,176,65,111,1092,384,708
142443,40,1561,622,939,276,110,166,1285,512,773
142461,40,151,72,79,,,,151,72,79
142522,40,772,267,505,3,0,3,769,267,502
142559,40,4377,1741,2636,90,28,62,4287,1713,2574
142957,40,1,0,1,,,,1,0,1
143084,40,21,14,7,19,14,5,2,0,2
143118,40,38,11,27,13,1,12,25,10,15
143215,40,1475,663,812,231,94,137,1244,569,675
143279,40,1428,589,839,38,12,26,1390,577,813
143288,40,30,9,21,27,9,18,3,0,3
143358,40,12,5,7,1,1,0,11,4,7
143613,40,579,218,361,43,11,32,536,207,329
144005,40,6,4,2,,,,6,4,2
144050,40,78,31,47,45,16,29,33,15,18
144157,40,822,274,548,298,79,219,524,195,329
144166,40,1327,401,926,213,57,156,1114,344,770
144175,40,866,285,581,185,51,134,681,234,447
144184,40,2617,859,1758,223,46,177,2394,813,1581
144193,40,2342,705,1637,341,99,242,2001,606,1395
144209,40,1534,612,922,74,36,38,1460,576,884
144218,40,2699,941,1758,325,98,227,2374,843,1531
144281,40,35,17,18,21,10,11,14,7,7
144351,40,68,25,43,,,,68,25,43
144564,40,768,348,420,65,27,38,703,321,382
144740,40,235,71,164,114,17,97,121,54,67
144865,40,6048,2758,3290,646,323,323,5402,2435,2967
144892,40,2287,1019,1268,3,0,3,2284,1019,1265
144944,40,1703,530,1173,251,74,177,1452,456,996
144962,40,123,58,65,1,0,1,122,58,64
144971,40,8,2,6,2,1,1,6,1,5
145336,40,11,4,7,2,2,0,9,2,7
145372,40,62,30,32,31,17,14,31,13,18
145497,40,89,18,71,1,1,0,88,17,71
145521,40,302,133,169,71,35,36,231,98,133
145600,40,268,131,137,161,91,70,107,40,67
145619,40,11,2,9,2,0,2,9,2,7
145637,40,890,560,330,368,236,132,522,324,198
145646,40,7,6,1,3,3,0,4,3,1
145682,40,2585,1090,1495,213,96,117,2372,994,1378
145691,40,9,3,6,3,1,2,6,2,4
145707,40,407,191,216,26,9,17,381,182,199
145725,40,109,66,43,41,19,22,68,47,21
145813,40,42,19,23,14,4,10,28,15,13
145831,40,617,193,424,21,8,13,596,185,411
146205,40,797,305,492,41,10,31,756,295,461
146278,40,358,171,187,13,3,10,345,168,177
146296,40,2614,1131,1483,43,18,25,2571,1113,1458
146339,40,9,1,8,4,1,3,5,0,5
146348,40,394,149,245,43,16,27,351,133,218
146366,40,542,219,323,15,3,12,527,216,311
146418,40,711,297,414,34,11,23,677,286,391
146427,40,16,7,9,,,,16,7,9
146472,40,2993,1038,1955,405,170,235,2588,868,1720
146481,40,4,2,2,1,1,0,3,1,2
146506,40,1205,552,653,38,18,20,1167,534,633
146603,40,1708,791,917,60,29,31,1648,762,886
146612,40,108,71,37,1,0,1,107,71,36
146667,40,3,2,1,,,,3,2,1
146676,40,63,36,27,2,1,1,61,35,26
146685,40,881,380,501,82,44,38,799,336,463
146719,40,80,31,49,16,6,10,64,25,39
147004,40,4170,1761,2409,99,44,55,4071,1717,2354
147013,40,7,4,3,1,0,1,6,4,2
147244,40,93,28,65,38,7,31,55,21,34
147341,40,5,3,2,2,1,1,3,2,1
147369,40,25,13,12,3,3,0,22,10,12
147378,40,3135,1740,1395,117,56,61,3018,1684,1334
147411,40,1148,500,648,22,12,10,1126,488,638
147536,40,122,20,102,21,5,16,101,15,86
147590,40,12,3,9,2,2,0,10,1,9
147660,40,20,8,12,4,0,4,16,8,8
147679,40,15,5,10,3,2,1,12,3,9
147703,40,15,8,7,,,,15,8,7
147767,40,156,30,126,26,9,17,130,21,109
147776,40,61,26,35,30,13,17,31,13,18
147800,40,571,143,428,45,25,20,526,118,408
147828,40,44,14,30,14,3,11,30,11,19
147916,40,2122,794,1328,337,114,223,1785,680,1105
148007,40,312,98,214,20,10,10,292,88,204
148016,40,3,1,2,2,1,1,1,0,1
148131,40,89,34,55,,,,89,34,55
148256,40,791,369,422,48,14,34,743,355,388
148292,40,810,353,457,29,12,17,781,341,440
148380,40,858,300,558,379,130,249,479,170,309
148405,40,31,16,15,,,,31,16,15
148487,40,71,22,49,4,2,2,67,20,47
148496,40,29,8,21,,,,29,8,21
148575,40,2,1,1,,,,2,1,1
148584,40,53,9,44,,,,53,9,44
148627,40,14,7,7,4,2,2,10,5,5
148654,40,62,22,40,24,9,15,38,13,25
148672,40,302,115,187,21,7,14,281,108,173
148821,40,387,147,240,76,20,56,311,127,184
148876,40,23,1,22,2,1,1,21,0,21
148937,40,605,260,345,13,4,9,592,256,336
148991,40,452,200,252,9,1,8,443,199,244
149222,40,174,63,111,8,1,7,166,62,104
149231,40,64,35,29,18,14,4,46,21,25
149365,40,1659,785,874,50,28,22,1609,757,852
149505,40,89,31,58,43,15,28,46,16,30
149514,40,41,15,26,23,9,14,18,6,12
149532,40,2548,1060,1488,181,52,129,2367,1008,1359
149639,40,16,13,3,3,2,1,13,11,2
149727,40,2188,1004,1184,37,12,25,2151,992,1159
149763,40,1,1,0,,,,1,1,0
149772,40,126,48,78,,,,126,48,78
149781,40,40,18,22,,,,40,18,22
149842,40,2904,1251,1653,116,44,72,2788,1207,1581
150066,40,22,12,10,3,2,1,19,10,9
150136,40,1002,396,606,4,1,3,998,395,603
150145,40,62,28,34,1,1,0,61,27,34
150163,40,149,41,108,29,21,8,120,20,100
150172,40,1,0,1,,,,1,0,1
150400,40,16,5,11,,,,16,5,11
150455,40,5,1,4,4,1,3,1,0,1
150534,40,242,112,130,14,4,10,228,108,120
150604,40,19,9,10,,,,19,9,10
150668,40,24,4,20,1,0,1,23,4,19
150677,40,172,53,119,35,1,34,137,52,85
150756,40,4,3,1,1,1,0,3,2,1
150774,40,23,4,19,,,,23,4,19
150941,40,118,49,69,1,0,1,117,49,68
150987,40,35011,16861,18150,1588,668,920,33423,16193,17230
151102,40,2060,869,1191,18,3,15,2042,866,1176
151111,40,490,180,310,53,21,32,437,159,278
151263,40,109,41,68,,,,109,41,68
151290,40,142,68,74,,,,142,68,74
151306,40,1877,731,1146,48,11,37,1829,720,1109
151324,40,51,33,18,2,1,1,49,32,17
151333,40,205,93,112,2,1,1,203,92,111
151342,40,74,37,37,6,3,3,68,34,34
151351,40,258,111,147,81,49,32,177,62,115
151360,40,122,38,84,8,3,5,114,35,79
151379,40,87,35,52,5,3,2,82,32,50
151388,40,248,103,145,15,9,6,233,94,139
151661,40,28,24,4,28,24,4,,,
151777,40,4,0,4,,,,4,0,4
151786,40,312,61,251,56,6,50,256,55,201
151801,40,193,78,115,,,,193,78,115
152080,40,23,11,12,23,11,12,,,
152099,40,110,50,60,53,25,28,57,25,32
152318,40,6,2,4,4,0,4,2,2,0
152336,40,2,1,1,,,,2,1,1
152381,40,9,1,8,1,0,1,8,1,7
152390,40,27,3,24,1,0,1,26,3,23
152530,40,231,98,133,4,2,2,227,96,131
152567,40,1557,591,966,44,22,22,1513,569,944
152600,40,14,5,9,9,3,6,5,2,3
152637,40,12253,5984,6269,1123,534,589,11130,5450,5680
152992,40,118,48,70,2,0,2,116,48,68
153001,40,55,12,43,14,5,9,41,7,34
153108,40,33,16,17,1,1,0,32,15,17
153126,40,15,4,11,1,1,0,14,3,11
153144,40,24,14,10,10,4,6,14,10,4
153162,40,1,1,0,1,1,0,,,
153214,40,10361,4540,5821,354,137,217,10007,4403,5604
153250,40,124,62,62,2,1,1,122,61,61
153269,40,45,22,23,3,1,2,42,21,21
153278,40,12,6,6,,,,12,6,6
153296,40,140,52,88,3,0,3,137,52,85
153302,40,17,4,13,1,0,1,16,4,12
153311,40,4025,1976,2049,247,106,141,3778,1870,1908
153320,40,87,38,49,9,5,4,78,33,45
153366,40,35,21,14,,,,35,21,14
153375,40,29,13,16,1,1,0,28,12,16
153384,40,35,21,14,9,3,6,26,18,8
153445,40,2371,992,1379,103,33,70,2268,959,1309
153472,40,1571,768,803,240,108,132,1331,660,671
153524,40,2071,1044,1027,227,88,139,1844,956,888
153533,40,883,317,566,25,10,15,858,307,551
153603,40,271,125,146,45,29,16,226,96,130
153621,40,43,22,21,6,3,3,37,19,18
153630,40,2203,972,1231,229,103,126,1974,869,1105
153658,40,410,191,219,104,59,45,306,132,174
153737,40,4826,2360,2466,139,53,86,4687,2307,2380
153825,40,60,22,38,2,2,0,58,20,38
153834,40,12,3,9,5,1,4,7,2,5
153861,40,3,1,2,,,,3,1,2
153922,40,951,381,570,108,54,54,843,327,516
153977,40,1,0,1,,,,1,0,1
154004,40,57,23,34,2,0,2,55,23,32
154013,40,10,3,7,,,,10,3,7
154022,40,1550,1080,470,1550,1080,470,,,
154059,40,1091,504,587,100,65,35,991,439,552
154095,40,155,58,97,20,9,11,135,49,86
154101,40,23,5,18,5,1,4,18,4,14
154110,40,2244,1062,1182,97,47,50,2147,1015,1132
154129,40,937,351,586,22,13,9,915,338,577
154174,40,4,2,2,3,2,1,1,0,1
154235,40,8,3,5,,,,8,3,5
154350,40,5,2,3,,,,5,2,3
154378,40,824,354,470,42,19,23,782,335,447
154396,40,793,359,434,37,10,27,756,349,407
154493,40,187,66,121,2,0,2,185,66,119
154518,40,54,26,28,2,2,0,52,24,28
154527,40,11,4,7,1,1,0,10,3,7
154572,40,2794,1186,1608,226,87,139,2568,1099,1469
154590,40,41,14,27,4,3,1,37,11,26
154642,40,866,336,530,217,74,143,649,262,387
154688,40,338,138,200,,,,338,138,200
154697,40,1591,668,923,124,38,86,1467,630,837
154712,40,129,55,74,2,0,2,127,55,72
154721,40,47,20,27,,,,47,20,27
154749,40,7,0,7,5,0,5,2,0,2
154800,40,879,332,547,41,26,15,838,306,532
154855,40,57,17,40,5,0,5,52,17,35
154907,40,750,327,423,20,8,12,730,319,411
154925,40,512,298,214,84,72,12,428,226,202
154934,40,490,178,312,25,8,17,465,170,295
154952,40,622,264,358,109,82,27,513,182,331
154998,40,684,347,337,156,116,40,528,231,297
155007,40,2,2,0,,,,2,2,0
155025,40,89,26,63,23,4,19,66,22,44
155052,40,1027,572,455,34,11,23,993,561,432
155061,40,378,174,204,71,40,31,307,134,173
155070,40,6,3,3,,,,6,3,3
155089,40,214,85,129,36,17,19,178,68,110
155098,40,654,276,378,54,39,15,600,237,363
155104,40,554,249,305,48,23,25,506,226,280
155140,40,1,0,1,1,0,1,,,
155186,40,1129,502,627,27,11,16,1102,491,611
155195,40,1977,961,1016,117,63,54,1860,898,962
155201,40,383,139,244,21,8,13,362,131,231
155210,40,6060,2725,3335,645,337,308,5415,2388,3027
155292,40,1520,687,833,181,77,104,1339,610,729
155317,40,731,349,382,83,39,44,648,310,338
155335,40,1289,520,769,17,6,11,1272,514,758
155399,40,235,118,117,29,18,11,206,100,106
155414,40,2,1,1,,,,2,1,1
155423,40,6,4,2,,,,6,4,2
155450,40,52,28,24,7,5,2,45,23,22
155487,40,533,335,198,7,3,4,526,332,194
155496,40,5,2,3,,,,5,2,3
155511,40,5,1,4,,,,5,1,4
155520,40,163,85,78,7,3,4,156,82,74
155566,40,826,388,438,31,16,15,795,372,423
155593,40,427,218,209,,,,427,218,209
155618,40,367,235,132,80,68,12,287,167,120
155636,40,11,5,6,2,2,0,9,3,6
155681,40,268,113,155,31,12,19,237,101,136
155715,40,564,226,338,38,16,22,526,210,316
155812,40,67,33,34,,,,67,33,34
155830,40,592,261,331,41,28,13,551,233,318
155858,40,704,285,419,68,22,46,636,263,373
155900,40,19,14,5,,,,19,14,5
155937,40,87,32,55,14,4,10,73,28,45
155973,40,66,28,38,5,2,3,61,26,35
156082,40,844,317,527,19,7,12,825,310,515
156107,40,2529,1342,1187,268,183,85,2261,1159,1102
156125,40,1632,669,963,54,24,30,1578,645,933
156213,40,137,48,89,3,1,2,134,47,87
156231,40,814,297,517,35,14,21,779,283,496
156286,40,51,26,25,1,0,1,50,26,24
156295,40,14,7,7,,,,14,7,7
156338,40,1538,654,884,33,8,25,1505,646,859
156356,40,50,21,29,3,2,1,47,19,28
156365,40,2014,736,1278,47,16,31,1967,720,1247
156392,40,2138,909,1229,102,38,64,2036,871,1165
156408,40,5,1,4,5,1,4,,,
156417,40,29,23,6,,,,29,23,6
156541,40,459,193,266,20,11,9,439,182,257
156620,40,697,262,435,3,2,1,694,260,434
156648,40,2011,867,1144,322,113,209,1689,754,935
156745,40,31,13,18,1,0,1,30,13,17
156790,40,1419,737,682,75,26,49,1344,711,633
156851,40,617,191,426,30,9,21,587,182,405
156860,40,592,197,395,46,16,30,546,181,365
156921,40,4525,2017,2508,181,82,99,4344,1935,2409
157030,40,12,5,7,,,,12,5,7
157058,40,475,185,290,9,1,8,466,184,282
157076,40,37,27,10,6,3,3,31,24,7
157085,40,542,234,308,47,27,20,495,207,288
157100,40,89,28,61,,,,89,28,61
157216,40,51,24,27,10,2,8,41,22,19
157289,40,1819,646,1173,70,47,23,1749,599,1150
157304,40,1422,801,621,116,37,79,1306,764,542
157331,40,1577,669,908,66,27,39,1511,642,869
157377,40,13,6,7,1,0,1,12,6,6
157386,40,3102,1205,1897,164,72,92,2938,1133,1805
157401,40,907,294,613,39,15,24,868,279,589
157438,40,1569,696,873,169,64,105,1400,632,768
157447,40,1832,679,1153,213,67,146,1619,612,1007
157483,40,1908,938,970,7,2,5,1901,936,965
157535,40,368,168,200,1,1,0,367,167,200
157553,40,472,175,297,63,23,40,409,152,257
157711,40,1632,728,904,40,29,11,1592,699,893
157739,40,1111,600,511,147,57,90,964,543,421
157748,40,166,74,92,4,1,3,162,73,89
157757,40,82,40,42,,,,82,40,42
157793,40,25,11,14,8,4,4,17,7,10
157809,40,390,164,226,1,1,0,389,163,226
157863,40,13,4,9,,,,13,4,9
157951,40,2203,759,1444,201,96,105,2002,663,1339
158088,40,723,473,250,43,39,4,680,434,246
158431,40,623,239,384,60,28,32,563,211,352
158477,40,9,4,5,8,4,4,1,0,1
158662,40,856,351,505,83,44,39,773,307,466
158802,40,2,0,2,,,,2,0,2
158884,40,603,253,350,14,10,4,589,243,346
159382,40,595,214,381,66,21,45,529,193,336
159391,40,2818,1170,1648,140,78,62,2678,1092,1586
159407,40,495,160,335,4,1,3,491,159,332
159416,40,281,90,191,2,1,1,279,89,190
159568,40,90,31,59,1,0,1,89,31,58
159647,40,2268,923,1345,327,130,197,1941,793,1148
159656,40,135,22,113,57,15,42,78,7,71
159717,40,691,268,423,125,43,82,566,225,341
159939,40,879,352,527,36,19,17,843,333,510
159966,40,386,139,247,8,4,4,378,135,243
159993,40,1352,518,834,40,17,23,1312,501,811
160010,40,178,111,67,66,48,18,112,63,49
160038,40,2109,762,1347,216,66,150,1893,696,1197
160065,40,351,141,210,,,,351,141,210
160074,40,59,26,33,,,,59,26,33
160481,40,221,98,123,4,3,1,217,95,122
160579,40,437,200,237,46,17,29,391,183,208
160612,40,2353,899,1454,8,4,4,2345,895,1450
160621,40,751,327,424,24,11,13,727,316,411
160630,40,519,196,323,,,,519,196,323
160649,40,832,336,496,14,7,7,818,329,489
160658,40,1088,487,601,29,19,10,1059,468,591
160667,40,2678,1239,1439,11,9,2,2667,1230,1437
160755,40,262,113,149,96,57,39,166,56,110
160904,40,28,15,13,5,5,0,23,10,13
160959,40,5,2,3,3,1,2,2,1,1
160995,40,2,0,2,2,0,2,,,
161004,40,3,3,0,,,,3,3,0
161077,40,992,460,532,10,8,2,982,452,530
161138,40,787,410,377,34,26,8,753,384,369
161192,40,815,302,513,10,0,10,805,302,503
161217,40,1354,502,852,26,10,16,1328,492,836
161226,40,200,75,125,9,2,7,191,73,118
161235,40,1166,353,813,4,2,2,1162,351,811
161253,40,869,330,539,18,2,16,851,328,523
161299,40,3,2,1,1,1,0,2,1,1
161341,40,590,212,378,47,22,25,543,190,353
161457,40,1447,439,1008,26,14,12,1421,425,996
161484,40,156,78,78,1,0,1,155,78,77
161509,40,2,0,2,,,,2,0,2
161545,40,1272,512,760,15,5,10,1257,507,750
161554,40,1288,563,725,42,19,23,1246,544,702
161563,40,622,262,360,6,2,4,616,260,356
161572,40,10,2,8,10,2,8,,,
161581,40,175,63,112,22,3,19,153,60,93
161688,40,750,266,484,40,15,25,710,251,459
161767,40,2056,820,1236,50,21,29,2006,799,1207
161864,40,693,243,450,39,8,31,654,235,419
161873,40,26,11,15,,,,26,11,15
162007,40,102,46,56,6,2,4,96,44,52
162061,40,9,5,4,,,,9,5,4
162104,40,427,162,265,26,11,15,401,151,250
162122,40,511,177,334,43,12,31,468,165,303
162168,40,397,132,265,11,1,10,386,131,255
162210,40,96,41,55,2,1,1,94,40,54
162283,40,60,28,32,3,3,0,57,25,32
162557,40,1757,744,1013,146,57,89,1611,687,924
162584,40,391,221,170,138,75,63,253,146,107
162609,40,188,66,122,4,1,3,184,65,119
162654,40,3,0,3,,,,3,0,3
162690,40,858,348,510,88,29,59,770,319,451
162706,40,838,354,484,45,25,20,793,329,464
162760,40,15,5,10,3,1,2,12,4,8
162779,40,892,346,546,68,32,36,824,314,510
162928,40,405,101,304,8,0,8,397,101,296
163046,40,19,7,12,6,2,4,13,5,8
163204,40,2108,1260,848,50,22,28,2058,1238,820
163259,40,18,3,15,,,,18,3,15
163268,40,88,42,46,3,3,0,85,39,46
163286,40,554,271,283,81,45,36,473,226,247
163295,40,1,0,1,,,,1,0,1
163338,40,53,26,27,,,,53,26,27
163426,40,3634,1232,2402,969,356,613,2665,876,1789
163453,40,7,2,5,,,,7,2,5
163462,40,46,17,29,6,1,5,40,16,24
163578,40,26,2,24,2,0,2,24,2,22
163657,40,2180,709,1471,400,128,272,1780,581,1199
163851,40,240,123,117,6,1,5,234,122,112
163912,40,12,9,3,2,1,1,10,8,2
164076,40,90,43,47,16,8,8,74,35,39
164173,40,20,5,15,,,,20,5,15
164216,40,16,6,10,11,3,8,5,3,2
164270,40,16,6,10,4,2,2,12,4,8
164313,40,437,134,303,8,3,5,429,131,298
164447,40,24,11,13,,,,24,11,13
164492,40,43,13,30,,,,43,13,30
164562,40,15,2,13,,,,15,2,13
164580,40,44,21,23,19,10,9,25,11,14
164614,40,2,1,1,,,,2,1,1
164632,40,46,0,46,2,0,2,44,0,44
164641,40,1,0,1,,,,1,0,1
164739,40,54,25,29,51,23,28,3,2,1
164748,40,51,25,26,1,0,1,50,25,25
164775,40,302,124,178,11,4,7,291,120,171
164872,40,26,7,19,2,1,1,24,6,18
164924,40,163,76,87,91,32,59,72,44,28
164988,40,728,372,356,263,132,131,465,240,225
165015,40,14,3,11,3,1,2,11,2,9
165024,40,227,89,138,24,7,17,203,82,121
165033,40,646,265,381,49,16,33,597,249,348
165112,40,1357,444,913,52,15,37,1305,429,876
165167,40,185,61,124,,,,185,61,124
165194,40,370,114,256,35,8,27,335,106,229
165264,40,3,0,3,,,,3,0,3
165334,40,12,6,6,6,2,4,6,4,2
165529,40,25,11,14,11,6,5,14,5,9
165574,40,3,0,3,,,,3,0,3
165644,40,1,1,0,,,,1,1,0
165662,40,10,4,6,3,2,1,7,2,5
165671,40,78,18,60,1,1,0,77,17,60
165699,40,65,35,30,8,1,7,57,34,23
165802,40,167,19,148,,,,167,19,148
165820,40,181,96,85,9,3,6,172,93,79
165866,40,178,74,104,10,6,4,168,68,100
165884,40,57,43,14,18,16,2,39,27,12
165936,40,32,12,20,9,2,7,23,10,13
165981,40,336,118,218,49,16,33,287,102,185
166018,40,7,3,4,7,3,4,,,
166027,40,1641,792,849,107,60,47,1534,732,802
166045,40,30,13,17,30,13,17,,,
166054,40,1,1,0,1,1,0,,,
166124,40,24,7,17,,,,24,7,17
166133,40,509,171,338,35,8,27,474,163,311
166391,40,7,5,2,,,,7,5,2
166452,40,72,29,43,52,23,29,20,6,14
166513,40,338,164,174,24,12,12,314,152,162
166629,40,284,119,165,73,32,41,211,87,124
166638,40,320,168,152,105,54,51,215,114,101
166647,40,636,213,423,54,25,29,582,188,394
166656,40,4,0,4,,,,4,0,4
166674,40,55,18,37,,,,55,18,37
166683,40,9,6,3,9,6,3,,,
166692,40,9,1,8,7,0,7,2,1,1
166823,40,1193,430,763,186,73,113,1007,357,650
166850,40,119,29,90,,,,119,29,90
166869,40,5,3,2,5,3,2,,,
166887,40,2204,904,1300,126,66,60,2078,838,1240
166911,40,5,3,2,,,,5,3,2
166939,40,6,2,4,3,0,3,3,2,1
166957,40,477,155,322,95,33,62,382,122,260
167057,40,18,10,8,,,,18,10,8
167260,40,3,0,3,,,,3,0,3
167288,40,19,2,17,,,,19,2,17
167312,40,496,165,331,18,13,5,478,152,326
167358,40,102,45,57,66,23,43,36,22,14
167376,40,886,268,618,48,16,32,838,252,586
167394,40,45,15,30,,,,45,15,30
167455,40,17,14,3,16,13,3,1,1,0
167525,40,357,126,231,39,21,18,318,105,213
167534,40,1193,409,784,62,26,36,1131,383,748
167598,40,34,5,29,1,0,1,33,5,28
167631,40,135,41,94,13,9,4,122,32,90
167677,40,5,5,0,5,5,0,,,
167729,40,509,192,317,36,17,19,473,175,298
167783,40,2,0,2,1,0,1,1,0,1
167792,40,26,13,13,,,,26,13,13
167871,40,2,1,1,,,,2,1,1
167899,40,3,1,2,,,,3,1,2
167905,40,368,109,259,15,6,9,353,103,250
167987,40,215,81,134,11,6,5,204,75,129
167996,40,52,27,25,3,1,2,49,26,23
168005,40,40,11,29,17,4,13,23,7,16
168148,40,48,26,22,10,3,7,38,23,15
168218,40,78,30,48,6,0,6,72,30,42
168227,40,92,55,37,13,11,2,79,44,35
168254,40,4,0,4,,,,4,0,4
168263,40,265,113,152,3,1,2,262,112,150
168281,40,3,0,3,3,0,3,,,
168342,40,45,15,30,6,2,4,39,13,26
168421,40,90,51,39,41,20,21,49,31,18
168430,40,369,147,222,3,2,1,366,145,221
168528,40,64,20,44,,,,64,20,44
168546,40,12,6,6,2,1,1,10,5,5
168591,40,30,11,19,10,1,9,20,10,10
168607,40,735,303,432,99,33,66,636,270,366
168740,40,43,19,24,11,4,7,32,15,17
168786,40,83,42,41,1,0,1,82,42,40
168847,40,549,188,361,37,10,27,512,178,334
168883,40,734,282,452,63,26,37,671,256,415
169080,40,105,39,66,2,0,2,103,39,64
169248,40,94,44,50,7,4,3,87,40,47
169275,40,1369,486,883,260,86,174,1109,400,709
169363,40,108,37,71,,,,108,37,71
169442,40,127,45,82,6,5,1,121,40,81
169479,40,451,178,273,8,4,4,443,174,269
169521,40,1093,415,678,127,42,85,966,373,593
169716,40,539,365,174,,,,539,365,174
169798,40,386,166,220,118,57,61,268,109,159
169910,40,438,164,274,5,0,5,433,164,269
169974,40,415,150,265,65,22,43,350,128,222
169983,40,20,14,6,4,3,1,16,11,5
169992,40,278,107,171,49,19,30,229,88,141
170000,40,238,132,106,,,,238,132,106
170037,40,44,24,20,2,2,0,42,22,20
170055,40,1398,582,816,68,30,38,1330,552,778
170082,40,140,44,96,9,8,1,131,36,95
170091,40,10,3,7,,,,10,3,7
170240,40,2102,910,1192,463,214,249,1639,696,943
170286,40,20,7,13,3,2,1,17,5,12
170301,40,77,31,46,2,1,1,75,30,45
170444,40,1114,438,676,100,39,61,1014,399,615
170532,40,15,3,12,14,3,11,1,0,1
170541,40,1392,596,796,219,95,124,1173,501,672
170550,40,787,249,538,71,19,52,716,230,486
170587,40,520,285,235,14,7,7,506,278,228
170620,40,375,150,225,13,8,5,362,142,220
170639,40,219,83,136,8,4,4,211,79,132
170657,40,1404,505,899,261,87,174,1143,418,725
170675,40,450,231,219,1,0,1,449,231,218
170790,40,1492,523,969,113,50,63,1379,473,906
170806,40,86,69,17,15,11,4,71,58,13
170967,40,245,92,153,41,14,27,204,78,126
170976,40,219,122,97,144,85,59,75,37,38
171100,40,150,64,86,76,31,45,74,33,41
171128,40,76,37,39,,,,76,37,39
171137,40,162,70,92,16,6,10,146,64,82
171146,40,623,247,376,77,26,51,546,221,325
171155,40,1137,383,754,55,22,33,1082,361,721
171225,40,731,272,459,44,23,21,687,249,438
171234,40,416,134,282,7,3,4,409,131,278
171304,40,742,244,498,113,34,79,629,210,419
171395,40,639,252,387,69,29,40,570,223,347
171456,40,281,91,190,10,6,4,271,85,186
171483,40,435,149,286,28,12,16,407,137,270
171492,40,24,13,11,4,3,1,20,10,10
171535,40,1985,993,992,291,171,120,1694,822,872
171571,40,233,86,147,33,15,18,200,71,129
171599,40,13,6,7,,,,13,6,7
171881,40,22,10,12,5,3,2,17,7,10
172033,40,24,15,9,,,,24,15,9
172051,40,267,78,189,106,30,76,161,48,113
172200,40,890,345,545,46,23,23,844,322,522
172264,40,142,49,93,3,2,1,139,47,92
172291,40,1033,367,666,191,70,121,842,297,545
172307,40,467,199,268,41,23,18,426,176,250
172334,40,106,48,58,,,,106,48,58
172440,40,24,7,17,,,,24,7,17
172617,40,2480,1169,1311,506,277,229,1974,892,1082
172635,40,3713,1431,2282,113,39,74,3600,1392,2208
172644,40,309,100,209,23,6,17,286,94,192
172671,40,321,119,202,46,18,28,275,101,174
172699,40,301,125,176,22,9,13,279,116,163
172866,40,3,2,1,3,2,1,,,
172918,40,1331,574,757,184,75,109,1147,499,648
172954,40,197,89,108,35,26,9,162,63,99
172963,40,3663,1380,2283,895,314,581,2768,1066,1702
173045,40,17,9,8,3,2,1,14,7,7
173063,40,1325,545,780,237,76,161,1088,469,619
173115,40,227,69,158,6,4,2,221,65,156
173124,40,369,150,219,37,15,22,332,135,197
173142,40,122,45,77,5,3,2,117,42,75
173160,40,355,127,228,172,62,110,183,65,118
173203,40,2824,1066,1758,586,178,408,2238,888,1350
173258,40,36,10,26,24,8,16,12,2,10
173300,40,21,7,14,5,1,4,16,6,10
173328,40,372,126,246,117,42,75,255,84,171
173416,40,379,205,174,29,18,11,350,187,163
173452,40,59,19,40,,,,59,19,40
173461,40,1654,632,1022,180,54,126,1474,578,896
173559,40,2185,734,1451,240,68,172,1945,666,1279
173638,40,1602,686,916,217,73,144,1385,613,772
173665,40,30,9,21,8,1,7,22,8,14
173708,40,1117,587,530,102,80,22,1015,507,508
173735,40,210,56,154,92,28,64,118,28,90
173799,40,1307,431,876,260,97,163,1047,334,713
173805,40,377,124,253,116,33,83,261,91,170
173902,40,9,3,6,5,3,2,4,0,4
173911,40,541,252,289,39,12,27,502,240,262
173920,40,1120,385,735,136,45,91,984,340,644
173993,40,303,105,198,100,38,62,203,67,136
174020,40,311,151,160,17,9,8,294,142,152
174066,40,5475,2278,3197,499,226,273,4976,2052,2924
174075,40,730,298,432,44,10,34,686,288,398
174127,40,8,3,5,5,2,3,3,1,2
174136,40,1167,435,732,168,70,98,999,365,634
174154,40,4,1,3,,,,4,1,3
174233,40,940,390,550,103,44,59,837,346,491
174251,40,97,46,51,26,12,14,71,34,37
174358,40,248,89,159,27,5,22,221,84,137
174376,40,1608,574,1034,373,120,253,1235,454,781
174428,40,2685,994,1691,750,281,469,1935,713,1222
174437,40,82,30,52,27,12,15,55,18,37
174473,40,984,338,646,35,15,20,949,323,626
174491,40,1690,621,1069,561,205,356,1129,416,713
174507,40,138,47,91,57,20,37,81,27,54
174525,40,14,6,8,1,1,0,13,5,8
174570,40,1170,444,726,51,14,37,1119,430,689
174604,40,60,22,38,48,18,30,12,4,8
174738,40,1274,431,843,353,107,246,921,324,597
174747,40,7,0,7,2,0,2,5,0,5
174756,40,555,208,347,181,69,112,374,139,235
174783,40,2902,1131,1771,261,63,198,2641,1068,1573
174792,40,5,5,0,1,1,0,4,4,0
174817,40,30,21,9,3,2,1,27,19,8
174844,40,33,13,20,16,4,12,17,9,8
174862,40,388,161,227,94,31,63,294,130,164
174899,40,10,2,8,5,1,4,5,1,4
174914,40,26,16,10,1,0,1,25,16,9
175005,40,39,1,38,1,0,1,38,1,37
175014,40,105,0,105,,,,105,0,105
175041,40,1188,450,738,135,49,86,1053,401,652
175078,40,4574,1773,2801,187,68,119,4387,1705,2682
175157,40,196,69,127,23,3,20,173,66,107
175227,40,8,7,1,1,1,0,7,6,1
175236,40,662,207,455,253,75,178,409,132,277
175263,40,828,375,453,76,38,38,752,337,415
175272,40,142,37,105,20,4,16,122,33,89
175315,40,1408,583,825,295,126,169,1113,457,656
175342,40,55,12,43,,,,55,12,43
175421,40,82,36,46,1,0,1,81,36,45
175430,40,339,147,192,12,2,10,327,145,182
175519,40,253,99,154,,,,253,99,154
175573,40,830,277,553,104,33,71,726,244,482
175616,40,325,123,202,7,4,3,318,119,199
175643,40,565,209,356,45,23,22,520,186,334
175652,40,712,236,476,75,25,50,637,211,426
175786,40,3128,1314,1814,220,100,120,2908,1214,1694
175810,40,912,357,555,4,4,0,908,353,555
175829,40,792,303,489,35,11,24,757,292,465
175856,40,21,12,9,6,2,4,15,10,5
175883,40,854,352,502,46,15,31,808,337,471
175935,40,362,126,236,4,3,1,358,123,235
175980,40,2,1,1,,,,2,1,1
176008,40,347,102,245,10,8,2,337,94,243
176017,40,98,58,40,70,43,27,28,15,13
176035,40,344,129,215,,,,344,129,215
176044,40,398,166,232,24,2,22,374,164,210
176053,40,279,142,137,5,1,4,274,141,133
176071,40,1575,607,968,284,103,181,1291,504,787
176080,40,133,70,63,33,20,13,100,50,50
176169,40,508,189,319,1,0,1,507,189,318
176178,40,1629,613,1016,22,6,16,1607,607,1000
176239,40,791,277,514,133,30,103,658,247,411
176336,40,4,2,2,2,1,1,2,1,1
176354,40,205,71,134,,,,205,71,134
176372,40,96,29,67,2,2,0,94,27,67
176406,40,124,42,82,67,19,48,57,23,34
176479,40,1377,531,846,158,77,81,1219,454,765
176628,40,25,8,17,,,,25,8,17
176789,40,71,33,38,13,7,6,58,26,32
176910,40,11,6,5,,,,11,6,5
176947,40,1,1,0,,,,1,1,0
176965,40,1170,435,735,28,8,20,1142,427,715
177065,40,192,88,104,14,5,9,178,83,95
177083,40,1,1,0,,,,1,1,0
177135,40,1211,465,746,64,27,37,1147,438,709
177144,40,39,17,22,,,,39,17,22
177214,40,5,1,4,4,1,3,1,0,1
177250,40,838,332,506,109,58,51,729,274,455
177339,40,15,8,7,,,,15,8,7
177418,40,9,4,5,1,0,1,8,4,4
177472,40,2092,981,1111,151,64,87,1941,917,1024
177542,40,115,37,78,,,,115,37,78
177551,40,11,4,7,5,1,4,6,3,3
177676,40,1096,466,630,133,45,88,963,421,542
177746,40,2,1,1,,,,2,1,1
177940,40,376,171,205,41,37,4,335,134,201
177968,40,20,7,13,,,,20,7,13
177977,40,98,60,38,23,9,14,75,51,24
177986,40,33,16,17,6,2,4,27,14,13
177995,40,2090,931,1159,374,170,204,1716,761,955
178059,40,58,12,46,,,,58,12,46
178208,40,70,47,23,7,5,2,63,42,21
178217,40,740,249,491,128,28,100,612,221,391
178244,40,2747,1070,1677,59,14,45,2688,1056,1632
178341,40,652,241,411,24,9,15,628,232,396
178369,40,294,97,197,12,3,9,282,94,188
178387,40,1243,438,805,48,27,21,1195,411,784
178396,40,604,298,306,44,21,23,560,277,283
178402,40,3936,1648,2288,73,46,27,3863,1602,2261
178411,40,28,18,10,5,3,2,23,15,8
178420,40,6629,2703,3926,362,170,192,6267,2533,3734
178448,40,1370,471,899,185,64,121,1185,407,778
178615,40,572,246,326,17,9,8,555,237,318
178624,40,546,190,356,30,9,21,516,181,335
178679,40,4,4,0,,,,4,4,0
178697,40,11,5,6,,,,11,5,6
178721,40,256,166,90,10,7,3,246,159,87
178767,40,1,0,1,,,,1,0,1
178891,40,6,6,0,,,,6,6,0
179043,40,783,268,515,7,1,6,776,267,509
179159,40,1468,653,815,32,26,6,1436,627,809
179256,40,2,1,1,,,,2,1,1
179265,40,1,0,1,1,0,1,,,
179308,40,2899,867,2032,507,188,319,2392,679,1713
179326,40,401,173,228,26,12,14,375,161,214
179344,40,1038,362,676,47,13,34,991,349,642
179539,40,1127,420,707,32,10,22,1095,410,685
179557,40,1323,471,852,86,32,54,1237,439,798
179566,40,4627,1937,2690,64,19,45,4563,1918,2645
179645,40,640,207,433,23,8,15,617,199,418
179715,40,564,176,388,16,5,11,548,171,377
179867,40,321,86,235,25,9,16,296,77,219
179894,40,19,10,9,,,,19,10,9
179946,40,4,1,3,,,,4,1,3
179964,40,55,38,17,1,0,1,54,38,16
180054,40,14,0,14,,,,14,0,14
180081,40,344,135,209,,,,344,135,209
180106,40,14,7,7,5,2,3,9,5,4
180151,40,150,55,95,11,4,7,139,51,88
180160,40,6,2,4,,,,6,2,4
180179,40,910,333,577,32,10,22,878,323,555
180197,40,827,420,407,27,14,13,800,406,394
180203,40,38,18,20,1,0,1,37,18,19
180212,40,112,42,70,,,,112,42,70
180249,40,437,146,291,33,20,13,404,126,278
180258,40,5,2,3,,,,5,2,3
180276,40,831,332,499,16,9,7,815,323,492
180328,40,5,2,3,1,0,1,4,2,2
180373,40,172,53,119,2,0,2,170,53,117
180416,40,7,2,5,,,,7,2,5
180461,40,319,144,175,24,7,17,295,137,158
180489,40,197,67,130,25,8,17,172,59,113
180522,40,170,125,45,1,1,0,169,124,45
180595,40,10,4,6,2,1,1,8,3,5
180647,40,54,18,36,,,,54,18,36
180692,40,116,20,96,4,3,1,112,17,95
180717,40,22,11,11,9,6,3,13,5,8
180814,40,525,207,318,36,14,22,489,193,296
180878,40,60,9,51,,,,60,9,51
180902,40,2832,1218,1614,56,23,33,2776,1195,1581
180948,40,158,57,101,3,2,1,155,55,100
180984,40,1360,619,741,1,0,1,1359,619,740
181002,40,26,12,14,7,3,4,19,9,10
181020,40,3,1,2,1,0,1,2,1,1
181127,40,1,0,1,1,0,1,,,
181215,40,138,57,81,20,3,17,118,54,64
181303,40,7242,3398,3844,2197,1098,1099,5045,2300,2745
181312,40,1158,473,685,62,16,46,1096,457,639
181330,40,201,81,120,1,0,1,200,81,119
181394,40,187,93,94,21,7,14,166,86,80
181419,40,191,72,119,,,,191,72,119
181428,40,23,4,19,14,2,12,9,2,7
181446,40,20,4,16,17,4,13,3,0,3
181464,40,104,47,57,2,0,2,102,47,55
181491,40,2852,1700,1152,78,30,48,2774,1670,1104
181534,40,348,126,222,2,0,2,346,126,220
181543,40,2,0,2,,,,2,0,2
181604,40,36,9,27,,,,36,9,27
181640,40,3432,1496,1936,84,46,38,3348,1450,1898
181738,40,111,42,69,8,1,7,103,41,62
181765,40,36,10,26,1,0,1,35,10,25
181783,40,718,275,443,7,2,5,711,273,438
181817,40,726,302,424,55,30,25,671,272,399
182005,40,2125,1305,820,153,69,84,1972,1236,736
182281,40,477,181,296,9,4,5,468,177,291
182290,40,751,379,372,23,9,14,728,370,358
182306,40,1460,491,969,130,45,85,1330,446,884
182458,40,3,2,1,,,,3,2,1
182500,40,3124,1606,1518,281,126,155,2843,1480,1363
182564,40,1518,827,691,360,152,208,1158,675,483
182634,40,8,2,6,,,,8,2,6
182670,40,23,14,9,23,14,9,,,
182795,40,2,1,1,,,,2,1,1
182980,40,50,21,29,9,4,5,41,17,24
183026,40,2636,1058,1578,119,64,55,2517,994,1523
183044,40,99,53,46,24,12,12,75,41,34
183062,40,34,21,13,5,3,2,29,18,11
183071,40,10,4,6,1,0,1,9,4,5
183080,40,50,21,29,3,1,2,47,20,27
183099,40,476,167,309,12,6,6,464,161,303
183105,40,116,32,84,2,1,1,114,31,83
183114,40,92,26,66,1,0,1,91,26,65
183123,40,169,70,99,2,2,0,167,68,99
183132,40,352,171,181,14,10,4,338,161,177
183141,40,150,72,78,15,8,7,135,64,71
183150,40,150,57,93,5,3,2,145,54,91
183211,40,60,27,33,,,,60,27,33
183239,40,2,1,1,1,0,1,1,1,0
183257,40,73,10,63,4,3,1,69,7,62
183655,40,275,114,161,65,30,35,210,84,126
183743,40,1213,507,706,273,122,151,940,385,555
183789,40,74,35,39,1,0,1,73,35,38
183822,40,5,3,2,,,,5,3,2
183859,40,1682,671,1011,66,30,36,1616,641,975
183877,40,373,162,211,81,42,39,292,120,172
183910,40,7,4,3,,,,7,4,3
183938,40,1451,592,859,125,54,71,1326,538,788
183974,40,17,5,12,7,1,6,10,4,6
184180,40,741,351,390,155,65,90,586,286,300
184205,40,528,190,338,10,5,5,518,185,333
184348,40,114,72,42,80,55,25,34,17,17
184481,40,592,224,368,208,75,133,384,149,235
184603,40,3025,1237,1788,13,8,5,3012,1229,1783
184612,40,96,26,70,9,3,6,87,23,64
184694,40,90,55,35,66,41,25,24,14,10
184773,40,298,136,162,,,,298,136,162
184782,40,194,84,110,4,2,2,190,82,108
184791,40,961,337,624,75,32,43,886,305,581
184959,40,2,1,1,,,,2,1,1
184995,40,490,173,317,59,17,42,431,156,275
185129,40,116,36,80,21,8,13,95,28,67
185262,40,282,82,200,117,29,88,165,53,112
185509,40,771,333,438,50,28,22,721,305,416
185536,40,1318,545,773,46,26,20,1272,519,753
185572,40,23,11,12,6,5,1,17,6,11
185590,40,100,43,57,26,10,16,74,33,41
185721,40,1,1,0,,,,1,1,0
185828,40,806,434,372,18,14,4,788,420,368
185873,40,1356,552,804,158,66,92,1198,486,712
186034,40,453,195,258,100,49,51,353,146,207
186131,40,85,51,34,4,3,1,81,48,33
186186,40,1,1,0,1,1,0,,,
186201,40,286,97,189,9,1,8,277,96,181
186283,40,48,24,24,9,1,8,39,23,16
186371,40,109,92,17,3,2,1,106,90,16
186380,40,325,119,206,28,10,18,297,109,188
186399,40,268,124,144,9,2,7,259,122,137
186432,40,117,36,81,26,8,18,91,28,63
186469,40,11,7,4,2,0,2,9,7,2
186584,40,139,85,54,119,72,47,20,13,7
186618,40,64,0,64,7,0,7,57,0,57
186645,40,1301,534,767,87,42,45,1214,492,722
186867,40,11,10,1,10,9,1,1,1,0
186876,40,33,13,20,10,5,5,23,8,15
187046,40,139,82,57,,,,139,82,57
187134,40,111,63,48,88,52,36,23,11,12
187198,40,339,141,198,30,16,14,309,125,184
187444,40,54,25,29,6,1,5,48,24,24
187532,40,3288,1415,1873,120,49,71,3168,1366,1802
187596,40,367,165,202,2,0,2,365,165,200
187620,40,1747,709,1038,247,91,156,1500,618,882
187639,40,885,343,542,87,32,55,798,311,487
187648,40,895,355,540,10,6,4,885,349,536
187666,40,458,214,244,124,77,47,334,137,197
187745,40,448,188,260,,,,448,188,260
187897,40,93,33,60,2,0,2,91,33,58
187903,40,150,55,95,39,22,17,111,33,78
187912,40,102,65,37,,,,102,65,37
187958,40,718,317,401,189,81,108,529,236,293
187967,40,43,13,30,1,0,1,42,13,29
187976,40,126,65,61,3,1,2,123,64,59
187985,40,701,324,377,101,47,54,600,277,323
187994,40,485,178,307,23,9,14,462,169,293
188003,40,933,334,599,65,27,38,868,307,561
188021,40,428,147,281,10,2,8,418,145,273
188030,40,557,203,354,23,11,12,534,192,342
188049,40,709,297,412,11,1,10,698,296,402
188058,40,260,130,130,15,7,8,245,123,122
188100,40,1396,480,916,131,65,66,1265,415,850
188137,40,1116,470,646,59,21,38,1057,449,608
188216,40,13,4,9,5,2,3,8,2,6
188225,40,431,161,270,12,6,6,419,155,264
188261,40,424,233,191,4,1,3,420,232,188
188304,40,454,216,238,54,30,24,400,186,214
188340,40,1,1,0,,,,1,1,0
188429,40,83,52,31,17,13,4,66,39,27
188438,40,708,329,379,45,28,17,663,301,362
188517,40,12,1,11,,,,12,1,11
188526,40,8,2,6,,,,8,2,6
188641,40,25,8,17,4,1,3,21,7,14
188942,40,4,0,4,4,0,4,,,
189088,40,135,70,65,44,25,19,91,45,46
189097,40,36,8,28,1,0,1,35,8,27
189228,40,293,150,143,161,77,84,132,73,59
189547,40,1333,609,724,77,38,39,1256,571,685
189565,40,29,4,25,1,0,1,28,4,24
189583,40,112,37,75,,,,112,37,75
189592,40,4,1,3,,,,4,1,3
189705,40,59,27,32,14,5,9,45,22,23
189839,40,417,166,251,29,9,20,388,157,231
189848,40,27,12,15,3,2,1,24,10,14
190044,40,62,43,19,18,11,7,44,32,12
190053,40,572,255,317,38,25,13,534,230,304
190099,40,11,7,4,,,,11,7,4
190114,40,46,16,30,,,,46,16,30
190169,40,522,206,316,4,1,3,518,205,313
190372,40,7,2,5,6,2,4,1,0,1
190415,40,52,27,25,51,26,25,1,1,0
190442,40,2478,1102,1376,355,147,208,2123,955,1168
190512,40,376,116,260,55,17,38,321,99,222
190521,40,1081,401,680,66,33,33,1015,368,647
190530,40,663,228,435,12,9,3,651,219,432
190549,40,838,285,553,109,40,69,729,245,484
190558,40,351,128,223,12,8,4,339,120,219
190567,40,503,249,254,63,26,37,440,223,217
190576,40,45,21,24,2,0,2,43,21,22
190585,40,511,152,359,55,25,30,456,127,329
190594,40,859,338,521,27,14,13,832,324,508
190600,40,312,90,222,2,2,0,310,88,222
190619,40,6466,3129,3337,170,72,98,6296,3057,3239
190628,40,3182,1551,1631,223,114,109,2959,1437,1522
190637,40,766,197,569,9,0,9,757,197,560
190646,40,310,85,225,91,31,60,219,54,165
190655,40,787,349,438,41,26,15,746,323,423
190664,40,1024,420,604,17,2,15,1007,418,589
190673,40,1256,430,826,20,13,7,1236,417,819
190691,40,1174,470,704,222,122,100,952,348,604
190716,40,8,8,0,,,,8,8,0
190725,40,60,19,41,,,,60,19,41
190752,40,1,1,0,1,1,0,,,
190761,40,16,4,12,,,,16,4,12
190840,40,3234,1382,1852,234,79,155,3000,1303,1697
190983,40,2,0,2,,,,2,0,2
191083,40,1772,779,993,68,33,35,1704,746,958
191126,40,248,46,202,18,3,15,230,43,187
191199,40,2439,1025,1414,66,32,34,2373,993,1380
191205,40,1,0,1,,,,1,0,1
191241,40,235,76,159,40,15,25,195,61,134
191302,40,743,319,424,31,5,26,712,314,398
191339,40,2280,930,1350,173,61,112,2107,869,1238
191515,40,1,0,1,1,0,1,,,
191533,40,4,1,3,2,0,2,2,1,1
191612,40,699,265,434,98,37,61,601,228,373
191621,40,5,4,1,,,,5,4,1
191630,40,21,6,15,19,5,14,2,1,1
191649,40,46,36,10,17,11,6,29,25,4
191676,40,22,11,11,,,,22,11,11
191719,40,2351,1041,1310,165,97,68,2186,944,1242
191931,40,327,173,154,,,,327,173,154
191968,40,40,19,21,3,1,2,37,18,19
191986,40,2096,934,1162,163,61,102,1933,873,1060
192022,40,698,253,445,32,16,16,666,237,429
192110,40,115,64,51,,,,115,64,51
192192,40,1,0,1,,,,1,0,1
192323,40,109,25,84,,,,109,25,84
192448,40,4798,2153,2645,67,32,35,4731,2121,2610
192509,40,41,11,30,6,4,2,35,7,28
192712,40,11,1,10,2,1,1,9,0,9
192749,40,16,6,10,1,0,1,15,6,9
192785,40,37,11,26,,,,37,11,26
192819,40,413,193,220,,,,413,193,220
192864,40,57,15,42,9,2,7,48,13,35
192925,40,17,6,11,1,0,1,16,6,10
193016,40,645,208,437,18,2,16,627,206,421
193061,40,3,3,0,3,3,0,,,
193283,40,2491,1142,1349,203,115,88,2288,1027,1261
193292,40,60,17,43,8,1,7,52,16,36
193308,40,469,149,320,6,4,2,463,145,318
193326,40,719,377,342,10,7,3,709,370,339
193353,40,8,2,6,,,,8,2,6
193399,40,28,16,12,3,0,3,25,16,9
193478,40,1553,583,970,366,168,198,1187,415,772
193584,40,7,1,6,,,,7,1,6
193654,40,8,5,3,1,1,0,7,4,3
193900,40,216,93,123,81,34,47,135,59,76
193946,40,1155,467,688,87,37,50,1068,430,638
193973,40,21,8,13,8,2,6,13,6,7
194028,40,831,273,558,50,13,37,781,260,521
194091,40,69,34,35,1,1,0,68,33,35
194116,40,43,4,39,,,,43,4,39
194161,40,7,1,6,1,1,0,6,0,6
194222,40,3461,1663,1798,98,63,35,3363,1600,1763
194240,40,1345,579,766,69,33,36,1276,546,730
194310,40,440,177,263,30,7,23,410,170,240
194392,40,4,0,4,,,,4,0,4
194499,40,23,5,18,,,,23,5,18
194569,40,52,27,25,7,4,3,45,23,22
194578,40,39,10,29,18,6,12,21,4,17
194693,40,1,1,0,1,1,0,,,
194824,40,35,22,13,,,,35,22,13
194958,40,33,12,21,,,,33,12,21
195003,40,915,663,252,9,7,2,906,656,250
195030,40,151,43,108,3,1,2,148,42,106
195058,40,1414,609,805,13,7,6,1401,602,799
195128,40,5,2,3,,,,5,2,3
195164,40,54,24,30,,,,54,24,30
195173,40,8,5,3,,,,8,5,3
195216,40,20,5,15,2,0,2,18,5,13
195234,40,20,9,11,,,,20,9,11
195243,40,797,367,430,17,0,17,780,367,413
195304,40,30,8,22,26,8,18,4,0,4
195322,40,2136,952,1184,125,53,72,2011,899,1112
195438,40,41,41,0,41,41,0,,,
195474,40,42,18,24,1,1,0,41,17,24
195526,40,10,2,8,5,1,4,5,1,4
195544,40,21,10,11,2,2,0,19,8,11
195720,40,11,4,7,,,,11,4,7
195809,40,5394,2212,3182,15,7,8,5379,2205,3174
195988,40,762,352,410,74,35,39,688,317,371
196006,40,14,7,7,1,1,0,13,6,7
196015,40,85,37,48,2,1,1,83,36,47
196024,40,17,9,8,,,,17,9,8
196033,40,14,5,9,,,,14,5,9
196042,40,366,176,190,84,53,31,282,123,159
196051,40,18,11,7,7,6,1,11,5,6
196060,40,98,31,67,5,2,3,93,29,64
196079,40,4,3,1,3,2,1,1,1,0
196088,40,164,92,72,22,10,12,142,82,60
196097,40,99,37,62,65,20,45,34,17,17
196103,40,62,25,37,23,5,18,39,20,19
196112,40,113,27,86,5,4,1,108,23,85
196121,40,46,17,29,2,0,2,44,17,27
196130,40,123,56,67,10,4,6,113,52,61
196149,40,10,5,5,,,,10,5,5
196158,40,12,3,9,,,,12,3,9
196167,40,18,7,11,5,2,3,13,5,8
196176,40,114,32,82,3,3,0,111,29,82
196185,40,6,1,5,1,0,1,5,1,4
196194,40,40,26,14,1,1,0,39,25,14
196200,40,6,3,3,1,1,0,5,2,3
196219,40,70,30,40,15,6,9,55,24,31
196237,40,97,45,52,15,9,6,82,36,46
196246,40,37,19,18,7,3,4,30,16,14
196264,40,637,288,349,60,23,37,577,265,312
196291,40,2,1,1,,,,2,1,1
196307,40,4,1,3,,,,4,1,3
196413,40,263,130,133,95,31,64,168,99,69
196431,40,1,1,0,1,1,0,,,
196565,40,3198,1412,1786,149,66,83,3049,1346,1703
196592,40,850,214,636,25,9,16,825,205,620
196653,40,53,35,18,1,0,1,52,35,17
196699,40,1567,832,735,217,97,120,1350,735,615
196866,40,24,11,13,10,6,4,14,5,9
197036,40,63,51,12,63,51,12,,,
197045,40,176,49,127,11,2,9,165,47,118
197133,40,16,3,13,6,1,5,10,2,8
197142,40,4,1,3,,,,4,1,3
197151,40,8,3,5,8,3,5,,,
197197,40,6,4,2,,,,6,4,2
197230,40,1,1,0,,,,1,1,0
197285,40,123,20,103,,,,123,20,103
197294,40,1204,569,635,155,98,57,1049,471,578
197647,40,1,1,0,1,1,0,,,
197708,40,74,59,15,,,,74,59,15
197814,40,1099,421,678,269,102,167,830,319,511
197850,40,1470,535,935,124,36,88,1346,499,847
197869,40,69,35,34,37,20,17,32,15,17
197887,40,2159,826,1333,217,71,146,1942,755,1187
197911,40,105,7,98,1,0,1,104,7,97
197966,40,226,91,135,38,14,24,188,77,111
197984,40,81,36,45,1,1,0,80,35,45
198011,40,108,18,90,59,8,51,49,10,39
198039,40,805,317,488,63,28,35,742,289,453
198066,40,1,0,1,,,,1,0,1
198084,40,575,218,357,79,34,45,496,184,312
198118,40,1355,554,801,246,99,147,1109,455,654
198136,40,12,6,6,1,1,0,11,5,6
198154,40,4155,2560,1595,479,401,78,3676,2159,1517
198206,40,333,123,210,21,8,13,312,115,197
198215,40,10,2,8,,,,10,2,8
198233,40,1138,448,690,164,62,102,974,386,588
198251,40,1857,651,1206,208,81,127,1649,570,1079
198260,40,3759,1349,2410,562,215,347,3197,1134,2063
198321,40,889,335,554,99,37,62,790,298,492
198330,40,775,246,529,78,28,50,697,218,479
198367,40,718,294,424,117,54,63,601,240,361
198376,40,1177,444,733,295,94,201,882,350,532
198385,40,3,1,2,3,1,2,,,
198419,40,68,32,36,49,24,25,19,8,11
198455,40,843,285,558,83,33,50,760,252,508
198464,40,1232,306,926,17,6,11,1215,300,915
198491,40,117,33,84,7,1,6,110,32,78
198507,40,149,37,112,9,4,5,140,33,107
198534,40,1458,581,877,114,46,68,1344,535,809
198543,40,571,171,400,157,55,102,414,116,298
198552,40,1309,477,832,148,50,98,1161,427,734
198561,40,3,0,3,,,,3,0,3
198570,40,1915,712,1203,134,59,75,1781,653,1128
198598,40,147,40,107,7,0,7,140,40,100
198613,40,167,70,97,104,46,58,63,24,39
198622,40,1680,711,969,233,79,154,1447,632,815
198640,40,445,176,269,69,24,45,376,152,224
198668,40,494,193,301,39,17,22,455,176,279
198695,40,39,12,27,5,3,2,34,9,25
198710,40,798,280,518,148,52,96,650,228,422
198729,40,293,100,193,26,15,11,267,85,182
198774,40,1377,520,857,134,51,83,1243,469,774
198808,40,3,1,2,1,0,1,2,1,1
198817,40,894,371,523,151,49,102,743,322,421
198835,40,121,46,75,23,5,18,98,41,57
198899,40,8,1,7,1,0,1,7,1,6
198905,40,476,175,301,79,18,61,397,157,240
198914,40,430,219,211,60,29,31,370,190,180
198923,40,704,271,433,12,6,6,692,265,427
198950,40,16,2,14,1,0,1,15,2,13
198969,40,8,3,5,2,0,2,6,3,3
198987,40,1442,550,892,134,53,81,1308,497,811
199023,40,193,100,93,65,29,36,128,71,57
199032,40,2,1,1,,,,2,1,1
199069,40,194,43,151,15,3,12,179,40,139
199087,40,1124,460,664,91,35,56,1033,425,608
199102,40,269,138,131,94,47,47,175,91,84
199111,40,149,50,99,30,15,15,119,35,84
199120,40,123,52,71,15,5,10,108,47,61
199139,40,408,210,198,99,52,47,309,158,151
199148,40,289,113,176,101,55,46,188,58,130
199157,40,569,194,375,153,53,100,416,141,275
199184,40,3,1,2,,,,3,1,2
199193,40,1506,833,673,129,76,53,1377,757,620
199209,40,62,22,40,7,0,7,55,22,33
199218,40,327,125,202,179,77,102,148,48,100
199263,40,109,37,72,8,2,6,101,35,66
199272,40,76,14,62,19,0,19,57,14,43
199281,40,138,21,117,8,1,7,130,20,110
199324,40,461,186,275,86,35,51,375,151,224
199333,40,2019,1027,992,199,75,124,1820,952,868
199412,40,22,12,10,9,7,2,13,5,8
199421,40,880,309,571,65,23,42,815,286,529
199449,40,835,327,508,211,75,136,624,252,372
199458,40,12,6,6,1,1,0,11,5,6
199467,40,62,23,39,1,0,1,61,23,38
199476,40,428,118,310,73,17,56,355,101,254
199485,40,590,215,375,20,9,11,570,206,364
199494,40,2312,847,1465,325,130,195,1987,717,1270
199607,40,26,2,24,4,0,4,22,2,20
199625,40,673,232,441,73,36,37,600,196,404
199634,40,1378,563,815,121,40,81,1257,523,734
199643,40,12,1,11,4,0,4,8,1,7
199722,40,250,69,181,39,12,27,211,57,154
199731,40,854,403,451,85,39,46,769,364,405
199740,40,818,274,544,85,21,64,733,253,480
199759,40,246,104,142,2,2,0,244,102,142
199768,40,1167,445,722,143,50,93,1024,395,629
199786,40,1133,453,680,243,97,146,890,356,534
199795,40,481,209,272,136,46,90,345,163,182
199838,40,1013,359,654,158,61,97,855,298,557
199847,40,7,5,2,4,4,0,3,1,2
199856,40,2972,1070,1902,281,90,191,2691,980,1711
199865,40,5,2,3,4,2,2,1,0,1
199892,40,293,91,202,3,0,3,290,91,199
199908,40,611,223,388,133,42,91,478,181,297
199926,40,994,423,571,88,44,44,906,379,527
199953,40,773,278,495,43,12,31,730,266,464
199962,40,3,2,1,,,,3,2,1
199999,40,145,33,112,22,13,9,123,20,103
200004,40,165,29,136,28,11,17,137,18,119
200022,40,936,363,573,17,11,6,919,352,567
200059,40,171,57,114,5,1,4,166,56,110
200086,40,32,11,21,,,,32,11,21
200156,40,26,17,9,3,2,1,23,15,8
200192,40,1071,459,612,21,9,12,1050,450,600
200208,40,25,6,19,,,,25,6,19
200217,40,394,172,222,2,0,2,392,172,220
200226,40,281,113,168,,,,281,113,168
200253,40,328,118,210,3,2,1,325,116,209
200280,40,720,454,266,18,9,9,702,445,257
200305,40,1024,437,587,12,5,7,1012,432,580
200314,40,673,282,391,8,1,7,665,281,384
200332,40,267,137,130,32,13,19,235,124,111
200341,40,239,86,153,8,4,4,231,82,149
200466,40,17,6,11,,,,17,6,11
200484,40,17,9,8,,,,17,9,8
200527,40,89,26,63,1,1,0,88,25,63
200554,40,26,5,21,,,,26,5,21
200572,40,581,187,394,98,8,90,483,179,304
200800,40,1172,494,678,90,28,62,1082,466,616
200846,40,850,320,530,60,23,37,790,297,493
200873,40,3,1,2,,,,3,1,2
201061,40,1,1,0,,,,1,1,0
201104,40,740,262,478,75,24,51,665,238,427
201140,40,11,4,7,,,,11,4,7
201177,40,8,3,5,2,1,1,6,2,4
201195,40,32,8,24,20,5,15,12,3,9
201283,40,317,115,202,86,37,49,231,78,153
201371,40,10,6,4,,,,10,6,4
201432,40,802,299,503,62,18,44,740,281,459
201441,40,1686,705,981,72,31,41,1614,674,940
201548,40,45,19,26,20,6,14,25,13,12
201645,40,95,44,51,15,14,1,80,30,50
201654,40,578,230,348,21,12,9,557,218,339
201672,40,966,401,565,64,22,42,902,379,523
201690,40,18,11,7,3,1,2,15,10,5
201751,40,91,24,67,24,5,19,67,19,48
201821,40,9,0,9,,,,9,0,9
201885,40,1780,796,984,152,84,68,1628,712,916
201928,40,2590,949,1641,128,59,69,2462,890,1572
201946,40,4396,2039,2357,59,34,25,4337,2005,2332
201955,40,2168,927,1241,44,20,24,2124,907,1217
201964,40,556,204,352,14,3,11,542,201,341
201973,40,1712,631,1081,108,40,68,1604,591,1013
202046,40,6,4,2,,,,6,4,2
202134,40,273,112,161,36,16,20,237,96,141
202170,40,1,0,1,,,,1,0,1
202222,40,8191,3236,4955,580,260,320,7611,2976,4635
202356,40,4247,1602,2645,308,131,177,3939,1471,2468
202435,40,4,4,0,2,2,0,2,2,0
202480,40,82,48,34,20,9,11,62,39,23
202514,40,13,4,9,2,1,1,11,3,8
202523,40,9,8,1,,,,9,8,1
202648,40,2711,1038,1673,523,196,327,2188,842,1346
202763,40,1574,635,939,37,17,20,1537,618,919
202806,40,296,91,205,42,9,33,254,82,172
202903,40,115,53,62,2,0,2,113,53,60
202912,40,23,1,22,11,0,11,12,1,11
203085,40,18,8,10,1,1,0,17,7,10
203128,40,466,187,279,8,5,3,458,182,276
203155,40,658,224,434,70,24,46,588,200,388
203331,40,1618,627,991,96,34,62,1522,593,929
203368,40,51,30,21,25,13,12,26,17,9
203447,40,391,132,259,4,0,4,387,132,255
203456,40,292,99,193,1,0,1,291,99,192
203465,40,929,345,584,28,7,21,901,338,563
203474,40,324,112,212,6,3,3,318,109,209
203483,40,359,138,221,27,9,18,332,129,203
203492,40,393,148,245,1,1,0,392,147,245
203517,40,997,383,614,126,55,71,871,328,543
203526,40,572,204,368,12,3,9,560,201,359
203535,40,7,2,5,,,,7,2,5
203544,40,50,22,28,1,0,1,49,22,27
203580,40,82,31,51,4,1,3,78,30,48
203599,40,1262,454,808,223,92,131,1039,362,677
203678,40,2012,852,1160,50,24,26,1962,828,1134
203748,40,3601,1461,2140,332,128,204,3269,1333,1936
203757,40,101,26,75,3,0,3,98,26,72
203775,40,136,60,76,5,0,5,131,60,71
203845,40,49,23,26,1,1,0,48,22,26
203881,40,1291,482,809,34,15,19,1257,467,790
203960,40,9,1,8,,,,9,1,8
204006,40,172,66,106,31,13,18,141,53,88
204015,40,340,128,212,84,52,32,256,76,180
204024,40,135,62,73,38,25,13,97,37,60
204185,40,26,8,18,14,5,9,12,3,9
204194,40,209,69,140,40,9,31,169,60,109
204200,40,388,183,205,4,2,2,384,181,203
204255,40,845,310,535,151,54,97,694,256,438
204264,40,79,37,42,11,3,8,68,34,34
204422,40,1183,490,693,191,110,81,992,380,612
204440,40,1811,1158,653,160,91,69,1651,1067,584
204468,40,235,80,155,14,3,11,221,77,144
204617,40,81,34,47,15,3,12,66,31,35
204635,40,239,109,130,6,2,4,233,107,126
204662,40,31,10,21,10,3,7,21,7,14
204671,40,91,36,55,12,7,5,79,29,50
204680,40,128,48,80,19,8,11,109,40,69
204699,40,79,38,41,19,11,8,60,27,33
204705,40,115,35,80,10,4,6,105,31,74
204796,40,1120,582,538,152,80,72,968,502,466
204802,40,936,317,619,16,4,12,920,313,607
204820,40,1246,408,838,25,9,16,1221,399,822
204839,40,1733,581,1152,13,3,10,1720,578,1142
204848,40,1432,539,893,11,2,9,1421,537,884
204857,40,500,191,309,59,34,25,441,157,284
204866,40,1511,490,1021,21,2,19,1490,488,1002
204909,40,1,1,0,1,1,0,,,
204936,40,73,27,46,19,5,14,54,22,32
204945,40,3017,2105,912,114,67,47,2903,2038,865
205054,40,5,2,3,5,2,3,,,
205203,40,982,422,560,567,269,298,415,153,262
205443,40,488,165,323,36,9,27,452,156,296
205470,40,4210,1775,2435,196,113,83,4014,1662,2352
205841,40,3604,1490,2114,231,82,149,3373,1408,1965
205957,40,167,69,98,12,11,1,155,58,97
205966,40,1138,367,771,166,42,124,972,325,647
206011,40,907,482,425,38,14,24,869,468,401
206048,40,380,142,238,12,5,7,368,137,231
206084,40,1145,409,736,109,46,63,1036,363,673
206349,40,6,1,5,,,,6,1,5
206437,40,136,58,78,13,5,8,123,53,70
206446,40,885,342,543,70,32,38,815,310,505
206491,40,16,4,12,,,,16,4,12
206507,40,5,1,4,,,,5,1,4
206525,40,30,14,16,8,4,4,22,10,12
206589,40,8,2,6,1,1,0,7,1,6
206604,40,598,283,315,47,21,26,551,262,289
206613,40,341,120,221,10,6,4,331,114,217
206622,40,15,11,4,1,0,1,14,11,3
206695,40,1071,388,683,101,29,72,970,359,611
206835,40,2,1,1,,,,2,1,1
206862,40,7,4,3,2,1,1,5,3,2
206905,40,208,110,98,,,,208,110,98
206914,40,366,139,227,7,2,5,359,137,222
206923,40,536,180,356,98,29,69,438,151,287
206941,40,351,152,199,5,3,2,346,149,197
206996,40,390,143,247,10,3,7,380,140,240
207041,40,154,57,97,4,2,2,150,55,95
207050,40,331,127,204,2,1,1,329,126,203
207069,40,1067,428,639,55,25,30,1012,403,609
207157,40,6,3,3,,,,6,3,3
207236,40,974,302,672,191,49,142,783,253,530
207263,40,311,115,196,4,3,1,307,112,195
207281,40,1084,421,663,13,5,8,1071,416,655
207290,40,241,74,167,12,1,11,229,73,156
207306,40,182,76,106,3,3,0,179,73,106
207324,40,126,64,62,3,1,2,123,63,60
207351,40,113,52,61,8,4,4,105,48,57
207388,40,375,139,236,36,18,18,339,121,218
207397,40,745,268,477,14,7,7,731,261,470
207403,40,23,13,10,,,,23,13,10
207449,40,1629,589,1040,106,42,64,1523,547,976
207458,40,4,1,3,2,1,1,2,0,2
207500,40,352,172,180,87,54,33,265,118,147
207564,40,299,133,166,6,2,4,293,131,162
207582,40,823,368,455,4,2,2,819,366,453
207661,40,463,181,282,11,2,9,452,179,273
207670,40,2157,850,1307,46,13,33,2111,837,1274
207722,40,8,4,4,,,,8,4,4
207740,40,387,150,237,31,11,20,356,139,217
207847,40,189,67,122,8,0,8,181,67,114
207856,40,4,2,2,,,,4,2,2
207865,40,208,91,117,,,,208,91,117
207935,40,2618,965,1653,209,73,136,2409,892,1517
207971,40,30,11,19,16,4,12,14,7,7
208035,40,377,148,229,10,6,4,367,142,225
208053,40,201,114,87,,,,201,114,87
208275,40,303,174,129,28,9,19,275,165,110
208318,40,276,127,149,13,6,7,263,121,142
208390,40,968,375,593,183,82,101,785,293,492
208406,40,639,313,326,121,53,68,518,260,258
208415,40,238,155,83,48,37,11,190,118,72
208646,40,143,41,102,3,1,2,140,40,100
208725,40,4,4,0,,,,4,4,0
208822,40,14,11,3,,,,14,11,3
209038,40,875,414,461,27,14,13,848,400,448
209056,40,20,11,9,9,6,3,11,5,6
209065,40,10,5,5,8,5,3,2,0,2
209074,40,28,11,17,19,6,13,9,5,4
209241,40,5,5,0,,,,5,5,0
209250,40,2513,1950,563,272,122,150,2241,1828,413
209287,40,2,1,1,,,,2,1,1
209409,40,6,5,1,,,,6,5,1
209506,40,1519,599,920,7,5,2,1512,594,918
209542,40,526,238,288,175,107,68,351,131,220
209551,40,113,62,51,3,0,3,110,62,48
209603,40,4,0,4,4,0,4,,,
209612,40,103,19,84,40,3,37,63,16,47
209746,40,1605,661,944,165,73,92,1440,588,852
209807,40,2079,922,1157,123,60,63,1956,862,1094
209825,40,24,15,9,,,,24,15,9
209922,40,27,11,16,4,1,3,23,10,13
209940,40,418,160,258,77,21,56,341,139,202
210146,40,1188,410,778,132,44,88,1056,366,690
210155,40,297,102,195,38,20,18,259,82,177
210234,40,284,122,162,31,16,15,253,106,147
210270,40,317,106,211,25,7,18,292,99,193
210331,40,25,12,13,7,4,3,18,8,10
210401,40,50,17,33,41,10,31,9,7,2
210429,40,28,11,17,3,1,2,25,10,15
210438,40,11,5,6,,,,11,5,6
210571,40,9,2,7,3,0,3,6,2,4
210605,40,1360,710,650,135,80,55,1225,630,595
210669,40,37,12,25,3,0,3,34,12,22
210739,40,44,18,26,8,4,4,36,14,22
210775,40,7,2,5,,,,7,2,5
211024,40,72,29,43,40,15,25,32,14,18
211079,40,502,190,312,1,1,0,501,189,312
211088,40,129,51,78,1,0,1,128,51,77
211158,40,344,127,217,132,51,81,212,76,136
211273,40,1,0,1,1,0,1,,,
211291,40,10,1,9,2,0,2,8,1,7
211307,40,710,281,429,42,25,17,668,256,412
211343,40,531,223,308,7,4,3,524,219,305
211352,40,51,19,32,,,,51,19,32
211361,40,149,48,101,1,0,1,148,48,100
211431,40,3,0,3,1,0,1,2,0,2
211440,40,52,31,21,,,,52,31,21
211468,40,12,0,12,,,,12,0,12
211477,40,14,6,8,,,,14,6,8
211556,40,264,46,218,14,2,12,250,44,206
211583,40,61,6,55,11,2,9,50,4,46
211608,40,13,2,11,,,,13,2,11
211644,40,85,25,60,,,,85,25,60
211981,40,105,37,68,,,,105,37,68
212009,40,42,15,27,21,7,14,21,8,13
212054,40,105,47,58,19,5,14,86,42,44
212106,40,14,7,7,,,,14,7,7
212115,40,45,18,27,4,2,2,41,16,25
212133,40,61,6,55,,,,61,6,55
212160,40,160,70,90,3,0,3,157,70,87
212197,40,24,14,10,,,,24,14,10
212577,40,8,4,4,,,,8,4,4
212601,40,484,180,304,5,1,4,479,179,300
212656,40,108,48,60,4,0,4,104,48,56
212674,40,2,0,2,1,0,1,1,0,1
212771,40,45,0,45,,,,45,0,45
212805,40,133,66,67,,,,133,66,67
212832,40,308,169,139,,,,308,169,139
212869,40,6,0,6,,,,6,0,6
212878,40,2728,1002,1726,102,32,70,2626,970,1656
212984,40,30,5,25,,,,30,5,25
213011,40,213,63,150,2,1,1,211,62,149
213020,40,344,201,143,6,3,3,338,198,140
213181,40,3,0,3,,,,3,0,3
213233,40,46,36,10,21,20,1,25,16,9
213251,40,63,30,33,32,13,19,31,17,14
213303,40,116,29,87,16,4,12,100,25,75
213321,40,81,30,51,2,0,2,79,30,49
213349,40,211,58,153,3,0,3,208,58,150
213358,40,2,1,1,,,,2,1,1
213367,40,90,21,69,6,1,5,84,20,64
213376,40,188,74,114,18,10,8,170,64,106
213385,40,6,2,4,,,,6,2,4
213400,40,195,80,115,,,,195,80,115
213507,40,56,26,30,1,0,1,55,26,29
213525,40,1515,506,1009,173,64,109,1342,442,900
213543,40,5,2,3,1,0,1,4,2,2
213598,40,4,2,2,,,,4,2,2
213613,40,105,18,87,8,3,5,97,15,82
213659,40,695,239,456,21,7,14,674,232,442
213668,40,8,3,5,5,2,3,3,1,2
213774,40,123,34,89,5,0,5,118,34,84
213783,40,296,90,206,4,1,3,292,89,203
213826,40,71,7,64,18,0,18,53,7,46
213987,40,47,9,38,2,1,1,45,8,37
213996,40,145,56,89,,,,145,56,89
214041,40,144,61,83,44,15,29,100,46,54
214069,40,10,4,6,,,,10,4,6
214111,40,1376,551,825,88,42,46,1288,509,779
214157,40,57,19,38,5,1,4,52,18,34
214166,40,1643,569,1074,39,20,19,1604,549,1055
214175,40,22,10,12,,,,22,10,12
214272,40,56,20,36,,,,56,20,36
214379,40,670,221,449,19,4,15,651,217,434
214582,40,1,0,1,,,,1,0,1
215053,40,6,2,4,,,,6,2,4
215062,40,648,257,391,219,105,114,429,152,277
215105,40,2,0,2,,,,2,0,2
215114,40,37,14,23,11,5,6,26,9,17
215132,40,76,30,46,,,,76,30,46
215239,40,766,237,529,77,26,51,689,211,478
215266,40,10,4,6,2,1,1,8,3,5
215275,40,3,2,1,2,1,1,1,1,0
215284,40,5,2,3,,,,5,2,3
215293,40,3924,1537,2387,47,21,26,3877,1516,2361
215309,40,1,0,1,1,0,1,,,
215415,40,71,46,25,,,,71,46,25
215442,40,8,3,5,,,,8,3,5
215585,40,1495,555,940,45,24,21,1450,531,919
215655,40,19,8,11,3,0,3,16,8,8
215743,40,853,342,511,17,7,10,836,335,501
215770,40,84,57,27,,,,84,57,27
215798,40,47,25,22,11,6,5,36,19,17
215929,40,54,24,30,4,0,4,50,24,26
215947,40,18,4,14,1,1,0,17,3,14
215992,40,1,1,0,,,,1,1,0
216010,40,224,46,178,18,10,8,206,36,170
216038,40,78,35,43,14,6,8,64,29,35
216047,40,9,9,0,9,9,0,,,
216278,40,85,33,52,2,1,1,83,32,51
216287,40,8,2,6,6,1,5,2,1,1
216296,40,32,24,8,24,20,4,8,4,4
216339,40,371,157,214,61,25,36,310,132,178
216357,40,16,3,13,8,0,8,8,3,5
216366,40,27,6,21,6,3,3,21,3,18
216524,40,22,12,10,,,,22,12,10
216542,40,35,20,15,,,,35,20,15
216597,40,32,11,21,4,2,2,28,9,19
216667,40,5,2,3,4,1,3,1,1,0
216694,40,17,5,12,,,,17,5,12
216764,40,319,151,168,17,7,10,302,144,158
216807,40,90,26,64,3,2,1,87,24,63
216825,40,1365,484,881,111,45,66,1254,439,815
216852,40,37,5,32,5,1,4,32,4,28
216931,40,98,42,56,1,0,1,97,42,55
217013,40,314,94,220,41,9,32,273,85,188
217059,40,75,32,43,3,3,0,72,29,43
217156,40,224,58,166,6,2,4,218,56,162
217165,40,3,2,1,2,2,0,1,0,1
217235,40,24,8,16,4,1,3,20,7,13
217402,40,38,22,16,7,6,1,31,16,15
217420,40,124,30,94,14,7,7,110,23,87
217475,40,826,273,553,128,40,88,698,233,465
217484,40,894,406,488,22,11,11,872,395,477
217518,40,117,57,60,3,1,2,114,56,58
217536,40,9,2,7,4,1,3,5,1,4
217606,40,1,1,0,,,,1,1,0
217615,40,223,87,136,3,0,3,220,87,133
217633,40,257,74,183,5,4,1,252,70,182
217688,40,11,4,7,2,1,1,9,3,6
217712,40,437,150,287,17,6,11,420,144,276
217721,40,1,1,0,1,1,0,,,
217749,40,278,123,155,5,2,3,273,121,152
217776,40,102,45,57,1,1,0,101,44,57
217819,40,197,70,127,46,17,29,151,53,98
217837,40,700,248,452,10,2,8,690,246,444
217864,40,36,17,19,,,,36,17,19
217873,40,6,1,5,,,,6,1,5
217882,40,76,39,37,13,9,4,63,30,33
217907,40,337,183,154,7,5,2,330,178,152
217925,40,162,64,98,7,4,3,155,60,95
217934,40,20,1,19,,,,20,1,19
217961,40,1,0,1,,,,1,0,1
217989,40,294,103,191,38,11,27,256,92,164
218025,40,478,194,284,36,7,29,442,187,255
218061,40,608,189,419,27,12,15,581,177,404
218070,40,8,3,5,4,0,4,4,3,1
218113,40,1886,817,1069,60,25,35,1826,792,1034
218140,40,1203,443,760,168,90,78,1035,353,682
218229,40,207,61,146,7,0,7,200,61,139
218238,40,1,0,1,,,,1,0,1
218353,40,1061,339,722,55,23,32,1006,316,690
218414,40,11,3,8,,,,11,3,8
218441,40,373,132,241,1,1,0,372,131,241
218487,40,634,233,401,62,27,35,572,206,366
218520,40,904,367,537,119,35,84,785,332,453
218539,40,60,17,43,7,2,5,53,15,38
218645,40,288,101,187,74,25,49,214,76,138
218654,40,176,60,116,9,5,4,167,55,112
218663,40,434,219,215,211,122,89,223,97,126
218672,40,1081,421,660,70,25,45,1011,396,615
218681,40,428,161,267,17,5,12,411,156,255
218690,40,846,299,547,66,23,43,780,276,504
218706,40,980,447,533,97,54,43,883,393,490
218724,40,406,180,226,30,11,19,376,169,207
218733,40,11,3,8,,,,11,3,8
218742,40,485,155,330,81,23,58,404,132,272
218821,40,3,1,2,,,,3,1,2
218830,40,1123,419,704,127,62,65,996,357,639
218858,40,580,208,372,63,14,49,517,194,323
218885,40,701,339,362,11,5,6,690,334,356
218894,40,2531,1021,1510,416,195,221,2115,826,1289
218955,40,140,50,90,7,3,4,133,47,86
218964,40,208,60,148,,,,208,60,148
218973,40,6,1,5,,,,6,1,5
218991,40,620,249,371,141,55,86,479,194,285
219000,40,57,29,28,15,4,11,42,25,17
219046,40,1304,541,763,31,10,21,1273,531,742
219082,40,841,355,486,31,6,25,810,349,461
219091,40,116,27,89,6,2,4,110,25,85
219143,40,387,160,227,5,3,2,382,157,225
219189,40,203,109,94,10,6,4,193,103,90
219198,40,395,161,234,3,0,3,392,161,231
219204,40,5,1,4,,,,5,1,4
219259,40,1523,619,904,27,13,14,1496,606,890
219277,40,61,14,47,1,1,0,60,13,47
219295,40,6,1,5,,,,6,1,5
219347,40,107,68,39,4,4,0,103,64,39
219356,40,1196,423,773,24,10,14,1172,413,759
219383,40,31,16,15,,,,31,16,15
219408,40,9,3,6,,,,9,3,6
219426,40,306,121,185,1,1,0,305,120,185
219471,40,1659,539,1120,34,11,23,1625,528,1097
219480,40,466,171,295,16,11,5,450,160,290
219602,40,928,349,579,40,15,25,888,334,554
219639,40,22,6,16,,,,22,6,16
219709,40,26,8,18,8,1,7,18,7,11
219718,40,1074,398,676,28,23,5,1046,375,671
219790,40,507,225,282,13,5,8,494,220,274
219806,40,94,42,52,6,3,3,88,39,49
219824,40,1517,616,901,133,63,70,1384,553,831
219833,40,60,25,35,13,4,9,47,21,26
219842,40,134,79,55,12,7,5,122,72,50
219879,40,1030,400,630,87,54,33,943,346,597
219888,40,1118,412,706,31,23,8,1087,389,698
219921,40,128,104,24,,,,128,104,24
219949,40,387,146,241,42,18,24,345,128,217
219976,40,7,3,4,1,0,1,6,3,3
219994,40,177,127,50,,,,177,127,50
220057,40,797,268,529,61,19,42,736,249,487
220075,40,548,232,316,26,13,13,522,219,303
220127,40,2,2,0,,,,2,2,0
220206,40,47,9,38,,,,47,9,38
220215,40,375,134,241,5,2,3,370,132,238
220251,40,251,144,107,,,,251,144,107
220279,40,417,299,118,,,,417,299,118
220321,40,354,221,133,,,,354,221,133
220394,40,56,44,12,,,,56,44,12
220400,40,1162,404,758,101,32,69,1061,372,689
220473,40,1,0,1,,,,1,0,1
220516,40,55,21,34,,,,55,21,34
220552,40,18,4,14,5,0,5,13,4,9
220613,40,538,215,323,2,1,1,536,214,322
220631,40,98,38,60,,,,98,38,60
220640,40,1220,762,458,,,,1220,762,458
220701,40,111,45,66,,,,111,45,66
220710,40,71,30,41,5,2,3,66,28,38
220756,40,18,17,1,,,,18,17,1
220853,40,282,144,138,,,,282,144,138
220862,40,2111,837,1274,46,24,22,2065,813,1252
220978,40,890,328,562,32,11,21,858,317,541
221050,40,164,119,45,,,,164,119,45
221096,40,1648,567,1081,134,67,67,1514,500,1014
221102,40,3,2,1,,,,3,2,1
221184,40,1211,438,773,128,59,69,1083,379,704
221236,40,148,116,32,,,,148,116,32
221281,40,44,24,20,,,,44,24,20
221333,40,280,238,42,,,,280,238,42
221351,40,67,9,58,18,5,13,49,4,45
221388,40,26,22,4,,,,26,22,4
221397,40,1393,477,916,204,93,111,1189,384,805
221430,40,623,448,175,,,,623,448,175
221485,40,1205,491,714,19,7,12,1186,484,702
221494,40,41,39,2,,,,41,39,2
221519,40,10,4,6,,,,10,4,6
221582,40,168,134,34,,,,168,134,34
221591,40,101,78,23,,,,101,78,23
221616,40,1030,807,223,,,,1030,807,223
221625,40,244,197,47,,,,244,197,47
221643,40,1965,812,1153,51,25,26,1914,787,1127
221661,40,97,38,59,,,,97,38,59
221731,40,12,5,7,1,1,0,11,4,7
221740,40,46,21,25,,,,46,21,25
221759,40,110,51,59,23,11,12,87,40,47
221768,40,1264,442,822,19,11,8,1245,431,814
221838,40,520,274,246,3,0,3,517,274,243
221847,40,208,88,120,3,0,3,205,88,117
221892,40,103,54,49,,,,103,54,49
221908,40,916,394,522,65,25,40,851,369,482
221953,40,169,58,111,,,,169,58,111
221971,40,143,59,84,,,,143,59,84
221999,40,7,2,5,,,,7,2,5
222053,40,1621,582,1039,82,25,57,1539,557,982
222062,40,1618,569,1049,90,27,63,1528,542,986
222105,40,2,2,0,,,,2,2,0
222178,40,7,5,2,,,,7,5,2
222567,40,2004,799,1205,132,49,83,1872,750,1122
222576,40,1973,803,1170,130,49,81,1843,754,1089
222628,40,3,1,2,1,0,1,2,1,1
222822,40,1608,673,935,114,34,80,1494,639,855
222831,40,3703,1416,2287,144,41,103,3559,1375,2184
222938,40,6,2,4,,,,6,2,4
222983,40,4,2,2,1,1,0,3,1,2
222992,40,9231,3893,5338,583,278,305,8648,3615,5033
223232,40,89,39,50,37,21,16,52,18,34
223320,40,1530,658,872,69,27,42,1461,631,830
223427,40,1934,898,1036,71,27,44,1863,871,992
223506,40,1011,449,562,71,40,31,940,409,531
223816,40,3496,1459,2037,728,283,445,2768,1176,1592
223898,40,86,35,51,26,11,15,60,24,36
224004,40,1,1,0,,,,1,1,0
224110,40,1956,866,1090,43,23,20,1913,843,1070
224147,40,58,29,29,3,2,1,55,27,28
224226,40,350,172,178,,,,350,172,178
224244,40,54,25,29,,,,54,25,29
224323,40,4,2,2,1,0,1,3,2,1
224350,40,616,275,341,74,34,40,542,241,301
224527,40,198,78,120,,,,198,78,120
224545,40,7,2,5,,,,7,2,5
224554,40,67,29,38,35,13,22,32,16,16
224615,40,27138,11135,16003,4417,1873,2544,22721,9262,13459
224642,40,198,67,131,23,10,13,175,57,118
224776,40,8,1,7,,,,8,1,7
224891,40,809,328,481,149,48,101,660,280,380
224961,40,381,170,211,87,41,46,294,129,165
225070,40,1174,371,803,69,18,51,1105,353,752
225201,40,24,20,4,24,20,4,,,
225247,40,17,7,10,1,1,0,16,6,10
225308,40,864,362,502,91,31,60,773,331,442
225371,40,1853,762,1091,904,339,565,949,423,526
225399,40,7,2,5,,,,7,2,5
225414,40,17,2,15,2,0,2,15,2,13
225423,40,8599,3392,5207,883,301,582,7716,3091,4625
225432,40,97,32,65,11,4,7,86,28,58
225502,40,81,26,55,4,2,2,77,24,53
225511,40,1028,545,483,268,113,155,760,432,328
225520,40,2260,1022,1238,86,20,66,2174,1002,1172
225548,40,88,33,55,,,,88,33,55
225575,40,1,0,1,,,,1,0,1
225627,40,157,60,97,33,13,20,124,47,77
225876,40,250,89,161,5,2,3,245,87,158
225885,40,4,2,2,,,,4,2,2
226019,40,1779,726,1053,68,17,51,1711,709,1002
226091,40,496,177,319,3,0,3,493,177,316
226107,40,895,305,590,39,11,28,856,294,562
226116,40,87,32,55,19,5,14,68,27,41
226134,40,1971,924,1047,304,131,173,1667,793,874
226152,40,538,215,323,80,22,58,458,193,265
226204,40,41,14,27,1,1,0,40,13,27
226231,40,1368,622,746,46,16,30,1322,606,716
226383,40,118,53,65,,,,118,53,65
226408,40,1383,550,833,182,55,127,1201,495,706
226471,40,48,19,29,5,1,4,43,18,25
226578,40,1870,743,1127,48,19,29,1822,724,1098
226587,40,27,17,10,2,2,0,25,15,10
226806,40,198,75,123,7,2,5,191,73,118
226833,40,209,87,122,2,2,0,207,85,122
227182,40,19560,8132,11428,2239,900,1339,17321,7232,10089
227225,40,1028,459,569,155,57,98,873,402,471
227304,40,3410,1588,1822,498,197,301,2912,1391,1521
227331,40,29,8,21,4,1,3,25,7,18
227368,40,3,1,2,,,,3,1,2
227377,40,3662,1432,2230,75,26,49,3587,1406,2181
227386,40,930,404,526,81,37,44,849,367,482
227401,40,1947,754,1193,124,48,76,1823,706,1117
227687,40,183,85,98,25,11,14,158,74,84
227757,40,7,1,6,6,0,6,1,1,0
227845,40,3,2,1,,,,3,2,1
227854,40,3555,1612,1943,413,156,257,3142,1456,1686
227863,40,64,50,14,2,0,2,62,50,12
227924,40,2936,1070,1866,251,105,146,2685,965,1720
227979,40,7584,2992,4592,1271,491,780,6313,2501,3812
228042,40,50,15,35,2,2,0,48,13,35
228149,40,10,5,5,1,0,1,9,5,4
228158,40,2216,910,1306,121,55,66,2095,855,1240
228246,40,14,5,9,1,1,0,13,4,9
228316,40,2925,1244,1681,242,84,158,2683,1160,1523
228325,40,50,22,28,4,4,0,46,18,28
228343,40,4,1,3,1,1,0,3,0,3
228431,40,838,334,504,25,10,15,813,324,489
228468,40,149,59,90,,,,149,59,90
228501,40,5,2,3,,,,5,2,3
228547,40,1189,530,659,129,71,58,1060,459,601
228608,40,1358,494,864,335,103,232,1023,391,632
228699,40,903,363,540,255,84,171,648,279,369
228705,40,330,141,189,5,0,5,325,141,184
228723,40,717,559,158,116,68,48,601,491,110
228769,40,303,112,191,20,8,12,283,104,179
228778,40,410,201,209,188,114,74,222,87,135
228787,40,30,18,12,29,18,11,1,0,1
228796,40,57,28,29,5,2,3,52,26,26
228802,40,433,199,234,2,0,2,431,199,232
228875,40,7,3,4,1,0,1,6,3,3
228981,40,27,11,16,1,0,1,26,11,15
229018,40,806,273,533,158,43,115,648,230,418
229027,40,650,330,320,172,96,76,478,234,244
229115,40,718,311,407,34,17,17,684,294,390
229160,40,321,125,196,1,0,1,320,125,195
229179,40,1255,499,756,15,9,6,1240,490,750
229267,40,18,5,13,1,1,0,17,4,13
229355,40,2625,1066,1559,175,68,107,2450,998,1452
229504,40,19,7,12,1,0,1,18,7,11
229540,40,696,257,439,9,6,3,687,251,436
229780,40,297,126,171,1,0,1,296,126,170
229799,40,1548,647,901,120,43,77,1428,604,824
229814,40,130,77,53,,,,130,77,53
229832,40,903,401,502,147,66,81,756,335,421
229841,40,561,205,356,27,11,16,534,194,340
230010,40,142,29,113,,,,142,29,113
230047,40,32,10,22,1,1,0,31,9,22
230056,40,113,73,40,,,,113,73,40
230162,40,1353,927,426,30,12,18,1323,915,408
230171,40,3405,1521,1884,237,111,126,3168,1410,1758
230366,40,13,5,8,13,5,8,,,
230418,40,22,9,13,2,1,1,20,8,12
230490,40,825,514,311,61,21,40,764,493,271
230597,40,2434,1088,1346,328,138,190,2106,950,1156
230603,40,2783,909,1874,220,103,117,2563,806,1757
230676,40,910,657,253,10,6,4,900,651,249
230728,40,3739,1435,2304,153,67,86,3586,1368,2218
230737,40,13053,6112,6941,1242,617,625,11811,5495,6316
230746,40,8852,3986,4866,553,274,279,8299,3712,4587
230764,40,976,505,471,111,60,51,865,445,420
230782,40,12844,5827,7017,1315,635,680,11529,5192,6337
230807,40,13,5,8,10,5,5,3,0,3
230816,40,36,5,31,4,0,4,32,5,27
230834,40,127,34,93,35,6,29,92,28,64
230852,40,47,29,18,2,1,1,45,28,17
230861,40,2162,696,1466,176,55,121,1986,641,1345
230913,40,203,64,139,46,10,36,157,54,103
230959,40,21,7,14,12,3,9,9,4,5
230995,40,64,28,36,44,14,30,20,14,6
231059,40,6,3,3,,,,6,3,3
231068,40,361,97,264,296,77,219,65,20,45
231095,40,18,9,9,2,2,0,16,7,9
231165,40,287,177,110,36,21,15,251,156,95
231174,40,545,202,343,63,25,38,482,177,305
231420,40,20,5,15,2,1,1,18,4,14
231536,40,958,344,614,52,22,30,906,322,584
231554,40,90,33,57,49,21,28,41,12,29
231581,40,1,0,1,1,0,1,,,
231624,40,22,12,10,8,8,0,14,4,10
231651,40,261,73,188,6,1,5,255,72,183
231697,40,1467,651,816,375,124,251,1092,527,565
231712,40,9,5,4,1,1,0,8,4,4
231785,40,6,2,4,,,,6,2,4
231873,40,558,239,319,62,27,35,496,212,284
231882,40,1018,498,520,202,111,91,816,387,429
232025,40,12,2,10,,,,12,2,10
232043,40,42,18,24,1,0,1,41,18,23
232052,40,244,114,130,45,22,23,199,92,107
232089,40,3,0,3,,,,3,0,3
232186,40,543,259,284,126,57,69,417,202,215
232195,40,2235,881,1354,172,65,107,2063,816,1247
232265,40,12,6,6,7,4,3,5,2,3
232414,40,1953,795,1158,588,229,359,1365,566,799
232423,40,327,162,165,27,10,17,300,152,148
232450,40,3172,1299,1873,105,39,66,3067,1260,1807
232557,40,517,243,274,59,28,31,458,215,243
232566,40,286,92,194,10,1,9,276,91,185
232575,40,2682,1099,1583,596,253,343,2086,846,1240
232609,40,26,3,23,4,1,3,22,2,20
232672,40,31,10,21,6,0,6,25,10,15
232681,40,36,10,26,11,2,9,25,8,17
232706,40,330,276,54,4,2,2,326,274,52
232788,40,811,343,468,203,66,137,608,277,331
232867,40,1949,966,983,410,172,238,1539,794,745
232885,40,44,3,41,,,,44,3,41
232937,40,12,6,6,,,,12,6,6
232946,40,16658,7543,9115,754,422,332,15904,7121,8783
232982,40,249,111,138,15,3,12,234,108,126
233019,40,504,211,293,166,51,115,338,160,178
233037,40,621,229,392,52,16,36,569,213,356
233116,40,1958,871,1087,172,62,110,1786,809,977
233277,40,76,35,41,13,4,9,63,31,32
233295,40,11,2,9,7,1,6,4,1,3
233301,40,7,3,4,1,0,1,6,3,3
233310,40,1372,558,814,252,102,150,1120,456,664
233338,40,1427,613,814,43,11,32,1384,602,782
233374,40,68,34,34,58,28,30,10,6,4
233426,40,26,9,17,6,2,4,20,7,13
233541,40,294,65,229,,,,294,65,229
233611,40,104,65,39,,,,104,65,39
233639,40,1386,545,841,445,171,274,941,374,567
233648,40,581,239,342,67,30,37,514,209,305
233684,40,1,1,0,,,,1,1,0
233718,40,1,0,1,1,0,1,,,
233754,40,1505,626,879,131,59,72,1374,567,807
233772,40,3187,1320,1867,250,116,134,2937,1204,1733
233897,40,712,179,533,12,5,7,700,174,526
233903,40,733,275,458,130,45,85,603,230,373
233921,40,61,29,32,43,19,24,18,10,8
233949,40,2090,959,1131,110,41,69,1980,918,1062
234030,40,476,215,261,54,18,36,422,197,225
234076,40,253,107,146,55,28,27,198,79,119
234155,40,13,7,6,,,,13,7,6
234164,40,53,18,35,6,2,4,47,16,31
234173,40,51,23,28,3,0,3,48,23,25
234207,40,7,2,5,6,2,4,1,0,1
234377,40,901,390,511,143,44,99,758,346,412
234669,40,1794,683,1111,557,265,292,1237,418,819
234696,40,209,117,92,14,9,5,195,108,87
234711,40,82,68,14,,,,82,68,14
234827,40,58,19,39,27,12,15,31,7,24
234845,40,537,161,376,45,17,28,492,144,348
234915,40,141,36,105,,,,141,36,105
234933,40,1047,450,597,417,197,220,630,253,377
234951,40,1662,585,1077,937,475,462,725,110,615
234979,40,788,699,89,61,28,33,727,671,56
235024,40,27,4,23,2,0,2,25,4,21
235097,40,628,234,394,421,157,264,207,77,130
235103,40,1767,730,1037,529,286,243,1238,444,794
235149,40,198,114,84,86,38,48,112,76,36
235167,40,30,11,19,4,2,2,26,9,17
235237,40,956,452,504,419,188,231,537,264,273
235316,40,24,8,16,10,2,8,14,6,8
235334,40,172,92,80,82,39,43,90,53,37
235343,40,229,123,106,90,55,35,139,68,71
235422,40,6,1,5,,,,6,1,5
235431,40,697,274,423,333,141,192,364,133,231
235547,40,8,1,7,,,,8,1,7
235671,40,3403,2166,1237,1246,865,381,2157,1301,856
235699,40,1718,631,1087,575,243,332,1143,388,755
235750,40,167,58,109,30,10,20,137,48,89
236072,40,1973,706,1267,181,100,81,1792,606,1186
236133,40,24,4,20,15,2,13,9,2,7
236188,40,877,453,424,520,313,207,357,140,217
236230,40,42,20,22,8,1,7,34,19,15
236258,40,511,148,363,123,37,86,388,111,277
236382,40,2041,1581,460,417,210,207,1624,1371,253
236452,40,11,4,7,4,1,3,7,3,4
236504,40,3085,2489,596,198,124,74,2887,2365,522
236513,40,1373,555,818,651,276,375,722,279,443
236577,40,29,18,11,,,,29,18,11
236595,40,8,4,4,,,,8,4,4
236610,40,2124,788,1336,809,395,414,1315,393,922
236638,40,904,551,353,83,37,46,821,514,307
236656,40,765,294,471,347,147,200,418,147,271
236692,40,2101,886,1215,98,43,55,2003,843,1160
236708,40,159,69,90,22,11,11,137,58,79
236753,40,414,169,245,178,83,95,236,86,150
236887,40,1221,675,546,516,312,204,705,363,342
236896,40,86,43,43,,,,86,43,43
236939,40,312,121,191,63,30,33,249,91,158
236948,40,4834,2016,2818,111,49,62,4723,1967,2756
236975,40,250,62,188,33,9,24,217,53,164
237011,40,86,37,49,34,18,16,52,19,33
237039,40,239,104,135,15,5,10,224,99,125
237057,40,20,12,8,,,,20,12,8
237066,40,16,8,8,3,1,2,13,7,6
237109,40,882,219,663,521,134,387,361,85,276
237118,40,44,13,31,,,,44,13,31
237136,40,25,9,16,,,,25,9,16
237181,40,14,2,12,7,1,6,7,1,6
237215,40,24,10,14,2,1,1,22,9,13
237312,40,44,17,27,,,,44,17,27
237330,40,42,24,18,6,3,3,36,21,15
237358,40,2,0,2,,,,2,0,2
237367,40,365,135,230,3,1,2,362,134,228
237385,40,375,137,238,25,7,18,350,130,220
237437,40,4,0,4,1,0,1,3,0,3
237525,40,833,311,522,31,18,13,802,293,509
237686,40,744,269,475,51,14,37,693,255,438
237701,40,176,60,116,1,0,1,175,60,115
237792,40,151,59,92,,,,151,59,92
237817,40,224,76,148,12,5,7,212,71,141
237899,40,1908,741,1167,101,40,61,1807,701,1106
237932,40,434,169,265,224,86,138,210,83,127
237950,40,516,185,331,,,,516,185,331
237969,40,4,0,4,2,0,2,2,0,2
238014,40,258,97,161,24,9,15,234,88,146
238032,40,842,302,540,59,27,32,783,275,508
238193,40,59,10,49,11,2,9,48,8,40
238263,40,3551,1681,1870,279,134,145,3272,1547,1725
238324,40,158,43,115,,,,158,43,115
238333,40,55,21,34,23,8,15,32,13,19
238397,40,177,82,95,7,3,4,170,79,91
238430,40,275,63,212,,,,275,63,212
238458,40,85,39,46,33,13,20,52,26,26
238476,40,19,6,13,,,,19,6,13
238616,40,286,105,181,5,1,4,281,104,177
238661,40,86,53,33,7,3,4,79,50,29
238722,40,5906,3251,2655,138,75,63,5768,3176,2592
238759,40,4626,2630,1996,37,20,17,4589,2610,1979
238980,40,92,34,58,3,2,1,89,32,57
239008,40,482,283,199,9,2,7,473,281,192
239017,40,15,5,10,11,3,8,4,2,2
239071,40,255,120,135,13,4,9,242,116,126
239080,40,5,0,5,,,,5,0,5
239105,40,194,93,101,31,14,17,163,79,84
239220,40,844,426,418,8,2,6,836,424,412
239248,40,818,353,465,129,78,51,689,275,414
239309,40,2,1,1,,,,2,1,1
239318,40,11,6,5,,,,11,6,5
239372,40,862,417,445,39,27,12,823,390,433
239390,40,57,6,51,1,0,1,56,6,50
239442,40,417,150,267,3,1,2,414,149,265
239460,40,2929,1297,1632,104,46,58,2825,1251,1574
239488,40,2999,1460,1539,108,45,63,2891,1415,1476
239512,40,11,5,6,1,0,1,10,5,5
239628,40,20,8,12,4,1,3,16,7,9
239716,40,22,12,10,6,2,4,16,10,6
239910,40,1099,507,592,22,8,14,1077,499,578
240107,40,21,7,14,,,,21,7,14
240116,40,2893,1420,1473,122,52,70,2771,1368,1403
240125,40,2908,1332,1576,53,22,31,2855,1310,1545
240170,40,265,135,130,9,7,2,256,128,128
240189,40,453,199,254,63,30,33,390,169,221
240198,40,473,185,288,24,14,10,449,171,278
240268,40,236,77,159,27,14,13,209,63,146
240277,40,2782,623,2159,98,20,78,2684,603,2081
240329,40,170,61,109,29,11,18,141,50,91
240338,40,55,27,28,,,,55,27,28
240365,40,4527,1669,2858,113,36,77,4414,1633,2781
240374,40,121,51,70,1,1,0,120,50,70
240392,40,3,0,3,,,,3,0,3
240417,40,154,61,93,50,17,33,104,44,60
240426,40,129,46,83,1,0,1,128,46,82
240444,40,1055,497,558,187,114,73,868,383,485
240453,40,1089,361,728,195,61,134,894,300,594
240462,40,142,51,91,8,5,3,134,46,88
240471,40,258,103,155,27,10,17,231,93,138
240480,40,386,119,267,3,3,0,383,116,267
240505,40,1047,559,488,28,14,14,1019,545,474
240514,40,809,396,413,68,39,29,741,357,384
240596,40,869,402,467,95,43,52,774,359,415
240620,40,1394,660,734,14,6,8,1380,654,726
240657,40,535,235,300,28,16,12,507,219,288
240666,40,2234,1362,872,140,46,94,2094,1316,778
240693,40,1059,453,606,26,10,16,1033,443,590
240727,40,169,79,90,2,1,1,167,78,89
240736,40,64,12,52,,,,64,12,52
240745,40,2,2,0,1,1,0,1,1,0
240754,40,25,13,12,3,1,2,22,12,10
240790,40,22,10,12,5,2,3,17,8,9
241100,40,5,1,4,2,0,2,3,1,2
241128,40,5,1,4,2,0,2,3,1,2
241191,40,11,4,7,,,,11,4,7
241225,40,17,5,12,2,0,2,15,5,10
241331,40,1,0,1,,,,1,0,1
241377,40,1,0,1,,,,1,0,1
241386,40,1,0,1,,,,1,0,1
241395,40,15,4,11,3,1,2,12,3,9
241410,40,172,38,134,4,2,2,168,36,132
241766,40,10,8,2,,,,10,8,2
241836,40,2,0,2,,,,2,0,2
242565,40,100,73,27,100,73,27,,,
242617,40,47,19,28,7,2,5,40,17,23
242626,40,49,15,34,5,1,4,44,14,30
242635,40,63,13,50,5,0,5,58,13,45
242644,40,9,3,6,3,0,3,6,3,3
242653,40,186,58,128,33,13,20,153,45,108
242662,40,34,11,23,,,,34,11,23
242680,40,25,8,17,2,0,2,23,8,15
242699,40,15,5,10,,,,15,5,10
242705,40,32,8,24,2,0,2,30,8,22
242972,40,31,16,15,,,,31,16,15
243106,40,33,8,25,2,2,0,31,6,25
243115,40,32,10,22,2,1,1,30,9,21
243142,40,86,25,61,5,1,4,81,24,57
243151,40,22,9,13,4,2,2,18,7,11
243179,40,44,11,33,6,2,4,38,9,29
243188,40,5,1,4,3,1,2,2,0,2
243197,40,196,81,115,67,22,45,129,59,70
243212,40,13,5,8,,,,13,5,8
243221,40,74,24,50,16,5,11,58,19,39
243443,40,39,15,24,3,1,2,36,14,22
243577,40,19,12,7,2,0,2,17,12,5
243586,40,16,6,10,4,1,3,12,5,7
243638,40,10,8,2,3,3,0,7,5,2
243647,40,2,1,1,,,,2,1,1
243665,40,44,15,29,2,1,1,42,14,28
243780,40,148,75,73,6,3,3,142,72,70
243832,40,13,2,11,,,,13,2,11
244437,40,2390,961,1429,270,96,174,2120,865,1255
244446,40,559,193,366,48,25,23,511,168,343
245625,40,2407,1121,1286,188,80,108,2219,1041,1178
245838,40,31,14,17,,,,31,14,17
245883,40,3,0,3,,,,3,0,3
245953,40,303,142,161,11,5,6,292,137,155
245999,40,1490,755,735,,,,1490,755,735
246354,40,2935,1188,1747,542,202,340,2393,986,1407
246813,40,828,299,529,36,12,24,792,287,505
247603,40,299,138,161,132,75,57,167,63,104
247649,40,161,109,52,,,,161,109,52
247834,40,9527,3761,5766,604,275,329,8923,3486,5437
247940,40,1752,832,920,318,105,213,1434,727,707
248606,40,1176,767,409,,,,1176,767,409
248925,40,73,68,5,,,,73,68,5
248934,40,117,49,68,,,,117,49,68
250027,40,2,1,1,,,,2,1,1
251260,40,530,237,293,18,14,4,512,223,289
260372,40,43,13,30,,,,43,13,30
262031,40,400,147,253,45,14,31,355,133,222
262086,40,218,89,129,14,6,8,204,83,121
262457,40,14,2,12,14,2,12,,,
363633,40,353,135,218,13,8,5,340,127,213
363907,40,1,1,0,1,1,0,,,
364016,40,1552,649,903,139,71,68,1413,578,835
364025,40,6181,2801,3380,486,214,272,5695,2587,3108
364627,40,312,161,151,,,,312,161,151
364946,40,221,130,91,,,,221,130,91
365198,40,437,295,142,,,,437,295,142
365213,40,343,137,206,,,,343,137,206
365374,40,869,453,416,,,,869,453,416
365480,40,533,304,229,,,,533,304,229
366003,40,6,2,4,2,1,1,4,1,3
366252,40,34,15,19,,,,34,15,19
366340,40,127,42,85,2,1,1,125,41,84
366395,40,5955,2527,3428,150,81,69,5805,2446,3359
366401,40,642,269,373,19,7,12,623,262,361
366465,40,342,162,180,31,26,5,311,136,175
366623,40,213,125,88,,,,213,125,88
366711,40,26,6,20,11,2,9,15,4,11
367459,40,2165,889,1276,116,41,75,2049,848,1201
367884,40,2,1,1,,,,2,1,1
368911,40,714,278,436,21,10,11,693,268,425
372082,40,20,2,18,,,,20,2,18
375656,40,115,64,51,,,,115,64,51
375683,40,625,363,262,,,,625,363,262
376695,40,6,5,1,,,,6,5,1
377485,40,25,6,19,,,,25,6,19
377555,40,22,7,15,4,2,2,18,5,13
377564,40,14,8,6,,,,14,8,6
378105,40,41,2,39,41,2,39,,,
378576,40,31,3,28,,,,31,3,28
380359,40,39,15,24,2,1,1,37,14,23
380368,40,1113,436,677,125,31,94,988,405,583
380377,40,11,2,9,1,1,0,10,1,9
380438,40,3,1,2,3,1,2,,,
382911,40,1,0,1,,,,1,0,1
383190,40,614,203,411,25,14,11,589,189,400
383996,40,257,102,155,30,12,18,227,90,137
384254,40,29,20,9,,,,29,20,9
384333,40,2293,928,1365,198,68,130,2095,860,1235
384342,40,1674,725,949,148,72,76,1526,653,873
384421,40,2,2,0,2,2,0,,,
386472,40,1,1,0,,,,1,1,0
395362,40,266,104,162,51,12,39,215,92,123
399212,40,832,393,439,41,18,23,791,375,416
403469,40,2029,1228,801,32,19,13,1997,1209,788
403478,40,195,96,99,19,13,6,176,83,93
403487,40,383,118,265,28,11,17,355,107,248
404426,40,551,278,273,21,16,5,530,262,268
404994,40,4,0,4,,,,4,0,4
405872,40,762,277,485,36,17,19,726,260,466
407610,40,6,6,0,,,,6,6,0
408844,40,7,1,6,,,,7,1,6
409315,40,9294,3980,5314,1832,768,1064,7462,3212,4250
409698,40,104,47,57,66,19,47,38,28,10
413413,40,5,2,3,,,,5,2,3
413617,40,31,13,18,3,1,2,28,12,16
414595,40,56,7,49,8,1,7,48,6,42
414878,40,101,44,57,,,,101,44,57
414911,40,1520,509,1011,72,25,47,1448,484,964
417734,40,8,1,7,,,,8,1,7
418126,40,2,0,2,,,,2,0,2
418302,40,329,195,134,,,,329,195,134
418348,40,372,253,119,,,,372,253,119
420398,40,3884,1414,2470,196,62,134,3688,1352,2336
420431,40,324,142,182,1,1,0,323,141,182
420440,40,535,201,334,14,6,8,521,195,326
420538,40,393,185,208,5,4,1,388,181,207
420556,40,183,66,117,33,10,23,150,56,94
420723,40,253,103,150,29,12,17,224,91,133
423652,40,92,46,46,4,2,2,88,44,44
426314,40,251,193,58,7,6,1,244,187,57
427991,40,254,155,99,26,20,6,228,135,93
428019,40,147,83,64,,,,147,83,64
428170,40,12,1,11,1,0,1,11,1,10
428392,40,383,154,229,20,12,8,363,142,221
429128,40,303,11,292,6,0,6,297,11,286
430184,40,1,0,1,,,,1,0,1
430704,40,1,1,0,,,,1,1,0
431017,40,234,143,91,,,,234,143,91
431929,40,3,2,1,,,,3,2,1
432524,40,1,1,0,,,,1,1,0
433174,40,1,0,1,,,,1,0,1
433660,40,344,138,206,270,110,160,74,28,46
434016,40,52,16,36,5,2,3,47,14,33
434061,40,1192,517,675,389,216,173,803,301,502
434159,40,1,1,0,1,1,0,,,
434469,40,20,3,17,20,3,17,,,
434584,40,89,36,53,10,2,8,79,34,45
434672,40,1815,692,1123,98,45,53,1717,647,1070
434751,40,27,6,21,,,,27,6,21
436304,40,745,288,457,191,55,136,554,233,321
436818,40,12,5,7,,,,12,5,7
436827,40,16,10,6,2,1,1,14,9,5
436836,40,62,37,25,6,4,2,56,33,23
437097,40,1,1,0,1,1,0,,,
437103,40,625,314,311,61,46,15,564,268,296
437325,40,6,3,3,1,1,0,5,2,3
438258,40,1,0,1,1,0,1,,,
438498,40,14,6,8,14,6,8,,,
438708,40,174,51,123,7,1,6,167,50,117
439190,40,643,302,341,363,168,195,280,134,146
439701,40,1,1,0,,,,1,1,0
439783,40,3,1,2,2,1,1,1,0,1
440396,40,16,10,6,14,8,6,2,2,0
440402,40,666,243,423,43,13,30,623,230,393
440749,40,24,20,4,,,,24,20,4
440794,40,127,32,95,2,0,2,125,32,93
440828,40,5,3,2,,,,5,3,2
441070,40,14,8,6,,,,14,8,6
441690,40,28,18,10,,,,28,18,10
441760,40,1600,686,914,134,43,91,1466,643,823
441858,40,35,3,32,22,1,21,13,2,11
441900,40,3048,1018,2030,86,17,69,2962,1001,1961
441937,40,12,4,8,5,1,4,7,3,4
441982,40,21,9,12,,,,21,9,12
442356,40,127,13,114,1,0,1,126,13,113
442444,40,66,11,55,66,11,55,,,
442781,40,130,35,95,5,1,4,125,34,91
442842,40,6,1,5,,,,6,1,5
443049,40,1,1,0,,,,1,1,0
443058,40,8,6,2,,,,8,6,2
443410,40,9,7,2,,,,9,7,2
443492,40,555,178,377,13,5,8,542,173,369
443599,40,9,0,9,,,,9,0,9
444219,40,859,363,496,50,22,28,809,341,468
444325,40,105,14,91,89,12,77,16,2,14
444565,40,5,2,3,,,,5,2,3
444954,40,137,31,106,17,9,8,120,22,98
445027,40,173,96,77,171,96,75,2,0,2
445267,40,1384,524,860,60,12,48,1324,512,812
446048,40,19,11,8,4,1,3,15,10,5
446233,40,4,1,3,,,,4,1,3
446640,40,6,2,4,,,,6,2,4
446774,40,2571,969,1602,185,82,103,2386,887,1499
447014,40,2,0,2,2,0,2,,,
447050,40,13,2,11,10,2,8,3,0,3
447582,40,269,88,181,24,7,17,245,81,164
447689,40,572,188,384,94,46,48,478,142,336
448248,40,1291,551,740,116,5,111,1175,546,629
448594,40,688,226,462,14,5,9,674,221,453
448673,40,7,2,5,,,,7,2,5
449038,40,1,0,1,,,,1,0,1
449339,40,1724,997,727,2,0,2,1722,997,725
449384,40,137,83,54,41,27,14,96,56,40
449764,40,1,0,1,1,0,1,,,
449816,40,321,226,95,1,1,0,320,225,95
450933,40,147,102,45,32,20,12,115,82,33
450960,40,7,2,5,,,,7,2,5
451370,40,1,1,0,1,1,0,,,
451398,40,2,2,0,2,2,0,,,
451583,40,76,25,51,9,8,1,67,17,50
451750,40,1,0,1,,,,1,0,1
451820,40,3,1,2,,,,3,1,2
451927,40,16,6,10,1,0,1,15,6,9
454184,40,29,9,20,12,1,11,17,8,9
454227,40,223,23,200,2,0,2,221,23,198
454582,40,44,15,29,1,1,0,43,14,29
454616,40,6,3,3,6,3,3,,,
454829,40,86,17,69,5,0,5,81,17,64
455114,40,4142,2311,1831,89,52,37,4053,2259,1794
455512,40,673,270,403,8,2,6,665,268,397
455983,40,4,2,2,4,2,2,,,
456959,40,15,1,14,11,1,10,4,0,4
457387,40,187,100,87,,,,187,100,87
457402,40,1,1,0,1,1,0,,,
457484,40,4,2,2,,,,4,2,2
457688,40,1,0,1,1,0,1,,,
458034,40,15,4,11,15,4,11,,,
458113,40,7,1,6,,,,7,1,6
458496,40,5,3,2,,,,5,3,2
458973,40,1,0,1,,,,1,0,1
458982,40,7,3,4,,,,7,3,4
459204,40,530,67,463,530,67,463,,,
459259,40,74,72,2,,,,74,72,2
459727,40,22,11,11,,,,22,11,11
459851,40,4,0,4,,,,4,0,4
459949,40,170,50,120,20,7,13,150,43,107
459994,40,29,10,19,1,1,0,28,9,19
460349,40,12,5,7,,,,12,5,7
460394,40,1092,417,675,37,15,22,1055,402,653
460464,40,1780,685,1095,41,22,19,1739,663,1076
461023,40,2,1,1,,,,2,1,1
461245,40,11,10,1,,,,11,10,1
461281,40,14,0,14,,,,14,0,14
461315,40,6,0,6,1,0,1,5,0,5
461528,40,16,10,6,,,,16,10,6
461795,40,7,2,5,,,,7,2,5
463056,40,24,16,8,1,1,0,23,15,8
474863,40,375,56,319,26,4,22,349,52,297
475121,40,3,0,3,,,,3,0,3
475176,40,6,3,3,6,3,3,,,
475273,40,1,0,1,,,,1,0,1
475398,40,5,3,2,,,,5,3,2
475723,40,129,105,24,13,7,6,116,98,18
475839,40,3,2,1,,,,3,2,1
476726,40,140,14,126,140,14,126,,,
476975,40,366,151,215,4,3,1,362,148,214
480091,40,2538,545,1993,370,77,293,2168,468,1700
480569,40,2,1,1,,,,2,1,1
480967,40,26,3,23,,,,26,3,23
481252,40,1,0,1,1,0,1,,,
482149,40,351,117,234,22,8,14,329,109,220
482158,40,712,284,428,62,34,28,650,250,400
482228,40,18,5,13,,,,18,5,13
482413,40,4,2,2,1,0,1,3,2,1
482431,40,5,2,3,,,,5,2,3
482459,40,3,1,2,,,,3,1,2
482468,40,14,1,13,6,0,6,8,1,7
482477,40,137,56,81,40,23,17,97,33,64
482574,40,2,1,1,,,,2,1,1
482680,40,1628,585,1043,162,56,106,1466,529,937
482699,40,281,78,203,26,6,20,255,72,183
482705,40,2867,1312,1555,2757,1272,1485,110,40,70
482936,40,9,5,4,1,0,1,8,5,3
483036,40,3,0,3,,,,3,0,3
483045,40,4083,1876,2207,98,37,61,3985,1839,2146
483124,40,198,87,111,3,0,3,195,87,108
483212,40,930,571,359,19,11,8,911,560,351
484002,40,58,4,54,55,4,51,3,0,3
484473,40,658,264,394,,,,658,264,394
484613,40,2937,1042,1895,2937,1042,1895,,,
484905,40,70,20,50,67,19,48,3,1,2
484932,40,31,15,16,,,,31,15,16
485111,40,2545,822,1723,122,37,85,2423,785,1638
485342,40,174,65,109,,,,174,65,109
485458,40,2101,869,1232,207,68,139,1894,801,1093
485564,40,295,26,269,290,26,264,5,0,5
486026,40,30,30,0,30,30,0,,,
486150,40,12,0,12,,,,12,0,12
486239,40,32,14,18,32,14,18,,,
486372,40,2,1,1,,,,2,1,1
486594,40,2,0,2,,,,2,0,2
486840,40,1148,359,789,340,104,236,808,255,553
486901,40,19,7,12,,,,19,7,12
487092,40,1,1,0,,,,1,1,0
487162,40,1456,612,844,59,31,28,1397,581,816
487320,40,1360,1066,294,703,598,105,657,468,189
487524,40,158,44,114,,,,158,44,114
487603,40,544,268,276,25,13,12,519,255,264
487995,40,5,1,4,1,0,1,4,1,3
488068,40,18,3,15,,,,18,3,15
488305,40,5,2,3,1,0,1,4,2,2
488679,40,33,20,13,30,18,12,3,2,1
488730,40,1241,455,786,114,44,70,1127,411,716
488776,40,16,14,2,3,1,2,13,13,0
488785,40,3,1,2,,,,3,1,2
488846,40,17774,10663,7111,5113,2947,2166,12661,7716,4945
488891,40,161,53,108,161,53,108,,,
488934,40,2797,1410,1387,,,,2797,1410,1387
489201,40,1762,650,1112,332,133,199,1430,517,913
489779,40,264,130,134,14,7,7,250,123,127
489937,40,6,3,3,4,3,1,2,0,2
490090,40,36,17,19,,,,36,17,19
490133,40,1,0,1,1,0,1,,,
490230,40,1,1,0,1,1,0,,,
490346,40,4,0,4,4,0,4,,,
490504,40,10,10,0,10,10,0,,,
490513,40,2,2,0,2,2,0,,,
490805,40,1648,591,1057,20,9,11,1628,582,1046
491525,40,5,3,2,1,1,0,4,2,2
491631,40,48,0,48,,,,48,0,48
491844,40,16,6,10,1,0,1,15,6,9
491941,40,4,0,4,4,0,4,,,
492069,40,4,2,2,,,,4,2,2
492689,40,1,1,0,,,,1,1,0
492759,40,3,0,3,,,,3,0,3
492801,40,56,16,40,4,1,3,52,15,37
492962,40,36,14,22,,,,36,14,22
493619,40,1,1,0,1,1,0,,,
493664,40,1,1,0,1,1,0,,,
493716,40,8,8,0,8,8,0,,,
493822,40,15,6,9,,,,15,6,9
494597,40,20,3,17,20,3,17,,,
494603,40,7,4,3,,,,7,4,3
494685,40,3,2,1,2,1,1,1,1,0
494959,40,18,7,11,,,,18,7,11
495013,40,4,3,1,,,,4,3,1
495031,40,1,1,0,1,1,0,,,
495271,40,3,1,2,,,,3,1,2
495280,40,2,2,0,,,,2,2,0
495767,40,1247,656,591,71,35,36,1176,621,555
497037,40,7,1,6,,,,7,1,6
497046,40,1455,436,1019,143,51,92,1312,385,927
100654,50,862,281,581,535,163,372,327,118,209
100663,50,8742,2982,5760,4525,1670,2855,4217,1312,2905
100690,50,472,214,258,153,76,77,319,138,181
100706,50,2067,1010,1057,674,353,321,1393,657,736
100724,50,465,139,326,323,96,227,142,43,99
100751,50,6631,2448,4183,3771,1523,2248,2860,925,1935
100812,50,235,94,141,32,14,18,203,80,123
100830,50,982,397,585,400,215,185,582,182,400
100858,50,6595,3079,3516,3554,1480,2074,3041,1599,1442
101116,50,54,9,45,35,7,28,19,2,17
101189,50,947,358,589,764,275,489,183,83,100
101365,50,7,1,6,6,1,5,1,0,1
101435,50,5,1,4,5,1,4,,,
101453,50,47,44,3,6,5,1,41,39,2
101480,50,1473,474,999,456,149,307,1017,325,692
101587,50,3272,655,2617,2997,577,2420,275,78,197
101693,50,257,81,176,62,10,52,195,71,124
101709,50,410,96,314,153,33,120,257,63,194
101879,50,2442,834,1608,597,171,426,1845,663,1182
101912,50,74,28,46,58,21,37,16,7,9
102049,50,2151,694,1457,1941,634,1307,210,60,150
102058,50,8,5,3,2,2,0,6,3,3
102094,50,5159,1044,4115,4148,869,3279,1011,175,836
102234,50,117,71,46,23,12,11,94,59,35
102298,50,59,15,44,57,13,44,2,2,0
102368,50,3604,1320,2284,1106,302,804,2498,1018,1480
102377,50,470,113,357,414,100,314,56,13,43
102395,50,97,71,26,33,23,10,64,48,16
102553,50,586,194,392,142,49,93,444,145,299
102614,50,982,380,602,366,155,211,616,225,391
102632,50,240,52,188,57,16,41,183,36,147
102669,50,178,52,126,50,11,39,128,41,87
104090,50,32,10,22,32,10,22,,,
104151,50,13165,6858,6307,10331,5462,4869,2834,1396,1438
104179,50,10840,4821,6019,6134,2631,3503,4706,2190,2516
104586,50,38,31,7,33,29,4,5,2,3
104665,50,6,5,1,6,5,1,,,
104717,50,37202,8384,28818,2,0,2,37200,8384,28816
105330,50,4549,1462,3087,2425,822,1603,2124,640,1484
105367,50,577,238,339,437,188,249,140,50,90
105534,50,66,11,55,66,11,55,,,
105589,50,659,120,539,233,39,194,426,81,345
106245,50,2326,896,1430,1107,456,651,1219,440,779
106263,50,2004,721,1283,1562,605,957,442,116,326
106397,50,4803,2237,2566,1787,747,1040,3016,1490,1526
106412,50,186,92,94,127,66,61,59,26,33
106458,50,4622,1366,3256,651,247,404,3971,1119,2852
106467,50,739,268,471,152,88,64,587,180,407
106485,50,409,141,268,146,48,98,263,93,170
106704,50,1861,495,1366,750,213,537,1111,282,829
107044,50,1289,438,851,611,219,392,678,219,459
107071,50,691,154,537,164,37,127,527,117,410
107080,50,9,5,4,9,5,4,,,
107141,50,685,185,500,127,38,89,558,147,411
107512,50,48,1,47,48,1,47,,,
107877,50,25,9,16,,,,25,9,16
107983,50,1274,449,825,276,137,139,998,312,686
108092,50,44,9,35,12,3,9,32,6,26
108232,50,2442,831,1611,1185,452,733,1257,379,878
108269,50,119,40,79,96,36,60,23,4,19
108861,50,60,40,20,13,8,5,47,32,15
108870,50,430,207,223,421,202,219,9,5,4
109086,50,13,6,7,13,6,7,,,
109651,50,291,124,167,260,109,151,31,15,16
109785,50,4187,1085,3102,1982,516,1466,2205,569,1636
110060,50,102,59,43,72,43,29,30,16,14
110097,50,1955,1065,890,759,412,347,1196,653,543
110316,50,1762,373,1389,1093,258,835,669,115,554
110361,50,3237,848,2389,2130,532,1598,1107,316,791
110370,50,381,114,267,345,107,238,36,7,29
110398,50,1140,444,696,1107,433,674,33,11,22
110404,50,1410,941,469,1410,941,469,,,
110413,50,1174,450,724,920,343,577,254,107,147
110422,50,1103,556,547,816,389,427,287,167,120
110468,50,3284,741,2543,1337,246,1091,1947,495,1452
110486,50,1605,403,1202,1154,266,888,451,137,314
110495,50,1283,313,970,853,190,663,430,123,307
110510,50,2656,875,1781,1564,464,1100,1092,411,681
110529,50,2482,1173,1309,1165,497,668,1317,676,641
110538,50,1240,417,823,711,219,492,529,198,331
110547,50,2599,742,1857,1371,353,1018,1228,389,839
110556,50,2860,967,1893,1991,633,1358,869,334,535
110565,50,5138,1892,3246,2230,712,1518,2908,1180,1728
110574,50,3075,1040,2035,2092,694,1398,983,346,637
110583,50,6293,2359,3934,3791,1375,2416,2502,984,1518
110592,50,3977,1447,2530,2530,864,1666,1447,583,864
110608,50,5612,1853,3759,2702,851,1851,2910,1002,1908
110617,50,3047,1002,2045,1647,485,1162,1400,517,883
110635,50,13222,6831,6391,10737,5355,5382,2485,1476,1009
110644,50,8393,3675,4718,7600,3319,4281,793,356,437
110653,50,7056,3514,3542,6551,3290,3261,505,224,281
110662,50,13994,7066,6928,12470,6106,6364,1524,960,564
110671,50,3979,2141,1838,3658,1964,1694,321,177,144
110680,50,8542,4918,3624,7953,4552,3401,589,366,223
110699,50,3165,1130,2035,3165,1130,2035,,,
110705,50,3033,1613,1420,2786,1500,1286,247,113,134
110714,50,1977,1056,921,1917,1021,896,60,35,25
110778,50,1038,450,588,76,14,62,962,436,526
111045,50,27,9,18,19,9,10,8,0,8
111081,50,479,178,301,472,173,299,7,5,2
111188,50,45,28,17,,,,45,28,17
111391,50,758,315,443,495,195,300,263,120,143
111948,50,2277,867,1410,1771,691,1080,506,176,330
111966,50,640,169,471,574,153,421,66,16,50
112075,50,2126,745,1381,1554,476,1078,572,269,303
112084,50,13,8,5,10,7,3,3,1,2
112127,50,64,27,37,25,16,9,39,11,28
112251,50,1953,797,1156,1174,488,686,779,309,470
112260,50,6,4,2,5,3,2,1,1,0
112394,50,9,7,2,6,5,1,3,2,1
112525,50,3788,1381,2407,3731,1370,2361,57,11,46
113582,50,8,0,8,2,0,2,6,0,6
113698,50,606,148,458,483,122,361,123,26,97
113704,50,65,54,11,46,41,5,19,13,6
114114,50,198,35,163,81,12,69,117,23,94
114123,50,73,20,53,63,17,46,10,3,7
114354,50,40,4,36,21,4,17,19,0,19
114549,50,1146,253,893,788,174,614,358,79,279
114585,50,375,90,285,243,57,186,132,33,99
114734,50,64,41,23,26,21,5,38,20,18
114813,50,838,221,617,382,89,293,456,132,324
114840,50,2191,1151,1040,505,222,283,1686,929,757
115083,50,1734,850,884,757,382,375,977,468,509
115214,50,194,97,97,145,79,66,49,18,31
115728,50,419,107,312,198,53,145,221,54,167
115746,50,908,247,661,620,175,445,288,72,216
115755,50,554,166,388,412,129,283,142,37,105
115773,50,153,46,107,65,20,45,88,26,62
116226,50,3,0,3,3,0,3,,,
116846,50,76,19,57,63,15,48,13,4,9
117104,50,131,60,71,112,51,61,19,9,10
117140,50,2510,783,1727,1390,435,955,1120,348,772
117168,50,31,13,18,27,11,16,4,2,2
117520,50,607,331,276,571,312,259,36,19,17
117557,50,202,123,79,201,122,79,1,1,0
117575,50,134,79,55,60,25,35,74,54,20
117627,50,387,128,259,249,77,172,138,51,87
117636,50,3317,1211,2106,2705,1057,1648,612,154,458
117672,50,1019,526,493,1001,517,484,18,9,9
117751,50,853,737,116,382,331,51,471,406,65
117946,50,3057,1148,1909,2475,913,1562,582,235,347
118541,50,71,34,37,27,8,19,44,26,18
118888,50,371,68,303,189,40,149,182,28,154
119058,50,700,215,485,570,175,395,130,40,90
119173,50,695,148,547,575,123,452,120,25,95
119270,50,11,6,5,11,6,5,,,
119605,50,9487,2720,6767,5498,1573,3925,3989,1147,2842
119678,50,2787,2217,570,1490,1233,257,1297,984,313
119775,50,77,52,25,63,42,21,14,10,4
120166,50,51,20,31,51,20,31,,,
120184,50,203,52,151,53,9,44,150,43,107
120403,50,55,10,45,55,10,45,,,
120537,50,519,153,366,355,101,254,164,52,112
120698,50,1085,188,897,720,118,602,365,70,295
120768,50,696,91,605,32,3,29,664,88,576
120795,50,97,40,57,27,7,20,70,33,37
120838,50,17,10,7,17,10,7,,,
120865,50,4,1,3,2,1,1,2,0,2
120883,50,2760,1052,1708,2133,801,1332,627,251,376
121150,50,6738,2032,4706,2950,1061,1889,3788,971,2817
121309,50,1271,371,900,559,156,403,712,215,497
121628,50,132,72,60,132,72,60,,,
121691,50,1415,505,910,1112,373,739,303,132,171
122117,50,106,41,65,80,31,49,26,10,16
122296,50,1320,345,975,844,249,595,476,96,380
122409,50,5163,1851,3312,3222,1058,2164,1941,793,1148
122436,50,3339,1417,1922,1643,583,1060,1696,834,862
122454,50,28,9,19,27,9,18,1,0,1
122506,50,214,88,126,213,88,125,1,0,1
122597,50,3475,1205,2270,2236,761,1475,1239,444,795
122612,50,4065,1381,2684,1996,658,1338,2069,723,1346
122649,50,161,57,104,10,5,5,151,52,99
122728,50,466,204,262,335,139,196,131,65,66
122755,50,8845,3230,5615,4318,1633,2685,4527,1597,2930
122931,50,3023,1392,1631,1899,881,1018,1124,511,613
123095,50,915,168,747,233,47,186,682,121,561
123165,50,21,7,14,20,6,14,1,1,0
123280,50,10,4,6,4,0,4,6,4,2
123448,50,371,121,250,175,63,112,196,58,138
123457,50,113,43,70,47,12,35,66,31,35
123554,50,966,343,623,493,200,293,473,143,330
123572,50,784,244,540,376,95,281,408,149,259
123633,50,260,79,181,171,46,125,89,33,56
123651,50,293,92,201,54,8,46,239,84,155
123916,50,75,18,57,35,12,23,40,6,34
123943,50,729,225,504,705,215,490,24,10,14
123952,50,266,151,115,265,150,115,1,1,0
123961,50,28528,12633,15895,22425,9914,12511,6103,2719,3384
123970,50,956,399,557,745,328,417,211,71,140
124283,50,237,139,98,168,97,71,69,42,27
124487,50,40,26,14,8,7,1,32,19,13
125037,50,258,89,169,233,86,147,25,3,22
125231,50,39336,7329,32007,17078,3087,13991,22258,4242,18016
125718,50,124,112,12,87,78,9,37,34,3
125763,50,62,16,46,33,7,26,29,9,20
125897,50,99,46,53,68,33,35,31,13,18
126012,50,517,111,406,517,111,406,,,
126049,50,286,113,173,230,89,141,56,24,32
126182,50,1303,379,924,739,154,585,564,225,339
126562,50,9978,3544,6434,4217,1616,2601,5761,1928,3833
126580,50,2029,811,1218,499,169,330,1530,642,888
126614,50,8114,4692,3422,2906,1516,1390,5208,3176,2032
126669,50,1284,319,965,603,162,441,681,157,524
126678,50,25,5,20,10,3,7,15,2,13
126775,50,1700,1174,526,1239,829,410,461,345,116
126818,50,7632,3333,4299,2939,1084,1855,4693,2249,2444
126827,50,2855,1136,1719,2407,931,1476,448,205,243
126979,50,899,485,414,560,290,270,339,195,144
127060,50,8263,2795,5468,3445,1042,2403,4818,1753,3065
127185,50,118,28,90,38,12,26,80,16,64
127273,50,197,76,121,132,48,84,65,28,37
127556,50,195,68,127,90,30,60,105,38,67
127565,50,1163,251,912,664,101,563,499,150,349
127653,50,639,161,478,358,97,261,281,64,217
127741,50,2991,733,2258,932,288,644,2059,445,1614
127909,50,97,25,72,97,25,72,,,
127918,50,2821,882,1939,2067,643,1424,754,239,515
127945,50,12,3,9,1,0,1,11,3,8
127954,50,33,5,28,33,5,28,,,
128106,50,2182,479,1703,449,116,333,1733,363,1370
128391,50,448,140,308,302,104,198,146,36,110
128498,50,297,77,220,196,52,144,101,25,76
128744,50,1690,602,1088,860,384,476,830,218,612
128771,50,1905,684,1221,484,164,320,1421,520,901
128780,50,92,22,70,6,0,6,86,22,64
129020,50,8309,3744,4565,5668,2518,3150,2641,1226,1415
129154,50,102,23,79,10,2,8,92,21,71
129215,50,174,53,121,74,29,45,100,24,76
129242,50,1223,405,818,567,210,357,656,195,461
129428,50,105,79,26,,,,105,79,26
129491,50,112,60,52,33,23,10,79,37,42
129525,50,1914,711,1203,684,259,425,1230,452,778
129534,50,417,307,110,54,45,9,363,262,101
129941,50,2490,1292,1198,1742,914,828,748,378,370
130110,50,1,1,0,,,,1,1,0
130183,50,1058,379,679,108,38,70,950,341,609
130226,50,2919,952,1967,1774,619,1155,1145,333,812
130253,50,3024,779,2245,1380,427,953,1644,352,1292
130314,50,1226,222,1004,673,118,555,553,104,449
130493,50,1988,491,1497,809,181,628,1179,310,869
130590,50,31,23,8,7,5,2,24,18,6
130697,50,196,83,113,132,66,66,64,17,47
130776,50,630,160,470,81,23,58,549,137,412
130794,50,8031,3721,4310,7828,3640,4188,203,81,122
130934,50,801,226,575,705,199,506,96,27,69
130943,50,4586,2135,2451,3504,1655,1849,1082,480,602
130989,50,445,180,265,92,29,63,353,151,202
131113,50,4797,1403,3394,958,362,596,3839,1041,2798
131159,50,6389,2368,4021,3116,1139,1977,3273,1229,2044
131283,50,2130,1006,1124,887,456,431,1243,550,693
131399,50,529,211,318,321,120,201,208,91,117
131405,50,74,67,7,71,66,5,3,1,2
131450,50,421,105,316,239,41,198,182,64,118
131469,50,14955,5699,9256,7375,2993,4382,7580,2706,4874
131496,50,13337,6098,7239,8169,3774,4395,5168,2324,2844
131520,50,3101,1016,2085,2637,863,1774,464,153,311
131803,50,78,27,51,16,8,8,62,19,43
131876,50,421,43,378,118,9,109,303,34,269
131973,50,448,224,224,179,93,86,269,131,138
132408,50,24,17,7,8,3,5,16,14,2
132471,50,4005,1135,2870,2370,747,1623,1635,388,1247
132602,50,111,46,65,91,37,54,20,9,11
132657,50,745,306,439,386,152,234,359,154,205
132842,50,659,94,565,463,62,401,196,32,164
132903,50,10314,4153,6161,4889,2174,2715,5425,1979,3446
133465,50,163,34,129,132,28,104,31,6,25
133526,50,31,14,17,31,14,17,,,
133553,50,677,483,194,582,411,171,95,72,23
133650,50,1699,567,1132,1400,458,942,299,109,190
133669,50,5356,2035,3321,2375,915,1460,2981,1120,1861
133711,50,11,0,11,2,0,2,9,0,9
133872,50,523,137,386,309,90,219,214,47,167
133881,50,4339,1548,2791,963,498,465,3376,1050,2326
133951,50,10249,3949,6300,7793,2988,4805,2456,961,1495
133979,50,36,13,23,24,10,14,12,3,9
134079,50,575,192,383,365,129,236,210,63,147
134097,50,11537,4433,7104,6666,2852,3814,4871,1581,3290
134130,50,20905,8809,12096,13239,6156,7083,7666,2653,5013
134237,50,1435,794,641,1435,794,641,,,
134510,50,2,1,1,1,0,1,1,1,0
134811,50,40,10,30,24,6,18,16,4,12
134945,50,1349,327,1022,631,155,476,718,172,546
135081,50,1871,597,1274,1171,389,782,700,208,492
135364,50,408,289,119,93,69,24,315,220,95
135610,50,54,20,34,16,6,10,38,14,24
135726,50,7007,3109,3898,6203,2815,3388,804,294,510
136172,50,2427,672,1755,986,289,697,1441,383,1058
136215,50,14261,3969,10292,8997,2906,6091,5264,1063,4201
136330,50,850,297,553,527,163,364,323,134,189
136701,50,136,134,2,114,113,1,22,21,1
136950,50,547,245,302,333,165,168,214,80,134
137032,50,2783,1006,1777,2512,874,1638,271,132,139
137272,50,8,8,0,8,8,0,,,
137351,50,11697,4520,7177,6573,2800,3773,5124,1720,3404
137476,50,2313,831,1482,1899,697,1202,414,134,280
137546,50,1381,597,784,980,430,550,401,167,234
137564,50,1247,472,775,565,221,344,682,251,431
137777,50,2,2,0,2,2,0,,,
137847,50,956,380,576,434,205,229,522,175,347
137953,50,10,5,5,,,,10,5,5
138275,50,125,63,62,7,4,3,118,59,59
138293,50,36,18,18,20,9,11,16,9,7
138309,50,135,20,115,92,16,76,43,4,39
138354,50,3969,1260,2709,586,183,403,3383,1077,2306
138600,50,46,3,43,15,1,14,31,2,29
138716,50,473,86,387,260,50,210,213,36,177
138868,50,25,15,10,12,6,6,13,9,4
138929,50,303,121,182,193,86,107,110,35,75
138947,50,665,183,482,461,118,343,204,65,139
139144,50,131,36,95,56,13,43,75,23,52
139153,50,229,105,124,132,64,68,97,41,56
139199,50,1124,199,925,690,137,553,434,62,372
139311,50,672,181,491,271,72,199,401,109,292
139348,50,177,85,92,133,63,70,44,22,22
139366,50,1495,488,1007,463,185,278,1032,303,729
139393,50,42,12,30,36,9,27,6,3,3
139579,50,548,143,405,482,128,354,66,15,51
139658,50,7649,2773,4876,6356,2209,4147,1293,564,729
139719,50,257,63,194,134,33,101,123,30,93
139755,50,26396,19527,6869,7333,4948,2385,19063,14579,4484
139764,50,691,152,539,419,57,362,272,95,177
139861,50,1177,336,841,297,87,210,880,249,631
139931,50,3549,1006,2543,1425,424,1001,2124,582,1542
139940,50,7988,2900,5088,5705,2163,3542,2283,737,1546
139959,50,9952,3802,6150,7458,2971,4487,2494,831,1663
140146,50,237,131,106,130,64,66,107,67,40
140234,50,60,15,45,53,15,38,7,0,7
140252,50,1866,904,962,1627,789,838,239,115,124
140340,50,36,11,25,34,10,24,2,1,1
140447,50,4068,1277,2791,2934,991,1943,1134,286,848
140562,50,753,293,460,725,283,442,28,10,18
140818,50,805,161,644,309,67,242,496,94,402
140872,50,119,58,61,83,36,47,36,22,14
140951,50,2864,841,2023,2158,649,1509,706,192,514
140960,50,247,78,169,125,39,86,122,39,83
140988,50,128,68,60,103,52,51,25,16,9
141167,50,625,112,513,425,80,345,200,32,168
141185,50,29,15,14,11,5,6,18,10,8
141237,50,105,44,61,67,23,44,38,21,17
141264,50,2797,690,2107,872,187,685,1925,503,1422
141325,50,39,4,35,37,4,33,2,0,2
141334,50,3149,745,2404,575,182,393,2574,563,2011
141361,50,19,5,14,18,5,13,1,0,1
141486,50,665,180,485,473,117,356,192,63,129
141565,50,480,147,333,294,84,210,186,63,123
141574,50,4978,1881,3097,2419,892,1527,2559,989,1570
141644,50,520,182,338,373,132,241,147,50,97
142115,50,3390,1213,2177,1285,468,817,2105,745,1360
142276,50,2317,904,1413,1488,618,870,829,286,543
142285,50,2672,1324,1348,1742,862,880,930,462,468
142294,50,26,11,15,14,8,6,12,3,9
142328,50,1,1,0,,,,1,1,0
142461,50,721,205,516,569,158,411,152,47,105
142832,50,1864,333,1531,1175,208,967,689,125,564
142957,50,13,9,4,4,4,0,9,5,4
143048,50,764,197,567,672,174,498,92,23,69
143084,50,29,0,29,29,0,29,,,
143118,50,2051,424,1627,943,176,767,1108,248,860
143233,50,74,39,35,22,13,9,52,26,26
143297,50,16,0,16,,,,16,0,16
143358,50,1257,279,978,360,138,222,897,141,756
143659,50,227,143,84,90,78,12,137,65,72
143853,50,2853,999,1854,2805,987,1818,48,12,36
143978,50,1267,242,1025,819,143,676,448,99,349
144005,50,864,259,605,467,155,312,397,104,293
144014,50,317,111,206,126,45,81,191,66,125
144050,50,11196,6165,5031,9109,4863,4246,2087,1302,785
144281,50,243,94,149,198,84,114,45,10,35
144351,50,4648,1492,3156,242,84,158,4406,1408,2998
144740,50,7376,3197,4179,5173,2147,3026,2203,1050,1153
144892,50,1705,640,1065,730,343,387,975,297,678
144962,50,604,204,400,176,32,144,428,172,256
145275,50,284,127,157,163,72,91,121,55,66
145336,50,1686,535,1151,782,317,465,904,218,686
145372,50,157,47,110,12,4,8,145,43,102
145558,50,2051,865,1186,1980,847,1133,71,18,53
145600,50,11920,4752,7168,8416,3559,4857,3504,1193,2311
145619,50,1193,311,882,318,99,219,875,212,663
145628,50,514,136,378,496,134,362,18,2,16
145637,50,21828,12170,9658,13119,7257,5862,8709,4913,3796
145725,50,3488,2086,1402,2416,1343,1073,1072,743,329
145813,50,2559,897,1662,1289,531,758,1270,366,904
145886,50,127,26,101,123,25,98,4,1,3
146339,50,241,95,146,208,83,125,33,12,21
146481,50,29,10,19,13,5,8,16,5,11
146490,50,394,175,219,,,,394,175,219
146612,50,2276,866,1410,908,442,466,1368,424,944
146667,50,250,145,105,81,36,45,169,109,60
146676,50,30,7,23,,,,30,7,23
146719,50,5679,1821,3858,4172,1433,2739,1507,388,1119
146728,50,130,63,67,111,51,60,19,12,7
146755,50,25,3,22,25,3,22,,,
146977,50,203,126,77,51,31,20,152,95,57
147013,50,515,166,349,174,85,89,341,81,260
147031,50,70,22,48,44,14,30,26,8,18
147129,50,36,2,34,28,2,26,8,0,8
147244,50,94,38,56,62,25,37,32,13,19
147369,50,703,439,264,203,120,83,500,319,181
147536,50,3708,650,3058,1619,339,1280,2089,311,1778
147590,50,435,182,253,404,173,231,31,9,22
147660,50,324,95,229,286,84,202,38,11,27
147679,50,900,356,544,113,32,81,787,324,463
147697,50,346,243,103,251,188,63,95,55,40
147703,50,4400,1797,2603,1895,904,991,2505,893,1612
147767,50,14562,6882,7680,10397,4890,5507,4165,1992,2173
147776,50,1832,587,1245,487,181,306,1345,406,939
147828,50,819,188,631,54,20,34,765,168,597
148131,50,133,66,67,35,19,16,98,47,51
148405,50,244,92,152,67,28,39,177,64,113
148487,50,1471,395,1076,896,248,648,575,147,428
148496,50,1003,197,806,348,66,282,655,131,524
148511,50,2771,649,2122,1757,527,1230,1014,122,892
148575,50,157,19,138,1,0,1,156,19,137
148584,50,1854,372,1482,196,61,135,1658,311,1347
148593,50,15,1,14,,,,15,1,14
148627,50,648,156,492,162,37,125,486,119,367
148654,50,1441,705,736,478,211,267,963,494,469
148885,50,187,166,21,130,125,5,57,41,16
148982,50,110,31,79,45,11,34,65,20,45
149028,50,73,4,69,4,0,4,69,4,65
149222,50,3119,1444,1675,1883,830,1053,1236,614,622
149231,50,3043,1158,1885,1318,531,787,1725,627,1098
149329,50,15,15,0,15,15,0,,,
149505,50,64,6,58,60,6,54,4,0,4
149514,50,813,565,248,289,199,90,524,366,158
149639,50,164,70,94,15,10,5,149,60,89
149763,50,59,8,51,37,5,32,22,3,19
149772,50,2061,884,1177,1007,531,476,1054,353,701
149781,50,706,244,462,228,72,156,478,172,306
150066,50,186,86,100,22,10,12,164,76,88
150136,50,5421,1245,4176,1218,338,880,4203,907,3296
150145,50,133,51,82,38,18,20,95,33,62
150163,50,1022,343,679,473,151,322,549,192,357
150172,50,115,54,61,19,6,13,96,48,48
150215,50,145,48,97,107,39,68,38,9,29
150288,50,307,270,37,212,187,25,95,83,12
150455,50,78,33,45,40,20,20,38,13,25
150534,50,282,86,196,275,84,191,7,2,5
150604,50,63,16,47,61,15,46,2,1,1
150668,50,62,7,55,12,3,9,50,4,46
150677,50,321,173,148,80,29,51,241,144,97
150756,50,79,33,46,79,33,46,,,
150941,50,230,51,179,208,42,166,22,9,13
151102,50,530,247,283,220,115,105,310,132,178
151111,50,8493,3166,5327,5097,2110,2987,3396,1056,2340
151263,50,1262,341,921,706,183,523,556,158,398
151290,50,928,517,411,456,273,183,472,244,228
151306,50,1848,678,1170,376,114,262,1472,564,908
151324,50,1755,635,1120,830,270,560,925,365,560
151333,50,178,59,119,40,11,29,138,48,90
151342,50,584,159,425,142,32,110,442,127,315
151351,50,11075,5883,5192,6912,3692,3220,4163,2191,1972
151360,50,397,102,295,102,28,74,295,74,221
151379,50,537,174,363,95,26,69,442,148,294
151388,50,224,72,152,12,5,7,212,67,145
151777,50,322,122,200,275,112,163,47,10,37
151786,50,1091,439,652,801,351,450,290,88,202
151801,50,401,78,323,176,48,128,225,30,195
151810,50,51,16,35,17,4,13,34,12,22
151865,50,122,68,54,29,9,20,93,59,34
152080,50,4166,2352,1814,3894,2219,1675,272,133,139
152099,50,173,82,91,66,29,37,107,53,54
152318,50,20,18,2,15,13,2,5,5,0
152336,50,470,123,347,173,45,128,297,78,219
152381,50,334,35,299,112,16,96,222,19,203
152390,50,125,8,117,63,1,62,62,7,55
152451,50,183,154,29,104,101,3,79,53,26
152530,50,38,23,15,17,8,9,21,15,6
152567,50,213,57,156,208,55,153,5,2,3
152600,50,417,179,238,305,146,159,112,33,79
152798,50,238,24,214,143,14,129,95,10,85
152992,50,234,74,160,106,46,60,128,28,100
153001,50,453,74,379,6,1,5,447,73,374
153126,50,171,38,133,122,29,93,49,9,40
153162,50,9,3,6,6,1,5,3,2,1
153250,50,249,88,161,1,0,1,248,88,160
153269,50,1973,658,1315,921,330,591,1052,328,724
153278,50,407,176,231,351,150,201,56,26,30
153320,50,62,52,10,22,19,3,40,33,7
153366,50,470,76,394,225,40,185,245,36,209
153375,50,196,77,119,99,48,51,97,29,68
153603,50,4900,2481,2419,3092,1519,1573,1808,962,846
153621,50,66,34,32,60,31,29,6,3,3
153658,50,8301,3828,4473,5106,2276,2830,3195,1552,1643
153825,50,90,26,64,81,24,57,9,2,7
153861,50,1748,1078,670,1133,848,285,615,230,385
154004,50,1074,206,868,42,3,39,1032,203,829
154013,50,290,99,191,116,27,89,174,72,102
154022,50,7278,2224,5054,7278,2224,5054,,,
154095,50,1250,324,926,449,120,329,801,204,597
154101,50,460,112,348,87,18,69,373,94,279
154156,50,1562,741,821,1396,693,703,166,48,118
154174,50,2139,1200,939,2102,1176,926,37,24,13
154235,50,685,190,495,479,94,385,206,96,110
154350,50,46,18,28,4,3,1,42,15,27
154493,50,521,172,349,410,129,281,111,43,68
154518,50,432,269,163,29,18,11,403,251,152
154527,50,25,7,18,1,0,1,24,7,17
154536,50,206,77,129,181,66,115,25,11,14
154590,50,68,42,26,42,30,12,26,12,14
154688,50,820,274,546,66,20,46,754,254,500
154712,50,85,47,38,67,36,31,18,11,7
154855,50,16,15,1,16,15,1,,,
155025,50,2667,785,1882,551,163,388,2116,622,1494
155061,50,2700,803,1897,593,161,432,2107,642,1465
155070,50,31,22,9,17,11,6,14,11,3
155089,50,502,161,341,167,37,130,335,124,211
155317,50,7622,3253,4369,5505,2444,3061,2117,809,1308
155335,50,463,144,319,383,122,261,80,22,58
155399,50,4610,1786,2824,2554,1031,1523,2056,755,1301
155414,50,52,34,18,,,,52,34,18
155511,50,12,3,9,1,0,1,11,3,8
155520,50,413,85,328,90,24,66,323,61,262
155627,50,93,66,27,82,58,24,11,8,3
155636,50,257,136,121,192,105,87,65,31,34
155681,50,1457,564,893,420,199,221,1037,365,672
155812,50,422,152,270,187,60,127,235,92,143
155900,50,118,56,62,46,25,21,72,31,41
155937,50,14,2,12,14,2,12,,,
155973,50,67,25,42,,,,67,25,42
156082,50,829,277,552,499,208,291,330,69,261
156125,50,3317,1392,1925,1624,764,860,1693,628,1065
156213,50,248,98,150,20,10,10,228,88,140
156222,50,1725,1024,701,581,323,258,1144,701,443
156286,50,742,251,491,326,142,184,416,109,307
156356,50,89,10,79,56,7,49,33,3,30
156365,50,5572,3210,2362,2486,1406,1080,3086,1804,1282
156417,50,24,23,1,24,23,1,,,
156471,50,276,29,247,222,25,197,54,4,50
156541,50,14434,8094,6340,2208,815,1393,12226,7279,4947
156620,50,2300,689,1611,708,207,501,1592,482,1110
156727,50,2468,141,2327,1793,101,1692,675,40,635
156745,50,366,95,271,1,0,1,365,95,270
157021,50,32,16,16,22,12,10,10,4,6
157058,50,144,78,66,75,39,36,69,39,30
157085,50,8490,3203,5287,6444,2589,3855,2046,614,1432
157100,50,71,21,50,11,4,7,60,17,43
157207,50,94,40,54,6,2,4,88,38,50
157216,50,854,306,548,462,222,240,392,84,308
157289,50,6506,3030,3476,4423,2060,2363,2083,970,1113
157298,50,136,48,88,84,30,54,52,18,34
157377,50,209,65,144,55,26,29,154,39,115
157386,50,670,252,418,189,82,107,481,170,311
157401,50,1763,619,1144,555,189,366,1208,430,778
157447,50,5165,1339,3826,1312,364,948,3853,975,2878
157535,50,900,391,509,893,386,507,7,5,2
157748,50,3429,2956,473,1596,1428,168,1833,1528,305
157757,50,797,144,653,537,89,448,260,55,205
157793,50,456,177,279,365,144,221,91,33,58
157809,50,144,69,75,57,31,26,87,38,49
157863,50,235,106,129,97,44,53,138,62,76
157951,50,2021,689,1332,756,241,515,1265,448,817
158477,50,19,11,8,,,,19,11,8
159009,50,865,224,641,194,56,138,671,168,503
159373,50,1942,713,1229,1843,699,1144,99,14,85
159391,50,6639,2633,4006,4609,1797,2812,2030,836,1194
159416,50,6404,2577,3827,1344,476,868,5060,2101,2959
159568,50,176,41,135,63,11,52,113,30,83
159647,50,984,457,527,623,301,322,361,156,205
159656,50,1205,378,827,722,256,466,483,122,361
159717,50,561,140,421,267,83,184,294,57,237
159939,50,1445,588,857,709,322,387,736,266,470
159948,50,1212,868,344,386,243,143,826,625,201
159966,50,658,124,534,222,47,175,436,77,359
159993,50,1990,477,1513,1080,297,783,910,180,730
160038,50,1113,213,900,197,72,125,916,141,775
160065,50,355,68,287,187,31,156,168,37,131
160074,50,353,92,261,268,78,190,85,14,71
160612,50,997,235,762,378,107,271,619,128,491
160621,50,1757,640,1117,1106,433,673,651,207,444
160630,50,294,75,219,167,44,123,127,31,96
160658,50,2525,1113,1412,1092,516,576,1433,597,836
160755,50,5347,2091,3256,4111,1677,2434,1236,414,822
160904,50,849,211,638,819,203,616,30,8,22
160959,50,2,1,1,1,1,0,1,0,1
160995,50,6,1,5,6,1,5,,,
161217,50,48,22,26,5,4,1,43,18,25
161226,50,298,39,259,21,1,20,277,38,239
161253,50,2542,973,1569,881,377,504,1661,596,1065
161299,50,17,12,5,10,6,4,7,6,1
161341,50,17,9,8,9,7,2,8,2,6
161457,50,2971,799,2172,2454,707,1747,517,92,425
161509,50,82,18,64,67,14,53,15,4,11
161518,50,169,62,107,35,18,17,134,44,90
161554,50,2040,516,1524,624,220,404,1416,296,1120
161563,50,90,32,58,30,17,13,60,15,45
161572,50,448,113,335,188,43,145,260,70,190
161873,50,2105,764,1341,990,373,617,1115,391,724
162007,50,927,295,632,471,165,306,456,130,326
162061,50,465,357,108,296,233,63,169,124,45
162210,50,95,24,71,21,5,16,74,19,55
162283,50,256,67,189,65,19,46,191,48,143
162584,50,772,282,490,264,104,160,508,178,330
162654,50,860,178,682,67,20,47,793,158,635
162760,50,878,271,607,154,60,94,724,211,513
162928,50,25917,11817,14100,11528,4937,6591,14389,6880,7509
163046,50,1353,387,966,401,87,314,952,300,652
163204,50,10223,4647,5576,120,41,79,10103,4606,5497
163259,50,6314,1769,4545,4419,1333,3086,1895,436,1459
163268,50,2803,1447,1356,1536,835,701,1267,612,655
163286,50,10350,5247,5103,8006,4136,3870,2344,1111,1233
163295,50,607,169,438,220,68,152,387,101,286
163338,50,573,187,386,347,113,234,226,74,152
163453,50,1435,571,864,1144,456,688,291,115,176
163462,50,515,317,198,273,210,63,242,107,135
163532,50,188,188,0,171,171,0,17,17,0
163578,50,1377,281,1096,355,70,285,1022,211,811
163851,50,875,195,680,513,119,394,362,76,286
163912,50,25,6,19,24,5,19,1,1,0
163976,50,67,52,15,45,35,10,22,17,5
164076,50,2949,675,2274,993,237,756,1956,438,1518
164085,50,807,69,738,106,10,96,701,59,642
164173,50,475,110,365,92,26,66,383,84,299
164270,50,1296,272,1024,561,134,427,735,138,597
164368,50,1576,890,686,1340,750,590,236,140,96
164447,50,956,255,701,857,233,624,99,22,77
164492,50,402,271,131,120,68,52,282,203,79
164562,50,373,94,279,177,50,127,196,44,152
164580,50,1108,644,464,561,347,214,547,297,250
164632,50,1215,124,1091,477,43,434,738,81,657
164739,50,1162,553,609,506,260,246,656,293,363
164748,50,766,412,354,639,329,310,127,83,44
164872,50,438,181,257,409,172,237,29,9,20
164915,50,163,60,103,66,27,39,97,33,64
164924,50,5622,2373,3249,3893,1619,2274,1729,754,975
164988,50,17875,7600,10275,11587,4949,6638,6288,2651,3637
165015,50,1967,855,1112,1552,699,853,415,156,259
165024,50,1573,365,1208,501,98,403,1072,267,805
165167,50,1463,332,1131,457,103,354,1006,229,777
165334,50,1048,517,531,881,449,432,167,68,99
165495,50,18,5,13,18,5,13,,,
165529,50,192,73,119,48,7,41,144,66,78
165644,50,155,45,110,91,32,59,64,13,51
165662,50,1783,221,1562,1285,172,1113,498,49,449
165671,50,80,12,68,14,4,10,66,8,58
165699,50,1005,216,789,296,86,210,709,130,579
165802,50,114,37,77,9,6,3,105,31,74
165820,50,3325,1021,2304,520,189,331,2805,832,1973
165866,50,1282,295,987,104,32,72,1178,263,915
165936,50,436,115,321,164,35,129,272,80,192
165945,50,1380,870,510,356,196,160,1024,674,350
166027,50,21766,10082,11684,13677,6438,7239,8089,3644,4445
166045,50,103,42,61,71,30,41,32,12,20
166054,50,79,63,16,63,56,7,16,7,9
166391,50,394,163,231,28,10,18,366,153,213
166452,50,2253,307,1946,617,87,530,1636,220,1416
166489,50,238,100,138,223,97,126,15,3,12
166513,50,4713,2530,2183,1620,899,721,3093,1631,1462
166629,50,7814,3743,4071,2720,1346,1374,5094,2397,2697
166638,50,3368,1127,2241,1311,464,847,2057,663,1394
166656,50,3636,969,2667,2245,665,1580,1391,304,1087
166674,50,129,48,81,102,40,62,27,8,19
166683,50,7296,4524,2772,7199,4451,2748,97,73,24
166692,50,98,77,21,98,77,21,,,
166708,50,1292,445,847,1202,433,769,90,12,78
166717,50,817,152,665,552,95,457,265,57,208
166850,50,1332,364,968,724,245,479,608,119,489
166869,50,1144,174,970,829,122,707,315,52,263
166939,50,122,16,106,15,3,12,107,13,94
167057,50,404,203,201,351,175,176,53,28,25
167093,50,525,125,400,525,125,400,,,
167215,50,1064,378,686,807,272,535,257,106,151
167260,50,227,149,78,64,44,20,163,105,58
167288,50,124,41,83,64,19,45,60,22,38
167358,50,12420,6465,5955,11189,5900,5289,1231,565,666
167394,50,319,67,252,100,24,76,219,43,176
167455,50,16,5,11,16,5,11,,,
167464,50,41,41,0,41,41,0,,,
167598,50,2328,257,2071,439,69,370,1889,188,1701
167677,50,78,57,21,48,46,2,30,11,19
167729,50,1576,343,1233,644,139,505,932,204,728
167783,50,4236,484,3752,1444,189,1255,2792,295,2497
167835,50,358,58,300,341,52,289,17,6,11
167899,50,906,278,628,728,220,508,178,58,120
167987,50,1884,875,1009,751,374,377,1133,501,632
167996,50,56,21,35,18,10,8,38,11,27
168005,50,2420,899,1521,1345,472,873,1075,427,648
168148,50,6617,2556,4061,5492,2084,3408,1125,472,653
168227,50,205,138,67,121,73,48,84,65,19
168254,50,1074,413,661,621,259,362,453,154,299
168263,50,774,252,522,389,121,268,385,131,254
168342,50,50,22,28,50,22,28,,,
168421,50,2006,1381,625,866,598,268,1140,783,357
168430,50,777,138,639,160,11,149,617,127,490
168528,50,66,34,32,50,28,22,16,6,10
168591,50,13,4,9,13,4,9,,,
168740,50,1569,960,609,616,406,210,953,554,399
168786,50,124,37,87,55,21,34,69,16,53
168847,50,307,77,230,101,19,82,206,58,148
169080,50,189,72,117,103,41,62,86,31,55
169099,50,249,171,78,163,118,45,86,53,33
169220,50,203,51,152,141,36,105,62,15,47
169248,50,4007,1583,2424,1626,684,942,2381,899,1482
169327,50,139,69,70,92,53,39,47,16,31
169363,50,167,35,132,87,19,68,80,16,64
169424,50,129,47,82,129,47,82,,,
169442,50,62,33,29,52,28,24,10,5,5
169479,50,1032,387,645,174,50,124,858,337,521
169716,50,2303,958,1345,1724,736,988,579,222,357
169798,50,2610,833,1777,872,264,608,1738,569,1169
169910,50,1113,381,732,723,273,450,390,108,282
169983,50,342,268,74,110,88,22,232,180,52
170000,50,55,18,37,45,16,29,10,2,8
170037,50,423,193,230,39,16,23,384,177,207
170082,50,3027,849,2178,1533,398,1135,1494,451,1043
170286,50,87,59,28,35,28,7,52,31,21
170675,50,599,405,194,27,21,6,572,384,188
170806,50,404,95,309,109,29,80,295,66,229
170967,50,27,20,7,25,18,7,2,2,0
170976,50,17996,8888,9108,15912,7633,8279,2084,1255,829
171100,50,11085,4698,6387,8080,3598,4482,3005,1100,1905
171128,50,1231,859,372,814,560,254,417,299,118
171137,50,1976,1210,766,511,298,213,1465,912,553
171146,50,1423,466,957,640,180,460,783,286,497
171456,50,603,192,411,229,90,139,374,102,272
171492,50,306,167,139,85,42,43,221,125,96
171571,50,3399,1468,1931,1929,800,1129,1470,668,802
171599,50,34,19,15,,,,34,19,15
171881,50,13,10,3,9,7,2,4,3,1
172033,50,110,86,24,46,45,1,64,41,23
172051,50,734,155,579,228,51,177,506,104,402
172264,50,184,68,116,57,18,39,127,50,77
172334,50,1470,174,1296,1301,149,1152,169,25,144
172477,50,691,280,411,161,66,95,530,214,316
172608,50,858,409,449,21,12,9,837,397,440
172644,50,8080,3232,4848,5071,2031,3040,3009,1201,1808
172699,50,3679,1375,2304,1365,443,922,2314,932,1382
172705,50,377,233,144,73,40,33,304,193,111
173045,50,803,240,563,563,172,391,240,68,172
173124,50,402,153,249,82,32,50,320,121,199
173142,50,17,11,6,14,8,6,3,3,0
173160,50,1078,350,728,345,65,280,733,285,448
173300,50,36,3,33,,,,36,3,33
173328,50,2188,756,1432,2154,739,1415,34,17,17
173452,50,125,67,58,2,1,1,123,66,57
173665,50,1114,326,788,41,13,28,1073,313,760
173683,50,172,52,120,102,31,71,70,21,49
173896,50,480,210,270,301,135,166,179,75,104
173920,50,1956,621,1335,669,199,470,1287,422,865
173957,50,992,464,528,947,444,503,45,20,25
174020,50,914,370,544,219,69,150,695,301,394
174066,50,16167,6994,9173,9647,3925,5722,6520,3069,3451
174127,50,100,22,78,38,9,29,62,13,49
174154,50,9,1,8,8,1,7,1,0,1
174233,50,860,348,512,562,195,367,298,153,145
174358,50,1062,297,765,206,51,155,856,246,610
174437,50,84,34,50,60,27,33,24,7,17
174491,50,109,63,46,16,12,4,93,51,42
174507,50,739,335,404,689,328,361,50,7,43
174747,50,15,0,15,14,0,14,1,0,1
174783,50,1818,670,1148,677,273,404,1141,397,744
174792,50,105,61,44,47,22,25,58,39,19
174817,50,3455,963,2492,2279,621,1658,1176,342,834
174862,50,337,155,182,244,109,135,93,46,47
174899,50,1368,318,1050,957,208,749,411,110,301
174914,50,3280,1481,1799,1059,419,640,2221,1062,1159
175005,50,1319,144,1175,524,69,455,795,75,720
175014,50,256,60,196,181,34,147,75,26,49
175078,50,430,143,287,225,63,162,205,80,125
175139,50,197,82,115,93,37,56,104,45,59
175272,50,797,159,638,288,66,222,509,93,416
175281,50,1210,534,676,468,200,268,742,334,408
175342,50,541,132,409,171,56,115,370,76,294
175421,50,2564,664,1900,216,82,134,2348,582,1766
175430,50,31,14,17,18,8,10,13,6,7
175616,50,686,220,466,278,101,177,408,119,289
175856,50,2317,566,1751,870,208,662,1447,358,1089
175980,50,31,16,15,19,11,8,12,5,7
176017,50,5111,1999,3112,3631,1518,2113,1480,481,999
176035,50,299,44,255,175,16,159,124,28,96
176044,50,350,114,236,117,41,76,233,73,160
176053,50,1727,548,1179,1182,419,763,545,129,416
176080,50,4502,2039,2463,2068,897,1171,2434,1142,1292
176372,50,3453,1164,2289,1572,576,996,1881,588,1293
176406,50,26,6,20,1,0,1,25,6,19
176451,50,231,132,99,65,37,28,166,95,71
176479,50,2401,762,1639,1659,576,1083,742,186,556
176600,50,99,63,36,34,26,8,65,37,28
176628,50,352,79,273,280,60,220,72,19,53
176664,50,44,36,8,21,17,4,23,19,4
176770,50,207,28,179,105,14,91,102,14,88
176789,50,84,64,20,37,26,11,47,38,9
176910,50,29,24,5,23,18,5,6,6,0
176965,50,2953,1268,1685,1177,615,562,1776,653,1123
177038,50,537,292,245,508,283,225,29,9,20
177065,50,414,153,261,81,26,55,333,127,206
177092,50,597,554,43,269,248,21,328,306,22
177126,50,634,400,234,196,129,67,438,271,167
177144,50,53,24,29,53,24,29,,,
177214,50,270,85,185,22,9,13,248,76,172
177278,50,103,50,53,51,21,30,52,29,23
177339,50,431,183,248,195,90,105,236,93,143
177418,50,290,69,221,155,27,128,135,42,93
177542,50,56,22,34,38,16,22,18,6,12
177719,50,106,23,83,82,22,60,24,1,23
177816,50,54,54,0,54,54,0,,,
177834,50,3647,1400,2247,2972,1184,1788,675,216,459
177940,50,105,51,54,34,13,21,71,38,33
177968,50,2384,707,1677,632,200,432,1752,507,1245
177986,50,1506,678,828,1066,565,501,440,113,327
178059,50,4911,1080,3831,719,235,484,4192,845,3347
178208,50,2572,2214,358,1515,1349,166,1057,865,192
178244,50,732,181,551,119,34,85,613,147,466
178341,50,107,35,72,28,12,16,79,23,56
178369,50,35,15,20,12,6,6,23,9,14
178387,50,176,56,120,59,22,37,117,34,83
178396,50,7705,2948,4757,4250,1723,2527,3455,1225,2230
178402,50,5305,2308,2997,3276,1532,1744,2029,776,1253
178411,50,1545,1147,398,910,701,209,635,446,189
178420,50,2842,903,1939,875,311,564,1967,592,1375
178518,50,220,131,89,163,94,69,57,37,20
178615,50,335,112,223,244,75,169,91,37,54
178624,50,2564,1053,1511,985,512,473,1579,541,1038
178721,50,1395,598,797,157,56,101,1238,542,696
178989,50,130,15,115,1,0,1,129,15,114
179043,50,922,352,570,387,107,280,535,245,290
179159,50,4729,1889,2840,4107,1684,2423,622,205,417
179265,50,544,189,355,520,173,347,24,16,8
179317,50,102,49,53,68,34,34,34,15,19
179326,50,608,216,392,259,109,150,349,107,242
179548,50,184,31,153,147,29,118,37,2,35
179557,50,1222,480,742,618,304,314,604,176,428
179566,50,4088,1498,2590,1740,641,1099,2348,857,1491
179812,50,1335,671,664,1331,670,661,4,1,3
179867,50,8939,4252,4687,7477,3600,3877,1462,652,810
179894,50,4433,1842,2591,1054,472,582,3379,1370,2009
179955,50,26,10,16,23,10,13,3,0,3
179964,50,956,375,581,103,46,57,853,329,524
180106,50,23,8,15,22,7,15,1,1,0
180179,50,386,91,295,151,39,112,235,52,183
180258,50,223,46,177,210,42,168,13,4,9
180416,50,209,135,74,71,44,27,138,91,47
180461,50,2140,898,1242,667,265,402,1473,633,840
180489,50,2883,1068,1815,1186,461,725,1697,607,1090
180522,50,42,10,32,11,1,10,31,9,22
180595,50,241,57,184,195,45,150,46,12,34
180647,50,5,2,3,3,1,2,2,1,1
180814,50,2999,1304,1695,2215,970,1245,784,334,450
180832,50,564,79,485,26,7,19,538,72,466
180878,50,124,20,104,64,19,45,60,1,59
180948,50,450,157,293,106,34,72,344,123,221
180984,50,439,96,343,318,75,243,121,21,100
181002,50,4254,1671,2583,3010,1211,1799,1244,460,784
181020,50,955,232,723,396,110,286,559,122,437
181127,50,22,12,10,12,8,4,10,4,6
181215,50,1848,559,1289,318,81,237,1530,478,1052
181297,50,372,42,330,337,37,300,35,5,30
181330,50,270,73,197,60,23,37,210,50,160
181394,50,3131,1243,1888,1031,406,625,2100,837,1263
181428,50,2814,983,1831,2175,791,1384,639,192,447
181446,50,110,23,87,23,6,17,87,17,70
181464,50,4879,2401,2478,2618,1355,1263,2261,1046,1215
181534,50,304,80,224,63,16,47,241,64,177
181604,50,376,49,327,326,39,287,50,10,40
181738,50,89,15,74,89,15,74,,,
181783,50,814,285,529,149,42,107,665,243,422
181853,50,213,64,149,17,7,10,196,57,139
182281,50,5367,2189,3178,2957,1240,1717,2410,949,1461
182290,50,4009,1574,2435,1622,648,974,2387,926,1461
182458,50,352,91,261,221,58,163,131,33,98
182634,50,50,10,40,12,7,5,38,3,35
182670,50,2205,1112,1093,2172,1094,1078,33,18,15
182795,50,498,197,301,339,134,205,159,63,96
182829,50,557,319,238,365,199,166,192,120,72
182980,50,2495,1702,793,2316,1633,683,179,69,110
183026,50,23649,7538,16111,7416,2424,4992,16233,5114,11119
183044,50,2473,974,1499,1414,542,872,1059,432,627
183062,50,136,51,85,23,6,17,113,45,68
183071,50,11,4,7,1,0,1,10,4,6
183080,50,688,194,494,377,118,259,311,76,235
183211,50,970,230,740,220,109,111,750,121,629
183239,50,23,9,14,23,9,14,,,
183257,50,279,65,214,34,9,25,245,56,189
183789,50,122,34,88,32,9,23,90,25,65
183804,50,4391,4391,0,4056,4056,0,335,335,0
183822,50,1,1,0,,,,1,1,0
183910,50,467,77,390,120,17,103,347,60,287
183974,50,423,104,319,24,1,23,399,103,296
184348,50,610,292,318,283,145,138,327,147,180
184603,50,1927,577,1350,591,204,387,1336,373,963
184612,50,412,99,313,70,16,54,342,83,259
184694,50,758,210,548,577,141,436,181,69,112
184773,50,514,108,406,138,30,108,376,78,298
184782,50,3933,1643,2290,2113,1013,1100,1820,630,1190
185129,50,1656,409,1247,334,109,225,1322,300,1022
185262,50,2186,465,1721,1024,222,802,1162,243,919
185572,50,1356,304,1052,720,171,549,636,133,503
185590,50,4651,1339,3312,1659,450,1209,2992,889,2103
185758,50,128,62,66,30,12,18,98,50,48
185828,50,2718,1852,866,1581,1061,520,1137,791,346
186122,50,333,164,169,322,156,166,11,8,3
186131,50,3157,1840,1317,3157,1840,1317,,,
186186,50,11,11,0,11,11,0,,,
186201,50,587,141,446,219,58,161,368,83,285
186283,50,982,324,658,301,103,198,681,221,460
186371,50,1713,731,982,762,325,437,951,406,545
186380,50,14652,5322,9330,8856,3554,5302,5796,1768,4028
186399,50,3834,1915,1919,1920,989,931,1914,926,988
186432,50,875,402,473,456,260,196,419,142,277
186584,50,3818,1436,2382,1738,667,1071,2080,769,1311
186618,50,446,92,354,181,26,155,265,66,199
186867,50,4223,3081,1142,2790,2048,742,1433,1033,400
186876,50,960,232,728,427,83,344,533,149,384
187046,50,967,388,579,4,0,4,963,388,575
187134,50,630,127,503,238,34,204,392,93,299
187444,50,2150,528,1622,517,141,376,1633,387,1246
187596,50,10,2,8,9,1,8,1,1,0
187648,50,1235,302,933,385,80,305,850,222,628
187745,50,61,20,41,58,18,40,3,2,1
187897,50,1101,278,823,628,148,480,473,130,343
187967,50,490,297,193,239,160,79,251,137,114
187985,50,6346,2799,3547,3200,1336,1864,3146,1463,1683
188030,50,2673,1039,1634,1342,564,778,1331,475,856
188182,50,650,183,467,152,51,101,498,132,366
188207,50,192,15,177,86,10,76,106,5,101
188304,50,1031,222,809,325,47,278,706,175,531
188340,50,6,3,3,1,0,1,5,3,2
188429,50,2269,586,1683,1294,334,960,975,252,723
188526,50,431,154,277,418,149,269,13,5,8
188535,50,597,268,329,543,249,294,54,19,35
188580,50,839,334,505,839,334,505,,,
188641,50,497,137,360,167,61,106,330,76,254
188854,50,10,3,7,10,3,7,,,
189015,50,635,75,560,267,29,238,368,46,322
189088,50,420,169,251,332,136,196,88,33,55
189413,50,46,5,41,46,5,41,,,
189501,50,1184,468,716,1079,423,656,105,45,60
189705,50,764,323,441,409,176,233,355,147,208
189848,50,29,2,27,29,2,27,,,
189857,50,95,95,0,95,95,0,,,
190044,50,1101,610,491,640,340,300,461,270,191
190080,50,44,28,16,8,7,1,36,21,15
190099,50,12,5,7,8,3,5,4,2,2
190114,50,258,70,188,221,60,161,37,10,27
190150,50,24944,11166,13778,20761,9210,11551,4183,1956,2227
190372,50,60,48,12,29,19,10,31,29,2
190415,50,10079,5144,4935,9558,4849,4709,521,295,226
190424,50,1371,595,776,1317,576,741,54,19,35
190503,50,111,41,70,110,41,69,1,0,1
190512,50,4110,1813,2297,695,309,386,3415,1504,1911
190549,50,2533,862,1671,564,194,370,1969,668,1301
190558,50,1050,277,773,226,67,159,824,210,614
190567,50,2667,1023,1644,897,379,518,1770,644,1126
190576,50,6269,2296,3973,3434,1451,1983,2835,845,1990
190594,50,5947,1347,4600,1715,380,1335,4232,967,3265
190600,50,2064,805,1259,572,159,413,1492,646,846
190637,50,2017,527,1490,215,38,177,1802,489,1313
190664,50,2889,789,2100,474,117,357,2415,672,1743
190682,50,699,239,460,472,158,314,227,81,146
190691,50,258,58,200,179,34,145,79,24,55
190716,50,1223,368,855,687,256,431,536,112,424
190725,50,861,170,691,569,129,440,292,41,251
190761,50,380,90,290,201,52,149,179,38,141
190983,50,39,9,30,19,7,12,20,2,18
191126,50,242,36,206,180,27,153,62,9,53
191205,50,28,22,6,14,12,2,14,10,4
191241,50,7082,2430,4652,3979,1596,2383,3103,834,2269
191320,50,53,22,31,30,13,17,23,9,14
191533,50,7,3,4,,,,7,3,4
191621,50,56,16,40,51,14,37,5,2,3
191630,50,24,13,11,24,13,11,,,
191649,50,4193,1506,2687,3030,1135,1895,1163,371,792
191676,50,32,16,16,14,7,7,18,9,9
191931,50,623,222,401,384,123,261,239,99,140
191968,50,421,114,307,368,91,277,53,23,30
192040,50,204,102,102,98,52,46,106,50,56
192110,50,377,199,178,354,183,171,23,16,7
192192,50,168,23,145,116,11,105,52,12,40
192271,50,239,16,223,133,10,123,106,6,100
192323,50,588,161,427,333,84,249,255,77,178
192448,50,4484,982,3502,2574,590,1984,1910,392,1518
192703,50,528,258,270,428,212,216,100,46,54
192712,50,547,253,294,547,253,294,,,
192749,50,1008,342,666,366,173,193,642,169,473
192785,50,40,3,37,22,3,19,18,0,18
192819,50,886,340,546,413,152,261,473,188,285
192925,50,521,121,400,397,85,312,124,36,88
193016,50,2267,481,1786,1159,298,861,1108,183,925
193052,50,165,165,0,161,161,0,4,4,0
193070,50,23,23,0,23,23,0,,,
193247,50,21,21,0,21,21,0,,,
193292,50,1602,288,1314,290,73,217,1312,215,1097
193308,50,811,247,564,251,87,164,560,160,400
193353,50,373,74,299,60,19,41,313,55,258
193399,50,667,112,555,345,94,251,322,18,304
193405,50,1249,520,729,1249,520,729,,,
193584,50,582,111,471,362,71,291,220,40,180
193654,50,3112,994,2118,2443,809,1634,669,185,484
193751,50,569,284,285,449,259,190,120,25,95
193821,50,1130,434,696,939,353,586,191,81,110
193830,50,1561,594,967,1314,533,781,247,61,186
193894,50,222,105,117,199,97,102,23,8,15
193900,50,29454,12484,16970,21755,9321,12434,7699,3163,4536
193973,50,923,305,618,565,204,361,358,101,257
194073,50,338,171,167,337,171,166,1,0,1
194091,50,3282,1552,1730,2809,1341,1468,473,211,262
194116,50,183,25,158,182,25,157,1,0,1
194161,50,881,362,519,373,165,208,508,197,311
194310,50,5219,1821,3398,2498,870,1628,2721,951,1770
194392,50,34,20,14,18,9,9,16,11,5
194578,50,1462,371,1091,1298,339,959,164,32,132
194657,50,211,211,0,211,211,0,,,
194666,50,55,55,0,55,55,0,,,
194763,50,205,205,0,205,205,0,,,
194824,50,1160,801,359,1140,788,352,20,13,7
194958,50,544,101,443,432,82,350,112,19,93
195003,50,2790,1733,1057,2181,1364,817,609,369,240
195030,50,5471,2456,3015,3909,1967,1942,1562,489,1073
195049,50,268,145,123,268,145,123,,,
195128,50,1069,167,902,377,71,306,692,96,596
195155,50,115,94,21,8,6,2,107,88,19
195164,50,798,294,504,219,81,138,579,213,366
195173,50,117,64,53,59,32,27,58,32,26
195216,50,32,18,14,18,10,8,14,8,6
195234,50,1509,353,1156,585,129,456,924,224,700
195243,50,178,59,119,81,25,56,97,34,63
195304,50,237,39,198,193,31,162,44,8,36
195438,50,46,46,0,46,46,0,,,
195474,50,138,82,56,84,50,34,54,32,22
195544,50,913,200,713,170,60,110,743,140,603
195580,50,79,72,7,64,58,6,15,14,1
195720,50,942,232,710,534,155,379,408,77,331
195809,50,4206,1534,2672,2711,1049,1662,1495,485,1010
196024,50,131,11,120,10,0,10,121,11,110
196042,50,64,55,9,20,18,2,44,37,7
196060,50,4421,1548,2873,2168,825,1343,2253,723,1530
196079,50,3748,1820,1928,2234,1086,1148,1514,734,780
196088,50,10865,5164,5701,7506,3665,3841,3359,1499,1860
196097,50,8609,3622,4987,5759,2857,2902,2850,765,2085
196103,50,374,156,218,192,79,113,182,77,105
196112,50,813,326,487,266,134,132,547,192,355
196121,50,1277,413,864,342,114,228,935,299,636
196130,50,1026,264,762,383,82,301,643,182,461
196149,50,674,191,483,249,67,182,425,124,301
196158,50,212,42,170,129,19,110,83,23,60
196167,50,71,17,54,38,12,26,33,5,28
196176,50,819,258,561,431,146,285,388,112,276
196185,50,538,99,439,167,41,126,371,58,313
196194,50,923,343,580,368,133,235,555,210,345
196200,50,255,71,184,147,45,102,108,26,82
196219,50,83,43,40,69,38,31,14,5,9
196228,50,407,112,295,405,111,294,2,1,1
196237,50,348,137,211,149,65,84,199,72,127
196246,50,415,129,286,250,68,182,165,61,104
196255,50,1924,659,1265,1531,556,975,393,103,290
196264,50,1536,433,1103,144,42,102,1392,391,1001
196291,50,144,119,25,68,53,15,76,66,10
196307,50,1350,504,846,1220,483,737,130,21,109
196413,50,6994,3356,3638,4114,1972,2142,2880,1384,1496
196468,50,4805,1036,3769,3209,671,2538,1596,365,1231
196592,50,6043,1783,4260,3584,1293,2291,2459,490,1969
196680,50,1906,1052,854,,,,1906,1052,854
196884,50,222,91,131,205,84,121,17,7,10
197018,50,1084,1084,0,1084,1084,0,,,
197027,50,17,13,4,,,,17,13,4
197045,50,1256,364,892,270,62,208,986,302,684
197151,50,582,145,437,522,136,386,60,9,51
197197,50,390,101,289,127,58,69,263,43,220
197601,50,27,27,0,27,27,0,,,
197647,50,32,32,0,26,26,0,6,6,0
197674,50,28,28,0,21,21,0,7,7,0
197692,50,14,14,0,14,14,0,,,
197708,50,2844,894,1950,2253,694,1559,591,200,391
197735,50,245,245,0,245,245,0,,,
197744,50,53,53,0,41,41,0,12,12,0
197869,50,2086,617,1469,920,336,584,1166,281,885
197911,50,63,25,38,35,23,12,28,2,26
197984,50,10,0,10,8,0,8,2,0,2
198066,50,10,5,5,10,5,5,,,
198109,50,119,7,112,92,5,87,27,2,25
198136,50,2297,879,1418,1925,762,1163,372,117,255
198215,50,65,34,31,64,34,30,1,0,1
198303,50,61,26,35,35,19,16,26,7,19
198419,50,10737,4884,5853,10175,4636,5539,562,248,314
198464,50,5558,1811,3747,2577,871,1706,2981,940,2041
198507,50,98,21,77,36,12,24,62,9,53
198516,50,825,301,524,751,263,488,74,38,36
198543,50,1191,387,804,471,117,354,720,270,450
198561,50,1458,446,1012,468,150,318,990,296,694
198598,50,120,28,92,50,12,38,70,16,54
198613,50,6,0,6,,,,6,0,6
198695,50,950,326,624,887,302,585,63,24,39
198756,50,44,8,36,44,8,36,,,
198808,50,1,0,1,,,,1,0,1
198835,50,826,213,613,478,115,363,348,98,250
198899,50,47,23,24,28,13,15,19,10,9
198950,50,284,32,252,128,16,112,156,16,140
198969,50,396,112,284,294,92,202,102,20,82
199032,50,160,47,113,143,43,100,17,4,13
199069,50,203,40,163,107,20,87,96,20,76
199102,50,1726,675,1051,889,362,527,837,313,524
199120,50,11796,4884,6912,7559,3090,4469,4237,1794,2443
199139,50,6332,2493,3839,2749,1210,1539,3583,1283,2300
199148,50,3860,1150,2710,1675,490,1185,2185,660,1525
199157,50,2061,531,1530,1417,380,1037,644,151,493
199184,50,181,88,93,179,87,92,2,1,1
199193,50,10326,5145,5181,5685,2817,2868,4641,2328,2313
199209,50,107,25,82,78,17,61,29,8,21
199218,50,3542,999,2543,1285,363,922,2257,636,1621
199281,50,2001,588,1413,601,131,470,1400,457,943
199306,50,378,106,272,161,27,134,217,79,138
199412,50,623,176,447,124,42,82,499,134,365
199582,50,22,9,13,9,4,5,13,5,8
199607,50,132,12,120,3,1,2,129,11,118
199643,50,143,68,75,91,48,43,52,20,32
199698,50,35,19,16,33,18,15,2,1,1
199759,50,2273,1712,561,968,760,208,1305,952,353
199847,50,3475,1472,2003,2685,1213,1472,790,259,531
199865,50,80,26,54,80,26,54,,,
199962,50,956,289,667,754,194,560,202,95,107
199971,50,14,5,9,14,5,9,,,
199999,50,500,95,405,361,66,295,139,29,110
200004,50,1732,556,1176,932,286,646,800,270,530
200013,50,22,4,18,12,4,8,10,0,10
200059,50,78,41,37,2,0,2,76,41,35
200156,50,258,92,166,118,47,71,140,45,95
200217,50,1215,369,846,698,208,490,517,161,356
200226,50,25,3,22,3,1,2,22,2,20
200253,50,260,69,191,121,35,86,139,34,105
200280,50,4054,1477,2577,1807,730,1077,2247,747,1500
200332,50,2262,1072,1190,1005,450,555,1257,622,635
200466,50,23,5,18,8,1,7,15,4,11
200484,50,118,91,27,46,35,11,72,56,16
200572,50,163,53,110,7,3,4,156,50,106
200697,50,1178,979,199,586,512,74,592,467,125
200800,50,2248,970,1278,1233,608,625,1015,362,653
201061,50,5,1,4,4,1,3,1,0,1
201104,50,1198,493,705,717,304,413,481,189,292
201140,50,116,106,10,73,73,0,43,33,10
201195,50,485,153,332,353,112,241,132,41,91
201371,50,63,21,42,54,21,33,9,0,9
201441,50,3180,1204,1976,1401,587,814,1779,617,1162
201548,50,730,296,434,514,216,298,216,80,136
201645,50,6350,2867,3483,5362,2473,2889,988,394,594
201654,50,452,196,256,242,118,124,210,78,132
201690,50,9,5,4,4,1,3,5,4,1
201885,50,11361,4236,7125,5949,2571,3378,5412,1665,3747
201964,50,189,101,88,142,77,65,47,24,23
202073,50,135,67,68,135,67,68,,,
202134,50,4827,2229,2598,2865,1466,1399,1962,763,1199
202170,50,24,8,16,23,8,15,1,0,1
202480,50,3334,1691,1643,2515,1303,1212,819,388,431
202514,50,56,33,23,14,10,4,42,23,19
202763,50,1033,353,680,613,195,418,420,158,262
202806,50,2075,718,1357,1160,392,768,915,326,589
202903,50,12,10,2,,,,12,10,2
203067,50,322,123,199,277,115,162,45,8,37
203085,50,143,56,87,70,27,43,73,29,44
203128,50,20,9,11,20,9,11,,,
203368,50,511,190,321,267,97,170,244,93,151
203465,50,12,2,10,,,,12,2,10
203517,50,5464,1819,3645,2958,1149,1809,2506,670,1836
203544,50,194,33,161,178,29,149,16,4,12
203580,50,194,84,110,92,32,60,102,52,50
203757,50,200,67,133,164,56,108,36,11,25
203775,50,288,77,211,67,26,41,221,51,170
203845,50,92,19,73,91,19,72,1,0,1
203960,50,87,11,76,24,5,19,63,6,57
203997,50,126,42,84,78,21,57,48,21,27
204024,50,2261,653,1608,949,363,586,1312,290,1022
204176,50,169,30,139,154,28,126,15,2,13
204185,50,242,105,137,170,61,109,72,44,28
204194,50,365,121,244,223,80,143,142,41,101
204200,50,589,115,474,248,80,168,341,35,306
204264,50,591,125,466,219,54,165,372,71,301
204468,50,146,54,92,,,,146,54,92
204477,50,1011,470,541,995,464,531,16,6,10
204486,50,54,18,36,37,15,22,17,3,14
204501,50,11,8,3,11,8,3,,,
204617,50,428,129,299,161,55,106,267,74,193
204635,50,690,267,423,688,267,421,2,0,2
204671,50,3,0,3,,,,3,0,3
204680,50,6,2,4,,,,6,2,4
204705,50,3,1,2,,,,3,1,2
204796,50,14571,6058,8513,10161,4109,6052,4410,1949,2461
204857,50,6398,2700,3698,3225,1391,1834,3173,1309,1864
204936,50,352,105,247,80,35,45,272,70,202
204990,50,200,100,100,115,66,49,85,34,51
205027,50,118,113,5,20,20,0,98,93,5
205124,50,21,21,0,20,20,0,1,1,0
205203,50,18,14,4,8,6,2,10,8,2
205443,50,191,58,133,87,23,64,104,35,69
205957,50,805,354,451,176,77,99,629,277,352
206048,50,730,293,437,216,86,130,514,207,307
206084,50,3818,1554,2264,2706,1116,1590,1112,438,674
206154,50,1,0,1,,,,1,0,1
206279,50,287,88,199,156,54,102,131,34,97
206288,50,399,233,166,325,196,129,74,37,37
206349,50,416,49,367,82,6,76,334,43,291
206437,50,801,158,643,314,78,236,487,80,407
206491,50,13,6,7,8,5,3,5,1,4
206507,50,4,0,4,4,0,4,,,
206516,50,107,55,52,82,41,41,25,14,11
206525,50,40,21,19,14,11,3,26,10,16
206604,50,2818,1280,1538,1142,427,715,1676,853,823
206613,50,9,3,6,,,,9,3,6
206622,50,1493,558,935,505,169,336,988,389,599
206695,50,1921,655,1266,896,302,594,1025,353,672
206835,50,120,34,86,4,3,1,116,31,85
206862,50,673,247,426,432,155,277,241,92,149
206914,50,312,81,231,118,29,89,194,52,142
206941,50,1479,460,1019,547,197,350,932,263,669
207041,50,644,198,446,231,85,146,413,113,300
207157,50,16,13,3,6,5,1,10,8,2
207209,50,146,53,93,70,23,47,76,30,46
207263,50,1502,373,1129,627,161,466,875,212,663
207306,50,201,52,149,79,22,57,122,30,92
207315,50,1303,585,718,841,359,482,462,226,236
207324,50,322,186,136,124,72,52,198,114,84
207342,50,2382,886,1496,1930,763,1167,452,123,329
207388,50,4361,2092,2269,1806,727,1079,2555,1365,1190
207403,50,80,25,55,26,5,21,54,20,34
207458,50,1122,439,683,812,328,484,310,111,199
207500,50,6890,3111,3779,3653,1618,2035,3237,1493,1744
207582,50,702,315,387,555,255,300,147,60,87
207661,50,128,51,77,85,33,52,43,18,25
207847,50,2399,911,1488,779,273,506,1620,638,982
207856,50,22,11,11,17,7,10,5,4,1
207865,50,899,273,626,513,191,322,386,82,304
207971,50,1104,578,526,794,393,401,310,185,125
208646,50,285,85,200,118,45,73,167,40,127
208822,50,1726,542,1184,626,172,454,1100,370,730
209056,50,1383,397,986,949,281,668,434,116,318
209065,50,14,9,5,11,7,4,3,2,1
209241,50,85,84,1,54,54,0,31,30,1
209287,50,259,139,120,144,75,69,115,64,51
209296,50,434,65,369,363,55,308,71,10,61
209409,50,210,61,149,122,36,86,88,25,63
209490,50,2201,791,1410,1706,635,1071,495,156,339
209506,50,134,52,82,53,24,29,81,28,53
209542,50,5629,2599,3030,3422,1665,1757,2207,934,1273
209551,50,3655,1658,1997,3406,1553,1853,249,105,144
209603,50,84,17,67,77,16,61,7,1,6
209612,50,2010,527,1483,1811,474,1337,199,53,146
209807,50,5105,1813,3292,2404,870,1534,2701,943,1758
209825,50,444,156,288,130,62,68,314,94,220
209922,50,18,11,7,,,,18,11,7
210146,50,783,237,546,163,55,108,620,182,438
210304,50,4,2,2,2,2,0,2,0,2
210331,50,196,91,105,57,32,25,139,59,80
210368,50,835,585,250,62,34,28,773,551,222
210401,50,549,270,279,521,263,258,28,7,21
210429,50,414,125,289,225,78,147,189,47,142
210438,50,1130,430,700,582,294,288,548,136,412
210492,50,15,6,9,12,6,6,3,0,3
210508,50,24,12,12,24,12,12,,,
210571,50,90,26,64,28,7,21,62,19,43
210739,50,792,260,532,407,108,299,385,152,233
210775,50,504,156,348,278,90,188,226,66,160
210809,50,573,312,261,,,,573,312,261
211024,50,229,135,94,140,80,60,89,55,34
211088,50,1232,292,940,518,137,381,714,155,559
211130,50,200,120,80,113,70,43,87,50,37
211158,50,676,181,495,316,95,221,360,86,274
211273,50,355,78,277,308,72,236,47,6,41
211291,50,33,10,23,16,4,12,17,6,11
211352,50,417,119,298,76,26,50,341,93,248
211361,50,2046,622,1424,772,212,560,1274,410,864
211431,50,738,82,656,242,31,211,496,51,445
211440,50,8125,5059,3066,7326,4556,2770,799,503,296
211468,50,387,55,332,134,17,117,253,38,215
211477,50,19,3,16,,,,19,3,16
211556,50,983,203,780,692,151,541,291,52,239
211583,50,433,98,335,216,45,171,217,53,164
211644,50,766,145,621,180,20,160,586,125,461
211893,50,42,22,20,42,22,20,,,
211981,50,419,138,281,48,11,37,371,127,244
212009,50,6,2,4,6,2,4,,,
212054,50,8803,3176,5627,4244,1682,2562,4559,1494,3065
212106,50,3215,1062,2153,2935,985,1950,280,77,203
212115,50,809,236,573,252,91,161,557,145,412
212133,50,2703,1102,1601,747,318,429,1956,784,1172
212160,50,1104,186,918,569,100,469,535,86,449
212197,50,242,56,186,116,12,104,126,44,82
212443,50,180,119,61,81,56,25,99,63,36
212601,50,1431,585,846,1037,467,570,394,118,276
212656,50,135,47,88,76,26,50,59,21,38
212771,50,274,77,197,74,23,51,200,54,146
212805,50,11,7,4,2,2,0,9,5,4
212832,50,729,146,583,673,142,531,56,4,52
212984,50,840,136,704,112,17,95,728,119,609
213011,50,902,181,721,196,30,166,706,151,555
213020,50,1965,693,1272,734,284,450,1231,409,822
213251,50,34,15,19,8,2,6,26,13,13
213303,50,73,29,44,28,15,13,45,14,31
213321,50,299,72,227,75,18,57,224,54,170
213349,50,978,273,705,301,113,188,677,160,517
213358,50,301,66,235,237,46,191,64,20,44
213367,50,1297,372,925,270,51,219,1027,321,706
213400,50,422,229,193,28,12,16,394,217,177
213446,50,86,42,44,40,18,22,46,24,22
213507,50,350,123,227,190,47,143,160,76,84
213543,50,1812,962,850,1032,585,447,780,377,403
213598,50,149,36,113,108,23,85,41,13,28
213613,50,454,136,318,277,91,186,177,45,132
213631,50,291,137,154,106,50,56,185,87,98
213783,50,13,4,9,,,,13,4,9
213826,50,857,219,638,632,141,491,225,78,147
213987,50,400,143,257,274,93,181,126,50,76
213996,50,781,223,558,284,65,219,497,158,339
214041,50,954,235,719,202,47,155,752,188,564
214069,50,466,112,354,247,55,192,219,57,162
214148,50,25,1,24,18,0,18,7,1,6
214157,50,632,165,467,230,63,167,402,102,300
214166,50,28,17,11,22,15,7,6,2,4
214175,50,21,10,11,21,10,11,,,
214272,50,474,151,323,161,67,94,313,84,229
214564,50,1186,244,942,1087,228,859,99,16,83
214883,50,87,21,66,9,1,8,78,20,58
214971,50,57,12,45,56,12,44,1,0,1
215062,50,16746,7333,9413,12924,5797,7127,3822,1536,2286
215105,50,160,46,114,128,41,87,32,5,27
215114,50,272,107,165,44,24,20,228,83,145
215123,50,3062,1137,1925,2913,1110,1803,149,27,122
215132,50,1033,314,719,832,228,604,201,86,115
215293,50,9345,3785,5560,7307,3045,4262,2038,740,1298
215424,50,240,129,111,206,112,94,34,17,17
215442,50,930,321,609,151,62,89,779,259,520
215619,50,53,19,34,47,18,29,6,1,5
215655,50,759,325,434,,,,759,325,434
215691,50,210,56,154,76,10,66,134,46,88
215743,50,482,141,341,278,79,199,204,62,142
215770,50,2268,798,1470,442,182,260,1826,616,1210
215798,50,162,63,99,84,26,58,78,37,41
215813,50,66,55,11,43,43,0,23,12,11
215929,50,1205,462,743,496,189,307,709,273,436
215947,50,359,104,255,277,87,190,82,17,65
216010,50,767,288,479,285,96,189,482,192,290
216038,50,1504,370,1134,639,188,451,865,182,683
216047,50,127,119,8,103,103,0,24,16,8
216278,50,5,0,5,2,0,2,3,0,3
216339,50,9659,3860,5799,7242,2997,4245,2417,863,1554
216348,50,20,18,2,6,5,1,14,13,1
216357,50,62,22,40,62,22,40,,,
216366,50,4516,1268,3248,2657,915,1742,1859,353,1506
216463,50,200,142,58,76,58,18,124,84,40
216542,50,75,36,39,5,2,3,70,34,36
216597,50,3838,1789,2049,1380,640,740,2458,1149,1309
216667,50,1,0,1,,,,1,0,1
216694,50,288,91,197,117,38,79,171,53,118
216764,50,3143,996,2147,1074,294,780,2069,702,1367
216807,50,62,20,42,21,9,12,41,11,30
216816,50,904,613,291,215,159,56,689,454,235
216852,50,3109,874,2235,1754,631,1123,1355,243,1112
216931,50,3044,685,2359,520,177,343,2524,508,2016
217013,50,426,101,325,18,7,11,408,94,314
217040,50,2,2,0,2,2,0,,,
217059,50,325,72,253,74,27,47,251,45,206
217156,50,3347,1674,1673,3174,1594,1580,173,80,93
217165,50,378,194,184,197,96,101,181,98,83
217235,50,465,132,333,372,92,280,93,40,53
217305,50,168,42,126,138,33,105,30,9,21
217402,50,492,199,293,204,103,101,288,96,192
217420,50,1079,229,850,258,60,198,821,169,652
217484,50,2767,1037,1730,1738,619,1119,1029,418,611
217493,50,532,182,350,532,182,350,,,
217518,50,322,134,188,225,87,138,97,47,50
217536,50,679,232,447,197,67,130,482,165,317
217606,50,40,28,12,1,1,0,39,27,12
217624,50,58,26,32,34,16,18,24,10,14
217633,50,851,388,463,721,307,414,130,81,49
217688,50,616,226,390,131,35,96,485,191,294
217721,50,13,8,5,13,8,5,,,
217749,50,450,240,210,87,42,45,363,198,165
217776,50,257,52,205,48,13,35,209,39,170
217819,50,974,220,754,319,89,230,655,131,524
217864,50,975,488,487,185,87,98,790,401,389
217873,50,87,26,61,50,15,35,37,11,26
217882,50,5688,2664,3024,3082,1685,1397,2606,979,1627
217907,50,109,38,71,52,19,33,57,19,38
217925,50,1433,682,751,264,129,135,1169,553,616
217934,50,324,41,283,290,39,251,34,2,32
217961,50,618,124,494,125,31,94,493,93,400
217998,50,125,93,32,19,12,7,106,81,25
218061,50,448,102,346,125,13,112,323,89,234
218070,50,156,32,124,92,19,73,64,13,51
218229,50,226,66,160,78,21,57,148,45,103
218238,50,160,58,102,139,49,90,21,9,12
218335,50,2906,963,1943,2649,931,1718,257,32,225
218414,50,5,1,4,5,1,4,,,
218441,50,291,153,138,243,123,120,48,30,18
218539,50,240,62,178,231,59,172,9,3,6
218645,50,768,257,511,165,62,103,603,195,408
218654,50,14,3,11,4,1,3,10,2,8
218663,50,8607,3217,5390,5941,2466,3475,2666,751,1915
218724,50,683,210,473,169,78,91,514,132,382
218733,50,300,73,227,195,49,146,105,24,81
218742,50,457,62,395,29,5,24,428,57,371
218751,50,394,199,195,394,199,195,,,
218964,50,1201,214,987,347,72,275,854,142,712
219000,50,307,80,227,75,41,34,232,39,193
219046,50,193,66,127,28,8,20,165,58,107
219082,50,468,350,118,90,70,20,378,280,98
219091,50,156,55,101,65,32,33,91,23,68
219198,50,175,67,108,153,61,92,22,6,16
219204,50,262,132,130,91,46,45,171,86,85
219240,50,703,429,274,146,76,70,557,353,204
219259,50,473,126,347,57,32,25,416,94,322
219277,50,37,13,24,,,,37,13,24
219295,50,24,4,20,7,1,6,17,3,14
219347,50,333,254,79,204,148,56,129,106,23
219356,50,1618,603,1015,532,241,291,1086,362,724
219374,50,78,16,62,39,7,32,39,9,30
219383,50,288,116,172,63,39,24,225,77,148
219471,50,2477,921,1556,1362,559,803,1115,362,753
219602,50,1191,407,784,394,140,254,797,267,530
219639,50,25,5,20,5,1,4,20,4,16
219709,50,1620,502,1118,1227,329,898,393,173,220
219718,50,565,196,369,166,47,119,399,149,250
219790,50,174,72,102,15,5,10,159,67,92
219806,50,1140,273,867,173,98,75,967,175,792
219833,50,473,249,224,304,188,116,169,61,108
219842,50,382,243,139,98,62,36,284,181,103
219949,50,283,121,162,70,32,38,213,89,124
219976,50,1826,530,1296,1572,447,1125,254,83,171
220075,50,2987,918,2069,1883,644,1239,1104,274,830
220181,50,28,9,19,23,5,18,5,4,1
220206,50,27,12,15,6,5,1,21,7,14
220215,50,523,164,359,107,54,53,416,110,306
220473,50,284,147,137,124,55,69,160,92,68
220516,50,300,74,226,264,66,198,36,8,28
220552,50,1198,383,815,1044,340,704,154,43,111
220613,50,555,230,325,161,52,109,394,178,216
220631,50,3445,1268,2177,3075,1146,1929,370,122,248
220701,50,24,9,15,13,7,6,11,2,9
220792,50,964,352,612,964,352,612,,,
220862,50,4920,1898,3022,2255,929,1326,2665,969,1696
220871,50,221,98,123,146,60,86,75,38,37
220978,50,2965,1070,1895,880,334,546,2085,736,1349
220996,50,291,140,151,209,100,109,82,40,42
221351,50,23,9,14,7,3,4,16,6,10
221519,50,85,50,35,67,42,25,18,8,10
221661,50,319,70,249,102,16,86,217,54,163
221670,50,537,178,359,537,178,359,,,
221731,50,112,26,86,71,13,58,41,13,28
221740,50,1441,577,864,743,253,490,698,324,374
221759,50,6634,2873,3761,3937,1635,2302,2697,1238,1459
221768,50,705,219,486,186,50,136,519,169,350
221838,50,1702,522,1180,724,241,483,978,281,697
221847,50,1446,584,862,324,126,198,1122,458,664
221892,50,1800,515,1285,870,237,633,930,278,652
221953,50,260,92,168,190,60,130,70,32,38
221971,50,937,276,661,526,134,392,411,142,269
221999,50,6685,2639,4046,5558,2287,3271,1127,352,775
222178,50,1774,499,1275,410,65,345,1364,434,930
222628,50,840,225,615,384,103,281,456,122,334
222831,50,1705,583,1122,945,277,668,760,306,454
222877,50,3,3,0,2,2,0,1,1,0
222983,50,16,5,11,16,5,11,,,
223001,50,185,69,116,44,18,26,141,51,90
223117,50,61,51,10,13,9,4,48,42,6
223223,50,1596,671,925,1587,664,923,9,7,2
223232,50,5435,1871,3564,3623,1367,2256,1812,504,1308
224004,50,429,135,294,119,32,87,310,103,207
224147,50,2735,994,1741,469,158,311,2266,836,1430
224226,50,1273,525,748,541,221,320,732,304,428
224305,50,2568,1551,1017,965,579,386,1603,972,631
224323,50,1038,586,452,310,196,114,728,390,338
224527,50,169,77,92,63,29,34,106,48,58
224545,50,343,94,249,80,24,56,263,70,193
224554,50,3920,1262,2658,1184,436,748,2736,826,1910
224660,50,15,6,9,,,,15,6,9
224712,50,140,38,102,58,19,39,82,19,63
224776,50,1,0,1,,,,1,0,1
225201,50,55,29,26,55,29,26,,,
225247,50,457,156,301,324,106,218,133,50,83
225399,50,1340,328,1012,204,60,144,1136,268,868
225414,50,2515,899,1616,946,349,597,1569,550,1019
225432,50,1465,574,891,102,36,66,1363,538,825
225502,50,1152,338,814,318,73,245,834,265,569
225511,50,8450,3823,4627,5720,2640,3080,2730,1183,1547
225548,50,68,48,20,5,1,4,63,47,16
225575,50,10,4,6,9,3,6,1,1,0
225627,50,2662,1104,1558,2176,867,1309,486,237,249
226091,50,7943,2043,5900,855,352,503,7088,1691,5397
226152,50,1565,571,994,409,137,272,1156,434,722
226231,50,218,50,168,48,12,36,170,38,132
226383,50,268,50,218,36,7,29,232,43,189
226471,50,508,153,355,333,96,237,175,57,118
226587,50,3,1,2,1,1,0,2,0,2
226833,50,756,260,496,300,105,195,456,155,301
227216,50,9851,4221,5630,4895,2381,2514,4956,1840,3116
227289,50,184,124,60,103,83,20,81,41,40
227331,50,1333,252,1081,1150,216,934,183,36,147
227368,50,5535,1958,3577,1892,785,1107,3643,1173,2470
227526,50,956,355,601,520,220,300,436,135,301
227757,50,4038,2580,1458,3692,2360,1332,346,220,126
227845,50,707,180,527,177,48,129,530,132,398
227863,50,1210,467,743,405,184,221,805,283,522
227881,50,3324,1053,2271,907,288,619,2417,765,1652
228042,50,86,29,57,65,23,42,21,6,15
228149,50,1339,574,765,907,392,515,432,182,250
228194,50,984,468,516,793,379,414,191,89,102
228246,50,5477,2872,2605,2638,1325,1313,2839,1547,1292
228325,50,324,153,171,56,19,37,268,134,134
228431,50,1647,475,1172,652,185,467,995,290,705
228459,50,4689,1617,3072,2695,928,1767,1994,689,1305
228468,50,17,8,9,5,1,4,12,7,5
228501,50,492,156,336,96,37,59,396,119,277
228529,50,2329,736,1593,596,181,415,1733,555,1178
228635,50,2308,1062,1246,1735,742,993,573,320,253
228644,50,2712,1040,1672,2360,927,1433,352,113,239
228653,50,2812,866,1946,1649,643,1006,1163,223,940
228705,50,1320,627,693,621,311,310,699,316,383
228723,50,15807,8274,7533,12362,6616,5746,3445,1658,1787
228769,50,12987,4389,8598,4722,2445,2277,8265,1944,6321
228778,50,11075,5482,5593,10521,5247,5274,554,235,319
228787,50,8250,4600,3650,5722,3259,2463,2528,1341,1187
228796,50,3938,1692,2246,1536,701,835,2402,991,1411
228802,50,2502,732,1770,830,279,551,1672,453,1219
228866,50,259,130,129,257,130,127,2,0,2
228875,50,1716,693,1023,1601,649,952,115,44,71
228909,50,2472,872,1600,2286,826,1460,186,46,140
228981,50,41,16,25,41,16,25,,,
229018,50,1285,527,758,400,175,225,885,352,533
229027,50,4933,2181,2752,2173,1011,1162,2760,1170,1590
229063,50,1798,661,1137,1313,487,826,485,174,311
229115,50,7410,3304,4106,4496,2259,2237,2914,1045,1869
229160,50,756,272,484,487,191,296,269,81,188
229179,50,6048,542,5506,2448,244,2204,3600,298,3302
229267,50,177,69,108,130,49,81,47,20,27
229300,50,5111,1574,3537,3100,1119,1981,2011,455,1556
229337,50,3910,1110,2800,2563,838,1725,1347,272,1075
229780,50,818,348,470,336,136,200,482,212,270
229814,50,2519,1016,1503,587,180,407,1932,836,1096
230038,50,3169,1725,1444,2025,1107,918,1144,618,526
230171,50,65,29,36,36,22,14,29,7,22
230366,50,36,10,26,36,10,26,,,
230603,50,1531,715,816,332,171,161,1199,544,655
230728,50,3171,1387,1784,1216,572,644,1955,815,1140
230737,50,720,331,389,320,127,193,400,204,196
230764,50,8638,4312,4326,6874,3372,3502,1764,940,824
230782,50,986,383,603,446,181,265,540,202,338
230807,50,369,125,244,291,97,194,78,28,50
230816,50,113,23,90,113,23,90,,,
230834,50,625,141,484,33,16,17,592,125,467
230852,50,608,299,309,35,12,23,573,287,286
230889,50,223,65,158,208,63,145,15,2,13
230913,50,251,60,191,30,9,21,221,51,170
230959,50,79,7,72,,,,79,7,72
230995,50,684,410,274,656,397,259,28,13,15
231059,50,152,39,113,43,15,28,109,24,85
231068,50,112,22,90,40,7,33,72,15,57
231147,50,655,231,424,574,206,368,81,25,56
231165,50,3,2,1,1,0,1,2,2,0
231174,50,2200,838,1362,1698,674,1024,502,164,338
231420,50,222,65,157,51,17,34,171,48,123
231554,50,230,74,156,165,56,109,65,18,47
231581,50,36,13,23,33,12,21,3,1,2
231624,50,2974,1269,1705,1741,783,958,1233,486,747
231651,50,5823,1990,3833,2093,722,1371,3730,1268,2462
231712,50,112,45,67,90,32,58,22,13,9
231970,50,1301,487,814,1128,440,688,173,47,126
232025,50,288,85,203,286,83,203,2,2,0
232043,50,384,80,304,83,25,58,301,55,246
232089,50,6,1,5,4,1,3,2,0,2
232186,50,11746,4775,6971,4774,2133,2641,6972,2642,4330
232265,50,450,121,329,370,96,274,80,25,55
232308,50,142,41,101,39,10,29,103,31,72
232423,50,2096,616,1480,1115,298,817,981,318,663
232557,50,47013,18215,28798,22999,8829,14170,24014,9386,14628
232566,50,1126,340,786,264,68,196,862,272,590
232609,50,913,317,596,465,176,289,448,141,307
232672,50,653,124,529,407,84,323,246,40,206
232681,50,296,91,205,123,24,99,173,67,106
232706,50,1334,396,938,600,159,441,734,237,497
232797,50,129,71,58,89,53,36,40,18,22
232885,50,52,3,49,45,3,42,7,0,7
232937,50,442,162,280,307,102,205,135,60,75
232982,50,4816,1898,2918,1721,592,1129,3095,1306,1789
233277,50,2485,390,2095,722,153,569,1763,237,1526
233301,50,68,16,52,64,14,50,4,2,2
233374,50,724,279,445,480,196,284,244,83,161
233541,50,1871,417,1454,919,216,703,952,201,751
233684,50,628,220,408,170,83,87,458,137,321
233718,50,2,0,2,2,0,2,,,
233842,50,181,64,117,98,39,59,83,25,58
233921,50,7519,4250,3269,5519,3066,2453,2000,1184,816
234030,50,7200,2426,4774,5014,1742,3272,2186,684,1502
234076,50,8711,4084,4627,6820,3411,3409,1891,673,1218
234137,50,341,138,203,328,132,196,13,6,7
234155,50,401,122,279,246,76,170,155,46,109
234164,50,487,272,215,342,177,165,145,95,50
234173,50,83,34,49,20,8,12,63,26,37
234207,50,381,186,195,379,186,193,2,0,2
234827,50,610,228,382,238,87,151,372,141,231
234915,50,851,312,539,92,29,63,759,283,476
235097,50,2675,820,1855,1992,597,1395,683,223,460
235167,50,267,87,180,174,58,116,93,29,64
235316,50,2395,815,1580,1811,622,1189,584,193,391
235422,50,87,21,66,34,8,26,53,13,40
235547,50,676,101,575,566,80,486,110,21,89
236133,50,305,110,195,229,77,152,76,33,43
236230,50,333,92,241,228,60,168,105,32,73
236328,50,307,66,241,249,63,186,58,3,55
236452,50,258,116,142,63,35,28,195,81,114
236577,50,803,209,594,327,81,246,476,128,348
236595,50,3027,1026,2001,1705,530,1175,1322,496,826
236896,50,182,42,140,160,31,129,22,11,11
236939,50,5565,2489,3076,3586,1532,2054,1979,957,1022
236948,50,16233,6939,9294,13103,5464,7639,3130,1475,1655
237011,50,1106,403,703,814,301,513,292,102,190
237066,50,372,125,247,152,59,93,220,66,154
237118,50,78,31,47,78,31,47,,,
237136,50,7,2,5,,,,7,2,5
237181,50,14,10,4,14,10,4,,,
237312,50,764,443,321,590,328,262,174,115,59
237330,50,362,87,275,138,33,105,224,54,170
237367,50,289,95,194,95,40,55,194,55,139
237525,50,3015,1037,1978,1897,689,1208,1118,348,770
237783,50,209,94,115,199,89,110,10,5,5
237792,50,565,125,440,145,57,88,420,68,352
237880,50,806,411,395,806,411,395,,,
237899,50,134,56,78,75,37,38,59,19,40
237905,50,7,0,7,7,0,7,,,
237932,50,204,99,105,123,70,53,81,29,52
237969,50,72,17,55,65,17,48,7,0,7
238032,50,5875,2607,3268,4264,1913,2351,1611,694,917
238078,50,101,44,57,5,2,3,96,42,54
238193,50,905,100,805,651,70,581,254,30,224
238263,50,65,16,49,18,6,12,47,10,37
238324,50,183,71,112,30,7,23,153,64,89
238430,50,488,132,356,119,37,82,369,95,274
238458,50,513,177,336,383,122,261,130,55,75
238476,50,111,46,65,49,21,28,62,25,37
238616,50,2290,574,1716,1210,337,873,1080,237,843
238661,50,661,162,499,423,107,316,238,55,183
238980,50,606,190,416,107,30,77,499,160,339
239071,50,248,144,104,28,19,9,220,125,95
239080,50,296,51,245,33,4,29,263,47,216
239105,50,3660,1431,2229,2587,1010,1577,1073,421,652
239169,50,1538,643,895,1460,623,837,78,20,58
239318,50,182,101,81,70,27,43,112,74,38
239390,50,557,44,513,449,32,417,108,12,96
239424,50,134,111,23,91,76,15,43,35,8
239637,50,111,101,10,89,89,0,22,12,10
239716,50,68,31,37,8,3,5,60,28,32
240107,50,860,235,625,538,139,399,322,96,226
240189,50,1695,747,948,555,223,332,1140,524,616
240213,50,75,10,65,34,3,31,41,7,34
240268,50,700,311,389,108,16,92,592,295,297
240277,50,523,194,329,166,49,117,357,145,212
240329,50,937,324,613,393,118,275,544,206,338
240338,50,116,32,84,3,0,3,113,32,81
240365,50,1196,351,845,295,52,243,901,299,602
240374,50,767,381,386,193,86,107,574,295,279
240392,50,1275,196,1079,985,160,825,290,36,254
240417,50,1061,324,737,238,52,186,823,272,551
240426,50,409,104,305,89,22,67,320,82,238
240444,50,12455,5801,6654,10262,4822,5440,2193,979,1214
240453,50,4418,1649,2769,2578,960,1618,1840,689,1151
240462,50,507,265,242,49,14,35,458,251,207
240471,50,406,104,302,147,41,106,259,63,196
240480,50,640,169,471,171,49,122,469,120,349
240727,50,2610,1135,1475,1610,744,866,1000,391,609
240754,50,338,115,223,127,44,83,211,71,140
241100,50,33,6,27,29,5,24,4,1,3
241128,50,16,1,15,12,1,11,4,0,4
241191,50,69,24,45,46,21,25,23,3,20
241216,50,78,44,34,49,26,23,29,18,11
241225,50,194,59,135,108,30,78,86,29,57
241304,50,235,40,195,140,26,114,95,14,81
241331,50,1713,266,1447,1461,242,1219,252,24,228
241377,50,232,46,186,110,23,87,122,23,99
241386,50,16,4,12,6,2,4,10,2,8
241395,50,376,76,300,195,36,159,181,40,141
241410,50,1702,523,1179,1098,355,743,604,168,436
241614,50,102,47,55,43,21,22,59,26,33
241739,50,1605,513,1092,1130,356,774,475,157,318
241766,50,21,14,7,14,9,5,7,5,2
241793,50,395,202,193,273,133,140,122,69,53
241836,50,42,14,28,25,9,16,17,5,12
242617,50,564,185,379,341,115,226,223,70,153
242626,50,240,81,159,215,69,146,25,12,13
242635,50,341,87,254,268,72,196,73,15,58
242644,50,115,40,75,87,28,59,28,12,16
242653,50,2039,625,1414,1486,457,1029,553,168,385
242662,50,480,136,344,275,80,195,205,56,149
242680,50,111,46,65,96,37,59,15,9,6
242699,50,126,68,58,114,60,54,12,8,4
242705,50,76,27,49,58,16,42,18,11,7
242723,50,696,261,435,335,130,205,361,131,230
242972,50,1189,300,889,453,113,340,736,187,549
243081,50,783,308,475,774,306,468,9,2,7
243197,50,880,462,418,797,416,381,83,46,37
243203,50,1828,644,1184,1747,618,1129,81,26,55
243221,50,3019,1081,1938,2270,846,1424,749,235,514
243346,50,1109,239,870,783,166,617,326,73,253
243443,50,499,159,340,78,20,58,421,139,282
243498,50,133,84,49,65,37,28,68,47,21
243568,50,365,165,200,365,165,200,,,
243577,50,565,355,210,309,193,116,256,162,94
243586,50,78,15,63,43,6,37,35,9,26
243601,50,2328,712,1616,1803,543,1260,525,169,356
243665,50,250,51,199,69,14,55,181,37,144
243744,50,10035,5667,4368,8960,4935,4025,1075,732,343
243780,50,12538,7204,5334,6854,3942,2912,5684,3262,2422
243823,50,1488,733,755,1428,703,725,60,30,30
243832,50,119,57,62,88,45,43,31,12,19
245652,50,81,50,31,56,36,20,25,14,11
245777,50,48,48,0,48,48,0,,,
245838,50,682,169,513,616,150,466,66,19,47
245847,50,201,39,162,186,37,149,15,2,13
245865,50,1035,179,856,727,136,591,308,43,265
245883,50,678,106,572,485,81,404,193,25,168
245892,50,340,74,266,273,57,216,67,17,50
245953,50,575,159,416,500,132,368,75,27,48
246345,50,59,22,37,16,7,9,43,15,28
246789,50,129,75,54,35,20,15,94,55,39
247162,50,35,16,19,2,1,1,33,15,18
247649,50,55,3,52,,,,55,3,52
247773,50,4,4,0,3,3,0,1,1,0
247825,50,6,6,0,5,5,0,1,1,0
248934,50,327,173,154,327,173,154,,,
251312,50,139,37,102,94,25,69,45,12,33
262022,50,7,0,7,,,,7,0,7
262086,50,4561,1138,3423,2226,524,1702,2335,614,1721
262129,50,27,17,10,27,17,10,,,
363907,50,110,25,85,28,4,24,82,21,61
363916,50,16,5,11,9,4,5,7,1,6
363934,50,52,39,13,8,7,1,44,32,12
366003,50,73,31,42,33,12,21,40,19,21
366252,50,5,0,5,5,0,5,,,
366368,50,86,27,59,85,27,58,1,0,1
366605,50,18,5,13,17,5,12,1,0,1
366711,50,1292,367,925,910,256,654,382,111,271
367884,50,119,22,97,78,12,66,41,10,31
367954,50,5224,1544,3680,4807,1446,3361,417,98,319
369002,50,290,101,189,121,48,73,169,53,116
369516,50,10,1,9,10,1,9,,,
369659,50,181,44,137,160,37,123,21,7,14
372073,50,6,2,4,6,2,4,,,
374024,50,233,50,183,11,2,9,222,48,174
377555,50,598,298,300,310,135,175,288,163,125
377564,50,700,271,429,445,187,258,255,84,171
378576,50,752,144,608,370,71,299,382,73,309
381352,50,73,12,61,59,11,48,14,1,13
381459,50,284,187,97,60,34,26,224,153,71
383020,50,54,14,40,47,13,34,7,1,6
384306,50,101,23,78,65,16,49,36,7,29
384412,50,213,115,98,213,115,98,,,
385415,50,1271,564,707,1232,554,678,39,10,29
385619,50,437,207,230,349,173,176,88,34,54
386472,50,4,1,3,3,1,2,1,0,1
399911,50,10,6,4,10,6,4,,,
401223,50,170,62,108,104,49,55,66,13,53
401250,50,134,25,109,83,19,64,51,6,45
404222,50,210,73,137,205,73,132,5,0,5
404338,50,8,5,3,8,5,3,,,
407629,50,4372,1976,2396,4372,1976,2396,,,
408844,50,290,72,218,117,31,86,173,41,132
409254,50,399,9,390,52,2,50,347,7,340
409616,50,525,209,316,523,208,315,2,1,1
409698,50,811,242,569,609,172,437,202,70,132
413413,50,26333,4471,21862,5457,1074,4383,20876,3397,17479
414595,50,400,78,322,281,59,222,119,19,100
414878,50,984,725,259,152,99,53,832,626,206
414966,50,167,82,85,29,16,13,138,66,72
416801,50,27,5,22,17,2,15,10,3,7
418126,50,105,33,72,59,19,40,46,14,32
420042,50,7,4,3,7,4,3,,,
420246,50,599,77,522,510,60,450,89,17,72
420705,50,134,89,45,63,42,21,71,47,24
422695,50,17,1,16,17,1,16,,,
423643,50,3890,1585,2305,3809,1558,2251,81,27,54
426314,50,3326,2449,877,1727,1247,480,1599,1202,397
428259,50,79,34,45,56,27,29,23,7,16
429085,50,102,27,75,44,13,31,58,14,44
429094,50,143,23,120,107,16,91,36,7,29
430184,50,267,75,192,56,19,37,211,56,155
430670,50,306,130,176,306,130,176,,,
430704,50,71,24,47,68,24,44,3,0,3
432348,50,158,89,69,158,89,69,,,
433004,50,135,45,90,135,45,90,,,
433387,50,42164,12309,29855,42164,12309,29855,,,
433420,50,6,3,3,6,3,3,,,
433536,50,19,3,16,17,3,14,2,0,2
433660,50,1681,491,1190,687,178,509,994,313,681
434441,50,76,14,62,76,14,62,,,
435000,50,993,372,621,892,345,547,101,27,74
436261,50,37,6,31,37,6,31,,,
436614,50,25,20,5,4,2,2,21,18,3
437097,50,921,592,329,913,587,326,8,5,3
437316,50,16,0,16,,,,16,0,16
437325,50,6,3,3,,,,6,3,3
438498,50,157,78,79,77,42,35,80,36,44
438586,50,101,35,66,30,11,19,71,24,47
439020,50,45,12,33,30,5,25,15,7,8
439394,50,71,12,59,71,12,59,,,
439446,50,124,18,106,124,18,106,,,
439701,50,351,161,190,122,53,69,229,108,121
439783,50,118,36,82,60,17,43,58,19,39
439817,50,219,106,113,78,42,36,141,64,77
439914,50,30,8,22,30,8,22,,,
439969,50,85,16,69,85,16,69,,,
440004,50,41,12,29,41,12,29,,,
440031,50,573,202,371,553,196,357,20,6,14
440396,50,43,30,13,27,19,8,16,11,5
440794,50,103,31,72,99,30,69,4,1,3
440828,50,204,46,158,136,34,102,68,12,56
441104,50,315,58,257,166,29,137,149,29,120
441131,50,279,64,215,186,42,144,93,22,71
441238,50,95,36,59,95,36,59,,,
441636,50,20,3,17,20,3,17,,,
441690,50,26,11,15,12,4,8,14,7,7
441900,50,69,5,64,32,2,30,37,3,34
441937,50,495,188,307,213,59,154,282,129,153
442064,50,97,15,82,88,13,75,9,2,7
442295,50,299,135,164,286,132,154,13,3,10
442356,50,146,22,124,1,1,0,145,21,124
442426,50,24,5,19,9,1,8,15,4,11
442569,50,947,469,478,630,300,330,317,169,148
442639,50,370,230,140,370,230,140,,,
442806,50,2276,1005,1271,2276,1005,1271,,,
442842,50,168,27,141,73,10,63,95,17,78
442930,50,28,11,17,23,9,14,5,2,3
443030,50,74,22,52,74,22,52,,,
443049,50,151,87,64,84,51,33,67,36,31
443058,50,141,66,75,45,18,27,96,48,48
443076,50,144,71,73,87,41,46,57,30,27
443128,50,137,67,70,116,57,59,21,10,11
443340,50,12,6,6,11,5,6,1,1,0
443410,50,59,45,14,45,31,14,14,14,0
443562,50,187,53,134,143,40,103,44,13,31
443599,50,321,25,296,73,6,67,248,19,229
443702,50,73,48,25,58,37,21,15,11,4
443766,50,340,58,282,57,14,43,283,44,239
443784,50,173,53,120,47,13,34,126,40,86
444103,50,39,34,5,9,9,0,30,25,5
444130,50,12490,3058,9432,4997,1371,3626,7493,1687,5806
444413,50,15,15,0,15,15,0,,,
444699,50,59,6,53,56,5,51,3,1,2
444778,50,78,23,55,31,7,24,47,16,31
444787,50,2,0,2,,,,2,0,2
445027,50,2213,1098,1115,1834,995,839,379,103,276
445054,50,42,35,7,42,35,7,,,
445133,50,46,16,30,15,5,10,31,11,20
445188,50,772,431,341,769,428,341,3,3,0
445267,50,356,83,273,79,23,56,277,60,217
445735,50,993,442,551,993,442,551,,,
445869,50,397,140,257,253,92,161,144,48,96
446002,50,36,8,28,17,3,14,19,5,14
446039,50,30,8,22,30,8,22,,,
446048,50,43,30,13,34,23,11,9,7,2
446224,50,56,10,46,55,10,45,1,0,1
446394,50,15,7,8,1,0,1,14,7,7
446561,50,191,42,149,191,42,149,,,
446640,50,2569,1318,1251,2433,1242,1191,136,76,60
447050,50,2372,441,1931,1845,343,1502,527,98,429
447263,50,177,36,141,173,36,137,4,0,4
447698,50,135,28,107,105,22,83,30,6,24
447801,50,99,29,70,61,21,40,38,8,30
447953,50,212,144,68,163,116,47,49,28,21
448673,50,76,7,69,49,4,45,27,3,24
448691,50,184,44,140,10,2,8,174,42,132
449038,50,245,70,175,53,18,35,192,52,140
449135,50,7,2,5,3,1,2,4,1,3
449339,50,9329,5701,3628,657,401,256,8672,5300,3372
449348,50,38,19,19,3,2,1,35,17,18
449481,50,40,9,31,40,9,31,,,
449764,50,17,11,6,15,10,5,2,1,1
449834,50,34,32,2,11,11,0,23,21,2
449870,50,103,48,55,87,42,45,16,6,10
449889,50,8693,2141,6552,8693,2141,6552,,,
449898,50,318,61,257,227,42,185,91,19,72
449922,50,172,74,98,172,74,98,,,
450298,50,33,12,21,9,3,6,24,9,15
450304,50,131,55,76,88,40,48,43,15,28
450377,50,157,28,129,21,6,15,136,22,114
450571,50,42,7,35,27,3,24,15,4,11
450933,50,4740,2553,2187,4740,2553,2187,,,
451079,50,83,13,70,83,13,70,,,
451103,50,442,168,274,251,94,157,191,74,117
451510,50,607,243,364,557,222,335,50,21,29
453163,50,514,95,419,64,13,51,450,82,368
453215,50,58,8,50,15,6,9,43,2,41
454227,50,14420,1323,13097,604,67,537,13816,1256,12560
454582,50,46,13,33,31,8,23,15,5,10
454689,50,552,252,300,270,115,155,282,137,145
454829,50,3604,599,3005,1027,192,835,2577,407,2170
454838,50,28,8,20,28,8,20,,,
454856,50,26,1,25,26,1,25,,,
455099,50,95,60,35,25,14,11,70,46,24
455178,50,108,23,85,105,22,83,3,1,2
455406,50,593,256,337,590,255,335,3,1,2
455433,50,506,107,399,412,85,327,94,22,72
455664,50,3037,533,2504,528,91,437,2509,442,2067
455804,50,132,83,49,72,38,34,60,45,15
455813,50,66,41,25,45,26,19,21,15,6
455992,50,348,111,237,346,110,236,2,1,1
456481,50,66,27,39,38,15,23,28,12,16
456490,50,21,15,6,14,10,4,7,5,2
456542,50,689,285,404,593,262,331,96,23,73
456621,50,16,1,15,2,0,2,14,1,13
457086,50,2,0,2,2,0,2,,,
457226,50,6,5,1,,,,6,5,1
457271,50,68,23,45,25,8,17,43,15,28
457299,50,5,1,4,5,1,4,,,
457402,50,8,4,4,,,,8,4,4
457484,50,24,14,10,6,3,3,18,11,7
457688,50,6,2,4,6,2,4,,,
457697,50,47,28,19,6,5,1,41,23,18
458210,50,1331,235,1096,1072,201,871,259,34,225
458885,50,47,7,40,3,0,3,44,7,37
458919,50,642,125,517,138,39,99,504,86,418
458955,50,36,5,31,2,1,1,34,4,30
458964,50,243,43,200,42,11,31,201,32,169
458973,50,235,57,178,52,17,35,183,40,143
459259,50,120,24,96,93,17,76,27,7,20
459268,50,60,10,50,47,9,38,13,1,12
459727,50,1804,442,1362,869,205,664,935,237,698
459736,50,1248,495,753,1102,449,653,146,46,100
459745,50,699,106,593,420,54,366,279,52,227
459824,50,1641,686,955,1288,598,690,353,88,265
459842,50,8,2,6,7,2,5,1,0,1
459851,50,3,1,2,2,1,1,1,0,1
459949,50,489,143,346,95,20,75,394,123,271
459994,50,3008,1380,1628,546,280,266,2462,1100,1362
460349,50,778,223,555,221,71,150,557,152,405
460376,50,9,4,5,6,2,4,3,2,1
460738,50,1560,171,1389,1016,104,912,544,67,477
461023,50,75,13,62,73,12,61,2,1,1
461032,50,30,17,13,15,7,8,15,10,5
461120,50,70,37,33,66,35,31,4,2,2
461139,50,72,16,56,72,16,56,,,
461148,50,294,150,144,294,150,144,,,
461281,50,12,2,10,9,2,7,3,0,3
461485,50,142,120,22,46,38,8,96,82,14
461528,50,51,39,12,8,6,2,43,33,10
461643,50,12,2,10,12,2,10,,,
461795,50,425,215,210,227,120,107,198,95,103
461883,50,86,39,47,83,37,46,3,2,1
462044,50,95,24,71,41,13,28,54,11,43
464226,50,79,45,34,68,38,30,11,7,4
474863,50,271,64,207,195,49,146,76,15,61
475033,50,3031,751,2280,,,,3031,751,2280
475121,50,1973,410,1563,931,197,734,1042,213,829
475228,50,70,28,42,70,28,42,,,
475273,50,174,46,128,47,11,36,127,35,92
475398,50,91,50,41,7,3,4,84,47,37
475495,50,1265,390,875,1264,390,874,1,0,1
475608,50,44,28,16,22,17,5,22,11,11
476975,50,3947,1516,2431,287,106,181,3660,1410,2250
477039,50,307,53,254,242,40,202,65,13,52
480073,50,24,6,18,20,5,15,4,1,3
480198,50,131,49,82,111,41,70,20,8,12
480569,50,523,273,250,14,6,8,509,267,242
480657,50,16,2,14,11,1,10,5,1,4
480781,50,111,67,44,110,66,44,1,1,0
480790,50,1456,739,717,1456,739,717,,,
480985,50,6,0,6,4,0,4,2,0,2
481030,50,27,15,12,14,8,6,13,7,6
481058,50,247,142,105,137,66,71,110,76,34
481094,50,197,18,179,195,18,177,2,0,2
481401,50,457,304,153,62,49,13,395,255,140
481535,50,31,17,14,31,17,14,,,
481720,50,5,0,5,2,0,2,3,0,3
482149,50,3474,1160,2314,2767,980,1787,707,180,527
482158,50,386,188,198,195,98,97,191,90,101
482228,50,45,33,12,7,4,3,38,29,9
482413,50,249,119,130,68,38,30,181,81,100
482422,50,25,9,16,,,,25,9,16
482431,50,200,111,89,25,12,13,175,99,76
482440,50,1,0,1,,,,1,0,1
482459,50,46,25,21,7,4,3,39,21,18
482468,50,66,22,44,13,6,7,53,16,37
482477,50,3128,1194,1934,354,147,207,2774,1047,1727
482538,50,4,3,1,1,1,0,3,2,1
482547,50,1,0,1,,,,1,0,1
482556,50,11,5,6,2,2,0,9,3,6
482565,50,8,4,4,,,,8,4,4
482574,50,17,9,8,2,1,1,15,8,7
482608,50,82,31,51,17,3,14,65,28,37
482617,50,3,2,1,1,0,1,2,2,0
482635,50,55,22,33,7,5,2,48,17,31
482653,50,51,25,26,5,4,1,46,21,25
482680,50,829,230,599,207,55,152,622,175,447
482705,50,6123,2627,3496,140,40,100,5983,2587,3396
482936,50,84,70,14,59,52,7,25,18,7
483036,50,445,167,278,176,65,111,269,102,167
483124,50,15139,5276,9863,3812,1112,2700,11327,4164,7163
483595,50,2189,599,1590,1651,446,1205,538,153,385
483780,50,270,175,95,253,167,86,17,8,9
483975,50,731,358,373,724,354,370,7,4,3
484613,50,18765,4660,14105,18765,4660,14105,,,
484631,50,433,180,253,433,180,253,,,
484710,50,4,3,1,4,3,1,,,
484756,50,8,6,2,8,6,2,,,
484844,50,32,17,15,,,,32,17,15
484862,50,250,112,138,115,56,59,135,56,79
484905,50,752,253,499,425,166,259,327,87,240
485403,50,102,21,81,53,10,43,49,11,38
485546,50,313,179,134,201,117,84,112,62,50
485768,50,483,174,309,481,174,307,2,0,2
486053,50,82,75,7,66,61,5,16,14,2
486080,50,12,8,4,12,8,4,,,
486239,50,87,31,56,70,26,44,17,5,12
486284,50,44,23,21,10,5,5,34,18,16
486354,50,2,1,1,2,1,1,,,
486433,50,152,37,115,136,34,102,16,3,13
486460,50,24,5,19,24,5,19,,,
486840,50,4008,1606,2402,1369,527,842,2639,1079,1560
486901,50,373,140,233,239,79,160,134,61,73
487010,50,2971,1141,1830,2771,1089,1682,200,52,148
487153,50,45,11,34,45,11,34,,,
487524,50,723,219,504,302,105,197,421,114,307
487603,50,187,58,129,82,18,64,105,40,65
487649,50,215,65,150,210,62,148,5,3,2
487995,50,94,27,67,53,15,38,41,12,29
488031,50,145,77,68,145,77,68,,,
488068,50,30,3,27,4,0,4,26,3,23
488387,50,325,68,257,105,26,79,220,42,178
488448,50,38,26,12,38,26,12,,,
488527,50,718,349,369,717,348,369,1,1,0
488554,50,636,290,346,636,290,346,,,
488572,50,282,137,145,282,137,145,,,
488679,50,4307,1317,2990,4165,1279,2886,142,38,104
488776,50,81,25,56,50,14,36,31,11,20
488785,50,22,17,5,14,11,3,8,6,2
488800,50,249,66,183,226,63,163,23,3,20
488846,50,10451,5936,4515,2334,1380,954,8117,4556,3561
488907,50,40,4,36,29,3,26,11,1,10
489335,50,36,21,15,3,1,2,33,20,13
489779,50,10981,2940,8041,5706,1850,3856,5275,1090,4185
489858,50,617,204,413,612,201,411,5,3,2
489937,50,511,352,159,39,26,13,472,326,146
490045,50,152,79,73,87,54,33,65,25,40
490063,50,264,137,127,264,137,127,,,
490081,50,107,55,52,100,54,46,7,1,6
490106,50,374,147,227,105,33,72,269,114,155
490133,50,2823,1473,1350,2729,1426,1303,94,47,47
490230,50,22,12,10,21,12,9,1,0,1
490373,50,348,175,173,348,175,173,,,
490601,50,645,336,309,645,336,309,,,
490753,50,26,6,20,26,6,20,,,
490805,50,750,259,491,228,127,101,522,132,390
491190,50,124,22,102,89,18,71,35,4,31
491808,50,167,32,135,100,21,79,67,11,56
492209,50,49,7,42,43,7,36,6,0,6
492607,50,114,26,88,30,5,25,84,21,63
492689,50,518,243,275,514,242,272,4,1,3
492704,50,169,29,140,165,26,139,4,3,1
493512,50,3,2,1,3,2,1,,,
493673,50,123,45,78,57,19,38,66,26,40
493895,50,601,548,53,519,472,47,82,76,6
493947,50,622,387,235,622,387,235,,,
494010,50,72,17,55,72,17,55,,,
494551,50,27,4,23,4,1,3,23,3,20
494597,50,39,25,14,17,9,8,22,16,6
494603,50,1813,1328,485,468,328,140,1345,1000,345
494807,50,618,113,505,612,111,501,6,2,4
494940,50,23,12,11,19,12,7,4,0,4
495192,50,257,57,200,244,51,193,13,6,7
495314,50,405,213,192,405,213,192,,,
495767,50,15438,7987,7451,8397,4309,4088,7041,3678,3363
496043,50,474,247,227,474,247,227,,,
496326,50,3,2,1,3,2,1,,,
496469,50,142,14,128,81,5,76,61,9,52
496627,50,755,340,415,542,222,320,213,118,95
