UNITID,EFLEVEL,EFTOTAL,EFMEN,EFWOM,EFFT,EFFTMEN,EFFTWOM,EFPT,EFPTMEN,EFPTWOM
100654,10,6007,2369,3638,5262,2074,3188,745,295,450
100663,10,21639,7903,13736,15080,5686,9394,6559,2217,4342
100690,10,647,278,369,260,115,145,387,163,224
100706,10,9237,5333,3904,6587,3936,2651,2650,1397,1253
100724,10,3828,1347,2481,3425,1209,2216,403,138,265
100751,10,38644,16506,22138,32593,14326,18267,6051,2180,3871
100760,10,1777,751,1026,514,224,290,1263,527,736
100812,10,2894,887,2007,1152,322,830,1742,565,1177
100830,10,5109,1900,3209,3260,1255,2005,1849,645,1204
100858,10,31764,15678,16086,26479,12829,13650,5285,2849,2436
100937,10,975,512,463,969,511,458,6,1,5
101028,10,1641,560,1081,519,205,314,1122,355,767
101116,10,361,49,312,242,36,206,119,13,106
101143,10,2010,1011,999,945,517,428,1065,494,571
101161,10,6800,2872,3928,2708,1052,1656,4092,1820,2272
101189,10,2817,1153,1664,2068,854,1214,749,299,450
101240,10,4352,1664,2688,2003,820,1183,2349,844,1505
101277,10,45,0,45,45,0,45,,,
101286,10,3832,1195,2637,1259,403,856,2573,792,1781
101295,10,5965,2172,3793,2333,887,1446,3632,1285,2347
101301,10,1860,778,1082,516,237,279,1344,541,803
101365,10,578,126,452,240,55,185,338,71,267
101435,10,817,454,363,797,447,350,20,7,13
101453,10,143,124,19,44,38,6,99,86,13
101462,10,976,388,588,223,103,120,753,285,468
101471,10,768,671,97,626,543,83,142,128,14
101480,10,9632,3839,5793,6950,2813,4137,2682,1026,1656
101505,10,8431,3090,5341,2011,812,1199,6420,2278,4142
101514,10,8163,3698,4465,2698,1313,1385,5465,2385,3080
101569,10,2919,987,1932,1110,450,660,1809,537,1272
101587,10,5860,1442,4418,4986,1158,3828,874,284,590
101602,10,1929,878,1051,759,290,469,1170,588,582
101648,10,320,232,88,320,232,88,,,
101675,10,1258,570,688,1201,544,657,57,26,31
101693,10,1804,698,1106,1145,416,729,659,282,377
101709,10,2586,886,1700,2123,757,1366,463,129,334
101736,10,4032,1853,2179,905,401,504,3127,1452,1675
101879,10,9830,3490,6340,5452,1924,3528,4378,1566,2812
101897,10,2590,902,1688,921,349,572,1669,553,1116
101912,10,1470,632,838,1330,564,766,140,68,72
101994,10,434,196,238,185,99,86,249,97,152
102030,10,2968,1040,1928,978,427,551,1990,613,1377
102049,10,5682,1824,3858,5451,1752,3699,231,72,159
102058,10,50,23,27,23,13,10,27,10,17
102067,10,4166,1698,2468,1735,851,884,2431,847,1584
102076,10,2507,928,1579,1012,373,639,1495,555,940
102094,10,13438,4284,9154,11048,3532,7516,2390,752,1638
102234,10,1046,467,579,920,403,517,126,64,62
102270,10,744,328,416,608,267,341,136,61,75
102298,10,903,453,450,851,428,423,52,25,27
102313,10,1984,771,1213,814,360,454,1170,411,759
102368,10,14156,5098,9058,8220,2819,5401,5936,2279,3657
102377,10,2570,912,1658,2412,849,1563,158,63,95
102395,10,240,175,65,59,41,18,181,134,47
102429,10,3703,1495,2208,1054,446,608,2649,1049,1600
102553,10,10464,4139,6325,4042,1732,2310,6422,2407,4015
102580,10,39,23,16,21,14,7,18,9,9
102614,10,6607,2531,4076,2663,1221,1442,3944,1310,2634
102632,10,1923,669,1254,531,211,320,1392,458,934
102669,10,595,132,463,439,75,364,156,57,99
102711,10,202,140,62,133,95,38,69,45,24
102845,10,2117,577,1540,2117,577,1540,,,
103501,10,268,36,232,268,36,232,,,
103741,10,184,10,174,124,9,115,60,1,59
103893,10,1048,208,840,1048,208,840,,,
103909,10,532,69,463,532,69,463,,,
103927,10,446,83,363,446,83,363,,,
103954,10,34,2,32,34,2,32,,,
103963,10,411,352,59,411,352,59,,,
104090,10,888,102,786,888,102,786,,,
104151,10,80065,41414,38651,71337,36735,34602,8728,4679,4049
104160,10,8050,3257,4793,1989,870,1119,6061,2387,3674
104179,10,49403,21985,27418,36323,15669,20654,13080,6316,6764
104346,10,4652,1781,2871,1089,469,620,3563,1312,2251
104391,10,85,2,83,85,2,83,,,
104425,10,3797,1699,2098,1392,576,816,2405,1123,1282
104443,10,60,5,55,46,4,42,14,1,13
104568,10,383,3,380,187,3,184,196,0,196
104577,10,4864,1989,2875,1351,627,724,3513,1362,2151
104586,10,3162,2295,867,3009,2170,839,153,125,28
104665,10,6,5,1,6,5,1,,,
104708,10,13342,5915,7427,3647,1842,1805,9695,4073,5622
104717,10,101816,27888,73928,23951,9589,14362,77865,18299,59566
105145,10,4699,1663,3036,1004,390,614,3695,1273,2422
105154,10,15772,7109,8663,4109,2027,2082,11663,5082,6581
105206,10,4038,1285,2753,746,288,458,3292,997,2295
105215,10,658,612,46,658,612,46,,,
105297,10,1552,391,1161,710,189,521,842,202,640
105330,10,28086,10274,17812,22735,8513,14222,5351,1761,3590
105349,10,2740,991,1749,503,231,272,2237,760,1477
105428,10,9649,3519,6130,2217,870,1347,7432,2649,4783
105525,10,15293,6575,8718,3467,1643,1824,11826,4932,6894
105534,10,2589,505,2084,2589,505,2084,,,
105543,10,690,111,579,690,111,579,,,
105589,10,969,244,725,479,134,345,490,110,380
105659,10,1006,916,90,1006,916,90,,,
105668,10,17078,6879,10199,2005,746,1259,15073,6133,8940
105677,10,27,26,1,27,26,1,,,
105747,10,7065,3115,3950,1479,722,757,5586,2393,3193
105792,10,3706,1539,2167,834,380,454,2872,1159,1713
105899,10,1082,654,428,933,580,353,149,74,75
106041,10,1972,1864,108,1972,1864,108,,,
106148,10,6997,2967,4030,1353,717,636,5644,2250,3394
106245,10,8197,3175,5022,4101,1727,2374,4096,1448,2648
106263,10,3240,921,2319,2336,741,1595,904,180,724
106306,10,497,381,116,448,343,105,49,38,11
106315,10,98,2,96,98,2,96,,,
106324,10,29,1,28,18,1,17,11,0,11
106342,10,496,295,201,483,289,194,13,6,7
106351,10,60,29,31,60,29,31,,,
106360,10,16,1,15,16,1,15,,,
106397,10,30936,13701,17235,25214,11193,14021,5722,2508,3214
106412,10,2387,1050,1337,1968,874,1094,419,176,243
106449,10,2928,1188,1740,1308,531,777,1620,657,963
106458,10,13190,4593,8597,5687,2304,3383,7503,2289,5214
106467,10,9445,3985,5460,5209,2323,2886,4236,1662,2574
106485,10,2719,1085,1634,1690,741,949,1029,344,685
106494,10,37,0,37,37,0,37,,,
106546,10,549,54,495,480,47,433,69,7,62
106625,10,1566,586,980,702,262,440,864,324,540
106704,10,9913,3530,6383,7385,2749,4636,2528,781,1747
106713,10,564,312,252,461,270,191,103,42,61
106795,10,1278,462,816,504,181,323,774,281,493
106810,10,201,103,98,171,91,80,30,12,18
106883,10,1179,392,787,341,106,235,838,286,552
106908,10,358,17,341,347,17,330,11,0,11
106980,10,2340,961,1379,1192,518,674,1148,443,705
106999,10,1008,343,665,459,144,315,549,199,350
107044,10,4805,2015,2790,3568,1496,2072,1237,519,718
107071,10,2519,1009,1510,1730,777,953,789,232,557
107080,10,1144,568,576,1130,556,574,14,12,2
107099,10,90,5,85,90,5,85,,,
107123,10,69,17,52,69,17,52,,,
107141,10,2326,892,1434,1382,551,831,944,341,603
107220,10,230,5,225,230,5,225,,,
107293,10,67,0,67,67,0,67,,,
107318,10,979,389,590,165,42,123,814,347,467
107327,10,1502,536,966,447,170,277,1055,366,689
107442,10,28,15,13,28,15,13,,,
107460,10,1856,836,1020,754,331,423,1102,505,597
107488,10,201,146,55,199,144,55,2,2,0
107512,10,1784,731,1053,1608,665,943,176,66,110
107521,10,1832,893,939,324,94,230,1508,799,709
107549,10,983,322,661,460,143,317,523,179,344
107558,10,784,374,410,770,368,402,14,6,8
107585,10,1888,759,1129,986,407,579,902,352,550
107600,10,769,318,451,675,285,390,94,33,61
107619,10,1234,451,783,441,149,292,793,302,491
107637,10,898,248,650,192,58,134,706,190,516
107655,10,27,0,27,27,0,27,,,
107664,10,4245,1431,2814,2176,802,1374,2069,629,1440
107725,10,1188,406,782,406,147,259,782,259,523
107743,10,679,254,425,345,129,216,334,125,209
107789,10,109,1,108,109,1,108,,,
107831,10,84,1,83,84,1,83,,,
107840,10,321,126,195,292,113,179,29,13,16
107877,10,584,272,312,549,257,292,35,15,20
107974,10,1162,370,792,486,165,321,676,205,471
107983,10,5094,2296,2798,3355,1607,1748,1739,689,1050
107992,10,943,409,534,474,221,253,469,188,281
108065,10,14,0,14,7,0,7,7,0,7
108092,10,5379,2166,3213,3386,1303,2083,1993,863,1130
108232,10,6786,2695,4091,3260,1435,1825,3526,1260,2266
108269,10,111,33,78,80,30,50,31,3,28
108667,10,5673,2409,3264,635,355,280,5038,2054,2984
108807,10,10329,4802,5527,3032,1483,1549,7297,3319,3978
108852,10,220,93,127,220,93,127,,,
108861,10,88,49,39,18,9,9,70,40,30
108870,10,423,189,234,422,188,234,1,1,0
108977,10,234,55,179,115,28,87,119,27,92
109040,10,1969,447,1522,1969,447,1522,,,
109208,10,27422,14210,13212,4334,2005,2329,23088,12205,10883
109350,10,11840,5184,6656,3491,1654,1837,8349,3530,4819
109651,10,2420,1033,1387,2112,891,1221,308,142,166
109721,10,202,49,153,202,49,153,,,
109730,10,94,50,44,94,50,44,,,
109785,10,7169,2036,5133,4837,1435,3402,2332,601,1731
109819,10,26873,11728,15145,7244,3039,4205,19629,8689,10940
109907,10,2884,977,1907,1119,353,766,1765,624,1141
109934,10,398,39,359,398,39,359,,,
110060,10,264,188,76,215,160,55,49,28,21
110097,10,5387,2405,2982,3916,1626,2290,1471,779,692
110194,10,264,264,0,264,264,0,,,
110219,10,1767,365,1402,1767,365,1402,,,
110246,10,9362,4172,5190,4091,1904,2187,5271,2268,3003
110316,10,2145,407,1738,1145,267,878,1000,140,860
110334,10,9149,4001,5148,1786,829,957,7363,3172,4191
110361,10,11495,3915,7580,9354,3216,6138,2141,699,1442
110370,10,1501,532,969,1420,494,926,81,38,43
110398,10,1193,472,721,1160,458,702,33,14,19
110404,10,2401,1464,937,2401,1464,937,,,
110413,10,3615,1545,2070,3363,1455,1908,252,90,162
110422,10,22000,11266,10734,20702,10473,10229,1298,793,505
110468,10,3599,833,2766,1687,338,1349,1912,495,1417
110486,10,9613,3162,6451,7613,2483,5130,2000,679,1321
110495,10,10154,3293,6861,7759,2435,5324,2395,858,1537
110510,10,19803,7420,12383,15152,5583,9569,4651,1837,2814
110529,10,27503,14779,12724,22533,12040,10493,4970,2739,2231
110538,10,14183,6337,7846,12306,5520,6786,1877,817,1060
110547,10,16426,6186,10240,11785,4454,7331,4641,1732,2909
110556,10,23999,9584,14415,19412,7597,11815,4587,1987,2600
110565,10,40386,16775,23611,30089,12346,17743,10297,4429,5868
110574,10,13673,5481,8192,10116,4066,6050,3557,1415,2142
110583,10,38973,16087,22886,31371,12704,18667,7602,3383,4219
110592,10,26460,10904,15556,21038,8534,12504,5422,2370,3052
110608,10,37579,16582,20997,28897,12654,16243,8682,3928,4754
110617,10,31818,13586,18232,24253,10100,14153,7565,3486,4079
110635,10,45307,20985,24322,41022,18628,22394,4285,2357,1928
110644,10,39679,16261,23418,38072,15521,22551,1607,740,867
110653,10,35937,16257,19680,34733,15653,19080,1204,604,600
110662,10,46430,19869,26561,44390,18679,25711,2040,1190,850
110671,10,26809,13193,13616,25556,12494,13062,1253,699,554
110680,10,42006,20883,21123,40252,19853,20399,1754,1030,724
110699,10,3140,1119,2021,3140,1119,2021,,,
110705,10,26420,11905,14515,25514,11434,14080,906,471,435
110714,10,19478,9821,9657,18646,9335,9311,832,486,346
110778,10,948,319,629,25,2,23,923,317,606
110875,10,55,1,54,55,1,54,,,
110918,10,13,7,6,3,1,2,10,6,4
111045,10,80,29,51,71,27,44,9,2,7
111054,10,144,28,116,144,28,116,,,
111081,10,1440,545,895,1402,525,877,38,20,18
111188,10,849,673,176,779,623,156,70,50,20
111391,10,623,241,382,531,204,327,92,37,55
111434,10,5388,2229,3159,747,381,366,4641,1848,2793
111461,10,18075,10118,7957,4802,2415,2387,13273,7703,5570
111513,10,205,3,202,162,1,161,43,2,41
111638,10,415,154,261,415,154,261,,,
111708,10,196,167,29,196,167,29,,,
111717,10,183,146,37,181,146,35,2,0,2
111726,10,148,114,34,148,114,34,,,
111744,10,96,92,4,96,92,4,,,
111762,10,103,58,45,103,58,45,,,
111799,10,157,26,131,157,26,131,,,
111887,10,19469,9181,10288,7838,3627,4211,11631,5554,6077
111896,10,4919,2097,2822,736,351,385,4183,1746,2437
111920,10,10736,5375,5361,2809,1370,1439,7927,4005,3922
111939,10,19238,7552,11686,5647,2401,3246,13591,5151,8440
111948,10,10014,3948,6066,9023,3520,5503,991,428,563
111966,10,777,221,556,669,189,480,108,32,76
112075,10,3744,1377,2367,3024,1041,1983,720,336,384
112084,10,355,165,190,267,137,130,88,28,60
112127,10,64,26,38,19,10,9,45,16,29
112172,10,9975,4413,5562,3913,1777,2136,6062,2636,3426
112181,10,143,2,141,143,2,141,,,
112190,10,16134,7388,8746,4680,2483,2197,11454,4905,6549
112251,10,1903,764,1139,1135,463,672,768,301,467
112260,10,1389,678,711,1383,673,710,6,5,1
112288,10,489,20,469,489,20,469,,,
112367,10,210,34,176,28,7,21,182,27,155
112385,10,8077,4452,3625,610,271,339,7467,4181,3286
112394,10,390,285,105,309,227,82,81,58,23
112455,10,111,27,84,111,27,84,,,
112525,10,3724,1354,2370,3683,1344,2339,41,10,31
112561,10,2349,1016,1333,834,393,441,1515,623,892
112570,10,291,169,122,196,117,79,95,52,43
112686,10,4082,1487,2595,740,302,438,3342,1185,2157
112826,10,5832,2329,3503,1384,662,722,4448,1667,2781
113096,10,13294,5672,7622,3006,1437,1569,10288,4235,6053
113111,10,5113,2300,2813,1478,682,796,3635,1618,2017
113193,10,9908,4876,5032,2758,1397,1361,7150,3479,3671
113218,10,8043,3528,4515,1558,772,786,6485,2756,3729
113236,10,13523,5846,7677,4729,2128,2601,8794,3718,5076
113333,10,16335,8276,8059,7923,4313,3610,8412,3963,4449
113449,10,186,53,133,186,53,133,,,
113537,10,8,1,7,8,1,7,,,
113573,10,10382,4367,6015,3864,1764,2100,6518,2603,3915
113582,10,101,9,92,82,8,74,19,1,18
113634,10,16097,7859,8238,5866,3075,2791,10231,4784,5447
113698,10,1877,528,1349,1654,475,1179,223,53,170
113704,10,62,53,9,43,39,4,19,14,5
113856,10,27855,13628,14227,5098,2298,2800,22757,11330,11427
113980,10,19944,9430,10514,7034,3482,3552,12910,5948,6962
114114,10,198,35,163,81,12,69,117,23,94
114123,10,78,26,52,77,26,51,1,0,1
114266,10,7952,3578,4374,1925,914,1011,6027,2664,3363
114354,10,1814,320,1494,1385,233,1152,429,87,342
114433,10,1383,813,570,464,240,224,919,573,346
114460,10,293,38,255,199,23,176,94,15,79
114549,10,1000,215,785,737,160,577,263,55,208
114585,10,335,73,262,205,48,157,130,25,105
114637,10,78,6,72,78,6,72,,,
114716,10,12434,6609,5825,3364,1652,1712,9070,4957,4113
114734,10,66,38,28,22,16,6,44,22,22
114761,10,72,9,63,72,9,63,,,
114789,10,22609,10228,12381,5790,2547,3243,16819,7681,9138
114813,10,3032,785,2247,1488,422,1066,1544,363,1181
114840,10,2089,1125,964,380,157,223,1709,968,741
114859,10,18370,8571,9799,6633,3300,3333,11737,5271,6466
114938,10,4561,2151,2410,1399,652,747,3162,1499,1663
114947,10,154,70,84,154,70,84,,,
115001,10,10658,4798,5860,5077,2389,2688,5581,2409,3172
115010,10,661,160,501,661,160,501,,,
115083,10,2661,1481,1180,1709,1051,658,952,430,522
115126,10,10053,4593,5460,2869,1397,1472,7184,3196,3988
115214,10,172,84,88,121,74,47,51,10,41
115296,10,12862,5313,7549,3869,1726,2143,8993,3587,5406
115357,10,171,51,120,89,33,56,82,18,64
115393,10,8892,4107,4785,3202,1461,1741,5690,2646,3044
115409,10,922,470,452,906,458,448,16,12,4
115658,10,102,8,94,38,4,34,64,4,60
115728,10,959,304,655,665,221,444,294,83,211
115746,10,851,229,622,584,159,425,267,70,197
115755,10,6025,2504,3521,5064,2118,2946,961,386,575
115773,10,393,93,300,198,59,139,195,34,161
115861,10,7747,3376,4371,3538,1531,2007,4209,1845,2364
115931,10,614,494,120,614,494,120,,,
116226,10,96,6,90,37,4,33,59,2,57
116350,10,116,11,105,115,11,104,1,0,1
116439,10,10464,5345,5119,3692,2068,1624,6772,3277,3495
116563,10,187,7,180,187,7,180,,,
116846,10,108,42,66,56,16,40,52,26,26
117052,10,7086,3292,3794,1815,990,825,5271,2302,2969
117104,10,500,234,266,436,201,235,64,33,31
117140,10,5662,1994,3668,4137,1502,2635,1525,492,1033
117168,10,760,198,562,674,172,502,86,26,60
117195,10,2519,1530,989,548,264,284,1971,1266,705
117238,10,66,11,55,66,11,55,,,
117247,10,9653,4299,5354,1571,789,782,8082,3510,4572
117274,10,1694,1198,496,373,200,173,1321,998,323
117283,10,45,20,25,27,11,16,18,9,9
117520,10,587,327,260,553,301,252,34,26,8
117557,10,377,263,114,370,257,113,7,6,1
117575,10,153,80,73,34,15,19,119,65,54
117627,10,1614,643,971,1399,556,843,215,87,128
117636,10,4280,1428,2852,3418,1213,2205,862,215,647
117645,10,22402,9717,12685,8712,3830,4882,13690,5887,7803
117672,10,1636,681,955,1184,552,632,452,129,323
117690,10,7384,2869,4515,1475,635,840,5909,2234,3675
117706,10,15372,6783,8589,4219,1962,2257,11153,4821,6332
117715,10,4913,1562,3351,542,204,338,4371,1358,3013
117724,10,10377,5834,4543,2226,1399,827,8151,4435,3716
117733,10,15037,6413,8624,2887,1353,1534,12150,5060,7090
117751,10,2606,1650,956,1366,755,611,1240,895,345
117788,10,13199,5604,7595,2687,1234,1453,10512,4370,6142
117803,10,195,52,143,,,,195,52,143
117867,10,9283,3655,5628,1597,687,910,7686,2968,4718
117894,10,7791,3365,4426,2565,1176,1389,5226,2189,3037
117946,10,10165,4486,5679,9381,4147,5234,784,339,445
117955,10,263,59,204,198,41,157,65,18,47
118134,10,90,4,86,32,4,28,58,0,58
118143,10,88,3,85,21,2,19,67,1,66
118161,10,117,4,113,117,4,113,,,
118198,10,952,178,774,952,178,774,,,
118347,10,4283,1841,2442,1176,602,574,3107,1239,1868
118684,10,3554,1305,2249,682,261,421,2872,1044,1828
118693,10,800,449,351,776,437,339,24,12,12
118718,10,10214,4036,6178,4316,1754,2562,5898,2282,3616
118772,10,6514,2427,4087,1017,434,583,5497,1993,3504
118912,10,10860,4502,6358,3920,1790,2130,6940,2712,4228
118930,10,5747,2529,3218,1313,651,662,4434,1878,2556
118958,10,63,25,38,24,8,16,39,17,22
118976,10,16224,6240,9984,7632,3125,4507,8592,3115,5477
118994,10,398,232,166,398,232,166,,,
119058,10,657,199,458,514,147,367,143,52,91
119067,10,6514,2879,3635,2051,974,1077,4463,1905,2558
119137,10,12484,5803,6681,4229,2122,2107,8255,3681,4574
119164,10,26256,12327,13929,8903,4504,4399,17353,7823,9530
119173,10,2440,278,2162,2057,218,1839,383,60,323
119216,10,15153,5918,9235,5522,2341,3181,9631,3577,6054
119270,10,864,640,224,614,456,158,250,184,66
119331,10,4041,1685,2356,1442,644,798,2599,1041,1558
119553,10,1198,329,869,1180,326,854,18,3,15
119605,10,18631,6865,11766,11457,4004,7453,7174,2861,4313
119678,10,2670,2091,579,1445,1180,265,1225,911,314
119775,10,294,172,122,250,147,103,44,25,19
119951,10,193,15,178,193,15,178,,,
120069,10,333,54,279,333,54,279,,,
120078,10,625,102,523,625,102,523,,,
120087,10,231,36,195,231,36,195,,,
120166,10,164,77,87,160,76,84,4,1,3
120184,10,201,50,151,54,8,46,147,42,105
120254,10,1942,798,1144,1913,782,1131,29,16,13
120290,10,8358,4264,4094,2671,1368,1303,5687,2896,2791
120342,10,16614,8351,8263,6500,3474,3026,10114,4877,5237
120403,10,1312,390,922,1280,378,902,32,12,20
120421,10,6339,2870,3469,1580,731,849,4759,2139,2620
120537,10,1116,392,724,868,301,567,248,91,157
120661,10,730,179,551,674,170,504,56,9,47
120698,10,1129,165,964,890,125,765,239,40,199
120768,10,1068,120,948,30,7,23,1038,113,925
120795,10,109,36,73,27,8,19,82,28,54
120838,10,17,7,10,17,7,10,,,
120865,10,870,324,546,678,258,420,192,66,126
120883,10,6277,2703,3574,5530,2410,3120,747,293,454
120953,10,4639,4009,630,526,374,152,4113,3635,478
120971,10,17655,9384,8271,5541,2868,2673,12114,6516,5598
121044,10,21923,10051,11872,7717,3818,3899,14206,6233,7973
121150,10,10030,3357,6673,5998,2314,3684,4032,1043,2989
121257,10,1212,496,716,1179,484,695,33,12,21
121275,10,69,46,23,69,46,23,,,
121309,10,4319,1474,2845,3238,1123,2115,1081,351,730
121345,10,1716,778,938,1706,772,934,10,6,4
121363,10,4113,1503,2610,1359,567,792,2754,936,1818
121433,10,119,6,113,118,6,112,1,0,1
121619,10,23852,13558,10294,3863,1930,1933,19989,11628,8361
121628,10,126,74,52,126,74,52,,,
121637,10,119,10,109,113,10,103,6,0,6
121691,10,3460,1340,2120,2961,1131,1830,499,209,290
121707,10,4006,1930,2076,1204,612,592,2802,1318,1484
121859,10,253,29,224,142,28,114,111,1,110
121868,10,236,2,234,126,0,126,110,2,108
121886,10,16139,9303,6836,3927,1987,1940,12212,7316,4896
121901,10,19147,7782,11365,5014,2202,2812,14133,5580,8553
122117,10,94,35,59,68,27,41,26,8,18
122180,10,17719,7058,10661,4034,1693,2341,13685,5365,8320
122205,10,16660,7424,9236,5104,2601,2503,11556,4823,6733
122296,10,1911,448,1463,1388,344,1044,523,104,419
122339,10,12144,5402,6742,1690,766,924,10454,4636,5818
122375,10,18076,7977,10099,3585,1707,1878,14491,6270,8221
122384,10,13062,7009,6053,1837,1174,663,11225,5835,5390
122409,10,37402,15692,21710,31807,13077,18730,5595,2615,2980
122436,10,8815,3769,5046,7088,2983,4105,1727,786,941
122506,10,437,238,199,434,236,198,3,2,1
122597,10,25282,10934,14348,19463,8281,11182,5819,2653,3166
122612,10,9688,3366,6322,7597,2624,4973,2091,742,1349
122649,10,145,58,87,131,55,76,14,3,11
122658,10,16168,6509,9659,6988,3060,3928,9180,3449,5731
122685,10,2265,567,1698,2265,567,1698,,,
122694,10,831,267,564,831,267,564,,,
122728,10,1624,687,937,1236,536,700,388,151,237
122746,10,7561,3140,4421,1595,697,898,5966,2443,3523
122755,10,35751,17300,18451,26030,12987,13043,9721,4313,5408
122791,10,7512,3686,3826,1816,975,841,5696,2711,2985
122889,10,12675,5606,7069,5778,2643,3135,6897,2963,3934
122931,10,9178,4568,4610,8007,4065,3942,1171,503,668
122977,10,22375,9905,12470,8852,4146,4706,13523,5759,7764
123013,10,15552,6973,8579,4296,2076,2220,11256,4897,6359
123095,10,1013,170,843,234,44,190,779,126,653
123165,10,1099,8,1091,1090,6,1084,9,2,7
123217,10,13170,5514,7656,4903,2221,2682,8267,3293,4974
123280,10,33,17,16,9,4,5,24,13,11
123299,10,7363,2909,4454,2780,1075,1705,4583,1834,2749
123341,10,15766,7123,8643,5571,2668,2903,10195,4455,5740
123350,10,157,48,109,120,35,85,37,13,24
123448,10,382,127,255,204,60,144,178,67,111
123457,10,874,341,533,699,269,430,175,72,103
123484,10,1204,611,593,516,304,212,688,307,381
123493,10,98,29,69,98,29,69,,,
123509,10,8523,4052,4471,1713,877,836,6810,3175,3635
123527,10,10767,4208,6559,2498,964,1534,8269,3244,5025
123554,10,2765,1146,1619,2293,1003,1290,472,143,329
123563,10,8426,3677,4749,2439,1015,1424,5987,2662,3325
123572,10,6637,2458,4179,5410,1960,3450,1227,498,729
123633,10,188,57,131,133,38,95,55,19,36
123642,10,237,19,218,147,13,134,90,6,84
123651,10,2256,745,1511,1901,624,1277,355,121,234
123679,10,803,220,583,694,202,492,109,18,91
123800,10,16530,7408,9122,6432,2886,3546,10098,4522,5576
123916,10,85,19,66,32,8,24,53,11,42
123943,10,685,197,488,665,190,475,20,7,13
123952,10,507,298,209,480,282,198,27,16,11
123961,10,48945,22574,26371,42969,19814,23155,5976,2760,3216
123970,10,927,376,551,722,308,414,205,68,137
124113,10,4508,2381,2127,840,274,566,3668,2107,1561
124283,10,196,114,82,141,88,53,55,26,29
124292,10,516,250,266,516,250,266,,,
124487,10,114,52,62,13,6,7,101,46,55
124681,10,1173,477,696,1173,477,696,,,
124706,10,825,173,652,825,173,652,,,
124937,10,676,224,452,585,210,375,91,14,77
125028,10,10559,4548,6011,3183,1485,1698,7376,3063,4313
125037,10,255,90,165,239,89,150,16,1,15
125082,10,86,12,74,83,10,73,3,2,1
125091,10,12648,5002,7646,3783,1580,2203,8865,3422,5443
125170,10,6122,2659,3463,980,467,513,5142,2192,2950
125231,10,42312,7320,34992,17003,2808,14195,25309,4512,20797
125310,10,42,13,29,42,13,29,,,
125462,10,3061,1396,1665,494,250,244,2567,1146,1421
125471,10,8656,3534,5122,1496,662,834,7160,2872,4288
125499,10,6513,2893,3620,2003,956,1047,4510,1937,2573
125532,10,1837,195,1642,1837,195,1642,,,
125718,10,101,89,12,70,61,9,31,28,3
125727,10,1284,499,785,1272,492,780,12,7,5
125763,10,1192,521,671,1120,494,626,72,27,45
125897,10,943,444,499,857,400,457,86,44,42
126012,10,520,108,412,520,108,412,,,
126049,10,271,98,173,214,81,133,57,17,40
126076,10,142,142,0,142,142,0,,,
126119,10,5401,2087,3314,1302,556,746,4099,1531,2568
126182,10,2854,1209,1645,1755,737,1018,1099,472,627
126207,10,7178,3282,3896,1872,917,955,5306,2365,2941
126289,10,12636,5544,7092,2278,992,1286,10358,4552,5806
126359,10,205,19,186,205,19,186,,,
126562,10,23744,9480,14264,12435,5214,7221,11309,4266,7043
126580,10,11431,5163,6268,7779,3526,4253,3652,1637,2015
126605,10,284,252,32,284,252,32,,,
126614,10,39585,21815,17770,31637,16943,14694,7948,4872,3076
126669,10,8964,2844,6120,2568,857,1711,6396,1987,4409
126678,10,2203,971,1232,2151,952,1199,52,19,33
126687,10,731,131,600,731,131,600,,,
126711,10,5184,2187,2997,1441,706,735,3743,1481,2262
126748,10,1179,479,700,414,167,247,765,312,453
126775,10,7403,5078,2325,6733,4588,2145,670,490,180
126784,10,130,127,3,130,127,3,,,
126818,10,33403,14875,18528,25325,11133,14192,8078,3742,4336
126827,10,24808,8374,16434,15562,5324,10238,9246,3050,6196
126863,10,8343,3484,4859,1268,624,644,7075,2860,4215
126915,10,261,78,183,91,32,59,170,46,124
126942,10,7292,2755,4537,1748,659,1089,5544,2096,3448
126951,10,1155,1042,113,1155,1042,113,,,
126979,10,874,450,424,250,115,135,624,335,289
127060,10,13734,5231,8503,8637,3324,5313,5097,1907,3190
127158,10,5313,4671,642,1178,921,257,4135,3750,385
127185,10,3400,1517,1883,2897,1326,1571,503,191,312
127200,10,19449,8575,10874,4083,1975,2108,15366,6600,8766
127273,10,185,73,112,123,46,77,62,27,35
127316,10,313,50,263,91,23,68,222,27,195
127389,10,668,295,373,352,162,190,316,133,183
127556,10,8905,4166,4739,6626,3067,3559,2279,1099,1180
127565,10,16995,7274,9721,10003,4346,5657,6992,2928,4064
127617,10,1462,531,931,328,113,215,1134,418,716
127653,10,1065,290,775,678,185,493,387,105,282
127714,10,566,279,287,20,6,14,546,273,273
127732,10,1446,514,932,666,315,351,780,199,581
127741,10,9380,2902,6478,6196,2049,4147,3184,853,2331
127778,10,999,434,565,483,227,256,516,207,309
127820,10,11899,4858,7041,4031,1781,2250,7868,3077,4791
127884,10,6481,2613,3868,1609,702,907,4872,1911,2961
127909,10,6470,3045,3425,1898,1010,888,4572,2035,2537
127918,10,4668,1510,3158,3481,1106,2375,1187,404,783
127945,10,2050,534,1516,1138,306,832,912,228,684
127954,10,45,5,40,45,5,40,,,
128106,10,6617,2642,3975,2916,1272,1644,3701,1370,2331
128151,10,960,504,456,928,499,429,32,5,27
128179,10,691,490,201,691,490,201,,,
128188,10,1105,407,698,1105,407,698,,,
128258,10,1505,702,803,601,316,285,904,386,518
128328,10,4085,2882,1203,4085,2882,1203,,,
128337,10,81,1,80,49,1,48,32,0,32
128391,10,3548,1735,1813,1897,1040,857,1651,695,956
128498,10,1275,476,799,1066,417,649,209,59,150
128577,10,1264,606,658,454,256,198,810,350,460
128586,10,60,60,0,60,60,0,,,
128744,10,3988,1561,2427,2824,1279,1545,1164,282,882
128771,10,9468,4834,4634,6550,3507,3043,2918,1327,1591
128780,10,1602,378,1224,407,88,319,1195,290,905
128896,10,202,18,184,202,18,184,,,
128902,10,1948,749,1199,1915,737,1178,33,12,21
129002,10,426,255,171,402,248,154,24,7,17
129020,10,27003,12559,14444,23869,11065,12804,3134,1494,1640
129154,10,3158,491,2667,348,115,233,2810,376,2434
129181,10,973,892,81,855,790,65,118,102,16
129215,10,4082,1651,2431,3366,1372,1994,716,279,437
129242,10,6019,2457,3562,5261,2201,3060,758,256,502
129349,10,161,5,156,125,5,120,36,0,36
129367,10,2395,667,1728,605,204,401,1790,463,1327
129428,10,115,84,31,,,,115,84,31
129482,10,369,25,344,369,25,344,,,
129491,10,92,53,39,43,30,13,49,23,26
129525,10,5732,2362,3370,4403,1879,2524,1329,483,846
129534,10,719,449,270,134,78,56,585,371,214
129543,10,3364,1295,2069,1146,488,658,2218,807,1411
129695,10,4164,1813,2351,1455,692,763,2709,1121,1588
129729,10,4554,1815,2739,1598,741,857,2956,1074,1882
129756,10,1880,758,1122,730,345,385,1150,413,737
129774,10,539,288,251,465,247,218,74,41,33
129808,10,2937,1060,1877,1058,474,584,1879,586,1293
129923,10,638,287,351,441,180,261,197,107,90
129932,10,314,274,40,256,218,38,58,56,2
129941,10,8819,4221,4598,7539,3595,3944,1280,626,654
130004,10,4069,1691,2378,1338,628,710,2731,1063,1668
130040,10,1149,411,738,445,188,257,704,223,481
130110,10,221,76,145,151,53,98,70,23,47
130174,10,2146,1233,913,1546,909,637,600,324,276
130183,10,17034,4424,12610,7243,1703,5540,9791,2721,7070
130217,10,1195,468,727,418,185,233,777,283,494
130226,10,8788,3184,5604,7579,2852,4727,1209,332,877
130253,10,10721,3720,7001,8673,3207,5466,2048,513,1535
130314,10,1992,453,1539,1434,356,1078,558,97,461
130396,10,5578,2108,3470,1670,742,928,3908,1366,2542
130493,10,8889,3136,5753,6189,2276,3913,2700,860,1840
130590,10,2205,1084,1121,2133,1040,1093,72,44,28
130606,10,3267,1414,1853,1321,593,728,1946,821,1125
130624,10,1037,609,428,1037,609,428,,,
130697,10,3253,1491,1762,3130,1440,1690,123,51,72
130776,10,4417,2004,2413,3234,1564,1670,1183,440,743
130794,10,14776,6957,7819,14538,6832,7706,238,125,113
130837,10,51,3,48,51,3,48,,,
130873,10,308,102,206,308,102,206,,,
130907,10,11726,3776,7950,3878,1601,2277,7848,2175,5673
130934,10,5826,1963,3863,4740,1545,3195,1086,418,668
130943,10,24039,10234,13805,21672,9149,12523,2367,1085,1282
130989,10,1012,474,538,619,297,322,393,177,216
131061,10,185,10,175,103,9,94,82,1,81
131113,10,14020,5247,8773,4144,1824,2320,9876,3423,6453
131159,10,13885,5105,8780,10840,3946,6894,3045,1159,1886
131283,10,4968,2267,2701,3614,1648,1966,1354,619,735
131399,10,3577,1293,2284,1566,679,887,2011,614,1397
131405,10,73,65,8,62,55,7,11,10,1
131450,10,1322,546,776,1109,470,639,213,76,137
131469,10,25939,9774,16165,17658,6882,10776,8281,2892,5389
131496,10,20984,9469,11515,15462,6823,8639,5522,2646,2876
131520,10,12886,3794,9092,11550,3334,8216,1336,460,876
131803,10,362,87,275,40,18,22,322,69,253
131830,10,18,8,10,18,8,10,,,
131876,10,1895,131,1764,1061,35,1026,834,96,738
131973,10,454,245,209,186,103,83,268,142,126
132374,10,2832,2350,482,2832,2350,482,,,
132408,10,410,207,203,191,82,109,219,125,94
132471,10,6958,2243,4715,4663,1533,3130,2295,710,1585
132602,10,2727,1007,1720,2606,963,1643,121,44,77
132657,10,3520,1639,1881,3026,1420,1606,494,219,275
132675,10,45,30,15,39,24,15,6,6,0
132693,10,13114,5309,7805,4023,1831,2192,9091,3478,5613
132709,10,30057,12049,18008,9220,4079,5141,20837,7970,12867
132842,10,864,119,745,534,72,462,330,47,283
132851,10,5483,2010,3473,2251,885,1366,3232,1125,2107
132879,10,155,99,56,146,92,54,9,7,2
132903,10,68346,30531,37815,45857,20646,25211,22489,9885,12604
132976,10,481,239,242,481,239,242,,,
133021,10,1826,702,1124,725,312,413,1101,390,711
133155,10,675,309,366,374,210,164,301,99,202
133386,10,11584,4506,7078,4425,2011,2414,7159,2495,4664
133465,10,528,120,408,438,103,335,90,17,73
133492,10,1993,599,1394,1934,574,1360,59,25,34
133508,10,14326,5121,9205,5516,2114,3402,8810,3007,5803
133526,10,1181,632,549,1090,590,500,91,42,49
133553,10,10301,7531,2770,7484,5546,1938,2817,1985,832
133650,10,9215,3079,6136,7884,2638,5246,1331,441,890
133669,10,29592,12335,17257,18734,7814,10920,10858,4521,6337
133702,10,20363,7338,13025,5813,2315,3498,14550,5023,9527
133711,10,2623,824,1799,2538,798,1740,85,26,59
133809,10,622,293,329,542,257,285,80,36,44
133845,10,598,58,540,558,57,501,40,1,39
133854,10,317,68,249,317,68,249,,,
133863,10,473,66,407,473,66,407,,,
133872,10,1610,349,1261,682,171,511,928,178,750
133881,10,8315,3865,4450,4056,2566,1490,4259,1299,2960
133951,10,55609,23855,31754,33562,14037,19525,22047,9818,12229
133960,10,920,409,511,398,222,176,522,187,335
133979,10,1137,511,626,1045,464,581,92,47,45
133997,10,332,108,224,332,108,224,,,
134024,10,55,11,44,55,11,44,,,
134079,10,3281,1208,2073,2983,1115,1868,298,93,205
134097,10,44161,18352,25809,36031,15171,20860,8130,3181,4949
134130,10,55211,23787,31424,43969,19331,24638,11242,4456,6786
134228,10,31,11,20,27,10,17,4,1,3
134237,10,26737,18303,8434,26737,18303,8434,,,
134291,10,663,533,130,550,440,110,113,93,20
134307,10,893,833,60,216,208,8,677,625,52
134343,10,4694,1670,3024,1817,700,1117,2877,970,1907
134422,10,23,0,23,13,0,13,10,0,10
134495,10,19504,8171,11333,9062,4264,4798,10442,3907,6535
134510,10,170,86,84,78,36,42,92,50,42
134529,10,299,31,268,299,31,268,,,
134574,10,158,33,125,158,33,125,,,
134608,10,14862,5968,8894,5382,2445,2937,9480,3523,5957
134714,10,396,62,334,145,31,114,251,31,220
134811,10,909,271,638,605,166,439,304,105,199
134945,10,3837,1314,2523,2989,1085,1904,848,229,619
135081,10,19020,5489,13531,11360,3581,7779,7660,1908,5752
135142,10,238,2,236,39,0,39,199,2,197
135160,10,2706,881,1825,906,286,620,1800,595,1205
135179,10,744,431,313,451,268,183,293,163,130
135188,10,4460,1694,2766,1506,588,918,2954,1106,1848
135267,10,562,421,141,556,419,137,6,2,4
135276,10,1430,791,639,777,369,408,653,422,231
135294,10,476,239,237,361,230,131,115,9,106
135337,10,103,9,94,30,7,23,73,2,71
135364,10,581,417,164,107,77,30,474,340,134
135391,10,8588,3179,5409,3587,1474,2113,5001,1705,3296
135407,10,1054,608,446,1024,587,437,30,21,9
135522,10,337,182,155,337,182,155,,,
135559,10,63,9,54,36,7,29,27,2,25
135610,10,120,50,70,52,18,34,68,32,36
135647,10,850,727,123,596,526,70,254,201,53
135717,10,47245,19732,27513,19071,8238,10833,28174,11494,16680
135726,10,19402,8801,10601,18141,8303,9838,1261,498,763
135735,10,2310,1805,505,372,325,47,1938,1480,458
136109,10,124,1,123,68,1,67,56,0,56
136145,10,1127,330,797,373,104,269,754,226,528
136172,10,16406,6673,9733,11763,4822,6941,4643,1851,2792
136215,10,20948,5925,15023,15254,4716,10538,5694,1209,4485
136233,10,4898,1938,2960,2081,868,1213,2817,1070,1747
136303,10,142,28,114,107,26,81,35,2,33
136330,10,3828,1382,2446,2792,942,1850,1036,440,596
136358,10,24223,9681,14542,7449,3449,4000,16774,6232,10542
136400,10,9202,3550,5652,3263,1323,1940,5939,2227,3712
136473,10,7981,2855,5126,3051,1145,1906,4930,1710,3220
136491,10,645,386,259,517,355,162,128,31,97
136516,10,8180,2811,5369,3023,1088,1935,5157,1723,3434
136659,10,425,337,88,201,154,47,224,183,41
136701,10,137,134,3,115,114,1,22,20,2
136765,10,403,202,201,343,172,171,60,30,30
136774,10,1705,464,1241,1681,458,1223,24,6,18
136826,10,805,498,307,505,308,197,300,190,110
136950,10,3029,1247,1782,2727,1120,1607,302,127,175
137023,10,373,168,205,367,164,203,6,4,2
137032,10,10242,4003,6239,5509,2161,3348,4733,1842,2891
137078,10,23501,9000,14501,7284,3167,4117,16217,5833,10384
137087,10,646,367,279,606,362,244,40,5,35
137096,10,12729,5797,6932,5359,2705,2654,7370,3092,4278
137120,10,1138,717,421,531,335,196,607,382,225
137209,10,14323,6179,8144,4674,2272,2402,9649,3907,5742
137245,10,1475,724,751,1475,724,751,,,
137272,10,51,49,2,51,49,2,,,
137281,10,6434,2365,4069,1631,672,959,4803,1693,3110
137315,10,2892,980,1912,1114,440,674,1778,540,1238
137351,10,49600,21001,28599,36931,15809,21122,12669,5192,7477
137476,10,6370,2640,3730,3794,1691,2103,2576,949,1627
137546,10,3928,1699,2229,3486,1508,1978,442,191,251
137564,10,10044,4033,6011,4849,1904,2945,5195,2129,3066
137591,10,244,52,192,181,44,137,63,8,55
137713,10,187,71,116,151,62,89,36,9,27
137759,10,11266,4881,6385,6084,2867,3217,5182,2014,3168
137777,10,34,34,0,34,34,0,,,
137801,10,211,108,103,211,108,103,,,
137847,10,10566,4399,6167,9802,4083,5719,764,316,448
137856,10,227,127,100,134,80,54,93,47,46
137865,10,424,254,170,401,232,169,23,22,1
137953,10,350,194,156,214,130,84,136,64,72
137962,10,181,97,84,146,83,63,35,14,21
138187,10,43370,17731,25639,16112,7070,9042,27258,10661,16597
138275,10,849,456,393,700,372,328,149,84,65
138284,10,306,153,153,280,132,148,26,21,5
138293,10,1133,789,344,923,648,275,210,141,69
138309,10,8166,1122,7044,4134,595,3539,4032,527,3505
138354,10,13521,5135,8386,6872,2833,4039,6649,2302,4347
138372,10,1569,986,583,251,73,178,1318,913,405
138479,10,811,512,299,811,512,299,,,
138488,10,2132,1204,928,178,41,137,1954,1163,791
138497,10,383,245,138,383,245,138,,,
138558,10,3647,1459,2188,2377,1092,1285,1270,367,903
138600,10,1114,24,1090,1074,21,1053,40,3,37
138655,10,543,359,184,512,341,171,31,18,13
138664,10,93,34,59,93,34,59,,,
138682,10,2577,759,1818,884,266,618,1693,493,1200
138716,10,6334,1605,4729,4505,1240,3265,1829,365,1464
138761,10,247,100,147,186,95,91,61,5,56
138813,10,457,206,251,283,133,150,174,73,101
138822,10,593,18,575,593,18,575,,,
138840,10,3125,1110,2015,940,440,500,2185,670,1515
138868,10,2015,972,1043,828,441,387,1187,531,656
138901,10,1435,498,937,565,196,369,870,302,568
138929,10,342,120,222,227,80,147,115,40,75
138938,10,333,25,308,194,8,186,139,17,122
138947,10,4000,969,3031,3649,860,2789,351,109,242
138956,10,3970,1631,2339,1364,584,780,2606,1047,1559
139144,10,2360,860,1500,2261,828,1433,99,32,67
139153,10,371,185,186,239,117,122,132,68,64
139199,10,2704,350,2354,1691,201,1490,1013,149,864
139205,10,911,527,384,576,344,232,335,183,152
139250,10,3147,960,2187,1818,552,1266,1329,408,921
139278,10,6140,2068,4072,1657,640,1017,4483,1428,3055
139311,10,5847,1806,4041,3278,1006,2272,2569,800,1769
139348,10,158,60,98,121,40,81,37,20,17
139357,10,3134,948,2186,855,281,574,2279,667,1612
139366,10,7479,2972,4507,4619,1802,2817,2860,1170,1690
139384,10,6141,2303,3838,1488,610,878,4653,1693,2960
139393,10,886,409,477,827,385,442,59,24,35
139463,10,4527,1757,2770,2768,1085,1683,1759,672,1087
139506,10,58,31,27,58,31,27,,,
139579,10,722,179,543,646,164,482,76,15,61
139621,10,1873,839,1034,1145,541,604,728,298,430
139630,10,850,457,393,715,403,312,135,54,81
139658,10,14841,5753,9088,13342,5157,8185,1499,596,903
139700,10,4768,1709,3059,1965,800,1165,2803,909,1894
139719,10,2605,903,1702,2224,788,1436,381,115,266
139746,10,61,12,49,61,12,49,,,
139755,10,45296,30704,14592,23912,14924,8988,21384,15780,5604
139764,10,3070,1023,2047,1883,601,1282,1187,422,765
139861,10,6315,2176,4139,5094,1784,3310,1221,392,829
139931,10,25481,10309,15172,19418,8104,11314,6063,2205,3858
139940,10,36516,14365,22151,27020,10715,16305,9496,3650,5846
139959,10,40607,16641,23966,36330,14936,21394,4277,1705,2572
139968,10,3135,1111,2024,1732,663,1069,1403,448,955
139986,10,5018,1442,3576,1237,372,865,3781,1070,2711
139995,10,479,180,299,288,109,179,191,71,120
140003,10,130,15,115,59,5,54,71,10,61
140012,10,8450,3513,4937,1726,897,829,6724,2616,4108
140146,10,193,107,86,97,55,42,96,52,44
140234,10,679,367,312,653,359,294,26,8,18
140243,10,5599,2207,3392,1237,511,726,4362,1696,2666
140252,10,2753,1345,1408,2363,1193,1170,390,152,238
140331,10,9017,3869,5148,2716,1309,1407,6301,2560,3741
140340,10,663,113,550,355,77,278,308,36,272
140447,10,8889,2912,5977,6971,2450,4521,1918,462,1456
140553,10,2567,2565,2,2185,2185,0,382,380,2
140562,10,891,307,584,819,290,529,72,17,55
140571,10,253,112,141,168,70,98,85,42,43
140678,10,2449,986,1463,830,400,430,1619,586,1033
140696,10,1491,557,934,1410,526,884,81,31,50
140720,10,310,132,178,273,121,152,37,11,26
140818,10,1843,521,1322,1266,392,874,577,129,448
140827,10,67,18,49,67,18,49,,,
140872,10,1141,586,555,1020,542,478,121,44,77
140942,10,3642,1319,2323,1224,545,679,2418,774,1644
140951,10,16414,4935,11479,13661,4093,9568,2753,842,1911
140960,10,2945,1103,1842,2437,933,1504,508,170,338
140988,10,1515,670,845,1175,547,628,340,123,217
141006,10,1799,833,966,764,415,349,1035,418,617
141015,10,37,16,21,36,15,21,1,1,0
141060,10,3102,168,2934,2326,0,2326,776,168,608
141167,10,1531,511,1020,861,320,541,670,191,479
141185,10,2046,770,1276,894,344,550,1152,426,726
141237,10,2796,1300,1496,898,436,462,1898,864,1034
141255,10,4003,1423,2580,804,242,562,3199,1181,2018
141264,10,10209,3182,7027,6483,2093,4390,3726,1089,2637
141325,10,660,40,620,457,2,455,203,38,165
141334,10,11893,3825,8068,6892,2452,4440,5001,1373,3628
141361,10,1511,587,924,893,392,501,618,195,423
141486,10,2369,662,1707,1869,497,1372,500,165,335
141565,10,2977,1033,1944,2065,734,1331,912,299,613
141574,10,19074,7454,11620,13853,5336,8517,5221,2118,3103
141608,10,52,37,15,52,37,15,,,
141644,10,4876,1725,3151,3160,1000,2160,1716,725,991
141680,10,3069,1626,1443,820,567,253,2249,1059,1190
141796,10,5828,1967,3861,1535,601,934,4293,1366,2927
141802,10,1308,471,837,237,114,123,1071,357,714
141811,10,6221,2325,3896,1689,767,922,4532,1558,2974
141839,10,2472,833,1639,609,238,371,1863,595,1268
141981,10,2913,978,1935,1503,531,972,1410,447,963
141990,10,2384,848,1536,501,166,335,1883,682,1201
142054,10,403,56,347,403,56,347,,,
142090,10,96,54,42,80,45,35,16,9,7
142115,10,26115,11059,15056,14621,6256,8365,11494,4803,6691
142179,10,2333,927,1406,620,281,339,1713,646,1067
142276,10,12301,4921,7380,6858,2730,4128,5443,2191,3252
142285,10,11507,5671,5836,8409,4172,4237,3098,1499,1599
142294,10,1082,531,551,1065,523,542,17,8,9
142328,10,3746,1381,2365,2034,774,1260,1712,607,1105
142407,10,87,12,75,87,12,75,,,
142443,10,4296,1655,2641,1616,718,898,2680,937,1743
142461,10,1778,665,1113,1224,499,725,554,166,388
142489,10,60,8,52,60,8,52,,,
142522,10,43023,18805,24218,16574,7757,8817,26449,11048,15401
142559,10,8096,3089,5007,1864,767,1097,6232,2322,3910
142832,10,1841,345,1496,1072,186,886,769,159,610
142887,10,111,45,66,88,31,57,23,14,9
142957,10,19,9,10,8,4,4,11,5,6
143048,10,3532,887,2645,3237,800,2437,295,87,208
143084,10,2349,1059,1290,2324,1047,1277,25,12,13
143118,10,5918,1693,4225,4588,1393,3195,1330,300,1030
143215,10,7188,3141,4047,2677,1221,1456,4511,1920,2591
143233,10,79,36,43,21,9,12,58,27,31
143279,10,3773,1424,2349,1186,523,663,2587,901,1686
143288,10,382,168,214,376,167,209,6,1,5
143297,10,167,19,148,121,13,108,46,6,40
143358,10,5552,2477,3075,4531,2252,2279,1021,225,796
143376,10,229,11,218,155,11,144,74,0,74
143464,10,100,4,96,91,4,87,9,0,9
143473,10,31,2,29,8,1,7,23,1,22
143482,10,29,0,29,14,0,14,15,0,15
143491,10,39,2,37,13,1,12,26,1,25
143552,10,51,1,50,20,0,20,31,1,30
143613,10,1688,611,1077,719,302,417,969,309,660
143659,10,213,134,79,110,88,22,103,46,57
143853,10,2758,913,1845,2714,901,1813,44,12,32
143978,10,1296,249,1047,842,147,695,454,102,352
144005,10,2317,758,1559,1396,490,906,921,268,653
144014,10,195,74,121,52,22,30,143,52,91
144050,10,18339,9925,8414,16392,8706,7686,1947,1219,728
144157,10,2237,938,1299,838,409,429,1399,529,870
144166,10,7314,1718,5596,2524,632,1892,4790,1086,3704
144175,10,2101,840,1261,699,322,377,1402,518,884
144184,10,5289,2057,3232,1324,499,825,3965,1558,2407
144193,10,4787,2232,2555,1414,843,571,3373,1389,1984
144209,10,5559,2276,3283,1978,870,1108,3581,1406,2175
144218,10,7508,3343,4165,2242,1194,1048,5266,2149,3117
144281,10,6646,2637,4009,6288,2487,3801,358,150,208
144351,10,5354,1886,3468,1368,628,740,3986,1258,2728
144564,10,1924,803,1121,755,294,461,1169,509,660
144573,10,142,5,137,104,3,101,38,2,36
144740,10,20917,9261,11656,17839,7839,10000,3078,1422,1656
144795,10,359,93,266,330,88,242,29,5,24
144865,10,21939,10044,11895,6898,3478,3420,15041,6566,8475
144883,10,529,264,265,529,264,265,,,
144892,10,8857,3721,5136,4962,2110,2852,3895,1611,2284
144944,10,8910,3952,4958,2758,1394,1364,6152,2558,3594
144962,10,3731,1421,2310,3091,1121,1970,640,300,340
144971,10,559,295,264,524,289,235,35,6,29
145099,10,274,19,255,274,19,255,,,
145239,10,252,34,218,252,34,218,,,
145275,10,280,129,151,209,99,110,71,30,41
145309,10,41,10,31,41,10,31,,,
145336,10,4427,1600,2827,2593,1047,1546,1834,553,1281
145354,10,43,2,41,7,0,7,36,2,34
145372,10,1088,553,535,888,481,407,200,72,128
145406,10,378,7,371,110,5,105,268,2,266
145424,10,62,0,62,17,0,17,45,0,45
145433,10,97,1,96,37,1,36,60,0,60
145497,10,160,21,139,52,11,41,108,10,98
145521,10,1184,478,706,522,215,307,662,263,399
145558,10,1940,798,1142,1885,784,1101,55,14,41
145600,10,33747,14969,18778,28060,12652,15408,5687,2317,3370
145619,10,3123,1386,1737,2001,1038,963,1122,348,774
145628,10,481,130,351,461,127,334,20,3,17
145637,10,56916,31000,25916,47046,25352,21694,9870,5648,4222
145646,10,1527,783,744,1518,778,740,9,5,4
145682,10,7044,2789,4255,2097,1029,1068,4947,1760,3187
145691,10,1029,480,549,990,469,521,39,11,28
145707,10,869,373,496,464,215,249,405,158,247
145725,10,6943,4396,2547,5433,3334,2099,1510,1062,448
145813,10,20683,8734,11949,18372,7869,10503,2311,865,1446
145831,10,2371,985,1386,970,460,510,1401,525,876
145886,10,119,26,93,112,22,90,7,4,3
146205,10,3272,1344,1928,1310,555,755,1962,789,1173
146278,10,1718,670,1048,774,329,445,944,341,603
146296,10,10212,4480,5732,3556,1678,1878,6656,2802,3854
146339,10,973,473,500,875,446,429,98,27,71
146348,10,2333,925,1408,930,425,505,1403,500,903
146366,10,3370,1383,1987,1082,443,639,2288,940,1348
146418,10,2581,1060,1521,921,445,476,1660,615,1045
146427,10,1058,466,592,1047,462,585,11,4,7
146454,10,28,0,28,28,0,28,,,
146472,10,11651,5037,6614,3745,1895,1850,7906,3142,4764
146481,10,1753,721,1032,1698,702,996,55,19,36
146490,10,295,127,168,,,,295,127,168
146506,10,3742,1549,2193,1865,789,1076,1877,760,1117
146533,10,116,22,94,85,19,66,31,3,28
146603,10,3973,1694,2279,1264,568,696,2709,1126,1583
146612,10,6513,3262,3251,4543,2465,2078,1970,797,1173
146667,10,258,151,107,101,47,54,157,104,53
146685,10,4444,1695,2749,1671,832,839,2773,863,1910
146700,10,1209,906,303,1209,906,303,,,
146719,10,16899,5281,11618,15097,4753,10344,1802,528,1274
146728,10,133,68,65,127,66,61,6,2,4
146755,10,101,16,85,84,15,69,17,1,16
146807,10,64,7,57,19,2,17,45,5,40
146816,10,303,33,270,254,23,231,49,10,39
146977,10,162,97,65,128,82,46,34,15,19
147004,10,8874,3909,4965,2072,998,1074,6802,2911,3891
147013,10,1960,905,1055,1563,797,766,397,108,289
147031,10,69,21,48,43,13,30,26,8,18
147129,10,456,41,415,226,18,208,230,23,207
147244,10,1807,801,1006,1665,755,910,142,46,96
147341,10,767,388,379,750,381,369,17,7,10
147369,10,2410,1284,1126,1586,795,791,824,489,335
147378,10,10511,5184,5327,3746,1830,1916,6765,3354,3411
147396,10,67,59,8,66,58,8,1,1,0
147411,10,3753,1641,2112,1131,537,594,2622,1104,1518
147536,10,7525,1675,5850,4214,1127,3087,3311,548,2763
147590,10,498,197,301,451,185,266,47,12,35
147642,10,53,5,48,9,0,9,44,5,39
147660,10,2695,1255,1440,2535,1181,1354,160,74,86
147679,10,2660,1069,1591,1851,773,1078,809,296,513
147697,10,374,225,149,234,131,103,140,94,46
147703,10,15649,7135,8514,11908,5601,6307,3741,1534,2207
147767,10,23161,10711,12450,19264,8896,10368,3897,1815,2082
147776,10,5756,2219,3537,2947,1200,1747,2809,1019,1790
147800,10,7645,3479,4166,2042,1137,905,5603,2342,3261
147819,10,36,1,35,36,1,35,,,
147828,10,3255,1312,1943,2449,1091,1358,806,221,585
147916,10,5686,2566,3120,2147,1102,1045,3539,1464,2075
148007,10,2680,1046,1634,935,384,551,1745,662,1083
148016,10,323,191,132,305,178,127,18,13,5
148098,10,48,1,47,33,1,32,15,0,15
148131,10,1307,683,624,1021,558,463,286,125,161
148256,10,2017,863,1154,1035,454,581,982,409,573
148292,10,2075,741,1334,514,202,312,1561,539,1022
148380,10,5861,2617,3244,2345,1076,1269,3516,1541,1975
148405,10,1181,533,648,945,444,501,236,89,147
148487,10,3725,1302,2423,2800,1072,1728,925,230,695
148496,10,3196,826,2370,2367,645,1722,829,181,648
148511,10,2870,649,2221,1809,510,1299,1061,139,922
148575,10,371,49,322,195,31,164,176,18,158
148584,10,3297,872,2425,1414,471,943,1883,401,1482
148593,10,94,8,86,65,6,59,29,2,27
148627,10,3523,1236,2287,2922,1055,1867,601,181,420
148654,10,4198,2035,2163,2493,1176,1317,1705,859,846
148672,10,1386,559,827,634,267,367,752,292,460
148821,10,1174,445,729,474,174,300,700,271,429
148876,10,680,119,561,462,81,381,218,38,180
148885,10,204,182,22,135,132,3,69,50,19
148937,10,1379,616,763,507,240,267,872,376,496
148982,10,99,35,64,26,5,21,73,30,43
148991,10,1212,502,710,452,197,255,760,305,455
149028,10,242,24,218,126,15,111,116,9,107
149204,10,39,1,38,39,1,38,,,
149222,10,11107,5440,5667,8813,4199,4614,2294,1241,1053
149231,10,12519,5259,7260,9275,4000,5275,3244,1259,1985
149310,10,175,109,66,175,109,66,,,
149329,10,90,90,0,90,90,0,,,
149365,10,3905,1591,2314,819,304,515,3086,1287,1799
149505,10,908,333,575,792,302,490,116,31,85
149514,10,1242,847,395,656,421,235,586,426,160
149532,10,8616,4034,4582,2612,1233,1379,6004,2801,3203
149550,10,147,14,133,105,14,91,42,0,42
149639,10,263,113,150,78,32,46,185,81,104
149727,10,7491,3302,4189,2297,1151,1146,5194,2151,3043
149763,10,429,92,337,261,60,201,168,32,136
149772,10,7643,3323,4320,5736,2604,3132,1907,719,1188
149781,10,2885,1247,1638,2307,1004,1303,578,243,335
149842,10,12434,5435,6999,3823,1934,1889,8611,3501,5110
150066,10,1290,631,659,1038,519,519,252,112,140
150136,10,19777,6882,12895,13797,5273,8524,5980,1609,4371
150145,10,1292,518,774,1049,438,611,243,80,163
150163,10,5525,2169,3356,4696,1859,2837,829,310,519
150172,10,658,397,261,427,250,177,231,147,84
150215,10,152,50,102,104,32,72,48,18,30
150251,10,186,6,180,94,1,93,92,5,87
150288,10,294,260,34,221,196,25,73,64,9
150303,10,288,3,285,143,1,142,145,2,143
150400,10,1752,862,890,1727,852,875,25,10,15
150428,10,16,0,16,16,0,16,,,
150455,10,677,311,366,638,296,342,39,15,24
150534,10,2017,773,1244,1720,644,1076,297,129,168
150604,10,959,483,476,907,458,449,52,25,27
150668,10,768,284,484,680,264,416,88,20,68
150677,10,2065,861,1204,1536,578,958,529,283,246
150756,10,1124,548,576,1119,544,575,5,4,1
150765,10,116,2,114,116,2,114,,,
150774,10,434,246,188,412,243,169,22,3,19
150853,10,215,4,211,132,4,128,83,0,83
150941,10,1472,543,929,1025,362,663,447,181,266
150987,10,89705,40496,49209,16424,6357,10067,73281,34139,39142
151102,10,9069,4352,4717,4840,2486,2354,4229,1866,2363
151111,10,25979,10279,15700,20004,8047,11957,5975,2232,3743
151263,10,5018,1738,3280,3890,1424,2466,1128,314,814
151290,10,2595,1511,1084,1901,1129,772,694,382,312
151306,10,9178,3357,5821,5238,1901,3337,3940,1456,2484
151324,10,8658,3622,5036,6540,2764,3776,2118,858,1260
151333,10,2846,988,1858,2087,712,1375,759,276,483
151342,10,4326,1443,2883,3029,1009,2020,1297,434,863
151351,10,47005,24008,22997,41923,21270,20653,5082,2738,2344
151360,10,3198,806,2392,2074,531,1543,1124,275,849
151379,10,3672,1406,2266,2318,877,1441,1354,529,825
151388,10,3039,1052,1987,1610,501,1109,1429,551,878
151467,10,167,18,149,167,18,149,,,
151564,10,43,1,42,10,1,9,33,0,33
151607,10,100,2,98,76,2,74,24,0,24
151661,10,889,742,147,889,742,147,,,
151777,10,1217,548,669,1124,523,601,93,25,68
151786,10,3701,1370,2331,2865,1161,1704,836,209,627
151801,10,2603,895,1708,2250,786,1464,353,109,244
151810,10,187,63,124,84,27,57,103,36,67
151865,10,132,73,59,24,10,14,108,63,45
151962,10,352,103,249,284,80,204,68,23,45
152044,10,83,42,41,17,14,3,66,28,38
152080,10,13105,6942,6163,12809,6796,6013,296,146,150
152099,10,880,446,434,704,359,345,176,87,89
152150,10,65,1,64,36,1,35,29,0,29
152275,10,119,43,76,61,2,59,58,41,17
152309,10,93,39,54,82,34,48,11,5,6
152318,10,2188,1656,532,2153,1629,524,35,27,8
152336,10,1903,617,1286,1576,548,1028,327,69,258
152381,10,1147,234,913,832,203,629,315,31,284
152390,10,1519,10,1509,1436,2,1434,83,8,75
152451,10,175,151,24,110,110,0,65,41,24
152497,10,144,14,130,122,13,109,22,1,21
152530,10,2221,1020,1201,1747,794,953,474,226,248
152567,10,4088,2076,2012,2509,1481,1028,1579,595,984
152600,10,2958,1328,1630,2743,1218,1525,215,110,105
152628,10,28,1,27,12,1,11,16,0,16
152637,10,16773,8331,8442,4025,2071,1954,12748,6260,6488
152673,10,835,835,0,834,834,0,1,1,0
152798,10,497,57,440,393,43,350,104,14,90
152992,10,927,405,522,668,340,328,259,65,194
153001,10,1973,600,1373,1304,473,831,669,127,542
153074,10,175,6,169,175,6,169,,,
153083,10,142,3,139,142,3,139,,,
153108,10,1169,607,562,1118,583,535,51,24,27
153126,10,965,489,476,798,419,379,167,70,97
153144,10,1264,554,710,1242,541,701,22,13,9
153162,10,1073,559,514,1065,553,512,8,6,2
153214,10,21637,9438,12199,5257,2489,2768,16380,6949,9431
153241,10,68,27,41,56,23,33,12,4,8
153250,10,1861,883,978,1482,748,734,379,135,244
153269,10,4685,1752,2933,3584,1381,2203,1101,371,730
153278,10,1776,988,788,1491,878,613,285,110,175
153296,10,718,342,376,518,271,247,200,71,129
153302,10,206,92,114,170,77,93,36,15,21
153311,10,7145,2923,4222,1931,742,1189,5214,2181,3033
153320,10,448,243,205,311,163,148,137,80,57
153366,10,1237,562,675,976,503,473,261,59,202
153375,10,1827,802,1025,1524,704,820,303,98,205
153384,10,1759,835,924,1706,806,900,53,29,24
153427,10,75,32,43,75,32,43,,,
153445,10,4787,2017,2770,1834,860,974,2953,1157,1796
153463,10,20,1,19,20,1,19,,,
153472,10,3361,1566,1795,1665,778,887,1696,788,908
153524,10,5058,2431,2627,2637,1422,1215,2421,1009,1412
153533,10,1960,895,1065,769,428,341,1191,467,724
153542,10,19,2,17,19,2,17,,,
153597,10,77,3,74,77,3,74,,,
153603,10,29969,16417,13552,27021,14744,12277,2948,1673,1275
153621,10,871,488,383,767,446,321,104,42,62
153630,10,5342,2425,2917,2308,1279,1029,3034,1146,1888
153658,10,30015,13316,16699,25306,11079,14227,4709,2237,2472
153737,10,12406,5487,6919,4166,1929,2237,8240,3558,4682
153746,10,39,2,37,39,2,37,,,
153764,10,57,0,57,57,0,57,,,
153773,10,59,4,55,59,4,55,,,
153782,10,21,0,21,21,0,21,,,
153825,10,1319,731,588,1228,684,544,91,47,44
153834,10,1610,727,883,1593,718,875,17,9,8
153861,10,2673,1382,1291,1744,1060,684,929,322,607
153922,10,1707,733,974,704,336,368,1003,397,606
153977,10,911,130,781,457,84,373,454,46,408
154004,10,2249,782,1467,1187,584,603,1062,198,864
154013,10,1526,542,984,1103,418,685,423,124,299
154022,10,34190,12414,21776,27272,9630,17642,6918,2784,4134
154059,10,2479,1130,1349,1138,569,569,1341,561,780
154095,10,8945,3239,5706,7375,2749,4626,1570,490,1080
154101,10,1651,645,1006,1115,533,582,536,112,424
154110,10,4355,1833,2522,967,437,530,3388,1396,1992
154129,10,1811,790,1021,569,350,219,1242,440,802
154156,10,1527,706,821,1392,673,719,135,33,102
154174,10,2178,1235,943,2141,1209,932,37,26,11
154208,10,126,4,122,20,0,20,106,4,102
154235,10,2747,1150,1597,2471,1033,1438,276,117,159
154262,10,196,16,180,86,11,75,110,5,105
154332,10,96,3,93,96,3,93,,,
154350,10,1151,552,599,1078,520,558,73,32,41
154378,10,2476,1030,1446,1170,504,666,1306,526,780
154396,10,1581,651,930,652,284,368,929,367,562
154448,10,146,10,136,146,10,136,,,
154457,10,13,0,13,13,0,13,,,
154466,10,30,2,28,30,2,28,,,
154493,10,3072,1247,1825,1717,676,1041,1355,571,784
154518,10,2763,1703,1060,1772,1062,710,991,641,350
154527,10,1444,708,736,1386,675,711,58,33,25
154536,10,186,76,110,169,70,99,17,6,11
154545,10,94,67,27,94,67,27,,,
154572,10,5150,2062,3088,1638,741,897,3512,1321,2191
154590,10,1473,740,733,1333,688,645,140,52,88
154642,10,2007,739,1268,859,392,467,1148,347,801
154688,10,2105,899,1206,960,452,508,1145,447,698
154697,10,4269,1937,2332,1237,538,699,3032,1399,1633
154712,10,2362,1163,1199,2168,1082,1086,194,81,113
154721,10,744,435,309,678,407,271,66,28,38
154749,10,497,260,237,486,258,228,11,2,9
154800,10,6697,2567,4130,2781,1151,1630,3916,1416,2500
154855,10,571,288,283,474,248,226,97,40,57
154907,10,1651,679,972,593,271,322,1058,408,650
154925,10,1474,860,614,905,583,322,569,277,292
154934,10,1380,429,951,583,233,350,797,196,601
154952,10,2230,936,1294,1189,577,612,1041,359,682
154998,10,1670,821,849,795,451,344,875,370,505
155007,10,358,95,263,165,57,108,193,38,155
155025,10,5324,1759,3565,3180,1139,2041,2144,620,1524
155052,10,1610,880,730,295,133,162,1315,747,568
155061,10,12949,4860,8089,5492,2137,3355,7457,2723,4734
155070,10,169,86,83,127,61,66,42,25,17
155089,10,1724,722,1002,1067,496,571,657,226,431
155098,10,1499,686,813,685,344,341,814,342,472
155104,10,1914,888,1026,1083,551,532,831,337,494
155140,10,727,280,447,652,258,394,75,22,53
155159,10,72,0,72,72,0,72,,,
155177,10,325,148,177,302,142,160,23,6,17
155186,10,2339,1043,1296,803,394,409,1536,649,887
155195,10,4960,2145,2815,1728,784,944,3232,1361,1871
155201,10,809,370,439,430,249,181,379,121,258
155210,10,16497,7418,9079,4922,2393,2529,11575,5025,6550
155283,10,577,65,512,528,61,467,49,4,45
155292,10,4676,1945,2731,1601,709,892,3075,1236,1839
155308,10,188,137,51,168,119,49,20,18,2
155317,10,26708,12098,14610,22306,10225,12081,4402,1873,2529
155335,10,2848,1056,1792,1183,408,775,1665,648,1017
155353,10,76,67,9,76,67,9,,,
155399,10,19722,9287,10435,15992,7842,8150,3730,1445,2285
155414,10,859,494,365,752,420,332,107,74,33
155423,10,1157,722,435,871,591,280,286,131,155
155450,10,1425,541,884,503,195,308,922,346,576
155487,10,909,523,386,261,158,103,648,365,283
155496,10,132,69,63,100,52,48,32,17,15
155511,10,822,554,268,804,545,259,18,9,9
155520,10,1508,602,906,992,455,537,516,147,369
155566,10,1638,695,943,554,245,309,1084,450,634
155593,10,999,621,378,412,296,116,587,325,262
155618,10,666,458,208,388,301,87,278,157,121
155627,10,953,602,351,868,543,325,85,59,26
155636,10,468,149,319,229,88,141,239,61,178
155681,10,5858,2796,3062,4402,2217,2185,1456,579,877
155715,10,1202,643,559,555,375,180,647,268,379
155812,10,1267,612,655,938,482,456,329,130,199
155830,10,855,411,444,239,130,109,616,281,335
155858,10,1663,604,1059,681,284,397,982,320,662
155900,10,1174,766,408,671,426,245,503,340,163
155937,10,706,419,287,527,331,196,179,88,91
155973,10,637,369,268,506,316,190,131,53,78
156082,10,5460,1980,3480,3646,1347,2299,1814,633,1181
156107,10,5021,2745,2276,1527,997,530,3494,1748,1746
156125,10,16216,7220,8996,10738,5008,5730,5478,2212,3266
156134,10,907,536,371,907,536,371,,,
156189,10,565,296,269,531,281,250,34,15,19
156213,10,1650,650,1000,1093,453,640,557,197,360
156222,10,1747,1021,726,508,274,234,1239,747,492
156231,10,2515,998,1517,1083,489,594,1432,509,923
156286,10,2970,1107,1863,2516,956,1560,454,151,303
156295,10,1433,582,851,1408,568,840,25,14,11
156310,10,279,4,275,248,4,244,31,0,31
156338,10,4732,1885,2847,1430,593,837,3302,1292,2010
156356,10,646,226,420,530,199,331,116,27,89
156365,10,11775,5665,6110,7246,3892,3354,4529,1773,2756
156392,10,10318,4200,6118,3680,1609,2071,6638,2591,4047
156408,10,1357,655,702,1352,651,701,5,4,1
156417,10,147,127,20,86,75,11,61,52,9
156426,10,172,12,160,112,8,104,60,4,56
156471,10,4443,352,4091,2108,171,1937,2335,181,2154
156541,10,18053,8231,9822,6732,2285,4447,11321,5946,5375
156620,10,14324,5588,8736,10169,3992,6177,4155,1596,2559
156648,10,5648,2350,3298,2131,869,1262,3517,1481,2036
156727,10,2335,143,2192,1634,90,1544,701,53,648
156745,10,1548,637,911,1202,559,643,346,78,268
156754,10,44,1,43,44,1,43,,,
156790,10,2556,1089,1467,796,322,474,1760,767,993
156842,10,193,5,188,136,4,132,57,1,56
156851,10,1506,410,1096,369,103,266,1137,307,830
156860,10,2028,690,1338,699,245,454,1329,445,884
156921,10,12053,5236,6817,2887,1358,1529,9166,3878,5288
156967,10,96,2,94,96,2,94,,,
157021,10,296,46,250,139,33,106,157,13,144
157030,10,78,48,30,49,32,17,29,16,13
157058,10,1726,719,1007,1258,498,760,468,221,247
157076,10,813,418,395,747,373,374,66,45,21
157085,10,31547,12723,18824,27620,11315,16305,3927,1408,2519
157100,10,629,388,241,468,315,153,161,73,88
157207,10,90,44,46,9,5,4,81,39,42
157216,10,3159,1542,1617,2565,1378,1187,594,164,430
157289,10,22017,9663,12354,15500,6862,8638,6517,2801,3716
157298,10,100,31,69,72,22,50,28,9,19
157304,10,3493,1568,1925,988,329,659,2505,1239,1266
157331,10,3974,1572,2402,1030,444,586,2944,1128,1816
157377,10,1441,536,905,1123,461,662,318,75,243
157386,10,8807,3409,5398,4658,1843,2815,4149,1566,2583
157401,10,9479,3516,5963,6374,2411,3963,3105,1105,2000
157438,10,4440,1959,2481,1188,574,614,3252,1385,1867
157447,10,15801,5729,10072,8633,3441,5192,7168,2288,4880
157483,10,5309,2313,2996,1607,619,988,3702,1694,2008
157535,10,2434,1069,1365,2012,892,1120,422,177,245
157553,10,2576,1091,1485,1152,509,643,1424,582,842
157614,10,89,2,87,61,2,59,28,0,28
157650,10,106,3,103,75,3,72,31,0,31
157669,10,78,2,76,78,2,76,,,
157678,10,95,0,95,95,0,95,,,
157711,10,5529,2213,3316,2019,866,1153,3510,1347,2163
157739,10,2625,1022,1603,1002,344,658,1623,678,945
157748,10,4266,3299,967,2088,1587,501,2178,1712,466
157757,10,1532,441,1091,1059,305,754,473,136,337
157793,10,2309,769,1540,1579,516,1063,730,253,477
157809,10,1958,944,1014,1344,710,634,614,234,380
157818,10,979,430,549,954,415,539,25,15,10
157863,10,970,550,420,792,463,329,178,87,91
157951,10,16493,6183,10310,11904,4527,7377,4589,1656,2933
158088,10,1226,610,616,710,308,402,516,302,214
158246,10,128,39,89,128,39,89,,,
158325,10,110,14,96,110,14,96,,,
158431,10,6312,2059,4253,2816,1018,1798,3496,1041,2455
158477,10,556,252,304,518,235,283,38,17,21
158538,10,59,0,59,59,0,59,,,
158617,10,636,186,450,636,186,450,,,
158662,10,12377,3723,8654,3934,1299,2635,8443,2424,6019
158778,10,64,0,64,64,0,64,,,
158787,10,61,0,61,61,0,61,,,
158802,10,1224,299,925,1162,289,873,62,10,52
158884,10,2393,873,1520,627,257,370,1766,616,1150
159009,10,5058,1745,3313,3895,1430,2465,1163,315,848
159027,10,43,0,43,43,0,43,,,
159197,10,505,426,79,505,426,79,,,
159328,10,98,1,97,98,1,97,,,
159373,10,2740,785,1955,2557,761,1796,183,24,159
159382,10,4289,1273,3016,2294,684,1610,1995,589,1406
159391,10,37348,16394,20954,31072,13687,17385,6276,2707,3569
159407,10,3038,767,2271,1529,431,1098,1509,336,1173
159416,10,8721,3362,5359,3093,1168,1925,5628,2194,3434
159513,10,183,6,177,183,6,177,,,
159522,10,170,4,166,170,4,166,,,
159531,10,27,0,27,27,0,27,,,
159568,10,1026,495,531,834,437,397,192,58,134
159601,10,30,0,30,30,0,30,,,
159647,10,10839,5644,5195,7938,4435,3503,2901,1209,1692
159656,10,4397,1480,2917,3691,1285,2406,706,195,511
159717,10,6230,2377,3853,4715,1870,2845,1515,507,1008
159939,10,7111,3397,3714,4684,2302,2382,2427,1095,1332
159948,10,1855,1236,619,744,494,250,1111,742,369
159966,10,5883,2036,3847,4479,1609,2870,1404,427,977
159993,10,8398,2695,5703,5104,1778,3326,3294,917,2377
160010,10,970,592,378,320,256,64,650,336,314
160038,10,9389,2743,6646,5042,1635,3407,4347,1108,3239
160065,10,1120,275,845,452,86,366,668,189,479
160074,10,1228,255,973,737,151,586,491,104,387
160117,10,182,1,181,182,1,181,,,
160126,10,37,1,36,15,0,15,22,1,21
160199,10,41,1,40,41,1,40,,,
160320,10,2499,84,2415,2499,84,2415,,,
160409,10,107,107,0,105,105,0,2,2,0
160472,10,106,9,97,63,7,56,43,2,41
160481,10,2047,610,1437,982,320,662,1065,290,775
160524,10,270,74,196,270,74,196,,,
160579,10,3268,1532,1736,1640,832,808,1628,700,928
160597,10,161,48,113,81,24,57,80,24,56
160612,10,13465,4918,8547,8127,3029,5098,5338,1889,3449
160621,10,8226,2800,5426,6166,2093,4073,2060,707,1353
160630,10,1950,557,1393,1056,262,794,894,295,599
160649,10,3154,960,2194,1522,486,1036,1632,474,1158
160658,10,15219,6469,8750,11691,5017,6674,3528,1452,2076
160667,10,5074,2423,2651,1283,697,586,3791,1726,2065
160755,10,14027,5451,8576,11475,4477,6998,2552,974,1578
160904,10,3419,776,2643,3300,747,2553,119,29,90
160959,10,380,123,257,365,116,249,15,7,8
160977,10,1790,846,944,1790,846,944,,,
160995,10,400,84,316,400,84,316,,,
161004,10,1915,926,989,1909,924,985,6,2,4
161022,10,237,19,218,106,7,99,131,12,119
161077,10,3376,1448,1928,1220,616,604,2156,832,1324
161086,10,2299,1094,1205,2299,1094,1205,,,
161138,10,2376,1164,1212,933,489,444,1443,675,768
161192,10,2119,697,1422,510,196,314,1609,501,1108
161208,10,46,43,3,46,43,3,,,
161217,10,4446,1466,2980,1301,389,912,3145,1077,2068
161226,10,1837,554,1283,1168,401,767,669,153,516
161235,10,1210,361,849,351,114,237,859,247,612
161253,10,12231,5848,6383,8367,4189,4178,3864,1659,2205
161299,10,897,721,176,862,691,171,35,30,5
161341,10,1847,677,1170,737,280,457,1110,397,713
161457,10,6434,1930,4504,4549,1399,3150,1885,531,1354
161484,10,783,382,401,315,181,134,468,201,267
161493,10,155,4,151,123,2,121,32,2,30
161509,10,436,100,336,423,96,327,13,4,9
161518,10,1478,552,926,801,314,487,677,238,439
161527,10,248,23,225,171,8,163,77,15,62
161545,10,6007,2608,3399,2310,1133,1177,3697,1475,2222
161554,10,7583,2807,4776,4075,1537,2538,3508,1270,2238
161563,10,1737,775,962,720,346,374,1017,429,588
161572,10,4281,899,3382,3887,818,3069,394,81,313
161581,10,505,188,317,168,91,77,337,97,240
161688,10,2578,790,1788,825,322,503,1753,468,1285
161767,10,10192,4040,6152,2842,1385,1457,7350,2655,4695
161800,10,147,39,108,44,16,28,103,23,80
161855,10,43,1,42,20,0,20,23,1,22
161864,10,3538,983,2555,847,287,560,2691,696,1995
161873,10,3288,1212,2076,1713,652,1061,1575,560,1015
162007,10,6275,2336,3939,4769,1806,2963,1506,530,976
162061,10,823,651,172,589,470,119,234,181,53
162104,10,1823,689,1134,547,253,294,1276,436,840
162122,10,4868,1855,3013,1797,777,1020,3071,1078,1993
162168,10,1794,590,1204,425,180,245,1369,410,959
162210,10,671,235,436,446,158,288,225,77,148
162283,10,2006,466,1540,1410,342,1068,596,124,472
162335,10,54,0,54,54,0,54,,,
162371,10,612,552,60,612,552,60,,,
162557,10,5811,2547,3264,1686,882,804,4125,1665,2460
162584,10,4067,1833,2234,2807,1415,1392,1260,418,842
162609,10,579,281,298,304,155,149,275,126,149
162654,10,1727,464,1263,1026,347,679,701,117,584
162690,10,3504,1190,2314,1130,483,647,2374,707,1667
162706,10,4591,1833,2758,1617,781,836,2974,1052,1922
162760,10,2056,722,1334,1386,537,849,670,185,485
162779,10,8177,3392,4785,2293,1136,1157,5884,2256,3628
162830,10,94,4,90,94,4,90,,,
162928,10,31275,14474,16801,16888,7561,9327,14387,6913,7474
163028,10,947,851,96,708,636,72,239,215,24
163046,10,5238,2166,3072,4366,1862,2504,872,304,568
163204,10,55838,30478,25360,10160,5245,4915,45678,25233,20445
163259,10,6931,1875,5056,4925,1421,3504,2006,454,1552
163268,10,13991,7454,6537,11284,6079,5205,2707,1375,1332
163286,10,40792,20762,20030,36165,18328,17837,4627,2434,2193
163295,10,1952,479,1473,1567,377,1190,385,102,283
163338,10,2518,1092,1426,2095,918,1177,423,174,249
163347,10,382,23,359,382,23,359,,,
163408,10,83,13,70,47,5,42,36,8,28
163426,10,17137,7931,9206,5620,2842,2778,11517,5089,6428
163453,10,9101,3483,5618,8187,3089,5098,914,394,520
163462,10,2456,1204,1252,2049,1059,990,407,145,262
163532,10,422,422,0,407,407,0,15,15,0
163541,10,265,116,149,133,64,69,132,52,80
163578,10,1733,251,1482,773,78,695,960,173,787
163657,10,10244,3768,6476,2956,1225,1731,7288,2543,4745
163815,10,41,1,40,15,1,14,26,0,26
163851,10,7123,3071,4052,6286,2725,3561,837,346,491
163912,10,1520,624,896,1478,605,873,42,19,23
163976,10,541,293,248,506,267,239,35,26,9
164076,10,19793,7642,12151,15830,6319,9511,3963,1323,2640
164085,10,701,57,644,81,12,69,620,45,575
164155,10,4450,3184,1266,4450,3184,1266,,,
164173,10,3483,1234,2249,2780,1085,1695,703,149,554
164216,10,955,400,555,941,391,550,14,9,5
164270,10,3000,1018,1982,2365,888,1477,635,130,505
164313,10,2438,752,1686,409,180,229,2029,572,1457
164368,10,2176,1285,891,1815,1070,745,361,215,146
164447,10,2010,745,1265,1838,702,1136,172,43,129
164465,10,1898,917,981,1898,917,981,,,
164492,10,1436,855,581,934,494,440,502,361,141
164535,10,54,12,42,54,12,42,,,
164562,10,2059,865,1194,1814,808,1006,245,57,188
164580,10,3989,2299,1690,3405,1995,1410,584,304,280
164599,10,26,4,22,,,,26,4,22
164614,10,43,28,15,31,19,12,12,9,3
164632,10,2465,121,2344,1265,47,1218,1200,74,1126
164641,10,224,64,160,120,45,75,104,19,85
164739,10,5165,3031,2134,4496,2703,1793,669,328,341
164748,10,8282,4693,3589,6521,3544,2977,1761,1149,612
164775,10,1367,449,918,350,146,204,1017,303,714
164845,10,66,1,65,57,1,56,9,0,9
164872,10,747,306,441,631,263,368,116,43,73
164915,10,155,52,103,57,23,34,98,29,69
164924,10,15287,6938,8349,13437,6062,7375,1850,876,974
164988,10,36714,15646,21068,29251,12286,16965,7463,3360,4103
165015,10,5581,2408,3173,5145,2234,2911,436,174,262
165024,10,9604,3755,5849,7025,2836,4189,2579,919,1660
165033,10,5822,1966,3856,2066,803,1263,3756,1163,2593
165060,10,150,14,136,91,9,82,59,5,54
165112,10,8439,3389,5050,2354,1100,1254,6085,2289,3796
165167,10,2135,478,1657,487,124,363,1648,354,1294
165194,10,2336,854,1482,629,281,348,1707,573,1134
165255,10,186,2,184,89,0,89,97,2,95
165264,10,983,76,907,93,7,86,890,69,821
165334,10,3770,1711,2059,3534,1601,1933,236,110,126
165495,10,18,7,11,18,7,11,,,
165529,10,2052,842,1210,1755,744,1011,297,98,199
165556,10,399,42,357,341,32,309,58,10,48
165574,10,1189,594,595,1103,557,546,86,37,49
165608,10,44,4,40,32,4,28,12,0,12
165635,10,202,187,15,202,187,15,,,
165644,10,535,273,262,447,240,207,88,33,55
165662,10,5891,1664,4227,5340,1594,3746,551,70,481
165671,10,2012,456,1556,1814,417,1397,198,39,159
165699,10,4006,1351,2655,3225,1158,2067,781,193,588
165750,10,32,11,21,21,11,10,11,0,11
165802,10,1421,487,934,649,343,306,772,144,628
165820,10,6554,2487,4067,2895,1341,1554,3659,1146,2513
165866,10,4111,1609,2502,2564,1162,1402,1547,447,1100
165884,10,513,420,93,292,245,47,221,175,46
165936,10,1628,612,1016,1335,508,827,293,104,189
165945,10,1334,837,497,283,166,117,1051,671,380
165981,10,1419,497,922,372,133,239,1047,364,683
166018,10,508,190,318,508,190,318,,,
166027,10,30631,14207,16424,21206,9937,11269,9425,4270,5155
166045,10,212,99,113,135,63,72,77,36,41
166054,10,131,113,18,108,95,13,23,18,5
166124,10,3083,1383,1700,3062,1375,1687,21,8,13
166133,10,3550,1240,2310,1175,486,689,2375,754,1621
166391,10,1591,584,1007,1220,432,788,371,152,219
166407,10,225,13,212,13,0,13,212,13,199
166452,10,3406,669,2737,1507,338,1169,1899,331,1568
166489,10,315,115,200,280,102,178,35,13,22
166498,10,65,2,63,29,0,29,36,2,34
166513,10,17153,9743,7410,11374,6639,4735,5779,3104,2675
166629,10,32229,15689,16540,25768,12566,13202,6461,3123,3338
166638,10,15586,6425,9161,11290,4769,6521,4296,1656,2640
166647,10,3497,1516,1981,1077,577,500,2420,939,1481
166656,10,6824,1654,5170,5381,1342,4039,1443,312,1131
166674,10,1939,510,1429,1673,421,1252,266,89,177
166683,10,11858,6784,5074,11625,6622,5003,233,162,71
166692,10,1425,1226,199,1392,1196,196,33,30,3
166708,10,1352,464,888,1249,445,804,103,19,84
166717,10,897,184,713,561,100,461,336,84,252
166805,10,54,37,17,24,19,5,30,18,12
166823,10,4810,1852,2958,1614,754,860,3196,1098,2098
166850,10,5505,2344,3161,4873,2148,2725,632,196,436
166869,10,1353,214,1139,944,135,809,409,79,330
166887,10,7770,3118,4652,1599,725,874,6171,2393,3778
166911,10,296,71,225,283,65,218,13,6,7
166939,10,2392,30,2362,2192,4,2188,200,26,174
166957,10,2868,907,1961,785,316,469,2083,591,1492
167039,10,6,0,6,6,0,6,,,
167057,10,796,420,376,749,393,356,47,27,20
167093,10,536,128,408,536,128,408,,,
167215,10,1060,381,679,814,284,530,246,97,149
167260,10,1403,888,515,1124,742,382,279,146,133
167288,10,938,390,548,735,323,412,203,67,136
167297,10,152,92,60,152,92,60,,,
167312,10,4391,1538,2853,1225,547,678,3166,991,2175
167358,10,30013,14266,15747,28848,13704,15144,1165,562,603
167376,10,4339,1608,2731,1089,518,571,3250,1090,2160
167394,10,1275,316,959,889,243,646,386,73,313
167464,10,47,47,0,47,47,0,,,
167525,10,2602,1050,1552,833,388,445,1769,662,1107
167534,10,6481,2428,4053,1913,859,1054,4568,1569,2999
167598,10,3230,438,2792,1311,241,1070,1919,197,1722
167631,10,1214,385,829,328,136,192,886,249,637
167677,10,103,86,17,82,78,4,21,8,13
167729,10,6539,2050,4489,4485,1414,3071,2054,636,1418
167783,10,5710,440,5270,3034,173,2861,2676,267,2409
167792,10,298,117,181,258,97,161,40,20,20
167835,10,2873,52,2821,2835,43,2792,38,9,29
167871,10,128,28,100,72,8,64,56,20,36
167899,10,2921,1283,1638,2720,1208,1512,201,75,126
167905,10,3945,1568,2377,1422,685,737,2523,883,1640
167987,10,7457,3556,3901,5566,2765,2801,1891,791,1100
167996,10,2543,1138,1405,2467,1102,1365,76,36,40
168005,10,6734,2510,4224,5590,2059,3531,1144,451,693
168032,10,5,0,5,5,0,5,,,
168148,10,13431,5522,7909,12004,4910,7094,1427,612,815
168218,10,2447,35,2412,2363,0,2363,84,35,49
168227,10,3920,2999,921,3529,2697,832,391,302,89
168254,10,3430,1805,1625,2958,1597,1361,472,208,264
168263,10,4702,1975,2727,3658,1537,2121,1044,438,606
168281,10,1667,612,1055,1656,607,1049,11,5,6
168342,10,2222,1047,1175,2198,1036,1162,24,11,13
168421,10,7308,4703,2605,5971,3783,2188,1337,920,417
168430,10,5311,1914,3397,3554,1316,2238,1757,598,1159
168528,10,1821,974,847,1733,936,797,88,38,50
168546,10,1456,693,763,1444,687,757,12,6,6
168555,10,31,1,30,25,1,24,6,0,6
168573,10,731,713,18,731,713,18,,,
168591,10,1260,588,672,1238,571,667,22,17,5
168607,10,1536,717,819,495,276,219,1041,441,600
168740,10,2858,1635,1223,1663,925,738,1195,710,485
168786,10,1265,538,727,1085,475,610,180,63,117
168847,10,4106,1075,3031,1509,385,1124,2597,690,1907
168883,10,1969,762,1207,570,245,325,1399,517,882
168892,10,116,4,112,62,3,59,54,1,53
169080,10,3231,1501,1730,2764,1273,1491,467,228,239
169099,10,239,168,71,132,102,30,107,66,41
169187,10,104,20,84,25,10,15,79,10,69
169220,10,178,42,136,120,30,90,58,12,46
169248,10,14557,5769,8788,11012,4531,6481,3545,1238,2307
169275,10,5969,2051,3918,1713,650,1063,4256,1401,2855
169284,10,263,18,245,196,6,190,67,12,55
169327,10,891,530,361,713,436,277,178,94,84
169363,10,1203,548,655,978,472,506,225,76,149
169424,10,129,47,82,129,47,82,,,
169442,10,1517,548,969,1199,425,774,318,123,195
169479,10,5073,2164,2909,2185,1099,1086,2888,1065,1823
169503,10,277,3,274,277,3,274,,,
169521,10,7056,2655,4401,2032,831,1201,5024,1824,3200
169576,10,108,2,106,108,2,106,,,
169655,10,1303,1217,86,1303,1217,86,,,
169716,10,5360,2282,3078,3825,1439,2386,1535,843,692
169761,10,480,91,389,480,91,389,,,
169798,10,14018,5392,8626,9039,3489,5550,4979,1903,3076
169813,10,58,1,57,58,1,57,,,
169910,10,10072,4521,5551,7248,3343,3905,2824,1178,1646
169974,10,1069,425,644,359,150,209,710,275,435
169983,10,1769,1390,379,1458,1158,300,311,232,79
169992,10,837,317,520,364,158,206,473,159,314
170000,10,1031,427,604,632,274,358,399,153,246
170037,10,1781,710,1071,1155,455,700,626,255,371
170055,10,11803,5161,6642,3360,1625,1735,8443,3536,4907
170082,10,21648,8323,13325,18066,6926,11140,3582,1397,2185
170091,10,133,76,57,126,72,54,7,4,3
170240,10,11204,4829,6375,3938,1746,2192,7266,3083,4183
170286,10,1678,865,813,1598,820,778,80,45,35
170301,10,3251,1253,1998,3126,1204,1922,125,49,76
170444,10,4244,1480,2764,925,335,590,3319,1145,2174
170532,10,1210,526,684,1190,517,673,20,9,11
170541,10,6358,2806,3552,1695,728,967,4663,2078,2585
170550,10,3427,1026,2401,738,283,455,2689,743,1946
170587,10,1403,529,874,444,165,279,959,364,595
170611,10,107,3,104,99,3,96,8,0,8
170620,10,2543,924,1619,719,283,436,1824,641,1183
170639,10,1655,740,915,1295,605,690,360,135,225
170657,10,9573,4160,5413,2890,1323,1567,6683,2837,3846
170675,10,2966,2006,960,1769,1234,535,1197,772,425
170736,10,52,1,51,23,0,23,29,1,28
170790,10,15946,6784,9162,4423,2044,2379,11523,4740,6783
170806,10,2109,735,1374,1438,515,923,671,220,451
170967,10,1167,465,702,775,325,450,392,140,252
170976,10,51225,24739,26486,47345,22517,24828,3880,2222,1658
171012,10,134,106,28,134,106,28,,,
171100,10,50023,23541,26482,44292,20954,23338,5731,2587,3144
171128,10,7063,4952,2111,6292,4410,1882,771,542,229
171137,10,8223,4554,3669,5330,2851,2479,2893,1703,1190
171146,10,5985,2123,3862,3531,1288,2243,2454,835,1619
171155,10,3382,1211,2171,1014,441,573,2368,770,1598
171225,10,2398,903,1495,584,239,345,1814,664,1150
171234,10,1603,542,1061,292,102,190,1311,440,871
171304,10,3446,1292,2154,1088,461,627,2358,831,1527
171395,10,1560,542,1018,568,218,350,992,324,668
171456,10,6970,2817,4153,5818,2390,3428,1152,427,725
171483,10,3098,1412,1686,1116,554,562,1982,858,1124
171492,10,2246,1371,875,1347,854,493,899,517,382
171535,10,13430,6072,7358,3437,1778,1659,9993,4294,5699
171571,10,16108,6848,9260,12199,5008,7191,3909,1840,2069
171599,10,919,567,352,841,523,318,78,44,34
171775,10,46,0,46,37,0,37,9,0,9
171881,10,82,36,46,69,30,39,13,6,7
171988,10,82,5,77,82,5,77,,,
171997,10,130,5,125,130,5,125,,,
172015,10,76,1,75,76,1,75,,,
172033,10,338,223,115,98,96,2,240,127,113
172051,10,7147,2454,4693,5701,1991,3710,1446,463,983
172200,10,7650,3226,4424,1876,971,905,5774,2255,3519
172264,10,1857,809,1048,1150,544,606,707,265,442
172291,10,3192,1104,2088,1139,391,748,2053,713,1340
172307,10,1807,759,1048,791,360,431,1016,399,617
172334,10,2396,549,1847,1994,460,1534,402,89,313
172422,10,109,84,25,109,84,25,,,
172440,10,450,235,215,401,223,178,49,12,37
172477,10,564,241,323,108,42,66,456,199,257
172495,10,248,7,241,178,7,171,70,0,70
172608,10,1218,599,619,81,49,32,1137,550,587
172617,10,10622,4791,5831,2809,1405,1404,7813,3386,4427
172635,10,12219,4130,8089,1422,585,837,10797,3545,7252
172644,10,23630,9453,14177,16985,6735,10250,6645,2718,3927
172671,10,992,363,629,237,99,138,755,264,491
172680,10,110,5,105,63,4,59,47,1,46
172699,10,17000,8054,8946,12696,6062,6634,4304,1992,2312
172705,10,433,260,173,79,37,42,354,223,131
172866,10,105,98,7,105,98,7,,,
172918,10,2865,1383,1482,1146,650,496,1719,733,986
172954,10,1580,733,847,727,442,285,853,291,562
172963,10,7902,3139,4763,2580,1074,1506,5322,2065,3257
173045,10,3088,1248,1840,2709,1136,1573,379,112,267
173063,10,3175,1480,1695,1085,535,550,2090,945,1145
173115,10,721,223,498,266,148,118,455,75,380
173124,10,4023,1670,2353,2408,1101,1307,1615,569,1046
173142,10,830,401,429,667,331,336,163,70,93
173160,10,3546,1345,2201,2337,882,1455,1209,463,746
173203,10,4633,1919,2714,1522,717,805,3111,1202,1909
173258,10,2059,1021,1038,2041,1015,1026,18,6,12
173300,10,1903,877,1026,1771,824,947,132,53,79
173328,10,5544,1978,3566,4330,1565,2765,1214,413,801
173416,10,2717,1586,1131,1333,864,469,1384,722,662
173452,10,880,413,467,614,311,303,266,102,164
173461,10,3849,1728,2121,1402,725,677,2447,1003,1444
173559,10,5282,2132,3150,1886,943,943,3396,1189,2207
173638,10,3352,1631,1721,978,496,482,2374,1135,1239
173647,10,2072,923,1149,2031,900,1131,41,23,18
173665,10,2638,890,1748,1742,635,1107,896,255,641
173683,10,147,46,101,63,23,40,84,23,61
173708,10,3974,2476,1498,1326,954,372,2648,1522,1126
173735,10,3044,1457,1587,1961,1098,863,1083,359,724
173744,10,508,25,483,508,25,483,,,
173799,10,3459,1324,2135,1101,468,633,2358,856,1502
173896,10,410,173,237,355,144,211,55,29,26
173902,10,2175,917,1258,2144,898,1246,31,19,12
173911,10,2602,1096,1506,1012,550,462,1590,546,1044
173920,10,14590,6350,8240,10596,4930,5666,3994,1420,2574
173957,10,1237,507,730,1184,486,698,53,21,32
174020,10,6294,2617,3677,2663,1174,1489,3631,1443,2188
174066,10,54955,24390,30565,38361,16981,21380,16594,7409,9185
174075,10,2303,932,1371,1018,403,615,1285,529,756
174127,10,821,258,563,727,235,492,94,23,71
174136,10,6030,2563,3467,1825,893,932,4205,1670,2535
174154,10,815,92,723,408,47,361,407,45,362
174190,10,150,3,147,116,2,114,34,1,33
174233,10,9675,4802,4873,8005,4002,4003,1670,800,870
174251,10,1068,471,597,994,442,552,74,29,45
174321,10,115,4,111,113,4,109,2,0,2
174358,10,4682,1650,3032,3105,1142,1963,1577,508,1069
174376,10,4896,1917,2979,1428,626,802,3468,1291,2177
174428,10,9346,3900,5446,3275,1521,1754,6071,2379,3692
174437,10,992,464,528,851,396,455,141,68,73
174473,10,2495,1030,1465,838,371,467,1657,659,998
174491,10,3253,1260,1993,1887,762,1125,1366,498,868
174507,10,1031,392,639,754,329,425,277,63,214
174525,10,102,57,45,79,47,32,23,10,13
174570,10,1873,735,1138,461,204,257,1412,531,881
174738,10,4482,1645,2837,1728,778,950,2754,867,1887
174747,10,1470,1,1469,1443,1,1442,27,0,27
174756,10,3466,1362,2104,1594,709,885,1872,653,1219
174783,10,10420,4528,5892,5325,2436,2889,5095,2092,3003
174792,10,1645,1603,42,1534,1513,21,111,90,21
174817,10,4133,1338,2795,2728,890,1838,1405,448,957
174844,10,3046,1274,1772,3022,1267,1755,24,7,17
174862,10,1583,723,860,888,433,455,695,290,405
174899,10,3207,909,2298,2538,753,1785,669,156,513
174914,10,9025,4430,4595,6777,3348,3429,2248,1082,1166
174978,10,142,3,139,106,2,104,36,1,35
175005,10,3577,234,3343,2121,94,2027,1456,140,1316
175014,10,3058,532,2526,1633,297,1336,1425,235,1190
175041,10,5365,2322,3043,1962,993,969,3403,1329,2074
175078,10,6930,2623,4307,1708,645,1063,5222,1978,3244
175120,10,440,302,138,440,302,138,,,
175139,10,224,90,134,97,39,58,127,51,76
175227,10,1359,1102,257,1127,923,204,232,179,53
175236,10,2904,1074,1830,1583,669,914,1321,405,916
175263,10,1923,839,1084,668,360,308,1255,479,776
175272,10,6154,1874,4280,4921,1516,3405,1233,358,875
175281,10,1192,487,705,1070,438,632,122,49,73
175315,10,7646,3194,4452,2921,1323,1598,4725,1871,2854
175342,10,2933,943,1990,2194,754,1440,739,189,550
175421,10,3627,1156,2471,1189,484,705,2438,672,1766
175430,10,922,448,474,557,274,283,365,174,191
175494,10,122,38,84,122,38,84,,,
175519,10,1783,651,1132,1111,435,676,672,216,456
175573,10,2801,1110,1691,1801,749,1052,1000,361,639
175616,10,2556,942,1614,1665,671,994,891,271,620
175643,10,2380,920,1460,1523,626,897,857,294,563
175652,10,3324,1470,1854,2174,1026,1148,1150,444,706
175698,10,36,29,7,26,22,4,10,7,3
175722,10,24,0,24,24,0,24,,,
175786,10,9407,3704,5703,4824,1966,2858,4583,1738,2845
175810,10,4948,1666,3282,3015,1064,1951,1933,602,1331
175829,10,4599,1791,2808,2892,1198,1694,1707,593,1114
175856,10,6906,2307,4599,5156,1832,3324,1750,475,1275
175883,10,4399,1667,2732,2762,1069,1693,1637,598,1039
175935,10,2621,847,1774,1745,579,1166,876,268,608
175980,10,661,364,297,647,356,291,14,8,6
176008,10,2039,728,1311,1374,515,859,665,213,452
176017,10,22300,9326,12974,19742,8324,11418,2558,1002,1556
176035,10,2339,518,1821,1667,298,1369,672,220,452
176044,10,1879,787,1092,1148,511,637,731,276,455
176053,10,3946,1495,2451,3045,1182,1863,901,313,588
176062,10,55,0,55,55,0,55,,,
176071,10,7845,2996,4849,4720,1945,2775,3125,1051,2074
176080,10,22649,10985,11664,18796,9050,9746,3853,1935,1918
176169,10,3062,1152,1910,2350,905,1445,712,247,465
176178,10,7198,2686,4512,4332,1663,2669,2866,1023,1843
176239,10,5462,1907,3555,3887,1418,2469,1575,489,1086
176318,10,755,313,442,587,234,353,168,79,89
176336,10,97,76,21,92,72,20,5,4,1
176354,10,1807,724,1083,1387,580,807,420,144,276
176372,10,13526,4729,8797,10086,3500,6586,3440,1229,2211
176406,10,677,257,420,571,219,352,106,38,68
176433,10,56,2,54,42,2,40,14,0,14
176451,10,180,123,57,37,30,7,143,93,50
176479,10,5662,1841,3821,3256,1090,2166,2406,751,1655
176600,10,95,57,38,61,47,14,34,10,24
176628,10,1306,476,830,1122,426,696,184,50,134
176664,10,306,192,114,251,160,91,55,32,23
176716,10,136,1,135,136,1,135,,,
176770,10,852,109,743,435,63,372,417,46,371
176789,10,299,156,143,163,81,82,136,75,61
176798,10,216,50,166,126,22,104,90,28,62
176910,10,190,123,67,118,74,44,72,49,23
176947,10,1080,523,557,1065,515,550,15,8,7
176965,10,11637,5323,6314,7121,3455,3666,4516,1868,2648
176983,10,76,57,19,65,51,14,11,6,5
177038,10,614,304,310,569,284,285,45,20,25
177065,10,6046,2431,3615,2410,914,1496,3636,1517,2119
177083,10,27,27,0,25,25,0,2,2,0
177092,10,582,529,53,260,242,18,322,287,35
177117,10,311,0,311,309,0,309,2,0,2
177126,10,608,377,231,184,118,66,424,259,165
177135,10,4034,1507,2527,1799,761,1038,2235,746,1489
177144,10,999,540,459,934,513,421,65,27,38
177214,10,1595,691,904,1368,618,750,227,73,154
177250,10,2692,1056,1636,1225,528,697,1467,528,939
177278,10,93,42,51,62,26,36,31,16,15
177302,10,344,322,22,344,322,22,,,
177339,10,1868,879,989,1526,725,801,342,154,188
177418,10,944,383,561,762,330,432,182,53,129
177436,10,26,1,25,26,1,25,,,
177472,10,10889,4594,6295,4690,1998,2692,6199,2596,3603
177542,10,494,241,253,337,157,180,157,84,73
177551,10,1084,326,758,947,285,662,137,41,96
177588,10,66,3,63,66,3,63,,,
177603,10,124,3,121,114,3,111,10,0,10
177676,10,3626,1452,2174,1728,744,984,1898,708,1190
177685,10,143,13,130,143,13,130,,,
177719,10,493,66,427,424,62,362,69,4,65
177746,10,738,167,571,728,163,565,10,4,6
177816,10,67,67,0,67,67,0,,,
177834,10,3723,1353,2370,3096,1167,1929,627,186,441
177931,10,29,2,27,29,2,27,,,
177940,10,1833,750,1083,1236,519,717,597,231,366
177968,10,7000,2675,4325,4603,1946,2657,2397,729,1668
177977,10,2176,1779,397,1837,1561,276,339,218,121
177986,10,1735,765,970,1169,594,575,566,171,395
177995,10,12872,5203,7669,5521,2461,3060,7351,2742,4609
178059,10,9959,2668,7291,3999,1370,2629,5960,1298,4662
178077,10,89,2,87,89,2,87,,,
178183,10,204,21,183,204,21,183,,,
178208,10,3772,3043,729,1930,1645,285,1842,1398,444
178217,10,2289,787,1502,1273,454,819,1016,333,683
178244,10,5231,2064,3167,1515,678,837,3716,1386,2330
178341,10,4144,1572,2572,2593,998,1595,1551,574,977
178369,10,1527,849,678,1210,750,460,317,99,218
178387,10,4023,1539,2484,2351,957,1394,1672,582,1090
178396,10,31304,13746,17558,26259,11745,14514,5045,2001,3044
178402,10,15703,6664,9039,9127,3888,5239,6576,2776,3800
178411,10,7080,5377,1703,5911,4505,1406,1169,872,297
178420,10,15181,6142,9039,5140,2144,2996,10041,3998,6043
178448,10,5017,1887,3130,2200,872,1328,2817,1015,1802
178518,10,177,109,68,73,40,33,104,69,35
178527,10,60,3,57,34,3,31,26,0,26
178615,10,3960,1548,2412,3066,1182,1884,894,366,528
178624,10,8505,3255,5250,5310,2147,3163,3195,1108,2087
178679,10,689,384,305,491,272,219,198,112,86
178697,10,1487,647,840,1470,641,829,17,6,11
178721,10,7662,4131,3531,3247,1563,1684,4415,2568,1847
178767,10,88,15,73,36,7,29,52,8,44
178828,10,34,8,26,34,8,26,,,
178891,10,1671,1524,147,1250,1140,110,421,384,37
178989,10,318,37,281,217,27,190,101,10,91
179043,10,3405,1199,2206,2013,689,1324,1392,510,882
179159,10,15755,6451,9304,11229,4508,6721,4526,1943,2583
179195,10,34,2,32,34,2,32,,,
179265,10,695,252,443,672,246,426,23,6,17
179308,10,14301,4950,9351,5294,2106,3188,9007,2844,6163
179317,10,102,51,51,60,31,29,42,20,22
179326,10,2386,883,1503,1451,598,853,935,285,650
179344,10,1770,569,1201,684,218,466,1086,351,735
179511,10,91,1,90,52,1,51,39,0,39
179539,10,3724,1339,2385,1798,630,1168,1926,709,1217
179548,10,590,39,551,538,36,502,52,3,49
179557,10,9927,4017,5910,7133,2946,4187,2794,1071,1723
179566,10,22535,8919,13616,13135,5084,8051,9400,3835,5565
179645,10,2624,818,1806,1376,427,949,1248,391,857
179715,10,1772,486,1286,777,226,551,995,260,735
179812,10,1306,624,682,1292,621,671,14,3,11
179867,10,17012,7969,9043,14629,6960,7669,2383,1009,1374
179894,10,6396,2839,3557,3095,1452,1643,3301,1387,1914
179946,10,610,335,275,602,331,271,8,4,4
179955,10,853,433,420,832,423,409,21,10,11
179964,10,1508,532,976,703,225,478,805,307,498
179991,10,37,2,35,37,2,35,,,
180054,10,346,74,272,195,40,155,151,34,117
180063,10,37,1,36,37,1,36,,,
180081,10,655,357,298,278,180,98,377,177,200
180090,10,68,2,66,68,2,66,,,
180106,10,1168,461,707,1139,449,690,29,12,17
180151,10,462,225,237,210,105,105,252,120,132
180160,10,221,77,144,91,35,56,130,42,88
180179,10,4057,1436,2621,2052,809,1243,2005,627,1378
180197,10,2129,939,1190,586,269,317,1543,670,873
180203,10,115,48,67,98,44,54,17,4,13
180212,10,697,213,484,400,124,276,297,89,208
180249,10,1192,345,847,453,140,313,739,205,534
180258,10,955,296,659,602,214,388,353,82,271
180276,10,1423,592,831,337,168,169,1086,424,662
180328,10,296,96,200,194,69,125,102,27,75
180373,10,583,196,387,275,124,151,308,72,236
180416,10,1625,1001,624,1395,864,531,230,137,93
180461,10,16681,8671,8010,13159,6948,6211,3522,1723,1799
180489,10,9955,3963,5992,6941,2842,4099,3014,1121,1893
180522,10,1140,642,498,696,427,269,444,215,229
180595,10,1054,489,565,1033,481,552,21,8,13
180647,10,619,177,442,464,137,327,155,40,115
180692,10,1424,452,972,1013,359,654,411,93,318
180814,10,13841,5964,7877,8788,3779,5009,5053,2185,2868
180832,10,1133,159,974,263,49,214,870,110,760
180878,10,725,76,649,412,42,370,313,34,279
180902,10,6519,2721,3798,1752,888,864,4767,1833,2934
180948,10,2260,801,1459,1601,601,1000,659,200,459
180957,10,67,58,9,67,58,9,,,
180984,10,3047,1323,1724,1431,607,824,1616,716,900
181002,10,8397,3415,4982,7222,2962,4260,1175,453,722
181020,10,1879,748,1131,1269,618,651,610,130,480
181127,10,936,456,480,926,450,476,10,6,4
181145,10,24,2,22,24,2,22,,,
181190,10,107,4,103,107,4,103,,,
181215,10,6041,2062,3979,3937,1437,2500,2104,625,1479
181297,10,1146,121,1025,871,94,777,275,27,248
181303,10,14541,7129,7412,3928,1990,1938,10613,5139,5474
181312,10,2084,862,1222,668,321,347,1416,541,875
181330,10,1615,732,883,1231,626,605,384,106,278
181394,10,15058,6544,8514,11020,4683,6337,4038,1861,2177
181419,10,474,172,302,83,25,58,391,147,244
181428,10,3660,1064,2596,2872,849,2023,788,215,573
181446,10,1688,734,954,1512,693,819,176,41,135
181464,10,23805,11869,11936,20695,10310,10385,3110,1559,1551
181491,10,5583,2981,2602,1996,1065,931,3587,1916,1671
181534,10,1799,696,1103,1027,448,579,772,248,524
181543,10,22,13,9,12,7,5,10,6,4
181604,10,857,61,796,737,33,704,120,28,92
181640,10,9465,4496,4969,3171,1813,1358,6294,2683,3611
181738,10,694,250,444,546,205,341,148,45,103
181765,10,303,103,200,236,70,166,67,33,34
181783,10,4773,1918,2855,3038,1287,1751,1735,631,1104
181817,10,1575,633,942,618,283,335,957,350,607
181853,10,626,286,340,412,218,194,214,68,146
181880,10,203,5,198,125,4,121,78,1,77
181941,10,292,185,107,292,185,107,,,
182005,10,28901,12325,16576,9013,3871,5142,19888,8454,11434
182148,10,614,125,489,614,125,489,,,
182281,10,30660,13154,17506,22662,9675,12987,7998,3479,4519
182290,10,20945,9531,11414,15477,7121,8356,5468,2410,3058
182306,10,3197,1136,2061,878,355,523,2319,781,1538
182500,10,9651,4454,5197,2649,1163,1486,7002,3291,3711
182564,10,3582,1660,1922,1170,489,681,2412,1171,1241
182634,10,943,259,684,771,228,543,172,31,141
182670,10,6744,3405,3339,6701,3383,3318,43,22,21
182704,10,66,2,64,51,1,50,15,1,14
182722,10,151,12,139,116,12,104,35,0,35
182795,10,1663,718,945,1370,590,780,293,128,165
182829,10,651,366,285,428,232,196,223,134,89
182892,10,64,0,64,38,0,38,26,0,26
182917,10,59,26,33,59,26,33,,,
182980,10,2852,1700,1152,2694,1628,1066,158,72,86
182999,10,15,0,15,15,0,15,,,
183026,10,164091,58950,105141,40350,15333,25017,123741,43617,80124
183035,10,37,2,35,37,2,35,,,
183044,10,13953,6014,7939,12591,5398,7193,1362,616,746
183062,10,2872,1326,1546,2648,1211,1437,224,115,109
183071,10,534,269,265,424,208,216,110,61,49
183080,10,3872,1849,2023,3385,1682,1703,487,167,320
183099,10,2619,939,1680,902,404,498,1717,535,1182
183105,10,523,186,337,161,85,76,362,101,261
183114,10,658,166,492,110,40,70,548,126,422
183123,10,645,320,325,228,159,69,417,161,256
183132,10,1976,950,1026,620,401,219,1356,549,807
183141,10,1245,586,659,341,207,134,904,379,525
183150,10,1415,568,847,429,221,208,986,347,639
183202,10,82,2,80,69,1,68,13,1,12
183211,10,2551,816,1735,1531,681,850,1020,135,885
183239,10,1977,788,1189,1955,775,1180,22,13,9
183248,10,135,15,120,78,9,69,57,6,51
183257,10,1425,395,1030,613,169,444,812,226,586
183275,10,89,43,46,89,43,46,,,
183488,10,562,44,518,445,37,408,117,7,110
183600,10,33,0,33,19,0,19,14,0,14
183655,10,4278,1590,2688,1786,741,1045,2492,849,1643
183725,10,365,193,172,321,180,141,44,13,31
183743,10,11192,5314,5878,5875,2975,2900,5317,2339,2978
183789,10,2078,510,1568,1254,334,920,824,176,648
183804,10,8097,8097,0,7749,7749,0,348,348,0
183822,10,1153,471,682,1071,439,632,82,32,50
183859,10,9896,4607,5289,4059,2098,1961,5837,2509,3328
183877,10,6180,2448,3732,2983,1323,1660,3197,1125,2072
183910,10,2028,699,1329,1647,615,1032,381,84,297
183938,10,7770,2955,4815,3054,1307,1747,4716,1648,3068
183974,10,1498,492,1006,991,348,643,507,144,363
183983,10,76,73,3,76,73,3,,,
184056,10,548,120,428,405,94,311,143,26,117
184092,10,760,99,661,760,99,661,,,
184180,10,5838,3111,2727,2585,1504,1081,3253,1607,1646
184205,10,2426,841,1585,909,336,573,1517,505,1012
184348,10,2092,929,1163,1717,762,955,375,167,208
184427,10,339,316,23,236,224,12,103,92,11
184481,10,6466,2540,3926,2998,1204,1794,3468,1336,2132
184506,10,83,8,75,54,4,50,29,4,25
184603,10,7285,2995,4290,2514,1145,1369,4771,1850,2921
184612,10,2148,585,1563,1667,464,1203,481,121,360
184694,10,2823,1161,1662,2525,1029,1496,298,132,166
184746,10,82,75,7,74,68,6,8,7,1
184773,10,1962,523,1439,1224,298,926,738,225,513
184782,10,19535,9611,9924,15740,8138,7602,3795,1473,2322
184791,10,5441,2192,3249,2826,1230,1596,2615,962,1653
184816,10,86,2,84,53,1,52,33,1,32
184959,10,719,108,611,322,49,273,397,59,338
184968,10,191,29,162,32,6,26,159,23,136
184995,10,6683,2593,4090,3495,1434,2061,3188,1159,2029
185129,10,6539,2416,4123,4476,1850,2626,2063,566,1497
185174,10,81,64,17,81,64,17,,,
185262,10,12884,4638,8246,9782,3631,6151,3102,1007,2095
185396,10,1625,1570,55,1392,1347,45,233,223,10
185466,10,360,7,353,126,1,125,234,6,228
185509,10,5821,2694,3127,1916,1036,880,3905,1658,2247
185536,10,9736,4471,5265,4054,1972,2082,5682,2499,3183
185572,10,5027,1702,3325,4259,1488,2771,768,214,554
185590,10,21784,8204,13580,17121,6549,10572,4663,1655,3008
185679,10,582,88,494,49,5,44,533,83,450
185721,10,415,119,296,263,77,186,152,42,110
185758,10,132,63,69,21,9,12,111,54,57
185767,10,264,34,230,132,15,117,132,19,113
185828,10,12332,8812,3520,9649,6942,2707,2683,1870,813
185873,10,7186,3129,4057,3040,1495,1545,4146,1634,2512
185970,10,135,11,124,104,9,95,31,2,29
186016,10,454,27,427,252,18,234,202,9,193
186034,10,5119,1914,3205,1865,799,1066,3254,1115,2139
186052,10,886,740,146,608,518,90,278,222,56
186122,10,323,162,161,313,155,158,10,7,3
186131,10,8842,4668,4174,8778,4634,4144,64,34,30
186186,10,203,203,0,203,203,0,,,
186201,10,5478,2193,3285,4548,1880,2668,930,313,617
186274,10,207,16,191,119,10,109,88,6,82
186283,10,4054,1653,2401,3275,1387,1888,779,266,513
186371,10,5966,2403,3563,4332,1717,2615,1634,686,948
186380,10,50637,23354,27283,43363,20847,22516,7274,2507,4767
186399,10,11017,5196,5821,8058,3795,4263,2959,1401,1558
186405,10,16,5,11,16,5,11,,,
186423,10,53,8,45,53,8,45,,,
186432,10,3430,1563,1867,2831,1339,1492,599,224,375
186469,10,1111,391,720,520,231,289,591,160,431
186584,10,9623,4040,5583,7466,3235,4231,2157,805,1352
186593,10,80,26,54,55,25,30,25,1,24
186618,10,1122,342,780,785,267,518,337,75,262
186645,10,6321,3216,3105,2521,1372,1149,3800,1844,1956
186867,10,9314,6581,2733,7848,5534,2314,1466,1047,419
186876,10,9080,3416,5664,8165,3116,5049,915,300,615
186900,10,73,73,0,73,73,0,,,
187000,10,368,347,21,252,235,17,116,112,4
187046,10,8248,4772,3476,83,17,66,8165,4755,3410
187134,10,7629,3175,4454,7086,2984,4102,543,191,352
187198,10,7796,2971,4825,3493,1618,1875,4303,1353,2950
187444,10,9070,3182,5888,5758,2264,3494,3312,918,2394
187505,10,688,145,543,688,145,543,,,
187532,10,19095,7337,11758,4272,1847,2425,14823,5490,9333
187596,10,1354,527,827,542,249,293,812,278,534
187620,10,6662,2608,4054,2807,1191,1616,3855,1417,2438
187639,10,2303,752,1551,591,192,399,1712,560,1152
187648,10,5106,1826,3280,2434,854,1580,2672,972,1700
187666,10,1856,784,1072,834,382,452,1022,402,620
187745,10,868,342,526,315,116,199,553,226,327
187897,10,2677,837,1840,1597,565,1032,1080,272,808
187903,10,2228,876,1352,937,401,536,1291,475,816
187912,10,424,334,90,345,288,57,79,46,33
187958,10,2113,795,1318,607,239,368,1506,556,950
187967,10,1689,1116,573,1342,946,396,347,170,177
187976,10,1009,471,538,82,32,50,927,439,488
187985,10,21953,9289,12664,15071,6364,8707,6882,2925,3957
187994,10,1032,364,668,252,87,165,780,277,503
188003,10,1673,600,1073,269,86,183,1404,514,890
188021,10,825,247,578,185,60,125,640,187,453
188030,10,14268,5968,8300,10766,4520,6246,3502,1448,2054
188049,10,1953,764,1189,246,94,152,1707,670,1037
188058,10,1154,482,672,447,157,290,707,325,382
188100,10,5454,1726,3728,1611,647,964,3843,1079,2764
188137,10,3266,1222,2044,653,251,402,2613,971,1642
188182,10,1066,403,663,499,229,270,567,174,393
188207,10,193,16,177,125,11,114,68,5,63
188216,10,269,93,176,179,81,98,90,12,78
188225,10,1222,426,796,141,58,83,1081,368,713
188261,10,824,537,287,126,79,47,698,458,240
188289,10,68,4,64,66,4,62,2,0,2
188304,10,3378,1106,2272,1525,561,964,1853,545,1308
188340,10,1187,1038,149,954,828,126,233,210,23
188429,10,7252,2175,5077,5883,1818,4065,1369,357,1012
188438,10,2662,1198,1464,1399,673,726,1263,525,738
188517,10,296,111,185,230,100,130,66,11,55
188526,10,930,338,592,911,333,578,19,5,14
188535,10,643,284,359,572,257,315,71,27,44
188580,10,837,322,515,837,322,515,,,
188641,10,1813,784,1029,1484,682,802,329,102,227
188650,10,148,3,145,148,3,145,,,
188669,10,67,15,52,67,15,52,,,
188678,10,209,68,141,209,68,141,,,
188687,10,382,127,255,100,40,60,282,87,195
188696,10,166,17,149,166,17,149,,,
188854,10,1480,401,1079,1480,401,1079,,,
188890,10,1072,1049,23,799,782,17,273,267,6
188915,10,47,14,33,22,13,9,25,1,24
188942,10,308,0,308,288,0,288,20,0,20
189015,10,683,99,584,351,52,299,332,47,285
189088,10,2706,1136,1570,2471,1006,1465,235,130,105
189097,10,3442,114,3328,3091,0,3091,351,114,237
189219,10,122,120,2,122,120,2,,,
189228,10,1882,643,1239,1211,436,775,671,207,464
189255,10,110,1,109,71,1,70,39,0,39
189273,10,74,74,0,74,74,0,,,
189282,10,329,45,284,261,38,223,68,7,61
189404,10,137,1,136,45,0,45,92,1,91
189413,10,461,92,369,461,92,369,,,
189468,10,149,4,145,89,4,85,60,0,60
189477,10,139,3,136,51,2,49,88,1,87
189501,10,1210,478,732,1110,441,669,100,37,63
189547,10,5409,2274,3135,2448,1056,1392,2961,1218,1743
189565,10,463,133,330,374,117,257,89,16,73
189583,10,787,223,564,454,116,338,333,107,226
189592,10,328,87,241,269,80,189,59,7,52
189705,10,2492,1183,1309,2103,1019,1084,389,164,225
189714,10,331,9,322,230,4,226,101,5,96
189811,10,827,158,669,827,158,669,,,
189839,10,3479,1411,2068,831,321,510,2648,1090,1558
189848,10,745,240,505,571,177,394,174,63,111
189857,10,768,768,0,768,768,0,,,
189990,10,745,7,738,148,3,145,597,4,593
190008,10,43,14,29,43,14,29,,,
190044,10,3719,2393,1326,3228,2119,1109,491,274,217
190053,10,994,437,557,306,159,147,688,278,410
190071,10,115,13,102,26,4,22,89,9,80
190080,10,37,20,17,4,2,2,33,18,15
190099,10,3141,1394,1747,3120,1383,1737,21,11,10
190114,10,632,166,466,456,113,343,176,53,123
190150,10,34782,16150,18632,28383,12951,15432,6399,3199,3200
190169,10,1447,604,843,461,220,241,986,384,602
190239,10,131,4,127,96,2,94,35,2,33
190318,10,199,13,186,190,5,185,9,8,1
190372,10,958,490,468,938,471,467,20,19,1
190415,10,25898,12213,13685,25098,11788,13310,800,425,375
190424,10,1327,546,781,1286,530,756,41,16,25
190442,10,3786,1602,2184,1307,565,742,2479,1037,1442
190451,10,215,34,181,62,13,49,153,21,132
190503,10,3124,1567,1557,2984,1487,1497,140,80,60
190512,10,19854,9601,10253,13293,6574,6719,6561,3027,3534
190521,10,17444,7355,10089,11110,4847,6263,6334,2508,3826
190530,10,6715,2838,3877,3839,1734,2105,2876,1104,1772
190549,10,14195,5778,8417,9085,3844,5241,5110,1934,3176
190558,10,10248,4622,5626,7515,3498,4017,2733,1124,1609
190567,10,14489,6588,7901,10323,4804,5519,4166,1784,2382
190576,10,8733,2855,5878,4183,1592,2591,4550,1263,3287
190585,10,4904,1527,3377,2412,852,1560,2492,675,1817
190594,10,22970,7261,15709,14959,4796,10163,8011,2465,5546
190600,10,13921,5091,8830,10139,3632,6507,3782,1459,2323
190619,10,15042,7138,7904,5581,2488,3093,9461,4650,4811
190628,10,13064,6151,6913,6664,2928,3736,6400,3223,3177
190637,10,13015,4161,8854,7587,2536,5051,5428,1625,3803
190646,10,3640,1057,2583,2467,717,1750,1173,340,833
190655,10,13087,7213,5874,8427,5001,3426,4660,2212,2448
190664,10,17001,7506,9495,10891,4950,5941,6110,2556,3554
190673,10,9573,4467,5106,5329,2744,2585,4244,1723,2521
190682,10,699,237,462,497,162,335,202,75,127
190691,10,6446,2315,4131,3815,1340,2475,2631,975,1656
190707,10,18,5,13,18,5,13,,,
190716,10,2518,701,1817,1632,510,1122,886,191,695
190725,10,2642,617,2025,2176,521,1655,466,96,370
190752,10,51,51,0,51,51,0,,,
190761,10,1407,462,945,1201,423,778,206,39,167
190840,10,7047,3132,3915,2556,1234,1322,4491,1898,2593
190956,10,141,14,127,13,2,11,128,12,116
190983,10,657,223,434,612,210,402,45,13,32
191083,10,7843,3760,4083,4546,2357,2189,3297,1403,1894
191126,10,8125,1429,6696,7075,1185,5890,1050,244,806
191199,10,5331,2294,3037,1957,942,1015,3374,1352,2022
191205,10,546,375,171,472,339,133,74,36,38
191241,10,16556,6277,10279,13418,5330,8088,3138,947,2191
191302,10,1812,751,1061,675,305,370,1137,446,691
191311,10,149,53,96,149,53,96,,,
191339,10,4323,1659,2664,1445,552,893,2878,1107,1771
191515,10,2072,928,1144,2070,927,1143,2,1,1
191533,10,1103,452,651,1079,446,633,24,6,18
191597,10,544,77,467,348,55,293,196,22,174
191612,10,2030,841,1189,1054,445,609,976,396,580
191621,10,877,408,469,830,386,444,47,22,25
191630,10,1607,793,814,1589,781,808,18,12,6
191649,10,10238,4143,6095,8858,3653,5205,1380,490,890
191676,10,833,311,522,720,265,455,113,46,67
191719,10,9140,4510,4630,4481,2561,1920,4659,1949,2710
191728,10,952,194,758,665,143,522,287,51,236
191931,10,3621,1626,1995,2999,1346,1653,622,280,342
191940,10,172,16,156,172,16,156,,,
191959,10,67,54,13,67,54,13,,,
191968,10,5054,2182,2872,4931,2119,2812,123,63,60
191986,10,3756,1634,2122,1407,626,781,2349,1008,1341
192004,10,287,78,209,278,75,203,9,3,6
192022,10,2292,892,1400,1166,497,669,1126,395,731
192040,10,318,142,176,227,97,130,91,45,46
192110,10,986,511,475,855,443,412,131,68,63
192165,10,187,187,0,187,187,0,,,
192192,10,1250,289,961,997,243,754,253,46,207
192271,10,1310,134,1176,1141,124,1017,169,10,159
192323,10,3203,1154,2049,2504,1009,1495,699,145,554
192448,10,15737,5440,10297,7909,2479,5430,7828,2961,4867
192484,10,165,3,162,77,1,76,88,2,86
192509,10,743,111,632,688,102,586,55,9,46
192624,10,142,142,0,142,142,0,,,
192688,10,437,78,359,353,54,299,84,24,60
192703,10,3575,2029,1546,3342,1889,1453,233,140,93
192712,10,1115,522,593,1092,516,576,23,6,17
192749,10,2240,822,1418,1558,608,950,682,214,468
192785,10,805,91,714,220,29,191,585,62,523
192800,10,9,0,9,3,0,3,6,0,6
192819,10,6464,2721,3743,5506,2305,3201,958,416,542
192864,10,1608,291,1317,1404,272,1132,204,19,185
192925,10,1727,485,1242,1474,448,1026,253,37,216
192961,10,121,19,102,1,0,1,120,19,101
192970,10,15,5,10,15,5,10,,,
193016,10,8615,2425,6190,5911,1656,4255,2704,769,1935
193052,10,549,549,0,548,548,0,1,1,0
193061,10,47,47,0,47,47,0,,,
193070,10,81,81,0,81,81,0,,,
193201,10,365,42,323,365,42,323,,,
193247,10,138,138,0,138,138,0,,,
193265,10,66,59,7,49,45,4,17,14,3
193283,10,5539,2485,3054,2318,1088,1230,3221,1397,1824
193292,10,4807,1230,3577,2930,862,2068,1877,368,1509
193308,10,7011,2419,4592,4096,1659,2437,2915,760,2155
193326,10,8283,3480,4803,4431,1982,2449,3852,1498,2354
193353,10,1918,543,1375,1245,390,855,673,153,520
193380,10,95,12,83,,,,95,12,83
193399,10,2877,624,2253,2379,562,1817,498,62,436
193405,10,1253,503,750,1253,503,750,,,
193478,10,11996,5729,6267,6711,3495,3216,5285,2234,3051
193584,10,2522,651,1871,2273,595,1678,249,56,193
193609,10,64,25,39,64,25,39,,,
193654,10,10108,2580,7528,9277,2329,6948,831,251,580
193751,10,551,269,282,405,229,176,146,40,106
193821,10,1050,397,653,884,326,558,166,71,95
193830,10,1454,608,846,1267,549,718,187,59,128
193858,10,266,18,248,266,18,248,,,
193894,10,140,61,79,112,51,61,28,10,18
193900,10,59144,24466,34678,50670,20828,29842,8474,3638,4836
193946,10,3838,1511,2327,2114,875,1239,1724,636,1088
193973,10,3858,1363,2495,3411,1197,2214,447,166,281
193991,10,40,4,36,31,2,29,9,2,7
194028,10,1604,587,1017,601,237,364,1003,350,653
194073,10,334,156,178,330,154,176,4,2,2
194091,10,6906,3735,3171,6009,3258,2751,897,477,420
194116,10,633,63,570,292,35,257,341,28,313
194161,10,1595,656,939,896,376,520,699,280,419
194189,10,101,101,0,101,101,0,,,
194222,10,7320,3564,3756,2797,1405,1392,4523,2159,2364
194240,10,4976,2010,2966,1991,911,1080,2985,1099,1886
194259,10,17,1,16,17,1,16,,,
194310,10,13609,4765,8844,10717,3761,6956,2892,1004,1888
194392,10,686,440,246,660,424,236,26,16,10
194435,10,73,2,71,73,2,71,,,
194499,10,807,158,649,790,155,635,17,3,14
194569,10,146,84,62,71,44,27,75,40,35
194578,10,5494,1479,4015,5256,1425,3831,238,54,184
194657,10,247,247,0,247,247,0,,,
194666,10,502,502,0,502,502,0,,,
194693,10,38,38,0,38,38,0,,,
194718,10,72,72,0,72,72,0,,,
194736,10,148,148,0,148,148,0,,,
194763,10,590,590,0,590,590,0,,,
194824,10,6968,4807,2161,6868,4729,2139,100,78,22
194958,10,1573,418,1155,1240,357,883,333,61,272
195003,10,16615,10846,5769,14936,9723,5213,1679,1123,556
195030,10,12197,5682,6515,10180,4980,5200,2017,702,1315
195049,10,273,149,124,273,149,124,,,
195058,10,5472,2534,2938,2556,1372,1184,2916,1162,1754
195067,10,317,17,300,230,12,218,87,5,82
195128,10,2159,490,1669,1464,378,1086,695,112,583
195155,10,171,119,52,12,11,1,159,108,51
195164,10,2602,1294,1308,2023,1069,954,579,225,354
195173,10,2661,1126,1535,2511,1062,1449,150,64,86
195191,10,239,23,216,208,17,191,31,6,25
195216,10,2175,999,1176,2139,982,1157,36,17,19
195234,10,2786,853,1933,1936,615,1321,850,238,612
195243,10,2033,975,1058,1055,533,522,978,442,536
195289,10,127,18,109,15,1,14,112,17,95
195304,10,1696,334,1362,1637,321,1316,59,13,46
195322,10,3657,1599,2058,1000,451,549,2657,1148,1509
195438,10,226,226,0,226,226,0,,,
195474,10,3648,1642,2006,3503,1574,1929,145,68,77
195526,10,2758,1141,1617,2725,1127,1598,33,14,19
195544,10,4348,1302,3046,3352,1077,2275,996,225,771
195580,10,95,82,13,70,57,13,25,25,0
195702,10,141,20,121,83,14,69,58,6,52
195720,10,3621,1337,2284,3092,1218,1874,529,119,410
195784,10,658,94,564,658,94,564,,,
195809,10,19663,8435,11228,12616,5468,7148,7047,2967,4080
195988,10,1698,731,967,636,307,329,1062,424,638
196006,10,3348,2148,1200,3057,2046,1011,291,102,189
196015,10,2836,1232,1604,2342,1064,1278,494,168,326
196024,10,2612,1185,1427,2036,1080,956,576,105,471
196033,10,1783,764,1019,1668,713,955,115,51,64
196042,10,9314,5508,3806,7401,4424,2977,1913,1084,829
196051,10,1803,919,884,1571,863,708,232,56,176
196060,10,16658,7200,9458,13760,6104,7656,2898,1096,1802
196079,10,18312,8823,9489,16551,7940,8611,1761,883,878
196088,10,32099,16606,15493,26541,13953,12588,5558,2653,2905
196097,10,25710,12181,13529,21993,10787,11206,3717,1394,2323
196103,10,1976,966,1010,1464,725,739,512,241,271
196112,10,2842,1689,1153,2005,1373,632,837,316,521
196121,10,6424,2493,3931,4883,1993,2890,1541,500,1041
196130,10,6445,2637,3808,5247,2182,3065,1198,455,743
196149,10,6690,2937,3753,6095,2752,3343,595,185,410
196158,10,3491,1399,2092,3242,1321,1921,249,78,171
196167,10,4184,1474,2710,4008,1402,2606,176,72,104
196176,10,6964,2417,4547,6047,2079,3968,917,338,579
196185,10,5430,2001,3429,4931,1876,3055,499,125,374
196194,10,6906,3212,3694,5922,2788,3134,984,424,560
196200,10,2427,893,1534,2203,837,1366,224,56,168
196219,10,3182,1336,1846,2917,1222,1695,265,114,151
196228,10,409,100,309,407,98,309,2,2,0
196237,10,4270,1758,2512,3465,1405,2060,805,353,452
196246,10,4474,1696,2778,3868,1471,2397,606,225,381
196255,10,2185,685,1500,1696,567,1129,489,118,371
196264,10,9407,3148,6259,3450,965,2485,5957,2183,3774
196291,10,1427,1229,198,1276,1097,179,151,132,19
196307,10,1431,525,906,1289,499,790,142,26,116
196389,10,1053,224,829,1045,222,823,8,2,6
196413,10,22698,10438,12260,20107,9270,10837,2591,1168,1423
196431,10,348,348,0,346,346,0,2,2,0
196440,10,16,16,0,16,16,0,,,
196468,10,4514,954,3560,3224,632,2592,1290,322,968
196565,10,4442,1893,2549,1074,518,556,3368,1375,1993
196583,10,67,67,0,67,67,0,,,
196592,10,11111,3182,7929,6564,2197,4367,4547,985,3562
196653,10,1022,140,882,341,42,299,681,98,583
196680,10,15833,8162,7671,,,,15833,8162,7671
196699,10,2912,1430,1482,989,472,517,1923,958,965
196866,10,2107,1164,943,2092,1157,935,15,7,8
196884,10,229,95,134,167,66,101,62,29,33
197018,10,2104,2104,0,2104,2104,0,,,
197027,10,943,756,187,931,747,184,12,9,3
197036,10,4393,3394,999,4393,3394,999,,,
197045,10,3861,1410,2451,2445,1007,1438,1416,403,1013
197133,10,2459,944,1515,2436,933,1503,23,11,12
197142,10,465,228,237,403,206,197,62,22,40
197151,10,4127,1053,3074,3989,1015,2974,138,38,100
197197,10,1949,686,1263,1660,632,1028,289,54,235
197221,10,102,76,26,102,76,26,,,
197230,10,357,156,201,351,153,198,6,3,3
197285,10,828,243,585,663,194,469,165,49,116
197294,10,8807,4145,4662,4222,2155,2067,4585,1990,2595
197337,10,66,1,65,63,1,62,3,0,3
197531,10,487,229,258,487,229,258,,,
197601,10,154,154,0,154,154,0,,,
197647,10,137,137,0,133,133,0,4,4,0
197674,10,242,242,0,241,241,0,1,1,0
197692,10,85,85,0,85,85,0,,,
197708,10,6056,2610,3446,5284,2282,3002,772,328,444
197735,10,991,991,0,991,991,0,,,
197744,10,206,206,0,194,194,0,12,12,0
197814,10,2314,825,1489,669,264,405,1645,561,1084
197850,10,3338,1208,2130,622,234,388,2716,974,1742
197869,10,20436,8650,11786,18223,7874,10349,2213,776,1437
197887,10,6473,2481,3992,1736,704,1032,4737,1777,2960
197911,10,1265,579,686,1068,554,514,197,25,172
197966,10,1741,562,1179,459,141,318,1282,421,861
197984,10,1501,796,705,1363,745,618,138,51,87
197993,10,168,0,168,158,0,158,10,0,10
198011,10,978,322,656,387,121,266,591,201,390
198039,10,2794,1083,1711,748,303,445,2046,780,1266
198066,10,759,472,287,739,459,280,20,13,7
198084,10,1678,641,1037,676,301,375,1002,340,662
198109,10,528,38,490,195,15,180,333,23,310
198118,10,3703,1487,2216,1231,553,678,2472,934,1538
198136,10,5272,2328,2944,4393,1929,2464,879,399,480
198154,10,14170,7016,7154,3241,1547,1694,10929,5469,5460
198206,10,1554,520,1034,576,238,338,978,282,696
198215,10,1172,557,615,1076,536,540,96,21,75
198233,10,4172,1814,2358,1234,571,663,2938,1243,1695
198251,10,5231,1833,3398,1421,542,879,3810,1291,2519
198260,10,17694,7409,10285,6631,2978,3653,11063,4431,6632
198303,10,886,524,362,800,486,314,86,38,48
198321,10,1946,658,1288,594,216,378,1352,442,910
198330,10,3611,1335,2276,1494,574,920,2117,761,1356
198367,10,2701,1079,1622,769,370,399,1932,709,1223
198376,10,3921,1376,2545,1354,518,836,2567,858,1709
198385,10,1927,899,1028,1927,899,1028,,,
198419,10,18023,8161,9862,17425,7850,9575,598,311,287
198455,10,4294,1628,2666,757,351,406,3537,1277,2260
198464,10,27151,10753,16398,20393,8489,11904,6758,2264,4494
198491,10,1313,333,980,219,38,181,1094,295,799
198507,10,2149,902,1247,1735,777,958,414,125,289
198516,10,7123,2850,4273,6891,2736,4155,232,114,118
198534,10,10233,3925,6308,3738,1481,2257,6495,2444,4051
198543,10,6787,2065,4722,4416,1301,3115,2371,764,1607
198552,10,8270,2944,5326,2260,981,1279,6010,1963,4047
198561,10,3144,1016,2128,1906,713,1193,1238,303,935
198570,10,5558,1957,3601,1373,546,827,4185,1411,2774
198598,10,826,441,385,645,389,256,181,52,129
198613,10,1167,577,590,1124,561,563,43,16,27
198622,10,10067,4194,5873,3546,1634,1912,6521,2560,3961
198640,10,995,327,668,213,67,146,782,260,522
198668,10,1286,439,847,414,187,227,872,252,620
198677,10,26,13,13,17,9,8,9,4,5
198695,10,5981,2574,3407,5832,2523,3309,149,51,98
198710,10,1876,694,1182,557,218,339,1319,476,843
198729,10,1359,438,921,449,136,313,910,302,608
198756,10,1093,488,605,1029,467,562,64,21,43
198774,10,4282,1542,2740,1425,562,863,2857,980,1877
198808,10,855,299,556,821,294,527,34,5,29
198817,10,2199,792,1407,697,289,408,1502,503,999
198835,10,2354,877,1477,1765,701,1064,589,176,413
198844,10,105,1,104,105,1,104,,,
198862,10,839,497,342,814,485,329,25,12,13
198871,10,434,334,100,424,325,99,10,9,1
198899,10,1032,522,510,935,487,448,97,35,62
198905,10,842,277,565,212,42,170,630,235,395
198914,10,783,336,447,238,90,148,545,246,299
198923,10,1100,438,662,227,98,129,873,340,533
198950,10,1587,30,1557,1361,10,1351,226,20,206
198969,10,1811,905,906,1585,827,758,226,78,148
198978,10,517,63,454,496,62,434,21,1,20
198987,10,3456,1335,2121,842,353,489,2614,982,1632
199005,10,6,0,6,6,0,6,,,
199023,10,702,345,357,247,120,127,455,225,230
199032,10,972,484,488,843,431,412,129,53,76
199069,10,2239,717,1522,1304,513,791,935,204,731
199078,10,152,17,135,149,17,132,3,0,3
199087,10,2645,981,1664,691,287,404,1954,694,1260
199102,10,13487,5117,8370,11484,4188,7296,2003,929,1074
199111,10,2914,1222,1692,2535,1046,1489,379,176,203
199120,10,31705,12594,19111,28484,11180,17304,3221,1414,1807
199139,10,29551,14578,14973,22968,11665,11303,6583,2913,3670
199148,10,17978,5924,12054,13509,4528,8981,4469,1396,3073
199157,10,7553,2230,5323,5969,1813,4156,1584,417,1167
199184,10,1104,449,655,1072,435,637,32,14,18
199193,10,36700,18643,18057,31047,15675,15372,5653,2968,2685
199209,10,1337,659,678,1101,578,523,236,81,155
199218,10,17843,6042,11801,13561,4907,8654,4282,1135,3147
199263,10,329,87,242,72,13,59,257,74,183
199272,10,713,349,364,580,320,260,133,29,104
199281,10,7666,2678,4988,4802,1814,2988,2864,864,2000
199306,10,1076,415,661,796,327,469,280,88,192
199324,10,1150,437,713,148,62,86,1002,375,627
199333,10,7144,2813,4331,2753,1140,1613,4391,1673,2718
199412,10,1873,628,1245,1367,488,879,506,140,366
199421,10,2469,848,1621,568,194,374,1901,654,1247
199449,10,2290,786,1504,654,252,402,1636,534,1102
199458,10,133,92,41,130,90,40,3,2,1
199467,10,569,177,392,117,36,81,452,141,311
199476,10,1901,528,1373,548,154,394,1353,374,979
199485,10,1712,601,1111,417,179,238,1295,422,873
199494,10,6754,2517,4237,1759,724,1035,4995,1793,3202
199582,10,1108,548,560,868,413,455,240,135,105
199607,10,469,15,454,280,0,280,189,15,174
199625,10,1590,518,1072,443,159,284,1147,359,788
199634,10,3778,1408,2370,1127,497,630,2651,911,1740
199643,10,1067,500,567,900,434,466,167,66,101
199689,10,186,7,179,148,1,147,38,6,32
199698,10,809,353,456,700,338,362,109,15,94
199722,10,1228,422,806,372,161,211,856,261,595
199731,10,2256,838,1418,505,187,318,1751,651,1100
199740,10,2319,716,1603,435,144,291,1884,572,1312
199759,10,2764,1948,816,1267,963,304,1497,985,512
199768,10,2797,1093,1704,896,399,497,1901,694,1207
199786,10,3939,1519,2420,1216,508,708,2723,1011,1712
199795,10,888,356,532,257,95,162,631,261,370
199838,10,2814,892,1922,928,319,609,1886,573,1313
199847,10,8963,3876,5087,7952,3537,4415,1011,339,672
199856,10,21551,9711,11840,6790,3438,3352,14761,6273,8488
199865,10,793,267,526,774,267,507,19,0,19
199883,10,163,19,144,163,19,144,,,
199892,10,2732,1037,1695,753,345,408,1979,692,1287
199908,10,1749,640,1109,527,208,319,1222,432,790
199926,10,2321,968,1353,661,322,339,1660,646,1014
199953,10,1779,603,1176,372,126,246,1407,477,930
199962,10,3396,1276,2120,3170,1190,1980,226,86,140
199971,10,70,43,27,70,43,27,,,
199980,10,44,41,3,44,41,3,,,
199999,10,5004,1194,3810,4232,1036,3196,772,158,614
200004,10,11635,4797,6838,8896,3775,5121,2739,1022,1717
200013,10,496,85,411,275,47,228,221,38,183
200022,10,3771,1972,1799,1821,1047,774,1950,925,1025
200059,10,1473,664,809,985,462,523,488,202,286
200086,10,172,52,120,107,36,71,65,16,49
200110,10,51,1,50,51,1,50,,,
200156,10,1242,646,596,1054,578,476,188,68,120
200192,10,1679,683,996,416,184,232,1263,499,764
200208,10,316,87,229,154,59,95,162,28,134
200217,10,3652,1416,2236,2462,947,1515,1190,469,721
200226,10,1123,407,716,603,260,343,520,147,373
200253,10,2777,973,1804,1882,682,1200,895,291,604
200280,10,13876,7007,6869,8777,4372,4405,5099,2635,2464
200305,10,2942,1667,1275,1514,1006,508,1428,661,767
200314,10,1080,406,674,297,113,184,783,293,490
200332,10,12242,6007,6235,9909,4940,4969,2333,1067,1266
200341,10,924,327,597,514,203,311,410,124,286
200466,10,257,111,146,200,97,103,57,14,43
200484,10,289,165,124,230,126,104,59,39,20
200527,10,599,233,366,461,186,275,138,47,91
200554,10,506,177,329,473,163,310,33,14,19
200572,10,1658,685,973,828,361,467,830,324,506
200590,10,152,27,125,143,23,120,9,4,5
200697,10,1048,859,189,502,429,73,546,430,116
200785,10,369,47,322,176,21,155,193,26,167
200800,10,13465,6717,6748,9820,5087,4733,3645,1630,2015
200846,10,1416,570,846,507,188,319,909,382,527
200873,10,86,49,37,53,24,29,33,25,8
201034,10,610,297,313,127,39,88,483,258,225
201061,10,263,68,195,253,64,189,10,4,6
201098,10,45,18,27,26,7,19,19,11,8
201104,10,4174,1729,2445,2699,1136,1563,1475,593,882
201131,10,115,36,79,80,3,77,35,33,2
201140,10,141,124,17,74,74,0,67,50,17
201159,10,166,122,44,92,72,20,74,50,24
201177,10,250,22,228,119,12,107,131,10,121
201195,10,3220,1363,1857,2986,1275,1711,234,88,146
201283,10,723,254,469,305,137,168,418,117,301
201371,10,745,368,377,717,354,363,28,14,14
201432,10,1845,687,1158,882,338,544,963,349,614
201441,10,16920,7184,9736,13036,5539,7497,3884,1645,2239
201469,10,534,113,421,415,102,313,119,11,108
201478,10,183,83,100,128,37,91,55,46,9
201496,10,450,282,168,450,282,168,,,
201539,10,92,15,77,66,10,56,26,5,21
201548,10,2617,1058,1559,2360,948,1412,257,110,147
201645,10,12201,5908,6293,11080,5442,5638,1121,466,655
201654,10,4960,2240,2720,4030,1848,2182,930,392,538
201672,10,2614,791,1823,454,146,308,2160,645,1515
201681,10,37,5,32,37,5,32,,,
201690,10,5434,1623,3811,3129,1023,2106,2305,600,1705
201751,10,129,44,85,39,15,24,90,29,61
201803,10,34,4,30,34,4,30,,,
201821,10,866,71,795,661,55,606,205,16,189
201867,10,101,16,85,101,16,85,,,
201885,10,41155,19134,22021,31186,15510,15676,9969,3624,6345
201928,10,8404,3271,5133,1957,893,1064,6447,2378,4069
201946,10,7448,3003,4445,1118,466,652,6330,2537,3793
201955,10,6569,2568,4001,2805,1200,1605,3764,1368,2396
201964,10,1600,676,924,791,361,430,809,315,494
201973,10,4703,1575,3128,857,307,550,3846,1268,2578
202046,10,584,163,421,568,152,416,16,11,5
202073,10,341,167,174,337,165,172,4,2,2
202134,10,14385,6635,7750,10722,5115,5607,3663,1520,2143
202152,10,96,11,85,96,11,85,,,
202170,10,972,296,676,958,294,664,14,2,12
202222,10,25129,11170,13959,5616,2633,2983,19513,8537,10976
202356,10,15764,5987,9777,3969,1763,2206,11795,4224,7571
202435,10,110,17,93,71,14,57,39,3,36
202453,10,69,59,10,69,59,10,,,
202480,10,11674,6052,5622,10596,5541,5055,1078,511,567
202514,10,540,322,218,482,292,190,58,30,28
202523,10,2416,1154,1262,2400,1147,1253,16,7,9
202648,10,4353,1678,2675,1119,495,624,3234,1183,2051
202657,10,365,96,269,76,14,62,289,82,207
202763,10,4869,1742,3127,2973,993,1980,1896,749,1147
202806,10,8044,3061,4983,3391,1256,2135,4653,1805,2848
202888,10,50,6,44,35,6,29,15,0,15
202903,10,443,235,208,171,72,99,272,163,109
202912,10,342,15,327,139,9,130,203,6,197
202949,10,154,145,9,154,145,9,,,
202985,10,17,1,16,9,1,8,8,0,8
203030,10,35,1,34,35,1,34,,,
203067,10,318,119,199,248,102,146,70,17,53
203085,10,1086,560,526,997,530,467,89,30,59
203128,10,1018,466,552,704,343,361,314,123,191
203146,10,396,366,30,396,366,30,,,
203155,10,1951,1000,951,1498,836,662,453,164,289
203234,10,69,3,66,69,3,66,,,
203289,10,40,28,12,40,28,12,,,
203331,10,30364,9351,21013,9182,2735,6447,21182,6616,14566
203368,10,2922,1508,1414,2577,1355,1222,345,153,192
203386,10,2643,196,2447,1756,139,1617,887,57,830
203438,10,112,0,112,51,0,51,61,0,61
203447,10,1723,637,1086,192,64,128,1531,573,958
203456,10,1024,350,674,20,7,13,1004,343,661
203465,10,3446,1275,2171,976,402,574,2470,873,1597
203474,10,1734,681,1053,343,128,215,1391,553,838
203483,10,1940,795,1145,426,190,236,1514,605,909
203492,10,1315,370,945,247,36,211,1068,334,734
203517,10,25854,9548,16306,19791,7412,12379,6063,2136,3927
203526,10,2095,762,1333,318,136,182,1777,626,1151
203535,10,1885,826,1059,1877,824,1053,8,2,6
203544,10,832,139,693,567,75,492,265,64,201
203580,10,906,501,405,717,407,310,189,94,95
203599,10,4620,1766,2854,1248,551,697,3372,1215,2157
203614,10,414,120,294,414,120,294,,,
203678,10,3533,1289,2244,558,215,343,2975,1074,1901
203720,10,136,78,58,111,76,35,25,2,23
203739,10,44,7,37,37,5,32,7,2,5
203748,10,9170,3444,5726,2146,846,1300,7024,2598,4426
203757,10,1136,457,679,867,380,487,269,77,192
203775,10,1199,506,693,815,370,445,384,136,248
203845,10,1198,579,619,1107,541,566,91,38,53
203881,10,2767,1140,1627,425,163,262,2342,977,1365
203942,10,32,17,15,32,17,15,,,
203960,10,1261,156,1105,413,58,355,848,98,750
203997,10,136,41,95,84,21,63,52,20,32
204006,10,2268,1046,1222,1647,746,901,621,300,321
204015,10,1269,559,710,785,351,434,484,208,276
204024,10,19107,8769,10338,17358,8252,9106,1749,517,1232
204121,10,72,0,72,30,0,30,42,0,42
204158,10,127,36,91,127,36,91,,,
204176,10,766,97,669,603,80,523,163,17,146
204185,10,2130,1096,1034,2021,1035,986,109,61,48
204194,10,1941,729,1212,1494,591,903,447,138,309
204200,10,2027,746,1281,1211,528,683,816,218,598
204255,10,1726,706,1020,542,262,280,1184,444,740
204264,10,2117,784,1333,1507,679,828,610,105,505
204334,10,137,1,136,1,0,1,136,1,135
204422,10,2439,944,1495,698,309,389,1741,635,1106
204431,10,46,9,37,46,9,37,,,
204440,10,4030,1407,2623,623,410,213,3407,997,2410
204459,10,10,9,1,10,9,1,,,
204468,10,1444,664,780,958,501,457,486,163,323
204477,10,1001,469,532,978,459,519,23,10,13
204486,10,2615,2185,430,2441,2079,362,174,106,68
204501,10,2992,1226,1766,2984,1222,1762,8,4,4
204608,10,374,336,38,374,336,38,,,
204617,10,1276,524,752,910,423,487,366,101,265
204635,10,3015,1565,1450,2807,1464,1343,208,101,107
204662,10,446,185,261,398,163,235,48,22,26
204671,10,818,358,460,672,293,379,146,65,81
204680,10,828,369,459,652,294,358,176,75,101
204699,10,900,463,437,734,380,354,166,83,83
204705,10,2263,1118,1145,1854,918,936,409,200,209
204714,10,81,3,78,81,3,78,,,
204723,10,303,232,71,303,232,71,,,
204769,10,124,7,117,124,7,117,,,
204778,10,65,1,64,65,1,64,,,
204796,10,60540,29012,31528,52402,25082,27320,8138,3930,4208
204802,10,1143,420,723,249,90,159,894,330,564
204820,10,1928,664,1264,566,183,383,1362,481,881
204839,10,2006,672,1334,437,142,295,1569,530,1039
204848,10,1994,721,1273,479,167,312,1515,554,961
204857,10,24145,9606,14539,17802,7631,10171,6343,1975,4368
204866,10,1923,604,1319,428,98,330,1495,506,989
204884,10,149,7,142,149,7,142,,,
204893,10,43,9,34,20,7,13,23,2,21
204909,10,1410,617,793,1398,611,787,12,6,6
204936,10,2458,963,1495,2137,850,1287,321,113,208
204945,10,7559,3838,3721,1806,769,1037,5753,3069,2684
204963,10,47,3,44,47,3,44,,,
204981,10,108,24,84,19,2,17,89,22,67
204990,10,187,86,101,102,54,48,85,32,53
205027,10,161,159,2,56,56,0,105,103,2
205054,10,404,41,363,404,41,363,,,
205090,10,69,8,61,9,1,8,60,7,53
205124,10,74,74,0,73,73,0,1,1,0
205142,10,121,39,82,116,39,77,5,0,5
205179,10,441,74,367,426,73,353,15,1,14
205203,10,1800,649,1151,1044,428,616,756,221,535
205391,10,178,33,145,98,18,80,80,15,65
205443,10,3297,1357,1940,2194,935,1259,1103,422,681
205470,10,17591,7958,9633,3385,1700,1685,14206,6258,7948
205559,10,26,3,23,26,3,23,,,
205841,10,10031,4266,5765,2516,1233,1283,7515,3033,4482
205887,10,403,50,353,403,50,353,,,
205957,10,3656,1572,2084,2632,1124,1508,1024,448,576
205966,10,1947,633,1314,432,139,293,1515,494,1021
206011,10,2207,1270,937,489,254,235,1718,1016,702
206039,10,40,1,39,29,0,29,11,1,10
206048,10,3044,1407,1637,1726,913,813,1318,494,824
206084,10,15545,7236,8309,12338,5849,6489,3207,1387,1820
206154,10,21,17,4,,,,21,17,4
206172,10,40,15,25,40,15,25,,,
206181,10,134,37,97,51,4,47,83,33,50
206279,10,787,317,470,336,128,208,451,189,262
206288,10,467,282,185,324,196,128,143,86,57
206321,10,85,26,59,46,2,44,39,24,15
206349,10,950,84,866,586,45,541,364,39,325
206394,10,47,11,36,20,6,14,27,5,22
206437,10,2309,888,1421,1725,753,972,584,135,449
206446,10,1556,538,1018,433,197,236,1123,341,782
206491,10,656,295,361,509,234,275,147,61,86
206507,10,1046,468,578,995,444,551,51,24,27
206516,10,121,64,57,92,47,45,29,17,12
206525,10,1299,614,685,1227,583,644,72,31,41
206589,10,1967,955,1012,1958,953,1005,9,2,7
206604,10,9678,4389,5289,6346,2782,3564,3332,1607,1725
206613,10,1294,521,773,729,274,455,565,247,318
206622,10,6114,2618,3496,5075,2213,2862,1039,405,634
206695,10,11071,4801,6270,7971,3589,4382,3100,1212,1888
206817,10,299,149,150,255,126,129,44,23,21
206835,10,848,445,403,642,363,279,206,82,124
206862,10,1507,688,819,1221,571,650,286,117,169
206905,10,300,175,125,49,22,27,251,153,98
206914,10,3418,1200,2218,2085,738,1347,1333,462,871
206923,10,1823,590,1233,911,348,563,912,242,670
206932,10,441,32,409,183,25,158,258,7,251
206941,10,12250,4548,7702,8479,3145,5334,3771,1403,2368
206996,10,1687,504,1183,738,250,488,949,254,695
207041,10,3376,1285,2091,2506,1013,1493,870,272,598
207050,10,1238,423,815,629,237,392,609,186,423
207069,10,1735,641,1094,496,222,274,1239,419,820
207087,10,27,1,26,27,1,26,,,
207102,10,83,21,62,83,21,62,,,
207157,10,281,160,121,209,127,82,72,33,39
207209,10,1903,742,1161,1748,672,1076,155,70,85
207236,10,2282,699,1583,859,317,542,1423,382,1041
207254,10,639,574,65,639,574,65,,,
207263,10,6702,2360,4342,4319,1619,2700,2383,741,1642
207281,10,3271,1274,1997,1267,530,737,2004,744,1260
207290,10,1717,684,1033,1174,542,632,543,142,401
207306,10,1852,729,1123,1310,545,765,542,184,358
207315,10,1459,633,826,966,403,563,493,230,263
207324,10,2537,1220,1317,2081,991,1090,456,229,227
207342,10,3389,931,2458,2860,817,2043,529,114,415
207351,10,1242,503,739,862,401,461,380,102,278
207388,10,25372,12219,13153,20219,9570,10649,5153,2649,2504
207397,10,4340,1551,2789,950,422,528,3390,1129,2261
207403,10,1399,622,777,1286,556,730,113,66,47
207449,10,11353,4099,7254,3310,1338,1972,8043,2761,5282
207458,10,2550,946,1604,2285,844,1441,265,102,163
207500,10,28308,13294,15014,22464,10617,11847,5844,2677,3167
207564,10,2357,1550,807,1385,1052,333,972,498,474
207582,10,5051,2111,2940,3326,1366,1960,1725,745,980
207661,10,3155,1237,1918,1995,783,1212,1160,454,706
207670,10,6702,2331,4371,2097,815,1282,4605,1516,3089
207704,10,206,1,205,103,1,102,103,0,103
207722,10,825,293,532,756,271,485,69,22,47
207740,10,1551,506,1045,707,260,447,844,246,598
207786,10,22,1,21,22,1,21,,,
207847,10,5479,2178,3301,2763,1184,1579,2716,994,1722
207856,10,425,238,187,371,208,163,54,30,24
207865,10,4777,1732,3045,3550,1375,2175,1227,357,870
207935,10,14391,5242,9149,4496,1863,2633,9895,3379,6516
207962,10,793,679,114,793,679,114,,,
207971,10,3769,1891,1878,3288,1610,1678,481,281,200
208035,10,1338,430,908,514,230,284,824,200,624
208044,10,48,9,39,48,9,39,,,
208053,10,267,140,127,25,13,12,242,127,115
208275,10,1227,555,672,553,235,318,674,320,354
208318,10,4155,1913,2242,1655,793,862,2500,1120,1380
208390,10,7642,3452,4190,3422,1516,1906,4220,1936,2284
208406,10,4638,2331,2307,1693,788,905,2945,1543,1402
208415,10,714,311,403,262,96,166,452,215,237
208433,10,73,3,70,73,3,70,,,
208479,10,487,62,425,487,62,425,,,
208512,10,510,59,451,510,59,451,,,
208637,10,196,47,149,,,,196,47,149
208646,10,2674,1065,1609,1587,657,930,1087,408,679
208725,10,38,22,16,34,20,14,4,2,2
208822,10,4028,1508,2520,2978,1150,1828,1050,358,692
208859,10,40,6,34,40,6,34,,,
209038,10,6745,3204,3541,2717,1294,1423,4028,1910,2118
209056,10,3595,1169,2426,3209,1062,2147,386,107,279
209065,10,1754,611,1143,1616,572,1044,138,39,99
209074,10,4242,1957,2285,1748,887,861,2494,1070,1424
209083,10,55,15,40,55,15,40,,,
209153,10,26,4,22,26,4,22,,,
209205,10,36,2,34,36,2,34,,,
209241,10,120,118,2,83,83,0,37,35,2
209250,10,6012,3381,2631,1915,851,1064,4097,2530,1567
209287,10,608,335,273,460,263,197,148,72,76
209296,10,374,53,321,340,48,292,34,5,29
209409,10,699,291,408,616,264,352,83,27,56
209490,10,2870,884,1986,2160,682,1478,710,202,508
209506,10,4911,2375,2536,2164,1146,1018,2747,1229,1518
209542,10,34292,17323,16969,23189,11820,11369,11103,5503,5600
209551,10,23163,10292,12871,21429,9477,11952,1734,815,919
209603,10,487,115,372,464,109,355,23,6,17
209612,10,3559,1148,2411,3215,1049,2166,344,99,245
209667,10,58,5,53,58,5,53,,,
209676,10,97,9,88,97,9,88,,,
209694,10,37,7,30,37,7,30,,,
209700,10,208,31,177,208,31,177,,,
209719,10,66,0,66,66,0,66,,,
209746,10,19400,8251,11149,7428,3291,4137,11972,4960,7012
209807,10,21609,8975,12634,13642,5634,8008,7967,3341,4626
209825,10,3793,1374,2419,3425,1239,2186,368,135,233
209922,10,1534,646,888,1492,628,864,42,18,24
209940,10,3423,1402,2021,1216,483,733,2207,919,1288
210146,10,5204,1882,3322,2581,977,1604,2623,905,1718
210155,10,1443,555,888,819,373,446,624,182,442
210234,10,1329,600,729,665,343,322,664,257,407
210270,10,2325,865,1460,768,324,444,1557,541,1016
210304,10,444,167,277,413,155,258,31,12,19
210331,10,963,433,530,726,307,419,237,126,111
210368,10,817,559,258,56,25,31,761,534,227
210401,10,1909,825,1084,1850,805,1045,59,20,39
210429,10,3751,1289,2462,3109,1070,2039,642,219,423
210438,10,1096,376,720,517,241,276,579,135,444
210492,10,285,141,144,265,131,134,20,10,10
210571,10,1498,640,858,1281,559,722,217,81,136
210599,10,838,422,416,838,422,416,,,
210605,10,10467,4861,5606,3420,1652,1768,7047,3209,3838
210669,10,1353,635,718,1322,624,698,31,11,20
210711,10,51,2,49,51,2,49,,,
210739,10,2991,1020,1971,2307,795,1512,684,225,459
210748,10,64,2,62,34,0,34,30,2,28
210775,10,2484,880,1604,1933,746,1187,551,134,417
210784,10,156,1,155,131,1,130,25,0,25
211006,10,348,322,26,342,321,21,6,1,5
211024,10,552,288,264,327,169,158,225,119,106
211079,10,1720,630,1090,515,228,287,1205,402,803
211088,10,3026,981,2045,2175,713,1462,851,268,583
211130,10,160,81,79,101,53,48,59,28,31
211273,10,1742,63,1679,1672,50,1622,70,13,57
211291,10,3787,1813,1974,3760,1809,1951,27,4,23
211307,10,6162,2579,3583,2045,1003,1042,4117,1576,2541
211316,10,98,2,96,72,2,70,26,0,26
211334,10,30,0,30,30,0,30,,,
211343,10,2496,934,1562,954,417,537,1542,517,1025
211352,10,1613,596,1017,1180,460,720,433,136,297
211431,10,2104,289,1815,1233,188,1045,871,101,770
211440,10,16002,8973,7029,15006,8385,6621,996,588,408
211468,10,1324,116,1208,859,71,788,465,45,420
211477,10,943,329,614,197,92,105,746,237,509
211556,10,2387,589,1798,1853,479,1374,534,110,424
211583,10,1420,524,896,1041,435,606,379,89,290
211608,10,697,232,465,621,215,406,76,17,59
211635,10,78,13,65,78,13,65,,,
211802,10,155,39,116,155,39,116,,,
211893,10,151,84,67,151,84,67,,,
211927,10,7992,3026,4966,1953,926,1027,6039,2100,3939
211981,10,2178,801,1377,1576,632,944,602,169,433
212009,10,2137,888,1249,2096,873,1223,41,15,26
212045,10,198,49,149,196,49,147,2,0,2
212054,10,22344,10174,12170,17263,8478,8785,5081,1696,3385
212106,10,8107,2934,5173,7742,2822,4920,365,112,253
212115,10,5143,2168,2975,4195,1845,2350,948,323,625
212133,10,5769,2365,3404,2310,992,1318,3459,1373,2086
212197,10,2021,793,1228,1756,697,1059,265,96,169
212230,10,37,2,35,33,2,31,4,0,4
212267,10,87,1,86,50,0,50,37,1,36
212276,10,83,4,79,60,3,57,23,1,22
212294,10,66,1,65,56,1,55,10,0,10
212300,10,67,1,66,61,1,60,6,0,6
212328,10,95,6,89,58,6,52,37,0,37
212337,10,102,4,98,56,1,55,46,3,43
212355,10,141,5,136,92,2,90,49,3,46
212382,10,138,1,137,91,1,90,47,0,47
212391,10,50,4,46,35,3,32,15,1,14
212434,10,136,117,19,136,117,19,,,
212577,10,1990,926,1064,1984,923,1061,6,3,3
212601,10,4665,1989,2676,3725,1642,2083,940,347,593
212656,10,1232,642,590,1031,542,489,201,100,101
212674,10,2854,1362,1492,2238,1088,1150,616,274,342
212753,10,86,3,83,51,1,50,35,2,33
212771,10,377,54,323,125,22,103,252,32,220
212805,10,2316,1198,1118,2147,1111,1036,169,87,82
212832,10,2091,572,1519,1766,431,1335,325,141,184
212869,10,910,167,743,591,124,467,319,43,276
212878,10,12576,4113,8463,3338,1275,2063,9238,2838,6400
212911,10,1421,647,774,1419,646,773,2,1,1
212975,10,94,72,22,94,72,22,,,
212984,10,2912,658,2254,1995,492,1503,917,166,751
212993,10,80,35,45,68,31,37,12,4,8
213011,10,2361,616,1745,1181,354,827,1180,262,918
213020,10,8816,3431,5385,6837,2605,4232,1979,826,1153
213163,10,342,47,295,304,45,259,38,2,36
213181,10,350,28,322,301,24,277,49,4,45
213233,10,586,466,120,478,387,91,108,79,29
213251,10,1212,567,645,1156,537,619,56,30,26
213303,10,1131,515,616,837,457,380,294,58,236
213321,10,1993,916,1077,1669,822,847,324,94,230
213330,10,31,0,31,31,0,31,,,
213349,10,7455,3077,4378,6233,2696,3537,1222,381,841
213358,10,2068,773,1295,933,334,599,1135,439,696
213367,10,4049,1337,2712,2280,831,1449,1769,506,1263
213376,10,1868,753,1115,1382,615,767,486,138,348
213385,10,2729,1364,1365,2712,1355,1357,17,9,8
213400,10,2066,1030,1036,923,447,476,1143,583,560
213446,10,73,28,45,44,15,29,29,13,16
213455,10,88,3,85,51,3,48,37,0,37
213473,10,90,12,78,54,2,52,36,10,26
213491,10,55,1,54,17,1,16,38,0,38
213507,10,2080,914,1166,1804,796,1008,276,118,158
213525,10,6242,2265,3977,1922,909,1013,4320,1356,2964
213534,10,311,125,186,300,122,178,11,3,8
213543,10,7394,3994,3400,6611,3601,3010,783,393,390
213570,10,419,60,359,419,60,359,,,
213589,10,299,263,36,264,231,33,35,32,3
213598,10,1824,617,1207,1685,574,1111,139,43,96
213622,10,112,18,94,89,17,72,23,1,22
213631,10,263,123,140,82,38,44,181,85,96
213659,10,4220,1439,2781,1345,546,799,2875,893,1982
213668,10,1059,502,557,1052,500,552,7,2,5
213774,10,583,165,418,341,93,248,242,72,170
213826,10,2729,851,1878,2449,779,1670,280,72,208
213914,10,215,19,196,215,19,196,,,
213932,10,174,23,151,174,23,151,,,
213987,10,2801,1124,1677,2477,1018,1459,324,106,218
213996,10,3231,1198,2033,2546,959,1587,685,239,446
214023,10,11,3,8,10,2,8,1,1,0
214041,10,6775,2650,4125,4829,2031,2798,1946,619,1327
214069,10,2242,719,1523,1617,574,1043,625,145,480
214111,10,8596,3454,5142,2540,1241,1299,6056,2213,3843
214148,10,368,1,367,354,1,353,14,0,14
214157,10,2533,924,1609,2042,790,1252,491,134,357
214166,10,2752,933,1819,1066,326,740,1686,607,1079
214175,10,1959,771,1188,1904,746,1158,55,25,30
214272,10,2155,751,1404,1501,545,956,654,206,448
214290,10,628,570,58,628,570,58,,,
214379,10,8484,3155,5329,3018,1352,1666,5466,1803,3663
214476,10,39,7,32,36,6,30,3,1,2
214528,10,227,212,15,163,152,11,64,60,4
214564,10,1165,234,931,1070,223,847,95,11,84
214582,10,651,71,580,332,37,295,319,34,285
214591,10,3295,2114,1181,3066,1959,1107,229,155,74
214607,10,271,178,93,99,72,27,172,106,66
214625,10,460,275,185,391,244,147,69,31,38
214634,10,281,83,198,179,54,125,102,29,73
214643,10,368,237,131,337,218,119,31,19,12
214652,10,875,475,400,824,449,375,51,26,25
214670,10,888,510,378,780,463,317,108,47,61
214689,10,2577,1360,1217,2499,1311,1188,78,49,29
214698,10,522,289,233,487,276,211,35,13,22
214704,10,2077,1229,848,1873,1130,743,204,99,105
214713,10,4572,2739,1833,3994,2432,1562,578,307,271
214731,10,1196,729,467,1095,665,430,101,64,37
214740,10,366,204,162,306,185,121,60,19,41
214759,10,424,192,232,396,175,221,28,17,11
214768,10,473,253,220,452,243,209,21,10,11
214777,10,50028,26390,23638,48270,25337,22933,1758,1053,705
214786,10,363,223,140,338,211,127,25,12,13
214795,10,670,275,395,574,232,342,96,43,53
214801,10,3090,1811,1279,2823,1657,1166,267,154,113
214810,10,623,228,395,553,204,349,70,24,46
214829,10,718,463,255,581,381,200,137,82,55
214883,10,856,199,657,172,39,133,684,160,524
214892,10,243,101,142,243,101,142,,,
214944,10,515,451,64,377,337,40,138,114,24
214971,10,172,53,119,154,47,107,18,6,12
215008,10,52,51,1,52,51,1,,,
215044,10,145,20,125,145,20,125,,,
215053,10,245,69,176,224,62,162,21,7,14
215062,10,28201,12366,15835,23559,10434,13125,4642,1932,2710
215105,10,1313,450,863,1230,420,810,83,30,53
215114,10,1031,481,550,795,383,412,236,98,138
215123,10,3036,1146,1890,2906,1112,1794,130,34,96
215239,10,11636,3832,7804,3807,1445,2362,7829,2387,5442
215266,10,1074,490,584,1014,473,541,60,17,43
215275,10,1328,556,772,1268,522,746,60,34,26
215284,10,2043,1156,887,1996,1131,865,47,25,22
215293,10,33767,14131,19636,26630,11171,15459,7137,2960,4177
215309,10,23,3,20,14,2,12,9,1,8
215336,10,24,1,23,24,1,23,,,
215381,10,541,503,38,541,503,38,,,
215390,10,372,102,270,91,24,67,281,78,203
215415,10,1066,669,397,887,568,319,179,101,78
215424,10,223,122,101,185,100,85,38,22,16
215442,10,3288,1162,2126,2340,838,1502,948,324,624
215479,10,64,9,55,64,9,55,,,
215530,10,40,0,40,36,0,36,4,0,4
215585,10,4533,1586,2947,919,406,513,3614,1180,2434
215594,10,259,41,218,194,33,161,65,8,57
215619,10,48,15,33,39,12,27,9,3,6
215637,10,168,75,93,168,75,93,,,
215655,10,3431,1837,1594,2750,1535,1215,681,302,379
215682,10,417,387,30,417,387,30,,,
215691,10,754,288,466,452,201,251,302,87,215
215743,10,2857,1045,1812,1702,619,1083,1155,426,729
215770,10,7861,3200,4661,5850,2499,3351,2011,701,1310
215798,10,1536,853,683,1430,804,626,106,49,57
215813,10,86,67,19,57,57,0,29,10,19
215886,10,33,10,23,16,6,10,17,4,13
215929,10,4731,1990,2741,3949,1660,2289,782,330,452
215947,10,1988,683,1305,1770,620,1150,218,63,155
215974,10,422,60,362,315,42,273,107,18,89
215983,10,23,5,18,23,5,18,,,
215992,10,118,46,72,117,46,71,1,0,1
216010,10,5162,2401,2761,4203,2027,2176,959,374,585
216038,10,8221,3327,4894,6935,2957,3978,1286,370,916
216047,10,158,152,6,132,132,0,26,20,6
216074,10,89,2,87,56,2,54,33,0,33
216083,10,272,97,175,248,95,153,24,2,22
216162,10,337,27,310,337,27,310,,,
216223,10,40,3,37,40,3,37,,,
216278,10,2231,948,1283,2133,905,1228,98,43,55
216287,10,1625,790,835,1625,790,835,,,
216296,10,1312,1189,123,1282,1162,120,30,27,3
216311,10,123,123,0,123,123,0,,,
216339,10,33196,14232,18964,28908,12429,16479,4288,1803,2485
216348,10,28,26,2,5,5,0,23,21,2
216357,10,907,436,471,881,425,456,26,11,15
216366,10,8286,2222,6064,6136,1773,4363,2150,449,1701
216436,10,105,93,12,105,93,12,,,
216445,10,101,96,5,101,96,5,,,
216454,10,73,66,7,73,66,7,,,
216463,10,254,182,72,53,40,13,201,142,59
216524,10,1527,793,734,1502,778,724,25,15,10
216542,10,583,273,310,449,217,232,134,56,78
216551,10,84,67,17,82,65,17,2,2,0
216579,10,93,4,89,93,4,89,,,
216597,10,10383,4800,5583,8296,3772,4524,2087,1028,1059
216630,10,33,4,29,33,4,29,,,
216667,10,1151,603,548,1138,594,544,13,9,4
216694,10,1366,564,802,1157,489,668,209,75,134
216746,10,52,46,6,41,36,5,11,10,1
216764,10,17275,6780,10495,13579,5435,8144,3696,1345,2351
216773,10,106,15,91,106,15,91,,,
216807,10,1211,533,678,1046,490,556,165,43,122
216816,10,986,653,333,245,174,71,741,479,262
216825,10,4171,1427,2744,1340,522,818,2831,905,1926
216852,10,5416,1862,3554,4081,1620,2461,1335,242,1093
216931,10,5207,1611,3596,2338,1026,1312,2869,585,2284
216940,10,278,278,0,278,278,0,,,
217013,10,1360,314,1046,607,146,461,753,168,585
217040,10,37,37,0,37,37,0,,,
217059,10,3656,1527,2129,3034,1290,1744,622,237,385
217077,10,551,194,357,551,194,357,,,
217156,10,11189,5381,5808,10585,5171,5414,604,210,394
217165,10,3536,2210,1326,3359,2107,1252,177,103,74
217235,10,4566,1728,2838,4237,1587,2650,329,141,188
217305,10,1895,1087,808,1684,990,694,211,97,114
217323,10,276,267,9,276,267,9,,,
217402,10,4473,2028,2445,4044,1858,2186,429,170,259
217420,10,5787,1683,4104,3981,1217,2764,1806,466,1340
217475,10,12263,4800,7463,4964,2202,2762,7299,2598,4701
217484,10,17473,7314,10159,14614,6070,8544,2859,1244,1615
217493,10,2620,857,1763,2620,857,1763,,,
217518,10,4397,2170,2227,3902,1896,2006,495,274,221
217536,10,2872,914,1958,2292,731,1561,580,183,397
217581,10,135,1,134,91,1,90,44,0,44
217606,10,225,118,107,134,65,69,91,53,38
217615,10,2121,748,1373,699,269,430,1422,479,943
217624,10,657,372,285,602,347,255,55,25,30
217633,10,4121,1436,2685,3616,1241,2375,505,195,310
217688,10,3418,1245,2173,2789,993,1796,629,252,377
217712,10,2196,646,1550,458,169,289,1738,477,1261
217721,10,1840,828,1012,1752,785,967,88,43,45
217749,10,3095,1424,1671,2339,1075,1264,756,349,407
217776,10,1175,389,786,692,276,416,483,113,370
217794,10,101,1,100,65,1,64,36,0,36
217819,10,10885,3498,7387,9464,3041,6423,1421,457,964
217828,10,43,2,41,28,1,27,15,1,14
217837,10,1466,425,1041,240,80,160,1226,345,881
217864,10,3721,2831,890,2652,2226,426,1069,605,464
217873,10,1830,564,1266,1665,502,1163,165,62,103
217882,10,28466,13554,14912,25034,12103,12931,3432,1451,1981
217891,10,197,86,111,192,84,108,5,2,3
217907,10,1160,516,644,780,339,441,380,177,203
217925,10,2481,1142,1339,745,379,366,1736,763,973
217934,10,1514,233,1281,957,157,800,557,76,481
217961,10,1284,273,1011,901,195,706,383,78,305
217989,10,725,298,427,327,151,176,398,147,251
217998,10,956,643,313,775,511,264,181,132,49
218025,10,2940,1087,1853,1112,519,593,1828,568,1260
218061,10,4045,1342,2703,2695,908,1787,1350,434,916
218070,10,2443,983,1460,2381,958,1423,62,25,37
218113,10,11380,4584,6796,4192,1823,2369,7188,2761,4427
218140,10,8137,2816,5321,3575,1488,2087,4562,1328,3234
218159,10,113,4,109,83,3,80,30,1,29
218195,10,124,5,119,74,4,70,50,1,49
218229,10,4167,1317,2850,3317,1079,2238,850,238,612
218238,10,1786,856,930,1473,738,735,313,118,195
218335,10,3175,943,2232,2904,899,2005,271,44,227
218353,10,9091,3392,5699,3669,1644,2025,5422,1748,3674
218399,10,384,182,202,380,178,202,4,4,0
218414,10,1312,724,588,1273,708,565,39,16,23
218441,10,2125,995,1130,1815,886,929,310,109,201
218487,10,2012,590,1422,563,214,349,1449,376,1073
218520,10,5315,1664,3651,1733,639,1094,3582,1025,2557
218539,10,1199,510,689,1130,492,638,69,18,51
218645,10,3840,1379,2461,2610,987,1623,1230,392,838
218654,10,2124,672,1452,1673,536,1137,451,136,315
218663,10,35653,15070,20583,31941,13739,18202,3712,1331,2381
218672,10,1772,717,1055,675,280,395,1097,437,660
218681,10,745,299,446,285,140,145,460,159,301
218690,10,1537,677,860,498,243,255,1039,434,605
218706,10,1098,497,601,294,146,148,804,351,453
218724,10,10337,4604,5733,9163,4082,5081,1174,522,652
218733,10,2649,1174,1475,2285,1013,1272,364,161,203
218742,10,4913,1557,3356,3632,1176,2456,1281,381,900
218751,10,375,177,198,374,177,197,1,0,1
218821,10,1064,488,576,958,441,517,106,47,59
218830,10,6224,2412,3812,2477,1056,1421,3747,1356,2391
218858,10,3314,974,2340,902,368,534,2412,606,1806
218885,10,5629,2640,2989,3154,1660,1494,2475,980,1495
218894,10,11789,4473,7316,3969,1640,2329,7820,2833,4987
218919,10,507,215,292,452,188,264,55,27,28
218955,10,673,224,449,116,29,87,557,195,362
218964,10,4712,1452,3260,3497,1139,2358,1215,313,902
218973,10,1823,870,953,1807,860,947,16,10,6
218991,10,4521,1862,2659,1904,857,1047,2617,1005,1612
219000,10,2086,755,1331,1824,680,1144,262,75,187
219037,10,62,1,61,57,0,57,5,1,4
219046,10,3425,1252,2173,1619,557,1062,1806,695,1111
219082,10,3241,2085,1156,1490,1066,424,1751,1019,732
219091,10,887,412,475,658,341,317,229,71,158
219125,10,76,4,72,65,2,63,11,2,9
219143,10,2238,1122,1116,1526,881,645,712,241,471
219170,10,23,3,20,23,3,20,,,
219189,10,1203,782,421,861,603,258,342,179,163
219198,10,1252,584,668,765,371,394,487,213,274
219204,10,1151,544,607,193,99,94,958,445,513
219240,10,917,545,372,152,82,70,765,463,302
219259,10,3344,1228,2116,1116,483,633,2228,745,1483
219277,10,1177,343,834,486,164,322,691,179,512
219295,10,615,230,385,400,204,196,215,26,189
219338,10,15,3,12,15,3,12,,,
219347,10,2492,1888,604,1920,1488,432,572,400,172
219356,10,11327,4951,6376,8155,3804,4351,3172,1147,2025
219374,10,544,130,414,186,45,141,358,85,273
219383,10,1594,616,978,1239,470,769,355,146,209
219392,10,27,4,23,27,4,23,,,
219408,10,187,74,113,105,49,56,82,25,57
219426,10,2453,1136,1317,1285,754,531,1168,382,786
219453,10,125,1,124,125,1,124,,,
219471,10,9856,3641,6215,6009,2298,3711,3847,1343,2504
219480,10,1267,551,716,533,279,254,734,272,462
219505,10,53,34,19,37,24,13,16,10,6
219587,10,70,0,70,70,0,70,,,
219596,10,221,162,59,221,162,59,,,
219602,10,9326,3706,5620,5772,2264,3508,3554,1442,2112
219639,10,797,71,726,314,32,282,483,39,444
219709,10,8910,2937,5973,8288,2657,5631,622,280,342
219718,10,4686,2153,2533,2551,1341,1210,2135,812,1323
219790,10,1656,777,879,792,404,388,864,373,491
219806,10,2586,934,1652,1578,711,867,1008,223,785
219824,10,6429,2373,4056,3021,1166,1855,3408,1207,2201
219833,10,1934,968,966,1531,778,753,403,190,213
219842,10,565,355,210,176,115,61,389,240,149
219851,10,59,2,57,59,2,57,,,
219879,10,3180,1379,1801,1541,682,859,1639,697,942
219888,10,4954,1867,3087,2526,1048,1478,2428,819,1609
219903,10,1317,116,1201,1317,116,1201,,,
219921,10,396,264,132,177,101,76,219,163,56
219949,10,2588,1093,1495,1946,831,1115,642,262,380
219976,10,4704,1660,3044,4306,1497,2809,398,163,235
219994,10,982,662,320,619,378,241,363,284,79
220002,10,33,5,28,33,5,28,,,
220057,10,2683,834,1849,1188,428,760,1495,406,1089
220075,10,13483,5048,8435,10276,3973,6303,3207,1075,2132
220118,10,220,13,207,220,13,207,,,
220127,10,495,306,189,412,228,184,83,78,5
220163,10,72,2,70,53,2,51,19,0,19
220181,10,1055,345,710,1017,330,687,38,15,23
220206,10,394,203,191,207,111,96,187,92,95
220215,10,2330,993,1337,1468,679,789,862,314,548
220251,10,579,348,231,161,104,57,418,244,174
220279,10,643,449,194,196,136,60,447,313,134
220321,10,912,423,489,300,162,138,612,261,351
220394,10,328,213,115,233,144,89,95,69,26
220400,10,3442,1043,2399,1292,428,864,2150,615,1535
220464,10,196,76,120,59,22,37,137,54,83
220473,10,939,459,480,726,336,390,213,123,90
220491,10,261,8,253,181,6,175,80,2,78
220516,10,1357,472,885,1174,423,751,183,49,134
220552,10,6182,1057,5125,4554,818,3736,1628,239,1389
220598,10,1010,566,444,954,539,415,56,27,29
220604,10,609,215,394,534,187,347,75,28,47
220613,10,3927,1544,2383,2853,1072,1781,1074,472,602
220631,10,5418,1790,3628,4699,1596,3103,719,194,525
220640,10,1417,899,518,313,159,154,1104,740,364
220701,10,934,384,550,769,324,445,165,60,105
220710,10,1069,486,583,976,444,532,93,42,51
220756,10,134,121,13,98,87,11,36,34,2
220765,10,346,82,264,181,46,135,165,36,129
220792,10,962,335,627,962,335,627,,,
220853,10,1547,1035,512,853,580,273,694,455,239
220862,10,21917,8749,13168,13643,5718,7925,8274,3031,5243
220871,10,203,91,112,150,64,86,53,27,26
220978,10,20086,9110,10976,14613,6860,7753,5473,2250,3223
220996,10,295,133,162,219,108,111,76,25,51
221050,10,859,640,219,518,359,159,341,281,60
221096,10,5636,2088,3548,2876,1199,1677,2760,889,1871
221102,10,337,271,66,215,176,39,122,95,27
221148,10,1053,968,85,1053,968,85,,,
221184,10,6617,2447,4170,2718,1120,1598,3899,1327,2572
221236,10,444,316,128,216,154,62,228,162,66
221281,10,248,123,125,164,74,90,84,49,35
221333,10,565,437,128,183,111,72,382,326,56
221351,10,2008,837,1171,1955,823,1132,53,14,39
221388,10,362,229,133,137,40,97,225,189,36
221397,10,4457,1528,2929,2179,863,1316,2278,665,1613
221430,10,1411,942,469,242,168,74,1169,774,395
221485,10,6443,2281,4162,2547,966,1581,3896,1315,2581
221494,10,550,444,106,371,298,73,179,146,33
221519,10,1704,810,894,1657,788,869,47,22,25
221582,10,439,328,111,138,97,41,301,231,70
221591,10,495,354,141,309,209,100,186,145,41
221607,10,577,445,132,192,118,74,385,327,58
221616,10,2239,1413,826,502,351,151,1737,1062,675
221625,10,1157,743,414,736,464,272,421,279,142
221643,10,8452,3964,4488,4004,2022,1982,4448,1942,2506
221661,10,2903,1258,1645,2293,1050,1243,610,208,402
221670,10,532,166,366,532,166,366,,,
221731,10,1052,394,658,913,340,573,139,54,85
221740,10,11283,4748,6535,9612,3939,5673,1671,809,862
221759,10,33805,15269,18536,29813,13383,16430,3992,1886,2106
221768,10,6868,2542,4326,4519,1704,2815,2349,838,1511
221829,10,342,12,330,342,12,330,,,
221838,10,9218,3158,6060,7335,2495,4840,1883,663,1220
221847,10,9902,5221,4681,8061,4375,3686,1841,846,995
221892,10,3327,1131,2196,2509,869,1640,818,262,556
221908,10,5100,2388,2712,2607,1138,1469,2493,1250,1243
221953,10,1303,624,679,1026,531,495,277,93,184
221971,10,2731,938,1793,1977,663,1314,754,275,479
221999,10,13710,6047,7663,12486,5628,6858,1224,419,805
222053,10,6957,2628,4329,3516,1422,2094,3441,1206,2235
222062,10,5477,1959,3518,2603,1027,1576,2874,932,1942
222105,10,361,337,24,172,165,7,189,172,17
222178,10,5079,1748,3331,3458,1226,2232,1621,522,1099
222567,10,5411,2239,3172,952,427,525,4459,1812,2647
222576,10,8988,3219,5769,3442,1390,2052,5546,1829,3717
222628,10,909,260,649,112,24,88,797,236,561
222822,10,4002,1433,2569,1444,525,919,2558,908,1650
222831,10,10599,4281,6318,5704,2263,3441,4895,2018,2877
222877,10,218,138,80,215,136,79,3,2,1
222886,10,375,23,352,373,23,350,2,0,2
222938,10,317,148,169,212,102,110,105,46,59
222983,10,1182,585,597,1179,582,597,3,3,0
222992,10,34527,14777,19750,7843,3817,4026,26684,10960,15724
223001,10,172,60,112,41,17,24,131,43,88
223056,10,44,0,44,44,0,44,,,
223083,10,467,67,400,128,24,104,339,43,296
223117,10,104,88,16,15,12,3,89,76,13
223223,10,1610,656,954,1603,650,953,7,6,1
223232,10,20709,8045,12664,18727,7465,11262,1982,580,1402
223320,10,3899,1381,2518,824,296,528,3075,1085,1990
223427,10,17909,8879,9030,8779,4562,4217,9130,4317,4813
223463,10,302,67,235,302,67,235,,,
223472,10,175,16,159,175,16,159,,,
223506,10,4044,1856,2188,793,359,434,3251,1497,1754
223816,10,8326,3577,4749,1641,659,982,6685,2918,3767
223852,10,22,1,21,22,1,21,,,
223898,10,2877,1066,1811,1048,407,641,1829,659,1170
223922,10,1371,611,760,556,256,300,815,355,460
224004,10,1863,561,1302,1397,443,954,466,118,348
224013,10,38,2,36,38,2,36,,,
224110,10,7360,3119,4241,1812,801,1011,5548,2318,3230
224147,10,10778,4237,6541,6594,2611,3983,4184,1626,2558
224156,10,275,6,269,202,4,198,73,2,71
224226,10,4348,1830,2518,2929,1220,1709,1419,610,809
224244,10,247,151,96,220,138,82,27,13,14
224271,10,776,189,587,772,185,587,4,4,0
224305,10,2569,1491,1078,794,466,328,1775,1025,750
224323,10,2328,1119,1209,1707,802,905,621,317,304
224350,10,9725,4048,5677,1371,639,732,8354,3409,4945
224527,10,1771,828,943,1299,647,652,472,181,291
224545,10,2110,787,1323,1451,591,860,659,196,463
224554,10,11306,4337,6969,6826,2734,4092,4480,1603,2877
224615,10,64156,26171,37985,14830,6752,8078,49326,19419,29907
224642,10,24398,10349,14049,6847,3058,3789,17551,7291,10260
224660,10,623,316,307,484,256,228,139,60,79
224679,10,1328,1140,188,707,588,119,621,552,69
224712,10,115,36,79,55,23,32,60,13,47
224758,10,28,1,27,25,0,25,3,1,2
224776,10,265,122,143,173,82,91,92,40,52
224828,10,72,1,71,48,1,47,24,0,24
224891,10,1634,707,927,594,238,356,1040,469,571
224961,10,2026,689,1337,656,267,389,1370,422,948
225043,10,11,10,1,11,10,1,,,
225070,10,3938,1497,2441,1323,507,816,2615,990,1625
225201,10,876,554,322,876,554,322,,,
225247,10,1765,779,986,1576,700,876,189,79,110
225308,10,5362,2119,3243,1580,612,968,3782,1507,2275
225371,10,3689,1434,2255,1037,455,582,2652,979,1673
225399,10,4257,1392,2865,2344,876,1468,1913,516,1397
225414,10,8562,3146,5416,4100,1562,2538,4462,1584,2878
225423,10,48159,19467,28692,13857,6041,7816,34302,13426,20876
225432,10,14208,5273,8935,6270,2444,3826,7938,2829,5109
225502,10,4057,1373,2684,1599,590,1009,2458,783,1675
225511,10,46700,22359,24341,33405,15587,17818,13295,6772,6523
225520,10,4264,1727,2537,995,337,658,3269,1390,1879
225548,10,838,463,375,675,378,297,163,85,78
225575,10,1025,439,586,973,420,553,52,19,33
225627,10,7305,2730,4575,6140,2244,3896,1165,486,679
225876,10,471,199,272,192,104,88,279,95,184
225885,10,729,340,389,632,303,329,97,37,60
225991,10,102,57,45,102,57,45,,,
226019,10,5189,2064,3125,1971,826,1145,3218,1238,1980
226091,10,16803,5723,11080,9088,3655,5433,7715,2068,5647
226107,10,2682,892,1790,798,260,538,1884,632,1252
226116,10,2600,962,1638,714,254,460,1886,708,1178
226125,10,122,6,116,122,6,116,,,
226134,10,9317,3956,5361,2104,893,1211,7213,3063,4150
226152,10,8505,3163,5342,5692,2155,3537,2813,1008,1805
226204,10,7807,3916,3891,1014,546,468,6793,3370,3423
226231,10,3536,1833,1703,1415,907,508,2121,926,1195
226277,10,1212,1115,97,1212,1115,97,,,
226383,10,1596,557,1039,1174,431,743,422,126,296
226408,10,4482,1754,2728,1115,478,637,3367,1276,2091
226471,10,3575,1228,2347,3185,1088,2097,390,140,250
226578,10,6942,2242,4700,2243,778,1465,4699,1464,3235
226587,10,1237,654,583,1021,555,466,216,99,117
226675,10,336,47,289,336,47,289,,,
226806,10,5404,2201,3203,1504,590,914,3900,1611,2289
226833,10,5784,2109,3675,3768,1435,2333,2016,674,1342
226860,10,39,2,37,39,2,37,,,
226879,10,157,21,136,62,9,53,95,12,83
226903,10,1070,429,641,1070,429,641,,,
227058,10,57,0,57,57,0,57,,,
227146,10,6277,2427,3850,2314,1014,1300,3963,1413,2550
227182,10,68415,28040,40375,18795,8560,10235,49620,19480,30140
227216,10,44767,20574,24193,33672,15683,17989,11095,4891,6204
227225,10,3029,1096,1933,1162,397,765,1867,699,1168
227289,10,157,101,56,79,66,13,78,35,43
227298,10,176,165,11,176,165,11,,,
227304,10,7995,3242,4753,2635,969,1666,5360,2273,3087
227313,10,324,6,318,145,4,141,179,2,177
227322,10,446,6,440,202,4,198,244,2,242
227331,10,2326,604,1722,2011,544,1467,315,60,255
227368,10,31559,12532,19027,21452,8475,12977,10107,4057,6050
227377,10,7648,3189,4459,1676,782,894,5972,2407,3565
227386,10,2386,802,1584,920,326,594,1466,476,990
227401,10,4427,1669,2758,1463,597,866,2964,1072,1892
227429,10,938,301,637,320,144,176,618,157,461
227526,10,9056,2955,6101,7586,2436,5150,1470,519,951
227687,10,2297,1077,1220,733,380,353,1564,697,867
227748,10,250,234,16,172,161,11,78,73,5
227757,10,8672,4935,3737,7998,4513,3485,674,422,252
227845,10,3470,1231,2239,2809,1055,1754,661,176,485
227854,10,12653,5321,7332,1756,866,890,10897,4455,6442
227863,10,3588,1509,2079,2474,943,1531,1114,566,548
227881,10,21480,7664,13816,15528,5626,9902,5952,2038,3914
227924,10,18233,6929,11304,3854,1530,2324,14379,5399,8980
227979,10,30593,12525,18068,9309,3965,5344,21284,8560,12724
228042,10,1193,508,685,1105,484,621,88,24,64
228088,10,50,0,50,50,0,50,,,
228149,10,3253,1351,1902,2812,1158,1654,441,193,248
228158,10,8580,3481,5099,3869,1723,2146,4711,1758,2953
228185,10,18,14,4,18,14,4,,,
228194,10,1003,457,546,812,371,441,191,86,105
228200,10,409,182,227,383,170,213,26,12,14
228219,10,482,194,288,475,193,282,7,1,6
228246,10,12053,6040,6013,9284,4557,4727,2769,1483,1286
228282,10,18,4,14,18,4,14,,,
228316,10,6278,2600,3678,1970,769,1201,4308,1831,2477
228325,10,1794,869,925,1323,667,656,471,202,269
228343,10,1483,685,798,1465,677,788,18,8,10
228431,10,11327,4075,7252,8471,3067,5404,2856,1008,1848
228459,10,38171,15091,23080,30299,11890,18409,7872,3201,4671
228468,10,793,322,471,597,245,352,196,77,119
228486,10,88,54,34,79,50,29,9,4,5
228501,10,1987,794,1193,1015,526,489,972,268,704
228529,10,14092,5075,9017,9369,3335,6034,4723,1740,2983
228547,10,40131,16816,23315,7274,3426,3848,32857,13390,19467
228608,10,4602,1536,3066,1706,595,1111,2896,941,1955
228635,10,2354,1079,1275,1747,743,1004,607,336,271
228644,10,3518,1260,2258,3070,1113,1957,448,147,301
228653,10,3361,983,2378,2175,741,1434,1186,242,944
228699,10,3800,1431,2369,977,381,596,2823,1050,1773
228705,10,6092,3017,3075,4549,2330,2219,1543,687,856
228723,10,74014,39380,34634,63842,33840,30002,10172,5540,4632
228769,10,43946,17436,26510,24834,11591,13243,19112,5845,13267
228778,10,52384,23099,29285,49081,21475,27606,3303,1624,1679
228787,10,31570,17841,13729,25307,14197,11110,6263,3644,2619
228796,10,23880,10599,13281,15154,6720,8434,8726,3879,4847
228802,10,9322,3393,5929,5404,2094,3310,3918,1299,2619
228866,10,257,123,134,253,121,132,4,2,2
228875,10,12273,4732,7541,11958,4593,7365,315,139,176
228884,10,642,382,260,592,357,235,50,25,25
228909,10,2337,816,1521,2161,763,1398,176,53,123
228981,10,1369,639,730,1301,607,694,68,32,36
229018,10,5848,2277,3571,3435,1350,2085,2413,927,1486
229027,10,34393,16323,18070,24006,11154,12852,10387,5169,5218
229063,10,8632,2979,5653,7034,2415,4619,1598,564,1034
229115,10,40378,20000,20378,34129,17196,16933,6249,2804,3445
229160,10,2578,1126,1452,1861,873,988,717,253,464
229179,10,15958,1806,14152,8813,782,8031,7145,1024,6121
229267,10,2692,1240,1452,2601,1202,1399,91,38,53
229300,10,5354,1598,3756,3494,1164,2330,1860,434,1426
229337,10,5136,1250,3886,3713,986,2727,1423,264,1159
229355,10,11901,4428,7473,4933,1981,2952,6968,2447,4521
229416,10,1845,1752,93,1845,1752,93,,,
229425,10,124,4,120,40,1,39,84,3,81
229504,10,2249,808,1441,625,273,352,1624,535,1089
229522,10,94,8,86,78,5,73,16,3,13
229540,10,3064,979,2085,748,327,421,2316,652,1664
229656,10,305,11,294,133,4,129,172,7,165
229780,10,2978,1385,1593,1586,762,824,1392,623,769
229799,10,5445,1973,3472,1617,619,998,3828,1354,2474
229814,10,9242,3737,5505,5914,2344,3570,3328,1393,1935
229832,10,1392,705,687,465,246,219,927,459,468
229841,10,5495,2310,3185,2275,1091,1184,3220,1219,2001
229887,10,698,343,355,652,333,319,46,10,36
230010,10,1379,856,523,507,267,240,872,589,283
230038,10,34464,16740,17724,30147,14570,15577,4317,2170,2147
230047,10,2735,1108,1627,2594,1055,1539,141,53,88
230065,10,298,6,292,108,4,104,190,2,188
230144,10,88,1,87,88,1,87,,,
230162,10,3518,2258,1260,473,208,265,3045,2050,995
230171,10,12556,5303,7253,7389,2971,4418,5167,2332,2835
230199,10,69,4,65,69,4,65,,,
230205,10,66,5,61,50,2,48,16,3,13
230214,10,328,47,281,110,10,100,218,37,181
230366,10,307,43,264,307,43,264,,,
230418,10,4058,1881,2177,1158,614,544,2900,1267,1633
230490,10,3043,1857,1186,323,101,222,2720,1756,964
230597,10,5997,2739,3258,3479,1625,1854,2518,1114,1404
230603,10,14330,5850,8480,8488,3626,4862,5842,2224,3618
230676,10,1242,856,386,114,64,50,1128,792,336
230728,10,27943,12349,15594,18038,8167,9871,9905,4182,5723
230737,10,43099,21377,21722,19057,9821,9236,24042,11556,12486
230746,10,26300,11979,14321,5644,2697,2947,20656,9282,11374
230764,10,34734,17671,17063,28070,14286,13784,6664,3385,3279
230782,10,29914,13169,16745,12028,5195,6833,17886,7974,9912
230807,10,1280,481,799,1158,430,728,122,51,71
230816,10,880,277,603,815,237,578,65,40,25
230834,10,2363,944,1419,1499,704,795,864,240,624
230852,10,3543,2118,1425,2276,1406,870,1267,712,555
230861,10,5596,1622,3974,787,269,518,4809,1353,3456
230889,10,320,88,232,284,81,203,36,7,29
230913,10,1779,607,1172,1000,398,602,779,209,570
230959,10,2843,1303,1540,2750,1285,1465,93,18,75
230995,10,3363,2334,1029,2715,1882,833,648,452,196
231004,10,70,2,68,70,2,68,,,
231059,10,1399,623,776,1231,574,657,168,49,119
231068,10,617,145,472,552,133,419,65,12,53
231095,10,101,41,60,85,32,53,16,9,7
231147,10,653,201,452,589,180,409,64,21,43
231165,10,1414,693,721,744,392,352,670,301,369
231174,10,14088,5150,8938,12845,4699,8146,1243,451,792
231280,10,106,3,103,83,3,80,23,0,23
231411,10,459,408,51,459,408,51,,,
231420,10,1363,652,711,1040,552,488,323,100,223
231536,10,3562,1437,2125,1085,482,603,2477,955,1522
231554,10,991,457,534,897,422,475,94,35,59
231581,10,1421,676,745,1413,673,740,8,3,5
231624,10,9654,4052,5602,8409,3559,4850,1245,493,752
231651,10,10337,3770,6567,4583,1729,2854,5754,2041,3713
231688,10,21,2,19,12,1,11,9,1,8
231697,10,3388,1395,1993,1042,437,605,2346,958,1388
231712,10,4559,2113,2446,4432,2045,2387,127,68,59
231785,10,1281,251,1030,705,205,500,576,46,530
231873,10,946,397,549,283,137,146,663,260,403
231882,10,2274,961,1313,897,430,467,1377,531,846
231970,10,1319,488,831,1077,428,649,242,60,182
232016,10,109,40,69,73,34,39,36,6,30
232025,10,1358,616,742,1329,601,728,29,15,14
232043,10,1334,453,881,876,347,529,458,106,352
232052,10,658,275,383,170,57,113,488,218,270
232089,10,855,499,356,765,461,304,90,38,52
232186,10,39049,18826,20223,27121,13512,13609,11928,5314,6614
232195,10,7688,2815,4873,2165,902,1263,5523,1913,3610
232256,10,846,843,3,838,835,3,8,8,0
232265,10,3286,1115,2171,3001,975,2026,285,140,145
232308,10,803,34,769,721,10,711,82,24,58
232414,10,7527,2960,4567,2352,1033,1319,5175,1927,3248
232423,10,22224,9297,12927,19984,8368,11616,2240,929,1311
232450,10,8792,3672,5120,1975,894,1081,6817,2778,4039
232557,10,96709,39998,56711,53991,22061,31930,42718,17937,24781
232566,10,4358,1324,3034,3184,965,2219,1174,359,815
232575,10,5720,2155,3565,1745,763,982,3975,1392,2583
232609,10,2394,877,1517,2082,781,1301,312,96,216
232618,10,227,30,197,26,1,25,201,29,172
232672,10,1957,412,1545,1463,347,1116,494,65,429
232681,10,3757,1379,2378,3080,1139,1941,677,240,437
232706,10,3711,1426,2285,2286,771,1515,1425,655,770
232724,10,23,1,22,23,1,22,,,
232788,10,1928,718,1210,822,332,490,1106,386,720
232797,10,1113,211,902,418,121,297,695,90,605
232867,10,3980,2032,1948,1372,742,630,2608,1290,1318
232885,10,331,24,307,268,16,252,63,8,55
232919,10,454,395,59,371,321,50,83,74,9
232937,10,5783,1920,3863,4894,1617,3277,889,303,586
232946,10,51896,24984,26912,13327,6928,6399,38569,18056,20513
232982,10,23107,10102,13005,15582,6853,8729,7525,3249,4276
233019,10,1861,785,1076,1048,476,572,813,309,504
233037,10,1188,411,777,303,125,178,885,286,599
233082,10,103,8,95,8,1,7,95,7,88
233116,10,5022,2139,2883,998,457,541,4024,1682,2342
233277,10,7718,2556,5162,6191,2207,3984,1527,349,1178
233286,10,116,18,98,99,17,82,17,1,16
233295,10,1490,677,813,1450,653,797,40,24,16
233301,10,553,212,341,532,201,331,21,11,10
233310,10,2591,931,1660,634,252,382,1957,679,1278
233329,10,410,31,379,410,31,379,,,
233338,10,2051,871,1180,720,323,397,1331,548,783
233356,10,481,39,442,382,29,353,99,10,89
233374,10,3876,1738,2138,3495,1597,1898,381,141,240
233408,10,338,41,297,271,38,233,67,3,64
233426,10,1826,840,986,1759,802,957,67,38,29
233480,10,27,6,21,27,6,21,,,
233541,10,4260,1357,2903,2904,1079,1825,1356,278,1078
233602,10,74,45,29,65,39,26,9,6,3
233611,10,1053,554,499,1010,531,479,43,23,20
233639,10,3112,1059,2053,942,281,661,2170,778,1392
233648,10,2163,805,1358,1021,417,604,1142,388,754
233666,10,22,1,21,17,1,16,5,0,5
233684,10,2608,867,1741,511,290,221,2097,577,1520
233718,10,460,0,460,453,0,453,7,0,7
233754,10,6018,2465,3553,1779,820,959,4239,1645,2594
233772,10,16195,6669,9526,4898,2063,2835,11297,4606,6691
233842,10,177,63,114,102,39,63,75,24,51
233897,10,1704,686,1018,1054,511,543,650,175,475
233903,10,2068,783,1285,740,316,424,1328,467,861
233921,10,38170,21687,16483,35282,19939,15343,2888,1748,1140
233949,10,5860,2513,3347,1627,722,905,4233,1791,2442
234030,10,28082,10044,18038,23167,8193,14974,4915,1851,3064
234076,10,26082,11746,14336,23248,10602,12646,2834,1144,1690
234085,10,1512,1310,202,1512,1310,202,,,
234119,10,116,45,71,82,29,53,34,16,18
234137,10,837,359,478,717,279,438,120,80,40
234155,10,4648,1851,2797,4286,1730,2556,362,121,241
234164,10,1860,929,931,1458,748,710,402,181,221
234173,10,1538,670,868,1115,459,656,423,211,212
234207,10,2243,1104,1139,2235,1099,1136,8,5,3
234377,10,2116,799,1317,708,233,475,1408,566,842
234669,10,10617,4668,5949,5547,2581,2966,5070,2087,2983
234696,10,1632,821,811,1056,599,457,576,222,354
234711,10,1736,729,1007,1203,516,687,533,213,320
234827,10,9257,4335,4922,7803,3702,4101,1454,633,821
234845,10,2277,888,1389,1288,513,775,989,375,614
234915,10,2095,789,1306,240,93,147,1855,696,1159
234924,10,261,30,231,261,30,231,,,
234933,10,6593,2610,3983,3528,1423,2105,3065,1187,1878
234951,10,2788,1052,1736,1594,691,903,1194,361,833
234979,10,6192,2808,3384,3424,1399,2025,2768,1409,1359
235024,10,443,156,287,408,147,261,35,9,26
235088,10,231,219,12,231,219,12,,,
235097,10,10910,4306,6604,9034,3549,5485,1876,757,1119
235103,10,5753,2590,3163,2541,1267,1274,3212,1323,1889
235149,10,6054,2607,3447,3017,1354,1663,3037,1253,1784
235167,10,2105,803,1302,1864,709,1155,241,94,147
235237,10,8635,3243,5392,4496,1675,2821,4139,1568,2571
235307,10,100,5,95,100,5,95,,,
235316,10,7253,3103,4150,6637,2889,3748,616,214,402
235334,10,1475,657,818,962,433,529,513,224,289
235343,10,6252,2898,3354,3769,1818,1951,2483,1080,1403
235352,10,88,13,75,88,13,75,,,
235422,10,853,213,640,733,184,549,120,29,91
235431,10,4684,1720,2964,2570,978,1592,2114,742,1372
235501,10,133,57,76,133,57,76,,,
235547,10,728,107,621,635,91,544,93,16,77
235583,10,35,0,35,35,0,35,,,
235671,10,4133,2515,1618,2108,1435,673,2025,1080,945
235699,10,3150,1296,1854,1526,760,766,1624,536,1088
235750,10,2435,749,1686,1234,410,824,1201,339,862
236018,10,39,4,35,39,4,35,,,
236072,10,4675,1749,2926,1462,713,749,3213,1036,2177
236133,10,1014,354,660,909,310,599,105,44,61
236188,10,4905,2142,2763,2900,1235,1665,2005,907,1098
236212,10,879,740,139,879,740,139,,,
236230,10,2633,942,1691,2419,863,1556,214,79,135
236258,10,1583,544,1039,766,265,501,817,279,538
236328,10,2023,814,1209,1934,794,1140,89,20,69
236382,10,3072,2102,970,964,492,472,2108,1610,498
236452,10,1609,654,955,1322,535,787,287,119,168
236504,10,4901,3621,1280,1341,807,534,3560,2814,746
236513,10,4476,1900,2576,2750,1197,1553,1726,703,1023
236577,10,3118,976,2142,2647,817,1830,471,159,312
236595,10,7121,2617,4504,5489,1994,3495,1632,623,1009
236610,10,4418,1822,2596,1940,941,999,2478,881,1597
236638,10,3860,1757,2103,1910,817,1093,1950,940,1010
236656,10,3788,1456,2332,2229,936,1293,1559,520,1039
236692,10,6502,2710,3792,3294,1380,1914,3208,1330,1878
236708,10,3795,1548,2247,2576,1081,1495,1219,467,752
236744,10,39,1,38,39,1,38,,,
236753,10,5502,1967,3535,3399,1322,2077,2103,645,1458
236887,10,2662,1361,1301,1551,759,792,1111,602,509
236896,10,1432,698,734,1289,628,661,143,70,73
236939,10,27539,12687,14852,23128,10732,12396,4411,1955,2456
236948,10,52319,24831,27488,42432,18204,24228,9887,6627,3260
236975,10,2529,916,1613,1742,658,1084,787,258,529
237011,10,14747,6265,8482,12938,5339,7599,1809,926,883
237039,10,3340,1458,1882,1636,762,874,1704,696,1008
237057,10,1493,652,841,1450,629,821,43,23,20
237066,10,2415,986,1429,2159,901,1258,256,85,171
237109,10,3279,929,2350,2119,644,1475,1160,285,875
237118,10,767,426,341,702,411,291,65,15,50
237127,10,39,0,39,39,0,39,,,
237136,10,232,124,108,157,80,77,75,44,31
237145,10,15,0,15,15,0,15,,,
237172,10,65,43,22,51,37,14,14,6,8
237181,10,623,347,276,593,333,260,30,14,16
237215,10,1306,528,778,990,416,574,316,112,204
237242,10,41,40,1,34,33,1,7,7,0
237303,10,55,26,29,55,26,29,,,
237312,10,3059,1842,1217,1853,976,877,1206,866,340
237321,10,61,5,56,61,5,56,,,
237330,10,1748,680,1068,1367,553,814,381,127,254
237358,10,650,266,384,636,263,373,14,3,11
237367,10,3498,1451,2047,2456,1114,1342,1042,337,705
237385,10,1630,823,807,988,474,514,642,349,293
237437,10,147,21,126,129,20,109,18,1,17
237473,10,101,71,30,101,71,30,,,
237491,10,18,3,15,18,3,15,,,
237525,10,10691,4285,6406,8106,3356,4750,2585,929,1656
237543,10,122,30,92,80,17,63,42,13,29
237561,10,47,19,28,47,19,28,,,
237570,10,79,1,78,79,1,78,,,
237598,10,20,3,17,20,3,17,,,
237686,10,2288,819,1469,966,361,605,1322,458,864
237701,10,1145,485,660,882,395,487,263,90,173
237729,10,130,36,94,97,16,81,33,20,13
237783,10,984,457,527,873,400,473,111,57,54
237792,10,3235,1181,2054,2315,869,1446,920,312,608
237817,10,1365,413,952,899,276,623,466,137,329
237844,10,86,43,43,86,43,43,,,
237880,10,793,398,395,793,398,395,,,
237899,10,3785,1570,2215,1398,625,773,2387,945,1442
237905,10,61,12,49,61,12,49,,,
237932,10,2315,857,1458,1775,676,1099,540,181,359
237950,10,1481,771,710,972,577,395,509,194,315
237969,10,951,450,501,925,440,485,26,10,16
237987,10,225,31,194,225,31,194,,,
237996,10,525,88,437,525,88,437,,,
238005,10,79,6,73,79,6,73,,,
238014,10,1222,427,795,551,229,322,671,198,473
238032,10,24741,11687,13054,21685,10358,11327,3056,1329,1727
238078,10,749,433,316,574,355,219,175,78,97
238096,10,30,2,28,30,2,28,,,
238175,10,113,1,112,113,1,112,,,
238193,10,1596,128,1468,1180,81,1099,416,47,369
238263,10,12982,5820,7162,3238,1641,1597,9744,4179,5565
238324,10,748,143,605,322,32,290,426,111,315
238333,10,964,455,509,933,445,488,31,10,21
238397,10,2391,878,1513,645,267,378,1746,611,1135
238430,10,1332,383,949,490,176,314,842,207,635
238458,10,3283,1049,2234,2988,940,2048,295,109,186
238476,10,2667,1180,1487,2532,1125,1407,135,55,80
238616,10,4988,1652,3336,3197,1169,2028,1791,483,1308
238661,10,1876,567,1309,1489,433,1056,387,134,253
238722,10,11181,6226,4955,1892,1054,838,9289,5172,4117
238759,10,9881,4824,5057,1130,566,564,8751,4258,4493
238810,10,66,5,61,44,3,41,22,2,20
238980,10,2406,978,1428,830,396,434,1576,582,994
239008,10,3154,1681,1473,410,217,193,2744,1464,1280
239017,10,1426,658,768,1405,647,758,21,11,10
239071,10,965,424,541,509,214,295,456,210,246
239080,10,1340,415,925,940,326,614,400,89,311
239105,10,11167,4765,6402,9745,4154,5591,1422,611,811
239169,10,1615,663,952,1524,634,890,91,29,62
239220,10,2779,1323,1456,587,314,273,2192,1009,1183
239248,10,12211,4977,7234,3260,1590,1670,8951,3387,5564
239309,10,896,193,703,882,188,694,14,5,9
239318,10,2729,1933,796,2570,1824,746,159,109,50
239372,10,3074,1264,1810,823,396,427,2251,868,1383
239390,10,1198,48,1150,1006,32,974,192,16,176
239424,10,130,111,19,84,70,14,46,41,5
239442,10,1186,421,765,185,71,114,1001,350,651
239460,10,6069,2567,3502,1126,497,629,4943,2070,2873
239488,10,10661,4727,5934,2273,1157,1116,8388,3570,4818
239512,10,518,244,274,502,239,263,16,5,11
239628,10,766,389,377,760,387,373,6,2,4
239716,10,1882,824,1058,1798,781,1017,84,43,41
239877,10,39,1,38,32,1,31,7,0,7
239910,10,2710,1090,1620,717,329,388,1993,761,1232
240107,10,2456,581,1875,1755,456,1299,701,125,576
240116,10,8364,3764,4600,2119,989,1130,6245,2775,3470
240125,10,7268,3942,3326,1593,883,710,5675,3059,2616
240170,10,3872,1707,2165,1556,837,719,2316,870,1446
240189,10,11079,5440,5639,8581,4382,4199,2498,1058,1440
240198,10,2677,1080,1597,855,388,467,1822,692,1130
240213,10,83,11,72,35,3,32,48,8,40
240268,10,10104,4038,6066,8645,3434,5211,1459,604,855
240277,10,9599,3248,6351,5172,1939,3233,4427,1309,3118
240329,10,10274,4328,5946,9133,3824,5309,1141,504,637
240338,10,1086,483,603,969,436,533,117,47,70
240365,10,13705,5446,8259,7036,2856,4180,6669,2590,4079
240374,10,3947,1761,2186,2545,1146,1399,1402,615,787
240392,10,3473,585,2888,1878,332,1546,1595,253,1342
240417,10,7234,3879,3355,5331,3035,2296,1903,844,1059
240426,10,2710,907,1803,1731,638,1093,979,269,710
240444,10,48956,22993,25963,44262,20663,23599,4694,2330,2364
240453,10,22676,9913,12763,17520,7798,9722,5156,2115,3041
240462,10,6486,4022,2464,5411,3348,2063,1075,674,401
240471,10,5188,1801,3387,4191,1431,2760,997,370,627
240480,10,7964,3315,4649,6491,2836,3655,1473,479,994
240505,10,3354,1485,1869,1426,592,834,1928,893,1035
240514,10,1923,872,1051,612,247,365,1311,625,686
240596,10,1421,581,840,455,166,289,966,415,551
240620,10,3770,1459,2311,1373,541,832,2397,918,1479
240657,10,1423,618,805,650,300,350,773,318,455
240666,10,3596,1662,1934,1256,521,735,2340,1141,1199
240693,10,2391,1002,1389,799,368,431,1592,634,958
240709,10,45,5,40,35,5,30,10,0,10
240718,10,993,934,59,993,934,59,,,
240727,10,11100,5095,6005,8643,4113,4530,2457,982,1475
240736,10,1051,296,755,509,145,364,542,151,391
240745,10,1618,723,895,698,289,409,920,434,486
240754,10,2962,1235,1727,2136,891,1245,826,344,482
240790,10,1297,490,807,953,366,587,344,124,220
240879,10,131,25,106,131,25,106,,,
241100,10,223,105,118,175,88,87,48,17,31
241128,10,212,99,113,171,80,91,41,19,22
241146,10,141,47,94,137,46,91,4,1,3
241182,10,397,75,322,397,75,322,,,
241191,10,838,327,511,719,274,445,119,53,66
241216,10,1653,1031,622,985,598,387,668,433,235
241225,10,784,250,534,513,168,345,271,82,189
241304,10,2165,587,1578,1182,316,866,983,271,712
241331,10,2459,382,2077,2084,325,1759,375,57,318
241377,10,830,290,540,624,232,392,206,58,148
241386,10,147,31,116,112,25,87,35,6,29
241395,10,641,170,471,399,114,285,242,56,186
241410,10,5776,1983,3793,4623,1599,3024,1153,384,769
241517,10,210,55,155,149,39,110,61,16,45
241614,10,381,209,172,196,120,76,185,89,96
241720,10,596,235,361,433,153,280,163,82,81
241739,10,6120,1953,4167,4077,1295,2782,2043,658,1385
241766,10,326,225,101,202,135,67,124,90,34
241793,10,334,177,157,205,103,102,129,74,55
241836,10,959,296,663,405,143,262,554,153,401
241906,10,235,74,161,235,74,161,,,
241951,10,489,124,365,358,83,275,131,41,90
242042,10,452,260,192,424,237,187,28,23,5
242112,10,391,166,225,336,153,183,55,13,42
242121,10,214,79,135,126,46,80,88,33,55
242130,10,326,95,231,260,72,188,66,23,43
242149,10,347,88,259,259,69,190,88,19,69
242556,10,247,162,85,240,157,83,7,5,2
242583,10,165,116,49,124,88,36,41,28,13
242617,10,3249,1436,1813,2676,1199,1477,573,237,336
242626,10,3178,1286,1892,2586,1028,1558,592,258,334
242635,10,2705,939,1766,2175,783,1392,530,156,374
242644,10,1074,366,708,850,296,554,224,70,154
242653,10,5001,1921,3080,3582,1359,2223,1419,562,857
242662,10,3267,1150,2117,2387,860,1527,880,290,590
242680,10,1314,480,834,1073,394,679,241,86,155
242699,10,1605,519,1086,1313,424,889,292,95,197
242705,10,3820,2121,1699,3174,1746,1428,646,375,271
242723,10,656,244,412,320,122,198,336,122,214
242820,10,944,730,214,944,730,214,,,
242945,10,171,60,111,128,43,85,43,17,26
242954,10,66,22,44,54,17,37,12,5,7
242972,10,26720,9028,17692,18174,6082,12092,8546,2946,5600
243081,10,820,305,515,813,303,510,7,2,5
243106,10,1985,889,1096,1777,800,977,208,89,119
243115,10,2897,1102,1795,2666,1010,1656,231,92,139
243133,10,3022,1487,1535,2578,1269,1309,444,218,226
243142,10,2270,835,1435,1758,631,1127,512,204,308
243151,10,2216,706,1510,1975,620,1355,241,86,155
243179,10,2634,884,1750,2362,786,1576,272,98,174
243188,10,346,179,167,305,157,148,41,22,19
243197,10,11062,6091,4971,9799,5352,4447,1263,739,524
243203,10,2034,648,1386,1926,625,1301,108,23,85
243212,10,2221,1001,1220,2021,935,1086,200,66,134
243221,10,12037,4616,7421,10178,3825,6353,1859,791,1068
243346,10,5558,2006,3552,3766,1358,2408,1792,648,1144
243443,10,4224,1507,2717,3129,1126,2003,1095,381,714
243498,10,128,81,47,71,44,27,57,37,20
243568,10,522,186,336,496,180,316,26,6,20
243577,10,4244,2995,1249,1990,1359,631,2254,1636,618
243586,10,725,248,477,591,212,379,134,36,98
243601,10,10133,3873,6260,7337,2696,4641,2796,1177,1619
243638,10,1996,811,1185,1321,522,799,675,289,386
243647,10,454,206,248,279,137,142,175,69,106
243665,10,1636,438,1198,985,285,700,651,153,498
243744,10,18283,9650,8633,16992,8802,8190,1291,848,443
243780,10,51528,29790,21738,43353,24974,18379,8175,4816,3359
243799,10,22,1,21,22,1,21,,,
243823,10,2063,903,1160,1883,846,1037,180,57,123
243832,10,1302,391,911,630,186,444,672,205,467
243841,10,466,89,377,363,73,290,103,16,87
244233,10,1,0,1,1,0,1,,,
244279,10,132,3,129,132,3,129,,,
244437,10,15456,5936,9520,5841,2450,3391,9615,3486,6129
244446,10,2874,1041,1833,617,296,321,2257,745,1512
244613,10,323,308,15,170,162,8,153,146,7
245281,10,78,41,37,78,41,37,,,
245625,10,3386,1488,1898,619,257,362,2767,1231,1536
245652,10,439,231,208,398,214,184,41,17,24
245777,10,97,97,0,95,95,0,2,2,0
245838,10,867,227,640,750,183,567,117,44,73
245847,10,279,65,214,232,48,184,47,17,30
245865,10,1045,173,872,742,130,612,303,43,260
245883,10,799,128,671,519,83,436,280,45,235
245892,10,443,89,354,310,61,249,133,28,105
245953,10,2442,883,1559,1024,361,663,1418,522,896
245962,10,167,10,157,164,10,154,3,0,3
245980,10,39,7,32,39,7,32,,,
245999,10,2559,1269,1290,401,163,238,2158,1106,1052
246017,10,1459,948,511,487,396,91,972,552,420
246035,10,285,44,241,285,44,241,,,
246071,10,50,8,42,50,8,42,,,
246345,10,55,18,37,22,9,13,33,9,24
246354,10,10641,4129,6512,2026,751,1275,8615,3378,5237
246406,10,15,3,12,15,3,12,,,
246415,10,68,3,65,20,2,18,48,1,47
246460,10,106,9,97,106,9,97,,,
246789,10,117,72,45,25,14,11,92,58,34
246813,10,3865,1318,2547,681,301,380,3184,1017,2167
246895,10,443,178,265,251,84,167,192,94,98
246974,10,403,42,361,403,42,361,,,
247010,10,44,0,44,44,0,44,,,
247047,10,88,2,86,88,2,86,,,
247065,10,653,47,606,381,20,361,272,27,245
247153,10,216,48,168,216,48,168,,,
247162,10,64,26,38,31,15,16,33,11,22
247409,10,68,0,68,68,0,68,,,
247603,10,2181,1161,1020,1339,741,598,842,420,422
247649,10,624,381,243,371,237,134,253,144,109
247773,10,68,68,0,68,68,0,,,
247834,10,35077,15784,19293,11361,5876,5485,23716,9908,13808
247940,10,4621,2088,2533,1592,700,892,3029,1388,1641
248192,10,25,0,25,25,0,25,,,
248527,10,83,0,83,83,0,83,,,
248606,10,1706,1007,699,180,68,112,1526,939,587
248624,10,77,17,60,77,17,60,,,
248633,10,56,2,54,56,2,54,,,
248660,10,137,33,104,121,33,88,16,0,16
248703,10,227,2,225,104,1,103,123,1,122
248925,10,1016,675,341,592,348,244,424,327,97
248934,10,11740,4656,7084,11616,4610,7006,124,46,78
249061,10,49,0,49,25,0,25,24,0,24
249238,10,330,15,315,212,7,205,118,8,110
249609,10,167,103,64,167,103,64,,,
250027,10,305,95,210,300,95,205,5,0,5
250285,10,288,258,30,161,146,15,127,112,15
250744,10,377,44,333,377,44,333,,,
250902,10,102,7,95,55,4,51,47,3,44
250993,10,549,314,235,30,11,19,519,303,216
251260,10,4386,1937,2449,2340,1177,1163,2046,760,1286
251312,10,510,80,430,395,64,331,115,16,99
260336,10,17,4,13,17,4,13,,,
260363,10,8,0,8,8,0,8,,,
260372,10,303,70,233,116,20,96,187,50,137
260664,10,310,222,88,310,222,88,,,
260691,10,768,207,561,768,207,561,,,
260789,10,667,138,529,667,138,529,,,
260813,10,232,26,206,232,26,206,,,
260929,10,186,17,169,185,17,168,1,0,1
260965,10,77,0,77,77,0,77,,,
260992,10,514,38,476,165,22,143,349,16,333
261436,10,834,57,777,834,57,777,,,
261676,10,18,1,17,18,1,17,,,
261685,10,32,1,31,32,1,31,,,
261719,10,220,1,219,220,1,219,,,
261773,10,34,7,27,32,6,26,2,1,1
261861,10,8,0,8,8,0,8,,,
262031,10,5800,2386,3414,3139,1404,1735,2661,982,1679
262086,10,8689,2560,6129,2401,754,1647,6288,1806,4482
262129,10,689,227,462,681,221,460,8,6,2
262341,10,615,535,80,615,535,80,,,
262369,10,97,0,97,97,0,97,,,
262457,10,435,60,375,435,60,375,,,
262466,10,32,18,14,32,18,14,,,
362700,10,428,37,391,418,36,382,10,1,9
362782,10,242,6,236,82,2,80,160,4,156
363013,10,28,3,25,28,3,25,,,
363147,10,421,2,419,421,2,419,,,
363165,10,1919,1038,881,567,306,261,1352,732,620
363633,10,774,347,427,252,106,146,522,241,281
363679,10,209,3,206,190,3,187,19,0,19
363712,10,44,44,0,44,44,0,,,
363882,10,88,1,87,88,1,87,,,
363907,10,506,283,223,338,197,141,168,86,82
363916,10,159,46,113,119,35,84,40,11,29
363934,10,860,682,178,434,346,88,426,336,90
364016,10,5676,2545,3131,1582,840,742,4094,1705,2389
364025,10,13775,6574,7201,3451,1803,1648,10324,4771,5553
364548,10,201,103,98,135,58,77,66,45,21
364575,10,26,0,26,26,0,26,,,
364627,10,427,223,204,71,21,50,356,202,154
364636,10,162,37,125,131,37,94,31,0,31
364760,10,48,6,42,23,3,20,25,3,22
364946,10,381,184,197,87,20,67,294,164,130
364964,10,23,3,20,23,3,20,,,
365091,10,317,14,303,317,14,303,,,
365125,10,194,6,188,194,6,188,,,
365198,10,563,274,289,44,2,42,519,272,247
365213,10,458,229,229,118,34,84,340,195,145
365240,10,18,12,6,18,12,6,,,
365374,10,1608,901,707,286,140,146,1322,761,561
365383,10,65,5,60,65,5,60,,,
365480,10,806,428,378,114,20,94,692,408,284
365505,10,19,3,16,19,3,16,,,
365693,10,138,0,138,138,0,138,,,
365763,10,31,6,25,31,6,25,,,
365824,10,99,6,93,99,6,93,,,
365833,10,116,8,108,116,8,108,,,
366003,10,317,140,177,113,34,79,204,106,98
366155,10,30,12,18,30,12,18,,,
366191,10,1216,1176,40,1216,1176,40,,,
366252,10,4241,2729,1512,3479,2454,1025,762,275,487
366261,10,275,90,185,257,83,174,18,7,11
366270,10,304,11,293,304,11,293,,,
366289,10,31,25,6,31,25,6,,,
366340,10,281,91,190,173,58,115,108,33,75
366368,10,104,31,73,103,31,72,1,0,1
366395,10,20014,8983,11031,9113,4452,4661,10901,4531,6370
366401,10,6724,3173,3551,2174,1134,1040,4550,2039,2511
366438,10,28,2,26,16,2,14,12,0,12
366465,10,2045,704,1341,764,293,471,1281,411,870
366535,10,255,35,220,255,35,220,,,
366553,10,578,244,334,575,244,331,3,0,3
366571,10,22,3,19,22,3,19,,,
366605,10,7,5,2,7,5,2,,,
366623,10,261,125,136,32,9,23,229,116,113
366632,10,5,0,5,5,0,5,,,
366711,10,15109,5955,9154,11975,4693,7282,3134,1262,1872
367051,10,79,2,77,47,2,45,32,0,32
367088,10,107,3,104,65,3,62,42,0,42
367103,10,119,93,26,119,93,26,,,
367112,10,165,24,141,151,21,130,14,3,11
367158,10,53,1,52,53,1,52,,,
367334,10,189,166,23,148,130,18,41,36,5
367361,10,90,60,30,86,58,28,4,2,2
367431,10,42,1,41,42,1,41,,,
367459,10,7593,3090,4503,1882,832,1050,5711,2258,3453
367875,10,1053,343,710,860,271,589,193,72,121
367884,10,443,140,303,284,80,204,159,60,99
367954,10,5152,1499,3653,4768,1408,3360,384,91,293
367972,10,106,3,103,106,3,103,,,
367981,10,62,0,62,37,0,37,25,0,25
368230,10,94,4,90,65,1,64,29,3,26
368364,10,332,177,155,165,104,61,167,73,94
368407,10,32,2,30,1,1,0,31,1,30
368443,10,371,103,268,371,103,268,,,
368452,10,298,109,189,298,109,189,,,
368629,10,474,98,376,474,98,376,,,
368647,10,9,1,8,9,1,8,,,
368771,10,241,53,188,241,53,188,,,
368832,10,53,11,42,17,5,12,36,6,30
368911,10,1757,495,1262,271,76,195,1486,419,1067
369002,10,295,110,185,109,38,71,186,72,114
369400,10,943,903,40,943,903,40,,,
369419,10,642,349,293,642,349,293,,,
369446,10,42,3,39,23,3,20,19,0,19
369455,10,190,40,150,190,40,150,,,
369516,10,135,29,106,135,29,106,,,
369659,10,160,29,131,132,25,107,28,4,24
369668,10,131,46,85,92,44,48,39,2,37
369686,10,69,14,55,69,14,55,,,
369783,10,282,16,266,282,16,266,,,
369950,10,92,80,12,92,80,12,,,
371052,10,232,40,192,232,40,192,,,
371690,10,813,184,629,98,10,88,715,174,541
371830,10,112,94,18,110,94,16,2,0,2
371928,10,115,41,74,115,41,74,,,
371964,10,342,248,94,342,248,94,,,
372028,10,128,19,109,128,19,109,,,
372073,10,151,47,104,151,47,104,,,
372082,10,103,32,71,93,32,61,10,0,10
372240,10,21,0,21,21,0,21,,,
372329,10,384,45,339,384,45,339,,,
372356,10,188,4,184,188,4,184,,,
372462,10,113,19,94,110,18,92,3,1,2
372921,10,450,155,295,450,155,295,,,
373085,10,28,0,28,24,0,24,4,0,4
373216,10,119,21,98,119,21,98,,,
373456,10,26,1,25,18,1,17,8,0,8
373526,10,279,209,70,279,209,70,,,
373678,10,113,46,67,81,37,44,32,9,23
373696,10,59,25,34,41,16,25,18,9,9
373711,10,63,6,57,63,6,57,,,
373784,10,475,255,220,475,255,220,,,
374024,10,227,52,175,13,1,12,214,51,163
374316,10,60,47,13,38,35,3,22,12,10
374343,10,58,1,57,58,1,57,,,
374574,10,675,117,558,472,94,378,203,23,180
374592,10,47,15,32,47,15,32,,,
375106,10,138,114,24,123,100,23,15,14,1
375230,10,196,196,0,196,196,0,,,
375373,10,115,48,67,5,0,5,110,48,62
375407,10,95,24,71,84,19,65,11,5,6
375416,10,186,51,135,186,51,135,,,
375540,10,38,0,38,14,0,14,24,0,24
375568,10,42,13,29,4,4,0,38,9,29
375656,10,165,77,88,23,3,20,142,74,68
375683,10,934,566,368,158,108,50,776,458,318
375726,10,568,305,263,401,186,215,167,119,48
375939,10,121,23,98,121,23,98,,,
375966,10,127,11,116,73,6,67,54,5,49
375984,10,186,9,177,142,7,135,44,2,42
376224,10,185,42,143,155,38,117,30,4,26
376242,10,60,51,9,60,51,9,,,
376288,10,111,30,81,111,30,81,,,
376330,10,196,52,144,196,52,144,,,
376385,10,185,87,98,180,86,94,5,1,4
376446,10,72,1,71,16,1,15,56,0,56
376631,10,21,8,13,19,8,11,2,0,2
376677,10,128,48,80,126,46,80,2,2,0
376695,10,1384,616,768,597,277,320,787,339,448
377111,10,181,72,109,181,72,109,,,
377193,10,28,2,26,11,1,10,17,1,16
377218,10,125,121,4,125,121,4,,,
377272,10,17,3,14,17,3,14,,,
377281,10,71,6,65,71,6,65,,,
377315,10,75,0,75,75,0,75,,,
377449,10,209,95,114,168,83,85,41,12,29
377458,10,221,89,132,160,76,84,61,13,48
377485,10,54,7,47,15,3,12,39,4,35
377546,10,119,42,77,114,41,73,5,1,4
377555,10,5735,3124,2611,4725,2562,2163,1010,562,448
377564,10,4794,2408,2386,4096,2089,2007,698,319,379
377643,10,108,7,101,108,7,101,,,
377652,10,152,8,144,152,8,144,,,
377661,10,615,97,518,615,97,518,,,
377722,10,436,21,415,436,21,415,,,
377759,10,151,146,5,151,146,5,,,
378105,10,446,14,432,328,12,316,118,2,116
378576,10,989,162,827,371,64,307,618,98,520
378886,10,243,55,188,75,17,58,168,38,130
378956,10,608,565,43,608,565,43,,,
379621,10,72,5,67,56,5,51,16,0,16
379746,10,365,18,347,365,18,347,,,
379782,10,218,20,198,218,20,198,,,
380067,10,268,2,266,268,2,266,,,
380359,10,538,101,437,187,48,139,351,53,298
380368,10,1648,667,981,413,151,262,1235,516,719
380377,10,643,146,497,454,112,342,189,34,155
380438,10,712,96,616,712,96,616,,,
381255,10,78,61,17,78,61,17,,,
381282,10,81,31,50,81,31,50,,,
381325,10,109,36,73,109,36,73,,,
381352,10,65,16,49,55,11,44,10,5,5
381370,10,279,17,262,140,11,129,139,6,133
381404,10,390,14,376,141,4,137,249,10,239
381459,10,321,219,102,67,48,19,254,171,83
381486,10,19,0,19,19,0,19,,,
381699,10,38,0,38,26,0,26,12,0,12
381732,10,55,13,42,7,2,5,48,11,37
382258,10,142,13,129,62,3,59,80,10,70
382416,10,80,18,62,80,18,62,,,
382461,10,42,1,41,27,1,26,15,0,15
382780,10,155,9,146,136,7,129,19,2,17
382911,10,54,23,31,40,18,22,14,5,9
382957,10,353,95,258,342,93,249,11,2,9
383020,10,56,12,44,42,8,34,14,4,10
383084,10,337,126,211,256,85,171,81,41,40
383163,10,174,2,172,43,0,43,131,2,129
383190,10,2127,845,1282,660,345,315,1467,500,967
383279,10,178,24,154,60,10,50,118,14,104
383297,10,185,8,177,34,0,34,151,8,143
383312,10,65,26,39,65,26,39,,,
383330,10,76,15,61,76,15,61,,,
383367,10,127,33,94,107,30,77,20,3,17
383464,10,134,9,125,134,9,125,,,
383525,10,43,9,34,43,9,34,,,
383765,10,148,6,142,98,5,93,50,1,49
383996,10,691,253,438,151,47,104,540,206,334
384236,10,978,360,618,978,360,618,,,
384245,10,711,259,452,711,259,452,,,
384254,10,501,331,170,457,303,154,44,28,16
384306,10,116,20,96,77,12,65,39,8,31
384333,10,9620,3752,5868,2421,977,1444,7199,2775,4424
384342,10,4774,2038,2736,1599,770,829,3175,1268,1907
384412,10,534,329,205,534,329,205,,,
384421,10,95,95,0,95,95,0,,,
385132,10,115,6,109,78,5,73,37,1,36
385415,10,1303,560,743,1088,464,624,215,96,119
385503,10,210,15,195,210,15,195,,,
385619,10,2624,1295,1329,2578,1277,1301,46,18,28
386153,10,426,0,426,366,0,366,60,0,60
386472,10,746,142,604,436,85,351,310,57,253
387925,10,113,11,102,113,11,102,,,
388520,10,205,124,81,73,51,22,132,73,59
389860,10,326,163,163,217,79,138,109,84,25
390905,10,237,133,104,58,42,16,179,91,88
391005,10,117,3,114,117,3,114,,,
391759,10,22,0,22,,,,22,0,22
392257,10,3201,230,2971,3201,230,2971,,,
392354,10,10,2,8,10,2,8,,,
392415,10,258,71,187,258,71,187,,,
393649,10,1288,497,791,1288,497,791,,,
393861,10,463,84,379,428,80,348,35,4,31
395362,10,1402,481,921,370,118,252,1032,363,669
395690,10,276,169,107,276,169,107,,,
397942,10,1150,333,817,1150,333,817,,,
399212,10,11696,7519,4177,2201,1104,1097,9495,6415,3080
399869,10,541,515,26,541,515,26,,,
399911,10,455,163,292,455,163,292,,,
400080,10,1017,698,319,1017,698,319,,,
400187,10,516,70,446,327,50,277,189,20,169
400558,10,57,18,39,57,18,39,,,
401223,10,424,150,274,183,56,127,241,94,147
401250,10,107,25,82,59,14,45,48,11,37
401764,10,223,5,218,71,0,71,152,5,147
402563,10,210,11,199,210,11,199,,,
402800,10,146,4,142,136,3,133,10,1,9
403469,10,1740,1077,663,216,101,115,1524,976,548
403478,10,636,283,353,347,167,180,289,116,173
403487,10,926,357,569,417,192,225,509,165,344
404055,10,269,30,239,269,30,239,,,
404222,10,216,76,140,213,74,139,3,2,1
404338,10,43,18,25,43,18,25,,,
404426,10,2535,1151,1384,862,450,412,1673,701,972
404684,10,313,91,222,313,91,222,,,
404718,10,255,4,251,255,4,251,,,
404912,10,802,160,642,802,160,642,,,
405012,10,87,1,86,87,1,86,,,
405058,10,149,149,0,149,149,0,,,
405076,10,470,70,400,470,70,400,,,
405854,10,237,237,0,237,237,0,,,
405872,10,2891,1194,1697,862,450,412,2029,744,1285
406024,10,1962,247,1715,1082,127,955,880,120,760
406033,10,3163,395,2768,1922,247,1675,1241,148,1093
406149,10,86,18,68,86,18,68,,,
406325,10,140,8,132,36,4,32,104,4,100
406361,10,11,1,10,11,1,10,,,
406422,10,70,3,67,36,0,36,34,3,31
406486,10,35,21,14,19,12,7,16,9,7
406547,10,45,3,42,26,3,23,19,0,19
407090,10,468,5,463,139,2,137,329,3,326
407142,10,103,1,102,103,1,102,,,
407151,10,70,0,70,70,0,70,,,
407179,10,91,3,88,61,2,59,30,1,29
407355,10,181,24,157,181,24,157,,,
407434,10,59,1,58,59,1,58,,,
407461,10,72,54,18,72,54,18,,,
407470,10,145,5,140,112,4,108,33,1,32
407489,10,73,54,19,9,0,9,64,54,10
407513,10,127,53,74,38,3,35,89,50,39
407522,10,33,12,21,,,,33,12,21
407568,10,138,6,132,118,2,116,20,4,16
407577,10,69,36,33,46,19,27,23,17,6
407595,10,45,2,43,45,2,43,,,
407610,10,52,35,17,2,2,0,50,33,17
407629,10,4307,1868,2439,4307,1868,2439,,,
407683,10,60,2,58,30,2,28,30,0,30
407708,10,210,7,203,210,7,203,,,
407735,10,64,1,63,64,1,63,,,
407832,10,189,117,72,75,46,29,114,71,43
408066,10,182,40,142,122,29,93,60,11,49
408163,10,43,2,41,43,2,41,,,
408385,10,645,274,371,645,274,371,,,
408729,10,21,1,20,20,0,20,1,1,0
408844,10,2718,804,1914,1750,582,1168,968,222,746
408862,10,298,5,293,132,3,129,166,2,164
409032,10,53,1,52,53,1,52,,,
409120,10,61,24,37,61,24,37,,,
409193,10,175,170,5,175,170,5,,,
409254,10,331,7,324,39,0,39,292,7,285
409315,10,27894,12006,15888,8427,3730,4697,19467,8276,11191
409537,10,17,5,12,,,,17,5,12
409591,10,88,18,70,44,7,37,44,11,33
409616,10,552,230,322,550,230,320,2,0,2
409698,10,7045,2688,4357,5949,2180,3769,1096,508,588
410797,10,87,45,42,87,45,42,,,
410964,10,39,0,39,35,0,35,4,0,4
411684,10,150,46,104,150,46,104,,,
411754,10,37,8,29,37,8,29,,,
412173,10,506,47,459,466,44,422,40,3,37
412535,10,37,3,34,35,3,32,2,0,2
412544,10,150,8,142,93,7,86,57,1,56
412599,10,344,100,244,344,100,244,,,
413176,10,37,21,16,37,21,16,,,
413413,10,39727,6599,33128,9187,1530,7657,30540,5069,25471
413617,10,281,77,204,67,25,42,214,52,162
413626,10,172,52,120,99,30,69,73,22,51
413680,10,336,321,15,336,321,15,,,
413820,10,21,0,21,21,0,21,,,
413893,10,1276,444,832,1276,444,832,,,
413972,10,30,2,28,30,2,28,,,
414063,10,102,0,102,95,0,95,7,0,7
414124,10,292,221,71,225,175,50,67,46,21
414461,10,2220,2106,114,2004,1899,105,216,207,9
414489,10,105,1,104,105,1,104,,,
414540,10,251,6,245,214,5,209,37,1,36
414595,10,620,129,491,290,64,226,330,65,265
414869,10,333,4,329,104,3,101,229,1,228
414878,10,4344,3168,1176,1514,1127,387,2830,2041,789
414911,10,2270,850,1420,631,282,349,1639,568,1071
414939,10,300,40,260,300,40,260,,,
414966,10,133,64,69,24,11,13,109,53,56
415039,10,49,3,46,37,3,34,12,0,12
415057,10,20,20,0,20,20,0,,,
415987,10,86,6,80,86,6,80,,,
416458,10,126,42,84,126,42,84,,,
416801,10,364,75,289,315,62,253,49,13,36
417008,10,110,2,108,110,2,108,,,
417062,10,57,2,55,44,0,44,13,2,11
417105,10,405,261,144,281,162,119,124,99,25
417123,10,87,35,52,41,19,22,46,16,30
417248,10,51,49,2,51,49,2,,,
417275,10,27,25,2,27,25,2,,,
417327,10,152,24,128,91,18,73,61,6,55
417442,10,67,1,66,67,1,66,,,
417503,10,224,0,224,136,0,136,88,0,88
417600,10,13,0,13,13,0,13,,,
417628,10,20,2,18,19,2,17,1,0,1
417637,10,47,16,31,47,16,31,,,
417646,10,23,1,22,23,1,22,,,
417655,10,19,2,17,19,2,17,,,
417682,10,15,1,14,15,1,14,,,
417716,10,193,4,189,193,4,189,,,
417725,10,45,2,43,45,2,43,,,
417734,10,134,30,104,49,14,35,85,16,69
417752,10,19,8,11,17,7,10,2,1,1
417831,10,108,77,31,108,77,31,,,
417840,10,393,29,364,393,29,364,,,
417868,10,39,12,27,18,4,14,21,8,13
417886,10,20,1,19,20,1,19,,,
417910,10,201,31,170,201,31,170,,,
417983,10,29,0,29,,,,29,0,29
417992,10,46,3,43,28,2,26,18,1,17
418001,10,83,3,80,83,3,80,,,
418010,10,67,5,62,34,1,33,33,4,29
418029,10,42,4,38,42,4,38,,,
418038,10,170,17,153,170,17,153,,,
418065,10,257,32,225,204,24,180,53,8,45
418083,10,50,8,42,50,8,42,,,
418126,10,193,64,129,110,35,75,83,29,54
418171,10,54,54,0,54,54,0,,,
418199,10,45,32,13,6,6,0,39,26,13
418205,10,176,103,73,124,72,52,52,31,21
418223,10,115,7,108,115,7,108,,,
418250,10,211,132,79,39,21,18,172,111,61
418269,10,86,45,41,86,45,41,,,
418278,10,115,30,85,66,19,47,49,11,38
418296,10,1541,841,700,468,147,321,1073,694,379
418302,10,530,255,275,103,20,83,427,235,192
418320,10,910,480,430,60,18,42,850,462,388
418348,10,492,338,154,67,57,10,425,281,144
418357,10,148,76,72,21,8,13,127,68,59
418409,10,213,104,109,151,63,88,62,41,21
418427,10,89,8,81,78,8,70,11,0,11
418445,10,26,0,26,18,0,18,8,0,8
418454,10,56,34,22,55,33,22,1,1,0
418481,10,38,0,38,38,0,38,,,
418515,10,86,6,80,75,6,69,11,0,11
418524,10,43,2,41,43,2,41,,,
418533,10,239,34,205,200,22,178,39,12,27
418542,10,81,9,72,35,3,32,46,6,40
418560,10,87,14,73,24,1,23,63,13,50
418588,10,34,1,33,34,1,33,,,
418612,10,7,0,7,7,0,7,,,
418658,10,369,314,55,369,314,55,,,
418773,10,371,176,195,296,163,133,75,13,62
418782,10,275,264,11,275,264,11,,,
418889,10,51,45,6,33,28,5,18,17,1
418913,10,14,4,10,14,4,10,,,
418968,10,103,1,102,103,1,102,,,
419031,10,35,2,33,35,2,33,,,
419095,10,40,3,37,40,3,37,,,
419183,10,82,7,75,82,7,75,,,
419217,10,59,11,48,59,11,48,,,
419226,10,506,249,257,363,202,161,143,47,96
419235,10,148,29,119,148,29,119,,,
419244,10,250,196,54,121,101,20,129,95,34
419253,10,26,21,5,26,21,5,,,
419280,10,29,0,29,25,0,25,4,0,4
419341,10,9,4,5,9,4,5,,,
419420,10,39,15,24,39,15,24,,,
419484,10,19,2,17,19,2,17,,,
419633,10,85,11,74,85,11,74,,,
419703,10,452,429,23,452,429,23,,,
419712,10,129,127,2,129,127,2,,,
419721,10,249,235,14,249,235,14,,,
420024,10,189,19,170,160,15,145,29,4,25
420042,10,25,14,11,25,14,11,,,
420130,10,264,12,252,264,12,252,,,
420246,10,591,80,511,548,70,478,43,10,33
420255,10,77,75,2,77,75,2,,,
420325,10,79,79,0,79,79,0,,,
420343,10,861,832,29,687,667,20,174,165,9
420370,10,438,139,299,438,139,299,,,
420398,10,17222,7191,10031,3481,1592,1889,13741,5599,8142
420431,10,1819,632,1187,327,103,224,1492,529,963
420440,10,1625,592,1033,445,194,251,1180,398,782
420468,10,248,107,141,198,101,97,50,6,44
420538,10,1247,488,759,480,199,281,767,289,478
420556,10,1039,363,676,290,115,175,749,248,501
420705,10,149,101,48,61,41,20,88,60,28
420723,10,538,228,310,110,40,70,428,188,240
420981,10,339,45,294,339,45,294,,,
421513,10,48,5,43,43,3,40,5,2,3
421610,10,134,8,126,128,8,120,6,0,6
421665,10,46,1,45,25,1,24,21,0,21
421708,10,1177,145,1032,925,103,822,252,42,210
421717,10,29,20,9,11,9,2,18,11,7
421771,10,49,0,49,34,0,34,15,0,15
421841,10,376,169,207,376,169,207,,,
421878,10,387,36,351,293,28,265,94,8,86
421896,10,190,69,121,190,69,121,,,
422020,10,229,218,11,229,218,11,,,
422695,10,272,19,253,257,17,240,15,2,13
422835,10,280,50,230,280,50,230,,,
423120,10,724,72,652,718,71,647,6,1,5
423397,10,543,328,215,543,328,215,,,
423412,10,32,27,5,32,27,5,,,
423643,10,3782,1486,2296,3698,1459,2239,84,27,57
423652,10,398,105,293,158,37,121,240,68,172
425250,10,80,12,68,52,9,43,28,3,25
425986,10,172,21,151,172,21,151,,,
426314,10,11574,9450,2124,4009,3142,867,7565,6308,1257
427308,10,129,4,125,129,4,125,,,
427335,10,74,0,74,68,0,68,6,0,6
427894,10,60,59,1,60,59,1,,,
427973,10,232,206,26,152,134,18,80,72,8
427982,10,149,95,54,129,85,44,20,10,10
427991,10,621,333,288,350,178,172,271,155,116
428000,10,87,20,67,87,20,67,,,
428019,10,241,124,117,25,11,14,216,113,103
428055,10,141,35,106,141,35,106,,,
428125,10,49,35,14,48,34,14,1,1,0
428170,10,608,60,548,363,34,329,245,26,219
428259,10,124,28,96,48,14,34,76,14,62
428392,10,1580,661,919,509,230,279,1071,431,640
429085,10,87,23,64,37,11,26,50,12,38
429094,10,135,24,111,95,16,79,40,8,32
429128,10,596,27,569,7,0,7,589,27,562
430184,10,1535,452,1083,226,118,108,1309,334,975
430227,10,74,1,73,57,1,56,17,0,17
430245,10,611,162,449,611,162,449,,,
430306,10,54,18,36,32,14,18,22,4,18
430403,10,220,14,206,220,14,206,,,
430564,10,36,11,25,17,4,13,19,7,12
430582,10,409,189,220,409,189,220,,,
430670,10,407,161,246,407,161,246,,,
430704,10,91,28,63,89,28,61,2,0,2
430795,10,155,43,112,155,43,112,,,
430883,10,29,2,27,29,2,27,,,
430908,10,29,4,25,17,2,15,12,2,10
430935,10,618,455,163,444,327,117,174,128,46
430971,10,36,5,31,36,5,31,,,
431017,10,359,220,139,79,39,40,280,181,99
431071,10,23,7,16,12,5,7,11,2,9
431105,10,95,7,88,39,4,35,56,3,53
431123,10,138,136,2,138,136,2,,,
431141,10,1299,492,807,1258,489,769,41,3,38
431187,10,152,137,15,152,137,15,,,
431196,10,94,7,87,94,7,87,,,
431266,10,101,4,97,31,3,28,70,1,69
431275,10,33,5,28,8,2,6,25,3,22
431284,10,68,0,68,60,0,60,8,0,8
431558,10,287,95,192,276,92,184,11,3,8
431600,10,168,32,136,140,24,116,28,8,20
431716,10,452,209,243,452,209,243,,,
431983,10,74,74,0,74,74,0,,,
432117,10,174,3,171,109,2,107,65,1,64
432269,10,72,60,12,72,60,12,,,
432348,10,152,83,69,152,83,69,,,
432384,10,442,90,352,442,90,352,,,
432524,10,129,43,86,124,41,83,5,2,3
433004,10,510,141,369,510,141,369,,,
433013,10,714,231,483,714,231,483,,,
433040,10,41,3,38,41,3,38,,,
433068,10,273,179,94,216,123,93,57,56,1
433101,10,673,83,590,471,64,407,202,19,183
433138,10,126,17,109,107,10,97,19,7,12
433174,10,409,54,355,72,12,60,337,42,295
433387,10,156935,57842,99093,156935,57842,99093,,,
433420,10,333,286,47,333,286,47,,,
433536,10,375,38,337,216,23,193,159,15,144
433660,10,15969,6755,9214,12145,5122,7023,3824,1633,2191
434016,10,208,75,133,75,30,45,133,45,88
434061,10,5677,2146,3531,3019,1311,1708,2658,835,1823
434140,10,684,148,536,684,148,536,,,
434159,10,431,351,80,431,351,80,,,
434274,10,82,12,70,55,7,48,27,5,22
434283,10,49,2,47,47,2,45,2,0,2
434308,10,386,16,370,386,16,370,,,
434344,10,217,7,210,217,7,210,,,
434362,10,35,34,1,35,34,1,,,
434432,10,13,1,12,13,1,12,,,
434441,10,77,15,62,77,15,62,,,
434469,10,279,42,237,277,42,235,2,0,2
434496,10,92,1,91,92,1,91,,,
434539,10,11,7,4,6,4,2,5,3,2
434584,10,179,57,122,48,17,31,131,40,91
434672,10,15319,5638,9681,4058,1968,2090,11261,3670,7591
434751,10,102,25,77,47,11,36,55,14,41
434821,10,588,27,561,588,27,561,,,
434830,10,160,1,159,111,1,110,49,0,49
434900,10,363,94,269,206,46,160,157,48,109
434937,10,43,43,0,43,43,0,,,
435000,10,1015,385,630,928,365,563,87,20,67
436030,10,206,92,114,121,68,53,85,24,61
436261,10,25,3,22,25,3,22,,,
436304,10,2339,1221,1118,1160,623,537,1179,598,581
436429,10,5588,3620,1968,5588,3620,1968,,,
436553,10,773,136,637,773,136,637,,,
436599,10,118,20,98,7,0,7,111,20,91
436614,10,82,53,29,31,19,12,51,34,17
436632,10,142,27,115,78,20,58,64,7,57
436641,10,20,8,12,20,8,12,,,
436650,10,158,12,146,158,12,146,,,
436775,10,113,5,108,113,5,108,,,
436818,10,768,330,438,696,295,401,72,35,37
436827,10,493,274,219,463,258,205,30,16,14
436836,10,2297,1185,1112,2105,1079,1026,192,106,86
437097,10,1189,743,446,1149,716,433,40,27,13
437103,10,9284,3219,6065,3560,1359,2201,5724,1860,3864
437237,10,83,70,13,83,70,13,,,
437556,10,1108,451,657,1017,440,577,91,11,80
437608,10,134,101,33,132,99,33,2,2,0
437635,10,697,68,629,697,68,629,,,
437723,10,22,10,12,22,10,12,,,
437732,10,65,4,61,49,2,47,16,2,14
437750,10,90,89,1,90,89,1,,,
437769,10,140,10,130,140,10,130,,,
437778,10,247,8,239,247,8,239,,,
437857,10,115,2,113,91,1,90,24,1,23
437936,10,669,83,586,669,83,586,,,
438179,10,230,32,198,230,32,198,,,
438221,10,144,12,132,127,11,116,17,1,16
438258,10,466,86,380,466,86,380,,,
438285,10,240,22,218,240,22,218,,,
438337,10,190,74,116,148,55,93,42,19,23
438504,10,1401,1347,54,1401,1347,54,,,
438586,10,1050,357,693,833,280,553,217,77,140
438674,10,41,0,41,21,0,21,20,0,20
438708,10,376,83,293,120,29,91,256,54,202
438735,10,156,142,14,102,94,8,54,48,6
438984,10,53,18,35,53,18,35,,,
439020,10,46,10,36,34,7,27,12,3,9
439118,10,298,45,253,298,45,253,,,
439190,10,1844,909,935,1064,541,523,780,368,412
439367,10,1214,349,865,1214,349,865,,,
439394,10,55,10,45,55,10,45,,,
439446,10,145,26,119,145,26,119,,,
439455,10,324,14,310,160,9,151,164,5,159
439473,10,205,64,141,101,34,67,104,30,74
439491,10,245,30,215,245,30,215,,,
439570,10,451,17,434,451,17,434,,,
439622,10,436,58,378,436,58,378,,,
439668,10,411,353,58,411,353,58,,,
439686,10,8,0,8,8,0,8,,,
439701,10,532,211,321,193,71,122,339,140,199
439738,10,375,69,306,375,69,306,,,
439747,10,190,33,157,127,25,102,63,8,55
439774,10,62,21,41,46,19,27,16,2,14
439783,10,190,53,137,111,30,81,79,23,56
439792,10,345,38,307,339,38,301,6,0,6
439817,10,193,83,110,54,27,27,139,56,83
439844,10,54,0,54,54,0,54,,,
439862,10,153,92,61,64,25,39,89,67,22
439871,10,182,4,178,179,4,175,3,0,3
439899,10,81,39,42,64,26,38,17,13,4
439914,10,33,5,28,33,5,28,,,
439932,10,56,5,51,56,5,51,,,
439969,10,138,46,92,138,46,92,,,
440004,10,34,8,26,34,8,26,,,
440031,10,668,202,466,638,195,443,30,7,23
440059,10,728,673,55,486,446,40,242,227,15
440101,10,111,4,107,51,0,51,60,4,56
440262,10,408,389,19,293,277,16,115,112,3
440271,10,152,69,83,152,69,83,,,
440396,10,294,141,153,240,111,129,54,30,24
440402,10,1592,538,1054,566,222,344,1026,316,710
440651,10,505,119,386,297,87,210,208,32,176
440730,10,384,141,243,384,141,243,,,
440749,10,61,43,18,6,5,1,55,38,17
440776,10,51,20,31,51,20,31,,,
440794,10,558,147,411,454,103,351,104,44,60
440819,10,12,8,4,12,8,4,,,
440828,10,1273,607,666,752,348,404,521,259,262
440855,10,154,6,148,154,6,148,,,
440989,10,444,350,94,444,350,94,,,
441025,10,174,56,118,168,55,113,6,1,5
441052,10,1465,383,1082,1465,383,1082,,,
441070,10,143,56,87,39,16,23,104,40,64
441104,10,343,73,270,181,28,153,162,45,117
441131,10,283,69,214,169,44,125,114,25,89
441168,10,26,1,25,26,1,25,,,
441210,10,600,221,379,87,3,84,513,218,295
441229,10,1640,324,1316,1640,324,1316,,,
441256,10,43,1,42,43,1,42,,,
441371,10,6368,199,6169,6358,199,6159,10,0,10
441380,10,227,88,139,183,70,113,44,18,26
441414,10,123,27,96,21,10,11,102,17,85
441423,10,680,218,462,680,218,462,,,
441487,10,68,4,64,68,4,64,,,
441496,10,185,159,26,132,114,18,53,45,8
441502,10,352,24,328,352,24,328,,,
441575,10,294,20,274,294,20,274,,,
441593,10,12,1,11,12,1,11,,,
441609,10,183,183,0,183,183,0,,,
441618,10,18,0,18,9,0,9,9,0,9
441636,10,360,61,299,306,46,260,54,15,39
441645,10,124,3,121,96,3,93,28,0,28
441663,10,261,27,234,261,27,234,,,
441672,10,42,6,36,42,6,36,,,
441690,10,152,95,57,52,30,22,100,65,35
441706,10,267,120,147,267,120,147,,,
441742,10,849,79,770,766,71,695,83,8,75
441760,10,4808,2180,2628,1370,717,653,3438,1463,1975
441788,10,406,366,40,273,243,30,133,123,10
441830,10,41,10,31,41,10,31,,,
441858,10,202,9,193,177,5,172,25,4,21
441876,10,211,6,205,127,5,122,84,1,83
441900,10,7169,1972,5197,2014,441,1573,5155,1531,3624
441937,10,6128,2099,4029,4468,1459,3009,1660,640,1020
441982,10,386,194,192,356,178,178,30,16,14
442064,10,92,14,78,86,10,76,6,4,2
442073,10,600,123,477,433,105,328,167,18,149
442134,10,320,64,256,320,64,256,,,
442240,10,405,79,326,248,45,203,157,34,123
442295,10,265,132,133,240,124,116,25,8,17
442329,10,931,832,99,931,832,99,,,
442356,10,1775,207,1568,556,66,490,1219,141,1078
442383,10,146,21,125,146,21,125,,,
442426,10,425,39,386,290,25,265,135,14,121
442435,10,61,12,49,61,12,49,,,
442444,10,969,500,469,969,500,469,,,
442523,10,77,29,48,73,27,46,4,2,2
442569,10,5436,2150,3286,1976,784,1192,3460,1366,2094
442602,10,377,51,326,377,51,326,,,
442611,10,1274,1195,79,1274,1195,79,,,
442639,10,569,371,198,569,371,198,,,
442657,10,241,13,228,241,13,228,,,
442781,10,922,199,723,232,46,186,690,153,537
442806,10,2446,1044,1402,2446,1044,1402,,,
442842,10,233,40,193,94,17,77,139,23,116
442879,10,886,73,813,867,70,797,19,3,16
442888,10,46,44,2,46,44,2,,,
442930,10,517,236,281,479,216,263,38,20,18
442976,10,64,6,58,64,6,58,,,
442985,10,263,35,228,263,35,228,,,
443021,10,24,23,1,24,23,1,,,
443030,10,75,23,52,75,23,52,,,
443049,10,335,190,145,168,91,77,167,99,68
443058,10,211,96,115,65,28,37,146,68,78
443076,10,146,76,70,79,43,36,67,33,34
443100,10,46,28,18,46,28,18,,,
443137,10,232,46,186,232,46,186,,,
443146,10,52,40,12,36,28,8,16,12,4
443207,10,98,94,4,98,94,4,,,
443216,10,150,124,26,150,124,26,,,
443225,10,33,26,7,33,26,7,,,
443234,10,178,10,168,178,10,168,,,
443252,10,2288,1218,1070,2288,1218,1070,,,
443261,10,196,18,178,141,16,125,55,2,53
443289,10,200,15,185,200,15,185,,,
443298,10,29,26,3,29,26,3,,,
443322,10,229,41,188,229,41,188,,,
443331,10,2620,525,2095,2090,416,1674,530,109,421
443340,10,60,26,34,59,25,34,1,1,0
443377,10,53,44,9,53,44,9,,,
443410,10,1124,781,343,1012,697,315,112,84,28
443492,10,1460,602,858,756,361,395,704,241,463
443562,10,442,95,347,298,74,224,144,21,123
443571,10,449,224,225,449,224,225,,,
443599,10,987,76,911,224,31,193,763,45,718
443632,10,55,35,20,55,35,20,,,
443641,10,129,4,125,65,3,62,64,1,63
443650,10,2478,475,2003,2111,343,1768,367,132,235
443669,10,69,6,63,69,6,63,,,
443696,10,48,11,37,48,11,37,,,
443702,10,62,32,30,14,6,8,48,26,22
443748,10,319,74,245,308,74,234,11,0,11
443766,10,2882,550,2332,191,72,119,2691,478,2213
443784,10,1374,334,1040,105,43,62,1269,291,978
443951,10,45,18,27,45,18,27,,,
443979,10,73,0,73,6,0,6,67,0,67
444051,10,43,0,43,31,0,31,12,0,12
444088,10,528,72,456,528,72,456,,,
444103,10,35,29,6,13,12,1,22,17,5
444130,10,11578,2784,8794,5191,1395,3796,6387,1389,4998
444194,10,190,7,183,190,7,183,,,
444219,10,8796,3932,4864,1898,924,974,6898,3008,3890
444228,10,30,0,30,30,0,30,,,
444255,10,57,3,54,57,3,54,,,
444282,10,84,2,82,36,1,35,48,1,47
444291,10,125,5,120,85,3,82,40,2,38
444307,10,62,2,60,47,1,46,15,1,14
444325,10,114,19,95,107,18,89,7,1,6
444334,10,92,18,74,92,18,74,,,
444361,10,54,25,29,54,25,29,,,
444370,10,32,30,2,32,30,2,,,
444398,10,109,53,56,77,40,37,32,13,19
444404,10,21,8,13,13,6,7,8,2,6
444413,10,164,164,0,164,164,0,,,
444440,10,37,5,32,37,5,32,,,
444468,10,40,1,39,35,1,34,5,0,5
444486,10,272,11,261,240,9,231,32,2,30
444510,10,77,4,73,77,4,73,,,
444529,10,27,3,24,27,3,24,,,
444556,10,437,212,225,437,212,225,,,
444565,10,343,148,195,248,106,142,95,42,53
444583,10,375,160,215,375,160,215,,,
444635,10,74,8,66,74,8,66,,,
444662,10,68,58,10,68,58,10,,,
444671,10,142,57,85,142,57,85,,,
444699,10,59,7,52,57,6,51,2,1,1
444714,10,154,18,136,154,18,136,,,
444732,10,58,12,46,58,12,46,,,
444778,10,113,38,75,61,18,43,52,20,32
444787,10,2994,402,2592,1798,225,1573,1196,177,1019
444811,10,361,20,341,170,12,158,191,8,183
444857,10,130,2,128,72,1,71,58,1,57
444866,10,155,8,147,115,6,109,40,2,38
444893,10,267,8,259,267,8,259,,,
444936,10,108,18,90,107,17,90,1,1,0
444945,10,287,29,258,287,29,258,,,
444954,10,1273,495,778,648,274,374,625,221,404
445027,10,14333,5521,8812,13169,5184,7985,1164,337,827
445054,10,40,31,9,40,31,9,,,
445133,10,171,63,108,101,39,62,70,24,46
445188,10,9103,4674,4429,8957,4585,4372,146,89,57
445203,10,185,24,161,185,24,161,,,
445212,10,168,34,134,84,19,65,84,15,69
445230,10,711,207,504,711,207,504,,,
445249,10,240,63,177,240,63,177,,,
445267,10,3145,898,2247,980,198,782,2165,700,1465
445364,10,620,62,558,620,62,558,,,
445461,10,260,78,182,257,78,179,3,0,3
445498,10,11,11,0,11,11,0,,,
445540,10,57,0,57,57,0,57,,,
445647,10,163,7,156,95,4,91,68,3,65
445656,10,213,7,206,131,3,128,82,4,78
445692,10,517,422,95,476,388,88,41,34,7
445708,10,1140,387,753,1101,373,728,39,14,25
445735,10,1479,547,932,1479,547,932,,,
445744,10,458,57,401,458,57,401,,,
445762,10,188,175,13,123,114,9,65,61,4
445780,10,21,4,17,21,4,17,,,
445799,10,1001,964,37,1001,964,37,,,
445841,10,156,2,154,123,2,121,33,0,33
445850,10,117,3,114,84,2,82,33,1,32
445869,10,407,149,258,188,62,126,219,87,132
445911,10,737,323,414,539,244,295,198,79,119
445948,10,1962,292,1670,1962,292,1670,,,
445957,10,284,66,218,,,,284,66,218
446002,10,23,6,17,11,3,8,12,3,9
446039,10,33,9,24,33,9,24,,,
446048,10,1310,608,702,1266,584,682,44,24,20
446084,10,61,7,54,,,,61,7,54
446093,10,56,4,52,56,4,52,,,
446109,10,294,46,248,222,40,182,72,6,66
446118,10,579,104,475,579,104,475,,,
446127,10,194,12,182,194,12,182,,,
446163,10,485,458,27,296,278,18,189,180,9
446206,10,59,2,57,48,2,46,11,0,11
446224,10,55,10,45,42,5,37,13,5,8
446233,10,157,88,69,140,81,59,17,7,10
446242,10,128,30,98,128,30,98,,,
446251,10,64,20,44,64,20,44,,,
446260,10,766,16,750,766,16,750,,,
446288,10,77,0,77,50,0,50,27,0,27
446303,10,69,1,68,55,0,55,14,1,13
446349,10,24,3,21,24,3,21,,,
446385,10,239,138,101,225,130,95,14,8,6
446516,10,5,3,2,5,3,2,,,
446525,10,1556,1314,242,1556,1314,242,,,
446552,10,1521,813,708,1521,813,708,,,
446561,10,2259,486,1773,2259,486,1773,,,
446598,10,24,2,22,23,2,21,1,0,1
446604,10,2590,2590,0,2590,2590,0,,,
446640,10,3082,1698,1384,2916,1603,1313,166,95,71
446774,10,4247,1662,2585,750,312,438,3497,1350,2147
447014,10,180,15,165,180,15,165,,,
447023,10,1981,820,1161,1959,815,1144,22,5,17
447050,10,2790,519,2271,2026,365,1661,764,154,610
447148,10,192,4,188,130,4,126,62,0,62
447166,10,58,5,53,37,4,33,21,1,20
447175,10,73,4,69,42,3,39,31,1,30
447263,10,2304,372,1932,1444,234,1210,860,138,722
447351,10,556,302,254,556,302,254,,,
447421,10,223,22,201,223,22,201,,,
447449,10,56,15,41,37,13,24,19,2,17
447467,10,98,5,93,98,5,93,,,
447582,10,1007,332,675,562,196,366,445,136,309
447591,10,714,74,640,714,74,640,,,
447607,10,1513,784,729,1513,784,729,,,
447616,10,1208,701,507,1208,701,507,,,
447689,10,11030,4553,6477,7188,2999,4189,3842,1554,2288
447698,10,130,23,107,86,13,73,44,10,34
447704,10,115,2,113,115,2,113,,,
447713,10,150,49,101,150,49,101,,,
447722,10,38,3,35,38,3,35,,,
447731,10,93,7,86,60,6,54,33,1,32
447759,10,263,71,192,241,67,174,22,4,18
447768,10,1639,381,1258,1639,381,1258,,,
447777,10,802,455,347,17,11,6,785,444,341
447795,10,20,2,18,20,2,18,,,
447801,10,93,25,68,60,17,43,33,8,25
447810,10,18,4,14,18,4,14,,,
447847,10,241,224,17,241,224,17,,,
447865,10,18,13,5,16,12,4,2,1,1
447883,10,153,21,132,66,13,53,87,8,79
447892,10,86,8,78,71,7,64,15,1,14
447908,10,68,1,67,41,0,41,27,1,26
447917,10,41,8,33,41,8,33,,,
447935,10,264,12,252,264,12,252,,,
447953,10,662,381,281,456,260,196,206,121,85
447962,10,142,10,132,142,10,132,,,
447971,10,38,3,35,38,3,35,,,
447980,10,58,1,57,42,1,41,16,0,16
447999,10,168,32,136,168,32,136,,,
448026,10,122,6,116,96,6,90,26,0,26
448071,10,126,7,119,126,7,119,,,
448123,10,209,28,181,209,28,181,,,
448196,10,109,9,100,106,9,97,3,0,3
448220,10,143,6,137,143,6,137,,,
448239,10,118,4,114,118,4,114,,,
448248,10,3306,1838,1468,384,44,340,2922,1794,1128
448257,10,17,0,17,2,0,2,15,0,15
448275,10,19,0,19,19,0,19,,,
448372,10,189,75,114,189,75,114,,,
448424,10,56,11,45,27,6,21,29,5,24
448433,10,1140,1095,45,1140,1095,45,,,
448594,10,3845,1412,2433,1222,470,752,2623,942,1681
448600,10,198,16,182,198,16,182,,,
448646,10,80,2,78,80,2,78,,,
448673,10,2475,243,2232,1075,100,975,1400,143,1257
448691,10,161,36,125,,,,161,36,125
448770,10,273,256,17,263,249,14,10,7,3
448798,10,116,6,110,116,6,110,,,
448859,10,120,110,10,120,110,10,,,
448895,10,561,83,478,561,83,478,,,
449038,10,1445,411,1034,255,132,123,1190,279,911
449074,10,551,62,489,551,62,489,,,
449083,10,202,202,0,202,202,0,,,
449092,10,128,128,0,128,128,0,,,
449135,10,227,69,158,155,63,92,72,6,66
449250,10,660,113,547,660,113,547,,,
449311,10,139,1,138,42,0,42,97,1,96
449320,10,697,679,18,516,503,13,181,176,5
449339,10,48668,30928,17740,3736,2026,1710,44932,28902,16030
449348,10,92,36,56,10,5,5,82,31,51
449357,10,81,4,77,81,4,77,,,
449384,10,539,334,205,299,183,116,240,151,89
449393,10,120,40,80,120,40,80,,,
449445,10,70,11,59,70,11,59,,,
449454,10,45,7,38,,,,45,7,38
449463,10,181,46,135,105,24,81,76,22,54
449472,10,82,1,81,82,1,81,,,
449481,10,45,6,39,45,6,39,,,
449490,10,90,17,73,90,17,73,,,
449506,10,122,35,87,122,35,87,,,
449524,10,308,26,282,308,26,282,,,
449533,10,57,9,48,57,9,48,,,
449597,10,2,0,2,2,0,2,,,
449603,10,176,103,73,176,103,73,,,
449612,10,97,45,52,97,45,52,,,
449658,10,110,110,0,107,107,0,3,3,0
449676,10,330,138,192,330,138,192,,,
449685,10,216,17,199,216,17,199,,,
449700,10,369,81,288,369,81,288,,,
449728,10,177,8,169,177,8,169,,,
449764,10,230,112,118,219,105,114,11,7,4
449773,10,187,31,156,187,31,156,,,
449782,10,22,3,19,16,2,14,6,1,5
449807,10,71,7,64,71,7,64,,,
449816,10,693,479,214,53,34,19,640,445,195
449834,10,40,39,1,10,10,0,30,29,1
449861,10,61,4,57,61,4,57,,,
449870,10,164,77,87,149,68,81,15,9,6
449889,10,10003,2357,7646,10003,2357,7646,,,
449898,10,712,120,592,506,88,418,206,32,174
449904,10,164,3,161,164,3,161,,,
449922,10,130,51,79,124,51,73,6,0,6
449959,10,150,36,114,85,20,65,65,16,49
449968,10,284,55,229,208,40,168,76,15,61
449977,10,206,3,203,161,2,159,45,1,44
449986,10,263,67,196,163,36,127,100,31,69
449995,10,129,7,122,74,5,69,55,2,53
450058,10,818,152,666,818,152,666,,,
450067,10,481,135,346,473,135,338,8,0,8
450128,10,533,18,515,533,18,515,,,
450298,10,270,70,200,30,17,13,240,53,187
450304,10,109,47,62,58,30,28,51,17,34
450377,10,1380,265,1115,112,45,67,1268,220,1048
450395,10,136,1,135,98,1,97,38,0,38
450401,10,416,46,370,416,46,370,,,
450571,10,480,54,426,227,25,202,253,29,224
450599,10,50,1,49,50,1,49,,,
450605,10,53,4,49,34,3,31,19,1,18
450614,10,114,4,110,82,3,79,32,1,31
450632,10,87,17,70,,,,87,17,70
450641,10,273,19,254,171,16,155,102,3,99
450650,10,230,20,210,81,0,81,149,20,129
450696,10,412,59,353,412,59,353,,,
450702,10,34,4,30,34,4,30,,,
450711,10,84,65,19,84,65,19,,,
450720,10,692,8,684,298,5,293,394,3,391
450933,10,15948,9946,6002,11046,6496,4550,4902,3450,1452
450951,10,150,79,71,150,79,71,,,
450960,10,326,32,294,249,23,226,77,9,68
450988,10,195,20,175,131,15,116,64,5,59
451042,10,15,4,11,7,0,7,8,4,4
451051,10,116,9,107,,,,116,9,107
451079,10,73,14,59,73,14,59,,,
451097,10,50,10,40,34,4,30,16,6,10
451103,10,801,241,560,396,118,278,405,123,282
451121,10,117,9,108,55,4,51,62,5,57
451149,10,995,65,930,995,65,930,,,
451158,10,773,33,740,773,33,740,,,
451167,10,168,85,83,94,56,38,74,29,45
451194,10,32,3,29,32,3,29,,,
451228,10,182,147,35,182,147,35,,,
451237,10,214,5,209,214,5,209,,,
451255,10,52,2,50,29,0,29,23,2,21
451282,10,124,4,120,80,2,78,44,2,42
451291,10,8,1,7,,,,8,1,7
451307,10,36,0,36,3,0,3,33,0,33
451316,10,54,4,50,54,4,50,,,
451334,10,289,121,168,153,67,86,136,54,82
451343,10,90,4,86,57,2,55,33,2,31
451352,10,142,22,120,107,19,88,35,3,32
451370,10,59,59,0,59,59,0,,,
451398,10,213,213,0,213,213,0,,,
451404,10,459,459,0,459,459,0,,,
451413,10,393,102,291,393,102,291,,,
451459,10,41,8,33,10,0,10,31,8,23
451468,10,432,4,428,432,4,428,,,
451477,10,1483,1203,280,1483,1203,280,,,
451495,10,281,71,210,281,71,210,,,
451501,10,282,97,185,282,97,185,,,
451510,10,619,237,382,573,214,359,46,23,23
451529,10,59,1,58,36,0,36,23,1,22
451547,10,16,4,12,16,4,12,,,
451556,10,1596,550,1046,1596,550,1046,,,
451565,10,181,24,157,168,14,154,13,10,3
451574,10,173,8,165,137,6,131,36,2,34
451583,10,1004,751,253,150,108,42,854,643,211
451626,10,19,1,18,19,1,18,,,
451714,10,292,51,241,181,12,169,111,39,72
451741,10,92,30,62,66,23,43,26,7,19
451750,10,1043,251,792,640,211,429,403,40,363
451820,10,78,47,31,50,30,20,28,17,11
451857,10,63,4,59,63,4,59,,,
451866,10,352,66,286,352,66,286,,,
451918,10,121,13,108,121,13,108,,,
451927,10,409,215,194,356,194,162,53,21,32
452009,10,54,2,52,54,2,52,,,
452072,10,23,1,22,23,1,22,,,
452081,10,894,31,863,894,31,863,,,
452106,10,62,59,3,62,59,3,,,
452124,10,383,83,300,381,82,299,2,1,1
452373,10,309,18,291,309,18,291,,,
452771,10,13,1,12,,,,13,1,12
452780,10,8,1,7,,,,8,1,7
452887,10,49,45,4,49,45,4,,,
452948,10,692,63,629,432,35,397,260,28,232
453163,10,3074,593,2481,247,102,145,2827,491,2336
453215,10,530,115,415,26,8,18,504,107,397
453297,10,35,12,23,,,,35,12,23
453756,10,73,44,29,73,44,29,,,
453792,10,110,7,103,110,7,103,,,
454184,10,326,127,199,283,113,170,43,14,29
454227,10,26687,2665,24022,3577,405,3172,23110,2260,20850
454236,10,537,60,477,209,21,188,328,39,289
454245,10,818,142,676,296,50,246,522,92,430
454537,10,61,1,60,61,1,60,,,
454546,10,169,12,157,169,12,157,,,
454555,10,252,12,240,252,12,240,,,
454582,10,224,85,139,57,26,31,167,59,108
454607,10,387,11,376,387,11,376,,,
454652,10,142,3,139,142,3,139,,,
454689,10,526,238,288,526,238,288,,,
454698,10,304,90,214,304,90,214,,,
454722,10,21,3,18,19,2,17,2,1,1
454759,10,38,31,7,33,27,6,5,4,1
454768,10,215,34,181,121,22,99,94,12,82
454777,10,213,29,184,139,20,119,74,9,65
454786,10,641,410,231,180,123,57,461,287,174
454795,10,254,68,186,176,51,125,78,17,61
454801,10,176,34,142,176,34,142,,,
454810,10,8894,2373,6521,8894,2373,6521,,,
454829,10,7386,1079,6307,1331,227,1104,6055,852,5203
454838,10,34,8,26,34,8,26,,,
454856,10,1084,142,942,1084,142,942,,,
454865,10,939,154,785,643,117,526,296,37,259
454874,10,42,1,41,11,0,11,31,1,30
454917,10,913,145,768,561,84,477,352,61,291
454926,10,319,17,302,270,15,255,49,2,47
454935,10,78,1,77,78,1,77,,,
454944,10,238,15,223,238,15,223,,,
454953,10,42,0,42,20,0,20,22,0,22
454962,10,61,2,59,32,1,31,29,1,28
454971,10,205,18,187,107,16,91,98,2,96
454980,10,145,0,145,28,0,28,117,0,117
454999,10,121,2,119,50,1,49,71,1,70
455008,10,166,5,161,58,3,55,108,2,106
455026,10,86,80,6,,,,86,80,6
455062,10,55,0,55,25,0,25,30,0,30
455071,10,108,30,78,,,,108,30,78
455080,10,239,26,213,238,26,212,1,0,1
455099,10,108,66,42,28,16,12,80,50,30
455105,10,79,0,79,79,0,79,,,
455114,10,9920,4343,5577,2287,1192,1095,7633,3151,4482
455141,10,208,5,203,208,5,203,,,
455178,10,88,26,62,86,26,60,2,0,2
455187,10,197,48,149,79,26,53,118,22,96
455196,10,3379,291,3088,3379,291,3088,,,
455202,10,251,37,214,66,6,60,185,31,154
455211,10,317,8,309,317,8,309,,,
455220,10,53,7,46,53,7,46,,,
455257,10,431,431,0,431,431,0,,,
455275,10,251,5,246,251,5,246,,,
455284,10,241,7,234,175,5,170,66,2,64
455327,10,50,3,47,42,3,39,8,0,8
455336,10,204,167,37,204,167,37,,,
455354,10,225,4,221,225,4,221,,,
455381,10,161,0,161,103,0,103,58,0,58
455406,10,620,280,340,619,280,339,1,0,1
455433,10,500,98,402,416,77,339,84,21,63
455460,10,127,27,100,127,27,100,,,
455479,10,626,73,553,536,66,470,90,7,83
455488,10,215,83,132,215,83,132,,,
455512,10,3441,1258,2183,646,259,387,2795,999,1796
455628,10,381,129,252,381,129,252,,,
455664,10,3326,557,2769,523,96,427,2803,461,2342
455707,10,51,12,39,51,12,39,,,
455725,10,679,10,669,528,7,521,151,3,148
455734,10,205,38,167,205,38,167,,,
455761,10,363,53,310,226,32,194,137,21,116
455770,10,136,78,58,135,78,57,1,0,1
455798,10,101,1,100,49,1,48,52,0,52
455804,10,131,88,43,80,53,27,51,35,16
455813,10,64,36,28,50,23,27,14,13,1
455831,10,115,13,102,115,13,102,,,
455859,10,254,3,251,219,3,216,35,0,35
455868,10,292,39,253,292,39,253,,,
455877,10,93,5,88,93,5,88,,,
455886,10,185,8,177,87,1,86,98,7,91
455895,10,416,27,389,177,4,173,239,23,216
455901,10,169,14,155,79,5,74,90,9,81
455910,10,49,7,42,49,7,42,,,
455929,10,55,0,55,55,0,55,,,
455965,10,130,8,122,130,8,122,,,
455974,10,160,9,151,160,9,151,,,
455983,10,182,55,127,180,54,126,2,1,1
455992,10,305,83,222,305,83,222,,,
456001,10,94,89,5,94,89,5,,,
456029,10,232,9,223,170,9,161,62,0,62
456038,10,384,45,339,384,45,339,,,
456065,10,142,2,140,138,2,136,4,0,4
456074,10,143,7,136,142,7,135,1,0,1
456135,10,95,1,94,66,1,65,29,0,29
456153,10,73,63,10,73,63,10,,,
456205,10,166,43,123,162,43,119,4,0,4
456214,10,390,241,149,390,241,149,,,
456287,10,117,1,116,117,1,116,,,
456454,10,438,125,313,361,114,247,77,11,66
456481,10,61,28,33,8,2,6,53,26,27
456490,10,134,87,47,44,29,15,90,58,32
456506,10,72,3,69,72,3,69,,,
456515,10,36,2,34,36,2,34,,,
456542,10,708,289,419,590,259,331,118,30,88
456551,10,69,3,66,69,3,66,,,
456579,10,233,92,141,217,90,127,16,2,14
456588,10,45,1,44,45,1,44,,,
456597,10,271,5,266,139,2,137,132,3,129
456621,10,300,92,208,24,13,11,276,79,197
456825,10,169,8,161,121,4,117,48,4,44
456852,10,374,129,245,374,129,245,,,
456922,10,247,48,199,229,46,183,18,2,16
456931,10,320,170,150,312,169,143,8,1,7
456959,10,630,124,506,595,114,481,35,10,25
456968,10,1142,53,1089,1070,48,1022,72,5,67
456977,10,61,53,8,61,53,8,,,
457031,10,65,0,65,43,0,43,22,0,22
457077,10,432,31,401,432,31,401,,,
457086,10,180,43,137,136,34,102,44,9,35
457101,10,323,92,231,323,92,231,,,
457110,10,463,82,381,463,82,381,,,
457129,10,918,94,824,235,14,221,683,80,603
457192,10,56,40,16,56,40,16,,,
457208,10,120,108,12,120,108,12,,,
457226,10,49,34,15,17,12,5,32,22,10
457253,10,122,6,116,39,2,37,83,4,79
457271,10,68,22,46,27,11,16,41,11,30
457299,10,369,68,301,327,60,267,42,8,34
457314,10,97,22,75,97,22,75,,,
457323,10,397,44,353,397,44,353,,,
457332,10,41,3,38,41,3,38,,,
457341,10,175,9,166,175,9,166,,,
457350,10,74,0,74,,,,74,0,74
457378,10,183,97,86,93,38,55,90,59,31
457387,10,305,161,144,147,78,69,158,83,75
457396,10,112,30,82,18,7,11,94,23,71
457402,10,231,197,34,47,44,3,184,153,31
457411,10,244,223,21,177,159,18,67,64,3
457420,10,172,11,161,121,10,111,51,1,50
457439,10,145,2,143,71,1,70,74,1,73
457448,10,77,1,76,77,1,76,,,
457466,10,38,30,8,38,30,8,,,
457475,10,116,3,113,116,3,113,,,
457484,10,131,61,70,54,25,29,77,36,41
457493,10,60,3,57,60,3,57,,,
457527,10,211,20,191,17,1,16,194,19,175
457536,10,676,103,573,676,103,573,,,
457545,10,92,3,89,73,2,71,19,1,18
457554,10,20,1,19,17,1,16,3,0,3
457563,10,237,7,230,237,7,230,,,
457572,10,138,3,135,138,3,135,,,
457581,10,135,1,134,131,1,130,4,0,4
457606,10,98,4,94,98,4,94,,,
457615,10,46,6,40,,,,46,6,40
457624,10,43,9,34,43,9,34,,,
457633,10,231,8,223,83,1,82,148,7,141
457642,10,42,0,42,42,0,42,,,
457679,10,26,1,25,26,1,25,,,
457697,10,182,92,90,24,10,14,158,82,76
457749,10,98,3,95,98,3,95,,,
457767,10,119,69,50,119,69,50,,,
457776,10,167,15,152,165,14,151,2,1,1
457785,10,41,0,41,41,0,41,,,
457794,10,118,13,105,118,13,105,,,
457800,10,201,22,179,201,22,179,,,
457819,10,676,275,401,,,,676,275,401
457837,10,131,7,124,65,6,59,66,1,65
457855,10,73,3,70,57,2,55,16,1,15
457873,10,88,66,22,43,34,9,45,32,13
457916,10,107,5,102,48,1,47,59,4,55
457925,10,12,6,6,12,6,6,,,
457943,10,40,7,33,40,7,33,,,
457952,10,186,2,184,153,2,151,33,0,33
457989,10,48,0,48,48,0,48,,,
458007,10,69,1,68,37,0,37,32,1,31
458034,10,41,7,34,41,7,34,,,
458043,10,90,1,89,62,1,61,28,0,28
458061,10,68,7,61,28,4,24,40,3,37
458070,10,270,13,257,257,13,244,13,0,13
458098,10,120,2,118,110,2,108,10,0,10
458104,10,225,1,224,5,0,5,220,1,219
458113,10,99,29,70,1,0,1,98,29,69
458122,10,24,0,24,24,0,24,,,
458131,10,137,7,130,137,7,130,,,
458140,10,62,54,8,62,54,8,,,
458168,10,79,4,75,79,4,75,,,
458210,10,4475,949,3526,3445,730,2715,1030,219,811
458229,10,2579,565,2014,2095,457,1638,484,108,376
458274,10,197,5,192,165,5,160,32,0,32
458405,10,191,71,120,189,71,118,2,0,2
458441,10,300,44,256,296,44,252,4,0,4
458496,10,88,45,43,59,31,28,29,14,15
458681,10,279,44,235,279,44,235,,,
458803,10,162,1,161,108,1,107,54,0,54
458812,10,91,3,88,73,2,71,18,1,17
458821,10,68,2,66,68,2,66,,,
458830,10,174,3,171,124,0,124,50,3,47
458858,10,225,6,219,130,3,127,95,3,92
458867,10,203,7,196,145,5,140,58,2,56
458885,10,307,49,258,11,1,10,296,48,248
458919,10,4904,1082,3822,604,248,356,4300,834,3466
458955,10,302,56,246,15,4,11,287,52,235
458964,10,1841,402,1439,172,81,91,1669,321,1348
458973,10,2460,686,1774,346,180,166,2114,506,1608
458982,10,180,94,86,126,64,62,54,30,24
459019,10,96,6,90,79,5,74,17,1,16
459046,10,57,3,54,44,2,42,13,1,12
459055,10,46,1,45,27,0,27,19,1,18
459064,10,73,5,68,49,3,46,24,2,22
459116,10,102,7,95,102,7,95,,,
459170,10,292,31,261,150,28,122,142,3,139
459189,10,114,0,114,87,0,87,27,0,27
459198,10,333,57,276,240,52,188,93,5,88
459204,10,4857,719,4138,4857,719,4138,,,
459213,10,2668,571,2097,2668,571,2097,,,
459231,10,209,20,189,209,20,189,,,
459259,10,442,123,319,305,51,254,137,72,65
459268,10,240,33,207,179,23,156,61,10,51
459277,10,341,23,318,341,23,318,,,
459286,10,178,23,155,133,15,118,45,8,37
459295,10,72,1,71,32,1,31,40,0,40
459301,10,103,5,98,78,3,75,25,2,23
459329,10,442,271,171,354,208,146,88,63,25
459347,10,95,1,94,21,0,21,74,1,73
459374,10,105,4,101,37,4,33,68,0,68
459392,10,160,6,154,98,6,92,62,0,62
459408,10,56,7,49,41,2,39,15,5,10
459417,10,50,36,14,40,31,9,10,5,5
459426,10,193,5,188,193,5,188,,,
459499,10,22,4,18,22,4,18,,,
459514,10,75,20,55,75,20,55,,,
459523,10,64,6,58,64,6,58,,,
459532,10,99,0,99,12,0,12,87,0,87
459541,10,25,0,25,11,0,11,14,0,14
459550,10,107,3,104,96,3,93,11,0,11
459578,10,108,33,75,75,18,57,33,15,18
459727,10,2249,574,1675,1126,249,877,1123,325,798
459736,10,1144,432,712,1033,388,645,111,44,67
459745,10,652,106,546,420,56,364,232,50,182
459824,10,1560,646,914,1270,571,699,290,75,215
459842,10,630,68,562,326,37,289,304,31,273
459851,10,394,48,346,198,30,168,196,18,178
459949,10,7309,2508,4801,4117,1419,2698,3192,1089,2103
459958,10,295,79,216,295,79,216,,,
459967,10,618,243,375,618,243,375,,,
459985,10,508,260,248,508,260,248,,,
459994,10,11017,3805,7212,901,426,475,10116,3379,6737
460011,10,182,0,182,127,0,127,55,0,55
460020,10,431,89,342,431,89,342,,,
460093,10,35,1,34,35,1,34,,,
460109,10,90,3,87,90,3,87,,,
460118,10,62,1,61,62,1,61,,,
460127,10,73,6,67,73,6,67,,,
460136,10,892,139,753,892,139,753,,,
460145,10,105,64,41,105,64,41,,,
460172,10,557,499,58,555,497,58,2,2,0
460181,10,615,91,524,615,91,524,,,
460190,10,320,52,268,320,52,268,,,
460206,10,521,127,394,521,127,394,,,
460349,10,2505,765,1740,582,142,440,1923,623,1300
460376,10,43,22,21,41,20,21,2,2,0
460385,10,75,10,65,75,10,65,,,
460394,10,9095,3844,5251,1518,687,831,7577,3157,4420
460464,10,9467,4396,5071,1601,899,702,7866,3497,4369
460482,10,180,17,163,180,17,163,,,
460525,10,27,3,24,27,3,24,,,
460534,10,293,6,287,293,6,287,,,
460543,10,1727,1649,78,1727,1649,78,,,
460677,10,426,91,335,360,79,281,66,12,54
460701,10,234,28,206,57,10,47,177,18,159
460756,10,273,18,255,239,18,221,34,0,34
460765,10,42,2,40,42,2,40,,,
460808,10,9,1,8,9,1,8,,,
460817,10,157,58,99,155,57,98,2,1,1
460826,10,482,107,375,474,105,369,8,2,6
460835,10,235,73,162,233,73,160,2,0,2
460862,10,219,6,213,113,2,111,106,4,102
460871,10,663,72,591,213,20,193,450,52,398
460914,10,328,3,325,328,3,325,,,
460932,10,84,0,84,84,0,84,,,
460969,10,285,19,266,285,19,266,,,
460978,10,298,5,293,149,2,147,149,3,146
460987,10,110,0,110,110,0,110,,,
460996,10,200,3,197,159,2,157,41,1,40
461014,10,867,56,811,867,56,811,,,
461023,10,486,67,419,473,65,408,13,2,11
461032,10,152,74,78,50,28,22,102,46,56
461087,10,1315,688,627,167,65,102,1148,623,525
461111,10,31,29,2,29,28,1,2,1,1
461120,10,77,43,34,65,35,30,12,8,4
461139,10,83,16,67,83,16,67,,,
461148,10,1285,749,536,1285,749,536,,,
461175,10,200,16,184,133,14,119,67,2,65
461193,10,191,1,190,186,1,185,5,0,5
461218,10,844,59,785,844,59,785,,,
461245,10,127,61,66,34,12,22,93,49,44
461254,10,49,10,39,49,10,39,,,
461263,10,161,11,150,161,11,150,,,
461272,10,85,0,85,49,0,49,36,0,36
461281,10,114,9,105,76,7,69,38,2,36
461306,10,165,49,116,31,15,16,134,34,100
461315,10,151,33,118,28,7,21,123,26,97
461324,10,791,169,622,754,161,593,37,8,29
461333,10,10,9,1,10,9,1,,,
461342,10,136,0,136,97,0,97,39,0,39
461379,10,32,7,25,6,1,5,26,6,20
461388,10,55,18,37,55,18,37,,,
461412,10,139,41,98,,,,139,41,98
461421,10,208,11,197,206,11,195,2,0,2
461430,10,591,548,43,,,,591,548,43
461485,10,161,139,22,64,53,11,97,86,11
461494,10,175,15,160,101,7,94,74,8,66
461500,10,31,5,26,23,3,20,8,2,6
461528,10,256,137,119,81,41,40,175,96,79
461537,10,38,1,37,37,1,36,1,0,1
461555,10,145,8,137,145,8,137,,,
461573,10,127,125,2,127,125,2,,,
461582,10,163,2,161,163,2,161,,,
461591,10,118,5,113,117,5,112,1,0,1
461607,10,90,13,77,35,9,26,55,4,51
461625,10,13,13,0,13,13,0,,,
461643,10,24,2,22,24,2,22,,,
461652,10,94,6,88,94,6,88,,,
461689,10,316,38,278,316,38,278,,,
461704,10,161,8,153,156,7,149,5,1,4
461713,10,40,0,40,15,0,15,25,0,25
461722,10,60,1,59,60,1,59,,,
461740,10,30,26,4,30,26,4,,,
461759,10,237,124,113,192,104,88,45,20,25
461768,10,241,4,237,170,3,167,71,1,70
461786,10,26,0,26,26,0,26,,,
461795,10,827,533,294,637,432,205,190,101,89
461810,10,25,9,16,22,8,14,3,1,2
461829,10,94,24,70,94,24,70,,,
461838,10,175,2,173,116,1,115,59,1,58
461847,10,54,54,0,54,54,0,,,
461856,10,64,30,34,64,30,34,,,
461865,10,25,2,23,25,2,23,,,
461874,10,98,13,85,98,13,85,,,
461883,10,109,48,61,93,42,51,16,6,10
461892,10,71,10,61,71,10,61,,,
461908,10,84,0,84,82,0,82,2,0,2
461917,10,215,0,215,121,0,121,94,0,94
461926,10,157,2,155,112,2,110,45,0,45
461944,10,101,1,100,101,1,100,,,
461953,10,28,1,27,17,1,16,11,0,11
461962,10,407,313,94,407,313,94,,,
461999,10,168,10,158,148,9,139,20,1,19
462008,10,239,15,224,154,12,142,85,3,82
462017,10,124,17,107,124,17,107,,,
462035,10,356,128,228,98,4,94,258,124,134
462044,10,92,22,70,45,11,34,47,11,36
462053,10,55,2,53,55,2,53,,,
462062,10,113,0,113,68,0,68,45,0,45
462071,10,185,40,145,181,39,142,4,1,3
462336,10,66,4,62,66,4,62,,,
462345,10,35,0,35,18,0,18,17,0,17
462354,10,300,150,150,282,138,144,18,12,6
463056,10,1535,774,761,1422,710,712,113,64,49
464226,10,1736,838,898,1429,722,707,307,116,191
466921,10,375,21,354,115,3,112,260,18,242
466930,10,2167,286,1881,510,69,441,1657,217,1440
467094,10,166,1,165,166,1,165,,,
467368,10,40,4,36,40,4,36,,,
467863,10,236,43,193,189,34,155,47,9,38
467872,10,284,11,273,200,8,192,84,3,81
467906,10,146,2,144,112,2,110,34,0,34
468246,10,98,9,89,98,9,89,,,
468255,10,12,2,10,12,2,10,,,
468291,10,74,8,66,74,8,66,,,
468769,10,179,173,6,179,173,6,,,
468848,10,848,434,414,848,434,414,,,
468893,10,174,6,168,114,5,109,60,1,59
468909,10,999,401,598,999,401,598,,,
468963,10,707,667,40,707,667,40,,,
469416,10,292,63,229,182,53,129,110,10,100
469610,10,9,1,8,9,1,8,,,
469629,10,147,128,19,147,128,19,,,
469911,10,95,6,89,95,6,89,,,
469957,10,24,0,24,24,0,24,,,
470038,10,1268,583,685,1268,583,685,,,
470047,10,38,11,27,38,11,27,,,
470296,10,15,0,15,15,0,15,,,
470393,10,145,8,137,52,4,48,93,4,89
474863,10,1895,366,1529,735,155,580,1160,211,949
474915,10,451,6,445,245,2,243,206,4,202
474924,10,184,5,179,39,3,36,145,2,143
475015,10,180,1,179,180,1,179,,,
475024,10,244,80,164,244,80,164,,,
475033,10,2637,647,1990,,,,2637,647,1990
475060,10,210,18,192,208,18,190,2,0,2
475121,10,7707,1664,6043,5116,1138,3978,2591,526,2065
475176,10,704,391,313,704,391,313,,,
475200,10,177,53,124,28,9,19,149,44,105
475228,10,76,26,50,76,26,50,,,
475273,10,461,107,354,105,23,82,356,84,272
475282,10,93,26,67,93,26,67,,,
475325,10,170,4,166,170,4,166,,,
475398,10,168,93,75,42,24,18,126,69,57
475404,10,149,2,147,84,1,83,65,1,64
475422,10,98,5,93,12,0,12,86,5,81
475431,10,49,4,45,49,4,45,,,
475468,10,279,4,275,77,2,75,202,2,200
475477,10,257,86,171,81,46,35,176,40,136
475486,10,264,48,216,168,20,148,96,28,68
475495,10,1455,431,1024,1455,431,1024,,,
475547,10,120,25,95,63,19,44,57,6,51
475556,10,153,10,143,95,5,90,58,5,53
475565,10,842,460,382,752,414,338,90,46,44
475574,10,38,17,21,21,7,14,17,10,7
475608,10,163,102,61,101,66,35,62,36,26
475635,10,20,6,14,5,3,2,15,3,12
475653,10,28,1,27,27,1,26,1,0,1
475662,10,55,0,55,26,0,26,29,0,29
475705,10,21,5,16,21,5,16,,,
475714,10,333,282,51,289,251,38,44,31,13
475723,10,632,380,252,138,72,66,494,308,186
475732,10,1421,134,1287,355,35,320,1066,99,967
475741,10,202,16,186,92,7,85,110,9,101
475839,10,308,155,153,153,87,66,155,68,87
476063,10,272,252,20,272,252,20,,,
476179,10,171,11,160,110,7,103,61,4,57
476230,10,30,2,28,30,2,28,,,
476355,10,29,12,17,29,12,17,,,
476489,10,93,71,22,93,71,22,,,
476498,10,250,163,87,250,163,87,,,
476513,10,44,1,43,44,1,43,,,
476540,10,109,2,107,77,1,76,32,1,31
476559,10,105,6,99,61,4,57,44,2,42
476568,10,19,13,6,19,13,6,,,
476595,10,93,16,77,93,16,77,,,
476601,10,86,86,0,86,86,0,,,
476610,10,28,17,11,28,17,11,,,
476629,10,143,6,137,143,6,137,,,
476683,10,245,12,233,242,12,230,3,0,3
476692,10,40,40,0,40,40,0,,,
476708,10,148,110,38,129,95,34,19,15,4
476717,10,638,638,0,638,638,0,,,
476726,10,660,111,549,660,111,549,,,
476735,10,26,16,10,26,16,10,,,
476753,10,229,6,223,115,5,110,114,1,113
476780,10,95,7,88,83,7,76,12,0,12
476799,10,327,58,269,327,58,269,,,
476805,10,44,0,44,44,0,44,,,
476814,10,611,421,190,,,,611,421,190
476841,10,237,23,214,154,16,138,83,7,76
476850,10,82,57,25,82,57,25,,,
476869,10,79,4,75,79,4,75,,,
476878,10,138,3,135,67,1,66,71,2,69
476887,10,599,8,591,578,8,570,21,0,21
476896,10,162,71,91,162,71,91,,,
476902,10,88,2,86,56,1,55,32,1,31
476939,10,682,60,622,682,60,622,,,
476957,10,12,1,11,10,1,9,2,0,2
476975,10,9565,4171,5394,1719,810,909,7846,3361,4485
476984,10,228,12,216,180,9,171,48,3,45
476993,10,246,2,244,246,2,244,,,
477002,10,47,3,44,43,3,40,4,0,4
477039,10,1468,204,1264,1037,147,890,431,57,374
477233,10,97,41,56,97,41,56,,,
478582,10,157,7,150,112,6,106,45,1,44
478591,10,164,4,160,95,2,93,69,2,67
478616,10,104,7,97,78,5,73,26,2,24
478917,10,74,3,71,74,3,71,,,
478953,10,203,6,197,203,6,197,,,
479062,10,113,107,6,67,64,3,46,43,3
479424,10,289,41,248,289,41,248,,,
479956,10,13979,6995,6984,3763,1643,2120,10216,5352,4864
479965,10,142,16,126,142,16,126,,,
479974,10,88,32,56,82,32,50,6,0,6
479983,10,108,14,94,108,14,94,,,
479992,10,21,19,2,3,2,1,18,17,1
480000,10,52,33,19,49,31,18,3,2,1
480019,10,910,770,140,798,669,129,112,101,11
480028,10,162,127,35,160,126,34,2,1,1
480037,10,1251,942,309,1251,942,309,,,
480073,10,300,51,249,237,38,199,63,13,50
480091,10,9050,1156,7894,5479,554,4925,3571,602,2969
480125,10,448,15,433,210,6,204,238,9,229
480161,10,12,1,11,12,1,11,,,
480198,10,376,126,250,287,99,188,89,27,62
480204,10,446,74,372,446,74,372,,,
480310,10,81,0,81,72,0,72,9,0,9
480471,10,813,461,352,813,461,352,,,
480523,10,82,5,77,82,5,77,,,
480532,10,37,1,36,37,1,36,,,
480550,10,31,0,31,31,0,31,,,
480569,10,1230,518,712,502,175,327,728,343,385
480657,10,590,73,517,292,34,258,298,39,259
480727,10,29,21,8,29,21,8,,,
480781,10,216,153,63,207,145,62,9,8,1
480790,10,1531,748,783,1525,746,779,6,2,4
480824,10,545,54,491,545,54,491,,,
480833,10,832,89,743,832,89,743,,,
480842,10,34,17,17,34,17,17,,,
480851,10,31,13,18,31,13,18,,,
480879,10,52,5,47,52,5,47,,,
480888,10,171,76,95,171,76,95,,,
480903,10,566,497,69,489,425,64,77,72,5
480921,10,88,73,15,88,73,15,,,
480930,10,37,0,37,28,0,28,9,0,9
480967,10,243,81,162,128,52,76,115,29,86
480976,10,63,6,57,63,6,57,,,
480985,10,282,1,281,282,1,281,,,
480994,10,116,4,112,90,4,86,26,0,26
481003,10,199,165,34,199,165,34,,,
481021,10,42,32,10,33,26,7,9,6,3
481030,10,42,24,18,2,1,1,40,23,17
481049,10,18,4,14,18,4,14,,,
481058,10,342,165,177,253,121,132,89,44,45
481085,10,226,19,207,226,19,207,,,
481094,10,199,25,174,199,25,174,,,
481100,10,106,20,86,25,5,20,81,15,66
481128,10,83,11,72,69,11,58,14,0,14
481137,10,86,41,45,86,41,45,,,
481146,10,84,11,73,50,4,46,34,7,27
481155,10,170,66,104,170,66,104,,,
481182,10,32,5,27,32,5,27,,,
481191,10,230,35,195,230,35,195,,,
481207,10,131,18,113,131,18,113,,,
481225,10,17,10,7,17,10,7,,,
481243,10,248,0,248,79,0,79,169,0,169
481252,10,64,8,56,64,8,56,,,
481289,10,88,22,66,88,22,66,,,
481298,10,60,1,59,60,1,59,,,
481313,10,82,1,81,48,1,47,34,0,34
481322,10,48,2,46,15,0,15,33,2,31
481331,10,78,58,20,78,58,20,,,
481340,10,45,0,45,45,0,45,,,
481368,10,69,6,63,69,6,63,,,
481386,10,339,39,300,5,0,5,334,39,295
481401,10,611,410,201,81,59,22,530,351,179
481410,10,79,79,0,79,79,0,,,
481429,10,104,15,89,104,15,89,,,
481438,10,67,67,0,67,67,0,,,
481447,10,29,5,24,10,2,8,19,3,16
481456,10,15,1,14,5,0,5,10,1,9
481465,10,78,2,76,55,1,54,23,1,22
481474,10,131,2,129,122,2,120,9,0,9
481483,10,111,5,106,63,2,61,48,3,45
481517,10,91,7,84,53,5,48,38,2,36
481526,10,217,1,216,217,1,216,,,
481535,10,44,20,24,44,20,24,,,
481571,10,12,6,6,12,6,6,,,
481678,10,71,1,70,44,1,43,27,0,27
481720,10,51,4,47,34,1,33,17,3,14
481739,10,47,3,44,34,3,31,13,0,13
481748,10,112,2,110,92,2,90,20,0,20
481775,10,248,75,173,248,75,173,,,
481845,10,73,2,71,44,1,43,29,1,28
481863,10,55,4,51,55,4,51,,,
481890,10,52,2,50,52,2,50,,,
481906,10,41,1,40,41,1,40,,,
481960,10,172,142,30,172,142,30,,,
482015,10,772,555,217,772,555,217,,,
482060,10,238,33,205,238,33,205,,,
482097,10,340,168,172,323,164,159,17,4,13
482149,10,9140,3092,6048,7391,2499,4892,1749,593,1156
482158,10,7688,3403,4285,4498,2103,2395,3190,1300,1890
482167,10,128,1,127,35,0,35,93,1,92
482176,10,252,9,243,182,7,175,70,2,68
482185,10,65,50,15,65,50,15,,,
482194,10,144,22,122,105,16,89,39,6,33
482200,10,64,12,52,64,12,52,,,
482228,10,182,114,68,43,31,12,139,83,56
482246,10,28,25,3,28,25,3,,,
482255,10,294,268,26,204,188,16,90,80,10
482291,10,1358,630,728,1358,630,728,,,
482413,10,568,268,300,266,149,117,302,119,183
482422,10,73,42,31,29,17,12,44,25,19
482431,10,1677,927,750,839,486,353,838,441,397
482459,10,294,129,165,116,51,65,178,78,100
482468,10,532,221,311,231,106,125,301,115,186
482477,10,26384,9441,16943,9958,3875,6083,16426,5566,10860
482547,10,10,6,4,4,3,1,6,3,3
482556,10,95,56,39,46,25,21,49,31,18
482565,10,12,6,6,3,2,1,9,4,5
482574,10,226,115,111,104,60,44,122,55,67
482635,10,108,65,43,49,33,16,59,32,27
482653,10,76,39,37,40,20,20,36,19,17
482680,10,18029,7764,10265,11949,5257,6692,6080,2507,3573
482699,10,1793,577,1216,1081,376,705,712,201,511
482705,10,8264,3249,5015,2036,666,1370,6228,2583,3645
482936,10,1593,1291,302,1406,1144,262,187,147,40
482963,10,397,73,324,397,73,324,,,
482981,10,145,126,19,102,89,13,43,37,6
482990,10,259,20,239,259,20,239,,,
483009,10,206,23,183,206,23,183,,,
483018,10,127,38,89,127,38,89,,,
483036,10,2198,847,1351,708,306,402,1490,541,949
483045,10,9683,3841,5842,1762,704,1058,7921,3137,4784
483054,10,104,75,29,104,75,29,,,
483106,10,207,28,179,145,19,126,62,9,53
483124,10,62551,22305,40246,22078,6928,15150,40473,15377,25096
483212,10,4105,1692,2413,1457,626,831,2648,1066,1582
483221,10,33,15,18,33,15,18,,,
483230,10,148,140,8,121,114,7,27,26,1
483258,10,12,9,3,12,9,3,,,
483276,10,62,53,9,62,53,9,,,
483328,10,86,11,75,66,9,57,20,2,18
483337,10,153,6,147,97,4,93,56,2,54
483346,10,63,3,60,63,3,60,,,
483355,10,194,6,188,194,6,188,,,
483364,10,129,10,119,129,10,119,,,
483373,10,150,18,132,135,17,118,15,1,14
483382,10,232,228,4,232,228,4,,,
483425,10,51,3,48,51,3,48,,,
483470,10,63,5,58,63,5,58,,,
483504,10,359,114,245,359,114,245,,,
483513,10,31,21,10,31,21,10,,,
483559,10,58,7,51,37,5,32,21,2,19
483577,10,39,2,37,23,2,21,16,0,16
483595,10,7904,1949,5955,5088,1273,3815,2816,676,2140
483647,10,32,2,30,32,2,30,,,
483708,10,266,50,216,91,11,80,175,39,136
483726,10,21,0,21,8,0,8,13,0,13
483735,10,70,6,64,36,4,32,34,2,32
483744,10,67,55,12,67,55,12,,,
483753,10,46,40,6,20,15,5,26,25,1
483780,10,645,415,230,617,395,222,28,20,8
483799,10,53,12,41,53,12,41,,,
483814,10,623,46,577,573,41,532,50,5,45
483823,10,635,450,185,635,450,185,,,
483841,10,26,4,22,26,4,22,,,
483850,10,7,1,6,7,1,6,,,
483869,10,124,33,91,124,33,91,,,
483878,10,211,20,191,211,20,191,,,
483887,10,36,10,26,36,10,26,,,
483896,10,202,7,195,32,2,30,170,5,165
483911,10,22,0,22,22,0,22,,,
483920,10,202,115,87,202,115,87,,,
483948,10,33,25,8,29,22,7,4,3,1
483957,10,42,11,31,42,11,31,,,
483975,10,761,362,399,753,356,397,8,6,2
484002,10,1663,131,1532,1612,127,1485,51,4,47
484011,10,100,19,81,82,19,63,18,0,18
484020,10,61,45,16,36,27,9,25,18,7
484048,10,63,47,16,63,47,16,,,
484057,10,248,10,238,42,3,39,206,7,199
484066,10,360,22,338,360,22,338,,,
484075,10,32,21,11,19,12,7,13,9,4
484084,10,77,0,77,49,0,49,28,0,28
484093,10,138,3,135,82,1,81,56,2,54
484109,10,92,1,91,92,1,91,,,
484127,10,109,15,94,109,15,94,,,
484136,10,33,9,24,33,9,24,,,
484163,10,178,47,131,105,25,80,73,22,51
484172,10,5,1,4,5,1,4,,,
484190,10,19,14,5,19,14,5,,,
484206,10,233,1,232,144,1,143,89,0,89
484233,10,217,121,96,,,,217,121,96
484330,10,30,1,29,30,1,29,,,
484349,10,40,1,39,40,1,39,,,
484358,10,67,3,64,67,3,64,,,
484367,10,340,46,294,340,46,294,,,
484376,10,533,59,474,533,59,474,,,
484394,10,140,16,124,87,7,80,53,9,44
484473,10,5356,2496,2860,2514,1219,1295,2842,1277,1565
484604,10,452,11,441,204,5,199,248,6,242
484613,10,88891,25618,63273,88891,25618,63273,,,
484631,10,635,329,306,635,329,306,,,
484710,10,30,22,8,30,22,8,,,
484756,10,57,28,29,57,28,29,,,
484844,10,660,289,371,613,259,354,47,30,17
484862,10,229,103,126,103,53,50,126,50,76
484871,10,115,115,0,115,115,0,,,
484899,10,209,5,204,209,5,204,,,
484905,10,3685,1253,2432,1989,668,1321,1696,585,1111
484923,10,61,0,61,50,0,50,11,0,11
484932,10,1634,684,950,948,359,589,686,325,361
484950,10,67,6,61,67,6,61,,,
484996,10,193,4,189,193,4,189,,,
485014,10,102,5,97,66,4,62,36,1,35
485032,10,169,9,160,90,5,85,79,4,75
485111,10,6998,2701,4297,2586,1138,1448,4412,1563,2849
485166,10,84,21,63,84,21,63,,,
485236,10,70,2,68,23,0,23,47,2,45
485272,10,914,95,819,527,52,475,387,43,344
485342,10,321,165,156,155,103,52,166,62,104
485360,10,35,1,34,35,1,34,,,
485379,10,281,63,218,281,63,218,,,
485388,10,304,38,266,304,38,266,,,
485397,10,139,2,137,97,2,95,42,0,42
485403,10,108,28,80,50,17,33,58,11,47
485412,10,117,22,95,117,22,95,,,
485458,10,3747,1307,2440,550,178,372,3197,1129,2068
485476,10,88,1,87,88,1,87,,,
485485,10,234,26,208,234,26,208,,,
485494,10,115,101,14,102,91,11,13,10,3
485500,10,117,107,10,8,8,0,109,99,10
485519,10,510,299,211,319,172,147,191,127,64
485546,10,506,270,236,244,125,119,262,145,117
485564,10,134,10,124,124,10,114,10,0,10
485573,10,213,28,185,202,27,175,11,1,10
485591,10,31,0,31,31,0,31,,,
485607,10,42,3,39,29,1,28,13,2,11
485698,10,141,121,20,139,121,18,2,0,2
485704,10,8,1,7,3,0,3,5,1,4
485768,10,850,466,384,850,466,384,,,
485801,10,95,14,81,95,14,81,,,
485856,10,39,10,29,16,5,11,23,5,18
485874,10,156,3,153,92,3,89,64,0,64
485926,10,229,61,168,228,60,168,1,1,0
485953,10,82,74,8,82,74,8,,,
485962,10,37,26,11,24,15,9,13,11,2
485999,10,91,91,0,91,91,0,,,
486017,10,23,23,0,23,23,0,,,
486026,10,127,127,0,127,127,0,,,
486053,10,242,183,59,181,133,48,61,50,11
486080,10,9,6,3,9,6,3,,,
486123,10,39,17,22,39,17,22,,,
486141,10,11,1,10,11,1,10,,,
486150,10,90,35,55,52,21,31,38,14,24
486169,10,56,46,10,56,46,10,,,
486196,10,189,189,0,189,189,0,,,
486202,10,23,3,20,23,3,20,,,
486239,10,207,94,113,182,83,99,25,11,14
486248,10,122,61,61,122,61,61,,,
486257,10,326,145,181,241,104,137,85,41,44
486284,10,261,80,181,214,64,150,47,16,31
486345,10,207,204,3,112,110,2,95,94,1
486354,10,52,24,28,52,24,28,,,
486372,10,105,78,27,98,73,25,7,5,2
486381,10,210,18,192,210,18,192,,,
486390,10,33,20,13,33,20,13,,,
486406,10,9,0,9,9,0,9,,,
486415,10,479,79,400,479,79,400,,,
486424,10,148,27,121,120,20,100,28,7,21
486433,10,159,53,106,127,44,83,32,9,23
486442,10,73,14,59,73,14,59,,,
486460,10,27,7,20,27,7,20,,,
486488,10,23,18,5,20,16,4,3,2,1
486497,10,71,67,4,69,65,4,2,2,0
486503,10,57,1,56,57,1,56,,,
486512,10,426,202,224,426,202,224,,,
486530,10,157,3,154,157,3,154,,,
486558,10,240,223,17,160,146,14,80,77,3
486567,10,244,11,233,242,11,231,2,0,2
486576,10,115,38,77,115,38,77,,,
486619,10,135,5,130,103,5,98,32,0,32
486691,10,111,2,109,70,2,68,41,0,41
486707,10,85,5,80,85,5,80,,,
486716,10,71,2,69,71,2,69,,,
486752,10,43,2,41,43,2,41,,,
486770,10,108,30,78,108,30,78,,,
486798,10,1529,1347,182,1529,1347,182,,,
486813,10,673,123,550,673,123,550,,,
486822,10,879,100,779,879,100,779,,,
486840,10,43190,21267,21923,30353,14958,15395,12837,6309,6528
486859,10,27,0,27,27,0,27,,,
486877,10,11,1,10,11,1,10,,,
486886,10,31,0,31,13,0,13,18,0,18
486901,10,1105,515,590,962,454,508,143,61,82
486938,10,567,98,469,212,40,172,355,58,297
486947,10,637,76,561,262,25,237,375,51,324
486956,10,1261,170,1091,428,65,363,833,105,728
486965,10,262,98,164,262,98,164,,,
486983,10,45,18,27,45,18,27,,,
487010,10,3139,1069,2070,2920,1014,1906,219,55,164
487047,10,85,4,81,85,4,81,,,
487065,10,70,1,69,70,1,69,,,
487083,10,33,0,33,33,0,33,,,
487092,10,1048,494,554,1048,494,554,,,
487153,10,42,7,35,42,7,35,,,
487162,10,4657,1552,3105,1149,323,826,3508,1229,2279
487232,10,106,5,101,106,5,101,,,
487302,10,473,107,366,472,107,365,1,0,1
487311,10,522,465,57,522,465,57,,,
487320,10,10601,7479,3122,5285,4270,1015,5316,3209,2107
487348,10,113,1,112,46,1,45,67,0,67
487375,10,1142,154,988,797,110,687,345,44,301
487384,10,475,144,331,475,144,331,,,
487393,10,597,247,350,597,247,350,,,
487409,10,616,242,374,616,242,374,,,
487418,10,640,232,408,640,232,408,,,
487427,10,532,179,353,532,179,353,,,
487436,10,664,123,541,664,123,541,,,
487445,10,426,171,255,426,171,255,,,
487454,10,375,109,266,375,109,266,,,
487472,10,761,238,523,761,238,523,,,
487481,10,1422,453,969,1422,453,969,,,
487490,10,1029,186,843,1029,186,843,,,
487506,10,88,2,86,30,0,30,58,2,56
487524,10,3065,1184,1881,2315,962,1353,750,222,528
487533,10,128,1,127,46,1,45,82,0,82
487588,10,358,11,347,358,11,347,,,
487597,10,1507,1445,62,1507,1445,62,,,
487603,10,1222,518,704,372,134,238,850,384,466
487621,10,26,23,3,22,19,3,4,4,0
487649,10,131,45,86,129,44,85,2,1,1
487658,10,94,76,18,94,76,18,,,
487676,10,198,14,184,96,1,95,102,13,89
487746,10,28,28,0,28,28,0,,,
487773,10,29,2,27,17,0,17,12,2,10
487791,10,503,457,46,308,279,29,195,178,17
487807,10,52,35,17,35,26,9,17,9,8
487816,10,12,0,12,12,0,12,,,
487852,10,32,9,23,,,,32,9,23
487861,10,306,44,262,240,36,204,66,8,58
487889,10,133,17,116,133,17,116,,,
487898,10,12,10,2,7,5,2,5,5,0
487904,10,26,16,10,26,16,10,,,
487922,10,65,0,65,52,0,52,13,0,13
487959,10,85,0,85,71,0,71,14,0,14
487968,10,72,6,66,72,6,66,,,
487977,10,2505,176,2329,2160,54,2106,345,122,223
487995,10,143,37,106,69,18,51,74,19,55
488004,10,28,28,0,28,28,0,,,
488013,10,224,12,212,207,11,196,17,1,16
488022,10,65,36,29,50,26,24,15,10,5
488031,10,177,79,98,176,79,97,1,0,1
488059,10,248,82,166,248,82,166,,,
488068,10,71,8,63,16,2,14,55,6,49
488077,10,4011,3916,95,2621,2546,75,1390,1370,20
488110,10,62,14,48,28,4,24,34,10,24
488129,10,26,0,26,4,0,4,22,0,22
488138,10,167,5,162,167,5,162,,,
488147,10,41,1,40,41,1,40,,,
488174,10,36,21,15,31,17,14,5,4,1
488183,10,15,1,14,15,1,14,,,
488192,10,68,66,2,68,66,2,,,
488217,10,93,4,89,93,4,89,,,
488226,10,16,8,8,16,8,8,,,
488253,10,69,43,26,42,29,13,27,14,13
488262,10,12,8,4,6,5,1,6,3,3
488271,10,85,2,83,85,2,83,,,
488280,10,37,29,8,37,29,8,,,
488299,10,47,9,38,37,9,28,10,0,10
488305,10,114,74,40,77,51,26,37,23,14
488314,10,98,98,0,98,98,0,,,
488332,10,204,23,181,204,23,181,,,
488350,10,126,126,0,126,126,0,,,
488369,10,70,54,16,70,54,16,,,
488378,10,92,6,86,91,6,85,1,0,1
488387,10,220,46,174,40,8,32,180,38,142
488396,10,33,31,2,5,4,1,28,27,1
488411,10,103,1,102,103,1,102,,,
488420,10,190,20,170,,,,190,20,170
488439,10,69,56,13,55,44,11,14,12,2
488448,10,100,68,32,95,65,30,5,3,2
488527,10,758,361,397,758,361,397,,,
488554,10,662,281,381,662,281,381,,,
488563,10,19,12,7,18,11,7,1,1,0
488572,10,391,188,203,387,186,201,4,2,2
488590,10,10,5,5,10,5,5,,,
488651,10,168,27,141,103,17,86,65,10,55
488679,10,10012,2947,7065,9260,2727,6533,752,220,532
488721,10,1182,1058,124,267,237,30,915,821,94
488730,10,7399,3054,4345,1436,672,764,5963,2382,3581
488749,10,121,27,94,105,24,81,16,3,13
488776,10,257,85,172,146,48,98,111,37,74
488785,10,232,117,115,212,105,107,20,12,8
488800,10,1108,312,796,1097,310,787,11,2,9
488837,10,203,182,21,203,182,21,,,
488846,10,34192,18317,15875,12439,6716,5723,21753,11601,10152
488891,10,338,115,223,338,115,223,,,
488907,10,30,1,29,23,0,23,7,1,6
488916,10,43,0,43,43,0,43,,,
488934,10,3953,2130,1823,613,331,282,3340,1799,1541
488952,10,50,0,50,50,0,50,,,
488961,10,57,3,54,57,3,54,,,
488970,10,29,1,28,29,1,28,,,
488989,10,136,3,133,88,0,88,48,3,45
488998,10,103,18,85,102,18,84,1,0,1
489122,10,54,3,51,25,0,25,29,3,26
489131,10,71,8,63,36,1,35,35,7,28
489140,10,92,14,78,37,2,35,55,12,43
489159,10,146,3,143,102,2,100,44,1,43
489201,10,7772,3209,4563,2015,922,1093,5757,2287,3470
489238,10,75,6,69,45,4,41,30,2,28
489247,10,55,10,45,23,5,18,32,5,27
489256,10,200,188,12,198,186,12,2,2,0
489283,10,670,110,560,670,110,560,,,
489335,10,53,35,18,4,1,3,49,34,15
489344,10,268,22,246,84,5,79,184,17,167
489353,10,597,133,464,316,72,244,281,61,220
489371,10,214,193,21,214,193,21,,,
489779,10,45125,17208,27917,11174,3864,7310,33951,13344,20607
489812,10,56,0,56,56,0,56,,,
489830,10,76,3,73,76,3,73,,,
489858,10,591,192,399,587,190,397,4,2,2
489937,10,826,517,309,499,279,220,327,238,89
490018,10,23,20,3,23,20,3,,,
490045,10,215,110,105,115,60,55,100,50,50
490054,10,289,95,194,191,65,126,98,30,68
490081,10,128,81,47,105,68,37,23,13,10
490090,10,54,30,24,31,12,19,23,18,5
490106,10,393,145,248,138,45,93,255,100,155
490115,10,57,46,11,57,46,11,,,
490124,10,5,2,3,5,2,3,,,
490133,10,5625,3085,2540,5379,2962,2417,246,123,123
490142,10,42,6,36,15,4,11,27,2,25
490151,10,63,1,62,46,1,45,17,0,17
490160,10,99,10,89,99,10,89,,,
490197,10,42,12,30,42,12,30,,,
490203,10,130,10,120,55,3,52,75,7,68
490221,10,9,1,8,7,0,7,2,1,1
490230,10,281,125,156,280,124,156,1,1,0
490249,10,27,23,4,27,23,4,,,
490258,10,131,22,109,131,22,109,,,
490267,10,25,22,3,20,20,0,5,2,3
490276,10,131,131,0,131,131,0,,,
490285,10,356,290,66,356,290,66,,,
490294,10,124,34,90,120,32,88,4,2,2
490300,10,84,23,61,44,1,43,40,22,18
490319,10,12,12,0,12,12,0,,,
490328,10,94,94,0,94,94,0,,,
490346,10,73,0,73,73,0,73,,,
490373,10,332,160,172,332,160,172,,,
490382,10,36,8,28,36,8,28,,,
490391,10,114,2,112,114,2,112,,,
490407,10,79,1,78,46,1,45,33,0,33
490416,10,26,20,6,26,20,6,,,
490425,10,167,2,165,167,2,165,,,
490434,10,30,0,30,30,0,30,,,
490443,10,115,0,115,115,0,115,,,
490452,10,50,3,47,21,3,18,29,0,29
490461,10,66,3,63,66,3,63,,,
490470,10,15,2,13,15,2,13,,,
490489,10,43,33,10,35,27,8,8,6,2
490498,10,28,21,7,28,21,7,,,
490504,10,40,40,0,40,40,0,,,
490513,10,34,34,0,34,34,0,,,
490522,10,21,0,21,21,0,21,,,
490531,10,46,36,10,23,18,5,23,18,5
490559,10,392,19,373,392,19,373,,,
490601,10,642,339,303,638,335,303,4,4,0
490674,10,7,0,7,7,0,7,,,
490692,10,48,40,8,48,40,8,,,
490717,10,74,8,66,74,8,66,,,
490735,10,95,5,90,95,5,90,,,
490744,10,30,26,4,30,26,4,,,
490753,10,43,12,31,43,12,31,,,
490805,10,8911,3910,5001,4991,2452,2539,3920,1458,2462
490814,10,94,4,90,94,4,90,,,
490832,10,212,13,199,157,8,149,55,5,50
490841,10,228,6,222,228,6,222,,,
490869,10,322,28,294,322,28,294,,,
490878,10,418,75,343,418,75,343,,,
490896,10,100,7,93,66,4,62,34,3,31
490948,10,9,6,3,9,6,3,,,
490975,10,357,52,305,334,48,286,23,4,19
491057,10,292,292,0,292,292,0,,,
491066,10,71,2,69,21,0,21,50,2,48
491075,10,69,62,7,69,62,7,,,
491084,10,53,0,53,53,0,53,,,
491136,10,87,2,85,54,1,53,33,1,32
491145,10,103,0,103,68,0,68,35,0,35
491181,10,470,59,411,254,33,221,216,26,190
491190,10,139,28,111,79,18,61,60,10,50
491215,10,57,55,2,57,55,2,,,
491224,10,83,4,79,49,1,48,34,3,31
491233,10,26,0,26,18,0,18,8,0,8
491242,10,66,34,32,66,34,32,,,
491251,10,68,41,27,68,41,27,,,
491260,10,80,2,78,56,2,54,24,0,24
491288,10,612,173,439,76,22,54,536,151,385
491297,10,146,59,87,10,4,6,136,55,81
491394,10,103,83,20,97,80,17,6,3,3
491446,10,159,0,159,156,0,156,3,0,3
491464,10,193,41,152,193,41,152,,,
491473,10,750,432,318,43,2,41,707,430,277
491507,10,10,0,10,10,0,10,,,
491525,10,102,55,47,61,30,31,41,25,16
491534,10,14,3,11,,,,14,3,11
491543,10,97,20,77,61,13,48,36,7,29
491552,10,32,0,32,32,0,32,,,
491570,10,32,0,32,32,0,32,,,
491589,10,26,18,8,7,4,3,19,14,5
491598,10,24,1,23,24,1,23,,,
491613,10,69,69,0,69,69,0,,,
491622,10,81,81,0,81,81,0,,,
491631,10,173,0,173,121,0,121,52,0,52
491640,10,186,186,0,186,186,0,,,
491659,10,163,114,49,163,114,49,,,
491668,10,162,4,158,162,4,158,,,
491677,10,37,24,13,20,14,6,17,10,7
491686,10,34,27,7,34,27,7,,,
491695,10,37,0,37,37,0,37,,,
491701,10,37,10,27,,,,37,10,27
491710,10,72,72,0,72,72,0,,,
491729,10,17,0,17,17,0,17,,,
491738,10,63,7,56,57,6,51,6,1,5
491747,10,17,2,15,17,2,15,,,
491756,10,99,82,17,99,82,17,,,
491765,10,93,93,0,93,93,0,,,
491774,10,144,20,124,102,12,90,42,8,34
491783,10,78,66,12,22,19,3,56,47,9
491792,10,74,3,71,74,3,71,,,
491808,10,195,38,157,166,32,134,29,6,23
491817,10,200,0,200,200,0,200,,,
491826,10,97,0,97,97,0,97,,,
491835,10,86,1,85,86,1,85,,,
491844,10,184,53,131,116,36,80,68,17,51
491853,10,53,0,53,53,0,53,,,
491871,10,18,0,18,13,0,13,5,0,5
491880,10,97,95,2,97,95,2,,,
491899,10,103,9,94,16,1,15,87,8,79
491905,10,109,4,105,109,4,105,,,
491914,10,178,178,0,178,178,0,,,
491923,10,328,2,326,288,2,286,40,0,40
491932,10,27,23,4,27,23,4,,,
491941,10,153,6,147,153,6,147,,,
491950,10,924,127,797,43,9,34,881,118,763
491978,10,50,21,29,10,5,5,40,16,24
491996,10,45,3,42,45,3,42,,,
492005,10,56,1,55,45,1,44,11,0,11
492023,10,273,41,232,,,,273,41,232
492032,10,29,0,29,,,,29,0,29
492069,10,82,47,35,76,46,30,6,1,5
492078,10,98,97,1,,,,98,97,1
492096,10,7,0,7,7,0,7,,,
492139,10,209,179,30,209,179,30,,,
492148,10,5,1,4,5,1,4,,,
492209,10,36,7,29,31,7,24,5,0,5
492281,10,62,45,17,62,45,17,,,
492306,10,174,44,130,,,,174,44,130
492315,10,110,20,90,,,,110,20,90
492324,10,192,16,176,,,,192,16,176
492360,10,48,18,30,36,16,20,12,2,10
492421,10,24,21,3,24,21,3,,,
492449,10,611,139,472,611,139,472,,,
492476,10,226,45,181,79,13,66,147,32,115
492607,10,145,37,108,49,6,43,96,31,65
492643,10,88,19,69,88,19,69,,,
492652,10,22,13,9,22,13,9,,,
492661,10,246,36,210,246,36,210,,,
492689,10,855,314,541,809,308,501,46,6,40
492704,10,208,36,172,203,33,170,5,3,2
492722,10,340,27,313,340,27,313,,,
492731,10,174,28,146,121,22,99,53,6,47
492759,10,365,34,331,155,13,142,210,21,189
492801,10,742,251,491,427,140,287,315,111,204
492935,10,129,14,115,129,14,115,,,
492953,10,107,5,102,61,3,58,46,2,44
492962,10,2604,996,1608,1090,388,702,1514,608,906
493071,10,499,122,377,499,122,377,,,
493080,10,362,181,181,66,38,28,296,143,153
493132,10,1125,1090,35,1125,1090,35,,,
493150,10,174,15,159,174,15,159,,,
493372,10,17,6,11,17,6,11,,,
493451,10,67,13,54,67,13,54,,,
493479,10,18,8,10,18,8,10,,,
493488,10,22,4,18,22,4,18,,,
493512,10,137,94,43,119,86,33,18,8,10
493521,10,38,29,9,37,28,9,1,1,0
493530,10,46,15,31,28,7,21,18,8,10
493549,10,111,102,9,111,102,9,,,
493558,10,12,11,1,12,11,1,,,
493567,10,51,2,49,,,,51,2,49
493576,10,11,0,11,11,0,11,,,
493585,10,64,3,61,64,3,61,,,
493594,10,40,40,0,40,40,0,,,
493600,10,175,175,0,175,175,0,,,
493619,10,24,11,13,21,10,11,3,1,2
493628,10,152,9,143,75,2,73,77,7,70
493637,10,19,1,18,19,1,18,,,
493646,10,246,0,246,246,0,246,,,
493655,10,21,13,8,20,13,7,1,0,1
493664,10,60,60,0,57,57,0,3,3,0
493673,10,162,71,91,72,33,39,90,38,52
493682,10,76,6,70,69,4,65,7,2,5
493691,10,35,0,35,25,0,25,10,0,10
493707,10,82,82,0,82,82,0,,,
493716,10,68,68,0,67,67,0,1,1,0
493743,10,221,171,50,113,89,24,108,82,26
493752,10,4,0,4,4,0,4,,,
493761,10,128,47,81,26,12,14,102,35,67
493770,10,32,1,31,32,1,31,,,
493798,10,114,0,114,100,0,100,14,0,14
493804,10,95,68,27,95,68,27,,,
493813,10,162,10,152,162,10,152,,,
493822,10,285,80,205,165,34,131,120,46,74
493831,10,42,27,15,42,27,15,,,
493868,10,38,27,11,32,23,9,6,4,2
493895,10,969,872,97,725,657,68,244,215,29
493910,10,33,1,32,11,0,11,22,1,21
493947,10,619,379,240,619,379,240,,,
493992,10,263,61,202,263,61,202,,,
494001,10,95,1,94,25,0,25,70,1,69
494010,10,104,36,68,101,35,66,3,1,2
494029,10,17,11,6,10,8,2,7,3,4
494162,10,296,31,265,184,14,170,112,17,95
494232,10,25,1,24,18,1,17,7,0,7
494250,10,693,42,651,693,42,651,,,
494278,10,243,39,204,80,6,74,163,33,130
494287,10,448,115,333,147,40,107,301,75,226
494357,10,965,354,611,965,354,611,,,
494436,10,295,62,233,295,62,233,,,
494463,10,290,0,290,290,0,290,,,
494472,10,14,0,14,6,0,6,8,0,8
494524,10,84,4,80,83,4,79,1,0,1
494551,10,34,4,30,11,2,9,23,2,21
494588,10,369,44,325,369,44,325,,,
494597,10,118,54,64,83,36,47,35,18,17
494603,10,2286,1550,736,567,387,180,1719,1163,556
494621,10,108,8,100,12,3,9,96,5,91
494630,10,47,26,21,43,24,19,4,2,2
494649,10,23,0,23,9,0,9,14,0,14
494658,10,57,2,55,45,2,43,12,0,12
494685,10,473,192,281,390,149,241,83,43,40
494694,10,74,4,70,74,4,70,,,
494700,10,35,2,33,35,2,33,,,
494719,10,73,38,35,40,18,22,33,20,13
494728,10,54,43,11,51,41,10,3,2,1
494737,10,171,171,0,171,171,0,,,
494746,10,471,84,387,471,84,387,,,
494755,10,60,8,52,60,8,52,,,
494764,10,169,159,10,128,119,9,41,40,1
494807,10,680,106,574,664,103,561,16,3,13
494843,10,548,38,510,548,38,510,,,
494852,10,473,102,371,473,102,371,,,
494898,10,69,12,57,69,12,57,,,
494904,10,138,30,108,48,10,38,90,20,70
494959,10,74,21,53,16,4,12,58,17,41
494986,10,36,1,35,26,1,25,10,0,10
494995,10,35,33,2,35,33,2,,,
495013,10,223,197,26,,,,223,197,26
495031,10,68,68,0,64,64,0,4,4,0
495040,10,50,2,48,50,2,48,,,
495059,10,45,23,22,43,22,21,2,1,1
495077,10,77,5,72,77,5,72,,,
495101,10,62,11,51,62,11,51,,,
495110,10,23,21,2,23,21,2,,,
495129,10,76,63,13,76,63,13,,,
495138,10,12,2,10,12,2,10,,,
495147,10,24,11,13,12,9,3,12,2,10
495165,10,32,9,23,32,9,23,,,
495174,10,38,18,20,,,,38,18,20
495183,10,150,64,86,150,64,86,,,
495192,10,322,72,250,311,70,241,11,2,9
495208,10,23,14,9,23,14,9,,,
495217,10,29,22,7,29,22,7,,,
495226,10,4,0,4,4,0,4,,,
495235,10,22,2,20,11,0,11,11,2,9
495244,10,21,1,20,14,0,14,7,1,6
495253,10,55,11,44,53,11,42,2,0,2
495262,10,45,0,45,22,0,22,23,0,23
495271,10,76,17,59,8,0,8,68,17,51
495280,10,32,18,14,20,12,8,12,6,6
495299,10,54,10,44,54,10,44,,,
495305,10,100,24,76,55,18,37,45,6,39
495314,10,491,261,230,491,261,230,,,
495341,10,50,36,14,50,36,14,,,
495350,10,22,8,14,22,8,14,,,
495369,10,59,7,52,31,4,27,28,3,25
495378,10,73,5,68,10,0,10,63,5,58
495387,10,52,38,14,29,21,8,23,17,6
495396,10,27,2,25,27,2,25,,,
495411,10,91,10,81,90,10,80,1,0,1
495420,10,320,39,281,192,23,169,128,16,112
495439,10,321,22,299,211,17,194,110,5,105
495448,10,516,59,457,385,39,346,131,20,111
495457,10,746,78,668,503,51,452,243,27,216
495518,10,85,3,82,54,2,52,31,1,30
495730,10,83,3,80,45,1,44,38,2,36
495776,10,20,19,1,20,19,1,,,
495794,10,247,4,243,167,2,165,80,2,78
495837,10,118,16,102,118,16,102,,,
495925,10,68,8,60,68,8,60,,,
495934,10,79,8,71,79,8,71,,,
495943,10,14,1,13,14,1,13,,,
495952,10,146,42,104,146,42,104,,,
495961,10,110,7,103,110,7,103,,,
495970,10,331,106,225,331,106,225,,,
495998,10,72,4,68,72,4,68,,,
496043,10,536,270,266,536,270,266,,,
496052,10,15,13,2,15,13,2,,,
496061,10,241,11,230,104,7,97,137,4,133
496186,10,166,147,19,164,145,19,2,2,0
496265,10,50,44,6,50,44,6,,,
496283,10,198,35,163,198,35,163,,,
496326,10,355,40,315,355,40,315,,,
496371,10,8,8,0,8,8,0,,,
496399,10,37,5,32,37,5,32,,,
496469,10,151,15,136,69,6,63,82,9,73
496478,10,55,40,15,,,,55,40,15
496520,10,74,19,55,,,,74,19,55
496539,10,68,1,67,45,0,45,23,1,22
496618,10,161,9,152,161,9,152,,,
496627,10,962,428,534,837,364,473,125,64,61
496636,10,213,40,173,213,40,173,,,
496645,10,247,172,75,47,5,42,200,167,33
496654,10,33,6,27,24,4,20,9,2,7
496663,10,29,21,8,27,19,8,2,2,0
496672,10,41,7,34,21,7,14,20,0,20
496681,10,131,4,127,131,4,127,,,
496690,10,43,6,37,37,4,33,6,2,4
496706,10,169,111,58,169,111,58,,,
496715,10,61,6,55,61,6,55,,,
496724,10,40,0,40,40,0,40,,,
496733,10,84,2,82,84,2,82,,,
496751,10,25,13,12,25,13,12,,,
496803,10,18,9,9,18,9,9,,,
496894,10,35,2,33,11,0,11,24,2,22
496919,10,858,383,475,858,383,475,,,
496955,10,676,259,417,676,259,417,,,
496964,10,22,14,8,22,14,8,,,
496973,10,185,29,156,118,17,101,67,12,55
496991,10,418,61,357,241,28,213,177,33,144
497000,10,217,56,161,217,56,161,,,
497037,10,766,149,617,460,80,380,306,69,237
497046,10,5522,1842,3680,706,260,446,4816,1582,3234
497073,10,406,11,395,185,5,180,221,6,215
497107,10,228,37,191,,,,228,37,191
497116,10,626,67,559,346,36,310,280,31,249
497125,10,377,38,339,172,18,154,205,20,185
497161,10,122,107,15,99,85,14,23,22,1
497189,10,31,2,29,31,2,29,,,
497198,10,114,3,111,71,1,70,43,2,41
497204,10,107,87,20,36,24,12,71,63,8
497213,10,35,17,18,20,13,7,15,4,11
497222,10,25,2,23,20,2,18,5,0,5
497268,10,258,24,234,181,14,167,77,10,67
497277,10,453,75,378,453,75,378,,,
497286,10,434,403,31,434,403,31,,,
497301,10,379,9,370,211,4,207,168,5,163
497310,10,108,1,107,108,1,107,,,
497329,10,282,70,212,282,70,212,,,
497338,10,96,9,87,96,9,87,,,
497356,10,40,24,16,37,22,15,3,2,1
497365,10,24,19,5,24,19,5,,,
497374,10,139,19,120,139,19,120,,,
497383,10,11,10,1,11,10,1,,,
497392,10,86,70,16,17,15,2,69,55,14
497408,10,61,35,26,48,30,18,13,5,8
497417,10,18,0,18,18,0,18,,,
497426,10,118,14,104,94,2,92,24,12,12
497435,10,76,21,55,76,21,55,,,
497444,10,25,9,16,5,3,2,20,6,14
497453,10,9,5,4,6,4,2,3,1,2
497462,10,182,88,94,154,73,81,28,15,13
497471,10,8,1,7,3,1,2,5,0,5
497480,10,896,84,812,708,26,682,188,58,130
497499,10,42,41,1,,,,42,41,1
497666,10,22,5,17,20,4,16,2,1,1
497675,10,30,2,28,18,2,16,12,0,12
497684,10,41,1,40,41,1,40,,,
497693,10,91,43,48,91,43,48,,,
497718,10,69,26,43,11,4,7,58,22,36
497736,10,54,6,48,54,6,48,,,
497745,10,150,131,19,124,110,14,26,21,5
497790,10,111,103,8,111,103,8,,,
497824,10,240,104,136,94,37,57,146,67,79
497833,10,227,104,123,217,104,113,10,0,10
497888,10,104,7,97,67,3,64,37,4,33
497897,10,185,8,177,185,8,177,,,
497903,10,4,0,4,4,0,4,,,
497912,10,101,7,94,101,7,94,,,
497949,10,595,182,413,595,182,413,,,
497958,10,520,133,387,520,133,387,,,
498003,10,209,85,124,153,66,87,56,19,37
498012,10,274,258,16,274,258,16,,,
498030,10,152,144,8,152,144,8,,,
498049,10,297,20,277,185,11,174,112,9,103
498076,10,130,10,120,44,3,41,86,7,79
498085,10,256,22,234,105,8,97,151,14,137
498094,10,212,8,204,83,5,78,129,3,126
498100,10,252,18,234,21,0,21,231,18,213
498119,10,52,4,48,13,0,13,39,4,35
498234,10,116,30,86,113,29,84,3,1,2
498243,10,6,1,5,6,1,5,,,
498289,10,111,53,58,20,9,11,91,44,47
498322,10,104,0,104,104,0,104,,,
498331,10,127,63,64,15,5,10,112,58,54
498340,10,74,9,65,74,9,65,,,
498359,10,68,0,68,38,0,38,30,0,30
498368,10,4,0,4,,,,4,0,4
498377,10,73,69,4,73,69,4,,,
498386,10,48,24,24,42,24,18,6,0,6
498401,10,47,2,45,38,2,36,9,0,9
498410,10,26,23,3,18,16,2,8,7,1
498447,10,144,9,135,73,8,65,71,1,70
498456,10,210,23,187,141,14,127,69,9,60
498465,10,136,108,28,136,108,28,,,
498483,10,26,4,22,23,4,19,3,0,3
498553,10,141,58,83,141,58,83,,,
498562,10,12074,4596,7478,9791,3802,5989,2283,794,1489
498571,10,12778,4532,8246,9188,3393,5795,3590,1139,2451
100654,20,5206,2111,3095,4794,1937,2857,412,174,238
100663,20,13032,4884,8148,10263,3836,6427,2769,1048,1721
100690,20,228,83,145,129,50,79,99,33,66
100706,20,7169,4265,2904,5861,3535,2326,1308,730,578
100724,20,3296,1185,2111,3042,1095,1947,254,90,164
100751,20,32458,14152,18306,28958,12755,16203,3500,1397,2103
100760,20,1777,751,1026,514,224,290,1263,527,736
100812,20,2520,744,1776,1106,307,799,1414,437,977
100830,20,3754,1199,2555,2568,814,1754,1186,385,801
100858,20,25379,12684,12695,22979,11374,11605,2400,1310,1090
100937,20,975,512,463,969,511,458,6,1,5
101028,20,1641,560,1081,519,205,314,1122,355,767
101116,20,315,42,273,215,32,183,100,10,90
101143,20,2010,1011,999,945,517,428,1065,494,571
101161,20,6800,2872,3928,2708,1052,1656,4092,1820,2272
101189,20,1792,794,998,1207,569,638,585,225,360
101240,20,4352,1664,2688,2003,820,1183,2349,844,1505
101277,20,45,0,45,45,0,45,,,
101286,20,3832,1195,2637,1259,403,856,2573,792,1781
101295,20,5965,2172,3793,2333,887,1446,3632,1285,2347
101301,20,1860,778,1082,516,237,279,1344,541,803
101365,20,570,125,445,233,54,179,337,71,266
101435,20,812,453,359,792,446,346,20,7,13
101453,20,82,70,12,33,28,5,49,42,7
101462,20,976,388,588,223,103,120,753,285,468
101471,20,768,671,97,626,543,83,142,128,14
101480,20,8310,3368,4942,6471,2651,3820,1839,717,1122
101505,20,8431,3090,5341,2011,812,1199,6420,2278,4142
101514,20,8163,3698,4465,2698,1313,1385,5465,2385,3080
101569,20,2919,987,1932,1110,450,660,1809,537,1272
101587,20,2427,725,1702,1901,536,1365,526,189,337
101602,20,1929,878,1051,759,290,469,1170,588,582
101648,20,320,232,88,320,232,88,,,
101675,20,1258,570,688,1201,544,657,57,26,31
101693,20,1584,621,963,1054,392,662,530,229,301
101709,20,2172,800,1372,1967,728,1239,205,72,133
101736,20,4032,1853,2179,905,401,504,3127,1452,1675
101879,20,7214,2650,4564,4655,1695,2960,2559,955,1604
101897,20,2590,902,1688,921,349,572,1669,553,1116
101912,20,1431,612,819,1305,551,754,126,61,65
101994,20,434,196,238,185,99,86,249,97,152
102030,20,2968,1040,1928,978,427,551,1990,613,1377
102049,20,3672,1185,2487,3609,1162,2447,63,23,40
102058,20,31,13,18,11,5,6,20,8,12
102067,20,4166,1698,2468,1735,851,884,2431,847,1584
102076,20,2507,928,1579,1012,373,639,1495,555,940
102094,20,8480,3267,5213,7056,2677,4379,1424,590,834
102234,20,933,401,532,900,390,510,33,11,22
102270,20,744,328,416,608,267,341,136,61,75
102298,20,835,435,400,787,411,376,48,24,24
102313,20,1984,771,1213,814,360,454,1170,411,759
102368,20,10768,3838,6930,7137,2526,4611,3631,1312,2319
102377,20,2100,801,1299,1986,749,1237,114,52,62
102395,20,108,85,23,24,14,10,84,71,13
102429,20,3703,1495,2208,1054,446,608,2649,1049,1600
102553,20,9925,3951,5974,3894,1676,2218,6031,2275,3756
102580,20,39,23,16,21,14,7,18,9,9
102614,20,5636,2142,3494,2320,1069,1251,3316,1073,2243
102632,20,1724,615,1109,489,197,292,1235,418,817
102669,20,490,99,391,382,61,321,108,38,70
102711,20,202,140,62,133,95,38,69,45,24
102845,20,2117,577,1540,2117,577,1540,,,
103501,20,268,36,232,268,36,232,,,
103741,20,184,10,174,124,9,115,60,1,59
103893,20,1048,208,840,1048,208,840,,,
103909,20,532,69,463,532,69,463,,,
103927,20,446,83,363,446,83,363,,,
103954,20,34,2,32,34,2,32,,,
103963,20,411,352,59,411,352,59,,,
104090,20,841,91,750,841,91,750,,,
104151,20,65492,33351,32141,59884,30168,29716,5608,3183,2425
104160,20,8050,3257,4793,1989,870,1119,6061,2387,3674
104179,20,38751,17213,21538,30230,13047,17183,8521,4166,4355
104346,20,4652,1781,2871,1089,469,620,3563,1312,2251
104391,20,85,2,83,85,2,83,,,
104425,20,3797,1699,2098,1392,576,816,2405,1123,1282
104443,20,60,5,55,46,4,42,14,1,13
104568,20,383,3,380,187,3,184,196,0,196
104577,20,4864,1989,2875,1351,627,724,3513,1362,2151
104586,20,3120,2266,854,2970,2142,828,150,124,26
104708,20,13342,5915,7427,3647,1842,1805,9695,4073,5622
104717,20,66769,20019,46750,23945,9586,14359,42824,10433,32391
105145,20,4699,1663,3036,1004,390,614,3695,1273,2422
105154,20,15772,7109,8663,4109,2027,2082,11663,5082,6581
105206,20,4038,1285,2753,746,288,458,3292,997,2295
105215,20,658,612,46,658,612,46,,,
105297,20,1548,389,1159,706,187,519,842,202,640
105330,20,23204,8550,14654,20011,7504,12507,3193,1046,2147
105349,20,2740,991,1749,503,231,272,2237,760,1477
105428,20,9649,3519,6130,2217,870,1347,7432,2649,4783
105525,20,15293,6575,8718,3467,1643,1824,11826,4932,6894
105534,20,2477,489,1988,2477,489,1988,,,
105543,20,690,111,579,690,111,579,,,
105589,20,313,113,200,243,96,147,70,17,53
105659,20,1006,916,90,1006,916,90,,,
105668,20,17078,6879,10199,2005,746,1259,15073,6133,8940
105677,20,27,26,1,27,26,1,,,
105747,20,7065,3115,3950,1479,722,757,5586,2393,3193
105792,20,3706,1539,2167,834,380,454,2872,1159,1713
105899,20,1082,654,428,933,580,353,149,74,75
106041,20,1972,1864,108,1972,1864,108,,,
106148,20,6997,2967,4030,1353,717,636,5644,2250,3394
106245,20,5825,2237,3588,2961,1218,1743,2864,1019,1845
106263,20,1299,208,1091,764,125,639,535,83,452
106306,20,497,381,116,448,343,105,49,38,11
106315,20,98,2,96,98,2,96,,,
106324,20,29,1,28,18,1,17,11,0,11
106342,20,496,295,201,483,289,194,13,6,7
106351,20,60,29,31,60,29,31,,,
106360,20,16,1,15,16,1,15,,,
106397,20,26269,11613,14656,23446,10475,12971,2823,1138,1685
106412,20,2182,950,1232,1840,807,1033,342,143,199
106449,20,2928,1188,1740,1308,531,777,1620,657,963
106458,20,8201,3127,5074,5138,2123,3015,3063,1004,2059
106467,20,8722,3732,4990,5060,2252,2808,3662,1480,2182
106485,20,2270,935,1335,1539,680,859,731,255,476
106494,20,37,0,37,37,0,37,,,
106546,20,549,54,495,480,47,433,69,7,62
106625,20,1566,586,980,702,262,440,864,324,540
106704,20,7994,3061,4933,6662,2552,4110,1332,509,823
106713,20,564,312,252,461,270,191,103,42,61
106795,20,1278,462,816,504,181,323,774,281,493
106810,20,201,103,98,171,91,80,30,12,18
106883,20,1179,392,787,341,106,235,838,286,552
106908,20,358,17,341,347,17,330,11,0,11
106980,20,2340,961,1379,1192,518,674,1148,443,705
106999,20,1008,343,665,459,144,315,549,199,350
107044,20,3523,1551,1972,3009,1313,1696,514,238,276
107071,20,1807,860,947,1612,765,847,195,95,100
107080,20,1132,558,574,1119,547,572,13,11,2
107099,20,90,5,85,90,5,85,,,
107123,20,69,17,52,69,17,52,,,
107141,20,1801,749,1052,1271,523,748,530,226,304
107220,20,230,5,225,230,5,225,,,
107293,20,67,0,67,67,0,67,,,
107318,20,979,389,590,165,42,123,814,347,467
107327,20,1502,536,966,447,170,277,1055,366,689
107442,20,28,15,13,28,15,13,,,
107460,20,1856,836,1020,754,331,423,1102,505,597
107488,20,201,146,55,199,144,55,2,2,0
107512,20,1730,725,1005,1562,661,901,168,64,104
107521,20,1832,893,939,324,94,230,1508,799,709
107549,20,983,322,661,460,143,317,523,179,344
107558,20,784,374,410,770,368,402,14,6,8
107585,20,1888,759,1129,986,407,579,902,352,550
107600,20,769,318,451,675,285,390,94,33,61
107619,20,1234,451,783,441,149,292,793,302,491
107637,20,898,248,650,192,58,134,706,190,516
107655,20,27,0,27,27,0,27,,,
107664,20,4245,1431,2814,2176,802,1374,2069,629,1440
107725,20,1188,406,782,406,147,259,782,259,523
107743,20,679,254,425,345,129,216,334,125,209
107789,20,109,1,108,109,1,108,,,
107831,20,84,1,83,84,1,83,,,
107840,20,321,126,195,292,113,179,29,13,16
107877,20,562,264,298,549,257,292,13,7,6
107974,20,1162,370,792,486,165,321,676,205,471
107983,20,3148,1349,1799,2648,1170,1478,500,179,321
107992,20,943,409,534,474,221,253,469,188,281
108065,20,14,0,14,7,0,7,7,0,7
108092,20,5335,2158,3177,3374,1302,2072,1961,856,1105
108232,20,4555,1946,2609,2189,1019,1170,2366,927,1439
108667,20,5673,2409,3264,635,355,280,5038,2054,2984
108807,20,10329,4802,5527,3032,1483,1549,7297,3319,3978
108852,20,220,93,127,220,93,127,,,
108861,20,19,11,8,6,4,2,13,7,6
108977,20,234,55,179,115,28,87,119,27,92
109040,20,1969,447,1522,1969,447,1522,,,
109208,20,27422,14210,13212,4334,2005,2329,23088,12205,10883
109350,20,11840,5184,6656,3491,1654,1837,8349,3530,4819
109651,20,2135,898,1237,1849,768,1081,286,130,156
109721,20,202,49,153,202,49,153,,,
109730,20,94,50,44,94,50,44,,,
109785,20,3348,1068,2280,2943,937,2006,405,131,274
109819,20,26873,11728,15145,7244,3039,4205,19629,8689,10940
109907,20,2884,977,1907,1119,353,766,1765,624,1141
109934,20,398,39,359,398,39,359,,,
110060,20,181,141,40,158,127,31,23,14,9
110097,20,3499,1372,2127,3169,1247,1922,330,125,205
110194,20,264,264,0,264,264,0,,,
110219,20,1767,365,1402,1767,365,1402,,,
110246,20,9362,4172,5190,4091,1904,2187,5271,2268,3003
110316,20,87,21,66,79,20,59,8,1,7
110334,20,9149,4001,5148,1786,829,957,7363,3172,4191
110361,20,8334,3057,5277,7232,2675,4557,1102,382,720
110370,20,1145,429,716,1086,398,688,59,31,28
110404,20,982,537,445,982,537,445,,,
110413,20,2513,1159,1354,2461,1139,1322,52,20,32
110422,20,21026,10769,10257,19990,10145,9845,1036,624,412
110468,20,274,93,181,,,,274,93,181
110486,20,8188,2773,5415,6630,2230,4400,1558,543,1015
110495,20,8926,2977,5949,6958,2273,4685,1968,704,1264
110510,20,17034,6485,10549,13495,5089,8406,3539,1396,2143
110529,20,25181,13707,11474,21491,11628,9863,3690,2079,1611
110538,20,12981,5939,7042,11584,5295,6289,1397,644,753
110547,20,13969,5437,8532,10396,4052,6344,3573,1385,2188
110556,20,21354,8696,12658,17563,7010,10553,3791,1686,2105
110565,20,35432,14920,20512,27822,11554,16268,7610,3366,4244
110574,20,10796,4369,6427,8165,3312,4853,2631,1057,1574
110583,20,32931,13772,19159,27710,11319,16391,5221,2453,2768
110592,20,22737,9516,13221,18694,7707,10987,4043,1809,2234
110608,20,32181,14710,17471,26188,11714,14474,5993,2996,2997
110617,20,28921,12647,16274,22598,9637,12961,6323,3010,3313
110635,20,32479,14435,18044,30824,13636,17188,1655,799,856
110644,20,31532,12699,18833,30673,12313,18360,859,386,473
110653,20,28662,12584,16078,27932,12213,15719,730,371,359
110662,20,32423,12853,19570,31763,12533,19230,660,320,340
110671,20,22911,11064,11847,21969,10542,11427,942,522,420
110680,20,33096,15764,17332,32138,15217,16921,958,547,411
110705,20,23459,10360,13099,22793,10006,12787,666,354,312
110714,20,17502,8778,8724,16728,8327,8401,774,451,323
110778,20,11,1,10,10,1,9,1,0,1
110875,20,55,1,54,55,1,54,,,
110918,20,13,7,6,3,1,2,10,6,4
111045,20,39,15,24,38,15,23,1,0,1
111054,20,144,28,116,144,28,116,,,
111081,20,940,365,575,923,353,570,17,12,5
111188,20,808,645,163,779,623,156,29,22,7
111434,20,5388,2229,3159,747,381,366,4641,1848,2793
111461,20,18075,10118,7957,4802,2415,2387,13273,7703,5570
111513,20,205,3,202,162,1,161,43,2,41
111638,20,415,154,261,415,154,261,,,
111708,20,196,167,29,196,167,29,,,
111717,20,183,146,37,181,146,35,2,0,2
111726,20,148,114,34,148,114,34,,,
111744,20,96,92,4,96,92,4,,,
111762,20,103,58,45,103,58,45,,,
111799,20,157,26,131,157,26,131,,,
111887,20,19469,9181,10288,7838,3627,4211,11631,5554,6077
111896,20,4919,2097,2822,736,351,385,4183,1746,2437
111920,20,10736,5375,5361,2809,1370,1439,7927,4005,3922
111939,20,19238,7552,11686,5647,2401,3246,13591,5151,8440
111948,20,7869,3153,4716,7334,2899,4435,535,254,281
111966,20,246,88,158,185,67,118,61,21,40
112075,20,1699,679,1020,1474,583,891,225,96,129
112084,20,328,154,174,254,130,124,74,24,50
112172,20,9975,4413,5562,3913,1777,2136,6062,2636,3426
112181,20,143,2,141,143,2,141,,,
112190,20,16134,7388,8746,4680,2483,2197,11454,4905,6549
112260,20,1386,678,708,1380,673,707,6,5,1
112288,20,489,20,469,489,20,469,,,
112367,20,210,34,176,28,7,21,182,27,155
112385,20,8077,4452,3625,610,271,339,7467,4181,3286
112394,20,379,277,102,300,220,80,79,57,22
112455,20,111,27,84,111,27,84,,,
112561,20,2349,1016,1333,834,393,441,1515,623,892
112570,20,291,169,122,196,117,79,95,52,43
112686,20,4082,1487,2595,740,302,438,3342,1185,2157
112826,20,5832,2329,3503,1384,662,722,4448,1667,2781
113096,20,13294,5672,7622,3006,1437,1569,10288,4235,6053
113111,20,5113,2300,2813,1478,682,796,3635,1618,2017
113193,20,9908,4876,5032,2758,1397,1361,7150,3479,3671
113218,20,8043,3528,4515,1558,772,786,6485,2756,3729
113236,20,13523,5846,7677,4729,2128,2601,8794,3718,5076
113333,20,16335,8276,8059,7923,4313,3610,8412,3963,4449
113449,20,186,53,133,186,53,133,,,
113537,20,8,1,7,8,1,7,,,
113573,20,10382,4367,6015,3864,1764,2100,6518,2603,3915
113582,20,90,8,82,71,7,64,19,1,18
113634,20,16097,7859,8238,5866,3075,2791,10231,4784,5447
113698,20,1139,316,823,1016,279,737,123,37,86
113856,20,27855,13628,14227,5098,2298,2800,22757,11330,11427
113980,20,19944,9430,10514,7034,3482,3552,12910,5948,6962
114266,20,7952,3578,4374,1925,914,1011,6027,2664,3363
114354,20,1780,317,1463,1365,232,1133,415,85,330
114433,20,1383,813,570,464,240,224,919,573,346
114460,20,293,38,255,199,23,176,94,15,79
114637,20,78,6,72,78,6,72,,,
114716,20,12434,6609,5825,3364,1652,1712,9070,4957,4113
114761,20,72,9,63,72,9,63,,,
114789,20,22609,10228,12381,5790,2547,3243,16819,7681,9138
114813,20,1744,481,1263,910,300,610,834,181,653
114859,20,18370,8571,9799,6633,3300,3333,11737,5271,6466
114938,20,4561,2151,2410,1399,652,747,3162,1499,1663
114947,20,154,70,84,154,70,84,,,
115001,20,10658,4798,5860,5077,2389,2688,5581,2409,3172
115010,20,661,160,501,661,160,501,,,
115083,20,601,418,183,416,324,92,185,94,91
115126,20,10053,4593,5460,2869,1397,1472,7184,3196,3988
115296,20,12862,5313,7549,3869,1726,2143,8993,3587,5406
115357,20,171,51,120,89,33,56,82,18,64
115393,20,8892,4107,4785,3202,1461,1741,5690,2646,3044
115409,20,922,470,452,906,458,448,16,12,4
115658,20,102,8,94,38,4,34,64,4,60
115728,20,564,204,360,474,175,299,90,29,61
115755,20,5461,2330,3131,4669,1987,2682,792,343,449
115773,20,159,28,131,71,16,55,88,12,76
115861,20,7747,3376,4371,3538,1531,2007,4209,1845,2364
115931,20,614,494,120,614,494,120,,,
116226,20,96,6,90,37,4,33,59,2,57
116350,20,116,11,105,115,11,104,1,0,1
116439,20,10464,5345,5119,3692,2068,1624,6772,3277,3495
116563,20,187,7,180,187,7,180,,,
116846,20,42,16,26,14,1,13,28,15,13
117052,20,7086,3292,3794,1815,990,825,5271,2302,2969
117104,20,397,183,214,344,155,189,53,28,25
117140,20,3365,1327,2038,2786,1096,1690,579,231,348
117168,20,729,187,542,647,163,484,82,24,58
117195,20,2519,1530,989,548,264,284,1971,1266,705
117238,20,66,11,55,66,11,55,,,
117247,20,9653,4299,5354,1571,789,782,8082,3510,4572
117274,20,1694,1198,496,373,200,173,1321,998,323
117283,20,45,20,25,27,11,16,18,9,9
117557,20,177,130,47,171,125,46,6,5,1
117575,20,31,20,11,3,1,2,28,19,9
117627,20,1263,518,745,1167,479,688,96,39,57
117636,20,1015,261,754,783,207,576,232,54,178
117645,20,22402,9717,12685,8712,3830,4882,13690,5887,7803
117672,20,477,112,365,101,14,87,376,98,278
117690,20,7384,2869,4515,1475,635,840,5909,2234,3675
117706,20,15372,6783,8589,4219,1962,2257,11153,4821,6332
117715,20,4913,1562,3351,542,204,338,4371,1358,3013
117724,20,10377,5834,4543,2226,1399,827,8151,4435,3716
117733,20,15037,6413,8624,2887,1353,1534,12150,5060,7090
117751,20,1765,917,848,1138,538,600,627,379,248
117788,20,13199,5604,7595,2687,1234,1453,10512,4370,6142
117803,20,195,52,143,,,,195,52,143
117867,20,9283,3655,5628,1597,687,910,7686,2968,4718
117894,20,7791,3365,4426,2565,1176,1389,5226,2189,3037
117946,20,7299,3438,3861,7117,3331,3786,182,107,75
117955,20,263,59,204,198,41,157,65,18,47
118134,20,90,4,86,32,4,28,58,0,58
118143,20,88,3,85,21,2,19,67,1,66
118161,20,117,4,113,117,4,113,,,
118198,20,952,178,774,952,178,774,,,
118347,20,4283,1841,2442,1176,602,574,3107,1239,1868
118684,20,3554,1305,2249,682,261,421,2872,1044,1828
118693,20,800,449,351,776,437,339,24,12,12
118718,20,10214,4036,6178,4316,1754,2562,5898,2282,3616
118772,20,6514,2427,4087,1017,434,583,5497,1993,3504
118912,20,10860,4502,6358,3920,1790,2130,6940,2712,4228
118930,20,5747,2529,3218,1313,651,662,4434,1878,2556
118958,20,63,25,38,24,8,16,39,17,22
118976,20,16224,6240,9984,7632,3125,4507,8592,3115,5477
118994,20,398,232,166,398,232,166,,,
119058,20,18,6,12,16,6,10,2,0,2
119067,20,6514,2879,3635,2051,974,1077,4463,1905,2558
119137,20,12484,5803,6681,4229,2122,2107,8255,3681,4574
119164,20,26256,12327,13929,8903,4504,4399,17353,7823,9530
119173,20,1797,130,1667,1550,101,1449,247,29,218
119216,20,15153,5918,9235,5522,2341,3181,9631,3577,6054
119270,20,832,626,206,582,442,140,250,184,66
119331,20,4041,1685,2356,1442,644,798,2599,1041,1558
119553,20,1198,329,869,1180,326,854,18,3,15
119605,20,8485,3956,4529,4353,2021,2332,4132,1935,2197
119775,20,229,132,97,199,112,87,30,20,10
119951,20,193,15,178,193,15,178,,,
120069,20,333,54,279,333,54,279,,,
120078,20,625,102,523,625,102,523,,,
120087,20,231,36,195,231,36,195,,,
120166,20,24,16,8,24,16,8,,,
120254,20,1942,798,1144,1913,782,1131,29,16,13
120290,20,8358,4264,4094,2671,1368,1303,5687,2896,2791
120342,20,16614,8351,8263,6500,3474,3026,10114,4877,5237
120403,20,1268,381,887,1236,369,867,32,12,20
120421,20,6339,2870,3469,1580,731,849,4759,2139,2620
120537,20,590,256,334,503,215,288,87,41,46
120661,20,730,179,551,674,170,504,56,9,47
120698,20,32,3,29,29,3,26,3,0,3
120768,20,398,30,368,,,,398,30,368
120838,20,13,5,8,13,5,8,,,
120865,20,848,314,534,677,257,420,171,57,114
120883,20,3294,1521,1773,3202,1482,1720,92,39,53
120953,20,4639,4009,630,526,374,152,4113,3635,478
120971,20,17655,9384,8271,5541,2868,2673,12114,6516,5598
121044,20,21923,10051,11872,7717,3818,3899,14206,6233,7973
121150,20,3662,1522,2140,3451,1437,2014,211,85,126
121257,20,1212,496,716,1179,484,695,33,12,21
121275,20,69,46,23,69,46,23,,,
121309,20,3154,1098,2056,2729,967,1762,425,131,294
121345,20,1716,778,938,1706,772,934,10,6,4
121363,20,4113,1503,2610,1359,567,792,2754,936,1818
121433,20,119,6,113,118,6,112,1,0,1
121619,20,23852,13558,10294,3863,1930,1933,19989,11628,8361
121637,20,119,10,109,113,10,103,6,0,6
121691,20,2313,944,1369,2054,823,1231,259,121,138
121707,20,4006,1930,2076,1204,612,592,2802,1318,1484
121859,20,253,29,224,142,28,114,111,1,110
121868,20,236,2,234,126,0,126,110,2,108
121886,20,16139,9303,6836,3927,1987,1940,12212,7316,4896
121901,20,19147,7782,11365,5014,2202,2812,14133,5580,8553
122117,20,2,1,1,2,1,1,,,
122180,20,17719,7058,10661,4034,1693,2341,13685,5365,8320
122205,20,16660,7424,9236,5104,2601,2503,11556,4823,6733
122296,20,704,145,559,587,129,458,117,16,101
122339,20,12144,5402,6742,1690,766,924,10454,4636,5818
122375,20,18076,7977,10099,3585,1707,1878,14491,6270,8221
122384,20,13062,7009,6053,1837,1174,663,11225,5835,5390
122409,20,32194,13815,18379,28634,12073,16561,3560,1742,1818
122436,20,5669,2481,3188,5512,2404,3108,157,77,80
122506,20,221,135,86,221,135,86,,,
122597,20,21961,9749,12212,17379,7574,9805,4582,2175,2407
122612,20,6018,2136,3882,5808,2044,3764,210,92,118
122658,20,16168,6509,9659,6988,3060,3928,9180,3449,5731
122685,20,2265,567,1698,2265,567,1698,,,
122694,20,831,267,564,831,267,564,,,
122728,20,1169,483,686,900,375,525,269,108,161
122746,20,7561,3140,4421,1595,697,898,5966,2443,3523
122755,20,26863,13999,12864,21626,11219,10407,5237,2780,2457
122791,20,7512,3686,3826,1816,975,841,5696,2711,2985
122889,20,12675,5606,7069,5778,2643,3135,6897,2963,3934
122931,20,6115,3160,2955,5998,3084,2914,117,76,41
122977,20,22375,9905,12470,8852,4146,4706,13523,5759,7764
123013,20,15552,6973,8579,4296,2076,2220,11256,4897,6359
123165,20,1080,1,1079,1075,0,1075,5,1,4
123217,20,13170,5514,7656,4903,2221,2682,8267,3293,4974
123280,20,24,11,13,8,3,5,16,8,8
123299,20,7363,2909,4454,2780,1075,1705,4583,1834,2749
123341,20,15766,7123,8643,5571,2668,2903,10195,4455,5740
123350,20,157,48,109,120,35,85,37,13,24
123457,20,729,294,435,643,255,388,86,39,47
123484,20,1204,611,593,516,304,212,688,307,381
123493,20,98,29,69,98,29,69,,,
123509,20,8523,4052,4471,1713,877,836,6810,3175,3635
123527,20,10767,4208,6559,2498,964,1534,8269,3244,5025
123554,20,2003,874,1129,1916,842,1074,87,32,55
123563,20,8426,3677,4749,2439,1015,1424,5987,2662,3325
123572,20,5934,2251,3683,5068,1876,3192,866,375,491
123642,20,237,19,218,147,13,134,90,6,84
123651,20,2001,665,1336,1830,612,1218,171,53,118
123679,20,803,220,583,694,202,492,109,18,91
123800,20,16530,7408,9122,6432,2886,3546,10098,4522,5576
123952,20,250,150,100,228,137,91,22,13,9
123961,20,20699,9916,10783,20185,9622,10563,514,294,220
124113,20,4508,2381,2127,840,274,566,3668,2107,1561
124292,20,516,250,266,516,250,266,,,
124487,20,75,31,44,11,5,6,64,26,38
124681,20,1173,477,696,1173,477,696,,,
124706,20,825,173,652,825,173,652,,,
124937,20,676,224,452,585,210,375,91,14,77
125028,20,10559,4548,6011,3183,1485,1698,7376,3063,4313
125082,20,86,12,74,83,10,73,3,2,1
125091,20,12648,5002,7646,3783,1580,2203,8865,3422,5443
125170,20,6122,2659,3463,980,467,513,5142,2192,2950
125231,20,6298,967,5331,1528,193,1335,4770,774,3996
125310,20,42,13,29,42,13,29,,,
125462,20,3061,1396,1665,494,250,244,2567,1146,1421
125471,20,8656,3534,5122,1496,662,834,7160,2872,4288
125499,20,6513,2893,3620,2003,956,1047,4510,1937,2573
125532,20,1837,195,1642,1837,195,1642,,,
125727,20,1284,499,785,1272,492,780,12,7,5
125763,20,1131,502,629,1097,488,609,34,14,20
125897,20,868,410,458,798,375,423,70,35,35
126076,20,142,142,0,142,142,0,,,
126119,20,5401,2087,3314,1302,556,746,4099,1531,2568
126182,20,1588,838,750,1075,589,486,513,249,264
126207,20,7178,3282,3896,1872,917,955,5306,2365,2941
126289,20,12636,5544,7092,2278,992,1286,10358,4552,5806
126359,20,205,19,186,205,19,186,,,
126562,20,14055,6071,7984,8387,3668,4719,5668,2403,3265
126580,20,9540,4381,5159,7249,3350,3899,2291,1031,1260
126605,20,284,252,32,284,252,32,,,
126614,20,31034,16737,14297,28728,15386,13342,2306,1351,955
126669,20,7602,2517,5085,2015,713,1302,5587,1804,3783
126678,20,2180,969,1211,2143,952,1191,37,17,20
126687,20,731,131,600,731,131,600,,,
126711,20,5184,2187,2997,1441,706,735,3743,1481,2262
126748,20,1179,479,700,414,167,247,765,312,453
126775,20,5714,3892,1822,5442,3708,1734,272,184,88
126784,20,130,127,3,130,127,3,,,
126818,20,25777,11698,14079,22245,10033,12212,3532,1665,1867
126827,20,22393,7472,14921,13556,4598,8958,8837,2874,5963
126863,20,8343,3484,4859,1268,624,644,7075,2860,4215
126915,20,261,78,183,91,32,59,170,46,124
126942,20,7292,2755,4537,1748,659,1089,5544,2096,3448
126951,20,1155,1042,113,1155,1042,113,,,
127060,20,6151,2728,3423,5666,2508,3158,485,220,265
127158,20,5313,4671,642,1178,921,257,4135,3750,385
127185,20,3308,1498,1810,2877,1322,1555,431,176,255
127200,20,19449,8575,10874,4083,1975,2108,15366,6600,8766
127316,20,313,50,263,91,23,68,222,27,195
127389,20,668,295,373,352,162,190,316,133,183
127556,20,8681,4092,4589,6497,3027,3470,2184,1065,1119
127565,20,15848,7032,8816,9340,4241,5099,6508,2791,3717
127617,20,1462,531,931,328,113,215,1134,418,716
127653,20,343,101,242,306,84,222,37,17,20
127714,20,566,279,287,20,6,14,546,273,273
127732,20,1446,514,932,666,315,351,780,199,581
127741,20,6728,2268,4460,5377,1811,3566,1351,457,894
127778,20,999,434,565,483,227,256,516,207,309
127820,20,11899,4858,7041,4031,1781,2250,7868,3077,4791
127884,20,6481,2613,3868,1609,702,907,4872,1911,2961
127909,20,6375,3021,3354,1803,986,817,4572,2035,2537
127918,20,2398,809,1589,1790,587,1203,608,222,386
127945,20,2050,534,1516,1138,306,832,912,228,684
127954,20,11,0,11,11,0,11,,,
128106,20,4772,2196,2576,2518,1160,1358,2254,1036,1218
128151,20,960,504,456,928,499,429,32,5,27
128179,20,691,490,201,691,490,201,,,
128188,20,1105,407,698,1105,407,698,,,
128258,20,1505,702,803,601,316,285,904,386,518
128328,20,4085,2882,1203,4085,2882,1203,,,
128337,20,81,1,80,49,1,48,32,0,32
128391,20,3095,1581,1514,1582,924,658,1513,657,856
128498,20,987,409,578,875,367,508,112,42,70
128577,20,1264,606,658,454,256,198,810,350,460
128586,20,60,60,0,60,60,0,,,
128744,20,1637,496,1141,1339,432,907,298,64,234
128771,20,7665,4186,3479,6080,3340,2740,1585,846,739
128780,20,1501,359,1142,399,88,311,1102,271,831
128896,20,202,18,184,202,18,184,,,
128902,20,1948,749,1199,1915,737,1178,33,12,21
129002,20,426,255,171,402,248,154,24,7,17
129020,20,18983,8952,10031,18397,8619,9778,586,333,253
129154,20,3031,465,2566,325,111,214,2706,354,2352
129181,20,973,892,81,855,790,65,118,102,16
129215,20,3926,1609,2317,3285,1345,1940,641,264,377
129242,20,4757,2016,2741,4655,1954,2701,102,62,40
129349,20,161,5,156,125,5,120,36,0,36
129367,20,2395,667,1728,605,204,401,1790,463,1327
129482,20,369,25,344,369,25,344,,,
129525,20,3969,1739,2230,3680,1623,2057,289,116,173
129534,20,271,131,140,95,49,46,176,82,94
129543,20,3364,1295,2069,1146,488,658,2218,807,1411
129695,20,4164,1813,2351,1455,692,763,2709,1121,1588
129729,20,4554,1815,2739,1598,741,857,2956,1074,1882
129756,20,1880,758,1122,730,345,385,1150,413,737
129774,20,539,288,251,465,247,218,74,41,33
129808,20,2937,1060,1877,1058,474,584,1879,586,1293
129923,20,638,287,351,441,180,261,197,107,90
129932,20,314,274,40,256,218,38,58,56,2
129941,20,4817,2090,2727,4484,1907,2577,333,183,150
130004,20,4069,1691,2378,1338,628,710,2731,1063,1668
130040,20,1149,411,738,445,188,257,704,223,481
130110,20,217,74,143,149,52,97,68,22,46
130174,20,2146,1233,913,1546,909,637,600,324,276
130183,20,14682,3891,10791,6048,1540,4508,8634,2351,6283
130217,20,1195,468,727,418,185,233,777,283,494
130226,20,6073,2340,3733,5847,2240,3607,226,100,126
130253,20,6782,2245,4537,6277,2091,4186,505,154,351
130314,20,831,221,610,787,212,575,44,9,35
130396,20,5578,2108,3470,1670,742,928,3908,1366,2542
130493,20,6920,2646,4274,5331,2078,3253,1589,568,1021
130590,20,2167,1059,1108,2128,1038,1090,39,21,18
130606,20,3267,1414,1853,1321,593,728,1946,821,1125
130624,20,1037,609,428,1037,609,428,,,
130697,20,3069,1420,1649,3006,1388,1618,63,32,31
130776,20,3799,1844,1955,3165,1543,1622,634,301,333
130794,20,6645,3254,3391,6594,3220,3374,51,34,17
130837,20,51,3,48,51,3,48,,,
130873,20,308,102,206,308,102,206,,,
130907,20,11726,3776,7950,3878,1601,2277,7848,2175,5673
130934,20,4996,1734,3262,4041,1345,2696,955,389,566
130943,20,19482,8084,11398,18034,7383,10651,1448,701,747
130989,20,620,308,312,534,274,260,86,34,52
131061,20,185,10,175,103,9,94,82,1,81
131113,20,9091,3504,5587,2756,1159,1597,6335,2345,3990
131159,20,7917,2875,5042,7600,2736,4864,317,139,178
131283,20,3011,1296,1715,2789,1225,1564,222,71,151
131399,20,3057,1089,1968,1244,561,683,1813,528,1285
131450,20,914,436,478,852,409,443,62,27,35
131469,20,11482,4176,7306,10332,3811,6521,1150,365,785
131496,20,7900,3519,4381,7187,3007,4180,713,512,201
131520,20,9809,2758,7051,9022,2449,6573,787,309,478
131803,20,315,73,242,25,12,13,290,61,229
131830,20,18,8,10,18,8,10,,,
131876,20,1561,97,1464,952,27,925,609,70,539
132374,20,2832,2350,482,2832,2350,482,,,
132408,20,385,193,192,183,79,104,202,114,88
132471,20,3122,1154,1968,2259,802,1457,863,352,511
132602,20,2628,971,1657,2527,936,1591,101,35,66
132657,20,2792,1364,1428,2617,1283,1334,175,81,94
132675,20,45,30,15,39,24,15,6,6,0
132693,20,13114,5309,7805,4023,1831,2192,9091,3478,5613
132709,20,30057,12049,18008,9220,4079,5141,20837,7970,12867
132842,20,217,35,182,99,13,86,118,22,96
132851,20,5483,2010,3473,2251,885,1366,3232,1125,2107
132879,20,155,99,56,146,92,54,9,7,2
132903,20,58662,26508,32154,41098,18526,22572,17564,7982,9582
132976,20,481,239,242,481,239,242,,,
133021,20,1826,702,1124,725,312,413,1101,390,711
133155,20,675,309,366,374,210,164,301,99,202
133386,20,11584,4506,7078,4425,2011,2414,7159,2495,4664
133465,20,303,61,242,241,45,196,62,16,46
133492,20,1993,599,1394,1934,574,1360,59,25,34
133508,20,14326,5121,9205,5516,2114,3402,8810,3007,5803
133526,20,1142,607,535,1054,566,488,88,41,47
133553,20,9533,6989,2544,6838,5092,1746,2695,1897,798
133650,20,7709,2590,5119,6640,2239,4401,1069,351,718
133669,20,24191,10223,13968,16166,6771,9395,8025,3452,4573
133702,20,20363,7338,13025,5813,2315,3498,14550,5023,9527
133711,20,2607,822,1785,2537,797,1740,70,25,45
133809,20,622,293,329,542,257,285,80,36,44
133845,20,598,58,540,558,57,501,40,1,39
133854,20,317,68,249,317,68,249,,,
133863,20,473,66,407,473,66,407,,,
133872,20,1110,208,902,372,70,302,738,138,600
133881,20,3364,2272,1092,2967,2007,960,397,265,132
133951,20,45688,19959,25729,26106,11108,14998,19582,8851,10731
133960,20,920,409,511,398,222,176,522,187,335
133979,20,1098,503,595,1030,459,571,68,44,24
133997,20,332,108,224,332,108,224,,,
134024,20,55,11,44,55,11,44,,,
134079,20,2721,1015,1706,2620,974,1646,101,41,60
134097,20,32936,14100,18836,29579,12477,17102,3357,1623,1734
134130,20,34552,15106,19446,31017,13307,17710,3535,1799,1736
134228,20,31,11,20,27,10,17,4,1,3
134237,20,25532,17639,7893,25532,17639,7893,,,
134291,20,663,533,130,550,440,110,113,93,20
134307,20,893,833,60,216,208,8,677,625,52
134343,20,4694,1670,3024,1817,700,1117,2877,970,1907
134422,20,23,0,23,13,0,13,10,0,10
134495,20,19504,8171,11333,9062,4264,4798,10442,3907,6535
134510,20,165,84,81,78,36,42,87,48,39
134529,20,299,31,268,299,31,268,,,
134574,20,158,33,125,158,33,125,,,
134608,20,14862,5968,8894,5382,2445,2937,9480,3523,5957
134714,20,396,62,334,145,31,114,251,31,220
134811,20,866,258,608,584,163,421,282,95,187
134945,20,2563,974,1589,2336,907,1429,227,67,160
135081,20,16960,4842,12118,9812,3067,6745,7148,1775,5373
135142,20,238,2,236,39,0,39,199,2,197
135160,20,2706,881,1825,906,286,620,1800,595,1205
135179,20,744,431,313,451,268,183,293,163,130
135188,20,4460,1694,2766,1506,588,918,2954,1106,1848
135267,20,562,421,141,556,419,137,6,2,4
135276,20,1430,791,639,777,369,408,653,422,231
135294,20,476,239,237,361,230,131,115,9,106
135337,20,103,9,94,30,7,23,73,2,71
135364,20,212,147,65,25,19,6,187,128,59
135391,20,8588,3179,5409,3587,1474,2113,5001,1705,3296
135407,20,1054,608,446,1024,587,437,30,21,9
135522,20,337,182,155,337,182,155,,,
135559,20,63,9,54,36,7,29,27,2,25
135610,20,67,32,35,33,14,19,34,18,16
135647,20,850,727,123,596,526,70,254,201,53
135717,20,47245,19732,27513,19071,8238,10833,28174,11494,16680
135726,20,12504,5798,6706,12004,5579,6425,500,219,281
135735,20,2310,1805,505,372,325,47,1938,1480,458
136109,20,124,1,123,68,1,67,56,0,56
136145,20,1127,330,797,373,104,269,754,226,528
136172,20,14171,6042,8129,10787,4541,6246,3384,1501,1883
136215,20,6971,1948,5023,6223,1794,4429,748,154,594
136233,20,4898,1938,2960,2081,868,1213,2817,1070,1747
136303,20,142,28,114,107,26,81,35,2,33
136330,20,3027,1109,1918,2287,786,1501,740,323,417
136358,20,24223,9681,14542,7449,3449,4000,16774,6232,10542
136400,20,9202,3550,5652,3263,1323,1940,5939,2227,3712
136473,20,7981,2855,5126,3051,1145,1906,4930,1710,3220
136491,20,645,386,259,517,355,162,128,31,97
136516,20,8180,2811,5369,3023,1088,1935,5157,1723,3434
136659,20,425,337,88,201,154,47,224,183,41
136765,20,403,202,201,343,172,171,60,30,30
136774,20,1705,464,1241,1681,458,1223,24,6,18
136826,20,805,498,307,505,308,197,300,190,110
136950,20,2583,1042,1541,2496,1006,1490,87,36,51
137023,20,373,168,205,367,164,203,6,4,2
137032,20,7320,2853,4467,3945,1480,2465,3375,1373,2002
137078,20,23501,9000,14501,7284,3167,4117,16217,5833,10384
137087,20,646,367,279,606,362,244,40,5,35
137096,20,12729,5797,6932,5359,2705,2654,7370,3092,4278
137120,20,1138,717,421,531,335,196,607,382,225
137209,20,14323,6179,8144,4674,2272,2402,9649,3907,5742
137245,20,1475,724,751,1475,724,751,,,
137272,20,42,40,2,42,40,2,,,
137281,20,6434,2365,4069,1631,672,959,4803,1693,3110
137315,20,2892,980,1912,1114,440,674,1778,540,1238
137351,20,38047,16478,21569,30097,12878,17219,7950,3600,4350
137476,20,3950,1782,2168,1733,943,790,2217,839,1378
137546,20,2561,1114,1447,2485,1066,1419,76,48,28
137564,20,8840,3538,5302,4364,1698,2666,4476,1840,2636
137591,20,244,52,192,181,44,137,63,8,55
137713,20,187,71,116,151,62,89,36,9,27
137759,20,11266,4881,6385,6084,2867,3217,5182,2014,3168
137777,20,33,33,0,33,33,0,,,
137801,20,211,108,103,211,108,103,,,
137847,20,9602,3982,5620,9356,3869,5487,246,113,133
137856,20,227,127,100,134,80,54,93,47,46
137865,20,424,254,170,401,232,169,23,22,1
137953,20,340,188,152,214,130,84,126,58,68
137962,20,181,97,84,146,83,63,35,14,21
138187,20,43370,17731,25639,16112,7070,9042,27258,10661,16597
138275,20,761,402,359,692,367,325,69,35,34
138284,20,306,153,153,280,132,148,26,21,5
138293,20,1100,774,326,894,634,260,206,140,66
138309,20,7937,1084,6853,3997,568,3429,3940,516,3424
138354,20,9291,3820,5471,6273,2671,3602,3018,1149,1869
138372,20,1569,986,583,251,73,178,1318,913,405
138479,20,811,512,299,811,512,299,,,
138488,20,2132,1204,928,178,41,137,1954,1163,791
138497,20,383,245,138,383,245,138,,,
138558,20,3647,1459,2188,2377,1092,1285,1270,367,903
138600,20,1006,16,990,990,14,976,16,2,14
138655,20,543,359,184,512,341,171,31,18,13
138664,20,93,34,59,93,34,59,,,
138682,20,2577,759,1818,884,266,618,1693,493,1200
138716,20,5812,1522,4290,4195,1193,3002,1617,329,1288
138761,20,247,100,147,186,95,91,61,5,56
138813,20,457,206,251,283,133,150,174,73,101
138822,20,593,18,575,593,18,575,,,
138840,20,3125,1110,2015,940,440,500,2185,670,1515
138868,20,1943,927,1016,822,438,384,1121,489,632
138901,20,1435,498,937,565,196,369,870,302,568
138938,20,333,25,308,194,8,186,139,17,122
138947,20,3427,807,2620,3257,747,2510,170,60,110
138956,20,3970,1631,2339,1364,584,780,2606,1047,1559
139144,20,2243,825,1418,2221,817,1404,22,8,14
139153,20,143,77,66,78,44,34,65,33,32
139199,20,1368,127,1241,854,53,801,514,74,440
139205,20,911,527,384,576,344,232,335,183,152
139250,20,3147,960,2187,1818,552,1266,1329,408,921
139278,20,6140,2068,4072,1657,640,1017,4483,1428,3055
139311,20,5283,1644,3639,3023,938,2085,2260,706,1554
139357,20,3134,948,2186,855,281,574,2279,667,1612
139366,20,6003,2503,3500,4175,1641,2534,1828,862,966
139384,20,6141,2303,3838,1488,610,878,4653,1693,2960
139393,20,847,398,449,798,376,422,49,22,27
139463,20,4527,1757,2770,2768,1085,1683,1759,672,1087
139506,20,58,31,27,58,31,27,,,
139579,20,195,49,146,161,40,121,34,9,25
139621,20,1873,839,1034,1145,541,604,728,298,430
139630,20,840,457,383,705,403,302,135,54,81
139658,20,7101,3047,4054,7022,3011,4011,79,36,43
139700,20,4768,1709,3059,1965,800,1165,2803,909,1894
139719,20,2360,843,1517,2081,752,1329,279,91,188
139746,20,61,12,49,61,12,49,,,
139755,20,18415,11178,7237,16207,9757,6450,2208,1421,787
139764,20,2473,887,1586,1585,563,1022,888,324,564
139861,20,5265,1863,3402,4783,1674,3109,482,189,293
139931,20,21979,9347,12632,17907,7644,10263,4072,1703,2369
139940,20,28924,11671,17253,21604,8716,12888,7320,2955,4365
139959,20,30714,12883,17831,28823,11967,16856,1891,916,975
139968,20,3135,1111,2024,1732,663,1069,1403,448,955
139986,20,5018,1442,3576,1237,372,865,3781,1070,2711
139995,20,479,180,299,288,109,179,191,71,120
140003,20,130,15,115,59,5,54,71,10,61
140012,20,8450,3513,4937,1726,897,829,6724,2616,4108
140234,20,607,346,261,589,341,248,18,5,13
140243,20,5599,2207,3392,1237,511,726,4362,1696,2666
140252,20,915,463,452,766,410,356,149,53,96
140331,20,9017,3869,5148,2716,1309,1407,6301,2560,3741
140340,20,615,94,521,310,60,250,305,34,271
140447,20,4859,1680,3179,4129,1526,2603,730,154,576
140553,20,2567,2565,2,2185,2185,0,382,380,2
140571,20,253,112,141,168,70,98,85,42,43
140678,20,2449,986,1463,830,400,430,1619,586,1033
140696,20,1491,557,934,1410,526,884,81,31,50
140720,20,310,132,178,273,121,152,37,11,26
140818,20,1245,382,863,1135,359,776,110,23,87
140827,20,67,18,49,67,18,49,,,
140872,20,1059,544,515,954,507,447,105,37,68
140942,20,3642,1319,2323,1224,545,679,2418,774,1644
140951,20,13582,4082,9500,11494,3430,8064,2088,652,1436
140960,20,2740,1037,1703,2326,899,1427,414,138,276
140988,20,1373,606,767,1063,497,566,310,109,201
141006,20,1799,833,966,764,415,349,1035,418,617
141015,20,37,16,21,36,15,21,1,1,0
141060,20,3102,168,2934,2326,0,2326,776,168,608
141167,20,793,375,418,506,252,254,287,123,164
141185,20,2008,762,1246,878,342,536,1130,420,710
141237,20,2683,1232,1451,827,391,436,1856,841,1015
141255,20,4003,1423,2580,804,242,562,3199,1181,2018
141264,20,7573,2524,5049,5710,1918,3792,1863,606,1257
141325,20,614,38,576,420,0,420,194,38,156
141334,20,8666,3074,5592,6280,2275,4005,2386,799,1587
141361,20,1496,578,918,878,383,495,618,195,423
141486,20,1583,447,1136,1310,364,946,273,83,190
141565,20,2593,913,1680,1834,666,1168,759,247,512
141574,20,14198,5616,8582,11536,4468,7068,2662,1148,1514
141608,20,52,37,15,52,37,15,,,
141644,20,4151,1472,2679,2662,816,1846,1489,656,833
141680,20,3069,1626,1443,820,567,253,2249,1059,1190
141796,20,5828,1967,3861,1535,601,934,4293,1366,2927
141802,20,1308,471,837,237,114,123,1071,357,714
141811,20,6221,2325,3896,1689,767,922,4532,1558,2974
141839,20,2472,833,1639,609,238,371,1863,595,1268
141981,20,2913,978,1935,1503,531,972,1410,447,963
141990,20,2384,848,1536,501,166,335,1883,682,1201
142054,20,403,56,347,403,56,347,,,
142090,20,96,54,42,80,45,35,16,9,7
142115,20,22922,9946,12976,13433,5823,7610,9489,4123,5366
142179,20,2333,927,1406,620,281,339,1713,646,1067
142276,20,10017,4061,5956,5387,2154,3233,4630,1907,2723
142285,20,8809,4328,4481,6643,3313,3330,2166,1015,1151
142294,20,1052,521,531,1044,516,528,8,5,3
142328,20,3744,1379,2365,2034,774,1260,1710,605,1105
142407,20,87,12,75,87,12,75,,,
142443,20,4296,1655,2641,1616,718,898,2680,937,1743
142461,20,1140,498,642,1008,452,556,132,46,86
142489,20,60,8,52,60,8,52,,,
142522,20,43023,18805,24218,16574,7757,8817,26449,11048,15401
142559,20,8096,3089,5007,1864,767,1097,6232,2322,3910
142832,20,9,9,0,,,,9,9,0
142887,20,111,45,66,88,31,57,23,14,9
142957,20,10,5,5,5,3,2,5,2,3
143048,20,2819,701,2118,2596,634,1962,223,67,156
143084,20,2318,1059,1259,2293,1047,1246,25,12,13
143118,20,4048,1323,2725,3663,1229,2434,385,94,291
143215,20,7188,3141,4047,2677,1221,1456,4511,1920,2591
143279,20,3773,1424,2349,1186,523,663,2587,901,1686
143288,20,382,168,214,376,167,209,6,1,5
143297,20,153,18,135,121,13,108,32,5,27
143358,20,4143,2036,2107,4026,1963,2063,117,73,44
143376,20,229,11,218,155,11,144,74,0,74
143464,20,100,4,96,91,4,87,9,0,9
143473,20,31,2,29,8,1,7,23,1,22
143482,20,29,0,29,14,0,14,15,0,15
143491,20,39,2,37,13,1,12,26,1,25
143552,20,51,1,50,20,0,20,31,1,30
143613,20,1688,611,1077,719,302,417,969,309,660
143978,20,34,7,27,17,3,14,17,4,13
144005,20,1450,483,967,935,331,604,515,152,363
144050,20,7595,4028,3567,7563,4012,3551,32,16,16
144157,20,2237,938,1299,838,409,429,1399,529,870
144166,20,7314,1718,5596,2524,632,1892,4790,1086,3704
144175,20,2101,840,1261,699,322,377,1402,518,884
144184,20,5289,2057,3232,1324,499,825,3965,1558,2407
144193,20,4787,2232,2555,1414,843,571,3373,1389,1984
144209,20,5559,2276,3283,1978,870,1108,3581,1406,2175
144218,20,7508,3343,4165,2242,1194,1048,5266,2149,3117
144281,20,6424,2548,3876,6111,2415,3696,313,133,180
144351,20,1328,611,717,1157,548,609,171,63,108
144564,20,1924,803,1121,755,294,461,1169,509,660
144573,20,142,5,137,104,3,101,38,2,36
144740,20,14134,6325,7809,12885,5739,7146,1249,586,663
144795,20,359,93,266,330,88,242,29,5,24
144865,20,21939,10044,11895,6898,3478,3420,15041,6566,8475
144883,20,529,264,265,529,264,265,,,
144892,20,6916,2824,4092,4014,1592,2422,2902,1232,1670
144944,20,8910,3952,4958,2758,1394,1364,6152,2558,3594
144962,20,3027,1170,1857,2831,1075,1756,196,95,101
144971,20,559,295,264,524,289,235,35,6,29
145099,20,274,19,255,274,19,255,,,
145239,20,252,34,218,252,34,218,,,
145309,20,41,10,31,41,10,31,,,
145336,20,2609,961,1648,1629,615,1014,980,346,634
145354,20,43,2,41,7,0,7,36,2,34
145372,20,948,509,439,859,475,384,89,34,55
145406,20,378,7,371,110,5,105,268,2,266
145424,20,62,0,62,17,0,17,45,0,45
145433,20,97,1,96,37,1,36,60,0,60
145497,20,160,21,139,52,11,41,108,10,98
145521,20,1184,478,706,522,215,307,662,263,399
145600,20,21807,10226,11581,19728,9222,10506,2079,1004,1075
145619,20,2042,1073,969,1787,976,811,255,97,158
145637,20,35120,18821,16299,33813,17996,15817,1307,825,482
145646,20,1527,783,744,1518,778,740,9,5,4
145682,20,7044,2789,4255,2097,1029,1068,4947,1760,3187
145691,20,1028,480,548,989,469,520,39,11,28
145707,20,869,373,496,464,215,249,405,158,247
145725,20,3125,2117,1008,2707,1793,914,418,324,94
145813,20,18055,7854,10201,16966,7301,9665,1089,553,536
145831,20,2371,985,1386,970,460,510,1401,525,876
146205,20,3272,1344,1928,1310,555,755,1962,789,1173
146278,20,1718,670,1048,774,329,445,944,341,603
146296,20,10212,4480,5732,3556,1678,1878,6656,2802,3854
146339,20,798,398,400,734,382,352,64,16,48
146348,20,2333,925,1408,930,425,505,1403,500,903
146366,20,3370,1383,1987,1082,443,639,2288,940,1348
146418,20,2581,1060,1521,921,445,476,1660,615,1045
146427,20,1058,466,592,1047,462,585,11,4,7
146454,20,28,0,28,28,0,28,,,
146472,20,11651,5037,6614,3745,1895,1850,7906,3142,4764
146481,20,1727,716,1011,1685,700,985,42,16,26
146506,20,3742,1549,2193,1865,789,1076,1877,760,1117
146533,20,116,22,94,85,19,66,31,3,28
146603,20,3973,1694,2279,1264,568,696,2709,1126,1583
146612,20,3933,2053,1880,3128,1590,1538,805,463,342
146667,20,87,51,36,51,31,20,36,20,16
146685,20,4444,1695,2749,1671,832,839,2773,863,1910
146700,20,1209,906,303,1209,906,303,,,
146719,20,11703,3649,8054,11174,3459,7715,529,190,339
146755,20,81,11,70,65,10,55,16,1,15
146807,20,64,7,57,19,2,17,45,5,40
146816,20,303,33,270,254,23,231,49,10,39
147004,20,8874,3909,4965,2072,998,1074,6802,2911,3891
147013,20,1534,776,758,1410,735,675,124,41,83
147129,20,433,40,393,208,18,190,225,22,203
147244,20,1708,766,942,1598,730,868,110,36,74
147341,20,767,388,379,750,381,369,17,7,10
147369,20,1753,891,862,1382,674,708,371,217,154
147378,20,10511,5184,5327,3746,1830,1916,6765,3354,3411
147396,20,67,59,8,66,58,8,1,1,0
147411,20,3753,1641,2112,1131,537,594,2622,1104,1518
147536,20,3984,1055,2929,2697,817,1880,1287,238,1049
147590,20,33,10,23,17,6,11,16,4,12
147642,20,53,5,48,9,0,9,44,5,39
147660,20,2368,1165,1203,2258,1110,1148,110,55,55
147679,20,1868,784,1084,1746,739,1007,122,45,77
147703,20,11429,5405,6024,9931,4649,5282,1498,756,742
147767,20,8993,4126,4867,8656,3990,4666,337,136,201
147776,20,4207,1729,2478,2525,1050,1475,1682,679,1003
147800,20,7645,3479,4166,2042,1137,905,5603,2342,3261
147819,20,36,1,35,36,1,35,,,
147828,20,2519,1111,1408,2407,1074,1333,112,37,75
147916,20,5686,2566,3120,2147,1102,1045,3539,1464,2075
148007,20,2680,1046,1634,935,384,551,1745,662,1083
148016,20,323,191,132,305,178,127,18,13,5
148098,20,48,1,47,33,1,32,15,0,15
148131,20,1147,598,549,989,539,450,158,59,99
148256,20,2017,863,1154,1035,454,581,982,409,573
148292,20,2075,741,1334,514,202,312,1561,539,1022
148380,20,5861,2617,3244,2345,1076,1269,3516,1541,1975
148405,20,951,442,509,871,405,466,80,37,43
148487,20,2413,956,1457,2060,850,1210,353,106,247
148496,20,2136,615,1521,2012,584,1428,124,31,93
148511,20,115,25,90,48,9,39,67,16,51
148575,20,244,36,208,195,31,164,49,5,44
148584,20,1414,465,949,1176,408,768,238,57,181
148593,20,82,6,76,65,6,59,17,0,17
148627,20,2981,1111,1870,2752,1022,1730,229,89,140
148654,20,2393,1089,1304,1678,727,951,715,362,353
148672,20,1386,559,827,634,267,367,752,292,460
148821,20,1174,445,729,474,174,300,700,271,429
148876,20,680,119,561,462,81,381,218,38,180
148937,20,1379,616,763,507,240,267,872,376,496
148991,20,1212,502,710,452,197,255,760,305,455
149028,20,181,18,163,123,15,108,58,3,55
149204,20,39,1,38,39,1,38,,,
149222,20,8000,3978,4022,6715,3251,3464,1285,727,558
149231,20,9321,3985,5336,7709,3312,4397,1612,673,939
149310,20,175,109,66,175,109,66,,,
149329,20,79,79,0,79,79,0,,,
149365,20,3905,1591,2314,819,304,515,3086,1287,1799
149505,20,854,325,529,749,297,452,105,28,77
149514,20,450,273,177,375,228,147,75,45,30
149532,20,8616,4034,4582,2612,1233,1379,6004,2801,3203
149550,20,147,14,133,105,14,91,42,0,42
149639,20,94,52,42,66,28,38,28,24,4
149727,20,7491,3302,4189,2297,1151,1146,5194,2151,3043
149763,20,371,85,286,216,56,160,155,29,126
149772,20,5309,2280,3029,4469,1910,2559,840,370,470
149781,20,2163,958,1205,2081,921,1160,82,37,45
149842,20,12434,5435,6999,3823,1934,1889,8611,3501,5110
150066,20,1129,549,580,1028,513,515,101,36,65
150136,20,14416,5622,8794,12622,4910,7712,1794,712,1082
150145,20,1181,472,709,1021,424,597,160,48,112
150163,20,4427,1785,2642,4259,1729,2530,168,56,112
150172,20,563,357,206,389,236,153,174,121,53
150251,20,186,6,180,94,1,93,92,5,87
150303,20,288,3,285,143,1,142,145,2,143
150400,20,1752,862,890,1727,852,875,25,10,15
150428,20,16,0,16,16,0,16,,,
150455,20,612,285,327,609,283,326,3,2,1
150534,20,1717,674,1043,1428,548,880,289,126,163
150604,20,896,468,428,850,448,402,46,20,26
150668,20,717,274,443,667,258,409,50,16,34
150677,20,1709,666,1043,1464,558,906,245,108,137
150756,20,951,476,475,946,472,474,5,4,1
150765,20,116,2,114,116,2,114,,,
150774,20,434,246,188,412,243,169,22,3,19
150853,20,215,4,211,132,4,128,83,0,83
150941,20,1229,481,748,911,341,570,318,140,178
150987,20,89705,40496,49209,16424,6357,10067,73281,34139,39142
151102,20,8390,4027,4363,4533,2320,2213,3857,1707,2150
151111,20,17727,7195,10532,14971,5954,9017,2756,1241,1515
151263,20,3715,1428,2287,3239,1263,1976,476,165,311
151290,20,1490,868,622,1292,769,523,198,99,99
151306,20,7355,2697,4658,4875,1783,3092,2480,914,1566
151324,20,6965,3016,3949,5738,2479,3259,1227,537,690
151333,20,2669,921,1748,2035,695,1340,634,226,408
151342,20,3753,1312,2441,2848,976,1872,905,336,569
151351,20,35660,17953,17707,34665,17393,17272,995,560,435
151360,20,2860,727,2133,1975,512,1463,885,215,670
151379,20,3227,1249,1978,2241,858,1383,986,391,595
151388,20,2786,972,1814,1590,497,1093,1196,475,721
151467,20,167,18,149,167,18,149,,,
151564,20,43,1,42,10,1,9,33,0,33
151607,20,100,2,98,76,2,74,24,0,24
151661,20,889,742,147,889,742,147,,,
151777,20,942,448,494,892,436,456,50,12,38
151786,20,2633,956,1677,2090,831,1259,543,125,418
151801,20,2236,819,1417,2072,745,1327,164,74,90
151810,20,161,54,107,67,21,46,94,33,61
151962,20,352,103,249,284,80,204,68,23,45
152044,20,83,42,41,17,14,3,66,28,38
152080,20,8971,4602,4369,8953,4589,4364,18,13,5
152099,20,699,373,326,644,337,307,55,36,19
152150,20,65,1,64,36,1,35,29,0,29
152275,20,119,43,76,61,2,59,58,41,17
152309,20,93,39,54,82,34,48,11,5,6
152318,20,2169,1641,528,2138,1618,520,31,23,8
152336,20,1576,531,1045,1428,506,922,148,25,123
152381,20,815,189,626,713,184,529,102,5,97
152390,20,1406,8,1398,1376,1,1375,30,7,23
152497,20,144,14,130,122,13,109,22,1,21
152530,20,2188,1003,1185,1733,787,946,455,216,239
152567,20,3819,2009,1810,2260,1416,844,1559,593,966
152600,20,2349,1009,1340,2305,989,1316,44,20,24
152628,20,28,1,27,12,1,11,16,0,16
152637,20,16773,8331,8442,4025,2071,1954,12748,6260,6488
152673,20,835,835,0,834,834,0,1,1,0
152798,20,278,25,253,248,21,227,30,4,26
152992,20,709,338,371,556,291,265,153,47,106
153001,20,1474,512,962,1295,473,822,179,39,140
153074,20,175,6,169,175,6,169,,,
153083,20,142,3,139,142,3,139,,,
153108,20,1169,607,562,1118,583,535,51,24,27
153126,20,785,429,356,706,394,312,79,35,44
153144,20,1264,554,710,1242,541,701,22,13,9
153162,20,1058,552,506,1057,551,506,1,1,0
153214,20,21637,9438,12199,5257,2489,2768,16380,6949,9431
153241,20,68,27,41,56,23,33,12,4,8
153250,20,1618,807,811,1459,746,713,159,61,98
153269,20,2835,1140,1695,2744,1092,1652,91,48,43
153278,20,1444,852,592,1207,762,445,237,90,147
153296,20,718,342,376,518,271,247,200,71,129
153302,20,206,92,114,170,77,93,36,15,21
153311,20,7145,2923,4222,1931,742,1189,5214,2181,3033
153320,20,377,182,195,283,137,146,94,45,49
153366,20,885,498,387,818,474,344,67,24,43
153375,20,1556,715,841,1390,648,742,166,67,99
153384,20,1759,835,924,1706,806,900,53,29,24
153427,20,75,32,43,75,32,43,,,
153445,20,4787,2017,2770,1834,860,974,2953,1157,1796
153463,20,20,1,19,20,1,19,,,
153472,20,3361,1566,1795,1665,778,887,1696,788,908
153524,20,5058,2431,2627,2637,1422,1215,2421,1009,1412
153533,20,1960,895,1065,769,428,341,1191,467,724
153542,20,19,2,17,19,2,17,,,
153597,20,77,3,74,77,3,74,,,
153603,20,25241,14072,11169,23992,13297,10695,1249,775,474
153621,20,785,438,347,694,403,291,91,35,56
153630,20,5342,2425,2917,2308,1279,1029,3034,1146,1888
153658,20,21973,9651,12322,20255,8866,11389,1718,785,933
153737,20,12406,5487,6919,4166,1929,2237,8240,3558,4682
153746,20,39,2,37,39,2,37,,,
153764,20,57,0,57,57,0,57,,,
153773,20,59,4,55,59,4,55,,,
153782,20,21,0,21,21,0,21,,,
153825,20,1227,703,524,1147,659,488,80,44,36
153834,20,1610,727,883,1593,718,875,17,9,8
153861,20,681,162,519,455,118,337,226,44,182
153922,20,1707,733,974,704,336,368,1003,397,606
153977,20,909,130,779,457,84,373,452,46,406
154004,20,1186,590,596,1128,575,553,58,15,43
154013,20,1271,472,799,998,392,606,273,80,193
154022,20,27201,10173,17028,20283,7389,12894,6918,2784,4134
154059,20,2479,1130,1349,1138,569,569,1341,561,780
154095,20,7735,2955,4780,6976,2640,4336,759,315,444
154101,20,1153,537,616,1019,513,506,134,24,110
154110,20,4355,1833,2522,967,437,530,3388,1396,1992
154129,20,1811,790,1021,569,350,219,1242,440,802
154174,20,32,19,13,28,15,13,4,4,0
154208,20,126,4,122,20,0,20,106,4,102
154235,20,2118,970,1148,2030,931,1099,88,39,49
154262,20,196,16,180,86,11,75,110,5,105
154332,20,96,3,93,96,3,93,,,
154350,20,1127,541,586,1062,513,549,65,28,37
154378,20,2476,1030,1446,1170,504,666,1306,526,780
154396,20,1581,651,930,652,284,368,929,367,562
154448,20,146,10,136,146,10,136,,,
154457,20,13,0,13,13,0,13,,,
154466,20,30,2,28,30,2,28,,,
154493,20,2463,1051,1412,1249,532,717,1214,519,695
154518,20,2295,1443,852,1577,945,632,718,498,220
154527,20,1416,700,716,1363,668,695,53,32,21
154545,20,94,67,27,94,67,27,,,
154572,20,5150,2062,3088,1638,741,897,3512,1321,2191
154590,20,1404,694,710,1290,656,634,114,38,76
154642,20,2007,739,1268,859,392,467,1148,347,801
154688,20,1509,696,813,945,451,494,564,245,319
154697,20,4269,1937,2332,1237,538,699,3032,1399,1633
154712,20,2289,1120,1169,2135,1057,1078,154,63,91
154721,20,744,435,309,678,407,271,66,28,38
154749,20,497,260,237,486,258,228,11,2,9
154800,20,6697,2567,4130,2781,1151,1630,3916,1416,2500
154855,20,537,262,275,440,222,218,97,40,57
154907,20,1651,679,972,593,271,322,1058,408,650
154925,20,1474,860,614,905,583,322,569,277,292
154934,20,1380,429,951,583,233,350,797,196,601
154952,20,2230,936,1294,1189,577,612,1041,359,682
154998,20,1670,821,849,795,451,344,875,370,505
155007,20,358,95,263,165,57,108,193,38,155
155025,20,2740,1014,1726,2542,935,1607,198,79,119
155052,20,1610,880,730,295,133,162,1315,747,568
155061,20,10427,4120,6307,4880,1982,2898,5547,2138,3409
155070,20,152,73,79,117,53,64,35,20,15
155089,20,1278,598,680,922,466,456,356,132,224
155098,20,1499,686,813,685,344,341,814,342,472
155104,20,1914,888,1026,1083,551,532,831,337,494
155140,20,727,280,447,652,258,394,75,22,53
155159,20,72,0,72,72,0,72,,,
155177,20,325,148,177,302,142,160,23,6,17
155186,20,2339,1043,1296,803,394,409,1536,649,887
155195,20,4960,2145,2815,1728,784,944,3232,1361,1871
155201,20,809,370,439,430,249,181,379,121,258
155210,20,16497,7418,9079,4922,2393,2529,11575,5025,6550
155283,20,577,65,512,528,61,467,49,4,45
155292,20,4676,1945,2731,1601,709,892,3075,1236,1839
155308,20,188,137,51,168,119,49,20,18,2
155317,20,19241,8943,10298,16801,7829,8972,2440,1114,1326
155335,20,2444,942,1502,863,312,551,1581,630,951
155353,20,76,67,9,76,67,9,,,
155399,20,15046,7487,7559,13462,6820,6642,1584,667,917
155414,20,791,448,343,752,420,332,39,28,11
155423,20,1157,722,435,871,591,280,286,131,155
155450,20,1425,541,884,503,195,308,922,346,576
155487,20,909,523,386,261,158,103,648,365,283
155496,20,132,69,63,100,52,48,32,17,15
155511,20,815,552,263,803,545,258,12,7,5
155520,20,1159,539,620,923,439,484,236,100,136
155566,20,1638,695,943,554,245,309,1084,450,634
155593,20,999,621,378,412,296,116,587,325,262
155618,20,666,458,208,388,301,87,278,157,121
155627,20,853,541,312,776,488,288,77,53,24
155636,20,275,64,211,83,19,64,192,45,147
155681,20,4489,2247,2242,4015,2026,1989,474,221,253
155715,20,1202,643,559,555,375,180,647,268,379
155812,20,903,471,432,751,406,345,152,65,87
155830,20,855,411,444,239,130,109,616,281,335
155858,20,1663,604,1059,681,284,397,982,320,662
155900,20,1067,708,359,630,395,235,437,313,124
155937,20,682,409,273,509,325,184,173,84,89
155973,20,571,334,237,506,316,190,65,18,47
156082,20,4733,1728,3005,3174,1149,2025,1559,579,980
156107,20,5021,2745,2276,1527,997,530,3494,1748,1746
156125,20,12049,5257,6792,8338,3692,4646,3711,1565,2146
156134,20,907,536,371,907,536,371,,,
156189,20,565,296,269,531,281,250,34,15,19
156213,20,1404,557,847,1077,446,631,327,111,216
156231,20,2515,998,1517,1083,489,594,1432,509,923
156286,20,2343,899,1444,2222,843,1379,121,56,65
156295,20,1433,582,851,1408,568,840,25,14,11
156310,20,279,4,275,248,4,244,31,0,31
156338,20,4732,1885,2847,1430,593,837,3302,1292,2010
156356,20,551,212,339,478,198,280,73,14,59
156365,20,6411,2573,3838,2443,1050,1393,3968,1523,2445
156392,20,10318,4200,6118,3680,1609,2071,6638,2591,4047
156408,20,1357,655,702,1352,651,701,5,4,1
156417,20,133,114,19,72,62,10,61,52,9
156426,20,172,12,160,112,8,104,60,4,56
156471,20,3999,314,3685,1733,137,1596,2266,177,2089
156541,20,5174,1765,3409,3894,1311,2583,1280,454,826
156620,20,12072,4914,7158,9515,3785,5730,2557,1129,1428
156648,20,5648,2350,3298,2131,869,1262,3517,1481,2036
156745,20,1233,574,659,1201,559,642,32,15,17
156754,20,44,1,43,44,1,43,,,
156790,20,2556,1089,1467,796,322,474,1760,767,993
156842,20,193,5,188,136,4,132,57,1,56
156851,20,1506,410,1096,369,103,266,1137,307,830
156860,20,2028,690,1338,699,245,454,1329,445,884
156921,20,12053,5236,6817,2887,1358,1529,9166,3878,5288
156967,20,96,2,94,96,2,94,,,
157021,20,237,20,217,93,12,81,144,8,136
157030,20,78,48,30,49,32,17,29,16,13
157058,20,1610,661,949,1204,468,736,406,193,213
157076,20,813,418,395,747,373,374,66,45,21
157085,20,22735,9583,13152,20790,8747,12043,1945,836,1109
157100,20,577,367,210,459,308,151,118,59,59
157216,20,1753,768,985,1541,703,838,212,65,147
157289,20,15921,6907,9014,11336,5009,6327,4585,1898,2687
157304,20,3493,1568,1925,988,329,659,2505,1239,1266
157331,20,3974,1572,2402,1030,444,586,2944,1128,1816
157377,20,1203,454,749,1024,420,604,179,34,145
157386,20,8215,3170,5045,4503,1763,2740,3712,1407,2305
157401,20,7679,2849,4830,5833,2243,3590,1846,606,1240
157438,20,4440,1959,2481,1188,574,614,3252,1385,1867
157447,20,10776,4361,6415,7412,3069,4343,3364,1292,2072
157483,20,5309,2313,2996,1607,619,988,3702,1694,2008
157535,20,1491,656,835,1080,486,594,411,170,241
157553,20,2576,1091,1485,1152,509,643,1424,582,842
157614,20,89,2,87,61,2,59,28,0,28
157650,20,106,3,103,75,3,72,31,0,31
157669,20,78,2,76,78,2,76,,,
157678,20,95,0,95,95,0,95,,,
157711,20,5529,2213,3316,2019,866,1153,3510,1347,2163
157739,20,2625,1022,1603,1002,344,658,1623,678,945
157748,20,1018,542,476,662,349,313,356,193,163
157757,20,767,281,486,551,195,356,216,86,130
157793,20,1844,604,1240,1200,390,810,644,214,430
157809,20,1829,888,941,1283,680,603,546,208,338
157818,20,979,430,549,954,415,539,25,15,10
157863,20,724,435,289,685,415,270,39,20,19
157951,20,14440,5490,8950,11163,4305,6858,3277,1185,2092
158088,20,1226,610,616,710,308,402,516,302,214
158246,20,128,39,89,128,39,89,,,
158325,20,110,14,96,110,14,96,,,
158431,20,6312,2059,4253,2816,1018,1798,3496,1041,2455
158477,20,523,238,285,518,235,283,5,3,2
158538,20,59,0,59,59,0,59,,,
158617,20,636,186,450,636,186,450,,,
158662,20,12377,3723,8654,3934,1299,2635,8443,2424,6019
158778,20,64,0,64,64,0,64,,,
158787,20,61,0,61,61,0,61,,,
158802,20,1224,299,925,1162,289,873,62,10,52
158884,20,2393,873,1520,627,257,370,1766,616,1150
159009,20,4201,1523,2678,3689,1359,2330,512,164,348
159027,20,43,0,43,43,0,43,,,
159197,20,505,426,79,505,426,79,,,
159328,20,98,1,97,98,1,97,,,
159373,20,880,119,761,783,111,672,97,8,89
159382,20,4289,1273,3016,2294,684,1610,1995,589,1406
159391,20,30952,13896,17056,26516,11924,14592,4436,1972,2464
159407,20,3038,767,2271,1529,431,1098,1509,336,1173
159416,20,2465,959,1506,1610,654,956,855,305,550
159513,20,183,6,177,183,6,177,,,
159522,20,170,4,166,170,4,166,,,
159531,20,27,0,27,27,0,27,,,
159568,20,832,446,386,745,411,334,87,35,52
159601,20,30,0,30,30,0,30,,,
159647,20,9924,5219,4705,7325,4142,3183,2599,1077,1522
159656,20,3289,1097,2192,3000,1004,1996,289,93,196
159717,20,5696,2242,3454,4471,1785,2686,1225,457,768
159939,20,5804,2839,2965,4043,2003,2040,1761,836,925
159948,20,801,483,318,286,193,93,515,290,225
159966,20,5314,1916,3398,4244,1558,2686,1070,358,712
159993,20,6552,2271,4281,4098,1497,2601,2454,774,1680
160010,20,970,592,378,320,256,64,650,336,314
160038,20,8405,2533,5872,4831,1543,3288,3574,990,2584
160065,20,774,213,561,306,62,244,468,151,317
160074,20,891,162,729,479,71,408,412,91,321
160117,20,182,1,181,182,1,181,,,
160126,20,37,1,36,15,0,15,22,1,21
160199,20,41,1,40,41,1,40,,,
160320,20,2499,84,2415,2499,84,2415,,,
160409,20,107,107,0,105,105,0,2,2,0
160472,20,106,9,97,63,7,56,43,2,41
160481,20,2047,610,1437,982,320,662,1065,290,775
160524,20,270,74,196,270,74,196,,,
160579,20,3268,1532,1736,1640,832,808,1628,700,928
160597,20,161,48,113,81,24,57,80,24,56
160612,20,12426,4683,7743,7715,2915,4800,4711,1768,2943
160621,20,6470,2133,4337,5091,1687,3404,1379,446,933
160630,20,1680,479,1201,885,212,673,795,267,528
160649,20,3154,960,2194,1522,486,1036,1632,474,1158
160658,20,12950,5464,7486,10598,4499,6099,2352,965,1387
160667,20,5074,2423,2651,1283,697,586,3791,1726,2065
160755,20,8785,3389,5396,8184,3158,5026,601,231,370
160904,20,2696,600,2096,2607,579,2028,89,21,68
160959,20,377,121,256,362,114,248,15,7,8
160977,20,1790,846,944,1790,846,944,,,
160995,20,399,84,315,399,84,315,,,
161004,20,1915,926,989,1909,924,985,6,2,4
161022,20,237,19,218,106,7,99,131,12,119
161077,20,3376,1448,1928,1220,616,604,2156,832,1324
161086,20,2299,1094,1205,2299,1094,1205,,,
161138,20,2376,1164,1212,933,489,444,1443,675,768
161192,20,2119,697,1422,510,196,314,1609,501,1108
161208,20,46,43,3,46,43,3,,,
161217,20,4384,1438,2946,1297,387,910,3087,1051,2036
161226,20,1558,512,1046,1144,400,744,414,112,302
161235,20,1194,358,836,337,113,224,857,245,612
161253,20,9774,4924,4850,7622,3894,3728,2152,1030,1122
161299,20,878,706,172,854,685,169,24,21,3
161341,20,1824,664,1160,734,278,456,1090,386,704
161457,20,3718,1171,2547,2276,738,1538,1442,433,1009
161484,20,783,382,401,315,181,134,468,201,267
161493,20,155,4,151,123,2,121,32,2,30
161509,20,380,87,293,370,84,286,10,3,7
161518,20,990,372,618,689,273,416,301,99,202
161527,20,248,23,225,171,8,163,77,15,62
161545,20,6007,2608,3399,2310,1133,1177,3697,1475,2222
161554,20,5616,2315,3301,3467,1348,2119,2149,967,1182
161563,20,1623,726,897,654,313,341,969,413,556
161572,20,3698,782,2916,3690,782,2908,8,0,8
161581,20,505,188,317,168,91,77,337,97,240
161688,20,2578,790,1788,825,322,503,1753,468,1285
161767,20,10192,4040,6152,2842,1385,1457,7350,2655,4695
161800,20,147,39,108,44,16,28,103,23,80
161855,20,43,1,42,20,0,20,23,1,22
161864,20,3538,983,2555,847,287,560,2691,696,1995
161873,20,1369,545,824,755,293,462,614,252,362
162007,20,5378,2062,3316,4418,1685,2733,960,377,583
162061,20,301,237,64,233,182,51,68,55,13
162104,20,1823,689,1134,547,253,294,1276,436,840
162122,20,4868,1855,3013,1797,777,1020,3071,1078,1993
162168,20,1794,590,1204,425,180,245,1369,410,959
162210,20,582,210,372,424,153,271,158,57,101
162283,20,1757,404,1353,1335,326,1009,422,78,344
162335,20,54,0,54,54,0,54,,,
162371,20,612,552,60,612,552,60,,,
162557,20,5811,2547,3264,1686,882,804,4125,1665,2460
162584,20,3263,1550,1713,2528,1308,1220,735,242,493
162609,20,579,281,298,304,155,149,275,126,149
162654,20,1001,330,671,975,323,652,26,7,19
162690,20,3504,1190,2314,1130,483,647,2374,707,1667
162706,20,4591,1833,2758,1617,781,836,2974,1052,1922
162760,20,1202,452,750,1152,433,719,50,19,31
162779,20,8177,3392,4785,2293,1136,1157,5884,2256,3628
162830,20,94,4,90,94,4,90,,,
162928,20,6044,2715,3329,5644,2596,3048,400,119,281
163028,20,947,851,96,708,636,72,239,215,24
163046,20,3977,1784,2193,3947,1768,2179,30,16,14
163204,20,46734,26164,20570,10071,5208,4863,36663,20956,15707
163259,20,963,167,796,732,130,602,231,37,194
163268,20,10625,5684,4941,9069,4863,4206,1556,821,735
163286,20,30353,15413,14940,28069,14109,13960,2284,1304,980
163295,20,1403,332,1071,1336,311,1025,67,21,46
163338,20,1933,901,1032,1749,802,947,184,99,85
163347,20,382,23,359,382,23,359,,,
163408,20,83,13,70,47,5,42,36,8,28
163426,20,17137,7931,9206,5620,2842,2778,11517,5089,6428
163453,20,7609,2883,4726,7009,2609,4400,600,274,326
163462,20,1896,895,1001,1766,842,924,130,53,77
163532,20,246,246,0,246,246,0,,,
163541,20,265,116,149,133,64,69,132,52,80
163578,20,660,25,635,497,16,481,163,9,154
163657,20,10244,3768,6476,2956,1225,1731,7288,2543,4745
163815,20,41,1,40,15,1,14,26,0,26
163851,20,6378,2895,3483,5853,2626,3227,525,269,256
163912,20,1497,620,877,1455,601,854,42,19,23
163976,20,462,233,229,460,233,227,2,0,2
164076,20,16861,6978,9883,14805,6062,8743,2056,916,1140
164155,20,4450,3184,1266,4450,3184,1266,,,
164173,20,2985,1134,1851,2672,1058,1614,313,76,237
164216,20,955,400,555,941,391,550,14,9,5
164270,20,1766,728,1038,1739,711,1028,27,17,10
164313,20,2438,752,1686,409,180,229,2029,572,1457
164368,20,682,418,264,682,418,264,,,
164447,20,1167,539,628,1097,513,584,70,26,44
164465,20,1898,917,981,1898,917,981,,,
164492,20,1069,618,451,829,446,383,240,172,68
164535,20,54,12,42,54,12,42,,,
164562,20,1704,769,935,1665,760,905,39,9,30
164580,20,2761,1599,1162,2737,1592,1145,24,7,17
164599,20,26,4,22,,,,26,4,22
164614,20,43,28,15,31,19,12,12,9,3
164632,20,1315,7,1308,815,0,815,500,7,493
164641,20,224,64,160,120,45,75,104,19,85
164739,20,4131,2507,1624,4075,2469,1606,56,38,18
164748,20,7499,4275,3224,5939,3250,2689,1560,1025,535
164775,20,1367,449,918,350,146,204,1017,303,714
164845,20,66,1,65,57,1,56,9,0,9
164872,20,297,132,165,206,98,108,91,34,57
164924,20,9982,4697,5285,9757,4569,5188,225,128,97
164988,20,18459,7742,10717,17734,7381,10353,725,361,364
165015,20,3687,1575,2112,3675,1569,2106,12,6,6
165024,20,8116,3391,4725,6541,2742,3799,1575,649,926
165033,20,5822,1966,3856,2066,803,1263,3756,1163,2593
165060,20,150,14,136,91,9,82,59,5,54
165112,20,8439,3389,5050,2354,1100,1254,6085,2289,3796
165167,20,840,188,652,109,32,77,731,156,575
165194,20,2336,854,1482,629,281,348,1707,573,1134
165255,20,186,2,184,89,0,89,97,2,95
165264,20,983,76,907,93,7,86,890,69,821
165334,20,2389,992,1397,2356,978,1378,33,14,19
165529,20,1833,766,1067,1687,728,959,146,38,108
165556,20,399,42,357,341,32,309,58,10,48
165574,20,1189,594,595,1103,557,546,86,37,49
165608,20,44,4,40,32,4,28,12,0,12
165635,20,202,187,15,202,187,15,,,
165644,20,409,232,177,381,222,159,28,10,18
165662,20,4155,1444,2711,4104,1425,2679,51,19,32
165671,20,1947,445,1502,1801,416,1385,146,29,117
165699,20,3062,1124,1938,2910,1060,1850,152,64,88
165750,20,32,11,21,21,11,10,11,0,11
165802,20,1312,452,860,624,330,294,688,122,566
165820,20,3168,1446,1722,2293,1109,1184,875,337,538
165866,20,2970,1346,1624,2473,1137,1336,497,209,288
165884,20,513,420,93,292,245,47,221,175,46
165936,20,1294,518,776,1238,488,750,56,30,26
165981,20,1419,497,922,372,133,239,1047,364,683
166018,20,508,190,318,508,190,318,,,
166027,20,9368,4498,4870,7516,3611,3905,1852,887,965
166045,20,123,59,64,63,31,32,60,28,32
166054,20,39,33,6,39,33,6,,,
166124,20,3083,1383,1700,3062,1375,1687,21,8,13
166133,20,3550,1240,2310,1175,486,689,2375,754,1621
166391,20,1247,439,808,1192,416,776,55,23,32
166407,20,225,13,212,13,0,13,212,13,199
166452,20,1554,404,1150,956,244,712,598,160,438
166489,20,40,19,21,31,17,14,9,2,7
166498,20,65,2,63,29,0,29,36,2,34
166513,20,12389,7191,5198,9640,5677,3963,2749,1514,1235
166629,20,24391,11843,12548,22920,11189,11731,1471,654,817
166638,20,12221,5235,6986,9792,4156,5636,2429,1079,1350
166647,20,3497,1516,1981,1077,577,500,2420,939,1481
166656,20,3522,823,2699,3276,771,2505,246,52,194
166674,20,1833,479,1354,1577,394,1183,256,85,171
166683,20,4657,2413,2244,4601,2378,2223,56,35,21
166692,20,1326,1146,180,1293,1116,177,33,30,3
166717,20,40,11,29,19,6,13,21,5,16
166805,20,54,37,17,24,19,5,30,18,12
166823,20,4810,1852,2958,1614,754,860,3196,1098,2098
166850,20,4229,1931,2298,3985,1842,2143,244,89,155
166869,20,140,22,118,140,22,118,,,
166887,20,7770,3118,4652,1599,725,874,6171,2393,3778
166911,20,296,71,225,283,65,218,13,6,7
166939,20,2193,2,2191,2172,0,2172,21,2,19
166957,20,2868,907,1961,785,316,469,2083,591,1492
167039,20,6,0,6,6,0,6,,,
167057,20,382,206,176,353,190,163,29,16,13
167260,20,1164,754,410,1054,707,347,110,47,63
167288,20,838,356,482,682,305,377,156,51,105
167297,20,152,92,60,152,92,60,,,
167312,20,4391,1538,2853,1225,547,678,3166,991,2175
167358,20,16302,7153,9149,16278,7138,9140,24,15,9
167376,20,4339,1608,2731,1089,518,571,3250,1090,2160
167394,20,980,252,728,797,217,580,183,35,148
167525,20,2602,1050,1552,833,388,445,1769,662,1107
167534,20,6481,2428,4053,1913,859,1054,4568,1569,2999
167598,20,1121,227,894,921,197,724,200,30,170
167631,20,1214,385,829,328,136,192,886,249,637
167677,20,29,29,0,27,27,0,2,2,0
167729,20,5078,1746,3332,3924,1325,2599,1154,421,733
167783,20,1788,0,1788,1601,0,1601,187,0,187
167792,20,298,117,181,258,97,161,40,20,20
167835,20,2523,1,2522,2518,1,2517,5,0,5
167871,20,128,28,100,72,8,64,56,20,36
167899,20,2005,1005,1000,1982,987,995,23,18,5
167905,20,3945,1568,2377,1422,685,737,2523,883,1640
167987,20,5517,2662,2855,4707,2327,2380,810,335,475
167996,20,2500,1121,1379,2439,1091,1348,61,30,31
168005,20,4381,1655,2726,4213,1571,2642,168,84,84
168032,20,5,0,5,5,0,5,,,
168148,20,6815,3022,3793,6635,2923,3712,180,99,81
168218,20,2447,35,2412,2363,0,2363,84,35,49
168227,20,3713,2868,845,3382,2609,773,331,259,72
168254,20,2406,1398,1008,2324,1348,976,82,50,32
168263,20,3943,1754,2189,3263,1434,1829,680,320,360
168281,20,1667,612,1055,1656,607,1049,11,5,6
168342,20,2169,1025,1144,2146,1014,1132,23,11,12
168421,20,5246,3303,1943,5115,3210,1905,131,93,38
168430,20,4478,1767,2711,3392,1297,2095,1086,470,616
168528,20,1747,936,811,1674,904,770,73,32,41
168546,20,1454,693,761,1442,687,755,12,6,6
168555,20,31,1,30,25,1,24,6,0,6
168573,20,731,713,18,731,713,18,,,
168591,20,1245,582,663,1223,565,658,22,17,5
168607,20,1536,717,819,495,276,219,1041,441,600
168740,20,1295,645,650,1100,545,555,195,100,95
168786,20,1169,514,655,1035,459,576,134,55,79
168847,20,3778,988,2790,1423,368,1055,2355,620,1735
168883,20,1969,762,1207,570,245,325,1399,517,882
168892,20,116,4,112,62,3,59,54,1,53
169080,20,2960,1439,1521,2637,1243,1394,323,196,127
169187,20,104,20,84,25,10,15,79,10,69
169248,20,10401,4032,6369,8937,3554,5383,1464,478,986
169275,20,5969,2051,3918,1713,650,1063,4256,1401,2855
169284,20,263,18,245,196,6,190,67,12,55
169327,20,719,455,264,553,365,188,166,90,76
169363,20,951,484,467,812,431,381,139,53,86
169442,20,1451,507,944,1140,387,753,311,120,191
169479,20,4069,1778,2291,2052,1061,991,2017,717,1300
169503,20,277,3,274,277,3,274,,,
169521,20,7056,2655,4401,2032,831,1201,5024,1824,3200
169576,20,108,2,106,108,2,106,,,
169655,20,1303,1217,86,1303,1217,86,,,
169716,20,3156,1408,1748,2146,751,1395,1010,657,353
169761,20,480,91,389,480,91,389,,,
169798,20,11617,4647,6970,8282,3263,5019,3335,1384,1951
169813,20,58,1,57,58,1,57,,,
169910,20,9000,4167,4833,6554,3098,3456,2446,1069,1377
169974,20,1069,425,644,359,150,209,710,275,435
169983,20,1422,1128,294,1370,1088,282,52,40,12
169992,20,837,317,520,364,158,206,473,159,314
170000,20,969,399,570,591,257,334,378,142,236
170037,20,1433,548,885,1121,441,680,312,107,205
170055,20,11803,5161,6642,3360,1625,1735,8443,3536,4907
170082,20,18665,7462,11203,16472,6468,10004,2193,994,1199
170091,20,133,76,57,126,72,54,7,4,3
170240,20,11204,4829,6375,3938,1746,2192,7266,3083,4183
170286,20,1573,789,784,1539,771,768,34,18,16
170301,20,3251,1253,1998,3126,1204,1922,125,49,76
170444,20,4244,1480,2764,925,335,590,3319,1145,2174
170532,20,1210,526,684,1190,517,673,20,9,11
170541,20,6358,2806,3552,1695,728,967,4663,2078,2585
170550,20,3427,1026,2401,738,283,455,2689,743,1946
170587,20,1403,529,874,444,165,279,959,364,595
170611,20,107,3,104,99,3,96,8,0,8
170620,20,2543,924,1619,719,283,436,1824,641,1183
170639,20,1655,740,915,1295,605,690,360,135,225
170657,20,9573,4160,5413,2890,1323,1567,6683,2837,3846
170675,20,2298,1556,742,1696,1208,488,602,348,254
170736,20,52,1,51,23,0,23,29,1,28
170790,20,15946,6784,9162,4423,2044,2379,11523,4740,6783
170806,20,1766,654,1112,1336,489,847,430,165,265
170967,20,1140,446,694,749,306,443,391,140,251
170976,20,32695,15580,17115,31319,14802,16517,1376,778,598
171012,20,134,106,28,134,106,28,,,
171100,20,39201,18944,20257,35982,17245,18737,3219,1699,1520
171128,20,5699,4012,1687,5403,3809,1594,296,203,93
171137,20,6116,3234,2882,4667,2450,2217,1449,784,665
171146,20,4609,1684,2925,2829,1082,1747,1780,602,1178
171155,20,3382,1211,2171,1014,441,573,2368,770,1598
171225,20,2398,903,1495,584,239,345,1814,664,1150
171234,20,1603,542,1061,292,102,190,1311,440,871
171304,20,3446,1292,2154,1088,461,627,2358,831,1527
171395,20,1560,542,1018,568,218,350,992,324,668
171456,20,6434,2634,3800,5612,2316,3296,822,318,504
171483,20,3098,1412,1686,1116,554,562,1982,858,1124
171492,20,1940,1202,738,1275,812,463,665,390,275
171535,20,13430,6072,7358,3437,1778,1659,9993,4294,5699
171571,20,12841,5480,7361,10244,4231,6013,2597,1249,1348
171599,20,860,538,322,841,523,318,19,15,4
171775,20,46,0,46,37,0,37,9,0,9
171881,20,79,33,46,67,28,39,12,5,7
171988,20,82,5,77,82,5,77,,,
171997,20,130,5,125,130,5,125,,,
172015,20,76,1,75,76,1,75,,,
172033,20,172,97,75,33,32,1,139,65,74
172051,20,6468,2327,4141,5464,1939,3525,1004,388,616
172200,20,7650,3226,4424,1876,971,905,5774,2255,3519
172264,20,1702,754,948,1103,532,571,599,222,377
172291,20,3192,1104,2088,1139,391,748,2053,713,1340
172307,20,1807,759,1048,791,360,431,1016,399,617
172334,20,1127,391,736,879,322,557,248,69,179
172422,20,109,84,25,109,84,25,,,
172440,20,450,235,215,401,223,178,49,12,37
172495,20,248,7,241,178,7,171,70,0,70
172608,20,578,295,283,70,42,28,508,253,255
172617,20,10622,4791,5831,2809,1405,1404,7813,3386,4427
172635,20,12219,4130,8089,1422,585,837,10797,3545,7252
172644,20,15958,6491,9467,12106,4828,7278,3852,1663,2189
172671,20,992,363,629,237,99,138,755,264,491
172680,20,110,5,105,63,4,59,47,1,46
172699,20,13589,6768,6821,11421,5643,5778,2168,1125,1043
172866,20,105,98,7,105,98,7,,,
172918,20,2865,1383,1482,1146,650,496,1719,733,986
172954,20,1580,733,847,727,442,285,853,291,562
172963,20,7902,3139,4763,2580,1074,1506,5322,2065,3257
173045,20,2358,1028,1330,2210,974,1236,148,54,94
173063,20,3175,1480,1695,1085,535,550,2090,945,1145
173115,20,721,223,498,266,148,118,455,75,380
173124,20,3677,1526,2151,2327,1063,1264,1350,463,887
173142,20,792,381,411,632,312,320,160,69,91
173160,20,2592,1033,1559,2018,812,1206,574,221,353
173203,20,4633,1919,2714,1522,717,805,3111,1202,1909
173258,20,2059,1021,1038,2041,1015,1026,18,6,12
173300,20,1827,854,973,1771,824,947,56,30,26
173328,20,3071,1047,2024,2055,724,1331,1016,323,693
173416,20,2717,1586,1131,1333,864,469,1384,722,662
173452,20,755,356,399,613,310,303,142,46,96
173461,20,3849,1728,2121,1402,725,677,2447,1003,1444
173559,20,5282,2132,3150,1886,943,943,3396,1189,2207
173638,20,3352,1631,1721,978,496,482,2374,1135,1239
173647,20,2072,923,1149,2031,900,1131,41,23,18
173665,20,1765,655,1110,1704,626,1078,61,29,32
173708,20,3974,2476,1498,1326,954,372,2648,1522,1126
173735,20,3044,1457,1587,1961,1098,863,1083,359,724
173744,20,508,25,483,508,25,483,,,
173799,20,3459,1324,2135,1101,468,633,2358,856,1502
173902,20,2175,917,1258,2144,898,1246,31,19,12
173911,20,2602,1096,1506,1012,550,462,1590,546,1044
173920,20,12676,5721,6955,9945,4720,5225,2731,1001,1730
173957,20,216,51,165,216,51,165,,,
174020,20,5488,2282,3206,2483,1104,1379,3005,1178,1827
174066,20,39248,17662,21586,29057,13234,15823,10191,4428,5763
174075,20,2303,932,1371,1018,403,615,1285,529,756
174127,20,702,231,471,687,223,464,15,8,7
174136,20,6030,2563,3467,1825,893,932,4205,1670,2535
174154,20,808,90,718,402,45,357,406,45,361
174190,20,150,3,147,116,2,114,34,1,33
174233,20,8810,4446,4364,7448,3806,3642,1362,640,722
174251,20,1068,471,597,994,442,552,74,29,45
174321,20,115,4,111,113,4,109,2,0,2
174358,20,3729,1380,2349,2909,1084,1825,820,296,524
174376,20,4896,1917,2979,1428,626,802,3468,1291,2177
174428,20,9346,3900,5446,3275,1521,1754,6071,2379,3692
174437,20,893,417,476,780,359,421,113,58,55
174473,20,2495,1030,1465,838,371,467,1657,659,998
174491,20,3161,1209,1952,1883,759,1124,1278,450,828
174507,20,341,96,245,115,42,73,226,54,172
174525,20,102,57,45,79,47,32,23,10,13
174570,20,1873,735,1138,461,204,257,1412,531,881
174738,20,4482,1645,2837,1728,778,950,2754,867,1887
174747,20,1443,0,1443,1422,0,1422,21,0,21
174756,20,3466,1362,2104,1594,709,885,1872,653,1219
174783,20,8569,3833,4736,4594,2155,2439,3975,1678,2297
174792,20,1528,1528,0,1480,1480,0,48,48,0
174817,20,1100,477,623,862,389,473,238,88,150
174844,20,3046,1274,1772,3022,1267,1755,24,7,17
174862,20,1251,566,685,669,327,342,582,239,343
174899,20,1938,618,1320,1676,560,1116,262,58,204
174914,20,5906,3045,2861,5712,2934,2778,194,111,83
174978,20,142,3,139,106,2,104,36,1,35
175005,20,2404,115,2289,1624,30,1594,780,85,695
175014,20,2649,443,2206,1374,242,1132,1275,201,1074
175041,20,5365,2322,3043,1962,993,969,3403,1329,2074
175078,20,6518,2491,4027,1500,590,910,5018,1901,3117
175120,20,440,302,138,440,302,138,,,
175227,20,1359,1102,257,1127,923,204,232,179,53
175236,20,2904,1074,1830,1583,669,914,1321,405,916
175263,20,1923,839,1084,668,360,308,1255,479,776
175272,20,5403,1730,3673,4635,1473,3162,768,257,511
175315,20,7646,3194,4452,2921,1323,1598,4725,1871,2854
175342,20,2431,808,1623,2021,691,1330,410,117,293
175421,20,1501,565,936,1077,443,634,424,122,302
175430,20,892,436,456,535,265,270,357,171,186
175494,20,122,38,84,122,38,84,,,
175519,20,1783,651,1132,1111,435,676,672,216,456
175573,20,2801,1110,1691,1801,749,1052,1000,361,639
175616,20,1889,762,1127,1418,596,822,471,166,305
175643,20,2380,920,1460,1523,626,897,857,294,563
175652,20,3324,1470,1854,2174,1026,1148,1150,444,706
175698,20,36,29,7,26,22,4,10,7,3
175722,20,24,0,24,24,0,24,,,
175786,20,9407,3704,5703,4824,1966,2858,4583,1738,2845
175810,20,4948,1666,3282,3015,1064,1951,1933,602,1331
175829,20,4599,1791,2808,2892,1198,1694,1707,593,1114
175856,20,4927,1800,3127,4316,1602,2714,611,198,413
175883,20,4399,1667,2732,2762,1069,1693,1637,598,1039
175935,20,2621,847,1774,1745,579,1166,876,268,608
175980,20,627,343,284,621,340,281,6,3,3
176008,20,2039,728,1311,1374,515,859,665,213,452
176017,20,17302,7430,9872,16240,6879,9361,1062,551,511
176035,20,2080,484,1596,1528,286,1242,552,198,354
176044,20,1654,715,939,1054,477,577,600,238,362
176053,20,2396,1010,1386,1953,813,1140,443,197,246
176062,20,55,0,55,55,0,55,,,
176071,20,7845,2996,4849,4720,1945,2775,3125,1051,2074
176080,20,18305,9066,9239,16621,8164,8457,1684,902,782
176169,20,3062,1152,1910,2350,905,1445,712,247,465
176178,20,7198,2686,4512,4332,1663,2669,2866,1023,1843
176239,20,5462,1907,3555,3887,1418,2469,1575,489,1086
176318,20,755,313,442,587,234,353,168,79,89
176336,20,97,76,21,92,72,20,5,4,1
176354,20,1807,724,1083,1387,580,807,420,144,276
176372,20,10258,3617,6641,8624,2936,5688,1634,681,953
176406,20,657,254,403,569,219,350,88,35,53
176433,20,56,2,54,42,2,40,14,0,14
176451,20,19,12,7,4,2,2,15,10,5
176479,20,3291,1127,2164,1706,546,1160,1585,581,1004
176628,20,978,394,584,872,366,506,106,28,78
176664,20,274,166,108,234,146,88,40,20,20
176716,20,136,1,135,136,1,135,,,
176770,20,677,87,590,349,51,298,328,36,292
176789,20,226,99,127,131,57,74,95,42,53
176798,20,216,50,166,126,22,104,90,28,62
176910,20,157,94,63,94,54,40,63,40,23
176947,20,1080,523,557,1065,515,550,15,8,7
176965,20,7345,3273,4072,5203,2397,2806,2142,876,1266
176983,20,76,57,19,65,51,14,11,6,5
177038,20,90,29,61,66,21,45,24,8,16
177065,20,5675,2296,3379,2349,892,1457,3326,1404,1922
177083,20,27,27,0,25,25,0,2,2,0
177117,20,311,0,311,309,0,309,2,0,2
177135,20,4034,1507,2527,1799,761,1038,2235,746,1489
177144,20,900,497,403,844,474,370,56,23,33
177214,20,1375,627,748,1355,617,738,20,10,10
177250,20,2692,1056,1636,1225,528,697,1467,528,939
177302,20,344,322,22,344,322,22,,,
177339,20,1246,592,654,1246,592,654,,,
177418,20,684,326,358,615,305,310,69,21,48
177436,20,26,1,25,26,1,25,,,
177472,20,10889,4594,6295,4690,1998,2692,6199,2596,3603
177542,20,452,220,232,317,144,173,135,76,59
177551,20,1084,326,758,947,285,662,137,41,96
177588,20,66,3,63,66,3,63,,,
177603,20,124,3,121,114,3,111,10,0,10
177676,20,3626,1452,2174,1728,744,984,1898,708,1190
177685,20,143,13,130,143,13,130,,,
177719,20,415,50,365,357,46,311,58,4,54
177746,20,738,167,571,728,163,565,10,4,6
177931,20,29,2,27,29,2,27,,,
177940,20,1730,700,1030,1184,495,689,546,205,341
177968,20,4808,2080,2728,4014,1759,2255,794,321,473
177977,20,2176,1779,397,1837,1561,276,339,218,121
177986,20,310,97,213,136,46,90,174,51,123
177995,20,12872,5203,7669,5521,2461,3060,7351,2742,4609
178059,20,5809,1860,3949,3324,1186,2138,2485,674,1811
178077,20,89,2,87,89,2,87,,,
178183,20,204,21,183,204,21,183,,,
178208,20,1009,651,358,421,296,125,588,355,233
178217,20,2289,787,1502,1273,454,819,1016,333,683
178244,20,4549,1903,2646,1390,649,741,3159,1254,1905
178341,20,4052,1538,2514,2571,991,1580,1481,547,934
178369,20,1494,837,657,1204,749,455,290,88,202
178387,20,3841,1470,2371,2337,951,1386,1504,519,985
178396,20,23745,10844,12901,21999,9981,12018,1746,863,883
178402,20,10179,4146,6033,5592,2170,3422,4587,1976,2611
178411,20,5498,4199,1299,4885,3747,1138,613,452,161
178420,20,12415,5234,7181,4195,1807,2388,8220,3427,4793
178448,20,5017,1887,3130,2200,872,1328,2817,1015,1802
178527,20,60,3,57,34,3,31,26,0,26
178615,20,3622,1454,2168,2837,1122,1715,785,332,453
178624,20,5308,2072,3236,4278,1682,2596,1030,390,640
178679,20,608,328,280,491,272,219,117,56,61
178697,20,1487,647,840,1470,641,829,17,6,11
178721,20,6238,3450,2788,3014,1438,1576,3224,2012,1212
178767,20,88,15,73,36,7,29,52,8,44
178828,20,34,8,26,34,8,26,,,
178891,20,1671,1524,147,1250,1140,110,421,384,37
178989,20,227,27,200,216,27,189,11,0,11
179043,20,2545,893,1652,1623,586,1037,922,307,615
179159,20,10662,4336,6326,6708,2589,4119,3954,1747,2207
179195,20,34,2,32,34,2,32,,,
179265,20,264,99,165,263,99,164,1,0,1
179308,20,14301,4950,9351,5294,2106,3188,9007,2844,6163
179326,20,1836,696,1140,1209,500,709,627,196,431
179344,20,1770,569,1201,684,218,466,1086,351,735
179511,20,91,1,90,52,1,51,39,0,39
179539,20,3724,1339,2385,1798,630,1168,1926,709,1217
179548,20,407,10,397,380,10,370,27,0,27
179557,20,8454,3369,5085,6312,2516,3796,2142,853,1289
179566,20,18419,7386,11033,11341,4389,6952,7078,2997,4081
179645,20,2624,818,1806,1376,427,949,1248,391,857
179715,20,1772,486,1286,777,226,551,995,260,735
179867,20,8132,3690,4442,7445,3504,3941,687,186,501
179894,20,2197,929,1268,1788,747,1041,409,182,227
179946,20,610,335,275,602,331,271,8,4,4
179955,20,824,423,401,811,413,398,13,10,3
179964,20,791,246,545,646,201,445,145,45,100
179991,20,37,2,35,37,2,35,,,
180054,20,346,74,272,195,40,155,151,34,117
180063,20,37,1,36,37,1,36,,,
180081,20,655,357,298,278,180,98,377,177,200
180090,20,68,2,66,68,2,66,,,
180106,20,1125,452,673,1099,441,658,26,11,15
180151,20,462,225,237,210,105,105,252,120,132
180160,20,221,77,144,91,35,56,130,42,88
180179,20,3665,1344,2321,1896,782,1114,1769,562,1207
180197,20,2129,939,1190,586,269,317,1543,670,873
180203,20,115,48,67,98,44,54,17,4,13
180212,20,697,213,484,400,124,276,297,89,208
180249,20,1192,345,847,453,140,313,739,205,534
180258,20,593,217,376,454,182,272,139,35,104
180276,20,1423,592,831,337,168,169,1086,424,662
180328,20,296,96,200,194,69,125,102,27,75
180373,20,583,196,387,275,124,151,308,72,236
180416,20,1437,883,554,1330,819,511,107,64,43
180461,20,14625,7790,6835,12535,6688,5847,2090,1102,988
180489,20,7215,3043,4172,5812,2443,3369,1403,600,803
180522,20,1105,637,468,683,426,257,422,211,211
180595,20,845,437,408,824,429,395,21,8,13
180647,20,591,170,421,443,133,310,148,37,111
180692,20,1424,452,972,1013,359,654,411,93,318
180814,20,10808,4764,6044,6509,2908,3601,4299,1856,2443
180832,20,631,91,540,237,39,198,394,52,342
180878,20,598,55,543,345,25,320,253,30,223
180902,20,6519,2721,3798,1752,888,864,4767,1833,2934
180948,20,1815,663,1152,1474,560,914,341,103,238
180957,20,67,58,9,67,58,9,,,
180984,20,2668,1243,1425,1122,541,581,1546,702,844
181002,20,4290,1789,2501,4184,1741,2443,106,48,58
181020,20,990,535,455,934,512,422,56,23,33
181127,20,919,442,477,911,438,473,8,4,4
181145,20,24,2,22,24,2,22,,,
181190,20,107,4,103,107,4,103,,,
181215,20,4269,1552,2717,3672,1367,2305,597,185,412
181297,20,808,84,724,566,62,504,242,22,220
181303,20,14541,7129,7412,3928,1990,1938,10613,5139,5474
181312,20,2084,862,1222,668,321,347,1416,541,875
181330,20,1340,654,686,1192,605,587,148,49,99
181394,20,12026,5358,6668,9985,4277,5708,2041,1081,960
181419,20,474,172,302,83,25,58,391,147,244
181428,20,886,120,766,743,100,643,143,20,123
181446,20,1545,710,835,1469,685,784,76,25,51
181464,20,19189,9616,9573,18175,9016,9159,1014,600,414
181491,20,5583,2981,2602,1996,1065,931,3587,1916,1671
181534,20,1569,641,928,997,444,553,572,197,375
181543,20,22,13,9,12,7,5,10,6,4
181604,20,539,16,523,496,0,496,43,16,27
181640,20,9465,4496,4969,3171,1813,1358,6294,2683,3611
181738,20,607,240,367,460,195,265,147,45,102
181765,20,303,103,200,236,70,166,67,33,34
181783,20,3860,1636,2224,2857,1220,1637,1003,416,587
181817,20,1575,633,942,618,283,335,957,350,607
181853,20,442,223,219,403,215,188,39,8,31
181880,20,203,5,198,125,4,121,78,1,77
181941,20,292,185,107,292,185,107,,,
182005,20,28901,12325,16576,9013,3871,5142,19888,8454,11434
182148,20,614,125,489,614,125,489,,,
182281,20,25365,11012,14353,19587,8423,11164,5778,2589,3189
182290,20,16973,7991,8982,13788,6472,7316,3185,1519,1666
182306,20,3197,1136,2061,878,355,523,2319,781,1538
182500,20,9651,4454,5197,2649,1163,1486,7002,3291,3711
182564,20,3582,1660,1922,1170,489,681,2412,1171,1241
182634,20,867,245,622,766,228,538,101,17,84
182670,20,4458,2274,2184,4457,2273,2184,1,1,0
182704,20,66,2,64,51,1,50,15,1,14
182722,20,151,12,139,116,12,104,35,0,35
182795,20,1118,507,611,997,454,543,121,53,68
182892,20,64,0,64,38,0,38,26,0,26
182917,20,59,26,33,59,26,33,,,
182980,20,1043,482,561,1006,465,541,37,17,20
182999,20,15,0,15,15,0,15,,,
183026,20,140865,51712,89153,33290,13057,20233,107575,38655,68920
183035,20,37,2,35,37,2,35,,,
183044,20,11512,5028,6484,11220,4858,6362,292,170,122
183062,20,2737,1274,1463,2632,1208,1424,105,66,39
183071,20,524,263,261,424,208,216,100,55,45
183080,20,3308,1689,1619,3183,1615,1568,125,74,51
183099,20,2619,939,1680,902,404,498,1717,535,1182
183105,20,523,186,337,161,85,76,362,101,261
183114,20,658,166,492,110,40,70,548,126,422
183123,20,645,320,325,228,159,69,417,161,256
183132,20,1976,950,1026,620,401,219,1356,549,807
183141,20,1245,586,659,341,207,134,904,379,525
183150,20,1415,568,847,429,221,208,986,347,639
183202,20,82,2,80,69,1,68,13,1,12
183211,20,1340,330,1010,946,288,658,394,42,352
183239,20,1959,781,1178,1938,768,1170,21,13,8
183248,20,135,15,120,78,9,69,57,6,51
183257,20,1195,341,854,579,164,415,616,177,439
183275,20,89,43,46,89,43,46,,,
183488,20,562,44,518,445,37,408,117,7,110
183600,20,33,0,33,19,0,19,14,0,14
183655,20,4278,1590,2688,1786,741,1045,2492,849,1643
183725,20,365,193,172,321,180,141,44,13,31
183743,20,11192,5314,5878,5875,2975,2900,5317,2339,2978
183789,20,1944,470,1474,1198,318,880,746,152,594
183804,20,3334,3334,0,3323,3323,0,11,11,0
183822,20,1152,470,682,1070,438,632,82,32,50
183859,20,9896,4607,5289,4059,2098,1961,5837,2509,3328
183877,20,6180,2448,3732,2983,1323,1660,3197,1125,2072
183910,20,1605,622,983,1534,594,940,71,28,43
183938,20,7770,2955,4815,3054,1307,1747,4716,1648,3068
183974,20,1026,370,656,961,348,613,65,22,43
183983,20,76,73,3,76,73,3,,,
184056,20,548,120,428,405,94,311,143,26,117
184092,20,760,99,661,760,99,661,,,
184180,20,5838,3111,2727,2585,1504,1081,3253,1607,1646
184205,20,2426,841,1585,909,336,573,1517,505,1012
184348,20,1513,650,863,1467,634,833,46,16,30
184427,20,339,316,23,236,224,12,103,92,11
184481,20,6466,2540,3926,2998,1204,1794,3468,1336,2132
184506,20,83,8,75,54,4,50,29,4,25
184603,20,5380,2420,2960,1905,906,999,3475,1514,1961
184612,20,1746,480,1266,1572,437,1135,174,43,131
184694,20,2053,938,1115,1935,877,1058,118,61,57
184746,20,82,75,7,74,68,6,8,7,1
184773,20,1471,423,1048,1073,263,810,398,160,238
184782,20,15231,7820,7411,13207,6886,6321,2024,934,1090
184791,20,5441,2192,3249,2826,1230,1596,2615,962,1653
184816,20,86,2,84,53,1,52,33,1,32
184959,20,719,108,611,322,49,273,397,59,338
184968,20,191,29,162,32,6,26,159,23,136
184995,20,6683,2593,4090,3495,1434,2061,3188,1159,2029
185129,20,4895,2026,2869,4146,1740,2406,749,286,463
185174,20,81,64,17,81,64,17,,,
185262,20,10845,4198,6647,8794,3394,5400,2051,804,1247
185396,20,1625,1570,55,1392,1347,45,233,223,10
185466,20,360,7,353,126,1,125,234,6,228
185509,20,5821,2694,3127,1916,1036,880,3905,1658,2247
185536,20,9736,4471,5265,4054,1972,2082,5682,2499,3183
185572,20,3811,1406,2405,3662,1335,2327,149,71,78
185590,20,17290,6882,10408,15428,6083,9345,1862,799,1063
185679,20,582,88,494,49,5,44,533,83,450
185721,20,415,119,296,263,77,186,152,42,110
185767,20,264,34,230,132,15,117,132,19,113
185828,20,9019,6551,2468,7414,5420,1994,1605,1131,474
185873,20,7186,3129,4057,3040,1495,1545,4146,1634,2512
185970,20,135,11,124,104,9,95,31,2,29
186016,20,454,27,427,252,18,234,202,9,193
186034,20,5119,1914,3205,1865,799,1066,3254,1115,2139
186052,20,886,740,146,608,518,90,278,222,56
186131,20,5604,2803,2801,5540,2769,2771,64,34,30
186186,20,194,194,0,194,194,0,,,
186201,20,4932,2052,2880,4316,1815,2501,616,237,379
186274,20,207,16,191,119,10,109,88,6,82
186283,20,3169,1369,1800,2966,1289,1677,203,80,123
186371,20,4185,1639,2546,3486,1337,2149,699,302,397
186380,20,36344,18156,18188,34667,17332,17335,1677,824,853
186399,20,7511,3441,4070,6335,2902,3433,1176,539,637
186405,20,16,5,11,16,5,11,,,
186423,20,53,8,45,53,8,45,,,
186432,20,2071,812,1259,1819,709,1110,252,103,149
186469,20,1111,391,720,520,231,289,591,160,431
186584,20,6012,2707,3305,5844,2616,3228,168,91,77
186593,20,80,26,54,55,25,30,25,1,24
186618,20,737,249,488,590,228,362,147,21,126
186645,20,6321,3216,3105,2521,1372,1149,3800,1844,1956
186867,20,4070,2768,1302,4050,2752,1298,20,16,4
186876,20,8138,3183,4955,7757,3008,4749,381,175,206
186900,20,73,73,0,73,73,0,,,
187000,20,368,347,21,252,235,17,116,112,4
187046,20,7358,4390,2968,76,15,61,7282,4375,2907
187134,20,7039,3047,3992,6841,2937,3904,198,110,88
187198,20,7796,2971,4825,3493,1618,1875,4303,1353,2950
187444,20,6604,2615,3989,5134,2100,3034,1470,515,955
187505,20,688,145,543,688,145,543,,,
187532,20,19095,7337,11758,4272,1847,2425,14823,5490,9333
187596,20,1330,517,813,526,242,284,804,275,529
187620,20,6662,2608,4054,2807,1191,1616,3855,1417,2438
187639,20,2303,752,1551,591,192,399,1712,560,1152
187648,20,3833,1506,2327,2039,767,1272,1794,739,1055
187666,20,1856,784,1072,834,382,452,1022,402,620
187745,20,800,319,481,249,93,156,551,226,325
187897,20,1625,578,1047,987,413,574,638,165,473
187903,20,2228,876,1352,937,401,536,1291,475,816
187912,20,424,334,90,345,288,57,79,46,33
187958,20,2113,795,1318,607,239,368,1506,556,950
187967,20,1218,840,378,1093,779,314,125,61,64
187976,20,1009,471,538,82,32,50,927,439,488
187985,20,16375,6848,9527,12042,5100,6942,4333,1748,2585
187994,20,1032,364,668,252,87,165,780,277,503
188003,20,1673,600,1073,269,86,183,1404,514,890
188021,20,825,247,578,185,60,125,640,187,453
188030,20,11591,4861,6730,9340,3887,5453,2251,974,1277
188049,20,1953,764,1189,246,94,152,1707,670,1037
188058,20,1154,482,672,447,157,290,707,325,382
188100,20,5454,1726,3728,1611,647,964,3843,1079,2764
188137,20,3266,1222,2044,653,251,402,2613,971,1642
188182,20,369,208,161,329,183,146,40,25,15
188216,20,269,93,176,179,81,98,90,12,78
188225,20,1222,426,796,141,58,83,1081,368,713
188261,20,824,537,287,126,79,47,698,458,240
188289,20,68,4,64,66,4,62,2,0,2
188304,20,2377,868,1509,1202,502,700,1175,366,809
188340,20,1175,1032,143,949,825,124,226,207,19
188429,20,5055,1637,3418,4780,1539,3241,275,98,177
188438,20,2662,1198,1464,1399,673,726,1263,525,738
188517,20,296,111,185,230,100,130,66,11,55
188526,20,584,208,376,581,206,375,3,2,1
188641,20,1347,652,695,1283,619,664,64,33,31
188650,20,148,3,145,148,3,145,,,
188669,20,67,15,52,67,15,52,,,
188678,20,209,68,141,209,68,141,,,
188687,20,382,127,255,100,40,60,282,87,195
188696,20,166,17,149,166,17,149,,,
188854,20,1471,398,1073,1471,398,1073,,,
188890,20,1072,1049,23,799,782,17,273,267,6
188915,20,47,14,33,22,13,9,25,1,24
188942,20,308,0,308,288,0,288,20,0,20
189088,20,2296,980,1316,2101,859,1242,195,121,74
189097,20,3442,114,3328,3091,0,3091,351,114,237
189219,20,122,120,2,122,120,2,,,
189228,20,1818,613,1205,1164,411,753,654,202,452
189255,20,110,1,109,71,1,70,39,0,39
189273,20,74,74,0,74,74,0,,,
189282,20,329,45,284,261,38,223,68,7,61
189404,20,137,1,136,45,0,45,92,1,91
189413,20,391,87,304,391,87,304,,,
189468,20,149,4,145,89,4,85,60,0,60
189477,20,139,3,136,51,2,49,88,1,87
189547,20,5409,2274,3135,2448,1056,1392,2961,1218,1743
189565,20,463,133,330,374,117,257,89,16,73
189583,20,787,223,564,454,116,338,333,107,226
189592,20,328,87,241,269,80,189,59,7,52
189705,20,1788,900,888,1723,860,863,65,40,25
189714,20,331,9,322,230,4,226,101,5,96
189811,20,827,158,669,827,158,669,,,
189839,20,3479,1411,2068,831,321,510,2648,1090,1558
189848,20,718,236,482,545,173,372,173,63,110
189857,20,679,679,0,679,679,0,,,
189990,20,745,7,738,148,3,145,597,4,593
190008,20,43,14,29,43,14,29,,,
190044,20,2668,1835,833,2625,1811,814,43,24,19
190053,20,994,437,557,306,159,147,688,278,410
190071,20,115,13,102,26,4,22,89,9,80
190099,20,3130,1392,1738,3112,1383,1729,18,9,9
190114,20,426,113,313,280,64,216,146,49,97
190150,20,8902,4530,4372,8263,4218,4045,639,312,327
190169,20,1447,604,843,461,220,241,986,384,602
190239,20,131,4,127,96,2,94,35,2,33
190318,20,199,13,186,190,5,185,9,8,1
190372,20,899,443,456,898,442,456,1,1,0
190415,20,15735,7162,8573,15685,7132,8553,50,30,20
190442,20,3786,1602,2184,1307,565,742,2479,1037,1442
190451,20,215,34,181,62,13,49,153,21,132
190503,20,3005,1523,1482,2867,1445,1422,138,78,60
190512,20,15896,7845,8051,12609,6257,6352,3287,1588,1699
190521,20,17444,7355,10089,11110,4847,6263,6334,2508,3826
190530,20,6715,2838,3877,3839,1734,2105,2876,1104,1772
190549,20,11661,4977,6684,8540,3672,4868,3121,1305,1816
190558,20,9299,4348,4951,7309,3433,3876,1990,915,1075
190567,20,11929,5655,6274,9511,4472,5039,2418,1183,1235
190576,20,2793,725,2068,892,247,645,1901,478,1423
190585,20,4904,1527,3377,2412,852,1560,2492,675,1817
190594,20,17256,5897,11359,13407,4447,8960,3849,1450,2399
190600,20,12061,4416,7645,9661,3508,6153,2400,908,1492
190619,20,15042,7138,7904,5581,2488,3093,9461,4650,4811
190628,20,13064,6151,6913,6664,2928,3736,6400,3223,3177
190637,20,11211,3660,7551,7401,2502,4899,3810,1158,2652
190646,20,3640,1057,2583,2467,717,1750,1173,340,833
190655,20,13087,7213,5874,8427,5001,3426,4660,2212,2448
190664,20,14406,6764,7642,10494,4860,5634,3912,1904,2008
190673,20,9573,4467,5106,5329,2744,2585,4244,1723,2521
190691,20,6199,2261,3938,3632,1299,2333,2567,962,1605
190707,20,18,5,13,18,5,13,,,
190716,20,1378,349,1029,1069,281,788,309,68,241
190725,20,1782,454,1328,1568,392,1176,214,62,152
190752,20,51,51,0,51,51,0,,,
190761,20,1097,398,699,1022,383,639,75,15,60
190840,20,7047,3132,3915,2556,1234,1322,4491,1898,2593
190956,20,141,14,127,13,2,11,128,12,116
190983,20,609,205,404,587,199,388,22,6,16
191083,20,7843,3760,4083,4546,2357,2189,3297,1403,1894
191126,20,7871,1395,6476,6885,1156,5729,986,239,747
191199,20,5331,2294,3037,1957,942,1015,3374,1352,2022
191205,20,496,343,153,457,329,128,39,14,25
191241,20,10098,4003,6095,9684,3835,5849,414,168,246
191302,20,1812,751,1061,675,305,370,1137,446,691
191311,20,149,53,96,149,53,96,,,
191339,20,4323,1659,2664,1445,552,893,2878,1107,1771
191515,20,2072,928,1144,2070,927,1143,2,1,1
191533,20,1099,452,647,1079,446,633,20,6,14
191597,20,544,77,467,348,55,293,196,22,174
191612,20,2030,841,1189,1054,445,609,976,396,580
191621,20,841,395,446,799,377,422,42,18,24
191630,20,1559,763,796,1547,754,793,12,9,3
191649,20,6110,2645,3465,5842,2502,3340,268,143,125
191676,20,805,301,504,712,263,449,93,38,55
191719,20,9140,4510,4630,4481,2561,1920,4659,1949,2710
191728,20,952,194,758,665,143,522,287,51,236
191931,20,3032,1420,1612,2603,1234,1369,429,186,243
191940,20,172,16,156,172,16,156,,,
191959,20,67,54,13,67,54,13,,,
191968,20,4619,2074,2545,4521,2028,2493,98,46,52
191986,20,3756,1634,2122,1407,626,781,2349,1008,1341
192004,20,287,78,209,278,75,203,9,3,6
192022,20,2292,892,1400,1166,497,669,1126,395,731
192040,20,149,61,88,145,59,86,4,2,2
192110,20,586,305,281,476,248,228,110,57,53
192165,20,187,187,0,187,187,0,,,
192192,20,985,247,738,917,233,684,68,14,54
192271,20,1080,113,967,986,108,878,94,5,89
192323,20,2600,997,1603,2193,917,1276,407,80,327
192448,20,11319,4452,6867,5304,1829,3475,6015,2623,3392
192484,20,165,3,162,77,1,76,88,2,86
192509,20,743,111,632,688,102,586,55,9,46
192624,20,142,142,0,142,142,0,,,
192688,20,437,78,359,353,54,299,84,24,60
192703,20,3066,1783,1283,2918,1682,1236,148,101,47
192712,20,508,253,255,503,252,251,5,1,4
192749,20,1290,520,770,1244,500,744,46,20,26
192785,20,761,87,674,177,25,152,584,62,522
192800,20,9,0,9,3,0,3,6,0,6
192819,20,5475,2289,3186,4919,2028,2891,556,261,295
192864,20,1608,291,1317,1404,272,1132,204,19,185
192925,20,1187,351,836,1061,338,723,126,13,113
192961,20,121,19,102,1,0,1,120,19,101
192970,20,15,5,10,15,5,10,,,
193016,20,6379,1969,4410,4815,1386,3429,1564,583,981
193052,20,344,344,0,344,344,0,,,
193061,20,47,47,0,47,47,0,,,
193070,20,52,52,0,52,52,0,,,
193201,20,365,42,323,365,42,323,,,
193247,20,114,114,0,114,114,0,,,
193265,20,66,59,7,49,45,4,17,14,3
193283,20,5539,2485,3054,2318,1088,1230,3221,1397,1824
193292,20,3271,935,2336,2636,802,1834,635,133,502
193308,20,5916,2023,3893,3609,1465,2144,2307,558,1749
193326,20,8283,3480,4803,4431,1982,2449,3852,1498,2354
193353,20,1542,475,1067,1183,365,818,359,110,249
193380,20,95,12,83,,,,95,12,83
193399,20,2259,517,1742,2090,493,1597,169,24,145
193478,20,11996,5729,6267,6711,3495,3216,5285,2234,3051
193584,20,1987,551,1436,1927,534,1393,60,17,43
193609,20,64,25,39,64,25,39,,,
193654,20,7171,1665,5506,6672,1523,5149,499,142,357
193858,20,266,18,248,266,18,248,,,
193900,20,29401,12019,17382,28354,11549,16805,1047,470,577
193946,20,3838,1511,2327,2114,875,1239,1724,636,1088
193973,20,2709,950,1759,2660,930,1730,49,20,29
193991,20,40,4,36,31,2,29,9,2,7
194028,20,1604,587,1017,601,237,364,1003,350,653
194091,20,3453,2042,1411,2950,1748,1202,503,294,209
194116,20,480,40,440,142,14,128,338,26,312
194161,20,768,312,456,573,223,350,195,89,106
194189,20,101,101,0,101,101,0,,,
194222,20,7320,3564,3756,2797,1405,1392,4523,2159,2364
194240,20,4976,2010,2966,1991,911,1080,2985,1099,1886
194259,20,17,1,16,17,1,16,,,
194310,20,8223,2788,5435,7480,2439,5041,743,349,394
194392,20,668,427,241,654,421,233,14,6,8
194435,20,73,2,71,73,2,71,,,
194499,20,807,158,649,790,155,635,17,3,14
194569,20,146,84,62,71,44,27,75,40,35
194578,20,3934,1106,2828,3854,1079,2775,80,27,53
194657,20,135,135,0,135,135,0,,,
194666,20,431,431,0,431,431,0,,,
194693,20,38,38,0,38,38,0,,,
194718,20,72,72,0,72,72,0,,,
194736,20,148,148,0,148,148,0,,,
194763,20,346,346,0,346,346,0,,,
194824,20,5902,4099,1803,5838,4048,1790,64,51,13
194958,20,1048,338,710,893,308,585,155,30,125
195003,20,13940,9227,4713,12811,8426,4385,1129,801,328
195030,20,6767,3196,3571,6425,3077,3348,342,119,223
195058,20,5472,2534,2938,2556,1372,1184,2916,1162,1754
195067,20,317,17,300,230,12,218,87,5,82
195128,20,1123,310,813,1090,305,785,33,5,28
195164,20,1856,1019,837,1771,981,790,85,38,47
195173,20,2276,861,1415,2147,807,1340,129,54,75
195191,20,239,23,216,208,17,191,31,6,25
195216,20,2145,983,1162,2130,977,1153,15,6,9
195234,20,1432,485,947,1371,458,913,61,27,34
195243,20,1859,911,948,979,505,474,880,406,474
195289,20,127,18,109,15,1,14,112,17,95
195304,20,1462,301,1161,1445,294,1151,17,7,10
195322,20,3657,1599,2058,1000,451,549,2657,1148,1509
195438,20,177,177,0,177,177,0,,,
195474,20,3516,1566,1950,3425,1527,1898,91,39,52
195526,20,2758,1141,1617,2725,1127,1598,33,14,19
195544,20,3556,1129,2427,3204,1028,2176,352,101,251
195702,20,141,20,121,83,14,69,58,6,52
195720,20,2629,1088,1541,2540,1059,1481,89,29,60
195784,20,658,94,564,658,94,564,,,
195809,20,15652,6943,8709,9878,4425,5453,5774,2518,3256
195988,20,1698,731,967,636,307,329,1062,424,638
196006,20,3348,2148,1200,3057,2046,1011,291,102,189
196015,20,2836,1232,1604,2342,1064,1278,494,168,326
196024,20,2478,1174,1304,2021,1080,941,457,94,363
196033,20,1783,764,1019,1668,713,955,115,51,64
196042,20,9264,5468,3796,7388,4415,2973,1876,1053,823
196051,20,1803,919,884,1571,863,708,232,56,176
196060,20,12264,5604,6660,11541,5240,6301,723,364,359
196079,20,14402,6833,7569,14082,6645,7437,320,188,132
196088,20,20761,11131,9630,19081,10369,8712,1680,762,918
196097,20,17509,8610,8899,16406,8018,8388,1103,592,511
196103,20,1621,813,808,1287,655,632,334,158,176
196112,20,1982,1342,640,1709,1220,489,273,122,151
196121,20,5149,2076,3073,4517,1879,2638,632,197,435
196130,20,5464,2381,3083,4861,2090,2771,603,291,312
196149,20,5993,2768,3225,5859,2692,3167,134,76,58
196158,20,3212,1342,1870,3111,1298,1813,101,44,57
196167,20,4110,1457,2653,3968,1392,2576,142,65,77
196176,20,6090,2150,3940,5541,1910,3631,549,240,309
196185,20,4859,1901,2958,4767,1848,2919,92,53,39
196194,20,5985,2851,3134,5538,2635,2903,447,216,231
196200,20,2082,813,1269,2003,790,1213,79,23,56
196219,20,3107,1297,1810,2855,1187,1668,252,110,142
196237,20,3907,1615,2292,3307,1330,1977,600,285,315
196246,20,4004,1567,2437,3548,1394,2154,456,173,283
196255,20,282,56,226,262,52,210,20,4,16
196264,20,7735,2679,5056,3282,907,2375,4453,1772,2681
196291,20,1295,1122,173,1200,1035,165,95,87,8
196307,20,158,37,121,128,31,97,30,6,24
196389,20,1053,224,829,1045,222,823,8,2,6
196413,20,15421,7030,8391,14806,6684,8122,615,346,269
196431,20,348,348,0,346,346,0,2,2,0
196440,20,14,14,0,14,14,0,,,
196565,20,4442,1893,2549,1074,518,556,3368,1375,1993
196583,20,67,67,0,67,67,0,,,
196592,20,4860,1416,3444,2995,938,2057,1865,478,1387
196653,20,1022,140,882,341,42,299,681,98,583
196680,20,13983,7151,6832,,,,13983,7151,6832
196699,20,2912,1430,1482,989,472,517,1923,958,965
196866,20,2107,1164,943,2092,1157,935,15,7,8
197018,20,2104,2104,0,2104,2104,0,,,
197027,20,931,747,184,931,747,184,,,
197036,20,4393,3394,999,4393,3394,999,,,
197045,20,2678,1099,1579,2156,942,1214,522,157,365
197133,20,2459,944,1515,2436,933,1503,23,11,12
197142,20,465,228,237,403,206,197,62,22,40
197151,20,3533,915,2618,3472,892,2580,61,23,38
197197,20,1653,619,1034,1579,593,986,74,26,48
197221,20,102,76,26,102,76,26,,,
197230,20,357,156,201,351,153,198,6,3,3
197285,20,828,243,585,663,194,469,165,49,116
197294,20,8807,4145,4662,4222,2155,2067,4585,1990,2595
197337,20,66,1,65,63,1,62,3,0,3
197531,20,487,229,258,487,229,258,,,
197601,20,122,122,0,122,122,0,,,
197647,20,111,111,0,111,111,0,,,
197674,20,214,214,0,214,214,0,,,
197692,20,71,71,0,71,71,0,,,
197708,20,2866,1583,1283,2795,1520,1275,71,63,8
197735,20,778,778,0,778,778,0,,,
197744,20,161,161,0,161,161,0,,,
197814,20,2314,825,1489,669,264,405,1645,561,1084
197850,20,3338,1208,2130,622,234,388,2716,974,1742
197869,20,18558,8097,10461,17365,7573,9792,1193,524,669
197887,20,6473,2481,3992,1736,704,1032,4737,1777,2960
197911,20,1187,549,638,1025,529,496,162,20,142
197966,20,1741,562,1179,459,141,318,1282,421,861
197984,20,1475,790,685,1346,740,606,129,50,79
197993,20,168,0,168,158,0,158,10,0,10
198011,20,978,322,656,387,121,266,591,201,390
198039,20,2794,1083,1711,748,303,445,2046,780,1266
198066,20,735,458,277,719,448,271,16,10,6
198084,20,1678,641,1037,676,301,375,1002,340,662
198109,20,451,31,420,135,9,126,316,22,294
198118,20,3703,1487,2216,1231,553,678,2472,934,1538
198136,20,2965,1419,1546,2468,1132,1336,497,287,210
198154,20,14170,7016,7154,3241,1547,1694,10929,5469,5460
198206,20,1554,520,1034,576,238,338,978,282,696
198215,20,1094,519,575,1000,499,501,94,20,74
198233,20,4172,1814,2358,1234,571,663,2938,1243,1695
198251,20,5231,1833,3398,1421,542,879,3810,1291,2519
198260,20,17694,7409,10285,6631,2978,3653,11063,4431,6632
198303,20,800,478,322,762,465,297,38,13,25
198321,20,1946,658,1288,594,216,378,1352,442,910
198330,20,3611,1335,2276,1494,574,920,2117,761,1356
198367,20,2701,1079,1622,769,370,399,1932,709,1223
198376,20,3921,1376,2545,1354,518,836,2567,858,1709
198385,20,1927,899,1028,1927,899,1028,,,
198419,20,6640,3153,3487,6589,3128,3461,51,25,26
198455,20,4294,1628,2666,757,351,406,3537,1277,2260
198464,20,21688,9038,12650,17617,7527,10090,4071,1511,2560
198491,20,1313,333,980,219,38,181,1094,295,799
198507,20,2033,876,1157,1704,768,936,329,108,221
198516,20,6337,2567,3770,6144,2476,3668,193,91,102
198534,20,10233,3925,6308,3738,1481,2257,6495,2444,4051
198543,20,5748,1706,4042,4019,1184,2835,1729,522,1207
198552,20,8270,2944,5326,2260,981,1279,6010,1963,4047
198561,20,1812,646,1166,1516,610,906,296,36,260
198570,20,5558,1957,3601,1373,546,827,4185,1411,2774
198598,20,730,419,311,601,379,222,129,40,89
198613,20,1129,562,567,1097,548,549,32,14,18
198622,20,10067,4194,5873,3546,1634,1912,6521,2560,3961
198640,20,995,327,668,213,67,146,782,260,522
198668,20,1286,439,847,414,187,227,872,252,620
198677,20,26,13,13,17,9,8,9,4,5
198695,20,5036,2240,2796,4934,2206,2728,102,34,68
198710,20,1876,694,1182,557,218,339,1319,476,843
198729,20,1359,438,921,449,136,313,910,302,608
198756,20,1052,481,571,988,460,528,64,21,43
198774,20,4282,1542,2740,1425,562,863,2857,980,1877
198808,20,855,299,556,821,294,527,34,5,29
198817,20,2199,792,1407,697,289,408,1502,503,999
198835,20,1529,666,863,1336,595,741,193,71,122
198844,20,105,1,104,105,1,104,,,
198862,20,839,497,342,814,485,329,25,12,13
198871,20,434,334,100,424,325,99,10,9,1
198899,20,994,508,486,914,478,436,80,30,50
198905,20,842,277,565,212,42,170,630,235,395
198914,20,783,336,447,238,90,148,545,246,299
198923,20,1100,438,662,227,98,129,873,340,533
198950,20,1322,4,1318,1258,0,1258,64,4,60
198969,20,1448,790,658,1288,726,562,160,64,96
198978,20,517,63,454,496,62,434,21,1,20
198987,20,3456,1335,2121,842,353,489,2614,982,1632
199005,20,6,0,6,6,0,6,,,
199023,20,702,345,357,247,120,127,455,225,230
199032,20,820,442,378,707,392,315,113,50,63
199069,20,2019,678,1341,1186,496,690,833,182,651
199078,20,152,17,135,149,17,132,3,0,3
199087,20,2645,981,1664,691,287,404,1954,694,1260
199102,20,11833,4463,7370,10577,3837,6740,1256,626,630
199111,20,2914,1222,1692,2535,1046,1489,379,176,203
199120,20,20029,7941,12088,19177,7536,11641,852,405,447
199139,20,23461,12165,11296,20089,10365,9724,3372,1800,1572
199148,20,14198,4764,9434,11668,3934,7734,2530,830,1700
199157,20,5634,1705,3929,4646,1434,3212,988,271,717
199184,20,920,362,558,894,350,544,26,12,14
199193,20,26254,13287,12967,23828,11905,11923,2426,1382,1044
199209,20,1249,632,617,1040,559,481,209,73,136
199218,20,14294,5055,9239,11923,4470,7453,2371,585,1786
199263,20,329,87,242,72,13,59,257,74,183
199272,20,713,349,364,580,320,260,133,29,104
199281,20,5643,2123,3520,4230,1672,2558,1413,451,962
199306,20,683,322,361,657,309,348,26,13,13
199324,20,1150,437,713,148,62,86,1002,375,627
199333,20,7144,2813,4331,2753,1140,1613,4391,1673,2718
199412,20,1317,472,845,1241,448,793,76,24,52
199421,20,2469,848,1621,568,194,374,1901,654,1247
199449,20,2290,786,1504,654,252,402,1636,534,1102
199458,20,133,92,41,130,90,40,3,2,1
199467,20,569,177,392,117,36,81,452,141,311
199476,20,1901,528,1373,548,154,394,1353,374,979
199485,20,1712,601,1111,417,179,238,1295,422,873
199494,20,6754,2517,4237,1759,724,1035,4995,1793,3202
199582,20,1085,539,546,855,408,447,230,131,99
199607,20,364,6,358,279,0,279,85,6,79
199625,20,1590,518,1072,443,159,284,1147,359,788
199634,20,3778,1408,2370,1127,497,630,2651,911,1740
199643,20,924,432,492,833,399,434,91,33,58
199689,20,186,7,179,148,1,147,38,6,32
199698,20,780,341,439,681,333,348,99,8,91
199722,20,1228,422,806,372,161,211,856,261,595
199731,20,2256,838,1418,505,187,318,1751,651,1100
199740,20,2319,716,1603,435,144,291,1884,572,1312
199759,20,679,403,276,267,170,97,412,233,179
199768,20,2797,1093,1704,896,399,497,1901,694,1207
199786,20,3939,1519,2420,1216,508,708,2723,1011,1712
199795,20,888,356,532,257,95,162,631,261,370
199838,20,2814,892,1922,928,319,609,1886,573,1313
199847,20,5447,2445,3002,5389,2411,2978,58,34,24
199856,20,21551,9711,11840,6790,3438,3352,14761,6273,8488
199865,20,723,247,476,710,247,463,13,0,13
199883,20,163,19,144,163,19,144,,,
199892,20,2732,1037,1695,753,345,408,1979,692,1287
199908,20,1749,640,1109,527,208,319,1222,432,790
199926,20,2321,968,1353,661,322,339,1660,646,1014
199953,20,1779,603,1176,372,126,246,1407,477,930
199962,20,2510,1026,1484,2454,1007,1447,56,19,37
199971,20,47,31,16,47,31,16,,,
199980,20,44,41,3,44,41,3,,,
199999,20,4513,1102,3411,3897,970,2927,616,132,484
200004,20,9956,4275,5681,8031,3526,4505,1925,749,1176
200013,20,467,78,389,256,41,215,211,37,174
200022,20,3771,1972,1799,1821,1047,774,1950,925,1025
200059,20,1411,629,782,972,456,516,439,173,266
200086,20,172,52,120,107,36,71,65,16,49
200110,20,51,1,50,51,1,50,,,
200156,20,978,550,428,942,529,413,36,21,15
200192,20,1679,683,996,416,184,232,1263,499,764
200208,20,316,87,229,154,59,95,162,28,134
200217,20,2506,1050,1456,1824,754,1070,682,296,386
200226,20,1077,397,680,591,257,334,486,140,346
200253,20,2530,907,1623,1768,650,1118,762,257,505
200280,20,9928,5554,4374,7004,3647,3357,2924,1907,1017
200305,20,2942,1667,1275,1514,1006,508,1428,661,767
200314,20,1080,406,674,297,113,184,783,293,490
200332,20,10096,4976,5120,8947,4496,4451,1149,480,669
200341,20,924,327,597,514,203,311,410,124,286
200466,20,231,108,123,194,97,97,37,11,26
200484,20,170,82,88,141,69,72,29,13,16
200527,20,599,233,366,461,186,275,138,47,91
200554,20,506,177,329,473,163,310,33,14,19
200572,20,1521,643,878,823,359,464,698,284,414
200590,20,152,27,125,143,23,120,9,4,5
200785,20,369,47,322,176,21,155,193,26,167
200800,20,11323,5804,5519,8602,4538,4064,2721,1266,1455
200846,20,1416,570,846,507,188,319,909,382,527
200873,20,86,49,37,53,24,29,33,25,8
201034,20,610,297,313,127,39,88,483,258,225
201061,20,259,67,192,251,64,187,8,3,5
201098,20,45,18,27,26,7,19,19,11,8
201104,20,3083,1281,1802,1983,828,1155,1100,453,647
201131,20,115,36,79,80,3,77,35,33,2
201140,20,37,31,6,,,,37,31,6
201159,20,166,122,44,92,72,20,74,50,24
201177,20,250,22,228,119,12,107,131,10,121
201195,20,2744,1222,1522,2628,1168,1460,116,54,62
201283,20,723,254,469,305,137,168,418,117,301
201371,20,664,355,309,639,341,298,25,14,11
201432,20,1845,687,1158,882,338,544,963,349,614
201441,20,13853,5989,7864,11581,4916,6665,2272,1073,1199
201469,20,534,113,421,415,102,313,119,11,108
201478,20,183,83,100,128,37,91,55,46,9
201496,20,450,282,168,450,282,168,,,
201539,20,92,15,77,66,10,56,26,5,21
201548,20,1938,782,1156,1882,755,1127,56,27,29
201645,20,6017,3136,2881,5907,3082,2825,110,54,56
201654,20,4533,2041,2492,3809,1731,2078,724,310,414
201672,20,2614,791,1823,454,146,308,2160,645,1515
201681,20,37,5,32,37,5,32,,,
201690,20,5406,1613,3793,3115,1015,2100,2291,598,1693
201751,20,129,44,85,39,15,24,90,29,61
201803,20,34,4,30,34,4,30,,,
201821,20,866,71,795,661,55,606,205,16,189
201867,20,101,16,85,101,16,85,,,
201885,20,29663,14714,14949,25016,12762,12254,4647,1952,2695
201928,20,8404,3271,5133,1957,893,1064,6447,2378,4069
201946,20,7448,3003,4445,1118,466,652,6330,2537,3793
201955,20,6569,2568,4001,2805,1200,1605,3764,1368,2396
201964,20,1439,591,848,668,295,373,771,296,475
201973,20,4703,1575,3128,857,307,550,3846,1268,2578
202046,20,584,163,421,568,152,416,16,11,5
202073,20,198,99,99,198,99,99,,,
202134,20,9776,4453,5323,7810,3592,4218,1966,861,1105
202152,20,96,11,85,96,11,85,,,
202170,20,956,291,665,944,290,654,12,1,11
202222,20,25129,11170,13959,5616,2633,2983,19513,8537,10976
202356,20,15764,5987,9777,3969,1763,2206,11795,4224,7571
202435,20,110,17,93,71,14,57,39,3,36
202453,20,69,59,10,69,59,10,,,
202480,20,8416,4372,4044,8106,4223,3883,310,149,161
202514,20,486,294,192,468,283,185,18,11,7
202523,20,2416,1154,1262,2400,1147,1253,16,7,9
202648,20,4353,1678,2675,1119,495,624,3234,1183,2051
202657,20,365,96,269,76,14,62,289,82,207
202763,20,3795,1327,2468,2234,704,1530,1561,623,938
202806,20,5647,2179,3468,1990,734,1256,3657,1445,2212
202888,20,50,6,44,35,6,29,15,0,15
202903,20,419,215,204,171,72,99,248,143,105
202912,20,342,15,327,139,9,130,203,6,197
202949,20,154,145,9,154,145,9,,,
202985,20,17,1,16,9,1,8,8,0,8
203030,20,35,1,34,35,1,34,,,
203085,20,933,495,438,899,486,413,34,9,25
203128,20,1002,461,541,691,338,353,311,123,188
203146,20,396,366,30,396,366,30,,,
203155,20,1951,1000,951,1498,836,662,453,164,289
203234,20,69,3,66,69,3,66,,,
203289,20,40,28,12,40,28,12,,,
203331,20,30364,9351,21013,9182,2735,6447,21182,6616,14566
203368,20,2417,1313,1104,2345,1276,1069,72,37,35
203386,20,2643,196,2447,1756,139,1617,887,57,830
203438,20,112,0,112,51,0,51,61,0,61
203447,20,1723,637,1086,192,64,128,1531,573,958
203456,20,1024,350,674,20,7,13,1004,343,661
203465,20,3443,1275,2168,976,402,574,2467,873,1594
203474,20,1734,681,1053,343,128,215,1391,553,838
203483,20,1940,795,1145,426,190,236,1514,605,909
203492,20,1315,370,945,247,36,211,1068,334,734
203517,20,20418,7723,12695,16802,6247,10555,3616,1476,2140
203526,20,2095,762,1333,318,136,182,1777,626,1151
203535,20,1885,826,1059,1877,824,1053,8,2,6
203544,20,645,115,530,383,52,331,262,63,199
203580,20,738,424,314,646,382,264,92,42,50
203599,20,4620,1766,2854,1248,551,697,3372,1215,2157
203614,20,414,120,294,414,120,294,,,
203678,20,3533,1289,2244,558,215,343,2975,1074,1901
203720,20,136,78,58,111,76,35,25,2,23
203739,20,44,7,37,37,5,32,7,2,5
203748,20,9170,3444,5726,2146,846,1300,7024,2598,4426
203757,20,953,396,557,693,321,372,260,75,185
203775,20,947,448,499,746,345,401,201,103,98
203845,20,1109,561,548,1027,527,500,82,34,48
203881,20,2767,1140,1627,425,163,262,2342,977,1365
203942,20,32,17,15,32,17,15,,,
203960,20,1120,133,987,365,48,317,755,85,670
204006,20,2251,1044,1207,1637,744,893,614,300,314
204015,20,1269,559,710,785,351,434,484,208,276
204024,20,16864,8119,8745,16434,7891,8543,430,228,202
204121,20,72,0,72,30,0,30,42,0,42
204158,20,127,36,91,127,36,91,,,
204176,20,628,78,550,482,64,418,146,14,132
204185,20,1891,1002,889,1855,982,873,36,20,16
204194,20,1628,630,998,1301,521,780,327,109,218
204200,20,1423,634,789,989,455,534,434,179,255
204255,20,1726,706,1020,542,262,280,1184,444,740
204264,20,1484,680,804,1307,635,672,177,45,132
204334,20,137,1,136,1,0,1,136,1,135
204422,20,2439,944,1495,698,309,389,1741,635,1106
204431,20,46,9,37,46,9,37,,,
204440,20,4030,1407,2623,623,410,213,3407,997,2410
204459,20,10,9,1,10,9,1,,,
204468,20,1329,619,710,958,501,457,371,118,253
204486,20,2576,2172,404,2421,2069,352,155,103,52
204501,20,2986,1220,1766,2978,1216,1762,8,4,4
204608,20,374,336,38,374,336,38,,,
204617,20,846,406,440,753,365,388,93,41,52
204635,20,2569,1388,1181,2368,1289,1079,201,99,102
204662,20,446,185,261,398,163,235,48,22,26
204671,20,818,358,460,672,293,379,146,65,81
204680,20,827,369,458,652,294,358,175,75,100
204699,20,900,463,437,734,380,354,166,83,83
204705,20,2263,1118,1145,1854,918,936,409,200,209
204714,20,81,3,78,81,3,78,,,
204723,20,303,232,71,303,232,71,,,
204769,20,124,7,117,124,7,117,,,
204778,20,65,1,64,65,1,64,,,
204796,20,46123,23014,23109,42360,21042,21318,3763,1972,1791
204802,20,1143,420,723,249,90,159,894,330,564
204820,20,1928,664,1264,566,183,383,1362,481,881
204839,20,2006,672,1334,437,142,295,1569,530,1039
204848,20,1994,721,1273,479,167,312,1515,554,961
204857,20,18113,7115,10998,14651,6282,8369,3462,833,2629
204866,20,1923,604,1319,428,98,330,1495,506,989
204884,20,149,7,142,149,7,142,,,
204893,20,43,9,34,20,7,13,23,2,21
204909,20,1410,617,793,1398,611,787,12,6,6
204936,20,2173,870,1303,2053,813,1240,120,57,63
204945,20,7559,3838,3721,1806,769,1037,5753,3069,2684
204963,20,47,3,44,47,3,44,,,
204981,20,108,24,84,19,2,17,89,22,67
205027,20,34,34,0,34,34,0,,,
205054,20,404,41,363,404,41,363,,,
205090,20,69,8,61,9,1,8,60,7,53
205124,20,55,55,0,55,55,0,,,
205142,20,121,39,82,116,39,77,5,0,5
205179,20,441,74,367,426,73,353,15,1,14
205203,20,1774,630,1144,1036,422,614,738,208,530
205391,20,178,33,145,98,18,80,80,15,65
205443,20,3091,1285,1806,2119,919,1200,972,366,606
205470,20,17591,7958,9633,3385,1700,1685,14206,6258,7948
205559,20,26,3,23,26,3,23,,,
205841,20,10031,4266,5765,2516,1233,1283,7515,3033,4482
205887,20,403,50,353,403,50,353,,,
205957,20,2785,1168,1617,2424,1014,1410,361,154,207
205966,20,1947,633,1314,432,139,293,1515,494,1021
206011,20,2207,1270,937,489,254,235,1718,1016,702
206039,20,40,1,39,29,0,29,11,1,10
206048,20,2339,1135,1204,1527,834,693,812,301,511
206084,20,11965,5755,6210,9703,4753,4950,2262,1002,1260
206154,20,21,17,4,,,,21,17,4
206172,20,40,15,25,40,15,25,,,
206181,20,134,37,97,51,4,47,83,33,50
206279,20,481,234,247,163,79,84,318,155,163
206321,20,85,26,59,46,2,44,39,24,15
206349,20,625,48,577,536,40,496,89,8,81
206394,20,47,11,36,20,6,14,27,5,22
206437,20,1558,727,831,1343,655,688,215,72,143
206446,20,1556,538,1018,433,197,236,1123,341,782
206491,20,643,288,355,499,228,271,144,60,84
206507,20,1015,458,557,970,438,532,45,20,25
206525,20,1258,598,660,1217,578,639,41,20,21
206589,20,1967,955,1012,1958,953,1005,9,2,7
206604,20,6938,3100,3838,5147,2274,2873,1791,826,965
206613,20,1294,521,773,729,274,455,565,247,318
206622,20,4852,2145,2707,4613,2042,2571,239,103,136
206695,20,8822,3946,4876,6950,3170,3780,1872,776,1096
206817,20,299,149,150,255,126,129,44,23,21
206835,20,722,402,320,605,353,252,117,49,68
206862,20,912,458,454,887,447,440,25,11,14
206905,20,300,175,125,49,22,27,251,153,98
206914,20,3133,1133,2000,1964,711,1253,1169,422,747
206923,20,1823,590,1233,911,348,563,912,242,670
206932,20,441,32,409,183,25,158,258,7,251
206941,20,10739,4067,6672,7845,2922,4923,2894,1145,1749
206996,20,1687,504,1183,738,250,488,949,254,695
207041,20,2730,1095,1635,2237,924,1313,493,171,322
207050,20,1238,423,815,629,237,392,609,186,423
207069,20,1735,641,1094,496,222,274,1239,419,820
207087,20,27,1,26,27,1,26,,,
207102,20,83,21,62,83,21,62,,,
207157,20,269,150,119,203,123,80,66,27,39
207209,20,1774,693,1081,1676,649,1027,98,44,54
207236,20,2282,699,1583,859,317,542,1423,382,1041
207254,20,639,574,65,639,574,65,,,
207263,20,5242,1994,3248,3676,1447,2229,1566,547,1019
207281,20,3271,1274,1997,1267,530,737,2004,744,1260
207290,20,1717,684,1033,1174,542,632,543,142,401
207306,20,1647,676,971,1241,525,716,406,151,255
207324,20,1950,840,1110,1747,760,987,203,80,123
207342,20,985,99,886,946,96,850,39,3,36
207351,20,1242,503,739,862,401,461,380,102,278
207388,20,20786,9968,10818,18265,8765,9500,2521,1203,1318
207397,20,4340,1551,2789,950,422,528,3390,1129,2261
207403,20,1330,590,740,1268,550,718,62,40,22
207449,20,11353,4099,7254,3310,1338,1972,8043,2761,5282
207458,20,1361,469,892,1309,442,867,52,27,25
207500,20,21282,10333,10949,18624,9018,9606,2658,1315,1343
207564,20,2357,1550,807,1385,1052,333,972,498,474
207582,20,4289,1740,2549,2755,1089,1666,1534,651,883
207661,20,3046,1199,1847,1916,757,1159,1130,442,688
207670,20,6702,2331,4371,2097,815,1282,4605,1516,3089
207704,20,206,1,205,103,1,102,103,0,103
207722,20,825,293,532,756,271,485,69,22,47
207740,20,1551,506,1045,707,260,447,844,246,598
207786,20,22,1,21,22,1,21,,,
207847,20,3022,1299,1723,1982,924,1058,1040,375,665
207856,20,404,229,175,365,204,161,39,25,14
207865,20,3941,1489,2452,3092,1212,1880,849,277,572
207935,20,14391,5242,9149,4496,1863,2633,9895,3379,6516
207962,20,793,679,114,793,679,114,,,
207971,20,2647,1285,1362,2434,1165,1269,213,120,93
208035,20,1338,430,908,514,230,284,824,200,624
208044,20,48,9,39,48,9,39,,,
208053,20,267,140,127,25,13,12,242,127,115
208275,20,1227,555,672,553,235,318,674,320,354
208318,20,4155,1913,2242,1655,793,862,2500,1120,1380
208390,20,7642,3452,4190,3422,1516,1906,4220,1936,2284
208406,20,4638,2331,2307,1693,788,905,2945,1543,1402
208415,20,714,311,403,262,96,166,452,215,237
208433,20,73,3,70,73,3,70,,,
208479,20,487,62,425,487,62,425,,,
208512,20,510,59,451,510,59,451,,,
208637,20,196,47,149,,,,196,47,149
208646,20,2415,979,1436,1479,620,859,936,359,577
208725,20,38,22,16,34,20,14,4,2,2
208822,20,2531,1016,1515,2336,942,1394,195,74,121
208859,20,40,6,34,40,6,34,,,
209038,20,6745,3204,3541,2717,1294,1423,4028,1910,2118
209056,20,2204,783,1421,2181,771,1410,23,12,11
209065,20,1720,597,1123,1601,562,1039,119,35,84
209074,20,4242,1957,2285,1748,887,861,2494,1070,1424
209083,20,55,15,40,55,15,40,,,
209153,20,26,4,22,26,4,22,,,
209205,20,36,2,34,36,2,34,,,
209241,20,33,33,0,28,28,0,5,5,0
209250,20,6012,3381,2631,1915,851,1064,4097,2530,1567
209287,20,378,216,162,340,203,137,38,13,25
209296,20,12,3,9,12,3,9,,,
209409,20,509,230,279,452,212,240,57,18,39
209490,20,752,129,623,481,83,398,271,46,225
209506,20,4802,2335,2467,2121,1131,990,2681,1204,1477
209542,20,28905,14816,14089,19845,10186,9659,9060,4630,4430
209551,20,19565,8730,10835,18185,8035,10150,1380,695,685
209603,20,376,86,290,359,80,279,17,6,11
209612,20,1639,654,985,1510,615,895,129,39,90
209667,20,58,5,53,58,5,53,,,
209676,20,97,9,88,97,9,88,,,
209694,20,37,7,30,37,7,30,,,
209700,20,208,31,177,208,31,177,,,
209719,20,66,0,66,66,0,66,,,
209746,20,19400,8251,11149,7428,3291,4137,11972,4960,7012
209807,20,16862,7267,9595,11200,4736,6464,5662,2531,3131
209825,20,3390,1228,2162,3309,1190,2119,81,38,43
209922,20,1523,640,883,1492,628,864,31,12,19
209940,20,3423,1402,2021,1216,483,733,2207,919,1288
210146,20,4285,1631,2654,2432,936,1496,1853,695,1158
210155,20,1443,555,888,819,373,446,624,182,442
210234,20,1329,600,729,665,343,322,664,257,407
210270,20,2325,865,1460,768,324,444,1557,541,1016
210304,20,444,167,277,413,155,258,31,12,19
210331,20,818,369,449,663,280,383,155,89,66
210401,20,1367,554,813,1337,541,796,30,13,17
210429,20,3320,1148,2172,2864,987,1877,456,161,295
210438,20,2,2,0,,,,2,2,0
210492,20,272,135,137,255,125,130,17,10,7
210571,20,1298,573,725,1211,540,671,87,33,54
210599,20,838,422,416,838,422,416,,,
210605,20,10467,4861,5606,3420,1652,1768,7047,3209,3838
210669,20,1353,635,718,1322,624,698,31,11,20
210711,20,51,2,49,51,2,49,,,
210739,20,2225,787,1438,1901,691,1210,324,96,228
210748,20,64,2,62,34,0,34,30,2,28
210775,20,2018,738,1280,1670,659,1011,348,79,269
210784,20,156,1,155,131,1,130,25,0,25
211006,20,348,322,26,342,321,21,6,1,5
211024,20,376,192,184,269,131,138,107,61,46
211079,20,1720,630,1090,515,228,287,1205,402,803
211088,20,1870,671,1199,1628,562,1066,242,109,133
211273,20,1409,0,1409,1403,0,1403,6,0,6
211291,20,3747,1797,1950,3733,1796,1937,14,1,13
211307,20,6162,2579,3583,2045,1003,1042,4117,1576,2541
211316,20,98,2,96,72,2,70,26,0,26
211334,20,30,0,30,30,0,30,,,
211343,20,2496,934,1562,954,417,537,1542,517,1025
211352,20,1186,474,712,1102,436,666,84,38,46
211431,20,1247,197,1050,909,151,758,338,46,292
211440,20,7059,3512,3547,6858,3399,3459,201,113,88
211468,20,953,62,891,696,42,654,257,20,237
211477,20,918,324,594,197,92,105,721,232,489
211556,20,1499,415,1084,1192,353,839,307,62,245
211583,20,989,424,565,832,392,440,157,32,125
211608,20,697,232,465,621,215,406,76,17,59
211635,20,78,13,65,78,13,65,,,
211802,20,155,39,116,155,39,116,,,
211893,20,103,61,42,103,61,42,,,
211927,20,7992,3026,4966,1953,926,1027,6039,2100,3939
211981,20,1777,667,1110,1537,623,914,240,44,196
212009,20,2125,882,1243,2095,872,1223,30,10,20
212045,20,198,49,149,196,49,147,2,0,2
212054,20,14021,7164,6857,12870,6688,6182,1151,476,675
212106,20,5095,1870,3225,5016,1830,3186,79,40,39
212115,20,4392,1942,2450,3947,1754,2193,445,188,257
212133,20,1848,669,1179,1281,534,747,567,135,432
212197,20,1737,725,1012,1607,673,934,130,52,78
212230,20,37,2,35,33,2,31,4,0,4
212267,20,87,1,86,50,0,50,37,1,36
212276,20,83,4,79,60,3,57,23,1,22
212294,20,66,1,65,56,1,55,10,0,10
212300,20,67,1,66,61,1,60,6,0,6
212328,20,95,6,89,58,6,52,37,0,37
212337,20,102,4,98,56,1,55,46,3,43
212355,20,141,5,136,92,2,90,49,3,46
212382,20,138,1,137,91,1,90,47,0,47
212391,20,50,4,46,35,3,32,15,1,14
212434,20,136,117,19,136,117,19,,,
212577,20,1990,926,1064,1984,923,1061,6,3,3
212601,20,3091,1284,1807,2533,1061,1472,558,223,335
212656,20,1123,602,521,962,516,446,161,86,75
212674,20,2241,1089,1152,2235,1086,1149,6,3,3
212753,20,86,3,83,51,1,50,35,2,33
212771,20,127,1,126,58,0,58,69,1,68
212805,20,2289,1180,1109,2147,1111,1036,142,69,73
212832,20,1412,416,996,1115,277,838,297,139,158
212869,20,910,167,743,591,124,467,319,43,276
212878,20,12576,4113,8463,3338,1275,2063,9238,2838,6400
212911,20,1421,647,774,1419,646,773,2,1,1
212975,20,94,72,22,94,72,22,,,
212984,20,2155,533,1622,1842,468,1374,313,65,248
212993,20,80,35,45,68,31,37,12,4,8
213011,20,1496,442,1054,998,322,676,498,120,378
213020,20,7038,2769,4269,6148,2315,3833,890,454,436
213163,20,342,47,295,304,45,259,38,2,36
213181,20,350,28,322,301,24,277,49,4,45
213233,20,586,466,120,478,387,91,108,79,29
213251,20,1179,549,630,1144,530,614,35,19,16
213303,20,1060,482,578,812,442,370,248,40,208
213321,20,1671,845,826,1558,802,756,113,43,70
213330,20,31,0,31,31,0,31,,,
213349,20,6497,2823,3674,5937,2589,3348,560,234,326
213358,20,1739,684,1055,677,273,404,1062,411,651
213367,20,2773,965,1808,2000,760,1240,773,205,568
213376,20,1868,753,1115,1382,615,767,486,138,348
213385,20,2729,1364,1365,2712,1355,1357,17,9,8
213400,20,1546,741,805,835,403,432,711,338,373
213455,20,88,3,85,51,3,48,37,0,37
213473,20,90,12,78,54,2,52,36,10,26
213491,20,55,1,54,17,1,16,38,0,38
213507,20,1683,769,914,1587,726,861,96,43,53
213525,20,6242,2265,3977,1922,909,1013,4320,1356,2964
213534,20,311,125,186,300,122,178,11,3,8
213543,20,5624,3039,2585,5557,2999,2558,67,40,27
213570,20,419,60,359,419,60,359,,,
213589,20,299,263,36,264,231,33,35,32,3
213598,20,1712,594,1118,1593,554,1039,119,40,79
213622,20,112,18,94,89,17,72,23,1,22
213659,20,4220,1439,2781,1345,546,799,2875,893,1982
213668,20,1059,502,557,1052,500,552,7,2,5
213774,20,583,165,418,341,93,248,242,72,170
213826,20,1857,592,1265,1710,557,1153,147,35,112
213914,20,215,19,196,215,19,196,,,
213932,20,174,23,151,174,23,151,,,
213987,20,2446,982,1464,2249,934,1315,197,48,149
213996,20,2495,978,1517,2277,899,1378,218,79,139
214023,20,11,3,8,10,2,8,1,1,0
214041,20,5814,2408,3406,4646,1977,2669,1168,431,737
214069,20,1776,592,1184,1385,511,874,391,81,310
214111,20,8596,3454,5142,2540,1241,1299,6056,2213,3843
214148,20,355,0,355,347,0,347,8,0,8
214157,20,1904,740,1164,1789,710,1079,115,30,85
214166,20,2720,916,1804,1040,313,727,1680,603,1077
214175,20,1945,762,1183,1890,737,1153,55,25,30
214272,20,1682,614,1068,1327,486,841,355,128,227
214290,20,628,570,58,628,570,58,,,
214379,20,8484,3155,5329,3018,1352,1666,5466,1803,3663
214476,20,39,7,32,36,6,30,3,1,2
214528,20,227,212,15,163,152,11,64,60,4
214582,20,651,71,580,332,37,295,319,34,285
214591,20,3188,2051,1137,3036,1947,1089,152,104,48
214625,20,460,275,185,391,244,147,69,31,38
214634,20,281,83,198,179,54,125,102,29,73
214643,20,363,236,127,337,218,119,26,18,8
214652,20,875,475,400,824,449,375,51,26,25
214670,20,888,510,378,780,463,317,108,47,61
214689,20,2577,1360,1217,2499,1311,1188,78,49,29
214698,20,522,289,233,487,276,211,35,13,22
214704,20,2071,1229,842,1873,1130,743,198,99,99
214713,20,4063,2514,1549,3788,2335,1453,275,179,96
214731,20,1196,729,467,1095,665,430,101,64,37
214740,20,366,204,162,306,185,121,60,19,41
214759,20,424,192,232,396,175,221,28,17,11
214768,20,473,253,220,452,243,209,21,10,11
214777,20,41745,22183,19562,40528,21368,19160,1217,815,402
214786,20,363,223,140,338,211,127,25,12,13
214795,20,670,275,395,574,232,342,96,43,53
214801,20,3090,1811,1279,2823,1657,1166,267,154,113
214810,20,623,228,395,553,204,349,70,24,46
214829,20,711,459,252,581,381,200,130,78,52
214883,20,762,183,579,163,38,125,599,145,454
214892,20,243,101,142,243,101,142,,,
214944,20,515,451,64,377,337,40,138,114,24
214971,20,114,36,78,110,35,75,4,1,3
215008,20,52,51,1,52,51,1,,,
215044,20,145,20,125,145,20,125,,,
215053,20,245,69,176,224,62,162,21,7,14
215062,20,11250,5044,6206,10412,4718,5694,838,326,512
215105,20,1170,402,768,1140,391,749,30,11,19
215114,20,820,400,420,759,367,392,61,33,28
215239,20,11636,3832,7804,3807,1445,2362,7829,2387,5442
215266,20,1074,490,584,1014,473,541,60,17,43
215275,20,1328,556,772,1268,522,746,60,34,26
215284,20,2043,1156,887,1996,1131,865,47,25,22
215293,20,24420,10356,14064,19291,8149,11142,5129,2207,2922
215309,20,23,3,20,14,2,12,9,1,8
215336,20,24,1,23,24,1,23,,,
215381,20,541,503,38,541,503,38,,,
215390,20,372,102,270,91,24,67,281,78,203
215415,20,1066,669,397,887,568,319,179,101,78
215442,20,2418,875,1543,2199,777,1422,219,98,121
215479,20,64,9,55,64,9,55,,,
215530,20,40,0,40,36,0,36,4,0,4
215585,20,4533,1586,2947,919,406,513,3614,1180,2434
215594,20,259,41,218,194,33,161,65,8,57
215637,20,168,75,93,168,75,93,,,
215655,20,2767,1528,1239,2584,1439,1145,183,89,94
215682,20,417,387,30,417,387,30,,,
215691,20,446,212,234,347,178,169,99,34,65
215743,20,2461,929,1532,1490,560,930,971,369,602
215770,20,5071,2303,2768,4809,2174,2635,262,129,133
215798,20,1359,783,576,1318,763,555,41,20,21
215886,20,33,10,23,16,6,10,17,4,13
215929,20,3593,1546,2047,3445,1464,1981,148,82,66
215947,20,1627,560,1067,1489,525,964,138,35,103
215974,20,422,60,362,315,42,273,107,18,89
215983,20,23,5,18,23,5,18,,,
215992,20,118,46,72,117,46,71,1,0,1
216010,20,4443,2152,2291,3987,1956,2031,456,196,260
216038,20,6757,2997,3760,6326,2790,3536,431,207,224
216047,20,32,32,0,32,32,0,,,
216074,20,89,2,87,56,2,54,33,0,33
216083,20,272,97,175,248,95,153,24,2,22
216162,20,337,27,310,337,27,310,,,
216223,20,40,3,37,40,3,37,,,
216278,20,2224,948,1276,2133,905,1228,91,43,48
216287,20,1625,790,835,1625,790,835,,,
216296,20,1312,1189,123,1282,1162,120,30,27,3
216311,20,123,123,0,123,123,0,,,
216339,20,24106,10635,13471,22026,9574,12452,2080,1061,1019
216357,20,804,403,401,780,393,387,24,10,14
216366,20,3771,967,2804,3334,864,2470,437,103,334
216436,20,105,93,12,105,93,12,,,
216445,20,101,96,5,101,96,5,,,
216454,20,73,66,7,73,66,7,,,
216524,20,1527,793,734,1502,778,724,25,15,10
216542,20,508,238,270,445,216,229,63,22,41
216551,20,84,67,17,82,65,17,2,2,0
216579,20,93,4,89,93,4,89,,,
216597,20,6989,3235,3754,6756,3100,3656,233,135,98
216630,20,33,4,29,33,4,29,,,
216667,20,1149,602,547,1138,594,544,11,8,3
216694,20,1116,484,632,1055,461,594,61,23,38
216746,20,52,46,6,41,36,5,11,10,1
216764,20,14392,5858,8534,12586,5146,7440,1806,712,1094
216773,20,106,15,91,106,15,91,,,
216807,20,1161,512,649,1018,479,539,143,33,110
216825,20,4171,1427,2744,1340,522,818,2831,905,1926
216852,20,2555,1061,1494,2339,997,1342,216,64,152
216931,20,2000,935,1065,1807,855,952,193,80,113
216940,20,278,278,0,278,278,0,,,
217013,20,966,231,735,582,136,446,384,95,289
217040,20,35,35,0,35,35,0,,,
217059,20,3335,1455,1880,2962,1263,1699,373,192,181
217077,20,551,194,357,551,194,357,,,
217156,20,7639,3675,3964,7189,3538,3651,450,137,313
217165,20,3204,2043,1161,3180,2025,1155,24,18,6
217235,20,4158,1610,2548,3955,1513,2442,203,97,106
217305,20,1720,1054,666,1537,961,576,183,93,90
217323,20,276,267,9,276,267,9,,,
217402,20,3996,1841,2155,3830,1761,2069,166,80,86
217420,20,4719,1461,3258,3701,1159,2542,1018,302,716
217475,20,12263,4800,7463,4964,2202,2762,7299,2598,4701
217484,20,14768,6312,8456,12931,5490,7441,1837,822,1015
217493,20,2108,691,1417,2108,691,1417,,,
217518,20,4103,2058,2045,3701,1828,1873,402,230,172
217536,20,2190,679,1511,2128,662,1466,62,17,45
217581,20,135,1,134,91,1,90,44,0,44
217606,20,182,92,90,134,65,69,48,27,21
217615,20,2121,748,1373,699,269,430,1422,479,943
217624,20,603,344,259,576,331,245,27,13,14
217633,20,3237,1068,2169,2857,947,1910,380,121,259
217688,20,2836,1037,1799,2583,928,1655,253,109,144
217712,20,2196,646,1550,458,169,289,1738,477,1261
217721,20,1796,799,997,1708,756,952,88,43,45
217749,20,2665,1206,1459,2265,1037,1228,400,169,231
217776,20,896,337,559,641,260,381,255,77,178
217794,20,101,1,100,65,1,64,36,0,36
217819,20,9972,3281,6691,9185,2956,6229,787,325,462
217828,20,43,2,41,28,1,27,15,1,14
217837,20,1466,425,1041,240,80,160,1226,345,881
217864,20,2695,2297,398,2469,2137,332,226,160,66
217873,20,1749,548,1201,1618,493,1125,131,55,76
217882,20,22566,10717,11849,21741,10236,11505,825,481,344
217891,20,197,86,111,192,84,108,5,2,3
217907,20,1060,487,573,747,329,418,313,158,155
217925,20,1001,481,520,564,298,266,437,183,254
217934,20,1173,188,985,790,128,662,383,60,323
217961,20,804,169,635,781,168,613,23,1,22
217989,20,725,298,427,327,151,176,398,147,251
217998,20,817,540,277,764,501,263,53,39,14
218025,20,2940,1087,1853,1112,519,593,1828,568,1260
218061,20,3635,1257,2378,2583,896,1687,1052,361,691
218070,20,2283,944,1339,2264,930,1334,19,14,5
218113,20,11380,4584,6796,4192,1823,2369,7188,2761,4427
218140,20,8137,2816,5321,3575,1488,2087,4562,1328,3234
218159,20,113,4,109,83,3,80,30,1,29
218195,20,124,5,119,74,4,70,50,1,49
218229,20,3562,1150,2412,3197,1033,2164,365,117,248
218238,20,1602,781,821,1314,676,638,288,105,183
218335,20,300,32,268,290,31,259,10,1,9
218353,20,9091,3392,5699,3669,1644,2025,5422,1748,3674
218399,20,384,182,202,380,178,202,4,4,0
218414,20,1296,715,581,1264,704,560,32,11,21
218441,20,1839,846,993,1574,761,813,265,85,180
218487,20,2012,590,1422,563,214,349,1449,376,1073
218520,20,5315,1664,3651,1733,639,1094,3582,1025,2557
218539,20,955,461,494,893,444,449,62,17,45
218645,20,3145,1148,1997,2452,931,1521,693,217,476
218654,20,2053,661,1392,1665,532,1133,388,129,259
218663,20,27343,11975,15368,26242,11394,14848,1101,581,520
218672,20,1772,717,1055,675,280,395,1097,437,660
218681,20,745,299,446,285,140,145,460,159,301
218690,20,1537,677,860,498,243,255,1039,434,605
218706,20,1098,497,601,294,146,148,804,351,453
218724,20,9794,4417,5377,9015,4012,5003,779,405,374
218733,20,2374,1094,1280,2114,965,1149,260,129,131
218742,20,4481,1482,2999,3585,1166,2419,896,316,580
218821,20,1064,488,576,958,441,517,106,47,59
218830,20,6224,2412,3812,2477,1056,1421,3747,1356,2391
218858,20,3314,974,2340,902,368,534,2412,606,1806
218885,20,5629,2640,2989,3154,1660,1494,2475,980,1495
218894,20,11789,4473,7316,3969,1640,2329,7820,2833,4987
218919,20,473,211,262,418,184,234,55,27,28
218955,20,673,224,449,116,29,87,557,195,362
218964,20,3741,1263,2478,3179,1065,2114,562,198,364
218973,20,1823,870,953,1807,860,947,16,10,6
218991,20,4521,1862,2659,1904,857,1047,2617,1005,1612
219000,20,1831,696,1135,1742,652,1090,89,44,45
219037,20,62,1,61,57,0,57,5,1,4
219046,20,3261,1193,2068,1602,548,1054,1659,645,1014
219082,20,2757,1722,1035,1396,995,401,1361,727,634
219091,20,723,339,384,580,303,277,143,36,107
219125,20,76,4,72,65,2,63,11,2,9
219143,20,2238,1122,1116,1526,881,645,712,241,471
219170,20,23,3,20,23,3,20,,,
219189,20,1203,782,421,861,603,258,342,179,163
219198,20,1080,523,557,617,313,304,463,210,253
219204,20,929,431,498,98,60,38,831,371,460
219240,20,38,19,19,11,5,6,27,14,13
219259,20,2851,1113,1738,1057,453,604,1794,660,1134
219277,20,1147,336,811,486,164,322,661,172,489
219295,20,600,228,372,393,203,190,207,25,182
219338,20,15,3,12,15,3,12,,,
219347,20,2163,1647,516,1727,1353,374,436,294,142
219356,20,9917,4407,5510,7607,3569,4038,2310,838,1472
219374,20,482,115,367,156,38,118,326,77,249
219383,20,1325,504,821,1172,434,738,153,70,83
219392,20,27,4,23,27,4,23,,,
219408,20,187,74,113,105,49,56,82,25,57
219426,20,2453,1136,1317,1285,754,531,1168,382,786
219453,20,125,1,124,125,1,124,,,
219471,20,7132,2570,4562,4544,1633,2911,2588,937,1651
219480,20,1267,551,716,533,279,254,734,272,462
219505,20,53,34,19,37,24,13,16,10,6
219587,20,70,0,70,70,0,70,,,
219596,20,221,162,59,221,162,59,,,
219602,20,8120,3306,4814,5326,2111,3215,2794,1195,1599
219639,20,777,67,710,303,30,273,474,37,437
219709,20,7384,2482,4902,7100,2352,4748,284,130,154
219718,20,4038,1915,2123,2382,1281,1101,1656,634,1022
219790,20,1482,713,769,774,395,379,708,318,390
219806,20,1519,668,851,1408,616,792,111,52,59
219824,20,6429,2373,4056,3021,1166,1855,3408,1207,2201
219833,20,1253,565,688,1002,448,554,251,117,134
219842,20,132,75,57,,,,132,75,57
219851,20,59,2,57,59,2,57,,,
219879,20,3180,1379,1801,1541,682,859,1639,697,942
219888,20,4954,1867,3087,2526,1048,1478,2428,819,1609
219903,20,1317,116,1201,1317,116,1201,,,
219921,20,396,264,132,177,101,76,219,163,56
219949,20,2311,972,1339,1870,803,1067,441,169,272
219976,20,2955,1152,1803,2791,1088,1703,164,64,100
219994,20,982,662,320,619,378,241,363,284,79
220002,20,33,5,28,33,5,28,,,
220057,20,2683,834,1849,1188,428,760,1495,406,1089
220075,20,10554,4091,6463,8480,3333,5147,2074,758,1316
220118,20,220,13,207,220,13,207,,,
220127,20,495,306,189,412,228,184,83,78,5
220163,20,72,2,70,53,2,51,19,0,19
220181,20,1009,332,677,983,323,660,26,9,17
220206,20,345,175,170,197,105,92,148,70,78
220215,20,1850,815,1035,1351,613,738,499,202,297
220251,20,579,348,231,161,104,57,418,244,174
220279,20,643,449,194,196,136,60,447,313,134
220321,20,912,423,489,300,162,138,612,261,351
220394,20,328,213,115,233,144,89,95,69,26
220400,20,3442,1043,2399,1292,428,864,2150,615,1535
220464,20,196,76,120,59,22,37,137,54,83
220473,20,669,314,355,605,280,325,64,34,30
220491,20,261,8,253,181,6,175,80,2,78
220516,20,1120,412,708,978,370,608,142,42,100
220552,20,4906,673,4233,3383,474,2909,1523,199,1324
220598,20,1010,566,444,954,539,415,56,27,29
220604,20,609,215,394,534,187,347,75,28,47
220613,20,3446,1341,2105,2673,997,1676,773,344,429
220631,20,1560,464,1096,1206,401,805,354,63,291
220640,20,1417,899,518,313,159,154,1104,740,364
220701,20,896,363,533,749,313,436,147,50,97
220710,20,1065,485,580,974,444,530,91,41,50
220756,20,134,121,13,98,87,11,36,34,2
220765,20,346,82,264,181,46,135,165,36,129
220853,20,1547,1035,512,853,580,273,694,455,239
220862,20,16708,6554,10154,10954,4385,6569,5754,2169,3585
220978,20,17438,8137,9301,13884,6573,7311,3554,1564,1990
221050,20,859,640,219,518,359,159,341,281,60
221096,20,5636,2088,3548,2876,1199,1677,2760,889,1871
221102,20,337,271,66,215,176,39,122,95,27
221148,20,1053,968,85,1053,968,85,,,
221184,20,6617,2447,4170,2718,1120,1598,3899,1327,2572
221236,20,444,316,128,216,154,62,228,162,66
221281,20,248,123,125,164,74,90,84,49,35
221333,20,565,437,128,183,111,72,382,326,56
221351,20,1996,827,1169,1943,813,1130,53,14,39
221388,20,362,229,133,137,40,97,225,189,36
221397,20,4457,1528,2929,2179,863,1316,2278,665,1613
221430,20,1411,942,469,242,168,74,1169,774,395
221485,20,6443,2281,4162,2547,966,1581,3896,1315,2581
221494,20,550,444,106,371,298,73,179,146,33
221519,20,1613,762,851,1590,752,838,23,10,13
221582,20,439,328,111,138,97,41,301,231,70
221591,20,495,354,141,309,209,100,186,145,41
221607,20,577,445,132,192,118,74,385,327,58
221616,20,2239,1413,826,502,351,151,1737,1062,675
221625,20,1157,743,414,736,464,272,421,279,142
221643,20,8452,3964,4488,4004,2022,1982,4448,1942,2506
221661,20,2571,1164,1407,2185,1023,1162,386,141,245
221731,20,929,361,568,834,322,512,95,39,56
221740,20,9884,4173,5711,8883,3690,5193,1001,483,518
221759,20,27039,12331,14708,25825,11690,14135,1214,641,573
221768,20,6165,2325,3840,4273,1633,2640,1892,692,1200
221829,20,342,12,330,342,12,330,,,
221838,20,7678,2620,5058,6686,2257,4429,992,363,629
221847,20,8537,4629,3908,7728,4214,3514,809,415,394
221892,20,1867,727,1140,1419,564,855,448,163,285
221908,20,5100,2388,2712,2607,1138,1469,2493,1250,1243
221953,20,1111,545,566,888,469,419,223,76,147
221971,20,1900,704,1196,1543,557,986,357,147,210
221999,20,7151,3443,3708,7082,3403,3679,69,40,29
222053,20,6957,2628,4329,3516,1422,2094,3441,1206,2235
222062,20,5477,1959,3518,2603,1027,1576,2874,932,1942
222105,20,361,337,24,172,165,7,189,172,17
222178,20,3211,1224,1987,3064,1163,1901,147,61,86
222567,20,5411,2239,3172,952,427,525,4459,1812,2647
222576,20,8988,3219,5769,3442,1390,2052,5546,1829,3717
222628,20,118,41,77,26,7,19,92,34,58
222822,20,4002,1433,2569,1444,525,919,2558,908,1650
222831,20,9066,3776,5290,4893,2036,2857,4173,1740,2433
222877,20,216,136,80,214,135,79,2,1,1
222886,20,375,23,352,373,23,350,2,0,2
222938,20,317,148,169,212,102,110,105,46,59
222983,20,1167,580,587,1164,577,587,3,3,0
222992,20,34527,14777,19750,7843,3817,4026,26684,10960,15724
223056,20,44,0,44,44,0,44,,,
223083,20,467,67,400,128,24,104,339,43,296
223117,20,59,46,13,8,6,2,51,40,11
223232,20,15213,6153,9060,14918,6024,8894,295,129,166
223320,20,3899,1381,2518,824,296,528,3075,1085,1990
223427,20,17909,8879,9030,8779,4562,4217,9130,4317,4813
223463,20,302,67,235,302,67,235,,,
223472,20,175,16,159,175,16,159,,,
223506,20,4044,1856,2188,793,359,434,3251,1497,1754
223816,20,8326,3577,4749,1641,659,982,6685,2918,3767
223852,20,22,1,21,22,1,21,,,
223898,20,2877,1066,1811,1048,407,641,1829,659,1170
223922,20,1371,611,760,556,256,300,815,355,460
224004,20,1573,485,1088,1334,426,908,239,59,180
224013,20,38,2,36,38,2,36,,,
224110,20,7360,3119,4241,1812,801,1011,5548,2318,3230
224147,20,7824,3093,4731,6012,2360,3652,1812,733,1079
224156,20,275,6,269,202,4,198,73,2,71
224226,20,2971,1231,1740,2313,954,1359,658,277,381
224244,20,247,151,96,220,138,82,27,13,14
224271,20,776,189,587,772,185,587,4,4,0
224323,20,1453,641,812,1427,631,796,26,10,16
224350,20,9725,4048,5677,1371,639,732,8354,3409,4945
224527,20,1579,733,846,1232,614,618,347,119,228
224545,20,1761,686,1075,1361,560,801,400,126,274
224554,20,7383,2946,4437,5358,2120,3238,2025,826,1199
224615,20,64156,26171,37985,14830,6752,8078,49326,19419,29907
224642,20,24398,10349,14049,6847,3058,3789,17551,7291,10260
224660,20,608,308,300,484,256,228,124,52,72
224679,20,1328,1140,188,707,588,119,621,552,69
224758,20,28,1,27,25,0,25,3,1,2
224776,20,263,122,141,173,82,91,90,40,50
224828,20,72,1,71,48,1,47,24,0,24
224891,20,1634,707,927,594,238,356,1040,469,571
224961,20,2026,689,1337,656,267,389,1370,422,948
225043,20,11,10,1,11,10,1,,,
225070,20,3938,1497,2441,1323,507,816,2615,990,1625
225201,20,792,513,279,792,513,279,,,
225247,20,1347,643,704,1263,606,657,84,37,47
225308,20,5362,2119,3243,1580,612,968,3782,1507,2275
225371,20,3689,1434,2255,1037,455,582,2652,979,1673
225399,20,2823,1045,1778,2153,826,1327,670,219,451
225414,20,6352,2351,4001,3198,1221,1977,3154,1130,2024
225423,20,48159,19467,28692,13857,6041,7816,34302,13426,20876
225432,20,12856,4766,8090,6143,2394,3749,6713,2372,4341
225502,20,2845,1026,1819,1277,515,762,1568,511,1057
225511,20,37943,18290,19653,27320,12716,14604,10623,5574,5049
225520,20,4264,1727,2537,995,337,658,3269,1390,1879
225548,20,773,415,358,659,365,294,114,50,64
225575,20,991,429,562,939,410,529,52,19,33
225627,20,4724,1682,3042,3992,1398,2594,732,284,448
225876,20,471,199,272,192,104,88,279,95,184
225885,20,729,340,389,632,303,329,97,37,60
225991,20,102,57,45,102,57,45,,,
226019,20,5189,2064,3125,1971,826,1145,3218,1238,1980
226091,20,8264,3367,4897,6162,2476,3686,2102,891,1211
226107,20,2682,892,1790,798,260,538,1884,632,1252
226116,20,2600,962,1638,714,254,460,1886,708,1178
226125,20,122,6,116,122,6,116,,,
226134,20,9317,3956,5361,2104,893,1211,7213,3063,4150
226152,20,6979,2667,4312,5321,2053,3268,1658,614,1044
226204,20,7807,3916,3891,1014,546,468,6793,3370,3423
226231,20,3350,1793,1557,1376,900,476,1974,893,1081
226277,20,1212,1115,97,1212,1115,97,,,
226383,20,1346,513,833,1135,425,710,211,88,123
226408,20,4482,1754,2728,1115,478,637,3367,1276,2091
226471,20,3072,1094,1978,2823,997,1826,249,97,152
226578,20,6942,2242,4700,2243,778,1465,4699,1464,3235
226587,20,1231,653,578,1016,554,462,215,99,116
226675,20,336,47,289,336,47,289,,,
226806,20,5404,2201,3203,1504,590,914,3900,1611,2289
226833,20,4818,1790,3028,3333,1285,2048,1485,505,980
226860,20,39,2,37,39,2,37,,,
226879,20,157,21,136,62,9,53,95,12,83
226903,20,1070,429,641,1070,429,641,,,
227058,20,57,0,57,57,0,57,,,
227146,20,6277,2427,3850,2314,1014,1300,3963,1413,2550
227182,20,68415,28040,40375,18795,8560,10235,49620,19480,30140
227216,20,33023,15129,17894,26003,11755,14248,7020,3374,3646
227225,20,3029,1096,1933,1162,397,765,1867,699,1168
227298,20,176,165,11,176,165,11,,,
227304,20,7995,3242,4753,2635,969,1666,5360,2273,3087
227313,20,324,6,318,145,4,141,179,2,177
227322,20,446,6,440,202,4,198,244,2,242
227331,20,1195,397,798,1037,362,675,158,35,123
227368,20,26434,10766,15668,19660,7779,11881,6774,2987,3787
227377,20,7648,3189,4459,1676,782,894,5972,2407,3565
227386,20,2386,802,1584,920,326,594,1466,476,990
227401,20,4427,1669,2758,1463,597,866,2964,1072,1892
227429,20,938,301,637,320,144,176,618,157,461
227526,20,8103,2613,5490,7163,2266,4897,940,347,593
227687,20,2297,1077,1220,733,380,353,1564,697,867
227748,20,250,234,16,172,161,11,78,73,5
227757,20,4494,2297,2197,4393,2241,2152,101,56,45
227845,20,2769,1055,1714,2616,992,1624,153,63,90
227854,20,12653,5321,7332,1756,866,890,10897,4455,6442
227863,20,2646,1136,1510,2165,820,1345,481,316,165
227881,20,18235,6660,11575,14573,5306,9267,3662,1354,2308
227924,20,18233,6929,11304,3854,1530,2324,14379,5399,8980
227979,20,30593,12525,18068,9309,3965,5344,21284,8560,12724
228042,20,1098,478,620,1028,460,568,70,18,52
228088,20,50,0,50,50,0,50,,,
228149,20,2001,796,1205,1935,767,1168,66,29,37
228158,20,8580,3481,5099,3869,1723,2146,4711,1758,2953
228185,20,18,14,4,18,14,4,,,
228200,20,409,182,227,383,170,213,26,12,14
228219,20,482,194,288,475,193,282,7,1,6
228246,20,7056,3478,3578,6880,3383,3497,176,95,81
228282,20,18,4,14,18,4,14,,,
228316,20,6278,2600,3678,1970,769,1201,4308,1831,2477
228325,20,1491,732,759,1282,649,633,209,83,126
228343,20,1483,685,798,1465,677,788,18,8,10
228431,20,9905,3654,6251,7855,2881,4974,2050,773,1277
228459,20,33834,13586,20248,27759,10984,16775,6075,2602,3473
228468,20,786,319,467,594,244,350,192,75,117
228486,20,88,54,34,79,50,29,9,4,5
228501,20,1550,650,900,918,479,439,632,171,461
228529,20,11880,4370,7510,8745,3128,5617,3135,1242,1893
228547,20,40131,16816,23315,7274,3426,3848,32857,13390,19467
228608,20,4602,1536,3066,1706,595,1111,2896,941,1955
228644,20,785,222,563,672,169,503,113,53,60
228653,20,585,105,480,439,75,364,146,30,116
228699,20,3800,1431,2369,977,381,596,2823,1050,1773
228705,20,4847,2391,2456,3912,1956,1956,935,435,500
228723,20,57512,30675,26837,51150,26971,24179,6362,3704,2658
228769,20,30791,12264,18527,18902,8358,10544,11889,3906,7983
228778,20,41309,17610,23699,38591,16248,22343,2718,1362,1356
228787,20,21617,12196,9421,17969,10006,7963,3648,2190,1458
228796,20,20165,9036,11129,13683,6054,7629,6482,2982,3500
228802,20,6971,2672,4299,4602,1806,2796,2369,866,1503
228875,20,10523,4033,6490,10326,3939,6387,197,94,103
228884,20,642,382,260,592,357,235,50,25,25
228909,20,5,3,2,,,,5,3,2
228981,20,1329,635,694,1265,604,661,64,31,33
229018,20,4640,1796,2844,3079,1187,1892,1561,609,952
229027,20,29686,14190,15496,21871,10155,11716,7815,4035,3780
229063,20,6830,2383,4447,5684,1967,3717,1146,416,730
229115,20,32579,16548,16031,29133,14731,14402,3446,1817,1629
229160,20,1879,868,1011,1415,686,729,464,182,282
229179,20,10153,1262,8891,6622,538,6084,3531,724,2807
229267,20,2512,1166,1346,2471,1151,1320,41,15,26
229300,20,554,75,479,473,67,406,81,8,73
229337,20,1448,191,1257,1243,158,1085,205,33,172
229355,20,11901,4428,7473,4933,1981,2952,6968,2447,4521
229416,20,1845,1752,93,1845,1752,93,,,
229425,20,124,4,120,40,1,39,84,3,81
229504,20,2249,808,1441,625,273,352,1624,535,1089
229522,20,94,8,86,78,5,73,16,3,13
229540,20,3064,979,2085,748,327,421,2316,652,1664
229656,20,305,11,294,133,4,129,172,7,165
229780,20,2275,1086,1189,1303,647,656,972,439,533
229799,20,5445,1973,3472,1617,619,998,3828,1354,2474
229814,20,6901,2849,4052,5316,2173,3143,1585,676,909
229832,20,1392,705,687,465,246,219,927,459,468
229841,20,5495,2310,3185,2275,1091,1184,3220,1219,2001
229887,20,698,343,355,652,333,319,46,10,36
230010,20,1379,856,523,507,267,240,872,589,283
230038,20,31411,15082,16329,28254,13555,14699,3157,1527,1630
230047,20,2735,1108,1627,2594,1055,1539,141,53,88
230065,20,298,6,292,108,4,104,190,2,188
230144,20,88,1,87,88,1,87,,,
230162,20,3518,2258,1260,473,208,265,3045,2050,995
230171,20,12481,5267,7214,7340,2946,4394,5141,2321,2820
230199,20,69,4,65,69,4,65,,,
230205,20,66,5,61,50,2,48,16,3,13
230214,20,328,47,281,110,10,100,218,37,181
230366,20,261,28,233,261,28,233,,,
230418,20,4058,1881,2177,1158,614,544,2900,1267,1633
230490,20,3043,1857,1186,323,101,222,2720,1756,964
230597,20,5997,2739,3258,3479,1625,1854,2518,1114,1404
230603,20,12649,5070,7579,8085,3442,4643,4564,1628,2936
230676,20,1242,856,386,114,64,50,1128,792,336
230728,20,24835,11026,13809,16707,7621,9086,8128,3405,4723
230737,20,42296,21022,21274,18667,9692,8975,23629,11330,12299
230746,20,26300,11979,14321,5644,2697,2947,20656,9282,11374
230764,20,26355,13605,12750,21291,11035,10256,5064,2570,2494
230782,20,28903,12786,16117,11548,5019,6529,17355,7767,9588
230807,20,961,380,581,921,358,563,40,22,18
230816,20,777,258,519,712,218,494,65,40,25
230834,20,1728,787,941,1461,684,777,267,103,164
230852,20,3060,1890,1170,2256,1400,856,804,490,314
230861,20,5596,1622,3974,787,269,518,4809,1353,3456
230889,20,112,35,77,91,29,62,21,6,15
230913,20,1482,537,945,955,392,563,527,145,382
230959,20,2773,1293,1480,2748,1284,1464,25,9,16
230995,20,2799,2025,774,2299,1605,694,500,420,80
231004,20,70,2,68,70,2,68,,,
231059,20,1209,570,639,1193,559,634,16,11,5
231068,20,542,124,418,534,124,410,8,0,8
231095,20,101,41,60,85,32,53,16,9,7
231165,20,1412,691,721,744,392,352,668,299,369
231174,20,11898,4323,7575,11150,4034,7116,748,289,459
231280,20,106,3,103,83,3,80,23,0,23
231411,20,459,408,51,459,408,51,,,
231420,20,1140,598,542,1022,547,475,118,51,67
231536,20,3562,1437,2125,1085,482,603,2477,955,1522
231554,20,705,371,334,626,341,285,79,30,49
231581,20,1385,666,719,1380,664,716,5,2,3
231624,20,6797,2835,3962,6716,2795,3921,81,40,41
231651,20,4541,1742,2799,2382,947,1435,2159,795,1364
231688,20,21,2,19,12,1,11,9,1,8
231697,20,3388,1395,1993,1042,437,605,2346,958,1388
231712,20,4449,2067,2382,4347,2012,2335,102,55,47
231785,20,1281,251,1030,705,205,500,576,46,530
231873,20,946,397,549,283,137,146,663,260,403
231882,20,2274,961,1313,897,430,467,1377,531,846
232016,20,109,40,69,73,34,39,36,6,30
232025,20,1082,532,550,1058,520,538,24,12,12
232043,20,892,373,519,783,318,465,109,55,54
232052,20,658,275,383,170,57,113,488,218,270
232089,20,835,493,342,754,456,298,81,37,44
232186,20,27014,13798,13216,21512,10868,10644,5502,2930,2572
232195,20,7688,2815,4873,2165,902,1263,5523,1913,3610
232256,20,846,843,3,838,835,3,8,8,0
232265,20,2846,985,1861,2648,874,1774,198,111,87
232308,20,691,0,691,690,0,690,1,0,1
232414,20,7527,2960,4567,2352,1033,1319,5175,1927,3248
232423,20,20346,8741,11605,18937,8080,10857,1409,661,748
232450,20,8792,3672,5120,1975,894,1081,6817,2778,4039
232557,20,48906,21351,27555,31034,13140,17894,17872,8211,9661
232566,20,3154,961,2193,2871,878,1993,283,83,200
232575,20,5720,2155,3565,1745,763,982,3975,1392,2583
232609,20,1589,589,1000,1511,567,944,78,22,56
232618,20,227,30,197,26,1,25,201,29,172
232672,20,1314,292,1022,1088,258,830,226,34,192
232681,20,3493,1298,2195,2982,1123,1859,511,175,336
232706,20,2275,1011,1264,1644,581,1063,631,430,201
232724,20,23,1,22,23,1,22,,,
232788,20,1928,718,1210,822,332,490,1106,386,720
232797,20,950,123,827,300,50,250,650,73,577
232867,20,3980,2032,1948,1372,742,630,2608,1290,1318
232885,20,286,19,267,227,11,216,59,8,51
232919,20,454,395,59,371,321,50,83,74,9
232937,20,5337,1740,3597,4618,1524,3094,719,216,503
232946,20,51896,24984,26912,13327,6928,6399,38569,18056,20513
232982,20,18375,8281,10094,13896,6277,7619,4479,2004,2475
233019,20,1861,785,1076,1048,476,572,813,309,504
233037,20,1188,411,777,303,125,178,885,286,599
233082,20,103,8,95,8,1,7,95,7,88
233116,20,5022,2139,2883,998,457,541,4024,1682,2342
233277,20,6008,2263,3745,5488,2071,3417,520,192,328
233286,20,116,18,98,99,17,82,17,1,16
233295,20,1490,677,813,1450,653,797,40,24,16
233301,20,478,188,290,461,179,282,17,9,8
233310,20,2591,931,1660,634,252,382,1957,679,1278
233329,20,410,31,379,410,31,379,,,
233338,20,2051,871,1180,720,323,397,1331,548,783
233356,20,481,39,442,382,29,353,99,10,89
233374,20,3145,1451,1694,3019,1397,1622,126,54,72
233408,20,338,41,297,271,38,233,67,3,64
233426,20,1826,840,986,1759,802,957,67,38,29
233480,20,27,6,21,27,6,21,,,
233541,20,2461,949,1512,2040,853,1187,421,96,325
233602,20,74,45,29,65,39,26,9,6,3
233611,20,1053,554,499,1010,531,479,43,23,20
233639,20,3112,1059,2053,942,281,661,2170,778,1392
233648,20,2163,805,1358,1021,417,604,1142,388,754
233666,20,22,1,21,17,1,16,5,0,5
233684,20,2198,745,1453,403,255,148,1795,490,1305
233718,20,457,0,457,450,0,450,7,0,7
233754,20,6018,2465,3553,1779,820,959,4239,1645,2594
233772,20,16195,6669,9526,4898,2063,2835,11297,4606,6691
233897,20,1704,686,1018,1054,511,543,650,175,475
233903,20,2068,783,1285,740,316,424,1328,467,861
233921,20,30434,17378,13056,29569,16805,12764,865,573,292
233949,20,5860,2513,3347,1627,722,905,4233,1791,2442
234030,20,20958,7679,13279,18265,6545,11720,2693,1134,1559
234076,20,17444,7681,9763,16523,7229,9294,921,452,469
234085,20,1512,1310,202,1512,1310,202,,,
234119,20,116,45,71,82,29,53,34,16,18
234137,20,479,213,266,400,151,249,79,62,17
234155,20,4300,1737,2563,4087,1654,2433,213,83,130
234164,20,1329,656,673,1075,545,530,254,111,143
234173,20,1479,652,827,1095,455,640,384,197,187
234207,20,1867,916,951,1859,911,948,8,5,3
234377,20,2116,799,1317,708,233,475,1408,566,842
234669,20,10617,4668,5949,5547,2581,2966,5070,2087,2983
234696,20,1632,821,811,1056,599,457,576,222,354
234711,20,1736,729,1007,1203,516,687,533,213,320
234827,20,8743,4131,4612,7619,3625,3994,1124,506,618
234845,20,2277,888,1389,1288,513,775,989,375,614
234915,20,1274,517,757,151,63,88,1123,454,669
234924,20,261,30,231,261,30,231,,,
234933,20,6593,2610,3983,3528,1423,2105,3065,1187,1878
234951,20,2788,1052,1736,1594,691,903,1194,361,833
234979,20,6192,2808,3384,3424,1399,2025,2768,1409,1359
235024,20,443,156,287,408,147,261,35,9,26
235088,20,231,219,12,231,219,12,,,
235097,20,7604,3302,4302,6683,2870,3813,921,432,489
235103,20,5753,2590,3163,2541,1267,1274,3212,1323,1889
235149,20,6054,2607,3447,3017,1354,1663,3037,1253,1784
235167,20,1851,710,1141,1651,631,1020,200,79,121
235237,20,8635,3243,5392,4496,1675,2821,4139,1568,2571
235307,20,100,5,95,100,5,95,,,
235316,20,5084,2346,2738,4998,2298,2700,86,48,38
235334,20,1475,657,818,962,433,529,513,224,289
235343,20,6252,2898,3354,3769,1818,1951,2483,1080,1403
235352,20,88,13,75,88,13,75,,,
235422,20,796,198,598,708,176,532,88,22,66
235431,20,4684,1720,2964,2570,978,1592,2114,742,1372
235501,20,133,57,76,133,57,76,,,
235547,20,74,10,64,43,5,38,31,5,26
235583,20,35,0,35,35,0,35,,,
235671,20,4133,2515,1618,2108,1435,673,2025,1080,945
235699,20,3150,1296,1854,1526,760,766,1624,536,1088
235750,20,2435,749,1686,1234,410,824,1201,339,862
236018,20,39,4,35,39,4,35,,,
236072,20,4675,1749,2926,1462,713,749,3213,1036,2177
236133,20,720,251,469,702,243,459,18,8,10
236188,20,4905,2142,2763,2900,1235,1665,2005,907,1098
236212,20,879,740,139,879,740,139,,,
236230,20,2301,854,1447,2192,800,1392,109,54,55
236258,20,1583,544,1039,766,265,501,817,279,538
236328,20,1712,727,985,1674,712,962,38,15,23
236382,20,3072,2102,970,964,492,472,2108,1610,498
236452,20,1365,550,815,1267,503,764,98,47,51
236504,20,4901,3621,1280,1341,807,534,3560,2814,746
236513,20,4476,1900,2576,2750,1197,1553,1726,703,1023
236577,20,2432,796,1636,2332,750,1582,100,46,54
236595,20,4046,1588,2458,3874,1514,2360,172,74,98
236610,20,4418,1822,2596,1940,941,999,2478,881,1597
236638,20,3860,1757,2103,1910,817,1093,1950,940,1010
236656,20,3788,1456,2332,2229,936,1293,1559,520,1039
236692,20,6502,2710,3792,3294,1380,1914,3208,1330,1878
236708,20,3795,1548,2247,2576,1081,1495,1219,467,752
236744,20,39,1,38,39,1,38,,,
236753,20,5502,1967,3535,3399,1322,2077,2103,645,1458
236887,20,2662,1361,1301,1551,759,792,1111,602,509
236896,20,1300,670,630,1174,605,569,126,65,61
236939,20,22612,10593,12019,19812,9396,10416,2800,1197,1603
236948,20,36213,17831,18382,29226,12560,16666,6987,5271,1716
236975,20,2529,916,1613,1742,658,1084,787,258,529
237011,20,13801,5903,7898,12222,5069,7153,1579,834,745
237039,20,3340,1458,1882,1636,762,874,1704,696,1008
237057,20,1493,652,841,1450,629,821,43,23,20
237066,20,2047,862,1185,1997,834,1163,50,28,22
237109,20,3279,929,2350,2119,644,1475,1160,285,875
237118,20,674,396,278,613,382,231,61,14,47
237127,20,39,0,39,39,0,39,,,
237136,20,220,117,103,154,78,76,66,39,27
237145,20,15,0,15,15,0,15,,,
237172,20,65,43,22,51,37,14,14,6,8
237181,20,599,334,265,593,333,260,6,1,5
237215,20,1286,518,768,977,409,568,309,109,200
237242,20,41,40,1,34,33,1,7,7,0
237303,20,55,26,29,55,26,29,,,
237312,20,2365,1432,933,1307,660,647,1058,772,286
237321,20,61,5,56,61,5,56,,,
237330,20,1399,593,806,1242,525,717,157,68,89
237358,20,650,266,384,636,263,373,14,3,11
237367,20,3197,1350,1847,2355,1069,1286,842,281,561
237385,20,1608,817,791,975,468,507,633,349,284
237437,20,147,21,126,129,20,109,18,1,17
237473,20,101,71,30,101,71,30,,,
237491,20,18,3,15,18,3,15,,,
237525,20,7952,3354,4598,6348,2704,3644,1604,650,954
237543,20,122,30,92,80,17,63,42,13,29
237561,20,47,19,28,47,19,28,,,
237570,20,79,1,78,79,1,78,,,
237598,20,20,3,17,20,3,17,,,
237686,20,2288,819,1469,966,361,605,1322,458,864
237701,20,1145,485,660,882,395,487,263,90,173
237729,20,130,36,94,97,16,81,33,20,13
237783,20,762,350,412,670,305,365,92,45,47
237792,20,2718,1051,1667,2095,805,1290,623,246,377
237817,20,1365,413,952,899,276,623,466,137,329
237844,20,86,43,43,86,43,43,,,
237899,20,3634,1511,2123,1316,585,731,2318,926,1392
237905,20,55,12,43,55,12,43,,,
237932,20,1919,716,1203,1579,598,981,340,118,222
237950,20,1481,771,710,972,577,395,509,194,315
237969,20,889,429,460,877,421,456,12,8,4
237987,20,225,31,194,225,31,194,,,
237996,20,525,88,437,525,88,437,,,
238005,20,79,6,73,79,6,73,,,
238014,20,1222,427,795,551,229,322,671,198,473
238032,20,19059,9179,9880,17543,8514,9029,1516,665,851
238078,20,594,355,239,506,319,187,88,36,52
238096,20,30,2,28,30,2,28,,,
238175,20,113,1,112,113,1,112,,,
238193,20,788,18,770,599,4,595,189,14,175
238263,20,12936,5812,7124,3222,1638,1584,9714,4174,5540
238324,20,563,85,478,263,20,243,300,65,235
238333,20,964,455,509,933,445,488,31,10,21
238397,20,2391,878,1513,645,267,378,1746,611,1135
238430,20,755,272,483,418,160,258,337,112,225
238458,20,2771,910,1861,2604,840,1764,167,70,97
238476,20,2559,1132,1427,2481,1101,1380,78,31,47
238616,20,2817,1054,1763,1961,780,1181,856,274,582
238661,20,1220,416,804,1054,343,711,166,73,93
238722,20,11181,6226,4955,1892,1054,838,9289,5172,4117
238759,20,9881,4824,5057,1130,566,564,8751,4258,4493
238810,20,66,5,61,44,3,41,22,2,20
238980,20,1898,826,1072,765,381,384,1133,445,688
239008,20,3154,1681,1473,410,217,193,2744,1464,1280
239017,20,1426,658,768,1405,647,758,21,11,10
239071,20,736,297,439,482,196,286,254,101,153
239080,20,1068,358,710,920,324,596,148,34,114
239105,20,7528,3328,4200,7184,3156,4028,344,172,172
239220,20,2779,1323,1456,587,314,273,2192,1009,1183
239248,20,12211,4977,7234,3260,1590,1670,8951,3387,5564
239309,20,896,193,703,882,188,694,14,5,9
239318,20,2575,1852,723,2514,1806,708,61,46,15
239372,20,3074,1264,1810,823,396,427,2251,868,1383
239390,20,716,6,710,615,0,615,101,6,95
239442,20,1186,421,765,185,71,114,1001,350,651
239460,20,6069,2567,3502,1126,497,629,4943,2070,2873
239488,20,10661,4727,5934,2273,1157,1116,8388,3570,4818
239512,20,518,244,274,502,239,263,16,5,11
239628,20,766,389,377,760,387,373,6,2,4
239716,20,1814,792,1022,1783,772,1011,31,20,11
239877,20,39,1,38,32,1,31,7,0,7
239910,20,2710,1090,1620,717,329,388,1993,761,1232
240107,20,1485,354,1131,1203,307,896,282,47,235
240116,20,8364,3764,4600,2119,989,1130,6245,2775,3470
240125,20,7268,3942,3326,1593,883,710,5675,3059,2616
240170,20,3872,1707,2165,1556,837,719,2316,870,1446
240189,20,9367,4725,4642,8098,4207,3891,1269,518,751
240198,20,2677,1080,1597,855,388,467,1822,692,1130
240268,20,9423,3739,5684,8524,3424,5100,899,315,584
240277,20,9146,3088,6058,5014,1894,3120,4132,1194,2938
240329,20,9347,4033,5314,8756,3722,5034,591,311,280
240338,20,1003,457,546,964,435,529,39,22,17
240365,20,12627,5111,7516,6759,2799,3960,5868,2312,3556
240374,20,3236,1429,1807,2394,1077,1317,842,352,490
240392,20,1803,299,1504,691,119,572,1112,180,932
240417,20,6254,3582,2672,5113,2984,2129,1141,598,543
240426,20,2213,808,1405,1604,619,985,609,189,420
240444,20,36306,17070,19236,33838,15761,18077,2468,1309,1159
240453,20,18348,8267,10081,14909,6759,8150,3439,1508,1931
240462,20,6028,3784,2244,5329,3330,1999,699,454,245
240471,20,4776,1702,3074,3998,1385,2613,778,317,461
240480,20,7313,3149,4164,6296,2781,3515,1017,368,649
240505,20,3354,1485,1869,1426,592,834,1928,893,1035
240514,20,1923,872,1051,612,247,365,1311,625,686
240596,20,1421,581,840,455,166,289,966,415,551
240620,20,3770,1459,2311,1373,541,832,2397,918,1479
240657,20,1423,618,805,650,300,350,773,318,455
240666,20,3596,1662,1934,1256,521,735,2340,1141,1199
240693,20,2391,1002,1389,799,368,431,1592,634,958
240709,20,45,5,40,35,5,30,10,0,10
240718,20,993,934,59,993,934,59,,,
240727,20,8518,3983,4535,7062,3392,3670,1456,591,865
240736,20,1051,296,755,509,145,364,542,151,391
240745,20,1618,723,895,698,289,409,920,434,486
240754,20,2669,1134,1535,2037,854,1183,632,280,352
240790,20,1297,490,807,953,366,587,344,124,220
240879,20,131,25,106,131,25,106,,,
241100,20,201,103,98,170,87,83,31,16,15
241128,20,201,98,103,165,80,85,36,18,18
241146,20,141,47,94,137,46,91,4,1,3
241182,20,397,75,322,397,75,322,,,
241191,20,796,314,482,683,263,420,113,51,62
241216,20,1577,990,587,936,573,363,641,417,224
241225,20,611,195,416,422,137,285,189,58,131
241304,20,1882,530,1352,987,281,706,895,249,646
241331,20,703,109,594,551,87,464,152,22,130
241377,20,648,249,399,551,215,336,97,34,63
241386,20,131,27,104,104,23,81,27,4,23
241395,20,308,101,207,242,83,159,66,18,48
241410,20,4139,1484,2655,3553,1248,2305,586,236,350
241517,20,210,55,155,149,39,110,61,16,45
241614,20,281,158,123,147,94,53,134,64,70
241720,20,596,235,361,433,153,280,163,82,81
241739,20,4780,1515,3265,3143,993,2150,1637,522,1115
241766,20,291,204,87,174,118,56,117,86,31
241836,20,924,291,633,385,139,246,539,152,387
241906,20,235,74,161,235,74,161,,,
241951,20,489,124,365,358,83,275,131,41,90
242042,20,452,260,192,424,237,187,28,23,5
242112,20,391,166,225,336,153,183,55,13,42
242121,20,214,79,135,126,46,80,88,33,55
242130,20,326,95,231,260,72,188,66,23,43
242149,20,347,88,259,259,69,190,88,19,69
242556,20,247,162,85,240,157,83,7,5,2
242583,20,165,116,49,124,88,36,41,28,13
242617,20,2747,1269,1478,2358,1093,1265,389,176,213
242626,20,2968,1212,1756,2400,968,1432,568,244,324
242635,20,2445,870,1575,1966,727,1239,479,143,336
242644,20,1000,334,666,798,275,523,202,59,143
242653,20,3278,1413,1865,2361,1015,1346,917,398,519
242662,20,2779,999,1780,2129,778,1351,650,221,429
242680,20,1211,439,772,982,357,625,229,82,147
242699,20,1488,452,1036,1219,374,845,269,78,191
242705,20,3752,2098,1654,3124,1728,1396,628,370,258
242820,20,944,730,214,944,730,214,,,
242945,20,171,60,111,128,43,85,43,17,26
242954,20,66,22,44,54,17,37,12,5,7
242972,20,25400,8708,16692,17606,5944,11662,7794,2764,5030
243106,20,1985,889,1096,1777,800,977,208,89,119
243115,20,2897,1102,1795,2666,1010,1656,231,92,139
243133,20,3022,1487,1535,2578,1269,1309,444,218,226
243142,20,2270,835,1435,1758,631,1127,512,204,308
243151,20,2216,706,1510,1975,620,1355,241,86,155
243179,20,2634,884,1750,2362,786,1576,272,98,174
243188,20,346,179,167,305,157,148,41,22,19
243197,20,10201,5643,4558,9017,4936,4081,1184,707,477
243203,20,264,40,224,245,37,208,19,3,16
243212,20,2221,1001,1220,2021,935,1086,200,66,134
243221,20,9212,3347,5865,8070,2880,5190,1142,467,675
243346,20,4651,1794,2857,3090,1202,1888,1561,592,969
243443,20,3731,1358,2373,3045,1099,1946,686,259,427
243568,20,112,14,98,86,8,78,26,6,20
243577,20,3665,2629,1036,1655,1146,509,2010,1483,527
243586,20,659,233,426,556,201,355,103,32,71
243601,20,7923,3190,4733,5687,2195,3492,2236,995,1241
243638,20,1996,811,1185,1321,522,799,675,289,386
243647,20,454,206,248,279,137,142,175,69,106
243665,20,1378,383,995,903,271,632,475,112,363
243744,20,8049,3912,4137,7761,3744,4017,288,168,120
243780,20,38593,22210,16383,36484,21065,15419,2109,1145,964
243799,20,22,1,21,22,1,21,,,
243823,20,415,117,298,314,90,224,101,27,74
243832,20,1207,342,865,561,153,408,646,189,457
243841,20,466,89,377,363,73,290,103,16,87
244233,20,1,0,1,1,0,1,,,
244279,20,132,3,129,132,3,129,,,
244437,20,15456,5936,9520,5841,2450,3391,9615,3486,6129
244446,20,2874,1041,1833,617,296,321,2257,745,1512
244613,20,323,308,15,170,162,8,153,146,7
245281,20,78,41,37,78,41,37,,,
245625,20,3386,1488,1898,619,257,362,2767,1231,1536
245652,20,364,188,176,355,187,168,9,1,8
245777,20,45,45,0,43,43,0,2,2,0
245838,20,74,30,44,26,11,15,48,19,29
245847,20,60,21,39,25,8,17,35,13,22
245883,20,80,17,63,10,3,7,70,14,56
245892,20,105,24,81,51,8,43,54,16,38
245953,20,1867,743,1124,750,292,458,1117,451,666
245962,20,167,10,157,164,10,154,3,0,3
245980,20,39,7,32,39,7,32,,,
245999,20,2559,1269,1290,401,163,238,2158,1106,1052
246017,20,1459,948,511,487,396,91,972,552,420
246035,20,285,44,241,285,44,241,,,
246071,20,50,8,42,50,8,42,,,
246354,20,10641,4129,6512,2026,751,1275,8615,3378,5237
246406,20,15,3,12,15,3,12,,,
246415,20,68,3,65,20,2,18,48,1,47
246460,20,106,9,97,106,9,97,,,
246813,20,3865,1318,2547,681,301,380,3184,1017,2167
246895,20,443,178,265,251,84,167,192,94,98
246974,20,403,42,361,403,42,361,,,
247010,20,44,0,44,44,0,44,,,
247047,20,88,2,86,88,2,86,,,
247065,20,653,47,606,381,20,361,272,27,245
247153,20,216,48,168,216,48,168,,,
247162,20,9,1,8,,,,9,1,8
247409,20,68,0,68,68,0,68,,,
247603,20,2181,1161,1020,1339,741,598,842,420,422
247649,20,585,377,208,371,237,134,214,140,74
247773,20,68,68,0,68,68,0,,,
247834,20,35077,15784,19293,11361,5876,5485,23716,9908,13808
247940,20,4621,2088,2533,1592,700,892,3029,1388,1641
248192,20,25,0,25,25,0,25,,,
248527,20,83,0,83,83,0,83,,,
248606,20,1706,1007,699,180,68,112,1526,939,587
248624,20,77,17,60,77,17,60,,,
248633,20,56,2,54,56,2,54,,,
248660,20,137,33,104,121,33,88,16,0,16
248703,20,227,2,225,104,1,103,123,1,122
248925,20,1016,675,341,592,348,244,424,327,97
248934,20,11399,4484,6915,11275,4438,6837,124,46,78
249061,20,49,0,49,25,0,25,24,0,24
249238,20,330,15,315,212,7,205,118,8,110
249609,20,167,103,64,167,103,64,,,
250027,20,305,95,210,300,95,205,5,0,5
250285,20,288,258,30,161,146,15,127,112,15
250744,20,377,44,333,377,44,333,,,
250902,20,102,7,95,55,4,51,47,3,44
250993,20,549,314,235,30,11,19,519,303,216
251260,20,4386,1937,2449,2340,1177,1163,2046,760,1286
251312,20,420,61,359,322,47,275,98,14,84
260336,20,17,4,13,17,4,13,,,
260363,20,8,0,8,8,0,8,,,
260372,20,288,70,218,101,20,81,187,50,137
260664,20,310,222,88,310,222,88,,,
260691,20,768,207,561,768,207,561,,,
260789,20,667,138,529,667,138,529,,,
260813,20,232,26,206,232,26,206,,,
260929,20,186,17,169,185,17,168,1,0,1
260965,20,77,0,77,77,0,77,,,
260992,20,514,38,476,165,22,143,349,16,333
261436,20,834,57,777,834,57,777,,,
261676,20,18,1,17,18,1,17,,,
261685,20,32,1,31,32,1,31,,,
261719,20,220,1,219,220,1,219,,,
261773,20,34,7,27,32,6,26,2,1,1
261861,20,8,0,8,8,0,8,,,
262031,20,5800,2386,3414,3139,1404,1735,2661,982,1679
262086,20,4822,1623,3199,1014,438,576,3808,1185,2623
262129,20,669,214,455,661,208,453,8,6,2
262341,20,615,535,80,615,535,80,,,
262369,20,97,0,97,97,0,97,,,
262457,20,435,60,375,435,60,375,,,
262466,20,32,18,14,32,18,14,,,
362700,20,428,37,391,418,36,382,10,1,9
362782,20,242,6,236,82,2,80,160,4,156
363013,20,28,3,25,28,3,25,,,
363147,20,421,2,419,421,2,419,,,
363165,20,1919,1038,881,567,306,261,1352,732,620
363633,20,774,347,427,252,106,146,522,241,281
363679,20,209,3,206,190,3,187,19,0,19
363712,20,44,44,0,44,44,0,,,
363882,20,88,1,87,88,1,87,,,
363907,20,405,258,147,300,185,115,105,73,32
363916,20,141,44,97,112,35,77,29,9,20
363934,20,802,639,163,417,333,84,385,306,79
364016,20,5676,2545,3131,1582,840,742,4094,1705,2389
364025,20,13775,6574,7201,3451,1803,1648,10324,4771,5553
364548,20,201,103,98,135,58,77,66,45,21
364575,20,26,0,26,26,0,26,,,
364627,20,427,223,204,71,21,50,356,202,154
364636,20,162,37,125,131,37,94,31,0,31
364760,20,48,6,42,23,3,20,25,3,22
364946,20,381,184,197,87,20,67,294,164,130
364964,20,23,3,20,23,3,20,,,
365091,20,317,14,303,317,14,303,,,
365125,20,194,6,188,194,6,188,,,
365198,20,563,274,289,44,2,42,519,272,247
365213,20,458,229,229,118,34,84,340,195,145
365240,20,18,12,6,18,12,6,,,
365374,20,1608,901,707,286,140,146,1322,761,561
365383,20,65,5,60,65,5,60,,,
365480,20,806,428,378,114,20,94,692,408,284
365505,20,19,3,16,19,3,16,,,
365693,20,138,0,138,138,0,138,,,
365763,20,31,6,25,31,6,25,,,
365824,20,99,6,93,99,6,93,,,
365833,20,116,8,108,116,8,108,,,
366003,20,239,101,138,86,27,59,153,74,79
366155,20,30,12,18,30,12,18,,,
366191,20,1216,1176,40,1216,1176,40,,,
366252,20,4234,2729,1505,3472,2454,1018,762,275,487
366261,20,275,90,185,257,83,174,18,7,11
366270,20,304,11,293,304,11,293,,,
366289,20,31,25,6,31,25,6,,,
366340,20,281,91,190,173,58,115,108,33,75
366395,20,20014,8983,11031,9113,4452,4661,10901,4531,6370
366401,20,6724,3173,3551,2174,1134,1040,4550,2039,2511
366438,20,28,2,26,16,2,14,12,0,12
366465,20,2045,704,1341,764,293,471,1281,411,870
366535,20,255,35,220,255,35,220,,,
366553,20,578,244,334,575,244,331,3,0,3
366571,20,22,3,19,22,3,19,,,
366623,20,261,125,136,32,9,23,229,116,113
366632,20,5,0,5,5,0,5,,,
366711,20,13914,5620,8294,11144,4457,6687,2770,1163,1607
367051,20,79,2,77,47,2,45,32,0,32
367088,20,107,3,104,65,3,62,42,0,42
367103,20,119,93,26,119,93,26,,,
367112,20,165,24,141,151,21,130,14,3,11
367158,20,53,1,52,53,1,52,,,
367334,20,189,166,23,148,130,18,41,36,5
367361,20,90,60,30,86,58,28,4,2,2
367431,20,42,1,41,42,1,41,,,
367459,20,7593,3090,4503,1882,832,1050,5711,2258,3453
367875,20,1053,343,710,860,271,589,193,72,121
367884,20,339,121,218,208,66,142,131,55,76
367972,20,106,3,103,106,3,103,,,
367981,20,62,0,62,37,0,37,25,0,25
368230,20,94,4,90,65,1,64,29,3,26
368364,20,332,177,155,165,104,61,167,73,94
368407,20,32,2,30,1,1,0,31,1,30
368443,20,371,103,268,371,103,268,,,
368452,20,298,109,189,298,109,189,,,
368629,20,474,98,376,474,98,376,,,
368647,20,9,1,8,9,1,8,,,
368771,20,241,53,188,241,53,188,,,
368832,20,53,11,42,17,5,12,36,6,30
368911,20,1757,495,1262,271,76,195,1486,419,1067
369400,20,943,903,40,943,903,40,,,
369419,20,642,349,293,642,349,293,,,
369446,20,42,3,39,23,3,20,19,0,19
369455,20,190,40,150,190,40,150,,,
369516,20,127,27,100,127,27,100,,,
369668,20,131,46,85,92,44,48,39,2,37
369686,20,69,14,55,69,14,55,,,
369783,20,282,16,266,282,16,266,,,
369950,20,92,80,12,92,80,12,,,
371052,20,232,40,192,232,40,192,,,
371690,20,813,184,629,98,10,88,715,174,541
371830,20,112,94,18,110,94,16,2,0,2
371928,20,115,41,74,115,41,74,,,
371964,20,342,248,94,342,248,94,,,
372028,20,128,19,109,128,19,109,,,
372073,20,143,43,100,143,43,100,,,
372082,20,103,32,71,93,32,61,10,0,10
372240,20,21,0,21,21,0,21,,,
372329,20,384,45,339,384,45,339,,,
372356,20,188,4,184,188,4,184,,,
372462,20,113,19,94,110,18,92,3,1,2
372921,20,450,155,295,450,155,295,,,
373085,20,28,0,28,24,0,24,4,0,4
373216,20,119,21,98,119,21,98,,,
373456,20,26,1,25,18,1,17,8,0,8
373526,20,279,209,70,279,209,70,,,
373678,20,113,46,67,81,37,44,32,9,23
373696,20,59,25,34,41,16,25,18,9,9
373711,20,63,6,57,63,6,57,,,
373784,20,475,255,220,475,255,220,,,
374316,20,60,47,13,38,35,3,22,12,10
374343,20,58,1,57,58,1,57,,,
374574,20,675,117,558,472,94,378,203,23,180
374592,20,47,15,32,47,15,32,,,
375106,20,138,114,24,123,100,23,15,14,1
375230,20,196,196,0,196,196,0,,,
375373,20,115,48,67,5,0,5,110,48,62
375407,20,95,24,71,84,19,65,11,5,6
375416,20,186,51,135,186,51,135,,,
375540,20,38,0,38,14,0,14,24,0,24
375568,20,42,13,29,4,4,0,38,9,29
375656,20,165,77,88,23,3,20,142,74,68
375683,20,934,566,368,158,108,50,776,458,318
375726,20,568,305,263,401,186,215,167,119,48
375939,20,121,23,98,121,23,98,,,
375966,20,127,11,116,73,6,67,54,5,49
375984,20,186,9,177,142,7,135,44,2,42
376224,20,185,42,143,155,38,117,30,4,26
376242,20,60,51,9,60,51,9,,,
376288,20,111,30,81,111,30,81,,,
376330,20,196,52,144,196,52,144,,,
376385,20,185,87,98,180,86,94,5,1,4
376446,20,72,1,71,16,1,15,56,0,56
376631,20,21,8,13,19,8,11,2,0,2
376677,20,128,48,80,126,46,80,2,2,0
376695,20,1384,616,768,597,277,320,787,339,448
377111,20,181,72,109,181,72,109,,,
377193,20,28,2,26,11,1,10,17,1,16
377218,20,125,121,4,125,121,4,,,
377272,20,17,3,14,17,3,14,,,
377281,20,71,6,65,71,6,65,,,
377315,20,75,0,75,75,0,75,,,
377449,20,209,95,114,168,83,85,41,12,29
377458,20,221,89,132,160,76,84,61,13,48
377485,20,54,7,47,15,3,12,39,4,35
377546,20,119,42,77,114,41,73,5,1,4
377555,20,5192,2847,2345,4449,2433,2016,743,414,329
377564,20,4083,2111,1972,3593,1862,1731,490,249,241
377643,20,108,7,101,108,7,101,,,
377652,20,152,8,144,152,8,144,,,
377661,20,615,97,518,615,97,518,,,
377722,20,436,21,415,436,21,415,,,
377759,20,151,146,5,151,146,5,,,
378105,20,446,14,432,328,12,316,118,2,116
378576,20,292,61,231,46,14,32,246,47,199
378886,20,243,55,188,75,17,58,168,38,130
378956,20,608,565,43,608,565,43,,,
379621,20,72,5,67,56,5,51,16,0,16
379746,20,365,18,347,365,18,347,,,
379782,20,218,20,198,218,20,198,,,
380067,20,268,2,266,268,2,266,,,
380359,20,538,101,437,187,48,139,351,53,298
380368,20,1648,667,981,413,151,262,1235,516,719
380377,20,643,146,497,454,112,342,189,34,155
380438,20,712,96,616,712,96,616,,,
381255,20,78,61,17,78,61,17,,,
381282,20,81,31,50,81,31,50,,,
381325,20,109,36,73,109,36,73,,,
381370,20,279,17,262,140,11,129,139,6,133
381404,20,390,14,376,141,4,137,249,10,239
381486,20,19,0,19,19,0,19,,,
381699,20,38,0,38,26,0,26,12,0,12
381732,20,55,13,42,7,2,5,48,11,37
382258,20,142,13,129,62,3,59,80,10,70
382416,20,80,18,62,80,18,62,,,
382461,20,42,1,41,27,1,26,15,0,15
382780,20,155,9,146,136,7,129,19,2,17
382911,20,54,23,31,40,18,22,14,5,9
382957,20,353,95,258,342,93,249,11,2,9
383020,20,4,2,2,2,1,1,2,1,1
383084,20,337,126,211,256,85,171,81,41,40
383163,20,174,2,172,43,0,43,131,2,129
383190,20,2127,845,1282,660,345,315,1467,500,967
383279,20,178,24,154,60,10,50,118,14,104
383297,20,185,8,177,34,0,34,151,8,143
383312,20,65,26,39,65,26,39,,,
383330,20,76,15,61,76,15,61,,,
383367,20,127,33,94,107,30,77,20,3,17
383464,20,134,9,125,134,9,125,,,
383525,20,43,9,34,43,9,34,,,
383765,20,148,6,142,98,5,93,50,1,49
383996,20,691,253,438,151,47,104,540,206,334
384236,20,978,360,618,978,360,618,,,
384245,20,711,259,452,711,259,452,,,
384254,20,501,331,170,457,303,154,44,28,16
384333,20,9620,3752,5868,2421,977,1444,7199,2775,4424
384342,20,4774,2038,2736,1599,770,829,3175,1268,1907
384412,20,228,125,103,228,125,103,,,
384421,20,95,95,0,95,95,0,,,
385132,20,115,6,109,78,5,73,37,1,36
385503,20,210,15,195,210,15,195,,,
385619,20,2246,1107,1139,2246,1107,1139,,,
386153,20,426,0,426,366,0,366,60,0,60
386472,20,735,139,596,426,83,343,309,56,253
387925,20,113,11,102,113,11,102,,,
388520,20,205,124,81,73,51,22,132,73,59
389860,20,326,163,163,217,79,138,109,84,25
390905,20,237,133,104,58,42,16,179,91,88
391005,20,117,3,114,117,3,114,,,
391759,20,22,0,22,,,,22,0,22
392257,20,3201,230,2971,3201,230,2971,,,
392354,20,10,2,8,10,2,8,,,
392415,20,258,71,187,258,71,187,,,
393649,20,1288,497,791,1288,497,791,,,
393861,20,463,84,379,428,80,348,35,4,31
395362,20,1402,481,921,370,118,252,1032,363,669
395690,20,276,169,107,276,169,107,,,
397942,20,1150,333,817,1150,333,817,,,
399212,20,11696,7519,4177,2201,1104,1097,9495,6415,3080
399869,20,541,515,26,541,515,26,,,
399911,20,445,156,289,445,156,289,,,
400080,20,1017,698,319,1017,698,319,,,
400187,20,516,70,446,327,50,277,189,20,169
400558,20,57,18,39,57,18,39,,,
401223,20,192,63,129,89,26,63,103,37,66
401764,20,223,5,218,71,0,71,152,5,147
402563,20,210,11,199,210,11,199,,,
402800,20,146,4,142,136,3,133,10,1,9
403469,20,1740,1077,663,216,101,115,1524,976,548
403478,20,636,283,353,347,167,180,289,116,173
403487,20,926,357,569,417,192,225,509,165,344
404055,20,269,30,239,269,30,239,,,
404338,20,23,9,14,23,9,14,,,
404426,20,2535,1151,1384,862,450,412,1673,701,972
404684,20,313,91,222,313,91,222,,,
404718,20,255,4,251,255,4,251,,,
404912,20,802,160,642,802,160,642,,,
405012,20,87,1,86,87,1,86,,,
405058,20,149,149,0,149,149,0,,,
405076,20,470,70,400,470,70,400,,,
405854,20,237,237,0,237,237,0,,,
405872,20,2891,1194,1697,862,450,412,2029,744,1285
406024,20,1962,247,1715,1082,127,955,880,120,760
406033,20,3163,395,2768,1922,247,1675,1241,148,1093
406149,20,86,18,68,86,18,68,,,
406325,20,140,8,132,36,4,32,104,4,100
406361,20,11,1,10,11,1,10,,,
406422,20,70,3,67,36,0,36,34,3,31
406486,20,35,21,14,19,12,7,16,9,7
406547,20,45,3,42,26,3,23,19,0,19
407090,20,468,5,463,139,2,137,329,3,326
407142,20,103,1,102,103,1,102,,,
407151,20,70,0,70,70,0,70,,,
407179,20,91,3,88,61,2,59,30,1,29
407355,20,181,24,157,181,24,157,,,
407434,20,59,1,58,59,1,58,,,
407461,20,72,54,18,72,54,18,,,
407470,20,145,5,140,112,4,108,33,1,32
407489,20,73,54,19,9,0,9,64,54,10
407513,20,127,53,74,38,3,35,89,50,39
407522,20,33,12,21,,,,33,12,21
407568,20,138,6,132,118,2,116,20,4,16
407577,20,69,36,33,46,19,27,23,17,6
407595,20,45,2,43,45,2,43,,,
407610,20,52,35,17,2,2,0,50,33,17
407629,20,10,1,9,10,1,9,,,
407683,20,60,2,58,30,2,28,30,0,30
407708,20,210,7,203,210,7,203,,,
407735,20,64,1,63,64,1,63,,,
407832,20,189,117,72,75,46,29,114,71,43
408066,20,182,40,142,122,29,93,60,11,49
408163,20,43,2,41,43,2,41,,,
408385,20,645,274,371,645,274,371,,,
408729,20,21,1,20,20,0,20,1,1,0
408844,20,2466,746,1720,1582,543,1039,884,203,681
408862,20,298,5,293,132,3,129,166,2,164
409032,20,53,1,52,53,1,52,,,
409120,20,61,24,37,61,24,37,,,
409193,20,175,170,5,175,170,5,,,
409315,20,27894,12006,15888,8427,3730,4697,19467,8276,11191
409537,20,17,5,12,,,,17,5,12
409591,20,88,18,70,44,7,37,44,11,33
409698,20,6248,2476,3772,5423,2061,3362,825,415,410
410797,20,87,45,42,87,45,42,,,
410964,20,39,0,39,35,0,35,4,0,4
411684,20,150,46,104,150,46,104,,,
411754,20,37,8,29,37,8,29,,,
412173,20,506,47,459,466,44,422,40,3,37
412535,20,37,3,34,35,3,32,2,0,2
412544,20,150,8,142,93,7,86,57,1,56
412599,20,344,100,244,344,100,244,,,
413176,20,37,21,16,37,21,16,,,
413413,20,13280,2239,11041,3292,477,2815,9988,1762,8226
413617,20,281,77,204,67,25,42,214,52,162
413626,20,172,52,120,99,30,69,73,22,51
413680,20,336,321,15,336,321,15,,,
413820,20,21,0,21,21,0,21,,,
413893,20,1276,444,832,1276,444,832,,,
413972,20,30,2,28,30,2,28,,,
414063,20,102,0,102,95,0,95,7,0,7
414124,20,292,221,71,225,175,50,67,46,21
414461,20,2220,2106,114,2004,1899,105,216,207,9
414489,20,105,1,104,105,1,104,,,
414540,20,251,6,245,214,5,209,37,1,36
414595,20,249,53,196,36,14,22,213,39,174
414869,20,333,4,329,104,3,101,229,1,228
414878,20,470,189,281,158,61,97,312,128,184
414911,20,2270,850,1420,631,282,349,1639,568,1071
414939,20,300,40,260,300,40,260,,,
415039,20,49,3,46,37,3,34,12,0,12
415057,20,20,20,0,20,20,0,,,
415987,20,86,6,80,86,6,80,,,
416458,20,126,42,84,126,42,84,,,
416801,20,337,70,267,295,59,236,42,11,31
417008,20,110,2,108,110,2,108,,,
417062,20,57,2,55,44,0,44,13,2,11
417105,20,405,261,144,281,162,119,124,99,25
417123,20,87,35,52,41,19,22,46,16,30
417248,20,51,49,2,51,49,2,,,
417275,20,27,25,2,27,25,2,,,
417327,20,152,24,128,91,18,73,61,6,55
417442,20,67,1,66,67,1,66,,,
417503,20,224,0,224,136,0,136,88,0,88
417600,20,13,0,13,13,0,13,,,
417628,20,20,2,18,19,2,17,1,0,1
417637,20,47,16,31,47,16,31,,,
417646,20,23,1,22,23,1,22,,,
417655,20,19,2,17,19,2,17,,,
417682,20,15,1,14,15,1,14,,,
417716,20,193,4,189,193,4,189,,,
417725,20,45,2,43,45,2,43,,,
417734,20,134,30,104,49,14,35,85,16,69
417752,20,19,8,11,17,7,10,2,1,1
417831,20,108,77,31,108,77,31,,,
417840,20,393,29,364,393,29,364,,,
417868,20,39,12,27,18,4,14,21,8,13
417886,20,20,1,19,20,1,19,,,
417910,20,201,31,170,201,31,170,,,
417983,20,29,0,29,,,,29,0,29
417992,20,46,3,43,28,2,26,18,1,17
418001,20,83,3,80,83,3,80,,,
418010,20,67,5,62,34,1,33,33,4,29
418029,20,42,4,38,42,4,38,,,
418038,20,170,17,153,170,17,153,,,
418065,20,257,32,225,204,24,180,53,8,45
418083,20,50,8,42,50,8,42,,,
418126,20,124,40,84,70,21,49,54,19,35
418171,20,54,54,0,54,54,0,,,
418199,20,45,32,13,6,6,0,39,26,13
418205,20,176,103,73,124,72,52,52,31,21
418223,20,115,7,108,115,7,108,,,
418250,20,211,132,79,39,21,18,172,111,61
418269,20,86,45,41,86,45,41,,,
418278,20,115,30,85,66,19,47,49,11,38
418296,20,1541,841,700,468,147,321,1073,694,379
418302,20,530,255,275,103,20,83,427,235,192
418320,20,910,480,430,60,18,42,850,462,388
418348,20,492,338,154,67,57,10,425,281,144
418357,20,148,76,72,21,8,13,127,68,59
418409,20,213,104,109,151,63,88,62,41,21
418427,20,89,8,81,78,8,70,11,0,11
418445,20,26,0,26,18,0,18,8,0,8
418454,20,56,34,22,55,33,22,1,1,0
418481,20,38,0,38,38,0,38,,,
418515,20,86,6,80,75,6,69,11,0,11
418524,20,43,2,41,43,2,41,,,
418533,20,239,34,205,200,22,178,39,12,27
418542,20,81,9,72,35,3,32,46,6,40
418560,20,87,14,73,24,1,23,63,13,50
418588,20,34,1,33,34,1,33,,,
418612,20,7,0,7,7,0,7,,,
418658,20,369,314,55,369,314,55,,,
418773,20,371,176,195,296,163,133,75,13,62
418782,20,275,264,11,275,264,11,,,
418889,20,51,45,6,33,28,5,18,17,1
418913,20,14,4,10,14,4,10,,,
418968,20,103,1,102,103,1,102,,,
419031,20,35,2,33,35,2,33,,,
419095,20,40,3,37,40,3,37,,,
419183,20,82,7,75,82,7,75,,,
419217,20,59,11,48,59,11,48,,,
419226,20,506,249,257,363,202,161,143,47,96
419235,20,148,29,119,148,29,119,,,
419244,20,250,196,54,121,101,20,129,95,34
419253,20,26,21,5,26,21,5,,,
419280,20,29,0,29,25,0,25,4,0,4
419341,20,9,4,5,9,4,5,,,
419420,20,39,15,24,39,15,24,,,
419484,20,19,2,17,19,2,17,,,
419633,20,85,11,74,85,11,74,,,
419703,20,452,429,23,452,429,23,,,
419712,20,129,127,2,129,127,2,,,
419721,20,249,235,14,249,235,14,,,
420024,20,189,19,170,160,15,145,29,4,25
420042,20,24,14,10,24,14,10,,,
420130,20,264,12,252,264,12,252,,,
420255,20,77,75,2,77,75,2,,,
420325,20,79,79,0,79,79,0,,,
420343,20,861,832,29,687,667,20,174,165,9
420370,20,438,139,299,438,139,299,,,
420398,20,17222,7191,10031,3481,1592,1889,13741,5599,8142
420431,20,1819,632,1187,327,103,224,1492,529,963
420440,20,1625,592,1033,445,194,251,1180,398,782
420468,20,248,107,141,198,101,97,50,6,44
420538,20,1247,488,759,480,199,281,767,289,478
420556,20,1039,363,676,290,115,175,749,248,501
420723,20,538,228,310,110,40,70,428,188,240
420981,20,339,45,294,339,45,294,,,
421513,20,48,5,43,43,3,40,5,2,3
421610,20,134,8,126,128,8,120,6,0,6
421665,20,46,1,45,25,1,24,21,0,21
421708,20,1177,145,1032,925,103,822,252,42,210
421717,20,29,20,9,11,9,2,18,11,7
421771,20,49,0,49,34,0,34,15,0,15
421841,20,376,169,207,376,169,207,,,
421878,20,387,36,351,293,28,265,94,8,86
421896,20,190,69,121,190,69,121,,,
422020,20,229,218,11,229,218,11,,,
422695,20,257,17,240,257,17,240,,,
422835,20,280,50,230,280,50,230,,,
423120,20,724,72,652,718,71,647,6,1,5
423397,20,543,328,215,543,328,215,,,
423412,20,32,27,5,32,27,5,,,
423652,20,398,105,293,158,37,121,240,68,172
425250,20,80,12,68,52,9,43,28,3,25
425986,20,172,21,151,172,21,151,,,
426314,20,8479,7197,1282,2175,1800,375,6304,5397,907
427308,20,129,4,125,129,4,125,,,
427335,20,74,0,74,68,0,68,6,0,6
427894,20,60,59,1,60,59,1,,,
427973,20,232,206,26,152,134,18,80,72,8
427982,20,149,95,54,129,85,44,20,10,10
427991,20,621,333,288,350,178,172,271,155,116
428000,20,87,20,67,87,20,67,,,
428019,20,241,124,117,25,11,14,216,113,103
428055,20,141,35,106,141,35,106,,,
428125,20,49,35,14,48,34,14,1,1,0
428170,20,608,60,548,363,34,329,245,26,219
428259,20,63,7,56,12,1,11,51,6,45
428392,20,1580,661,919,509,230,279,1071,431,640
429128,20,596,27,569,7,0,7,589,27,562
430184,20,1298,400,898,167,103,64,1131,297,834
430227,20,74,1,73,57,1,56,17,0,17
430245,20,611,162,449,611,162,449,,,
430306,20,54,18,36,32,14,18,22,4,18
430403,20,220,14,206,220,14,206,,,
430564,20,36,11,25,17,4,13,19,7,12
430582,20,409,189,220,409,189,220,,,
430670,20,73,17,56,73,17,56,,,
430704,20,23,5,18,22,5,17,1,0,1
430795,20,155,43,112,155,43,112,,,
430883,20,29,2,27,29,2,27,,,
430908,20,29,4,25,17,2,15,12,2,10
430935,20,618,455,163,444,327,117,174,128,46
430971,20,36,5,31,36,5,31,,,
431017,20,359,220,139,79,39,40,280,181,99
431071,20,23,7,16,12,5,7,11,2,9
431105,20,95,7,88,39,4,35,56,3,53
431123,20,138,136,2,138,136,2,,,
431141,20,1299,492,807,1258,489,769,41,3,38
431187,20,152,137,15,152,137,15,,,
431196,20,94,7,87,94,7,87,,,
431266,20,101,4,97,31,3,28,70,1,69
431275,20,33,5,28,8,2,6,25,3,22
431284,20,68,0,68,60,0,60,8,0,8
431558,20,287,95,192,276,92,184,11,3,8
431600,20,168,32,136,140,24,116,28,8,20
431716,20,452,209,243,452,209,243,,,
431983,20,74,74,0,74,74,0,,,
432117,20,174,3,171,109,2,107,65,1,64
432269,20,72,60,12,72,60,12,,,
432384,20,442,90,352,442,90,352,,,
432524,20,129,43,86,124,41,83,5,2,3
433004,20,347,90,257,347,90,257,,,
433013,20,714,231,483,714,231,483,,,
433040,20,41,3,38,41,3,38,,,
433068,20,273,179,94,216,123,93,57,56,1
433101,20,673,83,590,471,64,407,202,19,183
433138,20,126,17,109,107,10,97,19,7,12
433174,20,409,54,355,72,12,60,337,42,295
433387,20,112807,45265,67542,112807,45265,67542,,,
433420,20,330,285,45,330,285,45,,,
433536,20,364,37,327,207,22,185,157,15,142
433660,20,14130,6165,7965,11337,4899,6438,2793,1266,1527
434016,20,208,75,133,75,30,45,133,45,88
434061,20,5677,2146,3531,3019,1311,1708,2658,835,1823
434140,20,684,148,536,684,148,536,,,
434159,20,431,351,80,431,351,80,,,
434274,20,82,12,70,55,7,48,27,5,22
434283,20,49,2,47,47,2,45,2,0,2
434308,20,386,16,370,386,16,370,,,
434344,20,217,7,210,217,7,210,,,
434362,20,35,34,1,35,34,1,,,
434432,20,13,1,12,13,1,12,,,
434469,20,279,42,237,277,42,235,2,0,2
434496,20,92,1,91,92,1,91,,,
434539,20,11,7,4,6,4,2,5,3,2
434584,20,179,57,122,48,17,31,131,40,91
434672,20,15319,5638,9681,4058,1968,2090,11261,3670,7591
434751,20,102,25,77,47,11,36,55,14,41
434821,20,588,27,561,588,27,561,,,
434830,20,160,1,159,111,1,110,49,0,49
434900,20,363,94,269,206,46,160,157,48,109
434937,20,43,43,0,43,43,0,,,
435000,20,23,9,14,22,9,13,1,0,1
436030,20,206,92,114,121,68,53,85,24,61
436304,20,2339,1221,1118,1160,623,537,1179,598,581
436429,20,5588,3620,1968,5588,3620,1968,,,
436553,20,773,136,637,773,136,637,,,
436599,20,118,20,98,7,0,7,111,20,91
436614,20,55,31,24,27,15,12,28,16,12
436632,20,142,27,115,78,20,58,64,7,57
436641,20,20,8,12,20,8,12,,,
436650,20,158,12,146,158,12,146,,,
436775,20,113,5,108,113,5,108,,,
436818,20,768,330,438,696,295,401,72,35,37
436827,20,493,274,219,463,258,205,30,16,14
436836,20,2297,1185,1112,2105,1079,1026,192,106,86
437097,20,373,215,158,341,195,146,32,20,12
437103,20,9284,3219,6065,3560,1359,2201,5724,1860,3864
437237,20,83,70,13,83,70,13,,,
437556,20,1108,451,657,1017,440,577,91,11,80
437608,20,134,101,33,132,99,33,2,2,0
437635,20,697,68,629,697,68,629,,,
437723,20,22,10,12,22,10,12,,,
437732,20,65,4,61,49,2,47,16,2,14
437750,20,90,89,1,90,89,1,,,
437769,20,140,10,130,140,10,130,,,
437778,20,247,8,239,247,8,239,,,
437857,20,115,2,113,91,1,90,24,1,23
437936,20,669,83,586,669,83,586,,,
438179,20,230,32,198,230,32,198,,,
438221,20,144,12,132,127,11,116,17,1,16
438258,20,466,86,380,466,86,380,,,
438285,20,240,22,218,240,22,218,,,
438337,20,190,74,116,148,55,93,42,19,23
438504,20,1401,1347,54,1401,1347,54,,,
438586,20,958,330,628,792,271,521,166,59,107
438674,20,41,0,41,21,0,21,20,0,20
438708,20,376,83,293,120,29,91,256,54,202
438735,20,156,142,14,102,94,8,54,48,6
438984,20,53,18,35,53,18,35,,,
439020,20,3,1,2,2,0,2,1,1,0
439118,20,298,45,253,298,45,253,,,
439190,20,1844,909,935,1064,541,523,780,368,412
439367,20,1214,349,865,1214,349,865,,,
439446,20,1,1,0,1,1,0,,,
439455,20,324,14,310,160,9,151,164,5,159
439473,20,205,64,141,101,34,67,104,30,74
439491,20,245,30,215,245,30,215,,,
439570,20,451,17,434,451,17,434,,,
439622,20,436,58,378,436,58,378,,,
439668,20,411,353,58,411,353,58,,,
439686,20,8,0,8,8,0,8,,,
439701,20,255,94,161,117,43,74,138,51,87
439738,20,375,69,306,375,69,306,,,
439747,20,190,33,157,127,25,102,63,8,55
439774,20,62,21,41,46,19,27,16,2,14
439783,20,74,16,58,60,12,48,14,4,10
439792,20,345,38,307,339,38,301,6,0,6
439844,20,54,0,54,54,0,54,,,
439862,20,153,92,61,64,25,39,89,67,22
439871,20,182,4,178,179,4,175,3,0,3
439899,20,81,39,42,64,26,38,17,13,4
439932,20,56,5,51,56,5,51,,,
439969,20,67,26,41,67,26,41,,,
440059,20,728,673,55,486,446,40,242,227,15
440101,20,111,4,107,51,0,51,60,4,56
440262,20,408,389,19,293,277,16,115,112,3
440271,20,152,69,83,152,69,83,,,
440396,20,236,105,131,218,98,120,18,7,11
440402,20,1592,538,1054,566,222,344,1026,316,710
440651,20,505,119,386,297,87,210,208,32,176
440730,20,384,141,243,384,141,243,,,
440749,20,61,43,18,6,5,1,55,38,17
440776,20,51,20,31,51,20,31,,,
440794,20,462,123,339,364,81,283,98,42,56
440819,20,12,8,4,12,8,4,,,
440828,20,1042,545,497,585,300,285,457,245,212
440855,20,154,6,148,154,6,148,,,
440989,20,444,350,94,444,350,94,,,
441025,20,174,56,118,168,55,113,6,1,5
441052,20,1465,383,1082,1465,383,1082,,,
441070,20,143,56,87,39,16,23,104,40,64
441168,20,26,1,25,26,1,25,,,
441210,20,600,221,379,87,3,84,513,218,295
441229,20,1640,324,1316,1640,324,1316,,,
441256,20,43,1,42,43,1,42,,,
441371,20,6368,199,6169,6358,199,6159,10,0,10
441380,20,227,88,139,183,70,113,44,18,26
441414,20,123,27,96,21,10,11,102,17,85
441423,20,680,218,462,680,218,462,,,
441487,20,68,4,64,68,4,64,,,
441496,20,185,159,26,132,114,18,53,45,8
441502,20,352,24,328,352,24,328,,,
441575,20,294,20,274,294,20,274,,,
441593,20,12,1,11,12,1,11,,,
441609,20,183,183,0,183,183,0,,,
441618,20,18,0,18,9,0,9,9,0,9
441636,20,336,59,277,282,44,238,54,15,39
441645,20,124,3,121,96,3,93,28,0,28
441663,20,261,27,234,261,27,234,,,
441672,20,42,6,36,42,6,36,,,
441690,20,140,89,51,51,29,22,89,60,29
441706,20,267,120,147,267,120,147,,,
441742,20,849,79,770,766,71,695,83,8,75
441760,20,4808,2180,2628,1370,717,653,3438,1463,1975
441788,20,406,366,40,273,243,30,133,123,10
441830,20,41,10,31,41,10,31,,,
441858,20,202,9,193,177,5,172,25,4,21
441876,20,211,6,205,127,5,122,84,1,83
441900,20,7115,1970,5145,1997,440,1557,5118,1530,3588
441937,20,5734,1948,3786,4319,1409,2910,1415,539,876
441982,20,386,194,192,356,178,178,30,16,14
442073,20,600,123,477,433,105,328,167,18,149
442134,20,320,64,256,320,64,256,,,
442240,20,405,79,326,248,45,203,157,34,123
442329,20,931,832,99,931,832,99,,,
442356,20,1640,184,1456,555,66,489,1085,118,967
442383,20,146,21,125,146,21,125,,,
442426,20,407,37,370,280,24,256,127,13,114
442435,20,61,12,49,61,12,49,,,
442444,20,969,500,469,969,500,469,,,
442523,20,77,29,48,73,27,46,4,2,2
442569,20,4598,1758,2840,1454,542,912,3144,1216,1928
442602,20,377,51,326,377,51,326,,,
442611,20,1274,1195,79,1274,1195,79,,,
442639,20,223,140,83,223,140,83,,,
442657,20,241,13,228,241,13,228,,,
442781,20,922,199,723,232,46,186,690,153,537
442842,20,60,15,45,20,6,14,40,9,31
442879,20,886,73,813,867,70,797,19,3,16
442888,20,46,44,2,46,44,2,,,
442930,20,487,221,266,453,202,251,34,19,15
442976,20,64,6,58,64,6,58,,,
442985,20,263,35,228,263,35,228,,,
443021,20,24,23,1,24,23,1,,,
443049,20,177,99,78,88,47,41,89,52,37
443058,20,34,13,21,3,2,1,31,11,20
443100,20,46,28,18,46,28,18,,,
443137,20,232,46,186,232,46,186,,,
443146,20,52,40,12,36,28,8,16,12,4
443207,20,98,94,4,98,94,4,,,
443216,20,150,124,26,150,124,26,,,
443225,20,33,26,7,33,26,7,,,
443234,20,178,10,168,178,10,168,,,
443252,20,2288,1218,1070,2288,1218,1070,,,
443261,20,196,18,178,141,16,125,55,2,53
443289,20,200,15,185,200,15,185,,,
443298,20,29,26,3,29,26,3,,,
443322,20,229,41,188,229,41,188,,,
443331,20,2620,525,2095,2090,416,1674,530,109,421
443340,20,51,23,28,51,23,28,,,
443377,20,53,44,9,53,44,9,,,
443410,20,1067,741,326,972,670,302,95,71,24
443492,20,1460,602,858,756,361,395,704,241,463
443562,20,279,40,239,147,22,125,132,18,114
443571,20,449,224,225,449,224,225,,,
443599,20,751,66,685,176,27,149,575,39,536
443632,20,55,35,20,55,35,20,,,
443641,20,129,4,125,65,3,62,64,1,63
443650,20,2478,475,2003,2111,343,1768,367,132,235
443669,20,69,6,63,69,6,63,,,
443696,20,48,11,37,48,11,37,,,
443748,20,319,74,245,308,74,234,11,0,11
443766,20,2598,504,2094,145,64,81,2453,440,2013
443784,20,1222,289,933,67,29,38,1155,260,895
443951,20,45,18,27,45,18,27,,,
443979,20,73,0,73,6,0,6,67,0,67
444051,20,43,0,43,31,0,31,12,0,12
444088,20,528,72,456,528,72,456,,,
444130,20,106,25,81,15,3,12,91,22,69
444194,20,190,7,183,190,7,183,,,
444219,20,8796,3932,4864,1898,924,974,6898,3008,3890
444228,20,30,0,30,30,0,30,,,
444255,20,57,3,54,57,3,54,,,
444282,20,84,2,82,36,1,35,48,1,47
444291,20,125,5,120,85,3,82,40,2,38
444307,20,62,2,60,47,1,46,15,1,14
444325,20,114,19,95,107,18,89,7,1,6
444334,20,92,18,74,92,18,74,,,
444361,20,54,25,29,54,25,29,,,
444370,20,32,30,2,32,30,2,,,
444398,20,108,52,56,77,40,37,31,12,19
444404,20,21,8,13,13,6,7,8,2,6
444413,20,147,147,0,147,147,0,,,
444440,20,37,5,32,37,5,32,,,
444468,20,40,1,39,35,1,34,5,0,5
444486,20,272,11,261,240,9,231,32,2,30
444510,20,77,4,73,77,4,73,,,
444529,20,27,3,24,27,3,24,,,
444556,20,437,212,225,437,212,225,,,
444565,20,343,148,195,248,106,142,95,42,53
444583,20,375,160,215,375,160,215,,,
444635,20,74,8,66,74,8,66,,,
444662,20,68,58,10,68,58,10,,,
444671,20,142,57,85,142,57,85,,,
444714,20,154,18,136,154,18,136,,,
444732,20,58,12,46,58,12,46,,,
444778,20,44,19,25,24,8,16,20,11,9
444787,20,2988,402,2586,1793,225,1568,1195,177,1018
444811,20,361,20,341,170,12,158,191,8,183
444857,20,130,2,128,72,1,71,58,1,57
444866,20,155,8,147,115,6,109,40,2,38
444893,20,267,8,259,267,8,259,,,
444936,20,108,18,90,107,17,90,1,1,0
444945,20,287,29,258,287,29,258,,,
444954,20,1273,495,778,648,274,374,625,221,404
445027,20,10447,3826,6621,9543,3567,5976,904,259,645
445133,20,122,47,75,85,35,50,37,12,25
445188,20,8343,4251,4092,8202,4167,4035,141,84,57
445203,20,185,24,161,185,24,161,,,
445212,20,168,34,134,84,19,65,84,15,69
445230,20,711,207,504,711,207,504,,,
445249,20,240,63,177,240,63,177,,,
445267,20,2808,809,1999,893,172,721,1915,637,1278
445364,20,620,62,558,620,62,558,,,
445461,20,260,78,182,257,78,179,3,0,3
445498,20,11,11,0,11,11,0,,,
445540,20,57,0,57,57,0,57,,,
445647,20,163,7,156,95,4,91,68,3,65
445656,20,213,7,206,131,3,128,82,4,78
445692,20,517,422,95,476,388,88,41,34,7
445708,20,1140,387,753,1101,373,728,39,14,25
445735,20,574,150,424,574,150,424,,,
445744,20,458,57,401,458,57,401,,,
445762,20,188,175,13,123,114,9,65,61,4
445780,20,21,4,17,21,4,17,,,
445799,20,1001,964,37,1001,964,37,,,
445841,20,156,2,154,123,2,121,33,0,33
445850,20,117,3,114,84,2,82,33,1,32
445911,20,737,323,414,539,244,295,198,79,119
445948,20,1962,292,1670,1962,292,1670,,,
445957,20,284,66,218,,,,284,66,218
446048,20,1247,564,683,1224,555,669,23,9,14
446084,20,61,7,54,,,,61,7,54
446093,20,56,4,52,56,4,52,,,
446109,20,294,46,248,222,40,182,72,6,66
446118,20,579,104,475,579,104,475,,,
446127,20,194,12,182,194,12,182,,,
446163,20,485,458,27,296,278,18,189,180,9
446206,20,59,2,57,48,2,46,11,0,11
446224,20,11,5,6,,,,11,5,6
446233,20,157,88,69,140,81,59,17,7,10
446242,20,128,30,98,128,30,98,,,
446251,20,64,20,44,64,20,44,,,
446260,20,766,16,750,766,16,750,,,
446288,20,77,0,77,50,0,50,27,0,27
446303,20,69,1,68,55,0,55,14,1,13
446349,20,24,3,21,24,3,21,,,
446385,20,239,138,101,225,130,95,14,8,6
446516,20,5,3,2,5,3,2,,,
446525,20,1556,1314,242,1556,1314,242,,,
446552,20,1521,813,708,1521,813,708,,,
446561,20,2035,439,1596,2035,439,1596,,,
446598,20,24,2,22,23,2,21,1,0,1
446604,20,2590,2590,0,2590,2590,0,,,
446640,20,649,448,201,578,406,172,71,42,29
446774,20,4247,1662,2585,750,312,438,3497,1350,2147
447014,20,180,15,165,180,15,165,,,
447023,20,1981,820,1161,1959,815,1144,22,5,17
447050,20,212,60,152,72,23,49,140,37,103
447148,20,192,4,188,130,4,126,62,0,62
447166,20,58,5,53,37,4,33,21,1,20
447175,20,73,4,69,42,3,39,31,1,30
447263,20,2178,339,1839,1327,206,1121,851,133,718
447351,20,556,302,254,556,302,254,,,
447421,20,223,22,201,223,22,201,,,
447449,20,56,15,41,37,13,24,19,2,17
447467,20,98,5,93,98,5,93,,,
447582,20,1007,332,675,562,196,366,445,136,309
447591,20,714,74,640,714,74,640,,,
447607,20,1513,784,729,1513,784,729,,,
447616,20,1208,701,507,1208,701,507,,,
447689,20,11030,4553,6477,7188,2999,4189,3842,1554,2288
447704,20,115,2,113,115,2,113,,,
447713,20,150,49,101,150,49,101,,,
447722,20,38,3,35,38,3,35,,,
447731,20,93,7,86,60,6,54,33,1,32
447759,20,263,71,192,241,67,174,22,4,18
447768,20,1639,381,1258,1639,381,1258,,,
447777,20,802,455,347,17,11,6,785,444,341
447795,20,20,2,18,20,2,18,,,
447810,20,18,4,14,18,4,14,,,
447847,20,241,224,17,241,224,17,,,
447865,20,18,13,5,16,12,4,2,1,1
447883,20,153,21,132,66,13,53,87,8,79
447892,20,86,8,78,71,7,64,15,1,14
447908,20,68,1,67,41,0,41,27,1,26
447917,20,41,8,33,41,8,33,,,
447935,20,264,12,252,264,12,252,,,
447953,20,416,211,205,280,139,141,136,72,64
447962,20,142,10,132,142,10,132,,,
447971,20,38,3,35,38,3,35,,,
447980,20,58,1,57,42,1,41,16,0,16
447999,20,168,32,136,168,32,136,,,
448026,20,122,6,116,96,6,90,26,0,26
448071,20,126,7,119,126,7,119,,,
448123,20,209,28,181,209,28,181,,,
448196,20,109,9,100,106,9,97,3,0,3
448220,20,143,6,137,143,6,137,,,
448239,20,118,4,114,118,4,114,,,
448248,20,3306,1838,1468,384,44,340,2922,1794,1128
448257,20,17,0,17,2,0,2,15,0,15
448275,20,19,0,19,19,0,19,,,
448372,20,189,75,114,189,75,114,,,
448424,20,56,11,45,27,6,21,29,5,24
448433,20,1140,1095,45,1140,1095,45,,,
448594,20,3845,1412,2433,1222,470,752,2623,942,1681
448600,20,198,16,182,198,16,182,,,
448646,20,80,2,78,80,2,78,,,
448673,20,2384,232,2152,1021,93,928,1363,139,1224
448770,20,273,256,17,263,249,14,10,7,3
448798,20,116,6,110,116,6,110,,,
448859,20,120,110,10,120,110,10,,,
448895,20,561,83,478,561,83,478,,,
449038,20,1257,361,896,213,120,93,1044,241,803
449074,20,551,62,489,551,62,489,,,
449083,20,202,202,0,202,202,0,,,
449092,20,128,128,0,128,128,0,,,
449135,20,221,67,154,152,61,91,69,6,63
449250,20,660,113,547,660,113,547,,,
449311,20,139,1,138,42,0,42,97,1,96
449320,20,697,679,18,516,503,13,181,176,5
449339,20,39206,25072,14134,2934,1547,1387,36272,23525,12747
449348,20,66,23,43,9,5,4,57,18,39
449357,20,81,4,77,81,4,77,,,
449384,20,539,334,205,299,183,116,240,151,89
449393,20,120,40,80,120,40,80,,,
449445,20,70,11,59,70,11,59,,,
449454,20,45,7,38,,,,45,7,38
449463,20,181,46,135,105,24,81,76,22,54
449472,20,82,1,81,82,1,81,,,
449490,20,90,17,73,90,17,73,,,
449506,20,122,35,87,122,35,87,,,
449524,20,308,26,282,308,26,282,,,
449533,20,57,9,48,57,9,48,,,
449597,20,2,0,2,2,0,2,,,
449603,20,176,103,73,176,103,73,,,
449612,20,97,45,52,97,45,52,,,
449658,20,110,110,0,107,107,0,3,3,0
449676,20,330,138,192,330,138,192,,,
449685,20,216,17,199,216,17,199,,,
449700,20,369,81,288,369,81,288,,,
449728,20,177,8,169,177,8,169,,,
449764,20,211,96,115,205,94,111,6,2,4
449773,20,187,31,156,187,31,156,,,
449782,20,22,3,19,16,2,14,6,1,5
449807,20,71,7,64,71,7,64,,,
449816,20,693,479,214,53,34,19,640,445,195
449834,20,2,2,0,,,,2,2,0
449861,20,61,4,57,61,4,57,,,
449870,20,62,24,38,60,24,36,2,0,2
449889,20,142,36,106,142,36,106,,,
449898,20,421,75,346,313,56,257,108,19,89
449904,20,164,3,161,164,3,161,,,
449959,20,150,36,114,85,20,65,65,16,49
449968,20,284,55,229,208,40,168,76,15,61
449977,20,206,3,203,161,2,159,45,1,44
449986,20,263,67,196,163,36,127,100,31,69
449995,20,129,7,122,74,5,69,55,2,53
450058,20,818,152,666,818,152,666,,,
450067,20,481,135,346,473,135,338,8,0,8
450128,20,533,18,515,533,18,515,,,
450298,20,239,57,182,20,13,7,219,44,175
450377,20,1237,237,1000,85,38,47,1152,199,953
450395,20,136,1,135,98,1,97,38,0,38
450401,20,416,46,370,416,46,370,,,
450571,20,424,50,374,193,25,168,231,25,206
450599,20,50,1,49,50,1,49,,,
450605,20,53,4,49,34,3,31,19,1,18
450614,20,114,4,110,82,3,79,32,1,31
450632,20,87,17,70,,,,87,17,70
450641,20,273,19,254,171,16,155,102,3,99
450650,20,230,20,210,81,0,81,149,20,129
450696,20,412,59,353,412,59,353,,,
450702,20,34,4,30,34,4,30,,,
450711,20,84,65,19,84,65,19,,,
450720,20,692,8,684,298,5,293,394,3,391
450933,20,11330,7420,3910,6428,3970,2458,4902,3450,1452
450951,20,150,79,71,150,79,71,,,
450960,20,326,32,294,249,23,226,77,9,68
450988,20,195,20,175,131,15,116,64,5,59
451042,20,15,4,11,7,0,7,8,4,4
451051,20,116,9,107,,,,116,9,107
451097,20,50,10,40,34,4,30,16,6,10
451103,20,267,48,219,92,16,76,175,32,143
451121,20,117,9,108,55,4,51,62,5,57
451149,20,995,65,930,995,65,930,,,
451158,20,773,33,740,773,33,740,,,
451167,20,168,85,83,94,56,38,74,29,45
451194,20,32,3,29,32,3,29,,,
451228,20,182,147,35,182,147,35,,,
451237,20,214,5,209,214,5,209,,,
451255,20,52,2,50,29,0,29,23,2,21
451282,20,124,4,120,80,2,78,44,2,42
451291,20,8,1,7,,,,8,1,7
451307,20,36,0,36,3,0,3,33,0,33
451316,20,54,4,50,54,4,50,,,
451334,20,289,121,168,153,67,86,136,54,82
451343,20,90,4,86,57,2,55,33,2,31
451352,20,142,22,120,107,19,88,35,3,32
451370,20,59,59,0,59,59,0,,,
451398,20,213,213,0,213,213,0,,,
451404,20,459,459,0,459,459,0,,,
451413,20,393,102,291,393,102,291,,,
451459,20,41,8,33,10,0,10,31,8,23
451468,20,432,4,428,432,4,428,,,
451477,20,1483,1203,280,1483,1203,280,,,
451495,20,281,71,210,281,71,210,,,
451501,20,282,97,185,282,97,185,,,
451529,20,59,1,58,36,0,36,23,1,22
451547,20,16,4,12,16,4,12,,,
451556,20,1596,550,1046,1596,550,1046,,,
451565,20,181,24,157,168,14,154,13,10,3
451574,20,173,8,165,137,6,131,36,2,34
451583,20,1004,751,253,150,108,42,854,643,211
451626,20,19,1,18,19,1,18,,,
451714,20,292,51,241,181,12,169,111,39,72
451741,20,92,30,62,66,23,43,26,7,19
451750,20,1043,251,792,640,211,429,403,40,363
451820,20,78,47,31,50,30,20,28,17,11
451857,20,63,4,59,63,4,59,,,
451866,20,352,66,286,352,66,286,,,
451918,20,121,13,108,121,13,108,,,
451927,20,409,215,194,356,194,162,53,21,32
452009,20,54,2,52,54,2,52,,,
452072,20,23,1,22,23,1,22,,,
452081,20,894,31,863,894,31,863,,,
452106,20,62,59,3,62,59,3,,,
452124,20,383,83,300,381,82,299,2,1,1
452373,20,309,18,291,309,18,291,,,
452771,20,13,1,12,,,,13,1,12
452780,20,8,1,7,,,,8,1,7
452887,20,49,45,4,49,45,4,,,
452948,20,692,63,629,432,35,397,260,28,232
453163,20,2646,511,2135,190,86,104,2456,425,2031
453215,20,474,103,371,15,3,12,459,100,359
453297,20,35,12,23,,,,35,12,23
453756,20,73,44,29,73,44,29,,,
453792,20,110,7,103,110,7,103,,,
454184,20,326,127,199,283,113,170,43,14,29
454227,20,11661,1251,10410,2767,328,2439,8894,923,7971
454236,20,537,60,477,209,21,188,328,39,289
454245,20,818,142,676,296,50,246,522,92,430
454537,20,61,1,60,61,1,60,,,
454546,20,169,12,157,169,12,157,,,
454555,20,252,12,240,252,12,240,,,
454582,20,172,70,102,24,14,10,148,56,92
454607,20,387,11,376,387,11,376,,,
454652,20,142,3,139,142,3,139,,,
454689,20,2,1,1,2,1,1,,,
454698,20,304,90,214,304,90,214,,,
454722,20,21,3,18,19,2,17,2,1,1
454759,20,38,31,7,33,27,6,5,4,1
454768,20,215,34,181,121,22,99,94,12,82
454777,20,213,29,184,139,20,119,74,9,65
454786,20,641,410,231,180,123,57,461,287,174
454795,20,254,68,186,176,51,125,78,17,61
454801,20,176,34,142,176,34,142,,,
454810,20,8894,2373,6521,8894,2373,6521,,,
454829,20,4086,547,3539,642,90,552,3444,457,2987
454856,20,1034,133,901,1034,133,901,,,
454865,20,939,154,785,643,117,526,296,37,259
454874,20,42,1,41,11,0,11,31,1,30
454917,20,913,145,768,561,84,477,352,61,291
454926,20,319,17,302,270,15,255,49,2,47
454935,20,78,1,77,78,1,77,,,
454944,20,238,15,223,238,15,223,,,
454953,20,42,0,42,20,0,20,22,0,22
454962,20,61,2,59,32,1,31,29,1,28
454971,20,205,18,187,107,16,91,98,2,96
454980,20,145,0,145,28,0,28,117,0,117
454999,20,121,2,119,50,1,49,71,1,70
455008,20,166,5,161,58,3,55,108,2,106
455026,20,86,80,6,,,,86,80,6
455062,20,55,0,55,25,0,25,30,0,30
455071,20,108,30,78,,,,108,30,78
455080,20,239,26,213,238,26,212,1,0,1
455105,20,79,0,79,79,0,79,,,
455114,20,9920,4343,5577,2287,1192,1095,7633,3151,4482
455141,20,208,5,203,208,5,203,,,
455187,20,197,48,149,79,26,53,118,22,96
455196,20,3379,291,3088,3379,291,3088,,,
455202,20,251,37,214,66,6,60,185,31,154
455211,20,317,8,309,317,8,309,,,
455220,20,53,7,46,53,7,46,,,
455257,20,431,431,0,431,431,0,,,
455275,20,251,5,246,251,5,246,,,
455284,20,241,7,234,175,5,170,66,2,64
455327,20,50,3,47,42,3,39,8,0,8
455336,20,204,167,37,204,167,37,,,
455354,20,225,4,221,225,4,221,,,
455381,20,161,0,161,103,0,103,58,0,58
455460,20,127,27,100,127,27,100,,,
455479,20,626,73,553,536,66,470,90,7,83
455488,20,215,83,132,215,83,132,,,
455512,20,3441,1258,2183,646,259,387,2795,999,1796
455628,20,381,129,252,381,129,252,,,
455664,20,284,41,243,14,6,8,270,35,235
455707,20,51,12,39,51,12,39,,,
455725,20,679,10,669,528,7,521,151,3,148
455734,20,205,38,167,205,38,167,,,
455761,20,363,53,310,226,32,194,137,21,116
455770,20,136,78,58,135,78,57,1,0,1
455798,20,101,1,100,49,1,48,52,0,52
455831,20,115,13,102,115,13,102,,,
455859,20,254,3,251,219,3,216,35,0,35
455868,20,292,39,253,292,39,253,,,
455877,20,93,5,88,93,5,88,,,
455886,20,185,8,177,87,1,86,98,7,91
455895,20,416,27,389,177,4,173,239,23,216
455901,20,169,14,155,79,5,74,90,9,81
455910,20,49,7,42,49,7,42,,,
455929,20,55,0,55,55,0,55,,,
455965,20,130,8,122,130,8,122,,,
455974,20,160,9,151,160,9,151,,,
455983,20,182,55,127,180,54,126,2,1,1
456001,20,94,89,5,94,89,5,,,
456029,20,232,9,223,170,9,161,62,0,62
456038,20,384,45,339,384,45,339,,,
456065,20,142,2,140,138,2,136,4,0,4
456074,20,143,7,136,142,7,135,1,0,1
456135,20,95,1,94,66,1,65,29,0,29
456153,20,73,63,10,73,63,10,,,
456205,20,166,43,123,162,43,119,4,0,4
456214,20,390,241,149,390,241,149,,,
456287,20,117,1,116,117,1,116,,,
456454,20,438,125,313,361,114,247,77,11,66
456481,20,34,18,16,,,,34,18,16
456490,20,115,77,38,36,25,11,79,52,27
456506,20,72,3,69,72,3,69,,,
456515,20,36,2,34,36,2,34,,,
456551,20,69,3,66,69,3,66,,,
456579,20,233,92,141,217,90,127,16,2,14
456588,20,45,1,44,45,1,44,,,
456597,20,271,5,266,139,2,137,132,3,129
456621,20,288,88,200,21,10,11,267,78,189
456825,20,169,8,161,121,4,117,48,4,44
456852,20,374,129,245,374,129,245,,,
456922,20,247,48,199,229,46,183,18,2,16
456931,20,320,170,150,312,169,143,8,1,7
456959,20,630,124,506,595,114,481,35,10,25
456968,20,1142,53,1089,1070,48,1022,72,5,67
456977,20,61,53,8,61,53,8,,,
457031,20,65,0,65,43,0,43,22,0,22
457077,20,432,31,401,432,31,401,,,
457086,20,180,43,137,136,34,102,44,9,35
457101,20,323,92,231,323,92,231,,,
457110,20,463,82,381,463,82,381,,,
457129,20,918,94,824,235,14,221,683,80,603
457192,20,56,40,16,56,40,16,,,
457208,20,120,108,12,120,108,12,,,
457226,20,41,27,14,17,12,5,24,15,9
457253,20,122,6,116,39,2,37,83,4,79
457299,20,365,65,300,323,57,266,42,8,34
457314,20,97,22,75,97,22,75,,,
457323,20,397,44,353,397,44,353,,,
457332,20,41,3,38,41,3,38,,,
457341,20,175,9,166,175,9,166,,,
457350,20,74,0,74,,,,74,0,74
457378,20,183,97,86,93,38,55,90,59,31
457387,20,305,161,144,147,78,69,158,83,75
457396,20,112,30,82,18,7,11,94,23,71
457402,20,218,188,30,46,43,3,172,145,27
457411,20,244,223,21,177,159,18,67,64,3
457420,20,172,11,161,121,10,111,51,1,50
457439,20,145,2,143,71,1,70,74,1,73
457448,20,77,1,76,77,1,76,,,
457466,20,38,30,8,38,30,8,,,
457475,20,116,3,113,116,3,113,,,
457484,20,95,42,53,45,21,24,50,21,29
457493,20,60,3,57,60,3,57,,,
457527,20,211,20,191,17,1,16,194,19,175
457536,20,676,103,573,676,103,573,,,
457545,20,92,3,89,73,2,71,19,1,18
457554,20,20,1,19,17,1,16,3,0,3
457563,20,237,7,230,237,7,230,,,
457572,20,138,3,135,138,3,135,,,
457581,20,135,1,134,131,1,130,4,0,4
457606,20,98,4,94,98,4,94,,,
457615,20,46,6,40,,,,46,6,40
457624,20,43,9,34,43,9,34,,,
457633,20,231,8,223,83,1,82,148,7,141
457642,20,42,0,42,42,0,42,,,
457679,20,26,1,25,26,1,25,,,
457697,20,132,63,69,20,9,11,112,54,58
457749,20,98,3,95,98,3,95,,,
457767,20,119,69,50,119,69,50,,,
457776,20,167,15,152,165,14,151,2,1,1
457785,20,41,0,41,41,0,41,,,
457794,20,118,13,105,118,13,105,,,
457800,20,201,22,179,201,22,179,,,
457819,20,676,275,401,,,,676,275,401
457837,20,131,7,124,65,6,59,66,1,65
457855,20,73,3,70,57,2,55,16,1,15
457873,20,88,66,22,43,34,9,45,32,13
457916,20,107,5,102,48,1,47,59,4,55
457925,20,12,6,6,12,6,6,,,
457943,20,40,7,33,40,7,33,,,
457952,20,186,2,184,153,2,151,33,0,33
457989,20,48,0,48,48,0,48,,,
458007,20,69,1,68,37,0,37,32,1,31
458034,20,41,7,34,41,7,34,,,
458043,20,90,1,89,62,1,61,28,0,28
458061,20,68,7,61,28,4,24,40,3,37
458070,20,270,13,257,257,13,244,13,0,13
458098,20,120,2,118,110,2,108,10,0,10
458104,20,225,1,224,5,0,5,220,1,219
458113,20,99,29,70,1,0,1,98,29,69
458122,20,24,0,24,24,0,24,,,
458131,20,137,7,130,137,7,130,,,
458140,20,62,54,8,62,54,8,,,
458168,20,79,4,75,79,4,75,,,
458210,20,3023,680,2343,2287,514,1773,736,166,570
458229,20,2579,565,2014,2095,457,1638,484,108,376
458274,20,197,5,192,165,5,160,32,0,32
458405,20,191,71,120,189,71,118,2,0,2
458441,20,300,44,256,296,44,252,4,0,4
458496,20,88,45,43,59,31,28,29,14,15
458681,20,279,44,235,279,44,235,,,
458803,20,162,1,161,108,1,107,54,0,54
458812,20,91,3,88,73,2,71,18,1,17
458821,20,68,2,66,68,2,66,,,
458830,20,174,3,171,124,0,124,50,3,47
458858,20,225,6,219,130,3,127,95,3,92
458867,20,203,7,196,145,5,140,58,2,56
458885,20,275,45,230,6,1,5,269,44,225
458919,20,4319,978,3341,459,220,239,3860,758,3102
458955,20,277,54,223,12,4,8,265,50,215
458964,20,1625,365,1260,137,75,62,1488,290,1198
458973,20,2251,633,1618,300,167,133,1951,466,1485
458982,20,180,94,86,126,64,62,54,30,24
459019,20,96,6,90,79,5,74,17,1,16
459046,20,57,3,54,44,2,42,13,1,12
459055,20,46,1,45,27,0,27,19,1,18
459064,20,73,5,68,49,3,46,24,2,22
459116,20,102,7,95,102,7,95,,,
459170,20,292,31,261,150,28,122,142,3,139
459189,20,114,0,114,87,0,87,27,0,27
459198,20,333,57,276,240,52,188,93,5,88
459204,20,4857,719,4138,4857,719,4138,,,
459213,20,2668,571,2097,2668,571,2097,,,
459231,20,209,20,189,209,20,189,,,
459259,20,337,104,233,212,34,178,125,70,55
459268,20,205,28,177,152,18,134,53,10,43
459277,20,341,23,318,341,23,318,,,
459286,20,178,23,155,133,15,118,45,8,37
459295,20,72,1,71,32,1,31,40,0,40
459301,20,103,5,98,78,3,75,25,2,23
459329,20,442,271,171,354,208,146,88,63,25
459347,20,95,1,94,21,0,21,74,1,73
459374,20,105,4,101,37,4,33,68,0,68
459392,20,160,6,154,98,6,92,62,0,62
459408,20,56,7,49,41,2,39,15,5,10
459417,20,50,36,14,40,31,9,10,5,5
459426,20,193,5,188,193,5,188,,,
459499,20,22,4,18,22,4,18,,,
459514,20,75,20,55,75,20,55,,,
459523,20,64,6,58,64,6,58,,,
459532,20,99,0,99,12,0,12,87,0,87
459541,20,25,0,25,11,0,11,14,0,14
459550,20,107,3,104,96,3,93,11,0,11
459578,20,108,33,75,75,18,57,33,15,18
459727,20,413,123,290,217,55,162,196,68,128
459824,20,15,1,14,15,1,14,,,
459842,20,627,67,560,324,36,288,303,31,272
459851,20,392,46,346,197,29,168,195,17,178
459949,20,6616,2310,4306,3916,1362,2554,2700,948,1752
459958,20,295,79,216,295,79,216,,,
459967,20,618,243,375,618,243,375,,,
459985,20,508,260,248,508,260,248,,,
459994,20,8368,2654,5714,483,233,250,7885,2421,5464
460011,20,182,0,182,127,0,127,55,0,55
460020,20,431,89,342,431,89,342,,,
460093,20,35,1,34,35,1,34,,,
460109,20,90,3,87,90,3,87,,,
460118,20,62,1,61,62,1,61,,,
460127,20,73,6,67,73,6,67,,,
460136,20,892,139,753,892,139,753,,,
460145,20,105,64,41,105,64,41,,,
460172,20,557,499,58,555,497,58,2,2,0
460181,20,615,91,524,615,91,524,,,
460190,20,320,52,268,320,52,268,,,
460206,20,521,127,394,521,127,394,,,
460349,20,1843,554,1289,484,121,363,1359,433,926
460376,20,11,6,5,11,6,5,,,
460385,20,75,10,65,75,10,65,,,
460394,20,9095,3844,5251,1518,687,831,7577,3157,4420
460464,20,9467,4396,5071,1601,899,702,7866,3497,4369
460482,20,180,17,163,180,17,163,,,
460525,20,27,3,24,27,3,24,,,
460534,20,293,6,287,293,6,287,,,
460543,20,1727,1649,78,1727,1649,78,,,
460677,20,426,91,335,360,79,281,66,12,54
460701,20,234,28,206,57,10,47,177,18,159
460756,20,273,18,255,239,18,221,34,0,34
460765,20,42,2,40,42,2,40,,,
460808,20,9,1,8,9,1,8,,,
460817,20,157,58,99,155,57,98,2,1,1
460826,20,482,107,375,474,105,369,8,2,6
460835,20,235,73,162,233,73,160,2,0,2
460862,20,219,6,213,113,2,111,106,4,102
460871,20,663,72,591,213,20,193,450,52,398
460914,20,328,3,325,328,3,325,,,
460932,20,84,0,84,84,0,84,,,
460969,20,285,19,266,285,19,266,,,
460978,20,298,5,293,149,2,147,149,3,146
460987,20,110,0,110,110,0,110,,,
460996,20,200,3,197,159,2,157,41,1,40
461014,20,867,56,811,867,56,811,,,
461023,20,435,62,373,423,60,363,12,2,10
461032,20,112,54,58,44,24,20,68,30,38
461087,20,1315,688,627,167,65,102,1148,623,525
461111,20,31,29,2,29,28,1,2,1,1
461148,20,996,601,395,996,601,395,,,
461175,20,200,16,184,133,14,119,67,2,65
461193,20,191,1,190,186,1,185,5,0,5
461218,20,844,59,785,844,59,785,,,
461245,20,127,61,66,34,12,22,93,49,44
461254,20,49,10,39,49,10,39,,,
461263,20,161,11,150,161,11,150,,,
461272,20,85,0,85,49,0,49,36,0,36
461281,20,103,7,96,69,5,64,34,2,32
461306,20,165,49,116,31,15,16,134,34,100
461315,20,151,33,118,28,7,21,123,26,97
461324,20,791,169,622,754,161,593,37,8,29
461333,20,10,9,1,10,9,1,,,
461342,20,136,0,136,97,0,97,39,0,39
461379,20,32,7,25,6,1,5,26,6,20
461388,20,55,18,37,55,18,37,,,
461412,20,139,41,98,,,,139,41,98
461421,20,208,11,197,206,11,195,2,0,2
461430,20,591,548,43,,,,591,548,43
461494,20,175,15,160,101,7,94,74,8,66
461500,20,31,5,26,23,3,20,8,2,6
461528,20,191,94,97,72,35,37,119,59,60
461537,20,38,1,37,37,1,36,1,0,1
461555,20,145,8,137,145,8,137,,,
461573,20,127,125,2,127,125,2,,,
461582,20,163,2,161,163,2,161,,,
461591,20,118,5,113,117,5,112,1,0,1
461607,20,90,13,77,35,9,26,55,4,51
461625,20,13,13,0,13,13,0,,,
461643,20,17,1,16,17,1,16,,,
461652,20,94,6,88,94,6,88,,,
461689,20,316,38,278,316,38,278,,,
461704,20,161,8,153,156,7,149,5,1,4
461713,20,40,0,40,15,0,15,25,0,25
461722,20,60,1,59,60,1,59,,,
461740,20,30,26,4,30,26,4,,,
461759,20,237,124,113,192,104,88,45,20,25
461768,20,241,4,237,170,3,167,71,1,70
461786,20,26,0,26,26,0,26,,,
461795,20,453,333,120,429,316,113,24,17,7
461810,20,25,9,16,22,8,14,3,1,2
461829,20,94,24,70,94,24,70,,,
461838,20,175,2,173,116,1,115,59,1,58
461847,20,54,54,0,54,54,0,,,
461856,20,64,30,34,64,30,34,,,
461865,20,25,2,23,25,2,23,,,
461874,20,98,13,85,98,13,85,,,
461883,20,42,20,22,31,16,15,11,4,7
461892,20,71,10,61,71,10,61,,,
461908,20,84,0,84,82,0,82,2,0,2
461917,20,215,0,215,121,0,121,94,0,94
461926,20,157,2,155,112,2,110,45,0,45
461944,20,101,1,100,101,1,100,,,
461953,20,28,1,27,17,1,16,11,0,11
461962,20,407,313,94,407,313,94,,,
461999,20,168,10,158,148,9,139,20,1,19
462008,20,239,15,224,154,12,142,85,3,82
462017,20,124,17,107,124,17,107,,,
462035,20,356,128,228,98,4,94,258,124,134
462053,20,55,2,53,55,2,53,,,
462062,20,113,0,113,68,0,68,45,0,45
462071,20,185,40,145,181,39,142,4,1,3
462336,20,66,4,62,66,4,62,,,
462345,20,35,0,35,18,0,18,17,0,17
462354,20,300,150,150,282,138,144,18,12,6
463056,20,1535,774,761,1422,710,712,113,64,49
464226,20,1106,605,501,889,519,370,217,86,131
466921,20,375,21,354,115,3,112,260,18,242
466930,20,2167,286,1881,510,69,441,1657,217,1440
467094,20,166,1,165,166,1,165,,,
467368,20,40,4,36,40,4,36,,,
467863,20,236,43,193,189,34,155,47,9,38
467872,20,284,11,273,200,8,192,84,3,81
467906,20,146,2,144,112,2,110,34,0,34
468246,20,98,9,89,98,9,89,,,
468255,20,12,2,10,12,2,10,,,
468291,20,74,8,66,74,8,66,,,
468769,20,179,173,6,179,173,6,,,
468848,20,848,434,414,848,434,414,,,
468893,20,174,6,168,114,5,109,60,1,59
468909,20,999,401,598,999,401,598,,,
468963,20,707,667,40,707,667,40,,,
469416,20,292,63,229,182,53,129,110,10,100
469610,20,9,1,8,9,1,8,,,
469629,20,147,128,19,147,128,19,,,
469911,20,95,6,89,95,6,89,,,
469957,20,24,0,24,24,0,24,,,
470038,20,1268,583,685,1268,583,685,,,
470047,20,38,11,27,38,11,27,,,
470296,20,15,0,15,15,0,15,,,
470393,20,145,8,137,52,4,48,93,4,89
474863,20,1671,307,1364,572,111,461,1099,196,903
474915,20,451,6,445,245,2,243,206,4,202
474924,20,184,5,179,39,3,36,145,2,143
475015,20,180,1,179,180,1,179,,,
475024,20,244,80,164,244,80,164,,,
475033,20,153,27,126,,,,153,27,126
475060,20,210,18,192,208,18,190,2,0,2
475121,20,5738,1277,4461,4061,932,3129,1677,345,1332
475176,20,704,391,313,704,391,313,,,
475200,20,177,53,124,28,9,19,149,44,105
475273,20,309,59,250,52,9,43,257,50,207
475282,20,93,26,67,93,26,67,,,
475325,20,170,4,166,170,4,166,,,
475398,20,75,38,37,15,8,7,60,30,30
475404,20,149,2,147,84,1,83,65,1,64
475422,20,98,5,93,12,0,12,86,5,81
475431,20,49,4,45,49,4,45,,,
475468,20,279,4,275,77,2,75,202,2,200
475477,20,257,86,171,81,46,35,176,40,136
475486,20,264,48,216,168,20,148,96,28,68
475547,20,120,25,95,63,19,44,57,6,51
475556,20,153,10,143,95,5,90,58,5,53
475565,20,842,460,382,752,414,338,90,46,44
475574,20,38,17,21,21,7,14,17,10,7
475608,20,122,78,44,78,52,26,44,26,18
475635,20,20,6,14,5,3,2,15,3,12
475653,20,28,1,27,27,1,26,1,0,1
475662,20,55,0,55,26,0,26,29,0,29
475705,20,21,5,16,21,5,16,,,
475714,20,333,282,51,289,251,38,44,31,13
475723,20,632,380,252,138,72,66,494,308,186
475732,20,1421,134,1287,355,35,320,1066,99,967
475741,20,202,16,186,92,7,85,110,9,101
475839,20,308,155,153,153,87,66,155,68,87
476063,20,272,252,20,272,252,20,,,
476179,20,171,11,160,110,7,103,61,4,57
476230,20,30,2,28,30,2,28,,,
476355,20,29,12,17,29,12,17,,,
476489,20,93,71,22,93,71,22,,,
476498,20,250,163,87,250,163,87,,,
476513,20,44,1,43,44,1,43,,,
476540,20,109,2,107,77,1,76,32,1,31
476559,20,105,6,99,61,4,57,44,2,42
476568,20,19,13,6,19,13,6,,,
476595,20,93,16,77,93,16,77,,,
476601,20,86,86,0,86,86,0,,,
476610,20,28,17,11,28,17,11,,,
476629,20,143,6,137,143,6,137,,,
476683,20,245,12,233,242,12,230,3,0,3
476692,20,40,40,0,40,40,0,,,
476708,20,148,110,38,129,95,34,19,15,4
476717,20,638,638,0,638,638,0,,,
476726,20,660,111,549,660,111,549,,,
476735,20,26,16,10,26,16,10,,,
476753,20,229,6,223,115,5,110,114,1,113
476780,20,95,7,88,83,7,76,12,0,12
476799,20,327,58,269,327,58,269,,,
476805,20,44,0,44,44,0,44,,,
476814,20,611,421,190,,,,611,421,190
476841,20,237,23,214,154,16,138,83,7,76
476850,20,82,57,25,82,57,25,,,
476869,20,79,4,75,79,4,75,,,
476878,20,138,3,135,67,1,66,71,2,69
476887,20,599,8,591,578,8,570,21,0,21
476896,20,162,71,91,162,71,91,,,
476902,20,88,2,86,56,1,55,32,1,31
476939,20,682,60,622,682,60,622,,,
476957,20,12,1,11,10,1,9,2,0,2
476975,20,6433,2958,3475,1525,722,803,4908,2236,2672
476984,20,228,12,216,180,9,171,48,3,45
476993,20,246,2,244,246,2,244,,,
477002,20,47,3,44,43,3,40,4,0,4
477039,20,975,125,850,621,80,541,354,45,309
477233,20,97,41,56,97,41,56,,,
478582,20,157,7,150,112,6,106,45,1,44
478591,20,164,4,160,95,2,93,69,2,67
478616,20,104,7,97,78,5,73,26,2,24
478917,20,74,3,71,74,3,71,,,
478953,20,203,6,197,203,6,197,,,
479062,20,113,107,6,67,64,3,46,43,3
479424,20,289,41,248,289,41,248,,,
479956,20,8210,3925,4285,3322,1412,1910,4888,2513,2375
479965,20,142,16,126,142,16,126,,,
479974,20,88,32,56,82,32,50,6,0,6
479983,20,108,14,94,108,14,94,,,
479992,20,21,19,2,3,2,1,18,17,1
480000,20,52,33,19,49,31,18,3,2,1
480019,20,910,770,140,798,669,129,112,101,11
480028,20,162,127,35,160,126,34,2,1,1
480037,20,1251,942,309,1251,942,309,,,
480073,20,288,49,239,228,36,192,60,13,47
480091,20,9050,1156,7894,5479,554,4925,3571,602,2969
480125,20,448,15,433,210,6,204,238,9,229
480161,20,12,1,11,12,1,11,,,
480198,20,269,86,183,189,62,127,80,24,56
480204,20,446,74,372,446,74,372,,,
480310,20,81,0,81,72,0,72,9,0,9
480471,20,813,461,352,813,461,352,,,
480523,20,82,5,77,82,5,77,,,
480532,20,37,1,36,37,1,36,,,
480550,20,31,0,31,31,0,31,,,
480569,20,779,292,487,495,171,324,284,121,163
480657,20,568,70,498,277,32,245,291,38,253
480727,20,29,21,8,29,21,8,,,
480781,20,99,80,19,91,73,18,8,7,1
480824,20,545,54,491,545,54,491,,,
480833,20,832,89,743,832,89,743,,,
480842,20,34,17,17,34,17,17,,,
480851,20,31,13,18,31,13,18,,,
480879,20,52,5,47,52,5,47,,,
480888,20,171,76,95,171,76,95,,,
480903,20,566,497,69,489,425,64,77,72,5
480921,20,88,73,15,88,73,15,,,
480930,20,37,0,37,28,0,28,9,0,9
480967,20,243,81,162,128,52,76,115,29,86
480976,20,63,6,57,63,6,57,,,
480985,20,279,1,278,279,1,278,,,
480994,20,116,4,112,90,4,86,26,0,26
481003,20,199,165,34,199,165,34,,,
481021,20,42,32,10,33,26,7,9,6,3
481049,20,18,4,14,18,4,14,,,
481058,20,100,42,58,85,35,50,15,7,8
481085,20,226,19,207,226,19,207,,,
481100,20,106,20,86,25,5,20,81,15,66
481128,20,83,11,72,69,11,58,14,0,14
481137,20,86,41,45,86,41,45,,,
481146,20,84,11,73,50,4,46,34,7,27
481155,20,170,66,104,170,66,104,,,
481182,20,32,5,27,32,5,27,,,
481191,20,230,35,195,230,35,195,,,
481207,20,131,18,113,131,18,113,,,
481225,20,17,10,7,17,10,7,,,
481243,20,248,0,248,79,0,79,169,0,169
481252,20,64,8,56,64,8,56,,,
481289,20,88,22,66,88,22,66,,,
481298,20,60,1,59,60,1,59,,,
481313,20,82,1,81,48,1,47,34,0,34
481322,20,48,2,46,15,0,15,33,2,31
481331,20,78,58,20,78,58,20,,,
481340,20,45,0,45,45,0,45,,,
481368,20,69,6,63,69,6,63,,,
481386,20,339,39,300,5,0,5,334,39,295
481401,20,184,120,64,22,15,7,162,105,57
481410,20,79,79,0,79,79,0,,,
481429,20,104,15,89,104,15,89,,,
481438,20,67,67,0,67,67,0,,,
481447,20,29,5,24,10,2,8,19,3,16
481456,20,15,1,14,5,0,5,10,1,9
481465,20,78,2,76,55,1,54,23,1,22
481474,20,131,2,129,122,2,120,9,0,9
481483,20,111,5,106,63,2,61,48,3,45
481517,20,91,7,84,53,5,48,38,2,36
481526,20,217,1,216,217,1,216,,,
481571,20,12,6,6,12,6,6,,,
481678,20,71,1,70,44,1,43,27,0,27
481720,20,47,4,43,32,1,31,15,3,12
481739,20,47,3,44,34,3,31,13,0,13
481748,20,112,2,110,92,2,90,20,0,20
481775,20,248,75,173,248,75,173,,,
481845,20,73,2,71,44,1,43,29,1,28
481863,20,55,4,51,55,4,51,,,
481890,20,52,2,50,52,2,50,,,
481906,20,41,1,40,41,1,40,,,
481960,20,172,142,30,172,142,30,,,
482015,20,772,555,217,772,555,217,,,
482060,20,238,33,205,238,33,205,,,
482097,20,340,168,172,323,164,159,17,4,13
482149,20,5378,1894,3484,4363,1485,2878,1015,409,606
482158,20,7259,3204,4055,4260,1997,2263,2999,1207,1792
482167,20,128,1,127,35,0,35,93,1,92
482176,20,252,9,243,182,7,175,70,2,68
482185,20,65,50,15,65,50,15,,,
482194,20,144,22,122,105,16,89,39,6,33
482200,20,64,12,52,64,12,52,,,
482228,20,138,83,55,39,28,11,99,55,44
482246,20,28,25,3,28,25,3,,,
482255,20,294,268,26,204,188,16,90,80,10
482291,20,1358,630,728,1358,630,728,,,
482413,20,423,212,211,238,137,101,185,75,110
482422,20,60,37,23,27,16,11,33,21,12
482431,20,1583,877,706,829,480,349,754,397,357
482459,20,281,122,159,114,49,65,167,73,94
482468,20,509,212,297,227,103,124,282,109,173
482477,20,23357,8217,15140,9523,3685,5838,13834,4532,9302
482547,20,10,6,4,4,3,1,6,3,3
482556,20,88,53,35,45,24,21,43,29,14
482565,20,8,3,5,2,1,1,6,2,4
482574,20,218,110,108,104,60,44,114,50,64
482635,20,84,55,29,47,33,14,37,22,15
482653,20,59,32,27,38,19,19,21,13,8
482680,20,17240,7544,9696,11720,5193,6527,5520,2351,3169
482699,20,1793,577,1216,1081,376,705,712,201,511
482705,20,3224,1231,1993,1808,604,1204,1416,627,789
482936,20,1531,1244,287,1361,1108,253,170,136,34
482963,20,397,73,324,397,73,324,,,
482981,20,145,126,19,102,89,13,43,37,6
482990,20,259,20,239,259,20,239,,,
483009,20,206,23,183,206,23,183,,,
483018,20,127,38,89,127,38,89,,,
483036,20,1712,679,1033,584,270,314,1128,409,719
483045,20,9683,3841,5842,1762,704,1058,7921,3137,4784
483054,20,104,75,29,104,75,29,,,
483106,20,207,28,179,145,19,126,62,9,53
483124,20,46679,17164,29515,17981,5773,12208,28698,11391,17307
483212,20,4105,1692,2413,1457,626,831,2648,1066,1582
483221,20,32,15,17,32,15,17,,,
483230,20,148,140,8,121,114,7,27,26,1
483258,20,12,9,3,12,9,3,,,
483276,20,62,53,9,62,53,9,,,
483328,20,86,11,75,66,9,57,20,2,18
483337,20,153,6,147,97,4,93,56,2,54
483346,20,63,3,60,63,3,60,,,
483355,20,194,6,188,194,6,188,,,
483364,20,129,10,119,129,10,119,,,
483373,20,150,18,132,135,17,118,15,1,14
483382,20,232,228,4,232,228,4,,,
483425,20,51,3,48,51,3,48,,,
483470,20,63,5,58,63,5,58,,,
483504,20,359,114,245,359,114,245,,,
483513,20,31,21,10,31,21,10,,,
483559,20,58,7,51,37,5,32,21,2,19
483577,20,39,2,37,23,2,21,16,0,16
483595,20,4662,1068,3594,2600,604,1996,2062,464,1598
483647,20,32,2,30,32,2,30,,,
483708,20,266,50,216,91,11,80,175,39,136
483726,20,21,0,21,8,0,8,13,0,13
483735,20,70,6,64,36,4,32,34,2,32
483744,20,67,55,12,67,55,12,,,
483753,20,46,40,6,20,15,5,26,25,1
483780,20,176,115,61,167,109,58,9,6,3
483799,20,53,12,41,53,12,41,,,
483814,20,623,46,577,573,41,532,50,5,45
483823,20,635,450,185,635,450,185,,,
483841,20,26,4,22,26,4,22,,,
483850,20,7,1,6,7,1,6,,,
483869,20,124,33,91,124,33,91,,,
483878,20,211,20,191,211,20,191,,,
483887,20,36,10,26,36,10,26,,,
483896,20,202,7,195,32,2,30,170,5,165
483911,20,22,0,22,22,0,22,,,
483920,20,202,115,87,202,115,87,,,
483948,20,33,25,8,29,22,7,4,3,1
483957,20,42,11,31,42,11,31,,,
484002,20,1663,131,1532,1612,127,1485,51,4,47
484011,20,100,19,81,82,19,63,18,0,18
484020,20,61,45,16,36,27,9,25,18,7
484048,20,63,47,16,63,47,16,,,
484057,20,248,10,238,42,3,39,206,7,199
484066,20,360,22,338,360,22,338,,,
484075,20,32,21,11,19,12,7,13,9,4
484084,20,77,0,77,49,0,49,28,0,28
484093,20,138,3,135,82,1,81,56,2,54
484109,20,92,1,91,92,1,91,,,
484127,20,109,15,94,109,15,94,,,
484136,20,33,9,24,33,9,24,,,
484163,20,178,47,131,105,25,80,73,22,51
484172,20,5,1,4,5,1,4,,,
484190,20,19,14,5,19,14,5,,,
484206,20,233,1,232,144,1,143,89,0,89
484233,20,217,121,96,,,,217,121,96
484330,20,30,1,29,30,1,29,,,
484349,20,40,1,39,40,1,39,,,
484358,20,67,3,64,67,3,64,,,
484367,20,340,46,294,340,46,294,,,
484376,20,533,59,474,533,59,474,,,
484394,20,140,16,124,87,7,80,53,9,44
484473,20,5356,2496,2860,2514,1219,1295,2842,1277,1565
484604,20,452,11,441,204,5,199,248,6,242
484613,20,69866,20849,49017,69866,20849,49017,,,
484631,20,438,276,162,438,276,162,,,
484710,20,30,22,8,30,22,8,,,
484756,20,54,26,28,54,26,28,,,
484844,20,613,259,354,613,259,354,,,
484862,20,3,0,3,3,0,3,,,
484871,20,115,115,0,115,115,0,,,
484899,20,209,5,204,209,5,204,,,
484905,20,3001,1009,1992,1709,568,1141,1292,441,851
484923,20,61,0,61,50,0,50,11,0,11
484932,20,1634,684,950,948,359,589,686,325,361
484950,20,67,6,61,67,6,61,,,
484996,20,193,4,189,193,4,189,,,
485014,20,102,5,97,66,4,62,36,1,35
485032,20,169,9,160,90,5,85,79,4,75
485111,20,6998,2701,4297,2586,1138,1448,4412,1563,2849
485166,20,84,21,63,84,21,63,,,
485236,20,70,2,68,23,0,23,47,2,45
485272,20,914,95,819,527,52,475,387,43,344
485342,20,321,165,156,155,103,52,166,62,104
485360,20,35,1,34,35,1,34,,,
485379,20,281,63,218,281,63,218,,,
485388,20,304,38,266,304,38,266,,,
485397,20,139,2,137,97,2,95,42,0,42
485412,20,117,22,95,117,22,95,,,
485458,20,3747,1307,2440,550,178,372,3197,1129,2068
485476,20,88,1,87,88,1,87,,,
485485,20,234,26,208,234,26,208,,,
485494,20,115,101,14,102,91,11,13,10,3
485500,20,117,107,10,8,8,0,109,99,10
485519,20,510,299,211,319,172,147,191,127,64
485546,20,155,84,71,6,3,3,149,81,68
485564,20,134,10,124,124,10,114,10,0,10
485573,20,213,28,185,202,27,175,11,1,10
485591,20,31,0,31,31,0,31,,,
485607,20,42,3,39,29,1,28,13,2,11
485698,20,141,121,20,139,121,18,2,0,2
485704,20,8,1,7,3,0,3,5,1,4
485768,20,443,301,142,443,301,142,,,
485801,20,95,14,81,95,14,81,,,
485856,20,39,10,29,16,5,11,23,5,18
485874,20,156,3,153,92,3,89,64,0,64
485926,20,229,61,168,228,60,168,1,1,0
485953,20,82,74,8,82,74,8,,,
485962,20,37,26,11,24,15,9,13,11,2
485999,20,91,91,0,91,91,0,,,
486017,20,23,23,0,23,23,0,,,
486026,20,127,127,0,127,127,0,,,
486053,20,115,67,48,83,45,38,32,22,10
486123,20,39,17,22,39,17,22,,,
486141,20,11,1,10,11,1,10,,,
486150,20,90,35,55,52,21,31,38,14,24
486169,20,56,46,10,56,46,10,,,
486196,20,189,189,0,189,189,0,,,
486202,20,23,3,20,23,3,20,,,
486239,20,119,56,63,105,50,55,14,6,8
486248,20,122,61,61,122,61,61,,,
486257,20,326,145,181,241,104,137,85,41,44
486284,20,222,64,158,206,62,144,16,2,14
486345,20,207,204,3,112,110,2,95,94,1
486354,20,37,17,20,37,17,20,,,
486372,20,105,78,27,98,73,25,7,5,2
486381,20,210,18,192,210,18,192,,,
486390,20,33,20,13,33,20,13,,,
486406,20,9,0,9,9,0,9,,,
486415,20,479,79,400,479,79,400,,,
486424,20,148,27,121,120,20,100,28,7,21
486442,20,73,14,59,73,14,59,,,
486488,20,23,18,5,20,16,4,3,2,1
486497,20,71,67,4,69,65,4,2,2,0
486503,20,57,1,56,57,1,56,,,
486512,20,426,202,224,426,202,224,,,
486530,20,157,3,154,157,3,154,,,
486558,20,240,223,17,160,146,14,80,77,3
486567,20,244,11,233,242,11,231,2,0,2
486576,20,115,38,77,115,38,77,,,
486619,20,135,5,130,103,5,98,32,0,32
486691,20,111,2,109,70,2,68,41,0,41
486707,20,85,5,80,85,5,80,,,
486716,20,71,2,69,71,2,69,,,
486752,20,43,2,41,43,2,41,,,
486770,20,108,30,78,108,30,78,,,
486798,20,1529,1347,182,1529,1347,182,,,
486813,20,673,123,550,673,123,550,,,
486822,20,879,100,779,879,100,779,,,
486840,20,38927,19423,19504,28771,14264,14507,10156,5159,4997
486859,20,27,0,27,27,0,27,,,
486877,20,11,1,10,11,1,10,,,
486886,20,31,0,31,13,0,13,18,0,18
486901,20,755,379,376,708,357,351,47,22,25
486938,20,567,98,469,212,40,172,355,58,297
486947,20,637,76,561,262,25,237,375,51,324
486956,20,1261,170,1091,428,65,363,833,105,728
486965,20,262,98,164,262,98,164,,,
486983,20,45,18,27,45,18,27,,,
487010,20,295,22,273,281,19,262,14,3,11
487047,20,85,4,81,85,4,81,,,
487065,20,70,1,69,70,1,69,,,
487083,20,33,0,33,33,0,33,,,
487092,20,1048,494,554,1048,494,554,,,
487162,20,4657,1552,3105,1149,323,826,3508,1229,2279
487232,20,106,5,101,106,5,101,,,
487302,20,473,107,366,472,107,365,1,0,1
487311,20,522,465,57,522,465,57,,,
487320,20,10601,7479,3122,5285,4270,1015,5316,3209,2107
487348,20,113,1,112,46,1,45,67,0,67
487375,20,1142,154,988,797,110,687,345,44,301
487384,20,475,144,331,475,144,331,,,
487393,20,597,247,350,597,247,350,,,
487409,20,616,242,374,616,242,374,,,
487418,20,640,232,408,640,232,408,,,
487427,20,532,179,353,532,179,353,,,
487436,20,664,123,541,664,123,541,,,
487445,20,426,171,255,426,171,255,,,
487454,20,375,109,266,375,109,266,,,
487472,20,761,238,523,761,238,523,,,
487481,20,1422,453,969,1422,453,969,,,
487490,20,1029,186,843,1029,186,843,,,
487506,20,88,2,86,30,0,30,58,2,56
487524,20,2429,1000,1429,2038,880,1158,391,120,271
487533,20,128,1,127,46,1,45,82,0,82
487588,20,358,11,347,358,11,347,,,
487597,20,1507,1445,62,1507,1445,62,,,
487603,20,1086,473,613,317,115,202,769,358,411
487621,20,26,23,3,22,19,3,4,4,0
487658,20,94,76,18,94,76,18,,,
487676,20,198,14,184,96,1,95,102,13,89
487746,20,28,28,0,28,28,0,,,
487773,20,29,2,27,17,0,17,12,2,10
487791,20,503,457,46,308,279,29,195,178,17
487807,20,52,35,17,35,26,9,17,9,8
487816,20,12,0,12,12,0,12,,,
487852,20,32,9,23,,,,32,9,23
487861,20,306,44,262,240,36,204,66,8,58
487889,20,133,17,116,133,17,116,,,
487898,20,12,10,2,7,5,2,5,5,0
487904,20,26,16,10,26,16,10,,,
487922,20,65,0,65,52,0,52,13,0,13
487959,20,85,0,85,71,0,71,14,0,14
487968,20,72,6,66,72,6,66,,,
487977,20,2505,176,2329,2160,54,2106,345,122,223
487995,20,48,13,35,32,12,20,16,1,15
488004,20,28,28,0,28,28,0,,,
488013,20,224,12,212,207,11,196,17,1,16
488022,20,65,36,29,50,26,24,15,10,5
488031,20,48,19,29,47,19,28,1,0,1
488059,20,248,82,166,248,82,166,,,
488068,20,50,6,44,14,2,12,36,4,32
488077,20,4011,3916,95,2621,2546,75,1390,1370,20
488110,20,62,14,48,28,4,24,34,10,24
488129,20,26,0,26,4,0,4,22,0,22
488138,20,167,5,162,167,5,162,,,
488147,20,41,1,40,41,1,40,,,
488174,20,36,21,15,31,17,14,5,4,1
488183,20,15,1,14,15,1,14,,,
488192,20,68,66,2,68,66,2,,,
488217,20,93,4,89,93,4,89,,,
488226,20,16,8,8,16,8,8,,,
488253,20,69,43,26,42,29,13,27,14,13
488262,20,12,8,4,6,5,1,6,3,3
488271,20,85,2,83,85,2,83,,,
488280,20,37,29,8,37,29,8,,,
488299,20,47,9,38,37,9,28,10,0,10
488305,20,114,74,40,77,51,26,37,23,14
488314,20,98,98,0,98,98,0,,,
488332,20,204,23,181,204,23,181,,,
488350,20,126,126,0,126,126,0,,,
488369,20,70,54,16,70,54,16,,,
488378,20,92,6,86,91,6,85,1,0,1
488396,20,33,31,2,5,4,1,28,27,1
488411,20,103,1,102,103,1,102,,,
488420,20,190,20,170,,,,190,20,170
488439,20,69,56,13,55,44,11,14,12,2
488448,20,69,47,22,64,44,20,5,3,2
488563,20,19,12,7,18,11,7,1,1,0
488590,20,10,5,5,10,5,5,,,
488651,20,168,27,141,103,17,86,65,10,55
488679,20,5521,1340,4181,5032,1195,3837,489,145,344
488721,20,504,459,45,89,77,12,415,382,33
488730,20,7399,3054,4345,1436,672,764,5963,2382,3581
488749,20,121,27,94,105,24,81,16,3,13
488776,20,158,52,106,87,28,59,71,24,47
488785,20,205,98,107,190,88,102,15,10,5
488800,20,876,245,631,876,245,631,,,
488837,20,203,182,21,203,182,21,,,
488846,20,27220,14654,12566,10954,5898,5056,16266,8756,7510
488891,20,338,115,223,338,115,223,,,
488916,20,43,0,43,43,0,43,,,
488934,20,3953,2130,1823,613,331,282,3340,1799,1541
488952,20,50,0,50,50,0,50,,,
488961,20,57,3,54,57,3,54,,,
488970,20,29,1,28,29,1,28,,,
488989,20,136,3,133,88,0,88,48,3,45
488998,20,103,18,85,102,18,84,1,0,1
489122,20,54,3,51,25,0,25,29,3,26
489131,20,71,8,63,36,1,35,35,7,28
489140,20,92,14,78,37,2,35,55,12,43
489159,20,146,3,143,102,2,100,44,1,43
489201,20,7772,3209,4563,2015,922,1093,5757,2287,3470
489238,20,75,6,69,45,4,41,30,2,28
489247,20,55,10,45,23,5,18,32,5,27
489256,20,200,188,12,198,186,12,2,2,0
489283,20,670,110,560,670,110,560,,,
489344,20,268,22,246,84,5,79,184,17,167
489353,20,597,133,464,316,72,244,281,61,220
489371,20,214,193,21,214,193,21,,,
489779,20,33510,13993,19517,5368,1948,3420,28142,12045,16097
489812,20,56,0,56,56,0,56,,,
489830,20,76,3,73,76,3,73,,,
489937,20,350,186,164,297,165,132,53,21,32
490018,20,23,20,3,23,20,3,,,
490045,20,36,13,23,16,6,10,20,7,13
490054,20,289,95,194,191,65,126,98,30,68
490081,20,18,8,10,14,8,6,4,0,4
490090,20,54,30,24,31,12,19,23,18,5
490115,20,57,46,11,57,46,11,,,
490124,20,5,2,3,5,2,3,,,
490133,20,1817,1128,689,1719,1077,642,98,51,47
490142,20,42,6,36,15,4,11,27,2,25
490151,20,63,1,62,46,1,45,17,0,17
490160,20,99,10,89,99,10,89,,,
490197,20,42,12,30,42,12,30,,,
490203,20,130,10,120,55,3,52,75,7,68
490221,20,9,1,8,7,0,7,2,1,1
490230,20,252,108,144,251,107,144,1,1,0
490249,20,27,23,4,27,23,4,,,
490258,20,131,22,109,131,22,109,,,
490267,20,25,22,3,20,20,0,5,2,3
490276,20,131,131,0,131,131,0,,,
490285,20,356,290,66,356,290,66,,,
490294,20,124,34,90,120,32,88,4,2,2
490300,20,84,23,61,44,1,43,40,22,18
490319,20,12,12,0,12,12,0,,,
490328,20,94,94,0,94,94,0,,,
490346,20,73,0,73,73,0,73,,,
490382,20,36,8,28,36,8,28,,,
490391,20,114,2,112,114,2,112,,,
490407,20,79,1,78,46,1,45,33,0,33
490416,20,26,20,6,26,20,6,,,
490425,20,167,2,165,167,2,165,,,
490434,20,30,0,30,30,0,30,,,
490443,20,115,0,115,115,0,115,,,
490452,20,50,3,47,21,3,18,29,0,29
490461,20,66,3,63,66,3,63,,,
490470,20,15,2,13,15,2,13,,,
490489,20,43,33,10,35,27,8,8,6,2
490498,20,28,21,7,28,21,7,,,
490504,20,40,40,0,40,40,0,,,
490513,20,34,34,0,34,34,0,,,
490522,20,21,0,21,21,0,21,,,
490531,20,46,36,10,23,18,5,23,18,5
490559,20,392,19,373,392,19,373,,,
490674,20,7,0,7,7,0,7,,,
490692,20,48,40,8,48,40,8,,,
490717,20,74,8,66,74,8,66,,,
490735,20,95,5,90,95,5,90,,,
490744,20,30,26,4,30,26,4,,,
490753,20,11,5,6,11,5,6,,,
490805,20,8176,3611,4565,4710,2284,2426,3466,1327,2139
490814,20,94,4,90,94,4,90,,,
490832,20,212,13,199,157,8,149,55,5,50
490841,20,228,6,222,228,6,222,,,
490869,20,322,28,294,322,28,294,,,
490878,20,418,75,343,418,75,343,,,
490896,20,100,7,93,66,4,62,34,3,31
490948,20,9,6,3,9,6,3,,,
490975,20,357,52,305,334,48,286,23,4,19
491057,20,292,292,0,292,292,0,,,
491066,20,71,2,69,21,0,21,50,2,48
491075,20,69,62,7,69,62,7,,,
491084,20,53,0,53,53,0,53,,,
491136,20,87,2,85,54,1,53,33,1,32
491145,20,103,0,103,68,0,68,35,0,35
491181,20,470,59,411,254,33,221,216,26,190
491190,20,4,2,2,4,2,2,,,
491215,20,57,55,2,57,55,2,,,
491224,20,83,4,79,49,1,48,34,3,31
491233,20,26,0,26,18,0,18,8,0,8
491242,20,66,34,32,66,34,32,,,
491251,20,68,41,27,68,41,27,,,
491260,20,80,2,78,56,2,54,24,0,24
491288,20,612,173,439,76,22,54,536,151,385
491297,20,146,59,87,10,4,6,136,55,81
491394,20,103,83,20,97,80,17,6,3,3
491446,20,159,0,159,156,0,156,3,0,3
491464,20,193,41,152,193,41,152,,,
491473,20,750,432,318,43,2,41,707,430,277
491507,20,10,0,10,10,0,10,,,
491525,20,102,55,47,61,30,31,41,25,16
491534,20,14,3,11,,,,14,3,11
491543,20,97,20,77,61,13,48,36,7,29
491552,20,32,0,32,32,0,32,,,
491570,20,32,0,32,32,0,32,,,
491589,20,26,18,8,7,4,3,19,14,5
491598,20,24,1,23,24,1,23,,,
491613,20,69,69,0,69,69,0,,,
491622,20,81,81,0,81,81,0,,,
491631,20,173,0,173,121,0,121,52,0,52
491640,20,186,186,0,186,186,0,,,
491659,20,163,114,49,163,114,49,,,
491668,20,162,4,158,162,4,158,,,
491677,20,37,24,13,20,14,6,17,10,7
491686,20,34,27,7,34,27,7,,,
491695,20,37,0,37,37,0,37,,,
491701,20,37,10,27,,,,37,10,27
491710,20,72,72,0,72,72,0,,,
491729,20,17,0,17,17,0,17,,,
491738,20,63,7,56,57,6,51,6,1,5
491747,20,17,2,15,17,2,15,,,
491756,20,99,82,17,99,82,17,,,
491765,20,93,93,0,93,93,0,,,
491774,20,144,20,124,102,12,90,42,8,34
491783,20,78,66,12,22,19,3,56,47,9
491792,20,74,3,71,74,3,71,,,
491817,20,200,0,200,200,0,200,,,
491826,20,97,0,97,97,0,97,,,
491835,20,86,1,85,86,1,85,,,
491844,20,184,53,131,116,36,80,68,17,51
491853,20,53,0,53,53,0,53,,,
491871,20,18,0,18,13,0,13,5,0,5
491880,20,97,95,2,97,95,2,,,
491899,20,103,9,94,16,1,15,87,8,79
491905,20,109,4,105,109,4,105,,,
491914,20,178,178,0,178,178,0,,,
491923,20,328,2,326,288,2,286,40,0,40
491932,20,27,23,4,27,23,4,,,
491941,20,153,6,147,153,6,147,,,
491950,20,924,127,797,43,9,34,881,118,763
491978,20,50,21,29,10,5,5,40,16,24
491996,20,45,3,42,45,3,42,,,
492005,20,56,1,55,45,1,44,11,0,11
492023,20,273,41,232,,,,273,41,232
492032,20,29,0,29,,,,29,0,29
492069,20,82,47,35,76,46,30,6,1,5
492078,20,98,97,1,,,,98,97,1
492096,20,7,0,7,7,0,7,,,
492139,20,209,179,30,209,179,30,,,
492148,20,5,1,4,5,1,4,,,
492281,20,62,45,17,62,45,17,,,
492306,20,174,44,130,,,,174,44,130
492315,20,110,20,90,,,,110,20,90
492324,20,192,16,176,,,,192,16,176
492360,20,48,18,30,36,16,20,12,2,10
492421,20,24,21,3,24,21,3,,,
492449,20,611,139,472,611,139,472,,,
492476,20,226,45,181,79,13,66,147,32,115
492607,20,2,0,2,,,,2,0,2
492643,20,88,19,69,88,19,69,,,
492652,20,22,13,9,22,13,9,,,
492661,20,246,36,210,246,36,210,,,
492689,20,258,43,215,215,38,177,43,5,38
492722,20,340,27,313,340,27,313,,,
492731,20,174,28,146,121,22,99,53,6,47
492759,20,365,34,331,155,13,142,210,21,189
492801,20,742,251,491,427,140,287,315,111,204
492935,20,129,14,115,129,14,115,,,
492953,20,107,5,102,61,3,58,46,2,44
492962,20,2604,996,1608,1090,388,702,1514,608,906
493071,20,499,122,377,499,122,377,,,
493080,20,362,181,181,66,38,28,296,143,153
493132,20,1125,1090,35,1125,1090,35,,,
493150,20,174,15,159,174,15,159,,,
493372,20,17,6,11,17,6,11,,,
493451,20,67,13,54,67,13,54,,,
493479,20,18,8,10,18,8,10,,,
493488,20,22,4,18,22,4,18,,,
493512,20,132,92,40,114,84,30,18,8,10
493521,20,38,29,9,37,28,9,1,1,0
493530,20,46,15,31,28,7,21,18,8,10
493549,20,111,102,9,111,102,9,,,
493558,20,12,11,1,12,11,1,,,
493567,20,51,2,49,,,,51,2,49
493576,20,11,0,11,11,0,11,,,
493585,20,64,3,61,64,3,61,,,
493594,20,40,40,0,40,40,0,,,
493600,20,175,175,0,175,175,0,,,
493619,20,24,11,13,21,10,11,3,1,2
493628,20,152,9,143,75,2,73,77,7,70
493637,20,19,1,18,19,1,18,,,
493646,20,246,0,246,246,0,246,,,
493655,20,21,13,8,20,13,7,1,0,1
493664,20,60,60,0,57,57,0,3,3,0
493673,20,3,1,2,3,1,2,,,
493682,20,76,6,70,69,4,65,7,2,5
493691,20,35,0,35,25,0,25,10,0,10
493707,20,82,82,0,82,82,0,,,
493716,20,68,68,0,67,67,0,1,1,0
493743,20,221,171,50,113,89,24,108,82,26
493752,20,4,0,4,4,0,4,,,
493761,20,128,47,81,26,12,14,102,35,67
493770,20,32,1,31,32,1,31,,,
493798,20,114,0,114,100,0,100,14,0,14
493804,20,95,68,27,95,68,27,,,
493813,20,162,10,152,162,10,152,,,
493822,20,285,80,205,165,34,131,120,46,74
493831,20,42,27,15,42,27,15,,,
493868,20,38,27,11,32,23,9,6,4,2
493895,20,301,266,35,136,124,12,165,142,23
493910,20,33,1,32,11,0,11,22,1,21
493992,20,263,61,202,263,61,202,,,
494001,20,95,1,94,25,0,25,70,1,69
494029,20,17,11,6,10,8,2,7,3,4
494162,20,296,31,265,184,14,170,112,17,95
494232,20,25,1,24,18,1,17,7,0,7
494250,20,693,42,651,693,42,651,,,
494278,20,243,39,204,80,6,74,163,33,130
494287,20,448,115,333,147,40,107,301,75,226
494357,20,965,354,611,965,354,611,,,
494436,20,295,62,233,295,62,233,,,
494463,20,290,0,290,290,0,290,,,
494472,20,14,0,14,6,0,6,8,0,8
494524,20,84,4,80,83,4,79,1,0,1
494588,20,369,44,325,369,44,325,,,
494597,20,81,33,48,62,25,37,19,8,11
494603,20,309,194,115,198,129,69,111,65,46
494621,20,108,8,100,12,3,9,96,5,91
494630,20,47,26,21,43,24,19,4,2,2
494649,20,23,0,23,9,0,9,14,0,14
494658,20,57,2,55,45,2,43,12,0,12
494685,20,473,192,281,390,149,241,83,43,40
494694,20,74,4,70,74,4,70,,,
494700,20,35,2,33,35,2,33,,,
494719,20,73,38,35,40,18,22,33,20,13
494728,20,54,43,11,51,41,10,3,2,1
494737,20,171,171,0,171,171,0,,,
494746,20,471,84,387,471,84,387,,,
494755,20,60,8,52,60,8,52,,,
494764,20,169,159,10,128,119,9,41,40,1
494807,20,46,4,42,46,4,42,,,
494843,20,548,38,510,548,38,510,,,
494852,20,473,102,371,473,102,371,,,
494898,20,69,12,57,69,12,57,,,
494904,20,138,30,108,48,10,38,90,20,70
494959,20,74,21,53,16,4,12,58,17,41
494986,20,36,1,35,26,1,25,10,0,10
494995,20,35,33,2,35,33,2,,,
495013,20,223,197,26,,,,223,197,26
495031,20,68,68,0,64,64,0,4,4,0
495040,20,50,2,48,50,2,48,,,
495059,20,45,23,22,43,22,21,2,1,1
495077,20,77,5,72,77,5,72,,,
495101,20,62,11,51,62,11,51,,,
495110,20,23,21,2,23,21,2,,,
495129,20,76,63,13,76,63,13,,,
495138,20,12,2,10,12,2,10,,,
495147,20,24,11,13,12,9,3,12,2,10
495165,20,32,9,23,32,9,23,,,
495174,20,38,18,20,,,,38,18,20
495183,20,150,64,86,150,64,86,,,
495208,20,23,14,9,23,14,9,,,
495217,20,29,22,7,29,22,7,,,
495226,20,4,0,4,4,0,4,,,
495235,20,22,2,20,11,0,11,11,2,9
495244,20,21,1,20,14,0,14,7,1,6
495253,20,55,11,44,53,11,42,2,0,2
495262,20,45,0,45,22,0,22,23,0,23
495271,20,76,17,59,8,0,8,68,17,51
495280,20,32,18,14,20,12,8,12,6,6
495299,20,54,10,44,54,10,44,,,
495305,20,100,24,76,55,18,37,45,6,39
495341,20,50,36,14,50,36,14,,,
495350,20,22,8,14,22,8,14,,,
495369,20,59,7,52,31,4,27,28,3,25
495378,20,73,5,68,10,0,10,63,5,58
495387,20,52,38,14,29,21,8,23,17,6
495396,20,27,2,25,27,2,25,,,
495411,20,91,10,81,90,10,80,1,0,1
495420,20,320,39,281,192,23,169,128,16,112
495439,20,321,22,299,211,17,194,110,5,105
495448,20,516,59,457,385,39,346,131,20,111
495457,20,746,78,668,503,51,452,243,27,216
495518,20,85,3,82,54,2,52,31,1,30
495730,20,83,3,80,45,1,44,38,2,36
495776,20,20,19,1,20,19,1,,,
495794,20,247,4,243,167,2,165,80,2,78
495837,20,118,16,102,118,16,102,,,
495925,20,68,8,60,68,8,60,,,
495934,20,79,8,71,79,8,71,,,
495943,20,14,1,13,14,1,13,,,
495952,20,146,42,104,146,42,104,,,
495961,20,110,7,103,110,7,103,,,
495970,20,331,106,225,331,106,225,,,
495998,20,72,4,68,72,4,68,,,
496052,20,15,13,2,15,13,2,,,
496061,20,241,11,230,104,7,97,137,4,133
496186,20,166,147,19,164,145,19,2,2,0
496265,20,50,44,6,50,44,6,,,
496283,20,190,30,160,190,30,160,,,
496326,20,337,37,300,337,37,300,,,
496371,20,8,8,0,8,8,0,,,
496399,20,37,5,32,37,5,32,,,
496478,20,55,40,15,,,,55,40,15
496520,20,74,19,55,,,,74,19,55
496539,20,68,1,67,45,0,45,23,1,22
496618,20,161,9,152,161,9,152,,,
496627,20,146,63,83,146,63,83,,,
496636,20,213,40,173,213,40,173,,,
496645,20,247,172,75,47,5,42,200,167,33
496654,20,33,6,27,24,4,20,9,2,7
496663,20,29,21,8,27,19,8,2,2,0
496672,20,41,7,34,21,7,14,20,0,20
496681,20,131,4,127,131,4,127,,,
496690,20,43,6,37,37,4,33,6,2,4
496706,20,169,111,58,169,111,58,,,
496715,20,61,6,55,61,6,55,,,
496724,20,40,0,40,40,0,40,,,
496733,20,84,2,82,84,2,82,,,
496751,20,25,13,12,25,13,12,,,
496803,20,18,9,9,18,9,9,,,
496894,20,35,2,33,11,0,11,24,2,22
496919,20,858,383,475,858,383,475,,,
496955,20,676,259,417,676,259,417,,,
496964,20,22,14,8,22,14,8,,,
496973,20,185,29,156,118,17,101,67,12,55
496991,20,418,61,357,241,28,213,177,33,144
497000,20,217,56,161,217,56,161,,,
497037,20,766,149,617,460,80,380,306,69,237
497046,20,5522,1842,3680,706,260,446,4816,1582,3234
497073,20,406,11,395,185,5,180,221,6,215
497107,20,114,19,95,,,,114,19,95
497116,20,626,67,559,346,36,310,280,31,249
497125,20,377,38,339,172,18,154,205,20,185
497161,20,122,107,15,99,85,14,23,22,1
497189,20,31,2,29,31,2,29,,,
497198,20,114,3,111,71,1,70,43,2,41
497204,20,107,87,20,36,24,12,71,63,8
497213,20,35,17,18,20,13,7,15,4,11
497222,20,25,2,23,20,2,18,5,0,5
497268,20,258,24,234,181,14,167,77,10,67
497277,20,453,75,378,453,75,378,,,
497286,20,434,403,31,434,403,31,,,
497301,20,379,9,370,211,4,207,168,5,163
497310,20,108,1,107,108,1,107,,,
497329,20,282,70,212,282,70,212,,,
497338,20,96,9,87,96,9,87,,,
497356,20,40,24,16,37,22,15,3,2,1
497365,20,24,19,5,24,19,5,,,
497374,20,139,19,120,139,19,120,,,
497383,20,11,10,1,11,10,1,,,
497392,20,86,70,16,17,15,2,69,55,14
497408,20,61,35,26,48,30,18,13,5,8
497417,20,18,0,18,18,0,18,,,
497426,20,118,14,104,94,2,92,24,12,12
497435,20,76,21,55,76,21,55,,,
497444,20,25,9,16,5,3,2,20,6,14
497453,20,2,0,2,1,0,1,1,0,1
497462,20,152,73,79,127,58,69,25,15,10
497471,20,8,1,7,3,1,2,5,0,5
497480,20,774,48,726,708,26,682,66,22,44
497499,20,42,41,1,,,,42,41,1
497675,20,30,2,28,18,2,16,12,0,12
497684,20,41,1,40,41,1,40,,,
497736,20,54,6,48,54,6,48,,,
497745,20,150,131,19,124,110,14,26,21,5
497790,20,107,103,4,107,103,4,,,
497824,20,240,104,136,94,37,57,146,67,79
497833,20,227,104,123,217,104,113,10,0,10
497888,20,104,7,97,67,3,64,37,4,33
497897,20,185,8,177,185,8,177,,,
497903,20,4,0,4,4,0,4,,,
497912,20,101,7,94,101,7,94,,,
497949,20,595,182,413,595,182,413,,,
497958,20,520,133,387,520,133,387,,,
498003,20,209,85,124,153,66,87,56,19,37
498012,20,274,258,16,274,258,16,,,
498030,20,152,144,8,152,144,8,,,
498049,20,297,20,277,185,11,174,112,9,103
498076,20,130,10,120,44,3,41,86,7,79
498085,20,256,22,234,105,8,97,151,14,137
498094,20,212,8,204,83,5,78,129,3,126
498100,20,252,18,234,21,0,21,231,18,213
498119,20,52,4,48,13,0,13,39,4,35
498243,20,6,1,5,6,1,5,,,
498322,20,104,0,104,104,0,104,,,
498331,20,127,63,64,15,5,10,112,58,54
498340,20,74,9,65,74,9,65,,,
498359,20,68,0,68,38,0,38,30,0,30
498368,20,4,0,4,,,,4,0,4
498377,20,73,69,4,73,69,4,,,
498386,20,48,24,24,42,24,18,6,0,6
498401,20,47,2,45,38,2,36,9,0,9
498410,20,26,23,3,18,16,2,8,7,1
498447,20,144,9,135,73,8,65,71,1,70
498456,20,210,23,187,141,14,127,69,9,60
498465,20,136,108,28,136,108,28,,,
498483,20,26,4,22,23,4,19,3,0,3
498553,20,141,58,83,141,58,83,,,
498562,20,11016,4294,6722,9242,3632,5610,1774,662,1112
498571,20,9404,3671,5733,7860,3089,4771,1544,582,962
100654,30,5196,2107,3089,4792,1936,2856,404,171,233
100663,30,12776,4794,7982,10239,3822,6417,2537,972,1565
100690,30,228,83,145,129,50,79,99,33,66
100706,30,6985,4178,2807,5859,3533,2326,1126,645,481
100724,30,3296,1185,2111,3042,1095,1947,254,90,164
100751,30,31360,13795,17565,28886,12721,16165,2474,1074,1400
100760,30,963,378,585,508,222,286,455,156,299
100812,30,2465,722,1743,1106,307,799,1359,415,944
100830,30,3307,1073,2234,2444,768,1676,863,305,558
100858,30,25234,12594,12640,22946,11355,11591,2288,1239,1049
100937,30,968,508,460,962,507,455,6,1,5
101028,30,1101,338,763,498,195,303,603,143,460
101116,30,315,42,273,215,32,183,100,10,90
101143,30,1359,689,670,891,490,401,468,199,269
101161,30,4809,1680,3129,2686,1040,1646,2123,640,1483
101189,30,1587,698,889,1207,569,638,380,129,251
101240,30,3446,1216,2230,1988,813,1175,1458,403,1055
101277,30,45,0,45,45,0,45,,,
101286,30,3069,865,2204,1254,401,853,1815,464,1351
101295,30,4207,1374,2833,2230,844,1386,1977,530,1447
101301,30,856,293,563,500,229,271,356,64,292
101365,30,570,125,445,233,54,179,337,71,266
101435,30,810,453,357,791,446,345,19,7,12
101453,30,72,66,6,29,26,3,43,40,3
101462,30,698,268,430,223,103,120,475,165,310
101471,30,768,671,97,626,543,83,142,128,14
101480,30,7066,2847,4219,6313,2529,3784,753,318,435
101505,30,5550,1971,3579,1973,799,1174,3577,1172,2405
101514,30,6549,2842,3707,2678,1302,1376,3871,1540,2331
101569,30,2554,872,1682,1106,450,656,1448,422,1026
101587,30,2424,725,1699,1900,536,1364,524,189,335
101602,30,1111,411,700,745,286,459,366,125,241
101648,30,320,232,88,320,232,88,,,
101675,30,1257,569,688,1200,543,657,57,26,31
101693,30,1108,409,699,1054,392,662,54,17,37
101709,30,2128,784,1344,1962,724,1238,166,60,106
101736,30,2026,766,1260,900,400,500,1126,366,760
101879,30,5408,2004,3404,4602,1676,2926,806,328,478
101897,30,1565,548,1017,858,323,535,707,225,482
101912,30,1378,588,790,1305,551,754,73,37,36
101994,30,281,112,169,183,99,84,98,13,85
102030,30,1943,656,1287,976,427,549,967,229,738
102049,30,3668,1183,2485,3609,1162,2447,59,21,38
102058,30,30,13,17,11,5,6,19,8,11
102067,30,3257,1357,1900,1719,839,880,1538,518,1020
102076,30,1494,523,971,979,361,618,515,162,353
102094,30,8171,3167,5004,7047,2676,4371,1124,491,633
102234,30,932,401,531,900,390,510,32,11,21
102270,30,727,324,403,601,265,336,126,59,67
102298,30,832,433,399,785,410,375,47,23,24
102313,30,1599,612,987,809,359,450,790,253,537
102368,30,10316,3646,6670,7069,2498,4571,3247,1148,2099
102377,30,2100,801,1299,1986,749,1237,114,52,62
102395,30,94,77,17,23,14,9,71,63,8
102429,30,2205,791,1414,1043,436,607,1162,355,807
102553,30,6778,2694,4084,3541,1523,2018,3237,1171,2066
102580,30,31,20,11,21,14,7,10,6,4
102614,30,4010,1609,2401,2238,1036,1202,1772,573,1199
102632,30,964,321,643,452,184,268,512,137,375
102669,30,457,81,376,377,59,318,80,22,58
102711,30,202,140,62,133,95,38,69,45,24
102845,30,2117,577,1540,2117,577,1540,,,
103501,30,268,36,232,268,36,232,,,
103741,30,184,10,174,124,9,115,60,1,59
103893,30,1047,207,840,1047,207,840,,,
103909,30,532,69,463,532,69,463,,,
103927,30,446,83,363,446,83,363,,,
103954,30,34,2,32,34,2,32,,,
103963,30,411,352,59,411,352,59,,,
104090,30,841,91,750,841,91,750,,,
104151,30,64778,32992,31786,59765,30113,29652,5013,2879,2134
104160,30,7595,3059,4536,1948,848,1100,5647,2211,3436
104179,30,37979,16758,21221,30136,13006,17130,7843,3752,4091
104346,30,4402,1691,2711,1068,462,606,3334,1229,2105
104391,30,85,2,83,85,2,83,,,
104425,30,3032,1372,1660,1361,564,797,1671,808,863
104443,30,60,5,55,46,4,42,14,1,13
104568,30,383,3,380,187,3,184,196,0,196
104577,30,2942,1182,1760,1148,544,604,1794,638,1156
104586,30,3114,2260,854,2970,2142,828,144,118,26
104708,30,9807,4317,5490,3311,1673,1638,6496,2644,3852
104717,30,65147,19477,45670,23901,9548,14353,41246,9929,31317
105145,30,3470,1176,2294,912,353,559,2558,823,1735
105154,30,11351,5227,6124,3691,1837,1854,7660,3390,4270
105206,30,2791,858,1933,609,238,371,2182,620,1562
105215,30,658,612,46,658,612,46,,,
105297,30,1361,331,1030,702,185,517,659,146,513
105330,30,23090,8497,14593,20010,7503,12507,3080,994,2086
105349,30,1075,308,767,247,94,153,828,214,614
105428,30,6588,2253,4335,2062,806,1256,4526,1447,3079
105525,30,13328,5731,7597,3308,1562,1746,10020,4169,5851
105534,30,2477,489,1988,2477,489,1988,,,
105543,30,690,111,579,690,111,579,,,
105589,30,313,113,200,243,96,147,70,17,53
105659,30,990,903,87,990,903,87,,,
105668,30,3999,1453,2546,647,252,395,3352,1201,2151
105677,30,27,26,1,27,26,1,,,
105747,30,4245,1868,2377,1326,639,687,2919,1229,1690
105792,30,2192,938,1254,741,348,393,1451,590,861
105899,30,1028,630,398,928,579,349,100,51,49
106041,30,1972,1864,108,1972,1864,108,,,
106148,30,3577,1485,2092,1223,656,567,2354,829,1525
106245,30,4802,1756,3046,2877,1180,1697,1925,576,1349
106263,30,1287,206,1081,762,125,637,525,81,444
106306,30,497,381,116,448,343,105,49,38,11
106315,30,98,2,96,98,2,96,,,
106324,30,29,1,28,18,1,17,11,0,11
106342,30,489,291,198,481,287,194,8,4,4
106351,30,60,29,31,60,29,31,,,
106360,30,16,1,15,16,1,15,,,
106397,30,26002,11450,14552,23395,10440,12955,2607,1010,1597
106412,30,2155,936,1219,1840,807,1033,315,129,186
106449,30,1829,668,1161,1274,511,763,555,157,398
106458,30,7463,2810,4653,5095,2103,2992,2368,707,1661
106467,30,6108,2618,3490,5033,2245,2788,1075,373,702
106485,30,1819,742,1077,1537,679,858,282,63,219
106494,30,37,0,37,37,0,37,,,
106546,30,549,54,495,480,47,433,69,7,62
106625,30,1003,350,653,670,248,422,333,102,231
106704,30,7563,2893,4670,6620,2538,4082,943,355,588
106713,30,489,279,210,459,269,190,30,10,20
106795,30,833,264,569,447,167,280,386,97,289
106810,30,171,92,79,170,91,79,1,1,0
106883,30,519,149,370,317,101,216,202,48,154
106908,30,358,17,341,347,17,330,11,0,11
106980,30,1809,711,1098,1179,513,666,630,198,432
106999,30,694,212,482,448,140,308,246,72,174
107044,30,3198,1415,1783,3009,1313,1696,189,102,87
107071,30,1800,857,943,1610,763,847,190,94,96
107080,30,1127,554,573,1119,547,572,8,7,1
107099,30,90,5,85,90,5,85,,,
107123,30,69,17,52,69,17,52,,,
107141,30,1354,554,800,1271,523,748,83,31,52
107220,30,230,5,225,230,5,225,,,
107293,30,67,0,67,67,0,67,,,
107318,30,455,160,295,158,38,120,297,122,175
107327,30,748,243,505,423,161,262,325,82,243
107442,30,28,15,13,28,15,13,,,
107460,30,1121,447,674,735,321,414,386,126,260
107488,30,201,146,55,199,144,55,2,2,0
107512,30,1587,674,913,1562,661,901,25,13,12
107521,30,446,128,318,306,87,219,140,41,99
107549,30,614,170,444,448,141,307,166,29,137
107558,30,767,368,399,764,368,396,3,0,3
107585,30,1519,580,939,967,396,571,552,184,368
107600,30,766,318,448,672,285,387,94,33,61
107619,30,616,184,432,404,136,268,212,48,164
107637,30,789,209,580,171,54,117,618,155,463
107655,30,27,0,27,27,0,27,,,
107664,30,3862,1284,2578,2134,773,1361,1728,511,1217
107725,30,704,182,522,325,118,207,379,64,315
107743,30,441,166,275,323,125,198,118,41,77
107789,30,109,1,108,109,1,108,,,
107831,30,84,1,83,84,1,83,,,
107840,30,321,126,195,292,113,179,29,13,16
107877,30,556,261,295,549,257,292,7,4,3
107974,30,893,234,659,485,165,320,408,69,339
107983,30,2787,1225,1562,2637,1168,1469,150,57,93
107992,30,672,304,368,474,221,253,198,83,115
108065,30,14,0,14,7,0,7,7,0,7
108092,30,4143,1594,2549,3236,1239,1997,907,355,552
108232,30,4485,1918,2567,2180,1016,1164,2305,902,1403
108667,30,4236,1816,2420,551,318,233,3685,1498,2187
108807,30,7497,3502,3995,2961,1446,1515,4536,2056,2480
108852,30,220,93,127,220,93,127,,,
108861,30,19,11,8,6,4,2,13,7,6
108977,30,234,55,179,115,28,87,119,27,92
109040,30,1969,447,1522,1969,447,1522,,,
109208,30,24054,12841,11213,4166,1949,2217,19888,10892,8996
109350,30,10191,4419,5772,3454,1638,1816,6737,2781,3956
109651,30,2113,887,1226,1833,760,1073,280,127,153
109721,30,202,49,153,202,49,153,,,
109730,30,94,50,44,94,50,44,,,
109785,30,3344,1065,2279,2940,935,2005,404,130,274
109819,30,18098,7987,10111,7046,2965,4081,11052,5022,6030
109907,30,2496,826,1670,1098,348,750,1398,478,920
109934,30,398,39,359,398,39,359,,,
110060,30,181,141,40,158,127,31,23,14,9
110097,30,3474,1359,2115,3169,1247,1922,305,112,193
110194,30,264,264,0,264,264,0,,,
110219,30,1767,365,1402,1767,365,1402,,,
110246,30,8676,3844,4832,4037,1868,2169,4639,1976,2663
110316,30,87,21,66,79,20,59,8,1,7
110334,30,7275,3249,4026,1720,801,919,5555,2448,3107
110361,30,8077,2964,5113,7228,2674,4554,849,290,559
110370,30,1134,425,709,1085,398,687,49,27,22
110404,30,982,537,445,982,537,445,,,
110413,30,2510,1159,1351,2460,1139,1321,50,20,30
110422,30,20976,10743,10233,19944,10121,9823,1032,622,410
110468,30,274,93,181,,,,274,93,181
110486,30,8108,2749,5359,6621,2228,4393,1487,521,966
110495,30,8836,2959,5877,6939,2270,4669,1897,689,1208
110510,30,16712,6367,10345,13480,5083,8397,3232,1284,1948
110529,30,25080,13675,11405,21474,11623,9851,3606,2052,1554
110538,30,12853,5888,6965,11554,5281,6273,1299,607,692
110547,30,13903,5415,8488,10380,4046,6334,3523,1369,2154
110556,30,20985,8524,12461,17557,7006,10551,3428,1518,1910
110565,30,35249,14863,20386,27783,11543,16240,7466,3320,4146
110574,30,10709,4337,6372,8149,3306,4843,2560,1031,1529
110583,30,32780,13718,19062,27599,11277,16322,5181,2441,2740
110592,30,22690,9495,13195,18668,7695,10973,4022,1800,2222
110608,30,32103,14686,17417,26136,11699,14437,5967,2987,2980
110617,30,28544,12473,16071,22557,9622,12935,5987,2851,3136
110635,30,32475,14434,18041,30820,13635,17185,1655,799,856
110644,30,31512,12691,18821,30654,12305,18349,858,386,472
110653,30,28651,12580,16071,27921,12209,15712,730,371,359
110662,30,32423,12853,19570,31763,12533,19230,660,320,340
110671,30,22842,11037,11805,21954,10531,11423,888,506,382
110680,30,33092,15764,17328,32138,15217,16921,954,547,407
110705,30,23419,10348,13071,22793,10006,12787,626,342,284
110714,30,17502,8778,8724,16728,8327,8401,774,451,323
110778,30,11,1,10,10,1,9,1,0,1
110875,30,55,1,54,55,1,54,,,
110918,30,13,7,6,3,1,2,10,6,4
111045,30,26,11,15,25,11,14,1,0,1
111054,30,144,28,116,144,28,116,,,
111081,30,931,363,568,914,351,563,17,12,5
111188,30,808,645,163,779,623,156,29,22,7
111434,30,4271,1718,2553,713,365,348,3558,1353,2205
111461,30,15977,9206,6771,4756,2397,2359,11221,6809,4412
111513,30,205,3,202,162,1,161,43,2,41
111638,30,415,154,261,415,154,261,,,
111708,30,196,167,29,196,167,29,,,
111717,30,183,146,37,181,146,35,2,0,2
111726,30,148,114,34,148,114,34,,,
111744,30,96,92,4,96,92,4,,,
111762,30,103,58,45,103,58,45,,,
111799,30,157,26,131,157,26,131,,,
111887,30,18001,8593,9408,7789,3607,4182,10212,4986,5226
111896,30,3439,1577,1862,699,343,356,2740,1234,1506
111920,30,9750,4935,4815,2782,1355,1427,6968,3580,3388
111939,30,15342,5992,9350,5358,2259,3099,9984,3733,6251
111948,30,7665,3048,4617,7327,2898,4429,338,150,188
111966,30,238,82,156,183,65,118,55,17,38
112075,30,1691,675,1016,1474,583,891,217,92,125
112084,30,328,154,174,254,130,124,74,24,50
112172,30,8139,3672,4467,3822,1741,2081,4317,1931,2386
112181,30,143,2,141,143,2,141,,,
112190,30,14593,6731,7862,4615,2446,2169,9978,4285,5693
112260,30,1383,678,705,1377,673,704,6,5,1
112288,30,489,20,469,489,20,469,,,
112367,30,206,32,174,24,5,19,182,27,155
112385,30,6671,3717,2954,583,263,320,6088,3454,2634
112394,30,373,272,101,300,220,80,73,52,21
112455,30,111,27,84,111,27,84,,,
112561,30,1801,776,1025,791,371,420,1010,405,605
112570,30,291,169,122,196,117,79,95,52,43
112686,30,2497,864,1633,730,300,430,1767,564,1203
112826,30,4557,1794,2763,1354,646,708,3203,1148,2055
113096,30,12073,5189,6884,2945,1423,1522,9128,3766,5362
113111,30,4312,1982,2330,1417,651,766,2895,1331,1564
113193,30,7009,3360,3649,2725,1382,1343,4284,1978,2306
113218,30,6527,2899,3628,1482,737,745,5045,2162,2883
113236,30,11865,5085,6780,4676,2103,2573,7189,2982,4207
113333,30,14294,7327,6967,7664,4179,3485,6630,3148,3482
113449,30,186,53,133,186,53,133,,,
113537,30,8,1,7,8,1,7,,,
113573,30,8664,3637,5027,3767,1726,2041,4897,1911,2986
113582,30,90,8,82,71,7,64,19,1,18
113634,30,14387,7129,7258,5800,3044,2756,8587,4085,4502
113698,30,1139,316,823,1016,279,737,123,37,86
113856,30,23499,11862,11637,4990,2245,2745,18509,9617,8892
113980,30,16352,7628,8724,6334,3101,3233,10018,4527,5491
114266,30,6741,3031,3710,1847,885,962,4894,2146,2748
114354,30,1780,317,1463,1365,232,1133,415,85,330
114433,30,1243,724,519,464,240,224,779,484,295
114460,30,293,38,255,199,23,176,94,15,79
114637,30,78,6,72,78,6,72,,,
114716,30,10193,5460,4733,3240,1581,1659,6953,3879,3074
114761,30,72,9,63,72,9,63,,,
114789,30,18481,8465,10016,5517,2420,3097,12964,6045,6919
114813,30,1743,481,1262,909,300,609,834,181,653
114859,30,16426,7733,8693,6563,3262,3301,9863,4471,5392
114938,30,3805,1833,1972,1356,632,724,2449,1201,1248
114947,30,154,70,84,154,70,84,,,
115001,30,9350,4253,5097,4943,2352,2591,4407,1901,2506
115010,30,661,160,501,661,160,501,,,
115083,30,601,418,183,416,324,92,185,94,91
115126,30,8728,4000,4728,2821,1376,1445,5907,2624,3283
115296,30,10994,4561,6433,3750,1684,2066,7244,2877,4367
115357,30,171,51,120,89,33,56,82,18,64
115393,30,7600,3571,4029,3156,1440,1716,4444,2131,2313
115409,30,906,458,448,906,458,448,,,
115658,30,102,8,94,38,4,34,64,4,60
115728,30,564,204,360,474,175,299,90,29,61
115755,30,5373,2315,3058,4664,1985,2679,709,330,379
115773,30,158,28,130,71,16,55,87,12,75
115861,30,6952,3072,3880,3279,1444,1835,3673,1628,2045
115931,30,614,494,120,614,494,120,,,
116226,30,96,6,90,37,4,33,59,2,57
116350,30,116,11,105,115,11,104,1,0,1
116439,30,8398,4354,4044,3616,2023,1593,4782,2331,2451
116563,30,187,7,180,187,7,180,,,
116846,30,15,1,14,14,1,13,1,0,1
117052,30,4897,2280,2617,1730,944,786,3167,1336,1831
117104,30,395,182,213,344,155,189,51,27,24
117140,30,3363,1327,2036,2786,1096,1690,577,231,346
117168,30,729,187,542,647,163,484,82,24,58
117195,30,2234,1368,866,515,247,268,1719,1121,598
117238,30,66,11,55,66,11,55,,,
117247,30,6749,3030,3719,1411,723,688,5338,2307,3031
117274,30,1431,1041,390,369,198,171,1062,843,219
117283,30,45,20,25,27,11,16,18,9,9
117557,30,177,130,47,171,125,46,6,5,1
117575,30,31,20,11,3,1,2,28,19,9
117627,30,1216,498,718,1159,475,684,57,23,34
117636,30,910,249,661,783,207,576,127,42,85
117645,30,20670,8984,11686,8579,3774,4805,12091,5210,6881
117672,30,114,15,99,96,13,83,18,2,16
117690,30,5796,2257,3539,1453,626,827,4343,1631,2712
117706,30,12896,5720,7176,4149,1930,2219,8747,3790,4957
117715,30,3586,1067,2519,529,199,330,3057,868,2189
117724,30,8565,4901,3664,2202,1382,820,6363,3519,2844
117733,30,11706,4915,6791,2796,1307,1489,8910,3608,5302
117751,30,1496,785,711,1138,538,600,358,247,111
117788,30,10558,4531,6027,2635,1215,1420,7923,3316,4607
117803,30,195,52,143,,,,195,52,143
117867,30,7055,2788,4267,1564,675,889,5491,2113,3378
117894,30,6709,2932,3777,2516,1152,1364,4193,1780,2413
117946,30,7138,3346,3792,6992,3267,3725,146,79,67
117955,30,263,59,204,198,41,157,65,18,47
118134,30,90,4,86,32,4,28,58,0,58
118143,30,88,3,85,21,2,19,67,1,66
118161,30,117,4,113,117,4,113,,,
118198,30,952,178,774,952,178,774,,,
118347,30,3648,1570,2078,1158,591,567,2490,979,1511
118684,30,2353,790,1563,670,257,413,1683,533,1150
118693,30,786,444,342,763,432,331,23,12,11
118718,30,8333,3343,4990,4217,1710,2507,4116,1633,2483
118772,30,4784,1670,3114,928,397,531,3856,1273,2583
118912,30,10094,4209,5885,3899,1777,2122,6195,2432,3763
118930,30,4733,2125,2608,1249,623,626,3484,1502,1982
118958,30,63,25,38,24,8,16,39,17,22
118976,30,14655,5633,9022,7434,3066,4368,7221,2567,4654
118994,30,398,232,166,398,232,166,,,
119058,30,13,4,9,12,4,8,1,0,1
119067,30,5347,2379,2968,2023,963,1060,3324,1416,1908
119137,30,10966,5146,5820,4207,2110,2097,6759,3036,3723
119164,30,23073,10947,12126,8722,4411,4311,14351,6536,7815
119173,30,1778,125,1653,1550,101,1449,228,24,204
119216,30,13078,5130,7948,5362,2274,3088,7716,2856,4860
119270,30,785,598,187,578,442,136,207,156,51
119331,30,3301,1339,1962,1351,599,752,1950,740,1210
119553,30,1198,329,869,1180,326,854,18,3,15
119605,30,7993,3820,4173,4296,2005,2291,3697,1815,1882
119775,30,229,132,97,199,112,87,30,20,10
119951,30,193,15,178,193,15,178,,,
120069,30,333,54,279,333,54,279,,,
120078,30,625,102,523,625,102,523,,,
120087,30,231,36,195,231,36,195,,,
120166,30,24,16,8,24,16,8,,,
120254,30,1935,795,1140,1913,782,1131,22,13,9
120290,30,6420,3261,3159,2590,1325,1265,3830,1936,1894
120342,30,15636,7864,7772,6432,3436,2996,9204,4428,4776
120403,30,1264,380,884,1232,368,864,32,12,20
120421,30,5635,2567,3068,1568,723,845,4067,1844,2223
120537,30,590,256,334,503,215,288,87,41,46
120661,30,730,179,551,674,170,504,56,9,47
120698,30,32,3,29,29,3,26,3,0,3
120768,30,398,30,368,,,,398,30,368
120838,30,8,2,6,8,2,6,,,
120865,30,772,278,494,675,256,419,97,22,75
120883,30,3266,1502,1764,3174,1463,1711,92,39,53
120953,30,4087,3610,477,509,368,141,3578,3242,336
120971,30,15057,8021,7036,5409,2806,2603,9648,5215,4433
121044,30,19504,8937,10567,7653,3781,3872,11851,5156,6695
121150,30,3656,1518,2138,3449,1435,2014,207,83,124
121257,30,1212,496,716,1179,484,695,33,12,21
121275,30,69,46,23,69,46,23,,,
121309,30,3149,1096,2053,2729,967,1762,420,129,291
121345,30,1699,769,930,1699,769,930,,,
121363,30,2757,1009,1748,1256,529,727,1501,480,1021
121433,30,119,6,113,118,6,112,1,0,1
121619,30,20309,11937,8372,3779,1892,1887,16530,10045,6485
121637,30,119,10,109,113,10,103,6,0,6
121691,30,2301,941,1360,2053,822,1231,248,119,129
121707,30,3211,1581,1630,1180,602,578,2031,979,1052
121859,30,253,29,224,142,28,114,111,1,110
121868,30,236,2,234,126,0,126,110,2,108
121886,30,14394,8542,5852,3850,1951,1899,10544,6591,3953
121901,30,16317,6664,9653,4880,2140,2740,11437,4524,6913
122117,30,2,1,1,2,1,1,,,
122180,30,15947,6363,9584,3993,1682,2311,11954,4681,7273
122205,30,14307,6367,7940,4970,2521,2449,9337,3846,5491
122296,30,674,139,535,587,129,458,87,10,77
122339,30,9918,4457,5461,1641,744,897,8277,3713,4564
122375,30,14882,6530,8352,3469,1654,1815,11413,4876,6537
122384,30,10622,5874,4748,1764,1126,638,8858,4748,4110
122409,30,31810,13648,18162,28448,11992,16456,3362,1656,1706
122436,30,5569,2424,3145,5457,2371,3086,112,53,59
122506,30,221,135,86,221,135,86,,,
122597,30,21035,9379,11656,17110,7481,9629,3925,1898,2027
122612,30,5980,2118,3862,5793,2040,3753,187,78,109
122658,30,12462,5125,7337,6545,2898,3647,5917,2227,3690
122685,30,2144,553,1591,2144,553,1591,,,
122694,30,817,266,551,817,266,551,,,
122728,30,1123,464,659,899,375,524,224,89,135
122746,30,6245,2587,3658,1561,683,878,4684,1904,2780
122755,30,26735,13948,12787,21526,11175,10351,5209,2773,2436
122791,30,6019,3020,2999,1783,964,819,4236,2056,2180
122889,30,10514,4543,5971,5609,2567,3042,4905,1976,2929
122931,30,6103,3153,2950,5989,3079,2910,114,74,40
122977,30,20376,9033,11343,8695,4066,4629,11681,4967,6714
123013,30,13164,5945,7219,4184,2019,2165,8980,3926,5054
123165,30,1073,0,1073,1071,0,1071,2,0,2
123217,30,10380,4449,5931,4736,2134,2602,5644,2315,3329
123280,30,24,11,13,8,3,5,16,8,8
123299,30,4754,1812,2942,2325,908,1417,2429,904,1525
123341,30,12531,5670,6861,5481,2635,2846,7050,3035,4015
123350,30,157,48,109,120,35,85,37,13,24
123457,30,704,280,424,643,255,388,61,25,36
123484,30,932,511,421,505,297,208,427,214,213
123493,30,98,29,69,98,29,69,,,
123509,30,6038,2869,3169,1651,849,802,4387,2020,2367
123527,30,9194,3548,5646,2412,930,1482,6782,2618,4164
123554,30,1994,869,1125,1912,839,1073,82,30,52
123563,30,7213,3153,4060,2400,998,1402,4813,2155,2658
123572,30,5892,2232,3660,5058,1874,3184,834,358,476
123642,30,237,19,218,147,13,134,90,6,84
123651,30,2001,665,1336,1830,612,1218,171,53,118
123679,30,803,220,583,694,202,492,109,18,91
123800,30,14685,6598,8087,6320,2833,3487,8365,3765,4600
123952,30,245,148,97,223,135,88,22,13,9
123961,30,20505,9818,10687,20057,9562,10495,448,256,192
124113,30,3749,2139,1610,803,264,539,2946,1875,1071
124292,30,516,250,266,516,250,266,,,
124487,30,75,31,44,11,5,6,64,26,38
124681,30,1173,477,696,1173,477,696,,,
124706,30,825,173,652,825,173,652,,,
124937,30,676,224,452,585,210,375,91,14,77
125028,30,9451,4102,5349,3159,1470,1689,6292,2632,3660
125082,30,86,12,74,83,10,73,3,2,1
125091,30,10123,4087,6036,3621,1518,2103,6502,2569,3933
125170,30,4096,1783,2313,837,409,428,3259,1374,1885
125231,30,6274,962,5312,1527,193,1334,4747,769,3978
125310,30,42,13,29,42,13,29,,,
125462,30,1902,936,966,481,244,237,1421,692,729
125471,30,6898,2823,4075,1478,653,825,5420,2170,3250
125499,30,5480,2399,3081,1980,942,1038,3500,1457,2043
125532,30,1806,176,1630,1806,176,1630,,,
125727,30,1284,499,785,1272,492,780,12,7,5
125763,30,1124,501,623,1090,487,603,34,14,20
125897,30,868,410,458,798,375,423,70,35,35
126076,30,142,142,0,142,142,0,,,
126119,30,4181,1603,2578,1281,548,733,2900,1055,1845
126182,30,1307,741,566,1058,584,474,249,157,92
126207,30,3448,1507,1941,1484,742,742,1964,765,1199
126289,30,5369,2099,3270,1681,797,884,3688,1302,2386
126359,30,205,19,186,205,19,186,,,
126562,30,10922,4786,6136,8355,3658,4697,2567,1128,1439
126580,30,9102,4188,4914,7223,3333,3890,1879,855,1024
126605,30,284,252,32,284,252,32,,,
126614,30,30598,16530,14068,28654,15337,13317,1944,1193,751
126669,30,5399,1578,3821,1812,621,1191,3587,957,2630
126678,30,2174,968,1206,2139,952,1187,35,16,19
126687,30,731,131,600,731,131,600,,,
126711,30,2701,1055,1646,1199,568,631,1502,487,1015
126748,30,565,198,367,367,156,211,198,42,156
126775,30,5662,3846,1816,5404,3675,1729,258,171,87
126784,30,130,127,3,130,127,3,,,
126818,30,25150,11448,13702,22203,10010,12193,2947,1438,1509
126827,30,22315,7465,14850,13556,4598,8958,8759,2867,5892
126863,30,3239,1291,1948,953,491,462,2286,800,1486
126915,30,173,52,121,91,32,59,82,20,62
126942,30,5019,1799,3220,1670,638,1032,3349,1161,2188
126951,30,1155,1042,113,1155,1042,113,,,
127060,30,5986,2670,3316,5660,2506,3154,326,164,162
127158,30,5313,4671,642,1178,921,257,4135,3750,385
127185,30,3113,1425,1688,2854,1314,1540,259,111,148
127200,30,10781,4548,6233,3454,1696,1758,7327,2852,4475
127316,30,313,50,263,91,23,68,222,27,195
127389,30,394,177,217,300,146,154,94,31,63
127556,30,7654,3567,4087,6418,2984,3434,1236,583,653
127565,30,14947,6678,8269,9192,4178,5014,5755,2500,3255
127617,30,635,197,438,241,80,161,394,117,277
127653,30,338,99,239,306,84,222,32,15,17
127714,30,316,142,174,20,6,14,296,136,160
127732,30,827,348,479,634,306,328,193,42,151
127741,30,6024,2004,4020,5365,1802,3563,659,202,457
127778,30,642,281,361,455,219,236,187,62,125
127820,30,9153,3698,5455,3507,1571,1936,5646,2127,3519
127884,30,3237,1002,2235,1161,452,709,2076,550,1526
127909,30,4146,2035,2111,1601,866,735,2545,1169,1376
127918,30,2239,777,1462,1774,584,1190,465,193,272
127945,30,2041,530,1511,1138,306,832,903,224,679
127954,30,11,0,11,11,0,11,,,
128106,30,3008,1424,1584,2434,1131,1303,574,293,281
128151,30,590,299,291,559,295,264,31,4,27
128179,30,691,490,201,691,490,201,,,
128188,30,1105,407,698,1105,407,698,,,
128258,30,1075,515,560,570,306,264,505,209,296
128328,30,4085,2882,1203,4085,2882,1203,,,
128337,30,81,1,80,49,1,48,32,0,32
128391,30,1673,973,700,1555,904,651,118,69,49
128498,30,978,405,573,875,367,508,103,38,65
128577,30,1013,483,530,454,256,198,559,227,332
128586,30,60,60,0,60,60,0,,,
128744,30,1604,476,1128,1339,432,907,265,44,221
128771,30,7500,4091,3409,6076,3338,2738,1424,753,671
128780,30,1426,346,1080,397,87,310,1029,259,770
128896,30,202,18,184,202,18,184,,,
128902,30,1915,737,1178,1915,737,1178,,,
129002,30,426,255,171,402,248,154,24,7,17
129020,30,18768,8848,9920,18319,8591,9728,449,257,192
129154,30,2802,362,2440,318,105,213,2484,257,2227
129181,30,973,892,81,855,790,65,118,102,16
129215,30,3534,1461,2073,3275,1341,1934,259,120,139
129242,30,4706,1977,2729,4655,1954,2701,51,23,28
129349,30,161,5,156,125,5,120,36,0,36
129367,30,2182,594,1588,605,204,401,1577,390,1187
129482,30,369,25,344,369,25,344,,,
129525,30,3876,1701,2175,3678,1621,2057,198,80,118
129534,30,196,92,104,95,49,46,101,43,58
129543,30,2959,1143,1816,1144,487,657,1815,656,1159
129695,30,3724,1626,2098,1450,689,761,2274,937,1337
129729,30,4216,1669,2547,1596,740,856,2620,929,1691
129756,30,1688,691,997,726,343,383,962,348,614
129774,30,480,254,226,465,247,218,15,7,8
129808,30,2736,987,1749,1052,472,580,1684,515,1169
129923,30,638,287,351,441,180,261,197,107,90
129932,30,314,274,40,256,218,38,58,56,2
129941,30,4765,2070,2695,4484,1907,2577,281,163,118
130004,30,3484,1431,2053,1311,612,699,2173,819,1354
130040,30,965,343,622,445,188,257,520,155,365
130110,30,198,67,131,145,50,95,53,17,36
130174,30,2146,1233,913,1546,909,637,600,324,276
130183,30,14297,3707,10590,6047,1539,4508,8250,2168,6082
130217,30,1023,411,612,406,182,224,617,229,388
130226,30,6021,2316,3705,5846,2240,3606,175,76,99
130253,30,6729,2232,4497,6277,2091,4186,452,141,311
130314,30,821,219,602,787,212,575,34,7,27
130396,30,5114,1924,3190,1651,732,919,3463,1192,2271
130493,30,6246,2416,3830,5322,2076,3246,924,340,584
130590,30,2141,1040,1101,2112,1025,1087,29,15,14
130606,30,2974,1281,1693,1315,589,726,1659,692,967
130624,30,1037,609,428,1037,609,428,,,
130697,30,3006,1391,1615,3000,1388,1612,6,3,3
130776,30,3679,1783,1896,3165,1543,1622,514,240,274
130794,30,6639,3252,3387,6588,3218,3370,51,34,17
130837,30,51,3,48,51,3,48,,,
130873,30,308,102,206,308,102,206,,,
130907,30,10030,3241,6789,3846,1588,2258,6184,1653,4531
130934,30,4588,1576,3012,4006,1332,2674,582,244,338
130943,30,18665,7699,10966,18022,7375,10647,643,324,319
130989,30,617,307,310,534,274,260,83,33,50
131061,30,185,10,175,103,9,94,82,1,81
131113,30,8210,3118,5092,2752,1158,1594,5458,1960,3498
131159,30,7669,2748,4921,7411,2633,4778,258,115,143
131283,30,2958,1267,1691,2786,1222,1564,172,45,127
131399,30,2912,1039,1873,1241,558,683,1671,481,1190
131450,30,910,435,475,852,409,443,58,26,32
131469,30,10798,4008,6790,10225,3781,6444,573,227,346
131496,30,7343,3085,4258,7148,2995,4153,195,90,105
131520,30,9243,2552,6691,9019,2449,6570,224,103,121
131803,30,315,73,242,25,12,13,290,61,229
131830,30,18,8,10,18,8,10,,,
131876,30,1369,34,1335,893,11,882,476,23,453
132374,30,2584,2238,346,2584,2238,346,,,
132408,30,254,126,128,167,75,92,87,51,36
132471,30,2539,910,1629,2243,794,1449,296,116,180
132602,30,2628,971,1657,2527,936,1591,101,35,66
132657,30,2789,1364,1425,2616,1283,1333,173,81,92
132675,30,43,28,15,39,24,15,4,4,0
132693,30,9714,3988,5726,3581,1672,1909,6133,2316,3817
132709,30,24521,10058,14463,8123,3728,4395,16398,6330,10068
132842,30,217,35,182,99,13,86,118,22,96
132851,30,4510,1613,2897,1971,783,1188,2539,830,1709
132879,30,154,98,56,146,92,54,8,6,2
132903,30,57874,26065,31809,40519,18195,22324,17355,7870,9485
132976,30,313,172,141,313,172,141,,,
133021,30,1246,474,772,685,291,394,561,183,378
133155,30,675,309,366,374,210,164,301,99,202
133386,30,8884,3551,5333,3965,1849,2116,4919,1702,3217
133465,30,303,61,242,241,45,196,62,16,46
133492,30,1986,594,1392,1929,571,1358,57,23,34
133508,30,10623,3875,6748,4161,1645,2516,6462,2230,4232
133526,30,1142,607,535,1054,566,488,88,41,47
133553,30,7155,5350,1805,6830,5084,1746,325,266,59
133650,30,7436,2494,4942,6612,2235,4377,824,259,565
133669,30,23074,9749,13325,15612,6532,9080,7462,3217,4245
133702,30,16775,5931,10844,5329,2133,3196,11446,3798,7648
133711,30,2591,820,1771,2524,796,1728,67,24,43
133809,30,550,258,292,542,257,285,8,1,7
133845,30,598,58,540,558,57,501,40,1,39
133854,30,317,68,249,317,68,249,,,
133863,30,473,66,407,473,66,407,,,
133872,30,917,148,769,344,62,282,573,86,487
133881,30,3114,2126,988,2965,2007,958,149,119,30
133951,30,39277,17192,22085,25222,10667,14555,14055,6525,7530
133960,30,897,399,498,397,222,175,500,177,323
133979,30,1098,503,595,1030,459,571,68,44,24
133997,30,332,108,224,332,108,224,,,
134024,30,55,11,44,55,11,44,,,
134079,30,2702,1007,1695,2619,974,1645,83,33,50
134097,30,32691,14002,18689,29475,12447,17028,3216,1555,1661
134130,30,33673,14730,18943,30690,13165,17525,2983,1565,1418
134228,30,31,11,20,27,10,17,4,1,3
134237,30,25526,17634,7892,25526,17634,7892,,,
134291,30,604,488,116,546,436,110,58,52,6
134307,30,893,833,60,216,208,8,677,625,52
134343,30,3466,1233,2233,1784,684,1100,1682,549,1133
134422,30,20,0,20,10,0,10,10,0,10
134495,30,19474,8157,11317,9058,4264,4794,10416,3893,6523
134510,30,165,84,81,78,36,42,87,48,39
134529,30,299,31,268,299,31,268,,,
134574,30,158,33,125,158,33,125,,,
134608,30,11481,4655,6826,4851,2228,2623,6630,2427,4203
134714,30,396,62,334,145,31,114,251,31,220
134811,30,866,258,608,584,163,421,282,95,187
134945,30,2541,966,1575,2335,907,1428,206,59,147
135081,30,16649,4696,11953,9804,3063,6741,6845,1633,5212
135142,30,238,2,236,39,0,39,199,2,197
135160,30,2047,644,1403,819,263,556,1228,381,847
135179,30,668,391,277,442,265,177,226,126,100
135188,30,3188,1193,1995,1226,494,732,1962,699,1263
135267,30,562,421,141,556,419,137,6,2,4
135276,30,854,436,418,764,365,399,90,71,19
135294,30,476,239,237,361,230,131,115,9,106
135337,30,103,9,94,30,7,23,73,2,71
135364,30,212,147,65,25,19,6,187,128,59
135391,30,7251,2643,4608,3088,1279,1809,4163,1364,2799
135407,30,1054,608,446,1024,587,437,30,21,9
135522,30,322,168,154,322,168,154,,,
135559,30,63,9,54,36,7,29,27,2,25
135610,30,66,32,34,33,14,19,33,18,15
135647,30,850,727,123,596,526,70,254,201,53
135717,30,40538,17186,23352,18440,7991,10449,22098,9195,12903
135726,30,12215,5711,6504,11840,5528,6312,375,183,192
135735,30,1223,1123,100,372,325,47,851,798,53
136109,30,124,1,123,68,1,67,56,0,56
136145,30,756,202,554,272,76,196,484,126,358
136172,30,13866,5931,7935,10750,4522,6228,3116,1409,1707
136215,30,6885,1917,4968,6218,1794,4424,667,123,544
136233,30,3149,1252,1897,1516,664,852,1633,588,1045
136303,30,107,26,81,107,26,81,,,
136330,30,2396,822,1574,2282,782,1500,114,40,74
136358,30,20378,8276,12102,6989,3282,3707,13389,4994,8395
136400,30,6630,2657,3973,2667,1136,1531,3963,1521,2442
136473,30,6249,2134,4115,2737,1018,1719,3512,1116,2396
136491,30,645,386,259,517,355,162,128,31,97
136516,30,6114,2062,4052,2252,808,1444,3862,1254,2608
136659,30,230,174,56,201,154,47,29,20,9
136765,30,403,202,201,343,172,171,60,30,30
136774,30,1704,463,1241,1680,457,1223,24,6,18
136826,30,805,498,307,505,308,197,300,190,110
136950,30,2567,1036,1531,2487,1003,1484,80,33,47
137023,30,373,168,205,367,164,203,6,4,2
137032,30,6717,2615,4102,3942,1479,2463,2775,1136,1639
137078,30,18984,7084,11900,6245,2729,3516,12739,4355,8384
137087,30,646,367,279,606,362,244,40,5,35
137096,30,11038,5140,5898,5028,2574,2454,6010,2566,3444
137120,30,1138,717,421,531,335,196,607,382,225
137209,30,11898,5118,6780,4465,2136,2329,7433,2982,4451
137245,30,1297,649,648,1297,649,648,,,
137272,30,42,40,2,42,40,2,,,
137281,30,3708,1350,2358,1365,576,789,2343,774,1569
137315,30,2098,668,1430,889,350,539,1209,318,891
137351,30,36763,15928,20835,29681,12671,17010,7082,3257,3825
137476,30,1896,979,917,1690,932,758,206,47,159
137546,30,2517,1088,1429,2470,1058,1412,47,30,17
137564,30,4931,1963,2968,4248,1650,2598,683,313,370
137591,30,244,52,192,181,44,137,63,8,55
137713,30,187,71,116,151,62,89,36,9,27
137759,30,9939,4403,5536,5938,2823,3115,4001,1580,2421
137777,30,33,33,0,33,33,0,,,
137801,30,211,108,103,211,108,103,,,
137847,30,9593,3979,5614,9356,3869,5487,237,110,127
137856,30,154,83,71,131,77,54,23,6,17
137865,30,387,220,167,387,220,167,,,
137953,30,319,181,138,214,130,84,105,51,54
137962,30,175,95,80,146,83,63,29,12,17
138187,30,35867,14753,21114,14236,6304,7932,21631,8449,13182
138275,30,738,389,349,690,367,323,48,22,26
138284,30,306,153,153,280,132,148,26,21,5
138293,30,1093,771,322,894,634,260,199,137,62
138309,30,7936,1083,6853,3997,568,3429,3939,515,3424
138354,30,8806,3683,5123,6175,2638,3537,2631,1045,1586
138372,30,492,284,208,251,73,178,241,211,30
138479,30,564,358,206,564,358,206,,,
138488,30,248,94,154,178,41,137,70,53,17
138497,30,313,194,119,313,194,119,,,
138558,30,3160,1303,1857,2367,1091,1276,793,212,581
138600,30,923,0,923,921,0,921,2,0,2
138655,30,543,359,184,512,341,171,31,18,13
138664,30,93,34,59,93,34,59,,,
138682,30,2169,635,1534,857,260,597,1312,375,937
138716,30,5645,1466,4179,4165,1180,2985,1480,286,1194
138761,30,242,100,142,183,95,88,59,5,54
138813,30,456,205,251,283,133,150,173,72,101
138822,30,593,18,575,593,18,575,,,
138840,30,2866,1020,1846,931,433,498,1935,587,1348
138868,30,1041,515,526,786,422,364,255,93,162
138901,30,1272,417,855,543,190,353,729,227,502
138938,30,333,25,308,194,8,186,139,17,122
138947,30,3419,806,2613,3256,746,2510,163,60,103
138956,30,3489,1445,2044,1317,563,754,2172,882,1290
139144,30,2232,824,1408,2219,817,1402,13,7,6
139153,30,143,77,66,78,44,34,65,33,32
139199,30,1184,83,1101,852,53,799,332,30,302
139205,30,646,407,239,573,343,230,73,64,9
139250,30,2812,834,1978,1804,547,1257,1008,287,721
139278,30,4477,1439,3038,1368,534,834,3109,905,2204
139311,30,4540,1370,3170,2924,905,2019,1616,465,1151
139357,30,2699,793,1906,828,268,560,1871,525,1346
139366,30,5637,2350,3287,4101,1619,2482,1536,731,805
139384,30,3872,1362,2510,1351,531,820,2521,831,1690
139393,30,808,382,426,798,376,422,10,6,4
139463,30,4260,1631,2629,2708,1061,1647,1552,570,982
139506,30,58,31,27,58,31,27,,,
139579,30,195,49,146,161,40,121,34,9,25
139621,30,1514,707,807,1140,540,600,374,167,207
139630,30,730,417,313,704,402,302,26,15,11
139658,30,7017,3006,4011,6949,2973,3976,68,33,35
139700,30,4419,1584,2835,1943,793,1150,2476,791,1685
139719,30,2347,839,1508,2080,752,1328,267,87,180
139746,30,61,12,49,61,12,49,,,
139755,30,17379,10459,6920,16110,9684,6426,1269,775,494
139764,30,2092,726,1366,1576,559,1017,516,167,349
139861,30,5185,1827,3358,4767,1668,3099,418,159,259
139931,30,20996,8984,12012,17807,7602,10205,3189,1382,1807
139940,30,28439,11496,16943,21544,8690,12854,6895,2806,4089
139959,30,30566,12819,17747,28758,11938,16820,1808,881,927
139968,30,2663,939,1724,1711,655,1056,952,284,668
139986,30,3734,1024,2710,1154,347,807,2580,677,1903
139995,30,479,180,299,288,109,179,191,71,120
140003,30,130,15,115,59,5,54,71,10,61
140012,30,6649,2819,3830,1571,836,735,5078,1983,3095
140234,30,597,342,255,585,339,246,12,3,9
140243,30,3867,1576,2291,1177,488,689,2690,1088,1602
140252,30,910,461,449,766,410,356,144,51,93
140331,30,7188,3121,4067,2445,1181,1264,4743,1940,2803
140340,30,614,94,520,310,60,250,304,34,270
140447,30,4568,1631,2937,4058,1516,2542,510,115,395
140553,30,2564,2563,1,2183,2183,0,381,380,1
140571,30,252,112,140,168,70,98,84,42,42
140678,30,1851,763,1088,818,394,424,1033,369,664
140696,30,1426,535,891,1391,520,871,35,15,20
140720,30,299,130,169,273,121,152,26,9,17
140818,30,1212,375,837,1132,358,774,80,17,63
140827,30,67,18,49,67,18,49,,,
140872,30,1014,533,481,929,502,427,85,31,54
140942,30,3128,1089,2039,1104,488,616,2024,601,1423
140951,30,13352,4019,9333,11460,3416,8044,1892,603,1289
140960,30,2648,1013,1635,2323,897,1426,325,116,209
140988,30,1121,511,610,1055,494,561,66,17,49
141006,30,1435,704,731,749,409,340,686,295,391
141015,30,37,16,21,36,15,21,1,1,0
141060,30,3098,168,2930,2325,0,2325,773,168,605
141167,30,726,347,379,506,252,254,220,95,125
141185,30,835,327,508,765,304,461,70,23,47
141237,30,828,403,425,784,376,408,44,27,17
141255,30,2385,788,1597,755,217,538,1630,571,1059
141264,30,7277,2397,4880,5683,1906,3777,1594,491,1103
141325,30,510,1,509,413,0,413,97,1,96
141334,30,7939,2821,5118,6226,2244,3982,1713,577,1136
141361,30,837,368,469,833,367,466,4,1,3
141486,30,1505,418,1087,1292,357,935,213,61,152
141565,30,2381,845,1536,1832,665,1167,549,180,369
141574,30,13915,5543,8372,11329,4421,6908,2586,1122,1464
141608,30,52,37,15,52,37,15,,,
141644,30,2650,889,1761,2206,669,1537,444,220,224
141680,30,1895,1233,662,806,562,244,1089,671,418
141796,30,3863,1338,2525,1482,571,911,2381,767,1614
141802,30,756,259,497,234,114,120,522,145,377
141811,30,3621,1455,2166,1618,741,877,2003,714,1289
141839,30,1636,556,1080,596,235,361,1040,321,719
141981,30,2491,868,1623,1500,530,970,991,338,653
141990,30,1009,355,654,478,161,317,531,194,337
142054,30,403,56,347,403,56,347,,,
142090,30,95,53,42,80,45,35,15,8,7
142115,30,16979,7324,9655,13402,5808,7594,3577,1516,2061
142179,30,1317,470,847,586,265,321,731,205,526
142276,30,6830,2737,4093,5333,2125,3208,1497,612,885
142285,30,7120,3559,3561,6630,3309,3321,490,250,240
142294,30,1052,521,531,1044,516,528,8,5,3
142328,30,2344,856,1488,1846,710,1136,498,146,352
142407,30,87,12,75,87,12,75,,,
142443,30,2732,1011,1721,1367,620,747,1365,391,974
142461,30,1115,487,628,1003,451,552,112,36,76
142489,30,60,8,52,60,8,52,,,
142522,30,42213,18484,23729,16557,7749,8808,25656,10735,14921
142559,30,3531,1236,2295,1742,724,1018,1789,512,1277
142832,30,9,9,0,,,,9,9,0
142887,30,111,45,66,88,31,57,23,14,9
142957,30,5,3,2,1,1,0,4,2,2
143048,30,2819,701,2118,2596,634,1962,223,67,156
143084,30,2274,1032,1242,2259,1023,1236,15,9,6
143118,30,3987,1315,2672,3663,1229,2434,324,86,238
143215,30,5293,2277,3016,2421,1112,1309,2872,1165,1707
143279,30,2202,811,1391,1164,515,649,1038,296,742
143288,30,342,157,185,337,156,181,5,1,4
143297,30,151,18,133,121,13,108,30,5,25
143358,30,4133,2031,2102,4026,1963,2063,107,68,39
143376,30,229,11,218,155,11,144,74,0,74
143464,30,100,4,96,91,4,87,9,0,9
143473,30,31,2,29,8,1,7,23,1,22
143482,30,29,0,29,14,0,14,15,0,15
143491,30,39,2,37,13,1,12,26,1,25
143552,30,51,1,50,20,0,20,31,1,30
143613,30,1107,386,721,681,291,390,426,95,331
143978,30,34,7,27,17,3,14,17,4,13
144005,30,1364,442,922,935,331,604,429,111,318
144050,30,7511,3990,3521,7507,3987,3520,4,3,1
144157,30,1363,630,733,617,342,275,746,288,458
144166,30,5533,1124,4409,2247,531,1716,3286,593,2693
144175,30,1137,478,659,511,255,256,626,223,403
144184,30,2247,864,1383,960,395,565,1287,469,818
144193,30,2261,1249,1012,1090,714,376,1171,535,636
144209,30,3980,1637,2343,1902,831,1071,2078,806,1272
144218,30,4324,2167,2157,1937,1082,855,2387,1085,1302
144281,30,6378,2534,3844,6083,2406,3677,295,128,167
144351,30,1285,599,686,1157,548,609,128,51,77
144564,30,1192,485,707,687,268,419,505,217,288
144573,30,142,5,137,104,3,101,38,2,36
144740,30,13968,6291,7677,12859,5733,7126,1109,558,551
144795,30,359,93,266,330,88,242,29,5,24
144865,30,14402,6719,7683,6308,3199,3109,8094,3520,4574
144883,30,529,264,265,529,264,265,,,
144892,30,4586,1774,2812,4011,1590,2421,575,184,391
144944,30,6271,2958,3313,2480,1289,1191,3791,1669,2122
144962,30,2897,1117,1780,2824,1075,1749,73,42,31
144971,30,544,295,249,523,289,234,21,6,15
145099,30,274,19,255,274,19,255,,,
145239,30,252,34,218,252,34,218,,,
145309,30,41,10,31,41,10,31,,,
145336,30,2589,953,1636,1627,613,1014,962,340,622
145354,30,43,2,41,7,0,7,36,2,34
145372,30,902,483,419,829,457,372,73,26,47
145406,30,378,7,371,110,5,105,268,2,266
145424,30,62,0,62,17,0,17,45,0,45
145433,30,97,1,96,37,1,36,60,0,60
145497,30,73,15,58,51,11,40,22,4,18
145521,30,791,305,486,461,191,270,330,114,216
145600,30,21567,10083,11484,19565,9110,10455,2002,973,1029
145619,30,2026,1067,959,1785,975,810,241,92,149
145637,30,34031,18154,15877,33273,17641,15632,758,513,245
145646,30,1518,778,740,1512,775,737,6,3,3
145682,30,4630,1856,2774,1940,961,979,2690,895,1795
145691,30,1011,475,536,984,466,518,27,9,18
145707,30,587,245,342,430,200,230,157,45,112
145725,30,2877,1934,943,2683,1779,904,194,155,39
145813,30,18019,7843,10176,16953,7298,9655,1066,545,521
145831,30,1808,813,995,925,450,475,883,363,520
146205,30,2067,844,1223,1248,540,708,819,304,515
146278,30,1330,492,838,767,327,440,563,165,398
146296,30,8520,3736,4784,3517,1654,1863,5003,2082,2921
146339,30,781,394,387,731,381,350,50,13,37
146348,30,1874,742,1132,841,395,446,1033,347,686
146366,30,1778,666,1112,1059,435,624,719,231,488
146418,30,1718,743,975,886,437,449,832,306,526
146427,30,1051,463,588,1047,462,585,4,1,3
146454,30,28,0,28,28,0,28,,,
146472,30,8977,4077,4900,3435,1774,1661,5542,2303,3239
146481,30,1724,714,1010,1683,699,984,41,15,26
146506,30,2577,1032,1545,1834,769,1065,743,263,480
146533,30,116,22,94,85,19,66,31,3,28
146603,30,2210,845,1365,1177,515,662,1033,330,703
146612,30,3650,1882,1768,3124,1589,1535,526,293,233
146667,30,85,50,35,51,31,20,34,19,15
146685,30,3720,1453,2267,1582,783,799,2138,670,1468
146700,30,1209,906,303,1209,906,303,,,
146719,30,11626,3618,8008,11145,3447,7698,481,171,310
146755,30,81,11,70,65,10,55,16,1,15
146807,30,64,7,57,19,2,17,45,5,40
146816,30,303,33,270,254,23,231,49,10,39
147004,30,4366,1969,2397,1929,941,988,2437,1028,1409
147013,30,1528,772,756,1408,734,674,120,38,82
147129,30,433,40,393,208,18,190,225,22,203
147244,30,1603,723,880,1551,710,841,52,13,39
147341,30,761,387,374,744,380,364,17,7,10
147369,30,1716,872,844,1380,674,706,336,198,138
147378,30,7180,3378,3802,3628,1770,1858,3552,1608,1944
147396,30,67,59,8,66,58,8,1,1,0
147411,30,2608,1115,1493,1111,529,582,1497,586,911
147536,30,3791,1017,2774,2690,817,1873,1101,200,901
147590,30,30,9,21,17,6,11,13,3,10
147642,30,53,5,48,9,0,9,44,5,39
147660,30,2304,1133,1171,2257,1109,1148,47,24,23
147679,30,1866,782,1084,1745,738,1007,121,44,77
147703,30,11408,5399,6009,9925,4647,5278,1483,752,731
147767,30,8837,4087,4750,8588,3978,4610,249,109,140
147776,30,4058,1677,2381,2486,1034,1452,1572,643,929
147800,30,5918,2949,2969,1966,1113,853,3952,1836,2116
147819,30,36,1,35,36,1,35,,,
147828,30,2460,1090,1370,2391,1066,1325,69,24,45
147916,30,3247,1598,1649,1797,958,839,1450,640,810
148007,30,2349,883,1466,896,365,531,1453,518,935
148016,30,316,188,128,302,176,126,14,12,2
148098,30,48,1,47,33,1,32,15,0,15
148131,30,1027,551,476,989,539,450,38,12,26
148256,30,1278,546,732,964,430,534,314,116,198
148292,30,1366,458,908,479,189,290,887,269,618
148380,30,4543,2080,2463,1999,966,1033,2544,1114,1430
148405,30,908,420,488,867,404,463,41,16,25
148487,30,2362,941,1421,2056,850,1206,306,91,215
148496,30,2119,610,1509,2011,584,1427,108,26,82
148511,30,115,25,90,48,9,39,67,16,51
148575,30,244,36,208,195,31,164,49,5,44
148584,30,1390,456,934,1176,408,768,214,48,166
148593,30,82,6,76,65,6,59,17,0,17
148627,30,2963,1102,1861,2748,1021,1727,215,81,134
148654,30,2348,1073,1275,1657,719,938,691,354,337
148672,30,1081,417,664,611,259,352,470,158,312
148821,30,706,264,442,426,164,262,280,100,180
148876,30,670,117,553,462,81,381,208,36,172
148937,30,637,281,356,473,223,250,164,58,106
148991,30,735,293,442,435,193,242,300,100,200
149028,30,181,18,163,123,15,108,58,3,55
149204,30,39,1,38,39,1,38,,,
149222,30,7922,3952,3970,6696,3248,3448,1226,704,522
149231,30,9283,3965,5318,7693,3301,4392,1590,664,926
149310,30,98,46,52,98,46,52,,,
149329,30,79,79,0,79,79,0,,,
149365,30,1926,618,1308,671,263,408,1255,355,900
149505,30,783,301,482,698,280,418,85,21,64
149514,30,409,255,154,350,219,131,59,36,23
149532,30,6292,3173,3119,2496,1199,1297,3796,1974,1822
149550,30,147,14,133,105,14,91,42,0,42
149639,30,67,30,37,65,28,37,2,2,0
149727,30,5400,2411,2989,2283,1142,1141,3117,1269,1848
149763,30,371,85,286,216,56,160,155,29,126
149772,30,5196,2235,2961,4469,1910,2559,727,325,402
149781,30,2141,947,1194,2081,921,1160,60,26,34
149842,30,8686,3832,4854,3677,1880,1797,5009,1952,3057
150066,30,1111,542,569,1028,513,515,83,29,54
150136,30,13466,5225,8241,12620,4909,7711,846,316,530
150145,30,1115,447,668,1021,424,597,94,23,71
150163,30,4304,1760,2544,4248,1726,2522,56,34,22
150172,30,562,357,205,389,236,153,173,121,52
150251,30,186,6,180,94,1,93,92,5,87
150303,30,288,3,285,143,1,142,145,2,143
150400,30,1732,854,878,1725,852,873,7,2,5
150428,30,16,0,16,16,0,16,,,
150455,30,589,276,313,587,274,313,2,2,0
150534,30,1460,560,900,1420,546,874,40,14,26
150604,30,859,455,404,850,448,402,9,7,2
150668,30,704,270,434,667,258,409,37,12,25
150677,30,1458,573,885,1421,557,864,37,16,21
150756,30,949,474,475,945,471,474,4,3,1
150765,30,116,2,114,116,2,114,,,
150774,30,422,246,176,412,243,169,10,3,7
150853,30,215,4,211,132,4,128,83,0,83
150941,30,1066,404,662,911,341,570,155,63,92
150987,30,51796,22210,29586,14673,5580,9093,37123,16630,20493
151102,30,5482,2796,2686,4517,2314,2203,965,482,483
151111,30,17278,7033,10245,14924,5937,8987,2354,1096,1258
151263,30,3444,1333,2111,3238,1262,1976,206,71,135
151290,30,1341,797,544,1291,768,523,50,29,21
151306,30,5491,2002,3489,4834,1771,3063,657,231,426
151324,30,6926,2996,3930,5738,2479,3259,1188,517,671
151333,30,2419,834,1585,2031,693,1338,388,141,247
151342,30,3666,1283,2383,2843,974,1869,823,309,514
151351,30,35401,17833,17568,34537,17336,17201,864,497,367
151360,30,2711,685,2026,1964,509,1455,747,176,571
151379,30,3133,1219,1914,2237,856,1381,896,363,533
151388,30,2472,863,1609,1575,490,1085,897,373,524
151467,30,167,18,149,167,18,149,,,
151564,30,43,1,42,10,1,9,33,0,33
151607,30,100,2,98,76,2,74,24,0,24
151661,30,889,742,147,889,742,147,,,
151777,30,914,444,470,892,436,456,22,8,14
151786,30,2347,876,1471,2063,824,1239,284,52,232
151801,30,2097,762,1335,2072,745,1327,25,17,8
151810,30,161,54,107,67,21,46,94,33,61
151962,30,352,103,249,284,80,204,68,23,45
152044,30,83,42,41,17,14,3,66,28,38
152080,30,8917,4581,4336,8899,4568,4331,18,13,5
152099,30,604,332,272,569,303,266,35,29,6
152150,30,65,1,64,36,1,35,29,0,29
152275,30,119,43,76,61,2,59,58,41,17
152309,30,93,39,54,82,34,48,11,5,6
152318,30,2154,1629,525,2128,1610,518,26,19,7
152336,30,1572,529,1043,1428,506,922,144,23,121
152381,30,801,188,613,711,183,528,90,5,85
152390,30,1378,0,1378,1372,0,1372,6,0,6
152497,30,144,14,130,122,13,109,22,1,21
152530,30,1767,812,955,1721,785,936,46,27,19
152567,30,2250,1418,832,2215,1393,822,35,25,10
152600,30,2342,1005,1337,2301,986,1315,41,19,22
152628,30,28,1,27,12,1,11,16,0,16
152637,30,3646,1937,1709,2793,1526,1267,853,411,442
152673,30,835,835,0,834,834,0,1,1,0
152798,30,278,25,253,248,21,227,30,4,26
152992,30,624,299,325,556,291,265,68,8,60
153001,30,1419,501,918,1276,470,806,143,31,112
153074,30,175,6,169,175,6,169,,,
153083,30,142,3,139,142,3,139,,,
153108,30,1135,593,542,1117,582,535,18,11,7
153126,30,724,404,320,705,393,312,19,11,8
153144,30,1224,539,685,1218,535,683,6,4,2
153162,30,1056,551,505,1055,550,505,1,1,0
153214,30,10110,4288,5822,4831,2346,2485,5279,1942,3337
153241,30,68,27,41,56,23,33,12,4,8
153250,30,1472,753,719,1459,746,713,13,7,6
153269,30,2794,1116,1678,2739,1090,1649,55,26,29
153278,30,1439,849,590,1206,761,445,233,88,145
153296,30,560,284,276,514,269,245,46,15,31
153302,30,188,85,103,170,77,93,18,8,10
153311,30,3149,1034,2115,1607,618,989,1542,416,1126
153320,30,313,153,160,282,136,146,31,17,14
153366,30,860,483,377,818,474,344,42,9,33
153375,30,1525,698,827,1390,648,742,135,50,85
153384,30,1709,807,902,1703,805,898,6,2,4
153427,30,75,32,43,75,32,43,,,
153445,30,2581,1079,1502,1754,837,917,827,242,585
153463,30,20,1,19,20,1,19,,,
153472,30,1695,765,930,1396,675,721,299,90,209
153524,30,3042,1557,1485,2404,1332,1072,638,225,413
153533,30,977,502,475,741,417,324,236,85,151
153542,30,19,2,17,19,2,17,,,
153597,30,77,3,74,77,3,74,,,
153603,30,24994,13969,11025,23931,13263,10668,1063,706,357
153621,30,734,416,318,691,401,290,43,15,28
153630,30,3237,1463,1774,2026,1135,891,1211,328,883
153658,30,21545,9463,12082,20136,8804,11332,1409,659,750
153737,30,7370,3066,4304,3954,1862,2092,3416,1204,2212
153746,30,39,2,37,39,2,37,,,
153764,30,57,0,57,57,0,57,,,
153773,30,59,4,55,59,4,55,,,
153782,30,21,0,21,21,0,21,,,
153825,30,1192,694,498,1143,657,486,49,37,12
153834,30,1603,726,877,1592,718,874,11,8,3
153861,30,681,162,519,455,118,337,226,44,182
153922,30,774,335,439,581,272,309,193,63,130
153977,30,909,130,779,457,84,373,452,46,406
154004,30,1175,585,590,1123,574,549,52,11,41
154013,30,1201,445,756,998,392,606,203,53,150
154022,30,26113,9460,16653,20159,7307,12852,5954,2153,3801
154059,30,1370,617,753,1034,509,525,336,108,228
154095,30,7571,2892,4679,6963,2635,4328,608,257,351
154101,30,1106,518,588,1015,512,503,91,6,85
154110,30,1808,615,1193,869,405,464,939,210,729
154129,30,817,407,410,545,341,204,272,66,206
154174,30,29,16,13,28,15,13,1,1,0
154208,30,126,4,122,20,0,20,106,4,102
154235,30,2108,966,1142,2026,930,1096,82,36,46
154262,30,196,16,180,86,11,75,110,5,105
154332,30,96,3,93,96,3,93,,,
154350,30,1115,536,579,1062,513,549,53,23,30
154378,30,1545,630,915,1116,491,625,429,139,290
154396,30,787,305,482,594,269,325,193,36,157
154448,30,146,10,136,146,10,136,,,
154457,30,13,0,13,13,0,13,,,
154466,30,30,2,28,30,2,28,,,
154493,30,2203,924,1279,1245,532,713,958,392,566
154518,30,2231,1411,820,1571,939,632,660,472,188
154527,30,1402,695,707,1361,668,693,41,27,14
154545,30,94,67,27,94,67,27,,,
154572,30,2441,911,1530,1403,664,739,1038,247,791
154590,30,1362,676,686,1286,653,633,76,23,53
154642,30,1097,457,640,666,335,331,431,122,309
154688,30,1115,516,599,944,450,494,171,66,105
154697,30,2123,901,1222,1071,474,597,1052,427,625
154712,30,2155,1067,1088,2134,1056,1078,21,11,10
154721,30,684,412,272,678,407,271,6,5,1
154749,30,497,260,237,486,258,228,11,2,9
154800,30,5803,2199,3604,2712,1114,1598,3091,1085,2006
154855,30,464,232,232,436,221,215,28,11,17
154907,30,858,336,522,562,260,302,296,76,220
154925,30,909,546,363,820,508,312,89,38,51
154934,30,870,262,608,554,222,332,316,40,276
154952,30,1640,670,970,1079,498,581,561,172,389
154998,30,1285,660,625,752,424,328,533,236,297
155007,30,354,92,262,165,57,108,189,35,154
155025,30,2663,977,1686,2518,927,1591,145,50,95
155052,30,348,175,173,248,120,128,100,55,45
155061,30,10066,3955,6111,4846,1964,2882,5220,1991,3229
155070,30,152,73,79,117,53,64,35,20,15
155089,30,993,494,499,896,456,440,97,38,59
155098,30,831,394,437,633,312,321,198,82,116
155104,30,1376,639,737,1039,523,516,337,116,221
155140,30,727,280,447,652,258,394,75,22,53
155159,30,72,0,72,72,0,72,,,
155177,30,323,147,176,302,142,160,21,5,16
155186,30,1353,605,748,778,384,394,575,221,354
155195,30,3033,1202,1831,1638,741,897,1395,461,934
155201,30,510,287,223,415,247,168,95,40,55
155210,30,10296,4706,5590,4292,2056,2236,6004,2650,3354
155283,30,577,65,512,528,61,467,49,4,45
155292,30,3133,1280,1853,1410,648,762,1723,632,1091
155308,30,188,137,51,168,119,49,20,18,2
155317,30,18539,8609,9930,16729,7796,8933,1810,813,997
155335,30,883,324,559,837,303,534,46,21,25
155353,30,76,67,9,76,67,9,,,
155399,30,14762,7367,7395,13419,6790,6629,1343,577,766
155414,30,787,445,342,752,420,332,35,25,10
155423,30,1157,722,435,871,591,280,286,131,155
155450,30,1409,531,878,502,194,308,907,337,570
155487,30,322,175,147,237,142,95,85,33,52
155496,30,121,62,59,100,52,48,21,10,11
155511,30,812,552,260,802,545,257,10,7,3
155520,30,975,447,528,916,434,482,59,13,46
155566,30,776,284,492,518,230,288,258,54,204
155593,30,471,309,162,397,291,106,74,18,56
155618,30,304,228,76,299,227,72,5,1,4
155627,30,851,540,311,775,487,288,76,53,23
155636,30,272,63,209,83,19,64,189,44,145
155681,30,4221,2145,2076,3978,2015,1963,243,130,113
155715,30,604,406,198,519,357,162,85,49,36
155812,30,798,428,370,751,406,345,47,22,25
155830,30,270,121,149,200,106,94,70,15,55
155858,30,952,345,607,599,248,351,353,97,256
155900,30,1050,698,352,629,394,235,421,304,117
155937,30,566,358,208,500,324,176,66,34,32
155973,30,507,318,189,501,313,188,6,5,1
156082,30,3872,1400,2472,3147,1143,2004,725,257,468
156107,30,2396,1269,1127,1254,822,432,1142,447,695
156125,30,10304,4568,5736,8271,3661,4610,2033,907,1126
156134,30,907,536,371,907,536,371,,,
156189,30,538,285,253,531,281,250,7,4,3
156213,30,1256,510,746,1071,445,626,185,65,120
156231,30,1611,638,973,1053,476,577,558,162,396
156286,30,2275,871,1404,2209,840,1369,66,31,35
156295,30,1412,569,843,1406,567,839,6,2,4
156310,30,279,4,275,248,4,244,31,0,31
156338,30,2788,1091,1697,1390,577,813,1398,514,884
156356,30,551,212,339,478,198,280,73,14,59
156365,30,2749,1125,1624,2440,1049,1391,309,76,233
156392,30,7429,3008,4421,3524,1564,1960,3905,1444,2461
156408,30,1347,651,696,1343,647,696,4,4,0
156417,30,102,85,17,72,62,10,30,23,7
156426,30,172,12,160,112,8,104,60,4,56
156471,30,3999,314,3685,1733,137,1596,2266,177,2089
156541,30,4609,1524,3085,3854,1298,2556,755,226,529
156620,30,11215,4573,6642,9510,3784,5726,1705,789,916
156648,30,3677,1474,2203,1752,727,1025,1925,747,1178
156745,30,1204,561,643,1199,559,640,5,2,3
156754,30,44,1,43,44,1,43,,,
156790,30,1379,498,881,743,304,439,636,194,442
156842,30,193,5,188,136,4,132,57,1,56
156851,30,850,188,662,336,91,245,514,97,417
156860,30,1480,487,993,671,232,439,809,255,554
156921,30,7047,2994,4053,2699,1284,1415,4348,1710,2638
156967,30,96,2,94,96,2,94,,,
157021,30,228,12,216,84,4,80,144,8,136
157030,30,71,46,25,49,32,17,22,14,8
157058,30,1343,532,811,1202,467,735,141,65,76
157076,30,760,382,378,740,371,369,20,11,9
157085,30,22115,9330,12785,20744,8721,12023,1371,609,762
157100,30,448,307,141,428,295,133,20,12,8
157216,30,1608,721,887,1529,697,832,79,24,55
157289,30,13822,6152,7670,11266,4963,6303,2556,1189,1367
157304,30,1792,567,1225,831,272,559,961,295,666
157331,30,1929,632,1297,918,389,529,1011,243,768
157377,30,1187,448,739,1024,420,604,163,28,135
157386,30,4864,1884,2980,4331,1692,2639,533,192,341
157401,30,6588,2546,4042,5798,2233,3565,790,313,477
157438,30,2677,1189,1488,1028,518,510,1649,671,978
157447,30,8677,3566,5111,7120,2958,4162,1557,608,949
157483,30,2895,970,1925,1591,611,980,1304,359,945
157535,30,1109,498,611,1078,486,592,31,12,19
157553,30,1639,652,987,1096,488,608,543,164,379
157614,30,89,2,87,61,2,59,28,0,28
157650,30,106,3,103,75,3,72,31,0,31
157669,30,78,2,76,78,2,76,,,
157678,30,95,0,95,95,0,95,,,
157711,30,3494,1263,2231,1976,844,1132,1518,419,1099
157739,30,1484,469,1015,867,300,567,617,169,448
157748,30,874,486,388,659,348,311,215,138,77
157757,30,635,213,422,550,195,355,85,18,67
157793,30,1827,597,1230,1187,384,803,640,213,427
157809,30,1420,724,696,1283,680,603,137,44,93
157818,30,976,428,548,954,415,539,22,13,9
157863,30,711,427,284,682,413,269,29,14,15
157951,30,12149,4660,7489,10955,4199,6756,1194,461,733
158088,30,902,368,534,690,289,401,212,79,133
158246,30,128,39,89,128,39,89,,,
158325,30,110,14,96,110,14,96,,,
158431,30,5517,1732,3785,2740,962,1778,2777,770,2007
158477,30,511,232,279,506,229,277,5,3,2
158538,30,59,0,59,59,0,59,,,
158617,30,636,186,450,636,186,450,,,
158662,30,11286,3215,8071,3861,1263,2598,7425,1952,5473
158778,30,64,0,64,64,0,64,,,
158787,30,61,0,61,61,0,61,,,
158802,30,1220,298,922,1162,289,873,58,9,49
158884,30,1381,454,927,588,239,349,793,215,578
159009,30,4163,1508,2655,3688,1359,2329,475,149,326
159027,30,43,0,43,43,0,43,,,
159197,30,505,426,79,505,426,79,,,
159328,30,98,1,97,98,1,97,,,
159373,30,880,119,761,783,111,672,97,8,89
159382,30,3600,1014,2586,2247,669,1578,1353,345,1008
159391,30,27729,12525,15204,26396,11846,14550,1333,679,654
159407,30,2535,609,1926,1520,431,1089,1015,178,837
159416,30,2137,851,1286,1609,653,956,528,198,330
159513,30,183,6,177,183,6,177,,,
159522,30,170,4,166,170,4,166,,,
159531,30,27,0,27,27,0,27,,,
159568,30,767,418,349,743,409,334,24,9,15
159601,30,30,0,30,30,0,30,,,
159647,30,7434,4210,3224,6949,3984,2965,485,226,259
159656,30,3160,1057,2103,2953,991,1962,207,66,141
159717,30,4928,1933,2995,4370,1743,2627,558,190,368
159939,30,4925,2443,2482,3975,1974,2001,950,469,481
159948,30,801,483,318,286,193,93,515,290,225
159966,30,4808,1747,3061,4234,1553,2681,574,194,380
159993,30,5032,1721,3311,4027,1475,2552,1005,246,759
160010,30,791,488,303,265,213,52,526,275,251
160038,30,6243,1757,4486,4569,1447,3122,1674,310,1364
160065,30,453,74,379,300,59,241,153,15,138
160074,30,844,132,712,479,71,408,365,61,304
160117,30,182,1,181,182,1,181,,,
160126,30,37,1,36,15,0,15,22,1,21
160199,30,41,1,40,41,1,40,,,
160320,30,2499,84,2415,2499,84,2415,,,
160409,30,106,106,0,105,105,0,1,1,0
160472,30,106,9,97,63,7,56,43,2,41
160481,30,1788,517,1271,978,317,661,810,200,610
160524,30,270,74,196,270,74,196,,,
160579,30,2796,1318,1478,1594,811,783,1202,507,695
160597,30,161,48,113,81,24,57,80,24,56
160612,30,9567,3584,5983,7707,2911,4796,1860,673,1187
160621,30,5800,1883,3917,5075,1679,3396,725,204,521
160630,30,1144,259,885,885,212,673,259,47,212
160649,30,2069,546,1523,1401,440,961,668,106,562
160658,30,11932,4998,6934,10546,4469,6077,1386,529,857
160667,30,1781,920,861,1239,661,578,542,259,283
160755,30,8490,3262,5228,8081,3104,4977,409,158,251
160904,30,2681,596,2085,2603,578,2025,78,18,60
160959,30,372,120,252,358,114,244,14,6,8
160977,30,1790,846,944,1790,846,944,,,
160995,30,395,83,312,395,83,312,,,
161004,30,1909,924,985,1909,924,985,,,
161022,30,237,19,218,106,7,99,131,12,119
161077,30,2249,929,1320,1205,604,601,1044,325,719
161086,30,2299,1094,1205,2299,1094,1205,,,
161138,30,1479,714,765,899,466,433,580,248,332
161192,30,1311,414,897,496,188,308,815,226,589
161208,30,46,43,3,46,43,3,,,
161217,30,2870,855,2015,1273,377,896,1597,478,1119
161226,30,1217,424,793,1129,398,731,88,26,62
161235,30,650,171,479,336,112,224,314,59,255
161253,30,8720,4521,4199,7601,3885,3716,1119,636,483
161299,30,874,704,170,854,685,169,20,19,1
161341,30,1100,392,708,701,269,432,399,123,276
161457,30,2272,734,1538,2248,726,1522,24,8,16
161484,30,522,239,283,315,181,134,207,58,149
161493,30,155,4,151,123,2,121,32,2,30
161509,30,380,87,293,370,84,286,10,3,7
161518,30,963,361,602,689,273,416,274,88,186
161527,30,248,23,225,171,8,163,77,15,62
161545,30,4527,1989,2538,2277,1127,1150,2250,862,1388
161554,30,4322,1718,2604,3418,1331,2087,904,387,517
161563,30,673,323,350,654,313,341,19,10,9
161572,30,3679,780,2899,3671,780,2891,8,0,8
161581,30,273,111,162,165,90,75,108,21,87
161688,30,1764,475,1289,797,307,490,967,168,799
161767,30,8326,3304,5022,2766,1357,1409,5560,1947,3613
161800,30,147,39,108,44,16,28,103,23,80
161855,30,43,1,42,20,0,20,23,1,22
161864,30,2594,639,1955,669,207,462,1925,432,1493
161873,30,1351,537,814,755,293,462,596,244,352
162007,30,5289,2027,3262,4412,1685,2727,877,342,535
162061,30,296,235,61,233,182,51,63,53,10
162104,30,1315,479,836,485,218,267,830,261,569
162122,30,4378,1675,2703,1690,732,958,2688,943,1745
162168,30,1273,421,852,413,178,235,860,243,617
162210,30,499,170,329,422,152,270,77,18,59
162283,30,1708,386,1322,1335,326,1009,373,60,313
162335,30,54,0,54,54,0,54,,,
162371,30,612,552,60,612,552,60,,,
162557,30,3653,1609,2044,1551,821,730,2102,788,1314
162584,30,2873,1339,1534,2396,1230,1166,477,109,368
162609,30,367,185,182,300,154,146,67,31,36
162654,30,981,322,659,956,315,641,25,7,18
162690,30,2695,894,1801,1035,452,583,1660,442,1218
162706,30,3620,1470,2150,1558,747,811,2062,723,1339
162760,30,1182,443,739,1149,432,717,33,11,22
162779,30,6905,2879,4026,2204,1094,1110,4701,1785,2916
162830,30,94,4,90,94,4,90,,,
162928,30,5643,2602,3041,5633,2594,3039,10,8,2
163028,30,947,851,96,708,636,72,239,215,24
163046,30,3968,1780,2188,3945,1768,2177,23,12,11
163204,30,44458,24754,19704,10022,5176,4846,34436,19578,14858
163259,30,956,165,791,731,130,601,225,35,190
163268,30,10557,5660,4897,9069,4863,4206,1488,797,691
163286,30,29982,15205,14777,27912,14029,13883,2070,1176,894
163295,30,1401,330,1071,1336,311,1025,65,19,46
163338,30,1877,865,1012,1749,802,947,128,63,65
163347,30,382,23,359,382,23,359,,,
163408,30,83,13,70,47,5,42,36,8,28
163426,30,13357,6603,6754,4657,2464,2193,8700,4139,4561
163453,30,7599,2876,4723,7006,2608,4398,593,268,325
163462,30,1824,861,963,1741,825,916,83,36,47
163532,30,246,246,0,246,246,0,,,
163541,30,265,116,149,133,64,69,132,52,80
163578,30,634,20,614,494,16,478,140,4,136
163657,30,8618,3146,5472,2881,1189,1692,5737,1957,3780
163815,30,41,1,40,15,1,14,26,0,26
163851,30,6145,2780,3365,5846,2626,3220,299,154,145
163912,30,1476,611,865,1451,599,852,25,12,13
163976,30,462,233,229,460,233,227,2,0,2
164076,30,16734,6928,9806,14769,6047,8722,1965,881,1084
164155,30,4450,3184,1266,4450,3184,1266,,,
164173,30,2979,1131,1848,2672,1058,1614,307,73,234
164216,30,935,392,543,928,389,539,7,3,4
164270,30,1748,719,1029,1733,710,1023,15,9,6
164313,30,1886,562,1324,402,179,223,1484,383,1101
164368,30,682,418,264,682,418,264,,,
164447,30,1142,526,616,1097,513,584,45,13,32
164465,30,1898,917,981,1898,917,981,,,
164492,30,991,582,409,826,444,382,165,138,27
164535,30,54,12,42,54,12,42,,,
164562,30,1676,765,911,1665,760,905,11,5,6
164580,30,2709,1578,1131,2702,1575,1127,7,3,4
164599,30,26,4,22,,,,26,4,22
164614,30,39,25,14,30,19,11,9,6,3
164632,30,1263,0,1263,814,0,814,449,0,449
164641,30,223,64,159,120,45,75,103,19,84
164739,30,4070,2487,1583,4015,2450,1565,55,37,18
164748,30,7395,4221,3174,5935,3248,2687,1460,973,487
164775,30,1092,363,729,339,144,195,753,219,534
164845,30,66,1,65,57,1,56,9,0,9
164872,30,259,113,146,204,98,106,55,15,40
164924,30,9751,4603,5148,9593,4508,5085,158,95,63
164988,30,17668,7369,10299,17415,7245,10170,253,124,129
165015,30,3675,1570,2105,3671,1568,2103,4,2,2
165024,30,7911,3311,4600,6501,2726,3775,1410,585,825
165033,30,4920,1625,3295,2008,782,1226,2912,843,2069
165060,30,150,14,136,91,9,82,59,5,54
165112,30,7260,3013,4247,2287,1082,1205,4973,1931,3042
165167,30,656,123,533,107,31,76,549,92,457
165194,30,1998,729,1269,608,270,338,1390,459,931
165255,30,186,2,184,89,0,89,97,2,95
165264,30,962,75,887,93,7,86,869,68,801
165334,30,2363,979,1384,2350,974,1376,13,5,8
165529,30,1804,749,1055,1660,711,949,144,38,106
165556,30,399,42,357,341,32,309,58,10,48
165574,30,1180,593,587,1103,557,546,77,36,41
165608,30,44,4,40,32,4,28,12,0,12
165635,30,202,187,15,202,187,15,,,
165644,30,408,232,176,381,222,159,27,10,17
165662,30,4147,1443,2704,4100,1424,2676,47,19,28
165671,30,1855,425,1430,1800,415,1385,55,10,45
165699,30,2999,1090,1909,2896,1054,1842,103,36,67
165750,30,32,11,21,21,11,10,11,0,11
165802,30,1131,427,704,624,330,294,507,97,410
165820,30,2911,1316,1595,2281,1104,1177,630,212,418
165866,30,2712,1243,1469,2469,1134,1335,243,109,134
165884,30,438,374,64,279,236,43,159,138,21
165936,30,1255,505,750,1221,486,735,34,19,15
165981,30,1073,374,699,331,120,211,742,254,488
166018,30,505,189,316,505,189,316,,,
166027,30,7973,3811,4162,7403,3555,3848,570,256,314
166054,30,31,25,6,31,25,6,,,
166124,30,3062,1375,1687,3062,1375,1687,,,
166133,30,3007,1033,1974,1144,472,672,1863,561,1302
166391,30,1236,434,802,1192,416,776,44,18,26
166407,30,225,13,212,13,0,13,212,13,199
166452,30,1406,365,1041,956,244,712,450,121,329
166489,30,40,19,21,31,17,14,9,2,7
166498,30,65,2,63,29,0,29,36,2,34
166513,30,11985,6991,4994,9623,5667,3956,2362,1324,1038
166629,30,24111,11727,12384,22829,11152,11677,1282,575,707
166638,30,11749,5021,6728,9664,4085,5579,2085,936,1149
166647,30,2738,1260,1478,1024,546,478,1714,714,1000
166656,30,3488,822,2666,3276,771,2505,212,51,161
166674,30,1753,448,1305,1577,394,1183,176,54,122
166683,30,4638,2401,2237,4582,2366,2216,56,35,21
166692,30,1323,1144,179,1293,1116,177,30,28,2
166717,30,40,11,29,19,6,13,21,5,16
166805,30,54,37,17,24,19,5,30,18,12
166823,30,3635,1424,2211,1461,693,768,2174,731,1443
166850,30,4065,1871,2194,3985,1842,2143,80,29,51
166869,30,140,22,118,140,22,118,,,
166887,30,4558,1731,2827,1464,666,798,3094,1065,2029
166911,30,291,68,223,283,65,218,8,3,5
166939,30,2183,0,2183,2167,0,2167,16,0,16
166957,30,2342,754,1588,689,286,403,1653,468,1185
167039,30,6,0,6,6,0,6,,,
167057,30,363,197,166,353,190,163,10,7,3
167260,30,1164,754,410,1054,707,347,110,47,63
167288,30,760,328,432,679,304,375,81,24,57
167297,30,152,92,60,152,92,60,,,
167312,30,3615,1290,2325,1187,527,660,2428,763,1665
167358,30,16172,7100,9072,16172,7100,9072,,,
167376,30,3290,1226,2064,1029,499,530,2261,727,1534
167394,30,915,238,677,797,217,580,118,21,97
167525,30,2098,834,1264,786,363,423,1312,471,841
167534,30,5264,1994,3270,1859,838,1021,3405,1156,2249
167598,30,1095,225,870,921,197,724,174,28,146
167631,30,1148,365,783,325,135,190,823,230,593
167677,30,17,17,0,15,15,0,2,2,0
167729,30,4592,1561,3031,3889,1312,2577,703,249,454
167783,30,1786,0,1786,1600,0,1600,186,0,186
167792,30,263,100,163,258,97,161,5,3,2
167835,30,2515,1,2514,2510,1,2509,5,0,5
167871,30,127,28,99,72,8,64,55,20,35
167899,30,2002,1004,998,1982,987,995,20,17,3
167905,30,3678,1473,2205,1408,675,733,2270,798,1472
167987,30,5331,2586,2745,4699,2324,2375,632,262,370
167996,30,2466,1107,1359,2438,1091,1347,28,16,12
168005,30,4325,1636,2689,4186,1563,2623,139,73,66
168032,30,5,0,5,5,0,5,,,
168148,30,6747,2976,3771,6613,2909,3704,134,67,67
168218,30,2353,0,2353,2349,0,2349,4,0,4
168227,30,3557,2761,796,3379,2607,772,178,154,24
168254,30,2402,1396,1006,2324,1348,976,78,48,30
168263,30,3693,1659,2034,3254,1431,1823,439,228,211
168281,30,1653,608,1045,1651,606,1045,2,2,0
168342,30,2138,1012,1126,2138,1012,1126,,,
168421,30,5146,3240,1906,5058,3176,1882,88,64,24
168430,30,4025,1553,2472,3387,1294,2093,638,259,379
168528,30,1688,913,775,1673,903,770,15,10,5
168546,30,1445,689,756,1441,687,754,4,2,2
168555,30,31,1,30,25,1,24,6,0,6
168573,30,731,713,18,731,713,18,,,
168591,30,1222,572,650,1212,564,648,10,8,2
168607,30,726,380,346,403,248,155,323,132,191
168740,30,1249,629,620,1082,540,542,167,89,78
168786,30,1107,482,625,1033,457,576,74,25,49
168847,30,3230,790,2440,1378,354,1024,1852,436,1416
168883,30,1136,396,740,493,210,283,643,186,457
168892,30,116,4,112,62,3,59,54,1,53
169080,30,2833,1384,1449,2636,1243,1393,197,141,56
169187,30,104,20,84,25,10,15,79,10,69
169248,30,10297,3997,6300,8925,3549,5376,1372,448,924
169275,30,4690,1612,3078,1439,553,886,3251,1059,2192
169284,30,263,18,245,196,6,190,67,12,55
169327,30,716,455,261,553,365,188,163,90,73
169363,30,843,442,401,812,431,381,31,11,20
169442,30,1317,455,862,1129,382,747,188,73,115
169479,30,3412,1505,1907,1995,1043,952,1417,462,955
169503,30,277,3,274,277,3,274,,,
169521,30,5624,2146,3478,1870,773,1097,3754,1373,2381
169576,30,108,2,106,108,2,106,,,
169655,30,1303,1217,86,1303,1217,86,,,
169716,30,2322,810,1512,2140,751,1389,182,59,123
169761,30,480,91,389,480,91,389,,,
169798,30,11206,4471,6735,8165,3208,4957,3041,1263,1778
169813,30,58,1,57,58,1,57,,,
169910,30,8390,3960,4430,6552,3097,3455,1838,863,975
169974,30,565,220,345,296,118,178,269,102,167
169983,30,1401,1111,290,1356,1076,280,45,35,10
169992,30,536,194,342,310,135,175,226,59,167
170000,30,817,336,481,591,257,334,226,79,147
170037,30,1383,523,860,1120,440,680,263,83,180
170055,30,10272,4481,5791,3284,1585,1699,6988,2896,4092
170082,30,18487,7397,11090,16463,6459,10004,2024,938,1086
170091,30,132,75,57,126,72,54,6,3,3
170240,30,8779,3773,5006,3479,1541,1938,5300,2232,3068
170286,30,1562,781,781,1538,771,767,24,10,14
170301,30,3173,1226,1947,3123,1202,1921,50,24,26
170444,30,2953,1031,1922,801,296,505,2152,735,1417
170532,30,1192,521,671,1174,512,662,18,9,9
170541,30,4947,2193,2754,1470,633,837,3477,1560,1917
170550,30,2502,705,1797,679,261,418,1823,444,1379
170587,30,912,286,626,436,161,275,476,125,351
170611,30,107,3,104,99,3,96,8,0,8
170620,30,2091,759,1332,709,277,432,1382,482,900
170639,30,1468,668,800,1288,602,686,180,66,114
170657,30,8210,3650,4560,2705,1258,1447,5505,2392,3113
170675,30,1864,1326,538,1692,1204,488,172,122,50
170736,30,52,1,51,23,0,23,29,1,28
170790,30,14356,6185,8171,4310,1982,2328,10046,4203,5843
170806,30,1693,595,1098,1335,489,846,358,106,252
170967,30,848,329,519,712,296,416,136,33,103
170976,30,32448,15450,16998,31148,14705,16443,1300,745,555
171012,30,134,106,28,134,106,28,,,
171100,30,39021,18869,20152,35872,17203,18669,3149,1666,1483
171128,30,5633,3972,1661,5403,3809,1594,230,163,67
171137,30,5962,3171,2791,4656,2448,2208,1306,723,583
171146,30,4029,1448,2581,2744,1051,1693,1285,397,888
171155,30,2108,774,1334,942,417,525,1166,357,809
171225,30,1668,638,1030,526,215,311,1142,423,719
171234,30,1031,364,667,286,101,185,745,263,482
171304,30,2701,1051,1650,978,427,551,1723,624,1099
171395,30,988,340,648,552,211,341,436,129,307
171456,30,6322,2598,3724,5597,2310,3287,725,288,437
171483,30,2689,1262,1427,1100,545,555,1589,717,872
171492,30,1911,1187,724,1273,812,461,638,375,263
171535,30,11503,5093,6410,3122,1585,1537,8381,3508,4873
171571,30,12626,5384,7242,10221,4217,6004,2405,1167,1238
171599,30,859,537,322,841,523,318,18,14,4
171775,30,46,0,46,37,0,37,9,0,9
171881,30,78,32,46,67,28,39,11,4,7
171988,30,82,5,77,82,5,77,,,
171997,30,130,5,125,130,5,125,,,
172015,30,76,1,75,76,1,75,,,
172033,30,140,71,69,33,32,1,107,39,68
172051,30,6211,2255,3956,5369,1912,3457,842,343,499
172200,30,6635,2844,3791,1805,937,868,4830,1907,2923
172264,30,1554,700,854,1095,531,564,459,169,290
172291,30,2131,747,1384,961,330,631,1170,417,753
172307,30,1297,512,785,760,344,416,537,168,369
172334,30,1021,353,668,867,318,549,154,35,119
172422,30,109,84,25,109,84,25,,,
172440,30,386,217,169,368,213,155,18,4,14
172495,30,248,7,241,178,7,171,70,0,70
172608,30,569,292,277,70,42,28,499,250,249
172617,30,7950,3476,4474,2263,1114,1149,5687,2362,3325
172635,30,8875,2738,6137,1264,514,750,7611,2224,5387
172644,30,15669,6387,9282,12088,4823,7265,3581,1564,2017
172671,30,663,235,428,198,85,113,465,150,315
172680,30,110,5,105,63,4,59,47,1,46
172699,30,13264,6624,6640,11374,5623,5751,1890,1001,889
172866,30,103,96,7,103,96,7,,,
172918,30,1421,777,644,958,577,381,463,200,263
172954,30,1404,666,738,705,425,280,699,241,458
172963,30,4017,1543,2474,1756,777,979,2261,766,1495
173045,30,2334,1022,1312,2200,972,1228,134,50,84
173063,30,1950,936,1014,866,467,399,1084,469,615
173115,30,554,184,370,263,146,117,291,38,253
173124,30,3187,1361,1826,2295,1049,1246,892,312,580
173142,30,641,317,324,628,310,318,13,7,6
173160,30,2090,833,1257,1806,720,1086,284,113,171
173203,30,1548,709,839,908,523,385,640,186,454
173258,30,2007,996,1011,2007,996,1011,,,
173300,30,1800,842,958,1766,821,945,34,21,13
173328,30,2760,935,1825,1988,702,1286,772,233,539
173416,30,2089,1198,891,1291,836,455,798,362,436
173452,30,697,341,356,611,309,302,86,32,54
173461,30,2465,1114,1351,1214,651,563,1251,463,788
173559,30,2950,1220,1730,1624,846,778,1326,374,952
173638,30,1701,997,704,754,434,320,947,563,384
173647,30,2069,922,1147,2028,899,1129,41,23,18
173665,30,1745,648,1097,1697,625,1072,48,23,25
173708,30,2774,1788,986,1189,848,341,1585,940,645
173735,30,2032,1088,944,1534,955,579,498,133,365
173744,30,508,25,483,508,25,483,,,
173799,30,2107,840,1267,896,392,504,1211,448,763
173902,30,2164,916,1248,2136,897,1239,28,19,9
173911,30,1937,838,1099,945,525,420,992,313,679
173920,30,11354,5259,6095,9765,4653,5112,1589,606,983
173957,30,216,51,165,216,51,165,,,
174020,30,5152,2145,3007,2450,1084,1366,2702,1061,1641
174066,30,30560,14020,16540,28458,12956,15502,2102,1064,1038
174075,30,1489,604,885,979,388,591,510,216,294
174127,30,689,225,464,684,223,461,5,2,3
174136,30,4615,2013,2602,1652,827,825,2963,1186,1777
174154,30,808,90,718,402,45,357,406,45,361
174190,30,150,3,147,116,2,114,34,1,33
174233,30,7754,3998,3756,7309,3747,3562,445,251,194
174251,30,1024,454,570,970,431,539,54,23,31
174321,30,115,4,111,113,4,109,2,0,2
174358,30,3462,1302,2160,2883,1077,1806,579,225,354
174376,30,3252,1308,1944,1117,503,614,2135,805,1330
174428,30,5970,2653,3317,2532,1243,1289,3438,1410,2028
174437,30,827,384,443,751,349,402,76,35,41
174473,30,1512,636,876,798,355,443,714,281,433
174491,30,1512,637,875,1372,579,793,140,58,82
174507,30,227,61,166,62,21,41,165,40,125
174525,30,91,52,39,75,43,32,16,9,7
174570,30,596,232,364,368,173,195,228,59,169
174738,30,3140,1177,1963,1410,681,729,1730,496,1234
174747,30,1428,0,1428,1420,0,1420,8,0,8
174756,30,2825,1116,1709,1415,644,771,1410,472,938
174783,30,5395,2607,2788,4280,2056,2224,1115,551,564
174792,30,1501,1501,0,1477,1477,0,24,24,0
174817,30,1080,465,615,858,387,471,222,78,144
174844,30,3019,1267,1752,3011,1263,1748,8,4,4
174862,30,757,378,379,586,298,288,171,80,91
174899,30,1923,614,1309,1673,560,1113,250,54,196
174914,30,5868,3028,2840,5707,2931,2776,161,97,64
174978,30,142,3,139,106,2,104,36,1,35
175005,30,2349,107,2242,1624,30,1594,725,77,648
175014,30,2635,442,2193,1372,242,1130,1263,200,1063
175041,30,3827,1679,2148,1721,900,821,2106,779,1327
175078,30,1956,668,1288,1389,538,851,567,130,437
175120,30,440,302,138,440,302,138,,,
175227,30,1351,1096,255,1127,923,204,224,173,51
175236,30,2175,842,1333,1320,594,726,855,248,607
175263,30,1106,499,607,593,323,270,513,176,337
175272,30,5254,1686,3568,4590,1459,3131,664,227,437
175315,30,5873,2465,3408,2570,1170,1400,3303,1295,2008
175342,30,2344,782,1562,2017,690,1327,327,92,235
175421,30,1414,525,889,1068,442,626,346,83,263
175430,30,540,266,274,519,258,261,21,8,13
175494,30,122,38,84,122,38,84,,,
175519,30,1349,502,847,1111,435,676,238,67,171
175573,30,1973,820,1153,1705,726,979,268,94,174
175616,30,1627,682,945,1413,595,818,214,87,127
175643,30,1638,641,997,1408,576,832,230,65,165
175652,30,2596,1140,1456,2078,972,1106,518,168,350
175698,30,36,29,7,26,22,4,10,7,3
175722,30,24,0,24,24,0,24,,,
175786,30,6514,2454,4060,4630,1898,2732,1884,556,1328
175810,30,3901,1270,2631,2996,1054,1942,905,216,689
175829,30,3730,1466,2264,2860,1188,1672,870,278,592
175856,30,4905,1790,3115,4311,1598,2713,594,192,402
175883,30,3474,1277,2197,2731,1062,1669,743,215,528
175935,30,2143,656,1487,1729,569,1160,414,87,327
175980,30,622,340,282,619,339,280,3,1,2
176008,30,1692,608,1084,1349,508,841,343,100,243
176017,30,17157,7353,9804,16149,6836,9313,1008,517,491
176035,30,1701,322,1379,1525,286,1239,176,36,140
176044,30,1169,534,635,1037,471,566,132,63,69
176053,30,2098,866,1232,1950,813,1137,148,53,95
176062,30,55,0,55,55,0,55,,,
176071,30,6284,2412,3872,4431,1841,2590,1853,571,1282
176080,30,18154,8987,9167,16581,8140,8441,1573,847,726
176169,30,2566,975,1591,2349,905,1444,217,70,147
176178,30,5156,1913,3243,4258,1639,2619,898,274,624
176239,30,4579,1568,3011,3774,1368,2406,805,200,605
176318,30,731,303,428,587,234,353,144,69,75
176336,30,96,75,21,91,71,20,5,4,1
176354,30,1628,667,961,1380,579,801,248,88,160
176372,30,10149,3585,6564,8618,2934,5684,1531,651,880
176406,30,541,213,328,520,205,315,21,8,13
176433,30,56,2,54,42,2,40,14,0,14
176451,30,19,12,7,4,2,2,15,10,5
176479,30,1772,533,1239,1561,492,1069,211,41,170
176628,30,937,381,556,872,366,506,65,15,50
176664,30,274,166,108,234,146,88,40,20,20
176716,30,136,1,135,136,1,135,,,
176770,30,677,87,590,349,51,298,328,36,292
176789,30,202,88,114,127,56,71,75,32,43
176798,30,216,50,166,126,22,104,90,28,62
176910,30,152,92,60,94,54,40,58,38,20
176947,30,1074,519,555,1065,515,550,9,4,5
176965,30,5920,2755,3165,5161,2389,2772,759,366,393
176983,30,76,57,19,65,51,14,11,6,5
177038,30,90,29,61,66,21,45,24,8,16
177065,30,5486,2209,3277,2336,887,1449,3150,1322,1828
177083,30,25,25,0,25,25,0,,,
177117,30,311,0,311,309,0,309,2,0,2
177135,30,2705,1018,1687,1743,738,1005,962,280,682
177144,30,854,478,376,844,474,370,10,4,6
177214,30,1369,626,743,1350,616,734,19,10,9
177250,30,1750,666,1084,1081,468,613,669,198,471
177302,30,344,322,22,344,322,22,,,
177339,30,1246,592,654,1246,592,654,,,
177418,30,668,319,349,612,304,308,56,15,41
177436,30,26,1,25,26,1,25,,,
177472,30,7937,3314,4623,4522,1929,2593,3415,1385,2030
177542,30,397,206,191,316,144,172,81,62,19
177551,30,1078,324,754,945,285,660,133,39,94
177588,30,66,3,63,66,3,63,,,
177603,30,124,3,121,114,3,111,10,0,10
177676,30,2486,965,1521,1590,701,889,896,264,632
177685,30,143,13,130,143,13,130,,,
177719,30,415,50,365,357,46,311,58,4,54
177746,30,735,165,570,727,162,565,8,3,5
177931,30,29,2,27,29,2,27,,,
177940,30,1323,529,794,1176,489,687,147,40,107
177968,30,4627,2016,2611,4010,1756,2254,617,260,357
177977,30,1958,1656,302,1837,1561,276,121,95,26
177986,30,288,87,201,131,44,87,157,43,114
177995,30,10586,4218,6368,5120,2277,2843,5466,1941,3525
178059,30,5781,1854,3927,3324,1186,2138,2457,668,1789
178077,30,89,2,87,89,2,87,,,
178183,30,204,21,183,204,21,183,,,
178208,30,879,581,298,412,291,121,467,290,177
178217,30,1489,517,972,1131,413,718,358,104,254
178244,30,1508,678,830,1326,620,706,182,58,124
178341,30,3245,1257,1988,2506,978,1528,739,279,460
178369,30,1269,767,502,1201,748,453,68,19,49
178387,30,2628,1055,1573,2290,927,1363,338,128,210
178396,30,23206,10548,12658,21953,9963,11990,1253,585,668
178402,30,6479,2590,3889,5547,2143,3404,932,447,485
178411,30,5453,4180,1273,4880,3745,1135,573,435,138
178420,30,5378,2389,2989,3856,1666,2190,1522,723,799
178448,30,3023,1165,1858,1913,768,1145,1110,397,713
178527,30,60,3,57,34,3,31,26,0,26
178615,30,2920,1164,1756,2825,1118,1707,95,46,49
178624,30,4679,1826,2853,4263,1676,2587,416,150,266
178679,30,597,320,277,491,272,219,106,48,58
178697,30,1481,646,835,1468,641,827,13,5,8
178721,30,6061,3331,2730,3009,1434,1575,3052,1897,1155
178767,30,87,14,73,36,7,29,51,7,44
178828,30,34,8,26,34,8,26,,,
178891,30,1671,1524,147,1250,1140,110,421,384,37
178989,30,227,27,200,216,27,189,11,0,11
179043,30,1732,599,1133,1619,586,1033,113,13,100
179159,30,7332,2881,4451,6679,2564,4115,653,317,336
179195,30,34,2,32,34,2,32,,,
179265,30,264,99,165,263,99,164,1,0,1
179308,30,11240,3785,7455,4690,1868,2822,6550,1917,4633
179326,30,1475,548,927,1185,490,695,290,58,232
179344,30,882,265,617,642,205,437,240,60,180
179511,30,91,1,90,52,1,51,39,0,39
179539,30,2462,837,1625,1728,602,1126,734,235,499
179548,30,404,10,394,380,10,370,24,0,24
179557,30,7010,2832,4178,6202,2486,3716,808,346,462
179566,30,13332,5286,8046,11250,4352,6898,2082,934,1148
179645,30,1839,536,1303,1329,417,912,510,119,391
179715,30,1113,274,839,757,220,537,356,54,302
179867,30,7801,3611,4190,7401,3486,3915,400,125,275
179894,30,2174,922,1252,1786,747,1039,388,175,213
179946,30,607,333,274,601,330,271,6,3,3
179955,30,824,423,401,811,413,398,13,10,3
179964,30,754,220,534,645,201,444,109,19,90
179991,30,37,2,35,37,2,35,,,
180054,30,337,72,265,195,40,155,142,32,110
180063,30,37,1,36,37,1,36,,,
180081,30,322,196,126,277,180,97,45,16,29
180090,30,68,2,66,68,2,66,,,
180106,30,1108,445,663,1088,436,652,20,9,11
180151,30,247,114,133,206,104,102,41,10,31
180160,30,217,75,142,89,35,54,128,40,88
180179,30,2742,996,1746,1869,772,1097,873,224,649
180197,30,1090,449,641,551,255,296,539,194,345
180203,30,115,48,67,98,44,54,17,4,13
180212,30,580,170,410,400,124,276,180,46,134
180249,30,764,204,560,427,127,300,337,77,260
180258,30,593,217,376,454,182,272,139,35,104
180276,30,608,243,365,325,162,163,283,81,202
180328,30,295,95,200,194,69,125,101,26,75
180373,30,387,142,245,268,118,150,119,24,95
180416,30,1424,878,546,1330,819,511,94,59,35
180461,30,14343,7666,6677,12465,6650,5815,1878,1016,862
180489,30,6937,2919,4018,5781,2429,3352,1156,490,666
180522,30,816,468,348,683,426,257,133,42,91
180595,30,834,433,401,819,427,392,15,6,9
180647,30,514,141,373,432,123,309,82,18,64
180692,30,1202,395,807,1010,357,653,192,38,154
180814,30,10318,4588,5730,6452,2885,3567,3866,1703,2163
180832,30,631,91,540,237,39,198,394,52,342
180878,30,535,44,491,345,25,320,190,19,171
180902,30,3104,1281,1823,1674,861,813,1430,420,1010
180948,30,1690,619,1071,1473,560,913,217,59,158
180957,30,67,58,9,67,58,9,,,
180984,30,1138,552,586,1122,541,581,16,11,5
181002,30,4261,1773,2488,4172,1736,2436,89,37,52
181020,30,988,535,453,934,512,422,54,23,31
181127,30,918,442,476,911,438,473,7,4,3
181145,30,24,2,22,24,2,22,,,
181190,30,107,4,103,107,4,103,,,
181215,30,4159,1510,2649,3635,1358,2277,524,152,372
181297,30,808,84,724,566,62,504,242,22,220
181303,30,6653,3290,3363,2294,1220,1074,4359,2070,2289
181312,30,947,392,555,619,313,306,328,79,249
181330,30,1204,608,596,1192,605,587,12,3,9
181394,30,11866,5277,6589,9953,4262,5691,1913,1015,898
181419,30,229,66,163,78,24,54,151,42,109
181428,30,861,113,748,719,93,626,142,20,122
181446,30,1530,705,825,1457,681,776,73,24,49
181464,30,19097,9574,9523,18170,9015,9155,927,559,368
181491,30,2530,1210,1320,1922,1034,888,608,176,432
181534,30,1186,508,678,997,444,553,189,64,125
181543,30,18,11,7,12,7,5,6,4,2
181604,30,502,0,502,496,0,496,6,0,6
181640,30,6031,3020,3011,3075,1774,1301,2956,1246,1710
181738,30,475,202,273,460,195,265,15,7,8
181765,30,242,71,171,236,70,166,6,1,5
181783,30,3057,1311,1746,2852,1219,1633,205,92,113
181817,30,913,355,558,574,265,309,339,90,249
181853,30,442,223,219,403,215,188,39,8,31
181880,30,203,5,198,125,4,121,78,1,77
181941,30,292,185,107,292,185,107,,,
182005,30,27254,11321,15933,8922,3826,5096,18332,7495,10837
182148,30,614,125,489,614,125,489,,,
182281,30,24329,10629,13700,19535,8407,11128,4794,2222,2572
182290,30,15896,7483,8413,13747,6459,7288,2149,1024,1125
182306,30,1938,658,1280,726,292,434,1212,366,846
182500,30,6461,2958,3503,2363,1024,1339,4098,1934,2164
182564,30,1907,788,1119,738,335,403,1169,453,716
182634,30,814,237,577,766,228,538,48,9,39
182670,30,4412,2245,2167,4411,2244,2167,1,1,0
182704,30,66,2,64,51,1,50,15,1,14
182722,30,151,12,139,116,12,104,35,0,35
182795,30,1115,506,609,996,454,542,119,52,67
182892,30,64,0,64,38,0,38,26,0,26
182917,30,59,26,33,59,26,33,,,
182980,30,1036,479,557,1003,462,541,33,17,16
182999,30,15,0,15,15,0,15,,,
183026,30,138138,50553,87585,33203,13026,20177,104935,37527,67408
183035,30,37,2,35,37,2,35,,,
183044,30,11396,4966,6430,11183,4842,6341,213,124,89
183062,30,2690,1245,1445,2626,1207,1419,64,38,26
183071,30,507,259,248,424,208,216,83,51,32
183080,30,3286,1676,1610,3182,1614,1568,104,62,42
183099,30,2208,779,1429,891,396,495,1317,383,934
183105,30,424,159,265,160,84,76,264,75,189
183114,30,579,135,444,104,37,67,475,98,377
183123,30,503,270,233,222,156,66,281,114,167
183132,30,1690,807,883,595,382,213,1095,425,670
183141,30,1029,478,551,329,200,129,700,278,422
183150,30,1264,504,760,418,214,204,846,290,556
183202,30,82,2,80,69,1,68,13,1,12
183211,30,1329,327,1002,946,288,658,383,39,344
183239,30,1955,780,1175,1937,768,1169,18,12,6
183248,30,133,15,118,78,9,69,55,6,49
183257,30,1134,335,799,577,164,413,557,171,386
183275,30,89,43,46,89,43,46,,,
183488,30,562,44,518,445,37,408,117,7,110
183600,30,33,0,33,19,0,19,14,0,14
183655,30,3845,1415,2430,1630,683,947,2215,732,1483
183725,30,365,193,172,321,180,141,44,13,31
183743,30,10011,4811,5200,5661,2874,2787,4350,1937,2413
183789,30,1856,436,1420,1197,318,879,659,118,541
183804,30,3334,3334,0,3323,3323,0,11,11,0
183822,30,1149,470,679,1069,438,631,80,32,48
183859,30,7914,3762,4152,4007,2070,1937,3907,1692,2215
183877,30,5828,2283,3545,2906,1278,1628,2922,1005,1917
183910,30,1595,617,978,1534,594,940,61,23,38
183938,30,6378,2394,3984,2902,1249,1653,3476,1145,2331
183974,30,1015,368,647,956,347,609,59,21,38
183983,30,76,73,3,76,73,3,,,
184056,30,548,120,428,405,94,311,143,26,117
184092,30,760,99,661,760,99,661,,,
184180,30,5174,2794,2380,2458,1440,1018,2716,1354,1362
184205,30,1951,647,1304,869,322,547,1082,325,757
184348,30,1419,593,826,1407,588,819,12,5,7
184427,30,339,316,23,236,224,12,103,92,11
184481,30,5730,2248,3482,2700,1102,1598,3030,1146,1884
184506,30,83,8,75,54,4,50,29,4,25
184603,30,2415,1149,1266,1889,902,987,526,247,279
184612,30,1696,470,1226,1570,437,1133,126,33,93
184694,30,2012,917,1095,1932,875,1057,80,42,38
184746,30,82,75,7,74,68,6,8,7,1
184773,30,1166,286,880,1073,263,810,93,23,70
184782,30,14914,7693,7221,13202,6885,6317,1712,808,904
184791,30,4510,1874,2636,2740,1201,1539,1770,673,1097
184816,30,86,2,84,53,1,52,33,1,32
184959,30,717,106,611,322,49,273,395,57,338
184968,30,191,29,162,32,6,26,159,23,136
184995,30,6116,2385,3731,3442,1407,2035,2674,978,1696
185129,30,4677,1959,2718,4107,1729,2378,570,230,340
185174,30,81,64,17,81,64,17,,,
185262,30,10524,4095,6429,8673,3367,5306,1851,728,1123
185396,30,1625,1570,55,1392,1347,45,233,223,10
185466,30,360,7,353,126,1,125,234,6,228
185509,30,4945,2310,2635,1842,992,850,3103,1318,1785
185536,30,7900,3652,4248,3938,1914,2024,3962,1738,2224
185572,30,3799,1401,2398,3659,1333,2326,140,68,72
185590,30,16902,6752,10150,15388,6070,9318,1514,682,832
185679,30,582,88,494,49,5,44,533,83,450
185721,30,415,119,296,263,77,186,152,42,110
185767,30,264,34,230,132,15,117,132,19,113
185828,30,8365,6160,2205,7382,5393,1989,983,767,216
185873,30,5503,2453,3050,2897,1446,1451,2606,1007,1599
185970,30,135,11,124,104,9,95,31,2,29
186016,30,454,27,427,252,18,234,202,9,193
186034,30,4643,1731,2912,1773,767,1006,2870,964,1906
186052,30,886,740,146,608,518,90,278,222,56
186131,30,5527,2762,2765,5527,2762,2765,,,
186186,30,193,193,0,193,193,0,,,
186201,30,4611,1957,2654,4299,1807,2492,312,150,162
186274,30,207,16,191,119,10,109,88,6,82
186283,30,3105,1335,1770,2952,1283,1669,153,52,101
186371,30,4077,1546,2531,3484,1336,2148,593,210,383
186380,30,36090,18049,18041,34630,17318,17312,1460,731,729
186399,30,7188,3320,3868,6328,2896,3432,860,424,436
186405,30,16,5,11,16,5,11,,,
186423,30,53,8,45,53,8,45,,,
186432,30,1918,745,1173,1794,697,1097,124,48,76
186469,30,867,307,560,479,222,257,388,85,303
186584,30,5874,2625,3249,5734,2551,3183,140,74,66
186593,30,80,26,54,55,25,30,25,1,24
186618,30,672,247,425,590,228,362,82,19,63
186645,30,5052,2664,2388,2452,1337,1115,2600,1327,1273
186867,30,4054,2752,1302,4037,2739,1298,17,13,4
186876,30,8105,3174,4931,7747,3003,4744,358,171,187
186900,30,73,73,0,73,73,0,,,
187000,30,368,347,21,252,235,17,116,112,4
187046,30,7268,4338,2930,76,15,61,7192,4323,2869
187134,30,6840,2924,3916,6666,2830,3836,174,94,80
187198,30,7454,2815,4639,3459,1598,1861,3995,1217,2778
187444,30,6591,2610,3981,5131,2099,3032,1460,511,949
187505,30,688,145,543,688,145,543,,,
187532,30,15556,5822,9734,4156,1798,2358,11400,4024,7376
187596,30,937,351,586,523,240,283,414,111,303
187620,30,4741,1875,2866,2585,1101,1484,2156,774,1382
187639,30,1334,352,982,512,152,360,822,200,622
187648,30,2899,1108,1791,2032,765,1267,867,343,524
187666,30,1307,487,820,696,298,398,611,189,422
187745,30,311,107,204,248,92,156,63,15,48
187897,30,1500,530,970,982,410,572,518,120,398
187903,30,2135,842,1293,926,397,529,1209,445,764
187912,30,345,288,57,345,288,57,,,
187958,30,1394,473,921,453,179,274,941,294,647
187967,30,1160,825,335,1093,779,314,67,46,21
187976,30,867,403,464,77,29,48,790,374,416
187985,30,15642,6529,9113,11914,5034,6880,3728,1495,2233
187994,30,544,170,374,248,84,164,296,86,210
188003,30,501,126,375,224,67,157,277,59,218
188021,30,361,93,268,174,58,116,187,35,152
188030,30,11065,4666,6399,9322,3874,5448,1743,792,951
188049,30,1218,424,794,239,93,146,979,331,648
188058,30,812,278,534,444,156,288,368,122,246
188100,30,3987,1208,2779,1502,598,904,2485,610,1875
188137,30,2068,731,1337,567,211,356,1501,520,981
188182,30,369,208,161,329,183,146,40,25,15
188216,30,256,89,167,167,77,90,89,12,77
188225,30,761,257,504,127,53,74,634,204,430
188261,30,423,315,108,126,79,47,297,236,61
188289,30,68,4,64,66,4,62,2,0,2
188304,30,1782,573,1209,1109,442,667,673,131,542
188340,30,1175,1032,143,949,825,124,226,207,19
188429,30,5004,1611,3393,4769,1531,3238,235,80,155
188438,30,1987,857,1130,1371,652,719,616,205,411
188517,30,277,110,167,230,100,130,47,10,37
188526,30,584,208,376,581,206,375,3,2,1
188641,30,1305,632,673,1279,618,661,26,14,12
188650,30,148,3,145,148,3,145,,,
188669,30,67,15,52,67,15,52,,,
188678,30,209,68,141,209,68,141,,,
188687,30,382,127,255,100,40,60,282,87,195
188696,30,166,17,149,166,17,149,,,
188854,30,1471,398,1073,1471,398,1073,,,
188890,30,1072,1049,23,799,782,17,273,267,6
188915,30,47,14,33,22,13,9,25,1,24
188942,30,307,0,307,287,0,287,20,0,20
189088,30,2174,916,1258,2055,835,1220,119,81,38
189097,30,3126,0,3126,3084,0,3084,42,0,42
189219,30,122,120,2,122,120,2,,,
189228,30,1514,458,1056,940,303,637,574,155,419
189255,30,110,1,109,71,1,70,39,0,39
189273,30,74,74,0,74,74,0,,,
189282,30,329,45,284,261,38,223,68,7,61
189404,30,137,1,136,45,0,45,92,1,91
189413,30,391,87,304,391,87,304,,,
189468,30,149,4,145,89,4,85,60,0,60
189477,30,139,3,136,51,2,49,88,1,87
189547,30,3244,1270,1974,2351,1009,1342,893,261,632
189565,30,455,132,323,374,117,257,81,15,66
189583,30,602,152,450,451,116,335,151,36,115
189592,30,326,86,240,269,80,189,57,6,51
189705,30,1750,878,872,1707,852,855,43,26,17
189714,30,331,9,322,230,4,226,101,5,96
189811,30,827,158,669,827,158,669,,,
189839,30,1151,423,728,745,288,457,406,135,271
189848,30,633,192,441,537,170,367,96,22,74
189857,30,679,679,0,679,679,0,,,
189990,30,745,7,738,148,3,145,597,4,593
190008,30,43,14,29,43,14,29,,,
190044,30,2587,1784,803,2577,1780,797,10,4,6
190053,30,422,186,236,265,138,127,157,48,109
190071,30,115,13,102,26,4,22,89,9,80
190099,30,3124,1391,1733,3112,1383,1729,12,8,4
190114,30,372,95,277,280,64,216,92,31,61
190150,30,8902,4530,4372,8263,4218,4045,639,312,327
190169,30,878,325,553,454,218,236,424,107,317
190239,30,131,4,127,96,2,94,35,2,33
190318,30,199,13,186,190,5,185,9,8,1
190372,30,892,441,451,892,441,451,,,
190415,30,15676,7135,8541,15627,7105,8522,49,30,19
190442,30,1344,548,796,880,384,496,464,164,300
190451,30,215,34,181,62,13,49,153,21,132
190503,30,3005,1523,1482,2867,1445,1422,138,78,60
190512,30,15554,7728,7826,12561,6244,6317,2993,1484,1509
190521,30,16302,6861,9441,11044,4817,6227,5258,2044,3214
190530,30,6069,2608,3461,3830,1726,2104,2239,882,1357
190549,30,10785,4664,6121,8429,3644,4785,2356,1020,1336
190558,30,8987,4188,4799,7290,3429,3861,1697,759,938
190567,30,11481,5424,6057,9423,4428,4995,2058,996,1062
190576,30,2666,678,1988,892,247,645,1774,431,1343
190585,30,4392,1353,3039,2346,817,1529,2046,536,1510
190594,30,16549,5614,10935,13390,4437,8953,3159,1177,1982
190600,30,11726,4336,7390,9659,3507,6152,2067,829,1238
190619,30,7149,3099,4050,5418,2412,3006,1731,687,1044
190628,30,9915,4118,5797,6443,2816,3627,3472,1302,2170
190637,30,10485,3438,7047,7391,2497,4894,3094,941,2153
190646,30,3239,897,2342,2353,684,1669,886,213,673
190655,30,12312,6876,5436,8402,4988,3414,3910,1888,2022
190664,30,13513,6347,7166,10455,4843,5612,3058,1504,1554
190673,30,8380,4023,4357,5313,2739,2574,3067,1284,1783
190691,30,4822,1669,3153,3475,1218,2257,1347,451,896
190707,30,18,5,13,18,5,13,,,
190716,30,1372,347,1025,1069,281,788,303,66,237
190725,30,1682,421,1261,1568,392,1176,114,29,85
190752,30,51,51,0,51,51,0,,,
190761,30,1079,395,684,1022,383,639,57,12,45
190840,30,3631,1677,1954,2303,1140,1163,1328,537,791
190956,30,141,14,127,13,2,11,128,12,116
190983,30,603,201,402,586,199,387,17,2,15
191083,30,6086,2975,3111,4479,2318,2161,1607,657,950
191126,30,7635,1344,6291,6866,1151,5715,769,193,576
191199,30,2844,1272,1572,1893,911,982,951,361,590
191205,30,472,339,133,457,329,128,15,10,5
191241,30,9843,3917,5926,9613,3803,5810,230,114,116
191302,30,993,419,574,655,297,358,338,122,216
191311,30,149,53,96,149,53,96,,,
191339,30,2026,699,1327,1268,494,774,758,205,553
191515,30,2071,928,1143,2070,927,1143,1,1,0
191533,30,1085,450,635,1071,445,626,14,5,9
191597,30,544,77,467,348,55,293,196,22,174
191612,30,1298,557,741,1003,426,577,295,131,164
191621,30,827,392,435,798,377,421,29,15,14
191630,30,1539,755,784,1529,747,782,10,8,2
191649,30,6051,2606,3445,5818,2490,3328,233,116,117
191676,30,745,274,471,710,262,448,35,12,23
191719,30,6189,3191,2998,4348,2492,1856,1841,699,1142
191728,30,952,194,758,665,143,522,287,51,236
191931,30,2633,1255,1378,2601,1233,1368,32,22,10
191940,30,172,16,156,172,16,156,,,
191959,30,67,54,13,67,54,13,,,
191968,30,4601,2069,2532,4519,2027,2492,82,42,40
191986,30,1596,665,931,1196,544,652,400,121,279
192004,30,287,78,209,278,75,203,9,3,6
192022,30,1547,589,958,1121,466,655,426,123,303
192040,30,149,61,88,145,59,86,4,2,2
192110,30,476,248,228,476,248,228,,,
192165,30,187,187,0,187,187,0,,,
192192,30,983,247,736,917,233,684,66,14,52
192271,30,1075,112,963,981,107,874,94,5,89
192323,30,2459,959,1500,2183,913,1270,276,46,230
192448,30,5751,1919,3832,5225,1795,3430,526,124,402
192484,30,165,3,162,77,1,76,88,2,86
192509,30,713,103,610,683,99,584,30,4,26
192624,30,142,142,0,142,142,0,,,
192688,30,437,78,359,353,54,299,84,24,60
192703,30,3066,1783,1283,2918,1682,1236,148,101,47
192712,30,503,253,250,502,252,250,1,1,0
192749,30,1276,513,763,1243,499,744,33,14,19
192785,30,758,87,671,177,25,152,581,62,519
192800,30,9,0,9,3,0,3,6,0,6
192819,30,5069,2100,2969,4914,2025,2889,155,75,80
192864,30,1568,280,1288,1394,268,1126,174,12,162
192925,30,1185,351,834,1059,338,721,126,13,113
192961,30,121,19,102,1,0,1,120,19,101
192970,30,15,5,10,15,5,10,,,
193016,30,5510,1652,3858,4760,1369,3391,750,283,467
193052,30,344,344,0,344,344,0,,,
193061,30,47,47,0,47,47,0,,,
193070,30,52,52,0,52,52,0,,,
193201,30,365,42,323,365,42,323,,,
193247,30,114,114,0,114,114,0,,,
193265,30,66,59,7,49,45,4,17,14,3
193283,30,2852,1227,1625,2113,983,1130,739,244,495
193292,30,3207,917,2290,2630,799,1831,577,118,459
193308,30,5434,1841,3593,3588,1458,2130,1846,383,1463
193326,30,7460,3083,4377,4413,1972,2441,3047,1111,1936
193353,30,1466,435,1031,1183,365,818,283,70,213
193380,30,95,12,83,,,,95,12,83
193399,30,2233,508,1725,2088,493,1595,145,15,130
193478,30,10540,5170,5370,6355,3356,2999,4185,1814,2371
193584,30,1978,547,1431,1925,534,1391,53,13,40
193609,30,64,25,39,64,25,39,,,
193654,30,7136,1646,5490,6665,1518,5147,471,128,343
193858,30,266,18,248,266,18,248,,,
193900,30,29136,11924,17212,28206,11496,16710,930,428,502
193946,30,2763,1068,1695,2017,834,1183,746,234,512
193973,30,2668,938,1730,2622,920,1702,46,18,28
193991,30,40,4,36,31,2,29,9,2,7
194028,30,737,270,467,529,211,318,208,59,149
194091,30,3279,1946,1333,2950,1748,1202,329,198,131
194116,30,451,37,414,142,14,128,309,23,286
194161,30,761,310,451,573,223,350,188,87,101
194189,30,101,101,0,101,101,0,,,
194222,30,3865,1817,2048,2697,1342,1355,1168,475,693
194240,30,3539,1391,2148,1910,861,1049,1629,530,1099
194259,30,17,1,16,17,1,16,,,
194310,30,7766,2587,5179,7450,2431,5019,316,156,160
194392,30,668,427,241,654,421,233,14,6,8
194435,30,73,2,71,73,2,71,,,
194499,30,790,155,635,790,155,635,,,
194569,30,103,66,37,62,39,23,41,27,14
194578,30,3887,1097,2790,3831,1073,2758,56,24,32
194657,30,135,135,0,135,135,0,,,
194666,30,431,431,0,431,431,0,,,
194693,30,37,37,0,37,37,0,,,
194718,30,62,62,0,62,62,0,,,
194736,30,148,148,0,148,148,0,,,
194763,30,346,346,0,346,346,0,,,
194824,30,5886,4090,1796,5838,4048,1790,48,42,6
194958,30,1033,332,701,893,308,585,140,24,116
195003,30,13152,8660,4492,12798,8417,4381,354,243,111
195030,30,6569,3108,3461,6401,3063,3338,168,45,123
195058,30,4079,1915,2164,2528,1357,1171,1551,558,993
195067,30,317,17,300,230,12,218,87,5,82
195128,30,1117,309,808,1090,305,785,27,4,23
195164,30,1791,991,800,1771,981,790,20,10,10
195173,30,2245,851,1394,2128,800,1328,117,51,66
195191,30,239,23,216,208,17,191,31,6,25
195216,30,2130,979,1151,2127,976,1151,3,3,0
195234,30,1420,478,942,1371,458,913,49,20,29
195243,30,1016,535,481,979,505,474,37,30,7
195289,30,127,18,109,15,1,14,112,17,95
195304,30,1417,290,1127,1402,283,1119,15,7,8
195322,30,1491,627,864,912,411,501,579,216,363
195438,30,177,177,0,177,177,0,,,
195474,30,3480,1554,1926,3423,1527,1896,57,27,30
195526,30,2744,1137,1607,2720,1127,1593,24,10,14
195544,30,3531,1121,2410,3200,1027,2173,331,94,237
195702,30,141,20,121,83,14,69,58,6,52
195720,30,2616,1084,1532,2540,1059,1481,76,25,51
195784,30,658,94,564,658,94,564,,,
195809,30,10081,4537,5544,9850,4412,5438,231,125,106
195988,30,826,356,470,541,265,276,285,91,194
196006,30,3334,2135,1199,3057,2046,1011,277,89,188
196015,30,2758,1194,1564,2336,1060,1276,422,134,288
196024,30,2459,1164,1295,2021,1080,941,438,84,354
196033,30,1774,759,1015,1668,713,955,106,46,60
196042,30,8915,5311,3604,7284,4346,2938,1631,965,666
196051,30,1776,903,873,1556,852,704,220,51,169
196060,30,12175,5562,6613,11535,5240,6295,640,322,318
196079,30,14398,6830,7568,14080,6644,7436,318,186,132
196088,30,20569,11043,9526,19046,10360,8686,1523,683,840
196097,30,17406,8570,8836,16314,7988,8326,1092,582,510
196103,30,1604,803,801,1271,645,626,333,158,175
196112,30,1852,1304,548,1703,1218,485,149,86,63
196121,30,5107,2062,3045,4515,1878,2637,592,184,408
196130,30,5370,2338,3032,4838,2077,2761,532,261,271
196149,30,5980,2764,3216,5859,2692,3167,121,72,49
196158,30,3193,1336,1857,3108,1297,1811,85,39,46
196167,30,4078,1441,2637,3945,1380,2565,133,61,72
196176,30,5990,2127,3863,5540,1910,3630,450,217,233
196185,30,4849,1896,2953,4761,1846,2915,88,50,38
196194,30,5957,2834,3123,5538,2635,2903,419,199,220
196200,30,2078,812,1266,2003,790,1213,75,22,53
196219,30,3050,1268,1782,2844,1179,1665,206,89,117
196237,30,3800,1569,2231,3291,1320,1971,509,249,260
196246,30,3925,1528,2397,3535,1390,2145,390,138,252
196255,30,282,56,226,262,52,210,20,4,16
196264,30,7027,2386,4641,3218,883,2335,3809,1503,2306
196291,30,1291,1119,172,1200,1035,165,91,84,7
196307,30,157,36,121,128,31,97,29,5,24
196389,30,1051,223,828,1043,221,822,8,2,6
196413,30,15071,6867,8204,14601,6620,7981,470,247,223
196431,30,347,347,0,345,345,0,2,2,0
196440,30,14,14,0,14,14,0,,,
196565,30,1416,582,834,936,462,474,480,120,360
196583,30,67,67,0,67,67,0,,,
196592,30,4005,1233,2772,2971,935,2036,1034,298,736
196653,30,964,113,851,340,42,298,624,71,553
196680,30,13983,7151,6832,,,,13983,7151,6832
196699,30,1261,538,723,765,361,404,496,177,319
196866,30,2077,1154,923,2077,1154,923,,,
197018,30,2104,2104,0,2104,2104,0,,,
197027,30,931,747,184,931,747,184,,,
197036,30,4328,3345,983,4328,3345,983,,,
197045,30,2526,1066,1460,2140,938,1202,386,128,258
197133,30,2430,935,1495,2420,928,1492,10,7,3
197142,30,455,224,231,403,206,197,52,18,34
197151,30,3518,909,2609,3457,886,2571,61,23,38
197197,30,1638,610,1028,1568,586,982,70,24,46
197221,30,102,76,26,102,76,26,,,
197230,30,349,154,195,346,153,193,3,1,2
197285,30,742,217,525,663,194,469,79,23,56
197294,30,7636,3587,4049,4059,2046,2013,3577,1541,2036
197337,30,66,1,65,63,1,62,3,0,3
197531,30,487,229,258,487,229,258,,,
197601,30,122,122,0,122,122,0,,,
197647,30,111,111,0,111,111,0,,,
197674,30,214,214,0,214,214,0,,,
197692,30,71,71,0,71,71,0,,,
197708,30,2820,1537,1283,2795,1520,1275,25,17,8
197735,30,778,778,0,778,778,0,,,
197744,30,161,161,0,161,161,0,,,
197814,30,1161,355,806,418,168,250,743,187,556
197850,30,1564,523,1041,478,200,278,1086,323,763
197869,30,18467,8060,10407,17319,7552,9767,1148,508,640
197887,30,4019,1503,2516,1377,578,799,2642,925,1717
197911,30,1057,536,521,1025,529,496,32,7,25
197966,30,1497,461,1036,432,133,299,1065,328,737
197984,30,1413,762,651,1344,738,606,69,24,45
197993,30,168,0,168,158,0,158,10,0,10
198011,30,796,273,523,330,107,223,466,166,300
198039,30,1835,700,1135,669,270,399,1166,430,736
198066,30,731,456,275,718,448,270,13,8,5
198084,30,1070,416,654,576,262,314,494,154,340
198109,30,449,30,419,135,9,126,314,21,293
198118,30,2297,875,1422,953,440,513,1344,435,909
198136,30,2933,1398,1535,2465,1130,1335,468,268,200
198154,30,8950,3659,5291,2987,1328,1659,5963,2331,3632
198206,30,1151,382,769,552,231,321,599,151,448
198215,30,1076,516,560,1000,499,501,76,17,59
198233,30,2576,1095,1481,1083,508,575,1493,587,906
198251,30,4143,1458,2685,1374,530,844,2769,928,1841
198260,30,13522,5883,7639,5834,2673,3161,7688,3210,4478
198303,30,800,478,322,762,465,297,38,13,25
198321,30,1372,474,898,549,200,349,823,274,549
198330,30,2772,1074,1698,1431,554,877,1341,520,821
198367,30,1822,712,1110,642,305,337,1180,407,773
198376,30,2454,800,1654,1017,402,615,1437,398,1039
198385,30,1922,898,1024,1922,898,1024,,,
198419,30,6570,3129,3441,6543,3114,3429,27,15,12
198455,30,3254,1265,1989,678,325,353,2576,940,1636
198464,30,20385,8715,11670,17585,7515,10070,2800,1200,1600
198491,30,908,159,749,199,30,169,709,129,580
198507,30,1912,828,1084,1701,767,934,211,61,150
198516,30,6337,2567,3770,6144,2476,3668,193,91,102
198534,30,8521,3223,5298,3586,1417,2169,4935,1806,3129
198543,30,5218,1541,3677,3869,1139,2730,1349,402,947
198552,30,6787,2431,4356,2063,917,1146,4724,1514,3210
198561,30,1811,645,1166,1516,610,906,295,35,260
198570,30,3228,1103,2125,1144,463,681,2084,640,1444
198598,30,619,385,234,599,379,220,20,6,14
198613,30,1022,516,506,999,505,494,23,11,12
198622,30,8035,3353,4682,3261,1516,1745,4774,1837,2937
198640,30,519,137,382,150,47,103,369,90,279
198668,30,803,271,532,388,176,212,415,95,320
198677,30,26,13,13,17,9,8,9,4,5
198695,30,4965,2222,2743,4925,2203,2722,40,19,21
198710,30,1118,397,721,474,191,283,644,206,438
198729,30,954,259,695,389,114,275,565,145,420
198756,30,1041,479,562,985,459,526,56,20,36
198774,30,2659,930,1729,1223,493,730,1436,437,999
198808,30,854,298,556,821,294,527,33,4,29
198817,30,1244,421,823,512,229,283,732,192,540
198835,30,1393,607,786,1315,589,726,78,18,60
198844,30,105,1,104,105,1,104,,,
198862,30,839,497,342,814,485,329,25,12,13
198871,30,434,334,100,424,325,99,10,9,1
198899,30,980,502,478,913,478,435,67,24,43
198905,30,352,93,259,162,33,129,190,60,130
198914,30,350,125,225,170,63,107,180,62,118
198923,30,565,202,363,158,62,96,407,140,267
198950,30,1294,0,1294,1256,0,1256,38,0,38
198969,30,1442,788,654,1286,726,560,156,62,94
198978,30,517,63,454,496,62,434,21,1,20
198987,30,1757,668,1089,686,289,397,1071,379,692
199005,30,6,0,6,6,0,6,,,
199023,30,242,110,132,118,60,58,124,50,74
199032,30,816,438,378,707,392,315,109,46,63
199069,30,1784,626,1158,1176,495,681,608,131,477
199078,30,152,17,135,149,17,132,3,0,3
199087,30,1565,561,1004,576,246,330,989,315,674
199102,30,11553,4299,7254,10463,3770,6693,1090,529,561
199111,30,2803,1188,1615,2519,1041,1478,284,147,137
199120,30,19921,7890,12031,19162,7532,11630,759,358,401
199139,30,23063,11962,11101,19989,10321,9668,3074,1641,1433
199148,30,13862,4649,9213,11534,3883,7651,2328,766,1562
199157,30,5101,1529,3572,4476,1380,3096,625,149,476
199184,30,915,359,556,894,350,544,21,9,12
199193,30,25109,12667,12442,23645,11800,11845,1464,867,597
199209,30,1204,607,597,1038,559,479,166,48,118
199218,30,13960,4938,9022,11709,4388,7321,2251,550,1701
199263,30,234,58,176,59,11,48,175,47,128
199272,30,640,338,302,575,320,255,65,18,47
199281,30,5544,2104,3440,4220,1670,2550,1324,434,890
199306,30,683,322,361,657,309,348,26,13,13
199324,30,643,236,407,70,28,42,573,208,365
199333,30,4961,1783,3178,2493,1049,1444,2468,734,1734
199412,30,1301,465,836,1234,445,789,67,20,47
199421,30,1362,455,907,501,179,322,861,276,585
199449,30,1246,369,877,413,156,257,833,213,620
199458,30,125,88,37,122,86,36,3,2,1
199467,30,266,54,212,101,26,75,165,28,137
199476,30,1603,441,1162,521,144,377,1082,297,785
199485,30,1015,352,663,361,159,202,654,193,461
199494,30,4195,1521,2674,1409,586,823,2786,935,1851
199582,30,937,479,458,757,376,381,180,103,77
199607,30,331,4,327,279,0,279,52,4,48
199625,30,891,271,620,387,137,250,504,134,370
199634,30,2370,858,1512,1049,476,573,1321,382,939
199643,30,918,430,488,828,398,430,90,32,58
199689,30,186,7,179,148,1,147,38,6,32
199698,30,780,341,439,681,333,348,99,8,91
199722,30,754,234,520,296,130,166,458,104,354
199731,30,1410,461,949,443,158,285,967,303,664
199740,30,1398,374,1024,323,113,210,1075,261,814
199759,30,458,301,157,263,168,95,195,133,62
199768,30,1514,601,913,719,325,394,795,276,519
199786,30,2725,1015,1710,975,415,560,1750,600,1150
199795,30,420,155,265,168,63,105,252,92,160
199838,30,1677,487,1190,582,195,387,1095,292,803
199847,30,5446,2444,3002,5388,2410,2978,58,34,24
199856,30,18002,8384,9618,6514,3350,3164,11488,5034,6454
199865,30,697,241,456,695,241,454,2,0,2
199883,30,163,19,144,163,19,144,,,
199892,30,1904,746,1158,713,329,384,1191,417,774
199908,30,1280,469,811,485,189,296,795,280,515
199926,30,1248,505,743,591,285,306,657,220,437
199953,30,893,259,634,315,105,210,578,154,424
199962,30,2509,1026,1483,2454,1007,1447,55,19,36
199971,30,47,31,16,47,31,16,,,
199980,30,44,41,3,44,41,3,,,
199999,30,4449,1079,3370,3895,969,2926,554,110,444
200004,30,9809,4244,5565,7977,3501,4476,1832,743,1089
200013,30,466,78,388,256,41,215,210,37,173
200022,30,2561,1476,1085,1798,1031,767,763,445,318
200059,30,1148,512,636,971,456,515,177,56,121
200086,30,137,43,94,106,36,70,31,7,24
200110,30,51,1,50,51,1,50,,,
200156,30,968,544,424,938,526,412,30,18,12
200192,30,563,222,341,407,181,226,156,41,115
200208,30,271,78,193,149,57,92,122,21,101
200217,30,2149,889,1260,1824,754,1070,325,135,190
200226,30,767,293,474,587,255,332,180,38,142
200253,30,2168,777,1391,1767,649,1118,401,128,273
200280,30,9066,5025,4041,6991,3641,3350,2075,1384,691
200305,30,1768,1126,642,1496,999,497,272,127,145
200314,30,408,130,278,289,111,178,119,19,100
200332,30,9795,4811,4984,8902,4473,4429,893,338,555
200341,30,648,230,418,511,202,309,137,28,109
200466,30,227,106,121,194,97,97,33,9,24
200484,30,162,77,85,141,69,72,21,8,13
200527,30,510,204,306,460,185,275,50,19,31
200554,30,502,177,325,473,163,310,29,14,15
200572,30,914,426,488,726,354,372,188,72,116
200590,30,152,27,125,143,23,120,9,4,5
200785,30,369,47,322,176,21,155,193,26,167
200800,30,10099,5302,4797,8517,4498,4019,1582,804,778
200846,30,597,237,360,469,172,297,128,65,63
200873,30,77,44,33,53,24,29,24,20,4
201034,30,610,297,313,127,39,88,483,258,225
201061,30,259,67,192,251,64,187,8,3,5
201098,30,45,18,27,26,7,19,19,11,8
201104,30,2332,1028,1304,1883,807,1076,449,221,228
201131,30,115,36,79,80,3,77,35,33,2
201140,30,34,28,6,,,,34,28,6
201159,30,166,122,44,92,72,20,74,50,24
201177,30,245,19,226,117,12,105,128,7,121
201195,30,2708,1206,1502,2608,1159,1449,100,47,53
201283,30,490,183,307,296,134,162,194,49,145
201371,30,649,346,303,638,340,298,11,6,5
201432,30,1082,412,670,836,323,513,246,89,157
201441,30,12223,5288,6935,11496,4887,6609,727,401,326
201469,30,534,113,421,415,102,313,119,11,108
201478,30,183,83,100,128,37,91,55,46,9
201496,30,450,282,168,450,282,168,,,
201539,30,92,15,77,66,10,56,26,5,21
201548,30,1905,770,1135,1870,753,1117,35,17,18
201645,30,5927,3089,2838,5878,3063,2815,49,26,23
201654,30,3851,1752,2099,3789,1722,2067,62,30,32
201672,30,1465,351,1114,383,116,267,1082,235,847
201681,30,37,5,32,37,5,32,,,
201690,30,5395,1610,3785,3114,1014,2100,2281,596,1685
201751,30,24,4,20,9,1,8,15,3,12
201803,30,34,4,30,34,4,30,,,
201821,30,860,70,790,661,55,606,199,15,184
201867,30,101,16,85,101,16,85,,,
201885,30,27880,13883,13997,24865,12694,12171,3015,1189,1826
201928,30,5501,2237,3264,1868,859,1009,3633,1378,2255
201946,30,2200,709,1491,1021,425,596,1179,284,895
201955,30,3927,1526,2401,2764,1178,1586,1163,348,815
201964,30,929,396,533,651,289,362,278,107,171
201973,30,3117,935,2182,762,273,489,2355,662,1693
202046,30,575,157,418,564,150,414,11,7,4
202073,30,194,96,98,194,96,98,,,
202134,30,9502,4314,5188,7782,3578,4204,1720,736,984
202152,30,96,11,85,96,11,85,,,
202170,30,956,291,665,944,290,654,12,1,11
202222,30,16212,7525,8687,5111,2404,2707,11101,5121,5980
202356,30,11634,4428,7206,3703,1655,2048,7931,2773,5158
202435,30,89,17,72,56,14,42,33,3,30
202453,30,69,59,10,69,59,10,,,
202480,30,8349,4342,4007,8090,4218,3872,259,124,135
202514,30,478,292,186,461,281,180,17,11,6
202523,30,2406,1150,1256,2400,1147,1253,6,3,3
202648,30,1333,494,839,459,232,227,874,262,612
202657,30,365,96,269,76,14,62,289,82,207
202763,30,2257,712,1545,2191,688,1503,66,24,42
202806,30,5117,2068,3049,1944,716,1228,3173,1352,1821
202888,30,50,6,44,35,6,29,15,0,15
202903,30,268,139,129,165,71,94,103,68,35
202912,30,318,15,303,132,9,123,186,6,180
202949,30,154,145,9,154,145,9,,,
202985,30,17,1,16,9,1,8,8,0,8
203030,30,35,1,34,35,1,34,,,
203085,30,913,492,421,898,486,412,15,6,9
203128,30,737,359,378,684,336,348,53,23,30
203146,30,396,366,30,396,366,30,,,
203155,30,1765,938,827,1467,828,639,298,110,188
203234,30,69,3,66,69,3,66,,,
203289,30,40,28,12,40,28,12,,,
203331,30,28674,8704,19970,9092,2699,6393,19582,6005,13577
203368,30,2358,1295,1063,2314,1269,1045,44,26,18
203386,30,2643,196,2447,1756,139,1617,887,57,830
203438,30,112,0,112,51,0,51,61,0,61
203447,30,1331,513,818,187,63,124,1144,450,694
203456,30,736,269,467,19,6,13,717,263,454
203465,30,2602,985,1617,953,397,556,1649,588,1061
203474,30,1471,581,890,336,125,211,1135,456,679
203483,30,1591,661,930,398,176,222,1193,485,708
203492,30,1008,249,759,246,36,210,762,213,549
203517,30,19179,7242,11937,16669,6185,10484,2510,1057,1453
203526,30,1517,559,958,311,136,175,1206,423,783
203535,30,1877,824,1053,1877,824,1053,,,
203544,30,572,83,489,383,52,331,189,31,158
203580,30,662,389,273,635,377,258,27,12,15
203599,30,3191,1232,1959,1007,450,557,2184,782,1402
203614,30,414,120,294,414,120,294,,,
203678,30,1383,360,1023,466,184,282,917,176,741
203720,30,136,78,58,111,76,35,25,2,23
203739,30,44,7,37,37,5,32,7,2,5
203748,30,5483,1961,3522,1814,727,1087,3669,1234,2435
203757,30,749,339,410,691,321,370,58,18,40
203775,30,818,381,437,743,345,398,75,36,39
203845,30,1064,548,516,1026,527,499,38,21,17
203881,30,1276,563,713,366,138,228,910,425,485
203942,30,32,17,15,32,17,15,,,
203960,30,1106,127,979,365,48,317,741,79,662
204006,30,2065,982,1083,1596,730,866,469,252,217
204015,30,946,435,511,722,327,395,224,108,116
204024,30,16721,8055,8666,16402,7875,8527,319,180,139
204121,30,72,0,72,30,0,30,42,0,42
204158,30,127,36,91,127,36,91,,,
204176,30,628,78,550,482,64,418,146,14,132
204185,30,1867,993,874,1847,980,867,20,13,7
204194,30,1481,566,915,1280,510,770,201,56,145
204200,30,1045,470,575,984,453,531,61,17,44
204255,30,763,348,415,422,225,197,341,123,218
204264,30,1436,659,777,1307,635,672,129,24,105
204334,30,137,1,136,1,0,1,136,1,135
204422,30,1250,439,811,490,202,288,760,237,523
204431,30,46,9,37,46,9,37,,,
204440,30,1028,504,524,342,168,174,686,336,350
204459,30,10,9,1,10,9,1,,,
204468,30,1067,527,540,939,494,445,128,33,95
204486,30,2575,2171,404,2421,2069,352,154,102,52
204501,30,2986,1220,1766,2978,1216,1762,8,4,4
204608,30,374,336,38,374,336,38,,,
204617,30,795,383,412,745,360,385,50,23,27
204635,30,2402,1312,1090,2356,1284,1072,46,28,18
204662,30,421,178,243,390,161,229,31,17,14
204671,30,731,321,410,652,283,369,79,38,41
204680,30,722,326,396,647,293,354,75,33,42
204699,30,833,431,402,722,374,348,111,57,54
204705,30,2119,1048,1071,1839,911,928,280,137,143
204714,30,81,3,78,81,3,78,,,
204723,30,303,232,71,303,232,71,,,
204769,30,124,7,117,124,7,117,,,
204778,30,65,1,64,65,1,64,,,
204796,30,45140,22549,22591,42186,20955,21231,2954,1594,1360
204802,30,288,111,177,241,88,153,47,23,24
204820,30,758,244,514,546,175,371,212,69,143
204839,30,534,183,351,423,139,284,111,44,67
204848,30,633,239,394,463,163,300,170,76,94
204857,30,17611,6936,10675,14608,6262,8346,3003,674,2329
204866,30,560,130,430,411,92,319,149,38,111
204884,30,149,7,142,149,7,142,,,
204893,30,43,9,34,20,7,13,23,2,21
204909,30,1401,616,785,1390,610,780,11,6,5
204936,30,2097,842,1255,2022,803,1219,75,39,36
204945,30,4298,1616,2682,1636,670,966,2662,946,1716
204963,30,47,3,44,47,3,44,,,
204981,30,108,24,84,19,2,17,89,22,67
205027,30,34,34,0,34,34,0,,,
205054,30,404,41,363,404,41,363,,,
205090,30,69,8,61,9,1,8,60,7,53
205124,30,55,55,0,55,55,0,,,
205142,30,121,39,82,116,39,77,5,0,5
205179,30,441,74,367,426,73,353,15,1,14
205203,30,704,259,445,462,218,244,242,41,201
205391,30,178,33,145,98,18,80,80,15,65
205443,30,2425,1041,1384,2038,891,1147,387,150,237
205470,30,12623,5658,6965,3128,1555,1573,9495,4103,5392
205559,30,26,3,23,26,3,23,,,
205841,30,6208,2647,3561,2209,1118,1091,3999,1529,2470
205887,30,403,50,353,403,50,353,,,
205957,30,2605,1091,1514,2407,1005,1402,198,86,112
205966,30,748,214,534,290,95,195,458,119,339
206011,30,1095,602,493,430,232,198,665,370,295
206039,30,40,1,39,29,0,29,11,1,10
206048,30,1985,1009,976,1522,832,690,463,177,286
206084,30,10787,5315,5472,9574,4708,4866,1213,607,606
206154,30,21,17,4,,,,21,17,4
206172,30,40,15,25,40,15,25,,,
206181,30,134,37,97,51,4,47,83,33,50
206279,30,468,234,234,163,79,84,305,155,150
206321,30,85,26,59,46,2,44,39,24,15
206349,30,618,47,571,536,40,496,82,7,75
206394,30,43,11,32,20,6,14,23,5,18
206437,30,1454,680,774,1330,646,684,124,34,90
206446,30,936,304,632,423,191,232,513,113,400
206491,30,639,288,351,499,228,271,140,60,80
206507,30,1011,456,555,969,438,531,42,18,24
206525,30,1235,586,649,1210,575,635,25,11,14
206589,30,1960,954,1006,1958,953,1005,2,1,1
206604,30,6327,2836,3491,5110,2256,2854,1217,580,637
206613,30,984,410,574,719,273,446,265,137,128
206622,30,4837,2137,2700,4613,2042,2571,224,95,129
206695,30,7741,3512,4229,6861,3149,3712,880,363,517
206817,30,299,149,150,255,126,129,44,23,21
206835,30,722,402,320,605,353,252,117,49,68
206862,30,908,456,452,887,447,440,21,9,12
206905,30,57,30,27,49,22,27,8,8,0
206914,30,2643,943,1700,1948,707,1241,695,236,459
206923,30,1133,364,769,729,287,442,404,77,327
206932,30,441,32,409,183,25,158,258,7,251
206941,30,10400,3929,6471,7835,2916,4919,2565,1013,1552
206996,30,1346,371,975,727,247,480,619,124,495
207041,30,2584,1041,1543,2234,923,1311,350,118,232
207050,30,939,302,637,626,236,390,313,66,247
207069,30,753,251,502,419,182,237,334,69,265
207087,30,27,1,26,27,1,26,,,
207102,30,83,21,62,83,21,62,,,
207157,30,242,137,105,202,123,79,40,14,26
207209,30,1774,693,1081,1676,649,1027,98,44,54
207236,30,1300,376,924,692,268,424,608,108,500
207254,30,639,574,65,639,574,65,,,
207263,30,4885,1850,3035,3666,1444,2222,1219,406,813
207281,30,1905,711,1194,1248,523,725,657,188,469
207290,30,1529,610,919,1165,538,627,364,72,292
207306,30,1430,583,847,1237,523,714,193,60,133
207324,30,1856,784,1072,1735,755,980,121,29,92
207342,30,985,99,886,946,96,850,39,3,36
207351,30,1124,461,663,860,400,460,264,61,203
207388,30,20362,9799,10563,18220,8740,9480,2142,1059,1083
207397,30,3574,1251,2323,944,421,523,2630,830,1800
207403,30,1246,522,724,1229,514,715,17,8,9
207449,30,9384,3461,5923,3122,1251,1871,6262,2210,4052
207458,30,1344,464,880,1309,442,867,35,22,13
207500,30,20842,10138,10704,18479,8954,9525,2363,1184,1179
207564,30,2021,1405,616,1380,1050,330,641,355,286
207582,30,3250,1279,1971,2749,1086,1663,501,193,308
207661,30,2507,981,1526,1914,755,1159,593,226,367
207670,30,4422,1506,2916,2079,806,1273,2343,700,1643
207704,30,206,1,205,103,1,102,103,0,103
207722,30,808,287,521,756,271,485,52,16,36
207740,30,1121,342,779,687,254,433,434,88,346
207786,30,22,1,21,22,1,21,,,
207847,30,2853,1244,1609,1977,923,1054,876,321,555
207856,30,403,229,174,365,204,161,38,25,13
207865,30,3596,1364,2232,3088,1210,1878,508,154,354
207935,30,11481,4155,7326,4245,1773,2472,7236,2382,4854
207962,30,793,679,114,793,679,114,,,
207971,30,2612,1271,1341,2413,1159,1254,199,112,87
208035,30,918,298,620,491,225,266,427,73,354
208044,30,48,9,39,48,9,39,,,
208053,30,61,34,27,25,13,12,36,21,15
208275,30,889,341,548,533,224,309,356,117,239
208318,30,3274,1519,1755,1630,781,849,1644,738,906
208390,30,6588,3016,3572,3211,1430,1781,3377,1586,1791
208406,30,4099,2037,2062,1624,754,870,2475,1283,1192
208415,30,482,165,317,239,84,155,243,81,162
208433,30,73,3,70,73,3,70,,,
208479,30,487,62,425,487,62,425,,,
208512,30,510,59,451,510,59,451,,,
208637,30,196,47,149,,,,196,47,149
208646,30,2262,931,1331,1477,620,857,785,311,474
208725,30,37,22,15,34,20,14,3,2,1
208822,30,2495,1002,1493,2331,942,1389,164,60,104
208859,30,40,6,34,40,6,34,,,
209038,30,5851,2796,3055,2686,1277,1409,3165,1519,1646
209056,30,2187,776,1411,2168,766,1402,19,10,9
209065,30,1667,580,1087,1573,548,1025,94,32,62
209074,30,4196,1945,2251,1705,877,828,2491,1068,1423
209083,30,55,15,40,55,15,40,,,
209153,30,26,4,22,26,4,22,,,
209205,30,36,2,34,36,2,34,,,
209241,30,28,28,0,28,28,0,,,
209250,30,3345,1368,1977,1681,733,948,1664,635,1029
209287,30,375,216,159,340,203,137,35,13,22
209296,30,12,3,9,12,3,9,,,
209409,30,502,223,279,451,211,240,51,12,39
209490,30,752,129,623,481,83,398,271,46,225
209506,30,3088,1605,1483,2103,1120,983,985,485,500
209542,30,28407,14604,13803,19707,10119,9588,8700,4485,4215
209551,30,19443,8645,10798,18185,8035,10150,1258,610,648
209603,30,376,86,290,359,80,279,17,6,11
209612,30,1546,631,915,1487,608,879,59,23,36
209667,30,58,5,53,58,5,53,,,
209676,30,97,9,88,97,9,88,,,
209694,30,37,7,30,37,7,30,,,
209700,30,208,31,177,208,31,177,,,
209719,30,66,0,66,66,0,66,,,
209746,30,17823,7618,10205,7293,3217,4076,10530,4401,6129
209807,30,14299,6157,8142,10967,4641,6326,3332,1516,1816
209825,30,3368,1212,2156,3309,1190,2119,59,22,37
209922,30,1494,629,865,1488,627,861,6,2,4
209940,30,2975,1245,1730,1159,469,690,1816,776,1040
210146,30,2898,1124,1774,2352,918,1434,546,206,340
210155,30,1232,483,749,793,363,430,439,120,319
210234,30,1094,495,599,643,333,310,451,162,289
210270,30,1955,734,1221,747,315,432,1208,419,789
210304,30,440,166,274,409,154,255,31,12,19
210331,30,795,353,442,656,275,381,139,78,61
210401,30,1335,540,795,1315,532,783,20,8,12
210429,30,3292,1138,2154,2860,985,1875,432,153,279
210438,30,2,2,0,,,,2,2,0
210492,30,271,135,136,255,125,130,16,10,6
210571,30,1276,567,709,1205,540,665,71,27,44
210599,30,838,422,416,838,422,416,,,
210605,30,9385,4349,5036,3329,1604,1725,6056,2745,3311
210669,30,1324,624,700,1315,622,693,9,2,7
210711,30,51,2,49,51,2,49,,,
210739,30,2175,763,1412,1894,688,1206,281,75,206
210748,30,64,2,62,34,0,34,30,2,28
210775,30,2000,731,1269,1669,658,1011,331,73,258
210784,30,156,1,155,131,1,130,25,0,25
211006,30,348,322,26,342,321,21,6,1,5
211024,30,376,192,184,269,131,138,107,61,46
211079,30,1151,432,719,512,227,285,639,205,434
211088,30,1750,624,1126,1628,562,1066,122,62,60
211273,30,1402,0,1402,1397,0,1397,5,0,5
211291,30,3732,1796,1936,3731,1796,1935,1,0,1
211307,30,5298,2235,3063,2006,982,1024,3292,1253,2039
211316,30,98,2,96,72,2,70,26,0,26
211334,30,30,0,30,30,0,30,,,
211343,30,1972,733,1239,948,415,533,1024,318,706
211352,30,1145,458,687,1102,436,666,43,22,21
211431,30,1243,196,1047,909,151,758,334,45,289
211440,30,7005,3472,3533,6858,3399,3459,147,73,74
211468,30,933,59,874,696,42,654,237,17,220
211477,30,844,301,543,197,92,105,647,209,438
211556,30,1207,361,846,1169,348,821,38,13,25
211583,30,939,407,532,820,385,435,119,22,97
211608,30,686,231,455,620,214,406,66,17,49
211635,30,78,13,65,78,13,65,,,
211802,30,155,39,116,155,39,116,,,
211893,30,103,61,42,103,61,42,,,
211927,30,7992,3026,4966,1953,926,1027,6039,2100,3939
211981,30,1631,656,975,1537,623,914,94,33,61
212009,30,2083,868,1215,2076,863,1213,7,5,2
212045,30,198,49,149,196,49,147,2,0,2
212054,30,13933,7121,6812,12854,6682,6172,1079,439,640
212106,30,5087,1868,3219,5016,1830,3186,71,38,33
212115,30,4324,1920,2404,3939,1753,2186,385,167,218
212133,30,1692,643,1049,1279,533,746,413,110,303
212197,30,1703,712,991,1597,672,925,106,40,66
212230,30,37,2,35,33,2,31,4,0,4
212267,30,87,1,86,50,0,50,37,1,36
212276,30,83,4,79,60,3,57,23,1,22
212294,30,66,1,65,56,1,55,10,0,10
212300,30,67,1,66,61,1,60,6,0,6
212328,30,95,6,89,58,6,52,37,0,37
212337,30,102,4,98,56,1,55,46,3,43
212355,30,141,5,136,92,2,90,49,3,46
212382,30,138,1,137,91,1,90,47,0,47
212391,30,50,4,46,35,3,32,15,1,14
212434,30,136,117,19,136,117,19,,,
212577,30,1986,925,1061,1984,923,1061,2,2,0
212601,30,2588,1077,1511,2518,1053,1465,70,24,46
212656,30,1013,541,472,962,516,446,51,25,26
212674,30,2236,1086,1150,2232,1084,1148,4,2,2
212753,30,86,3,83,51,1,50,35,2,33
212771,30,107,0,107,55,0,55,52,0,52
212805,30,2160,1120,1040,2146,1111,1035,14,9,5
212832,30,1217,299,918,1115,277,838,102,22,80
212869,30,887,160,727,584,119,465,303,41,262
212878,30,9854,3107,6747,3220,1238,1982,6634,1869,4765
212911,30,1417,646,771,1417,646,771,,,
212975,30,94,72,22,94,72,22,,,
212984,30,2124,528,1596,1842,468,1374,282,60,222
212993,30,80,35,45,68,31,37,12,4,8
213011,30,1248,374,874,996,321,675,252,53,199
213020,30,6611,2544,4067,6125,2306,3819,486,238,248
213163,30,342,47,295,304,45,259,38,2,36
213181,30,350,28,322,301,24,277,49,4,45
213233,30,525,413,112,462,373,89,63,40,23
213251,30,1116,527,589,1113,526,587,3,1,2
213303,30,1009,475,534,811,442,369,198,33,165
213321,30,1595,820,775,1557,802,755,38,18,20
213330,30,31,0,31,31,0,31,,,
213349,30,6334,2765,3569,5936,2588,3348,398,177,221
213358,30,794,312,482,677,273,404,117,39,78
213367,30,2275,822,1453,1994,760,1234,281,62,219
213376,30,1800,726,1074,1347,598,749,453,128,325
213385,30,2725,1363,1362,2712,1355,1357,13,8,5
213400,30,1286,625,661,835,403,432,451,222,229
213455,30,88,3,85,51,3,48,37,0,37
213473,30,90,12,78,54,2,52,36,10,26
213491,30,55,1,54,17,1,16,38,0,38
213507,30,1618,740,878,1585,726,859,33,14,19
213525,30,4574,1666,2908,1760,856,904,2814,810,2004
213534,30,311,125,186,300,122,178,11,3,8
213543,30,5612,3035,2577,5550,2998,2552,62,37,25
213570,30,419,60,359,419,60,359,,,
213589,30,299,263,36,264,231,33,35,32,3
213598,30,1704,593,1111,1593,554,1039,111,39,72
213622,30,112,18,94,89,17,72,23,1,22
213659,30,3295,1083,2212,1317,534,783,1978,549,1429
213668,30,1046,499,547,1045,498,547,1,1,0
213774,30,461,115,346,341,93,248,120,22,98
213826,30,1793,579,1214,1706,556,1150,87,23,64
213914,30,215,19,196,215,19,196,,,
213932,30,174,23,151,174,23,151,,,
213987,30,2367,960,1407,2246,933,1313,121,27,94
213996,30,2327,923,1404,2276,899,1377,51,24,27
214023,30,11,3,8,10,2,8,1,1,0
214041,30,5697,2347,3350,4610,1959,2651,1087,388,699
214069,30,1727,577,1150,1385,511,874,342,66,276
214111,30,7110,2866,4244,2450,1203,1247,4660,1663,2997
214148,30,355,0,355,347,0,347,8,0,8
214157,30,1864,723,1141,1783,710,1073,81,13,68
214166,30,1097,307,790,970,288,682,127,19,108
214175,30,1933,760,1173,1890,737,1153,43,23,20
214272,30,1595,592,1003,1327,486,841,268,106,162
214290,30,628,570,58,628,570,58,,,
214379,30,7282,2668,4614,2982,1341,1641,4300,1327,2973
214476,30,39,7,32,36,6,30,3,1,2
214528,30,227,212,15,163,152,11,64,60,4
214582,30,650,71,579,332,37,295,318,34,284
214591,30,3149,2028,1121,3031,1942,1089,118,86,32
214625,30,440,269,171,391,244,147,49,25,24
214634,30,223,65,158,179,54,125,44,11,33
214643,30,351,229,122,336,217,119,15,12,3
214652,30,860,466,394,823,448,375,37,18,19
214670,30,843,498,345,780,463,317,63,35,28
214689,30,2565,1351,1214,2499,1311,1188,66,40,26
214698,30,503,282,221,487,276,211,16,6,10
214704,30,2024,1218,806,1873,1130,743,151,88,63
214713,30,4053,2511,1542,3786,2334,1452,267,177,90
214731,30,1189,724,465,1095,665,430,94,59,35
214740,30,326,192,134,306,185,121,20,7,13
214759,30,420,190,230,396,175,221,24,15,9
214768,30,470,251,219,452,243,209,18,8,10
214777,30,41417,21956,19461,40475,21343,19132,942,613,329
214786,30,356,221,135,338,211,127,18,10,8
214795,30,626,253,373,573,232,341,53,21,32
214801,30,3072,1801,1271,2822,1656,1166,250,145,105
214810,30,593,215,378,553,204,349,40,11,29
214829,30,662,433,229,581,381,200,81,52,29
214883,30,761,183,578,163,38,125,598,145,453
214892,30,243,101,142,243,101,142,,,
214944,30,515,451,64,377,337,40,138,114,24
214971,30,114,36,78,110,35,75,4,1,3
215008,30,52,51,1,52,51,1,,,
215044,30,145,20,125,145,20,125,,,
215053,30,236,66,170,224,62,162,12,4,8
215062,30,10572,4757,5815,10153,4611,5542,419,146,273
215105,30,1160,398,762,1135,390,745,25,8,17
215114,30,780,385,395,746,360,386,34,25,9
215239,30,10821,3583,7238,3731,1424,2307,7090,2159,4931
215266,30,1051,483,568,1004,469,535,47,14,33
215275,30,1323,553,770,1265,520,745,58,33,25
215284,30,2039,1155,884,1994,1131,863,45,24,21
215293,30,19954,8509,11445,19233,8129,11104,721,380,341
215309,30,23,3,20,14,2,12,9,1,8
215336,30,24,1,23,24,1,23,,,
215381,30,541,503,38,541,503,38,,,
215390,30,352,94,258,71,16,55,281,78,203
215415,30,997,623,374,887,568,319,110,55,55
215442,30,2410,872,1538,2199,777,1422,211,95,116
215479,30,64,9,55,64,9,55,,,
215530,30,40,0,40,36,0,36,4,0,4
215585,30,3198,1031,2167,866,375,491,2332,656,1676
215594,30,259,41,218,194,33,161,65,8,57
215637,30,168,75,93,168,75,93,,,
215655,30,2738,1517,1221,2582,1437,1145,156,80,76
215682,30,417,387,30,417,387,30,,,
215691,30,446,212,234,347,178,169,99,34,65
215743,30,1639,588,1051,1490,560,930,149,28,121
215770,30,4978,2245,2733,4808,2174,2634,170,71,99
215798,30,1335,772,563,1313,759,554,22,13,9
215886,30,33,10,23,16,6,10,17,4,13
215929,30,3515,1517,1998,3433,1463,1970,82,54,28
215947,30,1615,557,1058,1488,524,964,127,33,94
215974,30,422,60,362,315,42,273,107,18,89
215983,30,23,5,18,23,5,18,,,
215992,30,118,46,72,117,46,71,1,0,1
216010,30,4283,2111,2172,3977,1950,2027,306,161,145
216038,30,6707,2982,3725,6311,2785,3526,396,197,199
216047,30,32,32,0,32,32,0,,,
216074,30,89,2,87,56,2,54,33,0,33
216083,30,271,96,175,248,95,153,23,1,22
216162,30,337,27,310,337,27,310,,,
216223,30,40,3,37,40,3,37,,,
216278,30,2139,913,1226,2121,901,1220,18,12,6
216287,30,1619,790,829,1619,790,829,,,
216296,30,1310,1187,123,1282,1162,120,28,25,3
216311,30,123,123,0,123,123,0,,,
216339,30,23697,10458,13239,21918,9531,12387,1779,927,852
216357,30,776,397,379,767,392,375,9,5,4
216366,30,3739,960,2779,3328,864,2464,411,96,315
216436,30,105,93,12,105,93,12,,,
216445,30,101,96,5,101,96,5,,,
216454,30,73,66,7,73,66,7,,,
216524,30,1505,780,725,1502,778,724,3,2,1
216542,30,489,230,259,445,216,229,44,14,30
216551,30,84,67,17,82,65,17,2,2,0
216579,30,93,4,89,93,4,89,,,
216597,30,6926,3207,3719,6752,3099,3653,174,108,66
216630,30,33,4,29,33,4,29,,,
216667,30,1139,600,539,1130,594,536,9,6,3
216694,30,1066,466,600,1055,461,594,11,5,6
216746,30,52,46,6,41,36,5,11,10,1
216764,30,14014,5702,8312,12572,5138,7434,1442,564,878
216773,30,106,15,91,106,15,91,,,
216807,30,1023,485,538,1004,476,528,19,9,10
216825,30,2748,904,1844,1220,480,740,1528,424,1104
216852,30,2513,1044,1469,2324,992,1332,189,52,137
216931,30,1904,886,1018,1802,853,949,102,33,69
216940,30,278,278,0,278,278,0,,,
217013,30,635,126,509,526,119,407,109,7,102
217040,30,35,35,0,35,35,0,,,
217059,30,3219,1408,1811,2960,1262,1698,259,146,113
217077,30,551,194,357,551,194,357,,,
217156,30,7222,3553,3669,7166,3532,3634,56,21,35
217165,30,3193,2038,1155,3170,2020,1150,23,18,5
217235,30,4135,1602,2533,3940,1506,2434,195,96,99
217305,30,1720,1054,666,1537,961,576,183,93,90
217323,30,276,267,9,276,267,9,,,
217402,30,3959,1818,2141,3827,1758,2069,132,60,72
217420,30,4596,1430,3166,3680,1152,2528,916,278,638
217475,30,11271,4498,6773,4789,2147,2642,6482,2351,4131
217484,30,13828,5904,7924,12900,5481,7419,928,423,505
217493,30,2108,691,1417,2108,691,1417,,,
217518,30,3971,1982,1989,3697,1828,1869,274,154,120
217536,30,2174,676,1498,2116,660,1456,58,16,42
217581,30,135,1,134,91,1,90,44,0,44
217606,30,181,91,90,134,65,69,47,26,21
217615,30,1857,642,1215,695,268,427,1162,374,788
217624,30,603,344,259,576,331,245,27,13,14
217633,30,2960,978,1982,2849,942,1907,111,36,75
217688,30,2771,1006,1765,2583,928,1655,188,78,110
217712,30,1709,484,1225,419,163,256,1290,321,969
217721,30,1726,765,961,1708,756,952,18,9,9
217749,30,2374,1079,1295,2255,1033,1222,119,46,73
217776,30,798,295,503,640,260,380,158,35,123
217794,30,101,1,100,65,1,64,36,0,36
217819,30,9667,3168,6499,9148,2941,6207,519,227,292
217828,30,43,2,41,28,1,27,15,1,14
217837,30,943,246,697,228,71,157,715,175,540
217864,30,2658,2276,382,2469,2137,332,189,139,50
217873,30,1730,540,1190,1618,493,1125,112,47,65
217882,30,22467,10667,11800,21714,10225,11489,753,442,311
217891,30,197,86,111,192,84,108,5,2,3
217907,30,773,337,436,747,329,418,26,8,18
217925,30,775,392,383,562,298,264,213,94,119
217934,30,1136,187,949,788,128,660,348,59,289
217961,30,804,169,635,781,168,613,23,1,22
217989,30,408,184,224,299,143,156,109,41,68
217998,30,817,540,277,764,501,263,53,39,14
218025,30,2448,887,1561,1086,511,575,1362,376,986
218061,30,2684,942,1742,2537,885,1652,147,57,90
218070,30,2278,942,1336,2259,928,1331,19,14,5
218113,30,8878,3484,5394,4119,1788,2331,4759,1696,3063
218140,30,6781,2314,4467,3425,1427,1998,3356,887,2469
218159,30,113,4,109,83,3,80,30,1,29
218195,30,124,5,119,74,4,70,50,1,49
218229,30,3360,1083,2277,3193,1033,2160,167,50,117
218238,30,1551,767,784,1305,669,636,246,98,148
218335,30,300,32,268,290,31,259,10,1,9
218353,30,7798,2944,4854,3579,1618,1961,4219,1326,2893
218399,30,384,182,202,380,178,202,4,4,0
218414,30,1292,712,580,1264,704,560,28,8,20
218441,30,1651,795,856,1573,761,812,78,34,44
218487,30,1403,356,1047,524,203,321,879,153,726
218520,30,4355,1264,3091,1581,584,997,2774,680,2094
218539,30,877,440,437,873,439,434,4,1,3
218645,30,2817,1038,1779,2382,904,1478,435,134,301
218654,30,1885,606,1279,1663,531,1132,222,75,147
218663,30,26840,11706,15134,25960,11235,14725,880,471,409
218672,30,648,269,379,585,249,336,63,20,43
218681,30,293,144,149,251,131,120,42,13,29
218690,30,563,295,268,427,222,205,136,73,63
218706,30,253,132,121,224,116,108,29,16,13
218724,30,9495,4259,5236,8989,3997,4992,506,262,244
218733,30,2351,1090,1261,2114,965,1149,237,125,112
218742,30,4046,1349,2697,3514,1147,2367,532,202,330
218821,30,1063,487,576,958,441,517,105,46,59
218830,30,4936,1907,3029,2343,997,1346,2593,910,1683
218858,30,2675,768,1907,829,343,486,1846,425,1421
218885,30,4838,2273,2565,3139,1656,1483,1699,617,1082
218894,30,9194,3418,5776,3608,1490,2118,5586,1928,3658
218919,30,473,211,262,418,184,234,55,27,28
218955,30,413,76,337,105,24,81,308,52,256
218964,30,3376,1136,2240,3173,1063,2110,203,73,130
218973,30,1823,870,953,1807,860,947,16,10,6
218991,30,3494,1387,2107,1687,776,911,1807,611,1196
219000,30,1759,665,1094,1724,649,1075,35,16,19
219037,30,62,1,61,57,0,57,5,1,4
219046,30,1933,631,1302,1559,528,1031,374,103,271
219082,30,1894,1330,564,1372,991,381,522,339,183
219091,30,632,314,318,577,303,274,55,11,44
219125,30,76,4,72,65,2,63,11,2,9
219143,30,1806,938,868,1517,873,644,289,65,224
219170,30,23,3,20,23,3,20,,,
219189,30,996,663,333,844,592,252,152,71,81
219198,30,693,360,333,616,313,303,77,47,30
219204,30,922,425,497,98,60,38,824,365,459
219240,30,38,19,19,11,5,6,27,14,13
219259,30,1258,526,732,1017,442,575,241,84,157
219277,30,1109,328,781,485,164,321,624,164,460
219295,30,586,224,362,386,201,185,200,23,177
219338,30,15,3,12,15,3,12,,,
219347,30,2047,1583,464,1721,1348,373,326,235,91
219356,30,8627,3975,4652,7582,3562,4020,1045,413,632
219374,30,447,99,348,156,38,118,291,61,230
219383,30,1299,492,807,1172,434,738,127,58,69
219392,30,27,4,23,27,4,23,,,
219408,30,172,68,104,105,49,56,67,19,48
219426,30,2129,1009,1120,1281,754,527,848,255,593
219453,30,125,1,124,125,1,124,,,
219471,30,5265,1885,3380,4500,1615,2885,765,270,495
219480,30,757,341,416,523,273,250,234,68,166
219505,30,52,34,18,37,24,13,15,10,5
219587,30,70,0,70,70,0,70,,,
219596,30,221,162,59,221,162,59,,,
219602,30,7054,2889,4165,5272,2089,3183,1782,800,982
219639,30,777,67,710,303,30,273,474,37,437
219709,30,7349,2467,4882,7087,2347,4740,262,120,142
219718,30,2906,1527,1379,2376,1280,1096,530,247,283
219790,30,882,429,453,756,384,372,126,45,81
219806,30,1426,626,800,1402,613,789,24,13,11
219824,30,4690,1678,3012,2877,1103,1774,1813,575,1238
219833,30,1032,467,565,986,445,541,46,22,24
219851,30,59,2,57,59,2,57,,,
219879,30,2042,886,1156,1441,641,800,601,245,356
219888,30,3661,1379,2282,2485,1022,1463,1176,357,819
219903,30,1317,116,1201,1317,116,1201,,,
219921,30,256,156,100,177,101,76,79,55,24
219949,30,1934,820,1114,1834,790,1044,100,30,70
219976,30,2950,1152,1798,2791,1088,1703,159,64,95
219994,30,656,413,243,619,378,241,37,35,2
220002,30,33,5,28,33,5,28,,,
220057,30,1863,534,1329,1080,388,692,783,146,637
220075,30,9772,3801,5971,8451,3319,5132,1321,482,839
220118,30,220,13,207,220,13,207,,,
220127,30,440,253,187,412,228,184,28,25,3
220163,30,72,2,70,53,2,51,19,0,19
220181,30,1009,332,677,983,323,660,26,9,17
220206,30,247,138,109,194,104,90,53,34,19
220215,30,1384,625,759,1339,610,729,45,15,30
220251,30,200,123,77,161,104,57,39,19,20
220279,30,256,187,69,196,136,60,60,51,9
220321,30,350,178,172,300,162,138,50,16,34
220394,30,236,147,89,233,144,89,3,3,0
220400,30,2419,719,1700,1205,408,797,1214,311,903
220464,30,196,76,120,59,22,37,137,54,83
220473,30,668,313,355,604,279,325,64,34,30
220491,30,261,8,253,181,6,175,80,2,78
220516,30,1065,395,670,973,370,603,92,25,67
220552,30,4855,662,4193,3377,474,2903,1478,188,1290
220598,30,1010,566,444,954,539,415,56,27,29
220604,30,605,215,390,534,187,347,71,28,43
220613,30,2932,1132,1800,2671,997,1674,261,135,126
220631,30,1461,429,1032,1206,401,805,255,28,227
220640,30,359,200,159,313,159,154,46,41,5
220701,30,787,326,461,749,313,436,38,13,25
220710,30,977,447,530,968,443,525,9,4,5
220756,30,103,91,12,98,87,11,5,4,1
220765,30,346,82,264,181,46,135,165,36,129
220853,30,1011,698,313,853,580,273,158,118,40
220862,30,14181,5581,8600,10912,4365,6547,3269,1216,2053
220978,30,16239,7672,8567,13844,6559,7285,2395,1113,1282
221050,30,624,444,180,518,359,159,106,85,21
221096,30,4047,1535,2512,2712,1129,1583,1335,406,929
221102,30,332,268,64,214,176,38,118,92,26
221148,30,1053,968,85,1053,968,85,,,
221184,30,5020,1857,3163,2597,1069,1528,2423,788,1635
221236,30,280,180,100,216,154,62,64,26,38
221281,30,170,75,95,164,74,90,6,1,5
221333,30,278,181,97,183,111,72,95,70,25
221351,30,1966,817,1149,1927,808,1119,39,9,30
221388,30,167,54,113,137,40,97,30,14,16
221397,30,3075,1061,2014,1998,774,1224,1077,287,790
221430,30,346,236,110,242,168,74,104,68,36
221485,30,4928,1667,3261,2536,961,1575,2392,706,1686
221494,30,432,338,94,371,298,73,61,40,21
221519,30,1599,755,844,1590,752,838,9,3,6
221582,30,159,113,46,138,97,41,21,16,5
221591,30,352,240,112,309,209,100,43,31,12
221607,30,257,168,89,192,118,74,65,50,15
221616,30,540,370,170,502,351,151,38,19,19
221625,30,764,485,279,736,464,272,28,21,7
221643,30,6316,3111,3205,3906,1981,1925,2410,1130,1280
221661,30,2439,1113,1326,2185,1023,1162,254,90,164
221731,30,906,348,558,834,322,512,72,26,46
221740,30,9820,4139,5681,8879,3687,5192,941,452,489
221759,30,26905,12270,14635,25798,11679,14119,1107,591,516
221768,30,4629,1773,2856,4259,1627,2632,370,146,224
221829,30,342,12,330,342,12,330,,,
221838,30,7346,2501,4845,6680,2256,4424,666,245,421
221847,30,8341,4537,3804,7714,4206,3508,627,331,296
221892,30,1738,660,1078,1419,564,855,319,96,223
221908,30,4104,1955,2149,2516,1106,1410,1588,849,739
221953,30,981,502,479,888,469,419,93,33,60
221971,30,1731,636,1095,1540,555,985,191,81,110
221999,30,7144,3441,3703,7078,3401,3677,66,40,26
222053,30,5331,2036,3295,3403,1378,2025,1928,658,1270
222062,30,3585,1316,2269,2508,992,1516,1077,324,753
222105,30,354,332,22,172,165,7,182,167,15
222178,30,3141,1199,1942,3055,1163,1892,86,36,50
222567,30,3151,1326,1825,810,370,440,2341,956,1385
222576,30,7271,2526,4745,3327,1343,1984,3944,1183,2761
222628,30,114,39,75,26,7,19,88,32,56
222822,30,2453,808,1645,1334,485,849,1119,323,796
222831,30,5314,2272,3042,4743,2005,2738,571,267,304
222877,30,216,136,80,214,135,79,2,1,1
222886,30,375,23,352,373,23,350,2,0,2
222938,30,317,148,169,212,102,110,105,46,59
222983,30,1166,579,587,1164,577,587,2,2,0
222992,30,25332,10789,14543,7131,3447,3684,18201,7342,10859
223056,30,44,0,44,44,0,44,,,
223083,30,457,66,391,124,23,101,333,43,290
223117,30,53,42,11,5,4,1,48,38,10
223232,30,15134,6123,9011,14885,6008,8877,249,115,134
223320,30,2236,679,1557,743,269,474,1493,410,1083
223427,30,15721,7844,7877,8661,4508,4153,7060,3336,3724
223463,30,302,67,235,302,67,235,,,
223472,30,175,16,159,175,16,159,,,
223506,30,2898,1328,1570,728,324,404,2170,1004,1166
223816,30,4818,2092,2726,923,352,571,3895,1740,2155
223852,30,22,1,21,22,1,21,,,
223898,30,2797,1039,1758,1026,397,629,1771,642,1129
223922,30,1319,583,736,538,248,290,781,335,446
224004,30,1571,484,1087,1333,425,908,238,59,179
224013,30,38,2,36,38,2,36,,,
224110,30,5457,2272,3185,1778,779,999,3679,1493,2186
224147,30,7818,3090,4728,6012,2360,3652,1806,730,1076
224156,30,275,6,269,202,4,198,73,2,71
224226,30,2674,1108,1566,2310,952,1358,364,156,208
224244,30,245,150,95,220,138,82,25,12,13
224271,30,776,189,587,772,185,587,4,4,0
224323,30,1446,640,806,1423,630,793,23,10,13
224350,30,9104,3757,5347,1299,600,699,7805,3157,4648
224527,30,1324,646,678,1232,614,618,92,32,60
224545,30,1758,683,1075,1361,560,801,397,123,274
224554,30,7317,2918,4399,5324,2108,3216,1993,810,1183
224615,30,34709,13840,20869,9785,4481,5304,24924,9359,15565
224642,30,24129,10249,13880,6808,3043,3765,17321,7206,10115
224660,30,608,308,300,484,256,228,124,52,72
224679,30,1328,1140,188,707,588,119,621,552,69
224758,30,28,1,27,25,0,25,3,1,2
224776,30,263,122,141,173,82,91,90,40,50
224828,30,72,1,71,48,1,47,24,0,24
224891,30,726,280,446,491,206,285,235,74,161
224961,30,1522,483,1039,530,216,314,992,267,725
225043,30,11,10,1,11,10,1,,,
225070,30,2707,984,1723,1234,469,765,1473,515,958
225201,30,792,513,279,792,513,279,,,
225247,30,1323,634,689,1262,606,656,61,28,33
225308,30,4591,1829,2762,1413,549,864,3178,1280,1898
225371,30,1925,704,1221,920,405,515,1005,299,706
225399,30,2814,1040,1774,2152,825,1327,662,215,447
225414,30,6343,2349,3994,3195,1220,1975,3148,1129,2019
225423,30,37871,15145,22726,12821,5662,7159,25050,9483,15567
225432,30,12752,4731,8021,6132,2392,3740,6620,2339,4281
225502,30,2699,962,1737,1266,512,754,1433,450,983
225511,30,37080,17842,19238,27063,12597,14466,10017,5245,4772
225520,30,1652,487,1165,915,307,608,737,180,557
225548,30,721,391,330,659,365,294,62,26,36
225575,30,991,429,562,939,410,529,52,19,33
225627,30,4547,1621,2926,3940,1384,2556,607,237,370
225876,30,210,108,102,190,104,86,20,4,16
225885,30,729,340,389,632,303,329,97,37,60
225991,30,102,57,45,102,57,45,,,
226019,30,3183,1244,1939,1877,804,1073,1306,440,866
226091,30,8075,3296,4779,6155,2474,3681,1920,822,1098
226107,30,1446,414,1032,702,236,466,744,178,566
226116,30,2567,951,1616,702,248,454,1865,703,1162
226125,30,122,6,116,122,6,116,,,
226134,30,7564,3134,4430,1884,787,1097,5680,2347,3333
226152,30,6459,2448,4011,5246,2028,3218,1213,420,793
226204,30,7726,3894,3832,1014,546,468,6712,3348,3364
226231,30,1553,965,588,1300,867,433,253,98,155
226277,30,1212,1115,97,1212,1115,97,,,
226383,30,1221,453,768,1135,425,710,86,28,58
226408,30,3161,1203,1958,946,419,527,2215,784,1431
226471,30,3013,1066,1947,2822,996,1826,191,70,121
226578,30,4979,1465,3514,2184,753,1431,2795,712,2083
226587,30,1092,578,514,1004,546,458,88,32,56
226675,30,336,47,289,336,47,289,,,
226806,30,4737,1921,2816,1242,469,773,3495,1452,2043
226833,30,4421,1602,2819,3325,1280,2045,1096,322,774
226860,30,39,2,37,39,2,37,,,
226879,30,157,21,136,62,9,53,95,12,83
226903,30,1070,429,641,1070,429,641,,,
227058,30,57,0,57,57,0,57,,,
227146,30,6277,2427,3850,2314,1014,1300,3963,1413,2550
227182,30,47486,19176,28310,16191,7464,8727,31295,11712,19583
227216,30,33023,15129,17894,26003,11755,14248,7020,3374,3646
227225,30,1932,599,1333,1031,348,683,901,251,650
227298,30,176,165,11,176,165,11,,,
227304,30,4296,1462,2834,2170,788,1382,2126,674,1452
227313,30,324,6,318,145,4,141,179,2,177
227322,30,446,6,440,202,4,198,244,2,242
227331,30,1163,390,773,1033,361,672,130,29,101
227368,30,26420,10762,15658,19656,7778,11878,6764,2984,3780
227377,30,3644,1612,2032,1535,723,812,2109,889,1220
227386,30,1489,402,1087,844,289,555,645,113,532
227401,30,2339,828,1511,1328,548,780,1011,280,731
227429,30,938,301,637,320,144,176,618,157,461
227526,30,8103,2613,5490,7163,2266,4897,940,347,593
227687,30,2104,970,1134,709,369,340,1395,601,794
227748,30,250,234,16,172,161,11,78,73,5
227757,30,4480,2291,2189,4380,2236,2144,100,55,45
227845,30,2751,1048,1703,2602,987,1615,149,61,88
227854,30,9344,3681,5663,1341,684,657,8003,2997,5006
227863,30,2524,1028,1496,2164,819,1345,360,209,151
227881,30,18184,6642,11542,14573,5306,9267,3611,1336,2275
227924,30,15568,5872,9696,3620,1425,2195,11948,4447,7501
227979,30,22790,9362,13428,8012,3476,4536,14778,5886,8892
228042,30,1056,472,584,1019,460,559,37,12,25
228088,30,50,0,50,50,0,50,,,
228149,30,1991,789,1202,1931,765,1166,60,24,36
228158,30,6378,2540,3838,3735,1676,2059,2643,864,1779
228185,30,18,14,4,18,14,4,,,
228200,30,409,182,227,383,170,213,26,12,14
228219,30,482,194,288,475,193,282,7,1,6
228246,30,7044,3476,3568,6880,3383,3497,164,93,71
228282,30,18,4,14,18,4,14,,,
228316,30,3099,1167,1932,1489,578,911,1610,589,1021
228325,30,1435,713,722,1276,644,632,159,69,90
228343,30,1480,685,795,1462,677,785,18,8,10
228431,30,8961,3280,5681,7832,2871,4961,1129,409,720
228459,30,33834,13586,20248,27759,10984,16775,6075,2602,3473
228468,30,659,271,388,594,244,350,65,27,38
228486,30,84,51,33,79,50,29,5,1,4
228501,30,1495,630,865,914,477,437,581,153,428
228529,30,11880,4370,7510,8745,3128,5617,3135,1242,1893
228547,30,38915,16218,22697,7129,3343,3786,31786,12875,18911
228608,30,3198,1002,2196,1328,453,875,1870,549,1321
228644,30,785,222,563,672,169,503,113,53,60
228653,30,585,105,480,439,75,364,146,30,116
228699,30,1635,537,1098,678,278,400,957,259,698
228705,30,4562,2264,2298,3904,1955,1949,658,309,349
228723,30,56792,30107,26685,51043,26902,24141,5749,3205,2544
228769,30,30503,12147,18356,18867,8341,10526,11636,3806,7830
228778,30,40980,17447,23533,38444,16167,22277,2536,1280,1256
228787,30,21586,12182,9404,17938,9992,7946,3648,2190,1458
228796,30,20123,9021,11102,13675,6053,7622,6448,2968,3480
228802,30,6568,2500,4068,4594,1801,2793,1974,699,1275
228875,30,10510,4027,6483,10326,3939,6387,184,88,96
228884,30,642,382,260,592,357,235,50,25,25
228909,30,5,3,2,,,,5,3,2
228981,30,1307,628,679,1265,604,661,42,24,18
229018,30,4060,1572,2488,3073,1184,1889,987,388,599
229027,30,29112,13903,15209,21738,10077,11661,7374,3826,3548
229063,30,6830,2383,4447,5684,1967,3717,1146,416,730
229115,30,32346,16441,15905,29075,14705,14370,3271,1736,1535
229160,30,1549,730,819,1408,684,724,141,46,95
229179,30,8876,747,8129,6602,529,6073,2274,218,2056
229267,30,2491,1162,1329,2462,1148,1314,29,14,15
229300,30,554,75,479,473,67,406,81,8,73
229337,30,1448,191,1257,1243,158,1085,205,33,172
229355,30,9045,3272,5773,4651,1864,2787,4394,1408,2986
229416,30,1845,1752,93,1845,1752,93,,,
229425,30,124,4,120,40,1,39,84,3,81
229504,30,1937,668,1269,566,244,322,1371,424,947
229522,30,94,8,86,78,5,73,16,3,13
229540,30,2346,728,1618,736,322,414,1610,406,1204
229656,30,305,11,294,133,4,129,172,7,165
229780,30,2138,1027,1111,1301,646,655,837,381,456
229799,30,3604,1152,2452,1251,456,795,2353,696,1657
229814,30,6828,2797,4031,5316,2173,3143,1512,624,888
229832,30,487,276,211,327,182,145,160,94,66
229841,30,4757,2019,2738,2242,1078,1164,2515,941,1574
229887,30,698,343,355,652,333,319,46,10,36
230010,30,1271,813,458,507,267,240,764,546,218
230038,30,31411,15082,16329,28254,13555,14699,3157,1527,1630
230047,30,2716,1100,1616,2586,1053,1533,130,47,83
230065,30,298,6,292,108,4,104,190,2,188
230144,30,88,1,87,88,1,87,,,
230162,30,2272,1413,859,419,169,250,1853,1244,609
230171,30,8606,3498,5108,6977,2784,4193,1629,714,915
230199,30,69,4,65,69,4,65,,,
230205,30,66,5,61,50,2,48,16,3,13
230214,30,328,47,281,110,10,100,218,37,181
230366,30,248,26,222,248,26,222,,,
230418,30,4047,1876,2171,1157,614,543,2890,1262,1628
230490,30,1925,1111,814,272,85,187,1653,1026,627
230597,30,3654,1702,1952,3165,1500,1665,489,202,287
230603,30,9089,3938,5151,7820,3331,4489,1269,607,662
230676,30,286,186,100,107,64,43,179,122,57
230728,30,20573,9304,11269,16564,7565,8999,4009,1739,2270
230737,30,26961,14127,12834,17219,9010,8209,9742,5117,4625
230746,30,17290,8006,9284,5220,2488,2732,12070,5518,6552
230764,30,25392,13146,12246,21189,10979,10210,4203,2167,2036
230782,30,15540,6575,8965,10118,4372,5746,5422,2203,3219
230807,30,955,376,579,918,356,562,37,20,17
230816,30,733,241,492,708,217,491,25,24,1
230834,30,1585,731,854,1416,670,746,169,61,108
230852,30,3031,1868,1163,2255,1399,856,776,469,307
230861,30,3219,841,2378,562,208,354,2657,633,2024
230889,30,105,33,72,84,27,57,21,6,15
230913,30,1266,462,804,890,371,519,376,91,285
230959,30,2751,1286,1465,2736,1280,1456,15,6,9
230995,30,2706,1977,729,2241,1574,667,465,403,62
231004,30,70,2,68,70,2,68,,,
231059,30,1200,565,635,1190,557,633,10,8,2
231095,30,86,34,52,81,31,50,5,3,2
231165,30,1112,492,620,681,354,327,431,138,293
231174,30,11326,4115,7211,11061,3986,7075,265,129,136
231280,30,106,3,103,83,3,80,23,0,23
231411,30,459,408,51,459,408,51,,,
231420,30,1121,590,531,1018,545,473,103,45,58
231536,30,2624,1049,1575,1023,460,563,1601,589,1012
231554,30,615,330,285,566,313,253,49,17,32
231581,30,1379,664,715,1377,664,713,2,0,2
231624,30,6778,2827,3951,6711,2792,3919,67,35,32
231651,30,4281,1651,2630,2372,945,1427,1909,706,1203
231688,30,21,2,19,12,1,11,9,1,8
231697,30,2040,802,1238,639,300,339,1401,502,899
231712,30,4442,2065,2377,4346,2012,2334,96,53,43
231785,30,1269,251,1018,700,205,495,569,46,523
231873,30,448,176,272,255,123,132,193,53,140
231882,30,1290,486,804,697,328,369,593,158,435
232016,30,109,40,69,73,34,39,36,6,30
232025,30,1080,531,549,1058,520,538,22,11,11
232043,30,826,343,483,783,318,465,43,25,18
232052,30,409,147,262,138,47,91,271,100,171
232089,30,780,472,308,747,453,294,33,19,14
232186,30,26447,13489,12958,21367,10783,10584,5080,2706,2374
232195,30,5183,1827,3356,1891,785,1106,3292,1042,2250
232256,30,846,843,3,838,835,3,8,8,0
232265,30,2846,985,1861,2648,874,1774,198,111,87
232308,30,689,0,689,688,0,688,1,0,1
232414,30,5272,2005,3267,1716,755,961,3556,1250,2306
232423,30,19968,8548,11420,18923,8075,10848,1045,473,572
232450,30,5438,2258,3180,1872,849,1023,3566,1409,2157
232557,30,48408,21068,27340,30988,13116,17872,17420,7952,9468
232566,30,3009,926,2083,2869,878,1991,140,48,92
232575,30,3111,1055,2056,1172,503,669,1939,552,1387
232609,30,1543,578,965,1507,564,943,36,14,22
232618,30,227,30,197,26,1,25,201,29,172
232672,30,1298,289,1009,1085,258,827,213,31,182
232681,30,3443,1292,2151,2969,1123,1846,474,169,305
232706,30,1764,629,1135,1643,580,1063,121,49,72
232724,30,23,1,22,23,1,22,,,
232788,30,1148,398,750,661,260,401,487,138,349
232797,30,950,123,827,300,50,250,650,73,577
232867,30,1888,957,931,1020,580,440,868,377,491
232885,30,241,13,228,217,10,207,24,3,21
232919,30,454,395,59,371,321,50,83,74,9
232937,30,5328,1734,3594,4618,1524,3094,710,210,500
232946,30,32211,15661,16550,12533,6476,6057,19678,9185,10493
232982,30,18152,8173,9979,13868,6267,7601,4284,1906,2378
233019,30,1383,590,793,844,402,442,539,188,351
233037,30,591,182,409,251,104,147,340,78,262
233082,30,103,8,95,8,1,7,95,7,88
233116,30,2954,1167,1787,846,401,445,2108,766,1342
233277,30,5945,2226,3719,5478,2067,3411,467,159,308
233286,30,116,18,98,99,17,82,17,1,16
233295,30,1476,669,807,1442,649,793,34,20,14
233301,30,461,181,280,457,177,280,4,4,0
233310,30,1275,390,885,365,148,217,910,242,668
233329,30,410,31,379,410,31,379,,,
233338,30,728,334,394,608,289,319,120,45,75
233356,30,481,39,442,382,29,353,99,10,89
233374,30,3069,1419,1650,2953,1368,1585,116,51,65
233408,30,338,41,297,271,38,233,67,3,64
233426,30,1801,827,974,1747,799,948,54,28,26
233480,30,27,6,21,27,6,21,,,
233541,30,2104,874,1230,2036,850,1186,68,24,44
233602,30,74,45,29,65,39,26,9,6,3
233611,30,1053,554,499,1010,531,479,43,23,20
233639,30,1695,501,1194,512,118,394,1183,383,800
233648,30,1528,545,983,930,381,549,598,164,434
233666,30,22,1,21,17,1,16,5,0,5
233684,30,2197,744,1453,403,255,148,1794,489,1305
233718,30,451,0,451,450,0,450,1,0,1
233754,30,4227,1688,2539,1620,745,875,2607,943,1664
233772,30,12161,4858,7303,4585,1927,2658,7576,2931,4645
233897,30,993,490,503,966,473,493,27,17,10
233903,30,1350,502,848,633,291,342,717,211,506
233921,30,30339,17334,13005,29504,16778,12726,835,556,279
233949,30,3681,1492,2189,1551,687,864,2130,805,1325
234030,30,20552,7498,13054,18205,6518,11687,2347,980,1367
234076,30,17103,7482,9621,16452,7189,9263,651,293,358
234085,30,1512,1310,202,1512,1310,202,,,
234119,30,116,45,71,82,29,53,34,16,18
234137,30,479,213,266,400,151,249,79,62,17
234155,30,4295,1735,2560,4087,1654,2433,208,81,127
234164,30,1297,644,653,1072,544,528,225,100,125
234173,30,1154,479,675,1077,450,627,77,29,48
234207,30,1861,914,947,1856,911,945,5,3,2
234377,30,1145,329,816,548,195,353,597,134,463
234669,30,7823,3473,4350,4388,2015,2373,3435,1458,1977
234696,30,1543,764,779,1048,595,453,495,169,326
234711,30,1645,682,963,1199,514,685,446,168,278
234827,30,8650,4105,4545,7580,3610,3970,1070,495,575
234845,30,1661,657,1004,1213,475,738,448,182,266
234915,30,1077,448,629,147,61,86,930,387,543
234924,30,261,30,231,261,30,231,,,
234933,30,5441,2113,3328,3201,1288,1913,2240,825,1415
234951,30,2382,858,1524,1566,679,887,816,179,637
234979,30,5104,1965,3139,3234,1312,1922,1870,653,1217
235024,30,416,150,266,407,147,260,9,3,6
235088,30,231,219,12,231,219,12,,,
235097,30,6938,3033,3905,6250,2687,3563,688,346,342
235103,30,3749,1734,2015,1938,975,963,1811,759,1052
235149,30,5370,2269,3101,2804,1259,1545,2566,1010,1556
235167,30,1799,688,1111,1649,630,1019,150,58,92
235237,30,6309,2291,4018,4157,1513,2644,2152,778,1374
235307,30,100,5,95,100,5,95,,,
235316,30,5018,2320,2698,4957,2285,2672,61,35,26
235334,30,1220,508,712,824,355,469,396,153,243
235343,30,5518,2577,2941,3389,1645,1744,2129,932,1197
235352,30,88,13,75,88,13,75,,,
235422,30,796,198,598,708,176,532,88,22,66
235431,30,4318,1603,2715,2431,926,1505,1887,677,1210
235501,30,133,57,76,133,57,76,,,
235547,30,74,10,64,43,5,38,31,5,26
235583,30,35,0,35,35,0,35,,,
235671,30,1910,1270,640,1533,1138,395,377,132,245
235699,30,2237,942,1295,1402,688,714,835,254,581
235750,30,2121,613,1508,1206,402,804,915,211,704
236018,30,39,4,35,39,4,35,,,
236072,30,2744,1093,1651,1203,574,629,1541,519,1022
236133,30,662,231,431,646,225,421,16,6,10
236188,30,4016,1657,2359,2398,934,1464,1618,723,895
236212,30,879,740,139,879,740,139,,,
236230,30,2253,830,1423,2184,798,1386,69,32,37
236258,30,1105,396,709,635,222,413,470,174,296
236328,30,1712,727,985,1674,712,962,38,15,23
236382,30,1600,857,743,857,435,422,743,422,321
236452,30,1344,540,804,1256,500,756,88,40,48
236504,30,1660,921,739,1025,602,423,635,319,316
236513,30,3498,1509,1989,2322,1024,1298,1176,485,691
236577,30,2409,783,1626,2332,750,1582,77,33,44
236595,30,4033,1581,2452,3873,1513,2360,160,68,92
236610,30,3566,1456,2110,1716,817,899,1850,639,1211
236638,30,2763,1079,1684,1799,761,1038,964,318,646
236656,30,3611,1392,2219,2182,916,1266,1429,476,953
236692,30,4515,1789,2726,3194,1338,1856,1321,451,870
236708,30,3638,1477,2161,2559,1071,1488,1079,406,673
236744,30,39,1,38,39,1,38,,,
236753,30,5113,1837,3276,3230,1256,1974,1883,581,1302
236887,30,2260,1136,1124,1427,687,740,833,449,384
236896,30,1234,632,602,1174,605,569,60,27,33
236939,30,22265,10454,11811,19735,9371,10364,2530,1083,1447
236948,30,30931,13366,17565,28978,12422,16556,1953,944,1009
236975,30,2308,829,1479,1708,648,1060,600,181,419
237011,30,13686,5856,7830,12157,5046,7111,1529,810,719
237039,30,2821,1258,1563,1521,707,814,1300,551,749
237057,30,1472,641,831,1449,628,821,23,13,10
237066,30,2037,857,1180,1992,832,1160,45,25,20
237109,30,3241,913,2328,2114,641,1473,1127,272,855
237118,30,633,386,247,613,382,231,20,4,16
237127,30,39,0,39,39,0,39,,,
237136,30,182,102,80,154,78,76,28,24,4
237145,30,15,0,15,15,0,15,,,
237172,30,65,43,22,51,37,14,14,6,8
237181,30,594,333,261,593,333,260,1,0,1
237215,30,1244,505,739,965,406,559,279,99,180
237242,30,41,40,1,34,33,1,7,7,0
237303,30,55,26,29,55,26,29,,,
237312,30,2330,1419,911,1307,660,647,1023,759,264
237321,30,61,5,56,61,5,56,,,
237330,30,1311,553,758,1240,524,716,71,29,42
237358,30,644,263,381,636,263,373,8,0,8
237367,30,2776,1190,1586,2352,1067,1285,424,123,301
237385,30,1257,694,563,955,466,489,302,228,74
237437,30,144,20,124,129,20,109,15,0,15
237473,30,101,71,30,101,71,30,,,
237491,30,18,3,15,18,3,15,,,
237525,30,6965,2957,4008,6304,2679,3625,661,278,383
237543,30,122,30,92,80,17,63,42,13,29
237561,30,47,19,28,47,19,28,,,
237570,30,79,1,78,79,1,78,,,
237598,30,20,3,17,20,3,17,,,
237686,30,1486,529,957,927,347,580,559,182,377
237701,30,954,425,529,882,395,487,72,30,42
237729,30,130,36,94,97,16,81,33,20,13
237783,30,756,348,408,670,305,365,86,43,43
237792,30,2325,903,1422,2095,805,1290,230,98,132
237817,30,1093,318,775,758,229,529,335,89,246
237844,30,86,43,43,86,43,43,,,
237899,30,1362,604,758,1215,543,672,147,61,86
237905,30,55,12,43,55,12,43,,,
237932,30,1648,620,1028,1567,596,971,81,24,57
237950,30,1038,614,424,971,576,395,67,38,29
237969,30,886,428,458,877,421,456,9,7,2
237987,30,225,31,194,225,31,194,,,
237996,30,525,88,437,525,88,437,,,
238005,30,79,6,73,79,6,73,,,
238014,30,868,302,566,528,219,309,340,83,257
238032,30,18370,8924,9446,17543,8514,9029,827,410,417
238078,30,578,351,227,490,315,175,88,36,52
238096,30,30,2,28,30,2,28,,,
238175,30,113,1,112,113,1,112,,,
238193,30,717,11,706,585,3,582,132,8,124
238263,30,8572,3676,4896,2971,1524,1447,5601,2152,3449
238324,30,346,30,316,263,20,243,83,10,73
238333,30,921,440,481,921,440,481,,,
238397,30,2273,812,1461,642,266,376,1631,546,1085
238430,30,526,197,329,418,160,258,108,37,71
238458,30,2689,875,1814,2581,831,1750,108,44,64
238476,30,2541,1124,1417,2481,1101,1380,60,23,37
238616,30,2556,948,1608,1959,780,1179,597,168,429
238661,30,1127,361,766,1037,335,702,90,26,64
238722,30,5525,3021,2504,1775,986,789,3750,2035,1715
238759,30,4566,1842,2724,1039,517,522,3527,1325,2202
238810,30,66,5,61,44,3,41,22,2,20
238980,30,1281,555,726,754,375,379,527,180,347
239008,30,1747,851,896,404,214,190,1343,637,706
239017,30,1411,651,760,1394,642,752,17,9,8
239071,30,571,233,338,467,189,278,104,44,60
239080,30,1058,357,701,920,324,596,138,33,105
239105,30,7290,3215,4075,7160,3150,4010,130,65,65
239220,30,2035,945,1090,579,309,270,1456,636,820
239248,30,11082,4552,6530,3089,1497,1592,7993,3055,4938
239309,30,895,193,702,882,188,694,13,5,8
239318,30,2562,1845,717,2514,1806,708,48,39,9
239372,30,2269,901,1368,799,383,416,1470,518,952
239390,30,640,0,640,615,0,615,25,0,25
239442,30,738,232,506,179,68,111,559,164,395
239460,30,2958,1112,1846,991,446,545,1967,666,1301
239488,30,6966,2838,4128,2104,1093,1011,4862,1745,3117
239512,30,508,239,269,502,239,263,6,0,6
239628,30,754,387,367,754,387,367,,,
239716,30,1784,775,1009,1773,768,1005,11,7,4
239877,30,39,1,38,32,1,31,7,0,7
239910,30,1381,479,902,672,305,367,709,174,535
240107,30,1456,350,1106,1203,307,896,253,43,210
240116,30,4074,1546,2528,1939,907,1032,2135,639,1496
240125,30,4180,2512,1668,1526,867,659,2654,1645,1009
240170,30,3507,1578,1929,1544,830,714,1963,748,1215
240189,30,8893,4578,4315,8029,4175,3854,864,403,461
240198,30,2092,791,1301,835,380,455,1257,411,846
240268,30,9138,3641,5497,8497,3411,5086,641,230,411
240277,30,6305,2334,3971,4825,1837,2988,1480,497,983
240329,30,9137,3952,5185,8725,3710,5015,412,242,170
240338,30,990,447,543,964,435,529,26,12,14
240365,30,7812,3321,4491,6685,2767,3918,1127,554,573
240374,30,2969,1315,1654,2391,1075,1316,578,240,338
240392,30,1783,296,1487,691,119,572,1092,177,915
240417,30,6176,3550,2626,5089,2974,2115,1087,576,511
240426,30,2021,729,1292,1594,613,981,427,116,311
240444,30,35184,16507,18677,33547,15600,17947,1637,907,730
240453,30,17076,7850,9226,14747,6709,8038,2329,1141,1188
240462,30,5920,3739,2181,5318,3325,1993,602,414,188
240471,30,4327,1520,2807,3957,1368,2589,370,152,218
240480,30,6995,3046,3949,6287,2778,3509,708,268,440
240505,30,2222,835,1387,1400,583,817,822,252,570
240514,30,987,418,569,534,214,320,453,204,249
240596,30,509,178,331,376,144,232,133,34,99
240620,30,2394,841,1553,1343,528,815,1051,313,738
240657,30,889,365,524,616,283,333,273,82,191
240666,30,1700,693,1007,1101,478,623,599,215,384
240693,30,1239,511,728,773,360,413,466,151,315
240709,30,45,5,40,35,5,30,10,0,10
240718,30,993,934,59,993,934,59,,,
240727,30,8363,3919,4444,7061,3392,3669,1302,527,775
240736,30,966,283,683,509,145,364,457,138,319
240745,30,1473,621,852,687,280,407,786,341,445
240754,30,2629,1113,1516,2024,847,1177,605,266,339
240790,30,1279,482,797,948,365,583,331,117,214
240879,30,131,25,106,131,25,106,,,
241100,30,196,101,95,169,86,83,27,15,12
241128,30,200,98,102,165,80,85,35,18,17
241146,30,141,47,94,137,46,91,4,1,3
241182,30,397,75,322,397,75,322,,,
241191,30,787,312,475,682,263,419,105,49,56
241216,30,1577,990,587,936,573,363,641,417,224
241225,30,602,192,410,422,137,285,180,55,125
241304,30,1882,530,1352,987,281,706,895,249,646
241331,30,701,109,592,551,87,464,150,22,128
241377,30,645,249,396,550,215,335,95,34,61
241386,30,131,27,104,104,23,81,27,4,23
241395,30,290,97,193,240,83,157,50,14,36
241410,30,4075,1465,2610,3547,1246,2301,528,219,309
241517,30,210,55,155,149,39,110,61,16,45
241614,30,280,157,123,147,94,53,133,63,70
241720,30,596,235,361,433,153,280,163,82,81
241739,30,4780,1515,3265,3143,993,2150,1637,522,1115
241766,30,282,197,85,174,118,56,108,79,29
241836,30,922,290,632,385,139,246,537,151,386
241906,30,235,74,161,235,74,161,,,
241951,30,489,124,365,358,83,275,131,41,90
242042,30,298,174,124,270,151,119,28,23,5
242112,30,391,166,225,336,153,183,55,13,42
242121,30,214,79,135,126,46,80,88,33,55
242130,30,326,95,231,260,72,188,66,23,43
242149,30,347,88,259,259,69,190,88,19,69
242556,30,247,162,85,240,157,83,7,5,2
242583,30,165,116,49,124,88,36,41,28,13
242617,30,2699,1246,1453,2354,1091,1263,345,155,190
242626,30,2908,1193,1715,2398,966,1432,510,227,283
242635,30,2352,849,1503,1962,727,1235,390,122,268
242644,30,996,333,663,798,275,523,198,58,140
242653,30,3099,1346,1753,2330,999,1331,769,347,422
242662,30,2752,993,1759,2129,778,1351,623,215,408
242680,30,1185,433,752,980,356,624,205,77,128
242699,30,1473,448,1025,1216,373,843,257,75,182
242705,30,3730,2089,1641,3123,1728,1395,607,361,246
242820,30,944,730,214,944,730,214,,,
242945,30,171,60,111,128,43,85,43,17,26
242954,30,66,22,44,54,17,37,12,5,7
242972,30,25359,8690,16669,17597,5942,11655,7762,2748,5014
243106,30,1960,878,1082,1770,796,974,190,82,108
243115,30,2855,1091,1764,2662,1009,1653,193,82,111
243133,30,3022,1487,1535,2578,1269,1309,444,218,226
243142,30,2197,811,1386,1751,628,1123,446,183,263
243151,30,2200,699,1501,1973,619,1354,227,80,147
243179,30,2591,870,1721,2360,786,1574,231,84,147
243188,30,344,178,166,305,157,148,39,21,18
243197,30,9999,5560,4439,8947,4917,4030,1052,643,409
243203,30,264,40,224,245,37,208,19,3,16
243212,30,2123,975,1148,2012,931,1081,111,44,67
243221,30,9112,3306,5806,8042,2866,5176,1070,440,630
243346,30,4651,1794,2857,3090,1202,1888,1561,592,969
243443,30,3675,1335,2340,3021,1087,1934,654,248,406
243568,30,112,14,98,86,8,78,26,6,20
243577,30,3649,2619,1030,1655,1146,509,1994,1473,521
243586,30,647,231,416,555,200,355,92,31,61
243601,30,7923,3190,4733,5687,2195,3492,2236,995,1241
243638,30,1986,808,1178,1321,522,799,665,286,379
243647,30,454,206,248,279,137,142,175,69,106
243665,30,1325,366,959,898,270,628,427,96,331
243744,30,7761,3744,4017,7761,3744,4017,,,
243780,30,38438,22125,16313,36475,21058,15417,1963,1067,896
243799,30,22,1,21,22,1,21,,,
243823,30,411,115,296,314,90,224,97,25,72
243832,30,1201,341,860,561,153,408,640,188,452
243841,30,466,89,377,363,73,290,103,16,87
244233,30,1,0,1,1,0,1,,,
244279,30,132,3,129,132,3,129,,,
244437,30,12980,4867,8113,5656,2378,3278,7324,2489,4835
244446,30,1958,741,1217,550,257,293,1408,484,924
244613,30,323,308,15,170,162,8,153,146,7
245281,30,78,41,37,78,41,37,,,
245625,30,889,332,557,388,163,225,501,169,332
245652,30,364,188,176,355,187,168,9,1,8
245777,30,45,45,0,43,43,0,2,2,0
245838,30,74,30,44,26,11,15,48,19,29
245847,30,60,21,39,25,8,17,35,13,22
245883,30,80,17,63,10,3,7,70,14,56
245892,30,105,24,81,51,8,43,54,16,38
245953,30,1415,475,940,742,287,455,673,188,485
245962,30,167,10,157,164,10,154,3,0,3
245980,30,39,7,32,39,7,32,,,
245999,30,924,472,452,401,163,238,523,309,214
246017,30,1459,948,511,487,396,91,972,552,420
246035,30,285,44,241,285,44,241,,,
246071,30,50,8,42,50,8,42,,,
246354,30,7756,2950,4806,1442,538,904,6314,2412,3902
246406,30,15,3,12,15,3,12,,,
246415,30,68,3,65,20,2,18,48,1,47
246460,30,106,9,97,106,9,97,,,
246813,30,2997,996,2001,643,282,361,2354,714,1640
246895,30,443,178,265,251,84,167,192,94,98
246974,30,403,42,361,403,42,361,,,
247010,30,44,0,44,44,0,44,,,
247047,30,88,2,86,88,2,86,,,
247065,30,653,47,606,381,20,361,272,27,245
247153,30,216,48,168,216,48,168,,,
247162,30,9,1,8,,,,9,1,8
247409,30,68,0,68,68,0,68,,,
247603,30,1949,1047,902,1284,713,571,665,334,331
247649,30,458,292,166,371,237,134,87,55,32
247773,30,68,68,0,68,68,0,,,
247834,30,25111,11730,13381,10761,5606,5155,14350,6124,8226
247940,30,2551,1078,1473,1229,573,656,1322,505,817
248192,30,25,0,25,25,0,25,,,
248527,30,83,0,83,83,0,83,,,
248606,30,441,273,168,180,68,112,261,205,56
248624,30,77,17,60,77,17,60,,,
248633,30,56,2,54,56,2,54,,,
248660,30,137,33,104,121,33,88,16,0,16
248703,30,227,2,225,104,1,103,123,1,122
248925,30,747,454,293,592,348,244,155,106,49
248934,30,11275,4438,6837,11275,4438,6837,,,
249061,30,49,0,49,25,0,25,24,0,24
249238,30,330,15,315,212,7,205,118,8,110
249609,30,167,103,64,167,103,64,,,
250027,30,305,95,210,300,95,205,5,0,5
250285,30,288,258,30,161,146,15,127,112,15
250744,30,377,44,333,377,44,333,,,
250902,30,102,7,95,55,4,51,47,3,44
250993,30,549,314,235,30,11,19,519,303,216
251260,30,3767,1660,2107,2323,1164,1159,1444,496,948
251312,30,420,61,359,322,47,275,98,14,84
260336,30,17,4,13,17,4,13,,,
260363,30,8,0,8,8,0,8,,,
260372,30,254,60,194,101,20,81,153,40,113
260664,30,310,222,88,310,222,88,,,
260691,30,768,207,561,768,207,561,,,
260789,30,667,138,529,667,138,529,,,
260813,30,232,26,206,232,26,206,,,
260929,30,186,17,169,185,17,168,1,0,1
260965,30,77,0,77,77,0,77,,,
260992,30,514,38,476,165,22,143,349,16,333
261436,30,834,57,777,834,57,777,,,
261676,30,18,1,17,18,1,17,,,
261685,30,32,1,31,32,1,31,,,
261719,30,220,1,219,220,1,219,,,
261773,30,34,7,27,32,6,26,2,1,1
261861,30,8,0,8,8,0,8,,,
262031,30,5250,2175,3075,3087,1379,1708,2163,796,1367
262086,30,4545,1542,3003,1006,436,570,3539,1106,2433
262129,30,669,214,455,661,208,453,8,6,2
262341,30,615,535,80,615,535,80,,,
262369,30,97,0,97,97,0,97,,,
262457,30,419,60,359,419,60,359,,,
262466,30,32,18,14,32,18,14,,,
362700,30,428,37,391,418,36,382,10,1,9
362782,30,242,6,236,82,2,80,160,4,156
363013,30,28,3,25,28,3,25,,,
363147,30,421,2,419,421,2,419,,,
363165,30,1919,1038,881,567,306,261,1352,732,620
363633,30,430,174,256,232,102,130,198,72,126
363679,30,209,3,206,190,3,187,19,0,19
363712,30,44,44,0,44,44,0,,,
363882,30,88,1,87,88,1,87,,,
363907,30,405,258,147,300,185,115,105,73,32
363916,30,141,44,97,112,35,77,29,9,20
363934,30,802,639,163,417,333,84,385,306,79
364016,30,4084,1867,2217,1420,764,656,2664,1103,1561
364025,30,7010,3449,3561,2795,1479,1316,4215,1970,2245
364548,30,201,103,98,135,58,77,66,45,21
364575,30,26,0,26,26,0,26,,,
364627,30,108,47,61,71,21,50,37,26,11
364636,30,162,37,125,131,37,94,31,0,31
364760,30,48,6,42,23,3,20,25,3,22
364946,30,119,31,88,87,20,67,32,11,21
364964,30,23,3,20,23,3,20,,,
365091,30,317,14,303,317,14,303,,,
365125,30,194,6,188,194,6,188,,,
365198,30,160,54,106,44,2,42,116,52,64
365213,30,458,229,229,118,34,84,340,195,145
365240,30,18,12,6,18,12,6,,,
365374,30,745,435,310,286,140,146,459,295,164
365383,30,65,5,60,65,5,60,,,
365480,30,268,120,148,114,20,94,154,100,54
365505,30,19,3,16,19,3,16,,,
365693,30,138,0,138,138,0,138,,,
365763,30,31,6,25,31,6,25,,,
365824,30,99,6,93,99,6,93,,,
365833,30,116,8,108,116,8,108,,,
366003,30,237,100,137,86,27,59,151,73,78
366155,30,30,12,18,30,12,18,,,
366191,30,1216,1176,40,1216,1176,40,,,
366252,30,4193,2702,1491,3470,2452,1018,723,250,473
366261,30,275,90,185,257,83,174,18,7,11
366270,30,304,11,293,304,11,293,,,
366289,30,31,25,6,31,25,6,,,
366340,30,231,71,160,172,57,115,59,14,45
366395,30,13825,6310,7515,8917,4350,4567,4908,1960,2948
366401,30,6088,2894,3194,2159,1129,1030,3929,1765,2164
366438,30,28,2,26,16,2,14,12,0,12
366465,30,1616,514,1102,719,254,465,897,260,637
366535,30,255,35,220,255,35,220,,,
366553,30,578,244,334,575,244,331,3,0,3
366571,30,22,3,19,22,3,19,,,
366623,30,41,13,28,31,8,23,10,5,5
366632,30,5,0,5,5,0,5,,,
366711,30,13844,5600,8244,11119,4451,6668,2725,1149,1576
367051,30,79,2,77,47,2,45,32,0,32
367088,30,107,3,104,65,3,62,42,0,42
367103,30,119,93,26,119,93,26,,,
367112,30,165,24,141,151,21,130,14,3,11
367158,30,53,1,52,53,1,52,,,
367334,30,189,166,23,148,130,18,41,36,5
367361,30,90,60,30,86,58,28,4,2,2
367431,30,42,1,41,42,1,41,,,
367459,30,4900,2000,2900,1719,769,950,3181,1231,1950
367875,30,1053,343,710,860,271,589,193,72,121
367884,30,337,121,216,208,66,142,129,55,74
367972,30,106,3,103,106,3,103,,,
367981,30,62,0,62,37,0,37,25,0,25
368230,30,94,4,90,65,1,64,29,3,26
368364,30,332,177,155,165,104,61,167,73,94
368407,30,32,2,30,1,1,0,31,1,30
368443,30,371,103,268,371,103,268,,,
368452,30,298,109,189,298,109,189,,,
368629,30,474,98,376,474,98,376,,,
368647,30,9,1,8,9,1,8,,,
368771,30,241,53,188,241,53,188,,,
368832,30,53,11,42,17,5,12,36,6,30
368911,30,1018,224,794,256,66,190,762,158,604
369400,30,943,903,40,943,903,40,,,
369419,30,642,349,293,642,349,293,,,
369446,30,42,3,39,23,3,20,19,0,19
369455,30,190,40,150,190,40,150,,,
369516,30,127,27,100,127,27,100,,,
369668,30,131,46,85,92,44,48,39,2,37
369686,30,69,14,55,69,14,55,,,
369783,30,282,16,266,282,16,266,,,
369950,30,92,80,12,92,80,12,,,
371052,30,232,40,192,232,40,192,,,
371690,30,813,184,629,98,10,88,715,174,541
371830,30,112,94,18,110,94,16,2,0,2
371928,30,115,41,74,115,41,74,,,
371964,30,342,248,94,342,248,94,,,
372028,30,128,19,109,128,19,109,,,
372073,30,143,43,100,143,43,100,,,
372082,30,93,32,61,93,32,61,,,
372240,30,21,0,21,21,0,21,,,
372329,30,384,45,339,384,45,339,,,
372356,30,188,4,184,188,4,184,,,
372462,30,113,19,94,110,18,92,3,1,2
372921,30,450,155,295,450,155,295,,,
373085,30,28,0,28,24,0,24,4,0,4
373216,30,119,21,98,119,21,98,,,
373456,30,26,1,25,18,1,17,8,0,8
373526,30,279,209,70,279,209,70,,,
373678,30,113,46,67,81,37,44,32,9,23
373696,30,59,25,34,41,16,25,18,9,9
373711,30,63,6,57,63,6,57,,,
373784,30,475,255,220,475,255,220,,,
374316,30,60,47,13,38,35,3,22,12,10
374343,30,58,1,57,58,1,57,,,
374574,30,675,117,558,472,94,378,203,23,180
374592,30,47,15,32,47,15,32,,,
375106,30,138,114,24,123,100,23,15,14,1
375230,30,196,196,0,196,196,0,,,
375373,30,115,48,67,5,0,5,110,48,62
375407,30,95,24,71,84,19,65,11,5,6
375416,30,186,51,135,186,51,135,,,
375540,30,38,0,38,14,0,14,24,0,24
375568,30,42,13,29,4,4,0,38,9,29
375656,30,31,9,22,23,3,20,8,6,2
375683,30,270,197,73,158,108,50,112,89,23
375726,30,568,305,263,401,186,215,167,119,48
375939,30,121,23,98,121,23,98,,,
375966,30,127,11,116,73,6,67,54,5,49
375984,30,186,9,177,142,7,135,44,2,42
376224,30,185,42,143,155,38,117,30,4,26
376242,30,60,51,9,60,51,9,,,
376288,30,111,30,81,111,30,81,,,
376330,30,196,52,144,196,52,144,,,
376385,30,185,87,98,180,86,94,5,1,4
376446,30,72,1,71,16,1,15,56,0,56
376631,30,21,8,13,19,8,11,2,0,2
376677,30,128,48,80,126,46,80,2,2,0
376695,30,1384,616,768,597,277,320,787,339,448
377111,30,181,72,109,181,72,109,,,
377193,30,28,2,26,11,1,10,17,1,16
377218,30,125,121,4,125,121,4,,,
377272,30,17,3,14,17,3,14,,,
377281,30,71,6,65,71,6,65,,,
377315,30,75,0,75,75,0,75,,,
377449,30,209,95,114,168,83,85,41,12,29
377458,30,221,89,132,160,76,84,61,13,48
377485,30,29,4,25,15,3,12,14,1,13
377546,30,119,42,77,114,41,73,5,1,4
377555,30,5166,2836,2330,4448,2432,2016,718,404,314
377564,30,4054,2098,1956,3590,1860,1730,464,238,226
377643,30,108,7,101,108,7,101,,,
377652,30,152,8,144,152,8,144,,,
377661,30,615,97,518,615,97,518,,,
377722,30,436,21,415,436,21,415,,,
377759,30,151,146,5,151,146,5,,,
378105,30,380,7,373,264,5,259,116,2,114
378576,30,275,54,221,45,14,31,230,40,190
378886,30,243,55,188,75,17,58,168,38,130
378956,30,608,565,43,608,565,43,,,
379621,30,72,5,67,56,5,51,16,0,16
379746,30,365,18,347,365,18,347,,,
379782,30,218,20,198,218,20,198,,,
380067,30,268,2,266,268,2,266,,,
380359,30,477,81,396,180,45,135,297,36,261
380368,30,481,178,303,278,111,167,203,67,136
380377,30,632,145,487,453,112,341,179,33,146
380438,30,711,95,616,711,95,616,,,
381255,30,78,61,17,78,61,17,,,
381282,30,81,31,50,81,31,50,,,
381325,30,109,36,73,109,36,73,,,
381370,30,279,17,262,140,11,129,139,6,133
381404,30,390,14,376,141,4,137,249,10,239
381486,30,19,0,19,19,0,19,,,
381699,30,38,0,38,26,0,26,12,0,12
381732,30,55,13,42,7,2,5,48,11,37
382258,30,142,13,129,62,3,59,80,10,70
382416,30,80,18,62,80,18,62,,,
382461,30,42,1,41,27,1,26,15,0,15
382780,30,155,9,146,136,7,129,19,2,17
382911,30,54,23,31,40,18,22,14,5,9
382957,30,353,95,258,342,93,249,11,2,9
383020,30,4,2,2,2,1,1,2,1,1
383084,30,337,126,211,256,85,171,81,41,40
383163,30,174,2,172,43,0,43,131,2,129
383190,30,1456,626,830,648,337,311,808,289,519
383279,30,178,24,154,60,10,50,118,14,104
383297,30,185,8,177,34,0,34,151,8,143
383312,30,65,26,39,65,26,39,,,
383330,30,76,15,61,76,15,61,,,
383367,30,127,33,94,107,30,77,20,3,17
383464,30,134,9,125,134,9,125,,,
383525,30,43,9,34,43,9,34,,,
383765,30,148,6,142,98,5,93,50,1,49
383996,30,362,115,247,117,35,82,245,80,165
384236,30,978,360,618,978,360,618,,,
384245,30,711,259,452,711,259,452,,,
384254,30,469,311,158,457,303,154,12,8,4
384333,30,6088,2363,3725,2164,881,1283,3924,1482,2442
384342,30,3013,1313,1700,1481,711,770,1532,602,930
384412,30,228,125,103,228,125,103,,,
384421,30,94,94,0,94,94,0,,,
385132,30,115,6,109,78,5,73,37,1,36
385503,30,210,15,195,210,15,195,,,
385619,30,2246,1107,1139,2246,1107,1139,,,
386153,30,426,0,426,366,0,366,60,0,60
386472,30,735,139,596,426,83,343,309,56,253
387925,30,113,11,102,113,11,102,,,
388520,30,205,124,81,73,51,22,132,73,59
389860,30,326,163,163,217,79,138,109,84,25
390905,30,237,133,104,58,42,16,179,91,88
391005,30,117,3,114,117,3,114,,,
391759,30,22,0,22,,,,22,0,22
392257,30,3201,230,2971,3201,230,2971,,,
392354,30,10,2,8,10,2,8,,,
392415,30,258,71,187,258,71,187,,,
393649,30,1288,497,791,1288,497,791,,,
393861,30,463,84,379,428,80,348,35,4,31
395362,30,1059,346,713,329,108,221,730,238,492
395690,30,276,169,107,276,169,107,,,
397942,30,1150,333,817,1150,333,817,,,
399212,30,10419,6923,3496,2146,1074,1072,8273,5849,2424
399869,30,540,514,26,540,514,26,,,
399911,30,445,156,289,445,156,289,,,
400080,30,1017,698,319,1017,698,319,,,
400187,30,516,70,446,327,50,277,189,20,169
400558,30,57,18,39,57,18,39,,,
401223,30,192,63,129,89,26,63,103,37,66
401764,30,223,5,218,71,0,71,152,5,147
402563,30,210,11,199,210,11,199,,,
402800,30,146,4,142,136,3,133,10,1,9
403469,30,287,119,168,189,91,98,98,28,70
403478,30,409,182,227,322,150,172,87,32,55
403487,30,496,205,291,390,181,209,106,24,82
404055,30,269,30,239,269,30,239,,,
404338,30,23,9,14,23,9,14,,,
404426,30,2396,1096,1300,841,438,403,1555,658,897
404684,30,313,91,222,313,91,222,,,
404718,30,255,4,251,255,4,251,,,
404912,30,802,160,642,802,160,642,,,
405012,30,87,1,86,87,1,86,,,
405058,30,149,149,0,149,149,0,,,
405076,30,470,70,400,470,70,400,,,
405854,30,237,237,0,237,237,0,,,
405872,30,1976,849,1127,821,430,391,1155,419,736
406024,30,1962,247,1715,1082,127,955,880,120,760
406033,30,3163,395,2768,1922,247,1675,1241,148,1093
406149,30,86,18,68,86,18,68,,,
406325,30,140,8,132,36,4,32,104,4,100
406361,30,11,1,10,11,1,10,,,
406422,30,70,3,67,36,0,36,34,3,31
406486,30,35,21,14,19,12,7,16,9,7
406547,30,45,3,42,26,3,23,19,0,19
407090,30,468,5,463,139,2,137,329,3,326
407142,30,103,1,102,103,1,102,,,
407151,30,70,0,70,70,0,70,,,
407179,30,91,3,88,61,2,59,30,1,29
407355,30,181,24,157,181,24,157,,,
407434,30,59,1,58,59,1,58,,,
407461,30,72,54,18,72,54,18,,,
407470,30,145,5,140,112,4,108,33,1,32
407489,30,73,54,19,9,0,9,64,54,10
407513,30,127,53,74,38,3,35,89,50,39
407522,30,33,12,21,,,,33,12,21
407568,30,138,6,132,118,2,116,20,4,16
407577,30,69,36,33,46,19,27,23,17,6
407595,30,45,2,43,45,2,43,,,
407610,30,45,33,12,2,2,0,43,31,12
407629,30,10,1,9,10,1,9,,,
407683,30,60,2,58,30,2,28,30,0,30
407708,30,210,7,203,210,7,203,,,
407735,30,64,1,63,64,1,63,,,
407832,30,189,117,72,75,46,29,114,71,43
408066,30,182,40,142,122,29,93,60,11,49
408163,30,43,2,41,43,2,41,,,
408385,30,645,274,371,645,274,371,,,
408729,30,21,1,20,20,0,20,1,1,0
408844,30,2465,746,1719,1582,543,1039,883,203,680
408862,30,298,5,293,132,3,129,166,2,164
409032,30,53,1,52,53,1,52,,,
409120,30,61,24,37,61,24,37,,,
409193,30,175,170,5,175,170,5,,,
409315,30,17846,7472,10374,6423,2881,3542,11423,4591,6832
409537,30,17,5,12,,,,17,5,12
409591,30,88,18,70,44,7,37,44,11,33
409698,30,6129,2419,3710,5358,2041,3317,771,378,393
410797,30,87,45,42,87,45,42,,,
410964,30,39,0,39,35,0,35,4,0,4
411684,30,150,46,104,150,46,104,,,
411754,30,37,8,29,37,8,29,,,
412173,30,506,47,459,466,44,422,40,3,37
412535,30,37,3,34,35,3,32,2,0,2
412544,30,150,8,142,93,7,86,57,1,56
412599,30,344,100,244,344,100,244,,,
413176,30,37,21,16,37,21,16,,,
413413,30,13275,2235,11040,3290,475,2815,9985,1760,8225
413617,30,221,63,158,65,24,41,156,39,117
413626,30,172,52,120,99,30,69,73,22,51
413680,30,336,321,15,336,321,15,,,
413820,30,21,0,21,21,0,21,,,
413893,30,1276,444,832,1276,444,832,,,
413972,30,30,2,28,30,2,28,,,
414063,30,102,0,102,95,0,95,7,0,7
414124,30,292,221,71,225,175,50,67,46,21
414461,30,2220,2106,114,2004,1899,105,216,207,9
414489,30,105,1,104,105,1,104,,,
414540,30,251,6,245,214,5,209,37,1,36
414595,30,203,42,161,29,12,17,174,30,144
414869,30,333,4,329,104,3,101,229,1,228
414878,30,266,104,162,157,61,96,109,43,66
414911,30,835,348,487,571,263,308,264,85,179
414939,30,300,40,260,300,40,260,,,
415039,30,49,3,46,37,3,34,12,0,12
415057,30,20,20,0,20,20,0,,,
415987,30,86,6,80,86,6,80,,,
416458,30,126,42,84,126,42,84,,,
416801,30,337,70,267,295,59,236,42,11,31
417008,30,110,2,108,110,2,108,,,
417062,30,57,2,55,44,0,44,13,2,11
417105,30,405,261,144,281,162,119,124,99,25
417123,30,87,35,52,41,19,22,46,16,30
417248,30,51,49,2,51,49,2,,,
417275,30,27,25,2,27,25,2,,,
417327,30,152,24,128,91,18,73,61,6,55
417442,30,67,1,66,67,1,66,,,
417503,30,224,0,224,136,0,136,88,0,88
417600,30,13,0,13,13,0,13,,,
417628,30,20,2,18,19,2,17,1,0,1
417637,30,47,16,31,47,16,31,,,
417646,30,23,1,22,23,1,22,,,
417655,30,19,2,17,19,2,17,,,
417682,30,15,1,14,15,1,14,,,
417716,30,193,4,189,193,4,189,,,
417725,30,45,2,43,45,2,43,,,
417734,30,134,30,104,49,14,35,85,16,69
417752,30,19,8,11,17,7,10,2,1,1
417831,30,108,77,31,108,77,31,,,
417840,30,393,29,364,393,29,364,,,
417868,30,39,12,27,18,4,14,21,8,13
417886,30,20,1,19,20,1,19,,,
417910,30,201,31,170,201,31,170,,,
417983,30,29,0,29,,,,29,0,29
417992,30,46,3,43,28,2,26,18,1,17
418001,30,83,3,80,83,3,80,,,
418010,30,67,5,62,34,1,33,33,4,29
418029,30,42,4,38,42,4,38,,,
418038,30,170,17,153,170,17,153,,,
418065,30,257,32,225,204,24,180,53,8,45
418083,30,50,8,42,50,8,42,,,
418126,30,124,40,84,70,21,49,54,19,35
418171,30,54,54,0,54,54,0,,,
418199,30,45,32,13,6,6,0,39,26,13
418205,30,176,103,73,124,72,52,52,31,21
418223,30,115,7,108,115,7,108,,,
418250,30,211,132,79,39,21,18,172,111,61
418269,30,86,45,41,86,45,41,,,
418278,30,115,30,85,66,19,47,49,11,38
418296,30,1541,841,700,468,147,321,1073,694,379
418302,30,163,61,102,103,20,83,60,41,19
418320,30,149,68,81,60,18,42,89,50,39
418348,30,106,83,23,67,57,10,39,26,13
418357,30,148,76,72,21,8,13,127,68,59
418409,30,195,95,100,133,54,79,62,41,21
418427,30,89,8,81,78,8,70,11,0,11
418445,30,26,0,26,18,0,18,8,0,8
418454,30,56,34,22,55,33,22,1,1,0
418481,30,38,0,38,38,0,38,,,
418515,30,86,6,80,75,6,69,11,0,11
418524,30,43,2,41,43,2,41,,,
418533,30,239,34,205,200,22,178,39,12,27
418542,30,81,9,72,35,3,32,46,6,40
418560,30,87,14,73,24,1,23,63,13,50
418588,30,34,1,33,34,1,33,,,
418612,30,7,0,7,7,0,7,,,
418658,30,369,314,55,369,314,55,,,
418773,30,371,176,195,296,163,133,75,13,62
418782,30,275,264,11,275,264,11,,,
418889,30,51,45,6,33,28,5,18,17,1
418913,30,14,4,10,14,4,10,,,
418968,30,103,1,102,103,1,102,,,
419031,30,35,2,33,35,2,33,,,
419095,30,40,3,37,40,3,37,,,
419183,30,82,7,75,82,7,75,,,
419217,30,59,11,48,59,11,48,,,
419226,30,467,225,242,362,202,160,105,23,82
419235,30,148,29,119,148,29,119,,,
419244,30,250,196,54,121,101,20,129,95,34
419253,30,26,21,5,26,21,5,,,
419280,30,29,0,29,25,0,25,4,0,4
419341,30,9,4,5,9,4,5,,,
419420,30,39,15,24,39,15,24,,,
419484,30,19,2,17,19,2,17,,,
419633,30,85,11,74,85,11,74,,,
419703,30,452,429,23,452,429,23,,,
419712,30,129,127,2,129,127,2,,,
419721,30,249,235,14,249,235,14,,,
420024,30,189,19,170,160,15,145,29,4,25
420042,30,24,14,10,24,14,10,,,
420130,30,264,12,252,264,12,252,,,
420255,30,77,75,2,77,75,2,,,
420325,30,79,79,0,79,79,0,,,
420343,30,861,832,29,687,667,20,174,165,9
420370,30,388,128,260,388,128,260,,,
420398,30,12964,5541,7423,3277,1501,1776,9687,4040,5647
420431,30,1416,465,951,322,101,221,1094,364,730
420440,30,945,333,612,441,193,248,504,140,364
420468,30,248,107,141,198,101,97,50,6,44
420538,30,871,311,560,473,198,275,398,113,285
420556,30,536,201,335,247,102,145,289,99,190
420723,30,221,91,130,75,26,49,146,65,81
420981,30,339,45,294,339,45,294,,,
421513,30,48,5,43,43,3,40,5,2,3
421610,30,134,8,126,128,8,120,6,0,6
421665,30,46,1,45,25,1,24,21,0,21
421708,30,1177,145,1032,925,103,822,252,42,210
421717,30,29,20,9,11,9,2,18,11,7
421771,30,49,0,49,34,0,34,15,0,15
421841,30,376,169,207,376,169,207,,,
421878,30,387,36,351,293,28,265,94,8,86
421896,30,190,69,121,190,69,121,,,
422020,30,229,218,11,229,218,11,,,
422695,30,257,17,240,257,17,240,,,
422835,30,280,50,230,280,50,230,,,
423120,30,724,72,652,718,71,647,6,1,5
423397,30,543,328,215,543,328,215,,,
423412,30,32,27,5,32,27,5,,,
423652,30,324,87,237,151,35,116,173,52,121
425250,30,80,12,68,52,9,43,28,3,25
425986,30,172,21,151,172,21,151,,,
426314,30,8278,7039,1239,2161,1790,371,6117,5249,868
427308,30,129,4,125,129,4,125,,,
427335,30,74,0,74,68,0,68,6,0,6
427894,30,60,59,1,60,59,1,,,
427973,30,232,206,26,152,134,18,80,72,8
427982,30,149,95,54,129,85,44,20,10,10
427991,30,394,222,172,341,173,168,53,49,4
428000,30,87,20,67,87,20,67,,,
428019,30,49,23,26,25,11,14,24,12,12
428055,30,141,35,106,141,35,106,,,
428125,30,49,35,14,48,34,14,1,1,0
428170,30,577,55,522,359,34,325,218,21,197
428259,30,62,7,55,12,1,11,50,6,44
428392,30,917,375,542,496,225,271,421,150,271
429128,30,288,9,279,7,0,7,281,9,272
430184,30,1298,400,898,167,103,64,1131,297,834
430227,30,74,1,73,57,1,56,17,0,17
430245,30,611,162,449,611,162,449,,,
430306,30,54,18,36,32,14,18,22,4,18
430403,30,220,14,206,220,14,206,,,
430564,30,36,11,25,17,4,13,19,7,12
430582,30,409,189,220,409,189,220,,,
430670,30,73,17,56,73,17,56,,,
430704,30,23,5,18,22,5,17,1,0,1
430795,30,155,43,112,155,43,112,,,
430883,30,29,2,27,29,2,27,,,
430908,30,29,4,25,17,2,15,12,2,10
430935,30,618,455,163,444,327,117,174,128,46
430971,30,36,5,31,36,5,31,,,
431017,30,102,58,44,79,39,40,23,19,4
431071,30,23,7,16,12,5,7,11,2,9
431105,30,95,7,88,39,4,35,56,3,53
431123,30,138,136,2,138,136,2,,,
431141,30,1299,492,807,1258,489,769,41,3,38
431187,30,152,137,15,152,137,15,,,
431196,30,94,7,87,94,7,87,,,
431266,30,101,4,97,31,3,28,70,1,69
431275,30,33,5,28,8,2,6,25,3,22
431284,30,68,0,68,60,0,60,8,0,8
431558,30,287,95,192,276,92,184,11,3,8
431600,30,168,32,136,140,24,116,28,8,20
431716,30,452,209,243,452,209,243,,,
431983,30,74,74,0,74,74,0,,,
432117,30,174,3,171,109,2,107,65,1,64
432269,30,72,60,12,72,60,12,,,
432384,30,442,90,352,442,90,352,,,
432524,30,126,42,84,124,41,83,2,1,1
433004,30,347,90,257,347,90,257,,,
433013,30,714,231,483,714,231,483,,,
433040,30,41,3,38,41,3,38,,,
433068,30,273,179,94,216,123,93,57,56,1
433101,30,673,83,590,471,64,407,202,19,183
433138,30,126,17,109,107,10,97,19,7,12
433174,30,395,48,347,72,12,60,323,36,287
433387,30,112807,45265,67542,112807,45265,67542,,,
433420,30,330,285,45,330,285,45,,,
433536,30,364,37,327,207,22,185,157,15,142
433660,30,13788,6003,7785,11065,4768,6297,2723,1235,1488
434016,30,145,48,97,66,28,38,79,20,59
434061,30,4738,1809,2929,2682,1169,1513,2056,640,1416
434140,30,684,148,536,684,148,536,,,
434159,30,431,351,80,431,351,80,,,
434274,30,82,12,70,55,7,48,27,5,22
434283,30,49,2,47,47,2,45,2,0,2
434308,30,386,16,370,386,16,370,,,
434344,30,217,7,210,217,7,210,,,
434362,30,35,34,1,35,34,1,,,
434432,30,13,1,12,13,1,12,,,
434469,30,277,42,235,277,42,235,,,
434496,30,92,1,91,92,1,91,,,
434539,30,11,7,4,6,4,2,5,3,2
434584,30,162,46,116,47,16,31,115,30,85
434672,30,13223,4902,8321,3922,1911,2011,9301,2991,6310
434751,30,91,22,69,47,11,36,44,11,33
434821,30,588,27,561,588,27,561,,,
434830,30,160,1,159,111,1,110,49,0,49
434900,30,363,94,269,206,46,160,157,48,109
434937,30,43,43,0,43,43,0,,,
435000,30,23,9,14,22,9,13,1,0,1
436030,30,206,92,114,121,68,53,85,24,61
436304,30,1675,929,746,971,551,420,704,378,326
436429,30,5588,3620,1968,5588,3620,1968,,,
436553,30,773,136,637,773,136,637,,,
436599,30,118,20,98,7,0,7,111,20,91
436614,30,55,31,24,27,15,12,28,16,12
436632,30,142,27,115,78,20,58,64,7,57
436641,30,20,8,12,20,8,12,,,
436650,30,158,12,146,158,12,146,,,
436775,30,113,5,108,113,5,108,,,
436818,30,751,321,430,696,295,401,55,26,29
436827,30,480,269,211,463,258,205,17,11,6
436836,30,2246,1151,1095,2105,1079,1026,141,72,69
437097,30,372,214,158,341,195,146,31,19,12
437103,30,7371,2400,4971,3476,1309,2167,3895,1091,2804
437237,30,83,70,13,83,70,13,,,
437556,30,1108,451,657,1017,440,577,91,11,80
437608,30,134,101,33,132,99,33,2,2,0
437635,30,697,68,629,697,68,629,,,
437723,30,22,10,12,22,10,12,,,
437732,30,65,4,61,49,2,47,16,2,14
437750,30,90,89,1,90,89,1,,,
437769,30,140,10,130,140,10,130,,,
437778,30,247,8,239,247,8,239,,,
437857,30,115,2,113,91,1,90,24,1,23
437936,30,669,83,586,669,83,586,,,
438179,30,230,32,198,230,32,198,,,
438221,30,144,12,132,127,11,116,17,1,16
438258,30,466,86,380,466,86,380,,,
438285,30,240,22,218,240,22,218,,,
438337,30,190,74,116,148,55,93,42,19,23
438504,30,1401,1347,54,1401,1347,54,,,
438586,30,958,330,628,792,271,521,166,59,107
438674,30,41,0,41,21,0,21,20,0,20
438708,30,199,39,160,115,26,89,84,13,71
438735,30,156,142,14,102,94,8,54,48,6
438984,30,53,18,35,53,18,35,,,
439020,30,3,1,2,2,0,2,1,1,0
439118,30,298,45,253,298,45,253,,,
439190,30,1215,621,594,720,370,350,495,251,244
439367,30,1214,349,865,1214,349,865,,,
439446,30,1,1,0,1,1,0,,,
439455,30,324,14,310,160,9,151,164,5,159
439473,30,205,64,141,101,34,67,104,30,74
439491,30,245,30,215,245,30,215,,,
439570,30,451,17,434,451,17,434,,,
439622,30,436,58,378,436,58,378,,,
439668,30,411,353,58,411,353,58,,,
439686,30,8,0,8,8,0,8,,,
439701,30,255,94,161,117,43,74,138,51,87
439738,30,375,69,306,375,69,306,,,
439747,30,190,33,157,127,25,102,63,8,55
439774,30,62,21,41,46,19,27,16,2,14
439783,30,73,16,57,60,12,48,13,4,9
439792,30,345,38,307,339,38,301,6,0,6
439844,30,54,0,54,54,0,54,,,
439862,30,68,26,42,63,24,39,5,2,3
439871,30,182,4,178,179,4,175,3,0,3
439899,30,76,36,40,64,26,38,12,10,2
439932,30,56,5,51,56,5,51,,,
439969,30,67,26,41,67,26,41,,,
440059,30,728,673,55,486,446,40,242,227,15
440101,30,111,4,107,51,0,51,60,4,56
440262,30,406,387,19,293,277,16,113,110,3
440271,30,152,69,83,152,69,83,,,
440396,30,226,98,128,212,93,119,14,5,9
440402,30,1144,371,773,544,216,328,600,155,445
440651,30,505,119,386,297,87,210,208,32,176
440730,30,384,141,243,384,141,243,,,
440749,30,47,32,15,6,5,1,41,27,14
440776,30,51,20,31,51,20,31,,,
440794,30,378,90,288,352,75,277,26,15,11
440819,30,12,8,4,12,8,4,,,
440828,30,1040,544,496,585,300,285,455,244,211
440855,30,154,6,148,154,6,148,,,
440989,30,444,350,94,444,350,94,,,
441025,30,174,56,118,168,55,113,6,1,5
441052,30,1465,383,1082,1465,383,1082,,,
441070,30,108,44,64,34,14,20,74,30,44
441168,30,26,1,25,26,1,25,,,
441210,30,600,221,379,87,3,84,513,218,295
441229,30,1640,324,1316,1640,324,1316,,,
441256,30,43,1,42,43,1,42,,,
441371,30,6368,199,6169,6358,199,6159,10,0,10
441380,30,227,88,139,183,70,113,44,18,26
441414,30,123,27,96,21,10,11,102,17,85
441423,30,680,218,462,680,218,462,,,
441487,30,68,4,64,68,4,64,,,
441496,30,185,159,26,132,114,18,53,45,8
441502,30,352,24,328,352,24,328,,,
441575,30,294,20,274,294,20,274,,,
441593,30,12,1,11,12,1,11,,,
441609,30,141,141,0,141,141,0,,,
441618,30,18,0,18,9,0,9,9,0,9
441636,30,336,59,277,282,44,238,54,15,39
441645,30,124,3,121,96,3,93,28,0,28
441663,30,261,27,234,261,27,234,,,
441672,30,42,6,36,42,6,36,,,
441690,30,110,69,41,51,29,22,59,40,19
441706,30,267,120,147,267,120,147,,,
441742,30,849,79,770,766,71,695,83,8,75
441760,30,2971,1257,1714,1213,650,563,1758,607,1151
441788,30,406,366,40,273,243,30,133,123,10
441830,30,41,10,31,41,10,31,,,
441858,30,202,9,193,177,5,172,25,4,21
441876,30,211,6,205,127,5,122,84,1,83
441900,30,4581,1043,3538,1939,425,1514,2642,618,2024
441937,30,5717,1941,3776,4307,1403,2904,1410,538,872
441982,30,356,178,178,356,178,178,,,
442073,30,600,123,477,433,105,328,167,18,149
442134,30,320,64,256,320,64,256,,,
442240,30,405,79,326,248,45,203,157,34,123
442329,30,931,832,99,931,832,99,,,
442356,30,1529,171,1358,552,66,486,977,105,872
442383,30,146,21,125,146,21,125,,,
442426,30,407,37,370,280,24,256,127,13,114
442435,30,61,12,49,61,12,49,,,
442444,30,895,486,409,895,486,409,,,
442523,30,77,29,48,73,27,46,4,2,2
442569,30,4598,1758,2840,1454,542,912,3144,1216,1928
442602,30,377,51,326,377,51,326,,,
442611,30,1274,1195,79,1274,1195,79,,,
442639,30,223,140,83,223,140,83,,,
442657,30,241,13,228,241,13,228,,,
442781,30,781,161,620,221,44,177,560,117,443
442842,30,57,14,43,20,6,14,37,8,29
442879,30,886,73,813,867,70,797,19,3,16
442888,30,46,44,2,46,44,2,,,
442930,30,487,221,266,453,202,251,34,19,15
442976,30,64,6,58,64,6,58,,,
442985,30,263,35,228,263,35,228,,,
443021,30,24,23,1,24,23,1,,,
443049,30,177,99,78,88,47,41,89,52,37
443058,30,33,12,21,3,2,1,30,10,20
443100,30,46,28,18,46,28,18,,,
443137,30,232,46,186,232,46,186,,,
443146,30,52,40,12,36,28,8,16,12,4
443207,30,98,94,4,98,94,4,,,
443216,30,150,124,26,150,124,26,,,
443225,30,33,26,7,33,26,7,,,
443234,30,178,10,168,178,10,168,,,
443252,30,2288,1218,1070,2288,1218,1070,,,
443261,30,196,18,178,141,16,125,55,2,53
443289,30,200,15,185,200,15,185,,,
443298,30,29,26,3,29,26,3,,,
443322,30,229,41,188,229,41,188,,,
443331,30,2620,525,2095,2090,416,1674,530,109,421
443340,30,46,21,25,46,21,25,,,
443377,30,53,44,9,53,44,9,,,
443410,30,1058,734,324,972,670,302,86,64,22
443492,30,917,418,499,734,353,381,183,65,118
443562,30,279,40,239,147,22,125,132,18,114
443571,30,449,224,225,449,224,225,,,
443599,30,743,65,678,176,27,149,567,38,529
443632,30,55,35,20,55,35,20,,,
443641,30,129,4,125,65,3,62,64,1,63
443650,30,2478,475,2003,2111,343,1768,367,132,235
443669,30,69,6,63,69,6,63,,,
443696,30,48,11,37,48,11,37,,,
443748,30,319,74,245,308,74,234,11,0,11
443766,30,2598,504,2094,145,64,81,2453,440,2013
443784,30,1222,289,933,67,29,38,1155,260,895
443951,30,45,18,27,45,18,27,,,
443979,30,73,0,73,6,0,6,67,0,67
444051,30,43,0,43,31,0,31,12,0,12
444088,30,528,72,456,528,72,456,,,
444130,30,106,25,81,15,3,12,91,22,69
444194,30,190,7,183,190,7,183,,,
444219,30,7872,3551,4321,1847,908,939,6025,2643,3382
444228,30,30,0,30,30,0,30,,,
444255,30,57,3,54,57,3,54,,,
444282,30,84,2,82,36,1,35,48,1,47
444291,30,125,5,120,85,3,82,40,2,38
444307,30,62,2,60,47,1,46,15,1,14
444325,30,114,19,95,107,18,89,7,1,6
444334,30,92,18,74,92,18,74,,,
444361,30,54,25,29,54,25,29,,,
444370,30,32,30,2,32,30,2,,,
444398,30,108,52,56,77,40,37,31,12,19
444404,30,21,8,13,13,6,7,8,2,6
444413,30,145,145,0,145,145,0,,,
444440,30,37,5,32,37,5,32,,,
444468,30,40,1,39,35,1,34,5,0,5
444486,30,272,11,261,240,9,231,32,2,30
444510,30,77,4,73,77,4,73,,,
444529,30,27,3,24,27,3,24,,,
444556,30,437,212,225,437,212,225,,,
444565,30,336,146,190,248,106,142,88,40,48
444583,30,375,160,215,375,160,215,,,
444635,30,74,8,66,74,8,66,,,
444662,30,68,58,10,68,58,10,,,
444671,30,142,57,85,142,57,85,,,
444714,30,154,18,136,154,18,136,,,
444732,30,58,12,46,58,12,46,,,
444778,30,44,19,25,24,8,16,20,11,9
444787,30,2988,402,2586,1793,225,1568,1195,177,1018
444811,30,361,20,341,170,12,158,191,8,183
444857,30,130,2,128,72,1,71,58,1,57
444866,30,155,8,147,115,6,109,40,2,38
444893,30,267,8,259,267,8,259,,,
444936,30,108,18,90,107,17,90,1,1,0
444945,30,287,29,258,287,29,258,,,
444954,30,1019,403,616,633,268,365,386,135,251
445027,30,10317,3760,6557,9413,3501,5912,904,259,645
445133,30,122,47,75,85,35,50,37,12,25
445188,30,8343,4251,4092,8202,4167,4035,141,84,57
445203,30,185,24,161,185,24,161,,,
445212,30,168,34,134,84,19,65,84,15,69
445230,30,711,207,504,711,207,504,,,
445249,30,240,63,177,240,63,177,,,
445267,30,1493,312,1181,846,167,679,647,145,502
445364,30,620,62,558,620,62,558,,,
445461,30,260,78,182,257,78,179,3,0,3
445498,30,11,11,0,11,11,0,,,
445540,30,57,0,57,57,0,57,,,
445647,30,163,7,156,95,4,91,68,3,65
445656,30,213,7,206,131,3,128,82,4,78
445692,30,517,422,95,476,388,88,41,34,7
445708,30,1140,387,753,1101,373,728,39,14,25
445735,30,574,150,424,574,150,424,,,
445744,30,458,57,401,458,57,401,,,
445762,30,188,175,13,123,114,9,65,61,4
445780,30,21,4,17,21,4,17,,,
445799,30,1001,964,37,1001,964,37,,,
445841,30,156,2,154,123,2,121,33,0,33
445850,30,117,3,114,84,2,82,33,1,32
445911,30,737,323,414,539,244,295,198,79,119
445948,30,1962,292,1670,1962,292,1670,,,
445957,30,284,66,218,,,,284,66,218
446048,30,1230,559,671,1221,554,667,9,5,4
446084,30,61,7,54,,,,61,7,54
446093,30,56,4,52,56,4,52,,,
446109,30,294,46,248,222,40,182,72,6,66
446118,30,579,104,475,579,104,475,,,
446127,30,194,12,182,194,12,182,,,
446163,30,485,458,27,296,278,18,189,180,9
446206,30,59,2,57,48,2,46,11,0,11
446224,30,11,5,6,,,,11,5,6
446233,30,151,86,65,140,81,59,11,5,6
446242,30,128,30,98,128,30,98,,,
446251,30,64,20,44,64,20,44,,,
446260,30,766,16,750,766,16,750,,,
446288,30,77,0,77,50,0,50,27,0,27
446303,30,69,1,68,55,0,55,14,1,13
446349,30,24,3,21,24,3,21,,,
446385,30,239,138,101,225,130,95,14,8,6
446516,30,5,3,2,5,3,2,,,
446525,30,1556,1314,242,1556,1314,242,,,
446552,30,1521,813,708,1521,813,708,,,
446561,30,2035,439,1596,2035,439,1596,,,
446598,30,24,2,22,23,2,21,1,0,1
446604,30,2590,2590,0,2590,2590,0,,,
446640,30,629,440,189,578,406,172,51,34,17
446774,30,1478,552,926,584,237,347,894,315,579
447014,30,180,15,165,180,15,165,,,
447023,30,1981,820,1161,1959,815,1144,22,5,17
447050,30,197,57,140,71,23,48,126,34,92
447148,30,192,4,188,130,4,126,62,0,62
447166,30,58,5,53,37,4,33,21,1,20
447175,30,73,4,69,42,3,39,31,1,30
447263,30,2178,339,1839,1327,206,1121,851,133,718
447351,30,556,302,254,556,302,254,,,
447421,30,223,22,201,223,22,201,,,
447449,30,56,15,41,37,13,24,19,2,17
447467,30,98,5,93,98,5,93,,,
447582,30,753,246,507,535,190,345,218,56,162
447591,30,714,74,640,714,74,640,,,
447607,30,1513,784,729,1513,784,729,,,
447616,30,1208,701,507,1208,701,507,,,
447689,30,10451,4364,6087,7103,2965,4138,3348,1399,1949
447704,30,115,2,113,115,2,113,,,
447713,30,150,49,101,150,49,101,,,
447722,30,38,3,35,38,3,35,,,
447731,30,93,7,86,60,6,54,33,1,32
447759,30,263,71,192,241,67,174,22,4,18
447768,30,1639,381,1258,1639,381,1258,,,
447777,30,802,455,347,17,11,6,785,444,341
447795,30,20,2,18,20,2,18,,,
447810,30,18,4,14,18,4,14,,,
447847,30,160,148,12,160,148,12,,,
447865,30,18,13,5,16,12,4,2,1,1
447883,30,153,21,132,66,13,53,87,8,79
447892,30,86,8,78,71,7,64,15,1,14
447908,30,68,1,67,41,0,41,27,1,26
447917,30,41,8,33,41,8,33,,,
447935,30,264,12,252,264,12,252,,,
447953,30,416,211,205,280,139,141,136,72,64
447962,30,142,10,132,142,10,132,,,
447971,30,38,3,35,38,3,35,,,
447980,30,58,1,57,42,1,41,16,0,16
447999,30,168,32,136,168,32,136,,,
448026,30,122,6,116,96,6,90,26,0,26
448071,30,126,7,119,126,7,119,,,
448123,30,209,28,181,209,28,181,,,
448196,30,109,9,100,106,9,97,3,0,3
448220,30,143,6,137,143,6,137,,,
448239,30,118,4,114,118,4,114,,,
448248,30,2338,1449,889,298,41,257,2040,1408,632
448257,30,17,0,17,2,0,2,15,0,15
448275,30,19,0,19,19,0,19,,,
448372,30,189,75,114,189,75,114,,,
448424,30,56,11,45,27,6,21,29,5,24
448433,30,1140,1095,45,1140,1095,45,,,
448594,30,3004,1129,1875,1204,465,739,1800,664,1136
448600,30,198,16,182,198,16,182,,,
448646,30,80,2,78,80,2,78,,,
448673,30,2384,232,2152,1021,93,928,1363,139,1224
448770,30,273,256,17,263,249,14,10,7,3
448798,30,116,6,110,116,6,110,,,
448859,30,120,110,10,120,110,10,,,
448895,30,561,83,478,561,83,478,,,
449038,30,1257,361,896,213,120,93,1044,241,803
449074,30,551,62,489,551,62,489,,,
449083,30,202,202,0,202,202,0,,,
449092,30,128,128,0,128,128,0,,,
449135,30,221,67,154,152,61,91,69,6,63
449250,30,660,113,547,660,113,547,,,
449311,30,139,1,138,42,0,42,97,1,96
449320,30,697,679,18,516,503,13,181,176,5
449339,30,37569,24082,13487,2923,1543,1380,34646,22539,12107
449348,30,66,23,43,9,5,4,57,18,39
449357,30,81,4,77,81,4,77,,,
449384,30,290,175,115,277,169,108,13,6,7
449393,30,120,40,80,120,40,80,,,
449445,30,70,11,59,70,11,59,,,
449454,30,45,7,38,,,,45,7,38
449463,30,181,46,135,105,24,81,76,22,54
449472,30,82,1,81,82,1,81,,,
449490,30,90,17,73,90,17,73,,,
449506,30,122,35,87,122,35,87,,,
449524,30,308,26,282,308,26,282,,,
449533,30,57,9,48,57,9,48,,,
449597,30,2,0,2,2,0,2,,,
449603,30,176,103,73,176,103,73,,,
449612,30,97,45,52,97,45,52,,,
449658,30,110,110,0,107,107,0,3,3,0
449676,30,330,138,192,330,138,192,,,
449685,30,216,17,199,216,17,199,,,
449700,30,369,81,288,369,81,288,,,
449728,30,177,8,169,177,8,169,,,
449764,30,208,95,113,203,94,109,5,1,4
449773,30,187,31,156,187,31,156,,,
449782,30,22,3,19,16,2,14,6,1,5
449807,30,71,7,64,71,7,64,,,
449816,30,354,233,121,52,33,19,302,200,102
449834,30,2,2,0,,,,2,2,0
449861,30,61,4,57,61,4,57,,,
449870,30,59,24,35,57,24,33,2,0,2
449889,30,142,36,106,142,36,106,,,
449898,30,421,75,346,313,56,257,108,19,89
449904,30,164,3,161,164,3,161,,,
449959,30,150,36,114,85,20,65,65,16,49
449968,30,284,55,229,208,40,168,76,15,61
449977,30,206,3,203,161,2,159,45,1,44
449986,30,263,67,196,163,36,127,100,31,69
449995,30,129,7,122,74,5,69,55,2,53
450058,30,818,152,666,818,152,666,,,
450067,30,481,135,346,473,135,338,8,0,8
450128,30,533,18,515,533,18,515,,,
450298,30,239,57,182,20,13,7,219,44,175
450377,30,1237,237,1000,85,38,47,1152,199,953
450395,30,136,1,135,98,1,97,38,0,38
450401,30,416,46,370,416,46,370,,,
450571,30,424,50,374,193,25,168,231,25,206
450599,30,50,1,49,50,1,49,,,
450605,30,53,4,49,34,3,31,19,1,18
450614,30,114,4,110,82,3,79,32,1,31
450632,30,87,17,70,,,,87,17,70
450641,30,273,19,254,171,16,155,102,3,99
450650,30,230,20,210,81,0,81,149,20,129
450696,30,412,59,353,412,59,353,,,
450702,30,34,4,30,34,4,30,,,
450711,30,84,65,19,84,65,19,,,
450720,30,692,8,684,298,5,293,394,3,391
450933,30,11208,7332,3876,6410,3958,2452,4798,3374,1424
450951,30,150,79,71,150,79,71,,,
450960,30,326,32,294,249,23,226,77,9,68
450988,30,195,20,175,131,15,116,64,5,59
451042,30,15,4,11,7,0,7,8,4,4
451051,30,116,9,107,,,,116,9,107
451097,30,50,10,40,34,4,30,16,6,10
451103,30,267,48,219,92,16,76,175,32,143
451121,30,117,9,108,55,4,51,62,5,57
451149,30,995,65,930,995,65,930,,,
451158,30,773,33,740,773,33,740,,,
451167,30,168,85,83,94,56,38,74,29,45
451194,30,32,3,29,32,3,29,,,
451228,30,182,147,35,182,147,35,,,
451237,30,214,5,209,214,5,209,,,
451255,30,52,2,50,29,0,29,23,2,21
451282,30,124,4,120,80,2,78,44,2,42
451291,30,8,1,7,,,,8,1,7
451307,30,36,0,36,3,0,3,33,0,33
451316,30,54,4,50,54,4,50,,,
451334,30,289,121,168,153,67,86,136,54,82
451343,30,90,4,86,57,2,55,33,2,31
451352,30,142,22,120,107,19,88,35,3,32
451370,30,59,59,0,59,59,0,,,
451398,30,213,213,0,213,213,0,,,
451404,30,459,459,0,459,459,0,,,
451413,30,393,102,291,393,102,291,,,
451459,30,41,8,33,10,0,10,31,8,23
451468,30,432,4,428,432,4,428,,,
451477,30,1483,1203,280,1483,1203,280,,,
451495,30,281,71,210,281,71,210,,,
451501,30,282,97,185,282,97,185,,,
451529,30,59,1,58,36,0,36,23,1,22
451547,30,16,4,12,16,4,12,,,
451556,30,1596,550,1046,1596,550,1046,,,
451565,30,181,24,157,168,14,154,13,10,3
451574,30,173,8,165,137,6,131,36,2,34
451583,30,875,675,200,131,91,40,744,584,160
451626,30,19,1,18,19,1,18,,,
451714,30,292,51,241,181,12,169,111,39,72
451741,30,92,30,62,66,23,43,26,7,19
451750,30,1043,251,792,640,211,429,403,40,363
451820,30,78,47,31,50,30,20,28,17,11
451857,30,63,4,59,63,4,59,,,
451866,30,352,66,286,352,66,286,,,
451918,30,121,13,108,121,13,108,,,
451927,30,376,205,171,355,194,161,21,11,10
452009,30,54,2,52,54,2,52,,,
452072,30,23,1,22,23,1,22,,,
452081,30,894,31,863,894,31,863,,,
452106,30,62,59,3,62,59,3,,,
452124,30,383,83,300,381,82,299,2,1,1
452373,30,309,18,291,309,18,291,,,
452771,30,13,1,12,,,,13,1,12
452780,30,8,1,7,,,,8,1,7
452887,30,49,45,4,49,45,4,,,
452948,30,692,63,629,432,35,397,260,28,232
453163,30,2646,511,2135,190,86,104,2456,425,2031
453215,30,474,103,371,15,3,12,459,100,359
453297,30,35,12,23,,,,35,12,23
453756,30,73,44,29,73,44,29,,,
453792,30,110,7,103,110,7,103,,,
454184,30,290,115,175,276,111,165,14,4,10
454227,30,11535,1227,10308,2766,328,2438,8769,899,7870
454236,30,537,60,477,209,21,188,328,39,289
454245,30,818,142,676,296,50,246,522,92,430
454537,30,61,1,60,61,1,60,,,
454546,30,169,12,157,169,12,157,,,
454555,30,252,12,240,252,12,240,,,
454582,30,101,41,60,24,14,10,77,27,50
454607,30,387,11,376,387,11,376,,,
454652,30,142,3,139,142,3,139,,,
454689,30,2,1,1,2,1,1,,,
454698,30,304,90,214,304,90,214,,,
454722,30,21,3,18,19,2,17,2,1,1
454759,30,38,31,7,33,27,6,5,4,1
454768,30,215,34,181,121,22,99,94,12,82
454777,30,213,29,184,139,20,119,74,9,65
454786,30,641,410,231,180,123,57,461,287,174
454795,30,254,68,186,176,51,125,78,17,61
454801,30,176,34,142,176,34,142,,,
454810,30,8894,2373,6521,8894,2373,6521,,,
454829,30,4067,544,3523,639,90,549,3428,454,2974
454856,30,1034,133,901,1034,133,901,,,
454865,30,939,154,785,643,117,526,296,37,259
454874,30,42,1,41,11,0,11,31,1,30
454917,30,913,145,768,561,84,477,352,61,291
454926,30,319,17,302,270,15,255,49,2,47
454935,30,78,1,77,78,1,77,,,
454944,30,238,15,223,238,15,223,,,
454953,30,42,0,42,20,0,20,22,0,22
454962,30,61,2,59,32,1,31,29,1,28
454971,30,205,18,187,107,16,91,98,2,96
454980,30,145,0,145,28,0,28,117,0,117
454999,30,121,2,119,50,1,49,71,1,70
455008,30,166,5,161,58,3,55,108,2,106
455026,30,86,80,6,,,,86,80,6
455062,30,55,0,55,25,0,25,30,0,30
455071,30,108,30,78,,,,108,30,78
455080,30,239,26,213,238,26,212,1,0,1
455105,30,79,0,79,79,0,79,,,
455114,30,5826,2460,3366,2197,1138,1059,3629,1322,2307
455141,30,208,5,203,208,5,203,,,
455187,30,197,48,149,79,26,53,118,22,96
455196,30,3379,291,3088,3379,291,3088,,,
455202,30,251,37,214,66,6,60,185,31,154
455211,30,317,8,309,317,8,309,,,
455220,30,53,7,46,53,7,46,,,
455257,30,431,431,0,431,431,0,,,
455275,30,251,5,246,251,5,246,,,
455284,30,241,7,234,175,5,170,66,2,64
455327,30,50,3,47,42,3,39,8,0,8
455336,30,204,167,37,204,167,37,,,
455354,30,225,4,221,225,4,221,,,
455381,30,161,0,161,103,0,103,58,0,58
455460,30,127,27,100,127,27,100,,,
455479,30,626,73,553,536,66,470,90,7,83
455488,30,215,83,132,215,83,132,,,
455512,30,2832,1027,1805,637,256,381,2195,771,1424
455628,30,381,129,252,381,129,252,,,
455664,30,284,41,243,14,6,8,270,35,235
455707,30,51,12,39,51,12,39,,,
455725,30,679,10,669,528,7,521,151,3,148
455734,30,205,38,167,205,38,167,,,
455761,30,363,53,310,226,32,194,137,21,116
455770,30,136,78,58,135,78,57,1,0,1
455798,30,101,1,100,49,1,48,52,0,52
455831,30,115,13,102,115,13,102,,,
455859,30,254,3,251,219,3,216,35,0,35
455868,30,292,39,253,292,39,253,,,
455877,30,93,5,88,93,5,88,,,
455886,30,185,8,177,87,1,86,98,7,91
455895,30,416,27,389,177,4,173,239,23,216
455901,30,169,14,155,79,5,74,90,9,81
455910,30,49,7,42,49,7,42,,,
455929,30,55,0,55,55,0,55,,,
455965,30,130,8,122,130,8,122,,,
455974,30,160,9,151,160,9,151,,,
455983,30,182,55,127,180,54,126,2,1,1
456001,30,94,89,5,94,89,5,,,
456029,30,232,9,223,170,9,161,62,0,62
456038,30,384,45,339,384,45,339,,,
456065,30,142,2,140,138,2,136,4,0,4
456074,30,143,7,136,142,7,135,1,0,1
456135,30,95,1,94,66,1,65,29,0,29
456153,30,73,63,10,73,63,10,,,
456205,30,166,43,123,162,43,119,4,0,4
456214,30,390,241,149,390,241,149,,,
456287,30,117,1,116,117,1,116,,,
456454,30,438,125,313,361,114,247,77,11,66
456481,30,34,18,16,,,,34,18,16
456490,30,115,77,38,36,25,11,79,52,27
456506,30,72,3,69,72,3,69,,,
456515,30,36,2,34,36,2,34,,,
456551,30,69,3,66,69,3,66,,,
456579,30,233,92,141,217,90,127,16,2,14
456588,30,45,1,44,45,1,44,,,
456597,30,271,5,266,139,2,137,132,3,129
456621,30,288,88,200,21,10,11,267,78,189
456825,30,169,8,161,121,4,117,48,4,44
456852,30,374,129,245,374,129,245,,,
456922,30,247,48,199,229,46,183,18,2,16
456931,30,320,170,150,312,169,143,8,1,7
456959,30,617,123,494,590,114,476,27,9,18
456968,30,1142,53,1089,1070,48,1022,72,5,67
456977,30,61,53,8,61,53,8,,,
457031,30,65,0,65,43,0,43,22,0,22
457077,30,432,31,401,432,31,401,,,
457086,30,180,43,137,136,34,102,44,9,35
457101,30,323,92,231,323,92,231,,,
457110,30,463,82,381,463,82,381,,,
457129,30,918,94,824,235,14,221,683,80,603
457192,30,56,40,16,56,40,16,,,
457208,30,120,108,12,120,108,12,,,
457226,30,40,27,13,17,12,5,23,15,8
457253,30,122,6,116,39,2,37,83,4,79
457299,30,365,65,300,323,57,266,42,8,34
457314,30,97,22,75,97,22,75,,,
457323,30,397,44,353,397,44,353,,,
457332,30,41,3,38,41,3,38,,,
457341,30,175,9,166,175,9,166,,,
457350,30,74,0,74,,,,74,0,74
457378,30,183,97,86,93,38,55,90,59,31
457387,30,147,78,69,147,78,69,,,
457396,30,112,30,82,18,7,11,94,23,71
457402,30,193,171,22,45,43,2,148,128,20
457411,30,244,223,21,177,159,18,67,64,3
457420,30,172,11,161,121,10,111,51,1,50
457439,30,145,2,143,71,1,70,74,1,73
457448,30,77,1,76,77,1,76,,,
457466,30,38,30,8,38,30,8,,,
457475,30,116,3,113,116,3,113,,,
457484,30,95,42,53,45,21,24,50,21,29
457493,30,60,3,57,60,3,57,,,
457527,30,211,20,191,17,1,16,194,19,175
457536,30,676,103,573,676,103,573,,,
457545,30,92,3,89,73,2,71,19,1,18
457554,30,20,1,19,17,1,16,3,0,3
457563,30,237,7,230,237,7,230,,,
457572,30,138,3,135,138,3,135,,,
457581,30,135,1,134,131,1,130,4,0,4
457606,30,98,4,94,98,4,94,,,
457615,30,46,6,40,,,,46,6,40
457624,30,43,9,34,43,9,34,,,
457633,30,231,8,223,83,1,82,148,7,141
457642,30,42,0,42,42,0,42,,,
457679,30,26,1,25,26,1,25,,,
457697,30,132,63,69,20,9,11,112,54,58
457749,30,98,3,95,98,3,95,,,
457767,30,119,69,50,119,69,50,,,
457776,30,167,15,152,165,14,151,2,1,1
457785,30,41,0,41,41,0,41,,,
457794,30,118,13,105,118,13,105,,,
457800,30,201,22,179,201,22,179,,,
457819,30,676,275,401,,,,676,275,401
457837,30,131,7,124,65,6,59,66,1,65
457855,30,73,3,70,57,2,55,16,1,15
457873,30,88,66,22,43,34,9,45,32,13
457916,30,107,5,102,48,1,47,59,4,55
457925,30,12,6,6,12,6,6,,,
457943,30,40,7,33,40,7,33,,,
457952,30,186,2,184,153,2,151,33,0,33
457989,30,48,0,48,48,0,48,,,
458007,30,69,1,68,37,0,37,32,1,31
458034,30,41,7,34,41,7,34,,,
458043,30,90,1,89,62,1,61,28,0,28
458061,30,68,7,61,28,4,24,40,3,37
458070,30,270,13,257,257,13,244,13,0,13
458098,30,120,2,118,110,2,108,10,0,10
458104,30,225,1,224,5,0,5,220,1,219
458113,30,68,29,39,1,0,1,67,29,38
458122,30,24,0,24,24,0,24,,,
458131,30,137,7,130,137,7,130,,,
458140,30,62,54,8,62,54,8,,,
458168,30,79,4,75,79,4,75,,,
458210,30,3023,680,2343,2287,514,1773,736,166,570
458229,30,2579,565,2014,2095,457,1638,484,108,376
458274,30,197,5,192,165,5,160,32,0,32
458405,30,191,71,120,189,71,118,2,0,2
458441,30,300,44,256,296,44,252,4,0,4
458496,30,88,45,43,59,31,28,29,14,15
458681,30,279,44,235,279,44,235,,,
458803,30,162,1,161,108,1,107,54,0,54
458812,30,91,3,88,73,2,71,18,1,17
458821,30,68,2,66,68,2,66,,,
458830,30,174,3,171,124,0,124,50,3,47
458858,30,225,6,219,130,3,127,95,3,92
458867,30,203,7,196,145,5,140,58,2,56
458885,30,275,45,230,6,1,5,269,44,225
458919,30,4319,978,3341,459,220,239,3860,758,3102
458955,30,277,54,223,12,4,8,265,50,215
458964,30,1625,365,1260,137,75,62,1488,290,1198
458973,30,2251,633,1618,300,167,133,1951,466,1485
458982,30,180,94,86,126,64,62,54,30,24
459019,30,96,6,90,79,5,74,17,1,16
459046,30,57,3,54,44,2,42,13,1,12
459055,30,46,1,45,27,0,27,19,1,18
459064,30,73,5,68,49,3,46,24,2,22
459116,30,102,7,95,102,7,95,,,
459170,30,292,31,261,150,28,122,142,3,139
459189,30,114,0,114,87,0,87,27,0,27
459198,30,333,57,276,240,52,188,93,5,88
459204,30,4276,636,3640,4276,636,3640,,,
459213,30,2668,571,2097,2668,571,2097,,,
459231,30,209,20,189,209,20,189,,,
459259,30,274,42,232,211,34,177,63,8,55
459268,30,205,28,177,152,18,134,53,10,43
459277,30,341,23,318,341,23,318,,,
459286,30,178,23,155,133,15,118,45,8,37
459295,30,72,1,71,32,1,31,40,0,40
459301,30,103,5,98,78,3,75,25,2,23
459329,30,354,208,146,354,208,146,,,
459347,30,95,1,94,21,0,21,74,1,73
459374,30,105,4,101,37,4,33,68,0,68
459392,30,160,6,154,98,6,92,62,0,62
459408,30,56,7,49,41,2,39,15,5,10
459417,30,50,36,14,40,31,9,10,5,5
459426,30,193,5,188,193,5,188,,,
459499,30,22,4,18,22,4,18,,,
459514,30,75,20,55,75,20,55,,,
459523,30,64,6,58,64,6,58,,,
459532,30,99,0,99,12,0,12,87,0,87
459541,30,25,0,25,11,0,11,14,0,14
459550,30,107,3,104,96,3,93,11,0,11
459578,30,108,33,75,75,18,57,33,15,18
459727,30,387,110,277,217,55,162,170,55,115
459824,30,15,1,14,15,1,14,,,
459842,30,626,67,559,324,36,288,302,31,271
459851,30,390,46,344,197,29,168,193,17,176
459949,30,6404,2219,4185,3903,1355,2548,2501,864,1637
459958,30,295,79,216,295,79,216,,,
459967,30,618,243,375,618,243,375,,,
459985,30,508,260,248,508,260,248,,,
459994,30,8358,2652,5706,483,233,250,7875,2419,5456
460011,30,182,0,182,127,0,127,55,0,55
460020,30,431,89,342,431,89,342,,,
460093,30,35,1,34,35,1,34,,,
460109,30,90,3,87,90,3,87,,,
460118,30,62,1,61,62,1,61,,,
460127,30,73,6,67,73,6,67,,,
460136,30,892,139,753,892,139,753,,,
460145,30,105,64,41,105,64,41,,,
460172,30,557,499,58,555,497,58,2,2,0
460181,30,615,91,524,615,91,524,,,
460190,30,320,52,268,320,52,268,,,
460206,30,521,127,394,521,127,394,,,
460349,30,1838,551,1287,484,121,363,1354,430,924
460376,30,11,6,5,11,6,5,,,
460385,30,75,10,65,75,10,65,,,
460394,30,7823,3305,4518,1467,667,800,6356,2638,3718
460464,30,7203,3492,3711,1537,874,663,5666,2618,3048
460482,30,180,17,163,180,17,163,,,
460525,30,27,3,24,27,3,24,,,
460534,30,293,6,287,293,6,287,,,
460543,30,1727,1649,78,1727,1649,78,,,
460677,30,426,91,335,360,79,281,66,12,54
460701,30,234,28,206,57,10,47,177,18,159
460756,30,273,18,255,239,18,221,34,0,34
460765,30,42,2,40,42,2,40,,,
460808,30,9,1,8,9,1,8,,,
460817,30,157,58,99,155,57,98,2,1,1
460826,30,482,107,375,474,105,369,8,2,6
460835,30,235,73,162,233,73,160,2,0,2
460862,30,219,6,213,113,2,111,106,4,102
460871,30,663,72,591,213,20,193,450,52,398
460914,30,328,3,325,328,3,325,,,
460932,30,84,0,84,84,0,84,,,
460969,30,285,19,266,285,19,266,,,
460978,30,298,5,293,149,2,147,149,3,146
460987,30,110,0,110,110,0,110,,,
460996,30,200,3,197,159,2,157,41,1,40
461014,30,867,56,811,867,56,811,,,
461023,30,434,62,372,423,60,363,11,2,9
461032,30,112,54,58,44,24,20,68,30,38
461087,30,1315,688,627,167,65,102,1148,623,525
461111,30,31,29,2,29,28,1,2,1,1
461148,30,996,601,395,996,601,395,,,
461175,30,200,16,184,133,14,119,67,2,65
461193,30,191,1,190,186,1,185,5,0,5
461218,30,844,59,785,844,59,785,,,
461245,30,97,39,58,34,12,22,63,27,36
461254,30,49,10,39,49,10,39,,,
461263,30,161,11,150,161,11,150,,,
461272,30,85,0,85,49,0,49,36,0,36
461281,30,89,7,82,69,5,64,20,2,18
461306,30,165,49,116,31,15,16,134,34,100
461315,30,134,30,104,28,7,21,106,23,83
461324,30,791,169,622,754,161,593,37,8,29
461333,30,10,9,1,10,9,1,,,
461342,30,136,0,136,97,0,97,39,0,39
461379,30,32,7,25,6,1,5,26,6,20
461388,30,55,18,37,55,18,37,,,
461412,30,139,41,98,,,,139,41,98
461421,30,208,11,197,206,11,195,2,0,2
461430,30,591,548,43,,,,591,548,43
461494,30,175,15,160,101,7,94,74,8,66
461500,30,31,5,26,23,3,20,8,2,6
461528,30,180,89,91,72,35,37,108,54,54
461537,30,38,1,37,37,1,36,1,0,1
461555,30,145,8,137,145,8,137,,,
461573,30,127,125,2,127,125,2,,,
461582,30,163,2,161,163,2,161,,,
461591,30,118,5,113,117,5,112,1,0,1
461607,30,90,13,77,35,9,26,55,4,51
461625,30,13,13,0,13,13,0,,,
461643,30,17,1,16,17,1,16,,,
461652,30,94,6,88,94,6,88,,,
461689,30,316,38,278,316,38,278,,,
461704,30,161,8,153,156,7,149,5,1,4
461713,30,40,0,40,15,0,15,25,0,25
461722,30,60,1,59,60,1,59,,,
461740,30,30,26,4,30,26,4,,,
461759,30,212,110,102,172,92,80,40,18,22
461768,30,241,4,237,170,3,167,71,1,70
461786,30,26,0,26,26,0,26,,,
461795,30,453,333,120,429,316,113,24,17,7
461810,30,25,9,16,22,8,14,3,1,2
461829,30,94,24,70,94,24,70,,,
461838,30,175,2,173,116,1,115,59,1,58
461847,30,54,54,0,54,54,0,,,
461856,30,64,30,34,64,30,34,,,
461865,30,25,2,23,25,2,23,,,
461874,30,98,13,85,98,13,85,,,
461883,30,42,20,22,31,16,15,11,4,7
461892,30,71,10,61,71,10,61,,,
461908,30,84,0,84,82,0,82,2,0,2
461917,30,215,0,215,121,0,121,94,0,94
461926,30,157,2,155,112,2,110,45,0,45
461944,30,101,1,100,101,1,100,,,
461953,30,28,1,27,17,1,16,11,0,11
461962,30,407,313,94,407,313,94,,,
461999,30,168,10,158,148,9,139,20,1,19
462008,30,239,15,224,154,12,142,85,3,82
462017,30,124,17,107,124,17,107,,,
462035,30,356,128,228,98,4,94,258,124,134
462053,30,55,2,53,55,2,53,,,
462062,30,113,0,113,68,0,68,45,0,45
462071,30,185,40,145,181,39,142,4,1,3
462336,30,66,4,62,66,4,62,,,
462345,30,35,0,35,18,0,18,17,0,17
462354,30,300,150,150,282,138,144,18,12,6
463056,30,1500,751,749,1422,710,712,78,41,37
464226,30,1098,603,495,887,519,368,211,84,127
466921,30,375,21,354,115,3,112,260,18,242
466930,30,2167,286,1881,510,69,441,1657,217,1440
467094,30,166,1,165,166,1,165,,,
467368,30,40,4,36,40,4,36,,,
467863,30,236,43,193,189,34,155,47,9,38
467872,30,284,11,273,200,8,192,84,3,81
467906,30,146,2,144,112,2,110,34,0,34
468246,30,98,9,89,98,9,89,,,
468255,30,12,2,10,12,2,10,,,
468291,30,74,8,66,74,8,66,,,
468769,30,179,173,6,179,173,6,,,
468848,30,848,434,414,848,434,414,,,
468893,30,174,6,168,114,5,109,60,1,59
468909,30,999,401,598,999,401,598,,,
468963,30,707,667,40,707,667,40,,,
469416,30,292,63,229,182,53,129,110,10,100
469610,30,9,1,8,9,1,8,,,
469629,30,147,128,19,147,128,19,,,
469911,30,95,6,89,95,6,89,,,
469957,30,24,0,24,24,0,24,,,
470038,30,1268,583,685,1268,583,685,,,
470047,30,38,11,27,38,11,27,,,
470296,30,15,0,15,15,0,15,,,
470393,30,145,8,137,52,4,48,93,4,89
474863,30,1352,260,1092,548,109,439,804,151,653
474915,30,451,6,445,245,2,243,206,4,202
474924,30,184,5,179,39,3,36,145,2,143
475015,30,180,1,179,180,1,179,,,
475024,30,244,80,164,244,80,164,,,
475033,30,152,27,125,,,,152,27,125
475060,30,210,18,192,208,18,190,2,0,2
475121,30,5738,1277,4461,4061,932,3129,1677,345,1332
475176,30,704,391,313,704,391,313,,,
475200,30,177,53,124,28,9,19,149,44,105
475273,30,307,59,248,51,9,42,256,50,206
475282,30,93,26,67,93,26,67,,,
475325,30,170,4,166,170,4,166,,,
475398,30,70,33,37,14,7,7,56,26,30
475404,30,149,2,147,84,1,83,65,1,64
475422,30,98,5,93,12,0,12,86,5,81
475431,30,49,4,45,49,4,45,,,
475468,30,279,4,275,77,2,75,202,2,200
475477,30,257,86,171,81,46,35,176,40,136
475486,30,264,48,216,168,20,148,96,28,68
475547,30,120,25,95,63,19,44,57,6,51
475556,30,153,10,143,95,5,90,58,5,53
475565,30,842,460,382,752,414,338,90,46,44
475574,30,38,17,21,21,7,14,17,10,7
475608,30,121,78,43,78,52,26,43,26,17
475635,30,20,6,14,5,3,2,15,3,12
475653,30,28,1,27,27,1,26,1,0,1
475662,30,55,0,55,26,0,26,29,0,29
475705,30,21,5,16,21,5,16,,,
475714,30,333,282,51,289,251,38,44,31,13
475723,30,325,191,134,116,56,60,209,135,74
475732,30,1420,133,1287,355,35,320,1065,98,967
475741,30,202,16,186,92,7,85,110,9,101
475839,30,305,154,151,153,87,66,152,67,85
476063,30,272,252,20,272,252,20,,,
476179,30,171,11,160,110,7,103,61,4,57
476230,30,30,2,28,30,2,28,,,
476355,30,29,12,17,29,12,17,,,
476489,30,93,71,22,93,71,22,,,
476498,30,250,163,87,250,163,87,,,
476513,30,44,1,43,44,1,43,,,
476540,30,109,2,107,77,1,76,32,1,31
476559,30,105,6,99,61,4,57,44,2,42
476568,30,19,13,6,19,13,6,,,
476595,30,93,16,77,93,16,77,,,
476601,30,86,86,0,86,86,0,,,
476610,30,28,17,11,28,17,11,,,
476629,30,143,6,137,143,6,137,,,
476683,30,245,12,233,242,12,230,3,0,3
476692,30,38,38,0,38,38,0,,,
476708,30,148,110,38,129,95,34,19,15,4
476717,30,638,638,0,638,638,0,,,
476726,30,513,100,413,513,100,413,,,
476735,30,26,16,10,26,16,10,,,
476753,30,229,6,223,115,5,110,114,1,113
476780,30,95,7,88,83,7,76,12,0,12
476799,30,327,58,269,327,58,269,,,
476805,30,44,0,44,44,0,44,,,
476814,30,611,421,190,,,,611,421,190
476841,30,237,23,214,154,16,138,83,7,76
476850,30,82,57,25,82,57,25,,,
476869,30,79,4,75,79,4,75,,,
476878,30,138,3,135,67,1,66,71,2,69
476887,30,599,8,591,578,8,570,21,0,21
476896,30,162,71,91,162,71,91,,,
476902,30,88,2,86,56,1,55,32,1,31
476939,30,682,60,622,682,60,622,,,
476957,30,12,1,11,10,1,9,2,0,2
476975,30,6333,2917,3416,1525,722,803,4808,2195,2613
476984,30,228,12,216,180,9,171,48,3,45
476993,30,246,2,244,246,2,244,,,
477002,30,47,3,44,43,3,40,4,0,4
477039,30,975,125,850,621,80,541,354,45,309
477233,30,97,41,56,97,41,56,,,
478582,30,157,7,150,112,6,106,45,1,44
478591,30,164,4,160,95,2,93,69,2,67
478616,30,104,7,97,78,5,73,26,2,24
478917,30,74,3,71,74,3,71,,,
478953,30,203,6,197,203,6,197,,,
479062,30,113,107,6,67,64,3,46,43,3
479424,30,289,41,248,289,41,248,,,
479956,30,7798,3664,4134,3309,1407,1902,4489,2257,2232
479965,30,142,16,126,142,16,126,,,
479974,30,88,32,56,82,32,50,6,0,6
479983,30,108,14,94,108,14,94,,,
479992,30,21,19,2,3,2,1,18,17,1
480000,30,52,33,19,49,31,18,3,2,1
480019,30,910,770,140,798,669,129,112,101,11
480028,30,162,127,35,160,126,34,2,1,1
480037,30,1251,942,309,1251,942,309,,,
480073,30,288,49,239,228,36,192,60,13,47
480091,30,6668,625,6043,5118,476,4642,1550,149,1401
480125,30,448,15,433,210,6,204,238,9,229
480161,30,12,1,11,12,1,11,,,
480198,30,269,86,183,189,62,127,80,24,56
480204,30,446,74,372,446,74,372,,,
480310,30,81,0,81,72,0,72,9,0,9
480471,30,813,461,352,813,461,352,,,
480523,30,82,5,77,82,5,77,,,
480532,30,37,1,36,37,1,36,,,
480550,30,31,0,31,31,0,31,,,
480569,30,776,291,485,495,171,324,281,120,161
480657,30,568,70,498,277,32,245,291,38,253
480727,30,29,21,8,29,21,8,,,
480781,30,99,80,19,91,73,18,8,7,1
480824,30,545,54,491,545,54,491,,,
480833,30,832,89,743,832,89,743,,,
480842,30,34,17,17,34,17,17,,,
480851,30,31,13,18,31,13,18,,,
480879,30,52,5,47,52,5,47,,,
480888,30,171,76,95,171,76,95,,,
480903,30,566,497,69,489,425,64,77,72,5
480921,30,88,73,15,88,73,15,,,
480930,30,37,0,37,28,0,28,9,0,9
480967,30,228,78,150,128,52,76,100,26,74
480976,30,63,6,57,63,6,57,,,
480985,30,279,1,278,279,1,278,,,
480994,30,116,4,112,90,4,86,26,0,26
481003,30,199,165,34,199,165,34,,,
481021,30,41,32,9,33,26,7,8,6,2
481049,30,18,4,14,18,4,14,,,
481058,30,100,42,58,85,35,50,15,7,8
481085,30,226,19,207,226,19,207,,,
481100,30,106,20,86,25,5,20,81,15,66
481128,30,83,11,72,69,11,58,14,0,14
481137,30,86,41,45,86,41,45,,,
481146,30,84,11,73,50,4,46,34,7,27
481155,30,170,66,104,170,66,104,,,
481182,30,32,5,27,32,5,27,,,
481191,30,230,35,195,230,35,195,,,
481207,30,131,18,113,131,18,113,,,
481225,30,17,10,7,17,10,7,,,
481243,30,248,0,248,79,0,79,169,0,169
481252,30,64,8,56,64,8,56,,,
481289,30,88,22,66,88,22,66,,,
481298,30,60,1,59,60,1,59,,,
481313,30,82,1,81,48,1,47,34,0,34
481322,30,48,2,46,15,0,15,33,2,31
481331,30,78,58,20,78,58,20,,,
481340,30,45,0,45,45,0,45,,,
481368,30,69,6,63,69,6,63,,,
481386,30,339,39,300,5,0,5,334,39,295
481401,30,184,120,64,22,15,7,162,105,57
481410,30,79,79,0,79,79,0,,,
481429,30,104,15,89,104,15,89,,,
481438,30,67,67,0,67,67,0,,,
481447,30,29,5,24,10,2,8,19,3,16
481456,30,15,1,14,5,0,5,10,1,9
481465,30,78,2,76,55,1,54,23,1,22
481474,30,131,2,129,122,2,120,9,0,9
481483,30,111,5,106,63,2,61,48,3,45
481517,30,91,7,84,53,5,48,38,2,36
481526,30,217,1,216,217,1,216,,,
481571,30,12,6,6,12,6,6,,,
481678,30,71,1,70,44,1,43,27,0,27
481720,30,47,4,43,32,1,31,15,3,12
481739,30,47,3,44,34,3,31,13,0,13
481748,30,112,2,110,92,2,90,20,0,20
481775,30,248,75,173,248,75,173,,,
481845,30,73,2,71,44,1,43,29,1,28
481863,30,55,4,51,55,4,51,,,
481890,30,52,2,50,52,2,50,,,
481906,30,41,1,40,41,1,40,,,
481960,30,172,142,30,172,142,30,,,
482015,30,772,555,217,772,555,217,,,
482060,30,238,33,205,238,33,205,,,
482097,30,340,168,172,323,164,159,17,4,13
482149,30,5098,1774,3324,4332,1473,2859,766,301,465
482158,30,6589,2942,3647,4214,1979,2235,2375,963,1412
482167,30,128,1,127,35,0,35,93,1,92
482176,30,252,9,243,182,7,175,70,2,68
482185,30,65,50,15,65,50,15,,,
482194,30,144,22,122,105,16,89,39,6,33
482200,30,64,12,52,64,12,52,,,
482228,30,123,75,48,38,27,11,85,48,37
482246,30,28,25,3,28,25,3,,,
482255,30,294,268,26,204,188,16,90,80,10
482291,30,1358,630,728,1358,630,728,,,
482413,30,423,212,211,238,137,101,185,75,110
482422,30,60,37,23,27,16,11,33,21,12
482431,30,1582,877,705,829,480,349,753,397,356
482459,30,281,122,159,114,49,65,167,73,94
482468,30,508,212,296,226,103,123,282,109,173
482477,30,23164,8130,15034,9437,3647,5790,13727,4483,9244
482547,30,10,6,4,4,3,1,6,3,3
482556,30,88,53,35,45,24,21,43,29,14
482565,30,8,3,5,2,1,1,6,2,4
482574,30,218,110,108,104,60,44,114,50,64
482635,30,84,55,29,47,33,14,37,22,15
482653,30,59,32,27,38,19,19,21,13,8
482680,30,15815,6988,8827,11591,5138,6453,4224,1850,2374
482699,30,1570,516,1054,1077,376,701,493,140,353
482705,30,1958,660,1298,633,67,566,1325,593,732
482936,30,1517,1234,283,1361,1108,253,156,126,30
482963,30,397,73,324,397,73,324,,,
482981,30,145,126,19,102,89,13,43,37,6
482990,30,259,20,239,259,20,239,,,
483009,30,206,23,183,206,23,183,,,
483018,30,127,38,89,127,38,89,,,
483036,30,1706,674,1032,584,270,314,1122,404,718
483045,30,5393,1938,3455,1618,652,966,3775,1286,2489
483054,30,104,75,29,104,75,29,,,
483106,30,207,28,179,145,19,126,62,9,53
483124,30,46412,17032,29380,17979,5771,12208,28433,11261,17172
483212,30,3160,1114,2046,1440,616,824,1720,498,1222
483221,30,32,15,17,32,15,17,,,
483230,30,148,140,8,121,114,7,27,26,1
483258,30,12,9,3,12,9,3,,,
483276,30,62,53,9,62,53,9,,,
483328,30,86,11,75,66,9,57,20,2,18
483337,30,153,6,147,97,4,93,56,2,54
483346,30,63,3,60,63,3,60,,,
483355,30,194,6,188,194,6,188,,,
483364,30,129,10,119,129,10,119,,,
483373,30,150,18,132,135,17,118,15,1,14
483382,30,232,228,4,232,228,4,,,
483425,30,51,3,48,51,3,48,,,
483470,30,63,5,58,63,5,58,,,
483504,30,359,114,245,359,114,245,,,
483513,30,31,21,10,31,21,10,,,
483559,30,58,7,51,37,5,32,21,2,19
483577,30,39,2,37,23,2,21,16,0,16
483595,30,4662,1068,3594,2600,604,1996,2062,464,1598
483647,30,32,2,30,32,2,30,,,
483708,30,266,50,216,91,11,80,175,39,136
483726,30,21,0,21,8,0,8,13,0,13
483735,30,70,6,64,36,4,32,34,2,32
483744,30,67,55,12,67,55,12,,,
483753,30,46,40,6,20,15,5,26,25,1
483780,30,176,115,61,167,109,58,9,6,3
483799,30,53,12,41,53,12,41,,,
483814,30,623,46,577,573,41,532,50,5,45
483823,30,635,450,185,635,450,185,,,
483841,30,26,4,22,26,4,22,,,
483850,30,7,1,6,7,1,6,,,
483869,30,124,33,91,124,33,91,,,
483878,30,211,20,191,211,20,191,,,
483887,30,36,10,26,36,10,26,,,
483896,30,202,7,195,32,2,30,170,5,165
483911,30,22,0,22,22,0,22,,,
483920,30,202,115,87,202,115,87,,,
483948,30,33,25,8,29,22,7,4,3,1
483957,30,42,11,31,42,11,31,,,
484002,30,1600,124,1476,1551,120,1431,49,4,45
484011,30,100,19,81,82,19,63,18,0,18
484020,30,61,45,16,36,27,9,25,18,7
484048,30,63,47,16,63,47,16,,,
484057,30,248,10,238,42,3,39,206,7,199
484066,30,360,22,338,360,22,338,,,
484075,30,32,21,11,19,12,7,13,9,4
484084,30,77,0,77,49,0,49,28,0,28
484093,30,138,3,135,82,1,81,56,2,54
484109,30,92,1,91,92,1,91,,,
484127,30,109,15,94,109,15,94,,,
484136,30,33,9,24,33,9,24,,,
484163,30,178,47,131,105,25,80,73,22,51
484172,30,5,1,4,5,1,4,,,
484190,30,19,14,5,19,14,5,,,
484206,30,233,1,232,144,1,143,89,0,89
484233,30,217,121,96,,,,217,121,96
484330,30,30,1,29,30,1,29,,,
484349,30,40,1,39,40,1,39,,,
484358,30,67,3,64,67,3,64,,,
484367,30,340,46,294,340,46,294,,,
484376,30,533,59,474,533,59,474,,,
484394,30,140,16,124,87,7,80,53,9,44
484473,30,4650,2187,2463,2514,1219,1295,2136,968,1168
484604,30,452,11,441,204,5,199,248,6,242
484613,30,66792,19664,47128,66792,19664,47128,,,
484631,30,438,276,162,438,276,162,,,
484710,30,30,22,8,30,22,8,,,
484756,30,54,26,28,54,26,28,,,
484844,30,613,259,354,613,259,354,,,
484862,30,3,0,3,3,0,3,,,
484871,30,115,115,0,115,115,0,,,
484899,30,209,5,204,209,5,204,,,
484905,30,2923,990,1933,1652,554,1098,1271,436,835
484923,30,61,0,61,50,0,50,11,0,11
484932,30,1578,655,923,948,359,589,630,296,334
484950,30,67,6,61,67,6,61,,,
484996,30,193,4,189,193,4,189,,,
485014,30,102,5,97,66,4,62,36,1,35
485032,30,169,9,160,90,5,85,79,4,75
485111,30,4134,1733,2401,2504,1118,1386,1630,615,1015
485166,30,84,21,63,84,21,63,,,
485236,30,70,2,68,23,0,23,47,2,45
485272,30,914,95,819,527,52,475,387,43,344
485342,30,155,103,52,155,103,52,,,
485360,30,35,1,34,35,1,34,,,
485379,30,281,63,218,281,63,218,,,
485388,30,304,38,266,304,38,266,,,
485397,30,139,2,137,97,2,95,42,0,42
485412,30,117,22,95,117,22,95,,,
485458,30,1580,459,1121,389,110,279,1191,349,842
485476,30,88,1,87,88,1,87,,,
485485,30,234,26,208,234,26,208,,,
485494,30,115,101,14,102,91,11,13,10,3
485500,30,117,107,10,8,8,0,109,99,10
485519,30,510,299,211,319,172,147,191,127,64
485546,30,155,84,71,6,3,3,149,81,68
485564,30,134,10,124,124,10,114,10,0,10
485573,30,213,28,185,202,27,175,11,1,10
485591,30,31,0,31,31,0,31,,,
485607,30,42,3,39,29,1,28,13,2,11
485698,30,141,121,20,139,121,18,2,0,2
485704,30,8,1,7,3,0,3,5,1,4
485768,30,443,301,142,443,301,142,,,
485801,30,95,14,81,95,14,81,,,
485856,30,39,10,29,16,5,11,23,5,18
485874,30,156,3,153,92,3,89,64,0,64
485926,30,229,61,168,228,60,168,1,1,0
485953,30,82,74,8,82,74,8,,,
485962,30,37,26,11,24,15,9,13,11,2
485999,30,91,91,0,91,91,0,,,
486017,30,23,23,0,23,23,0,,,
486026,30,117,117,0,117,117,0,,,
486053,30,115,67,48,83,45,38,32,22,10
486123,30,39,17,22,39,17,22,,,
486141,30,11,1,10,11,1,10,,,
486150,30,63,21,42,42,13,29,21,8,13
486169,30,56,46,10,56,46,10,,,
486196,30,189,189,0,189,189,0,,,
486202,30,23,3,20,23,3,20,,,
486239,30,70,33,37,56,27,29,14,6,8
486248,30,122,61,61,122,61,61,,,
486257,30,326,145,181,241,104,137,85,41,44
486284,30,222,64,158,206,62,144,16,2,14
486345,30,207,204,3,112,110,2,95,94,1
486354,30,37,17,20,37,17,20,,,
486372,30,105,78,27,98,73,25,7,5,2
486381,30,210,18,192,210,18,192,,,
486390,30,33,20,13,33,20,13,,,
486406,30,9,0,9,9,0,9,,,
486415,30,479,79,400,479,79,400,,,
486424,30,148,27,121,120,20,100,28,7,21
486442,30,73,14,59,73,14,59,,,
486488,30,23,18,5,20,16,4,3,2,1
486497,30,71,67,4,69,65,4,2,2,0
486503,30,57,1,56,57,1,56,,,
486512,30,426,202,224,426,202,224,,,
486530,30,157,3,154,157,3,154,,,
486558,30,240,223,17,160,146,14,80,77,3
486567,30,244,11,233,242,11,231,2,0,2
486576,30,115,38,77,115,38,77,,,
486619,30,135,5,130,103,5,98,32,0,32
486691,30,111,2,109,70,2,68,41,0,41
486707,30,85,5,80,85,5,80,,,
486716,30,71,2,69,71,2,69,,,
486752,30,43,2,41,43,2,41,,,
486770,30,108,30,78,108,30,78,,,
486798,30,1529,1347,182,1529,1347,182,,,
486813,30,673,123,550,673,123,550,,,
486822,30,879,100,779,879,100,779,,,
486840,30,38051,19066,18985,28554,14171,14383,9497,4895,4602
486859,30,27,0,27,27,0,27,,,
486877,30,11,1,10,11,1,10,,,
486886,30,31,0,31,13,0,13,18,0,18
486901,30,726,369,357,708,357,351,18,12,6
486938,30,567,98,469,212,40,172,355,58,297
486947,30,637,76,561,262,25,237,375,51,324
486956,30,1261,170,1091,428,65,363,833,105,728
486965,30,262,98,164,262,98,164,,,
486983,30,45,18,27,45,18,27,,,
487010,30,295,22,273,281,19,262,14,3,11
487047,30,85,4,81,85,4,81,,,
487065,30,70,1,69,70,1,69,,,
487083,30,33,0,33,33,0,33,,,
487092,30,1048,494,554,1048,494,554,,,
487162,30,2829,755,2074,1097,296,801,1732,459,1273
487232,30,106,5,101,106,5,101,,,
487302,30,473,107,366,472,107,365,1,0,1
487311,30,522,465,57,522,465,57,,,
487320,30,8775,6111,2664,4411,3545,866,4364,2566,1798
487348,30,113,1,112,46,1,45,67,0,67
487375,30,1142,154,988,797,110,687,345,44,301
487384,30,475,144,331,475,144,331,,,
487393,30,597,247,350,597,247,350,,,
487409,30,616,242,374,616,242,374,,,
487418,30,640,232,408,640,232,408,,,
487427,30,532,179,353,532,179,353,,,
487436,30,664,123,541,664,123,541,,,
487445,30,426,171,255,426,171,255,,,
487454,30,375,109,266,375,109,266,,,
487472,30,761,238,523,761,238,523,,,
487481,30,1422,453,969,1422,453,969,,,
487490,30,1029,186,843,1029,186,843,,,
487506,30,88,2,86,30,0,30,58,2,56
487524,30,2338,978,1360,2038,880,1158,300,98,202
487533,30,128,1,127,46,1,45,82,0,82
487588,30,358,11,347,358,11,347,,,
487597,30,1507,1445,62,1507,1445,62,,,
487603,30,519,193,326,290,100,190,229,93,136
487621,30,26,23,3,22,19,3,4,4,0
487658,30,94,76,18,94,76,18,,,
487676,30,198,14,184,96,1,95,102,13,89
487746,30,28,28,0,28,28,0,,,
487773,30,29,2,27,17,0,17,12,2,10
487791,30,503,457,46,308,279,29,195,178,17
487807,30,52,35,17,35,26,9,17,9,8
487816,30,12,0,12,12,0,12,,,
487852,30,32,9,23,,,,32,9,23
487861,30,306,44,262,240,36,204,66,8,58
487889,30,133,17,116,133,17,116,,,
487898,30,12,10,2,7,5,2,5,5,0
487904,30,26,16,10,26,16,10,,,
487922,30,65,0,65,52,0,52,13,0,13
487959,30,85,0,85,71,0,71,14,0,14
487968,30,72,6,66,72,6,66,,,
487977,30,2505,176,2329,2160,54,2106,345,122,223
487995,30,44,12,32,32,12,20,12,0,12
488004,30,28,28,0,28,28,0,,,
488013,30,224,12,212,207,11,196,17,1,16
488022,30,65,36,29,50,26,24,15,10,5
488031,30,48,19,29,47,19,28,1,0,1
488059,30,248,82,166,248,82,166,,,
488068,30,39,5,34,14,2,12,25,3,22
488077,30,4011,3916,95,2621,2546,75,1390,1370,20
488110,30,62,14,48,28,4,24,34,10,24
488129,30,26,0,26,4,0,4,22,0,22
488138,30,167,5,162,167,5,162,,,
488147,30,41,1,40,41,1,40,,,
488174,30,36,21,15,31,17,14,5,4,1
488183,30,15,1,14,15,1,14,,,
488192,30,68,66,2,68,66,2,,,
488217,30,93,4,89,93,4,89,,,
488226,30,16,8,8,16,8,8,,,
488253,30,69,43,26,42,29,13,27,14,13
488262,30,12,8,4,6,5,1,6,3,3
488271,30,85,2,83,85,2,83,,,
488280,30,37,29,8,37,29,8,,,
488299,30,47,9,38,37,9,28,10,0,10
488305,30,106,72,34,77,51,26,29,21,8
488314,30,96,96,0,96,96,0,,,
488332,30,204,23,181,204,23,181,,,
488350,30,126,126,0,126,126,0,,,
488369,30,70,54,16,70,54,16,,,
488378,30,92,6,86,91,6,85,1,0,1
488396,30,33,31,2,5,4,1,28,27,1
488411,30,103,1,102,103,1,102,,,
488420,30,190,20,170,,,,190,20,170
488439,30,69,56,13,55,44,11,14,12,2
488448,30,69,47,22,64,44,20,5,3,2
488563,30,19,12,7,18,11,7,1,1,0
488590,30,10,5,5,10,5,5,,,
488651,30,168,27,141,103,17,86,65,10,55
488679,30,5451,1308,4143,5032,1195,3837,419,113,306
488721,30,504,459,45,89,77,12,415,382,33
488730,30,5277,2260,3017,1295,627,668,3982,1633,2349
488749,30,121,27,94,105,24,81,16,3,13
488776,30,152,50,102,83,26,57,69,24,45
488785,30,204,97,107,190,88,102,14,9,5
488800,30,876,245,631,876,245,631,,,
488837,30,203,182,21,203,182,21,,,
488846,30,16253,8803,7450,8172,4422,3750,8081,4381,3700
488891,30,170,62,108,170,62,108,,,
488916,30,43,0,43,43,0,43,,,
488934,30,1216,786,430,613,331,282,603,455,148
488952,30,50,0,50,50,0,50,,,
488961,30,57,3,54,57,3,54,,,
488970,30,29,1,28,29,1,28,,,
488989,30,136,3,133,88,0,88,48,3,45
488998,30,103,18,85,102,18,84,1,0,1
489122,30,54,3,51,25,0,25,29,3,26
489131,30,71,8,63,36,1,35,35,7,28
489140,30,92,14,78,37,2,35,55,12,43
489159,30,146,3,143,102,2,100,44,1,43
489201,30,6448,2685,3763,1925,876,1049,4523,1809,2714
489238,30,75,6,69,45,4,41,30,2,28
489247,30,55,10,45,23,5,18,32,5,27
489256,30,200,188,12,198,186,12,2,2,0
489283,30,670,110,560,670,110,560,,,
489344,30,268,22,246,84,5,79,184,17,167
489353,30,597,133,464,316,72,244,281,61,220
489371,30,214,193,21,214,193,21,,,
489779,30,33339,13912,19427,5350,1939,3411,27989,11973,16016
489812,30,56,0,56,56,0,56,,,
489830,30,76,3,73,76,3,73,,,
489937,30,350,186,164,297,165,132,53,21,32
490018,30,23,20,3,23,20,3,,,
490045,30,36,13,23,16,6,10,20,7,13
490054,30,289,95,194,191,65,126,98,30,68
490081,30,18,8,10,14,8,6,4,0,4
490090,30,54,30,24,31,12,19,23,18,5
490115,30,57,46,11,57,46,11,,,
490124,30,5,2,3,5,2,3,,,
490133,30,1817,1128,689,1719,1077,642,98,51,47
490142,30,42,6,36,15,4,11,27,2,25
490151,30,63,1,62,46,1,45,17,0,17
490160,30,99,10,89,99,10,89,,,
490197,30,42,12,30,42,12,30,,,
490203,30,130,10,120,55,3,52,75,7,68
490221,30,9,1,8,7,0,7,2,1,1
490230,30,252,108,144,251,107,144,1,1,0
490249,30,27,23,4,27,23,4,,,
490258,30,131,22,109,131,22,109,,,
490267,30,25,22,3,20,20,0,5,2,3
490276,30,131,131,0,131,131,0,,,
490285,30,356,290,66,356,290,66,,,
490294,30,124,34,90,120,32,88,4,2,2
490300,30,84,23,61,44,1,43,40,22,18
490319,30,12,12,0,12,12,0,,,
490328,30,94,94,0,94,94,0,,,
490346,30,68,0,68,68,0,68,,,
490382,30,36,8,28,36,8,28,,,
490391,30,114,2,112,114,2,112,,,
490407,30,79,1,78,46,1,45,33,0,33
490416,30,26,20,6,26,20,6,,,
490425,30,167,2,165,167,2,165,,,
490434,30,30,0,30,30,0,30,,,
490443,30,115,0,115,115,0,115,,,
490452,30,50,3,47,21,3,18,29,0,29
490461,30,66,3,63,66,3,63,,,
490470,30,15,2,13,15,2,13,,,
490489,30,43,33,10,35,27,8,8,6,2
490498,30,28,21,7,28,21,7,,,
490504,30,22,22,0,22,22,0,,,
490513,30,34,34,0,34,34,0,,,
490522,30,21,0,21,21,0,21,,,
490531,30,46,36,10,23,18,5,23,18,5
490559,30,392,19,373,392,19,373,,,
490674,30,7,0,7,7,0,7,,,
490692,30,48,40,8,48,40,8,,,
490717,30,74,8,66,74,8,66,,,
490735,30,95,5,90,95,5,90,,,
490744,30,30,26,4,30,26,4,,,
490753,30,11,5,6,11,5,6,,,
490805,30,6083,2755,3328,4684,2272,2412,1399,483,916
490814,30,94,4,90,94,4,90,,,
490832,30,212,13,199,157,8,149,55,5,50
490841,30,228,6,222,228,6,222,,,
490869,30,322,28,294,322,28,294,,,
490878,30,418,75,343,418,75,343,,,
490896,30,100,7,93,66,4,62,34,3,31
490948,30,9,6,3,9,6,3,,,
490975,30,357,52,305,334,48,286,23,4,19
491057,30,292,292,0,292,292,0,,,
491066,30,71,2,69,21,0,21,50,2,48
491075,30,69,62,7,69,62,7,,,
491084,30,53,0,53,53,0,53,,,
491136,30,87,2,85,54,1,53,33,1,32
491145,30,103,0,103,68,0,68,35,0,35
491181,30,470,59,411,254,33,221,216,26,190
491190,30,4,2,2,4,2,2,,,
491215,30,57,55,2,57,55,2,,,
491224,30,83,4,79,49,1,48,34,3,31
491233,30,26,0,26,18,0,18,8,0,8
491242,30,66,34,32,66,34,32,,,
491251,30,68,41,27,68,41,27,,,
491260,30,80,2,78,56,2,54,24,0,24
491288,30,606,171,435,76,22,54,530,149,381
491297,30,145,59,86,10,4,6,135,55,80
491394,30,103,83,20,97,80,17,6,3,3
491446,30,159,0,159,156,0,156,3,0,3
491464,30,193,41,152,193,41,152,,,
491473,30,750,432,318,43,2,41,707,430,277
491507,30,10,0,10,10,0,10,,,
491525,30,92,48,44,61,30,31,31,18,13
491534,30,14,3,11,,,,14,3,11
491543,30,97,20,77,61,13,48,36,7,29
491552,30,32,0,32,32,0,32,,,
491570,30,32,0,32,32,0,32,,,
491589,30,26,18,8,7,4,3,19,14,5
491598,30,24,1,23,24,1,23,,,
491613,30,69,69,0,69,69,0,,,
491622,30,81,81,0,81,81,0,,,
491631,30,134,0,134,121,0,121,13,0,13
491640,30,186,186,0,186,186,0,,,
491659,30,104,62,42,104,62,42,,,
491668,30,162,4,158,162,4,158,,,
491677,30,37,24,13,20,14,6,17,10,7
491686,30,34,27,7,34,27,7,,,
491695,30,37,0,37,37,0,37,,,
491701,30,37,10,27,,,,37,10,27
491710,30,64,64,0,64,64,0,,,
491729,30,17,0,17,17,0,17,,,
491738,30,63,7,56,57,6,51,6,1,5
491747,30,17,2,15,17,2,15,,,
491756,30,99,82,17,99,82,17,,,
491765,30,89,89,0,89,89,0,,,
491774,30,144,20,124,102,12,90,42,8,34
491783,30,78,66,12,22,19,3,56,47,9
491792,30,74,3,71,74,3,71,,,
491817,30,200,0,200,200,0,200,,,
491826,30,97,0,97,97,0,97,,,
491835,30,86,1,85,86,1,85,,,
491844,30,175,53,122,116,36,80,59,17,42
491853,30,53,0,53,53,0,53,,,
491871,30,18,0,18,13,0,13,5,0,5
491880,30,97,95,2,97,95,2,,,
491899,30,103,9,94,16,1,15,87,8,79
491905,30,109,4,105,109,4,105,,,
491914,30,178,178,0,178,178,0,,,
491923,30,328,2,326,288,2,286,40,0,40
491932,30,27,23,4,27,23,4,,,
491941,30,153,6,147,153,6,147,,,
491950,30,921,127,794,43,9,34,878,118,760
491978,30,50,21,29,10,5,5,40,16,24
491996,30,45,3,42,45,3,42,,,
492005,30,56,1,55,45,1,44,11,0,11
492023,30,273,41,232,,,,273,41,232
492032,30,29,0,29,,,,29,0,29
492069,30,77,44,33,71,43,28,6,1,5
492078,30,98,97,1,,,,98,97,1
492096,30,7,0,7,7,0,7,,,
492139,30,209,179,30,209,179,30,,,
492148,30,5,1,4,5,1,4,,,
492281,30,62,45,17,62,45,17,,,
492306,30,174,44,130,,,,174,44,130
492315,30,110,20,90,,,,110,20,90
492324,30,192,16,176,,,,192,16,176
492360,30,48,18,30,36,16,20,12,2,10
492421,30,24,21,3,24,21,3,,,
492449,30,611,139,472,611,139,472,,,
492476,30,226,45,181,79,13,66,147,32,115
492607,30,2,0,2,,,,2,0,2
492643,30,88,19,69,88,19,69,,,
492652,30,22,13,9,22,13,9,,,
492661,30,246,36,210,246,36,210,,,
492689,30,257,43,214,215,38,177,42,5,37
492722,30,340,27,313,340,27,313,,,
492731,30,174,28,146,121,22,99,53,6,47
492759,30,361,34,327,155,13,142,206,21,185
492801,30,712,240,472,424,140,284,288,100,188
492935,30,129,14,115,129,14,115,,,
492953,30,107,5,102,61,3,58,46,2,44
492962,30,2457,936,1521,1090,388,702,1367,548,819
493071,30,499,122,377,499,122,377,,,
493080,30,362,181,181,66,38,28,296,143,153
493132,30,1125,1090,35,1125,1090,35,,,
493150,30,174,15,159,174,15,159,,,
493372,30,17,6,11,17,6,11,,,
493451,30,67,13,54,67,13,54,,,
493479,30,18,8,10,18,8,10,,,
493488,30,22,4,18,22,4,18,,,
493512,30,132,92,40,114,84,30,18,8,10
493521,30,38,29,9,37,28,9,1,1,0
493530,30,46,15,31,28,7,21,18,8,10
493549,30,111,102,9,111,102,9,,,
493558,30,12,11,1,12,11,1,,,
493567,30,51,2,49,,,,51,2,49
493576,30,11,0,11,11,0,11,,,
493585,30,64,3,61,64,3,61,,,
493594,30,40,40,0,40,40,0,,,
493600,30,175,175,0,175,175,0,,,
493619,30,24,11,13,21,10,11,3,1,2
493628,30,152,9,143,75,2,73,77,7,70
493637,30,19,1,18,19,1,18,,,
493646,30,246,0,246,246,0,246,,,
493655,30,21,13,8,20,13,7,1,0,1
493664,30,59,59,0,56,56,0,3,3,0
493673,30,3,1,2,3,1,2,,,
493682,30,76,6,70,69,4,65,7,2,5
493691,30,35,0,35,25,0,25,10,0,10
493707,30,82,82,0,82,82,0,,,
493716,30,68,68,0,67,67,0,1,1,0
493743,30,221,171,50,113,89,24,108,82,26
493752,30,4,0,4,4,0,4,,,
493761,30,128,47,81,26,12,14,102,35,67
493770,30,32,1,31,32,1,31,,,
493798,30,114,0,114,100,0,100,14,0,14
493804,30,95,68,27,95,68,27,,,
493813,30,162,10,152,162,10,152,,,
493822,30,247,55,192,164,34,130,83,21,62
493831,30,42,27,15,42,27,15,,,
493868,30,38,27,11,32,23,9,6,4,2
493895,30,299,265,34,136,124,12,163,141,22
493910,30,33,1,32,11,0,11,22,1,21
493992,30,263,61,202,263,61,202,,,
494001,30,95,1,94,25,0,25,70,1,69
494029,30,17,11,6,10,8,2,7,3,4
494162,30,296,31,265,184,14,170,112,17,95
494232,30,25,1,24,18,1,17,7,0,7
494250,30,693,42,651,693,42,651,,,
494278,30,243,39,204,80,6,74,163,33,130
494287,30,448,115,333,147,40,107,301,75,226
494357,30,965,354,611,965,354,611,,,
494436,30,295,62,233,295,62,233,,,
494463,30,290,0,290,290,0,290,,,
494472,30,14,0,14,6,0,6,8,0,8
494524,30,84,4,80,83,4,79,1,0,1
494588,30,369,44,325,369,44,325,,,
494597,30,53,25,28,45,21,24,8,4,4
494603,30,288,184,104,195,127,68,93,57,36
494621,30,108,8,100,12,3,9,96,5,91
494630,30,47,26,21,43,24,19,4,2,2
494649,30,23,0,23,9,0,9,14,0,14
494658,30,57,2,55,45,2,43,12,0,12
494685,30,467,189,278,388,148,240,79,41,38
494694,30,74,4,70,74,4,70,,,
494700,30,35,2,33,35,2,33,,,
494719,30,73,38,35,40,18,22,33,20,13
494728,30,54,43,11,51,41,10,3,2,1
494737,30,171,171,0,171,171,0,,,
494746,30,471,84,387,471,84,387,,,
494755,30,60,8,52,60,8,52,,,
494764,30,169,159,10,128,119,9,41,40,1
494807,30,46,4,42,46,4,42,,,
494843,30,548,38,510,548,38,510,,,
494852,30,473,102,371,473,102,371,,,
494898,30,69,12,57,69,12,57,,,
494904,30,138,30,108,48,10,38,90,20,70
494959,30,53,13,40,16,4,12,37,9,28
494986,30,36,1,35,26,1,25,10,0,10
494995,30,35,33,2,35,33,2,,,
495013,30,219,194,25,,,,219,194,25
495031,30,68,68,0,64,64,0,4,4,0
495040,30,50,2,48,50,2,48,,,
495059,30,45,23,22,43,22,21,2,1,1
495077,30,77,5,72,77,5,72,,,
495101,30,62,11,51,62,11,51,,,
495110,30,23,21,2,23,21,2,,,
495129,30,76,63,13,76,63,13,,,
495138,30,12,2,10,12,2,10,,,
495147,30,23,11,12,11,9,2,12,2,10
495165,30,32,9,23,32,9,23,,,
495174,30,38,18,20,,,,38,18,20
495183,30,150,64,86,150,64,86,,,
495208,30,23,14,9,23,14,9,,,
495217,30,29,22,7,29,22,7,,,
495226,30,4,0,4,4,0,4,,,
495235,30,22,2,20,11,0,11,11,2,9
495244,30,21,1,20,14,0,14,7,1,6
495253,30,55,11,44,53,11,42,2,0,2
495262,30,45,0,45,22,0,22,23,0,23
495271,30,57,13,44,8,0,8,49,13,36
495280,30,27,15,12,20,12,8,7,3,4
495299,30,54,10,44,54,10,44,,,
495305,30,100,24,76,55,18,37,45,6,39
495341,30,50,36,14,50,36,14,,,
495350,30,22,8,14,22,8,14,,,
495369,30,59,7,52,31,4,27,28,3,25
495378,30,73,5,68,10,0,10,63,5,58
495387,30,52,38,14,29,21,8,23,17,6
495396,30,27,2,25,27,2,25,,,
495411,30,91,10,81,90,10,80,1,0,1
495420,30,320,39,281,192,23,169,128,16,112
495439,30,321,22,299,211,17,194,110,5,105
495448,30,516,59,457,385,39,346,131,20,111
495457,30,746,78,668,503,51,452,243,27,216
495518,30,85,3,82,54,2,52,31,1,30
495730,30,83,3,80,45,1,44,38,2,36
495776,30,20,19,1,20,19,1,,,
495794,30,247,4,243,167,2,165,80,2,78
495837,30,118,16,102,118,16,102,,,
495925,30,68,8,60,68,8,60,,,
495934,30,79,8,71,79,8,71,,,
495943,30,14,1,13,14,1,13,,,
495952,30,146,42,104,146,42,104,,,
495961,30,110,7,103,110,7,103,,,
495970,30,331,106,225,331,106,225,,,
495998,30,72,4,68,72,4,68,,,
496052,30,15,13,2,15,13,2,,,
496061,30,241,11,230,104,7,97,137,4,133
496186,30,166,147,19,164,145,19,2,2,0
496265,30,50,44,6,50,44,6,,,
496283,30,178,24,154,178,24,154,,,
496326,30,312,32,280,312,32,280,,,
496371,30,8,8,0,8,8,0,,,
496399,30,37,5,32,37,5,32,,,
496478,30,55,40,15,,,,55,40,15
496520,30,74,19,55,,,,74,19,55
496539,30,68,1,67,45,0,45,23,1,22
496618,30,161,9,152,161,9,152,,,
496627,30,146,63,83,146,63,83,,,
496636,30,213,40,173,213,40,173,,,
496645,30,157,105,52,47,5,42,110,100,10
496654,30,33,6,27,24,4,20,9,2,7
496663,30,29,21,8,27,19,8,2,2,0
496672,30,41,7,34,21,7,14,20,0,20
496681,30,131,4,127,131,4,127,,,
496690,30,43,6,37,37,4,33,6,2,4
496706,30,169,111,58,169,111,58,,,
496715,30,61,6,55,61,6,55,,,
496724,30,40,0,40,40,0,40,,,
496733,30,84,2,82,84,2,82,,,
496751,30,25,13,12,25,13,12,,,
496803,30,18,9,9,18,9,9,,,
496894,30,35,2,33,11,0,11,24,2,22
496919,30,858,383,475,858,383,475,,,
496955,30,676,259,417,676,259,417,,,
496964,30,22,14,8,22,14,8,,,
496973,30,185,29,156,118,17,101,67,12,55
496991,30,418,61,357,241,28,213,177,33,144
497000,30,217,56,161,217,56,161,,,
497037,30,766,149,617,460,80,380,306,69,237
497046,30,4204,1372,2832,680,250,430,3524,1122,2402
497073,30,406,11,395,185,5,180,221,6,215
497107,30,85,14,71,,,,85,14,71
497116,30,626,67,559,346,36,310,280,31,249
497125,30,377,38,339,172,18,154,205,20,185
497161,30,122,107,15,99,85,14,23,22,1
497189,30,31,2,29,31,2,29,,,
497198,30,114,3,111,71,1,70,43,2,41
497204,30,107,87,20,36,24,12,71,63,8
497213,30,35,17,18,20,13,7,15,4,11
497222,30,25,2,23,20,2,18,5,0,5
497268,30,258,24,234,181,14,167,77,10,67
497277,30,453,75,378,453,75,378,,,
497286,30,434,403,31,434,403,31,,,
497301,30,379,9,370,211,4,207,168,5,163
497310,30,108,1,107,108,1,107,,,
497329,30,282,70,212,282,70,212,,,
497338,30,96,9,87,96,9,87,,,
497356,30,40,24,16,37,22,15,3,2,1
497365,30,24,19,5,24,19,5,,,
497374,30,139,19,120,139,19,120,,,
497383,30,11,10,1,11,10,1,,,
497392,30,86,70,16,17,15,2,69,55,14
497408,30,60,34,26,47,29,18,13,5,8
497417,30,18,0,18,18,0,18,,,
497426,30,118,14,104,94,2,92,24,12,12
497435,30,76,21,55,76,21,55,,,
497444,30,25,9,16,5,3,2,20,6,14
497453,30,2,0,2,1,0,1,1,0,1
497462,30,36,23,13,11,8,3,25,15,10
497471,30,8,1,7,3,1,2,5,0,5
497480,30,774,48,726,708,26,682,66,22,44
497499,30,42,41,1,,,,42,41,1
497675,30,30,2,28,18,2,16,12,0,12
497684,30,41,1,40,41,1,40,,,
497736,30,54,6,48,54,6,48,,,
497745,30,150,131,19,124,110,14,26,21,5
497790,30,107,103,4,107,103,4,,,
497824,30,226,98,128,94,37,57,132,61,71
497833,30,226,104,122,217,104,113,9,0,9
497888,30,104,7,97,67,3,64,37,4,33
497897,30,185,8,177,185,8,177,,,
497903,30,4,0,4,4,0,4,,,
497912,30,101,7,94,101,7,94,,,
497949,30,595,182,413,595,182,413,,,
497958,30,520,133,387,520,133,387,,,
498003,30,209,85,124,153,66,87,56,19,37
498012,30,274,258,16,274,258,16,,,
498030,30,152,144,8,152,144,8,,,
498049,30,297,20,277,185,11,174,112,9,103
498076,30,130,10,120,44,3,41,86,7,79
498085,30,256,22,234,105,8,97,151,14,137
498094,30,212,8,204,83,5,78,129,3,126
498100,30,252,18,234,21,0,21,231,18,213
498119,30,52,4,48,13,0,13,39,4,35
498243,30,6,1,5,6,1,5,,,
498322,30,104,0,104,104,0,104,,,
498331,30,127,63,64,15,5,10,112,58,54
498340,30,74,9,65,74,9,65,,,
498359,30,68,0,68,38,0,38,30,0,30
498368,30,4,0,4,,,,4,0,4
498377,30,73,69,4,73,69,4,,,
498386,30,48,24,24,42,24,18,6,0,6
498401,30,47,2,45,38,2,36,9,0,9
498410,30,26,23,3,18,16,2,8,7,1
498447,30,144,9,135,73,8,65,71,1,70
498456,30,210,23,187,141,14,127,69,9,60
498465,30,136,108,28,136,108,28,,,
498483,30,26,4,22,23,4,19,3,0,3
498553,30,141,58,83,141,58,83,,,
498562,30,9778,3827,5951,9047,3551,5496,731,276,455
498571,30,9203,3588,5615,7854,3085,4769,1349,503,846
100654,31,1557,622,935,1547,618,929,10,4,6
100663,31,2217,755,1462,2172,733,1439,45,22,23
100706,31,1172,753,419,1154,743,411,18,10,8
100724,31,943,361,582,938,360,578,5,1,4
100751,31,8037,3490,4547,7981,3462,4519,56,28,28
100760,31,349,161,188,270,116,154,79,45,34
100830,31,407,133,274,384,123,261,23,10,13
100858,31,5303,2481,2822,5282,2469,2813,21,12,9
100937,31,244,142,102,244,142,102,,,
101028,31,265,104,161,191,76,115,74,28,46
101116,31,17,2,15,13,1,12,4,1,3
101143,31,462,236,226,354,185,169,108,51,57
101161,31,1496,617,879,1191,485,706,305,132,173
101189,31,225,130,95,206,126,80,19,4,15
101240,31,969,432,537,808,355,453,161,77,84
101277,31,37,0,37,37,0,37,,,
101286,31,770,294,476,494,185,309,276,109,167
101295,31,1296,507,789,947,392,555,349,115,234
101301,31,273,141,132,238,127,111,35,14,21
101365,31,99,33,66,15,1,14,84,32,52
101435,31,258,156,102,258,156,102,,,
101453,31,3,2,1,3,2,1,,,
101462,31,137,67,70,68,37,31,69,30,39
101471,31,467,423,44,392,354,38,75,69,6
101480,31,1941,801,1140,1911,788,1123,30,13,17
101505,31,1318,517,801,770,304,466,548,213,335
101514,31,1625,786,839,997,482,515,628,304,324
101569,31,678,274,404,422,180,242,256,94,162
101587,31,309,124,185,300,119,181,9,5,4
101602,31,418,186,232,369,157,212,49,29,20
101648,31,195,134,61,195,134,61,,,
101675,31,296,149,147,296,149,147,,,
101693,31,272,107,165,272,107,165,,,
101709,31,544,220,324,540,218,322,4,2,2
101736,31,649,306,343,440,219,221,209,87,122
101879,31,1140,422,718,1106,409,697,34,13,21
101897,31,541,226,315,430,180,250,111,46,65
101912,31,378,180,198,374,176,198,4,4,0
101994,31,82,51,31,75,49,26,7,2,5
102030,31,589,269,320,410,208,202,179,61,118
102049,31,974,289,685,972,289,683,2,0,2
102058,31,3,0,3,,,,3,0,3
102067,31,972,446,526,735,355,380,237,91,146
102076,31,565,207,358,502,188,314,63,19,44
102094,31,1614,609,1005,1599,602,997,15,7,8
102234,31,226,100,126,225,99,126,1,1,0
102270,31,149,68,81,123,53,70,26,15,11
102298,31,117,77,40,113,75,38,4,2,2
102313,31,387,178,209,264,134,130,123,44,79
102368,31,1683,638,1045,1413,515,898,270,123,147
102377,31,533,211,322,533,211,322,,,
102395,31,3,2,1,1,0,1,2,2,0
102429,31,674,312,362,505,215,290,169,97,72
102553,31,1072,471,601,705,330,375,367,141,226
102580,31,3,1,2,3,1,2,,,
102614,31,685,307,378,561,266,295,124,41,83
102632,31,165,69,96,111,51,60,54,18,36
102669,31,30,8,22,24,7,17,6,1,5
102711,31,168,115,53,109,74,35,59,41,18
102845,31,522,162,360,522,162,360,,,
103501,31,186,24,162,186,24,162,,,
103741,31,77,2,75,58,2,56,19,0,19
103893,31,172,36,136,172,36,136,,,
103909,31,68,11,57,68,11,57,,,
103927,31,73,15,58,73,15,58,,,
103954,31,4,0,4,4,0,4,,,
103963,31,169,145,24,169,145,24,,,
104090,31,60,0,60,60,0,60,,,
104151,31,15151,7705,7446,14980,7617,7363,171,88,83
104160,31,2096,901,1195,579,229,350,1517,672,845
104179,31,9069,3830,5239,6154,2602,3552,2915,1228,1687
104346,31,1474,700,774,367,175,192,1107,525,582
104391,31,69,2,67,69,2,67,,,
104425,31,810,370,440,511,226,285,299,144,155
104443,31,26,0,26,20,0,20,6,0,6
104568,31,233,2,231,114,2,112,119,0,119
104577,31,794,393,401,510,249,261,284,144,140
104586,31,756,529,227,756,529,227,,,
104708,31,2094,1031,1063,1200,603,597,894,428,466
104717,31,8445,3248,5197,7401,2913,4488,1044,335,709
105145,31,492,252,240,224,107,117,268,145,123
105154,31,2317,1154,1163,1228,610,618,1089,544,545
105206,31,483,213,270,108,70,38,375,143,232
105215,31,267,254,13,267,254,13,,,
105297,31,164,62,102,123,48,75,41,14,27
105330,31,5575,2100,3475,5434,2052,3382,141,48,93
105349,31,128,56,72,43,23,20,85,33,52
105428,31,1146,468,678,578,225,353,568,243,325
105525,31,2797,1326,1471,1066,524,542,1731,802,929
105534,31,141,35,106,141,35,106,,,
105543,31,101,13,88,101,13,88,,,
105589,31,33,15,18,32,15,17,1,0,1
105659,31,342,306,36,342,306,36,,,
105668,31,833,374,459,162,80,82,671,294,377
105677,31,14,13,1,14,13,1,,,
105747,31,785,399,386,399,212,187,386,187,199
105792,31,525,251,274,312,160,152,213,91,122
105899,31,301,174,127,295,170,125,6,4,2
106041,31,797,755,42,797,755,42,,,
106148,31,891,435,456,484,255,229,407,180,227
106245,31,549,245,304,523,232,291,26,13,13
106306,31,163,122,41,136,102,34,27,20,7
106315,31,7,1,6,7,1,6,,,
106324,31,25,1,24,15,1,14,10,0,10
106342,31,146,90,56,144,89,55,2,1,1
106351,31,3,2,1,3,2,1,,,
106397,31,7099,3166,3933,7063,3150,3913,36,16,20
106412,31,575,273,302,504,233,271,71,40,31
106449,31,614,269,345,541,246,295,73,23,50
106458,31,1325,566,759,1240,529,711,85,37,48
106467,31,1452,675,777,1385,647,738,67,28,39
106485,31,393,189,204,374,187,187,19,2,17
106494,31,6,0,6,6,0,6,,,
106546,31,4,0,4,4,0,4,,,
106625,31,297,132,165,251,110,141,46,22,24
106704,31,1803,636,1167,1799,634,1165,4,2,2
106713,31,103,64,39,103,64,39,,,
106795,31,256,115,141,181,88,93,75,27,48
106810,31,54,30,24,54,30,24,,,
106883,31,135,62,73,99,44,55,36,18,18
106908,31,49,1,48,48,1,47,1,0,1
106980,31,542,256,286,474,234,240,68,22,46
106999,31,245,88,157,186,66,120,59,22,37
107044,31,804,360,444,801,358,443,3,2,1
107071,31,413,183,230,404,178,226,9,5,4
107080,31,363,189,174,363,189,174,,,
107099,31,9,1,8,9,1,8,,,
107141,31,306,127,179,304,126,178,2,1,1
107220,31,173,5,168,173,5,168,,,
107293,31,21,0,21,21,0,21,,,
107318,31,107,42,65,56,17,39,51,25,26
107327,31,190,76,114,149,63,86,41,13,28
107442,31,3,3,0,3,3,0,,,
107460,31,358,182,176,306,151,155,52,31,21
107488,31,198,144,54,197,143,54,1,1,0
107512,31,445,182,263,445,182,263,,,
107521,31,103,49,54,90,43,47,13,6,7
107549,31,136,66,70,121,62,59,15,4,11
107558,31,229,107,122,229,107,122,,,
107585,31,479,218,261,410,184,226,69,34,35
107600,31,237,116,121,217,105,112,20,11,9
107619,31,143,55,88,115,49,66,28,6,22
107637,31,157,73,84,45,20,25,112,53,59
107655,31,2,0,2,2,0,2,,,
107664,31,785,315,470,605,246,359,180,69,111
107725,31,153,60,93,114,54,60,39,6,33
107743,31,157,71,86,135,59,76,22,12,10
107789,31,29,0,29,29,0,29,,,
107831,31,5,0,5,5,0,5,,,
107840,31,119,54,65,112,51,61,7,3,4
107877,31,144,59,85,144,59,85,,,
107974,31,201,82,119,165,70,95,36,12,24
107983,31,707,315,392,703,314,389,4,1,3
107992,31,219,121,98,195,111,84,24,10,14
108065,31,7,0,7,4,0,4,3,0,3
108092,31,832,319,513,764,280,484,68,39,29
108232,31,354,140,214,163,64,99,191,76,115
108667,31,766,387,379,159,90,69,607,297,310
108807,31,1351,726,625,780,413,367,571,313,258
108852,31,56,24,32,56,24,32,,,
108861,31,12,6,6,3,2,1,9,4,5
108977,31,33,11,22,11,5,6,22,6,16
109040,31,130,25,105,130,25,105,,,
109208,31,3446,2078,1368,1147,613,534,2299,1465,834
109350,31,2391,1201,1190,1272,626,646,1119,575,544
109651,31,275,109,166,275,109,166,,,
109721,31,146,31,115,146,31,115,,,
109730,31,41,21,20,41,21,20,,,
109785,31,518,161,357,510,158,352,8,3,5
109819,31,3001,1541,1460,1604,752,852,1397,789,608
109907,31,482,207,275,260,104,156,222,103,119
109934,31,78,8,70,78,8,70,,,
110060,31,25,21,4,23,20,3,2,1,1
110097,31,706,292,414,694,287,407,12,5,7
110194,31,203,203,0,203,203,0,,,
110219,31,373,61,312,373,61,312,,,
110246,31,2194,1109,1085,1093,545,548,1101,564,537
110334,31,1439,745,694,549,296,253,890,449,441
110361,31,1303,488,815,1269,480,789,34,8,26
110370,31,191,65,126,190,64,126,1,1,0
110404,31,224,116,108,224,116,108,,,
110413,31,602,279,323,602,279,323,,,
110422,31,5110,2412,2698,5099,2407,2692,11,5,6
110486,31,1107,391,716,1080,383,697,27,8,19
110495,31,1031,346,685,963,318,645,68,28,40
110510,31,2324,965,1359,2236,925,1311,88,40,48
110529,31,3655,2028,1627,3576,1984,1592,79,44,35
110538,31,2020,938,1082,1970,918,1052,50,20,30
110547,31,2062,918,1144,1908,839,1069,154,79,75
110556,31,3458,1420,2038,3236,1328,1908,222,92,130
110565,31,5280,2200,3080,4965,2054,2911,315,146,169
110574,31,896,393,503,882,384,498,14,9,5
110583,31,5365,2093,3272,5260,2042,3218,105,51,54
110592,31,3892,1766,2126,3715,1687,2028,177,79,98
110608,31,4972,2350,2622,4899,2315,2584,73,35,38
110617,31,3915,1721,2194,3804,1658,2146,111,63,48
110635,31,6726,2700,4026,6680,2681,3999,46,19,27
110644,31,6399,2495,3904,6292,2457,3835,107,38,69
110653,31,5664,2176,3488,5656,2174,3482,8,2,6
110662,31,6462,2410,4052,6450,2408,4042,12,2,10
110671,31,5573,2640,2933,5522,2615,2907,51,25,26
110680,31,6546,2790,3756,6530,2782,3748,16,8,8
110705,31,4966,2089,2877,4944,2079,2865,22,10,12
110714,31,3859,1705,2154,3834,1697,2137,25,8,17
110875,31,14,1,13,14,1,13,,,
110918,31,1,0,1,,,,1,0,1
111045,31,2,1,1,2,1,1,,,
111054,31,19,4,15,19,4,15,,,
111081,31,189,60,129,189,60,129,,,
111188,31,145,123,22,145,123,22,,,
111434,31,723,365,358,268,162,106,455,203,252
111461,31,2320,1290,1030,1354,705,649,966,585,381
111513,31,32,0,32,29,0,29,3,0,3
111638,31,12,8,4,12,8,4,,,
111708,31,24,20,4,24,20,4,,,
111717,31,40,34,6,40,34,6,,,
111726,31,22,16,6,22,16,6,,,
111744,31,26,26,0,26,26,0,,,
111762,31,18,9,9,18,9,9,,,
111799,31,24,4,20,24,4,20,,,
111887,31,3925,2012,1913,2282,1165,1117,1643,847,796
111896,31,712,422,290,185,106,79,527,316,211
111920,31,2020,1097,923,907,478,429,1113,619,494
111939,31,3161,1506,1655,1685,817,868,1476,689,787
111948,31,2076,737,1339,2061,732,1329,15,5,10
111966,31,14,4,10,14,4,10,,,
112075,31,344,136,208,344,136,208,,,
112084,31,44,16,28,38,14,24,6,2,4
112172,31,1712,897,815,1193,611,582,519,286,233
112181,31,45,0,45,45,0,45,,,
112190,31,2671,1342,1329,1097,599,498,1574,743,831
112260,31,322,157,165,322,157,165,,,
112288,31,450,20,430,450,20,430,,,
112367,31,45,9,36,24,5,19,21,4,17
112385,31,1058,633,425,113,59,54,945,574,371
112394,31,42,29,13,39,26,13,3,3,0
112455,31,10,1,9,10,1,9,,,
112561,31,347,185,162,212,103,109,135,82,53
112570,31,22,12,10,22,12,10,,,
112686,31,351,172,179,174,82,92,177,90,87
112826,31,771,408,363,377,207,170,394,201,193
113096,31,2534,1277,1257,1179,587,592,1355,690,665
113111,31,964,475,489,476,234,242,488,241,247
113193,31,1020,551,469,546,289,257,474,262,212
113218,31,1187,620,567,461,254,207,726,366,360
113236,31,2525,1171,1354,1564,700,864,961,471,490
113333,31,3511,1912,1599,2616,1460,1156,895,452,443
113449,31,43,16,27,43,16,27,,,
113573,31,1890,890,1000,1178,548,630,712,342,370
113582,31,8,2,6,7,1,6,1,1,0
113634,31,2559,1417,1142,1566,860,706,993,557,436
113698,31,217,50,167,215,50,165,2,0,2
113856,31,3183,1606,1577,1601,793,808,1582,813,769
113980,31,3822,1972,1850,2268,1185,1083,1554,787,767
114266,31,1298,644,654,615,299,316,683,345,338
114354,31,349,57,292,316,49,267,33,8,25
114433,31,291,170,121,152,84,68,139,86,53
114460,31,52,9,43,43,5,38,9,4,5
114637,31,2,1,1,2,1,1,,,
114716,31,1691,863,828,781,391,390,910,472,438
114761,31,17,1,16,17,1,16,,,
114789,31,3319,1687,1632,1741,831,910,1578,856,722
114813,31,157,56,101,155,56,99,2,0,2
114859,31,3399,1758,1641,2038,1044,994,1361,714,647
114938,31,763,373,390,426,204,222,337,169,168
114947,31,43,23,20,43,23,20,,,
115001,31,1748,911,837,1113,599,514,635,312,323
115010,31,113,34,79,113,34,79,,,
115126,31,1772,900,872,938,477,461,834,423,411
115296,31,2350,1120,1230,1361,649,712,989,471,518
115357,31,35,10,25,16,4,12,19,6,13
115393,31,1810,902,908,1075,520,555,735,382,353
115409,31,237,116,121,237,116,121,,,
115658,31,15,0,15,2,0,2,13,0,13
115728,31,137,48,89,136,47,89,1,1,0
115755,31,961,419,542,930,403,527,31,16,15
115773,31,5,1,4,3,1,2,2,0,2
115861,31,1654,845,809,1048,536,512,606,309,297
115931,31,136,109,27,136,109,27,,,
116350,31,20,1,19,20,1,19,,,
116439,31,2134,1139,995,1420,799,621,714,340,374
116563,31,38,2,36,38,2,36,,,
117052,31,1030,574,456,574,329,245,456,245,211
117104,31,74,33,41,71,32,39,3,1,2
117140,31,662,243,419,654,240,414,8,3,5
117168,31,116,31,85,115,30,85,1,1,0
117195,31,517,311,206,138,59,79,379,252,127
117238,31,33,10,23,33,10,23,,,
117247,31,1198,632,566,284,167,117,914,465,449
117274,31,286,220,66,112,70,42,174,150,24
117283,31,8,3,5,5,2,3,3,1,2
117557,31,89,68,21,87,66,21,2,2,0
117575,31,4,3,1,1,0,1,3,3,0
117627,31,329,130,199,328,129,199,1,1,0
117645,31,4153,2030,2123,2877,1369,1508,1276,661,615
117672,31,3,0,3,3,0,3,,,
117690,31,1075,458,617,564,245,319,511,213,298
117706,31,2738,1364,1374,1524,739,785,1214,625,589
117715,31,528,213,315,177,82,95,351,131,220
117724,31,1931,1254,677,664,461,203,1267,793,474
117733,31,2053,981,1072,928,457,471,1125,524,601
117751,31,327,147,180,296,132,164,31,15,16
117788,31,1593,758,835,719,358,361,874,400,474
117867,31,1247,597,650,505,251,254,742,346,396
117894,31,1487,740,747,873,409,464,614,331,283
117946,31,1608,728,880,1607,728,879,1,0,1
117955,31,42,8,34,36,8,28,6,0,6
118134,31,20,0,20,8,0,8,12,0,12
118143,31,6,0,6,2,0,2,4,0,4
118161,31,5,2,3,5,2,3,,,
118198,31,185,32,153,185,32,153,,,
118347,31,709,368,341,347,183,164,362,185,177
118684,31,363,173,190,122,60,62,241,113,128
118693,31,203,100,103,202,99,103,1,1,0
118718,31,1809,904,905,1229,632,597,580,272,308
118772,31,651,282,369,135,61,74,516,221,295
118912,31,1986,990,996,1107,543,564,879,447,432
118930,31,861,428,433,355,183,172,506,245,261
118958,31,9,2,7,9,2,7,,,
118976,31,2098,1000,1098,1209,577,632,889,423,466
118994,31,21,8,13,21,8,13,,,
119067,31,831,434,397,507,261,246,324,173,151
119137,31,2512,1333,1179,1531,809,722,981,524,457
119164,31,4363,2269,2094,2579,1354,1225,1784,915,869
119173,31,380,27,353,378,27,351,2,0,2
119216,31,3265,1481,1784,1875,864,1011,1390,617,773
119270,31,138,107,31,127,100,27,11,7,4
119331,31,749,360,389,444,214,230,305,146,159
119553,31,278,75,203,278,75,203,,,
119605,31,74,40,34,13,8,5,61,32,29
119775,31,12,4,8,12,4,8,,,
119951,31,69,2,67,69,2,67,,,
120069,31,46,9,37,46,9,37,,,
120078,31,112,17,95,112,17,95,,,
120087,31,48,10,38,48,10,38,,,
120166,31,16,11,5,16,11,5,,,
120254,31,531,206,325,531,206,325,,,
120290,31,1492,836,656,756,385,371,736,451,285
120342,31,4098,2143,1955,2607,1418,1189,1491,725,766
120403,31,314,88,226,314,88,226,,,
120421,31,1228,631,597,584,293,291,644,338,306
120537,31,90,36,54,88,35,53,2,1,1
120661,31,180,38,142,150,30,120,30,8,22
120768,31,3,0,3,,,,3,0,3
120838,31,3,1,2,3,1,2,,,
120865,31,112,42,70,112,42,70,,,
120883,31,847,385,462,839,382,457,8,3,5
120953,31,667,588,79,81,56,25,586,532,54
120971,31,3199,1879,1320,1795,1008,787,1404,871,533
121044,31,4352,2187,2165,2732,1395,1337,1620,792,828
121150,31,942,356,586,940,356,584,2,0,2
121257,31,309,134,175,309,134,175,,,
121275,31,18,11,7,18,11,7,,,
121309,31,690,249,441,689,248,441,1,1,0
121345,31,412,174,238,412,174,238,,,
121363,31,537,263,274,348,169,179,189,94,95
121433,31,17,1,16,17,1,16,,,
121619,31,3411,1952,1459,1181,643,538,2230,1309,921
121637,31,19,0,19,19,0,19,,,
121691,31,513,203,310,507,200,307,6,3,3
121707,31,622,361,261,305,165,140,317,196,121
121859,31,62,7,55,34,6,28,28,1,27
121868,31,53,0,53,35,0,35,18,0,18
121886,31,2934,1812,1122,1335,699,636,1599,1113,486
121901,31,3797,1743,2054,1892,846,1046,1905,897,1008
122180,31,2581,1184,1397,1110,501,609,1471,683,788
122205,31,2460,1269,1191,1301,694,607,1159,575,584
122339,31,1671,806,865,557,250,307,1114,556,558
122375,31,2389,1156,1233,1043,501,542,1346,655,691
122384,31,1587,914,673,642,410,232,945,504,441
122409,31,6573,2564,4009,6529,2549,3980,44,15,29
122436,31,1234,478,756,1234,478,756,,,
122506,31,46,28,18,46,28,18,,,
122597,31,3339,1411,1928,3186,1334,1852,153,77,76
122612,31,1555,523,1032,1548,518,1030,7,5,2
122658,31,2666,1305,1361,1791,889,902,875,416,459
122685,31,235,64,171,235,64,171,,,
122694,31,120,53,67,120,53,67,,,
122728,31,160,70,90,154,65,89,6,5,1
122746,31,1285,630,655,554,253,301,731,377,354
122755,31,4037,2131,1906,3877,2036,1841,160,95,65
122791,31,1287,682,605,663,336,327,624,346,278
122889,31,2717,1306,1411,1922,912,1010,795,394,401
122931,31,1641,791,850,1638,790,848,3,1,2
122977,31,4768,2235,2533,3237,1534,1703,1531,701,830
123013,31,1641,872,769,754,394,360,887,478,409
123165,31,260,0,260,260,0,260,,,
123217,31,2326,1167,1159,1607,802,805,719,365,354
123280,31,3,2,1,1,0,1,2,2,0
123299,31,644,351,293,368,201,167,276,150,126
123341,31,2509,1282,1227,1601,819,782,908,463,445
123350,31,42,22,20,27,10,17,15,12,3
123457,31,109,50,59,109,50,59,,,
123484,31,218,152,66,142,103,39,76,49,27
123493,31,55,21,34,55,21,34,,,
123509,31,981,536,445,489,264,225,492,272,220
123527,31,1583,661,922,588,179,409,995,482,513
123554,31,445,203,242,444,202,242,1,1,0
123563,31,1502,748,754,779,356,423,723,392,331
123572,31,967,386,581,940,374,566,27,12,15
123642,31,5,0,5,3,0,3,2,0,2
123651,31,541,182,359,539,182,357,2,0,2
123679,31,169,35,134,138,30,108,31,5,26
123800,31,3106,1518,1588,1864,884,980,1242,634,608
123952,31,28,17,11,28,17,11,,,
123961,31,3420,1573,1847,3418,1572,1846,2,1,1
124113,31,1045,701,344,236,87,149,809,614,195
124292,31,139,68,71,139,68,71,,,
124487,31,2,2,0,,,,2,2,0
124681,31,266,114,152,266,114,152,,,
124706,31,209,36,173,209,36,173,,,
124937,31,151,44,107,118,39,79,33,5,28
125028,31,2130,1043,1087,1214,552,662,916,491,425
125082,31,13,0,13,13,0,13,,,
125091,31,2375,1167,1208,1145,529,616,1230,638,592
125170,31,881,420,461,264,128,136,617,292,325
125231,31,73,18,55,,,,73,18,55
125310,31,8,1,7,8,1,7,,,
125462,31,423,233,190,173,90,83,250,143,107
125471,31,998,471,527,340,168,172,658,303,355
125499,31,1231,615,616,700,344,356,531,271,260
125532,31,223,19,204,223,19,204,,,
125727,31,315,110,205,311,109,202,4,1,3
125763,31,249,141,108,246,138,108,3,3,0
125897,31,117,49,68,113,46,67,4,3,1
126076,31,69,69,0,69,69,0,,,
126119,31,760,383,377,358,177,181,402,206,196
126182,31,306,177,129,298,170,128,8,7,1
126207,31,1060,528,532,525,300,225,535,228,307
126289,31,1054,508,546,473,256,217,581,252,329
126359,31,38,4,34,38,4,34,,,
126562,31,1676,683,993,1512,618,894,164,65,99
126580,31,1663,783,880,1551,726,825,112,57,55
126605,31,50,46,4,50,46,4,,,
126614,31,7102,3612,3490,7027,3573,3454,75,39,36
126669,31,826,269,557,437,143,294,389,126,263
126678,31,534,231,303,534,231,303,,,
126687,31,94,15,79,94,15,79,,,
126711,31,407,216,191,265,153,112,142,63,79
126748,31,178,71,107,131,60,71,47,11,36
126775,31,1512,1034,478,1510,1033,477,2,1,1
126784,31,18,17,1,18,17,1,,,
126818,31,5537,2420,3117,5348,2329,3019,189,91,98
126827,31,1087,241,846,617,125,492,470,116,354
126863,31,675,292,383,264,134,130,411,158,253
126915,31,156,45,111,80,26,54,76,19,57
126942,31,1229,439,790,458,186,272,771,253,518
126951,31,338,302,36,338,302,36,,,
127060,31,1638,726,912,1620,718,902,18,8,10
127158,31,1952,1690,262,74,37,37,1878,1653,225
127185,31,849,383,466,831,374,457,18,9,9
127200,31,2116,955,1161,792,402,390,1324,553,771
127316,31,61,9,52,20,4,16,41,5,36
127389,31,173,80,93,152,71,81,21,9,12
127556,31,1752,861,891,1632,803,829,120,58,62
127565,31,2197,1033,1164,1561,722,839,636,311,325
127617,31,178,67,111,74,33,41,104,34,70
127653,31,30,12,18,28,12,16,2,0,2
127714,31,12,6,6,,,,12,6,6
127732,31,294,150,144,278,145,133,16,5,11
127741,31,1191,418,773,1180,412,768,11,6,5
127778,31,197,107,90,168,94,74,29,13,16
127820,31,2021,963,1058,977,487,490,1044,476,568
127884,31,452,190,262,178,89,89,274,101,173
127909,31,920,439,481,471,239,232,449,200,249
127918,31,428,148,280,428,148,280,,,
127945,31,218,60,158,138,38,100,80,22,58
127954,31,9,0,9,9,0,9,,,
128106,31,653,334,319,583,297,286,70,37,33
128151,31,356,167,189,355,167,188,1,0,1
128179,31,92,67,25,92,67,25,,,
128188,31,142,48,94,142,48,94,,,
128258,31,326,181,145,217,123,94,109,58,51
128328,31,1054,742,312,1054,742,312,,,
128337,31,35,0,35,23,0,23,12,0,12
128391,31,439,251,188,436,250,186,3,1,2
128498,31,162,86,76,162,86,76,,,
128577,31,356,194,162,226,137,89,130,57,73
128586,31,29,29,0,29,29,0,,,
128744,31,283,102,181,280,102,178,3,0,3
128771,31,1256,701,555,1234,694,540,22,7,15
128780,31,17,5,12,2,0,2,15,5,10
128896,31,109,8,101,109,8,101,,,
128902,31,630,237,393,630,237,393,,,
129002,31,93,65,28,93,65,28,,,
129020,31,4069,1731,2338,4061,1726,2335,8,5,3
129154,31,385,72,313,53,33,20,332,39,293
129181,31,341,304,37,294,264,30,47,40,7
129215,31,716,263,453,712,261,451,4,2,2
129242,31,1328,551,777,1324,550,774,4,1,3
129349,31,13,0,13,9,0,9,4,0,4
129367,31,446,160,286,276,101,175,170,59,111
129482,31,89,6,83,89,6,83,,,
129525,31,1148,480,668,1137,475,662,11,5,6
129534,31,17,8,9,12,6,6,5,2,3
129543,31,763,367,396,455,219,236,308,148,160
129695,31,972,477,495,527,277,250,445,200,245
129729,31,1121,540,581,661,323,338,460,217,243
129756,31,463,209,254,306,142,164,157,67,90
129774,31,100,49,51,100,49,51,,,
129808,31,771,349,422,510,237,273,261,112,149
129923,31,162,66,96,137,44,93,25,22,3
129932,31,286,248,38,249,213,36,37,35,2
129941,31,1242,522,720,1224,510,714,18,12,6
130004,31,797,354,443,517,235,282,280,119,161
130040,31,287,120,167,212,90,122,75,30,45
130110,31,41,13,28,33,9,24,8,4,4
130174,31,482,296,186,361,227,134,121,69,52
130183,31,1266,485,781,801,304,497,465,181,284
130217,31,322,155,167,215,108,107,107,47,60
130226,31,1605,636,969,1604,636,968,1,0,1
130253,31,1775,577,1198,1774,577,1197,1,0,1
130314,31,189,62,127,189,62,127,,,
130396,31,1191,536,655,598,261,337,593,275,318
130493,31,1106,456,650,1091,446,645,15,10,5
130590,31,565,253,312,563,253,310,2,0,2
130606,31,759,376,383,497,251,246,262,125,137
130624,31,289,164,125,289,164,125,,,
130697,31,743,366,377,743,366,377,,,
130776,31,629,338,291,614,329,285,15,9,6
130794,31,1554,757,797,1554,757,797,,,
130873,31,305,102,203,305,102,203,,,
130907,31,2273,974,1299,1680,751,929,593,223,370
130934,31,1431,434,997,1255,380,875,176,54,122
130943,31,4906,1924,2982,4894,1919,2975,12,5,7
130989,31,103,53,50,99,51,48,4,2,2
131061,31,89,5,84,49,5,44,40,0,40
131113,31,774,338,436,225,94,131,549,244,305
131159,31,1759,577,1182,1752,572,1180,7,5,2
131283,31,765,351,414,763,349,414,2,2,0
131399,31,486,186,300,213,107,106,273,79,194
131450,31,161,83,78,161,83,78,,,
131469,31,2941,1101,1840,2930,1098,1832,11,3,8
131496,31,1576,626,950,1573,625,948,3,1,2
131520,31,2493,656,1837,2489,656,1833,4,0,4
131803,31,9,3,6,,,,9,3,6
131876,31,157,3,154,132,1,131,25,2,23
132374,31,932,794,138,932,794,138,,,
132408,31,25,8,17,24,8,16,1,0,1
132471,31,596,215,381,589,213,376,7,2,5
132602,31,965,326,639,953,323,630,12,3,9
132657,31,804,383,421,790,378,412,14,5,9
132675,31,28,19,9,25,16,9,3,3,0
132693,31,1845,870,975,1036,502,534,809,368,441
132709,31,5200,2456,2744,3018,1426,1592,2182,1030,1152
132842,31,10,3,7,3,0,3,7,3,4
132851,31,1152,449,703,742,300,442,410,149,261
132879,31,33,24,9,33,24,9,,,
132903,31,7511,3534,3977,6912,3159,3753,599,375,224
132976,31,227,136,91,227,136,91,,,
133021,31,390,169,221,280,126,154,110,43,67
133155,31,379,170,209,228,121,107,151,49,102
133386,31,1573,712,861,1058,496,562,515,216,299
133465,31,8,1,7,8,1,7,,,
133492,31,544,145,399,543,144,399,1,1,0
133508,31,2874,1183,1691,1828,734,1094,1046,449,597
133526,31,320,184,136,309,179,130,11,5,6
133553,31,1839,1360,479,1825,1350,475,14,10,4
133650,31,1539,469,1070,1484,457,1027,55,12,43
133669,31,4371,1729,2642,3050,1104,1946,1321,625,696
133702,31,2322,994,1328,1151,524,627,1171,470,701
133711,31,761,202,559,761,202,559,,,
133809,31,172,77,95,172,77,95,,,
133845,31,105,12,93,99,12,87,6,0,6
133854,31,58,10,48,58,10,48,,,
133863,31,117,15,102,117,15,102,,,
133872,31,76,10,66,41,7,34,35,3,32
133881,31,778,494,284,775,491,284,3,3,0
133951,31,4424,1877,2547,2979,1155,1824,1445,722,723
133960,31,193,108,85,131,78,53,62,30,32
133979,31,465,181,284,446,166,280,19,15,4
133997,31,62,18,44,62,18,44,,,
134024,31,7,1,6,7,1,6,,,
134079,31,754,270,484,752,269,483,2,1,1
134097,31,6030,2412,3618,5922,2368,3554,108,44,64
134130,31,6612,2730,3882,6594,2721,3873,18,9,9
134228,31,28,11,17,25,10,15,3,1,2
134237,31,5276,3700,1576,5276,3700,1576,,,
134291,31,494,406,88,450,367,83,44,39,5
134307,31,220,204,16,35,33,2,185,171,14
134343,31,816,339,477,696,287,409,120,52,68
134422,31,5,0,5,5,0,5,,,
134495,31,4864,2198,2666,3290,1541,1749,1574,657,917
134510,31,51,34,17,24,16,8,27,18,9
134529,31,99,10,89,99,10,89,,,
134574,31,70,17,53,70,17,53,,,
134608,31,3159,1534,1625,2366,1131,1235,793,403,390
134714,31,154,30,124,55,13,42,99,17,82
134811,31,105,34,71,61,22,39,44,12,32
134945,31,705,276,429,700,275,425,5,1,4
135081,31,1813,547,1266,1300,422,878,513,125,388
135142,31,106,0,106,32,0,32,74,0,74
135160,31,528,202,326,290,104,186,238,98,140
135179,31,223,115,108,177,97,80,46,18,28
135188,31,867,368,499,501,220,281,366,148,218
135267,31,403,302,101,401,301,100,2,1,1
135276,31,732,358,374,657,300,357,75,58,17
135294,31,170,91,79,118,84,34,52,7,45
135337,31,36,3,33,15,3,12,21,0,21
135364,31,17,16,1,5,5,0,12,11,1
135391,31,1834,760,1074,1275,547,728,559,213,346
135407,31,908,520,388,879,500,379,29,20,9
135522,31,226,132,94,226,132,94,,,
135559,31,20,3,17,12,2,10,8,1,7
135610,31,2,1,1,1,0,1,1,1,0
135647,31,308,251,57,177,143,34,131,108,23
135717,31,10484,4925,5559,7260,3361,3899,3224,1564,1660
135726,31,2371,1159,1212,2370,1159,1211,1,0,1
135735,31,269,240,29,156,132,24,113,108,5
136109,31,29,0,29,17,0,17,12,0,12
136145,31,208,84,124,102,41,61,106,43,63
136172,31,3133,1280,1853,3036,1236,1800,97,44,53
136215,31,1978,587,1391,1960,581,1379,18,6,12
136233,31,669,311,358,455,219,236,214,92,122
136303,31,98,25,73,98,25,73,,,
136330,31,708,247,461,697,244,453,11,3,8
136358,31,4580,2177,2403,2352,1153,1199,2228,1024,1204
136400,31,1848,768,1080,1042,431,611,806,337,469
136473,31,1309,503,806,822,322,500,487,181,306
136491,31,205,143,62,173,136,37,32,7,25
136516,31,895,355,540,545,213,332,350,142,208
136659,31,113,83,30,103,78,25,10,5,5
136765,31,400,201,199,342,172,170,58,29,29
136774,31,415,99,316,415,99,316,,,
136826,31,331,195,136,179,93,86,152,102,50
136950,31,632,252,380,632,252,380,,,
137023,31,318,143,175,316,142,174,2,1,1
137032,31,869,330,539,868,330,538,1,0,1
137078,31,3067,1353,1714,1606,735,871,1461,618,843
137087,31,237,150,87,219,150,69,18,0,18
137096,31,2571,1272,1299,1640,867,773,931,405,526
137120,31,581,338,243,487,295,192,94,43,51
137209,31,2237,1074,1163,1515,728,787,722,346,376
137245,31,639,293,346,639,293,346,,,
137272,31,8,8,0,8,8,0,,,
137281,31,884,402,482,534,243,291,350,159,191
137315,31,557,198,359,302,130,172,255,68,187
137351,31,6800,2850,3950,6655,2764,3891,145,86,59
137476,31,535,301,234,535,301,234,,,
137546,31,666,269,397,666,269,397,,,
137564,31,1132,454,678,1057,417,640,75,37,38
137591,31,87,13,74,81,13,68,6,0,6
137713,31,152,60,92,122,52,70,30,8,22
137759,31,3235,1551,1684,2672,1310,1362,563,241,322
137777,31,8,8,0,8,8,0,,,
137847,31,1878,922,956,1876,921,955,2,1,1
137856,31,73,44,29,62,41,21,11,3,8
137865,31,148,93,55,148,93,55,,,
137953,31,92,55,37,88,52,36,4,3,1
137962,31,34,12,22,34,12,22,,,
138187,31,9242,4100,5142,5805,2635,3170,3437,1465,1972
138275,31,240,141,99,239,141,98,1,0,1
138284,31,281,142,139,259,125,134,22,17,5
138293,31,279,218,61,275,214,61,4,4,0
138309,31,451,70,381,220,31,189,231,39,192
138354,31,1183,537,646,1021,453,568,162,84,78
138372,31,167,82,85,116,41,75,51,41,10
138479,31,294,189,105,294,189,105,,,
138488,31,145,64,81,100,27,73,45,37,8
138497,31,152,96,56,152,96,56,,,
138558,31,856,381,475,804,361,443,52,20,32
138600,31,276,0,276,276,0,276,,,
138655,31,149,97,52,137,90,47,12,7,5
138664,31,39,15,24,39,15,24,,,
138682,31,346,165,181,136,67,69,210,98,112
138716,31,1383,390,993,1295,370,925,88,20,68
138761,31,89,47,42,87,47,40,2,0,2
138813,31,60,28,32,27,12,15,33,16,17
138822,31,84,0,84,84,0,84,,,
138840,31,416,195,221,182,94,88,234,101,133
138868,31,262,150,112,241,142,99,21,8,13
138901,31,228,89,139,136,58,78,92,31,61
138938,31,29,1,28,21,1,20,8,0,8
138947,31,1157,251,906,1120,237,883,37,14,23
138956,31,628,300,328,302,133,169,326,167,159
139144,31,634,252,382,634,252,382,,,
139153,31,16,10,6,10,6,4,6,4,2
139199,31,237,19,218,215,13,202,22,6,16
139205,31,215,136,79,213,135,78,2,1,1
139250,31,751,217,534,623,183,440,128,34,94
139278,31,823,359,464,352,163,189,471,196,275
139311,31,579,223,356,508,194,314,71,29,42
139357,31,521,195,326,167,68,99,354,127,227
139366,31,1029,438,591,943,377,566,86,61,25
139384,31,616,283,333,234,114,120,382,169,213
139393,31,239,114,125,237,113,124,2,1,1
139463,31,911,370,541,764,309,455,147,61,86
139506,31,10,8,2,10,8,2,,,
139579,31,22,5,17,20,5,15,2,0,2
139621,31,697,336,361,587,281,306,110,55,55
139630,31,188,112,76,188,112,76,,,
139658,31,1424,636,788,1424,636,788,,,
139700,31,990,408,582,711,303,408,279,105,174
139719,31,552,179,373,532,171,361,20,8,12
139755,31,3647,2111,1536,3630,2100,1530,17,11,6
139764,31,485,173,312,467,166,301,18,7,11
139861,31,1364,487,877,1359,486,873,5,1,4
139931,31,4357,1925,2432,4231,1855,2376,126,70,56
139940,31,5479,2414,3065,5265,2302,2963,214,112,102
139959,31,6273,2362,3911,6250,2355,3895,23,7,16
139968,31,851,402,449,715,322,393,136,80,56
139986,31,596,233,363,207,86,121,389,147,242
139995,31,181,68,113,144,55,89,37,13,24
140003,31,36,2,34,14,0,14,22,2,20
140012,31,1015,544,471,328,211,117,687,333,354
140234,31,220,144,76,220,144,76,,,
140243,31,753,385,368,355,167,188,398,218,180
140252,31,168,104,64,163,100,63,5,4,1
140331,31,1504,780,724,722,386,336,782,394,388
140340,31,59,17,42,32,13,19,27,4,23
140447,31,927,397,530,897,390,507,30,7,23
140553,31,674,674,0,671,671,0,3,3,0
140571,31,81,38,43,52,24,28,29,14,15
140678,31,411,221,190,274,166,108,137,55,82
140696,31,425,163,262,425,163,262,,,
140720,31,90,36,54,84,33,51,6,3,3
140818,31,301,105,196,301,105,196,,,
140827,31,1,1,0,1,1,0,,,
140872,31,275,161,114,272,160,112,3,1,2
140942,31,540,247,293,258,132,126,282,115,167
140951,31,3469,988,2481,3355,939,2416,114,49,65
140960,31,588,218,370,578,214,364,10,4,6
140988,31,267,131,136,265,131,134,2,0,2
141006,31,320,209,111,182,129,53,138,80,58
141060,31,577,0,577,577,0,577,,,
141167,31,101,68,33,99,67,32,2,1,1
141185,31,238,89,149,227,87,140,11,2,9
141237,31,217,117,100,216,116,100,1,1,0
141255,31,311,164,147,96,48,48,215,116,99
141264,31,1127,386,741,1081,372,709,46,14,32
141325,31,122,0,122,122,0,122,,,
141334,31,1423,527,896,1352,506,846,71,21,50
141361,31,253,101,152,253,101,152,,,
141486,31,303,109,194,288,104,184,15,5,10
141565,31,392,121,271,355,111,244,37,10,27
141574,31,3106,1194,1912,2907,1107,1800,199,87,112
141608,31,7,4,3,7,4,3,,,
141644,31,582,145,437,573,144,429,9,1,8
141680,31,455,310,145,252,175,77,203,135,68
141796,31,909,340,569,460,172,288,449,168,281
141802,31,217,96,121,99,60,39,118,36,82
141811,31,825,383,442,496,248,248,329,135,194
141839,31,403,175,228,227,102,125,176,73,103
141981,31,216,96,120,188,83,105,28,13,15
141990,31,300,123,177,202,86,116,98,37,61
142054,31,53,8,45,53,8,45,,,
142090,31,28,15,13,26,14,12,2,1,1
142115,31,3174,1309,1865,3064,1260,1804,110,49,61
142179,31,345,142,203,181,94,87,164,48,116
142276,31,1398,578,820,1288,532,756,110,46,64
142285,31,1951,998,953,1911,980,931,40,18,22
142294,31,269,122,147,269,122,147,,,
142328,31,496,217,279,463,205,258,33,12,21
142407,31,9,0,9,9,0,9,,,
142443,31,732,326,406,523,252,271,209,74,135
142461,31,239,113,126,235,112,123,4,1,3
142489,31,7,1,6,7,1,6,,,
142522,31,4380,1758,2622,3643,1415,2228,737,343,394
142559,31,1004,434,570,658,309,349,346,125,221
142887,31,34,13,21,28,8,20,6,5,1
142957,31,1,1,0,1,1,0,,,
143048,31,651,138,513,650,137,513,1,1,0
143084,31,593,270,323,593,270,323,,,
143118,31,672,248,424,669,246,423,3,2,1
143215,31,1216,621,595,800,424,376,416,197,219
143279,31,642,305,337,483,244,239,159,61,98
143288,31,106,58,48,106,58,48,,,
143358,31,1036,467,569,1036,467,569,,,
143376,31,3,1,2,2,1,1,1,0,1
143464,31,10,0,10,10,0,10,,,
143473,31,5,0,5,1,0,1,4,0,4
143482,31,8,0,8,4,0,4,4,0,4
143491,31,15,2,13,5,1,4,10,1,9
143552,31,7,0,7,4,0,4,3,0,3
143613,31,270,141,129,214,123,91,56,18,38
144005,31,173,69,104,154,61,93,19,8,11
144050,31,1729,937,792,1729,937,792,,,
144157,31,358,223,135,234,157,77,124,66,58
144166,31,1158,273,885,708,169,539,450,104,346
144175,31,236,136,100,154,90,64,82,46,36
144184,31,538,231,307,336,148,188,202,83,119
144193,31,696,423,273,426,275,151,270,148,122
144209,31,790,374,416,560,263,297,230,111,119
144218,31,1100,668,432,737,455,282,363,213,150
144281,31,1606,630,976,1585,621,964,21,9,12
144351,31,267,161,106,267,161,106,,,
144564,31,303,157,146,213,100,113,90,57,33
144573,31,34,3,31,29,3,26,5,0,5
144740,31,2968,1202,1766,2961,1198,1763,7,4,3
144795,31,102,36,66,98,35,63,4,1,3
144865,31,3291,1654,1637,2099,1104,995,1192,550,642
144883,31,241,125,116,241,125,116,,,
144892,31,876,342,534,871,338,533,5,4,1
144944,31,1229,688,541,785,445,340,444,243,201
144962,31,617,262,355,617,262,355,,,
144971,31,151,76,75,150,76,74,1,0,1
145099,31,73,8,65,73,8,65,,,
145239,31,15,1,14,15,1,14,,,
145309,31,19,4,15,19,4,15,,,
145336,31,316,139,177,286,126,160,30,13,17
145354,31,2,0,2,1,0,1,1,0,1
145372,31,230,123,107,228,122,106,2,1,1
145406,31,3,0,3,,,,3,0,3
145424,31,12,0,12,,,,12,0,12
145433,31,11,0,11,1,0,1,10,0,10
145497,31,3,0,3,2,0,2,1,0,1
145521,31,263,133,130,208,101,107,55,32,23
145600,31,4244,1924,2320,4179,1887,2292,65,37,28
145619,31,425,243,182,415,240,175,10,3,7
145637,31,7957,4078,3879,7946,4074,3872,11,4,7
145646,31,382,217,165,382,217,165,,,
145682,31,1312,641,671,850,443,407,462,198,264
145691,31,233,121,112,233,121,112,,,
145707,31,241,110,131,208,96,112,33,14,19
145725,31,620,399,221,603,387,216,17,12,5
145813,31,3983,1707,2276,3974,1704,2270,9,3,6
145831,31,624,319,305,463,243,220,161,76,85
146205,31,645,294,351,471,217,254,174,77,97
146278,31,498,211,287,366,170,196,132,41,91
146296,31,677,376,301,316,188,128,361,188,173
146339,31,175,104,71,175,104,71,,,
146348,31,497,245,252,307,169,138,190,76,114
146366,31,483,238,245,376,196,180,107,42,65
146418,31,492,246,246,342,184,158,150,62,88
146427,31,249,133,116,249,133,116,,,
146454,31,18,0,18,18,0,18,,,
146472,31,2023,1023,1000,1288,657,631,735,366,369
146481,31,445,187,258,445,187,258,,,
146506,31,892,413,479,771,367,404,121,46,75
146603,31,503,211,292,387,168,219,116,43,73
146612,31,605,331,274,603,329,274,2,2,0
146667,31,2,1,1,2,1,1,,,
146685,31,981,462,519,652,347,305,329,115,214
146700,31,359,229,130,359,229,130,,,
146719,31,3099,909,2190,3056,899,2157,43,10,33
146807,31,8,0,8,2,0,2,6,0,6
146816,31,42,6,36,40,5,35,2,1,1
147004,31,786,370,416,399,209,190,387,161,226
147013,31,462,269,193,458,267,191,4,2,2
147129,31,10,1,9,1,0,1,9,1,8
147244,31,362,186,176,362,186,176,,,
147341,31,231,127,104,229,127,102,2,0,2
147369,31,164,86,78,149,78,71,15,8,7
147378,31,1832,997,835,1281,687,594,551,310,241
147396,31,25,23,2,25,23,2,,,
147411,31,758,360,398,482,235,247,276,125,151
147536,31,727,270,457,684,253,431,43,17,26
147642,31,11,0,11,5,0,5,6,0,6
147660,31,483,253,230,481,251,230,2,2,0
147679,31,496,213,283,494,213,281,2,0,2
147703,31,2440,1145,1295,2377,1113,1264,63,32,31
147767,31,2038,923,1115,2038,923,1115,,,
147776,31,516,225,291,498,217,281,18,8,10
147800,31,771,443,328,449,272,177,322,171,151
147819,31,20,0,20,20,0,20,,,
147828,31,682,324,358,681,324,357,1,0,1
147916,31,960,541,419,701,405,296,259,136,123
148007,31,429,209,220,232,103,129,197,106,91
148016,31,61,39,22,61,39,22,,,
148098,31,7,0,7,7,0,7,,,
148131,31,304,196,108,303,195,108,1,1,0
148256,31,479,239,240,407,212,195,72,27,45
148292,31,282,126,156,152,77,75,130,49,81
148380,31,1190,595,595,757,371,386,433,224,209
148405,31,168,101,67,168,101,67,,,
148487,31,408,190,218,405,189,216,3,1,2
148496,31,600,175,425,598,174,424,2,1,1
148584,31,216,93,123,215,93,122,1,0,1
148627,31,657,254,403,652,252,400,5,2,3
148654,31,245,97,148,243,96,147,2,1,1
148672,31,351,150,201,270,115,155,81,35,46
148821,31,258,122,136,196,94,102,62,28,34
148876,31,85,21,64,61,15,46,24,6,18
148937,31,227,111,116,199,94,105,28,17,11
148991,31,182,83,99,132,61,71,50,22,28
149204,31,15,1,14,15,1,14,,,
149222,31,1518,693,825,1486,682,804,32,11,21
149231,31,1866,793,1073,1827,777,1050,39,16,23
149310,31,27,14,13,27,14,13,,,
149329,31,33,33,0,33,33,0,,,
149365,31,311,122,189,172,80,92,139,42,97
149505,31,129,51,78,128,50,78,1,1,0
149514,31,94,57,37,86,51,35,8,6,2
149532,31,1460,816,644,1003,538,465,457,278,179
149550,31,27,1,26,24,1,23,3,0,3
149639,31,12,7,5,12,7,5,,,
149727,31,1413,736,677,937,496,441,476,240,236
149772,31,1074,468,606,1062,463,599,12,5,7
149781,31,504,201,303,503,201,302,1,0,1
149842,31,2257,1130,1127,1542,806,736,715,324,391
150066,31,326,175,151,323,174,149,3,1,2
150136,31,3477,1315,2162,3460,1306,2154,17,9,8
150145,31,248,125,123,247,124,123,1,1,0
150163,31,1200,520,680,1199,520,679,1,0,1
150172,31,128,88,40,106,73,33,22,15,7
150251,31,2,0,2,2,0,2,,,
150303,31,60,1,59,36,1,35,24,0,24
150400,31,535,247,288,535,247,288,,,
150428,31,4,0,4,4,0,4,,,
150455,31,173,87,86,173,87,86,,,
150534,31,377,148,229,377,148,229,,,
150604,31,246,124,122,245,124,121,1,0,1
150668,31,166,63,103,165,63,102,1,0,1
150677,31,445,162,283,445,162,283,,,
150756,31,280,128,152,280,128,152,,,
150765,31,51,0,51,51,0,51,,,
150774,31,186,110,76,186,110,76,,,
150853,31,38,1,37,37,1,36,1,0,1
150941,31,272,109,163,252,97,155,20,12,8
150987,31,12400,5858,6542,4562,2029,2533,7838,3829,4009
151102,31,1210,629,581,1172,612,560,38,17,21
151111,31,3523,1419,2104,3399,1355,2044,124,64,60
151263,31,856,357,499,851,356,495,5,1,4
151290,31,444,257,187,441,256,185,3,1,2
151306,31,1251,459,792,1234,452,782,17,7,10
151324,31,1535,659,876,1525,657,868,10,2,8
151333,31,517,180,337,495,173,322,22,7,15
151342,31,771,282,489,690,252,438,81,30,51
151351,31,9736,4887,4849,9709,4875,4834,27,12,15
151360,31,420,114,306,389,112,277,31,2,29
151379,31,606,220,386,566,205,361,40,15,25
151388,31,349,141,208,312,125,187,37,16,21
151467,31,32,4,28,32,4,28,,,
151564,31,40,1,39,8,1,7,32,0,32
151661,31,248,196,52,248,196,52,,,
151777,31,257,126,131,257,126,131,,,
151786,31,464,217,247,462,217,245,2,0,2
151801,31,580,216,364,580,216,364,,,
151810,31,13,5,8,4,1,3,9,4,5
151962,31,52,10,42,51,10,41,1,0,1
152044,31,67,29,38,11,9,2,56,20,36
152080,31,2037,1058,979,2037,1058,979,,,
152099,31,128,75,53,125,73,52,3,2,1
152150,31,22,1,21,9,1,8,13,0,13
152275,31,19,8,11,9,0,9,10,8,2
152309,31,21,8,13,21,8,13,,,
152318,31,598,473,125,598,473,125,,,
152336,31,366,154,212,359,150,209,7,4,3
152381,31,200,80,120,199,80,119,1,0,1
152390,31,397,0,397,397,0,397,,,
152497,31,4,2,2,4,2,2,,,
152530,31,519,243,276,519,243,276,,,
152567,31,653,418,235,653,418,235,,,
152600,31,604,257,347,603,256,347,1,1,0
152628,31,19,1,18,10,1,9,9,0,9
152637,31,1190,721,469,1094,662,432,96,59,37
152673,31,258,258,0,258,258,0,,,
152992,31,174,101,73,174,101,73,,,
153001,31,236,125,111,236,125,111,,,
153074,31,48,2,46,48,2,46,,,
153083,31,24,1,23,24,1,23,,,
153108,31,351,192,159,351,192,159,,,
153126,31,193,119,74,193,119,74,,,
153144,31,363,167,196,363,167,196,,,
153162,31,329,179,150,329,179,150,,,
153214,31,2685,1334,1351,1662,898,764,1023,436,587
153250,31,444,229,215,438,226,212,6,3,3
153269,31,733,296,437,731,294,437,2,2,0
153278,31,318,198,120,316,198,118,2,0,2
153296,31,251,133,118,243,130,113,8,3,5
153302,31,43,16,27,43,16,27,,,
153311,31,763,329,434,542,249,293,221,80,141
153320,31,111,49,62,106,47,59,5,2,3
153366,31,202,146,56,202,146,56,,,
153375,31,331,151,180,330,151,179,1,0,1
153384,31,437,194,243,437,194,243,,,
153427,31,21,9,12,21,9,12,,,
153445,31,883,424,459,717,375,342,166,49,117
153463,31,8,0,8,8,0,8,,,
153472,31,581,307,274,539,288,251,42,19,23
153524,31,1166,687,479,1014,634,380,152,53,99
153533,31,337,189,148,289,163,126,48,26,22
153597,31,21,2,19,21,2,19,,,
153603,31,5728,3183,2545,5683,3154,2529,45,29,16
153621,31,192,114,78,188,113,75,4,1,3
153630,31,1410,730,680,1039,619,420,371,111,260
153658,31,5178,2170,3008,5157,2158,2999,21,12,9
153737,31,2110,968,1142,1503,733,770,607,235,372
153746,31,18,2,16,18,2,16,,,
153764,31,28,0,28,28,0,28,,,
153773,31,51,3,48,51,3,48,,,
153782,31,12,0,12,12,0,12,,,
153825,31,286,181,105,286,181,105,,,
153834,31,400,183,217,400,183,217,,,
153861,31,36,7,29,20,5,15,16,2,14
153922,31,304,159,145,266,142,124,38,17,21
153977,31,69,9,60,48,6,42,21,3,18
154004,31,346,180,166,346,180,166,,,
154013,31,224,102,122,221,101,120,3,1,2
154022,31,657,233,424,470,166,304,187,67,120
154059,31,535,286,249,490,266,224,45,20,25
154095,31,1436,519,917,1425,512,913,11,7,4
154101,31,288,149,139,288,149,139,,,
154110,31,516,234,282,365,200,165,151,34,117
154129,31,309,199,110,265,185,80,44,14,30
154208,31,59,1,58,6,0,6,53,1,52
154235,31,459,221,238,458,221,237,1,0,1
154262,31,8,0,8,6,0,6,2,0,2
154332,31,35,1,34,35,1,34,,,
154350,31,302,159,143,301,158,143,1,1,0
154378,31,568,296,272,429,243,186,139,53,86
154396,31,310,153,157,264,142,122,46,11,35
154448,31,47,5,42,47,5,42,,,
154457,31,9,0,9,9,0,9,,,
154466,31,3,0,3,3,0,3,,,
154493,31,216,143,73,187,122,65,29,21,8
154518,31,153,91,62,143,85,58,10,6,4
154527,31,351,180,171,351,180,171,,,
154545,31,54,38,16,54,38,16,,,
154572,31,677,326,351,507,262,245,170,64,106
154590,31,317,188,129,313,186,127,4,2,2
154642,31,428,161,267,303,120,183,125,41,84
154688,31,232,127,105,229,125,104,3,2,1
154697,31,594,331,263,420,239,181,174,92,82
154712,31,593,303,290,593,303,290,,,
154721,31,259,175,84,259,175,84,,,
154749,31,111,61,50,111,61,50,,,
154800,31,1533,664,869,1042,436,606,491,228,263
154855,31,112,70,42,111,70,41,1,0,1
154907,31,261,112,149,232,104,128,29,8,21
154925,31,419,279,140,408,273,135,11,6,5
154934,31,242,112,130,204,101,103,38,11,27
154952,31,520,241,279,448,207,241,72,34,38
154998,31,463,262,201,342,195,147,121,67,54
155007,31,54,16,38,41,13,28,13,3,10
155025,31,537,184,353,534,183,351,3,1,2
155052,31,116,81,35,85,61,24,31,20,11
155061,31,825,338,487,760,316,444,65,22,43
155070,31,22,10,12,21,10,11,1,0,1
155089,31,265,145,120,260,140,120,5,5,0
155098,31,266,148,118,231,127,104,35,21,14
155104,31,546,280,266,468,245,223,78,35,43
155140,31,205,91,114,198,88,110,7,3,4
155159,31,26,0,26,26,0,26,,,
155177,31,108,68,40,107,68,39,1,0,1
155186,31,540,257,283,351,178,173,189,79,110
155195,31,889,414,475,704,331,373,185,83,102
155201,31,226,134,92,193,117,76,33,17,16
155210,31,2162,1085,1077,1298,649,649,864,436,428
155283,31,171,10,161,171,10,161,,,
155292,31,701,366,335,434,240,194,267,126,141
155308,31,37,28,9,33,24,9,4,4,0
155317,31,4457,1982,2475,4371,1943,2428,86,39,47
155335,31,177,76,101,177,76,101,,,
155353,31,59,53,6,59,53,6,,,
155399,31,2909,1444,1465,2839,1416,1423,70,28,42
155414,31,234,141,93,234,141,93,,,
155423,31,248,172,76,183,134,49,65,38,27
155450,31,216,78,138,168,62,106,48,16,32
155487,31,92,68,24,65,55,10,27,13,14
155496,31,28,14,14,28,14,14,,,
155511,31,250,177,73,250,177,73,,,
155520,31,233,126,107,233,126,107,,,
155566,31,319,145,174,282,130,152,37,15,22
155593,31,212,180,32,187,171,16,25,9,16
155618,31,156,116,40,156,116,40,,,
155627,31,261,177,84,243,161,82,18,16,2
155681,31,847,415,432,841,411,430,6,4,2
155715,31,287,196,91,278,189,89,9,7,2
155812,31,197,137,60,196,136,60,1,1,0
155830,31,114,70,44,88,62,26,26,8,18
155858,31,311,130,181,251,118,133,60,12,48
155900,31,203,128,75,196,122,74,7,6,1
155937,31,153,100,53,151,100,51,2,0,2
155973,31,151,100,51,151,100,51,,,
156082,31,780,288,492,738,275,463,42,13,29
156107,31,633,396,237,413,302,111,220,94,126
156125,31,1847,881,966,1762,839,923,85,42,43
156134,31,158,94,64,158,94,64,,,
156189,31,170,94,76,170,94,76,,,
156213,31,295,122,173,287,120,167,8,2,6
156231,31,381,212,169,326,190,136,55,22,33
156286,31,546,229,317,546,229,317,,,
156295,31,353,137,216,353,137,216,,,
156310,31,104,0,104,97,0,97,7,0,7
156338,31,727,343,384,450,204,246,277,139,138
156356,31,101,51,50,99,49,50,2,2,0
156365,31,682,320,362,654,314,340,28,6,22
156392,31,1804,804,1000,1155,525,630,649,279,370
156408,31,400,199,201,400,199,201,,,
156417,31,8,7,1,8,7,1,,,
156426,31,25,1,24,19,0,19,6,1,5
156471,31,368,15,353,275,7,268,93,8,85
156541,31,637,287,350,628,283,345,9,4,5
156620,31,2737,1075,1662,2554,1006,1548,183,69,114
156648,31,970,432,538,625,272,353,345,160,185
156745,31,356,163,193,356,163,193,,,
156754,31,5,0,5,5,0,5,,,
156790,31,336,144,192,248,113,135,88,31,57
156842,31,51,1,50,43,1,42,8,0,8
156851,31,185,52,133,124,36,88,61,16,45
156860,31,363,151,212,229,88,141,134,63,71
156921,31,1698,789,909,888,437,451,810,352,458
156967,31,6,1,5,6,1,5,,,
157021,31,35,1,34,13,0,13,22,1,21
157030,31,16,12,4,15,11,4,1,1,0
157058,31,367,148,219,324,126,198,43,22,21
157076,31,222,116,106,222,116,106,,,
157085,31,6061,2365,3696,5974,2326,3648,87,39,48
157100,31,114,86,28,113,85,28,1,1,0
157216,31,427,234,193,414,232,182,13,2,11
157289,31,2931,1300,1631,2706,1191,1515,225,109,116
157304,31,385,154,231,279,107,172,106,47,59
157331,31,497,202,295,324,148,176,173,54,119
157377,31,239,143,96,238,142,96,1,1,0
157386,31,1199,428,771,1190,424,766,9,4,5
157401,31,1366,526,840,1360,522,838,6,4,2
157438,31,649,331,318,296,157,139,353,174,179
157447,31,1638,703,935,1579,676,903,59,27,32
157483,31,778,331,447,589,257,332,189,74,115
157535,31,329,147,182,329,147,182,,,
157553,31,402,175,227,324,150,174,78,25,53
157614,31,40,1,39,29,1,28,11,0,11
157650,31,50,3,47,37,3,34,13,0,13
157669,31,32,1,31,32,1,31,,,
157678,31,46,0,46,46,0,46,,,
157711,31,918,412,506,666,322,344,252,90,162
157739,31,372,146,226,284,112,172,88,34,54
157748,31,187,106,81,161,88,73,26,18,8
157757,31,132,64,68,132,64,68,,,
157793,31,376,134,242,290,104,186,86,30,56
157809,31,384,218,166,382,218,164,2,0,2
157818,31,278,127,151,278,127,151,,,
157863,31,201,144,57,200,143,57,1,1,0
157951,31,2755,1029,1726,2719,1014,1705,36,15,21
158088,31,224,123,101,188,103,85,36,20,16
158246,31,58,22,36,58,22,36,,,
158431,31,1382,521,861,796,325,471,586,196,390
158477,31,173,86,87,173,86,87,,,
158538,31,8,0,8,8,0,8,,,
158617,31,400,117,283,400,117,283,,,
158662,31,2028,838,1190,1080,436,644,948,402,546
158778,31,7,0,7,7,0,7,,,
158787,31,14,0,14,14,0,14,,,
158802,31,334,80,254,331,80,251,3,0,3
158884,31,285,137,148,153,79,74,132,58,74
159009,31,861,313,548,819,301,518,42,12,30
159027,31,36,0,36,36,0,36,,,
159197,31,128,110,18,128,110,18,,,
159328,31,18,0,18,18,0,18,,,
159382,31,414,152,262,370,136,234,44,16,28
159391,31,7401,3083,4318,7367,3067,4300,34,16,18
159407,31,773,211,562,659,193,466,114,18,96
159416,31,306,135,171,288,131,157,18,4,14
159513,31,30,1,29,30,1,29,,,
159522,31,43,0,43,43,0,43,,,
159531,31,8,0,8,8,0,8,,,
159568,31,177,108,69,177,108,69,,,
159601,31,20,0,20,20,0,20,,,
159647,31,1772,1028,744,1764,1024,740,8,4,4
159656,31,797,252,545,791,251,540,6,1,5
159717,31,1054,444,610,1005,428,577,49,16,33
159939,31,1012,494,518,829,424,405,183,70,113
159948,31,104,44,60,32,22,10,72,22,50
159966,31,972,363,609,965,361,604,7,2,5
159993,31,1018,383,635,989,378,611,29,5,24
160010,31,203,156,47,94,74,20,109,82,27
160038,31,1020,372,648,971,351,620,49,21,28
160065,31,45,7,38,42,7,35,3,0,3
160074,31,73,11,62,70,11,59,3,0,3
160117,31,24,0,24,24,0,24,,,
160126,31,3,0,3,2,0,2,1,0,1
160199,31,5,0,5,5,0,5,,,
160320,31,194,4,190,194,4,190,,,
160409,31,16,16,0,16,16,0,,,
160472,31,58,5,53,33,4,29,25,1,24
160481,31,474,198,276,300,123,177,174,75,99
160524,31,99,28,71,99,28,71,,,
160579,31,646,334,312,459,263,196,187,71,116
160597,31,3,0,3,2,0,2,1,0,1
160612,31,2363,922,1441,1436,573,863,927,349,578
160621,31,1678,549,1129,1623,527,1096,55,22,33
160630,31,134,46,88,124,43,81,10,3,7
160649,31,392,163,229,367,156,211,25,7,18
160658,31,2885,1200,1685,2860,1188,1672,25,12,13
160667,31,525,318,207,420,265,155,105,53,52
160755,31,1843,619,1224,1843,619,1224,,,
160904,31,838,166,672,835,166,669,3,0,3
160959,31,96,40,56,95,39,56,1,1,0
160977,31,518,236,282,518,236,282,,,
160995,31,115,26,89,115,26,89,,,
161004,31,508,232,276,508,232,276,,,
161022,31,9,0,9,3,0,3,6,0,6
161077,31,826,401,425,614,318,296,212,83,129
161086,31,673,324,349,673,324,349,,,
161138,31,567,306,261,456,251,205,111,55,56
161192,31,372,138,234,234,94,140,138,44,94
161208,31,19,18,1,19,18,1,,,
161217,31,317,121,196,198,75,123,119,46,73
161226,31,264,110,154,263,109,154,1,1,0
161235,31,57,24,33,49,22,27,8,2,6
161253,31,1939,1032,907,1882,998,884,57,34,23
161299,31,219,175,44,219,175,44,,,
161341,31,141,51,90,121,46,75,20,5,15
161457,31,731,252,479,729,251,478,2,1,1
161484,31,145,82,63,121,75,46,24,7,17
161493,31,60,0,60,49,0,49,11,0,11
161509,31,98,17,81,96,16,80,2,1,1
161518,31,201,86,115,201,86,115,,,
161527,31,67,5,62,49,1,48,18,4,14
161545,31,1424,709,715,1054,547,507,370,162,208
161554,31,751,309,442,729,299,430,22,10,12
161563,31,234,103,131,234,103,131,,,
161572,31,415,103,312,415,103,312,,,
161581,31,103,59,44,86,56,30,17,3,14
161688,31,403,165,238,343,145,198,60,20,40
161767,31,1892,891,1001,1092,565,527,800,326,474
161800,31,46,12,34,14,8,6,32,4,28
161855,31,11,0,11,4,0,4,7,0,7
161864,31,509,170,339,198,71,127,311,99,212
161873,31,31,13,18,26,11,15,5,2,3
162007,31,1188,450,738,1170,439,731,18,11,7
162061,31,47,34,13,43,31,12,4,3,1
162104,31,370,139,231,220,86,134,150,53,97
162122,31,1108,476,632,604,275,329,504,201,303
162168,31,368,162,206,183,92,91,185,70,115
162210,31,59,21,38,57,20,37,2,1,1
162283,31,347,95,252,332,91,241,15,4,11
162335,31,3,0,3,3,0,3,,,
162371,31,285,251,34,285,251,34,,,
162557,31,961,500,461,641,352,289,320,148,172
162584,31,497,264,233,496,264,232,1,0,1
162609,31,170,85,85,166,84,82,4,1,3
162654,31,269,80,189,269,80,189,,,
162690,31,708,307,401,477,228,249,231,79,152
162706,31,949,453,496,659,333,326,290,120,170
162760,31,297,123,174,294,123,171,3,0,3
162779,31,1260,613,647,637,339,298,623,274,349
162830,31,18,0,18,18,0,18,,,
162928,31,1406,632,774,1406,632,774,,,
163028,31,288,258,30,234,213,21,54,45,9
163046,31,1271,602,669,1269,602,667,2,0,2
163204,31,763,358,405,179,78,101,584,280,304
163268,31,2144,1137,1007,2130,1131,999,14,6,8
163286,31,5849,2882,2967,5809,2860,2949,40,22,18
163295,31,227,47,180,227,47,180,,,
163338,31,588,287,301,578,283,295,10,4,6
163347,31,120,8,112,120,8,112,,,
163408,31,36,6,30,21,3,18,15,3,12
163426,31,2570,1445,1125,1552,863,689,1018,582,436
163453,31,2201,802,1399,2193,801,1392,8,1,7
163462,31,459,218,241,458,217,241,1,1,0
163532,31,40,40,0,40,40,0,,,
163541,31,54,29,25,29,18,11,25,11,14
163578,31,56,0,56,56,0,56,,,
163657,31,2042,890,1152,919,448,471,1123,442,681
163815,31,10,1,9,4,1,3,6,0,6
163851,31,1382,626,756,1376,624,752,6,2,4
163912,31,410,157,253,408,155,253,2,2,0
163976,31,130,59,71,130,59,71,,,
164076,31,2671,1053,1618,2662,1048,1614,9,5,4
164155,31,1168,839,329,1168,839,329,,,
164173,31,744,311,433,744,311,433,,,
164216,31,231,98,133,231,98,133,,,
164270,31,467,193,274,467,193,274,,,
164313,31,459,179,280,170,78,92,289,101,188
164368,31,180,112,68,180,112,68,,,
164447,31,331,193,138,329,191,138,2,2,0
164465,31,467,214,253,467,214,253,,,
164492,31,202,122,80,201,122,79,1,0,1
164535,31,9,1,8,9,1,8,,,
164562,31,369,196,173,369,196,173,,,
164580,31,656,365,291,656,365,291,,,
164599,31,10,2,8,,,,10,2,8
164614,31,5,1,4,5,1,4,,,
164632,31,139,0,139,139,0,139,,,
164641,31,20,6,14,17,4,13,3,2,1
164739,31,1141,697,444,1141,697,444,,,
164748,31,1627,887,740,1489,787,702,138,100,38
164775,31,253,106,147,145,68,77,108,38,70
164845,31,28,0,28,28,0,28,,,
164872,31,21,9,12,21,9,12,,,
164924,31,2335,1079,1256,2335,1079,1256,,,
164988,31,3635,1475,2160,3634,1475,2159,1,0,1
165015,31,987,437,550,987,437,550,,,
165024,31,1570,723,847,1496,680,816,74,43,31
165033,31,1242,503,739,731,322,409,511,181,330
165060,31,1,0,1,1,0,1,,,
165112,31,1598,730,868,706,352,354,892,378,514
165167,31,16,6,10,,,,16,6,10
165194,31,437,215,222,220,110,110,217,105,112
165255,31,86,1,85,51,0,51,35,1,34
165264,31,5,2,3,1,0,1,4,2,2
165334,31,703,291,412,703,291,412,,,
165529,31,490,224,266,487,223,264,3,1,2
165556,31,142,16,126,137,15,122,5,1,4
165574,31,343,170,173,336,169,167,7,1,6
165608,31,11,1,10,7,1,6,4,0,4
165635,31,54,48,6,54,48,6,,,
165644,31,73,47,26,72,47,25,1,0,1
165662,31,1002,317,685,1002,317,685,,,
165671,31,568,120,448,568,120,448,,,
165699,31,871,315,556,867,312,555,4,3,1
165750,31,27,10,17,19,10,9,8,0,8
165802,31,194,94,100,193,94,99,1,0,1
165820,31,486,227,259,481,225,256,5,2,3
165866,31,490,247,243,488,246,242,2,1,1
165884,31,178,161,17,134,121,13,44,40,4
165936,31,315,124,191,312,123,189,3,1,2
165981,31,208,83,125,89,39,50,119,44,75
166018,31,228,79,149,228,79,149,,,
166027,31,1644,738,906,1644,738,906,,,
166054,31,4,4,0,4,4,0,,,
166124,31,902,406,496,902,406,496,,,
166133,31,656,275,381,357,160,197,299,115,184
166391,31,314,106,208,314,106,208,,,
166452,31,240,70,170,225,64,161,15,6,9
166489,31,8,3,5,8,3,5,,,
166498,31,8,0,8,3,0,3,5,0,5
166513,31,1937,1187,750,1890,1158,732,47,29,18
166629,31,5589,2577,3012,5580,2574,3006,9,3,6
166638,31,2441,1055,1386,2357,1016,1341,84,39,45
166647,31,714,349,365,386,221,165,328,128,200
166656,31,730,177,553,726,177,549,4,0,4
166674,31,409,89,320,406,88,318,3,1,2
166683,31,1136,582,554,1136,582,554,,,
166692,31,317,273,44,317,273,44,,,
166805,31,13,10,3,7,7,0,6,3,3
166823,31,856,405,451,504,262,242,352,143,209
166850,31,1182,558,624,1182,558,624,,,
166887,31,918,435,483,424,220,204,494,215,279
166911,31,55,13,42,53,11,42,2,2,0
166939,31,544,0,544,544,0,544,,,
166957,31,447,188,259,223,95,128,224,93,131
167039,31,5,0,5,5,0,5,,,
167057,31,47,23,24,47,23,24,,,
167260,31,317,202,115,317,202,115,,,
167288,31,177,81,96,177,81,96,,,
167297,31,18,15,3,18,15,3,,,
167312,31,783,352,431,445,206,239,338,146,192
167358,31,2519,903,1616,2519,903,1616,,,
167376,31,667,294,373,344,169,175,323,125,198
167394,31,145,46,99,144,46,98,1,0,1
167525,31,344,156,188,173,87,86,171,69,102
167534,31,1211,588,623,606,334,272,605,254,351
167598,31,203,59,144,202,58,144,1,1,0
167631,31,207,83,124,108,55,53,99,28,71
167729,31,863,309,554,858,307,551,5,2,3
167783,31,395,0,395,395,0,395,,,
167792,31,94,35,59,94,35,59,,,
167835,31,619,0,619,619,0,619,,,
167871,31,54,16,38,33,3,30,21,13,8
167899,31,525,278,247,525,278,247,,,
167905,31,894,451,443,498,276,222,396,175,221
167987,31,1319,665,654,1300,656,644,19,9,10
167996,31,737,343,394,725,338,387,12,5,7
168005,31,1260,404,856,1254,401,853,6,3,3
168032,31,4,0,4,4,0,4,,,
168148,31,1694,728,966,1694,728,966,,,
168218,31,586,0,586,586,0,586,,,
168227,31,832,637,195,830,636,194,2,1,1
168254,31,602,356,246,589,350,239,13,6,7
168263,31,803,361,442,799,358,441,4,3,1
168281,31,494,187,307,494,187,307,,,
168342,31,577,267,310,577,267,310,,,
168421,31,1354,930,424,1354,930,424,,,
168430,31,799,320,479,788,316,472,11,4,7
168528,31,507,296,211,506,296,210,1,0,1
168546,31,418,200,218,418,200,218,,,
168555,31,22,0,22,18,0,18,4,0,4
168573,31,240,232,8,240,232,8,,,
168591,31,334,185,149,334,185,149,,,
168607,31,262,147,115,193,123,70,69,24,45
168740,31,232,120,112,217,109,108,15,11,4
168786,31,307,142,165,307,142,165,,,
168847,31,323,86,237,197,49,148,126,37,89
168883,31,227,111,116,118,62,56,109,49,60
168892,31,21,0,21,11,0,11,10,0,10
169080,31,660,330,330,627,312,315,33,18,15
169187,31,6,2,4,3,1,2,3,1,2
169248,31,2019,810,1209,1984,805,1179,35,5,30
169275,31,772,333,439,363,158,205,409,175,234
169284,31,114,11,103,83,4,79,31,7,24
169327,31,103,70,33,93,66,27,10,4,6
169363,31,224,134,90,224,134,90,,,
169442,31,260,74,186,251,70,181,9,4,5
169479,31,540,259,281,460,237,223,80,22,58
169503,31,35,0,35,35,0,35,,,
169521,31,1205,552,653,619,288,331,586,264,322
169576,31,7,0,7,7,0,7,,,
169655,31,543,511,32,543,511,32,,,
169716,31,508,186,322,491,180,311,17,6,11
169761,31,129,31,98,129,31,98,,,
169798,31,2177,891,1286,1978,739,1239,199,152,47
169813,31,12,0,12,12,0,12,,,
169910,31,1746,772,974,1710,762,948,36,10,26
169974,31,185,71,114,126,52,74,59,19,40
169983,31,294,232,62,294,232,62,,,
169992,31,169,80,89,135,65,70,34,15,19
170000,31,112,59,53,87,52,35,25,7,18
170037,31,293,108,185,285,103,182,8,5,3
170055,31,2603,1257,1346,1244,646,598,1359,611,748
170082,31,3875,1515,2360,3843,1503,2340,32,12,20
170091,31,43,28,15,38,25,13,5,3,2
170240,31,1982,969,1013,1160,574,586,822,395,427
170286,31,387,190,197,385,188,197,2,2,0
170301,31,955,355,600,955,355,600,,,
170444,31,517,217,300,207,91,116,310,126,184
170532,31,372,149,223,370,148,222,2,1,1
170541,31,977,478,499,448,202,246,529,276,253
170550,31,498,191,307,226,95,131,272,96,176
170587,31,178,78,100,99,56,43,79,22,57
170611,31,35,1,34,28,1,27,7,0,7
170620,31,471,213,258,255,121,134,216,92,124
170639,31,273,140,133,269,139,130,4,1,3
170657,31,1824,881,943,984,477,507,840,404,436
170675,31,427,297,130,420,293,127,7,4,3
170736,31,18,1,17,11,0,11,7,1,6
170790,31,2900,1416,1484,1348,707,641,1552,709,843
170806,31,249,102,147,248,102,146,1,0,1
170967,31,233,105,128,227,103,124,6,2,4
170976,31,7050,3069,3981,7024,3060,3964,26,9,17
171012,31,8,8,0,8,8,0,,,
171100,31,9829,4730,5099,9655,4647,5008,174,83,91
171128,31,1388,977,411,1381,971,410,7,6,1
171137,31,1005,527,478,976,510,466,29,17,12
171146,31,521,216,305,484,199,285,37,17,20
171155,31,365,157,208,220,108,112,145,49,96
171225,31,442,182,260,213,81,132,229,101,128
171234,31,200,95,105,100,46,54,100,49,51
171304,31,679,290,389,427,181,246,252,109,143
171395,31,199,86,113,135,65,70,64,21,43
171456,31,1416,603,813,1403,598,805,13,5,8
171483,31,601,289,312,373,178,195,228,111,117
171492,31,247,160,87,228,146,82,19,14,5
171535,31,2983,1497,1486,1263,693,570,1720,804,916
171571,31,2117,911,1206,2069,883,1186,48,28,20
171599,31,268,186,82,267,185,82,1,1,0
171775,31,16,0,16,16,0,16,,,
171881,31,7,3,4,7,3,4,,,
171988,31,24,1,23,24,1,23,,,
171997,31,62,3,59,62,3,59,,,
172015,31,36,1,35,36,1,35,,,
172033,31,4,2,2,2,2,0,2,0,2
172051,31,1337,490,847,1323,483,840,14,7,7
172200,31,1427,749,678,508,281,227,919,468,451
172264,31,279,146,133,276,146,130,3,0,3
172291,31,567,245,322,337,149,188,230,96,134
172307,31,490,224,266,410,181,229,80,43,37
172334,31,228,101,127,227,101,126,1,0,1
172422,31,42,30,12,42,30,12,,,
172440,31,117,76,41,117,76,41,,,
172495,31,63,5,58,63,5,58,,,
172617,31,1509,744,765,694,355,339,815,389,426
172635,31,1082,474,608,287,150,137,795,324,471
172644,31,2577,1045,1532,2459,984,1475,118,61,57
172671,31,188,81,107,106,47,59,82,34,48
172680,31,20,0,20,10,0,10,10,0,10
172699,31,2621,1210,1411,2578,1195,1383,43,15,28
172866,31,18,17,1,18,17,1,,,
172918,31,504,336,168,456,315,141,48,21,27
172954,31,281,175,106,166,126,40,115,49,66
172963,31,968,446,522,592,296,296,376,150,226
173045,31,612,258,354,610,257,353,2,1,1
173063,31,442,244,198,310,196,114,132,48,84
173115,31,88,51,37,70,47,23,18,4,14
173124,31,452,201,251,445,199,246,7,2,5
173142,31,176,98,78,176,98,78,,,
173160,31,448,177,271,440,172,268,8,5,3
173203,31,432,271,161,360,240,120,72,31,41
173258,31,532,268,264,532,268,264,,,
173300,31,444,215,229,444,215,229,,,
173328,31,302,135,167,298,134,164,4,1,3
173416,31,466,334,132,335,245,90,131,89,42
173452,31,142,77,65,142,77,65,,,
173461,31,586,318,268,375,223,152,211,95,116
173559,31,748,409,339,530,331,199,218,78,140
173638,31,388,258,130,305,214,91,83,44,39
173647,31,463,231,232,463,231,232,,,
173665,31,477,168,309,477,168,309,,,
173708,31,489,353,136,256,204,52,233,149,84
173735,31,608,383,225,557,368,189,51,15,36
173744,31,109,2,107,109,2,107,,,
173799,31,428,203,225,267,131,136,161,72,89
173902,31,552,212,340,552,212,340,,,
173911,31,419,231,188,283,178,105,136,53,83
173920,31,2307,1031,1276,2281,1016,1265,26,15,11
173957,31,30,9,21,30,9,21,,,
174020,31,135,60,75,101,51,50,34,9,25
174066,31,6737,2972,3765,6705,2956,3749,32,16,16
174075,31,187,67,120,179,62,117,8,5,3
174127,31,160,40,120,160,40,120,,,
174136,31,793,410,383,429,230,199,364,180,184
174154,31,136,18,118,93,12,81,43,6,37
174190,31,102,3,99,79,2,77,23,1,22
174233,31,1977,981,996,1956,973,983,21,8,13
174251,31,273,130,143,269,126,143,4,4,0
174321,31,25,3,22,24,3,21,1,0,1
174358,31,631,205,426,624,201,423,7,4,3
174376,31,603,279,324,312,159,153,291,120,171
174428,31,1467,722,745,853,438,415,614,284,330
174437,31,172,88,84,169,86,83,3,2,1
174473,31,314,172,142,231,134,97,83,38,45
174491,31,398,185,213,394,184,210,4,1,3
174507,31,4,2,2,4,2,2,,,
174525,31,24,13,11,24,13,11,,,
174570,31,149,88,61,113,76,37,36,12,24
174738,31,729,359,370,517,286,231,212,73,139
174747,31,324,0,324,324,0,324,,,
174756,31,610,309,301,409,230,179,201,79,122
174783,31,763,339,424,736,331,405,27,8,19
174792,31,383,383,0,383,383,0,,,
174817,31,215,83,132,215,83,132,,,
174844,31,869,374,495,869,374,495,,,
174862,31,207,108,99,191,101,90,16,7,9
174899,31,367,141,226,366,141,225,1,0,1
174914,31,1586,795,791,1569,788,781,17,7,10
174978,31,34,2,32,27,2,25,7,0,7
175005,31,346,4,342,324,2,322,22,2,20
175014,31,131,36,95,78,23,55,53,13,40
175041,31,904,455,449,509,289,220,395,166,229
175078,31,330,127,203,319,126,193,11,1,10
175120,31,350,244,106,350,244,106,,,
175227,31,323,265,58,300,246,54,23,19,4
175236,31,479,230,249,363,190,173,116,40,76
175263,31,218,120,98,161,102,59,57,18,39
175272,31,1173,332,841,1157,322,835,16,10,6
175315,31,1030,497,533,629,318,311,401,179,222
175342,31,498,159,339,459,147,312,39,12,27
175421,31,262,126,136,257,124,133,5,2,3
175430,31,90,34,56,90,34,56,,,
175494,31,17,4,13,17,4,13,,,
175519,31,349,164,185,304,150,154,45,14,31
175573,31,677,326,351,648,311,337,29,15,14
175616,31,217,99,118,212,98,114,5,1,4
175643,31,562,265,297,543,259,284,19,6,13
175652,31,685,388,297,648,371,277,37,17,20
175698,31,31,26,5,23,20,3,8,6,2
175722,31,3,0,3,3,0,3,,,
175786,31,1554,759,795,1370,669,701,184,90,94
175810,31,1037,477,560,992,460,532,45,17,28
175829,31,1433,642,791,1305,581,724,128,61,67
175856,31,1132,418,714,1068,397,671,64,21,43
175883,31,759,317,442,670,286,384,89,31,58
175935,31,440,206,234,418,196,222,22,10,12
175980,31,192,121,71,192,121,71,,,
176008,31,473,217,256,445,200,245,28,17,11
176017,31,4465,1916,2549,4429,1896,2533,36,20,16
176035,31,125,35,90,121,35,86,4,0,4
176044,31,225,117,108,205,106,99,20,11,9
176053,31,376,166,210,372,163,209,4,3,1
176062,31,9,0,9,9,0,9,,,
176071,31,1950,891,1059,1681,772,909,269,119,150
176080,31,3367,1618,1749,3353,1612,1741,14,6,8
176169,31,865,341,524,842,329,513,23,12,11
176178,31,1474,647,827,1400,617,783,74,30,44
176239,31,858,387,471,789,358,431,69,29,40
176318,31,184,90,94,164,78,86,20,12,8
176336,31,32,29,3,32,29,3,,,
176354,31,562,300,262,512,254,258,50,46,4
176372,31,1624,545,1079,1593,531,1062,31,14,17
176406,31,133,52,81,133,52,81,,,
176433,31,2,0,2,1,0,1,1,0,1
176451,31,3,2,1,,,,3,2,1
176479,31,178,77,101,173,76,97,5,1,4
176628,31,184,77,107,184,77,107,,,
176664,31,71,42,29,67,40,27,4,2,2
176716,31,11,0,11,11,0,11,,,
176770,31,1,0,1,1,0,1,,,
176789,31,32,13,19,27,12,15,5,1,4
176798,31,25,2,23,17,0,17,8,2,6
176910,31,12,7,5,10,7,3,2,0,2
176947,31,294,147,147,292,146,146,2,1,1
176965,31,1028,474,554,1010,468,542,18,6,12
176983,31,45,40,5,37,36,1,8,4,4
177038,31,6,3,3,2,1,1,4,2,2
177065,31,569,265,304,290,116,174,279,149,130
177083,31,4,4,0,4,4,0,,,
177117,31,96,0,96,96,0,96,,,
177135,31,948,411,537,819,358,461,129,53,76
177144,31,263,152,111,263,152,111,,,
177214,31,403,212,191,403,212,191,,,
177250,31,568,242,326,489,215,274,79,27,52
177302,31,100,93,7,100,93,7,,,
177339,31,343,162,181,343,162,181,,,
177418,31,183,112,71,181,111,70,2,1,1
177436,31,5,1,4,5,1,4,,,
177472,31,2675,1238,1437,1988,896,1092,687,342,345
177542,31,70,44,26,53,27,26,17,17,0
177551,31,235,78,157,227,75,152,8,3,5
177588,31,12,1,11,12,1,11,,,
177603,31,3,0,3,2,0,2,1,0,1
177676,31,840,369,471,718,327,391,122,42,80
177685,31,20,4,16,20,4,16,,,
177746,31,187,36,151,187,36,151,,,
177931,31,5,1,4,5,1,4,,,
177940,31,350,161,189,341,159,182,9,2,7
177968,31,886,375,511,865,368,497,21,7,14
177977,31,992,855,137,976,844,132,16,11,5
177986,31,15,6,9,8,3,5,7,3,4
177995,31,2931,1283,1648,2022,896,1126,909,387,522
178059,31,870,281,589,695,227,468,175,54,121
178077,31,22,1,21,22,1,21,,,
178183,31,26,7,19,26,7,19,,,
178208,31,61,48,13,37,28,9,24,20,4
178217,31,510,207,303,455,189,266,55,18,37
178244,31,317,171,146,308,168,140,9,3,6
178341,31,605,237,368,553,223,330,52,14,38
178369,31,381,256,125,377,253,124,4,3,1
178387,31,598,257,341,563,246,317,35,11,24
178396,31,4983,2151,2832,4928,2121,2807,55,30,25
178402,31,1165,406,759,1139,395,744,26,11,15
178411,31,1146,892,254,1136,885,251,10,7,3
178420,31,443,175,268,415,163,252,28,12,16
178448,31,1062,455,607,795,341,454,267,114,153
178527,31,41,1,40,20,1,19,21,0,21
178615,31,699,283,416,698,282,416,1,1,0
178624,31,1095,418,677,1076,413,663,19,5,14
178679,31,147,68,79,142,66,76,5,2,3
178697,31,358,178,180,358,178,180,,,
178721,31,336,194,142,216,115,101,120,79,41
178767,31,4,0,4,2,0,2,2,0,2
178828,31,21,8,13,21,8,13,,,
178891,31,550,508,42,476,438,38,74,70,4
179043,31,287,103,184,285,103,182,2,0,2
179159,31,1665,640,1025,1658,637,1021,7,3,4
179195,31,4,0,4,4,0,4,,,
179265,31,106,45,61,106,45,61,,,
179308,31,2378,1018,1360,1643,717,926,735,301,434
179326,31,279,127,152,265,124,141,14,3,11
179344,31,329,117,212,295,108,187,34,9,25
179511,31,42,1,41,23,1,22,19,0,19
179539,31,806,325,481,695,285,410,111,40,71
179548,31,76,5,71,76,5,71,,,
179557,31,1447,564,883,1388,538,850,59,26,33
179566,31,2332,876,1456,2188,818,1370,144,58,86
179645,31,579,217,362,508,193,315,71,24,47
179715,31,407,127,280,347,113,234,60,14,46
179867,31,1813,827,986,1808,826,982,5,1,4
179894,31,428,162,266,414,156,258,14,6,8
179946,31,161,77,84,161,77,84,,,
179955,31,243,132,111,243,132,111,,,
179964,31,225,67,158,213,63,150,12,4,8
179991,31,18,1,17,18,1,17,,,
180054,31,37,7,30,37,7,30,,,
180063,31,27,1,26,27,1,26,,,
180081,31,120,79,41,119,78,41,1,1,0
180090,31,43,2,41,43,2,41,,,
180106,31,296,126,170,296,126,170,,,
180151,31,101,42,59,96,41,55,5,1,4
180160,31,29,7,22,12,3,9,17,4,13
180179,31,572,229,343,474,196,278,98,33,65
180197,31,293,122,171,182,82,100,111,40,71
180203,31,28,14,14,28,14,14,,,
180212,31,72,27,45,60,24,36,12,3,9
180249,31,170,66,104,120,48,72,50,18,32
180258,31,99,45,54,97,45,52,2,0,2
180276,31,170,71,99,118,59,59,52,12,40
180328,31,72,31,41,65,28,37,7,3,4
180373,31,135,61,74,122,59,63,13,2,11
180416,31,309,190,119,307,189,118,2,1,1
180461,31,3752,2001,1751,3259,1735,1524,493,266,227
180489,31,1621,679,942,1500,624,876,121,55,66
180522,31,213,147,66,202,144,58,11,3,8
180595,31,261,134,127,260,134,126,1,0,1
180647,31,78,27,51,70,26,44,8,1,7
180692,31,271,108,163,262,107,155,9,1,8
180814,31,448,259,189,170,102,68,278,157,121
180832,31,37,4,33,31,3,28,6,1,5
180878,31,72,4,68,62,3,59,10,1,9
180902,31,727,375,352,567,320,247,160,55,105
180948,31,319,117,202,314,116,198,5,1,4
180957,31,15,11,4,15,11,4,,,
180984,31,335,165,170,335,165,170,,,
181002,31,1028,446,582,1028,446,582,,,
181020,31,240,135,105,239,134,105,1,1,0
181127,31,264,141,123,264,141,123,,,
181190,31,22,0,22,22,0,22,,,
181215,31,863,318,545,846,310,536,17,8,9
181297,31,44,1,43,37,1,36,7,0,7
181303,31,1117,638,479,561,333,228,556,305,251
181312,31,350,171,179,299,149,150,51,22,29
181330,31,324,176,148,324,176,148,,,
181394,31,2343,964,1379,2292,934,1358,51,30,21
181419,31,30,14,16,18,7,11,12,7,5
181446,31,358,174,184,358,174,184,,,
181464,31,4640,2256,2384,4616,2244,2372,24,12,12
181491,31,992,573,419,897,533,364,95,40,55
181534,31,231,110,121,223,107,116,8,3,5
181543,31,4,1,3,3,1,2,1,0,1
181604,31,88,0,88,88,0,88,,,
181640,31,1655,977,678,1092,717,375,563,260,303
181738,31,90,39,51,89,38,51,1,1,0
181765,31,102,32,70,102,32,70,,,
181783,31,778,357,421,777,357,420,1,0,1
181817,31,300,135,165,214,102,112,86,33,53
181853,31,108,58,50,108,58,50,,,
181880,31,194,5,189,123,4,119,71,1,70
181941,31,65,48,17,65,48,17,,,
182005,31,5056,2297,2759,2958,1348,1610,2098,949,1149
182148,31,76,10,66,76,10,66,,,
182281,31,4312,1884,2428,4222,1839,2383,90,45,45
182290,31,3296,1504,1792,3257,1486,1771,39,18,21
182306,31,267,135,132,116,62,54,151,73,78
182500,31,1489,713,776,845,369,476,644,344,300
182564,31,436,197,239,284,128,156,152,69,83
182634,31,186,72,114,182,69,113,4,3,1
182670,31,1124,564,560,1124,564,560,,,
182704,31,17,0,17,17,0,17,,,
182722,31,9,0,9,8,0,8,1,0,1
182795,31,318,160,158,318,160,158,,,
182892,31,44,0,44,26,0,26,18,0,18
182917,31,15,5,10,15,5,10,,,
182980,31,257,114,143,255,113,142,2,1,1
182999,31,8,0,8,8,0,8,,,
183026,31,13583,4993,8590,2948,1066,1882,10635,3927,6708
183035,31,10,0,10,10,0,10,,,
183044,31,2942,1268,1674,2942,1268,1674,,,
183062,31,709,332,377,707,330,377,2,2,0
183071,31,54,28,26,53,28,25,1,0,1
183080,31,870,433,437,860,427,433,10,6,4
183099,31,644,262,382,379,173,206,265,89,176
183105,31,125,68,57,82,51,31,43,17,26
183114,31,97,31,66,26,14,12,71,17,54
183123,31,164,105,59,111,86,25,53,19,34
183132,31,477,286,191,268,182,86,209,104,105
183141,31,284,146,138,133,81,52,151,65,86
183150,31,298,156,142,154,82,72,144,74,70
183202,31,9,0,9,9,0,9,,,
183211,31,275,112,163,269,112,157,6,0,6
183239,31,528,218,310,528,218,310,,,
183248,31,1,1,0,1,1,0,,,
183257,31,49,11,38,33,8,25,16,3,13
183275,31,25,8,17,25,8,17,,,
183488,31,111,18,93,99,17,82,12,1,11
183600,31,12,0,12,6,0,6,6,0,6
183655,31,1004,452,552,672,311,361,332,141,191
183725,31,114,62,52,106,57,49,8,5,3
183743,31,2775,1433,1342,2185,1136,1049,590,297,293
183789,31,135,56,79,120,49,71,15,7,8
183822,31,235,99,136,231,98,133,4,1,3
183859,31,1853,1027,826,1338,737,601,515,290,225
183877,31,1605,703,902,1165,508,657,440,195,245
183910,31,445,196,249,444,196,248,1,0,1
183938,31,1244,568,676,880,403,477,364,165,199
183974,31,190,75,115,187,74,113,3,1,2
183983,31,70,68,2,70,68,2,,,
184056,31,174,44,130,174,44,130,,,
184092,31,135,25,110,135,25,110,,,
184180,31,1239,741,498,858,514,344,381,227,154
184205,31,523,200,323,314,131,183,209,69,140
184348,31,309,126,183,309,126,183,,,
184427,31,121,113,8,96,90,6,25,23,2
184481,31,1447,665,782,944,435,509,503,230,273
184506,31,45,5,40,28,4,24,17,1,16
184603,31,531,290,241,514,289,225,17,1,16
184612,31,265,97,168,265,97,168,,,
184694,31,467,253,214,461,249,212,6,4,2
184746,31,65,58,7,58,52,6,7,6,1
184773,31,204,66,138,196,65,131,8,1,7
184782,31,2585,1321,1264,2574,1315,1259,11,6,5
184791,31,1276,602,674,1117,531,586,159,71,88
184816,31,51,2,49,36,1,35,15,1,14
184959,31,96,8,88,70,7,63,26,1,25
184968,31,3,0,3,3,0,3,,,
184995,31,1604,724,880,1163,524,639,441,200,241
185129,31,768,349,419,754,345,409,14,4,10
185174,31,36,26,10,36,26,10,,,
185262,31,1968,813,1155,1904,782,1122,64,31,33
185396,31,656,635,21,601,583,18,55,52,3
185466,31,347,7,340,119,1,118,228,6,222
185509,31,1254,660,594,736,405,331,518,255,263
185536,31,2499,1228,1271,1753,877,876,746,351,395
185572,31,896,309,587,896,309,587,,,
185590,31,3946,1633,2313,3942,1631,2311,4,2,2
185679,31,6,0,6,6,0,6,,,
185721,31,106,43,63,99,39,60,7,4,3
185828,31,1575,1082,493,1465,1016,449,110,66,44
185873,31,1844,950,894,1345,715,630,499,235,264
185970,31,8,1,7,8,1,7,,,
186016,31,46,4,42,34,4,30,12,0,12
186034,31,769,354,415,479,220,259,290,134,156
186052,31,419,346,73,359,306,53,60,40,20
186131,31,1497,735,762,1497,735,762,,,
186186,31,59,59,0,59,59,0,,,
186201,31,850,334,516,846,333,513,4,1,3
186274,31,19,2,17,13,2,11,6,0,6
186283,31,779,354,425,779,354,425,,,
186371,31,528,239,289,524,237,287,4,2,2
186380,31,7780,3830,3950,7769,3824,3945,11,6,5
186399,31,1239,586,653,1232,583,649,7,3,4
186432,31,401,174,227,398,173,225,3,1,2
186469,31,255,104,151,194,87,107,61,17,44
186584,31,1512,690,822,1511,689,822,1,1,0
186593,31,12,10,2,12,10,2,,,
186618,31,164,74,90,164,74,90,,,
186645,31,1381,774,607,1005,556,449,376,218,158
186867,31,1010,633,377,1010,633,377,,,
186876,31,1562,628,934,1560,627,933,2,1,1
186900,31,12,12,0,12,12,0,,,
187000,31,53,49,4,53,49,4,,,
187134,31,1583,660,923,1578,656,922,5,4,1
187198,31,1867,885,982,1364,676,688,503,209,294
187444,31,806,368,438,801,367,434,5,1,4
187505,31,241,59,182,241,59,182,,,
187532,31,2962,1223,1739,1314,583,731,1648,640,1008
187596,31,225,110,115,164,89,75,61,21,40
187620,31,1107,504,603,934,428,506,173,76,97
187639,31,293,97,196,178,59,119,115,38,77
187648,31,424,173,251,412,169,243,12,4,8
187666,31,450,196,254,314,145,169,136,51,85
187745,31,61,19,42,53,16,37,8,3,5
187897,31,246,128,118,225,115,110,21,13,8
187903,31,947,317,630,524,235,289,423,82,341
187912,31,192,158,34,192,158,34,,,
187958,31,267,114,153,179,78,101,88,36,52
187967,31,301,231,70,299,230,69,2,1,1
187976,31,100,46,54,29,12,17,71,34,37
187985,31,3509,1511,1998,3394,1455,1939,115,56,59
187994,31,148,60,88,94,35,59,54,25,29
188003,31,144,46,98,103,33,70,41,13,28
188021,31,120,41,79,79,32,47,41,9,32
188030,31,2325,944,1381,2292,930,1362,33,14,19
188049,31,200,75,125,91,39,52,109,36,73
188058,31,143,56,87,115,44,71,28,12,16
188100,31,541,223,318,291,138,153,250,85,165
188137,31,312,140,172,146,63,83,166,77,89
188182,31,27,19,8,22,15,7,5,4,1
188216,31,49,23,26,45,22,23,4,1,3
188225,31,106,31,75,44,13,31,62,18,44
188261,31,91,59,32,73,52,21,18,7,11
188289,31,21,1,20,21,1,20,,,
188304,31,310,152,158,257,137,120,53,15,38
188340,31,183,161,22,175,153,22,8,8,0
188429,31,1146,406,740,1142,405,737,4,1,3
188438,31,671,327,344,603,294,309,68,33,35
188517,31,39,25,14,39,25,14,,,
188526,31,111,38,73,111,38,73,,,
188641,31,369,195,174,369,195,174,,,
188650,31,75,2,73,75,2,73,,,
188669,31,21,6,15,21,6,15,,,
188678,31,106,31,75,106,31,75,,,
188687,31,16,6,10,9,4,5,7,2,5
188696,31,63,7,56,63,7,56,,,
188854,31,470,118,352,470,118,352,,,
188890,31,595,584,11,437,429,8,158,155,3
188915,31,9,2,7,9,2,7,,,
188942,31,116,0,116,114,0,114,2,0,2
189088,31,446,146,300,446,146,300,,,
189097,31,706,0,706,698,0,698,8,0,8
189219,31,102,100,2,102,100,2,,,
189228,31,99,33,66,63,17,46,36,16,20
189255,31,72,1,71,49,1,48,23,0,23
189273,31,25,25,0,25,25,0,,,
189404,31,4,0,4,1,0,1,3,0,3
189413,31,49,17,32,49,17,32,,,
189468,31,146,4,142,87,4,83,59,0,59
189477,31,6,0,6,1,0,1,5,0,5
189547,31,1109,501,608,993,457,536,116,44,72
189565,31,66,31,35,64,30,34,2,1,1
189583,31,74,19,55,68,18,50,6,1,5
189592,31,38,23,15,37,23,14,1,0,1
189705,31,478,239,239,475,238,237,3,1,2
189714,31,39,1,38,26,0,26,13,1,12
189811,31,41,6,35,41,6,35,,,
189839,31,336,127,209,290,112,178,46,15,31
189848,31,171,63,108,171,63,108,,,
189857,31,120,120,0,120,120,0,,,
189990,31,54,2,52,18,1,17,36,1,35
190008,31,2,0,2,2,0,2,,,
190044,31,596,413,183,596,413,183,,,
190053,31,111,63,48,100,58,42,11,5,6
190099,31,812,343,469,812,343,469,,,
190114,31,31,13,18,26,10,16,5,3,2
190150,31,1540,761,779,1494,738,756,46,23,23
190169,31,260,133,127,195,103,92,65,30,35
190239,31,45,2,43,32,1,31,13,1,12
190318,31,44,6,38,38,1,37,6,5,1
190372,31,195,78,117,195,78,117,,,
190415,31,3491,1570,1921,3491,1570,1921,,,
190442,31,442,204,238,369,170,199,73,34,39
190451,31,6,0,6,5,0,5,1,0,1
190503,31,674,310,364,674,310,364,,,
190512,31,2587,1228,1359,2554,1210,1344,33,18,15
190521,31,3885,1773,2112,3258,1486,1772,627,287,340
190530,31,1312,693,619,1090,566,524,222,127,95
190549,31,1689,807,882,1659,789,870,30,18,12
190558,31,1911,974,937,1842,940,902,69,34,35
190567,31,2734,1417,1317,2580,1340,1240,154,77,77
190576,31,5,1,4,,,,5,1,4
190585,31,894,358,536,726,300,426,168,58,110
190594,31,3140,975,2165,3066,950,2116,74,25,49
190600,31,1871,584,1287,1852,574,1278,19,10,9
190619,31,1669,831,838,1552,774,778,117,57,60
190628,31,2245,1037,1208,1940,914,1026,305,123,182
190637,31,1484,547,937,1432,536,896,52,11,41
190646,31,601,207,394,571,199,372,30,8,22
190655,31,3028,1857,1171,2792,1721,1071,236,136,100
190664,31,2334,1119,1215,2226,1059,1167,108,60,48
190673,31,2006,1087,919,1815,992,823,191,95,96
190691,31,777,328,449,744,312,432,33,16,17
190707,31,11,4,7,11,4,7,,,
190716,31,286,87,199,284,86,198,2,1,1
190725,31,358,85,273,358,85,273,,,
190752,31,14,14,0,14,14,0,,,
190761,31,214,101,113,214,101,113,,,
190840,31,1117,563,554,962,498,464,155,65,90
190956,31,4,0,4,3,0,3,1,0,1
190983,31,172,71,101,172,71,101,,,
191083,31,1977,1083,894,1604,914,690,373,169,204
191126,31,1343,238,1105,1295,221,1074,48,17,31
191199,31,952,480,472,775,393,382,177,87,90
191205,31,96,75,21,96,75,21,,,
191241,31,2594,962,1632,2581,957,1624,13,5,8
191302,31,313,147,166,267,134,133,46,13,33
191311,31,41,21,20,41,21,20,,,
191339,31,548,242,306,484,217,267,64,25,39
191515,31,478,199,279,478,199,279,,,
191533,31,340,147,193,340,147,193,,,
191597,31,2,1,1,2,1,1,,,
191612,31,442,208,234,398,177,221,44,31,13
191621,31,280,149,131,279,148,131,1,1,0
191630,31,438,224,214,438,224,214,,,
191649,31,1710,711,999,1704,708,996,6,3,3
191676,31,175,71,104,174,71,103,1,0,1
191719,31,1770,1067,703,1592,988,604,178,79,99
191728,31,322,67,255,272,59,213,50,8,42
191931,31,809,381,428,809,381,428,,,
191940,31,83,9,74,83,9,74,,,
191959,31,30,28,2,30,28,2,,,
191968,31,1311,592,719,1309,591,718,2,1,1
191986,31,551,263,288,506,244,262,45,19,26
192004,31,96,31,65,95,31,64,1,0,1
192022,31,524,221,303,446,194,252,78,27,51
192040,31,40,17,23,40,17,23,,,
192110,31,107,51,56,107,51,56,,,
192165,31,51,51,0,51,51,0,,,
192192,31,211,54,157,211,54,157,,,
192271,31,235,32,203,232,32,200,3,0,3
192323,31,604,230,374,601,229,372,3,1,2
192448,31,1107,440,667,1102,437,665,5,3,2
192484,31,28,0,28,18,0,18,10,0,10
192509,31,216,40,176,216,40,176,,,
192624,31,33,33,0,33,33,0,,,
192688,31,59,10,49,59,10,49,,,
192703,31,758,462,296,752,459,293,6,3,3
192712,31,154,74,80,154,74,80,,,
192749,31,314,130,184,314,130,184,,,
192785,31,58,6,52,32,2,30,26,4,22
192800,31,2,0,2,2,0,2,,,
192819,31,1334,529,805,1334,529,805,,,
192864,31,423,72,351,403,69,334,20,3,17
192925,31,371,135,236,337,128,209,34,7,27
192961,31,1,0,1,,,,1,0,1
193016,31,929,332,597,912,328,584,17,4,13
193052,31,27,27,0,27,27,0,,,
193061,31,6,6,0,6,6,0,,,
193070,31,15,15,0,15,15,0,,,
193201,31,73,10,63,73,10,63,,,
193247,31,38,38,0,38,38,0,,,
193265,31,61,54,7,45,41,4,16,13,3
193283,31,1002,460,542,909,433,476,93,27,66
193292,31,642,200,442,640,200,440,2,0,2
193308,31,1120,555,565,1059,544,515,61,11,50
193326,31,1762,818,944,1436,682,754,326,136,190
193353,31,236,82,154,222,81,141,14,1,13
193399,31,494,164,330,493,164,329,1,0,1
193478,31,2433,1347,1086,2143,1198,945,290,149,141
193584,31,470,158,312,470,158,312,,,
193609,31,5,2,3,5,2,3,,,
193654,31,1424,284,1140,1393,276,1117,31,8,23
193858,31,83,3,80,83,3,80,,,
193900,31,6184,2419,3765,6164,2410,3754,20,9,11
193946,31,778,339,439,719,313,406,59,26,33
193973,31,545,192,353,545,192,353,,,
193991,31,12,1,11,10,1,9,2,0,2
194028,31,317,117,200,254,97,157,63,20,43
194091,31,878,542,336,836,520,316,42,22,20
194116,31,27,4,23,15,2,13,12,2,10
194161,31,111,50,61,91,44,47,20,6,14
194189,31,1,1,0,1,1,0,,,
194222,31,1273,662,611,1105,580,525,168,82,86
194240,31,968,442,526,793,368,425,175,74,101
194259,31,9,0,9,9,0,9,,,
194310,31,2106,635,1471,2084,623,1461,22,12,10
194392,31,165,110,55,165,110,55,,,
194435,31,13,0,13,13,0,13,,,
194499,31,177,35,142,177,35,142,,,
194569,31,4,3,1,3,2,1,1,1,0
194578,31,886,247,639,882,245,637,4,2,2
194657,31,43,43,0,43,43,0,,,
194666,31,84,84,0,84,84,0,,,
194693,31,13,13,0,13,13,0,,,
194718,31,27,27,0,27,27,0,,,
194736,31,37,37,0,37,37,0,,,
194763,31,90,90,0,90,90,0,,,
194824,31,2002,1411,591,2002,1411,591,,,
194958,31,211,77,134,205,76,129,6,1,5
195003,31,3202,2126,1076,3201,2125,1076,1,1,0
195030,31,1625,759,866,1625,759,866,,,
195058,31,1250,701,549,1072,627,445,178,74,104
195067,31,169,8,161,127,7,120,42,1,41
195128,31,238,79,159,238,79,159,,,
195164,31,571,308,263,571,308,263,,,
195173,31,495,219,276,488,212,276,7,7,0
195191,31,2,0,2,2,0,2,,,
195216,31,533,244,289,533,244,289,,,
195234,31,240,78,162,239,78,161,1,0,1
195243,31,245,127,118,243,126,117,2,1,1
195289,31,2,0,2,2,0,2,,,
195304,31,384,65,319,384,65,319,,,
195322,31,502,234,268,380,181,199,122,53,69
195438,31,2,2,0,2,2,0,,,
195474,31,864,387,477,862,386,476,2,1,1
195526,31,784,301,483,781,300,481,3,1,2
195544,31,575,199,376,570,199,371,5,0,5
195702,31,1,1,0,1,1,0,,,
195720,31,643,273,370,643,273,370,,,
195784,31,41,10,31,41,10,31,,,
195809,31,2905,1301,1604,2870,1283,1587,35,18,17
195988,31,266,127,139,221,106,115,45,21,24
196006,31,1029,735,294,1022,730,292,7,5,2
196015,31,477,248,229,464,242,222,13,6,7
196024,31,682,399,283,680,397,283,2,2,0
196033,31,488,219,269,487,219,268,1,0,1
196042,31,1576,922,654,1523,889,634,53,33,20
196051,31,520,317,203,514,315,199,6,2,4
196060,31,2651,1114,1537,2645,1111,1534,6,3,3
196079,31,3107,1400,1707,3103,1397,1706,4,3,1
196088,31,4215,2191,2024,4187,2174,2013,28,17,11
196097,31,3347,1611,1736,3342,1609,1733,5,2,3
196103,31,356,176,180,340,169,171,16,7,9
196112,31,381,274,107,379,273,106,2,1,1
196121,31,1015,416,599,1011,414,597,4,2,2
196130,31,1252,586,666,1241,580,661,11,6,5
196149,31,1341,639,702,1340,638,702,1,1,0
196158,31,716,300,416,715,299,416,1,1,0
196167,31,872,259,613,872,259,613,,,
196176,31,1163,402,761,1156,399,757,7,3,4
196185,31,1106,382,724,1105,381,724,1,1,0
196194,31,1468,713,755,1460,709,751,8,4,4
196200,31,444,176,268,443,175,268,1,1,0
196219,31,687,276,411,684,273,411,3,3,0
196237,31,611,270,341,608,268,340,3,2,1
196246,31,845,328,517,838,325,513,7,3,4
196264,31,190,89,101,104,35,69,86,54,32
196291,31,284,254,30,284,254,30,,,
196389,31,448,95,353,444,93,351,4,2,2
196413,31,4108,1836,2272,4094,1829,2265,14,7,7
196431,31,37,37,0,35,35,0,2,2,0
196440,31,7,7,0,7,7,0,,,
196565,31,419,224,195,374,206,168,45,18,27
196583,31,10,10,0,10,10,0,,,
196592,31,526,183,343,450,162,288,76,21,55
196653,31,52,7,45,38,5,33,14,2,12
196680,31,224,121,103,,,,224,121,103
196699,31,374,183,191,306,155,151,68,28,40
196866,31,575,326,249,575,326,249,,,
197018,31,445,445,0,445,445,0,,,
197027,31,200,174,26,200,174,26,,,
197036,31,1173,926,247,1173,926,247,,,
197045,31,442,228,214,434,223,211,8,5,3
197133,31,679,278,401,679,278,401,,,
197142,31,101,49,52,101,49,52,,,
197151,31,775,181,594,774,180,594,1,1,0
197197,31,407,172,235,407,172,235,,,
197221,31,25,19,6,25,19,6,,,
197230,31,147,76,71,147,76,71,,,
197285,31,108,50,58,105,49,56,3,1,2
197294,31,2099,1073,1026,1571,816,755,528,257,271
197337,31,4,0,4,4,0,4,,,
197531,31,320,145,175,320,145,175,,,
197601,31,32,32,0,32,32,0,,,
197647,31,27,27,0,27,27,0,,,
197674,31,53,53,0,53,53,0,,,
197692,31,24,24,0,24,24,0,,,
197708,31,622,343,279,621,342,279,1,1,0
197735,31,196,196,0,196,196,0,,,
197744,31,10,10,0,10,10,0,,,
197814,31,298,132,166,151,79,72,147,53,94
197850,31,439,182,257,211,92,119,228,90,138
197869,31,3917,1640,2277,3899,1635,2264,18,5,13
197887,31,991,441,550,380,187,193,611,254,357
197911,31,300,176,124,299,175,124,1,1,0
197966,31,184,78,106,78,31,47,106,47,59
197984,31,394,225,169,393,225,168,1,0,1
197993,31,30,0,30,30,0,30,,,
198011,31,100,23,77,55,17,38,45,6,39
198039,31,388,175,213,161,75,86,227,100,127
198066,31,175,106,69,175,106,69,,,
198084,31,275,124,151,188,80,108,87,44,43
198109,31,17,0,17,9,0,9,8,0,8
198118,31,528,221,307,273,131,142,255,90,165
198136,31,519,237,282,493,220,273,26,17,9
198154,31,2001,905,1096,614,320,294,1387,585,802
198206,31,282,110,172,173,73,100,109,37,72
198215,31,298,150,148,298,150,148,,,
198233,31,657,318,339,384,192,192,273,126,147
198251,31,808,321,487,433,180,253,375,141,234
198260,31,1699,899,800,983,522,461,716,377,339
198303,31,215,130,85,215,130,85,,,
198321,31,164,89,75,108,63,45,56,26,30
198330,31,670,356,314,379,183,196,291,173,118
198367,31,325,151,174,138,67,71,187,84,103
198376,31,595,243,352,284,140,144,311,103,208
198385,31,542,249,293,542,249,293,,,
198419,31,1745,793,952,1745,793,952,,,
198455,31,624,293,331,172,92,80,452,201,251
198464,31,3788,1562,2226,3725,1545,2180,63,17,46
198491,31,134,32,102,44,8,36,90,24,66
198507,31,350,181,169,349,181,168,1,0,1
198516,31,1692,697,995,1692,697,995,,,
198534,31,1160,572,588,558,261,297,602,311,291
198543,31,786,249,537,762,234,528,24,15,9
198552,31,1309,613,696,514,286,228,795,327,468
198561,31,403,187,216,403,187,216,,,
198570,31,869,363,506,441,200,241,428,163,265
198598,31,183,130,53,183,130,53,,,
198613,31,369,193,176,369,193,176,,,
198622,31,1291,686,605,650,375,275,641,311,330
198640,31,59,22,37,19,7,12,40,15,25
198668,31,198,83,115,144,65,79,54,18,36
198677,31,5,5,0,3,3,0,2,2,0
198695,31,1501,680,821,1501,680,821,,,
198710,31,264,110,154,159,67,92,105,43,62
198729,31,126,53,73,89,33,56,37,20,17
198756,31,266,144,122,259,139,120,7,5,2
198774,31,502,220,282,291,145,146,211,75,136
198808,31,212,92,120,212,92,120,,,
198817,31,209,77,132,122,57,65,87,20,67
198835,31,395,187,208,373,183,190,22,4,18
198844,31,66,1,65,66,1,65,,,
198862,31,217,152,65,214,149,65,3,3,0
198871,31,235,178,57,231,174,57,4,4,0
198899,31,255,145,110,247,139,108,8,6,2
198905,31,54,17,37,28,4,24,26,13,13
198914,31,133,59,74,79,34,45,54,25,29
198923,31,114,50,64,34,16,18,80,34,46
198950,31,332,0,332,331,0,331,1,0,1
198969,31,326,218,108,323,216,107,3,2,1
198978,31,34,2,32,30,2,28,4,0,4
198987,31,347,145,202,167,77,90,180,68,112
199005,31,4,0,4,4,0,4,,,
199032,31,210,110,100,208,109,99,2,1,1
199069,31,268,131,137,254,130,124,14,1,13
199078,31,13,2,11,12,2,10,1,0,1
199087,31,523,212,311,246,117,129,277,95,182
199102,31,3075,1006,2069,3036,989,2047,39,17,22
199111,31,507,194,313,503,191,312,4,3,1
199120,31,4435,1679,2756,4425,1673,2752,10,6,4
199139,31,4157,2019,2138,4061,1966,2095,96,53,43
199148,31,2343,785,1558,2318,773,1545,25,12,13
199157,31,1079,339,740,1072,335,737,7,4,3
199184,31,210,90,120,210,90,120,,,
199193,31,5627,2727,2900,5610,2718,2892,17,9,8
199209,31,249,163,86,246,160,86,3,3,0
199218,31,2370,861,1509,2358,855,1503,12,6,6
199263,31,25,5,20,7,4,3,18,1,17
199272,31,136,81,55,136,81,55,,,
199281,31,714,323,391,677,306,371,37,17,20
199306,31,165,98,67,164,97,67,1,1,0
199324,31,94,41,53,9,4,5,85,37,48
199333,31,1074,459,615,705,331,374,369,128,241
199412,31,303,129,174,299,127,172,4,2,2
199421,31,415,158,257,171,69,102,244,89,155
199449,31,254,101,153,107,45,62,147,56,91
199458,31,27,19,8,27,19,8,,,
199467,31,22,6,16,13,4,9,9,2,7
199476,31,868,300,568,307,107,200,561,193,368
199485,31,269,124,145,147,77,70,122,47,75
199494,31,1331,545,786,559,252,307,772,293,479
199582,31,341,178,163,258,131,127,83,47,36
199607,31,91,0,91,88,0,88,3,0,3
199625,31,192,72,120,114,41,73,78,31,47
199634,31,602,269,333,349,184,165,253,85,168
199643,31,200,124,76,193,119,74,7,5,2
199689,31,18,0,18,18,0,18,,,
199698,31,180,101,79,176,100,76,4,1,3
199722,31,67,27,40,29,15,14,38,12,26
199731,31,148,62,86,44,24,20,104,38,66
199740,31,186,75,111,76,31,45,110,44,66
199759,31,33,18,15,12,7,5,21,11,10
199768,31,446,214,232,277,142,135,169,72,97
199786,31,632,260,372,344,147,197,288,113,175
199795,31,92,36,56,50,22,28,42,14,28
199838,31,268,106,162,140,60,80,128,46,82
199847,31,1370,621,749,1370,621,749,,,
199856,31,4029,2147,1882,2044,1123,921,1985,1024,961
199865,31,192,82,110,192,82,110,,,
199892,31,295,145,150,147,81,66,148,64,84
199908,31,214,104,110,115,62,53,99,42,57
199926,31,355,159,196,213,108,105,142,51,91
199953,31,100,42,58,52,21,31,48,21,27
199962,31,828,342,486,827,342,485,1,0,1
199971,31,6,5,1,6,5,1,,,
199980,31,24,22,2,24,22,2,,,
199999,31,855,226,629,849,225,624,6,1,5
200004,31,1932,834,1098,1914,821,1093,18,13,5
200013,31,27,4,23,11,0,11,16,4,12
200022,31,780,431,349,707,393,314,73,38,35
200059,31,242,131,111,230,125,105,12,6,6
200086,31,18,7,11,16,7,9,2,0,2
200110,31,26,0,26,26,0,26,,,
200156,31,257,143,114,256,142,114,1,1,0
200192,31,181,92,89,173,90,83,8,2,6
200208,31,26,11,15,15,8,7,11,3,8
200217,31,458,202,256,457,202,255,1,0,1
200226,31,107,52,55,107,52,55,,,
200253,31,378,146,232,359,139,220,19,7,12
200280,31,1753,887,866,1719,868,851,34,19,15
200305,31,749,512,237,669,470,199,80,42,38
200314,31,110,58,52,97,54,43,13,4,9
200332,31,2513,1190,1323,2485,1177,1308,28,13,15
200341,31,251,101,150,224,98,126,27,3,24
200466,31,49,28,21,46,26,20,3,2,1
200484,31,31,19,12,29,17,12,2,2,0
200527,31,120,58,62,117,56,61,3,2,1
200554,31,120,40,80,117,40,77,3,0,3
200572,31,205,102,103,185,95,90,20,7,13
200590,31,10,4,6,9,4,5,1,0,1
200785,31,74,12,62,42,7,35,32,5,27
200800,31,2115,1125,990,2068,1103,965,47,22,25
200846,31,144,58,86,126,46,80,18,12,6
200873,31,21,14,7,15,8,7,6,6,0
201034,31,296,165,131,44,15,29,252,150,102
201061,31,86,9,77,85,9,76,1,0,1
201098,31,11,5,6,7,2,5,4,3,1
201104,31,528,260,268,486,228,258,42,32,10
201131,31,93,29,64,65,3,62,28,26,2
201140,31,5,5,0,,,,5,5,0
201159,31,111,82,29,61,51,10,50,31,19
201177,31,53,7,46,45,6,39,8,1,7
201195,31,643,296,347,642,296,346,1,0,1
201283,31,142,61,81,121,53,68,21,8,13
201371,31,162,87,75,162,87,75,,,
201432,31,522,227,295,479,212,267,43,15,28
201441,31,2937,1217,1720,2921,1209,1712,16,8,8
201469,31,60,29,31,60,29,31,,,
201478,31,1,0,1,1,0,1,,,
201496,31,267,161,106,267,161,106,,,
201539,31,24,9,15,21,6,15,3,3,0
201548,31,518,217,301,518,217,301,,,
201645,31,1553,820,733,1553,820,733,,,
201654,31,1140,540,600,1138,539,599,2,1,1
201672,31,284,86,198,127,42,85,157,44,113
201681,31,35,5,30,35,5,30,,,
201690,31,614,282,332,545,254,291,69,28,41
201803,31,11,1,10,11,1,10,,,
201821,31,102,9,93,99,9,90,3,0,3
201885,31,6369,3177,3192,6283,3144,3139,86,33,53
201928,31,846,386,460,463,222,241,383,164,219
201946,31,436,173,263,309,137,172,127,36,91
201955,31,1415,604,811,1230,531,699,185,73,112
201964,31,143,60,83,103,42,61,40,18,22
201973,31,580,230,350,213,92,121,367,138,229
202046,31,154,38,116,154,38,116,,,
202073,31,41,23,18,41,23,18,,,
202134,31,1726,772,954,1701,761,940,25,11,14
202152,31,35,5,30,35,5,30,,,
202170,31,225,60,165,225,60,165,,,
202222,31,4080,1977,2103,1929,916,1013,2151,1061,1090
202356,31,2209,975,1234,1213,545,668,996,430,566
202435,31,12,1,11,8,1,7,4,0,4
202453,31,34,30,4,34,30,4,,,
202480,31,1996,1033,963,1991,1031,960,5,2,3
202514,31,149,102,47,146,100,46,3,2,1
202523,31,683,327,356,683,327,356,,,
202648,31,548,249,299,256,136,120,292,113,179
202657,31,121,41,80,43,7,36,78,34,44
202763,31,672,196,476,667,195,472,5,1,4
202806,31,173,101,72,22,12,10,151,89,62
202888,31,26,3,23,18,3,15,8,0,8
202903,31,71,28,43,52,17,35,19,11,8
202912,31,19,3,16,13,3,10,6,0,6
202949,31,80,78,2,80,78,2,,,
202985,31,4,0,4,1,0,1,3,0,3
203030,31,6,1,5,6,1,5,,,
203085,31,240,147,93,240,147,93,,,
203128,31,192,107,85,191,107,84,1,0,1
203146,31,327,304,23,327,304,23,,,
203155,31,562,342,220,544,333,211,18,9,9
203234,31,35,1,34,35,1,34,,,
203289,31,19,15,4,19,15,4,,,
203331,31,2255,776,1479,661,220,441,1594,556,1038
203368,31,566,310,256,566,310,256,,,
203386,31,234,21,213,234,21,213,,,
203438,31,24,0,24,17,0,17,7,0,7
203447,31,112,45,67,75,29,46,37,16,21
203456,31,22,7,15,13,5,8,9,2,7
203465,31,374,152,222,266,114,152,108,38,70
203474,31,175,75,100,141,59,82,34,16,18
203483,31,203,78,125,172,71,101,31,7,24
203492,31,96,17,79,66,10,56,30,7,23
203517,31,4281,1556,2725,4229,1532,2697,52,24,28
203526,31,239,111,128,166,78,88,73,33,40
203535,31,531,223,308,531,223,308,,,
203544,31,98,18,80,77,15,62,21,3,18
203580,31,225,154,71,225,154,71,,,
203599,31,375,174,201,237,110,127,138,64,74
203614,31,150,62,88,150,62,88,,,
203678,31,320,113,207,184,80,104,136,33,103
203720,31,35,27,8,32,27,5,3,0,3
203739,31,5,0,5,4,0,4,1,0,1
203748,31,1209,508,701,626,253,373,583,255,328
203757,31,170,82,88,168,80,88,2,2,0
203775,31,211,113,98,209,112,97,2,1,1
203845,31,321,187,134,320,187,133,1,0,1
203881,31,338,167,171,139,45,94,199,122,77
203942,31,11,6,5,11,6,5,,,
203960,31,50,8,42,33,4,29,17,4,13
204006,31,533,221,312,467,193,274,66,28,38
204015,31,180,84,96,164,78,86,16,6,10
204024,31,4035,1861,2174,4028,1859,2169,7,2,5
204121,31,33,0,33,13,0,13,20,0,20
204158,31,29,16,13,29,16,13,,,
204176,31,30,4,26,30,4,26,,,
204185,31,551,315,236,550,314,236,1,1,0
204194,31,290,104,186,289,104,185,1,0,1
204200,31,296,150,146,296,150,146,,,
204255,31,232,116,116,155,90,65,77,26,51
204264,31,412,208,204,412,208,204,,,
204334,31,59,0,59,,,,59,0,59
204422,31,384,164,220,241,105,136,143,59,84
204431,31,21,6,15,21,6,15,,,
204440,31,268,128,140,149,71,78,119,57,62
204459,31,9,9,0,9,9,0,,,
204468,31,230,121,109,228,121,107,2,0,2
204486,31,898,785,113,891,782,109,7,3,4
204501,31,882,357,525,882,357,525,,,
204608,31,134,121,13,134,121,13,,,
204617,31,209,90,119,209,90,119,,,
204635,31,666,358,308,666,358,308,,,
204662,31,217,92,125,213,90,123,4,2,2
204671,31,274,139,135,263,133,130,11,6,5
204680,31,300,138,162,294,137,157,6,1,5
204699,31,314,182,132,304,178,126,10,4,6
204705,31,1144,585,559,1105,564,541,39,21,18
204714,31,11,0,11,11,0,11,,,
204723,31,155,112,43,155,112,43,,,
204769,31,52,3,49,52,3,49,,,
204778,31,35,0,35,35,0,35,,,
204796,31,8060,3771,4289,8027,3751,4276,33,20,13
204802,31,85,36,49,84,36,48,1,0,1
204820,31,134,47,87,126,45,81,8,2,6
204839,31,135,55,80,125,50,75,10,5,5
204848,31,177,73,104,154,63,91,23,10,13
204857,31,4506,1841,2665,4465,1832,2633,41,9,32
204866,31,111,30,81,105,28,77,6,2,4
204884,31,28,3,25,28,3,25,,,
204893,31,5,1,4,5,1,4,,,
204909,31,453,202,251,453,202,251,,,
204936,31,550,205,345,546,203,343,4,2,2
204945,31,957,400,557,606,244,362,351,156,195
204963,31,39,2,37,39,2,37,,,
204981,31,57,11,46,5,0,5,52,11,41
205027,31,6,6,0,6,6,0,,,
205054,31,59,2,57,59,2,57,,,
205124,31,27,27,0,27,27,0,,,
205142,31,19,7,12,18,7,11,1,0,1
205179,31,40,18,22,39,18,21,1,0,1
205203,31,159,79,80,149,77,72,10,2,8
205391,31,57,10,47,42,8,34,15,2,13
205443,31,640,273,367,618,262,356,22,11,11
205470,31,3890,1984,1906,1129,553,576,2761,1431,1330
205559,31,5,0,5,5,0,5,,,
205841,31,1514,739,775,829,440,389,685,299,386
205887,31,116,14,102,116,14,102,,,
205957,31,663,281,382,639,272,367,24,9,15
205966,31,217,69,148,114,38,76,103,31,72
206011,31,353,204,149,191,107,84,162,97,65
206039,31,22,0,22,15,0,15,7,0,7
206048,31,647,358,289,496,292,204,151,66,85
206084,31,2126,1018,1108,2068,983,1085,58,35,23
206154,31,3,3,0,,,,3,3,0
206172,31,35,15,20,35,15,20,,,
206181,31,5,3,2,1,0,1,4,3,1
206279,31,22,8,14,5,1,4,17,7,10
206321,31,15,8,7,5,1,4,10,7,3
206349,31,107,7,100,107,7,100,,,
206394,31,6,2,4,4,1,3,2,1,1
206437,31,378,196,182,377,196,181,1,0,1
206446,31,188,70,118,122,55,67,66,15,51
206491,31,326,155,171,239,121,118,87,34,53
206507,31,317,147,170,317,147,170,,,
206525,31,405,207,198,405,207,198,,,
206589,31,578,300,278,578,300,278,,,
206604,31,1281,529,752,1235,513,722,46,16,30
206613,31,271,104,167,244,90,154,27,14,13
206622,31,1191,550,641,1189,548,641,2,2,0
206695,31,1602,734,868,1559,713,846,43,21,22
206817,31,125,67,58,117,61,56,8,6,2
206835,31,199,118,81,198,118,80,1,0,1
206862,31,264,133,131,263,133,130,1,0,1
206905,31,26,19,7,18,11,7,8,8,0
206914,31,475,184,291,438,170,268,37,14,23
206923,31,100,42,58,71,32,39,29,10,19
206932,31,105,6,99,35,3,32,70,3,67
206941,31,1613,598,1015,1483,546,937,130,52,78
206996,31,465,156,309,275,116,159,190,40,150
207041,31,501,243,258,486,240,246,15,3,12
207050,31,269,112,157,231,104,127,38,8,30
207069,31,215,86,129,128,66,62,87,20,67
207087,31,19,0,19,19,0,19,,,
207102,31,12,1,11,12,1,11,,,
207157,31,44,30,14,40,29,11,4,1,3
207209,31,550,228,322,544,227,317,6,1,5
207236,31,261,77,184,154,60,94,107,17,90
207254,31,119,107,12,119,107,12,,,
207263,31,707,321,386,686,312,374,21,9,12
207281,31,632,266,366,542,238,304,90,28,62
207290,31,630,275,355,506,254,252,124,21,103
207306,31,337,145,192,333,145,188,4,0,4
207324,31,357,185,172,351,183,168,6,2,4
207351,31,245,136,109,211,126,85,34,10,24
207388,31,4641,2194,2447,4342,2067,2275,299,127,172
207397,31,729,293,436,333,138,195,396,155,241
207403,31,368,144,224,366,143,223,2,1,1
207449,31,1780,634,1146,797,291,506,983,343,640
207458,31,300,127,173,300,127,173,,,
207500,31,4683,2051,2632,4118,1839,2279,565,212,353
207564,31,647,486,161,592,452,140,55,34,21
207582,31,719,299,420,617,254,363,102,45,57
207661,31,455,205,250,410,185,225,45,20,25
207670,31,1190,457,733,753,298,455,437,159,278
207704,31,38,0,38,26,0,26,12,0,12
207722,31,217,68,149,214,68,146,3,0,3
207740,31,355,135,220,279,111,168,76,24,52
207786,31,21,1,20,21,1,20,,,
207847,31,408,192,216,355,170,185,53,22,31
207856,31,116,62,54,110,59,51,6,3,3
207865,31,743,298,445,718,289,429,25,9,16
207935,31,3261,1317,1944,1818,743,1075,1443,574,869
207962,31,312,256,56,312,256,56,,,
207971,31,651,284,367,585,254,331,66,30,36
208035,31,297,126,171,233,104,129,64,22,42
208044,31,11,3,8,11,3,8,,,
208053,31,46,27,19,25,13,12,21,14,7
208275,31,249,115,134,184,87,97,65,28,37
208318,31,768,397,371,481,246,235,287,151,136
208390,31,1954,956,998,1240,576,664,714,380,334
208406,31,1252,637,615,618,288,330,634,349,285
208415,31,108,47,61,66,32,34,42,15,27
208433,31,31,3,28,31,3,28,,,
208479,31,135,5,130,135,5,130,,,
208512,31,25,8,17,25,8,17,,,
208637,31,41,11,30,,,,41,11,30
208646,31,252,110,142,245,108,137,7,2,5
208725,31,12,7,5,12,7,5,,,
208822,31,626,281,345,626,281,345,,,
208859,31,35,6,29,35,6,29,,,
209038,31,1505,746,759,918,454,464,587,292,295
209056,31,626,212,414,623,210,413,3,2,1
209065,31,379,146,233,379,146,233,,,
209074,31,929,487,442,561,299,262,368,188,180
209083,31,27,6,21,27,6,21,,,
209153,31,24,4,20,24,4,20,,,
209205,31,3,1,2,3,1,2,,,
209241,31,1,1,0,1,1,0,,,
209250,31,1085,514,571,675,334,341,410,180,230
209287,31,90,52,38,90,52,38,,,
209409,31,91,49,42,91,49,42,,,
209506,31,463,249,214,420,223,197,43,26,17
209542,31,4513,2235,2278,4065,2029,2036,448,206,242
209551,31,5313,2303,3010,5230,2263,2967,83,40,43
209603,31,90,18,72,89,18,71,1,0,1
209612,31,393,180,213,392,180,212,1,0,1
209667,31,47,5,42,47,5,42,,,
209676,31,87,9,78,87,9,78,,,
209694,31,30,7,23,30,7,23,,,
209700,31,39,11,28,39,11,28,,,
209719,31,28,0,28,28,0,28,,,
209746,31,4277,1944,2333,2085,965,1120,2192,979,1213
209807,31,1634,686,948,1519,634,885,115,52,63
209825,31,813,278,535,812,278,534,1,0,1
209922,31,394,158,236,394,158,236,,,
209940,31,839,378,461,440,187,253,399,191,208
210146,31,559,198,361,527,182,345,32,16,16
210155,31,459,197,262,374,176,198,85,21,64
210234,31,282,135,147,196,101,95,86,34,52
210270,31,703,289,414,366,171,195,337,118,219
210304,31,47,21,26,47,21,26,,,
210331,31,152,64,88,146,62,84,6,2,4
210401,31,524,209,315,523,209,314,1,0,1
210429,31,563,215,348,538,204,334,25,11,14
210492,31,78,36,42,76,34,42,2,2,0
210571,31,401,167,234,401,167,234,,,
210599,31,199,102,97,199,102,97,,,
210605,31,2480,1294,1186,1268,638,630,1212,656,556
210669,31,289,148,141,289,148,141,,,
210711,31,18,0,18,18,0,18,,,
210739,31,509,183,326,505,183,322,4,0,4
210748,31,12,0,12,10,0,10,2,0,2
210775,31,497,224,273,497,224,273,,,
210784,31,41,0,41,37,0,37,4,0,4
211006,31,31,27,4,30,27,3,1,0,1
211024,31,77,48,29,66,41,25,11,7,4
211079,31,382,156,226,231,113,118,151,43,108
211088,31,489,180,309,483,177,306,6,3,3
211273,31,396,0,396,396,0,396,,,
211291,31,1034,503,531,1034,503,531,,,
211307,31,1310,652,658,740,377,363,570,275,295
211316,31,24,1,23,18,1,17,6,0,6
211334,31,21,0,21,21,0,21,,,
211343,31,534,216,318,409,169,240,125,47,78
211352,31,282,97,185,282,97,185,,,
211431,31,199,43,156,193,42,151,6,1,5
211440,31,1716,839,877,1716,839,877,,,
211468,31,133,0,133,133,0,133,,,
211477,31,144,62,82,63,34,29,81,28,53
211556,31,306,102,204,305,101,204,1,1,0
211583,31,144,81,63,141,81,60,3,0,3
211608,31,196,66,130,192,65,127,4,1,3
211635,31,5,1,4,5,1,4,,,
211802,31,13,1,12,13,1,12,,,
211893,31,33,20,13,33,20,13,,,
211927,31,2261,1005,1256,622,320,302,1639,685,954
211981,31,438,191,247,438,191,247,,,
212009,31,577,241,336,577,241,336,,,
212045,31,75,19,56,75,19,56,,,
212054,31,2938,1503,1435,2914,1493,1421,24,10,14
212106,31,1441,516,925,1439,515,924,2,1,1
212115,31,1153,514,639,1144,509,635,9,5,4
212133,31,464,252,212,432,236,196,32,16,16
212197,31,463,191,272,462,190,272,1,1,0
212230,31,20,0,20,18,0,18,2,0,2
212267,31,48,0,48,28,0,28,20,0,20
212276,31,55,4,51,40,3,37,15,1,14
212294,31,32,1,31,29,1,28,3,0,3
212300,31,58,1,57,52,1,51,6,0,6
212328,31,50,5,45,30,5,25,20,0,20
212337,31,34,1,33,17,0,17,17,1,16
212355,31,75,4,71,46,1,45,29,3,26
212382,31,57,0,57,44,0,44,13,0,13
212391,31,16,3,13,11,2,9,5,1,4
212434,31,38,25,13,38,25,13,,,
212577,31,487,256,231,487,256,231,,,
212601,31,641,275,366,639,273,366,2,2,0
212656,31,276,163,113,274,163,111,2,0,2
212674,31,644,308,336,644,308,336,,,
212753,31,48,3,45,29,1,28,19,2,17
212805,31,609,328,281,609,328,281,,,
212832,31,143,51,92,143,51,92,,,
212869,31,181,55,126,162,48,114,19,7,12
212878,31,1513,588,925,823,342,481,690,246,444
212911,31,362,149,213,362,149,213,,,
212975,31,39,34,5,39,34,5,,,
212984,31,339,122,217,338,121,217,1,1,0
212993,31,21,7,14,19,6,13,2,1,1
213011,31,207,66,141,200,66,134,7,0,7
213020,31,1761,670,1091,1725,640,1085,36,30,6
213163,31,11,2,9,11,2,9,,,
213181,31,81,5,76,80,5,75,1,0,1
213233,31,188,160,28,183,156,27,5,4,1
213251,31,296,150,146,296,150,146,,,
213303,31,199,124,75,186,121,65,13,3,10
213321,31,369,193,176,363,191,172,6,2,4
213330,31,22,0,22,22,0,22,,,
213349,31,1599,724,875,1595,723,872,4,1,3
213358,31,128,50,78,125,48,77,3,2,1
213367,31,557,200,357,555,198,357,2,2,0
213376,31,441,229,212,367,198,169,74,31,43
213385,31,757,363,394,757,363,394,,,
213400,31,186,99,87,167,91,76,19,8,11
213455,31,48,1,47,32,1,31,16,0,16
213473,31,11,3,8,9,2,7,2,1,1
213491,31,41,1,40,9,1,8,32,0,32
213507,31,428,198,230,426,197,229,2,1,1
213525,31,1317,575,742,760,367,393,557,208,349
213534,31,124,67,57,124,67,57,,,
213543,31,1511,804,707,1511,804,707,,,
213570,31,114,14,100,114,14,100,,,
213589,31,106,91,15,106,91,15,,,
213598,31,401,130,271,397,128,269,4,2,2
213622,31,8,1,7,8,1,7,,,
213659,31,848,348,500,499,215,284,349,133,216
213668,31,296,147,149,296,147,149,,,
213774,31,126,38,88,120,35,85,6,3,3
213826,31,445,155,290,443,155,288,2,0,2
213914,31,50,6,44,50,6,44,,,
213987,31,543,215,328,539,213,326,4,2,2
213996,31,587,248,339,587,248,339,,,
214023,31,2,0,2,2,0,2,,,
214041,31,1199,515,684,1152,498,654,47,17,30
214069,31,371,150,221,367,149,218,4,1,3
214111,31,1430,660,770,867,431,436,563,229,334
214148,31,113,0,113,113,0,113,,,
214157,31,426,193,233,425,193,232,1,0,1
214166,31,295,90,205,295,90,205,,,
214175,31,420,168,252,420,168,252,,,
214272,31,392,127,265,392,127,265,,,
214290,31,417,387,30,417,387,30,,,
214379,31,1686,716,970,943,450,493,743,266,477
214476,31,5,2,3,5,2,3,,,
214528,31,45,40,5,36,34,2,9,6,3
214582,31,260,33,227,69,13,56,191,20,171
214591,31,829,515,314,829,515,314,,,
214625,31,134,80,54,134,80,54,,,
214634,31,51,13,38,49,13,36,2,0,2
214643,31,127,83,44,127,83,44,,,
214652,31,229,145,84,226,145,81,3,0,3
214670,31,267,173,94,263,171,92,4,2,2
214689,31,905,489,416,897,487,410,8,2,6
214698,31,168,98,70,168,98,70,,,
214704,31,632,386,246,621,380,241,11,6,5
214713,31,1197,758,439,1189,753,436,8,5,3
214731,31,399,266,133,385,256,129,14,10,4
214740,31,98,69,29,97,68,29,1,1,0
214759,31,102,54,48,102,54,48,,,
214768,31,149,85,64,149,85,64,,,
214777,31,9216,4703,4513,9181,4682,4499,35,21,14
214786,31,115,82,33,113,81,32,2,1,1
214795,31,190,79,111,189,79,110,1,0,1
214801,31,885,538,347,869,529,340,16,9,7
214810,31,177,59,118,175,57,118,2,2,0
214829,31,192,138,54,189,136,53,3,2,1
214883,31,12,3,9,2,1,1,10,2,8
214892,31,50,31,19,50,31,19,,,
214944,31,215,192,23,215,192,23,,,
214971,31,19,9,10,19,9,10,,,
215008,31,15,14,1,15,14,1,,,
215044,31,48,6,42,48,6,42,,,
215053,31,66,15,51,63,13,50,3,2,1
215062,31,2415,1071,1344,2415,1071,1344,,,
215105,31,182,67,115,182,67,115,,,
215114,31,202,96,106,200,94,106,2,2,0
215239,31,2521,984,1537,1324,515,809,1197,469,728
215266,31,297,144,153,296,144,152,1,0,1
215275,31,409,179,230,409,179,230,,,
215284,31,518,298,220,517,298,219,1,0,1
215293,31,4390,1587,2803,4386,1587,2799,4,0,4
215309,31,7,1,6,7,1,6,,,
215336,31,14,1,13,14,1,13,,,
215381,31,190,178,12,190,178,12,,,
215390,31,30,7,23,20,2,18,10,5,5
215415,31,326,234,92,323,231,92,3,3,0
215442,31,559,192,367,555,191,364,4,1,3
215530,31,23,0,23,22,0,22,1,0,1
215585,31,729,278,451,314,149,165,415,129,286
215594,31,12,1,11,9,0,9,3,1,2
215637,31,73,33,40,73,33,40,,,
215655,31,589,310,279,586,310,276,3,0,3
215682,31,121,116,5,121,116,5,,,
215691,31,80,37,43,76,35,41,4,2,2
215743,31,327,128,199,327,128,199,,,
215770,31,1096,527,569,1095,526,569,1,1,0
215798,31,342,215,127,342,215,127,,,
215886,31,6,6,0,4,4,0,2,2,0
215929,31,1057,477,580,1043,465,578,14,12,2
215947,31,386,146,240,384,146,238,2,0,2
215974,31,14,3,11,11,3,8,3,0,3
215992,31,57,24,33,57,24,33,,,
216010,31,1079,535,544,1077,533,544,2,2,0
216038,31,1460,604,856,1459,603,856,1,1,0
216047,31,3,3,0,3,3,0,,,
216074,31,37,1,36,23,1,22,14,0,14
216083,31,72,33,39,69,33,36,3,0,3
216223,31,16,1,15,16,1,15,,,
216278,31,578,243,335,578,243,335,,,
216287,31,433,204,229,433,204,229,,,
216296,31,556,506,50,555,505,50,1,1,0
216311,31,32,32,0,32,32,0,,,
216339,31,4664,1982,2682,4614,1955,2659,50,27,23
216357,31,229,109,120,228,109,119,1,0,1
216366,31,757,200,557,756,200,556,1,0,1
216436,31,23,20,3,23,20,3,,,
216445,31,27,26,1,27,26,1,,,
216454,31,24,22,2,24,22,2,,,
216524,31,381,191,190,381,191,190,,,
216542,31,133,67,66,131,67,64,2,0,2
216551,31,29,25,4,29,25,4,,,
216579,31,36,2,34,36,2,34,,,
216597,31,1778,868,910,1762,857,905,16,11,5
216667,31,348,187,161,348,187,161,,,
216694,31,299,148,151,299,148,151,,,
216746,31,16,16,0,11,11,0,5,5,0
216764,31,3006,1207,1799,2984,1198,1786,22,9,13
216773,31,11,3,8,11,3,8,,,
216807,31,289,143,146,287,141,146,2,2,0
216825,31,640,244,396,424,163,261,216,81,135
216852,31,536,234,302,533,233,300,3,1,2
216931,31,478,245,233,464,239,225,14,6,8
216940,31,116,116,0,116,116,0,,,
217013,31,136,34,102,136,34,102,,,
217040,31,9,9,0,9,9,0,,,
217059,31,749,328,421,745,327,418,4,1,3
217077,31,237,85,152,237,85,152,,,
217156,31,1717,829,888,1717,829,888,,,
217165,31,964,638,326,964,638,326,,,
217235,31,994,350,644,985,344,641,9,6,3
217305,31,439,315,124,439,315,124,,,
217323,31,249,240,9,249,240,9,,,
217402,31,1156,537,619,1154,535,619,2,2,0
217420,31,674,218,456,653,212,441,21,6,15
217475,31,3170,1535,1635,2329,1150,1179,841,385,456
217484,31,3420,1347,2073,3404,1341,2063,16,6,10
217493,31,481,156,325,481,156,325,,,
217518,31,1074,528,546,1057,516,541,17,12,5
217536,31,592,172,420,592,172,420,,,
217581,31,49,1,48,36,1,35,13,0,13
217606,31,34,17,17,27,14,13,7,3,4
217615,31,556,236,320,277,112,165,279,124,155
217624,31,174,103,71,169,99,70,5,4,1
217633,31,798,281,517,796,280,516,2,1,1
217688,31,727,260,467,723,259,464,4,1,3
217712,31,436,169,267,153,71,82,283,98,185
217721,31,384,187,197,384,187,197,,,
217749,31,583,256,327,576,253,323,7,3,4
217776,31,148,62,86,144,62,82,4,0,4
217794,31,28,1,27,19,1,18,9,0,9
217819,31,2210,580,1630,2204,577,1627,6,3,3
217828,31,12,0,12,10,0,10,2,0,2
217837,31,317,123,194,79,33,46,238,90,148
217864,31,678,579,99,676,577,99,2,2,0
217873,31,384,100,284,384,100,284,,,
217882,31,4588,1912,2676,4575,1907,2668,13,5,8
217891,31,55,27,28,55,27,28,,,
217907,31,188,118,70,188,118,70,,,
217925,31,179,87,92,162,82,80,17,5,12
217934,31,190,54,136,170,47,123,20,7,13
217961,31,225,54,171,225,54,171,,,
217989,31,181,98,83,160,85,75,21,13,8
217998,31,304,206,98,268,178,90,36,28,8
218025,31,655,311,344,428,223,205,227,88,139
218061,31,612,218,394,611,217,394,1,1,0
218070,31,647,274,373,647,274,373,,,
218113,31,1988,932,1056,1450,693,757,538,239,299
218140,31,1290,559,731,829,395,434,461,164,297
218159,31,7,2,5,5,1,4,2,1,1
218195,31,9,2,7,6,2,4,3,0,3
218229,31,842,275,567,838,274,564,4,1,3
218238,31,334,192,142,324,190,134,10,2,8
218353,31,2099,999,1100,1433,706,727,666,293,373
218399,31,118,53,65,118,53,65,,,
218414,31,415,238,177,415,238,177,,,
218441,31,495,259,236,487,257,230,8,2,6
218487,31,234,85,149,177,62,115,57,23,34
218520,31,1022,426,596,576,258,318,446,168,278
218539,31,269,147,122,269,147,122,,,
218645,31,552,220,332,548,218,330,4,2,2
218654,31,476,160,316,469,157,312,7,3,4
218663,31,6574,2591,3983,6567,2586,3981,7,5,2
218672,31,341,154,187,334,149,185,7,5,2
218681,31,135,68,67,128,65,63,7,3,4
218690,31,207,107,100,196,104,92,11,3,8
218706,31,110,62,48,106,60,46,4,2,2
218724,31,2662,1213,1449,2653,1207,1446,9,6,3
218733,31,902,433,469,817,380,437,85,53,32
218742,31,688,233,455,685,232,453,3,1,2
218821,31,504,225,279,451,202,249,53,23,30
218830,31,1165,558,607,770,366,404,395,192,203
218858,31,696,293,403,368,178,190,328,115,213
218885,31,2059,1079,980,1877,994,883,182,85,97
218894,31,1954,905,1049,1123,513,610,831,392,439
218919,31,137,68,69,120,53,67,17,15,2
218955,31,109,32,77,42,14,28,67,18,49
218964,31,709,234,475,707,233,474,2,1,1
218973,31,507,236,271,507,236,271,,,
218991,31,1005,513,492,666,348,318,339,165,174
219000,31,553,215,338,553,215,338,,,
219037,31,34,1,33,31,0,31,3,1,2
219046,31,481,157,324,444,147,297,37,10,27
219082,31,372,274,98,363,269,94,9,5,4
219091,31,179,105,74,164,101,63,15,4,11
219125,31,20,0,20,20,0,20,,,
219143,31,630,369,261,604,364,240,26,5,21
219189,31,419,312,107,406,307,99,13,5,8
219198,31,156,78,78,152,74,78,4,4,0
219204,31,128,68,60,6,4,2,122,64,58
219240,31,1,0,1,,,,1,0,1
219259,31,299,129,170,280,125,155,19,4,15
219277,31,89,41,48,56,31,25,33,10,23
219295,31,80,60,20,79,60,19,1,0,1
219347,31,538,412,126,523,403,120,15,9,6
219356,31,2191,1002,1189,2123,981,1142,68,21,47
219374,31,162,38,124,65,16,49,97,22,75
219383,31,308,106,202,302,104,198,6,2,4
219408,31,26,18,8,16,13,3,10,5,5
219426,31,692,360,332,522,312,210,170,48,122
219453,31,28,0,28,28,0,28,,,
219471,31,1326,441,885,1262,416,846,64,25,39
219480,31,187,98,89,153,86,67,34,12,22
219505,31,5,3,2,5,3,2,,,
219587,31,17,0,17,17,0,17,,,
219596,31,46,31,15,46,31,15,,,
219602,31,1465,595,870,1322,511,811,143,84,59
219639,31,38,6,32,36,5,31,2,1,1
219709,31,1917,610,1307,1910,607,1303,7,3,4
219718,31,456,183,273,382,165,217,74,18,56
219790,31,218,111,107,218,111,107,,,
219806,31,301,139,162,299,139,160,2,0,2
219824,31,1308,499,809,1177,451,726,131,48,83
219833,31,175,89,86,175,89,86,,,
219851,31,37,0,37,37,0,37,,,
219879,31,736,307,429,686,285,401,50,22,28
219888,31,1233,494,739,1119,446,673,114,48,66
219903,31,371,33,338,371,33,338,,,
219921,31,59,31,28,51,24,27,8,7,1
219949,31,630,299,331,623,298,325,7,1,6
219976,31,699,261,438,696,258,438,3,3,0
219994,31,156,102,54,153,100,53,3,2,1
220002,31,4,0,4,4,0,4,,,
220057,31,513,173,340,457,159,298,56,14,42
220075,31,2056,797,1259,2007,777,1230,49,20,29
220118,31,72,7,65,72,7,65,,,
220127,31,112,61,51,108,57,51,4,4,0
220163,31,45,2,43,32,2,30,13,0,13
220181,31,304,98,206,299,96,203,5,2,3
220206,31,53,28,25,49,27,22,4,1,3
220215,31,331,159,172,331,159,172,,,
220251,31,46,32,14,42,29,13,4,3,1
220279,31,60,50,10,53,43,10,7,7,0
220321,31,66,35,31,63,33,30,3,2,1
220394,31,82,54,28,81,53,28,1,1,0
220400,31,734,293,441,596,230,366,138,63,75
220464,31,14,4,10,14,4,10,,,
220473,31,163,81,82,155,76,79,8,5,3
220491,31,42,0,42,39,0,39,3,0,3
220516,31,152,68,84,147,67,80,5,1,4
220552,31,694,93,601,510,66,444,184,27,157
220598,31,314,187,127,293,177,116,21,10,11
220604,31,121,53,68,114,47,67,7,6,1
220613,31,517,209,308,516,209,307,1,0,1
220631,31,327,134,193,312,132,180,15,2,13
220640,31,67,45,22,62,41,21,5,4,1
220701,31,209,64,145,207,64,143,2,0,2
220710,31,279,136,143,278,135,143,1,1,0
220756,31,42,39,3,42,39,3,,,
220765,31,81,14,67,37,5,32,44,9,35
220853,31,230,158,72,205,141,64,25,17,8
220862,31,2414,1007,1407,2322,964,1358,92,43,49
220978,31,2805,1334,1471,2764,1311,1453,41,23,18
221050,31,178,123,55,163,112,51,15,11,4
221096,31,1576,623,953,1444,573,871,132,50,82
221102,31,85,67,18,49,42,7,36,25,11
221148,31,258,233,25,258,233,25,,,
221184,31,1415,625,790,1158,522,636,257,103,154
221236,31,61,49,12,54,44,10,7,5,2
221281,31,35,19,16,35,19,16,,,
221333,31,81,65,16,60,46,14,21,19,2
221351,31,478,196,282,478,196,282,,,
221388,31,24,8,16,21,5,16,3,3,0
221397,31,967,371,596,896,343,553,71,28,43
221430,31,102,83,19,80,64,16,22,19,3
221485,31,1240,505,735,981,397,584,259,108,151
221494,31,103,89,14,89,75,14,14,14,0
221519,31,416,194,222,416,194,222,,,
221582,31,52,40,12,44,34,10,8,6,2
221591,31,65,54,11,51,43,8,14,11,3
221607,31,53,37,16,41,27,14,12,10,2
221616,31,147,93,54,141,90,51,6,3,3
221625,31,175,125,50,168,120,48,7,5,2
221643,31,2064,1018,1046,1909,949,960,155,69,86
221661,31,628,299,329,619,295,324,9,4,5
221731,31,197,84,113,197,84,113,,,
221740,31,2246,912,1334,2229,907,1322,17,5,12
221759,31,6846,2860,3986,6828,2853,3975,18,7,11
221768,31,1107,419,688,1101,417,684,6,2,4
221829,31,123,3,120,123,3,120,,,
221838,31,3568,1178,2390,3548,1172,2376,20,6,14
221847,31,2050,1175,875,2046,1174,872,4,1,3
221892,31,378,161,217,365,154,211,13,7,6
221908,31,1073,482,591,1024,465,559,49,17,32
221953,31,141,88,53,129,84,45,12,4,8
221971,31,334,139,195,327,135,192,7,4,3
221999,31,1619,739,880,1617,739,878,2,0,2
222053,31,1602,681,921,1459,629,830,143,52,91
222062,31,1297,492,805,1228,465,763,69,27,42
222105,31,134,126,8,61,60,1,73,66,7
222178,31,894,330,564,894,330,564,,,
222567,31,563,271,292,229,109,120,334,162,172
222576,31,1443,646,797,1082,509,573,361,137,224
222822,31,760,302,458,549,222,327,211,80,131
222831,31,1236,508,728,1215,499,716,21,9,12
222877,31,101,68,33,101,68,33,,,
222886,31,270,18,252,270,18,252,,,
222938,31,47,20,27,23,8,15,24,12,12
222983,31,330,179,151,330,179,151,,,
222992,31,4533,2166,2367,2142,1022,1120,2391,1144,1247
223056,31,31,0,31,31,0,31,,,
223117,31,14,9,5,,,,14,9,5
223232,31,3296,1370,1926,3286,1365,1921,10,5,5
223320,31,517,166,351,212,73,139,305,93,212
223427,31,5027,2627,2400,3533,1842,1691,1494,785,709
223463,31,111,28,83,111,28,83,,,
223472,31,21,1,20,21,1,20,,,
223506,31,742,349,393,399,178,221,343,171,172
223816,31,1185,600,585,366,151,215,819,449,370
223852,31,14,0,14,14,0,14,,,
223898,31,883,372,511,289,124,165,594,248,346
223922,31,475,228,247,160,104,56,315,124,191
224004,31,185,90,95,183,88,95,2,2,0
224013,31,7,0,7,7,0,7,,,
224110,31,1234,566,668,675,286,389,559,280,279
224147,31,1984,809,1175,1901,768,1133,83,41,42
224156,31,45,1,44,35,0,35,10,1,9
224226,31,821,328,493,748,299,449,73,29,44
224244,31,79,47,32,75,46,29,4,1,3
224271,31,174,46,128,174,46,128,,,
224323,31,404,175,229,403,175,228,1,0,1
224350,31,838,362,476,286,147,139,552,215,337
224527,31,391,200,191,389,198,191,2,2,0
224545,31,302,149,153,296,148,148,6,1,5
224554,31,866,332,534,823,321,502,43,11,32
224615,31,5604,2635,2969,2041,1025,1016,3563,1610,1953
224642,31,4258,2010,2248,2460,1170,1290,1798,840,958
224660,31,94,52,42,88,49,39,6,3,3
224679,31,407,340,67,201,149,52,206,191,15
224758,31,13,1,12,12,0,12,1,1,0
224776,31,45,25,20,28,14,14,17,11,6
224828,31,16,1,15,14,1,13,2,0,2
224891,31,324,134,190,207,86,121,117,48,69
224961,31,290,115,175,208,86,122,82,29,53
225043,31,8,7,1,8,7,1,,,
225070,31,540,239,301,351,146,205,189,93,96
225201,31,146,123,23,146,123,23,,,
225247,31,350,179,171,349,179,170,1,0,1
225308,31,592,244,348,420,161,259,172,83,89
225371,31,306,141,165,242,121,121,64,20,44
225399,31,732,287,445,684,270,414,48,17,31
225414,31,353,146,207,291,124,167,62,22,40
225423,31,7883,3621,4262,4176,2024,2152,3707,1597,2110
225432,31,1373,626,747,1210,570,640,163,56,107
225502,31,211,95,116,183,84,99,28,11,17
225511,31,5555,2385,3170,5102,2195,2907,453,190,263
225520,31,452,170,282,345,135,210,107,35,72
225548,31,216,129,87,208,127,81,8,2,6
225575,31,190,101,89,188,100,88,2,1,1
225627,31,977,334,643,956,329,627,21,5,16
225876,31,120,68,52,113,67,46,7,1,6
225885,31,168,93,75,167,92,75,1,1,0
225991,31,20,9,11,20,9,11,,,
226019,31,918,436,482,723,341,382,195,95,100
226091,31,1482,610,872,1369,570,799,113,40,73
226107,31,345,134,211,244,98,146,101,36,65
226116,31,337,111,226,216,72,144,121,39,82
226125,31,60,3,57,60,3,57,,,
226134,31,1391,635,756,929,392,537,462,243,219
226152,31,1307,536,771,1277,521,756,30,15,15
226204,31,1578,871,707,359,211,148,1219,660,559
226231,31,314,197,117,299,191,108,15,6,9
226277,31,338,312,26,338,312,26,,,
226383,31,279,114,165,276,112,164,3,2,1
226408,31,881,408,473,413,193,220,468,215,253
226471,31,744,271,473,744,271,473,,,
226578,31,1056,383,673,683,258,425,373,125,248
226587,31,276,155,121,274,155,119,2,0,2
226806,31,755,303,452,494,197,297,261,106,155
226833,31,785,313,472,773,309,464,12,4,8
226860,31,16,0,16,16,0,16,,,
226879,31,63,11,52,14,5,9,49,6,43
226903,31,231,131,100,231,131,100,,,
227058,31,15,0,15,15,0,15,,,
227146,31,1085,478,607,826,371,455,259,107,152
227182,31,10339,4624,5715,5414,2570,2844,4925,2054,2871
227216,31,6624,2896,3728,6203,2695,3508,421,201,220
227225,31,542,222,320,391,156,235,151,66,85
227298,31,108,105,3,108,105,3,,,
227304,31,1152,414,738,678,258,420,474,156,318
227313,31,153,3,150,81,2,79,72,1,71
227322,31,253,4,249,126,3,123,127,1,126
227331,31,296,133,163,288,130,158,8,3,5
227368,31,5770,2392,3378,4596,1854,2742,1174,538,636
227377,31,988,495,493,504,266,238,484,229,255
227386,31,308,123,185,265,111,154,43,12,31
227401,31,682,294,388,535,250,285,147,44,103
227429,31,111,52,59,99,46,53,12,6,6
227526,31,1559,493,1066,1526,481,1045,33,12,21
227687,31,931,465,466,287,164,123,644,301,343
227748,31,39,36,3,39,36,3,,,
227757,31,1201,604,597,1201,604,597,,,
227845,31,640,238,402,640,238,402,,,
227854,31,1724,831,893,453,245,208,1271,586,685
227863,31,515,251,264,502,244,258,13,7,6
227881,31,3394,1246,2148,3221,1176,2045,173,70,103
227924,31,3565,1454,2111,1547,619,928,2018,835,1183
227979,31,6194,2844,3350,3824,1747,2077,2370,1097,1273
228042,31,373,170,203,372,170,202,1,0,1
228088,31,19,0,19,19,0,19,,,
228149,31,529,195,334,529,195,334,,,
228158,31,1351,660,691,1101,560,541,250,100,150
228185,31,16,13,3,16,13,3,,,
228200,31,141,63,78,131,56,75,10,7,3
228219,31,121,50,71,119,50,69,2,0,2
228246,31,1639,740,899,1636,740,896,3,0,3
228282,31,16,3,13,16,3,13,,,
228316,31,667,297,370,421,162,259,246,135,111
228325,31,300,162,138,298,160,138,2,2,0
228343,31,436,207,229,436,207,229,,,
228431,31,1867,688,1179,1844,678,1166,23,10,13
228459,31,7604,2814,4790,7307,2668,4639,297,146,151
228468,31,125,56,69,123,55,68,2,1,1
228486,31,39,23,16,37,22,15,2,1,1
228501,31,249,169,80,240,163,77,9,6,3
228529,31,2448,896,1552,2247,826,1421,201,70,131
228547,31,6504,2932,3572,2099,978,1121,4405,1954,2451
228608,31,718,308,410,373,168,205,345,140,205
228699,31,393,182,211,235,116,119,158,66,92
228705,31,1099,562,537,1066,542,524,33,20,13
228723,31,12490,6718,5772,11382,6115,5267,1108,603,505
228769,31,4858,2231,2627,4310,1967,2343,548,264,284
228778,31,9109,3619,5490,8979,3568,5411,130,51,79
228787,31,4218,2292,1926,3933,2113,1820,285,179,106
228796,31,3782,1768,2014,2971,1396,1575,811,372,439
228802,31,1118,418,700,975,368,607,143,50,93
228875,31,2491,855,1636,2484,854,1630,7,1,6
228884,31,135,88,47,134,87,47,1,1,0
228981,31,344,195,149,344,195,149,,,
229018,31,673,293,380,634,278,356,39,15,24
229027,31,5692,2511,3181,4617,2011,2606,1075,500,575
229063,31,2372,798,1574,2139,716,1423,233,82,151
229115,31,6813,3308,3505,6691,3241,3450,122,67,55
229160,31,464,243,221,461,243,218,3,0,3
229179,31,1343,101,1242,1321,95,1226,22,6,16
229267,31,655,298,357,655,298,357,,,
229355,31,2791,1214,1577,2058,912,1146,733,302,431
229416,31,818,774,44,818,774,44,,,
229425,31,45,2,43,18,1,17,27,1,26
229504,31,298,124,174,161,72,89,137,52,85
229522,31,62,4,58,55,3,52,7,1,6
229540,31,517,222,295,290,143,147,227,79,148
229656,31,25,0,25,8,0,8,17,0,17
229780,31,262,180,82,247,174,73,15,6,9
229799,31,622,216,406,347,129,218,275,87,188
229814,31,1281,550,731,1257,542,715,24,8,16
229832,31,176,105,71,157,94,63,19,11,8
229841,31,1391,645,746,1064,496,568,327,149,178
229887,31,244,135,109,240,133,107,4,2,2
230010,31,242,150,92,117,71,46,125,79,46
230038,31,5565,2230,3335,5360,2150,3210,205,80,125
230047,31,340,132,208,338,131,207,2,1,1
230065,31,249,3,246,88,2,86,161,1,160
230144,31,69,0,69,69,0,69,,,
230162,31,627,398,229,91,61,30,536,337,199
230171,31,2369,854,1515,2155,749,1406,214,105,109
230199,31,54,0,54,54,0,54,,,
230205,31,57,4,53,42,2,40,15,2,13
230214,31,24,4,20,9,1,8,15,3,12
230366,31,10,0,10,10,0,10,,,
230418,31,2101,905,1196,274,139,135,1827,766,1061
230490,31,415,243,172,64,21,43,351,222,129
230597,31,1739,771,968,1636,726,910,103,45,58
230603,31,2165,815,1350,2057,758,1299,108,57,51
230676,31,133,88,45,65,41,24,68,47,21
230728,31,4626,1911,2715,4169,1709,2460,457,202,255
230737,31,4754,2320,2434,3358,1625,1733,1396,695,701
230746,31,3466,1673,1793,1491,742,749,1975,931,1044
230764,31,5520,2741,2779,5294,2633,2661,226,108,118
230782,31,3023,1216,1807,2285,926,1359,738,290,448
230807,31,191,88,103,191,88,103,,,
230816,31,218,57,161,215,54,161,3,3,0
230834,31,422,213,209,421,213,208,1,0,1
230852,31,580,371,209,560,358,202,20,13,7
230861,31,616,194,422,158,56,102,458,138,320
230889,31,10,4,6,10,4,6,,,
230913,31,262,109,153,251,106,145,11,3,8
230959,31,639,291,348,639,291,348,,,
230995,31,558,390,168,549,382,167,9,8,1
231004,31,21,1,20,21,1,20,,,
231059,31,258,126,132,258,126,132,,,
231095,31,9,7,2,9,7,2,,,
231165,31,127,86,41,125,85,40,2,1,1
231174,31,3000,991,2009,2988,987,2001,12,4,8
231280,31,24,2,22,23,2,21,1,0,1
231411,31,191,163,28,191,163,28,,,
231420,31,252,165,87,249,164,85,3,1,2
231536,31,802,365,437,449,219,230,353,146,207
231554,31,149,101,48,147,99,48,2,2,0
231581,31,422,229,193,422,229,193,,,
231624,31,1642,725,917,1642,725,917,,,
231651,31,521,211,310,351,141,210,170,70,100
231688,31,4,2,2,2,1,1,2,1,1
231697,31,615,266,349,263,126,137,352,140,212
231712,31,1161,575,586,1161,575,586,,,
231785,31,140,77,63,131,76,55,9,1,8
231873,31,145,66,79,120,56,64,25,10,15
231882,31,374,175,199,257,128,129,117,47,70
232016,31,17,10,7,17,10,7,,,
232025,31,347,170,177,347,170,177,,,
232043,31,203,84,119,203,84,119,,,
232052,31,135,64,71,66,29,37,69,35,34
232089,31,238,155,83,230,149,81,8,6,2
232186,31,4144,2148,1996,4008,2064,1944,136,84,52
232195,31,1391,586,805,733,323,410,658,263,395
232256,31,279,279,0,279,279,0,,,
232265,31,867,288,579,841,282,559,26,6,20
232308,31,210,0,210,210,0,210,,,
232414,31,1191,527,664,570,275,295,621,252,369
232423,31,4863,2131,2732,4859,2130,2729,4,1,3
232450,31,1442,665,777,742,353,389,700,312,388
232557,31,6114,2772,3342,4688,2092,2596,1426,680,746
232566,31,794,235,559,783,231,552,11,4,7
232575,31,951,362,589,517,231,286,434,131,303
232609,31,410,150,260,410,150,260,,,
232618,31,3,0,3,2,0,2,1,0,1
232672,31,260,87,173,259,87,172,1,0,1
232681,31,749,280,469,732,278,454,17,2,15
232706,31,355,134,221,350,131,219,5,3,2
232788,31,324,144,180,247,113,134,77,31,46
232797,31,91,11,80,18,0,18,73,11,62
232867,31,584,326,258,447,252,195,137,74,63
232919,31,157,135,22,157,135,22,,,
232937,31,1300,469,831,1195,440,755,105,29,76
232946,31,8738,4568,4170,4817,2620,2197,3921,1948,1973
232982,31,3084,1464,1620,3023,1437,1586,61,27,34
233019,31,465,242,223,377,187,190,88,55,33
233037,31,154,64,90,106,51,55,48,13,35
233116,31,709,300,409,326,153,173,383,147,236
233277,31,1226,474,752,1222,473,749,4,1,3
233286,31,16,1,15,16,1,15,,,
233295,31,415,186,229,414,186,228,1,0,1
233301,31,147,62,85,147,62,85,,,
233310,31,358,152,206,164,69,95,194,83,111
233329,31,28,3,25,28,3,25,,,
233338,31,395,179,216,357,168,189,38,11,27
233374,31,851,384,467,850,383,467,1,1,0
233408,31,11,2,9,11,2,9,,,
233426,31,502,213,289,502,213,289,,,
233541,31,475,230,245,475,230,245,,,
233602,31,17,11,6,17,11,6,,,
233611,31,327,171,156,325,170,155,2,1,1
233639,31,423,158,265,193,51,142,230,107,123
233648,31,450,203,247,369,172,197,81,31,50
233666,31,20,1,19,16,1,15,4,0,4
233684,31,50,15,35,2,2,0,48,13,35
233718,31,154,0,154,154,0,154,,,
233754,31,961,414,547,512,242,270,449,172,277
233772,31,3049,1405,1644,1489,686,803,1560,719,841
233897,31,251,118,133,250,117,133,1,1,0
233903,31,356,161,195,244,120,124,112,41,71
233921,31,7166,3970,3196,7158,3965,3193,8,5,3
233949,31,1084,517,567,676,327,349,408,190,218
234030,31,4167,1455,2712,4120,1436,2684,47,19,28
234076,31,4022,1735,2287,4021,1734,2287,1,1,0
234085,31,347,297,50,347,297,50,,,
234119,31,4,1,3,1,0,1,3,1,2
234137,31,93,73,20,69,56,13,24,17,7
234155,31,1384,570,814,1376,566,810,8,4,4
234164,31,363,178,185,296,151,145,67,27,40
234173,31,282,132,150,280,131,149,2,1,1
234207,31,476,228,248,476,228,248,,,
234377,31,350,128,222,249,93,156,101,35,66
234669,31,1508,711,797,979,479,500,529,232,297
234696,31,346,192,154,250,162,88,96,30,66
234711,31,403,181,222,330,159,171,73,22,51
234827,31,1410,692,718,1355,667,688,55,25,30
234845,31,472,206,266,389,170,219,83,36,47
234915,31,26,10,16,2,1,1,24,9,15
234924,31,54,5,49,54,5,49,,,
234933,31,1618,704,914,1029,461,568,589,243,346
234951,31,354,153,201,282,131,151,72,22,50
234979,31,1355,549,806,1031,437,594,324,112,212
235024,31,124,48,76,124,48,76,,,
235088,31,115,111,4,115,111,4,,,
235097,31,1368,574,794,1338,558,780,30,16,14
235103,31,720,344,376,475,236,239,245,108,137
235149,31,1250,612,638,817,418,399,433,194,239
235167,31,271,99,172,261,97,164,10,2,8
235237,31,1377,542,835,1064,427,637,313,115,198
235307,31,15,0,15,15,0,15,,,
235316,31,1217,553,664,1216,553,663,1,0,1
235334,31,307,141,166,241,111,130,66,30,36
235343,31,1042,476,566,665,311,354,377,165,212
235352,31,17,3,14,17,3,14,,,
235422,31,152,42,110,128,35,93,24,7,17
235431,31,841,354,487,525,234,291,316,120,196
235501,31,113,43,70,113,43,70,,,
235583,31,12,0,12,12,0,12,,,
235671,31,294,201,93,236,185,51,58,16,42
235699,31,368,179,189,271,148,123,97,31,66
235750,31,515,181,334,353,133,220,162,48,114
236072,31,688,341,347,434,233,201,254,108,146
236133,31,152,58,94,151,57,94,1,1,0
236188,31,986,510,476,581,270,311,405,240,165
236212,31,232,187,45,232,187,45,,,
236230,31,526,218,308,526,218,308,,,
236258,31,224,98,126,161,67,94,63,31,32
236328,31,405,164,241,405,164,241,,,
236382,31,343,203,140,224,135,89,119,68,51
236452,31,294,119,175,292,118,174,2,1,1
236504,31,482,295,187,367,227,140,115,68,47
236513,31,876,446,430,662,347,315,214,99,115
236577,31,538,173,365,532,170,362,6,3,3
236595,31,1004,390,614,987,383,604,17,7,10
236610,31,605,319,286,367,209,158,238,110,128
236638,31,749,346,403,598,291,307,151,55,96
236656,31,825,364,461,584,268,316,241,96,145
236692,31,1189,541,648,934,451,483,255,90,165
236708,31,1080,491,589,844,384,460,236,107,129
236744,31,18,0,18,18,0,18,,,
236753,31,1360,561,799,948,420,528,412,141,271
236887,31,471,233,238,387,203,184,84,30,54
236896,31,296,171,125,296,171,125,,,
236939,31,3991,1887,2104,3897,1845,2052,94,42,52
236948,31,7386,3030,4356,7311,3000,4311,75,30,45
236975,31,578,265,313,463,220,243,115,45,70
237011,31,3223,1343,1880,3144,1311,1833,79,32,47
237039,31,523,250,273,314,160,154,209,90,119
237057,31,336,141,195,336,141,195,,,
237066,31,455,192,263,453,190,263,2,2,0
237109,31,701,231,470,545,185,360,156,46,110
237118,31,192,140,52,192,140,52,,,
237127,31,19,0,19,19,0,19,,,
237136,31,39,19,20,31,12,19,8,7,1
237145,31,10,0,10,10,0,10,,,
237172,31,35,28,7,29,27,2,6,1,5
237181,31,176,98,78,176,98,78,,,
237215,31,264,133,131,256,130,126,8,3,5
237242,31,23,22,1,18,17,1,5,5,0
237303,31,31,15,16,31,15,16,,,
237312,31,266,103,163,236,103,133,30,0,30
237321,31,10,1,9,10,1,9,,,
237330,31,370,173,197,365,172,193,5,1,4
237358,31,180,78,102,179,78,101,1,0,1
237367,31,701,331,370,681,321,360,20,10,10
237385,31,322,156,166,281,118,163,41,38,3
237437,31,21,4,17,20,4,16,1,0,1
237473,31,45,36,9,45,36,9,,,
237491,31,10,2,8,10,2,8,,,
237525,31,1549,669,880,1522,650,872,27,19,8
237543,31,48,12,36,32,7,25,16,5,11
237561,31,22,11,11,22,11,11,,,
237570,31,21,0,21,21,0,21,,,
237598,31,2,1,1,2,1,1,,,
237686,31,294,136,158,228,111,117,66,25,41
237701,31,389,174,215,384,172,212,5,2,3
237729,31,35,7,28,25,3,22,10,4,6
237783,31,187,94,93,143,69,74,44,25,19
237792,31,553,230,323,544,228,316,9,2,7
237817,31,335,103,232,299,94,205,36,9,27
237844,31,85,42,43,85,42,43,,,
237899,31,331,145,186,321,141,180,10,4,6
237932,31,430,165,265,424,163,261,6,2,4
237950,31,298,176,122,297,175,122,1,1,0
237969,31,275,133,142,275,133,142,,,
237987,31,25,6,19,25,6,19,,,
237996,31,51,8,43,51,8,43,,,
238005,31,38,3,35,38,3,35,,,
238014,31,258,110,148,217,98,119,41,12,29
238032,31,4571,2222,2349,4561,2216,2345,10,6,4
238078,31,145,100,45,145,100,45,,,
238175,31,60,0,60,60,0,60,,,
238193,31,133,0,133,133,0,133,,,
238263,31,1594,853,741,742,455,287,852,398,454
238324,31,46,3,43,45,3,42,1,0,1
238333,31,232,120,112,232,120,112,,,
238397,31,688,288,400,235,113,122,453,175,278
238430,31,102,47,55,102,47,55,,,
238458,31,674,255,419,668,254,414,6,1,5
238476,31,732,335,397,730,333,397,2,2,0
238616,31,421,183,238,413,179,234,8,4,4
238661,31,241,78,163,239,77,162,2,1,1
238722,31,600,338,262,283,182,101,317,156,161
238759,31,1164,544,620,344,196,148,820,348,472
238810,31,9,1,8,6,0,6,3,1,2
238980,31,229,116,113,227,115,112,2,1,1
239008,31,366,220,146,135,74,61,231,146,85
239017,31,364,172,192,364,172,192,,,
239071,31,157,58,99,141,50,91,16,8,8
239080,31,225,73,152,213,72,141,12,1,11
239105,31,1983,914,1069,1977,911,1066,6,3,3
239220,31,553,308,245,203,120,83,350,188,162
239248,31,2067,980,1087,928,515,413,1139,465,674
239309,31,221,33,188,221,33,188,,,
239318,31,672,498,174,672,498,174,,,
239372,31,468,242,226,279,149,130,189,93,96
239390,31,155,0,155,155,0,155,,,
239442,31,185,66,119,60,23,37,125,43,82
239460,31,640,241,399,241,101,140,399,140,259
239488,31,1395,718,677,739,464,275,656,254,402
239512,31,122,49,73,122,49,73,,,
239628,31,196,100,96,196,100,96,,,
239716,31,476,209,267,476,209,267,,,
239877,31,18,0,18,16,0,16,2,0,2
239910,31,417,201,216,257,147,110,160,54,106
240107,31,235,72,163,235,72,163,,,
240116,31,995,486,509,671,363,308,324,123,201
240125,31,716,535,181,319,217,102,397,318,79
240170,31,974,536,438,616,371,245,358,165,193
240189,31,2089,1142,947,2042,1116,926,47,26,21
240198,31,470,237,233,275,148,127,195,89,106
240268,31,2134,843,1291,2117,837,1280,17,6,11
240277,31,1137,452,685,1090,430,660,47,22,25
240329,31,2326,978,1348,2320,974,1346,6,4,2
240338,31,309,168,141,309,168,141,,,
240365,31,1738,738,1000,1681,714,967,57,24,33
240374,31,442,197,245,428,191,237,14,6,8
240392,31,283,62,221,79,22,57,204,40,164
240417,31,1252,729,523,1224,716,508,28,13,15
240426,31,319,133,186,311,130,181,8,3,5
240444,31,8628,3918,4710,8605,3904,4701,23,14,9
240453,31,3349,1532,1817,3261,1494,1767,88,38,50
240462,31,1437,897,540,1416,886,530,21,11,10
240471,31,1014,346,668,997,336,661,17,10,7
240480,31,1722,732,990,1683,714,969,39,18,21
240505,31,595,258,337,493,215,278,102,43,59
240514,31,263,118,145,206,90,116,57,28,29
240596,31,196,72,124,177,67,110,19,5,14
240620,31,644,280,364,499,224,275,145,56,89
240657,31,301,149,152,265,131,134,36,18,18
240666,31,534,258,276,443,212,231,91,46,45
240693,31,345,166,179,281,141,140,64,25,39
240709,31,37,5,32,29,5,24,8,0,8
240718,31,388,360,28,388,360,28,,,
240727,31,1627,758,869,1588,740,848,39,18,21
240736,31,309,91,218,200,60,140,109,31,78
240745,31,752,325,427,425,180,245,327,145,182
240754,31,461,210,251,438,201,237,23,9,14
240790,31,369,152,217,309,127,182,60,25,35
240879,31,129,24,105,129,24,105,,,
241100,31,28,13,15,28,13,15,,,
241128,31,22,16,6,21,16,5,1,0,1
241146,31,73,13,60,73,13,60,,,
241182,31,81,13,68,81,13,68,,,
241191,31,96,38,58,91,35,56,5,3,2
241216,31,328,194,134,322,190,132,6,4,2
241225,31,77,30,47,70,26,44,7,4,3
241304,31,496,149,347,341,102,239,155,47,108
241331,31,153,33,120,149,32,117,4,1,3
241377,31,172,53,119,171,53,118,1,0,1
241386,31,15,3,12,15,3,12,,,
241395,31,37,19,18,37,19,18,,,
241410,31,778,277,501,775,275,500,3,2,1
241517,31,32,10,22,32,10,22,,,
241614,31,36,17,19,19,12,7,17,5,12
241720,31,64,29,35,61,27,34,3,2,1
241739,31,678,233,445,609,202,407,69,31,38
241766,31,47,35,12,8,5,3,39,30,9
241836,31,110,35,75,80,29,51,30,6,24
241906,31,88,29,59,88,29,59,,,
241951,31,78,14,64,75,13,62,3,1,2
242042,31,175,104,71,154,86,68,21,18,3
242112,31,92,38,54,92,38,54,,,
242121,31,28,16,12,27,15,12,1,1,0
242130,31,68,27,41,62,24,38,6,3,3
242149,31,103,34,69,89,28,61,14,6,8
242556,31,129,82,47,129,82,47,,,
242583,31,53,34,19,47,32,15,6,2,4
242617,31,645,311,334,629,302,327,16,9,7
242626,31,629,244,385,602,232,370,27,12,15
242635,31,384,144,240,377,141,236,7,3,4
242644,31,255,105,150,249,103,146,6,2,4
242653,31,461,195,266,436,183,253,25,12,13
242662,31,505,187,318,487,179,308,18,8,10
242680,31,262,92,170,248,86,162,14,6,8
242699,31,277,90,187,270,88,182,7,2,5
242705,31,851,460,391,837,453,384,14,7,7
242820,31,501,388,113,501,388,113,,,
242945,31,168,59,109,126,42,84,42,17,25
242954,31,63,21,42,52,16,36,11,5,6
242972,31,6358,2495,3863,5399,2082,3317,959,413,546
243106,31,503,252,251,503,252,251,,,
243115,31,681,290,391,681,290,391,,,
243133,31,685,340,345,684,340,344,1,0,1
243142,31,701,269,432,701,269,432,,,
243151,31,483,162,321,482,161,321,1,1,0
243179,31,603,212,391,599,211,388,4,1,3
243188,31,80,45,35,80,45,35,,,
243197,31,1667,933,734,1666,933,733,1,0,1
243212,31,599,301,298,599,301,298,,,
243221,31,1749,674,1075,1743,670,1073,6,4,2
243346,31,923,385,538,806,332,474,117,53,64
243443,31,850,307,543,813,295,518,37,12,25
243568,31,5,2,3,5,2,3,,,
243577,31,547,389,158,530,373,157,17,16,1
243586,31,111,43,68,111,43,68,,,
243601,31,1506,589,917,1392,541,851,114,48,66
243638,31,507,214,293,417,177,240,90,37,53
243647,31,124,61,63,95,46,49,29,15,14
243665,31,251,76,175,224,68,156,27,8,19
243744,31,1733,792,941,1733,792,941,,,
243780,31,9447,5229,4218,9364,5210,4154,83,19,64
243799,31,3,0,3,3,0,3,,,
243823,31,80,23,57,63,17,46,17,6,11
243832,31,81,28,53,46,11,35,35,17,18
243841,31,73,28,45,59,24,35,14,4,10
244279,31,18,1,17,18,1,17,,,
244437,31,3213,1408,1805,2498,1094,1404,715,314,401
244446,31,332,156,176,112,59,53,220,97,123
244613,31,191,183,8,108,104,4,83,79,4
245281,31,4,3,1,4,3,1,,,
245625,31,240,111,129,161,75,86,79,36,43
245652,31,88,43,45,88,43,45,,,
245777,31,9,9,0,9,9,0,,,
245953,31,231,89,142,132,65,67,99,24,75
245962,31,44,2,42,42,2,40,2,0,2
245980,31,22,5,17,22,5,17,,,
245999,31,363,182,181,192,85,107,171,97,74
246017,31,1012,688,324,438,377,61,574,311,263
246035,31,57,11,46,57,11,46,,,
246071,31,10,1,9,10,1,9,,,
246354,31,2142,853,1289,817,312,505,1325,541,784
246406,31,6,2,4,6,2,4,,,
246415,31,15,0,15,3,0,3,12,0,12
246460,31,32,1,31,32,1,31,,,
246813,31,482,214,268,153,88,65,329,126,203
246895,31,132,56,76,86,26,60,46,30,16
246974,31,76,6,70,76,6,70,,,
247010,31,17,0,17,17,0,17,,,
247047,31,64,2,62,64,2,62,,,
247065,31,42,1,41,40,1,39,2,0,2
247153,31,52,10,42,52,10,42,,,
247409,31,40,0,40,40,0,40,,,
247603,31,668,390,278,550,330,220,118,60,58
247649,31,111,63,48,85,45,40,26,18,8
247773,31,21,21,0,21,21,0,,,
247834,31,5652,2880,2772,3484,1865,1619,2168,1015,1153
247940,31,712,335,377,483,229,254,229,106,123
248192,31,21,0,21,21,0,21,,,
248527,31,15,0,15,15,0,15,,,
248606,31,395,256,139,145,58,87,250,198,52
248624,31,16,4,12,16,4,12,,,
248633,31,11,0,11,11,0,11,,,
248660,31,13,3,10,12,3,9,1,0,1
248703,31,131,0,131,56,0,56,75,0,75
248925,31,176,134,42,142,102,40,34,32,2
248934,31,930,361,569,930,361,569,,,
249061,31,7,0,7,5,0,5,2,0,2
249238,31,19,0,19,18,0,18,1,0,1
249609,31,37,23,14,37,23,14,,,
250027,31,116,38,78,112,38,74,4,0,4
250285,31,46,42,4,46,42,4,,,
250744,31,90,13,77,90,13,77,,,
250902,31,91,7,84,50,4,46,41,3,38
250993,31,38,26,12,13,6,7,25,20,5
251260,31,1227,596,631,1043,514,529,184,82,102
251312,31,19,1,18,15,1,14,4,0,4
260363,31,5,0,5,5,0,5,,,
260372,31,26,10,16,9,3,6,17,7,10
260664,31,235,179,56,235,179,56,,,
260691,31,64,15,49,64,15,49,,,
260789,31,71,20,51,71,20,51,,,
260813,31,10,2,8,10,2,8,,,
260929,31,27,5,22,27,5,22,,,
260965,31,24,0,24,24,0,24,,,
260992,31,151,16,135,84,14,70,67,2,65
261436,31,355,24,331,355,24,331,,,
261676,31,10,0,10,10,0,10,,,
261685,31,9,0,9,9,0,9,,,
261719,31,94,1,93,94,1,93,,,
261773,31,11,6,5,10,6,4,1,0,1
262031,31,1457,678,779,1195,563,632,262,115,147
262086,31,216,81,135,69,29,40,147,52,95
262129,31,188,51,137,188,51,137,,,
262341,31,498,435,63,498,435,63,,,
262369,31,81,0,81,81,0,81,,,
262457,31,68,10,58,68,10,58,,,
262466,31,2,2,0,2,2,0,,,
362700,31,24,0,24,24,0,24,,,
362782,31,44,1,43,24,0,24,20,1,19
363013,31,13,3,10,13,3,10,,,
363147,31,69,1,68,69,1,68,,,
363165,31,1194,631,563,279,146,133,915,485,430
363633,31,107,59,48,87,49,38,20,10,10
363679,31,92,2,90,83,2,81,9,0,9
363712,31,34,34,0,34,34,0,,,
363882,31,19,0,19,19,0,19,,,
363907,31,62,42,20,61,42,19,1,0,1
363916,31,29,13,16,28,13,15,1,0,1
363934,31,143,113,30,103,81,22,40,32,8
364016,31,966,505,461,570,317,253,396,188,208
364025,31,1687,896,791,936,488,448,751,408,343
364548,31,144,79,65,91,43,48,53,36,17
364575,31,8,0,8,8,0,8,,,
364627,31,54,18,36,44,13,31,10,5,5
364636,31,72,22,50,57,22,35,15,0,15
364760,31,28,3,25,13,1,12,15,2,13
364946,31,23,11,12,18,8,10,5,3,2
364964,31,8,1,7,8,1,7,,,
365091,31,1,0,1,1,0,1,,,
365125,31,32,1,31,32,1,31,,,
365198,31,42,9,33,8,0,8,34,9,25
365213,31,204,103,101,25,9,16,179,94,85
365240,31,3,2,1,3,2,1,,,
365374,31,192,119,73,118,70,48,74,49,25
365383,31,23,0,23,23,0,23,,,
365480,31,110,56,54,33,8,25,77,48,29
365505,31,17,3,14,17,3,14,,,
365693,31,16,0,16,16,0,16,,,
365763,31,23,3,20,23,3,20,,,
365824,31,56,2,54,56,2,54,,,
365833,31,61,5,56,61,5,56,,,
366003,31,18,8,10,8,2,6,10,6,4
366155,31,2,2,0,2,2,0,,,
366191,31,533,511,22,533,511,22,,,
366252,31,1112,808,304,1092,795,297,20,13,7
366261,31,53,15,38,53,15,38,,,
366270,31,17,0,17,17,0,17,,,
366289,31,6,6,0,6,6,0,,,
366340,31,35,13,22,30,12,18,5,1,4
366395,31,3436,1739,1697,3028,1540,1488,408,199,209
366401,31,1401,719,682,770,413,357,631,306,325
366438,31,17,2,15,11,2,9,6,0,6
366465,31,209,85,124,116,58,58,93,27,66
366535,31,100,14,86,100,14,86,,,
366553,31,226,109,117,226,109,117,,,
366623,31,24,8,16,20,7,13,4,1,3
366632,31,4,0,4,4,0,4,,,
366711,31,2551,1106,1445,2410,1032,1378,141,74,67
367051,31,40,1,39,21,1,20,19,0,19
367088,31,29,1,28,23,1,22,6,0,6
367103,31,49,41,8,49,41,8,,,
367112,31,44,8,36,43,7,36,1,1,0
367158,31,26,0,26,26,0,26,,,
367334,31,148,132,16,115,103,12,33,29,4
367361,31,26,19,7,26,19,7,,,
367431,31,25,0,25,25,0,25,,,
367459,31,1385,599,786,712,303,409,673,296,377
367875,31,669,201,468,669,201,468,,,
367884,31,31,10,21,20,6,14,11,4,7
367981,31,8,0,8,7,0,7,1,0,1
368230,31,47,2,45,37,1,36,10,1,9
368364,31,166,87,79,95,68,27,71,19,52
368407,31,6,1,5,1,1,0,5,0,5
368443,31,218,69,149,218,69,149,,,
368452,31,68,21,47,68,21,47,,,
368629,31,50,10,40,50,10,40,,,
368771,31,10,3,7,10,3,7,,,
368832,31,15,5,10,8,3,5,7,2,5
368911,31,160,67,93,55,23,32,105,44,61
369400,31,368,357,11,368,357,11,,,
369419,31,521,268,253,521,268,253,,,
369446,31,31,0,31,18,0,18,13,0,13
369455,31,12,0,12,12,0,12,,,
369516,31,26,5,21,26,5,21,,,
369668,31,110,40,70,86,38,48,24,2,22
369686,31,29,3,26,29,3,26,,,
369783,31,72,2,70,72,2,70,,,
369950,31,24,19,5,24,19,5,,,
371052,31,57,14,43,57,14,43,,,
371690,31,190,59,131,5,0,5,185,59,126
371830,31,17,12,5,17,12,5,,,
371928,31,17,8,9,17,8,9,,,
371964,31,43,36,7,43,36,7,,,
372028,31,20,1,19,20,1,19,,,
372073,31,46,7,39,46,7,39,,,
372082,31,54,18,36,54,18,36,,,
372240,31,1,0,1,1,0,1,,,
372329,31,192,19,173,192,19,173,,,
372356,31,121,4,117,121,4,117,,,
372462,31,12,5,7,11,4,7,1,1,0
372921,31,68,31,37,68,31,37,,,
373085,31,9,0,9,9,0,9,,,
373216,31,56,7,49,56,7,49,,,
373456,31,17,0,17,12,0,12,5,0,5
373526,31,158,123,35,158,123,35,,,
373678,31,63,28,35,46,21,25,17,7,10
373696,31,36,16,20,26,11,15,10,5,5
373711,31,17,1,16,17,1,16,,,
373784,31,158,83,75,158,83,75,,,
374316,31,4,4,0,2,2,0,2,2,0
374343,31,29,0,29,29,0,29,,,
374574,31,165,34,131,165,34,131,,,
374592,31,45,15,30,45,15,30,,,
375106,31,120,101,19,107,88,19,13,13,0
375230,31,32,32,0,32,32,0,,,
375373,31,20,10,10,1,0,1,19,10,9
375407,31,34,8,26,29,6,23,5,2,3
375416,31,56,23,33,56,23,33,,,
375540,31,34,0,34,12,0,12,22,0,22
375568,31,39,10,29,2,2,0,37,8,29
375656,31,21,7,14,15,2,13,6,5,1
375683,31,161,115,46,88,57,31,73,58,15
375726,31,204,137,67,104,64,40,100,73,27
375939,31,8,0,8,8,0,8,,,
375966,31,13,0,13,9,0,9,4,0,4
375984,31,98,4,94,75,3,72,23,1,22
376224,31,51,19,32,51,19,32,,,
376242,31,29,25,4,29,25,4,,,
376288,31,65,13,52,65,13,52,,,
376330,31,25,14,11,25,14,11,,,
376385,31,113,57,56,113,57,56,,,
376446,31,5,0,5,2,0,2,3,0,3
376631,31,7,2,5,6,2,4,1,0,1
376677,31,2,1,1,2,1,1,,,
376695,31,414,205,209,263,136,127,151,69,82
377111,31,75,37,38,75,37,38,,,
377193,31,6,1,5,6,1,5,,,
377218,31,18,18,0,18,18,0,,,
377272,31,13,2,11,13,2,11,,,
377281,31,63,5,58,63,5,58,,,
377315,31,24,0,24,24,0,24,,,
377449,31,31,15,16,31,15,16,,,
377458,31,36,15,21,36,15,21,,,
377485,31,13,3,10,9,3,6,4,0,4
377546,31,46,16,30,46,16,30,,,
377555,31,980,546,434,947,531,416,33,15,18
377564,31,625,314,311,596,303,293,29,11,18
377643,31,9,0,9,9,0,9,,,
377652,31,18,0,18,18,0,18,,,
377661,31,46,8,38,46,8,38,,,
377722,31,62,3,59,62,3,59,,,
377759,31,80,78,2,80,78,2,,,
378105,31,44,0,44,30,0,30,14,0,14
378576,31,93,22,71,19,4,15,74,18,56
378886,31,104,24,80,25,9,16,79,15,64
378956,31,143,134,9,143,134,9,,,
379621,31,7,0,7,7,0,7,,,
379746,31,143,4,139,143,4,139,,,
379782,31,6,1,5,6,1,5,,,
380067,31,141,1,140,141,1,140,,,
380359,31,80,17,63,36,14,22,44,3,41
380368,31,103,44,59,83,38,45,20,6,14
380377,31,86,30,56,59,26,33,27,4,23
380438,31,23,3,20,23,3,20,,,
381255,31,17,14,3,17,14,3,,,
381282,31,16,9,7,16,9,7,,,
381325,31,13,3,10,13,3,10,,,
381370,31,190,10,180,100,7,93,90,3,87
381404,31,184,9,175,77,3,74,107,6,101
381486,31,7,0,7,7,0,7,,,
381699,31,27,0,27,19,0,19,8,0,8
381732,31,19,7,12,1,1,0,18,6,12
382258,31,60,3,57,24,1,23,36,2,34
382416,31,13,7,6,13,7,6,,,
382461,31,5,0,5,3,0,3,2,0,2
382780,31,58,3,55,51,3,48,7,0,7
382911,31,13,6,7,12,6,6,1,0,1
382957,31,70,30,40,70,30,40,,,
383084,31,293,113,180,220,75,145,73,38,35
383163,31,74,0,74,15,0,15,59,0,59
383190,31,378,195,183,226,117,109,152,78,74
383279,31,12,2,10,7,1,6,5,1,4
383297,31,21,0,21,3,0,3,18,0,18
383312,31,58,26,32,58,26,32,,,
383330,31,5,4,1,5,4,1,,,
383367,31,90,29,61,72,26,46,18,3,15
383464,31,58,4,54,58,4,54,,,
383525,31,43,9,34,43,9,34,,,
383765,31,104,6,98,74,5,69,30,1,29
383996,31,69,26,43,40,17,23,29,9,20
384236,31,169,72,97,169,72,97,,,
384245,31,127,55,72,127,55,72,,,
384254,31,102,66,36,102,66,36,,,
384333,31,1586,667,919,903,362,541,683,305,378
384342,31,704,339,365,478,238,240,226,101,125
384412,31,83,47,36,83,47,36,,,
384421,31,32,32,0,32,32,0,,,
385132,31,28,2,26,20,2,18,8,0,8
385503,31,38,4,34,38,4,34,,,
385619,31,280,132,148,280,132,148,,,
386153,31,311,0,311,269,0,269,42,0,42
386472,31,114,27,87,72,16,56,42,11,31
387925,31,33,5,28,33,5,28,,,
388520,31,59,48,11,23,19,4,36,29,7
389860,31,154,93,61,88,41,47,66,52,14
390905,31,151,86,65,37,27,10,114,59,55
391005,31,10,0,10,10,0,10,,,
391759,31,9,0,9,,,,9,0,9
392257,31,743,32,711,743,32,711,,,
392415,31,69,21,48,69,21,48,,,
393649,31,229,104,125,229,104,125,,,
393861,31,144,28,116,138,27,111,6,1,5
395362,31,152,72,80,58,24,34,94,48,46
395690,31,195,136,59,195,136,59,,,
397942,31,215,78,137,215,78,137,,,
399212,31,2026,1266,760,842,429,413,1184,837,347
399869,31,152,147,5,152,147,5,,,
399911,31,129,48,81,129,48,81,,,
400080,31,807,590,217,807,590,217,,,
400187,31,119,17,102,102,16,86,17,1,16
401223,31,20,11,9,5,3,2,15,8,7
401764,31,20,0,20,11,0,11,9,0,9
402563,31,24,0,24,24,0,24,,,
402800,31,20,0,20,20,0,20,,,
403469,31,119,69,50,98,62,36,21,7,14
403478,31,257,132,125,224,116,108,33,16,17
403487,31,213,100,113,187,95,92,26,5,21
404055,31,36,3,33,36,3,33,,,
404338,31,4,1,3,4,1,3,,,
404426,31,485,252,233,313,166,147,172,86,86
404684,31,116,34,82,116,34,82,,,
404718,31,179,3,176,179,3,176,,,
404912,31,133,22,111,133,22,111,,,
405012,31,53,1,52,53,1,52,,,
405058,31,39,39,0,39,39,0,,,
405076,31,143,22,121,143,22,121,,,
405854,31,17,17,0,17,17,0,,,
405872,31,553,273,280,370,197,173,183,76,107
406024,31,199,26,173,133,16,117,66,10,56
406033,31,587,75,512,558,69,489,29,6,23
406149,31,33,9,24,33,9,24,,,
406325,31,48,3,45,10,2,8,38,1,37
406361,31,3,0,3,3,0,3,,,
406422,31,24,0,24,24,0,24,,,
406486,31,12,6,6,9,5,4,3,1,2
406547,31,9,0,9,9,0,9,,,
407090,31,36,0,36,6,0,6,30,0,30
407142,31,16,0,16,16,0,16,,,
407151,31,19,0,19,19,0,19,,,
407179,31,54,2,52,35,2,33,19,0,19
407355,31,29,5,24,29,5,24,,,
407434,31,37,0,37,37,0,37,,,
407461,31,45,38,7,45,38,7,,,
407470,31,54,2,52,51,2,49,3,0,3
407489,31,18,14,4,3,0,3,15,14,1
407513,31,75,39,36,5,0,5,70,39,31
407522,31,32,11,21,,,,32,11,21
407568,31,29,0,29,28,0,28,1,0,1
407577,31,39,23,16,26,14,12,13,9,4
407595,31,42,2,40,42,2,40,,,
407610,31,9,8,1,,,,9,8,1
407683,31,49,1,48,22,1,21,27,0,27
407708,31,90,5,85,90,5,85,,,
407735,31,28,1,27,28,1,27,,,
407832,31,81,55,26,41,29,12,40,26,14
408066,31,9,1,8,6,1,5,3,0,3
408163,31,6,0,6,6,0,6,,,
408385,31,148,77,71,148,77,71,,,
408729,31,8,0,8,8,0,8,,,
408844,31,390,138,252,321,127,194,69,11,58
408862,31,75,2,73,27,1,26,48,1,47
409032,31,50,1,49,50,1,49,,,
409120,31,23,14,9,23,14,9,,,
409193,31,59,58,1,59,58,1,,,
409315,31,3948,1876,2072,2116,1054,1062,1832,822,1010
409537,31,5,1,4,,,,5,1,4
409591,31,50,13,37,21,5,16,29,8,21
409698,31,904,362,542,891,352,539,13,10,3
410797,31,28,15,13,28,15,13,,,
410964,31,8,0,8,7,0,7,1,0,1
411684,31,9,4,5,9,4,5,,,
412173,31,5,0,5,5,0,5,,,
412535,31,10,1,9,10,1,9,,,
412544,31,15,3,12,13,3,10,2,0,2
412599,31,151,54,97,151,54,97,,,
413176,31,20,14,6,20,14,6,,,
413413,31,70,19,51,22,5,17,48,14,34
413617,31,36,20,16,10,8,2,26,12,14
413626,31,93,34,59,54,20,34,39,14,25
413680,31,78,75,3,78,75,3,,,
413893,31,206,81,125,206,81,125,,,
413972,31,14,1,13,14,1,13,,,
414063,31,29,0,29,27,0,27,2,0,2
414124,31,103,76,27,96,73,23,7,3,4
414461,31,883,842,41,880,839,41,3,3,0
414489,31,91,1,90,91,1,90,,,
414540,31,181,2,179,160,2,158,21,0,21
414595,31,55,14,41,13,6,7,42,8,34
414869,31,20,0,20,9,0,9,11,0,11
414878,31,6,3,3,2,1,1,4,2,2
414911,31,249,123,126,206,108,98,43,15,28
414939,31,83,16,67,83,16,67,,,
415039,31,26,2,24,22,2,20,4,0,4
415057,31,17,17,0,17,17,0,,,
415987,31,47,2,45,47,2,45,,,
416458,31,26,8,18,26,8,18,,,
417008,31,9,0,9,9,0,9,,,
417062,31,16,0,16,15,0,15,1,0,1
417105,31,197,111,86,158,85,73,39,26,13
417123,31,28,16,12,20,12,8,8,4,4
417248,31,17,16,1,17,16,1,,,
417275,31,10,9,1,10,9,1,,,
417327,31,17,9,8,17,9,8,,,
417442,31,10,0,10,10,0,10,,,
417503,31,23,0,23,13,0,13,10,0,10
417600,31,10,0,10,10,0,10,,,
417628,31,13,2,11,13,2,11,,,
417637,31,7,5,2,7,5,2,,,
417646,31,9,0,9,9,0,9,,,
417655,31,7,0,7,7,0,7,,,
417682,31,6,1,5,6,1,5,,,
417716,31,10,1,9,10,1,9,,,
417725,31,7,0,7,7,0,7,,,
417734,31,5,1,4,2,1,1,3,0,3
417752,31,4,2,2,4,2,2,,,
417831,31,2,1,1,2,1,1,,,
417840,31,26,5,21,26,5,21,,,
417868,31,29,8,21,18,4,14,11,4,7
417910,31,43,4,39,43,4,39,,,
417983,31,12,0,12,,,,12,0,12
417992,31,1,0,1,1,0,1,,,
418001,31,2,0,2,2,0,2,,,
418010,31,19,1,18,8,0,8,11,1,10
418029,31,14,2,12,14,2,12,,,
418038,31,30,4,26,30,4,26,,,
418065,31,69,7,62,55,4,51,14,3,11
418083,31,8,4,4,8,4,4,,,
418126,31,4,2,2,2,1,1,2,1,1
418171,31,5,5,0,5,5,0,,,
418199,31,28,18,10,4,4,0,24,14,10
418205,31,9,8,1,9,8,1,,,
418223,31,73,4,69,73,4,69,,,
418250,31,163,105,58,30,14,16,133,91,42
418269,31,29,21,8,29,21,8,,,
418278,31,58,22,36,45,16,29,13,6,7
418296,31,847,520,327,294,112,182,553,408,145
418302,31,64,28,36,34,8,26,30,20,10
418320,31,111,57,54,33,11,22,78,46,32
418348,31,71,53,18,38,30,8,33,23,10
418357,31,139,74,65,13,7,6,126,67,59
418409,31,117,66,51,82,43,39,35,23,12
418427,31,16,3,13,16,3,13,,,
418445,31,8,0,8,8,0,8,,,
418454,31,3,2,1,3,2,1,,,
418481,31,15,0,15,15,0,15,,,
418515,31,72,5,67,63,5,58,9,0,9
418524,31,21,1,20,21,1,20,,,
418533,31,42,7,35,39,4,35,3,3,0
418542,31,34,3,31,14,2,12,20,1,19
418560,31,24,6,18,10,0,10,14,6,8
418588,31,18,1,17,18,1,17,,,
418658,31,147,130,17,147,130,17,,,
418773,31,157,77,80,134,74,60,23,3,20
418782,31,177,172,5,177,172,5,,,
418889,31,7,7,0,3,3,0,4,4,0
418913,31,11,3,8,11,3,8,,,
418968,31,21,0,21,21,0,21,,,
419031,31,31,2,29,31,2,29,,,
419095,31,12,0,12,12,0,12,,,
419183,31,57,7,50,57,7,50,,,
419217,31,2,1,1,2,1,1,,,
419226,31,198,102,96,157,99,58,41,3,38
419235,31,43,6,37,43,6,37,,,
419244,31,74,62,12,38,34,4,36,28,8
419253,31,8,7,1,8,7,1,,,
419280,31,6,0,6,6,0,6,,,
419341,31,7,3,4,7,3,4,,,
419420,31,21,11,10,21,11,10,,,
419484,31,5,1,4,5,1,4,,,
419633,31,30,4,26,30,4,26,,,
419703,31,250,236,14,250,236,14,,,
419712,31,69,67,2,69,67,2,,,
419721,31,147,139,8,147,139,8,,,
420024,31,27,4,23,27,4,23,,,
420130,31,12,1,11,12,1,11,,,
420255,31,26,25,1,26,25,1,,,
420325,31,21,21,0,21,21,0,,,
420343,31,361,349,12,287,279,8,74,70,4
420370,31,103,28,75,103,28,75,,,
420398,31,3192,1535,1657,1544,742,802,1648,793,855
420431,31,224,99,125,37,12,25,187,87,100
420440,31,392,168,224,284,131,153,108,37,71
420468,31,130,65,65,95,60,35,35,5,30
420538,31,230,105,125,169,83,86,61,22,39
420556,31,222,92,130,109,47,62,113,45,68
420723,31,71,32,39,36,16,20,35,16,19
420981,31,226,30,196,226,30,196,,,
421513,31,18,3,15,18,3,15,,,
421610,31,25,0,25,25,0,25,,,
421665,31,16,1,15,12,1,11,4,0,4
421708,31,23,5,18,17,5,12,6,0,6
421717,31,13,10,3,3,3,0,10,7,3
421771,31,10,0,10,8,0,8,2,0,2
421841,31,71,39,32,71,39,32,,,
421878,31,15,1,14,15,1,14,,,
421896,31,97,40,57,97,40,57,,,
422020,31,41,39,2,41,39,2,,,
422695,31,8,0,8,8,0,8,,,
422835,31,272,46,226,272,46,226,,,
423120,31,105,7,98,105,7,98,,,
423397,31,200,122,78,200,122,78,,,
423412,31,10,8,2,10,8,2,,,
423652,31,108,40,68,45,14,31,63,26,37
425250,31,19,3,16,15,3,12,4,0,4
425986,31,45,6,39,45,6,39,,,
426314,31,516,447,69,139,114,25,377,333,44
427308,31,40,1,39,40,1,39,,,
427335,31,63,0,63,58,0,58,5,0,5
427894,31,11,11,0,11,11,0,,,
427973,31,34,29,5,34,29,5,,,
427982,31,32,21,11,32,21,11,,,
427991,31,356,192,164,310,149,161,46,43,3
428000,31,1,0,1,1,0,1,,,
428019,31,35,19,16,13,9,4,22,10,12
428055,31,43,15,28,43,15,28,,,
428125,31,8,7,1,8,7,1,,,
428170,31,173,17,156,109,11,98,64,6,58
428392,31,335,156,179,205,97,108,130,59,71
429128,31,68,8,60,,,,68,8,60
430184,31,40,19,21,5,3,2,35,16,19
430227,31,41,1,40,33,1,32,8,0,8
430245,31,127,33,94,127,33,94,,,
430306,31,22,4,18,9,3,6,13,1,12
430403,31,8,0,8,8,0,8,,,
430564,31,29,9,20,12,3,9,17,6,11
430582,31,245,120,125,245,120,125,,,
430670,31,16,1,15,16,1,15,,,
430795,31,127,37,90,127,37,90,,,
430883,31,3,0,3,3,0,3,,,
430908,31,9,2,7,5,2,3,4,0,4
430935,31,112,81,31,98,68,30,14,13,1
430971,31,17,3,14,17,3,14,,,
431017,31,51,30,21,36,18,18,15,12,3
431071,31,16,4,12,10,3,7,6,1,5
431105,31,51,6,45,18,4,14,33,2,31
431123,31,84,83,1,84,83,1,,,
431141,31,185,98,87,185,98,87,,,
431187,31,118,105,13,118,105,13,,,
431196,31,11,1,10,11,1,10,,,
431266,31,67,1,66,,,,67,1,66
431275,31,5,2,3,3,2,1,2,0,2
431284,31,27,0,27,23,0,23,4,0,4
431558,31,198,71,127,191,69,122,7,2,5
431600,31,13,3,10,5,2,3,8,1,7
431716,31,353,152,201,353,152,201,,,
432117,31,15,2,13,9,1,8,6,1,5
432269,31,18,17,1,18,17,1,,,
432384,31,94,13,81,94,13,81,,,
432524,31,65,22,43,65,22,43,,,
433013,31,8,3,5,8,3,5,,,
433040,31,10,1,9,10,1,9,,,
433068,31,93,59,34,78,44,34,15,15,0
433101,31,235,32,203,186,25,161,49,7,42
433138,31,50,9,41,37,6,31,13,3,10
433174,31,7,1,6,,,,7,1,6
433387,31,1090,445,645,1090,445,645,,,
433420,31,29,27,2,29,27,2,,,
433536,31,39,4,35,24,1,23,15,3,12
433660,31,2787,1212,1575,2700,1172,1528,87,40,47
434016,31,38,17,21,21,12,9,17,5,12
434061,31,1133,578,555,852,456,396,281,122,159
434140,31,73,10,63,73,10,63,,,
434159,31,123,94,29,123,94,29,,,
434274,31,74,12,62,51,7,44,23,5,18
434283,31,12,1,11,11,1,10,1,0,1
434308,31,217,5,212,217,5,212,,,
434344,31,37,0,37,37,0,37,,,
434362,31,18,18,0,18,18,0,,,
434432,31,3,0,3,3,0,3,,,
434469,31,154,32,122,154,32,122,,,
434496,31,69,1,68,69,1,68,,,
434539,31,5,3,2,4,2,2,1,1,0
434584,31,36,18,18,15,8,7,21,10,11
434672,31,2781,1329,1452,1511,791,720,1270,538,732
434751,31,16,4,12,11,3,8,5,1,4
434821,31,165,8,157,165,8,157,,,
434830,31,69,1,68,50,1,49,19,0,19
434900,31,67,23,44,43,14,29,24,9,15
434937,31,10,10,0,10,10,0,,,
436030,31,71,24,47,47,16,31,24,8,16
436304,31,446,282,164,314,203,111,132,79,53
436429,31,1109,728,381,1109,728,381,,,
436553,31,20,10,10,20,10,10,,,
436599,31,19,3,16,1,0,1,18,3,15
436614,31,10,7,3,5,4,1,5,3,2
436632,31,109,19,90,61,14,47,48,5,43
436650,31,26,1,25,26,1,25,,,
436775,31,33,2,31,33,2,31,,,
436818,31,240,126,114,235,123,112,5,3,2
436827,31,182,110,72,179,108,71,3,2,1
436836,31,657,348,309,646,341,305,11,7,4
437097,31,3,2,1,2,1,1,1,1,0
437103,31,1754,772,982,1042,451,591,712,321,391
437237,31,21,21,0,21,21,0,,,
437556,31,244,88,156,216,85,131,28,3,25
437608,31,46,28,18,45,27,18,1,1,0
437635,31,173,12,161,173,12,161,,,
437723,31,21,9,12,21,9,12,,,
437732,31,13,1,12,13,1,12,,,
437750,31,37,37,0,37,37,0,,,
437769,31,21,2,19,21,2,19,,,
437778,31,219,6,213,219,6,213,,,
437857,31,28,1,27,23,0,23,5,1,4
437936,31,92,13,79,92,13,79,,,
438179,31,24,1,23,24,1,23,,,
438221,31,41,3,38,35,3,32,6,0,6
438258,31,79,10,69,79,10,69,,,
438285,31,116,6,110,116,6,110,,,
438337,31,188,74,114,147,55,92,41,19,22
438504,31,626,606,20,626,606,20,,,
438586,31,63,19,44,47,13,34,16,6,10
438674,31,2,0,2,1,0,1,1,0,1
438708,31,48,13,35,36,11,25,12,2,10
438735,31,13,12,1,13,12,1,,,
438984,31,45,14,31,45,14,31,,,
439118,31,61,8,53,61,8,53,,,
439190,31,273,147,126,206,112,94,67,35,32
439367,31,55,19,36,55,19,36,,,
439455,31,24,1,23,7,1,6,17,0,17
439473,31,70,21,49,40,11,29,30,10,20
439491,31,73,6,67,73,6,67,,,
439570,31,111,4,107,111,4,107,,,
439622,31,107,7,100,107,7,100,,,
439668,31,254,208,46,254,208,46,,,
439686,31,7,0,7,7,0,7,,,
439701,31,9,1,8,5,1,4,4,0,4
439738,31,54,13,41,54,13,41,,,
439747,31,71,13,58,53,10,43,18,3,15
439774,31,49,18,31,41,17,24,8,1,7
439792,31,33,4,29,33,4,29,,,
439844,31,34,0,34,34,0,34,,,
439862,31,22,10,12,21,10,11,1,0,1
439871,31,10,0,10,10,0,10,,,
439899,31,33,15,18,32,14,18,1,1,0
439932,31,45,5,40,45,5,40,,,
439969,31,54,20,34,54,20,34,,,
440059,31,153,140,13,153,140,13,,,
440101,31,45,3,42,20,0,20,25,3,22
440262,31,65,62,3,49,46,3,16,16,0
440271,31,68,33,35,68,33,35,,,
440396,31,77,36,41,75,36,39,2,0,2
440402,31,297,136,161,189,102,87,108,34,74
440651,31,123,36,87,110,34,76,13,2,11
440730,31,122,69,53,122,69,53,,,
440749,31,3,2,1,1,1,0,2,1,1
440776,31,8,2,6,8,2,6,,,
440794,31,120,20,100,112,16,96,8,4,4
440819,31,1,0,1,1,0,1,,,
440828,31,188,99,89,147,77,70,41,22,19
440855,31,133,6,127,133,6,127,,,
440989,31,71,60,11,71,60,11,,,
441025,31,63,34,29,63,34,29,,,
441052,31,138,20,118,138,20,118,,,
441070,31,27,15,12,8,6,2,19,9,10
441168,31,12,1,11,12,1,11,,,
441210,31,343,139,204,64,2,62,279,137,142
441229,31,264,73,191,264,73,191,,,
441256,31,16,0,16,16,0,16,,,
441371,31,1684,80,1604,1684,80,1604,,,
441380,31,37,11,26,29,5,24,8,6,2
441414,31,58,12,46,5,4,1,53,8,45
441423,31,191,67,124,191,67,124,,,
441487,31,21,3,18,21,3,18,,,
441496,31,31,26,5,31,26,5,,,
441502,31,110,7,103,110,7,103,,,
441575,31,72,4,68,72,4,68,,,
441609,31,10,10,0,10,10,0,,,
441618,31,12,0,12,6,0,6,6,0,6
441636,31,40,9,31,30,5,25,10,4,6
441645,31,16,0,16,11,0,11,5,0,5
441663,31,86,10,76,86,10,76,,,
441672,31,35,6,29,35,6,29,,,
441690,31,3,1,2,2,1,1,1,0,1
441706,31,116,61,55,116,61,55,,,
441742,31,265,19,246,241,17,224,24,2,22
441760,31,709,368,341,422,240,182,287,128,159
441788,31,51,45,6,51,45,6,,,
441830,31,11,3,8,11,3,8,,,
441858,31,43,1,42,43,1,42,,,
441876,31,13,2,11,12,2,10,1,0,1
441900,31,436,119,317,356,92,264,80,27,53
441937,31,635,185,450,602,172,430,33,13,20
441982,31,75,43,32,75,43,32,,,
442073,31,146,36,110,139,36,103,7,0,7
442134,31,70,12,58,70,12,58,,,
442240,31,13,2,11,3,0,3,10,2,8
442329,31,371,335,36,371,335,36,,,
442356,31,92,9,83,67,7,60,25,2,23
442383,31,35,8,27,35,8,27,,,
442426,31,44,3,41,16,0,16,28,3,25
442435,31,16,5,11,16,5,11,,,
442444,31,107,78,29,107,78,29,,,
442523,31,19,8,11,18,7,11,1,1,0
442569,31,591,118,473,103,34,69,488,84,404
442602,31,22,2,20,22,2,20,,,
442611,31,612,569,43,612,569,43,,,
442639,31,79,52,27,79,52,27,,,
442657,31,175,12,163,175,12,163,,,
442781,31,131,34,97,47,8,39,84,26,58
442842,31,28,7,21,,,,28,7,21
442879,31,71,6,65,71,6,65,,,
442888,31,11,11,0,11,11,0,,,
442930,31,117,52,65,107,46,61,10,6,4
442976,31,5,0,5,5,0,5,,,
442985,31,259,33,226,259,33,226,,,
443021,31,16,16,0,16,16,0,,,
443049,31,14,8,6,6,3,3,8,5,3
443058,31,4,2,2,,,,4,2,2
443100,31,18,11,7,18,11,7,,,
443137,31,164,27,137,164,27,137,,,
443146,31,17,14,3,14,11,3,3,3,0
443207,31,13,13,0,13,13,0,,,
443216,31,68,60,8,68,60,8,,,
443225,31,14,12,2,14,12,2,,,
443234,31,95,7,88,95,7,88,,,
443252,31,1725,897,828,1725,897,828,,,
443261,31,65,7,58,51,7,44,14,0,14
443289,31,111,10,101,111,10,101,,,
443298,31,27,24,3,27,24,3,,,
443322,31,73,14,59,73,14,59,,,
443331,31,1,0,1,1,0,1,,,
443340,31,4,2,2,4,2,2,,,
443377,31,22,17,5,22,17,5,,,
443410,31,186,118,68,183,118,65,3,0,3
443492,31,259,127,132,233,120,113,26,7,19
443562,31,38,3,35,28,2,26,10,1,9
443571,31,81,47,34,81,47,34,,,
443599,31,47,9,38,8,3,5,39,6,33
443632,31,13,8,5,13,8,5,,,
443641,31,16,0,16,8,0,8,8,0,8
443650,31,1046,266,780,770,156,614,276,110,166
443669,31,67,6,61,67,6,61,,,
443696,31,7,2,5,7,2,5,,,
443766,31,187,66,121,5,3,2,182,63,119
443784,31,59,19,40,1,0,1,58,19,39
443951,31,6,3,3,6,3,3,,,
443979,31,56,0,56,5,0,5,51,0,51
444051,31,19,0,19,13,0,13,6,0,6
444088,31,12,5,7,12,5,7,,,
444194,31,2,0,2,2,0,2,,,
444219,31,1626,803,823,722,355,367,904,448,456
444228,31,15,0,15,15,0,15,,,
444255,31,4,0,4,4,0,4,,,
444282,31,30,1,29,18,1,17,12,0,12
444291,31,51,2,49,39,2,37,12,0,12
444307,31,22,0,22,16,0,16,6,0,6
444325,31,4,1,3,4,1,3,,,
444334,31,29,8,21,29,8,21,,,
444361,31,25,12,13,25,12,13,,,
444370,31,10,10,0,10,10,0,,,
444398,31,12,7,5,9,6,3,3,1,2
444404,31,4,1,3,3,1,2,1,0,1
444413,31,47,47,0,47,47,0,,,
444440,31,10,1,9,10,1,9,,,
444468,31,19,1,18,16,1,15,3,0,3
444486,31,22,0,22,21,0,21,1,0,1
444510,31,24,4,20,24,4,20,,,
444529,31,11,1,10,11,1,10,,,
444556,31,107,49,58,107,49,58,,,
444565,31,14,5,9,14,5,9,,,
444583,31,204,93,111,204,93,111,,,
444635,31,31,2,29,31,2,29,,,
444662,31,2,2,0,2,2,0,,,
444671,31,72,33,39,72,33,39,,,
444714,31,20,2,18,20,2,18,,,
444732,31,31,8,23,31,8,23,,,
444778,31,1,1,0,,,,1,1,0
444787,31,61,10,51,57,9,48,4,1,3
444811,31,49,3,46,27,2,25,22,1,21
444857,31,14,0,14,6,0,6,8,0,8
444866,31,53,4,49,46,4,42,7,0,7
444893,31,238,8,230,238,8,230,,,
444936,31,23,3,20,23,3,20,,,
444945,31,172,11,161,172,11,161,,,
444954,31,331,141,190,242,105,137,89,36,53
445027,31,977,310,667,831,262,569,146,48,98
445133,31,12,3,9,6,2,4,6,1,5
445188,31,2393,1332,1061,2371,1321,1050,22,11,11
445203,31,70,7,63,70,7,63,,,
445212,31,16,6,10,11,5,6,5,1,4
445230,31,103,19,84,103,19,84,,,
445249,31,77,25,52,77,25,52,,,
445267,31,5,0,5,2,0,2,3,0,3
445364,31,135,14,121,135,14,121,,,
445498,31,10,10,0,10,10,0,,,
445540,31,11,0,11,11,0,11,,,
445647,31,42,4,38,24,2,22,18,2,16
445656,31,58,0,58,37,0,37,21,0,21
445692,31,201,163,38,197,160,37,4,3,1
445708,31,392,134,258,391,133,258,1,1,0
445744,31,51,7,44,51,7,44,,,
445762,31,32,30,2,32,30,2,,,
445780,31,2,0,2,2,0,2,,,
445799,31,467,449,18,467,449,18,,,
445841,31,20,0,20,17,0,17,3,0,3
445850,31,10,1,9,7,1,6,3,0,3
445911,31,192,93,99,180,87,93,12,6,6
445948,31,517,70,447,517,70,447,,,
445957,31,160,41,119,,,,160,41,119
446048,31,356,159,197,356,159,197,,,
446084,31,20,3,17,,,,20,3,17
446093,31,39,4,35,39,4,35,,,
446109,31,33,6,27,29,6,23,4,0,4
446118,31,78,8,70,78,8,70,,,
446127,31,43,5,38,43,5,38,,,
446163,31,300,286,14,191,181,10,109,105,4
446206,31,49,2,47,41,2,39,8,0,8
446233,31,35,20,15,35,20,15,,,
446242,31,6,1,5,6,1,5,,,
446251,31,58,14,44,58,14,44,,,
446260,31,115,3,112,115,3,112,,,
446288,31,4,0,4,3,0,3,1,0,1
446303,31,6,0,6,3,0,3,3,0,3
446349,31,12,1,11,12,1,11,,,
446385,31,61,42,19,61,42,19,,,
446516,31,2,2,0,2,2,0,,,
446525,31,362,301,61,362,301,61,,,
446552,31,518,247,271,518,247,271,,,
446561,31,233,53,180,233,53,180,,,
446598,31,4,2,2,4,2,2,,,
446604,31,566,566,0,566,566,0,,,
446640,31,139,101,38,132,96,36,7,5,2
446774,31,368,148,220,184,80,104,184,68,116
447014,31,30,3,27,30,3,27,,,
447023,31,571,290,281,563,289,274,8,1,7
447148,31,72,1,71,50,1,49,22,0,22
447166,31,32,5,27,23,4,19,9,1,8
447175,31,34,1,33,21,1,20,13,0,13
447263,31,155,19,136,90,11,79,65,8,57
447351,31,119,65,54,119,65,54,,,
447421,31,8,1,7,8,1,7,,,
447449,31,37,9,28,22,7,15,15,2,13
447467,31,82,3,79,82,3,79,,,
447582,31,207,96,111,172,81,91,35,15,20
447591,31,247,27,220,247,27,220,,,
447607,31,238,114,124,238,114,124,,,
447616,31,193,113,80,193,113,80,,,
447689,31,2317,1030,1287,1918,843,1075,399,187,212
447704,31,23,1,22,23,1,22,,,
447713,31,2,0,2,2,0,2,,,
447722,31,22,1,21,22,1,21,,,
447731,31,18,1,17,14,1,13,4,0,4
447759,31,14,6,8,10,5,5,4,1,3
447768,31,223,41,182,223,41,182,,,
447777,31,492,283,209,10,6,4,482,277,205
447795,31,18,2,16,18,2,16,,,
447810,31,12,2,10,12,2,10,,,
447847,31,12,12,0,12,12,0,,,
447865,31,8,6,2,6,5,1,2,1,1
447883,31,72,12,60,32,9,23,40,3,37
447892,31,24,4,20,23,3,20,1,1,0
447908,31,7,0,7,7,0,7,,,
447917,31,24,7,17,24,7,17,,,
447935,31,57,2,55,57,2,55,,,
447953,31,68,44,24,45,27,18,23,17,6
447962,31,44,2,42,44,2,42,,,
447971,31,28,3,25,28,3,25,,,
447980,31,10,0,10,10,0,10,,,
447999,31,54,9,45,54,9,45,,,
448026,31,24,3,21,19,3,16,5,0,5
448071,31,15,1,14,15,1,14,,,
448123,31,196,20,176,196,20,176,,,
448196,31,6,1,5,6,1,5,,,
448220,31,36,3,33,36,3,33,,,
448248,31,816,455,361,112,10,102,704,445,259
448257,31,7,0,7,1,0,1,6,0,6
448275,31,10,0,10,10,0,10,,,
448372,31,5,3,2,5,3,2,,,
448424,31,28,4,24,16,3,13,12,1,11
448433,31,453,439,14,453,439,14,,,
448594,31,658,288,370,352,153,199,306,135,171
448600,31,38,3,35,38,3,35,,,
448646,31,64,2,62,64,2,62,,,
448673,31,164,24,140,93,12,81,71,12,59
448770,31,33,29,4,32,28,4,1,1,0
448798,31,56,1,55,56,1,55,,,
448859,31,27,24,3,27,24,3,,,
448895,31,506,74,432,506,74,432,,,
449038,31,51,21,30,8,5,3,43,16,27
449074,31,101,5,96,101,5,96,,,
449083,31,102,102,0,102,102,0,,,
449092,31,94,94,0,94,94,0,,,
449135,31,38,15,23,29,15,14,9,0,9
449250,31,121,20,101,121,20,101,,,
449311,31,10,0,10,4,0,4,6,0,6
449320,31,223,219,4,177,174,3,46,45,1
449339,31,1756,1259,497,75,39,36,1681,1220,461
449348,31,4,1,3,1,1,0,3,0,3
449357,31,5,0,5,5,0,5,,,
449384,31,27,18,9,27,18,9,,,
449393,31,24,5,19,24,5,19,,,
449445,31,24,2,22,24,2,22,,,
449454,31,10,3,7,,,,10,3,7
449463,31,153,38,115,87,18,69,66,20,46
449472,31,40,0,40,40,0,40,,,
449490,31,49,11,38,49,11,38,,,
449506,31,20,7,13,20,7,13,,,
449524,31,23,2,21,23,2,21,,,
449533,31,22,3,19,22,3,19,,,
449597,31,1,0,1,1,0,1,,,
449603,31,107,57,50,107,57,50,,,
449612,31,12,1,11,12,1,11,,,
449658,31,33,33,0,33,33,0,,,
449676,31,154,80,74,154,80,74,,,
449685,31,178,14,164,178,14,164,,,
449700,31,84,19,65,84,19,65,,,
449728,31,43,2,41,43,2,41,,,
449764,31,44,22,22,44,22,22,,,
449773,31,175,28,147,175,28,147,,,
449782,31,19,2,17,14,1,13,5,1,4
449807,31,50,5,45,50,5,45,,,
449816,31,100,65,35,21,18,3,79,47,32
449834,31,1,1,0,,,,1,1,0
449861,31,37,3,34,37,3,34,,,
449870,31,5,2,3,5,2,3,,,
449898,31,19,3,16,14,1,13,5,2,3
449904,31,137,2,135,137,2,135,,,
449959,31,20,3,17,14,2,12,6,1,5
449968,31,16,0,16,11,0,11,5,0,5
449977,31,13,0,13,11,0,11,2,0,2
449986,31,9,1,8,7,1,6,2,0,2
449995,31,11,2,9,9,2,7,2,0,2
450058,31,59,28,31,59,28,31,,,
450067,31,65,28,37,64,28,36,1,0,1
450128,31,107,8,99,107,8,99,,,
450298,31,9,3,6,1,1,0,8,2,6
450377,31,44,12,32,1,1,0,43,11,32
450395,31,20,0,20,16,0,16,4,0,4
450401,31,161,22,139,161,22,139,,,
450571,31,33,7,26,19,4,15,14,3,11
450599,31,20,1,19,20,1,19,,,
450605,31,23,3,20,19,3,16,4,0,4
450614,31,39,1,38,31,1,30,8,0,8
450632,31,34,7,27,,,,34,7,27
450641,31,27,0,27,18,0,18,9,0,9
450650,31,126,16,110,42,0,42,84,16,68
450696,31,86,11,75,86,11,75,,,
450711,31,82,64,18,82,64,18,,,
450720,31,238,1,237,111,1,110,127,0,127
450933,31,296,201,95,197,126,71,99,75,24
450951,31,81,39,42,81,39,42,,,
450960,31,11,3,8,11,3,8,,,
450988,31,62,8,54,42,7,35,20,1,19
451042,31,8,2,6,4,0,4,4,2,2
451051,31,33,2,31,,,,33,2,31
451097,31,39,8,31,30,4,26,9,4,5
451103,31,181,32,149,59,11,48,122,21,101
451121,31,6,0,6,4,0,4,2,0,2
451149,31,75,6,69,75,6,69,,,
451158,31,98,1,97,98,1,97,,,
451167,31,1,0,1,1,0,1,,,
451194,31,6,0,6,6,0,6,,,
451228,31,108,90,18,108,90,18,,,
451237,31,49,2,47,49,2,47,,,
451255,31,15,1,14,10,0,10,5,1,4
451282,31,44,2,42,24,1,23,20,1,19
451291,31,4,1,3,,,,4,1,3
451307,31,7,0,7,1,0,1,6,0,6
451316,31,9,0,9,9,0,9,,,
451334,31,121,51,70,59,23,36,62,28,34
451343,31,16,0,16,13,0,13,3,0,3
451352,31,88,16,72,69,15,54,19,1,18
451370,31,10,10,0,10,10,0,,,
451398,31,59,59,0,59,59,0,,,
451404,31,152,152,0,152,152,0,,,
451413,31,4,2,2,4,2,2,,,
451459,31,41,8,33,10,0,10,31,8,23
451468,31,76,1,75,76,1,75,,,
451477,31,454,368,86,454,368,86,,,
451495,31,25,8,17,25,8,17,,,
451501,31,144,57,87,144,57,87,,,
451529,31,43,0,43,27,0,27,16,0,16
451547,31,9,3,6,9,3,6,,,
451556,31,624,217,407,624,217,407,,,
451565,31,22,1,21,22,1,21,,,
451574,31,46,3,43,40,2,38,6,1,5
451583,31,167,129,38,24,19,5,143,110,33
451626,31,5,0,5,5,0,5,,,
451714,31,33,1,32,33,1,32,,,
451741,31,18,6,12,18,6,12,,,
451750,31,129,68,61,129,68,61,,,
451820,31,9,3,6,8,3,5,1,0,1
451857,31,20,3,17,20,3,17,,,
451866,31,126,26,100,126,26,100,,,
451918,31,21,2,19,21,2,19,,,
451927,31,103,67,36,99,65,34,4,2,2
452009,31,9,1,8,9,1,8,,,
452072,31,10,0,10,10,0,10,,,
452081,31,235,11,224,235,11,224,,,
452106,31,21,20,1,21,20,1,,,
452124,31,43,12,31,43,12,31,,,
452373,31,32,2,30,32,2,30,,,
452771,31,11,1,10,,,,11,1,10
452780,31,3,0,3,,,,3,0,3
452887,31,13,11,2,13,11,2,,,
452948,31,156,14,142,86,8,78,70,6,64
453163,31,118,40,78,1,1,0,117,39,78
453215,31,31,8,23,,,,31,8,23
453297,31,14,6,8,,,,14,6,8
453756,31,25,16,9,25,16,9,,,
453792,31,37,3,34,37,3,34,,,
454184,31,65,35,30,64,35,29,1,0,1
454227,31,31,4,27,26,3,23,5,1,4
454236,31,10,0,10,10,0,10,,,
454245,31,9,2,7,9,2,7,,,
454537,31,28,1,27,28,1,27,,,
454546,31,146,9,137,146,9,137,,,
454555,31,230,10,220,230,10,220,,,
454607,31,83,1,82,83,1,82,,,
454652,31,15,0,15,15,0,15,,,
454698,31,68,21,47,68,21,47,,,
454722,31,3,0,3,3,0,3,,,
454759,31,1,1,0,1,1,0,,,
454768,31,7,0,7,3,0,3,4,0,4
454777,31,6,2,4,2,0,2,4,2,2
454786,31,127,88,39,52,42,10,75,46,29
454795,31,22,8,14,18,7,11,4,1,3
454801,31,4,1,3,4,1,3,,,
454810,31,2354,675,1679,2354,675,1679,,,
454829,31,174,40,134,64,13,51,110,27,83
454865,31,103,19,84,92,17,75,11,2,9
454874,31,33,1,32,8,0,8,25,1,24
454917,31,304,44,260,194,25,169,110,19,91
454926,31,35,1,34,28,1,27,7,0,7
454935,31,19,0,19,19,0,19,,,
454944,31,23,0,23,23,0,23,,,
454953,31,20,0,20,12,0,12,8,0,8
454962,31,25,0,25,16,0,16,9,0,9
454971,31,43,3,40,22,2,20,21,1,20
454980,31,6,0,6,2,0,2,4,0,4
454999,31,16,0,16,4,0,4,12,0,12
455008,31,49,2,47,12,1,11,37,1,36
455026,31,33,31,2,,,,33,31,2
455062,31,7,0,7,5,0,5,2,0,2
455071,31,53,13,40,,,,53,13,40
455080,31,2,0,2,2,0,2,,,
455105,31,1,0,1,1,0,1,,,
455114,31,1541,724,817,708,365,343,833,359,474
455141,31,29,1,28,29,1,28,,,
455187,31,138,30,108,43,13,30,95,17,78
455196,31,216,19,197,216,19,197,,,
455202,31,22,3,19,3,1,2,19,2,17
455211,31,50,0,50,50,0,50,,,
455220,31,34,6,28,34,6,28,,,
455257,31,99,99,0,99,99,0,,,
455275,31,38,0,38,38,0,38,,,
455284,31,61,2,59,54,1,53,7,1,6
455327,31,10,2,8,9,2,7,1,0,1
455336,31,41,35,6,41,35,6,,,
455354,31,1,0,1,1,0,1,,,
455381,31,69,0,69,39,0,39,30,0,30
455460,31,42,11,31,42,11,31,,,
455479,31,55,10,45,51,8,43,4,2,2
455488,31,63,25,38,63,25,38,,,
455512,31,563,239,324,229,88,141,334,151,183
455628,31,78,38,40,78,38,40,,,
455664,31,27,7,20,,,,27,7,20
455725,31,449,6,443,360,5,355,89,1,88
455734,31,98,15,83,98,15,83,,,
455761,31,62,11,51,44,4,40,18,7,11
455770,31,38,20,18,38,20,18,,,
455798,31,26,0,26,14,0,14,12,0,12
455831,31,92,12,80,92,12,80,,,
455859,31,46,0,46,42,0,42,4,0,4
455868,31,19,0,19,19,0,19,,,
455877,31,32,0,32,32,0,32,,,
455886,31,49,1,48,31,0,31,18,1,17
455895,31,91,4,87,48,1,47,43,3,40
455901,31,18,3,15,14,3,11,4,0,4
455910,31,47,5,42,47,5,42,,,
455929,31,12,0,12,12,0,12,,,
455965,31,19,1,18,19,1,18,,,
455974,31,105,5,100,105,5,100,,,
455983,31,35,12,23,35,12,23,,,
456001,31,69,66,3,69,66,3,,,
456029,31,9,0,9,7,0,7,2,0,2
456038,31,88,10,78,88,10,78,,,
456065,31,7,0,7,7,0,7,,,
456074,31,29,0,29,29,0,29,,,
456135,31,60,1,59,43,1,42,17,0,17
456153,31,19,16,3,19,16,3,,,
456205,31,57,28,29,56,28,28,1,0,1
456214,31,100,67,33,100,67,33,,,
456287,31,42,0,42,42,0,42,,,
456454,31,48,26,22,43,26,17,5,0,5
456490,31,8,5,3,5,2,3,3,3,0
456506,31,35,0,35,35,0,35,,,
456515,31,14,0,14,14,0,14,,,
456551,31,41,1,40,41,1,40,,,
456579,31,79,50,29,74,48,26,5,2,3
456588,31,13,0,13,13,0,13,,,
456597,31,60,0,60,36,0,36,24,0,24
456621,31,27,9,18,1,0,1,26,9,17
456825,31,1,0,1,1,0,1,,,
456852,31,84,35,49,84,35,49,,,
456922,31,77,15,62,71,14,57,6,1,5
456931,31,88,57,31,84,56,28,4,1,3
456959,31,193,31,162,190,30,160,3,1,2
456968,31,126,13,113,115,13,102,11,0,11
456977,31,43,42,1,43,42,1,,,
457031,31,8,0,8,5,0,5,3,0,3
457077,31,371,28,343,371,28,343,,,
457086,31,5,3,2,5,3,2,,,
457101,31,49,13,36,49,13,36,,,
457110,31,19,1,18,19,1,18,,,
457129,31,5,0,5,4,0,4,1,0,1
457192,31,30,21,9,30,21,9,,,
457208,31,18,16,2,18,16,2,,,
457226,31,5,3,2,4,3,1,1,0,1
457253,31,11,0,11,1,0,1,10,0,10
457299,31,16,5,11,16,5,11,,,
457314,31,18,6,12,18,6,12,,,
457323,31,64,6,58,64,6,58,,,
457332,31,5,0,5,5,0,5,,,
457341,31,19,2,17,19,2,17,,,
457378,31,78,42,36,38,18,20,40,24,16
457387,31,98,61,37,98,61,37,,,
457396,31,65,16,49,11,4,7,54,12,42
457402,31,69,61,8,21,20,1,48,41,7
457411,31,34,33,1,34,33,1,,,
457420,31,13,0,13,7,0,7,6,0,6
457439,31,13,0,13,11,0,11,2,0,2
457448,31,17,0,17,17,0,17,,,
457466,31,10,9,1,10,9,1,,,
457475,31,25,0,25,25,0,25,,,
457484,31,14,7,7,7,2,5,7,5,2
457493,31,9,0,9,9,0,9,,,
457536,31,80,11,69,80,11,69,,,
457545,31,16,0,16,14,0,14,2,0,2
457554,31,15,1,14,14,1,13,1,0,1
457563,31,38,3,35,38,3,35,,,
457572,31,28,1,27,28,1,27,,,
457581,31,25,0,25,25,0,25,,,
457606,31,88,4,84,88,4,84,,,
457615,31,4,0,4,,,,4,0,4
457624,31,16,2,14,16,2,14,,,
457633,31,50,2,48,23,0,23,27,2,25
457642,31,9,0,9,9,0,9,,,
457679,31,5,0,5,5,0,5,,,
457697,31,25,12,13,3,3,0,22,9,13
457749,31,27,0,27,27,0,27,,,
457767,31,60,36,24,60,36,24,,,
457776,31,12,2,10,12,2,10,,,
457785,31,22,0,22,22,0,22,,,
457794,31,113,13,100,113,13,100,,,
457800,31,194,22,172,194,22,172,,,
457819,31,156,78,78,,,,156,78,78
457837,31,19,2,17,16,2,14,3,0,3
457855,31,17,1,16,17,1,16,,,
457873,31,4,3,1,,,,4,3,1
457916,31,54,3,51,28,1,27,26,2,24
457925,31,1,1,0,1,1,0,,,
457943,31,14,1,13,14,1,13,,,
457952,31,36,0,36,32,0,32,4,0,4
457989,31,24,0,24,24,0,24,,,
458007,31,63,1,62,33,0,33,30,1,29
458034,31,3,0,3,3,0,3,,,
458043,31,17,0,17,13,0,13,4,0,4
458061,31,30,5,25,8,2,6,22,3,19
458070,31,33,0,33,33,0,33,,,
458098,31,47,2,45,44,2,42,3,0,3
458104,31,1,0,1,1,0,1,,,
458113,31,11,6,5,,,,11,6,5
458122,31,11,0,11,11,0,11,,,
458131,31,97,6,91,97,6,91,,,
458140,31,9,8,1,9,8,1,,,
458168,31,30,1,29,30,1,29,,,
458210,31,7,1,6,7,1,6,,,
458229,31,7,4,3,6,4,2,1,0,1
458274,31,24,0,24,20,0,20,4,0,4
458405,31,81,47,34,81,47,34,,,
458441,31,92,16,76,91,16,75,1,0,1
458496,31,10,4,6,7,3,4,3,1,2
458681,31,27,11,16,27,11,16,,,
458803,31,63,1,62,44,1,43,19,0,19
458812,31,36,0,36,30,0,30,6,0,6
458821,31,43,1,42,43,1,42,,,
458830,31,77,2,75,49,0,49,28,2,26
458858,31,74,3,71,50,2,48,24,1,23
458867,31,86,5,81,66,3,63,20,2,18
458885,31,19,9,10,,,,19,9,10
458919,31,168,53,115,6,1,5,162,52,110
458955,31,18,4,14,,,,18,4,14
458964,31,85,30,55,6,2,4,79,28,51
458973,31,104,41,63,5,4,1,99,37,62
458982,31,20,11,9,9,5,4,11,6,5
459019,31,66,4,62,56,4,52,10,0,10
459046,31,28,1,27,23,1,22,5,0,5
459055,31,16,0,16,11,0,11,5,0,5
459064,31,33,3,30,23,3,20,10,0,10
459116,31,21,0,21,21,0,21,,,
459170,31,37,4,33,23,3,20,14,1,13
459189,31,29,0,29,25,0,25,4,0,4
459198,31,11,2,9,10,2,8,1,0,1
459204,31,274,46,228,274,46,228,,,
459213,31,180,27,153,180,27,153,,,
459231,31,5,2,3,5,2,3,,,
459259,31,13,2,11,13,2,11,,,
459268,31,8,2,6,6,2,4,2,0,2
459277,31,92,2,90,92,2,90,,,
459286,31,14,2,12,10,1,9,4,1,3
459295,31,31,0,31,19,0,19,12,0,12
459301,31,12,0,12,7,0,7,5,0,5
459329,31,210,99,111,210,99,111,,,
459347,31,21,0,21,6,0,6,15,0,15
459374,31,74,0,74,24,0,24,50,0,50
459392,31,31,0,31,21,0,21,10,0,10
459408,31,15,1,14,15,1,14,,,
459417,31,11,9,2,11,9,2,,,
459426,31,126,5,121,126,5,121,,,
459499,31,1,0,1,1,0,1,,,
459514,31,36,12,24,36,12,24,,,
459523,31,63,6,57,63,6,57,,,
459532,31,37,0,37,4,0,4,33,0,33
459541,31,10,0,10,7,0,7,3,0,3
459550,31,19,3,16,19,3,16,,,
459578,31,9,4,5,5,1,4,4,3,1
459727,31,34,5,29,23,2,21,11,3,8
459842,31,60,8,52,28,5,23,32,3,29
459851,31,40,4,36,20,3,17,20,1,19
459949,31,1028,384,644,980,360,620,48,24,24
459958,31,70,22,48,70,22,48,,,
459967,31,168,59,109,168,59,109,,,
459985,31,119,68,51,119,68,51,,,
459994,31,469,192,277,15,4,11,454,188,266
460011,31,10,0,10,8,0,8,2,0,2
460020,31,71,25,46,71,25,46,,,
460093,31,19,0,19,19,0,19,,,
460109,31,41,3,38,41,3,38,,,
460118,31,31,1,30,31,1,30,,,
460127,31,38,6,32,38,6,32,,,
460136,31,136,16,120,136,16,120,,,
460145,31,23,17,6,23,17,6,,,
460172,31,149,138,11,149,138,11,,,
460181,31,116,8,108,116,8,108,,,
460190,31,57,8,49,57,8,49,,,
460206,31,95,9,86,95,9,86,,,
460349,31,175,71,104,28,9,19,147,62,85
460376,31,4,2,2,4,2,2,,,
460385,31,5,0,5,5,0,5,,,
460394,31,1756,803,953,582,282,300,1174,521,653
460464,31,1503,850,653,599,351,248,904,499,405
460482,31,49,9,40,49,9,40,,,
460525,31,25,3,22,25,3,22,,,
460534,31,258,6,252,258,6,252,,,
460543,31,796,764,32,796,764,32,,,
460677,31,91,31,60,90,31,59,1,0,1
460701,31,69,9,60,17,2,15,52,7,45
460756,31,180,16,164,156,16,140,24,0,24
460765,31,41,2,39,41,2,39,,,
460808,31,8,1,7,8,1,7,,,
460817,31,59,34,25,58,33,25,1,1,0
460826,31,147,43,104,144,43,101,3,0,3
460835,31,101,42,59,101,42,59,,,
460862,31,26,1,25,14,1,13,12,0,12
460871,31,1,0,1,,,,1,0,1
460914,31,45,1,44,45,1,44,,,
460932,31,73,0,73,73,0,73,,,
460969,31,75,4,71,75,4,71,,,
460978,31,143,2,141,76,0,76,67,2,65
460987,31,39,0,39,39,0,39,,,
460996,31,41,1,40,40,0,40,1,1,0
461014,31,253,14,239,253,14,239,,,
461023,31,26,4,22,26,4,22,,,
461032,31,2,1,1,1,0,1,1,1,0
461087,31,1073,583,490,44,26,18,1029,557,472
461111,31,15,15,0,14,14,0,1,1,0
461148,31,270,157,113,270,157,113,,,
461175,31,46,3,43,39,3,36,7,0,7
461193,31,16,0,16,16,0,16,,,
461218,31,81,5,76,81,5,76,,,
461245,31,65,28,37,26,11,15,39,17,22
461254,31,36,9,27,36,9,27,,,
461263,31,8,0,8,8,0,8,,,
461272,31,8,0,8,7,0,7,1,0,1
461306,31,132,41,91,19,10,9,113,31,82
461315,31,39,9,30,7,2,5,32,7,25
461333,31,10,9,1,10,9,1,,,
461342,31,54,0,54,44,0,44,10,0,10
461379,31,6,2,4,3,1,2,3,1,2
461388,31,15,5,10,15,5,10,,,
461412,31,103,32,71,,,,103,32,71
461421,31,11,0,11,11,0,11,,,
461430,31,137,128,9,,,,137,128,9
461494,31,38,2,36,25,1,24,13,1,12
461500,31,6,3,3,4,2,2,2,1,1
461528,31,24,11,13,10,3,7,14,8,6
461537,31,10,1,9,10,1,9,,,
461555,31,63,6,57,63,6,57,,,
461573,31,61,59,2,61,59,2,,,
461582,31,37,0,37,37,0,37,,,
461591,31,5,0,5,5,0,5,,,
461607,31,18,3,15,7,2,5,11,1,10
461625,31,3,3,0,3,3,0,,,
461652,31,16,1,15,16,1,15,,,
461689,31,69,11,58,69,11,58,,,
461704,31,82,4,78,82,4,78,,,
461713,31,8,0,8,,,,8,0,8
461722,31,54,1,53,54,1,53,,,
461740,31,14,12,2,14,12,2,,,
461759,31,61,27,34,51,24,27,10,3,7
461768,31,100,0,100,73,0,73,27,0,27
461786,31,22,0,22,22,0,22,,,
461795,31,154,115,39,150,112,38,4,3,1
461810,31,23,9,14,21,8,13,2,1,1
461829,31,12,4,8,12,4,8,,,
461838,31,74,0,74,63,0,63,11,0,11
461847,31,13,13,0,13,13,0,,,
461856,31,45,23,22,45,23,22,,,
461865,31,22,2,20,22,2,20,,,
461874,31,42,7,35,42,7,35,,,
461883,31,4,1,3,4,1,3,,,
461892,31,8,2,6,8,2,6,,,
461908,31,10,0,10,9,0,9,1,0,1
461917,31,42,0,42,14,0,14,28,0,28
461926,31,96,1,95,69,1,68,27,0,27
461944,31,30,1,29,30,1,29,,,
461953,31,1,0,1,1,0,1,,,
461962,31,373,299,74,373,299,74,,,
461999,31,135,10,125,116,9,107,19,1,18
462008,31,18,2,16,10,1,9,8,1,7
462017,31,28,2,26,28,2,26,,,
462035,31,200,82,118,56,1,55,144,81,63
462053,31,13,1,12,13,1,12,,,
462062,31,23,0,23,18,0,18,5,0,5
462071,31,31,9,22,31,9,22,,,
462336,31,12,0,12,12,0,12,,,
462345,31,26,0,26,14,0,14,12,0,12
462354,31,117,56,61,112,52,60,5,4,1
463056,31,616,345,271,606,339,267,10,6,4
464226,31,248,155,93,236,150,86,12,5,7
466921,31,4,0,4,3,0,3,1,0,1
466930,31,20,4,16,12,1,11,8,3,5
467094,31,30,0,30,30,0,30,,,
467863,31,14,4,10,14,4,10,,,
467872,31,27,1,26,19,0,19,8,1,7
467906,31,7,0,7,6,0,6,1,0,1
468246,31,24,1,23,24,1,23,,,
468255,31,2,1,1,2,1,1,,,
468291,31,15,5,10,15,5,10,,,
468769,31,40,37,3,40,37,3,,,
468848,31,144,76,68,144,76,68,,,
468893,31,22,1,21,22,1,21,,,
468909,31,171,75,96,171,75,96,,,
468963,31,552,525,27,552,525,27,,,
469416,31,58,17,41,36,14,22,22,3,19
469610,31,5,0,5,5,0,5,,,
469629,31,47,40,7,47,40,7,,,
469911,31,75,6,69,75,6,69,,,
470038,31,273,123,150,273,123,150,,,
470047,31,3,0,3,3,0,3,,,
470296,31,10,0,10,10,0,10,,,
470393,31,13,1,12,5,0,5,8,1,7
474863,31,12,1,11,11,1,10,1,0,1
474915,31,239,4,235,145,2,143,94,2,92
474924,31,94,2,92,19,2,17,75,0,75
475015,31,18,0,18,18,0,18,,,
475024,31,78,25,53,78,25,53,,,
475060,31,63,7,56,63,7,56,,,
475121,31,711,218,493,623,179,444,88,39,49
475176,31,116,64,52,116,64,52,,,
475282,31,7,3,4,7,3,4,,,
475325,31,140,4,136,140,4,136,,,
475398,31,5,3,2,1,0,1,4,3,1
475404,31,18,0,18,15,0,15,3,0,3
475431,31,19,1,18,19,1,18,,,
475468,31,4,0,4,2,0,2,2,0,2
475477,31,13,5,8,11,3,8,2,2,0
475486,31,26,3,23,26,3,23,,,
475547,31,23,7,16,16,7,9,7,0,7
475556,31,17,0,17,14,0,14,3,0,3
475565,31,385,228,157,385,228,157,,,
475574,31,5,3,2,5,3,2,,,
475608,31,19,9,10,13,6,7,6,3,3
475635,31,1,1,0,1,1,0,,,
475653,31,10,1,9,10,1,9,,,
475662,31,19,0,19,6,0,6,13,0,13
475714,31,59,54,5,42,38,4,17,16,1
475723,31,102,59,43,39,23,16,63,36,27
475732,31,10,1,9,9,1,8,1,0,1
475741,31,2,1,1,2,1,1,,,
475839,31,47,23,24,21,11,10,26,12,14
476063,31,111,102,9,111,102,9,,,
476179,31,72,3,69,46,3,43,26,0,26
476230,31,15,1,14,15,1,14,,,
476355,31,1,0,1,1,0,1,,,
476489,31,27,20,7,27,20,7,,,
476498,31,63,44,19,63,44,19,,,
476513,31,13,1,12,13,1,12,,,
476540,31,3,0,3,3,0,3,,,
476559,31,3,0,3,1,0,1,2,0,2
476568,31,17,11,6,17,11,6,,,
476595,31,44,9,35,44,9,35,,,
476601,31,25,25,0,25,25,0,,,
476610,31,1,1,0,1,1,0,,,
476629,31,15,1,14,15,1,14,,,
476683,31,23,3,20,22,3,19,1,0,1
476692,31,14,14,0,14,14,0,,,
476708,31,13,7,6,13,7,6,,,
476717,31,193,193,0,193,193,0,,,
476726,31,122,25,97,122,25,97,,,
476735,31,11,5,6,11,5,6,,,
476753,31,29,0,29,14,0,14,15,0,15
476780,31,20,3,17,19,3,16,1,0,1
476799,31,22,2,20,22,2,20,,,
476805,31,7,0,7,7,0,7,,,
476814,31,247,160,87,,,,247,160,87
476841,31,14,2,12,9,2,7,5,0,5
476850,31,18,12,6,18,12,6,,,
476869,31,46,2,44,46,2,44,,,
476878,31,71,3,68,37,1,36,34,2,32
476887,31,515,7,508,497,7,490,18,0,18
476896,31,47,17,30,47,17,30,,,
476902,31,34,1,33,22,1,21,12,0,12
476939,31,182,24,158,182,24,158,,,
476957,31,7,1,6,6,1,5,1,0,1
476975,31,91,47,44,16,5,11,75,42,33
476984,31,20,0,20,15,0,15,5,0,5
476993,31,59,0,59,59,0,59,,,
477002,31,22,0,22,19,0,19,3,0,3
477039,31,5,0,5,4,0,4,1,0,1
477233,31,4,1,3,4,1,3,,,
478582,31,51,1,50,33,1,32,18,0,18
478591,31,96,3,93,57,2,55,39,1,38
478616,31,37,0,37,32,0,32,5,0,5
478917,31,41,2,39,41,2,39,,,
478953,31,37,2,35,37,2,35,,,
479062,31,35,32,3,17,16,1,18,16,2
479424,31,40,10,30,40,10,30,,,
479956,31,299,136,163,198,83,115,101,53,48
479965,31,25,3,22,25,3,22,,,
479974,31,17,3,14,15,3,12,2,0,2
479983,31,14,0,14,14,0,14,,,
479992,31,2,1,1,1,1,0,1,0,1
480000,31,5,3,2,3,2,1,2,1,1
480019,31,587,507,80,533,459,74,54,48,6
480028,31,24,21,3,24,21,3,,,
480037,31,493,395,98,493,395,98,,,
480073,31,19,5,14,18,5,13,1,0,1
480091,31,686,95,591,646,87,559,40,8,32
480125,31,204,6,198,101,4,97,103,2,101
480161,31,1,0,1,1,0,1,,,
480198,31,1,1,0,,,,1,1,0
480204,31,89,14,75,89,14,75,,,
480310,31,28,0,28,27,0,27,1,0,1
480471,31,160,82,78,160,82,78,,,
480523,31,42,2,40,42,2,40,,,
480532,31,11,0,11,11,0,11,,,
480550,31,17,0,17,17,0,17,,,
480569,31,40,11,29,36,11,25,4,0,4
480657,31,40,8,32,24,2,22,16,6,10
480727,31,27,19,8,27,19,8,,,
480781,31,19,15,4,18,14,4,1,1,0
480824,31,191,20,171,191,20,171,,,
480833,31,149,14,135,149,14,135,,,
480842,31,20,12,8,20,12,8,,,
480851,31,8,4,4,8,4,4,,,
480879,31,6,1,5,6,1,5,,,
480888,31,63,30,33,63,30,33,,,
480903,31,239,207,32,197,167,30,42,40,2
480921,31,11,8,3,11,8,3,,,
480930,31,1,0,1,1,0,1,,,
480967,31,91,33,58,61,24,37,30,9,21
480976,31,9,1,8,9,1,8,,,
480985,31,1,0,1,1,0,1,,,
480994,31,4,0,4,4,0,4,,,
481003,31,124,108,16,124,108,16,,,
481021,31,26,18,8,19,13,6,7,5,2
481058,31,9,6,3,9,6,3,,,
481100,31,91,18,73,19,4,15,72,14,58
481128,31,11,0,11,9,0,9,2,0,2
481137,31,40,20,20,40,20,20,,,
481146,31,35,6,29,25,4,21,10,2,8
481155,31,57,24,33,57,24,33,,,
481191,31,104,19,85,104,19,85,,,
481207,31,32,5,27,32,5,27,,,
481225,31,5,1,4,5,1,4,,,
481243,31,42,0,42,19,0,19,23,0,23
481252,31,1,0,1,1,0,1,,,
481298,31,15,0,15,15,0,15,,,
481313,31,48,1,47,29,1,28,19,0,19
481322,31,37,1,36,10,0,10,27,1,26
481331,31,47,36,11,47,36,11,,,
481340,31,33,0,33,33,0,33,,,
481368,31,7,1,6,7,1,6,,,
481386,31,133,17,116,,,,133,17,116
481401,31,19,15,4,,,,19,15,4
481410,31,18,18,0,18,18,0,,,
481429,31,54,4,50,54,4,50,,,
481438,31,23,23,0,23,23,0,,,
481447,31,24,4,20,7,1,6,17,3,14
481456,31,3,1,2,1,0,1,2,1,1
481465,31,10,0,10,4,0,4,6,0,6
481474,31,5,0,5,5,0,5,,,
481483,31,41,2,39,27,1,26,14,1,13
481517,31,18,2,16,12,2,10,6,0,6
481526,31,40,0,40,40,0,40,,,
481571,31,9,5,4,9,5,4,,,
481678,31,30,0,30,19,0,19,11,0,11
481720,31,3,0,3,3,0,3,,,
481739,31,16,1,15,13,1,12,3,0,3
481748,31,53,0,53,48,0,48,5,0,5
481775,31,43,12,31,43,12,31,,,
481845,31,27,0,27,13,0,13,14,0,14
481863,31,15,1,14,15,1,14,,,
481890,31,28,2,26,28,2,26,,,
481906,31,17,0,17,17,0,17,,,
481960,31,46,39,7,46,39,7,,,
482015,31,189,137,52,189,137,52,,,
482060,31,195,28,167,195,28,167,,,
482097,31,74,49,25,71,47,24,3,2,1
482149,31,1047,387,660,1032,381,651,15,6,9
482158,31,1281,597,684,1094,530,564,187,67,120
482167,31,67,0,67,21,0,21,46,0,46
482176,31,54,1,53,34,1,33,20,0,20
482185,31,50,41,9,50,41,9,,,
482194,31,38,5,33,22,3,19,16,2,14
482200,31,21,1,20,21,1,20,,,
482228,31,12,7,5,5,4,1,7,3,4
482246,31,21,21,0,21,21,0,,,
482255,31,26,26,0,26,26,0,,,
482291,31,267,118,149,267,118,149,,,
482413,31,3,1,2,2,1,1,1,0,1
482431,31,106,44,62,53,25,28,53,19,34
482468,31,3,1,2,2,1,1,1,0,1
482477,31,1943,777,1166,925,375,550,1018,402,616
482556,31,2,1,1,,,,2,1,1
482574,31,1,1,0,,,,1,1,0
482653,31,2,1,1,2,1,1,,,
482680,31,3873,1822,2051,3651,1721,1930,222,101,121
482699,31,585,219,366,478,185,293,107,34,73
482936,31,450,355,95,433,347,86,17,8,9
482963,31,82,29,53,82,29,53,,,
482981,31,33,31,2,24,23,1,9,8,1
482990,31,77,6,71,77,6,71,,,
483009,31,202,21,181,202,21,181,,,
483018,31,31,8,23,31,8,23,,,
483036,31,33,11,22,13,4,9,20,7,13
483045,31,814,422,392,231,110,121,583,312,271
483054,31,15,10,5,15,10,5,,,
483106,31,56,7,49,43,4,39,13,3,10
483124,31,2973,931,2042,,,,2973,931,2042
483212,31,747,380,367,419,233,186,328,147,181
483221,31,28,13,15,28,13,15,,,
483230,31,28,28,0,23,23,0,5,5,0
483258,31,10,7,3,10,7,3,,,
483276,31,24,21,3,24,21,3,,,
483328,31,5,0,5,5,0,5,,,
483337,31,13,0,13,10,0,10,3,0,3
483346,31,15,0,15,15,0,15,,,
483355,31,12,0,12,12,0,12,,,
483364,31,9,2,7,9,2,7,,,
483373,31,12,0,12,12,0,12,,,
483382,31,126,125,1,126,125,1,,,
483425,31,12,1,11,12,1,11,,,
483470,31,14,2,12,14,2,12,,,
483504,31,112,40,72,112,40,72,,,
483513,31,9,7,2,9,7,2,,,
483559,31,24,1,23,15,1,14,9,0,9
483577,31,31,1,30,19,1,18,12,0,12
483595,31,778,176,602,308,65,243,470,111,359
483647,31,4,1,3,4,1,3,,,
483708,31,193,38,155,67,5,62,126,33,93
483726,31,6,0,6,3,0,3,3,0,3
483735,31,32,4,28,14,2,12,18,2,16
483744,31,5,4,1,5,4,1,,,
483753,31,8,6,2,6,4,2,2,2,0
483780,31,59,36,23,57,35,22,2,1,1
483799,31,19,7,12,19,7,12,,,
483814,31,48,3,45,48,3,45,,,
483823,31,341,256,85,341,256,85,,,
483841,31,25,4,21,25,4,21,,,
483850,31,4,1,3,4,1,3,,,
483869,31,112,31,81,112,31,81,,,
483878,31,68,4,64,68,4,64,,,
483887,31,10,4,6,10,4,6,,,
483896,31,21,0,21,5,0,5,16,0,16
483911,31,6,0,6,6,0,6,,,
483920,31,106,64,42,106,64,42,,,
483948,31,1,1,0,1,1,0,,,
483957,31,6,1,5,6,1,5,,,
484002,31,362,32,330,340,29,311,22,3,19
484011,31,6,3,3,4,3,1,2,0,2
484020,31,46,35,11,28,21,7,18,14,4
484048,31,21,20,1,21,20,1,,,
484057,31,62,4,58,15,2,13,47,2,45
484066,31,87,7,80,87,7,80,,,
484075,31,24,16,8,12,8,4,12,8,4
484084,31,23,0,23,8,0,8,15,0,15
484093,31,4,0,4,1,0,1,3,0,3
484109,31,5,0,5,5,0,5,,,
484127,31,26,3,23,26,3,23,,,
484136,31,18,5,13,18,5,13,,,
484163,31,132,34,98,76,18,58,56,16,40
484172,31,2,0,2,2,0,2,,,
484190,31,10,7,3,10,7,3,,,
484206,31,143,0,143,88,0,88,55,0,55
484233,31,83,39,44,,,,83,39,44
484330,31,14,1,13,14,1,13,,,
484349,31,15,1,14,15,1,14,,,
484358,31,31,2,29,31,2,29,,,
484367,31,95,14,81,95,14,81,,,
484376,31,110,12,98,110,12,98,,,
484394,31,35,1,34,23,1,22,12,0,12
484473,31,886,416,470,800,392,408,86,24,62
484604,31,185,5,180,96,3,93,89,2,87
484613,31,1927,766,1161,1927,766,1161,,,
484844,31,140,57,83,140,57,83,,,
484871,31,36,36,0,36,36,0,,,
484899,31,72,0,72,72,0,72,,,
484905,31,346,129,217,284,112,172,62,17,45
484923,31,17,0,17,16,0,16,1,0,1
484932,31,387,157,230,299,111,188,88,46,42
484950,31,3,1,2,3,1,2,,,
484996,31,94,3,91,94,3,91,,,
485014,31,38,2,36,27,1,26,11,1,10
485032,31,23,0,23,15,0,15,8,0,8
485111,31,897,455,442,739,386,353,158,69,89
485166,31,13,5,8,13,5,8,,,
485236,31,9,0,9,3,0,3,6,0,6
485272,31,3,2,1,3,2,1,,,
485342,31,46,21,25,46,21,25,,,
485360,31,2,0,2,2,0,2,,,
485379,31,126,28,98,126,28,98,,,
485388,31,134,19,115,134,19,115,,,
485397,31,57,1,56,46,1,45,11,0,11
485412,31,25,7,18,25,7,18,,,
485458,31,199,90,109,35,23,12,164,67,97
485476,31,15,0,15,15,0,15,,,
485485,31,124,13,111,124,13,111,,,
485494,31,59,50,9,52,45,7,7,5,2
485500,31,19,16,3,1,1,0,18,15,3
485519,31,79,31,48,41,16,25,38,15,23
485546,31,46,31,15,,,,46,31,15
485564,31,15,2,13,14,2,12,1,0,1
485573,31,46,5,41,41,5,36,5,0,5
485591,31,8,0,8,8,0,8,,,
485607,31,10,0,10,9,0,9,1,0,1
485698,31,23,19,4,23,19,4,,,
485704,31,1,0,1,1,0,1,,,
485768,31,158,119,39,158,119,39,,,
485801,31,46,7,39,46,7,39,,,
485856,31,2,1,1,2,1,1,,,
485874,31,15,0,15,8,0,8,7,0,7
485926,31,70,17,53,70,17,53,,,
485953,31,77,69,8,77,69,8,,,
485962,31,4,3,1,3,2,1,1,1,0
485999,31,28,28,0,28,28,0,,,
486017,31,4,4,0,4,4,0,,,
486026,31,42,42,0,42,42,0,,,
486053,31,10,3,7,8,2,6,2,1,1
486123,31,11,7,4,11,7,4,,,
486141,31,11,1,10,11,1,10,,,
486150,31,20,7,13,15,5,10,5,2,3
486169,31,30,25,5,30,25,5,,,
486196,31,84,84,0,84,84,0,,,
486202,31,11,2,9,11,2,9,,,
486239,31,3,2,1,3,2,1,,,
486248,31,95,34,61,95,34,61,,,
486257,31,52,28,24,45,23,22,7,5,2
486284,31,44,15,29,42,15,27,2,0,2
486345,31,108,108,0,67,67,0,41,41,0
486354,31,9,4,5,9,4,5,,,
486372,31,7,4,3,7,4,3,,,
486381,31,35,2,33,35,2,33,,,
486390,31,29,18,11,29,18,11,,,
486406,31,5,0,5,5,0,5,,,
486415,31,20,0,20,20,0,20,,,
486424,31,42,9,33,39,8,31,3,1,2
486442,31,72,13,59,72,13,59,,,
486497,31,6,6,0,6,6,0,,,
486503,31,26,0,26,26,0,26,,,
486512,31,157,70,87,157,70,87,,,
486530,31,28,1,27,28,1,27,,,
486558,31,48,46,2,48,46,2,,,
486567,31,38,4,34,37,4,33,1,0,1
486576,31,83,26,57,83,26,57,,,
486619,31,2,0,2,1,0,1,1,0,1
486691,31,35,0,35,24,0,24,11,0,11
486707,31,41,2,39,41,2,39,,,
486716,31,32,1,31,32,1,31,,,
486752,31,12,0,12,12,0,12,,,
486770,31,41,16,25,41,16,25,,,
486798,31,753,660,93,753,660,93,,,
486813,31,59,13,46,59,13,46,,,
486822,31,161,24,137,161,24,137,,,
486840,31,7024,3511,3513,6669,3317,3352,355,194,161
486859,31,2,0,2,2,0,2,,,
486877,31,7,1,6,7,1,6,,,
486886,31,22,0,22,8,0,8,14,0,14
486901,31,175,86,89,175,86,89,,,
486938,31,7,1,6,5,0,5,2,1,1
486947,31,1,0,1,1,0,1,,,
486956,31,9,1,8,7,1,6,2,0,2
486965,31,37,12,25,37,12,25,,,
486983,31,6,0,6,6,0,6,,,
487047,31,46,4,42,46,4,42,,,
487065,31,12,0,12,12,0,12,,,
487083,31,11,0,11,11,0,11,,,
487092,31,422,200,222,422,200,222,,,
487162,31,332,139,193,163,58,105,169,81,88
487232,31,36,2,34,36,2,34,,,
487302,31,50,21,29,50,21,29,,,
487311,31,96,85,11,96,85,11,,,
487320,31,2297,1819,478,1703,1478,225,594,341,253
487348,31,21,0,21,8,0,8,13,0,13
487375,31,33,3,30,25,2,23,8,1,7
487384,31,88,27,61,88,27,61,,,
487393,31,116,52,64,116,52,64,,,
487409,31,92,47,45,92,47,45,,,
487418,31,134,67,67,134,67,67,,,
487427,31,105,45,60,105,45,60,,,
487436,31,172,43,129,172,43,129,,,
487445,31,64,32,32,64,32,32,,,
487454,31,65,23,42,65,23,42,,,
487472,31,113,45,68,113,45,68,,,
487481,31,284,95,189,284,95,189,,,
487490,31,250,52,198,250,52,198,,,
487506,31,52,0,52,25,0,25,27,0,27
487524,31,591,267,324,561,259,302,30,8,22
487533,31,35,0,35,13,0,13,22,0,22
487588,31,129,4,125,129,4,125,,,
487597,31,545,519,26,545,519,26,,,
487603,31,83,34,49,48,20,28,35,14,21
487621,31,2,2,0,1,1,0,1,1,0
487658,31,31,18,13,31,18,13,,,
487676,31,15,2,13,3,0,3,12,2,10
487773,31,7,0,7,4,0,4,3,0,3
487791,31,155,136,19,115,101,14,40,35,5
487807,31,5,4,1,4,3,1,1,1,0
487816,31,2,0,2,2,0,2,,,
487852,31,19,6,13,,,,19,6,13
487861,31,73,11,62,61,10,51,12,1,11
487889,31,104,13,91,104,13,91,,,
487898,31,7,7,0,3,3,0,4,4,0
487904,31,15,8,7,15,8,7,,,
487922,31,9,0,9,8,0,8,1,0,1
487959,31,19,0,19,16,0,16,3,0,3
487977,31,239,22,217,205,8,197,34,14,20
488013,31,185,11,174,171,10,161,14,1,13
488022,31,2,1,1,2,1,1,,,
488031,31,2,0,2,2,0,2,,,
488059,31,28,9,19,28,9,19,,,
488077,31,1377,1361,16,807,794,13,570,567,3
488110,31,19,7,12,10,3,7,9,4,5
488129,31,19,0,19,1,0,1,18,0,18
488138,31,47,3,44,47,3,44,,,
488147,31,25,1,24,25,1,24,,,
488174,31,3,2,1,2,1,1,1,1,0
488183,31,1,0,1,1,0,1,,,
488192,31,38,37,1,38,37,1,,,
488217,31,27,0,27,27,0,27,,,
488226,31,12,6,6,12,6,6,,,
488253,31,27,18,9,17,12,5,10,6,4
488262,31,10,6,4,5,4,1,5,2,3
488271,31,55,2,53,55,2,53,,,
488280,31,3,1,2,3,1,2,,,
488299,31,38,9,29,29,9,20,9,0,9
488305,31,25,17,8,22,15,7,3,2,1
488314,31,23,23,0,23,23,0,,,
488332,31,1,0,1,1,0,1,,,
488350,31,59,59,0,59,59,0,,,
488369,31,9,8,1,9,8,1,,,
488378,31,49,5,44,49,5,44,,,
488396,31,17,16,1,3,2,1,14,14,0
488411,31,30,0,30,30,0,30,,,
488420,31,44,2,42,,,,44,2,42
488439,31,42,38,4,32,28,4,10,10,0
488448,31,11,11,0,11,11,0,,,
488563,31,9,7,2,9,7,2,,,
488590,31,8,3,5,8,3,5,,,
488651,31,136,22,114,79,12,67,57,10,47
488679,31,759,185,574,741,176,565,18,9,9
488721,31,9,8,1,,,,9,8,1
488730,31,1562,719,843,743,352,391,819,367,452
488749,31,86,17,69,75,14,61,11,3,8
488776,31,4,1,3,3,1,2,1,0,1
488785,31,35,16,19,33,14,19,2,2,0
488837,31,191,182,9,191,182,9,,,
488846,31,2700,1367,1333,1450,727,723,1250,640,610
488891,31,68,21,47,68,21,47,,,
488916,31,5,0,5,5,0,5,,,
488934,31,307,217,90,136,98,38,171,119,52
488952,31,28,0,28,28,0,28,,,
488961,31,25,1,24,25,1,24,,,
488970,31,10,0,10,10,0,10,,,
488989,31,21,0,21,13,0,13,8,0,8
488998,31,18,3,15,18,3,15,,,
489122,31,8,1,7,5,0,5,3,1,2
489131,31,8,2,6,4,0,4,4,2,2
489140,31,55,2,53,12,2,10,43,0,43
489159,31,20,2,18,15,1,14,5,1,4
489201,31,1203,607,596,646,339,307,557,268,289
489238,31,23,2,21,15,1,14,8,1,7
489247,31,19,4,15,12,3,9,7,1,6
489256,31,196,185,11,195,184,11,1,1,0
489283,31,196,29,167,196,29,167,,,
489344,31,3,0,3,2,0,2,1,0,1
489371,31,32,29,3,32,29,3,,,
489779,31,1280,665,615,10,6,4,1270,659,611
489812,31,12,0,12,12,0,12,,,
489830,31,15,0,15,15,0,15,,,
489937,31,84,57,27,78,52,26,6,5,1
490018,31,1,1,0,1,1,0,,,
490045,31,4,0,4,,,,4,0,4
490054,31,199,79,120,144,54,90,55,25,30
490081,31,6,4,2,4,4,0,2,0,2
490090,31,26,19,7,12,8,4,14,11,3
490115,31,16,12,4,16,12,4,,,
490133,31,419,255,164,405,245,160,14,10,4
490142,31,1,0,1,1,0,1,,,
490151,31,33,0,33,21,0,21,12,0,12
490160,31,42,5,37,42,5,37,,,
490203,31,12,2,10,2,0,2,10,2,8
490221,31,7,1,6,6,0,6,1,1,0
490230,31,12,4,8,12,4,8,,,
490249,31,10,8,2,10,8,2,,,
490258,31,70,16,54,70,16,54,,,
490267,31,10,10,0,10,10,0,,,
490276,31,46,46,0,46,46,0,,,
490285,31,145,122,23,145,122,23,,,
490294,31,38,7,31,38,7,31,,,
490300,31,18,1,17,16,0,16,2,1,1
490319,31,2,2,0,2,2,0,,,
490346,31,68,0,68,68,0,68,,,
490382,31,13,2,11,13,2,11,,,
490391,31,65,0,65,65,0,65,,,
490407,31,38,0,38,25,0,25,13,0,13
490416,31,8,8,0,8,8,0,,,
490425,31,59,0,59,59,0,59,,,
490434,31,19,0,19,19,0,19,,,
490443,31,7,0,7,7,0,7,,,
490452,31,23,2,21,8,2,6,15,0,15
490461,31,20,1,19,20,1,19,,,
490470,31,2,0,2,2,0,2,,,
490489,31,13,8,5,9,5,4,4,3,1
490498,31,15,11,4,15,11,4,,,
490504,31,6,6,0,6,6,0,,,
490513,31,13,13,0,13,13,0,,,
490522,31,16,0,16,16,0,16,,,
490531,31,21,18,3,12,10,2,9,8,1
490559,31,77,7,70,77,7,70,,,
490674,31,4,0,4,4,0,4,,,
490692,31,4,4,0,4,4,0,,,
490717,31,39,5,34,39,5,34,,,
490735,31,60,2,58,60,2,58,,,
490744,31,17,15,2,17,15,2,,,
490805,31,1292,657,635,1235,633,602,57,24,33
490814,31,44,4,40,44,4,40,,,
490832,31,48,3,45,40,2,38,8,1,7
490841,31,118,4,114,118,4,114,,,
490869,31,38,3,35,38,3,35,,,
490878,31,63,12,51,63,12,51,,,
490896,31,33,2,31,33,2,31,,,
490948,31,4,3,1,4,3,1,,,
490975,31,15,4,11,15,4,11,,,
491057,31,26,26,0,26,26,0,,,
491066,31,38,1,37,11,0,11,27,1,26
491075,31,56,50,6,56,50,6,,,
491084,31,40,0,40,40,0,40,,,
491136,31,39,0,39,28,0,28,11,0,11
491145,31,51,0,51,34,0,34,17,0,17
491181,31,96,15,81,50,7,43,46,8,38
491215,31,28,27,1,28,27,1,,,
491224,31,16,0,16,13,0,13,3,0,3
491233,31,4,0,4,3,0,3,1,0,1
491242,31,14,6,8,14,6,8,,,
491251,31,22,13,9,22,13,9,,,
491260,31,27,0,27,17,0,17,10,0,10
491288,31,3,1,2,,,,3,1,2
491394,31,17,14,3,15,14,1,2,0,2
491446,31,128,0,128,128,0,128,,,
491464,31,108,22,86,108,22,86,,,
491473,31,369,221,148,37,1,36,332,220,112
491507,31,5,0,5,5,0,5,,,
491525,31,40,15,25,34,11,23,6,4,2
491534,31,12,2,10,,,,12,2,10
491543,31,17,3,14,17,3,14,,,
491552,31,30,0,30,30,0,30,,,
491570,31,31,0,31,31,0,31,,,
491589,31,5,2,3,1,0,1,4,2,2
491598,31,11,0,11,11,0,11,,,
491613,31,19,19,0,19,19,0,,,
491622,31,15,15,0,15,15,0,,,
491631,31,51,0,51,51,0,51,,,
491640,31,41,41,0,41,41,0,,,
491659,31,12,9,3,12,9,3,,,
491668,31,58,1,57,58,1,57,,,
491677,31,25,17,8,17,13,4,8,4,4
491686,31,10,7,3,10,7,3,,,
491695,31,5,0,5,5,0,5,,,
491701,31,15,5,10,,,,15,5,10
491710,31,11,11,0,11,11,0,,,
491729,31,4,0,4,4,0,4,,,
491738,31,20,2,18,16,2,14,4,0,4
491747,31,1,0,1,1,0,1,,,
491756,31,74,59,15,74,59,15,,,
491765,31,23,23,0,23,23,0,,,
491774,31,36,5,31,29,4,25,7,1,6
491783,31,55,52,3,20,18,2,35,34,1
491792,31,23,0,23,23,0,23,,,
491817,31,135,0,135,135,0,135,,,
491826,31,23,0,23,23,0,23,,,
491835,31,37,1,36,37,1,36,,,
491844,31,86,25,61,56,20,36,30,5,25
491853,31,19,0,19,19,0,19,,,
491871,31,9,0,9,6,0,6,3,0,3
491880,31,32,31,1,32,31,1,,,
491899,31,24,4,20,3,1,2,21,3,18
491905,31,47,2,45,47,2,45,,,
491914,31,23,23,0,23,23,0,,,
491923,31,168,2,166,146,2,144,22,0,22
491932,31,17,14,3,17,14,3,,,
491941,31,31,1,30,31,1,30,,,
491950,31,106,24,82,,,,106,24,82
491978,31,14,6,8,4,2,2,10,4,6
491996,31,26,1,25,26,1,25,,,
492005,31,30,0,30,26,0,26,4,0,4
492023,31,13,4,9,,,,13,4,9
492032,31,13,0,13,,,,13,0,13
492069,31,9,5,4,9,5,4,,,
492096,31,2,0,2,2,0,2,,,
492139,31,77,66,11,77,66,11,,,
492148,31,2,1,1,2,1,1,,,
492281,31,5,5,0,5,5,0,,,
492306,31,129,33,96,,,,129,33,96
492315,31,60,15,45,,,,60,15,45
492324,31,80,12,68,,,,80,12,68
492360,31,8,2,6,7,2,5,1,0,1
492421,31,17,14,3,17,14,3,,,
492449,31,80,18,62,80,18,62,,,
492476,31,62,9,53,26,4,22,36,5,31
492643,31,19,6,13,19,6,13,,,
492652,31,8,6,2,8,6,2,,,
492661,31,43,5,38,43,5,38,,,
492722,31,90,7,83,90,7,83,,,
492731,31,39,4,35,29,4,25,10,0,10
492759,31,3,0,3,2,0,2,1,0,1
492801,31,43,22,21,24,13,11,19,9,10
492935,31,123,14,109,123,14,109,,,
492953,31,30,1,29,17,0,17,13,1,12
492962,31,444,156,288,143,54,89,301,102,199
493071,31,147,35,112,147,35,112,,,
493080,31,74,36,38,16,9,7,58,27,31
493132,31,506,485,21,506,485,21,,,
493150,31,25,1,24,25,1,24,,,
493451,31,18,1,17,18,1,17,,,
493479,31,12,6,6,12,6,6,,,
493488,31,18,2,16,18,2,16,,,
493512,31,18,16,2,18,16,2,,,
493521,31,17,12,5,17,12,5,,,
493530,31,11,8,3,4,3,1,7,5,2
493549,31,37,32,5,37,32,5,,,
493558,31,10,9,1,10,9,1,,,
493567,31,9,0,9,,,,9,0,9
493576,31,5,0,5,5,0,5,,,
493585,31,25,2,23,25,2,23,,,
493594,31,9,9,0,9,9,0,,,
493600,31,58,58,0,58,58,0,,,
493619,31,6,2,4,4,2,2,2,0,2
493628,31,18,3,15,8,1,7,10,2,8
493637,31,1,1,0,1,1,0,,,
493646,31,159,0,159,159,0,159,,,
493655,31,12,8,4,11,8,3,1,0,1
493664,31,7,7,0,7,7,0,,,
493682,31,31,2,29,26,1,25,5,1,4
493691,31,17,0,17,14,0,14,3,0,3
493707,31,30,30,0,30,30,0,,,
493716,31,20,20,0,20,20,0,,,
493743,31,83,67,16,58,47,11,25,20,5
493752,31,3,0,3,3,0,3,,,
493761,31,11,5,6,4,2,2,7,3,4
493770,31,18,1,17,18,1,17,,,
493798,31,100,0,100,100,0,100,,,
493804,31,94,68,26,94,68,26,,,
493813,31,161,10,151,161,10,151,,,
493822,31,9,4,5,7,3,4,2,1,1
493831,31,6,5,1,6,5,1,,,
493868,31,13,7,6,10,6,4,3,1,2
493910,31,21,0,21,8,0,8,13,0,13
493992,31,83,21,62,83,21,62,,,
494001,31,13,0,13,9,0,9,4,0,4
494029,31,2,2,0,2,2,0,,,
494162,31,25,3,22,15,1,14,10,2,8
494232,31,16,1,15,12,1,11,4,0,4
494250,31,45,2,43,45,2,43,,,
494278,31,34,6,28,18,2,16,16,4,12
494287,31,52,14,38,17,4,13,35,10,25
494357,31,182,83,99,182,83,99,,,
494436,31,23,9,14,23,9,14,,,
494463,31,214,0,214,214,0,214,,,
494472,31,10,0,10,3,0,3,7,0,7
494524,31,8,0,8,8,0,8,,,
494588,31,98,12,86,98,12,86,,,
494597,31,14,8,6,13,7,6,1,1,0
494603,31,103,77,26,74,56,18,29,21,8
494621,31,43,1,42,,,,43,1,42
494630,31,7,4,3,7,4,3,,,
494649,31,7,0,7,3,0,3,4,0,4
494658,31,5,0,5,5,0,5,,,
494685,31,54,18,36,51,17,34,3,1,2
494694,31,11,4,7,11,4,7,,,
494700,31,9,0,9,9,0,9,,,
494719,31,27,10,17,18,6,12,9,4,5
494728,31,7,5,2,5,4,1,2,1,1
494737,31,36,36,0,36,36,0,,,
494746,31,123,20,103,123,20,103,,,
494755,31,11,3,8,11,3,8,,,
494764,31,30,28,2,30,28,2,,,
494807,31,20,2,18,20,2,18,,,
494843,31,110,3,107,110,3,107,,,
494852,31,170,45,125,170,45,125,,,
494898,31,4,1,3,4,1,3,,,
494904,31,89,17,72,25,1,24,64,16,48
494959,31,13,4,9,7,2,5,6,2,4
494986,31,1,0,1,1,0,1,,,
494995,31,19,17,2,19,17,2,,,
495013,31,33,26,7,,,,33,26,7
495031,31,15,15,0,15,15,0,,,
495040,31,25,0,25,25,0,25,,,
495059,31,15,8,7,15,8,7,,,
495077,31,9,0,9,9,0,9,,,
495101,31,22,5,17,22,5,17,,,
495110,31,9,8,1,9,8,1,,,
495129,31,47,40,7,47,40,7,,,
495138,31,12,2,10,12,2,10,,,
495147,31,2,1,1,2,1,1,,,
495165,31,10,5,5,10,5,5,,,
495174,31,2,1,1,,,,2,1,1
495183,31,48,15,33,48,15,33,,,
495208,31,20,12,8,20,12,8,,,
495217,31,6,4,2,6,4,2,,,
495235,31,3,0,3,2,0,2,1,0,1
495244,31,9,1,8,4,0,4,5,1,4
495253,31,13,1,12,12,1,11,1,0,1
495262,31,18,0,18,9,0,9,9,0,9
495271,31,14,3,11,4,0,4,10,3,7
495280,31,3,2,1,3,2,1,,,
495299,31,14,2,12,14,2,12,,,
495305,31,55,18,37,32,14,18,23,4,19
495341,31,8,4,4,8,4,4,,,
495350,31,1,0,1,1,0,1,,,
495369,31,2,0,2,1,0,1,1,0,1
495378,31,16,4,12,2,0,2,14,4,10
495387,31,20,14,6,9,7,2,11,7,4
495396,31,18,2,16,18,2,16,,,
495411,31,16,2,14,16,2,14,,,
495420,31,9,2,7,9,2,7,,,
495439,31,20,2,18,14,2,12,6,0,6
495448,31,4,1,3,4,1,3,,,
495457,31,20,2,18,15,2,13,5,0,5
495518,31,37,1,36,28,1,27,9,0,9
495730,31,6,0,6,2,0,2,4,0,4
495794,31,18,0,18,12,0,12,6,0,6
495837,31,42,8,34,42,8,34,,,
495925,31,18,4,14,18,4,14,,,
495934,31,24,1,23,24,1,23,,,
495952,31,19,8,11,19,8,11,,,
495961,31,18,1,17,18,1,17,,,
495970,31,89,32,57,89,32,57,,,
495998,31,13,2,11,13,2,11,,,
496052,31,13,11,2,13,11,2,,,
496061,31,64,5,59,28,4,24,36,1,35
496186,31,32,30,2,32,30,2,,,
496265,31,11,10,1,11,10,1,,,
496283,31,9,0,9,9,0,9,,,
496326,31,7,1,6,7,1,6,,,
496371,31,1,1,0,1,1,0,,,
496399,31,13,1,12,13,1,12,,,
496478,31,25,20,5,,,,25,20,5
496520,31,10,4,6,,,,10,4,6
496539,31,12,0,12,9,0,9,3,0,3
496618,31,128,9,119,128,9,119,,,
496627,31,19,9,10,19,9,10,,,
496636,31,39,6,33,39,6,33,,,
496645,31,105,71,34,29,1,28,76,70,6
496654,31,16,4,12,16,4,12,,,
496663,31,27,20,7,26,19,7,1,1,0
496672,31,4,3,1,4,3,1,,,
496690,31,11,2,9,9,1,8,2,1,1
496706,31,15,11,4,15,11,4,,,
496715,31,45,5,40,45,5,40,,,
496724,31,10,0,10,10,0,10,,,
496733,31,29,1,28,29,1,28,,,
496751,31,15,3,12,15,3,12,,,
496803,31,16,7,9,16,7,9,,,
496894,31,2,0,2,1,0,1,1,0,1
496919,31,189,73,116,189,73,116,,,
496955,31,135,57,78,135,57,78,,,
496964,31,5,4,1,5,4,1,,,
496973,31,31,2,29,23,1,22,8,1,7
496991,31,39,8,31,25,6,19,14,2,12
497000,31,51,12,39,51,12,39,,,
497037,31,116,23,93,55,7,48,61,16,45
497046,31,660,283,377,245,118,127,415,165,250
497073,31,152,4,148,78,3,75,74,1,73
497116,31,131,10,121,117,7,110,14,3,11
497125,31,41,2,39,23,1,22,18,1,17
497161,31,46,42,4,38,34,4,8,8,0
497189,31,17,2,15,17,2,15,,,
497198,31,53,0,53,36,0,36,17,0,17
497204,31,23,19,4,15,12,3,8,7,1
497213,31,6,4,2,5,4,1,1,0,1
497222,31,4,0,4,4,0,4,,,
497268,31,22,2,20,16,1,15,6,1,5
497277,31,181,30,151,181,30,151,,,
497286,31,345,321,24,345,321,24,,,
497301,31,228,3,225,130,2,128,98,1,97
497310,31,34,0,34,34,0,34,,,
497329,31,55,15,40,55,15,40,,,
497338,31,77,7,70,77,7,70,,,
497356,31,34,23,11,32,21,11,2,2,0
497365,31,6,4,2,6,4,2,,,
497374,31,79,7,72,79,7,72,,,
497383,31,9,8,1,9,8,1,,,
497392,31,40,34,6,7,6,1,33,28,5
497408,31,12,8,4,11,8,3,1,0,1
497417,31,11,0,11,11,0,11,,,
497426,31,59,6,53,51,1,50,8,5,3
497435,31,14,6,8,14,6,8,,,
497444,31,14,4,10,4,3,1,10,1,9
497462,31,14,6,8,3,1,2,11,5,6
497471,31,5,1,4,2,1,1,3,0,3
497480,31,38,3,35,38,3,35,,,
497499,31,23,23,0,,,,23,23,0
497675,31,30,2,28,18,2,16,12,0,12
497684,31,12,0,12,12,0,12,,,
497736,31,51,5,46,51,5,46,,,
497745,31,46,39,7,46,39,7,,,
497790,31,102,101,1,102,101,1,,,
497824,31,11,5,6,9,4,5,2,1,1
497833,31,122,63,59,122,63,59,,,
497888,31,21,1,20,18,1,17,3,0,3
497897,31,1,0,1,1,0,1,,,
497903,31,1,0,1,1,0,1,,,
497912,31,47,4,43,47,4,43,,,
497949,31,139,47,92,139,47,92,,,
497958,31,116,39,77,116,39,77,,,
498003,31,69,31,38,53,26,27,16,5,11
498012,31,137,129,8,137,129,8,,,
498030,31,108,100,8,108,100,8,,,
498049,31,36,5,31,23,3,20,13,2,11
498076,31,23,2,21,19,2,17,4,0,4
498085,31,60,5,55,51,2,49,9,3,6
498094,31,20,1,19,13,1,12,7,0,7
498100,31,35,2,33,5,0,5,30,2,28
498119,31,8,1,7,7,0,7,1,1,0
498243,31,5,1,4,5,1,4,,,
498322,31,28,0,28,28,0,28,,,
498331,31,13,9,4,1,0,1,12,9,3
498340,31,41,6,35,41,6,35,,,
498359,31,14,0,14,9,0,9,5,0,5
498368,31,1,0,1,,,,1,0,1
498377,31,68,64,4,68,64,4,,,
498386,31,27,7,20,23,7,16,4,0,4
498401,31,24,1,23,23,1,22,1,0,1
498410,31,25,23,2,17,16,1,8,7,1
498447,31,16,0,16,12,0,12,4,0,4
498456,31,18,2,16,13,1,12,5,1,4
498465,31,131,108,23,131,108,23,,,
498483,31,17,3,14,17,3,14,,,
498553,31,74,38,36,74,38,36,,,
498562,31,2184,865,1319,2155,846,1309,29,19,10
498571,31,2035,797,1238,1914,762,1152,121,35,86
100654,34,3639,1485,2154,3245,1318,1927,394,167,227
100663,34,10559,4039,6520,8067,3089,4978,2492,950,1542
100690,34,228,83,145,129,50,79,99,33,66
100706,34,5813,3425,2388,4705,2790,1915,1108,635,473
100724,34,2353,824,1529,2104,735,1369,249,89,160
100751,34,23323,10305,13018,20905,9259,11646,2418,1046,1372
100760,34,614,217,397,238,106,132,376,111,265
100812,34,2465,722,1743,1106,307,799,1359,415,944
100830,34,2900,940,1960,2060,645,1415,840,295,545
100858,34,19931,10113,9818,17664,8886,8778,2267,1227,1040
100937,34,724,366,358,718,365,353,6,1,5
101028,34,836,234,602,307,119,188,529,115,414
101116,34,298,40,258,202,31,171,96,9,87
101143,34,897,453,444,537,305,232,360,148,212
101161,34,3313,1063,2250,1495,555,940,1818,508,1310
101189,34,1362,568,794,1001,443,558,361,125,236
101240,34,2477,784,1693,1180,458,722,1297,326,971
101277,34,8,0,8,8,0,8,,,
101286,34,2299,571,1728,760,216,544,1539,355,1184
101295,34,2911,867,2044,1283,452,831,1628,415,1213
101301,34,583,152,431,262,102,160,321,50,271
101365,34,471,92,379,218,53,165,253,39,214
101435,34,552,297,255,533,290,243,19,7,12
101453,34,69,64,5,26,24,2,43,40,3
101462,34,561,201,360,155,66,89,406,135,271
101471,34,301,248,53,234,189,45,67,59,8
101480,34,5125,2046,3079,4402,1741,2661,723,305,418
101505,34,4232,1454,2778,1203,495,708,3029,959,2070
101514,34,4924,2056,2868,1681,820,861,3243,1236,2007
101569,34,1876,598,1278,684,270,414,1192,328,864
101587,34,2115,601,1514,1600,417,1183,515,184,331
101602,34,693,225,468,376,129,247,317,96,221
101648,34,125,98,27,125,98,27,,,
101675,34,961,420,541,904,394,510,57,26,31
101693,34,836,302,534,782,285,497,54,17,37
101709,34,1584,564,1020,1422,506,916,162,58,104
101736,34,1377,460,917,460,181,279,917,279,638
101879,34,4268,1582,2686,3496,1267,2229,772,315,457
101897,34,1024,322,702,428,143,285,596,179,417
101912,34,1000,408,592,931,375,556,69,33,36
101994,34,199,61,138,108,50,58,91,11,80
102030,34,1354,387,967,566,219,347,788,168,620
102049,34,2694,894,1800,2637,873,1764,57,21,36
102058,34,27,13,14,11,5,6,16,8,8
102067,34,2285,911,1374,984,484,500,1301,427,874
102076,34,929,316,613,477,173,304,452,143,309
102094,34,6557,2558,3999,5448,2074,3374,1109,484,625
102234,34,706,301,405,675,291,384,31,10,21
102270,34,578,256,322,478,212,266,100,44,56
102298,34,715,356,359,672,335,337,43,21,22
102313,34,1212,434,778,545,225,320,667,209,458
102368,34,8633,3008,5625,5656,1983,3673,2977,1025,1952
102377,34,1567,590,977,1453,538,915,114,52,62
102395,34,91,75,16,22,14,8,69,61,8
102429,34,1531,479,1052,538,221,317,993,258,735
102553,34,5706,2223,3483,2836,1193,1643,2870,1030,1840
102580,34,28,19,9,18,13,5,10,6,4
102614,34,3325,1302,2023,1677,770,907,1648,532,1116
102632,34,799,252,547,341,133,208,458,119,339
102669,34,427,73,354,353,52,301,74,21,53
102711,34,34,25,9,24,21,3,10,4,6
102845,34,1595,415,1180,1595,415,1180,,,
103501,34,82,12,70,82,12,70,,,
103741,34,107,8,99,66,7,59,41,1,40
103893,34,875,171,704,875,171,704,,,
103909,34,464,58,406,464,58,406,,,
103927,34,373,68,305,373,68,305,,,
103954,34,30,2,28,30,2,28,,,
103963,34,242,207,35,242,207,35,,,
104090,34,781,91,690,781,91,690,,,
104151,34,49627,25287,24340,44785,22496,22289,4842,2791,2051
104160,34,5499,2158,3341,1369,619,750,4130,1539,2591
104179,34,28910,12928,15982,23982,10404,13578,4928,2524,2404
104346,34,2928,991,1937,701,287,414,2227,704,1523
104391,34,16,0,16,16,0,16,,,
104425,34,2222,1002,1220,850,338,512,1372,664,708
104443,34,34,5,29,26,4,22,8,1,7
104568,34,150,1,149,73,1,72,77,0,77
104577,34,2148,789,1359,638,295,343,1510,494,1016
104586,34,2358,1731,627,2214,1613,601,144,118,26
104708,34,7713,3286,4427,2111,1070,1041,5602,2216,3386
104717,34,56702,16229,40473,16500,6635,9865,40202,9594,30608
105145,34,2978,924,2054,688,246,442,2290,678,1612
105154,34,9034,4073,4961,2463,1227,1236,6571,2846,3725
105206,34,2308,645,1663,501,168,333,1807,477,1330
105215,34,391,358,33,391,358,33,,,
105297,34,1197,269,928,579,137,442,618,132,486
105330,34,17515,6397,11118,14576,5451,9125,2939,946,1993
105349,34,947,252,695,204,71,133,743,181,562
105428,34,5442,1785,3657,1484,581,903,3958,1204,2754
105525,34,10531,4405,6126,2242,1038,1204,8289,3367,4922
105534,34,2336,454,1882,2336,454,1882,,,
105543,34,589,98,491,589,98,491,,,
105589,34,280,98,182,211,81,130,69,17,52
105659,34,648,597,51,648,597,51,,,
105668,34,3166,1079,2087,485,172,313,2681,907,1774
105677,34,13,13,0,13,13,0,,,
105747,34,3460,1469,1991,927,427,500,2533,1042,1491
105792,34,1667,687,980,429,188,241,1238,499,739
105899,34,727,456,271,633,409,224,94,47,47
106041,34,1175,1109,66,1175,1109,66,,,
106148,34,2686,1050,1636,739,401,338,1947,649,1298
106245,34,4253,1511,2742,2354,948,1406,1899,563,1336
106263,34,1287,206,1081,762,125,637,525,81,444
106306,34,334,259,75,312,241,71,22,18,4
106315,34,91,1,90,91,1,90,,,
106324,34,4,0,4,3,0,3,1,0,1
106342,34,343,201,142,337,198,139,6,3,3
106351,34,57,27,30,57,27,30,,,
106360,34,16,1,15,16,1,15,,,
106397,34,18903,8284,10619,16332,7290,9042,2571,994,1577
106412,34,1580,663,917,1336,574,762,244,89,155
106449,34,1215,399,816,733,265,468,482,134,348
106458,34,6138,2244,3894,3855,1574,2281,2283,670,1613
106467,34,4656,1943,2713,3648,1598,2050,1008,345,663
106485,34,1426,553,873,1163,492,671,263,61,202
106494,34,31,0,31,31,0,31,,,
106546,34,545,54,491,476,47,429,69,7,62
106625,34,706,218,488,419,138,281,287,80,207
106704,34,5760,2257,3503,4821,1904,2917,939,353,586
106713,34,386,215,171,356,205,151,30,10,20
106795,34,577,149,428,266,79,187,311,70,241
106810,34,117,62,55,116,61,55,1,1,0
106883,34,384,87,297,218,57,161,166,30,136
106908,34,309,16,293,299,16,283,10,0,10
106980,34,1267,455,812,705,279,426,562,176,386
106999,34,449,124,325,262,74,188,187,50,137
107044,34,2394,1055,1339,2208,955,1253,186,100,86
107071,34,1387,674,713,1206,585,621,181,89,92
107080,34,764,365,399,756,358,398,8,7,1
107099,34,81,4,77,81,4,77,,,
107123,34,69,17,52,69,17,52,,,
107141,34,1048,427,621,967,397,570,81,30,51
107220,34,57,0,57,57,0,57,,,
107293,34,46,0,46,46,0,46,,,
107318,34,348,118,230,102,21,81,246,97,149
107327,34,558,167,391,274,98,176,284,69,215
107442,34,25,12,13,25,12,13,,,
107460,34,763,265,498,429,170,259,334,95,239
107488,34,3,2,1,2,1,1,1,1,0
107512,34,1142,492,650,1117,479,638,25,13,12
107521,34,343,79,264,216,44,172,127,35,92
107549,34,478,104,374,327,79,248,151,25,126
107558,34,538,261,277,535,261,274,3,0,3
107585,34,1040,362,678,557,212,345,483,150,333
107600,34,529,202,327,455,180,275,74,22,52
107619,34,473,129,344,289,87,202,184,42,142
107637,34,632,136,496,126,34,92,506,102,404
107655,34,25,0,25,25,0,25,,,
107664,34,3077,969,2108,1529,527,1002,1548,442,1106
107725,34,551,122,429,211,64,147,340,58,282
107743,34,284,95,189,188,66,122,96,29,67
107789,34,80,1,79,80,1,79,,,
107831,34,79,1,78,79,1,78,,,
107840,34,202,72,130,180,62,118,22,10,12
107877,34,412,202,210,405,198,207,7,4,3
107974,34,692,152,540,320,95,225,372,57,315
107983,34,2080,910,1170,1934,854,1080,146,56,90
107992,34,453,183,270,279,110,169,174,73,101
108065,34,7,0,7,3,0,3,4,0,4
108092,34,3311,1275,2036,2472,959,1513,839,316,523
108232,34,4131,1778,2353,2017,952,1065,2114,826,1288
108667,34,3470,1429,2041,392,228,164,3078,1201,1877
108807,34,6146,2776,3370,2181,1033,1148,3965,1743,2222
108852,34,164,69,95,164,69,95,,,
108861,34,7,5,2,3,2,1,4,3,1
108977,34,201,44,157,104,23,81,97,21,76
109040,34,1839,422,1417,1839,422,1417,,,
109208,34,20608,10763,9845,3019,1336,1683,17589,9427,8162
109350,34,7800,3218,4582,2182,1012,1170,5618,2206,3412
109651,34,1838,778,1060,1558,651,907,280,127,153
109721,34,56,18,38,56,18,38,,,
109730,34,53,29,24,53,29,24,,,
109785,34,2826,904,1922,2430,777,1653,396,127,269
109819,34,15097,6446,8651,5442,2213,3229,9655,4233,5422
109907,34,2014,619,1395,838,244,594,1176,375,801
109934,34,320,31,289,320,31,289,,,
110060,34,156,120,36,135,107,28,21,13,8
110097,34,2768,1067,1701,2475,960,1515,293,107,186
110194,34,61,61,0,61,61,0,,,
110219,34,1394,304,1090,1394,304,1090,,,
110246,34,6482,2735,3747,2944,1323,1621,3538,1412,2126
110316,34,87,21,66,79,20,59,8,1,7
110334,34,5836,2504,3332,1171,505,666,4665,1999,2666
110361,34,6774,2476,4298,5959,2194,3765,815,282,533
110370,34,943,360,583,895,334,561,48,26,22
110404,34,758,421,337,758,421,337,,,
110413,34,1908,880,1028,1858,860,998,50,20,30
110422,34,15866,8331,7535,14845,7714,7131,1021,617,404
110468,34,274,93,181,,,,274,93,181
110486,34,7001,2358,4643,5541,1845,3696,1460,513,947
110495,34,7805,2613,5192,5976,1952,4024,1829,661,1168
110510,34,14388,5402,8986,11244,4158,7086,3144,1244,1900
110529,34,21425,11647,9778,17898,9639,8259,3527,2008,1519
110538,34,10833,4950,5883,9584,4363,5221,1249,587,662
110547,34,11841,4497,7344,8472,3207,5265,3369,1290,2079
110556,34,17527,7104,10423,14321,5678,8643,3206,1426,1780
110565,34,29969,12663,17306,22818,9489,13329,7151,3174,3977
110574,34,9813,3944,5869,7267,2922,4345,2546,1022,1524
110583,34,27415,11625,15790,22339,9235,13104,5076,2390,2686
110592,34,18798,7729,11069,14953,6008,8945,3845,1721,2124
110608,34,27131,12336,14795,21237,9384,11853,5894,2952,2942
110617,34,24629,10752,13877,18753,7964,10789,5876,2788,3088
110635,34,25749,11734,14015,24140,10954,13186,1609,780,829
110644,34,25113,10196,14917,24362,9848,14514,751,348,403
110653,34,22987,10404,12583,22265,10035,12230,722,369,353
110662,34,25961,10443,15518,25313,10125,15188,648,318,330
110671,34,17269,8397,8872,16432,7916,8516,837,481,356
110680,34,26546,12974,13572,25608,12435,13173,938,539,399
110705,34,18453,8259,10194,17849,7927,9922,604,332,272
110714,34,13643,7073,6570,12894,6630,6264,749,443,306
110778,34,11,1,10,10,1,9,1,0,1
110875,34,41,0,41,41,0,41,,,
110918,34,12,7,5,3,1,2,9,6,3
111045,34,24,10,14,23,10,13,1,0,1
111054,34,125,24,101,125,24,101,,,
111081,34,742,303,439,725,291,434,17,12,5
111188,34,663,522,141,634,500,134,29,22,7
111434,34,3548,1353,2195,445,203,242,3103,1150,1953
111461,34,13657,7916,5741,3402,1692,1710,10255,6224,4031
111513,34,173,3,170,133,1,132,40,2,38
111638,34,403,146,257,403,146,257,,,
111708,34,172,147,25,172,147,25,,,
111717,34,143,112,31,141,112,29,2,0,2
111726,34,126,98,28,126,98,28,,,
111744,34,70,66,4,70,66,4,,,
111762,34,85,49,36,85,49,36,,,
111799,34,133,22,111,133,22,111,,,
111887,34,14076,6581,7495,5507,2442,3065,8569,4139,4430
111896,34,2727,1155,1572,514,237,277,2213,918,1295
111920,34,7730,3838,3892,1875,877,998,5855,2961,2894
111939,34,12181,4486,7695,3673,1442,2231,8508,3044,5464
111948,34,5589,2311,3278,5266,2166,3100,323,145,178
111966,34,224,78,146,169,61,108,55,17,38
112075,34,1347,539,808,1130,447,683,217,92,125
112084,34,284,138,146,216,116,100,68,22,46
112172,34,6427,2775,3652,2629,1130,1499,3798,1645,2153
112181,34,98,2,96,98,2,96,,,
112190,34,11922,5389,6533,3518,1847,1671,8404,3542,4862
112260,34,1061,521,540,1055,516,539,6,5,1
112288,34,39,0,39,39,0,39,,,
112367,34,161,23,138,,,,161,23,138
112385,34,5613,3084,2529,470,204,266,5143,2880,2263
112394,34,331,243,88,261,194,67,70,49,21
112455,34,101,26,75,101,26,75,,,
112561,34,1454,591,863,579,268,311,875,323,552
112570,34,269,157,112,174,105,69,95,52,43
112686,34,2146,692,1454,556,218,338,1590,474,1116
112826,34,3786,1386,2400,977,439,538,2809,947,1862
113096,34,9539,3912,5627,1766,836,930,7773,3076,4697
113111,34,3348,1507,1841,941,417,524,2407,1090,1317
113193,34,5989,2809,3180,2179,1093,1086,3810,1716,2094
113218,34,5340,2279,3061,1021,483,538,4319,1796,2523
113236,34,9340,3914,5426,3112,1403,1709,6228,2511,3717
113333,34,10783,5415,5368,5048,2719,2329,5735,2696,3039
113449,34,143,37,106,143,37,106,,,
113537,34,8,1,7,8,1,7,,,
113573,34,6774,2747,4027,2589,1178,1411,4185,1569,2616
113582,34,82,6,76,64,6,58,18,0,18
113634,34,11828,5712,6116,4234,2184,2050,7594,3528,4066
113698,34,922,266,656,801,229,572,121,37,84
113856,34,20316,10256,10060,3389,1452,1937,16927,8804,8123
113980,34,12530,5656,6874,4066,1916,2150,8464,3740,4724
114266,34,5443,2387,3056,1232,586,646,4211,1801,2410
114354,34,1431,260,1171,1049,183,866,382,77,305
114433,34,952,554,398,312,156,156,640,398,242
114460,34,241,29,212,156,18,138,85,11,74
114637,34,76,5,71,76,5,71,,,
114716,34,8502,4597,3905,2459,1190,1269,6043,3407,2636
114761,34,55,8,47,55,8,47,,,
114789,34,15162,6778,8384,3776,1589,2187,11386,5189,6197
114813,34,1586,425,1161,754,244,510,832,181,651
114859,34,13027,5975,7052,4525,2218,2307,8502,3757,4745
114938,34,3042,1460,1582,930,428,502,2112,1032,1080
114947,34,111,47,64,111,47,64,,,
115001,34,7602,3342,4260,3830,1753,2077,3772,1589,2183
115010,34,548,126,422,548,126,422,,,
115083,34,601,418,183,416,324,92,185,94,91
115126,34,6956,3100,3856,1883,899,984,5073,2201,2872
115296,34,8644,3441,5203,2389,1035,1354,6255,2406,3849
115357,34,136,41,95,73,29,44,63,12,51
115393,34,5790,2669,3121,2081,920,1161,3709,1749,1960
115409,34,669,342,327,669,342,327,,,
115658,34,87,8,79,36,4,32,51,4,47
115728,34,427,156,271,338,128,210,89,28,61
115755,34,4412,1896,2516,3734,1582,2152,678,314,364
115773,34,153,27,126,68,15,53,85,12,73
115861,34,5298,2227,3071,2231,908,1323,3067,1319,1748
115931,34,478,385,93,478,385,93,,,
116226,34,96,6,90,37,4,33,59,2,57
116350,34,96,10,86,95,10,85,1,0,1
116439,34,6264,3215,3049,2196,1224,972,4068,1991,2077
116563,34,149,5,144,149,5,144,,,
116846,34,15,1,14,14,1,13,1,0,1
117052,34,3867,1706,2161,1156,615,541,2711,1091,1620
117104,34,321,149,172,273,123,150,48,26,22
117140,34,2701,1084,1617,2132,856,1276,569,228,341
117168,34,613,156,457,532,133,399,81,23,58
117195,34,1717,1057,660,377,188,189,1340,869,471
117238,34,33,1,32,33,1,32,,,
117247,34,5551,2398,3153,1127,556,571,4424,1842,2582
117274,34,1145,821,324,257,128,129,888,693,195
117283,34,37,17,20,22,9,13,15,8,7
117557,34,88,62,26,84,59,25,4,3,1
117575,34,27,17,10,2,1,1,25,16,9
117627,34,887,368,519,831,346,485,56,22,34
117636,34,910,249,661,783,207,576,127,42,85
117645,34,16517,6954,9563,5702,2405,3297,10815,4549,6266
117672,34,111,15,96,93,13,80,18,2,16
117690,34,4721,1799,2922,889,381,508,3832,1418,2414
117706,34,10158,4356,5802,2625,1191,1434,7533,3165,4368
117715,34,3058,854,2204,352,117,235,2706,737,1969
117724,34,6634,3647,2987,1538,921,617,5096,2726,2370
117733,34,9653,3934,5719,1868,850,1018,7785,3084,4701
117751,34,1169,638,531,842,406,436,327,232,95
117788,34,8965,3773,5192,1916,857,1059,7049,2916,4133
117803,34,195,52,143,,,,195,52,143
117867,34,5808,2191,3617,1059,424,635,4749,1767,2982
117894,34,5222,2192,3030,1643,743,900,3579,1449,2130
117946,34,5530,2618,2912,5385,2539,2846,145,79,66
117955,34,221,51,170,162,33,129,59,18,41
118134,34,70,4,66,24,4,20,46,0,46
118143,34,82,3,79,19,2,17,63,1,62
118161,34,112,2,110,112,2,110,,,
118198,34,767,146,621,767,146,621,,,
118347,34,2939,1202,1737,811,408,403,2128,794,1334
118684,34,1990,617,1373,548,197,351,1442,420,1022
118693,34,583,344,239,561,333,228,22,11,11
118718,34,6524,2439,4085,2988,1078,1910,3536,1361,2175
118772,34,4133,1388,2745,793,336,457,3340,1052,2288
118912,34,8108,3219,4889,2792,1234,1558,5316,1985,3331
118930,34,3872,1697,2175,894,440,454,2978,1257,1721
118958,34,54,23,31,15,6,9,39,17,22
118976,34,12557,4633,7924,6225,2489,3736,6332,2144,4188
118994,34,377,224,153,377,224,153,,,
119058,34,13,4,9,12,4,8,1,0,1
119067,34,4516,1945,2571,1516,702,814,3000,1243,1757
119137,34,8454,3813,4641,2676,1301,1375,5778,2512,3266
119164,34,18710,8678,10032,6143,3057,3086,12567,5621,6946
119173,34,1398,98,1300,1172,74,1098,226,24,202
119216,34,9813,3649,6164,3487,1410,2077,6326,2239,4087
119270,34,647,491,156,451,342,109,196,149,47
119331,34,2552,979,1573,907,385,522,1645,594,1051
119553,34,920,254,666,902,251,651,18,3,15
119605,34,7919,3780,4139,4283,1997,2286,3636,1783,1853
119775,34,217,128,89,187,108,79,30,20,10
119951,34,124,13,111,124,13,111,,,
120069,34,287,45,242,287,45,242,,,
120078,34,513,85,428,513,85,428,,,
120087,34,183,26,157,183,26,157,,,
120166,34,8,5,3,8,5,3,,,
120254,34,1404,589,815,1382,576,806,22,13,9
120290,34,4928,2425,2503,1834,940,894,3094,1485,1609
120342,34,11538,5721,5817,3825,2018,1807,7713,3703,4010
120403,34,950,292,658,918,280,638,32,12,20
120421,34,4407,1936,2471,984,430,554,3423,1506,1917
120537,34,500,220,280,415,180,235,85,40,45
120661,34,550,141,409,524,140,384,26,1,25
120698,34,32,3,29,29,3,26,3,0,3
120768,34,395,30,365,,,,395,30,365
120838,34,5,1,4,5,1,4,,,
120865,34,660,236,424,563,214,349,97,22,75
120883,34,2419,1117,1302,2335,1081,1254,84,36,48
120953,34,3420,3022,398,428,312,116,2992,2710,282
120971,34,11858,6142,5716,3614,1798,1816,8244,4344,3900
121044,34,15152,6750,8402,4921,2386,2535,10231,4364,5867
121150,34,2714,1162,1552,2509,1079,1430,205,83,122
121257,34,903,362,541,870,350,520,33,12,21
121275,34,51,35,16,51,35,16,,,
121309,34,2459,847,1612,2040,719,1321,419,128,291
121345,34,1287,595,692,1287,595,692,,,
121363,34,2220,746,1474,908,360,548,1312,386,926
121433,34,102,5,97,101,5,96,1,0,1
121619,34,16898,9985,6913,2598,1249,1349,14300,8736,5564
121637,34,100,10,90,94,10,84,6,0,6
121691,34,1788,738,1050,1546,622,924,242,116,126
121707,34,2589,1220,1369,875,437,438,1714,783,931
121859,34,191,22,169,108,22,86,83,0,83
121868,34,183,2,181,91,0,91,92,2,90
121886,34,11460,6730,4730,2515,1252,1263,8945,5478,3467
121901,34,12520,4921,7599,2988,1294,1694,9532,3627,5905
122117,34,2,1,1,2,1,1,,,
122180,34,13366,5179,8187,2883,1181,1702,10483,3998,6485
122205,34,11847,5098,6749,3669,1827,1842,8178,3271,4907
122296,34,674,139,535,587,129,458,87,10,77
122339,34,8247,3651,4596,1084,494,590,7163,3157,4006
122375,34,12493,5374,7119,2426,1153,1273,10067,4221,5846
122384,34,9035,4960,4075,1122,716,406,7913,4244,3669
122409,34,25237,11084,14153,21919,9443,12476,3318,1641,1677
122436,34,4335,1946,2389,4223,1893,2330,112,53,59
122506,34,175,107,68,175,107,68,,,
122597,34,17696,7968,9728,13924,6147,7777,3772,1821,1951
122612,34,4425,1595,2830,4245,1522,2723,180,73,107
122658,34,9796,3820,5976,4754,2009,2745,5042,1811,3231
122685,34,1909,489,1420,1909,489,1420,,,
122694,34,697,213,484,697,213,484,,,
122728,34,963,394,569,745,310,435,218,84,134
122746,34,4960,1957,3003,1007,430,577,3953,1527,2426
122755,34,22698,11817,10881,17649,9139,8510,5049,2678,2371
122791,34,4732,2338,2394,1120,628,492,3612,1710,1902
122889,34,7797,3237,4560,3687,1655,2032,4110,1582,2528
122931,34,4462,2362,2100,4351,2289,2062,111,73,38
122977,34,15608,6798,8810,5458,2532,2926,10150,4266,5884
123013,34,11523,5073,6450,3430,1625,1805,8093,3448,4645
123165,34,813,0,813,811,0,811,2,0,2
123217,34,8054,3282,4772,3129,1332,1797,4925,1950,2975
123280,34,21,9,12,7,3,4,14,6,8
123299,34,4110,1461,2649,1957,707,1250,2153,754,1399
123341,34,10022,4388,5634,3880,1816,2064,6142,2572,3570
123350,34,115,26,89,93,25,68,22,1,21
123457,34,595,230,365,534,205,329,61,25,36
123484,34,714,359,355,363,194,169,351,165,186
123493,34,43,8,35,43,8,35,,,
123509,34,5057,2333,2724,1162,585,577,3895,1748,2147
123527,34,7611,2887,4724,1824,751,1073,5787,2136,3651
123554,34,1549,666,883,1468,637,831,81,29,52
123563,34,5711,2405,3306,1621,642,979,4090,1763,2327
123572,34,4925,1846,3079,4118,1500,2618,807,346,461
123642,34,232,19,213,144,13,131,88,6,82
123651,34,1460,483,977,1291,430,861,169,53,116
123679,34,634,185,449,556,172,384,78,13,65
123800,34,11579,5080,6499,4456,1949,2507,7123,3131,3992
123952,34,217,131,86,195,118,77,22,13,9
123961,34,17085,8245,8840,16639,7990,8649,446,255,191
124113,34,2704,1438,1266,567,177,390,2137,1261,876
124292,34,377,182,195,377,182,195,,,
124487,34,73,29,44,11,5,6,62,24,38
124681,34,907,363,544,907,363,544,,,
124706,34,616,137,479,616,137,479,,,
124937,34,525,180,345,467,171,296,58,9,49
125028,34,7321,3059,4262,1945,918,1027,5376,2141,3235
125082,34,73,12,61,70,10,60,3,2,1
125091,34,7748,2920,4828,2476,989,1487,5272,1931,3341
125170,34,3215,1363,1852,573,281,292,2642,1082,1560
125231,34,6201,944,5257,1527,193,1334,4674,751,3923
125310,34,34,12,22,34,12,22,,,
125462,34,1479,703,776,308,154,154,1171,549,622
125471,34,5900,2352,3548,1138,485,653,4762,1867,2895
125499,34,4249,1784,2465,1280,598,682,2969,1186,1783
125532,34,1583,157,1426,1583,157,1426,,,
125727,34,969,389,580,961,383,578,8,6,2
125763,34,875,360,515,844,349,495,31,11,20
125897,34,751,361,390,685,329,356,66,32,34
126076,34,73,73,0,73,73,0,,,
126119,34,3421,1220,2201,923,371,552,2498,849,1649
126182,34,1001,564,437,760,414,346,241,150,91
126207,34,2388,979,1409,959,442,517,1429,537,892
126289,34,4315,1591,2724,1208,541,667,3107,1050,2057
126359,34,167,15,152,167,15,152,,,
126562,34,9246,4103,5143,6843,3040,3803,2403,1063,1340
126580,34,7439,3405,4034,5672,2607,3065,1767,798,969
126605,34,234,206,28,234,206,28,,,
126614,34,23496,12918,10578,21627,11764,9863,1869,1154,715
126669,34,4573,1309,3264,1375,478,897,3198,831,2367
126678,34,1640,737,903,1605,721,884,35,16,19
126687,34,637,116,521,637,116,521,,,
126711,34,2294,839,1455,934,415,519,1360,424,936
126748,34,387,127,260,236,96,140,151,31,120
126775,34,4150,2812,1338,3894,2642,1252,256,170,86
126784,34,112,110,2,112,110,2,,,
126818,34,19613,9028,10585,16855,7681,9174,2758,1347,1411
126827,34,21228,7224,14004,12939,4473,8466,8289,2751,5538
126863,34,2564,999,1565,689,357,332,1875,642,1233
126915,34,17,7,10,11,6,5,6,1,5
126942,34,3790,1360,2430,1212,452,760,2578,908,1670
126951,34,817,740,77,817,740,77,,,
127060,34,4348,1944,2404,4040,1788,2252,308,156,152
127158,34,3361,2981,380,1104,884,220,2257,2097,160
127185,34,2264,1042,1222,2023,940,1083,241,102,139
127200,34,8665,3593,5072,2662,1294,1368,6003,2299,3704
127316,34,252,41,211,71,19,52,181,22,159
127389,34,221,97,124,148,75,73,73,22,51
127556,34,5902,2706,3196,4786,2181,2605,1116,525,591
127565,34,12750,5645,7105,7631,3456,4175,5119,2189,2930
127617,34,457,130,327,167,47,120,290,83,207
127653,34,308,87,221,278,72,206,30,15,15
127714,34,304,136,168,20,6,14,284,130,154
127732,34,533,198,335,356,161,195,177,37,140
127741,34,4833,1586,3247,4185,1390,2795,648,196,452
127778,34,445,174,271,287,125,162,158,49,109
127820,34,7132,2735,4397,2530,1084,1446,4602,1651,2951
127884,34,2785,812,1973,983,363,620,1802,449,1353
127909,34,3226,1596,1630,1130,627,503,2096,969,1127
127918,34,1811,629,1182,1346,436,910,465,193,272
127945,34,1823,470,1353,1000,268,732,823,202,621
127954,34,2,0,2,2,0,2,,,
128106,34,2355,1090,1265,1851,834,1017,504,256,248
128151,34,234,132,102,204,128,76,30,4,26
128179,34,599,423,176,599,423,176,,,
128188,34,963,359,604,963,359,604,,,
128258,34,749,334,415,353,183,170,396,151,245
128328,34,3031,2140,891,3031,2140,891,,,
128337,34,46,1,45,26,1,25,20,0,20
128391,34,1234,722,512,1119,654,465,115,68,47
128498,34,816,319,497,713,281,432,103,38,65
128577,34,657,289,368,228,119,109,429,170,259
128586,34,31,31,0,31,31,0,,,
128744,34,1321,374,947,1059,330,729,262,44,218
128771,34,6244,3390,2854,4842,2644,2198,1402,746,656
128780,34,1409,341,1068,395,87,308,1014,254,760
128896,34,93,10,83,93,10,83,,,
128902,34,1285,500,785,1285,500,785,,,
129002,34,333,190,143,309,183,126,24,7,17
129020,34,14699,7117,7582,14258,6865,7393,441,252,189
129154,34,2417,290,2127,265,72,193,2152,218,1934
129181,34,632,588,44,561,526,35,71,62,9
129215,34,2818,1198,1620,2563,1080,1483,255,118,137
129242,34,3378,1426,1952,3331,1404,1927,47,22,25
129349,34,148,5,143,116,5,111,32,0,32
129367,34,1736,434,1302,329,103,226,1407,331,1076
129482,34,280,19,261,280,19,261,,,
129525,34,2728,1221,1507,2541,1146,1395,187,75,112
129534,34,179,84,95,83,43,40,96,41,55
129543,34,2196,776,1420,689,268,421,1507,508,999
129695,34,2752,1149,1603,923,412,511,1829,737,1092
129729,34,3095,1129,1966,935,417,518,2160,712,1448
129756,34,1225,482,743,420,201,219,805,281,524
129774,34,380,205,175,365,198,167,15,7,8
129808,34,1965,638,1327,542,235,307,1423,403,1020
129923,34,476,221,255,304,136,168,172,85,87
129932,34,28,26,2,7,5,2,21,21,0
129941,34,3523,1548,1975,3260,1397,1863,263,151,112
130004,34,2687,1077,1610,794,377,417,1893,700,1193
130040,34,678,223,455,233,98,135,445,125,320
130110,34,157,54,103,112,41,71,45,13,32
130174,34,1664,937,727,1185,682,503,479,255,224
130183,34,13031,3222,9809,5246,1235,4011,7785,1987,5798
130217,34,701,256,445,191,74,117,510,182,328
130226,34,4416,1680,2736,4242,1604,2638,174,76,98
130253,34,4954,1655,3299,4503,1514,2989,451,141,310
130314,34,632,157,475,598,150,448,34,7,27
130396,34,3923,1388,2535,1053,471,582,2870,917,1953
130493,34,5140,1960,3180,4231,1630,2601,909,330,579
130590,34,1576,787,789,1549,772,777,27,15,12
130606,34,2215,905,1310,818,338,480,1397,567,830
130624,34,748,445,303,748,445,303,,,
130697,34,2263,1025,1238,2257,1022,1235,6,3,3
130776,34,3050,1445,1605,2551,1214,1337,499,231,268
130794,34,5085,2495,2590,5034,2461,2573,51,34,17
130837,34,51,3,48,51,3,48,,,
130873,34,3,0,3,3,0,3,,,
130907,34,7757,2267,5490,2166,837,1329,5591,1430,4161
130934,34,3157,1142,2015,2751,952,1799,406,190,216
130943,34,13759,5775,7984,13128,5456,7672,631,319,312
130989,34,514,254,260,435,223,212,79,31,48
131061,34,96,5,91,54,4,50,42,1,41
131113,34,7436,2780,4656,2527,1064,1463,4909,1716,3193
131159,34,5910,2171,3739,5659,2061,3598,251,110,141
131283,34,2193,916,1277,2023,873,1150,170,43,127
131399,34,2426,853,1573,1028,451,577,1398,402,996
131450,34,749,352,397,691,326,365,58,26,32
131469,34,7857,2907,4950,7295,2683,4612,562,224,338
131496,34,5767,2459,3308,5575,2370,3205,192,89,103
131520,34,6750,1896,4854,6530,1793,4737,220,103,117
131803,34,306,70,236,25,12,13,281,58,223
131830,34,18,8,10,18,8,10,,,
131876,34,1212,31,1181,761,10,751,451,21,430
132374,34,1652,1444,208,1652,1444,208,,,
132408,34,229,118,111,143,67,76,86,51,35
132471,34,1943,695,1248,1654,581,1073,289,114,175
132602,34,1663,645,1018,1574,613,961,89,32,57
132657,34,1985,981,1004,1826,905,921,159,76,83
132675,34,15,9,6,14,8,6,1,1,0
132693,34,7869,3118,4751,2545,1170,1375,5324,1948,3376
132709,34,19321,7602,11719,5105,2302,2803,14216,5300,8916
132842,34,207,32,175,96,13,83,111,19,92
132851,34,3358,1164,2194,1229,483,746,2129,681,1448
132879,34,121,74,47,113,68,45,8,6,2
132903,34,50363,22531,27832,33607,15036,18571,16756,7495,9261
132976,34,86,36,50,86,36,50,,,
133021,34,856,305,551,405,165,240,451,140,311
133155,34,296,139,157,146,89,57,150,50,100
133386,34,7311,2839,4472,2907,1353,1554,4404,1486,2918
133465,34,295,60,235,233,44,189,62,16,46
133492,34,1442,449,993,1386,427,959,56,22,34
133508,34,7749,2692,5057,2333,911,1422,5416,1781,3635
133526,34,822,423,399,745,387,358,77,36,41
133553,34,5316,3990,1326,5005,3734,1271,311,256,55
133650,34,5897,2025,3872,5128,1778,3350,769,247,522
133669,34,18703,8020,10683,12562,5428,7134,6141,2592,3549
133702,34,14453,4937,9516,4178,1609,2569,10275,3328,6947
133711,34,1830,618,1212,1763,594,1169,67,24,43
133809,34,378,181,197,370,180,190,8,1,7
133845,34,493,46,447,459,45,414,34,1,33
133854,34,259,58,201,259,58,201,,,
133863,34,356,51,305,356,51,305,,,
133872,34,841,138,703,303,55,248,538,83,455
133881,34,2336,1632,704,2190,1516,674,146,116,30
133951,34,34853,15315,19538,22243,9512,12731,12610,5803,6807
133960,34,704,291,413,266,144,122,438,147,291
133979,34,633,322,311,584,293,291,49,29,20
133997,34,270,90,180,270,90,180,,,
134024,34,48,10,38,48,10,38,,,
134079,34,1948,737,1211,1867,705,1162,81,32,49
134097,34,26661,11590,15071,23553,10079,13474,3108,1511,1597
134130,34,27061,12000,15061,24096,10444,13652,2965,1556,1409
134228,34,3,0,3,2,0,2,1,0,1
134237,34,20250,13934,6316,20250,13934,6316,,,
134291,34,110,82,28,96,69,27,14,13,1
134307,34,673,629,44,181,175,6,492,454,38
134343,34,2650,894,1756,1088,397,691,1562,497,1065
134422,34,15,0,15,5,0,5,10,0,10
134495,34,14610,5959,8651,5768,2723,3045,8842,3236,5606
134510,34,114,50,64,54,20,34,60,30,30
134529,34,200,21,179,200,21,179,,,
134574,34,88,16,72,88,16,72,,,
134608,34,8322,3121,5201,2485,1097,1388,5837,2024,3813
134714,34,242,32,210,90,18,72,152,14,138
134811,34,761,224,537,523,141,382,238,83,155
134945,34,1836,690,1146,1635,632,1003,201,58,143
135081,34,14836,4149,10687,8504,2641,5863,6332,1508,4824
135142,34,132,2,130,7,0,7,125,2,123
135160,34,1519,442,1077,529,159,370,990,283,707
135179,34,445,276,169,265,168,97,180,108,72
135188,34,2321,825,1496,725,274,451,1596,551,1045
135267,34,159,119,40,155,118,37,4,1,3
135276,34,122,78,44,107,65,42,15,13,2
135294,34,306,148,158,243,146,97,63,2,61
135337,34,67,6,61,15,4,11,52,2,50
135364,34,195,131,64,20,14,6,175,117,58
135391,34,5417,1883,3534,1813,732,1081,3604,1151,2453
135407,34,146,88,58,145,87,58,1,1,0
135522,34,96,36,60,96,36,60,,,
135559,34,43,6,37,24,5,19,19,1,18
135610,34,64,31,33,32,14,18,32,17,15
135647,34,542,476,66,419,383,36,123,93,30
135717,34,30054,12261,17793,11180,4630,6550,18874,7631,11243
135726,34,9844,4552,5292,9470,4369,5101,374,183,191
135735,34,954,883,71,216,193,23,738,690,48
136109,34,95,1,94,51,1,50,44,0,44
136145,34,548,118,430,170,35,135,378,83,295
136172,34,10733,4651,6082,7714,3286,4428,3019,1365,1654
136215,34,4907,1330,3577,4258,1213,3045,649,117,532
136233,34,2480,941,1539,1061,445,616,1419,496,923
136303,34,9,1,8,9,1,8,,,
136330,34,1688,575,1113,1585,538,1047,103,37,66
136358,34,15798,6099,9699,4637,2129,2508,11161,3970,7191
136400,34,4782,1889,2893,1625,705,920,3157,1184,1973
136473,34,4940,1631,3309,1915,696,1219,3025,935,2090
136491,34,440,243,197,344,219,125,96,24,72
136516,34,5219,1707,3512,1707,595,1112,3512,1112,2400
136659,34,117,91,26,98,76,22,19,15,4
136765,34,3,1,2,1,0,1,2,1,1
136774,34,1289,364,925,1265,358,907,24,6,18
136826,34,474,303,171,326,215,111,148,88,60
136950,34,1935,784,1151,1855,751,1104,80,33,47
137023,34,55,25,30,51,22,29,4,3,1
137032,34,5848,2285,3563,3074,1149,1925,2774,1136,1638
137078,34,15917,5731,10186,4639,1994,2645,11278,3737,7541
137087,34,409,217,192,387,212,175,22,5,17
137096,34,8467,3868,4599,3388,1707,1681,5079,2161,2918
137120,34,557,379,178,44,40,4,513,339,174
137209,34,9661,4044,5617,2950,1408,1542,6711,2636,4075
137245,34,658,356,302,658,356,302,,,
137272,34,34,32,2,34,32,2,,,
137281,34,2824,948,1876,831,333,498,1993,615,1378
137315,34,1541,470,1071,587,220,367,954,250,704
137351,34,29963,13078,16885,23026,9907,13119,6937,3171,3766
137476,34,1361,678,683,1155,631,524,206,47,159
137546,34,1851,819,1032,1804,789,1015,47,30,17
137564,34,3799,1509,2290,3191,1233,1958,608,276,332
137591,34,157,39,118,100,31,69,57,8,49
137713,34,35,11,24,29,10,19,6,1,5
137759,34,6704,2852,3852,3266,1513,1753,3438,1339,2099
137777,34,25,25,0,25,25,0,,,
137801,34,211,108,103,211,108,103,,,
137847,34,7715,3057,4658,7480,2948,4532,235,109,126
137856,34,81,39,42,69,36,33,12,3,9
137865,34,239,127,112,239,127,112,,,
137953,34,227,126,101,126,78,48,101,48,53
137962,34,141,83,58,112,71,41,29,12,17
138187,34,26625,10653,15972,8431,3669,4762,18194,6984,11210
138275,34,498,248,250,451,226,225,47,22,25
138284,34,25,11,14,21,7,14,4,4,0
138293,34,814,553,261,619,420,199,195,133,62
138309,34,7485,1013,6472,3777,537,3240,3708,476,3232
138354,34,7623,3146,4477,5154,2185,2969,2469,961,1508
138372,34,325,202,123,135,32,103,190,170,20
138479,34,270,169,101,270,169,101,,,
138488,34,103,30,73,78,14,64,25,16,9
138497,34,161,98,63,161,98,63,,,
138558,34,2304,922,1382,1563,730,833,741,192,549
138600,34,647,0,647,645,0,645,2,0,2
138655,34,394,262,132,375,251,124,19,11,8
138664,34,54,19,35,54,19,35,,,
138682,34,1823,470,1353,721,193,528,1102,277,825
138716,34,4262,1076,3186,2870,810,2060,1392,266,1126
138761,34,153,53,100,96,48,48,57,5,52
138813,34,396,177,219,256,121,135,140,56,84
138822,34,509,18,491,509,18,491,,,
138840,34,2450,825,1625,749,339,410,1701,486,1215
138868,34,779,365,414,545,280,265,234,85,149
138901,34,1044,328,716,407,132,275,637,196,441
138938,34,304,24,280,173,7,166,131,17,114
138947,34,2262,555,1707,2136,509,1627,126,46,80
138956,34,2861,1145,1716,1015,430,585,1846,715,1131
139144,34,1598,572,1026,1585,565,1020,13,7,6
139153,34,127,67,60,68,38,30,59,29,30
139199,34,947,64,883,637,40,597,310,24,286
139205,34,431,271,160,360,208,152,71,63,8
139250,34,2061,617,1444,1181,364,817,880,253,627
139278,34,3654,1080,2574,1016,371,645,2638,709,1929
139311,34,3961,1147,2814,2416,711,1705,1545,436,1109
139357,34,2178,598,1580,661,200,461,1517,398,1119
139366,34,4608,1912,2696,3158,1242,1916,1450,670,780
139384,34,3256,1079,2177,1117,417,700,2139,662,1477
139393,34,569,268,301,561,263,298,8,5,3
139463,34,3349,1261,2088,1944,752,1192,1405,509,896
139506,34,48,23,25,48,23,25,,,
139579,34,173,44,129,141,35,106,32,9,23
139621,34,817,371,446,553,259,294,264,112,152
139630,34,542,305,237,516,290,226,26,15,11
139658,34,5593,2370,3223,5525,2337,3188,68,33,35
139700,34,3429,1176,2253,1232,490,742,2197,686,1511
139719,34,1795,660,1135,1548,581,967,247,79,168
139746,34,61,12,49,61,12,49,,,
139755,34,13732,8348,5384,12480,7584,4896,1252,764,488
139764,34,1607,553,1054,1109,393,716,498,160,338
139861,34,3821,1340,2481,3408,1182,2226,413,158,255
139931,34,16639,7059,9580,13576,5747,7829,3063,1312,1751
139940,34,22960,9082,13878,16279,6388,9891,6681,2694,3987
139959,34,24293,10457,13836,22508,9583,12925,1785,874,911
139968,34,1812,537,1275,996,333,663,816,204,612
139986,34,3138,791,2347,947,261,686,2191,530,1661
139995,34,298,112,186,144,54,90,154,58,96
140003,34,94,13,81,45,5,40,49,8,41
140012,34,5634,2275,3359,1243,625,618,4391,1650,2741
140234,34,377,198,179,365,195,170,12,3,9
140243,34,3114,1191,1923,822,321,501,2292,870,1422
140252,34,742,357,385,603,310,293,139,47,92
140331,34,5684,2341,3343,1723,795,928,3961,1546,2415
140340,34,555,77,478,278,47,231,277,30,247
140447,34,3641,1234,2407,3161,1126,2035,480,108,372
140553,34,1890,1889,1,1512,1512,0,378,377,1
140571,34,171,74,97,116,46,70,55,28,27
140678,34,1440,542,898,544,228,316,896,314,582
140696,34,1001,372,629,966,357,609,35,15,20
140720,34,209,94,115,189,88,101,20,6,14
140818,34,911,270,641,831,253,578,80,17,63
140827,34,66,17,49,66,17,49,,,
140872,34,739,372,367,657,342,315,82,30,52
140942,34,2588,842,1746,846,356,490,1742,486,1256
140951,34,9883,3031,6852,8105,2477,5628,1778,554,1224
140960,34,2060,795,1265,1745,683,1062,315,112,203
140988,34,854,380,474,790,363,427,64,17,47
141006,34,1115,495,620,567,280,287,548,215,333
141015,34,37,16,21,36,15,21,1,1,0
141060,34,2521,168,2353,1748,0,1748,773,168,605
141167,34,625,279,346,407,185,222,218,94,124
141185,34,597,238,359,538,217,321,59,21,38
141237,34,611,286,325,568,260,308,43,26,17
141255,34,2074,624,1450,659,169,490,1415,455,960
141264,34,6150,2011,4139,4602,1534,3068,1548,477,1071
141325,34,388,1,387,291,0,291,97,1,96
141334,34,6516,2294,4222,4874,1738,3136,1642,556,1086
141361,34,584,267,317,580,266,314,4,1,3
141486,34,1202,309,893,1004,253,751,198,56,142
141565,34,1989,724,1265,1477,554,923,512,170,342
141574,34,10809,4349,6460,8422,3314,5108,2387,1035,1352
141608,34,45,33,12,45,33,12,,,
141644,34,2068,744,1324,1633,525,1108,435,219,216
141680,34,1440,923,517,554,387,167,886,536,350
141796,34,2954,998,1956,1022,399,623,1932,599,1333
141802,34,539,163,376,135,54,81,404,109,295
141811,34,2796,1072,1724,1122,493,629,1674,579,1095
141839,34,1233,381,852,369,133,236,864,248,616
141981,34,2275,772,1503,1312,447,865,963,325,638
141990,34,709,232,477,276,75,201,433,157,276
142054,34,350,48,302,350,48,302,,,
142090,34,67,38,29,54,31,23,13,7,6
142115,34,13805,6015,7790,10338,4548,5790,3467,1467,2000
142179,34,972,328,644,405,171,234,567,157,410
142276,34,5432,2159,3273,4045,1593,2452,1387,566,821
142285,34,5169,2561,2608,4719,2329,2390,450,232,218
142294,34,783,399,384,775,394,381,8,5,3
142328,34,1848,639,1209,1383,505,878,465,134,331
142407,34,78,12,66,78,12,66,,,
142443,34,2000,685,1315,844,368,476,1156,317,839
142461,34,876,374,502,768,339,429,108,35,73
142489,34,53,7,46,53,7,46,,,
142522,34,37833,16726,21107,12914,6334,6580,24919,10392,14527
142559,34,2527,802,1725,1084,415,669,1443,387,1056
142832,34,9,9,0,,,,9,9,0
142887,34,77,32,45,60,23,37,17,9,8
142957,34,4,2,2,,,,4,2,2
143048,34,2168,563,1605,1946,497,1449,222,66,156
143084,34,1681,762,919,1666,753,913,15,9,6
143118,34,3315,1067,2248,2994,983,2011,321,84,237
143215,34,4077,1656,2421,1621,688,933,2456,968,1488
143279,34,1560,506,1054,681,271,410,879,235,644
143288,34,236,99,137,231,98,133,5,1,4
143297,34,151,18,133,121,13,108,30,5,25
143358,34,3097,1564,1533,2990,1496,1494,107,68,39
143376,34,226,10,216,153,10,143,73,0,73
143464,34,90,4,86,81,4,77,9,0,9
143473,34,26,2,24,7,1,6,19,1,18
143482,34,21,0,21,10,0,10,11,0,11
143491,34,24,0,24,8,0,8,16,0,16
143552,34,44,1,43,16,0,16,28,1,27
143613,34,837,245,592,467,168,299,370,77,293
143978,34,34,7,27,17,3,14,17,4,13
144005,34,1191,373,818,781,270,511,410,103,307
144050,34,5782,3053,2729,5778,3050,2728,4,3,1
144157,34,1005,407,598,383,185,198,622,222,400
144166,34,4375,851,3524,1539,362,1177,2836,489,2347
144175,34,901,342,559,357,165,192,544,177,367
144184,34,1709,633,1076,624,247,377,1085,386,699
144193,34,1565,826,739,664,439,225,901,387,514
144209,34,3190,1263,1927,1342,568,774,1848,695,1153
144218,34,3224,1499,1725,1200,627,573,2024,872,1152
144281,34,4772,1904,2868,4498,1785,2713,274,119,155
144351,34,1018,438,580,890,387,503,128,51,77
144564,34,889,328,561,474,168,306,415,160,255
144573,34,108,2,106,75,0,75,33,2,31
144740,34,11000,5089,5911,9898,4535,5363,1102,554,548
144795,34,257,57,200,232,53,179,25,4,21
144865,34,11111,5065,6046,4209,2095,2114,6902,2970,3932
144883,34,288,139,149,288,139,149,,,
144892,34,3710,1432,2278,3140,1252,1888,570,180,390
144944,34,5042,2270,2772,1695,844,851,3347,1426,1921
144962,34,2280,855,1425,2207,813,1394,73,42,31
144971,34,393,219,174,373,213,160,20,6,14
145099,34,201,11,190,201,11,190,,,
145239,34,237,33,204,237,33,204,,,
145309,34,22,6,16,22,6,16,,,
145336,34,2273,814,1459,1341,487,854,932,327,605
145354,34,41,2,39,6,0,6,35,2,33
145372,34,672,360,312,601,335,266,71,25,46
145406,34,375,7,368,110,5,105,265,2,263
145424,34,50,0,50,17,0,17,33,0,33
145433,34,86,1,85,36,1,35,50,0,50
145497,34,70,15,55,49,11,38,21,4,17
145521,34,528,172,356,253,90,163,275,82,193
145600,34,17323,8159,9164,15386,7223,8163,1937,936,1001
145619,34,1601,824,777,1370,735,635,231,89,142
145637,34,26074,14076,11998,25327,13567,11760,747,509,238
145646,34,1136,561,575,1130,558,572,6,3,3
145682,34,3318,1215,2103,1090,518,572,2228,697,1531
145691,34,778,354,424,751,345,406,27,9,18
145707,34,346,135,211,222,104,118,124,31,93
145725,34,2257,1535,722,2080,1392,688,177,143,34
145813,34,14036,6136,7900,12979,5594,7385,1057,542,515
145831,34,1184,494,690,462,207,255,722,287,435
146205,34,1422,550,872,777,323,454,645,227,418
146278,34,832,281,551,401,157,244,431,124,307
146296,34,7843,3360,4483,3201,1466,1735,4642,1894,2748
146339,34,606,290,316,556,277,279,50,13,37
146348,34,1377,497,880,534,226,308,843,271,572
146366,34,1295,428,867,683,239,444,612,189,423
146418,34,1226,497,729,544,253,291,682,244,438
146427,34,802,330,472,798,329,469,4,1,3
146454,34,10,0,10,10,0,10,,,
146472,34,6954,3054,3900,2147,1117,1030,4807,1937,2870
146481,34,1279,527,752,1238,512,726,41,15,26
146506,34,1685,619,1066,1063,402,661,622,217,405
146533,34,116,22,94,85,19,66,31,3,28
146603,34,1707,634,1073,790,347,443,917,287,630
146612,34,3045,1551,1494,2521,1260,1261,524,291,233
146667,34,83,49,34,49,30,19,34,19,15
146685,34,2739,991,1748,930,436,494,1809,555,1254
146700,34,850,677,173,850,677,173,,,
146719,34,8527,2709,5818,8089,2548,5541,438,161,277
146755,34,81,11,70,65,10,55,16,1,15
146807,34,56,7,49,17,2,15,39,5,34
146816,34,261,27,234,214,18,196,47,9,38
147004,34,3580,1599,1981,1530,732,798,2050,867,1183
147013,34,1066,503,563,950,467,483,116,36,80
147129,34,423,39,384,207,18,189,216,21,195
147244,34,1241,537,704,1189,524,665,52,13,39
147341,34,530,260,270,515,253,262,15,7,8
147369,34,1552,786,766,1231,596,635,321,190,131
147378,34,5348,2381,2967,2347,1083,1264,3001,1298,1703
147396,34,42,36,6,41,35,6,1,1,0
147411,34,1850,755,1095,629,294,335,1221,461,760
147536,34,3064,747,2317,2006,564,1442,1058,183,875
147590,34,30,9,21,17,6,11,13,3,10
147642,34,42,5,37,4,0,4,38,5,33
147660,34,1821,880,941,1776,858,918,45,22,23
147679,34,1370,569,801,1251,525,726,119,44,75
147703,34,8968,4254,4714,7548,3534,4014,1420,720,700
147767,34,6799,3164,3635,6550,3055,3495,249,109,140
147776,34,3542,1452,2090,1988,817,1171,1554,635,919
147800,34,5147,2506,2641,1517,841,676,3630,1665,1965
147819,34,16,1,15,16,1,15,,,
147828,34,1778,766,1012,1710,742,968,68,24,44
147916,34,2287,1057,1230,1096,553,543,1191,504,687
148007,34,1920,674,1246,664,262,402,1256,412,844
148016,34,255,149,106,241,137,104,14,12,2
148098,34,41,1,40,26,1,25,15,0,15
148131,34,723,355,368,686,344,342,37,11,26
148256,34,799,307,492,557,218,339,242,89,153
148292,34,1084,332,752,327,112,215,757,220,537
148380,34,3353,1485,1868,1242,595,647,2111,890,1221
148405,34,740,319,421,699,303,396,41,16,25
148487,34,1954,751,1203,1651,661,990,303,90,213
148496,34,1519,435,1084,1413,410,1003,106,25,81
148511,34,115,25,90,48,9,39,67,16,51
148575,34,244,36,208,195,31,164,49,5,44
148584,34,1174,363,811,961,315,646,213,48,165
148593,34,82,6,76,65,6,59,17,0,17
148627,34,2306,848,1458,2096,769,1327,210,79,131
148654,34,2103,976,1127,1414,623,791,689,353,336
148672,34,730,267,463,341,144,197,389,123,266
148821,34,448,142,306,230,70,160,218,72,146
148876,34,585,96,489,401,66,335,184,30,154
148937,34,410,170,240,274,129,145,136,41,95
148991,34,553,210,343,303,132,171,250,78,172
149028,34,181,18,163,123,15,108,58,3,55
149204,34,24,0,24,24,0,24,,,
149222,34,6404,3259,3145,5210,2566,2644,1194,693,501
149231,34,7417,3172,4245,5866,2524,3342,1551,648,903
149310,34,71,32,39,71,32,39,,,
149329,34,46,46,0,46,46,0,,,
149365,34,1615,496,1119,499,183,316,1116,313,803
149505,34,654,250,404,570,230,340,84,20,64
149514,34,315,198,117,264,168,96,51,30,21
149532,34,4832,2357,2475,1493,661,832,3339,1696,1643
149550,34,120,13,107,81,13,68,39,0,39
149639,34,55,23,32,53,21,32,2,2,0
149727,34,3987,1675,2312,1346,646,700,2641,1029,1612
149763,34,371,85,286,216,56,160,155,29,126
149772,34,4122,1767,2355,3407,1447,1960,715,320,395
149781,34,1637,746,891,1578,720,858,59,26,33
149842,34,6429,2702,3727,2135,1074,1061,4294,1628,2666
150066,34,785,367,418,705,339,366,80,28,52
150136,34,9989,3910,6079,9160,3603,5557,829,307,522
150145,34,867,322,545,774,300,474,93,22,71
150163,34,3104,1240,1864,3049,1206,1843,55,34,21
150172,34,434,269,165,283,163,120,151,106,45
150251,34,184,6,178,92,1,91,92,5,87
150303,34,228,2,226,107,0,107,121,2,119
150400,34,1197,607,590,1190,605,585,7,2,5
150428,34,12,0,12,12,0,12,,,
150455,34,416,189,227,414,187,227,2,2,0
150534,34,1083,412,671,1043,398,645,40,14,26
150604,34,613,331,282,605,324,281,8,7,1
150668,34,538,207,331,502,195,307,36,12,24
150677,34,1013,411,602,976,395,581,37,16,21
150756,34,669,346,323,665,343,322,4,3,1
150765,34,65,2,63,65,2,63,,,
150774,34,236,136,100,226,133,93,10,3,7
150853,34,177,3,174,95,3,92,82,0,82
150941,34,794,295,499,659,244,415,135,51,84
150987,34,39396,16352,23044,10111,3551,6560,29285,12801,16484
151102,34,4272,2167,2105,3345,1702,1643,927,465,462
151111,34,13755,5614,8141,11525,4582,6943,2230,1032,1198
151263,34,2588,976,1612,2387,906,1481,201,70,131
151290,34,897,540,357,850,512,338,47,28,19
151306,34,4240,1543,2697,3600,1319,2281,640,224,416
151324,34,5391,2337,3054,4213,1822,2391,1178,515,663
151333,34,1902,654,1248,1536,520,1016,366,134,232
151342,34,2895,1001,1894,2153,722,1431,742,279,463
151351,34,25665,12946,12719,24828,12461,12367,837,485,352
151360,34,2291,571,1720,1575,397,1178,716,174,542
151379,34,2527,999,1528,1671,651,1020,856,348,508
151388,34,2123,722,1401,1263,365,898,860,357,503
151467,34,135,14,121,135,14,121,,,
151564,34,3,0,3,2,0,2,1,0,1
151607,34,100,2,98,76,2,74,24,0,24
151661,34,641,546,95,641,546,95,,,
151777,34,657,318,339,635,310,325,22,8,14
151786,34,1883,659,1224,1601,607,994,282,52,230
151801,34,1517,546,971,1492,529,963,25,17,8
151810,34,148,49,99,63,20,43,85,29,56
151962,34,300,93,207,233,70,163,67,23,44
152044,34,16,13,3,6,5,1,10,8,2
152080,34,6880,3523,3357,6862,3510,3352,18,13,5
152099,34,476,257,219,444,230,214,32,27,5
152150,34,43,0,43,27,0,27,16,0,16
152275,34,100,35,65,52,2,50,48,33,15
152309,34,72,31,41,61,26,35,11,5,6
152318,34,1556,1156,400,1530,1137,393,26,19,7
152336,34,1206,375,831,1069,356,713,137,19,118
152381,34,601,108,493,512,103,409,89,5,84
152390,34,981,0,981,975,0,975,6,0,6
152497,34,140,12,128,118,11,107,22,1,21
152530,34,1248,569,679,1202,542,660,46,27,19
152567,34,1597,1000,597,1562,975,587,35,25,10
152600,34,1738,748,990,1698,730,968,40,18,22
152628,34,9,0,9,2,0,2,7,0,7
152637,34,2456,1216,1240,1699,864,835,757,352,405
152673,34,577,577,0,576,576,0,1,1,0
152798,34,278,25,253,248,21,227,30,4,26
152992,34,450,198,252,382,190,192,68,8,60
153001,34,1183,376,807,1040,345,695,143,31,112
153074,34,127,4,123,127,4,123,,,
153083,34,118,2,116,118,2,116,,,
153108,34,784,401,383,766,390,376,18,11,7
153126,34,531,285,246,512,274,238,19,11,8
153144,34,861,372,489,855,368,487,6,4,2
153162,34,727,372,355,726,371,355,1,1,0
153214,34,7425,2954,4471,3169,1448,1721,4256,1506,2750
153241,34,68,27,41,56,23,33,12,4,8
153250,34,1028,524,504,1021,520,501,7,4,3
153269,34,2061,820,1241,2008,796,1212,53,24,29
153278,34,1121,651,470,890,563,327,231,88,143
153296,34,309,151,158,271,139,132,38,12,26
153302,34,145,69,76,127,61,66,18,8,10
153311,34,2386,705,1681,1065,369,696,1321,336,985
153320,34,202,104,98,176,89,87,26,15,11
153366,34,658,337,321,616,328,288,42,9,33
153375,34,1194,547,647,1060,497,563,134,50,84
153384,34,1272,613,659,1266,611,655,6,2,4
153427,34,54,23,31,54,23,31,,,
153445,34,1698,655,1043,1037,462,575,661,193,468
153463,34,12,1,11,12,1,11,,,
153472,34,1114,458,656,857,387,470,257,71,186
153524,34,1876,870,1006,1390,698,692,486,172,314
153533,34,640,313,327,452,254,198,188,59,129
153542,34,19,2,17,19,2,17,,,
153597,34,56,1,55,56,1,55,,,
153603,34,19266,10786,8480,18248,10109,8139,1018,677,341
153621,34,542,302,240,503,288,215,39,14,25
153630,34,1827,733,1094,987,516,471,840,217,623
153658,34,16367,7293,9074,14979,6646,8333,1388,647,741
153737,34,5260,2098,3162,2451,1129,1322,2809,969,1840
153746,34,21,0,21,21,0,21,,,
153764,34,29,0,29,29,0,29,,,
153773,34,8,1,7,8,1,7,,,
153782,34,9,0,9,9,0,9,,,
153825,34,906,513,393,857,476,381,49,37,12
153834,34,1203,543,660,1192,535,657,11,8,3
153861,34,645,155,490,435,113,322,210,42,168
153922,34,470,176,294,315,130,185,155,46,109
153977,34,840,121,719,409,78,331,431,43,388
154004,34,829,405,424,777,394,383,52,11,41
154013,34,977,343,634,777,291,486,200,52,148
154022,34,25456,9227,16229,19689,7141,12548,5767,2086,3681
154059,34,835,331,504,544,243,301,291,88,203
154095,34,6135,2373,3762,5538,2123,3415,597,250,347
154101,34,818,369,449,727,363,364,91,6,85
154110,34,1292,381,911,504,205,299,788,176,612
154129,34,508,208,300,280,156,124,228,52,176
154174,34,29,16,13,28,15,13,1,1,0
154208,34,67,3,64,14,0,14,53,3,50
154235,34,1649,745,904,1568,709,859,81,36,45
154262,34,188,16,172,80,11,69,108,5,103
154332,34,61,2,59,61,2,59,,,
154350,34,813,377,436,761,355,406,52,22,30
154378,34,977,334,643,687,248,439,290,86,204
154396,34,477,152,325,330,127,203,147,25,122
154448,34,99,5,94,99,5,94,,,
154457,34,4,0,4,4,0,4,,,
154466,34,27,2,25,27,2,25,,,
154493,34,1987,781,1206,1058,410,648,929,371,558
154518,34,2078,1320,758,1428,854,574,650,466,184
154527,34,1051,515,536,1010,488,522,41,27,14
154545,34,40,29,11,40,29,11,,,
154572,34,1764,585,1179,896,402,494,868,183,685
154590,34,1045,488,557,973,467,506,72,21,51
154642,34,669,296,373,363,215,148,306,81,225
154688,34,883,389,494,715,325,390,168,64,104
154697,34,1529,570,959,651,235,416,878,335,543
154712,34,1562,764,798,1541,753,788,21,11,10
154721,34,425,237,188,419,232,187,6,5,1
154749,34,386,199,187,375,197,178,11,2,9
154800,34,4270,1535,2735,1670,678,992,2600,857,1743
154855,34,352,162,190,325,151,174,27,11,16
154907,34,597,224,373,330,156,174,267,68,199
154925,34,490,267,223,412,235,177,78,32,46
154934,34,628,150,478,350,121,229,278,29,249
154952,34,1120,429,691,631,291,340,489,138,351
154998,34,822,398,424,410,229,181,412,169,243
155007,34,300,76,224,124,44,80,176,32,144
155025,34,2126,793,1333,1984,744,1240,142,49,93
155052,34,232,94,138,163,59,104,69,35,34
155061,34,9241,3617,5624,4086,1648,2438,5155,1969,3186
155070,34,130,63,67,96,43,53,34,20,14
155089,34,728,349,379,636,316,320,92,33,59
155098,34,565,246,319,402,185,217,163,61,102
155104,34,830,359,471,571,278,293,259,81,178
155140,34,522,189,333,454,170,284,68,19,49
155159,34,46,0,46,46,0,46,,,
155177,34,215,79,136,195,74,121,20,5,15
155186,34,813,348,465,427,206,221,386,142,244
155195,34,2144,788,1356,934,410,524,1210,378,832
155201,34,284,153,131,222,130,92,62,23,39
155210,34,8134,3621,4513,2994,1407,1587,5140,2214,2926
155283,34,406,55,351,357,51,306,49,4,45
155292,34,2432,914,1518,976,408,568,1456,506,950
155308,34,151,109,42,135,95,40,16,14,2
155317,34,14082,6627,7455,12358,5853,6505,1724,774,950
155335,34,706,248,458,660,227,433,46,21,25
155353,34,17,14,3,17,14,3,,,
155399,34,11853,5923,5930,10580,5374,5206,1273,549,724
155414,34,553,304,249,518,279,239,35,25,10
155423,34,909,550,359,688,457,231,221,93,128
155450,34,1193,453,740,334,132,202,859,321,538
155487,34,230,107,123,172,87,85,58,20,38
155496,34,93,48,45,72,38,34,21,10,11
155511,34,562,375,187,552,368,184,10,7,3
155520,34,742,321,421,683,308,375,59,13,46
155566,34,457,139,318,236,100,136,221,39,182
155593,34,259,129,130,210,120,90,49,9,40
155618,34,148,112,36,143,111,32,5,1,4
155627,34,590,363,227,532,326,206,58,37,21
155636,34,272,63,209,83,19,64,189,44,145
155681,34,3374,1730,1644,3137,1604,1533,237,126,111
155715,34,317,210,107,241,168,73,76,42,34
155812,34,601,291,310,555,270,285,46,21,25
155830,34,156,51,105,112,44,68,44,7,37
155858,34,641,215,426,348,130,218,293,85,208
155900,34,847,570,277,433,272,161,414,298,116
155937,34,413,258,155,349,224,125,64,34,30
155973,34,356,218,138,350,213,137,6,5,1
156082,34,3092,1112,1980,2409,868,1541,683,244,439
156107,34,1763,873,890,841,520,321,922,353,569
156125,34,8457,3687,4770,6509,2822,3687,1948,865,1083
156134,34,749,442,307,749,442,307,,,
156189,34,368,191,177,361,187,174,7,4,3
156213,34,961,388,573,784,325,459,177,63,114
156231,34,1230,426,804,727,286,441,503,140,363
156286,34,1729,642,1087,1663,611,1052,66,31,35
156295,34,1059,432,627,1053,430,623,6,2,4
156310,34,175,4,171,151,4,147,24,0,24
156338,34,2061,748,1313,940,373,567,1121,375,746
156356,34,450,161,289,379,149,230,71,12,59
156365,34,2067,805,1262,1786,735,1051,281,70,211
156392,34,5625,2204,3421,2369,1039,1330,3256,1165,2091
156408,34,947,452,495,943,448,495,4,4,0
156417,34,94,78,16,64,55,9,30,23,7
156426,34,147,11,136,93,8,85,54,3,51
156471,34,3631,299,3332,1458,130,1328,2173,169,2004
156541,34,3972,1237,2735,3226,1015,2211,746,222,524
156620,34,8478,3498,4980,6956,2778,4178,1522,720,802
156648,34,2707,1042,1665,1127,455,672,1580,587,993
156745,34,848,398,450,843,396,447,5,2,3
156754,34,39,1,38,39,1,38,,,
156790,34,1043,354,689,495,191,304,548,163,385
156842,34,142,4,138,93,3,90,49,1,48
156851,34,665,136,529,212,55,157,453,81,372
156860,34,1117,336,781,442,144,298,675,192,483
156921,34,5349,2205,3144,1811,847,964,3538,1358,2180
156967,34,90,1,89,90,1,89,,,
157021,34,193,11,182,71,4,67,122,7,115
157030,34,55,34,21,34,21,13,21,13,8
157058,34,976,384,592,878,341,537,98,43,55
157076,34,538,266,272,518,255,263,20,11,9
157085,34,16054,6965,9089,14770,6395,8375,1284,570,714
157100,34,334,221,113,315,210,105,19,11,8
157216,34,1181,487,694,1115,465,650,66,22,44
157289,34,10891,4852,6039,8560,3772,4788,2331,1080,1251
157304,34,1407,413,994,552,165,387,855,248,607
157331,34,1432,430,1002,594,241,353,838,189,649
157377,34,948,305,643,786,278,508,162,27,135
157386,34,3665,1456,2209,3141,1268,1873,524,188,336
157401,34,5222,2020,3202,4438,1711,2727,784,309,475
157438,34,2028,858,1170,732,361,371,1296,497,799
157447,34,7039,2863,4176,5541,2282,3259,1498,581,917
157483,34,2117,639,1478,1002,354,648,1115,285,830
157535,34,780,351,429,749,339,410,31,12,19
157553,34,1237,477,760,772,338,434,465,139,326
157614,34,49,1,48,32,1,31,17,0,17
157650,34,56,0,56,38,0,38,18,0,18
157669,34,46,1,45,46,1,45,,,
157678,34,49,0,49,49,0,49,,,
157711,34,2576,851,1725,1310,522,788,1266,329,937
157739,34,1112,323,789,583,188,395,529,135,394
157748,34,687,380,307,498,260,238,189,120,69
157757,34,503,149,354,418,131,287,85,18,67
157793,34,1451,463,988,897,280,617,554,183,371
157809,34,1036,506,530,901,462,439,135,44,91
157818,34,698,301,397,676,288,388,22,13,9
157863,34,510,283,227,482,270,212,28,13,15
157951,34,9394,3631,5763,8236,3185,5051,1158,446,712
158088,34,678,245,433,502,186,316,176,59,117
158246,34,70,17,53,70,17,53,,,
158325,34,110,14,96,110,14,96,,,
158431,34,4135,1211,2924,1944,637,1307,2191,574,1617
158477,34,338,146,192,333,143,190,5,3,2
158538,34,51,0,51,51,0,51,,,
158617,34,236,69,167,236,69,167,,,
158662,34,9258,2377,6881,2781,827,1954,6477,1550,4927
158778,34,57,0,57,57,0,57,,,
158787,34,47,0,47,47,0,47,,,
158802,34,886,218,668,831,209,622,55,9,46
158884,34,1096,317,779,435,160,275,661,157,504
159009,34,3302,1195,2107,2869,1058,1811,433,137,296
159027,34,7,0,7,7,0,7,,,
159197,34,377,316,61,377,316,61,,,
159328,34,80,1,79,80,1,79,,,
159373,34,880,119,761,783,111,672,97,8,89
159382,34,3186,862,2324,1877,533,1344,1309,329,980
159391,34,20328,9442,10886,19029,8779,10250,1299,663,636
159407,34,1762,398,1364,861,238,623,901,160,741
159416,34,1831,716,1115,1321,522,799,510,194,316
159513,34,153,5,148,153,5,148,,,
159522,34,127,4,123,127,4,123,,,
159531,34,19,0,19,19,0,19,,,
159568,34,590,310,280,566,301,265,24,9,15
159601,34,10,0,10,10,0,10,,,
159647,34,5662,3182,2480,5185,2960,2225,477,222,255
159656,34,2363,805,1558,2162,740,1422,201,65,136
159717,34,3874,1489,2385,3365,1315,2050,509,174,335
159939,34,3913,1949,1964,3146,1550,1596,767,399,368
159948,34,697,439,258,254,171,83,443,268,175
159966,34,3836,1384,2452,3269,1192,2077,567,192,375
159993,34,4014,1338,2676,3038,1097,1941,976,241,735
160010,34,588,332,256,171,139,32,417,193,224
160038,34,5223,1385,3838,3598,1096,2502,1625,289,1336
160065,34,408,67,341,258,52,206,150,15,135
160074,34,771,121,650,409,60,349,362,61,301
160117,34,158,1,157,158,1,157,,,
160126,34,34,1,33,13,0,13,21,1,20
160199,34,36,1,35,36,1,35,,,
160320,34,2305,80,2225,2305,80,2225,,,
160409,34,90,90,0,89,89,0,1,1,0
160472,34,48,4,44,30,3,27,18,1,17
160481,34,1314,319,995,678,194,484,636,125,511
160524,34,171,46,125,171,46,125,,,
160579,34,2150,984,1166,1135,548,587,1015,436,579
160597,34,158,48,110,79,24,55,79,24,55
160612,34,7204,2662,4542,6271,2338,3933,933,324,609
160621,34,4122,1334,2788,3452,1152,2300,670,182,488
160630,34,1010,213,797,761,169,592,249,44,205
160649,34,1677,383,1294,1034,284,750,643,99,544
160658,34,9047,3798,5249,7686,3281,4405,1361,517,844
160667,34,1256,602,654,819,396,423,437,206,231
160755,34,6647,2643,4004,6238,2485,3753,409,158,251
160904,34,1843,430,1413,1768,412,1356,75,18,57
160959,34,276,80,196,263,75,188,13,5,8
160977,34,1272,610,662,1272,610,662,,,
160995,34,280,57,223,280,57,223,,,
161004,34,1401,692,709,1401,692,709,,,
161022,34,228,19,209,103,7,96,125,12,113
161077,34,1423,528,895,591,286,305,832,242,590
161086,34,1626,770,856,1626,770,856,,,
161138,34,912,408,504,443,215,228,469,193,276
161192,34,939,276,663,262,94,168,677,182,495
161208,34,27,25,2,27,25,2,,,
161217,34,2553,734,1819,1075,302,773,1478,432,1046
161226,34,953,314,639,866,289,577,87,25,62
161235,34,593,147,446,287,90,197,306,57,249
161253,34,6781,3489,3292,5719,2887,2832,1062,602,460
161299,34,655,529,126,635,510,125,20,19,1
161341,34,959,341,618,580,223,357,379,118,261
161457,34,1541,482,1059,1519,475,1044,22,7,15
161484,34,377,157,220,194,106,88,183,51,132
161493,34,95,4,91,74,2,72,21,2,19
161509,34,282,70,212,274,68,206,8,2,6
161518,34,762,275,487,488,187,301,274,88,186
161527,34,181,18,163,122,7,115,59,11,48
161545,34,3103,1280,1823,1223,580,643,1880,700,1180
161554,34,3571,1409,2162,2689,1032,1657,882,377,505
161563,34,439,220,219,420,210,210,19,10,9
161572,34,3264,677,2587,3256,677,2579,8,0,8
161581,34,170,52,118,79,34,45,91,18,73
161688,34,1361,310,1051,454,162,292,907,148,759
161767,34,6434,2413,4021,1674,792,882,4760,1621,3139
161800,34,101,27,74,30,8,22,71,19,52
161855,34,32,1,31,16,0,16,16,1,15
161864,34,2085,469,1616,471,136,335,1614,333,1281
161873,34,1320,524,796,729,282,447,591,242,349
162007,34,4101,1577,2524,3242,1246,1996,859,331,528
162061,34,249,201,48,190,151,39,59,50,9
162104,34,945,340,605,265,132,133,680,208,472
162122,34,3270,1199,2071,1086,457,629,2184,742,1442
162168,34,905,259,646,230,86,144,675,173,502
162210,34,440,149,291,365,132,233,75,17,58
162283,34,1361,291,1070,1003,235,768,358,56,302
162335,34,51,0,51,51,0,51,,,
162371,34,327,301,26,327,301,26,,,
162557,34,2692,1109,1583,910,469,441,1782,640,1142
162584,34,2376,1075,1301,1900,966,934,476,109,367
162609,34,197,100,97,134,70,64,63,30,33
162654,34,712,242,470,687,235,452,25,7,18
162690,34,1987,587,1400,558,224,334,1429,363,1066
162706,34,2671,1017,1654,899,414,485,1772,603,1169
162760,34,885,320,565,855,309,546,30,11,19
162779,34,5645,2266,3379,1567,755,812,4078,1511,2567
162830,34,76,4,72,76,4,72,,,
162928,34,4237,1970,2267,4227,1962,2265,10,8,2
163028,34,659,593,66,474,423,51,185,170,15
163046,34,2697,1178,1519,2676,1166,1510,21,12,9
163204,34,43695,24396,19299,9843,5098,4745,33852,19298,14554
163259,34,956,165,791,731,130,601,225,35,190
163268,34,8413,4523,3890,6939,3732,3207,1474,791,683
163286,34,24133,12323,11810,22103,11169,10934,2030,1154,876
163295,34,1174,283,891,1109,264,845,65,19,46
163338,34,1289,578,711,1171,519,652,118,59,59
163347,34,262,15,247,262,15,247,,,
163408,34,47,7,40,26,2,24,21,5,16
163426,34,10787,5158,5629,3105,1601,1504,7682,3557,4125
163453,34,5398,2074,3324,4813,1807,3006,585,267,318
163462,34,1365,643,722,1283,608,675,82,35,47
163532,34,206,206,0,206,206,0,,,
163541,34,211,87,124,104,46,58,107,41,66
163578,34,578,20,558,438,16,422,140,4,136
163657,34,6576,2256,4320,1962,741,1221,4614,1515,3099
163815,34,31,0,31,11,0,11,20,0,20
163851,34,4763,2154,2609,4470,2002,2468,293,152,141
163912,34,1066,454,612,1043,444,599,23,10,13
163976,34,332,174,158,330,174,156,2,0,2
164076,34,14063,5875,8188,12107,4999,7108,1956,876,1080
164155,34,3282,2345,937,3282,2345,937,,,
164173,34,2235,820,1415,1928,747,1181,307,73,234
164216,34,704,294,410,697,291,406,7,3,4
164270,34,1281,526,755,1266,517,749,15,9,6
164313,34,1427,383,1044,232,101,131,1195,282,913
164368,34,502,306,196,502,306,196,,,
164447,34,811,333,478,768,322,446,43,11,32
164465,34,1431,703,728,1431,703,728,,,
164492,34,789,460,329,625,322,303,164,138,26
164535,34,45,11,34,45,11,34,,,
164562,34,1307,569,738,1296,564,732,11,5,6
164580,34,2053,1213,840,2046,1210,836,7,3,4
164599,34,16,2,14,,,,16,2,14
164614,34,34,24,10,25,18,7,9,6,3
164632,34,1124,0,1124,675,0,675,449,0,449
164641,34,203,58,145,103,41,62,100,17,83
164739,34,2929,1790,1139,2874,1753,1121,55,37,18
164748,34,5768,3334,2434,4446,2461,1985,1322,873,449
164775,34,839,257,582,194,76,118,645,181,464
164845,34,38,1,37,29,1,28,9,0,9
164872,34,238,104,134,183,89,94,55,15,40
164924,34,7416,3524,3892,7258,3429,3829,158,95,63
164988,34,14033,5894,8139,13781,5770,8011,252,124,128
165015,34,2688,1133,1555,2684,1131,1553,4,2,2
165024,34,6341,2588,3753,5005,2046,2959,1336,542,794
165033,34,3678,1122,2556,1277,460,817,2401,662,1739
165060,34,149,14,135,90,9,81,59,5,54
165112,34,5662,2283,3379,1581,730,851,4081,1553,2528
165167,34,640,117,523,107,31,76,533,86,447
165194,34,1561,514,1047,388,160,228,1173,354,819
165255,34,100,1,99,38,0,38,62,1,61
165264,34,957,73,884,92,7,85,865,66,799
165334,34,1660,688,972,1647,683,964,13,5,8
165529,34,1314,525,789,1173,488,685,141,37,104
165556,34,257,26,231,204,17,187,53,9,44
165574,34,837,423,414,767,388,379,70,35,35
165608,34,33,3,30,25,3,22,8,0,8
165635,34,148,139,9,148,139,9,,,
165644,34,335,185,150,309,175,134,26,10,16
165662,34,3145,1126,2019,3098,1107,1991,47,19,28
165671,34,1287,305,982,1232,295,937,55,10,45
165699,34,2128,775,1353,2029,742,1287,99,33,66
165750,34,5,1,4,2,1,1,3,0,3
165802,34,937,333,604,431,236,195,506,97,409
165820,34,2425,1089,1336,1800,879,921,625,210,415
165866,34,2222,996,1226,1981,888,1093,241,108,133
165884,34,260,213,47,145,115,30,115,98,17
165936,34,940,381,559,909,363,546,31,18,13
165981,34,865,291,574,242,81,161,623,210,413
166018,34,277,110,167,277,110,167,,,
166027,34,6329,3073,3256,5759,2817,2942,570,256,314
166054,34,27,21,6,27,21,6,,,
166124,34,2160,969,1191,2160,969,1191,,,
166133,34,2351,758,1593,787,312,475,1564,446,1118
166391,34,922,328,594,878,310,568,44,18,26
166407,34,225,13,212,13,0,13,212,13,199
166452,34,1166,295,871,731,180,551,435,115,320
166489,34,32,16,16,23,14,9,9,2,7
166498,34,57,2,55,26,0,26,31,2,29
166513,34,10048,5804,4244,7733,4509,3224,2315,1295,1020
166629,34,18522,9150,9372,17249,8578,8671,1273,572,701
166638,34,9308,3966,5342,7307,3069,4238,2001,897,1104
166647,34,2024,911,1113,638,325,313,1386,586,800
166656,34,2758,645,2113,2550,594,1956,208,51,157
166674,34,1344,359,985,1171,306,865,173,53,120
166683,34,3502,1819,1683,3446,1784,1662,56,35,21
166692,34,1006,871,135,976,843,133,30,28,2
166717,34,40,11,29,19,6,13,21,5,16
166805,34,41,27,14,17,12,5,24,15,9
166823,34,2779,1019,1760,957,431,526,1822,588,1234
166850,34,2883,1313,1570,2803,1284,1519,80,29,51
166869,34,140,22,118,140,22,118,,,
166887,34,3640,1296,2344,1040,446,594,2600,850,1750
166911,34,236,55,181,230,54,176,6,1,5
166939,34,1639,0,1639,1623,0,1623,16,0,16
166957,34,1895,566,1329,466,191,275,1429,375,1054
167039,34,1,0,1,1,0,1,,,
167057,34,316,174,142,306,167,139,10,7,3
167260,34,847,552,295,737,505,232,110,47,63
167288,34,583,247,336,502,223,279,81,24,57
167297,34,134,77,57,134,77,57,,,
167312,34,2832,938,1894,742,321,421,2090,617,1473
167358,34,13653,6197,7456,13653,6197,7456,,,
167376,34,2623,932,1691,685,330,355,1938,602,1336
167394,34,770,192,578,653,171,482,117,21,96
167525,34,1754,678,1076,613,276,337,1141,402,739
167534,34,4053,1406,2647,1253,504,749,2800,902,1898
167598,34,892,166,726,719,139,580,173,27,146
167631,34,941,282,659,217,80,137,724,202,522
167677,34,17,17,0,15,15,0,2,2,0
167729,34,3729,1252,2477,3031,1005,2026,698,247,451
167783,34,1391,0,1391,1205,0,1205,186,0,186
167792,34,169,65,104,164,62,102,5,3,2
167835,34,1896,1,1895,1891,1,1890,5,0,5
167871,34,73,12,61,39,5,34,34,7,27
167899,34,1477,726,751,1457,709,748,20,17,3
167905,34,2784,1022,1762,910,399,511,1874,623,1251
167987,34,4012,1921,2091,3399,1668,1731,613,253,360
167996,34,1729,764,965,1713,753,960,16,11,5
168005,34,3065,1232,1833,2932,1162,1770,133,70,63
168032,34,1,0,1,1,0,1,,,
168148,34,5053,2248,2805,4919,2181,2738,134,67,67
168218,34,1767,0,1767,1763,0,1763,4,0,4
168227,34,2725,2124,601,2549,1971,578,176,153,23
168254,34,1800,1040,760,1735,998,737,65,42,23
168263,34,2890,1298,1592,2455,1073,1382,435,225,210
168281,34,1159,421,738,1157,419,738,2,2,0
168342,34,1561,745,816,1561,745,816,,,
168421,34,3792,2310,1482,3704,2246,1458,88,64,24
168430,34,3226,1233,1993,2599,978,1621,627,255,372
168528,34,1181,617,564,1167,607,560,14,10,4
168546,34,1027,489,538,1023,487,536,4,2,2
168555,34,9,1,8,7,1,6,2,0,2
168573,34,491,481,10,491,481,10,,,
168591,34,888,387,501,878,379,499,10,8,2
168607,34,464,233,231,210,125,85,254,108,146
168740,34,1017,509,508,865,431,434,152,78,74
168786,34,800,340,460,726,315,411,74,25,49
168847,34,2907,704,2203,1181,305,876,1726,399,1327
168883,34,909,285,624,375,148,227,534,137,397
168892,34,95,4,91,51,3,48,44,1,43
169080,34,2173,1054,1119,2009,931,1078,164,123,41
169187,34,98,18,80,22,9,13,76,9,67
169248,34,8278,3187,5091,6941,2744,4197,1337,443,894
169275,34,3918,1279,2639,1076,395,681,2842,884,1958
169284,34,149,7,142,113,2,111,36,5,31
169327,34,613,385,228,460,299,161,153,86,67
169363,34,619,308,311,588,297,291,31,11,20
169442,34,1057,381,676,878,312,566,179,69,110
169479,34,2872,1246,1626,1535,806,729,1337,440,897
169503,34,242,3,239,242,3,239,,,
169521,34,4419,1594,2825,1251,485,766,3168,1109,2059
169576,34,101,2,99,101,2,99,,,
169655,34,760,706,54,760,706,54,,,
169716,34,1814,624,1190,1649,571,1078,165,53,112
169761,34,351,60,291,351,60,291,,,
169798,34,9029,3580,5449,6187,2469,3718,2842,1111,1731
169813,34,46,1,45,46,1,45,,,
169910,34,6644,3188,3456,4842,2335,2507,1802,853,949
169974,34,380,149,231,170,66,104,210,83,127
169983,34,1107,879,228,1062,844,218,45,35,10
169992,34,367,114,253,175,70,105,192,44,148
170000,34,705,277,428,504,205,299,201,72,129
170037,34,1090,415,675,835,337,498,255,78,177
170055,34,7669,3224,4445,2040,939,1101,5629,2285,3344
170082,34,14612,5882,8730,12620,4956,7664,1992,926,1066
170091,34,89,47,42,88,47,41,1,0,1
170240,34,6797,2804,3993,2319,967,1352,4478,1837,2641
170286,34,1175,591,584,1153,583,570,22,8,14
170301,34,2218,871,1347,2168,847,1321,50,24,26
170444,34,2436,814,1622,594,205,389,1842,609,1233
170532,34,820,372,448,804,364,440,16,8,8
170541,34,3970,1715,2255,1022,431,591,2948,1284,1664
170550,34,2004,514,1490,453,166,287,1551,348,1203
170587,34,734,208,526,337,105,232,397,103,294
170611,34,72,2,70,71,2,69,1,0,1
170620,34,1620,546,1074,454,156,298,1166,390,776
170639,34,1195,528,667,1019,463,556,176,65,111
170657,34,6386,2769,3617,1721,781,940,4665,1988,2677
170675,34,1437,1029,408,1272,911,361,165,118,47
170736,34,34,0,34,12,0,12,22,0,22
170790,34,11456,4769,6687,2962,1275,1687,8494,3494,5000
170806,34,1444,493,951,1087,387,700,357,106,251
170967,34,615,224,391,485,193,292,130,31,99
170976,34,25398,12381,13017,24124,11645,12479,1274,736,538
171012,34,126,98,28,126,98,28,,,
171100,34,29192,14139,15053,26217,12556,13661,2975,1583,1392
171128,34,4245,2995,1250,4022,2838,1184,223,157,66
171137,34,4957,2644,2313,3680,1938,1742,1277,706,571
171146,34,3508,1232,2276,2260,852,1408,1248,380,868
171155,34,1743,617,1126,722,309,413,1021,308,713
171225,34,1226,456,770,313,134,179,913,322,591
171234,34,831,269,562,186,55,131,645,214,431
171304,34,2022,761,1261,551,246,305,1471,515,956
171395,34,789,254,535,417,146,271,372,108,264
171456,34,4906,1995,2911,4194,1712,2482,712,283,429
171483,34,2088,973,1115,727,367,360,1361,606,755
171492,34,1664,1027,637,1045,666,379,619,361,258
171535,34,8520,3596,4924,1859,892,967,6661,2704,3957
171571,34,10509,4473,6036,8152,3334,4818,2357,1139,1218
171599,34,591,351,240,574,338,236,17,13,4
171775,34,30,0,30,21,0,21,9,0,9
171881,34,71,29,42,60,25,35,11,4,7
171988,34,58,4,54,58,4,54,,,
171997,34,68,2,66,68,2,66,,,
172015,34,40,0,40,40,0,40,,,
172033,34,136,69,67,31,30,1,105,39,66
172051,34,4874,1765,3109,4046,1429,2617,828,336,492
172200,34,5208,2095,3113,1297,656,641,3911,1439,2472
172264,34,1275,554,721,819,385,434,456,169,287
172291,34,1564,502,1062,624,181,443,940,321,619
172307,34,807,288,519,350,163,187,457,125,332
172334,34,793,252,541,640,217,423,153,35,118
172422,34,67,54,13,67,54,13,,,
172440,34,269,141,128,251,137,114,18,4,14
172495,34,185,2,183,115,2,113,70,0,70
172608,34,569,292,277,70,42,28,499,250,249
172617,34,6441,2732,3709,1569,759,810,4872,1973,2899
172635,34,7793,2264,5529,977,364,613,6816,1900,4916
172644,34,13092,5342,7750,9629,3839,5790,3463,1503,1960
172671,34,475,154,321,92,38,54,383,116,267
172680,34,90,5,85,53,4,49,37,1,36
172699,34,10643,5414,5229,8796,4428,4368,1847,986,861
172866,34,85,79,6,85,79,6,,,
172918,34,917,441,476,502,262,240,415,179,236
172954,34,1123,491,632,539,299,240,584,192,392
172963,34,3049,1097,1952,1164,481,683,1885,616,1269
173045,34,1722,764,958,1590,715,875,132,49,83
173063,34,1508,692,816,556,271,285,952,421,531
173115,34,466,133,333,193,99,94,273,34,239
173124,34,2735,1160,1575,1850,850,1000,885,310,575
173142,34,465,219,246,452,212,240,13,7,6
173160,34,1642,656,986,1366,548,818,276,108,168
173203,34,1116,438,678,548,283,265,568,155,413
173258,34,1475,728,747,1475,728,747,,,
173300,34,1356,627,729,1322,606,716,34,21,13
173328,34,2458,800,1658,1690,568,1122,768,232,536
173416,34,1623,864,759,956,591,365,667,273,394
173452,34,555,264,291,469,232,237,86,32,54
173461,34,1879,796,1083,839,428,411,1040,368,672
173559,34,2202,811,1391,1094,515,579,1108,296,812
173638,34,1313,739,574,449,220,229,864,519,345
173647,34,1606,691,915,1565,668,897,41,23,18
173665,34,1268,480,788,1220,457,763,48,23,25
173708,34,2285,1435,850,933,644,289,1352,791,561
173735,34,1424,705,719,977,587,390,447,118,329
173744,34,399,23,376,399,23,376,,,
173799,34,1679,637,1042,629,261,368,1050,376,674
173902,34,1612,704,908,1584,685,899,28,19,9
173911,34,1518,607,911,662,347,315,856,260,596
173920,34,9047,4228,4819,7484,3637,3847,1563,591,972
173957,34,186,42,144,186,42,144,,,
174020,34,5017,2085,2932,2349,1033,1316,2668,1052,1616
174066,34,23823,11048,12775,21753,10000,11753,2070,1048,1022
174075,34,1302,537,765,800,326,474,502,211,291
174127,34,529,185,344,524,183,341,5,2,3
174136,34,3822,1603,2219,1223,597,626,2599,1006,1593
174154,34,672,72,600,309,33,276,363,39,324
174190,34,48,0,48,37,0,37,11,0,11
174233,34,5777,3017,2760,5353,2774,2579,424,243,181
174251,34,751,324,427,701,305,396,50,19,31
174321,34,90,1,89,89,1,88,1,0,1
174358,34,2831,1097,1734,2259,876,1383,572,221,351
174376,34,2649,1029,1620,805,344,461,1844,685,1159
174428,34,4503,1931,2572,1679,805,874,2824,1126,1698
174437,34,655,296,359,582,263,319,73,33,40
174473,34,1198,464,734,567,221,346,631,243,388
174491,34,1114,452,662,978,395,583,136,57,79
174507,34,223,59,164,58,19,39,165,40,125
174525,34,67,39,28,51,30,21,16,9,7
174570,34,447,144,303,255,97,158,192,47,145
174738,34,2411,818,1593,893,395,498,1518,423,1095
174747,34,1104,0,1104,1096,0,1096,8,0,8
174756,34,2215,807,1408,1006,414,592,1209,393,816
174783,34,4632,2268,2364,3544,1725,1819,1088,543,545
174792,34,1118,1118,0,1094,1094,0,24,24,0
174817,34,865,382,483,643,304,339,222,78,144
174844,34,2150,893,1257,2142,889,1253,8,4,4
174862,34,550,270,280,395,197,198,155,73,82
174899,34,1556,473,1083,1307,419,888,249,54,195
174914,34,4282,2233,2049,4138,2143,1995,144,90,54
174978,34,108,1,107,79,0,79,29,1,28
175005,34,2003,103,1900,1300,28,1272,703,75,628
175014,34,2504,406,2098,1294,219,1075,1210,187,1023
175041,34,2923,1224,1699,1212,611,601,1711,613,1098
175078,34,1626,541,1085,1070,412,658,556,129,427
175120,34,90,58,32,90,58,32,,,
175227,34,1028,831,197,827,677,150,201,154,47
175236,34,1696,612,1084,957,404,553,739,208,531
175263,34,888,379,509,432,221,211,456,158,298
175272,34,4081,1354,2727,3433,1137,2296,648,217,431
175315,34,4843,1968,2875,1941,852,1089,2902,1116,1786
175342,34,1846,623,1223,1558,543,1015,288,80,208
175421,34,1152,399,753,811,318,493,341,81,260
175430,34,450,232,218,429,224,205,21,8,13
175494,34,105,34,71,105,34,71,,,
175519,34,1000,338,662,807,285,522,193,53,140
175573,34,1296,494,802,1057,415,642,239,79,160
175616,34,1410,583,827,1201,497,704,209,86,123
175643,34,1076,376,700,865,317,548,211,59,152
175652,34,1911,752,1159,1430,601,829,481,151,330
175698,34,5,3,2,3,2,1,2,1,1
175722,34,21,0,21,21,0,21,,,
175786,34,4960,1695,3265,3260,1229,2031,1700,466,1234
175810,34,2864,793,2071,2004,594,1410,860,199,661
175829,34,2297,824,1473,1555,607,948,742,217,525
175856,34,3773,1372,2401,3243,1201,2042,530,171,359
175883,34,2715,960,1755,2061,776,1285,654,184,470
175935,34,1703,450,1253,1311,373,938,392,77,315
175980,34,430,219,211,427,218,209,3,1,2
176008,34,1219,391,828,904,308,596,315,83,232
176017,34,12692,5437,7255,11720,4940,6780,972,497,475
176035,34,1576,287,1289,1404,251,1153,172,36,136
176044,34,944,417,527,832,365,467,112,52,60
176053,34,1722,700,1022,1578,650,928,144,50,94
176062,34,46,0,46,46,0,46,,,
176071,34,4334,1521,2813,2750,1069,1681,1584,452,1132
176080,34,14787,7369,7418,13228,6528,6700,1559,841,718
176169,34,1701,634,1067,1507,576,931,194,58,136
176178,34,3682,1266,2416,2858,1022,1836,824,244,580
176239,34,3721,1181,2540,2985,1010,1975,736,171,565
176318,34,547,213,334,423,156,267,124,57,67
176336,34,64,46,18,59,42,17,5,4,1
176354,34,1066,367,699,868,325,543,198,42,156
176372,34,8525,3040,5485,7025,2403,4622,1500,637,863
176406,34,408,161,247,387,153,234,21,8,13
176433,34,54,2,52,41,2,39,13,0,13
176451,34,16,10,6,4,2,2,12,8,4
176479,34,1594,456,1138,1388,416,972,206,40,166
176628,34,753,304,449,688,289,399,65,15,50
176664,34,203,124,79,167,106,61,36,18,18
176716,34,125,1,124,125,1,124,,,
176770,34,676,87,589,348,51,297,328,36,292
176789,34,170,75,95,100,44,56,70,31,39
176798,34,191,48,143,109,22,87,82,26,56
176910,34,140,85,55,84,47,37,56,38,18
176947,34,780,372,408,773,369,404,7,3,4
176965,34,4892,2281,2611,4151,1921,2230,741,360,381
176983,34,31,17,14,28,15,13,3,2,1
177038,34,84,26,58,64,20,44,20,6,14
177065,34,4917,1944,2973,2046,771,1275,2871,1173,1698
177083,34,21,21,0,21,21,0,,,
177117,34,215,0,215,213,0,213,2,0,2
177135,34,1757,607,1150,924,380,544,833,227,606
177144,34,591,326,265,581,322,259,10,4,6
177214,34,966,414,552,947,404,543,19,10,9
177250,34,1182,424,758,592,253,339,590,171,419
177302,34,244,229,15,244,229,15,,,
177339,34,903,430,473,903,430,473,,,
177418,34,485,207,278,431,193,238,54,14,40
177436,34,21,0,21,21,0,21,,,
177472,34,5262,2076,3186,2534,1033,1501,2728,1043,1685
177542,34,327,162,165,263,117,146,64,45,19
177551,34,843,246,597,718,210,508,125,36,89
177588,34,54,2,52,54,2,52,,,
177603,34,121,3,118,112,3,109,9,0,9
177676,34,1646,596,1050,872,374,498,774,222,552
177685,34,123,9,114,123,9,114,,,
177719,34,415,50,365,357,46,311,58,4,54
177746,34,548,129,419,540,126,414,8,3,5
177931,34,24,1,23,24,1,23,,,
177940,34,973,368,605,835,330,505,138,38,100
177968,34,3741,1641,2100,3145,1388,1757,596,253,343
177977,34,966,801,165,861,717,144,105,84,21
177986,34,273,81,192,123,41,82,150,40,110
177995,34,7655,2935,4720,3098,1381,1717,4557,1554,3003
178059,34,4911,1573,3338,2629,959,1670,2282,614,1668
178077,34,67,1,66,67,1,66,,,
178183,34,178,14,164,178,14,164,,,
178208,34,818,533,285,375,263,112,443,270,173
178217,34,979,310,669,676,224,452,303,86,217
178244,34,1191,507,684,1018,452,566,173,55,118
178341,34,2640,1020,1620,1953,755,1198,687,265,422
178369,34,888,511,377,824,495,329,64,16,48
178387,34,2030,798,1232,1727,681,1046,303,117,186
178396,34,18223,8397,9826,17025,7842,9183,1198,555,643
178402,34,5314,2184,3130,4408,1748,2660,906,436,470
178411,34,4307,3288,1019,3744,2860,884,563,428,135
178420,34,4935,2214,2721,3441,1503,1938,1494,711,783
178448,34,1961,710,1251,1118,427,691,843,283,560
178527,34,19,2,17,14,2,12,5,0,5
178615,34,2221,881,1340,2127,836,1291,94,45,49
178624,34,3584,1408,2176,3187,1263,1924,397,145,252
178679,34,450,252,198,349,206,143,101,46,55
178697,34,1123,468,655,1110,463,647,13,5,8
178721,34,5725,3137,2588,2793,1319,1474,2932,1818,1114
178767,34,83,14,69,34,7,27,49,7,42
178828,34,13,0,13,13,0,13,,,
178891,34,1121,1016,105,774,702,72,347,314,33
178989,34,227,27,200,216,27,189,11,0,11
179043,34,1445,496,949,1334,483,851,111,13,98
179159,34,5667,2241,3426,5021,1927,3094,646,314,332
179195,34,30,2,28,30,2,28,,,
179265,34,158,54,104,157,54,103,1,0,1
179308,34,8862,2767,6095,3047,1151,1896,5815,1616,4199
179326,34,1196,421,775,920,366,554,276,55,221
179344,34,553,148,405,347,97,250,206,51,155
179511,34,49,0,49,29,0,29,20,0,20
179539,34,1656,512,1144,1033,317,716,623,195,428
179548,34,328,5,323,304,5,299,24,0,24
179557,34,5563,2268,3295,4814,1948,2866,749,320,429
179566,34,11000,4410,6590,9062,3534,5528,1938,876,1062
179645,34,1260,319,941,821,224,597,439,95,344
179715,34,706,147,559,410,107,303,296,40,256
179867,34,5988,2784,3204,5593,2660,2933,395,124,271
179894,34,1746,760,986,1372,591,781,374,169,205
179946,34,446,256,190,440,253,187,6,3,3
179955,34,581,291,290,568,281,287,13,10,3
179964,34,529,153,376,432,138,294,97,15,82
179991,34,19,1,18,19,1,18,,,
180054,34,300,65,235,158,33,125,142,32,110
180063,34,10,0,10,10,0,10,,,
180081,34,202,117,85,158,102,56,44,15,29
180090,34,25,0,25,25,0,25,,,
180106,34,812,319,493,792,310,482,20,9,11
180151,34,146,72,74,110,63,47,36,9,27
180160,34,188,68,120,77,32,45,111,36,75
180179,34,2170,767,1403,1395,576,819,775,191,584
180197,34,797,327,470,369,173,196,428,154,274
180203,34,87,34,53,70,30,40,17,4,13
180212,34,508,143,365,340,100,240,168,43,125
180249,34,594,138,456,307,79,228,287,59,228
180258,34,494,172,322,357,137,220,137,35,102
180276,34,438,172,266,207,103,104,231,69,162
180328,34,223,64,159,129,41,88,94,23,71
180373,34,252,81,171,146,59,87,106,22,84
180416,34,1115,688,427,1023,630,393,92,58,34
180461,34,10591,5665,4926,9206,4915,4291,1385,750,635
180489,34,5316,2240,3076,4281,1805,2476,1035,435,600
180522,34,603,321,282,481,282,199,122,39,83
180595,34,573,299,274,559,293,266,14,6,8
180647,34,436,114,322,362,97,265,74,17,57
180692,34,931,287,644,748,250,498,183,37,146
180814,34,9870,4329,5541,6282,2783,3499,3588,1546,2042
180832,34,594,87,507,206,36,170,388,51,337
180878,34,463,40,423,283,22,261,180,18,162
180902,34,2377,906,1471,1107,541,566,1270,365,905
180948,34,1371,502,869,1159,444,715,212,58,154
180957,34,52,47,5,52,47,5,,,
180984,34,803,387,416,787,376,411,16,11,5
181002,34,3233,1327,1906,3144,1290,1854,89,37,52
181020,34,748,400,348,695,378,317,53,22,31
181127,34,654,301,353,647,297,350,7,4,3
181145,34,24,2,22,24,2,22,,,
181190,34,85,4,81,85,4,81,,,
181215,34,3296,1192,2104,2789,1048,1741,507,144,363
181297,34,764,83,681,529,61,468,235,22,213
181303,34,5536,2652,2884,1733,887,846,3803,1765,2038
181312,34,597,221,376,320,164,156,277,57,220
181330,34,880,432,448,868,429,439,12,3,9
181394,34,9523,4313,5210,7661,3328,4333,1862,985,877
181419,34,199,52,147,60,17,43,139,35,104
181428,34,861,113,748,719,93,626,142,20,122
181446,34,1172,531,641,1099,507,592,73,24,49
181464,34,14457,7318,7139,13554,6771,6783,903,547,356
181491,34,1538,637,901,1025,501,524,513,136,377
181534,34,955,398,557,774,337,437,181,61,120
181543,34,14,10,4,9,6,3,5,4,1
181604,34,414,0,414,408,0,408,6,0,6
181640,34,4376,2043,2333,1983,1057,926,2393,986,1407
181738,34,385,163,222,371,157,214,14,6,8
181765,34,140,39,101,134,38,96,6,1,5
181783,34,2279,954,1325,2075,862,1213,204,92,112
181817,34,613,220,393,360,163,197,253,57,196
181853,34,334,165,169,295,157,138,39,8,31
181880,34,9,0,9,2,0,2,7,0,7
181941,34,227,137,90,227,137,90,,,
182005,34,22198,9024,13174,5964,2478,3486,16234,6546,9688
182148,34,538,115,423,538,115,423,,,
182281,34,20017,8745,11272,15313,6568,8745,4704,2177,2527
182290,34,12600,5979,6621,10490,4973,5517,2110,1006,1104
182306,34,1671,523,1148,610,230,380,1061,293,768
182500,34,4972,2245,2727,1518,655,863,3454,1590,1864
182564,34,1471,591,880,454,207,247,1017,384,633
182634,34,628,165,463,584,159,425,44,6,38
182670,34,3288,1681,1607,3287,1680,1607,1,1,0
182704,34,49,2,47,34,1,33,15,1,14
182722,34,142,12,130,108,12,96,34,0,34
182795,34,797,346,451,678,294,384,119,52,67
182892,34,20,0,20,12,0,12,8,0,8
182917,34,44,21,23,44,21,23,,,
182980,34,779,365,414,748,349,399,31,16,15
182999,34,7,0,7,7,0,7,,,
183026,34,124555,45560,78995,30255,11960,18295,94300,33600,60700
183035,34,27,2,25,27,2,25,,,
183044,34,8454,3698,4756,8241,3574,4667,213,124,89
183062,34,1981,913,1068,1919,877,1042,62,36,26
183071,34,453,231,222,371,180,191,82,51,31
183080,34,2416,1243,1173,2322,1187,1135,94,56,38
183099,34,1564,517,1047,512,223,289,1052,294,758
183105,34,299,91,208,78,33,45,221,58,163
183114,34,482,104,378,78,23,55,404,81,323
183123,34,339,165,174,111,70,41,228,95,133
183132,34,1213,521,692,327,200,127,886,321,565
183141,34,745,332,413,196,119,77,549,213,336
183150,34,966,348,618,264,132,132,702,216,486
183202,34,73,2,71,60,1,59,13,1,12
183211,34,1054,215,839,677,176,501,377,39,338
183239,34,1427,562,865,1409,550,859,18,12,6
183248,34,132,14,118,77,8,69,55,6,49
183257,34,1085,324,761,544,156,388,541,168,373
183275,34,64,35,29,64,35,29,,,
183488,34,451,26,425,346,20,326,105,6,99
183600,34,21,0,21,13,0,13,8,0,8
183655,34,2841,963,1878,958,372,586,1883,591,1292
183725,34,251,131,120,215,123,92,36,8,28
183743,34,7236,3378,3858,3476,1738,1738,3760,1640,2120
183789,34,1721,380,1341,1077,269,808,644,111,533
183804,34,3334,3334,0,3323,3323,0,11,11,0
183822,34,914,371,543,838,340,498,76,31,45
183859,34,6061,2735,3326,2669,1333,1336,3392,1402,1990
183877,34,4223,1580,2643,1741,770,971,2482,810,1672
183910,34,1150,421,729,1090,398,692,60,23,37
183938,34,5134,1826,3308,2022,846,1176,3112,980,2132
183974,34,825,293,532,769,273,496,56,20,36
183983,34,6,5,1,6,5,1,,,
184056,34,374,76,298,231,50,181,143,26,117
184092,34,625,74,551,625,74,551,,,
184180,34,3935,2053,1882,1600,926,674,2335,1127,1208
184205,34,1428,447,981,555,191,364,873,256,617
184348,34,1110,467,643,1098,462,636,12,5,7
184427,34,218,203,15,140,134,6,78,69,9
184481,34,4283,1583,2700,1756,667,1089,2527,916,1611
184506,34,38,3,35,26,0,26,12,3,9
184603,34,1884,859,1025,1375,613,762,509,246,263
184612,34,1431,373,1058,1305,340,965,126,33,93
184694,34,1545,664,881,1471,626,845,74,38,36
184746,34,17,17,0,16,16,0,1,1,0
184773,34,962,220,742,877,198,679,85,22,63
184782,34,12329,6372,5957,10628,5570,5058,1701,802,899
184791,34,3234,1272,1962,1623,670,953,1611,602,1009
184816,34,35,0,35,17,0,17,18,0,18
184959,34,621,98,523,252,42,210,369,56,313
184968,34,188,29,159,29,6,23,159,23,136
184995,34,4512,1661,2851,2279,883,1396,2233,778,1455
185129,34,3909,1610,2299,3353,1384,1969,556,226,330
185174,34,45,38,7,45,38,7,,,
185262,34,8556,3282,5274,6769,2585,4184,1787,697,1090
185396,34,969,935,34,791,764,27,178,171,7
185466,34,13,0,13,7,0,7,6,0,6
185509,34,3691,1650,2041,1106,587,519,2585,1063,1522
185536,34,5401,2424,2977,2185,1037,1148,3216,1387,1829
185572,34,2903,1092,1811,2763,1024,1739,140,68,72
185590,34,12956,5119,7837,11446,4439,7007,1510,680,830
185679,34,576,88,488,43,5,38,533,83,450
185721,34,309,76,233,164,38,126,145,38,107
185767,34,264,34,230,132,15,117,132,19,113
185828,34,6790,5078,1712,5917,4377,1540,873,701,172
185873,34,3659,1503,2156,1552,731,821,2107,772,1335
185970,34,127,10,117,96,8,88,31,2,29
186016,34,408,23,385,218,14,204,190,9,181
186034,34,3874,1377,2497,1294,547,747,2580,830,1750
186052,34,467,394,73,249,212,37,218,182,36
186131,34,4030,2027,2003,4030,2027,2003,,,
186186,34,134,134,0,134,134,0,,,
186201,34,3761,1623,2138,3453,1474,1979,308,149,159
186274,34,188,14,174,106,8,98,82,6,76
186283,34,2326,981,1345,2173,929,1244,153,52,101
186371,34,3549,1307,2242,2960,1099,1861,589,208,381
186380,34,28310,14219,14091,26861,13494,13367,1449,725,724
186399,34,5949,2734,3215,5096,2313,2783,853,421,432
186405,34,16,5,11,16,5,11,,,
186423,34,53,8,45,53,8,45,,,
186432,34,1517,571,946,1396,524,872,121,47,74
186469,34,612,203,409,285,135,150,327,68,259
186584,34,4362,1935,2427,4223,1862,2361,139,73,66
186593,34,68,16,52,43,15,28,25,1,24
186618,34,508,173,335,426,154,272,82,19,63
186645,34,3671,1890,1781,1447,781,666,2224,1109,1115
186867,34,3044,2119,925,3027,2106,921,17,13,4
186876,34,6543,2546,3997,6187,2376,3811,356,170,186
186900,34,61,61,0,61,61,0,,,
187000,34,315,298,17,199,186,13,116,112,4
187046,34,7268,4338,2930,76,15,61,7192,4323,2869
187134,34,5257,2264,2993,5088,2174,2914,169,90,79
187198,34,5587,1930,3657,2095,922,1173,3492,1008,2484
187444,34,5785,2242,3543,4330,1732,2598,1455,510,945
187505,34,447,86,361,447,86,361,,,
187532,34,12594,4599,7995,2842,1215,1627,9752,3384,6368
187596,34,712,241,471,359,151,208,353,90,263
187620,34,3634,1371,2263,1651,673,978,1983,698,1285
187639,34,1041,255,786,334,93,241,707,162,545
187648,34,2475,935,1540,1620,596,1024,855,339,516
187666,34,857,291,566,382,153,229,475,138,337
187745,34,250,88,162,195,76,119,55,12,43
187897,34,1254,402,852,757,295,462,497,107,390
187903,34,1188,525,663,402,162,240,786,363,423
187912,34,153,130,23,153,130,23,,,
187958,34,1127,359,768,274,101,173,853,258,595
187967,34,859,594,265,794,549,245,65,45,20
187976,34,767,357,410,48,17,31,719,340,379
187985,34,12133,5018,7115,8520,3579,4941,3613,1439,2174
187994,34,396,110,286,154,49,105,242,61,181
188003,34,357,80,277,121,34,87,236,46,190
188021,34,241,52,189,95,26,69,146,26,120
188030,34,8740,3722,5018,7030,2944,4086,1710,778,932
188049,34,1018,349,669,148,54,94,870,295,575
188058,34,669,222,447,329,112,217,340,110,230
188100,34,3446,985,2461,1211,460,751,2235,525,1710
188137,34,1756,591,1165,421,148,273,1335,443,892
188182,34,342,189,153,307,168,139,35,21,14
188216,34,207,66,141,122,55,67,85,11,74
188225,34,655,226,429,83,40,43,572,186,386
188261,34,332,256,76,53,27,26,279,229,50
188289,34,47,3,44,45,3,42,2,0,2
188304,34,1472,421,1051,852,305,547,620,116,504
188340,34,992,871,121,774,672,102,218,199,19
188429,34,3858,1205,2653,3627,1126,2501,231,79,152
188438,34,1316,530,786,768,358,410,548,172,376
188517,34,238,85,153,191,75,116,47,10,37
188526,34,473,170,303,470,168,302,3,2,1
188641,34,936,437,499,910,423,487,26,14,12
188650,34,73,1,72,73,1,72,,,
188669,34,46,9,37,46,9,37,,,
188678,34,103,37,66,103,37,66,,,
188687,34,366,121,245,91,36,55,275,85,190
188696,34,103,10,93,103,10,93,,,
188854,34,1001,280,721,1001,280,721,,,
188890,34,477,465,12,362,353,9,115,112,3
188915,34,38,12,26,13,11,2,25,1,24
188942,34,191,0,191,173,0,173,18,0,18
189088,34,1728,770,958,1609,689,920,119,81,38
189097,34,2420,0,2420,2386,0,2386,34,0,34
189219,34,20,20,0,20,20,0,,,
189228,34,1415,425,990,877,286,591,538,139,399
189255,34,38,0,38,22,0,22,16,0,16
189273,34,49,49,0,49,49,0,,,
189282,34,329,45,284,261,38,223,68,7,61
189404,34,133,1,132,44,0,44,89,1,88
189413,34,342,70,272,342,70,272,,,
189468,34,3,0,3,2,0,2,1,0,1
189477,34,133,3,130,50,2,48,83,1,82
189547,34,2135,769,1366,1358,552,806,777,217,560
189565,34,389,101,288,310,87,223,79,14,65
189583,34,528,133,395,383,98,285,145,35,110
189592,34,288,63,225,232,57,175,56,6,50
189705,34,1272,639,633,1232,614,618,40,25,15
189714,34,292,8,284,204,4,200,88,4,84
189811,34,786,152,634,786,152,634,,,
189839,34,815,296,519,455,176,279,360,120,240
189848,34,462,129,333,366,107,259,96,22,74
189857,34,559,559,0,559,559,0,,,
189990,34,691,5,686,130,2,128,561,3,558
190008,34,41,14,27,41,14,27,,,
190044,34,1991,1371,620,1981,1367,614,10,4,6
190053,34,311,123,188,165,80,85,146,43,103
190071,34,115,13,102,26,4,22,89,9,80
190099,34,2312,1048,1264,2300,1040,1260,12,8,4
190114,34,341,82,259,254,54,200,87,28,59
190150,34,7362,3769,3593,6769,3480,3289,593,289,304
190169,34,618,192,426,259,115,144,359,77,282
190239,34,86,2,84,64,1,63,22,1,21
190318,34,155,7,148,152,4,148,3,3,0
190372,34,697,363,334,697,363,334,,,
190415,34,12185,5565,6620,12136,5535,6601,49,30,19
190442,34,902,344,558,511,214,297,391,130,261
190451,34,209,34,175,57,13,44,152,21,131
190503,34,2331,1213,1118,2193,1135,1058,138,78,60
190512,34,12967,6500,6467,10007,5034,4973,2960,1466,1494
190521,34,12417,5088,7329,7786,3331,4455,4631,1757,2874
190530,34,4757,1915,2842,2740,1160,1580,2017,755,1262
190549,34,9096,3857,5239,6770,2855,3915,2326,1002,1324
190558,34,7076,3214,3862,5448,2489,2959,1628,725,903
190567,34,8747,4007,4740,6843,3088,3755,1904,919,985
190576,34,2661,677,1984,892,247,645,1769,430,1339
190585,34,3498,995,2503,1620,517,1103,1878,478,1400
190594,34,13409,4639,8770,10324,3487,6837,3085,1152,1933
190600,34,9855,3752,6103,7807,2933,4874,2048,819,1229
190619,34,5480,2268,3212,3866,1638,2228,1614,630,984
190628,34,7670,3081,4589,4503,1902,2601,3167,1179,1988
190637,34,9001,2891,6110,5959,1961,3998,3042,930,2112
190646,34,2638,690,1948,1782,485,1297,856,205,651
190655,34,9284,5019,4265,5610,3267,2343,3674,1752,1922
190664,34,11179,5228,5951,8229,3784,4445,2950,1444,1506
190673,34,6374,2936,3438,3498,1747,1751,2876,1189,1687
190691,34,4045,1341,2704,2731,906,1825,1314,435,879
190707,34,7,1,6,7,1,6,,,
190716,34,1086,260,826,785,195,590,301,65,236
190725,34,1324,336,988,1210,307,903,114,29,85
190752,34,37,37,0,37,37,0,,,
190761,34,865,294,571,808,282,526,57,12,45
190840,34,2514,1114,1400,1341,642,699,1173,472,701
190956,34,137,14,123,10,2,8,127,12,115
190983,34,431,130,301,414,128,286,17,2,15
191083,34,4109,1892,2217,2875,1404,1471,1234,488,746
191126,34,6292,1106,5186,5571,930,4641,721,176,545
191199,34,1892,792,1100,1118,518,600,774,274,500
191205,34,376,264,112,361,254,107,15,10,5
191241,34,7249,2955,4294,7032,2846,4186,217,109,108
191302,34,680,272,408,388,163,225,292,109,183
191311,34,108,32,76,108,32,76,,,
191339,34,1478,457,1021,784,277,507,694,180,514
191515,34,1593,729,864,1592,728,864,1,1,0
191533,34,745,303,442,731,298,433,14,5,9
191597,34,542,76,466,346,54,292,196,22,174
191612,34,856,349,507,605,249,356,251,100,151
191621,34,547,243,304,519,229,290,28,14,14
191630,34,1101,531,570,1091,523,568,10,8,2
191649,34,4341,1895,2446,4114,1782,2332,227,113,114
191676,34,570,203,367,536,191,345,34,12,22
191719,34,4419,2124,2295,2756,1504,1252,1663,620,1043
191728,34,630,127,503,393,84,309,237,43,194
191931,34,1824,874,950,1792,852,940,32,22,10
191940,34,89,7,82,89,7,82,,,
191959,34,37,26,11,37,26,11,,,
191968,34,3290,1477,1813,3210,1436,1774,80,41,39
191986,34,1045,402,643,690,300,390,355,102,253
192004,34,191,47,144,183,44,139,8,3,5
192022,34,1023,368,655,675,272,403,348,96,252
192040,34,109,44,65,105,42,63,4,2,2
192110,34,369,197,172,369,197,172,,,
192165,34,136,136,0,136,136,0,,,
192192,34,772,193,579,706,179,527,66,14,52
192271,34,840,80,760,749,75,674,91,5,86
192323,34,1855,729,1126,1582,684,898,273,45,228
192448,34,4644,1479,3165,4123,1358,2765,521,121,400
192484,34,137,3,134,59,1,58,78,2,76
192509,34,497,63,434,467,59,408,30,4,26
192624,34,109,109,0,109,109,0,,,
192688,34,378,68,310,294,44,250,84,24,60
192703,34,2308,1321,987,2166,1223,943,142,98,44
192712,34,349,179,170,348,178,170,1,1,0
192749,34,962,383,579,929,369,560,33,14,19
192785,34,700,81,619,145,23,122,555,58,497
192800,34,7,0,7,1,0,1,6,0,6
192819,34,3735,1571,2164,3580,1496,2084,155,75,80
192864,34,1145,208,937,991,199,792,154,9,145
192925,34,814,216,598,722,210,512,92,6,86
192961,34,120,19,101,1,0,1,119,19,100
192970,34,15,5,10,15,5,10,,,
193016,34,4581,1320,3261,3848,1041,2807,733,279,454
193052,34,317,317,0,317,317,0,,,
193061,34,41,41,0,41,41,0,,,
193070,34,37,37,0,37,37,0,,,
193201,34,292,32,260,292,32,260,,,
193247,34,76,76,0,76,76,0,,,
193265,34,5,5,0,4,4,0,1,1,0
193283,34,1850,767,1083,1204,550,654,646,217,429
193292,34,2565,717,1848,1990,599,1391,575,118,457
193308,34,4314,1286,3028,2529,914,1615,1785,372,1413
193326,34,5698,2265,3433,2977,1290,1687,2721,975,1746
193353,34,1230,353,877,961,284,677,269,69,200
193380,34,95,12,83,,,,95,12,83
193399,34,1739,344,1395,1595,329,1266,144,15,129
193478,34,8107,3823,4284,4212,2158,2054,3895,1665,2230
193584,34,1508,389,1119,1455,376,1079,53,13,40
193609,34,59,23,36,59,23,36,,,
193654,34,5712,1362,4350,5272,1242,4030,440,120,320
193858,34,183,15,168,183,15,168,,,
193900,34,22952,9505,13447,22042,9086,12956,910,419,491
193946,34,1985,729,1256,1298,521,777,687,208,479
193973,34,2123,746,1377,2077,728,1349,46,18,28
193991,34,28,3,25,21,1,20,7,2,5
194028,34,420,153,267,275,114,161,145,39,106
194091,34,2401,1404,997,2114,1228,886,287,176,111
194116,34,424,33,391,127,12,115,297,21,276
194161,34,650,260,390,482,179,303,168,81,87
194189,34,100,100,0,100,100,0,,,
194222,34,2592,1155,1437,1592,762,830,1000,393,607
194240,34,2571,949,1622,1117,493,624,1454,456,998
194259,34,8,1,7,8,1,7,,,
194310,34,5660,1952,3708,5366,1808,3558,294,144,150
194392,34,503,317,186,489,311,178,14,6,8
194435,34,60,2,58,60,2,58,,,
194499,34,613,120,493,613,120,493,,,
194569,34,99,63,36,59,37,22,40,26,14
194578,34,3001,850,2151,2949,828,2121,52,22,30
194657,34,92,92,0,92,92,0,,,
194666,34,347,347,0,347,347,0,,,
194693,34,24,24,0,24,24,0,,,
194718,34,35,35,0,35,35,0,,,
194736,34,111,111,0,111,111,0,,,
194763,34,256,256,0,256,256,0,,,
194824,34,3884,2679,1205,3836,2637,1199,48,42,6
194958,34,822,255,567,688,232,456,134,23,111
195003,34,9950,6534,3416,9597,6292,3305,353,242,111
195030,34,4944,2349,2595,4776,2304,2472,168,45,123
195058,34,2829,1214,1615,1456,730,726,1373,484,889
195067,34,148,9,139,103,5,98,45,4,41
195128,34,879,230,649,852,226,626,27,4,23
195164,34,1220,683,537,1200,673,527,20,10,10
195173,34,1750,632,1118,1640,588,1052,110,44,66
195191,34,237,23,214,206,17,189,31,6,25
195216,34,1597,735,862,1594,732,862,3,3,0
195234,34,1180,400,780,1132,380,752,48,20,28
195243,34,771,408,363,736,379,357,35,29,6
195289,34,125,18,107,13,1,12,112,17,95
195304,34,1033,225,808,1018,218,800,15,7,8
195322,34,989,393,596,532,230,302,457,163,294
195438,34,175,175,0,175,175,0,,,
195474,34,2616,1167,1449,2561,1141,1420,55,26,29
195526,34,1960,836,1124,1939,827,1112,21,9,12
195544,34,2956,922,2034,2630,828,1802,326,94,232
195702,34,140,19,121,82,13,69,58,6,52
195720,34,1973,811,1162,1897,786,1111,76,25,51
195784,34,617,84,533,617,84,533,,,
195809,34,7176,3236,3940,6980,3129,3851,196,107,89
195988,34,560,229,331,320,159,161,240,70,170
196006,34,2305,1400,905,2035,1316,719,270,84,186
196015,34,2281,946,1335,1872,818,1054,409,128,281
196024,34,1777,765,1012,1341,683,658,436,82,354
196033,34,1286,540,746,1181,494,687,105,46,59
196042,34,7339,4389,2950,5761,3457,2304,1578,932,646
196051,34,1256,586,670,1042,537,505,214,49,165
196060,34,9524,4448,5076,8890,4129,4761,634,319,315
196079,34,11291,5430,5861,10977,5247,5730,314,183,131
196088,34,16354,8852,7502,14859,8186,6673,1495,666,829
196097,34,14059,6959,7100,12972,6379,6593,1087,580,507
196103,34,1248,627,621,931,476,455,317,151,166
196112,34,1471,1030,441,1324,945,379,147,85,62
196121,34,4092,1646,2446,3504,1464,2040,588,182,406
196130,34,4118,1752,2366,3597,1497,2100,521,255,266
196149,34,4639,2125,2514,4519,2054,2465,120,71,49
196158,34,2477,1036,1441,2393,998,1395,84,38,46
196167,34,3206,1182,2024,3073,1121,1952,133,61,72
196176,34,4827,1725,3102,4384,1511,2873,443,214,229
196185,34,3743,1514,2229,3656,1465,2191,87,49,38
196194,34,4489,2121,2368,4078,1926,2152,411,195,216
196200,34,1634,636,998,1560,615,945,74,21,53
196219,34,2363,992,1371,2160,906,1254,203,86,117
196237,34,3189,1299,1890,2683,1052,1631,506,247,259
196246,34,3080,1200,1880,2697,1065,1632,383,135,248
196255,34,282,56,226,262,52,210,20,4,16
196264,34,6837,2297,4540,3114,848,2266,3723,1449,2274
196291,34,1007,865,142,916,781,135,91,84,7
196307,34,157,36,121,128,31,97,29,5,24
196389,34,603,128,475,599,128,471,4,0,4
196413,34,10963,5031,5932,10507,4791,5716,456,240,216
196431,34,310,310,0,310,310,0,,,
196440,34,7,7,0,7,7,0,,,
196565,34,997,358,639,562,256,306,435,102,333
196583,34,57,57,0,57,57,0,,,
196592,34,3479,1050,2429,2521,773,1748,958,277,681
196653,34,912,106,806,302,37,265,610,69,541
196680,34,13759,7030,6729,,,,13759,7030,6729
196699,34,887,355,532,459,206,253,428,149,279
196866,34,1502,828,674,1502,828,674,,,
197018,34,1659,1659,0,1659,1659,0,,,
197027,34,731,573,158,731,573,158,,,
197036,34,3155,2419,736,3155,2419,736,,,
197045,34,2084,838,1246,1706,715,991,378,123,255
197133,34,1751,657,1094,1741,650,1091,10,7,3
197142,34,354,175,179,302,157,145,52,18,34
197151,34,2743,728,2015,2683,706,1977,60,22,38
197197,34,1231,438,793,1161,414,747,70,24,46
197221,34,77,57,20,77,57,20,,,
197230,34,202,78,124,199,77,122,3,1,2
197285,34,634,167,467,558,145,413,76,22,54
197294,34,5537,2514,3023,2488,1230,1258,3049,1284,1765
197337,34,62,1,61,59,1,58,3,0,3
197531,34,167,84,83,167,84,83,,,
197601,34,90,90,0,90,90,0,,,
197647,34,84,84,0,84,84,0,,,
197674,34,161,161,0,161,161,0,,,
197692,34,47,47,0,47,47,0,,,
197708,34,2198,1194,1004,2174,1178,996,24,16,8
197735,34,582,582,0,582,582,0,,,
197744,34,151,151,0,151,151,0,,,
197814,34,863,223,640,267,89,178,596,134,462
197850,34,1125,341,784,267,108,159,858,233,625
197869,34,14550,6420,8130,13420,5917,7503,1130,503,627
197887,34,3028,1062,1966,997,391,606,2031,671,1360
197911,34,757,360,397,726,354,372,31,6,25
197966,34,1313,383,930,354,102,252,959,281,678
197984,34,1019,537,482,951,513,438,68,24,44
197993,34,138,0,138,128,0,128,10,0,10
198011,34,696,250,446,275,90,185,421,160,261
198039,34,1447,525,922,508,195,313,939,330,609
198066,34,556,350,206,543,342,201,13,8,5
198084,34,795,292,503,388,182,206,407,110,297
198109,34,432,30,402,126,9,117,306,21,285
198118,34,1769,654,1115,680,309,371,1089,345,744
198136,34,2414,1161,1253,1972,910,1062,442,251,191
198154,34,6949,2754,4195,2373,1008,1365,4576,1746,2830
198206,34,869,272,597,379,158,221,490,114,376
198215,34,778,366,412,702,349,353,76,17,59
198233,34,1919,777,1142,699,316,383,1220,461,759
198251,34,3335,1137,2198,941,350,591,2394,787,1607
198260,34,11823,4984,6839,4851,2151,2700,6972,2833,4139
198303,34,585,348,237,547,335,212,38,13,25
198321,34,1208,385,823,441,137,304,767,248,519
198330,34,2102,718,1384,1052,371,681,1050,347,703
198367,34,1497,561,936,504,238,266,993,323,670
198376,34,1859,557,1302,733,262,471,1126,295,831
198385,34,1380,649,731,1380,649,731,,,
198419,34,4825,2336,2489,4798,2321,2477,27,15,12
198455,34,2630,972,1658,506,233,273,2124,739,1385
198464,34,16597,7153,9444,13860,5970,7890,2737,1183,1554
198491,34,774,127,647,155,22,133,619,105,514
198507,34,1562,647,915,1352,586,766,210,61,149
198516,34,4645,1870,2775,4452,1779,2673,193,91,102
198534,34,7361,2651,4710,3028,1156,1872,4333,1495,2838
198543,34,4432,1292,3140,3107,905,2202,1325,387,938
198552,34,5478,1818,3660,1549,631,918,3929,1187,2742
198561,34,1408,458,950,1113,423,690,295,35,260
198570,34,2359,740,1619,703,263,440,1656,477,1179
198598,34,436,255,181,416,249,167,20,6,14
198613,34,653,323,330,630,312,318,23,11,12
198622,34,6744,2667,4077,2611,1141,1470,4133,1526,2607
198640,34,460,115,345,131,40,91,329,75,254
198668,34,605,188,417,244,111,133,361,77,284
198677,34,21,8,13,14,6,8,7,2,5
198695,34,3464,1542,1922,3424,1523,1901,40,19,21
198710,34,854,287,567,315,124,191,539,163,376
198729,34,828,206,622,300,81,219,528,125,403
198756,34,775,335,440,726,320,406,49,15,34
198774,34,2157,710,1447,932,348,584,1225,362,863
198808,34,642,206,436,609,202,407,33,4,29
198817,34,1035,344,691,390,172,218,645,172,473
198835,34,998,420,578,942,406,536,56,14,42
198844,34,39,0,39,39,0,39,,,
198862,34,622,345,277,600,336,264,22,9,13
198871,34,199,156,43,193,151,42,6,5,1
198899,34,725,357,368,666,339,327,59,18,41
198905,34,298,76,222,134,29,105,164,47,117
198914,34,217,66,151,91,29,62,126,37,89
198923,34,451,152,299,124,46,78,327,106,221
198950,34,962,0,962,925,0,925,37,0,37
198969,34,1116,570,546,963,510,453,153,60,93
198978,34,483,61,422,466,60,406,17,1,16
198987,34,1410,523,887,519,212,307,891,311,580
199005,34,2,0,2,2,0,2,,,
199023,34,242,110,132,118,60,58,124,50,74
199032,34,606,328,278,499,283,216,107,45,62
199069,34,1516,495,1021,922,365,557,594,130,464
199078,34,139,15,124,137,15,122,2,0,2
199087,34,1042,349,693,330,129,201,712,220,492
199102,34,8478,3293,5185,7427,2781,4646,1051,512,539
199111,34,2296,994,1302,2016,850,1166,280,144,136
199120,34,15486,6211,9275,14737,5859,8878,749,352,397
199139,34,18906,9943,8963,15928,8355,7573,2978,1588,1390
199148,34,11519,3864,7655,9216,3110,6106,2303,754,1549
199157,34,4022,1190,2832,3404,1045,2359,618,145,473
199184,34,705,269,436,684,260,424,21,9,12
199193,34,19482,9940,9542,18035,9082,8953,1447,858,589
199209,34,955,444,511,792,399,393,163,45,118
199218,34,11590,4077,7513,9351,3533,5818,2239,544,1695
199263,34,209,53,156,52,7,45,157,46,111
199272,34,504,257,247,439,239,200,65,18,47
199281,34,4830,1781,3049,3543,1364,2179,1287,417,870
199306,34,518,224,294,493,212,281,25,12,13
199324,34,549,195,354,61,24,37,488,171,317
199333,34,3887,1324,2563,1788,718,1070,2099,606,1493
199412,34,998,336,662,935,318,617,63,18,45
199421,34,947,297,650,330,110,220,617,187,430
199449,34,992,268,724,306,111,195,686,157,529
199458,34,98,69,29,95,67,28,3,2,1
199467,34,244,48,196,88,22,66,156,26,130
199476,34,735,141,594,214,37,177,521,104,417
199485,34,746,228,518,214,82,132,532,146,386
199494,34,2864,976,1888,850,334,516,2014,642,1372
199582,34,596,301,295,499,245,254,97,56,41
199607,34,240,4,236,191,0,191,49,4,45
199625,34,699,199,500,273,96,177,426,103,323
199634,34,1768,589,1179,700,292,408,1068,297,771
199643,34,718,306,412,635,279,356,83,27,56
199689,34,168,7,161,130,1,129,38,6,32
199698,34,600,240,360,505,233,272,95,7,88
199722,34,687,207,480,267,115,152,420,92,328
199731,34,1262,399,863,399,134,265,863,265,598
199740,34,1212,299,913,247,82,165,965,217,748
199759,34,425,283,142,251,161,90,174,122,52
199768,34,1068,387,681,442,183,259,626,204,422
199786,34,2093,755,1338,631,268,363,1462,487,975
199795,34,328,119,209,118,41,77,210,78,132
199838,34,1409,381,1028,442,135,307,967,246,721
199847,34,4076,1823,2253,4018,1789,2229,58,34,24
199856,34,13973,6237,7736,4470,2227,2243,9503,4010,5493
199865,34,505,159,346,503,159,344,2,0,2
199883,34,163,19,144,163,19,144,,,
199892,34,1609,601,1008,566,248,318,1043,353,690
199908,34,1066,365,701,370,127,243,696,238,458
199926,34,893,346,547,378,177,201,515,169,346
199953,34,793,217,576,263,84,179,530,133,397
199962,34,1681,684,997,1627,665,962,54,19,35
199971,34,41,26,15,41,26,15,,,
199980,34,20,19,1,20,19,1,,,
199999,34,3594,853,2741,3046,744,2302,548,109,439
200004,34,7877,3410,4467,6063,2680,3383,1814,730,1084
200013,34,439,74,365,245,41,204,194,33,161
200022,34,1781,1045,736,1091,638,453,690,407,283
200059,34,906,381,525,741,331,410,165,50,115
200086,34,119,36,83,90,29,61,29,7,22
200110,34,25,1,24,25,1,24,,,
200156,34,711,401,310,682,384,298,29,17,12
200192,34,382,130,252,234,91,143,148,39,109
200208,34,245,67,178,134,49,85,111,18,93
200217,34,1691,687,1004,1367,552,815,324,135,189
200226,34,660,241,419,480,203,277,180,38,142
200253,34,1790,631,1159,1408,510,898,382,121,261
200280,34,7313,4138,3175,5272,2773,2499,2041,1365,676
200305,34,1019,614,405,827,529,298,192,85,107
200314,34,298,72,226,192,57,135,106,15,91
200332,34,7282,3621,3661,6417,3296,3121,865,325,540
200341,34,397,129,268,287,104,183,110,25,85
200466,34,178,78,100,148,71,77,30,7,23
200484,34,131,58,73,112,52,60,19,6,13
200527,34,390,146,244,343,129,214,47,17,30
200554,34,382,137,245,356,123,233,26,14,12
200572,34,709,324,385,541,259,282,168,65,103
200590,34,142,23,119,134,19,115,8,4,4
200785,34,295,35,260,134,14,120,161,21,140
200800,34,7984,4177,3807,6449,3395,3054,1535,782,753
200846,34,453,179,274,343,126,217,110,53,57
200873,34,56,30,26,38,16,22,18,14,4
201034,34,314,132,182,83,24,59,231,108,123
201061,34,173,58,115,166,55,111,7,3,4
201098,34,34,13,21,19,5,14,15,8,7
201104,34,1804,768,1036,1397,579,818,407,189,218
201131,34,22,7,15,15,0,15,7,7,0
201140,34,29,23,6,,,,29,23,6
201159,34,55,40,15,31,21,10,24,19,5
201177,34,192,12,180,72,6,66,120,6,114
201195,34,2065,910,1155,1966,863,1103,99,47,52
201283,34,348,122,226,175,81,94,173,41,132
201371,34,487,259,228,476,253,223,11,6,5
201432,34,560,185,375,357,111,246,203,74,129
201441,34,9286,4071,5215,8575,3678,4897,711,393,318
201469,34,474,84,390,355,73,282,119,11,108
201478,34,182,83,99,127,37,90,55,46,9
201496,34,183,121,62,183,121,62,,,
201539,34,68,6,62,45,4,41,23,2,21
201548,34,1387,553,834,1352,536,816,35,17,18
201645,34,4374,2269,2105,4325,2243,2082,49,26,23
201654,34,2711,1212,1499,2651,1183,1468,60,29,31
201672,34,1181,265,916,256,74,182,925,191,734
201681,34,2,0,2,2,0,2,,,
201690,34,4781,1328,3453,2569,760,1809,2212,568,1644
201751,34,24,4,20,9,1,8,15,3,12
201803,34,23,3,20,23,3,20,,,
201821,34,758,61,697,562,46,516,196,15,181
201867,34,101,16,85,101,16,85,,,
201885,34,21511,10706,10805,18582,9550,9032,2929,1156,1773
201928,34,4655,1851,2804,1405,637,768,3250,1214,2036
201946,34,1764,536,1228,712,288,424,1052,248,804
201955,34,2512,922,1590,1534,647,887,978,275,703
201964,34,786,336,450,548,247,301,238,89,149
201973,34,2537,705,1832,549,181,368,1988,524,1464
202046,34,421,119,302,410,112,298,11,7,4
202073,34,153,73,80,153,73,80,,,
202134,34,7776,3542,4234,6081,2817,3264,1695,725,970
202152,34,61,6,55,61,6,55,,,
202170,34,731,231,500,719,230,489,12,1,11
202222,34,12132,5548,6584,3182,1488,1694,8950,4060,4890
202356,34,9425,3453,5972,2490,1110,1380,6935,2343,4592
202435,34,77,16,61,48,13,35,29,3,26
202453,34,35,29,6,35,29,6,,,
202480,34,6353,3309,3044,6099,3187,2912,254,122,132
202514,34,329,190,139,315,181,134,14,9,5
202523,34,1723,823,900,1717,820,897,6,3,3
202648,34,785,245,540,203,96,107,582,149,433
202657,34,244,55,189,33,7,26,211,48,163
202763,34,1585,516,1069,1524,493,1031,61,23,38
202806,34,4944,1967,2977,1922,704,1218,3022,1263,1759
202888,34,24,3,21,17,3,14,7,0,7
202903,34,197,111,86,113,54,59,84,57,27
202912,34,299,12,287,119,6,113,180,6,174
202949,34,74,67,7,74,67,7,,,
202985,34,13,1,12,8,1,7,5,0,5
203030,34,29,0,29,29,0,29,,,
203085,34,673,345,328,658,339,319,15,6,9
203128,34,545,252,293,493,229,264,52,23,29
203146,34,69,62,7,69,62,7,,,
203155,34,1203,596,607,923,495,428,280,101,179
203234,34,34,2,32,34,2,32,,,
203289,34,21,13,8,21,13,8,,,
203331,34,26419,7928,18491,8431,2479,5952,17988,5449,12539
203368,34,1792,985,807,1748,959,789,44,26,18
203386,34,2409,175,2234,1522,118,1404,887,57,830
203438,34,88,0,88,34,0,34,54,0,54
203447,34,1219,468,751,112,34,78,1107,434,673
203456,34,714,262,452,6,1,5,708,261,447
203465,34,2228,833,1395,687,283,404,1541,550,991
203474,34,1296,506,790,195,66,129,1101,440,661
203483,34,1388,583,805,226,105,121,1162,478,684
203492,34,912,232,680,180,26,154,732,206,526
203517,34,14898,5686,9212,12440,4653,7787,2458,1033,1425
203526,34,1278,448,830,145,58,87,1133,390,743
203535,34,1346,601,745,1346,601,745,,,
203544,34,474,65,409,306,37,269,168,28,140
203580,34,437,235,202,410,223,187,27,12,15
203599,34,2816,1058,1758,770,340,430,2046,718,1328
203614,34,264,58,206,264,58,206,,,
203678,34,1063,247,816,282,104,178,781,143,638
203720,34,101,51,50,79,49,30,22,2,20
203739,34,39,7,32,33,5,28,6,2,4
203748,34,4274,1453,2821,1188,474,714,3086,979,2107
203757,34,579,257,322,523,241,282,56,16,40
203775,34,607,268,339,534,233,301,73,35,38
203845,34,743,361,382,706,340,366,37,21,16
203881,34,938,396,542,227,93,134,711,303,408
203942,34,21,11,10,21,11,10,,,
203960,34,1056,119,937,332,44,288,724,75,649
204006,34,1532,761,771,1129,537,592,403,224,179
204015,34,766,351,415,558,249,309,208,102,106
204024,34,12686,6194,6492,12374,6016,6358,312,178,134
204121,34,39,0,39,17,0,17,22,0,22
204158,34,98,20,78,98,20,78,,,
204176,34,598,74,524,452,60,392,146,14,132
204185,34,1316,678,638,1297,666,631,19,12,7
204194,34,1191,462,729,991,406,585,200,56,144
204200,34,749,320,429,688,303,385,61,17,44
204255,34,531,232,299,267,135,132,264,97,167
204264,34,1024,451,573,895,427,468,129,24,105
204334,34,78,1,77,1,0,1,77,1,76
204422,34,866,275,591,249,97,152,617,178,439
204431,34,25,3,22,25,3,22,,,
204440,34,760,376,384,193,97,96,567,279,288
204459,34,1,0,1,1,0,1,,,
204468,34,837,406,431,711,373,338,126,33,93
204486,34,1677,1386,291,1530,1287,243,147,99,48
204501,34,2104,863,1241,2096,859,1237,8,4,4
204608,34,240,215,25,240,215,25,,,
204617,34,586,293,293,536,270,266,50,23,27
204635,34,1736,954,782,1690,926,764,46,28,18
204662,34,204,86,118,177,71,106,27,15,12
204671,34,457,182,275,389,150,239,68,32,36
204680,34,422,188,234,353,156,197,69,32,37
204699,34,519,249,270,418,196,222,101,53,48
204705,34,975,463,512,734,347,387,241,116,125
204714,34,70,3,67,70,3,67,,,
204723,34,148,120,28,148,120,28,,,
204769,34,72,4,68,72,4,68,,,
204778,34,30,1,29,30,1,29,,,
204796,34,37080,18778,18302,34159,17204,16955,2921,1574,1347
204802,34,203,75,128,157,52,105,46,23,23
204820,34,624,197,427,420,130,290,204,67,137
204839,34,399,128,271,298,89,209,101,39,62
204848,34,456,166,290,309,100,209,147,66,81
204857,34,13105,5095,8010,10143,4430,5713,2962,665,2297
204866,34,449,100,349,306,64,242,143,36,107
204884,34,121,4,117,121,4,117,,,
204893,34,38,8,30,15,6,9,23,2,21
204909,34,948,414,534,937,408,529,11,6,5
204936,34,1547,637,910,1476,600,876,71,37,34
204945,34,3341,1216,2125,1030,426,604,2311,790,1521
204963,34,8,1,7,8,1,7,,,
204981,34,51,13,38,14,2,12,37,11,26
205027,34,28,28,0,28,28,0,,,
205054,34,345,39,306,345,39,306,,,
205090,34,69,8,61,9,1,8,60,7,53
205124,34,28,28,0,28,28,0,,,
205142,34,102,32,70,98,32,66,4,0,4
205179,34,401,56,345,387,55,332,14,1,13
205203,34,545,180,365,313,141,172,232,39,193
205391,34,121,23,98,56,10,46,65,13,52
205443,34,1785,768,1017,1420,629,791,365,139,226
205470,34,8733,3674,5059,1999,1002,997,6734,2672,4062
205559,34,21,3,18,21,3,18,,,
205841,34,4694,1908,2786,1380,678,702,3314,1230,2084
205887,34,287,36,251,287,36,251,,,
205957,34,1942,810,1132,1768,733,1035,174,77,97
205966,34,531,145,386,176,57,119,355,88,267
206011,34,742,398,344,239,125,114,503,273,230
206039,34,18,1,17,14,0,14,4,1,3
206048,34,1338,651,687,1026,540,486,312,111,201
206084,34,8661,4297,4364,7506,3725,3781,1155,572,583
206154,34,18,14,4,,,,18,14,4
206172,34,5,0,5,5,0,5,,,
206181,34,129,34,95,50,4,46,79,30,49
206279,34,446,226,220,158,78,80,288,148,140
206321,34,70,18,52,41,1,40,29,17,12
206349,34,511,40,471,429,33,396,82,7,75
206394,34,37,9,28,16,5,11,21,4,17
206437,34,1076,484,592,953,450,503,123,34,89
206446,34,748,234,514,301,136,165,447,98,349
206491,34,313,133,180,260,107,153,53,26,27
206507,34,694,309,385,652,291,361,42,18,24
206525,34,830,379,451,805,368,437,25,11,14
206589,34,1382,654,728,1380,653,727,2,1,1
206604,34,5046,2307,2739,3875,1743,2132,1171,564,607
206613,34,713,306,407,475,183,292,238,123,115
206622,34,3646,1587,2059,3424,1494,1930,222,93,129
206695,34,6139,2778,3361,5302,2436,2866,837,342,495
206817,34,174,82,92,138,65,73,36,17,19
206835,34,523,284,239,407,235,172,116,49,67
206862,34,644,323,321,624,314,310,20,9,11
206905,34,31,11,20,31,11,20,,,
206914,34,2168,759,1409,1510,537,973,658,222,436
206923,34,1033,322,711,658,255,403,375,67,308
206932,34,336,26,310,148,22,126,188,4,184
206941,34,8787,3331,5456,6352,2370,3982,2435,961,1474
206996,34,881,215,666,452,131,321,429,84,345
207041,34,2083,798,1285,1748,683,1065,335,115,220
207050,34,670,190,480,395,132,263,275,58,217
207069,34,538,165,373,291,116,175,247,49,198
207087,34,8,1,7,8,1,7,,,
207102,34,71,20,51,71,20,51,,,
207157,34,198,107,91,162,94,68,36,13,23
207209,34,1224,465,759,1132,422,710,92,43,49
207236,34,1039,299,740,538,208,330,501,91,410
207254,34,520,467,53,520,467,53,,,
207263,34,4178,1529,2649,2980,1132,1848,1198,397,801
207281,34,1273,445,828,706,285,421,567,160,407
207290,34,899,335,564,659,284,375,240,51,189
207306,34,1093,438,655,904,378,526,189,60,129
207324,34,1499,599,900,1384,572,812,115,27,88
207342,34,985,99,886,946,96,850,39,3,36
207351,34,879,325,554,649,274,375,230,51,179
207388,34,15721,7605,8116,13878,6673,7205,1843,932,911
207397,34,2845,958,1887,611,283,328,2234,675,1559
207403,34,878,378,500,863,371,492,15,7,8
207449,34,7604,2827,4777,2325,960,1365,5279,1867,3412
207458,34,1044,337,707,1009,315,694,35,22,13
207500,34,16159,8087,8072,14361,7115,7246,1798,972,826
207564,34,1374,919,455,788,598,190,586,321,265
207582,34,2531,980,1551,2132,832,1300,399,148,251
207661,34,2052,776,1276,1504,570,934,548,206,342
207670,34,3232,1049,2183,1326,508,818,1906,541,1365
207704,34,168,1,167,77,1,76,91,0,91
207722,34,591,219,372,542,203,339,49,16,33
207740,34,766,207,559,408,143,265,358,64,294
207786,34,1,0,1,1,0,1,,,
207847,34,2445,1052,1393,1622,753,869,823,299,524
207856,34,287,167,120,255,145,110,32,22,10
207865,34,2853,1066,1787,2370,921,1449,483,145,338
207935,34,8220,2838,5382,2427,1030,1397,5793,1808,3985
207962,34,481,423,58,481,423,58,,,
207971,34,1961,987,974,1828,905,923,133,82,51
208035,34,621,172,449,258,121,137,363,51,312
208044,34,37,6,31,37,6,31,,,
208053,34,15,7,8,,,,15,7,8
208275,34,640,226,414,349,137,212,291,89,202
208318,34,2506,1122,1384,1149,535,614,1357,587,770
208390,34,4634,2060,2574,1971,854,1117,2663,1206,1457
208406,34,2847,1400,1447,1006,466,540,1841,934,907
208415,34,374,118,256,173,52,121,201,66,135
208433,34,42,0,42,42,0,42,,,
208479,34,352,57,295,352,57,295,,,
208512,34,485,51,434,485,51,434,,,
208637,34,155,36,119,,,,155,36,119
208646,34,2010,821,1189,1232,512,720,778,309,469
208725,34,25,15,10,22,13,9,3,2,1
208822,34,1869,721,1148,1705,661,1044,164,60,104
208859,34,5,0,5,5,0,5,,,
209038,34,4346,2050,2296,1768,823,945,2578,1227,1351
209056,34,1561,564,997,1545,556,989,16,8,8
209065,34,1288,434,854,1194,402,792,94,32,62
209074,34,3267,1458,1809,1144,578,566,2123,880,1243
209083,34,28,9,19,28,9,19,,,
209153,34,2,0,2,2,0,2,,,
209205,34,33,1,32,33,1,32,,,
209241,34,27,27,0,27,27,0,,,
209250,34,2260,854,1406,1006,399,607,1254,455,799
209287,34,285,164,121,250,151,99,35,13,22
209296,34,12,3,9,12,3,9,,,
209409,34,411,174,237,360,162,198,51,12,39
209490,34,752,129,623,481,83,398,271,46,225
209506,34,2625,1356,1269,1683,897,786,942,459,483
209542,34,23894,12369,11525,15642,8090,7552,8252,4279,3973
209551,34,14130,6342,7788,12955,5772,7183,1175,570,605
209603,34,286,68,218,270,62,208,16,6,10
209612,34,1153,451,702,1095,428,667,58,23,35
209667,34,11,0,11,11,0,11,,,
209676,34,10,0,10,10,0,10,,,
209694,34,7,0,7,7,0,7,,,
209700,34,169,20,149,169,20,149,,,
209719,34,38,0,38,38,0,38,,,
209746,34,13546,5674,7872,5208,2252,2956,8338,3422,4916
209807,34,12665,5471,7194,9448,4007,5441,3217,1464,1753
209825,34,2555,934,1621,2497,912,1585,58,22,36
209922,34,1100,471,629,1094,469,625,6,2,4
209940,34,2136,867,1269,719,282,437,1417,585,832
210146,34,2339,926,1413,1825,736,1089,514,190,324
210155,34,773,286,487,419,187,232,354,99,255
210234,34,812,360,452,447,232,215,365,128,237
210270,34,1252,445,807,381,144,237,871,301,570
210304,34,393,145,248,362,133,229,31,12,19
210331,34,643,289,354,510,213,297,133,76,57
210401,34,811,331,480,792,323,469,19,8,11
210429,34,2729,923,1806,2322,781,1541,407,142,265
210438,34,2,2,0,,,,2,2,0
210492,34,193,99,94,179,91,88,14,8,6
210571,34,875,400,475,804,373,431,71,27,44
210599,34,639,320,319,639,320,319,,,
210605,34,6905,3055,3850,2061,966,1095,4844,2089,2755
210669,34,1035,476,559,1026,474,552,9,2,7
210711,34,33,2,31,33,2,31,,,
210739,34,1666,580,1086,1389,505,884,277,75,202
210748,34,52,2,50,24,0,24,28,2,26
210775,34,1503,507,996,1172,434,738,331,73,258
210784,34,115,1,114,94,1,93,21,0,21
211006,34,317,295,22,312,294,18,5,1,4
211024,34,299,144,155,203,90,113,96,54,42
211079,34,769,276,493,281,114,167,488,162,326
211088,34,1261,444,817,1145,385,760,116,59,57
211273,34,1006,0,1006,1001,0,1001,5,0,5
211291,34,2698,1293,1405,2697,1293,1404,1,0,1
211307,34,3988,1583,2405,1266,605,661,2722,978,1744
211316,34,74,1,73,54,1,53,20,0,20
211334,34,9,0,9,9,0,9,,,
211343,34,1438,517,921,539,246,293,899,271,628
211352,34,863,361,502,820,339,481,43,22,21
211431,34,1044,153,891,716,109,607,328,44,284
211440,34,5289,2633,2656,5142,2560,2582,147,73,74
211468,34,800,59,741,563,42,521,237,17,220
211477,34,700,239,461,134,58,76,566,181,385
211556,34,901,259,642,864,247,617,37,12,25
211583,34,795,326,469,679,304,375,116,22,94
211608,34,490,165,325,428,149,279,62,16,46
211635,34,73,12,61,73,12,61,,,
211802,34,142,38,104,142,38,104,,,
211893,34,70,41,29,70,41,29,,,
211927,34,5731,2021,3710,1331,606,725,4400,1415,2985
211981,34,1193,465,728,1099,432,667,94,33,61
212009,34,1506,627,879,1499,622,877,7,5,2
212045,34,123,30,93,121,30,91,2,0,2
212054,34,10995,5618,5377,9940,5189,4751,1055,429,626
212106,34,3646,1352,2294,3577,1315,2262,69,37,32
212115,34,3171,1406,1765,2795,1244,1551,376,162,214
212133,34,1228,391,837,847,297,550,381,94,287
212197,34,1240,521,719,1135,482,653,105,39,66
212230,34,17,2,15,15,2,13,2,0,2
212267,34,39,1,38,22,0,22,17,1,16
212276,34,28,0,28,20,0,20,8,0,8
212294,34,34,0,34,27,0,27,7,0,7
212300,34,9,0,9,9,0,9,,,
212328,34,45,1,44,28,1,27,17,0,17
212337,34,68,3,65,39,1,38,29,2,27
212355,34,66,1,65,46,1,45,20,0,20
212382,34,81,1,80,47,1,46,34,0,34
212391,34,34,1,33,24,1,23,10,0,10
212434,34,98,92,6,98,92,6,,,
212577,34,1499,669,830,1497,667,830,2,2,0
212601,34,1947,802,1145,1879,780,1099,68,22,46
212656,34,737,378,359,688,353,335,49,25,24
212674,34,1592,778,814,1588,776,812,4,2,2
212753,34,38,0,38,22,0,22,16,0,16
212771,34,107,0,107,55,0,55,52,0,52
212805,34,1551,792,759,1537,783,754,14,9,5
212832,34,1074,248,826,972,226,746,102,22,80
212869,34,706,105,601,422,71,351,284,34,250
212878,34,8341,2519,5822,2397,896,1501,5944,1623,4321
212911,34,1055,497,558,1055,497,558,,,
212975,34,55,38,17,55,38,17,,,
212984,34,1785,406,1379,1504,347,1157,281,59,222
212993,34,59,28,31,49,25,24,10,3,7
213011,34,1041,308,733,796,255,541,245,53,192
213020,34,4850,1874,2976,4400,1666,2734,450,208,242
213163,34,331,45,286,293,43,250,38,2,36
213181,34,269,23,246,221,19,202,48,4,44
213233,34,337,253,84,279,217,62,58,36,22
213251,34,820,377,443,817,376,441,3,1,2
213303,34,810,351,459,625,321,304,185,30,155
213321,34,1226,627,599,1194,611,583,32,16,16
213330,34,9,0,9,9,0,9,,,
213349,34,4735,2041,2694,4341,1865,2476,394,176,218
213358,34,666,262,404,552,225,327,114,37,77
213367,34,1718,622,1096,1439,562,877,279,60,219
213376,34,1359,497,862,980,400,580,379,97,282
213385,34,1968,1000,968,1955,992,963,13,8,5
213400,34,1100,526,574,668,312,356,432,214,218
213455,34,40,2,38,19,2,17,21,0,21
213473,34,79,9,70,45,0,45,34,9,25
213491,34,14,0,14,8,0,8,6,0,6
213507,34,1190,542,648,1159,529,630,31,13,18
213525,34,3257,1091,2166,1000,489,511,2257,602,1655
213534,34,187,58,129,176,55,121,11,3,8
213543,34,4101,2231,1870,4039,2194,1845,62,37,25
213570,34,305,46,259,305,46,259,,,
213589,34,193,172,21,158,140,18,35,32,3
213598,34,1303,463,840,1196,426,770,107,37,70
213622,34,104,17,87,81,16,65,23,1,22
213659,34,2447,735,1712,818,319,499,1629,416,1213
213668,34,750,352,398,749,351,398,1,1,0
213774,34,335,77,258,221,58,163,114,19,95
213826,34,1348,424,924,1263,401,862,85,23,62
213914,34,165,13,152,165,13,152,,,
213932,34,174,23,151,174,23,151,,,
213987,34,1824,745,1079,1707,720,987,117,25,92
213996,34,1740,675,1065,1689,651,1038,51,24,27
214023,34,9,3,6,8,2,6,1,1,0
214041,34,4498,1832,2666,3458,1461,1997,1040,371,669
214069,34,1356,427,929,1018,362,656,338,65,273
214111,34,5680,2206,3474,1583,772,811,4097,1434,2663
214148,34,242,0,242,234,0,234,8,0,8
214157,34,1438,530,908,1358,517,841,80,13,67
214166,34,802,217,585,675,198,477,127,19,108
214175,34,1513,592,921,1470,569,901,43,23,20
214272,34,1203,465,738,935,359,576,268,106,162
214290,34,211,183,28,211,183,28,,,
214379,34,5596,1952,3644,2039,891,1148,3557,1061,2496
214476,34,34,5,29,31,4,27,3,1,2
214528,34,182,172,10,127,118,9,55,54,1
214582,34,390,38,352,263,24,239,127,14,113
214591,34,2320,1513,807,2202,1427,775,118,86,32
214625,34,306,189,117,257,164,93,49,25,24
214634,34,172,52,120,130,41,89,42,11,31
214643,34,224,146,78,209,134,75,15,12,3
214652,34,631,321,310,597,303,294,34,18,16
214670,34,576,325,251,517,292,225,59,33,26
214689,34,1660,862,798,1602,824,778,58,38,20
214698,34,335,184,151,319,178,141,16,6,10
214704,34,1392,832,560,1252,750,502,140,82,58
214713,34,2856,1753,1103,2597,1581,1016,259,172,87
214731,34,790,458,332,710,409,301,80,49,31
214740,34,228,123,105,209,117,92,19,6,13
214759,34,318,136,182,294,121,173,24,15,9
214768,34,321,166,155,303,158,145,18,8,10
214777,34,32201,17253,14948,31294,16661,14633,907,592,315
214786,34,241,139,102,225,130,95,16,9,7
214795,34,436,174,262,384,153,231,52,21,31
214801,34,2187,1263,924,1953,1127,826,234,136,98
214810,34,416,156,260,378,147,231,38,9,29
214829,34,470,295,175,392,245,147,78,50,28
214883,34,749,180,569,161,37,124,588,143,445
214892,34,193,70,123,193,70,123,,,
214944,34,300,259,41,162,145,17,138,114,24
214971,34,95,27,68,91,26,65,4,1,3
215008,34,37,37,0,37,37,0,,,
215044,34,97,14,83,97,14,83,,,
215053,34,170,51,119,161,49,112,9,2,7
215062,34,8157,3686,4471,7738,3540,4198,419,146,273
215105,34,978,331,647,953,323,630,25,8,17
215114,34,578,289,289,546,266,280,32,23,9
215239,34,8300,2599,5701,2407,909,1498,5893,1690,4203
215266,34,754,339,415,708,325,383,46,14,32
215275,34,914,374,540,856,341,515,58,33,25
215284,34,1521,857,664,1477,833,644,44,24,20
215293,34,15564,6922,8642,14847,6542,8305,717,380,337
215309,34,16,2,14,7,1,6,9,1,8
215336,34,10,0,10,10,0,10,,,
215381,34,351,325,26,351,325,26,,,
215390,34,322,87,235,51,14,37,271,73,198
215415,34,671,389,282,564,337,227,107,52,55
215442,34,1851,680,1171,1644,586,1058,207,94,113
215479,34,64,9,55,64,9,55,,,
215530,34,17,0,17,14,0,14,3,0,3
215585,34,2469,753,1716,552,226,326,1917,527,1390
215594,34,247,40,207,185,33,152,62,7,55
215637,34,95,42,53,95,42,53,,,
215655,34,2149,1207,942,1996,1127,869,153,80,73
215682,34,296,271,25,296,271,25,,,
215691,34,366,175,191,271,143,128,95,32,63
215743,34,1312,460,852,1163,432,731,149,28,121
215770,34,3882,1718,2164,3713,1648,2065,169,70,99
215798,34,993,557,436,971,544,427,22,13,9
215886,34,27,4,23,12,2,10,15,2,13
215929,34,2458,1040,1418,2390,998,1392,68,42,26
215947,34,1229,411,818,1104,378,726,125,33,92
215974,34,408,57,351,304,39,265,104,18,86
215983,34,23,5,18,23,5,18,,,
215992,34,61,22,39,60,22,38,1,0,1
216010,34,3204,1576,1628,2900,1417,1483,304,159,145
216038,34,5247,2378,2869,4852,2182,2670,395,196,199
216047,34,29,29,0,29,29,0,,,
216074,34,52,1,51,33,1,32,19,0,19
216083,34,199,63,136,179,62,117,20,1,19
216162,34,337,27,310,337,27,310,,,
216223,34,24,2,22,24,2,22,,,
216278,34,1561,670,891,1543,658,885,18,12,6
216287,34,1186,586,600,1186,586,600,,,
216296,34,754,681,73,727,657,70,27,24,3
216311,34,91,91,0,91,91,0,,,
216339,34,19033,8476,10557,17304,7576,9728,1729,900,829
216357,34,547,288,259,539,283,256,8,5,3
216366,34,2982,760,2222,2572,664,1908,410,96,314
216436,34,82,73,9,82,73,9,,,
216445,34,74,70,4,74,70,4,,,
216454,34,49,44,5,49,44,5,,,
216524,34,1124,589,535,1121,587,534,3,2,1
216542,34,356,163,193,314,149,165,42,14,28
216551,34,55,42,13,53,40,13,2,2,0
216579,34,57,2,55,57,2,55,,,
216597,34,5148,2339,2809,4990,2242,2748,158,97,61
216630,34,33,4,29,33,4,29,,,
216667,34,791,413,378,782,407,375,9,6,3
216694,34,767,318,449,756,313,443,11,5,6
216746,34,36,30,6,30,25,5,6,5,1
216764,34,11008,4495,6513,9588,3940,5648,1420,555,865
216773,34,95,12,83,95,12,83,,,
216807,34,734,342,392,717,335,382,17,7,10
216825,34,2108,660,1448,796,317,479,1312,343,969
216852,34,1977,810,1167,1791,759,1032,186,51,135
216931,34,1426,641,785,1338,614,724,88,27,61
216940,34,162,162,0,162,162,0,,,
217013,34,499,92,407,390,85,305,109,7,102
217040,34,26,26,0,26,26,0,,,
217059,34,2470,1080,1390,2215,935,1280,255,145,110
217077,34,314,109,205,314,109,205,,,
217156,34,5505,2724,2781,5449,2703,2746,56,21,35
217165,34,2229,1400,829,2206,1382,824,23,18,5
217235,34,3141,1252,1889,2955,1162,1793,186,90,96
217305,34,1281,739,542,1098,646,452,183,93,90
217323,34,27,27,0,27,27,0,,,
217402,34,2803,1281,1522,2673,1223,1450,130,58,72
217420,34,3922,1212,2710,3027,940,2087,895,272,623
217475,34,8101,2963,5138,2460,997,1463,5641,1966,3675
217484,34,10408,4557,5851,9496,4140,5356,912,417,495
217493,34,1627,535,1092,1627,535,1092,,,
217518,34,2897,1454,1443,2640,1312,1328,257,142,115
217536,34,1582,504,1078,1524,488,1036,58,16,42
217581,34,86,0,86,55,0,55,31,0,31
217606,34,147,74,73,107,51,56,40,23,17
217615,34,1301,406,895,418,156,262,883,250,633
217624,34,429,241,188,407,232,175,22,9,13
217633,34,2162,697,1465,2053,662,1391,109,35,74
217688,34,2044,746,1298,1860,669,1191,184,77,107
217712,34,1273,315,958,266,92,174,1007,223,784
217721,34,1342,578,764,1324,569,755,18,9,9
217749,34,1791,823,968,1679,780,899,112,43,69
217776,34,650,233,417,496,198,298,154,35,119
217794,34,73,0,73,46,0,46,27,0,27
217819,34,7457,2588,4869,6944,2364,4580,513,224,289
217828,34,31,2,29,18,1,17,13,1,12
217837,34,626,123,503,149,38,111,477,85,392
217864,34,1980,1697,283,1793,1560,233,187,137,50
217873,34,1346,440,906,1234,393,841,112,47,65
217882,34,17879,8755,9124,17139,8318,8821,740,437,303
217891,34,142,59,83,137,57,80,5,2,3
217907,34,585,219,366,559,211,348,26,8,18
217925,34,596,305,291,400,216,184,196,89,107
217934,34,946,133,813,618,81,537,328,52,276
217961,34,579,115,464,556,114,442,23,1,22
217989,34,227,86,141,139,58,81,88,28,60
217998,34,513,334,179,496,323,173,17,11,6
218025,34,1793,576,1217,658,288,370,1135,288,847
218061,34,2072,724,1348,1926,668,1258,146,56,90
218070,34,1631,668,963,1612,654,958,19,14,5
218113,34,6890,2552,4338,2669,1095,1574,4221,1457,2764
218140,34,5491,1755,3736,2596,1032,1564,2895,723,2172
218159,34,106,2,104,78,2,76,28,0,28
218195,34,115,3,112,68,2,66,47,1,46
218229,34,2518,808,1710,2355,759,1596,163,49,114
218238,34,1217,575,642,981,479,502,236,96,140
218335,34,300,32,268,290,31,259,10,1,9
218353,34,5699,1945,3754,2146,912,1234,3553,1033,2520
218399,34,266,129,137,262,125,137,4,4,0
218414,34,877,474,403,849,466,383,28,8,20
218441,34,1156,536,620,1086,504,582,70,32,38
218487,34,1169,271,898,347,141,206,822,130,692
218520,34,3333,838,2495,1005,326,679,2328,512,1816
218539,34,608,293,315,604,292,312,4,1,3
218645,34,2265,818,1447,1834,686,1148,431,132,299
218654,34,1409,446,963,1194,374,820,215,72,143
218663,34,20266,9115,11151,19393,8649,10744,873,466,407
218672,34,307,115,192,251,100,151,56,15,41
218681,34,158,76,82,123,66,57,35,10,25
218690,34,356,188,168,231,118,113,125,70,55
218706,34,143,70,73,118,56,62,25,14,11
218724,34,6833,3046,3787,6336,2790,3546,497,256,241
218733,34,1449,657,792,1297,585,712,152,72,80
218742,34,3358,1116,2242,2829,915,1914,529,201,328
218821,34,559,262,297,507,239,268,52,23,29
218830,34,3771,1349,2422,1573,631,942,2198,718,1480
218858,34,1979,475,1504,461,165,296,1518,310,1208
218885,34,2779,1194,1585,1262,662,600,1517,532,985
218894,34,7240,2513,4727,2485,977,1508,4755,1536,3219
218919,34,336,143,193,298,131,167,38,12,26
218955,34,304,44,260,63,10,53,241,34,207
218964,34,2667,902,1765,2466,830,1636,201,72,129
218973,34,1316,634,682,1300,624,676,16,10,6
218991,34,2489,874,1615,1021,428,593,1468,446,1022
219000,34,1206,450,756,1171,434,737,35,16,19
219037,34,28,0,28,26,0,26,2,0,2
219046,34,1452,474,978,1115,381,734,337,93,244
219082,34,1522,1056,466,1009,722,287,513,334,179
219091,34,453,209,244,413,202,211,40,7,33
219125,34,56,4,52,45,2,43,11,2,9
219143,34,1176,569,607,913,509,404,263,60,203
219170,34,23,3,20,23,3,20,,,
219189,34,577,351,226,438,285,153,139,66,73
219198,34,537,282,255,464,239,225,73,43,30
219204,34,794,357,437,92,56,36,702,301,401
219240,34,37,19,18,11,5,6,26,14,12
219259,34,959,397,562,737,317,420,222,80,142
219277,34,1020,287,733,429,133,296,591,154,437
219295,34,506,164,342,307,141,166,199,23,176
219338,34,15,3,12,15,3,12,,,
219347,34,1509,1171,338,1198,945,253,311,226,85
219356,34,6436,2973,3463,5459,2581,2878,977,392,585
219374,34,285,61,224,91,22,69,194,39,155
219383,34,991,386,605,870,330,540,121,56,65
219392,34,27,4,23,27,4,23,,,
219408,34,146,50,96,89,36,53,57,14,43
219426,34,1437,649,788,759,442,317,678,207,471
219453,34,97,1,96,97,1,96,,,
219471,34,3939,1444,2495,3238,1199,2039,701,245,456
219480,34,570,243,327,370,187,183,200,56,144
219505,34,47,31,16,32,21,11,15,10,5
219587,34,53,0,53,53,0,53,,,
219596,34,175,131,44,175,131,44,,,
219602,34,5589,2294,3295,3950,1578,2372,1639,716,923
219639,34,739,61,678,267,25,242,472,36,436
219709,34,5432,1857,3575,5177,1740,3437,255,117,138
219718,34,2450,1344,1106,1994,1115,879,456,229,227
219790,34,664,318,346,538,273,265,126,45,81
219806,34,1125,487,638,1103,474,629,22,13,9
219824,34,3382,1179,2203,1700,652,1048,1682,527,1155
219833,34,857,378,479,811,356,455,46,22,24
219851,34,22,2,20,22,2,20,,,
219879,34,1306,579,727,755,356,399,551,223,328
219888,34,2428,885,1543,1366,576,790,1062,309,753
219903,34,946,83,863,946,83,863,,,
219921,34,197,125,72,126,77,49,71,48,23
219949,34,1304,521,783,1211,492,719,93,29,64
219976,34,2251,891,1360,2095,830,1265,156,61,95
219994,34,500,311,189,466,278,188,34,33,1
220002,34,29,5,24,29,5,24,,,
220057,34,1350,361,989,623,229,394,727,132,595
220075,34,7716,3004,4712,6444,2542,3902,1272,462,810
220118,34,148,6,142,148,6,142,,,
220127,34,328,192,136,304,171,133,24,21,3
220163,34,27,0,27,21,0,21,6,0,6
220181,34,705,234,471,684,227,457,21,7,14
220206,34,194,110,84,145,77,68,49,33,16
220215,34,1053,466,587,1008,451,557,45,15,30
220251,34,154,91,63,119,75,44,35,16,19
220279,34,196,137,59,143,93,50,53,44,9
220321,34,284,143,141,237,129,108,47,14,33
220394,34,154,93,61,152,91,61,2,2,0
220400,34,1685,426,1259,609,178,431,1076,248,828
220464,34,182,72,110,45,18,27,137,54,83
220473,34,505,232,273,449,203,246,56,29,27
220491,34,219,8,211,142,6,136,77,2,75
220516,34,913,327,586,826,303,523,87,24,63
220552,34,4161,569,3592,2867,408,2459,1294,161,1133
220598,34,696,379,317,661,362,299,35,17,18
220604,34,484,162,322,420,140,280,64,22,42
220613,34,2415,923,1492,2155,788,1367,260,135,125
220631,34,1134,295,839,894,269,625,240,26,214
220640,34,292,155,137,251,118,133,41,37,4
220701,34,578,262,316,542,249,293,36,13,23
220710,34,698,311,387,690,308,382,8,3,5
220756,34,61,52,9,56,48,8,5,4,1
220765,34,265,68,197,144,41,103,121,27,94
220853,34,781,540,241,648,439,209,133,101,32
220862,34,11767,4574,7193,8590,3401,5189,3177,1173,2004
220978,34,13434,6338,7096,11080,5248,5832,2354,1090,1264
221050,34,446,321,125,355,247,108,91,74,17
221096,34,2471,912,1559,1268,556,712,1203,356,847
221102,34,247,201,46,165,134,31,82,67,15
221148,34,795,735,60,795,735,60,,,
221184,34,3605,1232,2373,1439,547,892,2166,685,1481
221236,34,219,131,88,162,110,52,57,21,36
221281,34,135,56,79,129,55,74,6,1,5
221333,34,197,116,81,123,65,58,74,51,23
221351,34,1488,621,867,1449,612,837,39,9,30
221388,34,143,46,97,116,35,81,27,11,16
221397,34,2108,690,1418,1102,431,671,1006,259,747
221430,34,244,153,91,162,104,58,82,49,33
221485,34,3688,1162,2526,1555,564,991,2133,598,1535
221494,34,329,249,80,282,223,59,47,26,21
221519,34,1183,561,622,1174,558,616,9,3,6
221582,34,107,73,34,94,63,31,13,10,3
221591,34,287,186,101,258,166,92,29,20,9
221607,34,204,131,73,151,91,60,53,40,13
221616,34,393,277,116,361,261,100,32,16,16
221625,34,589,360,229,568,344,224,21,16,5
221643,34,4252,2093,2159,1997,1032,965,2255,1061,1194
221661,34,1811,814,997,1566,728,838,245,86,159
221731,34,709,264,445,637,238,399,72,26,46
221740,34,7574,3227,4347,6650,2780,3870,924,447,477
221759,34,20059,9410,10649,18970,8826,10144,1089,584,505
221768,34,3522,1354,2168,3158,1210,1948,364,144,220
221829,34,219,9,210,219,9,210,,,
221838,34,3778,1323,2455,3132,1084,2048,646,239,407
221847,34,6291,3362,2929,5668,3032,2636,623,330,293
221892,34,1360,499,861,1054,410,644,306,89,217
221908,34,3031,1473,1558,1492,641,851,1539,832,707
221953,34,840,414,426,759,385,374,81,29,52
221971,34,1397,497,900,1213,420,793,184,77,107
221999,34,5525,2702,2823,5461,2662,2799,64,40,24
222053,34,3729,1355,2374,1944,749,1195,1785,606,1179
222062,34,2288,824,1464,1280,527,753,1008,297,711
222105,34,220,206,14,111,105,6,109,101,8
222178,34,2247,869,1378,2161,833,1328,86,36,50
222567,34,2588,1055,1533,581,261,320,2007,794,1213
222576,34,5828,1880,3948,2245,834,1411,3583,1046,2537
222628,34,114,39,75,26,7,19,88,32,56
222822,34,1693,506,1187,785,263,522,908,243,665
222831,34,4078,1764,2314,3528,1506,2022,550,258,292
222877,34,115,68,47,113,67,46,2,1,1
222886,34,105,5,100,103,5,98,2,0,2
222938,34,270,128,142,189,94,95,81,34,47
222983,34,836,400,436,834,398,436,2,2,0
222992,34,20799,8623,12176,4989,2425,2564,15810,6198,9612
223056,34,13,0,13,13,0,13,,,
223083,34,457,66,391,124,23,101,333,43,290
223117,34,39,33,6,5,4,1,34,29,5
223232,34,11838,4753,7085,11599,4643,6956,239,110,129
223320,34,1719,513,1206,531,196,335,1188,317,871
223427,34,10694,5217,5477,5128,2666,2462,5566,2551,3015
223463,34,191,39,152,191,39,152,,,
223472,34,154,15,139,154,15,139,,,
223506,34,2156,979,1177,329,146,183,1827,833,994
223816,34,3633,1492,2141,557,201,356,3076,1291,1785
223852,34,8,1,7,8,1,7,,,
223898,34,1914,667,1247,737,273,464,1177,394,783
223922,34,844,355,489,378,144,234,466,211,255
224004,34,1386,394,992,1150,337,813,236,57,179
224013,34,31,2,29,31,2,29,,,
224110,34,4223,1706,2517,1103,493,610,3120,1213,1907
224147,34,5834,2281,3553,4111,1592,2519,1723,689,1034
224156,34,230,5,225,167,4,163,63,1,62
224226,34,1853,780,1073,1562,653,909,291,127,164
224244,34,166,103,63,145,92,53,21,11,10
224271,34,602,143,459,598,139,459,4,4,0
224323,34,1042,465,577,1020,455,565,22,10,12
224350,34,8266,3395,4871,1013,453,560,7253,2942,4311
224527,34,933,446,487,843,416,427,90,30,60
224545,34,1456,534,922,1065,412,653,391,122,269
224554,34,6451,2586,3865,4501,1787,2714,1950,799,1151
224615,34,29105,11205,17900,7744,3456,4288,21361,7749,13612
224642,34,19871,8239,11632,4348,1873,2475,15523,6366,9157
224660,34,514,256,258,396,207,189,118,49,69
224679,34,921,800,121,506,439,67,415,361,54
224758,34,15,0,15,13,0,13,2,0,2
224776,34,218,97,121,145,68,77,73,29,44
224828,34,56,0,56,34,0,34,22,0,22
224891,34,402,146,256,284,120,164,118,26,92
224961,34,1232,368,864,322,130,192,910,238,672
225043,34,3,3,0,3,3,0,,,
225070,34,2167,745,1422,883,323,560,1284,422,862
225201,34,646,390,256,646,390,256,,,
225247,34,973,455,518,913,427,486,60,28,32
225308,34,3999,1585,2414,993,388,605,3006,1197,1809
225371,34,1619,563,1056,678,284,394,941,279,662
225399,34,2082,753,1329,1468,555,913,614,198,416
225414,34,5990,2203,3787,2904,1096,1808,3086,1107,1979
225423,34,29988,11524,18464,8645,3638,5007,21343,7886,13457
225432,34,11379,4105,7274,4922,1822,3100,6457,2283,4174
225502,34,2488,867,1621,1083,428,655,1405,439,966
225511,34,31525,15457,16068,21961,10402,11559,9564,5055,4509
225520,34,1200,317,883,570,172,398,630,145,485
225548,34,505,262,243,451,238,213,54,24,30
225575,34,801,328,473,751,310,441,50,18,32
225627,34,3570,1287,2283,2984,1055,1929,586,232,354
225876,34,90,40,50,77,37,40,13,3,10
225885,34,561,247,314,465,211,254,96,36,60
225991,34,82,48,34,82,48,34,,,
226019,34,2265,808,1457,1154,463,691,1111,345,766
226091,34,6593,2686,3907,4786,1904,2882,1807,782,1025
226107,34,1101,280,821,458,138,320,643,142,501
226116,34,2230,840,1390,486,176,310,1744,664,1080
226125,34,62,3,59,62,3,59,,,
226134,34,6173,2499,3674,955,395,560,5218,2104,3114
226152,34,5152,1912,3240,3969,1507,2462,1183,405,778
226204,34,6148,3023,3125,655,335,320,5493,2688,2805
226231,34,1239,768,471,1001,676,325,238,92,146
226277,34,874,803,71,874,803,71,,,
226383,34,942,339,603,859,313,546,83,26,57
226408,34,2280,795,1485,533,226,307,1747,569,1178
226471,34,2269,795,1474,2078,725,1353,191,70,121
226578,34,3923,1082,2841,1501,495,1006,2422,587,1835
226587,34,816,423,393,730,391,339,86,32,54
226675,34,336,47,289,336,47,289,,,
226806,34,3982,1618,2364,748,272,476,3234,1346,1888
226833,34,3636,1289,2347,2552,971,1581,1084,318,766
226860,34,23,2,21,23,2,21,,,
226879,34,94,10,84,48,4,44,46,6,40
226903,34,839,298,541,839,298,541,,,
227058,34,42,0,42,42,0,42,,,
227146,34,5192,1949,3243,1488,643,845,3704,1306,2398
227182,34,37147,14552,22595,10777,4894,5883,26370,9658,16712
227216,34,26399,12233,14166,19800,9060,10740,6599,3173,3426
227225,34,1390,377,1013,640,192,448,750,185,565
227298,34,68,60,8,68,60,8,,,
227304,34,3144,1048,2096,1492,530,962,1652,518,1134
227313,34,171,3,168,64,2,62,107,1,106
227322,34,193,2,191,76,1,75,117,1,116
227331,34,867,257,610,745,231,514,122,26,96
227368,34,20650,8370,12280,15060,5924,9136,5590,2446,3144
227377,34,2656,1117,1539,1031,457,574,1625,660,965
227386,34,1181,279,902,579,178,401,602,101,501
227401,34,1657,534,1123,793,298,495,864,236,628
227429,34,827,249,578,221,98,123,606,151,455
227526,34,6544,2120,4424,5637,1785,3852,907,335,572
227687,34,1173,505,668,422,205,217,751,300,451
227748,34,211,198,13,133,125,8,78,73,5
227757,34,3279,1687,1592,3179,1632,1547,100,55,45
227845,34,2111,810,1301,1962,749,1213,149,61,88
227854,34,7620,2850,4770,888,439,449,6732,2411,4321
227863,34,2009,777,1232,1662,575,1087,347,202,145
227881,34,14790,5396,9394,11352,4130,7222,3438,1266,2172
227924,34,12003,4418,7585,2073,806,1267,9930,3612,6318
227979,34,16596,6518,10078,4188,1729,2459,12408,4789,7619
228042,34,683,302,381,647,290,357,36,12,24
228088,34,31,0,31,31,0,31,,,
228149,34,1462,594,868,1402,570,832,60,24,36
228158,34,5027,1880,3147,2634,1116,1518,2393,764,1629
228185,34,2,1,1,2,1,1,,,
228200,34,268,119,149,252,114,138,16,5,11
228219,34,361,144,217,356,143,213,5,1,4
228246,34,5405,2736,2669,5244,2643,2601,161,93,68
228282,34,2,1,1,2,1,1,,,
228316,34,2432,870,1562,1068,416,652,1364,454,910
228325,34,1135,551,584,978,484,494,157,67,90
228343,34,1044,478,566,1026,470,556,18,8,10
228431,34,7094,2592,4502,5988,2193,3795,1106,399,707
228459,34,26230,10772,15458,20452,8316,12136,5778,2456,3322
228468,34,534,215,319,471,189,282,63,26,37
228486,34,45,28,17,42,28,14,3,0,3
228501,34,1246,461,785,674,314,360,572,147,425
228529,34,9432,3474,5958,6498,2302,4196,2934,1172,1762
228547,34,32411,13286,19125,5030,2365,2665,27381,10921,16460
228608,34,2480,694,1786,955,285,670,1525,409,1116
228644,34,785,222,563,672,169,503,113,53,60
228653,34,585,105,480,439,75,364,146,30,116
228699,34,1242,355,887,443,162,281,799,193,606
228705,34,3463,1702,1761,2838,1413,1425,625,289,336
228723,34,44302,23389,20913,39661,20787,18874,4641,2602,2039
228769,34,25645,9916,15729,14557,6374,8183,11088,3542,7546
228778,34,31871,13828,18043,29465,12599,16866,2406,1229,1177
228787,34,17368,9890,7478,14005,7879,6126,3363,2011,1352
228796,34,16341,7253,9088,10704,4657,6047,5637,2596,3041
228802,34,5450,2082,3368,3619,1433,2186,1831,649,1182
228875,34,8019,3172,4847,7842,3085,4757,177,87,90
228884,34,507,294,213,458,270,188,49,24,25
228909,34,5,3,2,,,,5,3,2
228981,34,963,433,530,921,409,512,42,24,18
229018,34,3387,1279,2108,2439,906,1533,948,373,575
229027,34,23420,11392,12028,17121,8066,9055,6299,3326,2973
229063,34,4458,1585,2873,3545,1251,2294,913,334,579
229115,34,25533,13133,12400,22384,11464,10920,3149,1669,1480
229160,34,1085,487,598,947,441,506,138,46,92
229179,34,7533,646,6887,5281,434,4847,2252,212,2040
229267,34,1836,864,972,1807,850,957,29,14,15
229300,34,554,75,479,473,67,406,81,8,73
229337,34,1448,191,1257,1243,158,1085,205,33,172
229355,34,6254,2058,4196,2593,952,1641,3661,1106,2555
229416,34,1027,978,49,1027,978,49,,,
229425,34,79,2,77,22,0,22,57,2,55
229504,34,1639,544,1095,405,172,233,1234,372,862
229522,34,32,4,28,23,2,21,9,2,7
229540,34,1829,506,1323,446,179,267,1383,327,1056
229656,34,280,11,269,125,4,121,155,7,148
229780,34,1876,847,1029,1054,472,582,822,375,447
229799,34,2982,936,2046,904,327,577,2078,609,1469
229814,34,5547,2247,3300,4059,1631,2428,1488,616,872
229832,34,311,171,140,170,88,82,141,83,58
229841,34,3366,1374,1992,1178,582,596,2188,792,1396
229887,34,454,208,246,412,200,212,42,8,34
230010,34,1029,663,366,390,196,194,639,467,172
230038,34,25846,12852,12994,22894,11405,11489,2952,1447,1505
230047,34,2376,968,1408,2248,922,1326,128,46,82
230065,34,49,3,46,20,2,18,29,1,28
230144,34,19,1,18,19,1,18,,,
230162,34,1645,1015,630,328,108,220,1317,907,410
230171,34,6237,2644,3593,4822,2035,2787,1415,609,806
230199,34,15,4,11,15,4,11,,,
230205,34,9,1,8,8,0,8,1,1,0
230214,34,304,43,261,101,9,92,203,34,169
230366,34,238,26,212,238,26,212,,,
230418,34,1946,971,975,883,475,408,1063,496,567
230490,34,1510,868,642,208,64,144,1302,804,498
230597,34,1915,931,984,1529,774,755,386,157,229
230603,34,6924,3123,3801,5763,2573,3190,1161,550,611
230676,34,153,98,55,42,23,19,111,75,36
230728,34,15947,7393,8554,12395,5856,6539,3552,1537,2015
230737,34,22207,11807,10400,13861,7385,6476,8346,4422,3924
230746,34,13824,6333,7491,3729,1746,1983,10095,4587,5508
230764,34,19872,10405,9467,15895,8346,7549,3977,2059,1918
230782,34,12517,5359,7158,7833,3446,4387,4684,1913,2771
230807,34,764,288,476,727,268,459,37,20,17
230816,34,515,184,331,493,163,330,22,21,1
230834,34,1163,518,645,995,457,538,168,61,107
230852,34,2451,1497,954,1695,1041,654,756,456,300
230861,34,2603,647,1956,404,152,252,2199,495,1704
230889,34,95,29,66,74,23,51,21,6,15
230913,34,1004,353,651,639,265,374,365,88,277
230959,34,2112,995,1117,2097,989,1108,15,6,9
230995,34,2148,1587,561,1692,1192,500,456,395,61
231004,34,49,1,48,49,1,48,,,
231059,34,942,439,503,932,431,501,10,8,2
231095,34,77,27,50,72,24,48,5,3,2
231165,34,985,406,579,556,269,287,429,137,292
231174,34,8326,3124,5202,8073,2999,5074,253,125,128
231280,34,82,1,81,60,1,59,22,0,22
231411,34,268,245,23,268,245,23,,,
231420,34,869,425,444,769,381,388,100,44,56
231536,34,1822,684,1138,574,241,333,1248,443,805
231554,34,466,229,237,419,214,205,47,15,32
231581,34,957,435,522,955,435,520,2,0,2
231624,34,5136,2102,3034,5069,2067,3002,67,35,32
231651,34,3760,1440,2320,2021,804,1217,1739,636,1103
231688,34,17,0,17,10,0,10,7,0,7
231697,34,1425,536,889,376,174,202,1049,362,687
231712,34,3281,1490,1791,3185,1437,1748,96,53,43
231785,34,1129,174,955,569,129,440,560,45,515
231873,34,303,110,193,135,67,68,168,43,125
231882,34,916,311,605,440,200,240,476,111,365
232016,34,92,30,62,56,24,32,36,6,30
232025,34,733,361,372,711,350,361,22,11,11
232043,34,623,259,364,580,234,346,43,25,18
232052,34,274,83,191,72,18,54,202,65,137
232089,34,542,317,225,517,304,213,25,13,12
232186,34,22303,11341,10962,17359,8719,8640,4944,2622,2322
232195,34,3792,1241,2551,1158,462,696,2634,779,1855
232256,34,567,564,3,559,556,3,8,8,0
232265,34,1979,697,1282,1807,592,1215,172,105,67
232308,34,479,0,479,478,0,478,1,0,1
232414,34,4081,1478,2603,1146,480,666,2935,998,1937
232423,34,15105,6417,8688,14064,5945,8119,1041,472,569
232450,34,3996,1593,2403,1130,496,634,2866,1097,1769
232557,34,42294,18296,23998,26300,11024,15276,15994,7272,8722
232566,34,2215,691,1524,2086,647,1439,129,44,85
232575,34,2160,693,1467,655,272,383,1505,421,1084
232609,34,1133,428,705,1097,414,683,36,14,22
232618,34,224,30,194,24,1,23,200,29,171
232672,34,1038,202,836,826,171,655,212,31,181
232681,34,2694,1012,1682,2237,845,1392,457,167,290
232706,34,1409,495,914,1293,449,844,116,46,70
232724,34,23,1,22,23,1,22,,,
232788,34,824,254,570,414,147,267,410,107,303
232797,34,859,112,747,282,50,232,577,62,515
232867,34,1304,631,673,573,328,245,731,303,428
232885,34,241,13,228,217,10,207,24,3,21
232919,34,297,260,37,214,186,28,83,74,9
232937,34,4028,1265,2763,3423,1084,2339,605,181,424
232946,34,23473,11093,12380,7716,3856,3860,15757,7237,8520
232982,34,15068,6709,8359,10845,4830,6015,4223,1879,2344
233019,34,918,348,570,467,215,252,451,133,318
233037,34,437,118,319,145,53,92,292,65,227
233082,34,103,8,95,8,1,7,95,7,88
233116,34,2245,867,1378,520,248,272,1725,619,1106
233277,34,4719,1752,2967,4256,1594,2662,463,158,305
233286,34,100,17,83,83,16,67,17,1,16
233295,34,1061,483,578,1028,463,565,33,20,13
233301,34,314,119,195,310,115,195,4,4,0
233310,34,917,238,679,201,79,122,716,159,557
233329,34,382,28,354,382,28,354,,,
233338,34,333,155,178,251,121,130,82,34,48
233356,34,481,39,442,382,29,353,99,10,89
233374,34,2218,1035,1183,2103,985,1118,115,50,65
233408,34,327,39,288,260,36,224,67,3,64
233426,34,1299,614,685,1245,586,659,54,28,26
233480,34,27,6,21,27,6,21,,,
233541,34,1629,644,985,1561,620,941,68,24,44
233602,34,57,34,23,48,28,20,9,6,3
233611,34,726,383,343,685,361,324,41,22,19
233639,34,1272,343,929,319,67,252,953,276,677
233648,34,1078,342,736,561,209,352,517,133,384
233666,34,2,0,2,1,0,1,1,0,1
233684,34,2147,729,1418,401,253,148,1746,476,1270
233718,34,297,0,297,296,0,296,1,0,1
233754,34,3266,1274,1992,1108,503,605,2158,771,1387
233772,34,9112,3453,5659,3096,1241,1855,6016,2212,3804
233897,34,742,372,370,716,356,360,26,16,10
233903,34,994,341,653,389,171,218,605,170,435
233921,34,23173,13364,9809,22346,12813,9533,827,551,276
233949,34,2597,975,1622,875,360,515,1722,615,1107
234030,34,16385,6043,10342,14085,5082,9003,2300,961,1339
234076,34,13081,5747,7334,12431,5455,6976,650,292,358
234085,34,1165,1013,152,1165,1013,152,,,
234119,34,112,44,68,81,29,52,31,15,16
234137,34,386,140,246,331,95,236,55,45,10
234155,34,2911,1165,1746,2711,1088,1623,200,77,123
234164,34,934,466,468,776,393,383,158,73,85
234173,34,872,347,525,797,319,478,75,28,47
234207,34,1385,686,699,1380,683,697,5,3,2
234377,34,795,201,594,299,102,197,496,99,397
234669,34,6315,2762,3553,3409,1536,1873,2906,1226,1680
234696,34,1197,572,625,798,433,365,399,139,260
234711,34,1242,501,741,869,355,514,373,146,227
234827,34,7240,3413,3827,6225,2943,3282,1015,470,545
234845,34,1189,451,738,824,305,519,365,146,219
234915,34,1051,438,613,145,60,85,906,378,528
234924,34,207,25,182,207,25,182,,,
234933,34,3823,1409,2414,2172,827,1345,1651,582,1069
234951,34,2028,705,1323,1284,548,736,744,157,587
234979,34,3749,1416,2333,2203,875,1328,1546,541,1005
235024,34,292,102,190,283,99,184,9,3,6
235088,34,116,108,8,116,108,8,,,
235097,34,5570,2459,3111,4912,2129,2783,658,330,328
235103,34,3029,1390,1639,1463,739,724,1566,651,915
235149,34,4120,1657,2463,1987,841,1146,2133,816,1317
235167,34,1528,589,939,1388,533,855,140,56,84
235237,34,4932,1749,3183,3093,1086,2007,1839,663,1176
235307,34,85,5,80,85,5,80,,,
235316,34,3801,1767,2034,3741,1732,2009,60,35,25
235334,34,913,367,546,583,244,339,330,123,207
235343,34,4476,2101,2375,2724,1334,1390,1752,767,985
235352,34,71,10,61,71,10,61,,,
235422,34,644,156,488,580,141,439,64,15,49
235431,34,3477,1249,2228,1906,692,1214,1571,557,1014
235501,34,20,14,6,20,14,6,,,
235547,34,74,10,64,43,5,38,31,5,26
235583,34,23,0,23,23,0,23,,,
235671,34,1616,1069,547,1297,953,344,319,116,203
235699,34,1869,763,1106,1131,540,591,738,223,515
235750,34,1606,432,1174,853,269,584,753,163,590
236018,34,39,4,35,39,4,35,,,
236072,34,2056,752,1304,769,341,428,1287,411,876
236133,34,510,173,337,495,168,327,15,5,10
236188,34,3030,1147,1883,1817,664,1153,1213,483,730
236212,34,647,553,94,647,553,94,,,
236230,34,1727,612,1115,1658,580,1078,69,32,37
236258,34,881,298,583,474,155,319,407,143,264
236328,34,1307,563,744,1269,548,721,38,15,23
236382,34,1257,654,603,633,300,333,624,354,270
236452,34,1050,421,629,964,382,582,86,39,47
236504,34,1178,626,552,658,375,283,520,251,269
236513,34,2622,1063,1559,1660,677,983,962,386,576
236577,34,1871,610,1261,1800,580,1220,71,30,41
236595,34,3029,1191,1838,2886,1130,1756,143,61,82
236610,34,2961,1137,1824,1349,608,741,1612,529,1083
236638,34,2014,733,1281,1201,470,731,813,263,550
236656,34,2786,1028,1758,1598,648,950,1188,380,808
236692,34,3326,1248,2078,2260,887,1373,1066,361,705
236708,34,2558,986,1572,1715,687,1028,843,299,544
236744,34,21,1,20,21,1,20,,,
236753,34,3753,1276,2477,2282,836,1446,1471,440,1031
236887,34,1789,903,886,1040,484,556,749,419,330
236896,34,938,461,477,878,434,444,60,27,33
236939,34,18274,8567,9707,15838,7526,8312,2436,1041,1395
236948,34,23545,10336,13209,21667,9422,12245,1878,914,964
236975,34,1730,564,1166,1245,428,817,485,136,349
237011,34,10463,4513,5950,9013,3735,5278,1450,778,672
237039,34,2298,1008,1290,1207,547,660,1091,461,630
237057,34,1136,500,636,1113,487,626,23,13,10
237066,34,1582,665,917,1539,642,897,43,23,20
237109,34,2540,682,1858,1569,456,1113,971,226,745
237118,34,441,246,195,421,242,179,20,4,16
237127,34,20,0,20,20,0,20,,,
237136,34,143,83,60,123,66,57,20,17,3
237145,34,5,0,5,5,0,5,,,
237172,34,30,15,15,22,10,12,8,5,3
237181,34,418,235,183,417,235,182,1,0,1
237215,34,980,372,608,709,276,433,271,96,175
237242,34,18,18,0,16,16,0,2,2,0
237303,34,24,11,13,24,11,13,,,
237312,34,2064,1316,748,1071,557,514,993,759,234
237321,34,51,4,47,51,4,47,,,
237330,34,941,380,561,875,352,523,66,28,38
237358,34,464,185,279,457,185,272,7,0,7
237367,34,2075,859,1216,1671,746,925,404,113,291
237385,34,935,538,397,674,348,326,261,190,71
237437,34,123,16,107,109,16,93,14,0,14
237473,34,56,35,21,56,35,21,,,
237491,34,8,1,7,8,1,7,,,
237525,34,5416,2288,3128,4782,2029,2753,634,259,375
237543,34,74,18,56,48,10,38,26,8,18
237561,34,25,8,17,25,8,17,,,
237570,34,58,1,57,58,1,57,,,
237598,34,18,2,16,18,2,16,,,
237686,34,1192,393,799,699,236,463,493,157,336
237701,34,565,251,314,498,223,275,67,28,39
237729,34,95,29,66,72,13,59,23,16,7
237783,34,569,254,315,527,236,291,42,18,24
237792,34,1772,673,1099,1551,577,974,221,96,125
237817,34,758,215,543,459,135,324,299,80,219
237844,34,1,1,0,1,1,0,,,
237899,34,1031,459,572,894,402,492,137,57,80
237905,34,55,12,43,55,12,43,,,
237932,34,1218,455,763,1143,433,710,75,22,53
237950,34,740,438,302,674,401,273,66,37,29
237969,34,611,295,316,602,288,314,9,7,2
237987,34,200,25,175,200,25,175,,,
237996,34,474,80,394,474,80,394,,,
238005,34,41,3,38,41,3,38,,,
238014,34,610,192,418,311,121,190,299,71,228
238032,34,13799,6702,7097,12982,6298,6684,817,404,413
238078,34,433,251,182,345,215,130,88,36,52
238096,34,30,2,28,30,2,28,,,
238175,34,53,1,52,53,1,52,,,
238193,34,584,11,573,452,3,449,132,8,124
238263,34,6978,2823,4155,2229,1069,1160,4749,1754,2995
238324,34,300,27,273,218,17,201,82,10,72
238333,34,689,320,369,689,320,369,,,
238397,34,1585,524,1061,407,153,254,1178,371,807
238430,34,424,150,274,316,113,203,108,37,71
238458,34,2015,620,1395,1913,577,1336,102,43,59
238476,34,1809,789,1020,1751,768,983,58,21,37
238616,34,2135,765,1370,1546,601,945,589,164,425
238661,34,886,283,603,798,258,540,88,25,63
238722,34,4925,2683,2242,1492,804,688,3433,1879,1554
238759,34,3402,1298,2104,695,321,374,2707,977,1730
238810,34,57,4,53,38,3,35,19,1,18
238980,34,1052,439,613,527,260,267,525,179,346
239008,34,1381,631,750,269,140,129,1112,491,621
239017,34,1047,479,568,1030,470,560,17,9,8
239071,34,414,175,239,326,139,187,88,36,52
239080,34,833,284,549,707,252,455,126,32,94
239105,34,5307,2301,3006,5183,2239,2944,124,62,62
239220,34,1482,637,845,376,189,187,1106,448,658
239248,34,9015,3572,5443,2161,982,1179,6854,2590,4264
239309,34,674,160,514,661,155,506,13,5,8
239318,34,1890,1347,543,1842,1308,534,48,39,9
239372,34,1801,659,1142,520,234,286,1281,425,856
239390,34,485,0,485,460,0,460,25,0,25
239442,34,553,166,387,119,45,74,434,121,313
239460,34,2318,871,1447,750,345,405,1568,526,1042
239488,34,5571,2120,3451,1365,629,736,4206,1491,2715
239512,34,386,190,196,380,190,190,6,0,6
239628,34,558,287,271,558,287,271,,,
239716,34,1308,566,742,1297,559,738,11,7,4
239877,34,21,1,20,16,1,15,5,0,5
239910,34,964,278,686,415,158,257,549,120,429
240107,34,1221,278,943,968,235,733,253,43,210
240116,34,3079,1060,2019,1268,544,724,1811,516,1295
240125,34,3464,1977,1487,1207,650,557,2257,1327,930
240170,34,2533,1042,1491,928,459,469,1605,583,1022
240189,34,6804,3436,3368,5987,3059,2928,817,377,440
240198,34,1622,554,1068,560,232,328,1062,322,740
240268,34,7004,2798,4206,6380,2574,3806,624,224,400
240277,34,5168,1882,3286,3735,1407,2328,1433,475,958
240329,34,6811,2974,3837,6405,2736,3669,406,238,168
240338,34,681,279,402,655,267,388,26,12,14
240365,34,6074,2583,3491,5004,2053,2951,1070,530,540
240374,34,2527,1118,1409,1963,884,1079,564,234,330
240392,34,1500,234,1266,612,97,515,888,137,751
240417,34,4924,2821,2103,3865,2258,1607,1059,563,496
240426,34,1702,596,1106,1283,483,800,419,113,306
240444,34,26556,12589,13967,24942,11696,13246,1614,893,721
240453,34,13727,6318,7409,11486,5215,6271,2241,1103,1138
240462,34,4483,2842,1641,3902,2439,1463,581,403,178
240471,34,3313,1174,2139,2960,1032,1928,353,142,211
240480,34,5273,2314,2959,4604,2064,2540,669,250,419
240505,34,1627,577,1050,907,368,539,720,209,511
240514,34,724,300,424,328,124,204,396,176,220
240596,34,313,106,207,199,77,122,114,29,85
240620,34,1750,561,1189,844,304,540,906,257,649
240657,34,588,216,372,351,152,199,237,64,173
240666,34,1166,435,731,658,266,392,508,169,339
240693,34,894,345,549,492,219,273,402,126,276
240709,34,8,0,8,6,0,6,2,0,2
240718,34,605,574,31,605,574,31,,,
240727,34,6736,3161,3575,5473,2652,2821,1263,509,754
240736,34,657,192,465,309,85,224,348,107,241
240745,34,721,296,425,262,100,162,459,196,263
240754,34,2168,903,1265,1586,646,940,582,257,325
240790,34,910,330,580,639,238,401,271,92,179
240879,34,2,1,1,2,1,1,,,
241100,34,168,88,80,141,73,68,27,15,12
241128,34,178,82,96,144,64,80,34,18,16
241146,34,68,34,34,64,33,31,4,1,3
241182,34,316,62,254,316,62,254,,,
241191,34,691,274,417,591,228,363,100,46,54
241216,34,1249,796,453,614,383,231,635,413,222
241225,34,525,162,363,352,111,241,173,51,122
241304,34,1386,381,1005,646,179,467,740,202,538
241331,34,548,76,472,402,55,347,146,21,125
241377,34,473,196,277,379,162,217,94,34,60
241386,34,116,24,92,89,20,69,27,4,23
241395,34,253,78,175,203,64,139,50,14,36
241410,34,3297,1188,2109,2772,971,1801,525,217,308
241517,34,178,45,133,117,29,88,61,16,45
241614,34,244,140,104,128,82,46,116,58,58
241720,34,532,206,326,372,126,246,160,80,80
241739,34,4102,1282,2820,2534,791,1743,1568,491,1077
241766,34,235,162,73,166,113,53,69,49,20
241836,34,812,255,557,305,110,195,507,145,362
241906,34,147,45,102,147,45,102,,,
241951,34,411,110,301,283,70,213,128,40,88
242042,34,123,70,53,116,65,51,7,5,2
242112,34,299,128,171,244,115,129,55,13,42
242121,34,186,63,123,99,31,68,87,32,55
242130,34,258,68,190,198,48,150,60,20,40
242149,34,244,54,190,170,41,129,74,13,61
242556,34,118,80,38,111,75,36,7,5,2
242583,34,112,82,30,77,56,21,35,26,9
242617,34,2054,935,1119,1725,789,936,329,146,183
242626,34,2279,949,1330,1796,734,1062,483,215,268
242635,34,1968,705,1263,1585,586,999,383,119,264
242644,34,741,228,513,549,172,377,192,56,136
242653,34,2638,1151,1487,1894,816,1078,744,335,409
242662,34,2247,806,1441,1642,599,1043,605,207,398
242680,34,923,341,582,732,270,462,191,71,120
242699,34,1196,358,838,946,285,661,250,73,177
242705,34,2879,1629,1250,2286,1275,1011,593,354,239
242820,34,443,342,101,443,342,101,,,
242945,34,3,1,2,2,1,1,1,0,1
242954,34,3,1,2,2,1,1,1,0,1
242972,34,19001,6195,12806,12198,3860,8338,6803,2335,4468
243106,34,1457,626,831,1267,544,723,190,82,108
243115,34,2174,801,1373,1981,719,1262,193,82,111
243133,34,2337,1147,1190,1894,929,965,443,218,225
243142,34,1496,542,954,1050,359,691,446,183,263
243151,34,1717,537,1180,1491,458,1033,226,79,147
243179,34,1988,658,1330,1761,575,1186,227,83,144
243188,34,264,133,131,225,112,113,39,21,18
243197,34,8332,4627,3705,7281,3984,3297,1051,643,408
243203,34,264,40,224,245,37,208,19,3,16
243212,34,1524,674,850,1413,630,783,111,44,67
243221,34,7363,2632,4731,6299,2196,4103,1064,436,628
243346,34,3728,1409,2319,2284,870,1414,1444,539,905
243443,34,2825,1028,1797,2208,792,1416,617,236,381
243568,34,107,12,95,81,6,75,26,6,20
243577,34,3102,2230,872,1125,773,352,1977,1457,520
243586,34,536,188,348,444,157,287,92,31,61
243601,34,6417,2601,3816,4295,1654,2641,2122,947,1175
243638,34,1479,594,885,904,345,559,575,249,326
243647,34,330,145,185,184,91,93,146,54,92
243665,34,1074,290,784,674,202,472,400,88,312
243744,34,6028,2952,3076,6028,2952,3076,,,
243780,34,28991,16896,12095,27111,15848,11263,1880,1048,832
243799,34,19,1,18,19,1,18,,,
243823,34,331,92,239,251,73,178,80,19,61
243832,34,1120,313,807,515,142,373,605,171,434
243841,34,393,61,332,304,49,255,89,12,77
244233,34,1,0,1,1,0,1,,,
244279,34,114,2,112,114,2,112,,,
244437,34,9767,3459,6308,3158,1284,1874,6609,2175,4434
244446,34,1626,585,1041,438,198,240,1188,387,801
244613,34,132,125,7,62,58,4,70,67,3
245281,34,74,38,36,74,38,36,,,
245625,34,649,221,428,227,88,139,422,133,289
245652,34,276,145,131,267,144,123,9,1,8
245777,34,36,36,0,34,34,0,2,2,0
245838,34,74,30,44,26,11,15,48,19,29
245847,34,60,21,39,25,8,17,35,13,22
245883,34,80,17,63,10,3,7,70,14,56
245892,34,105,24,81,51,8,43,54,16,38
245953,34,1184,386,798,610,222,388,574,164,410
245962,34,123,8,115,122,8,114,1,0,1
245980,34,17,2,15,17,2,15,,,
245999,34,561,290,271,209,78,131,352,212,140
246017,34,447,260,187,49,19,30,398,241,157
246035,34,228,33,195,228,33,195,,,
246071,34,40,7,33,40,7,33,,,
246354,34,5614,2097,3517,625,226,399,4989,1871,3118
246406,34,9,1,8,9,1,8,,,
246415,34,53,3,50,17,2,15,36,1,35
246460,34,74,8,66,74,8,66,,,
246813,34,2515,782,1733,490,194,296,2025,588,1437
246895,34,311,122,189,165,58,107,146,64,82
246974,34,327,36,291,327,36,291,,,
247010,34,27,0,27,27,0,27,,,
247047,34,24,0,24,24,0,24,,,
247065,34,611,46,565,341,19,322,270,27,243
247153,34,164,38,126,164,38,126,,,
247162,34,9,1,8,,,,9,1,8
247409,34,28,0,28,28,0,28,,,
247603,34,1281,657,624,734,383,351,547,274,273
247649,34,347,229,118,286,192,94,61,37,24
247773,34,47,47,0,47,47,0,,,
247834,34,19459,8850,10609,7277,3741,3536,12182,5109,7073
247940,34,1839,743,1096,746,344,402,1093,399,694
248192,34,4,0,4,4,0,4,,,
248527,34,68,0,68,68,0,68,,,
248606,34,46,17,29,35,10,25,11,7,4
248624,34,61,13,48,61,13,48,,,
248633,34,45,2,43,45,2,43,,,
248660,34,124,30,94,109,30,79,15,0,15
248703,34,96,2,94,48,1,47,48,1,47
248925,34,571,320,251,450,246,204,121,74,47
248934,34,10345,4077,6268,10345,4077,6268,,,
249061,34,42,0,42,20,0,20,22,0,22
249238,34,311,15,296,194,7,187,117,8,109
249609,34,130,80,50,130,80,50,,,
250027,34,189,57,132,188,57,131,1,0,1
250285,34,242,216,26,115,104,11,127,112,15
250744,34,287,31,256,287,31,256,,,
250902,34,11,0,11,5,0,5,6,0,6
250993,34,511,288,223,17,5,12,494,283,211
251260,34,2540,1064,1476,1280,650,630,1260,414,846
251312,34,401,60,341,307,46,261,94,14,80
260336,34,17,4,13,17,4,13,,,
260363,34,3,0,3,3,0,3,,,
260372,34,228,50,178,92,17,75,136,33,103
260664,34,75,43,32,75,43,32,,,
260691,34,704,192,512,704,192,512,,,
260789,34,596,118,478,596,118,478,,,
260813,34,222,24,198,222,24,198,,,
260929,34,159,12,147,158,12,146,1,0,1
260965,34,53,0,53,53,0,53,,,
260992,34,363,22,341,81,8,73,282,14,268
261436,34,479,33,446,479,33,446,,,
261676,34,8,1,7,8,1,7,,,
261685,34,23,1,22,23,1,22,,,
261719,34,126,0,126,126,0,126,,,
261773,34,23,1,22,22,0,22,1,1,0
261861,34,8,0,8,8,0,8,,,
262031,34,3793,1497,2296,1892,816,1076,1901,681,1220
262086,34,4329,1461,2868,937,407,530,3392,1054,2338
262129,34,481,163,318,473,157,316,8,6,2
262341,34,117,100,17,117,100,17,,,
262369,34,16,0,16,16,0,16,,,
262457,34,351,50,301,351,50,301,,,
262466,34,30,16,14,30,16,14,,,
362700,34,404,37,367,394,36,358,10,1,9
362782,34,198,5,193,58,2,56,140,3,137
363013,34,15,0,15,15,0,15,,,
363147,34,352,1,351,352,1,351,,,
363165,34,725,407,318,288,160,128,437,247,190
363633,34,323,115,208,145,53,92,178,62,116
363679,34,117,1,116,107,1,106,10,0,10
363712,34,10,10,0,10,10,0,,,
363882,34,69,1,68,69,1,68,,,
363907,34,343,216,127,239,143,96,104,73,31
363916,34,112,31,81,84,22,62,28,9,19
363934,34,659,526,133,314,252,62,345,274,71
364016,34,3118,1362,1756,850,447,403,2268,915,1353
364025,34,5323,2553,2770,1859,991,868,3464,1562,1902
364548,34,57,24,33,44,15,29,13,9,4
364575,34,18,0,18,18,0,18,,,
364627,34,54,29,25,27,8,19,27,21,6
364636,34,90,15,75,74,15,59,16,0,16
364760,34,20,3,17,10,2,8,10,1,9
364946,34,96,20,76,69,12,57,27,8,19
364964,34,15,2,13,15,2,13,,,
365091,34,316,14,302,316,14,302,,,
365125,34,162,5,157,162,5,157,,,
365198,34,118,45,73,36,2,34,82,43,39
365213,34,254,126,128,93,25,68,161,101,60
365240,34,15,10,5,15,10,5,,,
365374,34,553,316,237,168,70,98,385,246,139
365383,34,42,5,37,42,5,37,,,
365480,34,158,64,94,81,12,69,77,52,25
365505,34,2,0,2,2,0,2,,,
365693,34,122,0,122,122,0,122,,,
365763,34,8,3,5,8,3,5,,,
365824,34,43,4,39,43,4,39,,,
365833,34,55,3,52,55,3,52,,,
366003,34,219,92,127,78,25,53,141,67,74
366155,34,28,10,18,28,10,18,,,
366191,34,683,665,18,683,665,18,,,
366252,34,3081,1894,1187,2378,1657,721,703,237,466
366261,34,222,75,147,204,68,136,18,7,11
366270,34,287,11,276,287,11,276,,,
366289,34,25,19,6,25,19,6,,,
366340,34,196,58,138,142,45,97,54,13,41
366395,34,10389,4571,5818,5889,2810,3079,4500,1761,2739
366401,34,4687,2175,2512,1389,716,673,3298,1459,1839
366438,34,11,0,11,5,0,5,6,0,6
366465,34,1407,429,978,603,196,407,804,233,571
366535,34,155,21,134,155,21,134,,,
366553,34,352,135,217,349,135,214,3,0,3
366571,34,22,3,19,22,3,19,,,
366623,34,17,5,12,11,1,10,6,4,2
366632,34,1,0,1,1,0,1,,,
366711,34,11293,4494,6799,8709,3419,5290,2584,1075,1509
367051,34,39,1,38,26,1,25,13,0,13
367088,34,78,2,76,42,2,40,36,0,36
367103,34,70,52,18,70,52,18,,,
367112,34,121,16,105,108,14,94,13,2,11
367158,34,27,1,26,27,1,26,,,
367334,34,41,34,7,33,27,6,8,7,1
367361,34,64,41,23,60,39,21,4,2,2
367431,34,17,1,16,17,1,16,,,
367459,34,3515,1401,2114,1007,466,541,2508,935,1573
367875,34,384,142,242,191,70,121,193,72,121
367884,34,306,111,195,188,60,128,118,51,67
367972,34,106,3,103,106,3,103,,,
367981,34,54,0,54,30,0,30,24,0,24
368230,34,47,2,45,28,0,28,19,2,17
368364,34,166,90,76,70,36,34,96,54,42
368407,34,26,1,25,,,,26,1,25
368443,34,153,34,119,153,34,119,,,
368452,34,230,88,142,230,88,142,,,
368629,34,424,88,336,424,88,336,,,
368647,34,9,1,8,9,1,8,,,
368771,34,231,50,181,231,50,181,,,
368832,34,38,6,32,9,2,7,29,4,25
368911,34,858,157,701,201,43,158,657,114,543
369400,34,575,546,29,575,546,29,,,
369419,34,121,81,40,121,81,40,,,
369446,34,11,3,8,5,3,2,6,0,6
369455,34,178,40,138,178,40,138,,,
369516,34,101,22,79,101,22,79,,,
369668,34,21,6,15,6,6,0,15,0,15
369686,34,40,11,29,40,11,29,,,
369783,34,210,14,196,210,14,196,,,
369950,34,68,61,7,68,61,7,,,
371052,34,175,26,149,175,26,149,,,
371690,34,623,125,498,93,10,83,530,115,415
371830,34,95,82,13,93,82,11,2,0,2
371928,34,98,33,65,98,33,65,,,
371964,34,299,212,87,299,212,87,,,
372028,34,108,18,90,108,18,90,,,
372073,34,97,36,61,97,36,61,,,
372082,34,39,14,25,39,14,25,,,
372240,34,20,0,20,20,0,20,,,
372329,34,192,26,166,192,26,166,,,
372356,34,67,0,67,67,0,67,,,
372462,34,101,14,87,99,14,85,2,0,2
372921,34,382,124,258,382,124,258,,,
373085,34,19,0,19,15,0,15,4,0,4
373216,34,63,14,49,63,14,49,,,
373456,34,9,1,8,6,1,5,3,0,3
373526,34,121,86,35,121,86,35,,,
373678,34,50,18,32,35,16,19,15,2,13
373696,34,23,9,14,15,5,10,8,4,4
373711,34,46,5,41,46,5,41,,,
373784,34,317,172,145,317,172,145,,,
374316,34,56,43,13,36,33,3,20,10,10
374343,34,29,1,28,29,1,28,,,
374574,34,510,83,427,307,60,247,203,23,180
374592,34,2,0,2,2,0,2,,,
375106,34,18,13,5,16,12,4,2,1,1
375230,34,164,164,0,164,164,0,,,
375373,34,95,38,57,4,0,4,91,38,53
375407,34,61,16,45,55,13,42,6,3,3
375416,34,130,28,102,130,28,102,,,
375540,34,4,0,4,2,0,2,2,0,2
375568,34,3,3,0,2,2,0,1,1,0
375656,34,10,2,8,8,1,7,2,1,1
375683,34,109,82,27,70,51,19,39,31,8
375726,34,364,168,196,297,122,175,67,46,21
375939,34,113,23,90,113,23,90,,,
375966,34,114,11,103,64,6,58,50,5,45
375984,34,88,5,83,67,4,63,21,1,20
376224,34,134,23,111,104,19,85,30,4,26
376242,34,31,26,5,31,26,5,,,
376288,34,46,17,29,46,17,29,,,
376330,34,171,38,133,171,38,133,,,
376385,34,72,30,42,67,29,38,5,1,4
376446,34,67,1,66,14,1,13,53,0,53
376631,34,14,6,8,13,6,7,1,0,1
376677,34,126,47,79,124,45,79,2,2,0
376695,34,970,411,559,334,141,193,636,270,366
377111,34,106,35,71,106,35,71,,,
377193,34,22,1,21,5,0,5,17,1,16
377218,34,107,103,4,107,103,4,,,
377272,34,4,1,3,4,1,3,,,
377281,34,8,1,7,8,1,7,,,
377315,34,51,0,51,51,0,51,,,
377449,34,178,80,98,137,68,69,41,12,29
377458,34,185,74,111,124,61,63,61,13,48
377485,34,16,1,15,6,0,6,10,1,9
377546,34,73,26,47,68,25,43,5,1,4
377555,34,4186,2290,1896,3501,1901,1600,685,389,296
377564,34,3429,1784,1645,2994,1557,1437,435,227,208
377643,34,99,7,92,99,7,92,,,
377652,34,134,8,126,134,8,126,,,
377661,34,569,89,480,569,89,480,,,
377722,34,374,18,356,374,18,356,,,
377759,34,71,68,3,71,68,3,,,
378105,34,336,7,329,234,5,229,102,2,100
378576,34,182,32,150,26,10,16,156,22,134
378886,34,139,31,108,50,8,42,89,23,66
378956,34,465,431,34,465,431,34,,,
379621,34,65,5,60,49,5,44,16,0,16
379746,34,222,14,208,222,14,208,,,
379782,34,212,19,193,212,19,193,,,
380067,34,127,1,126,127,1,126,,,
380359,34,397,64,333,144,31,113,253,33,220
380368,34,378,134,244,195,73,122,183,61,122
380377,34,546,115,431,394,86,308,152,29,123
380438,34,688,92,596,688,92,596,,,
381255,34,61,47,14,61,47,14,,,
381282,34,65,22,43,65,22,43,,,
381325,34,96,33,63,96,33,63,,,
381370,34,89,7,82,40,4,36,49,3,46
381404,34,206,5,201,64,1,63,142,4,138
381486,34,12,0,12,12,0,12,,,
381699,34,11,0,11,7,0,7,4,0,4
381732,34,36,6,30,6,1,5,30,5,25
382258,34,82,10,72,38,2,36,44,8,36
382416,34,67,11,56,67,11,56,,,
382461,34,37,1,36,24,1,23,13,0,13
382780,34,97,6,91,85,4,81,12,2,10
382911,34,41,17,24,28,12,16,13,5,8
382957,34,283,65,218,272,63,209,11,2,9
383020,34,4,2,2,2,1,1,2,1,1
383084,34,44,13,31,36,10,26,8,3,5
383163,34,100,2,98,28,0,28,72,2,70
383190,34,1078,431,647,422,220,202,656,211,445
383279,34,166,22,144,53,9,44,113,13,100
383297,34,164,8,156,31,0,31,133,8,125
383312,34,7,0,7,7,0,7,,,
383330,34,71,11,60,71,11,60,,,
383367,34,37,4,33,35,4,31,2,0,2
383464,34,76,5,71,76,5,71,,,
383765,34,44,0,44,24,0,24,20,0,20
383996,34,293,89,204,77,18,59,216,71,145
384236,34,809,288,521,809,288,521,,,
384245,34,584,204,380,584,204,380,,,
384254,34,367,245,122,355,237,118,12,8,4
384333,34,4502,1696,2806,1261,519,742,3241,1177,2064
384342,34,2309,974,1335,1003,473,530,1306,501,805
384412,34,145,78,67,145,78,67,,,
384421,34,62,62,0,62,62,0,,,
385132,34,87,4,83,58,3,55,29,1,28
385503,34,172,11,161,172,11,161,,,
385619,34,1966,975,991,1966,975,991,,,
386153,34,115,0,115,97,0,97,18,0,18
386472,34,621,112,509,354,67,287,267,45,222
387925,34,80,6,74,80,6,74,,,
388520,34,146,76,70,50,32,18,96,44,52
389860,34,172,70,102,129,38,91,43,32,11
390905,34,86,47,39,21,15,6,65,32,33
391005,34,107,3,104,107,3,104,,,
391759,34,13,0,13,,,,13,0,13
392257,34,2458,198,2260,2458,198,2260,,,
392354,34,10,2,8,10,2,8,,,
392415,34,189,50,139,189,50,139,,,
393649,34,1059,393,666,1059,393,666,,,
393861,34,319,56,263,290,53,237,29,3,26
395362,34,907,274,633,271,84,187,636,190,446
395690,34,81,33,48,81,33,48,,,
397942,34,935,255,680,935,255,680,,,
399212,34,8393,5657,2736,1304,645,659,7089,5012,2077
399869,34,388,367,21,388,367,21,,,
399911,34,316,108,208,316,108,208,,,
400080,34,210,108,102,210,108,102,,,
400187,34,397,53,344,225,34,191,172,19,153
400558,34,57,18,39,57,18,39,,,
401223,34,172,52,120,84,23,61,88,29,59
401764,34,203,5,198,60,0,60,143,5,138
402563,34,186,11,175,186,11,175,,,
402800,34,126,4,122,116,3,113,10,1,9
403469,34,168,50,118,91,29,62,77,21,56
403478,34,152,50,102,98,34,64,54,16,38
403487,34,283,105,178,203,86,117,80,19,61
404055,34,233,27,206,233,27,206,,,
404338,34,19,8,11,19,8,11,,,
404426,34,1911,844,1067,528,272,256,1383,572,811
404684,34,197,57,140,197,57,140,,,
404718,34,76,1,75,76,1,75,,,
404912,34,669,138,531,669,138,531,,,
405012,34,34,0,34,34,0,34,,,
405058,34,110,110,0,110,110,0,,,
405076,34,327,48,279,327,48,279,,,
405854,34,220,220,0,220,220,0,,,
405872,34,1423,576,847,451,233,218,972,343,629
406024,34,1763,221,1542,949,111,838,814,110,704
406033,34,2576,320,2256,1364,178,1186,1212,142,1070
406149,34,53,9,44,53,9,44,,,
406325,34,92,5,87,26,2,24,66,3,63
406361,34,8,1,7,8,1,7,,,
406422,34,46,3,43,12,0,12,34,3,31
406486,34,23,15,8,10,7,3,13,8,5
406547,34,36,3,33,17,3,14,19,0,19
407090,34,432,5,427,133,2,131,299,3,296
407142,34,87,1,86,87,1,86,,,
407151,34,51,0,51,51,0,51,,,
407179,34,37,1,36,26,0,26,11,1,10
407355,34,152,19,133,152,19,133,,,
407434,34,22,1,21,22,1,21,,,
407461,34,27,16,11,27,16,11,,,
407470,34,91,3,88,61,2,59,30,1,29
407489,34,55,40,15,6,0,6,49,40,9
407513,34,52,14,38,33,3,30,19,11,8
407522,34,1,1,0,,,,1,1,0
407568,34,109,6,103,90,2,88,19,4,15
407577,34,30,13,17,20,5,15,10,8,2
407595,34,3,0,3,3,0,3,,,
407610,34,36,25,11,2,2,0,34,23,11
407629,34,10,1,9,10,1,9,,,
407683,34,11,1,10,8,1,7,3,0,3
407708,34,120,2,118,120,2,118,,,
407735,34,36,0,36,36,0,36,,,
407832,34,108,62,46,34,17,17,74,45,29
408066,34,173,39,134,116,28,88,57,11,46
408163,34,37,2,35,37,2,35,,,
408385,34,497,197,300,497,197,300,,,
408729,34,13,1,12,12,0,12,1,1,0
408844,34,2075,608,1467,1261,416,845,814,192,622
408862,34,223,3,220,105,2,103,118,1,117
409032,34,3,0,3,3,0,3,,,
409120,34,38,10,28,38,10,28,,,
409193,34,116,112,4,116,112,4,,,
409315,34,13898,5596,8302,4307,1827,2480,9591,3769,5822
409537,34,12,4,8,,,,12,4,8
409591,34,38,5,33,23,2,21,15,3,12
409698,34,5225,2057,3168,4467,1689,2778,758,368,390
410797,34,59,30,29,59,30,29,,,
410964,34,31,0,31,28,0,28,3,0,3
411684,34,141,42,99,141,42,99,,,
411754,34,37,8,29,37,8,29,,,
412173,34,501,47,454,461,44,417,40,3,37
412535,34,27,2,25,25,2,23,2,0,2
412544,34,135,5,130,80,4,76,55,1,54
412599,34,193,46,147,193,46,147,,,
413176,34,17,7,10,17,7,10,,,
413413,34,13205,2216,10989,3268,470,2798,9937,1746,8191
413617,34,185,43,142,55,16,39,130,27,103
413626,34,79,18,61,45,10,35,34,8,26
413680,34,258,246,12,258,246,12,,,
413820,34,21,0,21,21,0,21,,,
413893,34,1070,363,707,1070,363,707,,,
413972,34,16,1,15,16,1,15,,,
414063,34,73,0,73,68,0,68,5,0,5
414124,34,189,145,44,129,102,27,60,43,17
414461,34,1337,1264,73,1124,1060,64,213,204,9
414489,34,14,0,14,14,0,14,,,
414540,34,70,4,66,54,3,51,16,1,15
414595,34,148,28,120,16,6,10,132,22,110
414869,34,313,4,309,95,3,92,218,1,217
414878,34,260,101,159,155,60,95,105,41,64
414911,34,586,225,361,365,155,210,221,70,151
414939,34,217,24,193,217,24,193,,,
415039,34,23,1,22,15,1,14,8,0,8
415057,34,3,3,0,3,3,0,,,
415987,34,39,4,35,39,4,35,,,
416458,34,100,34,66,100,34,66,,,
416801,34,337,70,267,295,59,236,42,11,31
417008,34,101,2,99,101,2,99,,,
417062,34,41,2,39,29,0,29,12,2,10
417105,34,208,150,58,123,77,46,85,73,12
417123,34,59,19,40,21,7,14,38,12,26
417248,34,34,33,1,34,33,1,,,
417275,34,17,16,1,17,16,1,,,
417327,34,135,15,120,74,9,65,61,6,55
417442,34,57,1,56,57,1,56,,,
417503,34,201,0,201,123,0,123,78,0,78
417600,34,3,0,3,3,0,3,,,
417628,34,7,0,7,6,0,6,1,0,1
417637,34,40,11,29,40,11,29,,,
417646,34,14,1,13,14,1,13,,,
417655,34,12,2,10,12,2,10,,,
417682,34,9,0,9,9,0,9,,,
417716,34,183,3,180,183,3,180,,,
417725,34,38,2,36,38,2,36,,,
417734,34,129,29,100,47,13,34,82,16,66
417752,34,15,6,9,13,5,8,2,1,1
417831,34,106,76,30,106,76,30,,,
417840,34,367,24,343,367,24,343,,,
417868,34,10,4,6,,,,10,4,6
417886,34,20,1,19,20,1,19,,,
417910,34,158,27,131,158,27,131,,,
417983,34,17,0,17,,,,17,0,17
417992,34,45,3,42,27,2,25,18,1,17
418001,34,81,3,78,81,3,78,,,
418010,34,48,4,44,26,1,25,22,3,19
418029,34,28,2,26,28,2,26,,,
418038,34,140,13,127,140,13,127,,,
418065,34,188,25,163,149,20,129,39,5,34
418083,34,42,4,38,42,4,38,,,
418126,34,120,38,82,68,20,48,52,18,34
418171,34,49,49,0,49,49,0,,,
418199,34,17,14,3,2,2,0,15,12,3
418205,34,167,95,72,115,64,51,52,31,21
418223,34,42,3,39,42,3,39,,,
418250,34,48,27,21,9,7,2,39,20,19
418269,34,57,24,33,57,24,33,,,
418278,34,57,8,49,21,3,18,36,5,31
418296,34,694,321,373,174,35,139,520,286,234
418302,34,99,33,66,69,12,57,30,21,9
418320,34,38,11,27,27,7,20,11,4,7
418348,34,35,30,5,29,27,2,6,3,3
418357,34,9,2,7,8,1,7,1,1,0
418409,34,78,29,49,51,11,40,27,18,9
418427,34,73,5,68,62,5,57,11,0,11
418445,34,18,0,18,10,0,10,8,0,8
418454,34,53,32,21,52,31,21,1,1,0
418481,34,23,0,23,23,0,23,,,
418515,34,14,1,13,12,1,11,2,0,2
418524,34,22,1,21,22,1,21,,,
418533,34,197,27,170,161,18,143,36,9,27
418542,34,47,6,41,21,1,20,26,5,21
418560,34,63,8,55,14,1,13,49,7,42
418588,34,16,0,16,16,0,16,,,
418612,34,7,0,7,7,0,7,,,
418658,34,222,184,38,222,184,38,,,
418773,34,214,99,115,162,89,73,52,10,42
418782,34,98,92,6,98,92,6,,,
418889,34,44,38,6,30,25,5,14,13,1
418913,34,3,1,2,3,1,2,,,
418968,34,82,1,81,82,1,81,,,
419031,34,4,0,4,4,0,4,,,
419095,34,28,3,25,28,3,25,,,
419183,34,25,0,25,25,0,25,,,
419217,34,57,10,47,57,10,47,,,
419226,34,269,123,146,205,103,102,64,20,44
419235,34,105,23,82,105,23,82,,,
419244,34,176,134,42,83,67,16,93,67,26
419253,34,18,14,4,18,14,4,,,
419280,34,23,0,23,19,0,19,4,0,4
419341,34,2,1,1,2,1,1,,,
419420,34,18,4,14,18,4,14,,,
419484,34,14,1,13,14,1,13,,,
419633,34,55,7,48,55,7,48,,,
419703,34,202,193,9,202,193,9,,,
419712,34,60,60,0,60,60,0,,,
419721,34,102,96,6,102,96,6,,,
420024,34,162,15,147,133,11,122,29,4,25
420042,34,24,14,10,24,14,10,,,
420130,34,252,11,241,252,11,241,,,
420255,34,51,50,1,51,50,1,,,
420325,34,58,58,0,58,58,0,,,
420343,34,500,483,17,400,388,12,100,95,5
420370,34,285,100,185,285,100,185,,,
420398,34,9772,4006,5766,1733,759,974,8039,3247,4792
420431,34,1192,366,826,285,89,196,907,277,630
420440,34,553,165,388,157,62,95,396,103,293
420468,34,118,42,76,103,41,62,15,1,14
420538,34,641,206,435,304,115,189,337,91,246
420556,34,314,109,205,138,55,83,176,54,122
420723,34,150,59,91,39,10,29,111,49,62
420981,34,113,15,98,113,15,98,,,
421513,34,30,2,28,25,0,25,5,2,3
421610,34,109,8,101,103,8,95,6,0,6
421665,34,30,0,30,13,0,13,17,0,17
421708,34,1154,140,1014,908,98,810,246,42,204
421717,34,16,10,6,8,6,2,8,4,4
421771,34,39,0,39,26,0,26,13,0,13
421841,34,305,130,175,305,130,175,,,
421878,34,372,35,337,278,27,251,94,8,86
421896,34,93,29,64,93,29,64,,,
422020,34,188,179,9,188,179,9,,,
422695,34,249,17,232,249,17,232,,,
422835,34,8,4,4,8,4,4,,,
423120,34,619,65,554,613,64,549,6,1,5
423397,34,343,206,137,343,206,137,,,
423412,34,22,19,3,22,19,3,,,
423652,34,216,47,169,106,21,85,110,26,84
425250,34,61,9,52,37,6,31,24,3,21
425986,34,127,15,112,127,15,112,,,
426314,34,7762,6592,1170,2022,1676,346,5740,4916,824
427308,34,89,3,86,89,3,86,,,
427335,34,11,0,11,10,0,10,1,0,1
427894,34,49,48,1,49,48,1,,,
427973,34,198,177,21,118,105,13,80,72,8
427982,34,117,74,43,97,64,33,20,10,10
427991,34,38,30,8,31,24,7,7,6,1
428000,34,86,20,66,86,20,66,,,
428019,34,14,4,10,12,2,10,2,2,0
428055,34,98,20,78,98,20,78,,,
428125,34,41,28,13,40,27,13,1,1,0
428170,34,404,38,366,250,23,227,154,15,139
428259,34,62,7,55,12,1,11,50,6,44
428392,34,582,219,363,291,128,163,291,91,200
429128,34,220,1,219,7,0,7,213,1,212
430184,34,1258,381,877,162,100,62,1096,281,815
430227,34,33,0,33,24,0,24,9,0,9
430245,34,484,129,355,484,129,355,,,
430306,34,32,14,18,23,11,12,9,3,6
430403,34,212,14,198,212,14,198,,,
430564,34,7,2,5,5,1,4,2,1,1
430582,34,164,69,95,164,69,95,,,
430670,34,57,16,41,57,16,41,,,
430704,34,23,5,18,22,5,17,1,0,1
430795,34,28,6,22,28,6,22,,,
430883,34,26,2,24,26,2,24,,,
430908,34,20,2,18,12,0,12,8,2,6
430935,34,506,374,132,346,259,87,160,115,45
430971,34,19,2,17,19,2,17,,,
431017,34,51,28,23,43,21,22,8,7,1
431071,34,7,3,4,2,2,0,5,1,4
431105,34,44,1,43,21,0,21,23,1,22
431123,34,54,53,1,54,53,1,,,
431141,34,1114,394,720,1073,391,682,41,3,38
431187,34,34,32,2,34,32,2,,,
431196,34,83,6,77,83,6,77,,,
431266,34,34,3,31,31,3,28,3,0,3
431275,34,28,3,25,5,0,5,23,3,20
431284,34,41,0,41,37,0,37,4,0,4
431558,34,89,24,65,85,23,62,4,1,3
431600,34,155,29,126,135,22,113,20,7,13
431716,34,99,57,42,99,57,42,,,
431983,34,74,74,0,74,74,0,,,
432117,34,159,1,158,100,1,99,59,0,59
432269,34,54,43,11,54,43,11,,,
432384,34,348,77,271,348,77,271,,,
432524,34,61,20,41,59,19,40,2,1,1
433004,34,347,90,257,347,90,257,,,
433013,34,706,228,478,706,228,478,,,
433040,34,31,2,29,31,2,29,,,
433068,34,180,120,60,138,79,59,42,41,1
433101,34,438,51,387,285,39,246,153,12,141
433138,34,76,8,68,70,4,66,6,4,2
433174,34,388,47,341,72,12,60,316,35,281
433387,34,111717,44820,66897,111717,44820,66897,,,
433420,34,301,258,43,301,258,43,,,
433536,34,325,33,292,183,21,162,142,12,130
433660,34,11001,4791,6210,8365,3596,4769,2636,1195,1441
434016,34,107,31,76,45,16,29,62,15,47
434061,34,3605,1231,2374,1830,713,1117,1775,518,1257
434140,34,611,138,473,611,138,473,,,
434159,34,308,257,51,308,257,51,,,
434274,34,8,0,8,4,0,4,4,0,4
434283,34,37,1,36,36,1,35,1,0,1
434308,34,169,11,158,169,11,158,,,
434344,34,180,7,173,180,7,173,,,
434362,34,17,16,1,17,16,1,,,
434432,34,10,1,9,10,1,9,,,
434469,34,123,10,113,123,10,113,,,
434496,34,23,0,23,23,0,23,,,
434539,34,6,4,2,2,2,0,4,2,2
434584,34,126,28,98,32,8,24,94,20,74
434672,34,10442,3573,6869,2411,1120,1291,8031,2453,5578
434751,34,75,18,57,36,8,28,39,10,29
434821,34,423,19,404,423,19,404,,,
434830,34,91,0,91,61,0,61,30,0,30
434900,34,296,71,225,163,32,131,133,39,94
434937,34,33,33,0,33,33,0,,,
435000,34,23,9,14,22,9,13,1,0,1
436030,34,135,68,67,74,52,22,61,16,45
436304,34,1229,647,582,657,348,309,572,299,273
436429,34,4479,2892,1587,4479,2892,1587,,,
436553,34,753,126,627,753,126,627,,,
436599,34,99,17,82,6,0,6,93,17,76
436614,34,45,24,21,22,11,11,23,13,10
436632,34,33,8,25,17,6,11,16,2,14
436641,34,20,8,12,20,8,12,,,
436650,34,132,11,121,132,11,121,,,
436775,34,80,3,77,80,3,77,,,
436818,34,511,195,316,461,172,289,50,23,27
436827,34,298,159,139,284,150,134,14,9,5
436836,34,1589,803,786,1459,738,721,130,65,65
437097,34,369,212,157,339,194,145,30,18,12
437103,34,5617,1628,3989,2434,858,1576,3183,770,2413
437237,34,62,49,13,62,49,13,,,
437556,34,864,363,501,801,355,446,63,8,55
437608,34,88,73,15,87,72,15,1,1,0
437635,34,524,56,468,524,56,468,,,
437723,34,1,1,0,1,1,0,,,
437732,34,52,3,49,36,1,35,16,2,14
437750,34,53,52,1,53,52,1,,,
437769,34,119,8,111,119,8,111,,,
437778,34,28,2,26,28,2,26,,,
437857,34,87,1,86,68,1,67,19,0,19
437936,34,577,70,507,577,70,507,,,
438179,34,206,31,175,206,31,175,,,
438221,34,103,9,94,92,8,84,11,1,10
438258,34,387,76,311,387,76,311,,,
438285,34,124,16,108,124,16,108,,,
438337,34,2,0,2,1,0,1,1,0,1
438504,34,775,741,34,775,741,34,,,
438586,34,895,311,584,745,258,487,150,53,97
438674,34,39,0,39,20,0,20,19,0,19
438708,34,151,26,125,79,15,64,72,11,61
438735,34,143,130,13,89,82,7,54,48,6
438984,34,8,4,4,8,4,4,,,
439020,34,3,1,2,2,0,2,1,1,0
439118,34,237,37,200,237,37,200,,,
439190,34,942,474,468,514,258,256,428,216,212
439367,34,1159,330,829,1159,330,829,,,
439446,34,1,1,0,1,1,0,,,
439455,34,300,13,287,153,8,145,147,5,142
439473,34,135,43,92,61,23,38,74,20,54
439491,34,172,24,148,172,24,148,,,
439570,34,340,13,327,340,13,327,,,
439622,34,329,51,278,329,51,278,,,
439668,34,157,145,12,157,145,12,,,
439686,34,1,0,1,1,0,1,,,
439701,34,246,93,153,112,42,70,134,51,83
439738,34,321,56,265,321,56,265,,,
439747,34,119,20,99,74,15,59,45,5,40
439774,34,13,3,10,5,2,3,8,1,7
439783,34,73,16,57,60,12,48,13,4,9
439792,34,312,34,278,306,34,272,6,0,6
439844,34,20,0,20,20,0,20,,,
439862,34,46,16,30,42,14,28,4,2,2
439871,34,172,4,168,169,4,165,3,0,3
439899,34,43,21,22,32,12,20,11,9,2
439932,34,11,0,11,11,0,11,,,
439969,34,13,6,7,13,6,7,,,
440059,34,575,533,42,333,306,27,242,227,15
440101,34,66,1,65,31,0,31,35,1,34
440262,34,341,325,16,244,231,13,97,94,3
440271,34,84,36,48,84,36,48,,,
440396,34,149,62,87,137,57,80,12,5,7
440402,34,847,235,612,355,114,241,492,121,371
440651,34,382,83,299,187,53,134,195,30,165
440730,34,262,72,190,262,72,190,,,
440749,34,44,30,14,5,4,1,39,26,13
440776,34,43,18,25,43,18,25,,,
440794,34,258,70,188,240,59,181,18,11,7
440819,34,11,8,3,11,8,3,,,
440828,34,852,445,407,438,223,215,414,222,192
440855,34,21,0,21,21,0,21,,,
440989,34,373,290,83,373,290,83,,,
441025,34,111,22,89,105,21,84,6,1,5
441052,34,1327,363,964,1327,363,964,,,
441070,34,81,29,52,26,8,18,55,21,34
441168,34,14,0,14,14,0,14,,,
441210,34,257,82,175,23,1,22,234,81,153
441229,34,1376,251,1125,1376,251,1125,,,
441256,34,27,1,26,27,1,26,,,
441371,34,4684,119,4565,4674,119,4555,10,0,10
441380,34,190,77,113,154,65,89,36,12,24
441414,34,65,15,50,16,6,10,49,9,40
441423,34,489,151,338,489,151,338,,,
441487,34,47,1,46,47,1,46,,,
441496,34,154,133,21,101,88,13,53,45,8
441502,34,242,17,225,242,17,225,,,
441575,34,222,16,206,222,16,206,,,
441593,34,12,1,11,12,1,11,,,
441609,34,131,131,0,131,131,0,,,
441618,34,6,0,6,3,0,3,3,0,3
441636,34,296,50,246,252,39,213,44,11,33
441645,34,108,3,105,85,3,82,23,0,23
441663,34,175,17,158,175,17,158,,,
441672,34,7,0,7,7,0,7,,,
441690,34,107,68,39,49,28,21,58,40,18
441706,34,151,59,92,151,59,92,,,
441742,34,584,60,524,525,54,471,59,6,53
441760,34,2262,889,1373,791,410,381,1471,479,992
441788,34,355,321,34,222,198,24,133,123,10
441830,34,30,7,23,30,7,23,,,
441858,34,159,8,151,134,4,130,25,4,21
441876,34,198,4,194,115,3,112,83,1,82
441900,34,4145,924,3221,1583,333,1250,2562,591,1971
441937,34,5082,1756,3326,3705,1231,2474,1377,525,852
441982,34,281,135,146,281,135,146,,,
442073,34,454,87,367,294,69,225,160,18,142
442134,34,250,52,198,250,52,198,,,
442240,34,392,77,315,245,45,200,147,32,115
442329,34,560,497,63,560,497,63,,,
442356,34,1437,162,1275,485,59,426,952,103,849
442383,34,111,13,98,111,13,98,,,
442426,34,363,34,329,264,24,240,99,10,89
442435,34,45,7,38,45,7,38,,,
442444,34,788,408,380,788,408,380,,,
442523,34,58,21,37,55,20,35,3,1,2
442569,34,4007,1640,2367,1351,508,843,2656,1132,1524
442602,34,355,49,306,355,49,306,,,
442611,34,662,626,36,662,626,36,,,
442639,34,144,88,56,144,88,56,,,
442657,34,66,1,65,66,1,65,,,
442781,34,650,127,523,174,36,138,476,91,385
442842,34,29,7,22,20,6,14,9,1,8
442879,34,815,67,748,796,64,732,19,3,16
442888,34,35,33,2,35,33,2,,,
442930,34,370,169,201,346,156,190,24,13,11
442976,34,59,6,53,59,6,53,,,
442985,34,4,2,2,4,2,2,,,
443021,34,8,7,1,8,7,1,,,
443049,34,163,91,72,82,44,38,81,47,34
443058,34,29,10,19,3,2,1,26,8,18
443100,34,28,17,11,28,17,11,,,
443137,34,68,19,49,68,19,49,,,
443146,34,35,26,9,22,17,5,13,9,4
443207,34,85,81,4,85,81,4,,,
443216,34,82,64,18,82,64,18,,,
443225,34,19,14,5,19,14,5,,,
443234,34,83,3,80,83,3,80,,,
443252,34,563,321,242,563,321,242,,,
443261,34,131,11,120,90,9,81,41,2,39
443289,34,89,5,84,89,5,84,,,
443298,34,2,2,0,2,2,0,,,
443322,34,156,27,129,156,27,129,,,
443331,34,2619,525,2094,2089,416,1673,530,109,421
443340,34,42,19,23,42,19,23,,,
443377,34,31,27,4,31,27,4,,,
443410,34,872,616,256,789,552,237,83,64,19
443492,34,658,291,367,501,233,268,157,58,99
443562,34,241,37,204,119,20,99,122,17,105
443571,34,368,177,191,368,177,191,,,
443599,34,696,56,640,168,24,144,528,32,496
443632,34,42,27,15,42,27,15,,,
443641,34,113,4,109,57,3,54,56,1,55
443650,34,1432,209,1223,1341,187,1154,91,22,69
443669,34,2,0,2,2,0,2,,,
443696,34,41,9,32,41,9,32,,,
443748,34,319,74,245,308,74,234,11,0,11
443766,34,2411,438,1973,140,61,79,2271,377,1894
443784,34,1163,270,893,66,29,37,1097,241,856
443951,34,39,15,24,39,15,24,,,
443979,34,17,0,17,1,0,1,16,0,16
444051,34,24,0,24,18,0,18,6,0,6
444088,34,516,67,449,516,67,449,,,
444130,34,106,25,81,15,3,12,91,22,69
444194,34,188,7,181,188,7,181,,,
444219,34,6246,2748,3498,1125,553,572,5121,2195,2926
444228,34,15,0,15,15,0,15,,,
444255,34,53,3,50,53,3,50,,,
444282,34,54,1,53,18,0,18,36,1,35
444291,34,74,3,71,46,1,45,28,2,26
444307,34,40,2,38,31,1,30,9,1,8
444325,34,110,18,92,103,17,86,7,1,6
444334,34,63,10,53,63,10,53,,,
444361,34,29,13,16,29,13,16,,,
444370,34,22,20,2,22,20,2,,,
444398,34,96,45,51,68,34,34,28,11,17
444404,34,17,7,10,10,5,5,7,2,5
444413,34,98,98,0,98,98,0,,,
444440,34,27,4,23,27,4,23,,,
444468,34,21,0,21,19,0,19,2,0,2
444486,34,250,11,239,219,9,210,31,2,29
444510,34,53,0,53,53,0,53,,,
444529,34,16,2,14,16,2,14,,,
444556,34,330,163,167,330,163,167,,,
444565,34,322,141,181,234,101,133,88,40,48
444583,34,171,67,104,171,67,104,,,
444635,34,43,6,37,43,6,37,,,
444662,34,66,56,10,66,56,10,,,
444671,34,70,24,46,70,24,46,,,
444714,34,134,16,118,134,16,118,,,
444732,34,27,4,23,27,4,23,,,
444778,34,43,18,25,24,8,16,19,10,9
444787,34,2927,392,2535,1736,216,1520,1191,176,1015
444811,34,312,17,295,143,10,133,169,7,162
444857,34,116,2,114,66,1,65,50,1,49
444866,34,102,4,98,69,2,67,33,2,31
444893,34,29,0,29,29,0,29,,,
444936,34,85,15,70,84,14,70,1,1,0
444945,34,115,18,97,115,18,97,,,
444954,34,688,262,426,391,163,228,297,99,198
445027,34,9340,3450,5890,8582,3239,5343,758,211,547
445133,34,110,44,66,79,33,46,31,11,20
445188,34,5950,2919,3031,5831,2846,2985,119,73,46
445203,34,115,17,98,115,17,98,,,
445212,34,152,28,124,73,14,59,79,14,65
445230,34,608,188,420,608,188,420,,,
445249,34,163,38,125,163,38,125,,,
445267,34,1488,312,1176,844,167,677,644,145,499
445364,34,485,48,437,485,48,437,,,
445461,34,260,78,182,257,78,179,3,0,3
445498,34,1,1,0,1,1,0,,,
445540,34,46,0,46,46,0,46,,,
445647,34,121,3,118,71,2,69,50,1,49
445656,34,155,7,148,94,3,91,61,4,57
445692,34,316,259,57,279,228,51,37,31,6
445708,34,748,253,495,710,240,470,38,13,25
445735,34,574,150,424,574,150,424,,,
445744,34,407,50,357,407,50,357,,,
445762,34,156,145,11,91,84,7,65,61,4
445780,34,19,4,15,19,4,15,,,
445799,34,534,515,19,534,515,19,,,
445841,34,136,2,134,106,2,104,30,0,30
445850,34,107,2,105,77,1,76,30,1,29
445911,34,545,230,315,359,157,202,186,73,113
445948,34,1445,222,1223,1445,222,1223,,,
445957,34,124,25,99,,,,124,25,99
446048,34,874,400,474,865,395,470,9,5,4
446084,34,41,4,37,,,,41,4,37
446093,34,17,0,17,17,0,17,,,
446109,34,261,40,221,193,34,159,68,6,62
446118,34,501,96,405,501,96,405,,,
446127,34,151,7,144,151,7,144,,,
446163,34,185,172,13,105,97,8,80,75,5
446206,34,10,0,10,7,0,7,3,0,3
446224,34,11,5,6,,,,11,5,6
446233,34,116,66,50,105,61,44,11,5,6
446242,34,122,29,93,122,29,93,,,
446251,34,6,6,0,6,6,0,,,
446260,34,651,13,638,651,13,638,,,
446288,34,73,0,73,47,0,47,26,0,26
446303,34,63,1,62,52,0,52,11,1,10
446349,34,12,2,10,12,2,10,,,
446385,34,178,96,82,164,88,76,14,8,6
446516,34,3,1,2,3,1,2,,,
446525,34,1194,1013,181,1194,1013,181,,,
446552,34,1003,566,437,1003,566,437,,,
446561,34,1802,386,1416,1802,386,1416,,,
446598,34,20,0,20,19,0,19,1,0,1
446604,34,2024,2024,0,2024,2024,0,,,
446640,34,490,339,151,446,310,136,44,29,15
446774,34,1110,404,706,400,157,243,710,247,463
447014,34,150,12,138,150,12,138,,,
447023,34,1410,530,880,1396,526,870,14,4,10
447050,34,197,57,140,71,23,48,126,34,92
447148,34,120,3,117,80,3,77,40,0,40
447166,34,26,0,26,14,0,14,12,0,12
447175,34,39,3,36,21,2,19,18,1,17
447263,34,2023,320,1703,1237,195,1042,786,125,661
447351,34,437,237,200,437,237,200,,,
447421,34,215,21,194,215,21,194,,,
447449,34,19,6,13,15,6,9,4,0,4
447467,34,16,2,14,16,2,14,,,
447582,34,546,150,396,363,109,254,183,41,142
447591,34,467,47,420,467,47,420,,,
447607,34,1275,670,605,1275,670,605,,,
447616,34,1015,588,427,1015,588,427,,,
447689,34,8134,3334,4800,5185,2122,3063,2949,1212,1737
447704,34,92,1,91,92,1,91,,,
447713,34,148,49,99,148,49,99,,,
447722,34,16,2,14,16,2,14,,,
447731,34,75,6,69,46,5,41,29,1,28
447759,34,249,65,184,231,62,169,18,3,15
447768,34,1416,340,1076,1416,340,1076,,,
447777,34,310,172,138,7,5,2,303,167,136
447795,34,2,0,2,2,0,2,,,
447810,34,6,2,4,6,2,4,,,
447847,34,148,136,12,148,136,12,,,
447865,34,10,7,3,10,7,3,,,
447883,34,81,9,72,34,4,30,47,5,42
447892,34,62,4,58,48,4,44,14,0,14
447908,34,61,1,60,34,0,34,27,1,26
447917,34,17,1,16,17,1,16,,,
447935,34,207,10,197,207,10,197,,,
447953,34,348,167,181,235,112,123,113,55,58
447962,34,98,8,90,98,8,90,,,
447971,34,10,0,10,10,0,10,,,
447980,34,48,1,47,32,1,31,16,0,16
447999,34,114,23,91,114,23,91,,,
448026,34,98,3,95,77,3,74,21,0,21
448071,34,111,6,105,111,6,105,,,
448123,34,13,8,5,13,8,5,,,
448196,34,103,8,95,100,8,92,3,0,3
448220,34,107,3,104,107,3,104,,,
448239,34,118,4,114,118,4,114,,,
448248,34,1522,994,528,186,31,155,1336,963,373
448257,34,10,0,10,1,0,1,9,0,9
448275,34,9,0,9,9,0,9,,,
448372,34,184,72,112,184,72,112,,,
448424,34,28,7,21,11,3,8,17,4,13
448433,34,687,656,31,687,656,31,,,
448594,34,2346,841,1505,852,312,540,1494,529,965
448600,34,160,13,147,160,13,147,,,
448646,34,16,0,16,16,0,16,,,
448673,34,2220,208,2012,928,81,847,1292,127,1165
448770,34,240,227,13,231,221,10,9,6,3
448798,34,60,5,55,60,5,55,,,
448859,34,93,86,7,93,86,7,,,
448895,34,55,9,46,55,9,46,,,
449038,34,1206,340,866,205,115,90,1001,225,776
449074,34,450,57,393,450,57,393,,,
449083,34,100,100,0,100,100,0,,,
449092,34,34,34,0,34,34,0,,,
449135,34,183,52,131,123,46,77,60,6,54
449250,34,539,93,446,539,93,446,,,
449311,34,129,1,128,38,0,38,91,1,90
449320,34,474,460,14,339,329,10,135,131,4
449339,34,35813,22823,12990,2848,1504,1344,32965,21319,11646
449348,34,62,22,40,8,4,4,54,18,36
449357,34,76,4,72,76,4,72,,,
449384,34,263,157,106,250,151,99,13,6,7
449393,34,96,35,61,96,35,61,,,
449445,34,46,9,37,46,9,37,,,
449454,34,35,4,31,,,,35,4,31
449463,34,28,8,20,18,6,12,10,2,8
449472,34,42,1,41,42,1,41,,,
449490,34,41,6,35,41,6,35,,,
449506,34,102,28,74,102,28,74,,,
449524,34,285,24,261,285,24,261,,,
449533,34,35,6,29,35,6,29,,,
449597,34,1,0,1,1,0,1,,,
449603,34,69,46,23,69,46,23,,,
449612,34,85,44,41,85,44,41,,,
449658,34,77,77,0,74,74,0,3,3,0
449676,34,176,58,118,176,58,118,,,
449685,34,38,3,35,38,3,35,,,
449700,34,285,62,223,285,62,223,,,
449728,34,134,6,128,134,6,128,,,
449764,34,164,73,91,159,72,87,5,1,4
449773,34,12,3,9,12,3,9,,,
449782,34,3,1,2,2,1,1,1,0,1
449807,34,21,2,19,21,2,19,,,
449816,34,254,168,86,31,15,16,223,153,70
449834,34,1,1,0,,,,1,1,0
449861,34,24,1,23,24,1,23,,,
449870,34,54,22,32,52,22,30,2,0,2
449889,34,142,36,106,142,36,106,,,
449898,34,402,72,330,299,55,244,103,17,86
449904,34,27,1,26,27,1,26,,,
449959,34,130,33,97,71,18,53,59,15,44
449968,34,268,55,213,197,40,157,71,15,56
449977,34,193,3,190,150,2,148,43,1,42
449986,34,254,66,188,156,35,121,98,31,67
449995,34,118,5,113,65,3,62,53,2,51
450058,34,759,124,635,759,124,635,,,
450067,34,416,107,309,409,107,302,7,0,7
450128,34,426,10,416,426,10,416,,,
450298,34,230,54,176,19,12,7,211,42,169
450377,34,1193,225,968,84,37,47,1109,188,921
450395,34,116,1,115,82,1,81,34,0,34
450401,34,255,24,231,255,24,231,,,
450571,34,391,43,348,174,21,153,217,22,195
450599,34,30,0,30,30,0,30,,,
450605,34,30,1,29,15,0,15,15,1,14
450614,34,75,3,72,51,2,49,24,1,23
450632,34,53,10,43,,,,53,10,43
450641,34,246,19,227,153,16,137,93,3,90
450650,34,104,4,100,39,0,39,65,4,61
450696,34,326,48,278,326,48,278,,,
450702,34,34,4,30,34,4,30,,,
450711,34,2,1,1,2,1,1,,,
450720,34,454,7,447,187,4,183,267,3,264
450933,34,10912,7131,3781,6213,3832,2381,4699,3299,1400
450951,34,69,40,29,69,40,29,,,
450960,34,315,29,286,238,20,218,77,9,68
450988,34,133,12,121,89,8,81,44,4,40
451042,34,7,2,5,3,0,3,4,2,2
451051,34,83,7,76,,,,83,7,76
451097,34,11,2,9,4,0,4,7,2,5
451103,34,86,16,70,33,5,28,53,11,42
451121,34,111,9,102,51,4,47,60,5,55
451149,34,920,59,861,920,59,861,,,
451158,34,675,32,643,675,32,643,,,
451167,34,167,85,82,93,56,37,74,29,45
451194,34,26,3,23,26,3,23,,,
451228,34,74,57,17,74,57,17,,,
451237,34,165,3,162,165,3,162,,,
451255,34,37,1,36,19,0,19,18,1,17
451282,34,80,2,78,56,1,55,24,1,23
451291,34,4,0,4,,,,4,0,4
451307,34,29,0,29,2,0,2,27,0,27
451316,34,45,4,41,45,4,41,,,
451334,34,168,70,98,94,44,50,74,26,48
451343,34,74,4,70,44,2,42,30,2,28
451352,34,54,6,48,38,4,34,16,2,14
451370,34,49,49,0,49,49,0,,,
451398,34,154,154,0,154,154,0,,,
451404,34,307,307,0,307,307,0,,,
451413,34,389,100,289,389,100,289,,,
451468,34,356,3,353,356,3,353,,,
451477,34,1029,835,194,1029,835,194,,,
451495,34,256,63,193,256,63,193,,,
451501,34,138,40,98,138,40,98,,,
451529,34,16,1,15,9,0,9,7,1,6
451547,34,7,1,6,7,1,6,,,
451556,34,972,333,639,972,333,639,,,
451565,34,159,23,136,146,13,133,13,10,3
451574,34,127,5,122,97,4,93,30,1,29
451583,34,708,546,162,107,72,35,601,474,127
451626,34,14,1,13,14,1,13,,,
451714,34,259,50,209,148,11,137,111,39,72
451741,34,74,24,50,48,17,31,26,7,19
451750,34,914,183,731,511,143,368,403,40,363
451820,34,69,44,25,42,27,15,27,17,10
451857,34,43,1,42,43,1,42,,,
451866,34,226,40,186,226,40,186,,,
451918,34,100,11,89,100,11,89,,,
451927,34,273,138,135,256,129,127,17,9,8
452009,34,45,1,44,45,1,44,,,
452072,34,13,1,12,13,1,12,,,
452081,34,659,20,639,659,20,639,,,
452106,34,41,39,2,41,39,2,,,
452124,34,340,71,269,338,70,268,2,1,1
452373,34,277,16,261,277,16,261,,,
452771,34,2,0,2,,,,2,0,2
452780,34,5,1,4,,,,5,1,4
452887,34,36,34,2,36,34,2,,,
452948,34,536,49,487,346,27,319,190,22,168
453163,34,2528,471,2057,189,85,104,2339,386,1953
453215,34,443,95,348,15,3,12,428,92,336
453297,34,21,6,15,,,,21,6,15
453756,34,48,28,20,48,28,20,,,
453792,34,73,4,69,73,4,69,,,
454184,34,225,80,145,212,76,136,13,4,9
454227,34,11504,1223,10281,2740,325,2415,8764,898,7866
454236,34,527,60,467,199,21,178,328,39,289
454245,34,809,140,669,287,48,239,522,92,430
454537,34,33,0,33,33,0,33,,,
454546,34,23,3,20,23,3,20,,,
454555,34,22,2,20,22,2,20,,,
454582,34,101,41,60,24,14,10,77,27,50
454607,34,304,10,294,304,10,294,,,
454652,34,127,3,124,127,3,124,,,
454689,34,2,1,1,2,1,1,,,
454698,34,236,69,167,236,69,167,,,
454722,34,18,3,15,16,2,14,2,1,1
454759,34,37,30,7,32,26,6,5,4,1
454768,34,208,34,174,118,22,96,90,12,78
454777,34,207,27,180,137,20,117,70,7,63
454786,34,514,322,192,128,81,47,386,241,145
454795,34,232,60,172,158,44,114,74,16,58
454801,34,172,33,139,172,33,139,,,
454810,34,6540,1698,4842,6540,1698,4842,,,
454829,34,3893,504,3389,575,77,498,3318,427,2891
454856,34,1034,133,901,1034,133,901,,,
454865,34,836,135,701,551,100,451,285,35,250
454874,34,9,0,9,3,0,3,6,0,6
454917,34,609,101,508,367,59,308,242,42,200
454926,34,284,16,268,242,14,228,42,2,40
454935,34,59,1,58,59,1,58,,,
454944,34,215,15,200,215,15,200,,,
454953,34,22,0,22,8,0,8,14,0,14
454962,34,36,2,34,16,1,15,20,1,19
454971,34,162,15,147,85,14,71,77,1,76
454980,34,139,0,139,26,0,26,113,0,113
454999,34,105,2,103,46,1,45,59,1,58
455008,34,117,3,114,46,2,44,71,1,70
455026,34,53,49,4,,,,53,49,4
455062,34,48,0,48,20,0,20,28,0,28
455071,34,55,17,38,,,,55,17,38
455080,34,237,26,211,236,26,210,1,0,1
455105,34,78,0,78,78,0,78,,,
455114,34,4285,1736,2549,1489,773,716,2796,963,1833
455141,34,179,4,175,179,4,175,,,
455187,34,59,18,41,36,13,23,23,5,18
455196,34,3163,272,2891,3163,272,2891,,,
455202,34,229,34,195,63,5,58,166,29,137
455211,34,267,8,259,267,8,259,,,
455220,34,19,1,18,19,1,18,,,
455257,34,332,332,0,332,332,0,,,
455275,34,213,5,208,213,5,208,,,
455284,34,180,5,175,121,4,117,59,1,58
455327,34,40,1,39,33,1,32,7,0,7
455336,34,163,132,31,163,132,31,,,
455354,34,224,4,220,224,4,220,,,
455381,34,92,0,92,64,0,64,28,0,28
455460,34,85,16,69,85,16,69,,,
455479,34,571,63,508,485,58,427,86,5,81
455488,34,152,58,94,152,58,94,,,
455512,34,2269,788,1481,408,168,240,1861,620,1241
455628,34,303,91,212,303,91,212,,,
455664,34,257,34,223,14,6,8,243,28,215
455707,34,51,12,39,51,12,39,,,
455725,34,230,4,226,168,2,166,62,2,60
455734,34,107,23,84,107,23,84,,,
455761,34,301,42,259,182,28,154,119,14,105
455770,34,98,58,40,97,58,39,1,0,1
455798,34,75,1,74,35,1,34,40,0,40
455831,34,23,1,22,23,1,22,,,
455859,34,208,3,205,177,3,174,31,0,31
455868,34,273,39,234,273,39,234,,,
455877,34,61,5,56,61,5,56,,,
455886,34,136,7,129,56,1,55,80,6,74
455895,34,325,23,302,129,3,126,196,20,176
455901,34,151,11,140,65,2,63,86,9,77
455910,34,2,2,0,2,2,0,,,
455929,34,43,0,43,43,0,43,,,
455965,34,111,7,104,111,7,104,,,
455974,34,55,4,51,55,4,51,,,
455983,34,147,43,104,145,42,103,2,1,1
456001,34,25,23,2,25,23,2,,,
456029,34,223,9,214,163,9,154,60,0,60
456038,34,296,35,261,296,35,261,,,
456065,34,135,2,133,131,2,129,4,0,4
456074,34,114,7,107,113,7,106,1,0,1
456135,34,35,0,35,23,0,23,12,0,12
456153,34,54,47,7,54,47,7,,,
456205,34,109,15,94,106,15,91,3,0,3
456214,34,290,174,116,290,174,116,,,
456287,34,75,1,74,75,1,74,,,
456454,34,390,99,291,318,88,230,72,11,61
456481,34,34,18,16,,,,34,18,16
456490,34,107,72,35,31,23,8,76,49,27
456506,34,37,3,34,37,3,34,,,
456515,34,22,2,20,22,2,20,,,
456551,34,28,2,26,28,2,26,,,
456579,34,154,42,112,143,42,101,11,0,11
456588,34,32,1,31,32,1,31,,,
456597,34,211,5,206,103,2,101,108,3,105
456621,34,261,79,182,20,10,10,241,69,172
456825,34,168,8,160,120,4,116,48,4,44
456852,34,290,94,196,290,94,196,,,
456922,34,170,33,137,158,32,126,12,1,11
456931,34,232,113,119,228,113,115,4,0,4
456959,34,424,92,332,400,84,316,24,8,16
456968,34,1016,40,976,955,35,920,61,5,56
456977,34,18,11,7,18,11,7,,,
457031,34,57,0,57,38,0,38,19,0,19
457077,34,61,3,58,61,3,58,,,
457086,34,175,40,135,131,31,100,44,9,35
457101,34,274,79,195,274,79,195,,,
457110,34,444,81,363,444,81,363,,,
457129,34,913,94,819,231,14,217,682,80,602
457192,34,26,19,7,26,19,7,,,
457208,34,102,92,10,102,92,10,,,
457226,34,35,24,11,13,9,4,22,15,7
457253,34,111,6,105,38,2,36,73,4,69
457299,34,349,60,289,307,52,255,42,8,34
457314,34,79,16,63,79,16,63,,,
457323,34,333,38,295,333,38,295,,,
457332,34,36,3,33,36,3,33,,,
457341,34,156,7,149,156,7,149,,,
457350,34,74,0,74,,,,74,0,74
457378,34,105,55,50,55,20,35,50,35,15
457387,34,49,17,32,49,17,32,,,
457396,34,47,14,33,7,3,4,40,11,29
457402,34,124,110,14,24,23,1,100,87,13
457411,34,210,190,20,143,126,17,67,64,3
457420,34,159,11,148,114,10,104,45,1,44
457439,34,132,2,130,60,1,59,72,1,71
457448,34,60,1,59,60,1,59,,,
457466,34,28,21,7,28,21,7,,,
457475,34,91,3,88,91,3,88,,,
457484,34,81,35,46,38,19,19,43,16,27
457493,34,51,3,48,51,3,48,,,
457527,34,211,20,191,17,1,16,194,19,175
457536,34,596,92,504,596,92,504,,,
457545,34,76,3,73,59,2,57,17,1,16
457554,34,5,0,5,3,0,3,2,0,2
457563,34,199,4,195,199,4,195,,,
457572,34,110,2,108,110,2,108,,,
457581,34,110,1,109,106,1,105,4,0,4
457606,34,10,0,10,10,0,10,,,
457615,34,42,6,36,,,,42,6,36
457624,34,27,7,20,27,7,20,,,
457633,34,181,6,175,60,1,59,121,5,116
457642,34,33,0,33,33,0,33,,,
457679,34,21,1,20,21,1,20,,,
457697,34,107,51,56,17,6,11,90,45,45
457749,34,71,3,68,71,3,68,,,
457767,34,59,33,26,59,33,26,,,
457776,34,155,13,142,153,12,141,2,1,1
457785,34,19,0,19,19,0,19,,,
457794,34,5,0,5,5,0,5,,,
457800,34,7,0,7,7,0,7,,,
457819,34,520,197,323,,,,520,197,323
457837,34,112,5,107,49,4,45,63,1,62
457855,34,56,2,54,40,1,39,16,1,15
457873,34,84,63,21,43,34,9,41,29,12
457916,34,53,2,51,20,0,20,33,2,31
457925,34,11,5,6,11,5,6,,,
457943,34,26,6,20,26,6,20,,,
457952,34,150,2,148,121,2,119,29,0,29
457989,34,24,0,24,24,0,24,,,
458007,34,6,0,6,4,0,4,2,0,2
458034,34,38,7,31,38,7,31,,,
458043,34,73,1,72,49,1,48,24,0,24
458061,34,38,2,36,20,2,18,18,0,18
458070,34,237,13,224,224,13,211,13,0,13
458098,34,73,0,73,66,0,66,7,0,7
458104,34,224,1,223,4,0,4,220,1,219
458113,34,57,23,34,1,0,1,56,23,33
458122,34,13,0,13,13,0,13,,,
458131,34,40,1,39,40,1,39,,,
458140,34,53,46,7,53,46,7,,,
458168,34,49,3,46,49,3,46,,,
458210,34,3016,679,2337,2280,513,1767,736,166,570
458229,34,2572,561,2011,2089,453,1636,483,108,375
458274,34,173,5,168,145,5,140,28,0,28
458405,34,110,24,86,108,24,84,2,0,2
458441,34,208,28,180,205,28,177,3,0,3
458496,34,78,41,37,52,28,24,26,13,13
458681,34,252,33,219,252,33,219,,,
458803,34,99,0,99,64,0,64,35,0,35
458812,34,55,3,52,43,2,41,12,1,11
458821,34,25,1,24,25,1,24,,,
458830,34,97,1,96,75,0,75,22,1,21
458858,34,151,3,148,80,1,79,71,2,69
458867,34,117,2,115,79,2,77,38,0,38
458885,34,256,36,220,6,1,5,250,35,215
458919,34,4151,925,3226,453,219,234,3698,706,2992
458955,34,259,50,209,12,4,8,247,46,201
458964,34,1540,335,1205,131,73,58,1409,262,1147
458973,34,2147,592,1555,295,163,132,1852,429,1423
458982,34,160,83,77,117,59,58,43,24,19
459019,34,30,2,28,23,1,22,7,1,6
459046,34,29,2,27,21,1,20,8,1,7
459055,34,30,1,29,16,0,16,14,1,13
459064,34,40,2,38,26,0,26,14,2,12
459116,34,81,7,74,81,7,74,,,
459170,34,255,27,228,127,25,102,128,2,126
459189,34,85,0,85,62,0,62,23,0,23
459198,34,322,55,267,230,50,180,92,5,87
459204,34,4002,590,3412,4002,590,3412,,,
459213,34,2488,544,1944,2488,544,1944,,,
459231,34,204,18,186,204,18,186,,,
459259,34,261,40,221,198,32,166,63,8,55
459268,34,197,26,171,146,16,130,51,10,41
459277,34,249,21,228,249,21,228,,,
459286,34,164,21,143,123,14,109,41,7,34
459295,34,41,1,40,13,1,12,28,0,28
459301,34,91,5,86,71,3,68,20,2,18
459329,34,144,109,35,144,109,35,,,
459347,34,74,1,73,15,0,15,59,1,58
459374,34,31,4,27,13,4,9,18,0,18
459392,34,129,6,123,77,6,71,52,0,52
459408,34,41,6,35,26,1,25,15,5,10
459417,34,39,27,12,29,22,7,10,5,5
459426,34,67,0,67,67,0,67,,,
459499,34,21,4,17,21,4,17,,,
459514,34,39,8,31,39,8,31,,,
459523,34,1,0,1,1,0,1,,,
459532,34,62,0,62,8,0,8,54,0,54
459541,34,15,0,15,4,0,4,11,0,11
459550,34,88,0,88,77,0,77,11,0,11
459578,34,99,29,70,70,17,53,29,12,17
459727,34,353,105,248,194,53,141,159,52,107
459824,34,15,1,14,15,1,14,,,
459842,34,566,59,507,296,31,265,270,28,242
459851,34,350,42,308,177,26,151,173,16,157
459949,34,5376,1835,3541,2923,995,1928,2453,840,1613
459958,34,225,57,168,225,57,168,,,
459967,34,450,184,266,450,184,266,,,
459985,34,389,192,197,389,192,197,,,
459994,34,7889,2460,5429,468,229,239,7421,2231,5190
460011,34,172,0,172,119,0,119,53,0,53
460020,34,360,64,296,360,64,296,,,
460093,34,16,1,15,16,1,15,,,
460109,34,49,0,49,49,0,49,,,
460118,34,31,0,31,31,0,31,,,
460127,34,35,0,35,35,0,35,,,
460136,34,756,123,633,756,123,633,,,
460145,34,82,47,35,82,47,35,,,
460172,34,408,361,47,406,359,47,2,2,0
460181,34,499,83,416,499,83,416,,,
460190,34,263,44,219,263,44,219,,,
460206,34,426,118,308,426,118,308,,,
460349,34,1663,480,1183,456,112,344,1207,368,839
460376,34,7,4,3,7,4,3,,,
460385,34,70,10,60,70,10,60,,,
460394,34,6067,2502,3565,885,385,500,5182,2117,3065
460464,34,5700,2642,3058,938,523,415,4762,2119,2643
460482,34,131,8,123,131,8,123,,,
460525,34,2,0,2,2,0,2,,,
460534,34,35,0,35,35,0,35,,,
460543,34,931,885,46,931,885,46,,,
460677,34,335,60,275,270,48,222,65,12,53
460701,34,165,19,146,40,8,32,125,11,114
460756,34,93,2,91,83,2,81,10,0,10
460765,34,1,0,1,1,0,1,,,
460808,34,1,0,1,1,0,1,,,
460817,34,98,24,74,97,24,73,1,0,1
460826,34,335,64,271,330,62,268,5,2,3
460835,34,134,31,103,132,31,101,2,0,2
460862,34,193,5,188,99,1,98,94,4,90
460871,34,662,72,590,213,20,193,449,52,397
460914,34,283,2,281,283,2,281,,,
460932,34,11,0,11,11,0,11,,,
460969,34,210,15,195,210,15,195,,,
460978,34,155,3,152,73,2,71,82,1,81
460987,34,71,0,71,71,0,71,,,
460996,34,159,2,157,119,2,117,40,0,40
461014,34,614,42,572,614,42,572,,,
461023,34,408,58,350,397,56,341,11,2,9
461032,34,110,53,57,43,24,19,67,29,38
461087,34,242,105,137,123,39,84,119,66,53
461111,34,16,14,2,15,14,1,1,0,1
461148,34,726,444,282,726,444,282,,,
461175,34,154,13,141,94,11,83,60,2,58
461193,34,175,1,174,170,1,169,5,0,5
461218,34,763,54,709,763,54,709,,,
461245,34,32,11,21,8,1,7,24,10,14
461254,34,13,1,12,13,1,12,,,
461263,34,153,11,142,153,11,142,,,
461272,34,77,0,77,42,0,42,35,0,35
461281,34,89,7,82,69,5,64,20,2,18
461306,34,33,8,25,12,5,7,21,3,18
461315,34,95,21,74,21,5,16,74,16,58
461324,34,791,169,622,754,161,593,37,8,29
461342,34,82,0,82,53,0,53,29,0,29
461379,34,26,5,21,3,0,3,23,5,18
461388,34,40,13,27,40,13,27,,,
461412,34,36,9,27,,,,36,9,27
461421,34,197,11,186,195,11,184,2,0,2
461430,34,454,420,34,,,,454,420,34
461494,34,137,13,124,76,6,70,61,7,54
461500,34,25,2,23,19,1,18,6,1,5
461528,34,156,78,78,62,32,30,94,46,48
461537,34,28,0,28,27,0,27,1,0,1
461555,34,82,2,80,82,2,80,,,
461573,34,66,66,0,66,66,0,,,
461582,34,126,2,124,126,2,124,,,
461591,34,113,5,108,112,5,107,1,0,1
461607,34,72,10,62,28,7,21,44,3,41
461625,34,10,10,0,10,10,0,,,
461643,34,17,1,16,17,1,16,,,
461652,34,78,5,73,78,5,73,,,
461689,34,247,27,220,247,27,220,,,
461704,34,79,4,75,74,3,71,5,1,4
461713,34,32,0,32,15,0,15,17,0,17
461722,34,6,0,6,6,0,6,,,
461740,34,16,14,2,16,14,2,,,
461759,34,151,83,68,121,68,53,30,15,15
461768,34,141,4,137,97,3,94,44,1,43
461786,34,4,0,4,4,0,4,,,
461795,34,299,218,81,279,204,75,20,14,6
461810,34,2,0,2,1,0,1,1,0,1
461829,34,82,20,62,82,20,62,,,
461838,34,101,2,99,53,1,52,48,1,47
461847,34,41,41,0,41,41,0,,,
461856,34,19,7,12,19,7,12,,,
461865,34,3,0,3,3,0,3,,,
461874,34,56,6,50,56,6,50,,,
461883,34,38,19,19,27,15,12,11,4,7
461892,34,63,8,55,63,8,55,,,
461908,34,74,0,74,73,0,73,1,0,1
461917,34,173,0,173,107,0,107,66,0,66
461926,34,61,1,60,43,1,42,18,0,18
461944,34,71,0,71,71,0,71,,,
461953,34,27,1,26,16,1,15,11,0,11
461962,34,34,14,20,34,14,20,,,
461999,34,33,0,33,32,0,32,1,0,1
462008,34,221,13,208,144,11,133,77,2,75
462017,34,96,15,81,96,15,81,,,
462035,34,156,46,110,42,3,39,114,43,71
462053,34,42,1,41,42,1,41,,,
462062,34,90,0,90,50,0,50,40,0,40
462071,34,154,31,123,150,30,120,4,1,3
462336,34,54,4,50,54,4,50,,,
462345,34,9,0,9,4,0,4,5,0,5
462354,34,183,94,89,170,86,84,13,8,5
463056,34,884,406,478,816,371,445,68,35,33
464226,34,850,448,402,651,369,282,199,79,120
466921,34,371,21,350,112,3,109,259,18,241
466930,34,2147,282,1865,498,68,430,1649,214,1435
467094,34,136,1,135,136,1,135,,,
467368,34,40,4,36,40,4,36,,,
467863,34,222,39,183,175,30,145,47,9,38
467872,34,257,10,247,181,8,173,76,2,74
467906,34,139,2,137,106,2,104,33,0,33
468246,34,74,8,66,74,8,66,,,
468255,34,10,1,9,10,1,9,,,
468291,34,59,3,56,59,3,56,,,
468769,34,139,136,3,139,136,3,,,
468848,34,704,358,346,704,358,346,,,
468893,34,152,5,147,92,4,88,60,1,59
468909,34,828,326,502,828,326,502,,,
468963,34,155,142,13,155,142,13,,,
469416,34,234,46,188,146,39,107,88,7,81
469610,34,4,1,3,4,1,3,,,
469629,34,100,88,12,100,88,12,,,
469911,34,20,0,20,20,0,20,,,
469957,34,24,0,24,24,0,24,,,
470038,34,995,460,535,995,460,535,,,
470047,34,35,11,24,35,11,24,,,
470296,34,5,0,5,5,0,5,,,
470393,34,132,7,125,47,4,43,85,3,82
474863,34,1340,259,1081,537,108,429,803,151,652
474915,34,212,2,210,100,0,100,112,2,110
474924,34,90,3,87,20,1,19,70,2,68
475015,34,162,1,161,162,1,161,,,
475024,34,166,55,111,166,55,111,,,
475033,34,152,27,125,,,,152,27,125
475060,34,147,11,136,145,11,134,2,0,2
475121,34,5027,1059,3968,3438,753,2685,1589,306,1283
475176,34,588,327,261,588,327,261,,,
475200,34,177,53,124,28,9,19,149,44,105
475273,34,307,59,248,51,9,42,256,50,206
475282,34,86,23,63,86,23,63,,,
475325,34,30,0,30,30,0,30,,,
475398,34,65,30,35,13,7,6,52,23,29
475404,34,131,2,129,69,1,68,62,1,61
475422,34,98,5,93,12,0,12,86,5,81
475431,34,30,3,27,30,3,27,,,
475468,34,275,4,271,75,2,73,200,2,198
475477,34,244,81,163,70,43,27,174,38,136
475486,34,238,45,193,142,17,125,96,28,68
475547,34,97,18,79,47,12,35,50,6,44
475556,34,136,10,126,81,5,76,55,5,50
475565,34,457,232,225,367,186,181,90,46,44
475574,34,33,14,19,16,4,12,17,10,7
475608,34,102,69,33,65,46,19,37,23,14
475635,34,19,5,14,4,2,2,15,3,12
475653,34,18,0,18,17,0,17,1,0,1
475662,34,36,0,36,20,0,20,16,0,16
475705,34,21,5,16,21,5,16,,,
475714,34,274,228,46,247,213,34,27,15,12
475723,34,223,132,91,77,33,44,146,99,47
475732,34,1410,132,1278,346,34,312,1064,98,966
475741,34,200,15,185,90,6,84,110,9,101
475839,34,258,131,127,132,76,56,126,55,71
476063,34,161,150,11,161,150,11,,,
476179,34,99,8,91,64,4,60,35,4,31
476230,34,15,1,14,15,1,14,,,
476355,34,28,12,16,28,12,16,,,
476489,34,66,51,15,66,51,15,,,
476498,34,187,119,68,187,119,68,,,
476513,34,31,0,31,31,0,31,,,
476540,34,106,2,104,74,1,73,32,1,31
476559,34,102,6,96,60,4,56,42,2,40
476568,34,2,2,0,2,2,0,,,
476595,34,49,7,42,49,7,42,,,
476601,34,61,61,0,61,61,0,,,
476610,34,27,16,11,27,16,11,,,
476629,34,128,5,123,128,5,123,,,
476683,34,222,9,213,220,9,211,2,0,2
476692,34,24,24,0,24,24,0,,,
476708,34,135,103,32,116,88,28,19,15,4
476717,34,445,445,0,445,445,0,,,
476726,34,391,75,316,391,75,316,,,
476735,34,15,11,4,15,11,4,,,
476753,34,200,6,194,101,5,96,99,1,98
476780,34,75,4,71,64,4,60,11,0,11
476799,34,305,56,249,305,56,249,,,
476805,34,37,0,37,37,0,37,,,
476814,34,364,261,103,,,,364,261,103
476841,34,223,21,202,145,14,131,78,7,71
476850,34,64,45,19,64,45,19,,,
476869,34,33,2,31,33,2,31,,,
476878,34,67,0,67,30,0,30,37,0,37
476887,34,84,1,83,81,1,80,3,0,3
476896,34,115,54,61,115,54,61,,,
476902,34,54,1,53,34,0,34,20,1,19
476939,34,500,36,464,500,36,464,,,
476957,34,5,0,5,4,0,4,1,0,1
476975,34,6242,2870,3372,1509,717,792,4733,2153,2580
476984,34,208,12,196,165,9,156,43,3,40
476993,34,187,2,185,187,2,185,,,
477002,34,25,3,22,24,3,21,1,0,1
477039,34,970,125,845,617,80,537,353,45,308
477233,34,93,40,53,93,40,53,,,
478582,34,106,6,100,79,5,74,27,1,26
478591,34,68,1,67,38,0,38,30,1,29
478616,34,67,7,60,46,5,41,21,2,19
478917,34,33,1,32,33,1,32,,,
478953,34,166,4,162,166,4,162,,,
479062,34,78,75,3,50,48,2,28,27,1
479424,34,249,31,218,249,31,218,,,
479956,34,7499,3528,3971,3111,1324,1787,4388,2204,2184
479965,34,117,13,104,117,13,104,,,
479974,34,71,29,42,67,29,38,4,0,4
479983,34,94,14,80,94,14,80,,,
479992,34,19,18,1,2,1,1,17,17,0
480000,34,47,30,17,46,29,17,1,1,0
480019,34,323,263,60,265,210,55,58,53,5
480028,34,138,106,32,136,105,31,2,1,1
480037,34,758,547,211,758,547,211,,,
480073,34,269,44,225,210,31,179,59,13,46
480091,34,5982,530,5452,4472,389,4083,1510,141,1369
480125,34,244,9,235,109,2,107,135,7,128
480161,34,11,1,10,11,1,10,,,
480198,34,268,85,183,189,62,127,79,23,56
480204,34,357,60,297,357,60,297,,,
480310,34,53,0,53,45,0,45,8,0,8
480471,34,653,379,274,653,379,274,,,
480523,34,40,3,37,40,3,37,,,
480532,34,26,1,25,26,1,25,,,
480550,34,14,0,14,14,0,14,,,
480569,34,736,280,456,459,160,299,277,120,157
480657,34,528,62,466,253,30,223,275,32,243
480727,34,2,2,0,2,2,0,,,
480781,34,80,65,15,73,59,14,7,6,1
480824,34,354,34,320,354,34,320,,,
480833,34,683,75,608,683,75,608,,,
480842,34,14,5,9,14,5,9,,,
480851,34,23,9,14,23,9,14,,,
480879,34,46,4,42,46,4,42,,,
480888,34,108,46,62,108,46,62,,,
480903,34,327,290,37,292,258,34,35,32,3
480921,34,77,65,12,77,65,12,,,
480930,34,36,0,36,27,0,27,9,0,9
480967,34,137,45,92,67,28,39,70,17,53
480976,34,54,5,49,54,5,49,,,
480985,34,278,1,277,278,1,277,,,
480994,34,112,4,108,86,4,82,26,0,26
481003,34,75,57,18,75,57,18,,,
481021,34,15,14,1,14,13,1,1,1,0
481049,34,18,4,14,18,4,14,,,
481058,34,91,36,55,76,29,47,15,7,8
481085,34,226,19,207,226,19,207,,,
481100,34,15,2,13,6,1,5,9,1,8
481128,34,72,11,61,60,11,49,12,0,12
481137,34,46,21,25,46,21,25,,,
481146,34,49,5,44,25,0,25,24,5,19
481155,34,113,42,71,113,42,71,,,
481182,34,32,5,27,32,5,27,,,
481191,34,126,16,110,126,16,110,,,
481207,34,99,13,86,99,13,86,,,
481225,34,12,9,3,12,9,3,,,
481243,34,206,0,206,60,0,60,146,0,146
481252,34,63,8,55,63,8,55,,,
481289,34,88,22,66,88,22,66,,,
481298,34,45,1,44,45,1,44,,,
481313,34,34,0,34,19,0,19,15,0,15
481322,34,11,1,10,5,0,5,6,1,5
481331,34,31,22,9,31,22,9,,,
481340,34,12,0,12,12,0,12,,,
481368,34,62,5,57,62,5,57,,,
481386,34,206,22,184,5,0,5,201,22,179
481401,34,165,105,60,22,15,7,143,90,53
481410,34,61,61,0,61,61,0,,,
481429,34,50,11,39,50,11,39,,,
481438,34,44,44,0,44,44,0,,,
481447,34,5,1,4,3,1,2,2,0,2
481456,34,12,0,12,4,0,4,8,0,8
481465,34,68,2,66,51,1,50,17,1,16
481474,34,126,2,124,117,2,115,9,0,9
481483,34,70,3,67,36,1,35,34,2,32
481517,34,73,5,68,41,3,38,32,2,30
481526,34,177,1,176,177,1,176,,,
481571,34,3,1,2,3,1,2,,,
481678,34,41,1,40,25,1,24,16,0,16
481720,34,44,4,40,29,1,28,15,3,12
481739,34,31,2,29,21,2,19,10,0,10
481748,34,59,2,57,44,2,42,15,0,15
481775,34,205,63,142,205,63,142,,,
481845,34,46,2,44,31,1,30,15,1,14
481863,34,40,3,37,40,3,37,,,
481890,34,24,0,24,24,0,24,,,
481906,34,24,1,23,24,1,23,,,
481960,34,126,103,23,126,103,23,,,
482015,34,583,418,165,583,418,165,,,
482060,34,43,5,38,43,5,38,,,
482097,34,266,119,147,252,117,135,14,2,12
482149,34,4051,1387,2664,3300,1092,2208,751,295,456
482158,34,5308,2345,2963,3120,1449,1671,2188,896,1292
482167,34,61,1,60,14,0,14,47,1,46
482176,34,198,8,190,148,6,142,50,2,48
482185,34,15,9,6,15,9,6,,,
482194,34,106,17,89,83,13,70,23,4,19
482200,34,43,11,32,43,11,32,,,
482228,34,111,68,43,33,23,10,78,45,33
482246,34,7,4,3,7,4,3,,,
482255,34,268,242,26,178,162,16,90,80,10
482291,34,1091,512,579,1091,512,579,,,
482413,34,420,211,209,236,136,100,184,75,109
482422,34,60,37,23,27,16,11,33,21,12
482431,34,1476,833,643,776,455,321,700,378,322
482459,34,281,122,159,114,49,65,167,73,94
482468,34,505,211,294,224,102,122,281,109,172
482477,34,21221,7353,13868,8512,3272,5240,12709,4081,8628
482547,34,10,6,4,4,3,1,6,3,3
482556,34,86,52,34,45,24,21,41,28,13
482565,34,8,3,5,2,1,1,6,2,4
482574,34,217,109,108,104,60,44,113,49,64
482635,34,84,55,29,47,33,14,37,22,15
482653,34,57,31,26,36,18,18,21,13,8
482680,34,11942,5166,6776,7940,3417,4523,4002,1749,2253
482699,34,985,297,688,599,191,408,386,106,280
482705,34,1958,660,1298,633,67,566,1325,593,732
482936,34,1067,879,188,928,761,167,139,118,21
482963,34,315,44,271,315,44,271,,,
482981,34,112,95,17,78,66,12,34,29,5
482990,34,182,14,168,182,14,168,,,
483009,34,4,2,2,4,2,2,,,
483018,34,96,30,66,96,30,66,,,
483036,34,1673,663,1010,571,266,305,1102,397,705
483045,34,4579,1516,3063,1387,542,845,3192,974,2218
483054,34,89,65,24,89,65,24,,,
483106,34,151,21,130,102,15,87,49,6,43
483124,34,43439,16101,27338,17979,5771,12208,25460,10330,15130
483212,34,2413,734,1679,1021,383,638,1392,351,1041
483221,34,4,2,2,4,2,2,,,
483230,34,120,112,8,98,91,7,22,21,1
483258,34,2,2,0,2,2,0,,,
483276,34,38,32,6,38,32,6,,,
483328,34,81,11,70,61,9,52,20,2,18
483337,34,140,6,134,87,4,83,53,2,51
483346,34,48,3,45,48,3,45,,,
483355,34,182,6,176,182,6,176,,,
483364,34,120,8,112,120,8,112,,,
483373,34,138,18,120,123,17,106,15,1,14
483382,34,106,103,3,106,103,3,,,
483425,34,39,2,37,39,2,37,,,
483470,34,49,3,46,49,3,46,,,
483504,34,247,74,173,247,74,173,,,
483513,34,22,14,8,22,14,8,,,
483559,34,34,6,28,22,4,18,12,2,10
483577,34,8,1,7,4,1,3,4,0,4
483595,34,3884,892,2992,2292,539,1753,1592,353,1239
483647,34,28,1,27,28,1,27,,,
483708,34,73,12,61,24,6,18,49,6,43
483726,34,15,0,15,5,0,5,10,0,10
483735,34,38,2,36,22,2,20,16,0,16
483744,34,62,51,11,62,51,11,,,
483753,34,38,34,4,14,11,3,24,23,1
483780,34,117,79,38,110,74,36,7,5,2
483799,34,34,5,29,34,5,29,,,
483814,34,575,43,532,525,38,487,50,5,45
483823,34,294,194,100,294,194,100,,,
483841,34,1,0,1,1,0,1,,,
483850,34,3,0,3,3,0,3,,,
483869,34,12,2,10,12,2,10,,,
483878,34,143,16,127,143,16,127,,,
483887,34,26,6,20,26,6,20,,,
483896,34,181,7,174,27,2,25,154,5,149
483911,34,16,0,16,16,0,16,,,
483920,34,96,51,45,96,51,45,,,
483948,34,32,24,8,28,21,7,4,3,1
483957,34,36,10,26,36,10,26,,,
484002,34,1238,92,1146,1211,91,1120,27,1,26
484011,34,94,16,78,78,16,62,16,0,16
484020,34,15,10,5,8,6,2,7,4,3
484048,34,42,27,15,42,27,15,,,
484057,34,186,6,180,27,1,26,159,5,154
484066,34,273,15,258,273,15,258,,,
484075,34,8,5,3,7,4,3,1,1,0
484084,34,54,0,54,41,0,41,13,0,13
484093,34,134,3,131,81,1,80,53,2,51
484109,34,87,1,86,87,1,86,,,
484127,34,83,12,71,83,12,71,,,
484136,34,15,4,11,15,4,11,,,
484163,34,46,13,33,29,7,22,17,6,11
484172,34,3,1,2,3,1,2,,,
484190,34,9,7,2,9,7,2,,,
484206,34,90,1,89,56,1,55,34,0,34
484233,34,134,82,52,,,,134,82,52
484330,34,16,0,16,16,0,16,,,
484349,34,25,0,25,25,0,25,,,
484358,34,36,1,35,36,1,35,,,
484367,34,245,32,213,245,32,213,,,
484376,34,423,47,376,423,47,376,,,
484394,34,105,15,90,64,6,58,41,9,32
484473,34,3764,1771,1993,1714,827,887,2050,944,1106
484604,34,267,6,261,108,2,106,159,4,155
484613,34,64865,18898,45967,64865,18898,45967,,,
484631,34,438,276,162,438,276,162,,,
484710,34,30,22,8,30,22,8,,,
484756,34,54,26,28,54,26,28,,,
484844,34,473,202,271,473,202,271,,,
484862,34,3,0,3,3,0,3,,,
484871,34,79,79,0,79,79,0,,,
484899,34,137,5,132,137,5,132,,,
484905,34,2577,861,1716,1368,442,926,1209,419,790
484923,34,44,0,44,34,0,34,10,0,10
484932,34,1191,498,693,649,248,401,542,250,292
484950,34,64,5,59,64,5,59,,,
484996,34,99,1,98,99,1,98,,,
485014,34,64,3,61,39,3,36,25,0,25
485032,34,146,9,137,75,5,70,71,4,67
485111,34,3237,1278,1959,1765,732,1033,1472,546,926
485166,34,71,16,55,71,16,55,,,
485236,34,61,2,59,20,0,20,41,2,39
485272,34,911,93,818,524,50,474,387,43,344
485342,34,109,82,27,109,82,27,,,
485360,34,33,1,32,33,1,32,,,
485379,34,155,35,120,155,35,120,,,
485388,34,170,19,151,170,19,151,,,
485397,34,82,1,81,51,1,50,31,0,31
485412,34,92,15,77,92,15,77,,,
485458,34,1381,369,1012,354,87,267,1027,282,745
485476,34,73,1,72,73,1,72,,,
485485,34,110,13,97,110,13,97,,,
485494,34,56,51,5,50,46,4,6,5,1
485500,34,98,91,7,7,7,0,91,84,7
485519,34,431,268,163,278,156,122,153,112,41
485546,34,109,53,56,6,3,3,103,50,53
485564,34,119,8,111,110,8,102,9,0,9
485573,34,167,23,144,161,22,139,6,1,5
485591,34,23,0,23,23,0,23,,,
485607,34,32,3,29,20,1,19,12,2,10
485698,34,118,102,16,116,102,14,2,0,2
485704,34,7,1,6,2,0,2,5,1,4
485768,34,285,182,103,285,182,103,,,
485801,34,49,7,42,49,7,42,,,
485856,34,37,9,28,14,4,10,23,5,18
485874,34,141,3,138,84,3,81,57,0,57
485926,34,159,44,115,158,43,115,1,1,0
485953,34,5,5,0,5,5,0,,,
485962,34,33,23,10,21,13,8,12,10,2
485999,34,63,63,0,63,63,0,,,
486017,34,19,19,0,19,19,0,,,
486026,34,75,75,0,75,75,0,,,
486053,34,105,64,41,75,43,32,30,21,9
486123,34,28,10,18,28,10,18,,,
486150,34,43,14,29,27,8,19,16,6,10
486169,34,26,21,5,26,21,5,,,
486196,34,105,105,0,105,105,0,,,
486202,34,12,1,11,12,1,11,,,
486239,34,67,31,36,53,25,28,14,6,8
486248,34,27,27,0,27,27,0,,,
486257,34,274,117,157,196,81,115,78,36,42
486284,34,178,49,129,164,47,117,14,2,12
486345,34,99,96,3,45,43,2,54,53,1
486354,34,28,13,15,28,13,15,,,
486372,34,98,74,24,91,69,22,7,5,2
486381,34,175,16,159,175,16,159,,,
486390,34,4,2,2,4,2,2,,,
486406,34,4,0,4,4,0,4,,,
486415,34,459,79,380,459,79,380,,,
486424,34,106,18,88,81,12,69,25,6,19
486442,34,1,1,0,1,1,0,,,
486488,34,23,18,5,20,16,4,3,2,1
486497,34,65,61,4,63,59,4,2,2,0
486503,34,31,1,30,31,1,30,,,
486512,34,269,132,137,269,132,137,,,
486530,34,129,2,127,129,2,127,,,
486558,34,192,177,15,112,100,12,80,77,3
486567,34,206,7,199,205,7,198,1,0,1
486576,34,32,12,20,32,12,20,,,
486619,34,133,5,128,102,5,97,31,0,31
486691,34,76,2,74,46,2,44,30,0,30
486707,34,44,3,41,44,3,41,,,
486716,34,39,1,38,39,1,38,,,
486752,34,31,2,29,31,2,29,,,
486770,34,67,14,53,67,14,53,,,
486798,34,776,687,89,776,687,89,,,
486813,34,614,110,504,614,110,504,,,
486822,34,718,76,642,718,76,642,,,
486840,34,31027,15555,15472,21885,10854,11031,9142,4701,4441
486859,34,25,0,25,25,0,25,,,
486877,34,4,0,4,4,0,4,,,
486886,34,9,0,9,5,0,5,4,0,4
486901,34,551,283,268,533,271,262,18,12,6
486938,34,560,97,463,207,40,167,353,57,296
486947,34,636,76,560,261,25,236,375,51,324
486956,34,1252,169,1083,421,64,357,831,105,726
486965,34,225,86,139,225,86,139,,,
486983,34,39,18,21,39,18,21,,,
487010,34,295,22,273,281,19,262,14,3,11
487047,34,39,0,39,39,0,39,,,
487065,34,58,1,57,58,1,57,,,
487083,34,22,0,22,22,0,22,,,
487092,34,626,294,332,626,294,332,,,
487162,34,2497,616,1881,934,238,696,1563,378,1185
487232,34,70,3,67,70,3,67,,,
487302,34,423,86,337,422,86,336,1,0,1
487311,34,426,380,46,426,380,46,,,
487320,34,6478,4292,2186,2708,2067,641,3770,2225,1545
487348,34,92,1,91,38,1,37,54,0,54
487375,34,1109,151,958,772,108,664,337,43,294
487384,34,387,117,270,387,117,270,,,
487393,34,481,195,286,481,195,286,,,
487409,34,524,195,329,524,195,329,,,
487418,34,506,165,341,506,165,341,,,
487427,34,427,134,293,427,134,293,,,
487436,34,492,80,412,492,80,412,,,
487445,34,362,139,223,362,139,223,,,
487454,34,310,86,224,310,86,224,,,
487472,34,648,193,455,648,193,455,,,
487481,34,1138,358,780,1138,358,780,,,
487490,34,779,134,645,779,134,645,,,
487506,34,36,2,34,5,0,5,31,2,29
487524,34,1747,711,1036,1477,621,856,270,90,180
487533,34,93,1,92,33,1,32,60,0,60
487588,34,229,7,222,229,7,222,,,
487597,34,962,926,36,962,926,36,,,
487603,34,436,159,277,242,80,162,194,79,115
487621,34,24,21,3,21,18,3,3,3,0
487658,34,63,58,5,63,58,5,,,
487676,34,183,12,171,93,1,92,90,11,79
487746,34,28,28,0,28,28,0,,,
487773,34,22,2,20,13,0,13,9,2,7
487791,34,348,321,27,193,178,15,155,143,12
487807,34,47,31,16,31,23,8,16,8,8
487816,34,10,0,10,10,0,10,,,
487852,34,13,3,10,,,,13,3,10
487861,34,233,33,200,179,26,153,54,7,47
487889,34,29,4,25,29,4,25,,,
487898,34,5,3,2,4,2,2,1,1,0
487904,34,11,8,3,11,8,3,,,
487922,34,56,0,56,44,0,44,12,0,12
487959,34,66,0,66,55,0,55,11,0,11
487968,34,72,6,66,72,6,66,,,
487977,34,2266,154,2112,1955,46,1909,311,108,203
487995,34,44,12,32,32,12,20,12,0,12
488004,34,28,28,0,28,28,0,,,
488013,34,39,1,38,36,1,35,3,0,3
488022,34,63,35,28,48,25,23,15,10,5
488031,34,46,19,27,45,19,26,1,0,1
488059,34,220,73,147,220,73,147,,,
488068,34,39,5,34,14,2,12,25,3,22
488077,34,2634,2555,79,1814,1752,62,820,803,17
488110,34,43,7,36,18,1,17,25,6,19
488129,34,7,0,7,3,0,3,4,0,4
488138,34,120,2,118,120,2,118,,,
488147,34,16,0,16,16,0,16,,,
488174,34,33,19,14,29,16,13,4,3,1
488183,34,14,1,13,14,1,13,,,
488192,34,30,29,1,30,29,1,,,
488217,34,66,4,62,66,4,62,,,
488226,34,4,2,2,4,2,2,,,
488253,34,42,25,17,25,17,8,17,8,9
488262,34,2,2,0,1,1,0,1,1,0
488271,34,30,0,30,30,0,30,,,
488280,34,34,28,6,34,28,6,,,
488299,34,9,0,9,8,0,8,1,0,1
488305,34,81,55,26,55,36,19,26,19,7
488314,34,73,73,0,73,73,0,,,
488332,34,203,23,180,203,23,180,,,
488350,34,67,67,0,67,67,0,,,
488369,34,61,46,15,61,46,15,,,
488378,34,43,1,42,42,1,41,1,0,1
488396,34,16,15,1,2,2,0,14,13,1
488411,34,73,1,72,73,1,72,,,
488420,34,146,18,128,,,,146,18,128
488439,34,27,18,9,23,16,7,4,2,2
488448,34,58,36,22,53,33,20,5,3,2
488563,34,10,5,5,9,4,5,1,1,0
488590,34,2,2,0,2,2,0,,,
488651,34,32,5,27,24,5,19,8,0,8
488679,34,4692,1123,3569,4291,1019,3272,401,104,297
488721,34,495,451,44,89,77,12,406,374,32
488730,34,3715,1541,2174,552,275,277,3163,1266,1897
488749,34,35,10,25,30,10,20,5,0,5
488776,34,148,49,99,80,25,55,68,24,44
488785,34,169,81,88,157,74,83,12,7,5
488800,34,876,245,631,876,245,631,,,
488837,34,12,0,12,12,0,12,,,
488846,34,13553,7436,6117,6722,3695,3027,6831,3741,3090
488891,34,102,41,61,102,41,61,,,
488916,34,38,0,38,38,0,38,,,
488934,34,909,569,340,477,233,244,432,336,96
488952,34,22,0,22,22,0,22,,,
488961,34,32,2,30,32,2,30,,,
488970,34,19,1,18,19,1,18,,,
488989,34,115,3,112,75,0,75,40,3,37
488998,34,85,15,70,84,15,69,1,0,1
489122,34,46,2,44,20,0,20,26,2,24
489131,34,63,6,57,32,1,31,31,5,26
489140,34,37,12,25,25,0,25,12,12,0
489159,34,126,1,125,87,1,86,39,0,39
489201,34,5245,2078,3167,1279,537,742,3966,1541,2425
489238,34,52,4,48,30,3,27,22,1,21
489247,34,36,6,30,11,2,9,25,4,21
489256,34,4,3,1,3,2,1,1,1,0
489283,34,474,81,393,474,81,393,,,
489344,34,265,22,243,82,5,77,183,17,166
489353,34,597,133,464,316,72,244,281,61,220
489371,34,182,164,18,182,164,18,,,
489779,34,32059,13247,18812,5340,1933,3407,26719,11314,15405
489812,34,44,0,44,44,0,44,,,
489830,34,61,3,58,61,3,58,,,
489937,34,266,129,137,219,113,106,47,16,31
490018,34,22,19,3,22,19,3,,,
490045,34,32,13,19,16,6,10,16,7,9
490054,34,90,16,74,47,11,36,43,5,38
490081,34,12,4,8,10,4,6,2,0,2
490090,34,28,11,17,19,4,15,9,7,2
490115,34,41,34,7,41,34,7,,,
490124,34,5,2,3,5,2,3,,,
490133,34,1398,873,525,1314,832,482,84,41,43
490142,34,41,6,35,14,4,10,27,2,25
490151,34,30,1,29,25,1,24,5,0,5
490160,34,57,5,52,57,5,52,,,
490197,34,42,12,30,42,12,30,,,
490203,34,118,8,110,53,3,50,65,5,60
490221,34,2,0,2,1,0,1,1,0,1
490230,34,240,104,136,239,103,136,1,1,0
490249,34,17,15,2,17,15,2,,,
490258,34,61,6,55,61,6,55,,,
490267,34,15,12,3,10,10,0,5,2,3
490276,34,85,85,0,85,85,0,,,
490285,34,211,168,43,211,168,43,,,
490294,34,86,27,59,82,25,57,4,2,2
490300,34,66,22,44,28,1,27,38,21,17
490319,34,10,10,0,10,10,0,,,
490328,34,94,94,0,94,94,0,,,
490382,34,23,6,17,23,6,17,,,
490391,34,49,2,47,49,2,47,,,
490407,34,41,1,40,21,1,20,20,0,20
490416,34,18,12,6,18,12,6,,,
490425,34,108,2,106,108,2,106,,,
490434,34,11,0,11,11,0,11,,,
490443,34,108,0,108,108,0,108,,,
490452,34,27,1,26,13,1,12,14,0,14
490461,34,46,2,44,46,2,44,,,
490470,34,13,2,11,13,2,11,,,
490489,34,30,25,5,26,22,4,4,3,1
490498,34,13,10,3,13,10,3,,,
490504,34,16,16,0,16,16,0,,,
490513,34,21,21,0,21,21,0,,,
490522,34,5,0,5,5,0,5,,,
490531,34,25,18,7,11,8,3,14,10,4
490559,34,315,12,303,315,12,303,,,
490674,34,3,0,3,3,0,3,,,
490692,34,44,36,8,44,36,8,,,
490717,34,35,3,32,35,3,32,,,
490735,34,35,3,32,35,3,32,,,
490744,34,13,11,2,13,11,2,,,
490753,34,11,5,6,11,5,6,,,
490805,34,4791,2098,2693,3449,1639,1810,1342,459,883
490814,34,50,0,50,50,0,50,,,
490832,34,164,10,154,117,6,111,47,4,43
490841,34,110,2,108,110,2,108,,,
490869,34,284,25,259,284,25,259,,,
490878,34,355,63,292,355,63,292,,,
490896,34,67,5,62,33,2,31,34,3,31
490948,34,5,3,2,5,3,2,,,
490975,34,342,48,294,319,44,275,23,4,19
491057,34,266,266,0,266,266,0,,,
491066,34,33,1,32,10,0,10,23,1,22
491075,34,13,12,1,13,12,1,,,
491084,34,13,0,13,13,0,13,,,
491136,34,48,2,46,26,1,25,22,1,21
491145,34,52,0,52,34,0,34,18,0,18
491181,34,374,44,330,204,26,178,170,18,152
491190,34,4,2,2,4,2,2,,,
491215,34,29,28,1,29,28,1,,,
491224,34,67,4,63,36,1,35,31,3,28
491233,34,22,0,22,15,0,15,7,0,7
491242,34,52,28,24,52,28,24,,,
491251,34,46,28,18,46,28,18,,,
491260,34,53,2,51,39,2,37,14,0,14
491288,34,603,170,433,76,22,54,527,148,379
491297,34,145,59,86,10,4,6,135,55,80
491394,34,86,69,17,82,66,16,4,3,1
491446,34,31,0,31,28,0,28,3,0,3
491464,34,85,19,66,85,19,66,,,
491473,34,381,211,170,6,1,5,375,210,165
491507,34,5,0,5,5,0,5,,,
491525,34,52,33,19,27,19,8,25,14,11
491534,34,2,1,1,,,,2,1,1
491543,34,80,17,63,44,10,34,36,7,29
491552,34,2,0,2,2,0,2,,,
491570,34,1,0,1,1,0,1,,,
491589,34,21,16,5,6,4,2,15,12,3
491598,34,13,1,12,13,1,12,,,
491613,34,50,50,0,50,50,0,,,
491622,34,66,66,0,66,66,0,,,
491631,34,83,0,83,70,0,70,13,0,13
491640,34,145,145,0,145,145,0,,,
491659,34,92,53,39,92,53,39,,,
491668,34,104,3,101,104,3,101,,,
491677,34,12,7,5,3,1,2,9,6,3
491686,34,24,20,4,24,20,4,,,
491695,34,32,0,32,32,0,32,,,
491701,34,22,5,17,,,,22,5,17
491710,34,53,53,0,53,53,0,,,
491729,34,13,0,13,13,0,13,,,
491738,34,43,5,38,41,4,37,2,1,1
491747,34,16,2,14,16,2,14,,,
491756,34,25,23,2,25,23,2,,,
491765,34,66,66,0,66,66,0,,,
491774,34,108,15,93,73,8,65,35,7,28
491783,34,23,14,9,2,1,1,21,13,8
491792,34,51,3,48,51,3,48,,,
491817,34,65,0,65,65,0,65,,,
491826,34,74,0,74,74,0,74,,,
491835,34,49,0,49,49,0,49,,,
491844,34,89,28,61,60,16,44,29,12,17
491853,34,34,0,34,34,0,34,,,
491871,34,9,0,9,7,0,7,2,0,2
491880,34,65,64,1,65,64,1,,,
491899,34,79,5,74,13,0,13,66,5,61
491905,34,62,2,60,62,2,60,,,
491914,34,155,155,0,155,155,0,,,
491923,34,160,0,160,142,0,142,18,0,18
491932,34,10,9,1,10,9,1,,,
491941,34,122,5,117,122,5,117,,,
491950,34,815,103,712,43,9,34,772,94,678
491978,34,36,15,21,6,3,3,30,12,18
491996,34,19,2,17,19,2,17,,,
492005,34,26,1,25,19,1,18,7,0,7
492023,34,260,37,223,,,,260,37,223
492032,34,16,0,16,,,,16,0,16
492069,34,68,39,29,62,38,24,6,1,5
492078,34,98,97,1,,,,98,97,1
492096,34,5,0,5,5,0,5,,,
492139,34,132,113,19,132,113,19,,,
492148,34,3,0,3,3,0,3,,,
492281,34,57,40,17,57,40,17,,,
492306,34,45,11,34,,,,45,11,34
492315,34,50,5,45,,,,50,5,45
492324,34,112,4,108,,,,112,4,108
492360,34,40,16,24,29,14,15,11,2,9
492421,34,7,7,0,7,7,0,,,
492449,34,531,121,410,531,121,410,,,
492476,34,164,36,128,53,9,44,111,27,84
492607,34,2,0,2,,,,2,0,2
492643,34,69,13,56,69,13,56,,,
492652,34,14,7,7,14,7,7,,,
492661,34,203,31,172,203,31,172,,,
492689,34,257,43,214,215,38,177,42,5,37
492722,34,250,20,230,250,20,230,,,
492731,34,135,24,111,92,18,74,43,6,37
492759,34,358,34,324,153,13,140,205,21,184
492801,34,669,218,451,400,127,273,269,91,178
492935,34,6,0,6,6,0,6,,,
492953,34,77,4,73,44,3,41,33,1,32
492962,34,2013,780,1233,947,334,613,1066,446,620
493071,34,352,87,265,352,87,265,,,
493080,34,288,145,143,50,29,21,238,116,122
493132,34,619,605,14,619,605,14,,,
493150,34,149,14,135,149,14,135,,,
493372,34,17,6,11,17,6,11,,,
493451,34,49,12,37,49,12,37,,,
493479,34,6,2,4,6,2,4,,,
493488,34,4,2,2,4,2,2,,,
493512,34,114,76,38,96,68,28,18,8,10
493521,34,21,17,4,20,16,4,1,1,0
493530,34,35,7,28,24,4,20,11,3,8
493549,34,74,70,4,74,70,4,,,
493558,34,2,2,0,2,2,0,,,
493567,34,42,2,40,,,,42,2,40
493576,34,6,0,6,6,0,6,,,
493585,34,39,1,38,39,1,38,,,
493594,34,31,31,0,31,31,0,,,
493600,34,117,117,0,117,117,0,,,
493619,34,18,9,9,17,8,9,1,1,0
493628,34,134,6,128,67,1,66,67,5,62
493637,34,18,0,18,18,0,18,,,
493646,34,87,0,87,87,0,87,,,
493655,34,9,5,4,9,5,4,,,
493664,34,52,52,0,49,49,0,3,3,0
493673,34,3,1,2,3,1,2,,,
493682,34,45,4,41,43,3,40,2,1,1
493691,34,18,0,18,11,0,11,7,0,7
493707,34,52,52,0,52,52,0,,,
493716,34,48,48,0,47,47,0,1,1,0
493743,34,138,104,34,55,42,13,83,62,21
493752,34,1,0,1,1,0,1,,,
493761,34,117,42,75,22,10,12,95,32,63
493770,34,14,0,14,14,0,14,,,
493798,34,14,0,14,,,,14,0,14
493804,34,1,0,1,1,0,1,,,
493813,34,1,0,1,1,0,1,,,
493822,34,238,51,187,157,31,126,81,20,61
493831,34,36,22,14,36,22,14,,,
493868,34,25,20,5,22,17,5,3,3,0
493895,34,299,265,34,136,124,12,163,141,22
493910,34,12,1,11,3,0,3,9,1,8
493992,34,180,40,140,180,40,140,,,
494001,34,82,1,81,16,0,16,66,1,65
494029,34,15,9,6,8,6,2,7,3,4
494162,34,271,28,243,169,13,156,102,15,87
494232,34,9,0,9,6,0,6,3,0,3
494250,34,648,40,608,648,40,608,,,
494278,34,209,33,176,62,4,58,147,29,118
494287,34,396,101,295,130,36,94,266,65,201
494357,34,783,271,512,783,271,512,,,
494436,34,272,53,219,272,53,219,,,
494463,34,76,0,76,76,0,76,,,
494472,34,4,0,4,3,0,3,1,0,1
494524,34,76,4,72,75,4,71,1,0,1
494588,34,271,32,239,271,32,239,,,
494597,34,39,17,22,32,14,18,7,3,4
494603,34,185,107,78,121,71,50,64,36,28
494621,34,65,7,58,12,3,9,53,4,49
494630,34,40,22,18,36,20,16,4,2,2
494649,34,16,0,16,6,0,6,10,0,10
494658,34,52,2,50,40,2,38,12,0,12
494685,34,413,171,242,337,131,206,76,40,36
494694,34,63,0,63,63,0,63,,,
494700,34,26,2,24,26,2,24,,,
494719,34,46,28,18,22,12,10,24,16,8
494728,34,47,38,9,46,37,9,1,1,0
494737,34,135,135,0,135,135,0,,,
494746,34,348,64,284,348,64,284,,,
494755,34,49,5,44,49,5,44,,,
494764,34,139,131,8,98,91,7,41,40,1
494807,34,26,2,24,26,2,24,,,
494843,34,438,35,403,438,35,403,,,
494852,34,303,57,246,303,57,246,,,
494898,34,65,11,54,65,11,54,,,
494904,34,49,13,36,23,9,14,26,4,22
494959,34,40,9,31,9,2,7,31,7,24
494986,34,35,1,34,25,1,24,10,0,10
494995,34,16,16,0,16,16,0,,,
495013,34,186,168,18,,,,186,168,18
495031,34,53,53,0,49,49,0,4,4,0
495040,34,25,2,23,25,2,23,,,
495059,34,30,15,15,28,14,14,2,1,1
495077,34,68,5,63,68,5,63,,,
495101,34,40,6,34,40,6,34,,,
495110,34,14,13,1,14,13,1,,,
495129,34,29,23,6,29,23,6,,,
495147,34,21,10,11,9,8,1,12,2,10
495165,34,22,4,18,22,4,18,,,
495174,34,36,17,19,,,,36,17,19
495183,34,102,49,53,102,49,53,,,
495208,34,3,2,1,3,2,1,,,
495217,34,23,18,5,23,18,5,,,
495226,34,4,0,4,4,0,4,,,
495235,34,19,2,17,9,0,9,10,2,8
495244,34,12,0,12,10,0,10,2,0,2
495253,34,42,10,32,41,10,31,1,0,1
495262,34,27,0,27,13,0,13,14,0,14
495271,34,43,10,33,4,0,4,39,10,29
495280,34,24,13,11,17,10,7,7,3,4
495299,34,40,8,32,40,8,32,,,
495305,34,45,6,39,23,4,19,22,2,20
495341,34,42,32,10,42,32,10,,,
495350,34,21,8,13,21,8,13,,,
495369,34,57,7,50,30,4,26,27,3,24
495378,34,57,1,56,8,0,8,49,1,48
495387,34,32,24,8,20,14,6,12,10,2
495396,34,9,0,9,9,0,9,,,
495411,34,75,8,67,74,8,66,1,0,1
495420,34,311,37,274,183,21,162,128,16,112
495439,34,301,20,281,197,15,182,104,5,99
495448,34,512,58,454,381,38,343,131,20,111
495457,34,726,76,650,488,49,439,238,27,211
495518,34,48,2,46,26,1,25,22,1,21
495730,34,77,3,74,43,1,42,34,2,32
495776,34,20,19,1,20,19,1,,,
495794,34,229,4,225,155,2,153,74,2,72
495837,34,76,8,68,76,8,68,,,
495925,34,50,4,46,50,4,46,,,
495934,34,55,7,48,55,7,48,,,
495943,34,14,1,13,14,1,13,,,
495952,34,127,34,93,127,34,93,,,
495961,34,92,6,86,92,6,86,,,
495970,34,242,74,168,242,74,168,,,
495998,34,59,2,57,59,2,57,,,
496052,34,2,2,0,2,2,0,,,
496061,34,177,6,171,76,3,73,101,3,98
496186,34,134,117,17,132,115,17,2,2,0
496265,34,39,34,5,39,34,5,,,
496283,34,169,24,145,169,24,145,,,
496326,34,305,31,274,305,31,274,,,
496371,34,7,7,0,7,7,0,,,
496399,34,24,4,20,24,4,20,,,
496478,34,30,20,10,,,,30,20,10
496520,34,64,15,49,,,,64,15,49
496539,34,56,1,55,36,0,36,20,1,19
496618,34,33,0,33,33,0,33,,,
496627,34,127,54,73,127,54,73,,,
496636,34,174,34,140,174,34,140,,,
496645,34,52,34,18,18,4,14,34,30,4
496654,34,17,2,15,8,0,8,9,2,7
496663,34,2,1,1,1,0,1,1,1,0
496672,34,37,4,33,17,4,13,20,0,20
496681,34,131,4,127,131,4,127,,,
496690,34,32,4,28,28,3,25,4,1,3
496706,34,154,100,54,154,100,54,,,
496715,34,16,1,15,16,1,15,,,
496724,34,30,0,30,30,0,30,,,
496733,34,55,1,54,55,1,54,,,
496751,34,10,10,0,10,10,0,,,
496803,34,2,2,0,2,2,0,,,
496894,34,33,2,31,10,0,10,23,2,21
496919,34,669,310,359,669,310,359,,,
496955,34,541,202,339,541,202,339,,,
496964,34,17,10,7,17,10,7,,,
496973,34,154,27,127,95,16,79,59,11,48
496991,34,379,53,326,216,22,194,163,31,132
497000,34,166,44,122,166,44,122,,,
497037,34,650,126,524,405,73,332,245,53,192
497046,34,3544,1089,2455,435,132,303,3109,957,2152
497073,34,254,7,247,107,2,105,147,5,142
497107,34,85,14,71,,,,85,14,71
497116,34,495,57,438,229,29,200,266,28,238
497125,34,336,36,300,149,17,132,187,19,168
497161,34,76,65,11,61,51,10,15,14,1
497189,34,14,0,14,14,0,14,,,
497198,34,61,3,58,35,1,34,26,2,24
497204,34,84,68,16,21,12,9,63,56,7
497213,34,29,13,16,15,9,6,14,4,10
497222,34,21,2,19,16,2,14,5,0,5
497268,34,236,22,214,165,13,152,71,9,62
497277,34,272,45,227,272,45,227,,,
497286,34,89,82,7,89,82,7,,,
497301,34,151,6,145,81,2,79,70,4,66
497310,34,74,1,73,74,1,73,,,
497329,34,227,55,172,227,55,172,,,
497338,34,19,2,17,19,2,17,,,
497356,34,6,1,5,5,1,4,1,0,1
497365,34,18,15,3,18,15,3,,,
497374,34,60,12,48,60,12,48,,,
497383,34,2,2,0,2,2,0,,,
497392,34,46,36,10,10,9,1,36,27,9
497408,34,48,26,22,36,21,15,12,5,7
497417,34,7,0,7,7,0,7,,,
497426,34,59,8,51,43,1,42,16,7,9
497435,34,62,15,47,62,15,47,,,
497444,34,11,5,6,1,0,1,10,5,5
497453,34,2,0,2,1,0,1,1,0,1
497462,34,22,17,5,8,7,1,14,10,4
497471,34,3,0,3,1,0,1,2,0,2
497480,34,736,45,691,670,23,647,66,22,44
497499,34,19,18,1,,,,19,18,1
497684,34,29,1,28,29,1,28,,,
497736,34,3,1,2,3,1,2,,,
497745,34,104,92,12,78,71,7,26,21,5
497790,34,5,2,3,5,2,3,,,
497824,34,215,93,122,85,33,52,130,60,70
497833,34,104,41,63,95,41,54,9,0,9
497888,34,83,6,77,49,2,47,34,4,30
497897,34,184,8,176,184,8,176,,,
497903,34,3,0,3,3,0,3,,,
497912,34,54,3,51,54,3,51,,,
497949,34,456,135,321,456,135,321,,,
497958,34,404,94,310,404,94,310,,,
498003,34,140,54,86,100,40,60,40,14,26
498012,34,137,129,8,137,129,8,,,
498030,34,44,44,0,44,44,0,,,
498049,34,261,15,246,162,8,154,99,7,92
498076,34,107,8,99,25,1,24,82,7,75
498085,34,196,17,179,54,6,48,142,11,131
498094,34,192,7,185,70,4,66,122,3,119
498100,34,217,16,201,16,0,16,201,16,185
498119,34,44,3,41,6,0,6,38,3,35
498243,34,1,0,1,1,0,1,,,
498322,34,76,0,76,76,0,76,,,
498331,34,114,54,60,14,5,9,100,49,51
498340,34,33,3,30,33,3,30,,,
498359,34,54,0,54,29,0,29,25,0,25
498368,34,3,0,3,,,,3,0,3
498377,34,5,5,0,5,5,0,,,
498386,34,21,17,4,19,17,2,2,0,2
498401,34,23,1,22,15,1,14,8,0,8
498410,34,1,0,1,1,0,1,,,
498447,34,128,9,119,61,8,53,67,1,66
498456,34,192,21,171,128,13,115,64,8,56
498465,34,5,0,5,5,0,5,,,
498483,34,9,1,8,6,1,5,3,0,3
498553,34,67,20,47,67,20,47,,,
498562,34,7594,2962,4632,6892,2705,4187,702,257,445
498571,34,7168,2791,4377,5940,2323,3617,1228,468,760
100654,35,209,87,122,196,82,114,13,5,8
100663,35,1133,454,679,759,315,444,374,139,235
100690,35,199,77,122,119,48,71,80,29,51
100706,35,638,332,306,483,252,231,155,80,75
100724,35,124,59,65,122,59,63,2,0,2
100751,35,1193,592,601,857,454,403,336,138,198
100760,35,98,35,63,37,14,23,61,21,40
100812,35,687,188,499,420,107,313,267,81,186
100830,35,336,88,248,244,66,178,92,22,70
100858,35,1121,591,530,969,519,450,152,72,80
100937,35,26,16,10,26,16,10,,,
101028,35,158,46,112,71,32,39,87,14,73
101116,35,70,9,61,51,6,45,19,3,16
101143,35,124,56,68,73,40,33,51,16,35
101161,35,400,111,289,182,64,118,218,47,171
101189,35,274,115,159,200,90,110,74,25,49
101240,35,341,93,248,187,64,123,154,29,125
101286,35,223,62,161,96,30,66,127,32,95
101295,35,501,120,381,230,63,167,271,57,214
101301,35,64,19,45,36,16,20,28,3,25
101365,35,42,2,40,11,1,10,31,1,30
101435,35,39,17,22,39,17,22,,,
101453,35,15,15,0,7,7,0,8,8,0
101462,35,166,53,113,56,24,32,110,29,81
101471,35,65,63,2,36,34,2,29,29,0
101480,35,475,182,293,396,167,229,79,15,64
101505,35,606,203,403,190,76,114,416,127,289
101514,35,566,237,329,246,125,121,320,112,208
101569,35,309,89,220,129,52,77,180,37,143
101587,35,478,126,352,440,107,333,38,19,19
101602,35,80,21,59,50,15,35,30,6,24
101648,35,17,16,1,17,16,1,,,
101675,35,118,53,65,114,52,62,4,1,3
101693,35,8,4,4,7,4,3,1,0,1
101709,35,133,41,92,113,36,77,20,5,15
101736,35,107,31,76,49,14,35,58,17,41
101879,35,632,247,385,478,201,277,154,46,108
101897,35,60,21,39,24,9,15,36,12,24
101912,35,37,12,25,37,12,25,,,
101994,35,45,11,34,26,9,17,19,2,17
102030,35,219,68,151,117,52,65,102,16,86
102049,35,89,40,49,84,38,46,5,2,3
102058,35,5,2,3,1,1,0,4,1,3
102067,35,281,139,142,156,92,64,125,47,78
102076,35,175,61,114,79,34,45,96,27,69
102094,35,714,271,443,618,239,379,96,32,64
102234,35,56,30,26,53,30,23,3,0,3
102270,35,68,38,30,66,37,29,2,1,1
102298,35,52,27,25,48,24,24,4,3,1
102313,35,224,66,158,109,39,70,115,27,88
102368,35,1034,377,657,614,250,364,420,127,293
102377,35,69,38,31,68,37,31,1,1,0
102395,35,17,15,2,2,2,0,15,13,2
102429,35,175,56,119,49,20,29,126,36,90
102553,35,12,6,6,8,4,4,4,2,2
102580,35,4,1,3,3,1,2,1,0,1
102614,35,403,181,222,235,118,117,168,63,105
102632,35,133,56,77,79,45,34,54,11,43
102669,35,289,33,256,247,24,223,42,9,33
102845,35,31,6,25,31,6,25,,,
103893,35,123,24,99,123,24,99,,,
103909,35,89,11,78,89,11,78,,,
103927,35,39,5,34,39,5,34,,,
103963,35,1,1,0,1,1,0,,,
104090,35,120,10,110,120,10,110,,,
104151,35,4087,2062,2025,3506,1756,1750,581,306,275
104160,35,257,112,145,79,39,40,178,73,105
104179,35,2848,1372,1476,1739,812,927,1109,560,549
104346,35,1017,297,720,212,92,120,805,205,600
104425,35,176,93,83,66,33,33,110,60,50
104577,35,210,90,120,68,40,28,142,50,92
104586,35,102,84,18,94,79,15,8,5,3
104708,35,913,384,529,263,126,137,650,258,392
104717,35,11334,3014,8320,1964,894,1070,9370,2120,7250
105145,35,755,224,531,161,69,92,594,155,439
105154,35,1418,650,768,358,201,157,1060,449,611
105206,35,93,17,76,20,4,16,73,13,60
105215,35,83,75,8,83,75,8,,,
105297,35,81,23,58,44,14,30,37,9,28
105330,35,1777,596,1181,1287,489,798,490,107,383
105349,35,277,65,212,59,20,39,218,45,173
105428,35,1078,429,649,347,172,175,731,257,474
105525,35,1329,554,775,321,170,151,1008,384,624
105534,35,512,87,425,512,87,425,,,
105543,35,48,8,40,48,8,40,,,
105589,35,34,11,23,29,11,18,5,0,5
105668,35,835,308,527,154,65,89,681,243,438
105747,35,703,276,427,193,73,120,510,203,307
105792,35,378,170,208,97,48,49,281,122,159
105899,35,92,67,25,91,66,25,1,1,0
106041,35,169,154,15,169,154,15,,,
106148,35,302,143,159,114,69,45,188,74,114
106245,35,841,282,559,503,205,298,338,77,261
106263,35,449,77,372,309,54,255,140,23,117
106306,35,55,46,9,47,39,8,8,7,1
106342,35,38,25,13,37,25,12,1,0,1
106397,35,1468,668,800,1118,566,552,350,102,248
106412,35,110,56,54,98,51,47,12,5,7
106449,35,151,50,101,95,37,58,56,13,43
106458,35,800,268,532,364,168,196,436,100,336
106467,35,316,135,181,260,118,142,56,17,39
106485,35,162,72,90,141,70,71,21,2,19
106546,35,203,21,182,172,18,154,31,3,28
106625,35,78,33,45,44,26,18,34,7,27
106704,35,552,238,314,507,222,285,45,16,29
106713,35,58,40,18,55,38,17,3,2,1
106795,35,40,13,27,19,7,12,21,6,15
106810,35,16,6,10,16,6,10,,,
106883,35,27,9,18,18,8,10,9,1,8
106980,35,160,58,102,113,45,68,47,13,34
106999,35,37,5,32,20,3,17,17,2,15
107044,35,115,52,63,104,46,58,11,6,5
107071,35,121,58,63,105,56,49,16,2,14
107080,35,12,6,6,11,6,5,1,0,1
107123,35,28,6,22,28,6,22,,,
107141,35,83,33,50,65,24,41,18,9,9
107318,35,47,17,30,18,5,13,29,12,17
107327,35,61,15,46,32,10,22,29,5,24
107460,35,94,38,56,61,31,30,33,7,26
107512,35,47,27,20,42,24,18,5,3,2
107521,35,64,13,51,47,7,40,17,6,11
107549,35,66,22,44,45,18,27,21,4,17
107558,35,55,33,22,55,33,22,,,
107585,35,154,50,104,74,28,46,80,22,58
107600,35,87,38,49,75,35,40,12,3,9
107619,35,38,14,24,27,12,15,11,2,9
107637,35,90,28,62,24,10,14,66,18,48
107664,35,475,164,311,259,99,160,216,65,151
107725,35,59,12,47,22,7,15,37,5,32
107743,35,41,17,24,24,13,11,17,4,13
107840,35,7,3,4,6,3,3,1,0,1
107877,35,44,26,18,42,25,17,2,1,1
107974,35,148,41,107,56,21,35,92,20,72
107983,35,196,82,114,185,80,105,11,2,9
107992,35,99,51,48,65,34,31,34,17,17
108092,35,297,120,177,223,96,127,74,24,50
108232,35,421,188,233,207,104,103,214,84,130
108667,35,1127,467,660,82,45,37,1045,422,623
108807,35,437,259,178,146,98,48,291,161,130
108852,35,32,9,23,32,9,23,,,
109040,35,259,51,208,259,51,208,,,
109208,35,3740,1890,1850,302,139,163,3438,1751,1687
109350,35,630,275,355,189,93,96,441,182,259
109651,35,133,55,78,133,55,78,,,
109785,35,134,67,67,123,59,64,11,8,3
109819,35,1155,603,552,312,142,170,843,461,382
109907,35,536,175,361,133,41,92,403,134,269
110060,35,18,12,6,17,12,5,1,0,1
110097,35,245,94,151,214,83,131,31,11,20
110219,35,142,25,117,142,25,117,,,
110246,35,715,342,373,271,145,126,444,197,247
110316,35,55,16,39,54,16,38,1,0,1
110334,35,567,271,296,113,62,51,454,209,245
110361,35,1033,369,664,902,332,570,131,37,94
110370,35,79,30,49,76,29,47,3,1,2
110404,35,8,5,3,8,5,3,,,
110413,35,223,103,120,219,101,118,4,2,2
110422,35,823,467,356,798,451,347,25,16,9
110468,35,47,11,36,,,,47,11,36
110486,35,1135,336,799,929,280,649,206,56,150
110495,35,1375,471,904,1075,373,702,300,98,202
110510,35,2468,879,1589,1900,700,1200,568,179,389
110529,35,2960,1516,1444,2655,1385,1270,305,131,174
110538,35,1335,583,752,1174,526,648,161,57,104
110547,35,1940,730,1210,1419,564,855,521,166,355
110556,35,2463,937,1526,2020,789,1231,443,148,295
110565,35,4520,1899,2621,3517,1486,2031,1003,413,590
110574,35,1839,698,1141,1428,552,876,411,146,265
110583,35,3964,1668,2296,3354,1402,1952,610,266,344
110592,35,2663,1066,1597,2092,843,1249,571,223,348
110608,35,5076,2263,2813,3910,1731,2179,1166,532,634
110617,35,3732,1532,2200,2910,1215,1695,822,317,505
110635,35,2706,1284,1422,2578,1214,1364,128,70,58
110644,35,2775,1272,1503,2720,1246,1474,55,26,29
110653,35,2588,1291,1297,2527,1261,1266,61,30,31
110662,35,3687,1507,2180,3594,1482,2112,93,25,68
110671,35,1457,793,664,1411,768,643,46,25,21
110680,35,3068,1503,1565,2983,1453,1530,85,50,35
110705,35,2097,1078,1019,2021,1031,990,76,47,29
110714,35,1227,648,579,1178,623,555,49,25,24
110778,35,10,1,9,10,1,9,,,
110918,35,1,1,0,,,,1,1,0
111045,35,8,3,5,7,3,4,1,0,1
111081,35,57,29,28,55,27,28,2,2,0
111188,35,70,58,12,70,58,12,,,
111434,35,852,383,469,56,35,21,796,348,448
111461,35,1060,530,530,307,161,146,753,369,384
111638,35,85,24,61,85,24,61,,,
111887,35,2086,962,1124,661,303,358,1425,659,766
111896,35,667,211,456,95,45,50,572,166,406
111920,35,1202,712,490,212,127,85,990,585,405
111939,35,1646,581,1065,486,190,296,1160,391,769
111948,35,317,152,165,307,146,161,10,6,4
111966,35,66,21,45,61,19,42,5,2,3
112075,35,253,101,152,244,97,147,9,4,5
112084,35,76,37,39,57,30,27,19,7,12
112172,35,813,321,492,305,108,197,508,213,295
112190,35,1255,594,661,366,211,155,889,383,506
112260,35,10,6,4,10,6,4,,,
112385,35,1957,956,1001,137,58,79,1820,898,922
112394,35,32,24,8,31,24,7,1,0,1
112561,35,121,51,70,39,17,22,82,34,48
112570,35,17,8,9,16,7,9,1,1,0
112686,35,372,135,237,104,49,55,268,86,182
112826,35,694,255,439,100,52,48,594,203,391
113096,35,2000,784,1216,175,78,97,1825,706,1119
113111,35,516,218,298,119,63,56,397,155,242
113193,35,706,351,355,239,116,123,467,235,232
113218,35,970,410,560,87,39,48,883,371,512
113236,35,1307,528,779,300,116,184,1007,412,595
113333,35,1182,571,611,423,214,209,759,357,402
113573,35,400,177,223,141,77,64,259,100,159
113582,35,9,0,9,9,0,9,,,
113634,35,1386,607,779,329,173,156,1057,434,623
113698,35,87,27,60,80,24,56,7,3,4
113856,35,2342,886,1456,398,170,228,1944,716,1228
113980,35,1232,497,735,389,182,207,843,315,528
114266,35,747,311,436,88,32,56,659,279,380
114354,35,312,55,257,279,49,230,33,6,27
114433,35,197,151,46,36,27,9,161,124,37
114716,35,1567,806,761,334,168,166,1233,638,595
114789,35,2150,953,1197,439,200,239,1711,753,958
114813,35,253,58,195,100,33,67,153,25,128
114859,35,1541,665,876,395,184,211,1146,481,665
114938,35,681,428,253,105,69,36,576,359,217
115001,35,634,296,338,220,107,113,414,189,225
115010,35,14,6,8,14,6,8,,,
115083,35,51,21,30,18,9,9,33,12,21
115126,35,1523,687,836,200,84,116,1323,603,720
115296,35,985,391,594,215,89,126,770,302,468
115393,35,469,260,209,101,47,54,368,213,155
115409,35,7,4,3,7,4,3,,,
115728,35,96,41,55,73,34,39,23,7,16
115755,35,811,380,431,706,339,367,105,41,64
115773,35,27,4,23,10,2,8,17,2,15
115861,35,208,126,82,65,29,36,143,97,46
115931,35,20,16,4,20,16,4,,,
116226,35,2,0,2,1,0,1,1,0,1
116439,35,822,406,416,174,93,81,648,313,335
116846,35,6,0,6,6,0,6,,,
117052,35,761,317,444,99,62,37,662,255,407
117104,35,55,26,29,50,24,26,5,2,3
117140,35,320,125,195,241,102,139,79,23,56
117168,35,73,20,53,69,18,51,4,2,2
117195,35,608,433,175,66,39,27,542,394,148
117247,35,1269,501,768,192,94,98,1077,407,670
117274,35,190,161,29,25,18,7,165,143,22
117283,35,4,4,0,3,3,0,1,1,0
117557,35,7,3,4,7,3,4,,,
117575,35,1,1,0,,,,1,1,0
117627,35,99,48,51,89,43,46,10,5,5
117636,35,225,63,162,193,51,142,32,12,20
117645,35,2180,915,1265,827,344,483,1353,571,782
117672,35,21,0,21,17,0,17,4,0,4
117690,35,1489,566,923,101,47,54,1388,519,869
117706,35,1663,699,964,234,109,125,1429,590,839
117715,35,1155,358,797,91,42,49,1064,316,748
117724,35,1420,798,622,198,126,72,1222,672,550
117733,35,2007,788,1219,179,84,95,1828,704,1124
117751,35,169,98,71,113,57,56,56,41,15
117788,35,2232,863,1369,278,115,163,1954,748,1206
117803,35,62,19,43,,,,62,19,43
117867,35,1573,592,981,98,32,66,1475,560,915
117894,35,652,295,357,130,68,62,522,227,295
117946,35,408,181,227,404,178,226,4,3,1
118198,35,128,25,103,128,25,103,,,
118347,35,325,141,184,97,53,44,228,88,140
118684,35,210,75,135,48,18,30,162,57,105
118693,35,102,67,35,100,66,34,2,1,1
118718,35,582,227,355,212,77,135,370,150,220
118772,35,1144,483,661,212,108,104,932,375,557
118912,35,1193,475,718,331,150,181,862,325,537
118930,35,716,322,394,156,90,66,560,232,328
118976,35,540,207,333,223,93,130,317,114,203
119058,35,4,0,4,4,0,4,,,
119067,35,604,293,311,178,107,71,426,186,240
119137,35,1146,470,676,185,84,101,961,386,575
119164,35,1696,821,875,589,310,279,1107,511,596
119173,35,193,32,161,169,28,141,24,4,20
119216,35,1479,514,965,542,196,346,937,318,619
119270,35,94,73,21,81,61,20,13,12,1
119331,35,142,52,90,31,14,17,111,38,73
119605,35,1567,752,815,474,226,248,1093,526,567
119775,35,34,19,15,33,19,14,1,0,1
120078,35,36,7,29,36,7,29,,,
120166,35,1,0,1,1,0,1,,,
120254,35,39,13,26,39,13,26,,,
120290,35,687,375,312,113,65,48,574,310,264
120342,35,1575,730,845,383,212,171,1192,518,674
120403,35,118,39,79,116,39,77,2,0,2
120421,35,778,361,417,73,39,34,705,322,383
120537,35,105,50,55,88,44,44,17,6,11
120698,35,13,2,11,11,2,9,2,0,2
120768,35,70,6,64,,,,70,6,64
120865,35,89,30,59,70,24,46,19,6,13
120883,35,197,89,108,192,88,104,5,1,4
120953,35,411,370,41,53,42,11,358,328,30
120971,35,1352,766,586,353,194,159,999,572,427
121044,35,1855,795,1060,547,262,285,1308,533,775
121150,35,79,29,50,54,23,31,25,6,19
121257,35,17,9,8,16,9,7,1,0,1
121275,35,33,24,9,33,24,9,,,
121309,35,321,122,199,198,91,107,123,31,92
121345,35,20,13,7,20,13,7,,,
121363,35,238,86,152,48,28,20,190,58,132
121619,35,1812,860,952,257,128,129,1555,732,823
121691,35,391,188,203,220,99,121,171,89,82
121707,35,297,155,142,110,55,55,187,100,87
121886,35,1107,682,425,239,143,96,868,539,329
121901,35,1814,689,1125,376,164,212,1438,525,913
122180,35,2667,1057,1610,379,170,209,2288,887,1401
122205,35,1638,627,1011,298,159,139,1340,468,872
122296,35,212,45,167,173,42,131,39,3,36
122339,35,2033,950,1083,250,122,128,1783,828,955
122375,35,2497,1125,1372,405,208,197,2092,917,1175
122384,35,2195,1072,1123,286,192,94,1909,880,1029
122409,35,4273,1953,2320,3810,1730,2080,463,223,240
122436,35,283,152,131,276,149,127,7,3,4
122506,35,7,3,4,7,3,4,,,
122597,35,2304,1056,1248,1966,910,1056,338,146,192
122612,35,350,153,197,344,150,194,6,3,3
122658,35,621,245,376,301,138,163,320,107,213
122685,35,265,77,188,265,77,188,,,
122694,35,92,28,64,92,28,64,,,
122728,35,189,92,97,158,78,80,31,14,17
122746,35,971,412,559,142,69,73,829,343,486
122755,35,3289,1656,1633,2619,1323,1296,670,333,337
122791,35,740,344,396,119,59,60,621,285,336
122889,35,808,334,474,293,141,152,515,193,322
122931,35,196,109,87,190,105,85,6,4,2
122977,35,1492,645,847,448,201,247,1044,444,600
123013,35,749,373,376,160,89,71,589,284,305
123165,35,7,0,7,7,0,7,,,
123217,35,621,275,346,233,112,121,388,163,225
123280,35,3,1,2,1,0,1,2,1,1
123299,35,300,114,186,123,47,76,177,67,110
123341,35,806,362,444,230,110,120,576,252,324
123457,35,130,53,77,126,51,75,4,2,2
123484,35,125,76,49,80,50,30,45,26,19
123509,35,899,409,490,122,50,72,777,359,418
123527,35,1290,496,794,379,158,221,911,338,573
123554,35,137,65,72,128,63,65,9,2,7
123563,35,561,258,303,115,43,72,446,215,231
123572,35,736,282,454,598,231,367,138,51,87
123642,35,30,3,27,18,2,16,12,1,11
123651,35,160,74,86,130,64,66,30,10,20
123800,35,942,428,514,355,153,202,587,275,312
123952,35,24,13,11,22,13,9,2,0,2
123961,35,1297,610,687,1287,604,683,10,6,4
124113,35,612,319,293,90,27,63,522,292,230
124292,35,16,9,7,16,9,7,,,
124487,35,5,3,2,,,,5,3,2
125028,35,1046,494,552,146,87,59,900,407,493
125091,35,686,263,423,217,73,144,469,190,279
125170,35,879,353,526,112,53,59,767,300,467
125231,35,1399,204,1195,395,56,339,1004,148,856
125462,35,293,169,124,36,27,9,257,142,115
125471,35,1767,708,1059,186,65,121,1581,643,938
125499,35,610,260,350,118,55,63,492,205,287
125532,35,285,26,259,285,26,259,,,
125727,35,86,38,48,85,38,47,1,0,1
125763,35,81,43,38,75,42,33,6,1,5
125897,35,110,55,55,105,51,54,5,4,1
126076,35,18,18,0,18,18,0,,,
126119,35,525,235,290,75,45,30,450,190,260
126182,35,142,96,46,102,70,32,40,26,14
126207,35,226,94,132,118,57,61,108,37,71
126289,35,988,355,633,305,155,150,683,200,483
126359,35,28,2,26,28,2,26,,,
126562,35,1593,712,881,1284,573,711,309,139,170
126580,35,950,424,526,736,341,395,214,83,131
126605,35,8,7,1,8,7,1,,,
126614,35,1446,841,605,1267,726,541,179,115,64
126669,35,837,241,596,98,42,56,739,199,540
126678,35,27,13,14,27,13,14,,,
126711,35,176,85,91,97,55,42,79,30,49
126748,35,119,46,73,71,37,34,48,9,39
126775,35,133,89,44,116,79,37,17,10,7
126784,35,13,12,1,13,12,1,,,
126818,35,1706,807,899,1397,672,725,309,135,174
126827,35,3185,485,2700,1986,289,1697,1199,196,1003
126863,35,469,192,277,185,98,87,284,94,190
126942,35,858,319,539,261,116,145,597,203,394
127060,35,166,80,86,136,67,69,30,13,17
127185,35,182,94,88,163,84,79,19,10,9
127200,35,1460,615,845,426,227,199,1034,388,646
127389,35,51,24,27,39,22,17,12,2,10
127556,35,431,224,207,337,183,154,94,41,53
127565,35,1878,795,1083,1138,495,643,740,300,440
127617,35,78,17,61,31,7,24,47,10,37
127653,35,100,33,67,94,28,66,6,5,1
127714,35,50,26,24,,,,50,26,24
127732,35,63,27,36,37,22,15,26,5,21
127741,35,536,170,366,416,144,272,120,26,94
127778,35,48,25,23,27,19,8,21,6,15
127820,35,1603,621,982,574,258,316,1029,363,666
127884,35,585,157,428,182,67,115,403,90,313
127909,35,703,343,360,277,165,112,426,178,248
127918,35,80,42,38,56,35,21,24,7,17
127945,35,234,63,171,148,41,107,86,22,64
128106,35,388,190,198,276,133,143,112,57,55
128179,35,88,55,33,88,55,33,,,
128188,35,151,50,101,151,50,101,,,
128258,35,135,67,68,69,44,25,66,23,43
128391,35,106,62,44,84,53,31,22,9,13
128498,35,78,28,50,72,26,46,6,2,4
128577,35,125,57,68,55,29,26,70,28,42
128744,35,171,38,133,139,36,103,32,2,30
128771,35,778,422,356,609,337,272,169,85,84
128780,35,431,93,338,128,27,101,303,66,237
128902,35,20,6,14,20,6,14,,,
129020,35,709,372,337,687,358,329,22,14,8
129154,35,602,97,505,85,32,53,517,65,452
129215,35,250,113,137,225,105,120,25,8,17
129242,35,23,17,6,23,17,6,,,
129367,35,305,79,226,85,24,61,220,55,165
129525,35,158,69,89,121,59,62,37,10,27
129534,35,24,14,10,16,10,6,8,4,4
129543,35,231,76,155,94,30,64,137,46,91
129695,35,433,161,272,179,77,102,254,84,170
129729,35,405,142,263,131,66,65,274,76,198
129756,35,189,78,111,64,35,29,125,43,82
129774,35,28,12,16,24,10,14,4,2,2
129808,35,221,71,150,71,27,44,150,44,106
129941,35,205,97,108,173,78,95,32,19,13
130004,35,275,104,171,113,52,61,162,52,110
130040,35,86,24,62,30,15,15,56,9,47
130110,35,29,7,22,17,4,13,12,3,9
130183,35,2195,465,1730,1243,257,986,952,208,744
130217,35,90,37,53,22,12,10,68,25,43
130226,35,200,68,132,190,64,126,10,4,6
130253,35,140,67,73,128,63,65,12,4,8
130314,35,53,18,35,47,17,30,6,1,5
130396,35,581,203,378,187,88,99,394,115,279
130493,35,671,267,404,535,227,308,136,40,96
130590,35,29,10,19,25,8,17,4,2,2
130606,35,274,104,170,102,37,65,172,67,105
130697,35,39,18,21,39,18,21,,,
130776,35,312,135,177,248,106,142,64,29,35
130794,35,24,13,11,24,13,11,,,
130907,35,782,289,493,422,184,238,360,105,255
130934,35,199,85,114,159,72,87,40,13,27
130943,35,387,187,200,364,176,188,23,11,12
130989,35,65,35,30,59,34,25,6,1,5
131113,35,1409,566,843,534,238,296,875,328,547
131159,35,15,4,11,14,4,10,1,0,1
131283,35,64,39,25,63,39,24,1,0,1
131399,35,176,75,101,78,44,34,98,31,67
131450,35,57,22,35,56,22,34,1,0,1
131469,35,357,122,235,252,91,161,105,31,74
131496,35,110,45,65,110,45,65,,,
131520,35,168,44,124,156,38,118,12,6,6
131803,35,49,14,35,9,5,4,40,9,31
131876,35,160,9,151,66,2,64,94,7,87
132408,35,32,13,19,20,8,12,12,5,7
132471,35,194,80,114,158,70,88,36,10,26
132602,35,128,74,54,125,74,51,3,0,3
132657,35,153,74,79,134,64,70,19,10,9
132693,35,464,207,257,195,101,94,269,106,163
132709,35,983,387,596,380,165,215,603,222,381
132842,35,74,10,64,21,4,17,53,6,47
132851,35,268,114,154,156,75,81,112,39,73
132879,35,27,19,8,26,19,7,1,0,1
132903,35,6900,2928,3972,4265,1879,2386,2635,1049,1586
133021,35,65,39,26,47,33,14,18,6,12
133386,35,578,251,327,281,137,144,297,114,183
133465,35,69,17,52,44,8,36,25,9,16
133492,35,65,29,36,65,29,36,,,
133508,35,542,219,323,233,115,118,309,104,205
133526,35,107,52,55,104,49,55,3,3,0
133553,35,239,192,47,229,185,44,10,7,3
133650,35,714,262,452,611,234,377,103,28,75
133669,35,2280,1041,1239,1337,624,713,943,417,526
133702,35,1605,553,1052,605,249,356,1000,304,696
133711,35,166,64,102,166,64,102,,,
133809,35,40,24,16,39,24,15,1,0,1
133872,35,125,12,113,29,5,24,96,7,89
133881,35,167,106,61,157,99,58,10,7,3
133951,35,5098,2061,3037,3369,1338,2031,1729,723,1006
133960,35,109,53,56,56,38,18,53,15,38
133979,35,88,52,36,86,50,36,2,2,0
133997,35,24,9,15,24,9,15,,,
134079,35,104,56,48,103,55,48,1,1,0
134097,35,1846,899,947,1591,782,809,255,117,138
134130,35,1429,667,762,1295,610,685,134,57,77
134237,35,2548,1639,909,2548,1639,909,,,
134343,35,161,47,114,87,27,60,74,20,54
134422,35,5,0,5,1,0,1,4,0,4
134495,35,1750,714,1036,926,454,472,824,260,564
134510,35,3,1,2,3,1,2,,,
134608,35,430,199,231,190,96,94,240,103,137
134811,35,156,46,110,82,21,61,74,25,49
134945,35,192,51,141,170,45,125,22,6,16
135081,35,204,74,130,144,57,87,60,17,43
135160,35,125,46,79,53,25,28,72,21,51
135188,35,187,64,123,82,37,45,105,27,78
135364,35,30,16,14,5,3,2,25,13,12
135391,35,427,151,276,168,79,89,259,72,187
135610,35,11,3,8,5,1,4,6,2,4
135717,35,1207,456,751,737,293,444,470,163,307
135726,35,597,254,343,579,248,331,18,6,12
136145,35,54,14,40,18,6,12,36,8,28
136172,35,1229,496,733,946,386,560,283,110,173
136215,35,483,107,376,319,76,243,164,31,133
136233,35,213,78,135,113,44,69,100,34,66
136330,35,185,57,128,176,57,119,9,0,9
136358,35,1389,580,809,685,319,366,704,261,443
136400,35,58,27,31,33,19,14,25,8,17
136473,35,321,131,190,163,75,88,158,56,102
136516,35,419,129,290,208,71,137,211,58,153
136774,35,65,24,41,64,23,41,1,1,0
136950,35,105,51,54,105,51,54,,,
137032,35,1103,423,680,411,152,259,692,271,421
137078,35,1241,407,834,412,166,246,829,241,588
137096,35,1092,476,616,650,300,350,442,176,266
137209,35,926,350,576,328,159,169,598,191,407
137281,35,161,70,91,68,42,26,93,28,65
137315,35,29,9,20,14,5,9,15,4,11
137351,35,3291,1356,1935,2382,1011,1371,909,345,564
137476,35,297,111,186,229,96,133,68,15,53
137546,35,109,51,58,106,50,56,3,1,2
137564,35,407,194,213,329,155,174,78,39,39
137759,35,917,424,493,680,335,345,237,89,148
137847,35,499,277,222,476,270,206,23,7,16
137953,35,29,18,11,21,13,8,8,5,3
137962,35,31,15,16,21,12,9,10,3,7
138187,35,2716,1109,1607,1280,571,709,1436,538,898
138275,35,123,53,70,113,50,63,10,3,7
138293,35,122,68,54,105,60,45,17,8,9
138309,35,1528,216,1312,683,104,579,845,112,733
138354,35,1284,449,835,849,317,532,435,132,303
138558,35,201,63,138,123,52,71,78,11,67
138600,35,7,0,7,7,0,7,,,
138682,35,346,111,235,139,40,99,207,71,136
138716,35,346,85,261,197,66,131,149,19,130
138761,35,33,5,28,16,5,11,17,0,17
138813,35,88,41,47,47,25,22,41,16,25
138840,35,535,231,304,178,92,86,357,139,218
138868,35,249,119,130,179,95,84,70,24,46
138901,35,195,76,119,112,47,65,83,29,54
138947,35,133,48,85,130,47,83,3,1,2
138956,35,569,203,366,221,97,124,348,106,242
139144,35,24,11,13,24,11,13,,,
139199,35,181,13,168,106,10,96,75,3,72
139205,35,103,74,29,75,47,28,28,27,1
139250,35,207,58,149,116,37,79,91,21,70
139278,35,507,141,366,179,63,116,328,78,250
139311,35,532,131,401,351,90,261,181,41,140
139357,35,390,125,265,132,51,81,258,74,184
139366,35,455,184,271,315,123,192,140,61,79
139384,35,447,145,302,150,58,92,297,87,210
139393,35,24,15,9,24,15,9,,,
139463,35,249,97,152,155,69,86,94,28,66
139579,35,44,8,36,37,7,30,7,1,6
139621,35,111,64,47,88,50,38,23,14,9
139630,35,67,39,28,67,39,28,,,
139658,35,571,243,328,567,243,324,4,0,4
139700,35,403,142,261,189,79,110,214,63,151
139719,35,117,41,76,97,36,61,20,5,15
139755,35,1024,701,323,979,670,309,45,31,14
139764,35,307,97,210,203,73,130,104,24,80
139861,35,188,70,118,171,67,104,17,3,14
139931,35,1213,521,692,989,431,558,224,90,134
139940,35,1408,542,866,993,391,602,415,151,264
139959,35,1807,948,859,1677,888,789,130,60,70
139968,35,262,80,182,161,56,105,101,24,77
139986,35,562,132,430,165,51,114,397,81,316
140012,35,1016,398,618,243,131,112,773,267,506
140234,35,52,24,28,50,24,26,2,0,2
140243,35,653,228,425,202,66,136,451,162,289
140252,35,136,64,72,115,56,59,21,8,13
140331,35,917,324,593,326,138,188,591,186,405
140340,35,49,4,45,29,2,27,20,2,18
140447,35,485,107,378,345,83,262,140,24,116
140553,35,176,176,0,73,73,0,103,103,0
140571,35,99,45,54,75,33,42,24,12,12
140678,35,229,99,130,103,56,47,126,43,83
140696,35,39,22,17,36,20,16,3,2,1
140720,35,31,10,21,28,10,18,3,0,3
140818,35,143,40,103,128,37,91,15,3,12
140872,35,85,45,40,73,43,30,12,2,10
140942,35,544,228,316,234,115,119,310,113,197
140951,35,661,214,447,581,196,385,80,18,62
140960,35,170,68,102,155,64,91,15,4,11
140988,35,89,45,44,82,43,39,7,2,5
141006,35,207,117,90,117,79,38,90,38,52
141060,35,19,0,19,19,0,19,,,
141167,35,158,66,92,101,45,56,57,21,36
141185,35,77,43,34,66,39,27,11,4,7
141237,35,32,14,18,30,13,17,2,1,1
141255,35,389,144,245,120,35,85,269,109,160
141264,35,577,205,372,423,152,271,154,53,101
141325,35,30,0,30,23,0,23,7,0,7
141334,35,596,208,388,444,163,281,152,45,107
141361,35,33,21,12,33,21,12,,,
141486,35,184,46,138,163,39,124,21,7,14
141565,35,335,127,208,247,91,156,88,36,52
141574,35,1447,540,907,1073,413,660,374,127,247
141644,35,293,134,159,202,89,113,91,45,46
141680,35,297,165,132,124,75,49,173,90,83
141796,35,549,169,380,200,72,128,349,97,252
141802,35,67,16,51,22,4,18,45,12,33
141811,35,392,137,255,153,64,89,239,73,166
141839,35,105,34,71,36,11,25,69,23,46
141981,35,462,146,316,251,77,174,211,69,142
141990,35,186,71,115,75,24,51,111,47,64
142054,35,75,8,67,75,8,67,,,
142090,35,11,7,4,9,5,4,2,2,0
142115,35,1634,716,918,1028,487,541,606,229,377
142179,35,129,44,85,53,28,25,76,16,60
142276,35,555,212,343,403,155,248,152,57,95
142285,35,516,264,252,453,235,218,63,29,34
142294,35,41,23,18,41,23,18,,,
142328,35,299,99,200,196,73,123,103,26,77
142443,35,170,67,103,89,45,44,81,22,59
142461,35,86,36,50,70,33,37,16,3,13
142522,35,3722,1555,2167,778,361,417,2944,1194,1750
142559,35,240,101,139,133,61,72,107,40,67
142832,35,9,9,0,,,,9,9,0
142887,35,6,3,3,4,2,2,2,1,1
143048,35,111,37,74,108,35,73,3,2,1
143084,35,54,24,30,54,24,30,,,
143118,35,542,175,367,455,158,297,87,17,70
143215,35,218,98,120,129,60,69,89,38,51
143279,35,135,58,77,75,36,39,60,22,38
143288,35,33,11,22,33,11,22,,,
143297,35,14,4,10,7,2,5,7,2,5
143358,35,148,85,63,134,77,57,14,8,6
143613,35,78,20,58,56,16,40,22,4,18
143978,35,11,4,7,6,2,4,5,2,3
144005,35,173,54,119,131,39,92,42,15,27
144050,35,74,47,27,74,47,27,,,
144157,35,165,96,69,96,69,27,69,27,42
144166,35,587,132,455,266,70,196,321,62,259
144175,35,177,77,100,107,57,50,70,20,50
144184,35,254,92,162,124,41,83,130,51,79
144193,35,204,142,62,148,113,35,56,29,27
144209,35,454,182,272,250,101,149,204,81,123
144218,35,304,154,150,171,93,78,133,61,72
144281,35,491,210,281,475,201,274,16,9,7
144351,35,138,63,75,115,54,61,23,9,14
144564,35,45,22,23,28,16,12,17,6,11
144740,35,1060,531,529,922,468,454,138,63,75
144865,35,1559,673,886,572,287,285,987,386,601
144883,35,7,6,1,7,6,1,,,
144892,35,605,239,366,514,215,299,91,24,67
144944,35,332,167,165,154,91,63,178,76,102
144962,35,411,153,258,403,149,254,8,4,4
144971,35,124,79,45,114,77,37,10,2,8
145239,35,72,19,53,72,19,53,,,
145336,35,432,171,261,318,129,189,114,42,72
145372,35,93,48,45,80,43,37,13,5,8
145497,35,8,5,3,7,5,2,1,0,1
145521,35,40,18,22,20,10,10,20,8,12
145600,35,2110,964,1146,1784,830,954,326,134,192
145619,35,252,128,124,213,122,91,39,6,33
145637,35,1390,793,597,1264,705,559,126,88,38
145646,35,33,22,11,33,22,11,,,
145682,35,100,43,57,40,24,16,60,19,41
145691,35,66,23,43,66,23,43,,,
145707,35,5,3,2,3,2,1,2,1,1
145725,35,123,74,49,111,65,46,12,9,3
145813,35,1773,906,867,1647,853,794,126,53,73
145831,35,17,5,12,10,2,8,7,3,4
146205,35,70,28,42,42,20,22,28,8,20
146278,35,161,58,103,70,29,41,91,29,62
146296,35,178,58,120,75,28,47,103,30,73
146339,35,71,42,29,71,42,29,,,
146348,35,125,58,67,68,37,31,57,21,36
146366,35,284,82,202,168,53,115,116,29,87
146418,35,98,41,57,58,30,28,40,11,29
146427,35,24,9,15,24,9,15,,,
146472,35,307,161,146,165,99,66,142,62,80
146481,35,84,34,50,84,34,50,,,
146506,35,144,48,96,80,30,50,64,18,46
146533,35,25,8,17,21,8,13,4,0,4
146603,35,132,47,85,76,31,45,56,16,40
146612,35,494,254,240,381,190,191,113,64,49
146667,35,4,2,2,1,0,1,3,2,1
146685,35,187,63,124,96,44,52,91,19,72
146719,35,435,165,270,410,153,257,25,12,13
146755,35,41,5,36,33,5,28,8,0,8
146816,35,104,10,94,102,10,92,2,0,2
147004,35,473,175,298,142,64,78,331,111,220
147013,35,187,72,115,174,71,103,13,1,12
147129,35,75,7,68,43,4,39,32,3,29
147244,35,132,56,76,123,55,68,9,1,8
147341,35,32,12,20,31,11,20,1,1,0
147369,35,255,120,135,205,94,111,50,26,24
147378,35,199,94,105,117,58,59,82,36,46
147396,35,8,6,2,8,6,2,,,
147411,35,98,43,55,55,27,28,43,16,27
147536,35,695,148,547,427,96,331,268,52,216
147590,35,13,2,11,9,2,7,4,0,4
147660,35,221,107,114,218,105,113,3,2,1
147679,35,160,75,85,135,69,66,25,6,19
147703,35,1252,617,635,1051,523,528,201,94,107
147767,35,228,113,115,228,113,115,,,
147776,35,584,262,322,393,180,213,191,82,109
147800,35,347,174,173,107,61,46,240,113,127
147828,35,108,60,48,106,58,48,2,2,0
147916,35,202,104,98,137,72,65,65,32,33
148007,35,158,44,114,94,26,68,64,18,46
148016,35,33,20,13,33,20,13,,,
148131,35,100,54,46,99,54,45,1,0,1
148256,35,46,16,30,32,13,19,14,3,11
148292,35,15,5,10,4,4,0,11,1,10
148380,35,166,68,98,99,38,61,67,30,37
148405,35,111,43,68,111,43,68,,,
148487,35,358,143,215,314,132,182,44,11,33
148496,35,146,34,112,140,34,106,6,0,6
148511,35,34,9,25,19,5,14,15,4,11
148575,35,80,12,68,58,9,49,22,3,19
148584,35,197,55,142,155,45,110,42,10,32
148593,35,44,4,40,33,4,29,11,0,11
148627,35,241,88,153,204,77,127,37,11,26
148654,35,436,179,257,293,120,173,143,59,84
148672,35,26,9,17,15,8,7,11,1,10
148821,35,75,21,54,42,13,29,33,8,25
148876,35,13,0,13,8,0,8,5,0,5
148937,35,15,7,8,10,5,5,5,2,3
148991,35,9,3,6,6,3,3,3,0,3
149028,35,44,4,40,36,3,33,8,1,7
149222,35,1072,532,540,861,411,450,211,121,90
149231,35,931,420,511,724,351,373,207,69,138
149310,35,17,8,9,17,8,9,,,
149329,35,1,1,0,1,1,0,,,
149365,35,93,30,63,45,19,26,48,11,37
149505,35,98,42,56,72,35,37,26,7,19
149514,35,54,33,21,47,29,18,7,4,3
149532,35,343,144,199,154,72,82,189,72,117
149639,35,8,5,3,8,5,3,,,
149727,35,181,81,100,96,48,48,85,33,52
149763,35,90,15,75,42,10,32,48,5,43
149772,35,640,269,371,512,230,282,128,39,89
149781,35,46,29,17,46,29,17,,,
149842,35,414,185,229,201,107,94,213,78,135
150066,35,50,22,28,45,22,23,5,0,5
150136,35,522,214,308,459,196,263,63,18,45
150145,35,97,33,64,80,29,51,17,4,13
150163,35,79,33,46,78,33,45,1,0,1
150172,35,99,83,16,64,54,10,35,29,6
150251,35,25,0,25,12,0,12,13,0,13
150400,35,8,5,3,8,5,3,,,
150455,35,12,5,7,12,5,7,,,
150534,35,57,22,35,57,22,35,,,
150604,35,24,15,9,23,14,9,1,1,0
150668,35,42,19,23,40,19,21,2,0,2
150677,35,59,32,27,57,31,26,2,1,1
150756,35,19,8,11,19,8,11,,,
150774,35,8,6,2,8,6,2,,,
150941,35,41,19,22,35,16,19,6,3,3
150987,35,2217,866,1351,665,285,380,1552,581,971
151102,35,323,147,176,268,124,144,55,23,32
151111,35,1025,418,607,836,343,493,189,75,114
151263,35,214,105,109,198,97,101,16,8,8
151290,35,70,54,16,69,53,16,1,1,0
151306,35,370,160,210,298,144,154,72,16,56
151324,35,527,236,291,355,181,174,172,55,117
151333,35,190,71,119,141,56,85,49,15,34
151342,35,281,96,185,206,70,136,75,26,49
151351,35,653,345,308,638,337,301,15,8,7
151360,35,195,45,150,126,32,94,69,13,56
151379,35,253,99,154,178,63,115,75,36,39
151388,35,289,103,186,182,62,120,107,41,66
151467,35,19,1,18,19,1,18,,,
151661,35,1,1,0,1,1,0,,,
151777,35,30,14,16,30,14,16,,,
151786,35,216,74,142,157,57,100,59,17,42
151801,35,66,33,33,64,33,31,2,0,2
151810,35,11,5,6,6,2,4,5,3,2
151962,35,59,16,43,55,15,40,4,1,3
152080,35,189,81,108,189,81,108,,,
152099,35,65,33,32,65,33,32,,,
152318,35,17,11,6,17,11,6,,,
152336,35,130,41,89,112,40,72,18,1,17
152381,35,110,29,81,78,26,52,32,3,29
152390,35,19,0,19,19,0,19,,,
152530,35,38,23,15,38,23,15,,,
152567,35,60,36,24,58,36,22,2,0,2
152600,35,128,53,75,121,51,70,7,2,5
152637,35,189,85,104,133,57,76,56,28,28
152673,35,7,7,0,7,7,0,,,
152798,35,149,11,138,135,10,125,14,1,13
152992,35,30,11,19,30,11,19,,,
153001,35,200,44,156,168,40,128,32,4,28
153108,35,37,19,18,37,19,18,,,
153126,35,77,47,30,69,43,26,8,4,4
153144,35,26,12,14,26,12,14,,,
153162,35,28,16,12,28,16,12,,,
153214,35,1200,495,705,716,319,397,484,176,308
153241,35,9,6,3,9,6,3,,,
153250,35,23,11,12,23,11,12,,,
153269,35,76,36,40,69,32,37,7,4,3
153278,35,92,46,46,65,41,24,27,5,22
153296,35,49,21,28,44,21,23,5,0,5
153302,35,20,10,10,18,10,8,2,0,2
153311,35,236,63,173,98,36,62,138,27,111
153320,35,13,8,5,12,8,4,1,0,1
153366,35,84,57,27,75,55,20,9,2,7
153375,35,198,92,106,171,85,86,27,7,20
153384,35,6,4,2,6,4,2,,,
153427,35,11,5,6,11,5,6,,,
153445,35,177,66,111,105,46,59,72,20,52
153472,35,144,49,95,127,47,80,17,2,15
153524,35,253,121,132,228,114,114,25,7,18
153533,35,23,6,17,8,3,5,15,3,12
153603,35,1383,752,631,1304,715,589,79,37,42
153621,35,82,47,35,77,46,31,5,1,4
153630,35,115,28,87,38,13,25,77,15,62
153658,35,1039,539,500,940,502,438,99,37,62
153737,35,309,132,177,153,75,78,156,57,99
153825,35,49,24,25,46,22,24,3,2,1
153834,35,20,12,8,20,12,8,,,
153861,35,190,43,147,95,25,70,95,18,77
153922,35,87,42,45,62,36,26,25,6,19
153977,35,319,64,255,211,52,159,108,12,96
154004,35,64,20,44,41,20,21,23,0,23
154013,35,155,57,98,125,51,74,30,6,24
154022,35,2398,835,1563,1605,559,1046,793,276,517
154059,35,64,27,37,36,18,18,28,9,19
154095,35,728,319,409,667,290,377,61,29,32
154101,35,33,17,16,33,17,16,,,
154110,35,98,38,60,36,17,19,62,21,41
154129,35,67,24,43,38,16,22,29,8,21
154174,35,16,9,7,15,8,7,1,1,0
154235,35,174,79,95,158,74,84,16,5,11
154262,35,64,12,52,42,10,32,22,2,20
154350,35,52,23,29,48,22,26,4,1,3
154378,35,50,16,34,36,9,27,14,7,7
154396,35,78,22,56,54,18,36,24,4,20
154493,35,354,131,223,210,74,136,144,57,87
154518,35,371,239,132,282,178,104,89,61,28
154527,35,26,19,7,25,19,6,1,0,1
154572,35,323,110,213,165,75,90,158,35,123
154590,35,181,65,116,160,62,98,21,3,18
154642,35,19,13,6,7,5,2,12,8,4
154688,35,92,39,53,77,33,44,15,6,9
154697,35,265,94,171,109,40,69,156,54,102
154712,35,63,34,29,63,34,29,,,
154721,35,50,39,11,49,38,11,1,1,0
154749,35,43,14,29,41,14,27,2,0,2
154800,35,441,169,272,206,96,110,235,73,162
154855,35,39,27,12,39,27,12,,,
154907,35,86,44,42,53,31,22,33,13,20
154925,35,93,57,36,78,51,27,15,6,9
154934,35,135,42,93,93,34,59,42,8,34
154952,35,143,66,77,91,43,48,52,23,29
154998,35,98,54,44,67,41,26,31,13,18
155007,35,47,12,35,12,5,7,35,7,28
155025,35,287,117,170,274,112,162,13,5,8
155052,35,58,14,44,42,9,33,16,5,11
155061,35,1009,377,632,568,243,325,441,134,307
155070,35,13,4,9,11,2,9,2,2,0
155089,35,104,53,51,88,46,42,16,7,9
155098,35,307,131,176,218,96,122,89,35,54
155104,35,107,58,49,89,50,39,18,8,10
155140,35,59,22,37,52,20,32,7,2,5
155177,35,35,8,27,29,7,22,6,1,5
155186,35,303,139,164,149,80,69,154,59,95
155195,35,375,131,244,137,56,81,238,75,163
155201,35,62,36,26,53,35,18,9,1,8
155210,35,982,454,528,388,197,191,594,257,337
155292,35,30,11,19,19,7,12,11,4,7
155308,35,32,15,17,29,14,15,3,1,2
155317,35,1150,520,630,921,447,474,229,73,156
155335,35,159,54,105,145,49,96,14,5,9
155399,35,1173,542,631,991,489,502,182,53,129
155414,35,102,59,43,100,59,41,2,0,2
155450,35,102,36,66,60,26,34,42,10,32
155487,35,60,26,34,36,20,16,24,6,18
155496,35,6,2,4,5,1,4,1,1,0
155511,35,53,31,22,52,30,22,1,1,0
155520,35,162,53,109,148,50,98,14,3,11
155566,35,71,23,48,32,13,19,39,10,29
155593,35,66,24,42,46,21,25,20,3,17
155618,35,26,16,10,24,16,8,2,0,2
155627,35,97,66,31,91,62,29,6,4,2
155636,35,73,14,59,34,5,29,39,9,30
155681,35,339,189,150,304,168,136,35,21,14
155715,35,77,50,27,67,49,18,10,1,9
155812,35,122,57,65,109,51,58,13,6,7
155830,35,52,23,29,39,22,17,13,1,12
155858,35,56,24,32,28,14,14,28,10,18
155900,35,146,106,40,58,40,18,88,66,22
155937,35,53,41,12,41,34,7,12,7,5
155973,35,41,33,8,41,33,8,,,
156082,35,418,132,286,344,111,233,74,21,53
156107,35,452,236,216,243,166,77,209,70,139
156125,35,1224,448,776,919,347,572,305,101,204
156134,35,154,70,84,154,70,84,,,
156189,35,14,12,2,13,11,2,1,1,0
156213,35,61,22,39,41,17,24,20,5,15
156231,35,107,40,67,64,27,37,43,13,30
156286,35,152,55,97,131,50,81,21,5,16
156295,35,27,13,14,27,13,14,,,
156338,35,225,76,149,78,28,50,147,48,99
156356,35,45,18,27,39,17,22,6,1,5
156365,35,355,109,246,275,95,180,80,14,66
156392,35,714,283,431,320,142,178,394,141,253
156408,35,6,4,2,6,4,2,,,
156417,35,16,13,3,10,9,1,6,4,2
156471,35,1792,144,1648,625,57,568,1167,87,1080
156541,35,665,167,498,480,126,354,185,41,144
156620,35,920,392,528,687,291,396,233,101,132
156648,35,253,95,158,115,47,68,138,48,90
156745,35,45,31,14,45,31,14,,,
156790,35,55,19,36,31,8,23,24,11,13
156851,35,62,13,49,22,8,14,40,5,35
156860,35,201,77,124,75,31,44,126,46,80
156921,35,570,251,319,253,129,124,317,122,195
157021,35,41,0,41,13,0,13,28,0,28
157030,35,2,0,2,1,0,1,1,0,1
157058,35,84,37,47,75,33,42,9,4,5
157076,35,71,32,39,70,31,39,1,1,0
157085,35,925,420,505,752,361,391,173,59,114
157100,35,64,48,16,57,45,12,7,3,4
157216,35,129,40,89,119,39,80,10,1,9
157289,35,976,386,590,673,265,408,303,121,182
157304,35,193,58,135,40,13,27,153,45,108
157331,35,143,59,84,74,36,38,69,23,46
157377,35,144,46,98,109,40,69,35,6,29
157386,35,257,103,154,196,85,111,61,18,43
157401,35,510,200,310,416,170,246,94,30,64
157438,35,293,121,172,107,48,59,186,73,113
157447,35,650,240,410,432,181,251,218,59,159
157483,35,165,61,104,93,35,58,72,26,46
157535,35,121,59,62,117,57,60,4,2,2
157553,35,88,31,57,58,23,35,30,8,22
157711,35,219,85,134,116,45,71,103,40,63
157739,35,72,20,52,38,10,28,34,10,24
157757,35,80,22,58,69,21,48,11,1,10
157793,35,176,54,122,96,40,56,80,14,66
157809,35,76,47,29,58,42,16,18,5,13
157818,35,14,12,2,14,12,2,,,
157863,35,78,52,26,77,52,25,1,0,1
157951,35,757,322,435,596,272,324,161,50,111
158088,35,117,25,92,101,22,79,16,3,13
158431,35,626,176,450,305,97,208,321,79,242
158477,35,20,14,6,20,14,6,,,
158662,35,1233,343,890,496,158,338,737,185,552
158802,35,80,41,39,78,41,37,2,0,2
158884,35,238,66,172,93,39,54,145,27,118
159009,35,166,75,91,147,71,76,19,4,15
159373,35,228,25,203,211,23,188,17,2,15
159382,35,723,179,544,378,94,284,345,85,260
159391,35,998,489,509,871,437,434,127,52,75
159407,35,245,61,184,101,31,70,144,30,114
159416,35,292,140,152,206,101,105,86,39,47
159568,35,55,28,27,52,27,25,3,1,2
159647,35,188,108,80,175,105,70,13,3,10
159656,35,126,55,71,100,47,53,26,8,18
159717,35,280,98,182,228,90,138,52,8,44
159939,35,392,199,193,337,167,170,55,32,23
159948,35,34,27,7,25,20,5,9,7,2
159966,35,231,100,131,197,90,107,34,10,24
159993,35,343,112,231,214,88,126,129,24,105
160010,35,77,39,38,27,18,9,50,21,29
160038,35,423,98,325,229,71,158,194,27,167
160065,35,44,7,37,34,6,28,10,1,9
160074,35,136,27,109,72,12,60,64,15,49
160409,35,23,23,0,23,23,0,,,
160481,35,200,44,156,96,28,68,104,16,88
160524,35,11,2,9,11,2,9,,,
160579,35,360,157,203,209,104,105,151,53,98
160612,35,490,202,288,400,175,225,90,27,63
160621,35,279,100,179,216,90,126,63,10,53
160630,35,145,27,118,112,26,86,33,1,32
160649,35,437,107,330,310,81,229,127,26,101
160658,35,617,218,399,463,184,279,154,34,120
160667,35,255,96,159,182,70,112,73,26,47
160755,35,97,53,44,97,53,44,,,
160904,35,58,16,42,56,16,40,2,0,2
160959,35,17,6,11,16,6,10,1,0,1
160977,35,4,3,1,4,3,1,,,
160995,35,74,23,51,74,23,51,,,
161004,35,8,1,7,8,1,7,,,
161022,35,87,7,80,35,4,31,52,3,49
161077,35,201,68,133,102,41,61,99,27,72
161086,35,6,2,4,6,2,4,,,
161138,35,148,75,73,99,56,43,49,19,30
161192,35,164,60,104,68,27,41,96,33,63
161208,35,19,17,2,19,17,2,,,
161217,35,423,130,293,193,61,132,230,69,161
161226,35,48,14,34,38,13,25,10,1,9
161235,35,130,23,107,62,14,48,68,9,59
161253,35,470,249,221,324,160,164,146,89,57
161299,35,22,17,5,22,17,5,,,
161341,35,325,132,193,167,70,97,158,62,96
161457,35,119,38,81,116,38,78,3,0,3
161484,35,74,37,37,54,28,26,20,9,11
161509,35,17,3,14,17,3,14,,,
161518,35,23,7,16,23,7,16,,,
161545,35,442,159,283,240,109,131,202,50,152
161554,35,503,189,314,432,163,269,71,26,45
161563,35,23,11,12,21,10,11,2,1,1
161572,35,956,173,783,956,173,783,,,
161581,35,18,7,11,10,5,5,8,2,6
161688,35,321,68,253,85,34,51,236,34,202
161767,35,425,150,275,106,49,57,319,101,218
161864,35,102,31,71,26,10,16,76,21,55
161873,35,240,84,156,171,63,108,69,21,48
162007,35,501,174,327,382,149,233,119,25,94
162061,35,27,20,7,23,17,6,4,3,1
162104,35,48,25,23,17,11,6,31,14,17
162122,35,284,119,165,121,57,64,163,62,101
162168,35,87,35,52,38,23,15,49,12,37
162210,35,54,15,39,46,14,32,8,1,7
162283,35,135,37,98,101,34,67,34,3,31
162557,35,231,106,125,93,50,43,138,56,82
162584,35,248,114,134,186,104,82,62,10,52
162609,35,25,17,8,22,15,7,3,2,1
162654,35,25,8,17,25,8,17,,,
162690,35,166,55,111,58,29,29,108,26,82
162706,35,190,75,115,95,48,47,95,27,68
162760,35,70,31,39,67,30,37,3,1,2
162779,35,519,185,334,160,68,92,359,117,242
162928,35,51,30,21,51,30,21,,,
163028,35,1,1,0,1,1,0,,,
163046,35,54,22,32,54,22,32,,,
163204,35,9448,5358,4090,1900,913,987,7548,4445,3103
163259,35,280,41,239,214,33,181,66,8,58
163268,35,826,365,461,695,316,379,131,49,82
163286,35,1993,1056,937,1783,963,820,210,93,117
163295,35,45,13,32,45,13,32,,,
163338,35,110,55,55,94,47,47,16,8,8
163426,35,744,367,377,293,158,135,451,209,242
163453,35,415,172,243,342,141,201,73,31,42
163462,35,59,30,29,43,24,19,16,6,10
163532,35,57,57,0,57,57,0,,,
163578,35,89,3,86,73,3,70,16,0,16
163657,35,506,174,332,196,76,120,310,98,212
163851,35,510,221,289,467,211,256,43,10,33
163912,35,70,38,32,70,38,32,,,
163976,35,7,7,0,7,7,0,,,
164076,35,1747,771,976,1524,689,835,223,82,141
164173,35,210,76,134,163,73,90,47,3,44
164216,35,24,11,13,24,11,13,,,
164270,35,44,17,27,44,17,27,,,
164313,35,140,45,95,28,17,11,112,28,84
164368,35,35,22,13,35,22,13,,,
164447,35,59,26,33,55,25,30,4,1,3
164465,35,19,9,10,19,9,10,,,
164492,35,123,79,44,78,39,39,45,40,5
164562,35,34,18,16,34,18,16,,,
164580,35,39,22,17,39,22,17,,,
164614,35,1,1,0,,,,1,1,0
164632,35,133,0,133,74,0,74,59,0,59
164641,35,36,7,29,16,3,13,20,4,16
164739,35,86,62,24,86,62,24,,,
164748,35,381,227,154,272,153,119,109,74,35
164775,35,198,59,139,49,17,32,149,42,107
164872,35,29,12,17,28,12,16,1,0,1
164924,35,135,68,67,117,55,62,18,13,5
164988,35,681,277,404,680,277,403,1,0,1
165015,35,41,23,18,41,23,18,,,
165024,35,659,278,381,531,235,296,128,43,85
165033,35,336,122,214,153,62,91,183,60,123
165112,35,632,249,383,244,108,136,388,141,247
165167,35,78,14,64,12,2,10,66,12,54
165194,35,238,76,162,74,30,44,164,46,118
165264,35,240,27,213,24,4,20,216,23,193
165334,35,57,28,29,57,28,29,,,
165529,35,77,29,48,63,28,35,14,1,13
165574,35,49,30,19,47,30,17,2,0,2
165644,35,26,17,9,22,15,7,4,2,2
165662,35,187,74,113,187,74,113,,,
165671,35,73,21,52,55,19,36,18,2,16
165699,35,75,26,49,69,26,43,6,0,6
165802,35,102,75,27,101,75,26,1,0,1
165820,35,289,115,174,169,88,81,120,27,93
165866,35,208,104,104,192,100,92,16,4,12
165884,35,48,39,9,41,32,9,7,7,0
165936,35,51,26,25,50,25,25,1,1,0
165981,35,110,42,68,40,14,26,70,28,42
166018,35,36,12,24,36,12,24,,,
166027,35,12,5,7,12,5,7,,,
166054,35,4,4,0,4,4,0,,,
166124,35,11,8,3,11,8,3,,,
166133,35,241,81,160,90,38,52,151,43,108
166391,35,54,19,35,49,17,32,5,2,3
166407,35,114,7,107,11,0,11,103,7,96
166452,35,147,46,101,75,25,50,72,21,51
166489,35,2,1,1,2,1,1,,,
166513,35,1056,535,521,755,399,356,301,136,165
166629,35,1238,656,582,1059,593,466,179,63,116
166638,35,1131,463,668,874,359,515,257,104,153
166647,35,277,109,168,110,54,56,167,55,112
166656,35,366,69,297,325,62,263,41,7,34
166674,35,82,27,55,77,25,52,5,2,3
166683,35,21,14,7,21,14,7,,,
166692,35,24,18,6,23,18,5,1,0,1
166717,35,15,5,10,12,4,8,3,1,2
166823,35,291,111,180,138,60,78,153,51,102
166850,35,109,52,57,108,51,57,1,1,0
166887,35,473,146,327,153,58,95,320,88,232
166911,35,12,2,10,12,2,10,,,
166939,35,44,0,44,39,0,39,5,0,5
166957,35,250,95,155,90,38,52,160,57,103
167057,35,9,5,4,9,5,4,,,
167260,35,78,48,30,62,44,18,16,4,12
167288,35,79,40,39,64,33,31,15,7,8
167312,35,323,108,215,136,59,77,187,49,138
167358,35,700,380,320,700,380,320,,,
167376,35,269,103,166,112,57,55,157,46,111
167394,35,166,38,128,125,33,92,41,5,36
167525,35,293,139,154,111,60,51,182,79,103
167534,35,415,145,270,171,74,97,244,71,173
167598,35,41,12,29,39,12,27,2,0,2
167631,35,43,14,29,20,8,12,23,6,17
167677,35,11,11,0,9,9,0,2,2,0
167729,35,351,133,218,275,116,159,76,17,59
167783,35,120,0,120,78,0,78,42,0,42
167835,35,32,0,32,31,0,31,1,0,1
167899,35,48,25,23,47,24,23,1,1,0
167905,35,293,96,197,102,38,64,191,58,133
167987,35,387,165,222,293,132,161,94,33,61
167996,35,46,20,26,46,20,26,,,
168005,35,244,85,159,238,84,154,6,1,5
168148,35,63,23,40,58,21,37,5,2,3
168218,35,20,0,20,20,0,20,,,
168227,35,93,74,19,76,57,19,17,17,0
168254,35,93,62,31,91,61,30,2,1,1
168263,35,309,161,148,240,126,114,69,35,34
168281,35,21,11,10,21,11,10,,,
168342,35,11,10,1,11,10,1,,,
168421,35,63,45,18,63,45,18,,,
168430,35,338,142,196,257,113,144,81,29,52
168528,35,63,38,25,61,37,24,2,1,1
168546,35,34,17,17,34,17,17,,,
168591,35,28,12,16,28,12,16,,,
168607,35,47,25,22,34,23,11,13,2,11
168740,35,88,40,48,77,32,45,11,8,3
168786,35,55,21,34,47,21,26,8,0,8
168847,35,430,109,321,155,44,111,275,65,210
168883,35,63,17,46,33,11,22,30,6,24
169080,35,72,43,29,58,31,27,14,12,2
169248,35,851,330,521,646,282,364,205,48,157
169275,35,363,123,240,123,47,76,240,76,164
169327,35,70,41,29,55,33,22,15,8,7
169363,35,52,31,21,46,28,18,6,3,3
169442,35,85,25,60,72,23,49,13,2,11
169479,35,380,153,227,179,101,78,201,52,149
169521,35,299,122,177,149,66,83,150,56,94
169655,35,21,19,2,21,19,2,,,
169716,35,174,54,120,161,50,111,13,4,9
169798,35,861,373,488,541,266,275,320,107,213
169910,35,884,391,493,592,255,337,292,136,156
169974,35,50,19,31,26,12,14,24,7,17
169983,35,34,23,11,32,21,11,2,2,0
169992,35,48,13,35,29,11,18,19,2,17
170000,35,128,46,82,75,28,47,53,18,35
170037,35,108,43,65,66,32,34,42,11,31
170055,35,688,293,395,301,149,152,387,144,243
170082,35,1295,570,725,1134,504,630,161,66,95
170091,35,19,10,9,18,10,8,1,0,1
170240,35,329,137,192,133,65,68,196,72,124
170286,35,19,11,8,18,11,7,1,0,1
170301,35,50,23,27,49,23,26,1,0,1
170444,35,240,78,162,81,25,56,159,53,106
170532,35,15,5,10,15,5,10,,,
170541,35,463,183,280,153,64,89,310,119,191
170550,35,257,64,193,80,31,49,177,33,144
170587,35,54,17,37,21,8,13,33,9,24
170620,35,160,48,112,59,21,38,101,27,74
170639,35,115,52,63,86,44,42,29,8,21
170657,35,679,312,367,290,143,147,389,169,220
170675,35,91,69,22,81,62,19,10,7,3
170790,35,635,240,395,223,100,123,412,140,272
170806,35,253,78,175,155,48,107,98,30,68
170967,35,92,39,53,78,36,42,14,3,11
170976,35,1342,704,638,1306,685,621,36,19,17
171100,35,1378,664,714,1251,613,638,127,51,76
171128,35,143,100,43,138,98,40,5,2,3
171137,35,520,265,255,370,189,181,150,76,74
171146,35,520,166,354,306,104,202,214,62,152
171155,35,329,142,187,213,100,113,116,42,74
171225,35,94,27,67,36,13,23,58,14,44
171234,35,84,26,58,30,12,18,54,14,40
171304,35,170,67,103,57,27,30,113,40,73
171395,35,52,22,30,26,17,9,26,5,21
171456,35,386,197,189,337,181,156,49,16,33
171483,35,185,96,89,93,59,34,92,37,55
171492,35,286,159,127,169,86,83,117,73,44
171535,35,2214,854,1360,488,211,277,1726,643,1083
171571,35,1343,516,827,1021,395,626,322,121,201
171599,35,42,23,19,41,23,18,1,0,1
171881,35,8,7,1,6,5,1,2,2,0
172051,35,316,115,201,250,93,157,66,22,44
172200,35,718,263,455,223,119,104,495,144,351
172264,35,199,75,124,92,35,57,107,40,67
172291,35,88,34,54,35,16,19,53,18,35
172307,35,90,31,59,48,25,23,42,6,36
172334,35,93,31,62,46,20,26,47,11,36
172440,35,38,23,15,35,23,12,3,0,3
172608,35,146,66,80,23,13,10,123,53,70
172617,35,518,213,305,206,90,116,312,123,189
172635,35,517,196,321,123,62,61,394,134,260
172644,35,1451,555,896,974,382,592,477,173,304
172671,35,25,10,15,5,3,2,20,7,13
172699,35,972,493,479,817,429,388,155,64,91
172866,35,12,11,1,12,11,1,,,
172918,35,218,121,97,77,37,40,141,84,57
172954,35,320,132,188,136,76,60,184,56,128
172963,35,629,233,396,288,116,172,341,117,224
173045,35,188,89,99,169,81,88,19,8,11
173063,35,187,67,120,93,46,47,94,21,73
173115,35,127,34,93,47,21,26,80,13,67
173124,35,457,178,279,274,128,146,183,50,133
173142,35,26,16,10,26,16,10,,,
173160,35,95,43,52,48,27,21,47,16,31
173203,35,241,98,143,155,76,79,86,22,64
173258,35,8,3,5,8,3,5,,,
173300,35,39,23,16,39,23,16,,,
173328,35,632,200,432,383,142,241,249,58,191
173416,35,486,230,256,303,173,130,183,57,126
173452,35,26,8,18,8,4,4,18,4,14
173461,35,336,162,174,155,90,65,181,72,109
173559,35,332,146,186,199,110,89,133,36,97
173638,35,154,64,90,81,41,40,73,23,50
173647,35,24,10,14,24,10,14,,,
173665,35,101,36,65,94,35,59,7,1,6
173708,35,540,312,228,267,177,90,273,135,138
173735,35,310,158,152,242,133,109,68,25,43
173799,35,360,131,229,161,67,94,199,64,135
173902,35,7,4,3,7,4,3,,,
173911,35,357,149,208,173,99,74,184,50,134
173920,35,1030,435,595,748,366,382,282,69,213
173957,35,125,27,98,125,27,98,,,
174020,35,1182,494,688,630,286,344,552,208,344
174066,35,1801,884,917,1686,820,866,115,64,51
174075,35,211,99,112,141,66,75,70,33,37
174127,35,46,18,28,46,18,28,,,
174136,35,781,352,429,332,169,163,449,183,266
174154,35,36,8,28,19,6,13,17,2,15
174233,35,341,178,163,327,170,157,14,8,6
174251,35,31,12,19,29,11,18,2,1,1
174358,35,351,148,203,263,112,151,88,36,52
174376,35,477,174,303,196,76,120,281,98,183
174428,35,851,338,513,390,170,220,461,168,293
174437,35,48,30,18,44,28,16,4,2,2
174473,35,204,79,125,104,41,63,100,38,62
174491,35,103,40,63,85,34,51,18,6,12
174507,35,67,16,51,30,9,21,37,7,30
174525,35,12,5,7,9,3,6,3,2,1
174570,35,124,33,91,76,27,49,48,6,42
174738,35,351,119,232,149,77,72,202,42,160
174747,35,16,0,16,16,0,16,,,
174756,35,451,165,286,254,114,140,197,51,146
174783,35,609,274,335,465,213,252,144,61,83
174792,35,25,25,0,25,25,0,,,
174817,35,63,34,29,26,19,7,37,15,22
174844,35,18,11,7,18,11,7,,,
174862,35,86,44,42,59,32,27,27,12,15
174899,35,283,80,203,202,68,134,81,12,69
174914,35,184,100,84,181,100,81,3,0,3
175005,35,278,23,255,128,8,120,150,15,135
175014,35,427,68,359,201,41,160,226,27,199
175041,35,491,174,317,211,104,107,280,70,210
175078,35,323,72,251,154,35,119,169,37,132
175227,35,167,137,30,145,118,27,22,19,3
175236,35,329,134,195,215,97,118,114,37,77
175263,35,248,133,115,156,97,59,92,36,56
175272,35,353,129,224,240,98,142,113,31,82
175315,35,1055,398,657,544,225,319,511,173,338
175342,35,209,72,137,180,68,112,29,4,25
175421,35,172,62,110,114,43,71,58,19,39
175430,35,79,41,38,76,40,36,3,1,2
175519,35,125,43,82,100,37,63,25,6,19
175573,35,165,60,105,141,51,90,24,9,15
175616,35,310,135,175,274,122,152,36,13,23
175643,35,190,77,113,172,72,100,18,5,13
175652,35,378,168,210,301,142,159,77,26,51
175786,35,2467,721,1746,1370,459,911,1097,262,835
175810,35,1602,380,1222,997,250,747,605,130,475
175829,35,167,66,101,96,47,49,71,19,52
175856,35,440,154,286,393,141,252,47,13,34
175883,35,330,125,205,271,105,166,59,20,39
175935,35,881,174,707,652,132,520,229,42,187
175980,35,16,8,8,16,8,8,,,
176008,35,505,121,384,374,96,278,131,25,106
176017,35,1315,527,788,1195,488,707,120,39,81
176035,35,515,86,429,482,82,400,33,4,29
176044,35,154,68,86,137,56,81,17,12,5
176053,35,271,127,144,226,116,110,45,11,34
176071,35,433,156,277,286,126,160,147,30,117
176080,35,1829,898,931,1649,822,827,180,76,104
176169,35,144,44,100,116,35,81,28,9,19
176178,35,12,2,10,8,2,6,4,0,4
176239,35,1388,297,1091,974,222,752,414,75,339
176318,35,124,56,68,90,39,51,34,17,17
176336,35,11,8,3,10,7,3,1,1,0
176354,35,125,32,93,76,21,55,49,11,38
176372,35,1342,465,877,1187,408,779,155,57,98
176406,35,34,14,20,34,14,20,,,
176451,35,8,4,4,4,2,2,4,2,2
176479,35,285,86,199,254,83,171,31,3,28
176628,35,97,55,42,97,55,42,,,
176664,35,33,23,10,26,20,6,7,3,4
176770,35,168,24,144,105,15,90,63,9,54
176789,35,29,13,16,14,7,7,15,6,9
176910,35,39,22,17,22,11,11,17,11,6
176947,35,93,47,46,93,47,46,,,
176965,35,642,312,330,544,271,273,98,41,57
177038,35,16,6,10,9,3,6,7,3,4
177065,35,955,380,575,400,157,243,555,223,332
177083,35,4,4,0,4,4,0,,,
177117,35,15,0,15,15,0,15,,,
177135,35,242,96,146,112,50,62,130,46,84
177144,35,63,38,25,62,38,24,1,0,1
177214,35,69,36,33,69,36,33,,,
177250,35,123,49,74,66,32,34,57,17,40
177302,35,11,8,3,11,8,3,,,
177339,35,61,35,26,61,35,26,,,
177418,35,51,33,18,44,29,15,7,4,3
177472,35,650,256,394,312,131,181,338,125,213
177542,35,35,15,20,33,14,19,2,1,1
177551,35,70,31,39,62,28,34,8,3,5
177676,35,160,64,96,94,41,53,66,23,43
177719,35,152,21,131,131,20,111,21,1,20
177746,35,47,15,32,47,15,32,,,
177940,35,116,61,55,98,58,40,18,3,15
177968,35,608,289,319,520,248,272,88,41,47
177977,35,97,75,22,92,71,21,5,4,1
177986,35,71,20,51,40,13,27,31,7,24
177995,35,1028,387,641,473,203,270,555,184,371
178059,35,970,286,684,300,111,189,670,175,495
178183,35,33,2,31,33,2,31,,,
178208,35,151,100,51,83,56,27,68,44,24
178217,35,106,49,57,75,33,42,31,16,15
178244,35,233,96,137,185,78,107,48,18,30
178341,35,318,131,187,238,97,141,80,34,46
178369,35,115,57,58,102,56,46,13,1,12
178387,35,196,96,100,165,85,80,31,11,20
178396,35,1261,588,673,1127,552,575,134,36,98
178402,35,846,371,475,692,301,391,154,70,84
178411,35,245,187,58,199,150,49,46,37,9
178420,35,1024,443,581,819,346,473,205,97,108
178448,35,195,87,108,128,63,65,67,24,43
178615,35,63,26,37,58,25,33,5,1,4
178624,35,309,133,176,257,121,136,52,12,40
178679,35,45,30,15,39,26,13,6,4,2
178697,35,20,9,11,20,9,11,,,
178721,35,768,430,338,475,252,223,293,178,115
178767,35,6,2,4,3,1,2,3,1,2
178891,35,193,168,25,131,114,17,62,54,8
179043,35,182,37,145,152,36,116,30,1,29
179159,35,503,232,271,264,117,147,239,115,124
179265,35,19,7,12,19,7,12,,,
179308,35,938,291,647,430,166,264,508,125,383
179326,35,178,61,117,122,50,72,56,11,45
179344,35,53,17,36,30,14,16,23,3,20
179539,35,191,68,123,110,41,69,81,27,54
179548,35,58,5,53,55,5,50,3,0,3
179557,35,506,219,287,426,193,233,80,26,54
179566,35,1289,496,793,1083,425,658,206,71,135
179645,35,85,33,52,59,24,35,26,9,17
179715,35,89,21,68,42,7,35,47,14,33
179867,35,194,90,104,127,68,59,67,22,45
179894,35,247,103,144,184,80,104,63,23,40
179946,35,36,25,11,36,25,11,,,
179955,35,49,30,19,49,30,19,,,
179964,35,82,26,56,58,21,37,24,5,19
180081,35,22,12,10,19,11,8,3,1,2
180106,35,44,19,25,41,19,22,3,0,3
180151,35,21,8,13,13,6,7,8,2,6
180179,35,285,110,175,202,97,105,83,13,70
180197,35,291,117,174,122,55,67,169,62,107
180203,35,6,2,4,5,1,4,1,1,0
180212,35,24,8,16,21,6,15,3,2,1
180249,35,95,27,68,60,15,45,35,12,23
180258,35,78,23,55,65,20,45,13,3,10
180276,35,74,37,37,40,25,15,34,12,22
180373,35,44,12,32,17,8,9,27,4,23
180416,35,64,44,20,55,40,15,9,4,5
180461,35,473,252,221,380,205,175,93,47,46
180489,35,600,255,345,432,191,241,168,64,104
180522,35,125,49,76,101,44,57,24,5,19
180595,35,50,29,21,49,29,20,1,0,1
180647,35,36,11,25,27,9,18,9,2,7
180692,35,102,21,81,76,17,59,26,4,22
180814,35,3090,1402,1688,1555,746,809,1535,656,879
180832,35,169,30,139,90,13,77,79,17,62
180878,35,63,7,56,42,4,38,21,3,18
180902,35,223,105,118,161,84,77,62,21,41
180948,35,206,62,144,170,58,112,36,4,32
180984,35,48,30,18,48,30,18,,,
181002,35,155,45,110,148,42,106,7,3,4
181020,35,55,32,23,52,30,22,3,2,1
181127,35,40,28,12,39,27,12,1,1,0
181145,35,13,2,11,13,2,11,,,
181215,35,325,105,220,258,97,161,67,8,59
181297,35,195,31,164,151,27,124,44,4,40
181303,35,556,260,296,255,137,118,301,123,178
181312,35,74,39,35,48,33,15,26,6,20
181330,35,108,53,55,108,53,55,,,
181394,35,1004,469,535,765,330,435,239,139,100
181419,35,20,7,13,11,5,6,9,2,7
181428,35,409,51,358,360,43,317,49,8,41
181446,35,67,38,29,60,35,25,7,3,4
181464,35,746,397,349,700,374,326,46,23,23
181491,35,142,53,89,95,43,52,47,10,37
181534,35,123,53,70,85,43,42,38,10,28
181543,35,2,1,1,1,0,1,1,1,0
181604,35,46,0,46,45,0,45,1,0,1
181640,35,638,287,351,292,153,139,346,134,212
181738,35,30,9,21,27,8,19,3,1,2
181765,35,15,2,13,13,2,11,2,0,2
181783,35,197,95,102,168,83,85,29,12,17
181817,35,135,63,72,91,51,40,44,12,32
181853,35,62,27,35,51,27,24,11,0,11
181941,35,41,23,18,41,23,18,,,
182005,35,1813,698,1115,706,299,407,1107,399,708
182148,35,23,3,20,23,3,20,,,
182281,35,2022,836,1186,1508,637,871,514,199,315
182290,35,1181,566,615,921,459,462,260,107,153
182306,35,104,45,59,29,16,13,75,29,46
182500,35,434,188,246,152,70,82,282,118,164
182564,35,172,68,104,57,26,31,115,42,73
182634,35,53,15,38,45,15,30,8,0,8
182670,35,30,18,12,30,18,12,,,
182795,35,45,16,29,35,15,20,10,1,9
182980,35,70,26,44,67,26,41,3,0,3
183026,35,22732,8418,14314,6049,2378,3671,16683,6040,10643
183044,35,366,176,190,357,169,188,9,7,2
183062,35,95,58,37,94,57,37,1,1,0
183071,35,61,34,27,52,28,24,9,6,3
183080,35,157,95,62,155,94,61,2,1,1
183099,35,273,74,199,92,39,53,181,35,146
183105,35,49,18,31,22,8,14,27,10,17
183114,35,91,21,70,25,7,18,66,14,52
183123,35,62,35,27,26,19,7,36,16,20
183132,35,192,73,119,50,24,26,142,49,93
183141,35,143,54,89,44,27,17,99,27,72
183150,35,166,60,106,66,32,34,100,28,72
183211,35,110,24,86,55,20,35,55,4,51
183239,35,38,21,17,38,21,17,,,
183248,35,22,4,18,7,1,6,15,3,12
183257,35,216,70,146,142,45,97,74,25,49
183275,35,4,2,2,4,2,2,,,
183488,35,92,9,83,43,6,37,49,3,46
183655,35,174,63,111,94,40,54,80,23,57
183743,35,767,330,437,453,228,225,314,102,212
183789,35,256,54,202,195,46,149,61,8,53
183804,35,539,539,0,538,538,0,1,1,0
183822,35,96,32,64,93,32,61,3,0,3
183859,35,262,113,149,116,63,53,146,50,96
183877,35,355,106,249,142,52,90,213,54,159
183910,35,62,19,43,51,18,33,11,1,10
183938,35,452,188,264,223,110,113,229,78,151
183974,35,81,30,51,76,28,48,5,2,3
184180,35,381,187,194,191,103,88,190,84,106
184205,35,90,34,56,44,16,28,46,18,28
184348,35,65,36,29,65,36,29,,,
184481,35,209,85,124,113,51,62,96,34,62
184603,35,201,108,93,135,65,70,66,43,23
184612,35,168,40,128,156,36,120,12,4,8
184694,35,95,46,49,86,43,43,9,3,6
184773,35,157,39,118,136,35,101,21,4,17
184782,35,1915,887,1028,1727,807,920,188,80,108
184791,35,454,160,294,228,78,150,226,82,144
184959,35,176,30,146,69,9,60,107,21,86
184995,35,201,69,132,116,44,72,85,25,60
185129,35,478,182,296,408,161,247,70,21,49
185262,35,1250,481,769,911,359,552,339,122,217
185509,35,162,83,79,60,42,18,102,41,61
185536,35,269,116,153,156,71,85,113,45,68
185572,35,182,78,104,174,73,101,8,5,3
185590,35,1313,574,739,1195,528,667,118,46,72
185721,35,79,7,72,49,4,45,30,3,27
185828,35,629,486,143,566,441,125,63,45,18
185873,35,162,62,100,66,33,33,96,29,67
186034,35,141,65,76,70,38,32,71,27,44
186131,35,27,20,7,27,20,7,,,
186186,35,43,43,0,43,43,0,,,
186201,35,366,180,186,345,174,171,21,6,15
186283,35,221,97,124,193,89,104,28,8,20
186371,35,498,183,315,416,153,263,82,30,52
186380,35,2144,1031,1113,2040,996,1044,104,35,69
186399,35,714,319,395,622,275,347,92,44,48
186432,35,225,66,159,209,60,149,16,6,10
186469,35,114,32,82,44,22,22,70,10,60
186584,35,180,74,106,176,72,104,4,2,2
186618,35,57,14,43,47,12,35,10,2,8
186645,35,252,120,132,118,67,51,134,53,81
186867,35,35,26,9,35,26,9,,,
186876,35,808,324,484,790,314,476,18,10,8
186900,35,11,11,0,11,11,0,,,
187046,35,1863,1117,746,16,2,14,1847,1115,732
187134,35,272,129,143,264,127,137,8,2,6
187198,35,559,178,381,246,105,141,313,73,240
187444,35,790,251,539,549,190,359,241,61,180
187532,35,1122,455,667,362,152,210,760,303,457
187596,35,60,28,32,34,19,15,26,9,17
187620,35,222,93,129,103,45,58,119,48,71
187639,35,119,25,94,36,5,31,83,20,63
187648,35,453,169,284,288,118,170,165,51,114
187666,35,42,11,31,19,7,12,23,4,19
187745,35,35,10,25,29,9,20,6,1,5
187897,35,293,95,198,180,73,107,113,22,91
187903,35,84,41,43,45,27,18,39,14,25
187912,35,21,20,1,21,20,1,,,
187958,35,79,30,49,19,10,9,60,20,40
187967,35,42,31,11,39,29,10,3,2,1
187976,35,89,45,44,8,4,4,81,41,40
187985,35,1195,507,688,766,347,419,429,160,269
187994,35,30,7,23,12,2,10,18,5,13
188003,35,39,9,30,15,5,10,24,4,20
188021,35,15,2,13,6,1,5,9,1,8
188030,35,618,321,297,465,259,206,153,62,91
188049,35,90,35,55,3,0,3,87,35,52
188058,35,97,33,64,43,17,26,54,16,38
188100,35,275,56,219,84,28,56,191,28,163
188137,35,243,97,146,63,33,30,180,64,116
188182,35,141,63,78,120,52,68,21,11,10
188216,35,19,3,16,11,2,9,8,1,7
188225,35,68,25,43,10,5,5,58,20,38
188261,35,26,12,14,16,9,7,10,3,7
188304,35,264,83,181,158,61,97,106,22,84
188340,35,129,116,13,118,107,11,11,9,2
188429,35,247,94,153,222,83,139,25,11,14
188438,35,130,57,73,90,49,41,40,8,32
188517,35,47,14,33,46,13,33,1,1,0
188526,35,55,23,32,55,23,32,,,
188641,35,45,15,30,43,14,29,2,1,1
188687,35,39,18,21,16,10,6,23,8,15
188854,35,105,30,75,105,30,75,,,
188915,35,34,10,24,11,9,2,23,1,22
188942,35,95,0,95,93,0,93,2,0,2
189088,35,81,27,54,79,26,53,2,1,1
189097,35,153,0,153,153,0,153,,,
189228,35,197,75,122,153,62,91,44,13,31
189273,35,6,6,0,6,6,0,,,
189282,35,157,26,131,93,19,74,64,7,57
189413,35,46,12,34,46,12,34,,,
189547,35,316,110,206,201,76,125,115,34,81
189565,35,87,23,64,79,22,57,8,1,7
189583,35,97,33,64,90,31,59,7,2,5
189592,35,72,14,58,61,14,47,11,0,11
189705,35,73,48,25,71,48,23,2,0,2
189811,35,135,15,120,135,15,120,,,
189839,35,120,39,81,79,28,51,41,11,30
189848,35,31,9,22,31,9,22,,,
189857,35,277,277,0,277,277,0,,,
190044,35,55,34,21,54,34,20,1,0,1
190053,35,44,22,22,34,20,14,10,2,8
190071,35,27,5,22,2,0,2,25,5,20
190099,35,17,10,7,17,10,7,,,
190114,35,68,19,49,51,11,40,17,8,9
190150,35,693,398,295,565,342,223,128,56,72
190169,35,90,29,61,40,18,22,50,11,39
190372,35,16,4,12,16,4,12,,,
190415,35,631,278,353,631,278,353,,,
190442,35,2,0,2,,,,2,0,2
190451,35,34,4,30,7,2,5,27,2,25
190503,35,415,209,206,415,209,206,,,
190512,35,1611,798,813,1198,595,603,413,203,210
190521,35,1396,570,826,905,402,503,491,168,323
190530,35,541,196,345,382,147,235,159,49,110
190549,35,971,375,596,760,289,471,211,86,125
190558,35,523,234,289,433,197,236,90,37,53
190567,35,672,280,392,524,218,306,148,62,86
190576,35,876,243,633,438,136,302,438,107,331
190585,35,515,133,382,343,96,247,172,37,135
190594,35,1555,541,1014,1161,406,755,394,135,259
190600,35,1346,548,798,1152,462,690,194,86,108
190619,35,793,312,481,623,259,364,170,53,117
190628,35,1184,444,740,775,328,447,409,116,293
190637,35,1353,433,920,892,276,616,461,157,304
190646,35,320,79,241,232,63,169,88,16,72
190655,35,955,377,578,544,233,311,411,144,267
190664,35,1179,518,661,918,410,508,261,108,153
190673,35,636,275,361,405,201,204,231,74,157
190691,35,482,152,330,333,103,230,149,49,100
190716,35,148,29,119,115,24,91,33,5,28
190725,35,290,57,233,273,51,222,17,6,11
190752,35,2,2,0,2,2,0,,,
190761,35,109,39,70,98,37,61,11,2,9
190840,35,138,52,86,98,36,62,40,16,24
190956,35,76,7,69,1,0,1,75,7,68
190983,35,27,9,18,27,9,18,,,
191083,35,268,110,158,200,90,110,68,20,48
191126,35,685,141,544,639,132,507,46,9,37
191199,35,284,125,159,155,74,81,129,51,78
191205,35,44,28,16,44,28,16,,,
191241,35,281,138,143,253,120,133,28,18,10
191302,35,35,11,24,21,5,16,14,6,8
191339,35,229,72,157,134,50,84,95,22,73
191515,35,8,4,4,8,4,4,,,
191533,35,26,11,15,26,11,15,,,
191597,35,236,27,209,140,16,124,96,11,85
191612,35,151,66,85,113,47,66,38,19,19
191621,35,85,40,45,79,37,42,6,3,3
191630,35,27,11,16,27,11,16,,,
191649,35,240,114,126,204,101,103,36,13,23
191676,35,28,10,18,26,9,17,2,1,1
191719,35,586,238,348,436,195,241,150,43,107
191931,35,114,58,56,113,57,56,1,1,0
191968,35,103,47,56,101,46,55,2,1,1
191986,35,129,60,69,93,49,44,36,11,25
192004,35,13,2,11,13,2,11,,,
192022,35,112,34,78,72,26,46,40,8,32
192040,35,2,1,1,2,1,1,,,
192110,35,6,2,4,6,2,4,,,
192192,35,110,22,88,84,17,67,26,5,21
192271,35,106,11,95,102,10,92,4,1,3
192323,35,130,63,67,105,61,44,25,2,23
192448,35,726,197,529,612,177,435,114,20,94
192509,35,32,2,30,32,2,30,,,
192624,35,11,11,0,11,11,0,,,
192688,35,107,21,86,102,19,83,5,2,3
192703,35,129,77,52,117,69,48,12,8,4
192712,35,17,11,6,17,11,6,,,
192749,35,130,44,86,124,41,83,6,3,3
192785,35,255,24,231,54,6,48,201,18,183
192819,35,138,62,76,138,62,76,,,
192864,35,57,12,45,48,12,36,9,0,9
192925,35,98,25,73,82,23,59,16,2,14
192961,35,32,2,30,,,,32,2,30
193016,35,566,162,404,517,146,371,49,16,33
193052,35,130,130,0,130,130,0,,,
193061,35,5,5,0,5,5,0,,,
193247,35,6,6,0,6,6,0,,,
193283,35,165,72,93,116,59,57,49,13,36
193292,35,190,49,141,151,42,109,39,7,32
193308,35,565,152,413,353,118,235,212,34,178
193326,35,534,207,327,356,156,200,178,51,127
193353,35,157,50,107,120,34,86,37,16,21
193380,35,24,2,22,,,,24,2,22
193399,35,510,33,477,487,32,455,23,1,22
193478,35,881,434,447,652,333,319,229,101,128
193584,35,99,28,71,96,28,68,3,0,3
193654,35,398,111,287,360,98,262,38,13,25
193900,35,842,273,569,807,259,548,35,14,21
193946,35,338,110,228,231,81,150,107,29,78
193973,35,107,51,56,106,51,55,1,0,1
194028,35,87,32,55,57,24,33,30,8,22
194091,35,142,72,70,108,60,48,34,12,22
194116,35,109,9,100,20,1,19,89,8,81
194161,35,134,45,89,105,36,69,29,9,20
194189,35,2,2,0,2,2,0,,,
194222,35,229,108,121,156,70,86,73,38,35
194240,35,257,81,176,156,53,103,101,28,73
194310,35,505,176,329,474,160,314,31,16,15
194392,35,30,23,7,30,23,7,,,
194499,35,122,22,100,122,22,100,,,
194569,35,31,17,14,18,11,7,13,6,7
194578,35,82,24,58,81,23,58,1,1,0
194657,35,2,2,0,2,2,0,,,
194666,35,32,32,0,32,32,0,,,
194736,35,1,1,0,1,1,0,,,
194824,35,85,61,24,70,50,20,15,11,4
194958,35,123,31,92,82,25,57,41,6,35
195003,35,248,134,114,236,130,106,12,4,8
195030,35,101,52,49,101,52,49,,,
195058,35,247,111,136,161,83,78,86,28,58
195128,35,116,36,80,111,35,76,5,1,4
195164,35,57,37,20,54,37,17,3,0,3
195173,35,136,62,74,129,59,70,7,3,4
195191,35,140,14,126,114,11,103,26,3,23
195216,35,18,10,8,18,10,8,,,
195234,35,116,46,70,114,45,69,2,1,1
195243,35,72,43,29,71,42,29,1,1,0
195289,35,32,4,28,4,0,4,28,4,24
195304,35,39,12,27,38,11,27,1,1,0
195322,35,75,27,48,41,17,24,34,10,24
195438,35,96,96,0,96,96,0,,,
195474,35,131,63,68,128,61,67,3,2,1
195526,35,15,6,9,14,5,9,1,1,0
195544,35,392,119,273,341,104,237,51,15,36
195702,35,71,11,60,45,6,39,26,5,21
195720,35,132,65,67,126,65,61,6,0,6
195784,35,116,11,105,116,11,105,,,
195809,35,319,169,150,313,166,147,6,3,3
195988,35,116,46,70,60,32,28,56,14,42
196006,35,244,111,133,196,103,93,48,8,40
196015,35,390,148,242,303,117,186,87,31,56
196024,35,232,75,157,153,61,92,79,14,65
196033,35,161,62,99,154,60,94,7,2,5
196042,35,865,494,371,692,406,286,173,88,85
196051,35,123,62,61,99,57,42,24,5,19
196060,35,861,445,416,808,420,388,53,25,28
196079,35,801,415,386,784,409,375,17,6,11
196088,35,1315,654,661,1222,614,608,93,40,53
196097,35,1179,523,656,1093,483,610,86,40,46
196103,35,165,85,80,138,77,61,27,8,19
196112,35,230,133,97,212,124,88,18,9,9
196121,35,578,226,352,489,205,284,89,21,68
196130,35,418,177,241,370,156,214,48,21,27
196149,35,504,267,237,500,267,233,4,0,4
196158,35,156,72,84,149,69,80,7,3,4
196167,35,176,86,90,172,83,89,4,3,1
196176,35,615,216,399,562,192,370,53,24,29
196185,35,286,141,145,285,141,144,1,0,1
196194,35,535,263,272,477,239,238,58,24,34
196200,35,159,68,91,155,66,89,4,2,2
196219,35,229,114,115,219,112,107,10,2,8
196237,35,503,220,283,455,199,256,48,21,27
196246,35,336,142,194,285,127,158,51,15,36
196255,35,161,33,128,149,31,118,12,2,10
196264,35,1528,492,1036,943,260,683,585,232,353
196291,35,45,39,6,45,39,6,,,
196307,35,69,17,52,65,17,48,4,0,4
196413,35,299,163,136,233,126,107,66,37,29
196431,35,245,245,0,245,245,0,,,
196565,35,189,77,112,129,66,63,60,11,49
196583,35,21,21,0,21,21,0,,,
196592,35,487,171,316,399,147,252,88,24,64
196653,35,203,31,172,109,13,96,94,18,76
196680,35,1260,634,626,,,,1260,634,626
196699,35,101,36,65,51,22,29,50,14,36
196866,35,23,13,10,23,13,10,,,
197018,35,164,164,0,164,164,0,,,
197027,35,43,36,7,43,36,7,,,
197045,35,241,80,161,194,71,123,47,9,38
197133,35,14,5,9,14,5,9,,,
197142,35,47,21,26,41,19,22,6,2,4
197151,35,175,52,123,174,51,123,1,1,0
197197,35,99,37,62,99,37,62,,,
197221,35,2,2,0,2,2,0,,,
197230,35,17,9,8,17,9,8,,,
197285,35,97,19,78,86,17,69,11,2,9
197294,35,495,214,281,293,141,152,202,73,129
197601,35,12,12,0,12,12,0,,,
197647,35,8,8,0,8,8,0,,,
197674,35,50,50,0,50,50,0,,,
197708,35,59,21,38,58,21,37,1,0,1
197735,35,43,43,0,43,43,0,,,
197744,35,26,26,0,26,26,0,,,
197814,35,78,24,54,33,16,17,45,8,37
197850,35,193,43,150,55,15,40,138,28,110
197869,35,1498,646,852,1316,598,718,182,48,134
197887,35,392,122,270,142,56,86,250,66,184
197911,35,76,37,39,69,36,33,7,1,6
197966,35,69,20,49,16,2,14,53,18,35
197984,35,106,65,41,96,64,32,10,1,9
197993,35,6,0,6,6,0,6,,,
198011,35,40,8,32,14,5,9,26,3,23
198039,35,183,63,120,57,21,36,126,42,84
198066,35,59,45,14,58,44,14,1,1,0
198084,35,152,62,90,89,45,44,63,17,46
198109,35,137,9,128,57,7,50,80,2,78
198118,35,303,115,188,106,59,47,197,56,141
198136,35,308,140,168,221,96,125,87,44,43
198154,35,97,34,63,24,6,18,73,28,45
198206,35,138,46,92,63,26,37,75,20,55
198215,35,115,50,65,100,49,51,15,1,14
198233,35,218,69,149,74,33,41,144,36,108
198251,35,355,102,253,124,44,80,231,58,173
198260,35,892,413,479,485,239,246,407,174,233
198303,35,41,28,13,35,25,10,6,3,3
198321,35,88,25,63,21,11,10,67,14,53
198330,35,335,102,233,174,54,120,161,48,113
198367,35,241,91,150,91,36,55,150,55,95
198376,35,183,39,144,56,23,33,127,16,111
198385,35,16,8,8,16,8,8,,,
198419,35,59,22,37,59,22,37,,,
198455,35,194,65,129,43,19,24,151,46,105
198464,35,1641,755,886,1198,582,616,443,173,270
198491,35,46,7,39,10,1,9,36,6,30
198507,35,223,106,117,186,96,90,37,10,27
198516,35,96,56,40,96,56,40,,,
198534,35,1491,605,886,567,212,355,924,393,531
198543,35,1020,293,727,754,222,532,266,71,195
198552,35,890,273,617,263,106,157,627,167,460
198561,35,241,58,183,136,47,89,105,11,94
198570,35,37,7,30,7,0,7,30,7,23
198598,35,41,32,9,41,32,9,,,
198613,35,43,25,18,43,25,18,,,
198622,35,1008,392,616,427,193,234,581,199,382
198640,35,47,7,40,8,1,7,39,6,33
198668,35,101,30,71,38,14,24,63,16,47
198677,35,11,4,7,7,3,4,4,1,3
198695,35,70,49,21,70,49,21,,,
198710,35,183,49,134,61,15,46,122,34,88
198729,35,66,17,49,33,8,25,33,9,24
198756,35,56,27,29,55,27,28,1,0,1
198774,35,198,58,140,79,25,54,119,33,86
198808,35,105,27,78,98,27,71,7,0,7
198817,35,335,106,229,125,45,80,210,61,149
198835,35,55,26,29,53,26,27,2,0,2
198862,35,36,26,10,35,25,10,1,1,0
198871,35,40,34,6,40,34,6,,,
198899,35,82,38,44,70,34,36,12,4,8
198914,35,7,4,3,2,2,0,5,2,3
198923,35,36,6,30,7,2,5,29,4,25
198950,35,49,0,49,38,0,38,11,0,11
198969,35,170,79,91,121,60,61,49,19,30
198987,35,102,26,76,39,9,30,63,17,46
199023,35,23,14,9,17,11,6,6,3,3
199032,35,59,40,19,50,35,15,9,5,4
199069,35,233,72,161,138,58,80,95,14,81
199087,35,3,1,2,1,1,0,2,0,2
199102,35,663,270,393,568,227,341,95,43,52
199111,35,275,123,152,233,102,131,42,21,21
199120,35,989,460,529,973,454,519,16,6,10
199139,35,2249,1128,1121,1891,975,916,358,153,205
199148,35,1493,483,1010,1110,384,726,383,99,284
199157,35,398,125,273,320,106,214,78,19,59
199184,35,36,19,17,36,19,17,,,
199193,35,1284,731,553,1186,670,516,98,61,37
199209,35,91,34,57,66,29,37,25,5,20
199218,35,1701,600,1101,1297,518,779,404,82,322
199263,35,32,3,29,5,0,5,27,3,24
199272,35,68,44,24,53,39,14,15,5,10
199281,35,730,249,481,507,186,321,223,63,160
199306,35,58,33,25,51,28,23,7,5,2
199324,35,25,9,16,4,2,2,21,7,14
199333,35,690,209,481,375,137,238,315,72,243
199412,35,117,26,91,114,25,89,3,1,2
199421,35,64,19,45,24,6,18,40,13,27
199449,35,136,29,107,44,16,28,92,13,79
199458,35,14,10,4,13,9,4,1,1,0
199467,35,20,5,15,5,3,2,15,2,13
199476,35,378,70,308,121,16,105,257,54,203
199485,35,71,21,50,16,8,8,55,13,42
199494,35,255,74,181,73,28,45,182,46,136
199582,35,84,39,45,73,33,40,11,6,5
199607,35,23,1,22,18,0,18,5,1,4
199625,35,66,19,47,21,11,10,45,8,37
199634,35,197,55,142,74,27,47,123,28,95
199643,35,97,43,54,95,42,53,2,1,1
199698,35,90,33,57,70,32,38,20,1,19
199722,35,24,6,18,8,4,4,16,2,14
199731,35,179,61,118,46,16,30,133,45,88
199740,35,194,44,150,38,12,26,156,32,124
199759,35,62,38,24,48,29,19,14,9,5
199768,35,71,31,40,31,15,16,40,16,24
199786,35,132,50,82,43,20,23,89,30,59
199795,35,25,11,14,10,5,5,15,6,9
199838,35,161,38,123,39,9,30,122,29,93
199847,35,30,13,17,30,13,17,,,
199856,35,2147,904,1243,854,400,454,1293,504,789
199865,35,39,11,28,39,11,28,,,
199883,35,40,6,34,40,6,34,,,
199892,35,147,59,88,44,23,21,103,36,67
199908,35,264,59,205,87,20,67,177,39,138
199926,35,41,15,26,17,10,7,24,5,19
199953,35,82,18,64,31,8,23,51,10,41
199962,35,116,42,74,114,41,73,2,1,1
199971,35,15,15,0,15,15,0,,,
199999,35,372,95,277,260,79,181,112,16,96
200004,35,1050,436,614,639,282,357,411,154,257
200013,35,86,10,76,44,5,39,42,5,37
200022,35,272,164,108,179,108,71,93,56,37
200059,35,159,51,108,132,47,85,27,4,23
200086,35,17,10,7,13,9,4,4,1,3
200156,35,53,36,17,52,36,16,1,0,1
200192,35,111,32,79,69,22,47,42,10,32
200208,35,6,2,4,4,1,3,2,1,1
200217,35,108,52,56,102,47,55,6,5,1
200226,35,138,35,103,91,28,63,47,7,40
200253,35,256,79,177,185,59,126,71,20,51
200280,35,921,472,449,493,230,263,428,242,186
200305,35,128,71,57,114,67,47,14,4,10
200314,35,66,20,46,39,16,23,27,4,23
200332,35,543,264,279,458,243,215,85,21,64
200341,35,53,19,34,37,17,20,16,2,14
200466,35,12,4,8,10,3,7,2,1,1
200484,35,22,8,14,18,8,10,4,0,4
200527,35,12,5,7,10,3,7,2,2,0
200554,35,85,28,57,81,26,55,4,2,2
200572,35,94,41,53,61,29,32,33,12,21
200590,35,72,13,59,66,10,56,6,3,3
200785,35,8,2,6,5,1,4,3,1,2
200800,35,383,180,203,305,146,159,78,34,44
200873,35,1,1,0,1,1,0,,,
201061,35,16,6,10,15,6,9,1,0,1
201104,35,144,60,84,105,48,57,39,12,27
201140,35,10,10,0,,,,10,10,0
201177,35,37,2,35,12,1,11,25,1,24
201195,35,125,52,73,119,52,67,6,0,6
201283,35,26,12,14,16,9,7,10,3,7
201371,35,21,14,7,17,11,6,4,3,1
201432,35,44,14,30,33,10,23,11,4,7
201441,35,457,234,223,399,202,197,58,32,26
201469,35,145,31,114,131,28,103,14,3,11
201548,35,90,23,67,88,23,65,2,0,2
201645,35,61,34,27,58,32,26,3,2,1
201654,35,109,52,57,107,51,56,2,1,1
201672,35,247,69,178,79,25,54,168,44,124
201690,35,443,150,293,208,89,119,235,61,174
201821,35,205,16,189,157,11,146,48,5,43
201867,35,54,9,45,54,9,45,,,
201885,35,1263,480,783,920,401,519,343,79,264
201928,35,779,313,466,341,157,184,438,156,282
201946,35,449,89,360,148,42,106,301,47,254
201955,35,286,92,194,186,71,115,100,21,79
201964,35,79,37,42,44,23,21,35,14,21
201973,35,508,179,329,127,49,78,381,130,251
202046,35,29,11,18,28,11,17,1,0,1
202073,35,2,0,2,2,0,2,,,
202134,35,897,400,497,678,314,364,219,86,133
202170,35,57,18,39,57,18,39,,,
202222,35,1476,650,826,536,234,302,940,416,524
202356,35,1078,420,658,415,193,222,663,227,436
202435,35,22,7,15,18,7,11,4,0,4
202480,35,196,99,97,191,99,92,5,0,5
202514,35,26,13,13,26,13,13,,,
202523,35,23,12,11,23,12,11,,,
202763,35,74,21,53,69,20,49,5,1,4
202806,35,981,386,595,274,109,165,707,277,430
202903,35,27,22,5,9,7,2,18,15,3
202912,35,90,5,85,39,4,35,51,1,50
203085,35,15,10,5,15,10,5,,,
203128,35,37,18,19,30,15,15,7,3,4
203155,35,294,154,140,239,133,106,55,21,34
203331,35,678,178,500,265,70,195,413,108,305
203368,35,61,40,21,59,39,20,2,1,1
203386,35,636,50,586,531,46,485,105,4,101
203447,35,64,27,37,16,8,8,48,19,29
203456,35,35,6,29,1,0,1,34,6,28
203465,35,161,63,98,82,39,43,79,24,55
203474,35,80,39,41,29,17,12,51,22,29
203483,35,86,37,49,29,15,14,57,22,35
203492,35,70,11,59,27,4,23,43,7,36
203517,35,835,371,464,729,329,400,106,42,64
203526,35,114,45,69,39,18,21,75,27,48
203535,35,20,9,11,20,9,11,,,
203544,35,102,15,87,51,6,45,51,9,42
203580,35,40,23,17,39,23,16,1,0,1
203599,35,212,68,144,74,31,43,138,37,101
203678,35,161,42,119,62,22,40,99,20,79
203720,35,37,22,15,36,21,15,1,1,0
203748,35,329,126,203,105,51,54,224,75,149
203757,35,56,31,25,51,30,21,5,1,4
203775,35,58,34,24,43,27,16,15,7,8
203845,35,19,10,9,19,10,9,,,
203881,35,92,26,66,37,13,24,55,13,42
203960,35,227,27,200,56,7,49,171,20,151
204006,35,141,71,70,96,47,49,45,24,21
204015,35,67,26,41,47,17,30,20,9,11
204024,35,226,116,110,220,113,107,6,3,3
204176,35,174,25,149,119,19,100,55,6,49
204185,35,45,22,23,43,20,23,2,2,0
204194,35,105,34,71,35,14,21,70,20,50
204200,35,54,23,31,49,22,27,5,1,4
204255,35,47,22,25,22,12,10,25,10,15
204264,35,95,23,72,48,17,31,47,6,41
204422,35,70,19,51,32,11,21,38,8,30
204440,35,35,18,17,16,8,8,19,10,9
204468,35,133,59,74,105,54,51,28,5,23
204486,35,117,85,32,110,83,27,7,2,5
204501,35,9,3,6,9,3,6,,,
204617,35,55,26,29,55,26,29,,,
204635,35,51,27,24,50,27,23,1,0,1
204662,35,18,8,10,15,7,8,3,1,2
204671,35,43,19,24,34,15,19,9,4,5
204680,35,48,22,26,32,12,20,16,10,6
204699,35,54,26,28,42,21,21,12,5,7
204705,35,122,62,60,86,44,42,36,18,18
204796,35,3461,1850,1611,3145,1722,1423,316,128,188
204802,35,19,8,11,17,6,11,2,2,0
204820,35,39,15,24,30,11,19,9,4,5
204839,35,42,11,31,26,6,20,16,5,11
204848,35,29,12,17,19,9,10,10,3,7
204857,35,879,253,626,454,181,273,425,72,353
204866,35,40,10,30,26,7,19,14,3,11
204884,35,48,1,47,48,1,47,,,
204909,35,26,10,16,26,10,16,,,
204936,35,76,34,42,75,33,42,1,1,0
204945,35,383,161,222,169,79,90,214,82,132
205027,35,15,15,0,15,15,0,,,
205054,35,44,3,41,44,3,41,,,
205124,35,1,1,0,1,1,0,,,
205179,35,66,11,55,64,11,53,2,0,2
205203,35,122,26,96,58,19,39,64,7,57
205443,35,149,69,80,125,60,65,24,9,15
205470,35,1498,694,804,327,156,171,1171,538,633
205559,35,1,0,1,1,0,1,,,
205841,35,616,241,375,241,105,136,375,136,239
205887,35,10,5,5,10,5,5,,,
205957,35,160,81,79,126,63,63,34,18,16
205966,35,71,22,49,22,5,17,49,17,32
206011,35,66,30,36,40,20,20,26,10,16
206048,35,132,72,60,101,64,37,31,8,23
206084,35,572,274,298,454,223,231,118,51,67
206154,35,7,4,3,,,,7,4,3
206279,35,108,47,61,41,13,28,67,34,33
206349,35,68,10,58,58,9,49,10,1,9
206394,35,6,1,5,2,0,2,4,1,3
206437,35,70,32,38,57,30,27,13,2,11
206446,35,72,31,41,38,24,14,34,7,27
206491,35,30,18,12,28,17,11,2,1,1
206507,35,48,22,26,44,21,23,4,1,3
206525,35,24,11,13,23,11,12,1,0,1
206589,35,16,10,6,16,10,6,,,
206604,35,705,321,384,551,266,285,154,55,99
206613,35,129,65,64,38,18,20,91,47,44
206622,35,125,44,81,103,40,63,22,4,18
206695,35,353,141,212,262,115,147,91,26,65
206817,35,13,7,6,11,5,6,2,2,0
206835,35,74,42,32,63,39,24,11,3,8
206862,35,66,36,30,63,35,28,3,1,2
206914,35,257,89,168,202,71,131,55,18,37
206923,35,28,10,18,21,9,12,7,1,6
206932,35,1,0,1,,,,1,0,1
206941,35,1072,430,642,790,325,465,282,105,177
207041,35,816,278,538,629,221,408,187,57,130
207050,35,60,17,43,30,14,16,30,3,27
207069,35,193,59,134,102,39,63,91,20,71
207157,35,31,21,10,27,19,8,4,2,2
207209,35,73,37,36,69,35,34,4,2,2
207236,35,104,35,69,57,26,31,47,9,38
207254,35,24,21,3,24,21,3,,,
207263,35,767,287,480,538,217,321,229,70,159
207281,35,127,51,76,71,34,37,56,17,39
207306,35,164,61,103,135,56,79,29,5,24
207324,35,188,65,123,163,61,102,25,4,21
207342,35,572,62,510,557,62,495,15,0,15
207351,35,309,81,228,212,66,146,97,15,82
207388,35,1623,778,845,1352,661,691,271,117,154
207397,35,490,165,325,99,47,52,391,118,273
207403,35,51,36,15,51,36,15,,,
207449,35,698,368,330,180,94,86,518,274,244
207458,35,179,49,130,174,46,128,5,3,2
207500,35,1007,522,485,824,431,393,183,91,92
207564,35,218,123,95,109,70,39,109,53,56
207582,35,230,92,138,179,76,103,51,16,35
207661,35,270,86,184,197,63,134,73,23,50
207670,35,200,76,124,63,28,35,137,48,89
207722,35,90,41,49,87,41,46,3,0,3
207740,35,111,31,80,75,24,51,36,7,29
207847,35,31,15,16,15,8,7,16,7,9
207856,35,41,27,14,36,22,14,5,5,0
207865,35,454,138,316,346,119,227,108,19,89
207935,35,834,286,548,249,102,147,585,184,401
207971,35,119,59,60,109,52,57,10,7,3
208035,35,110,32,78,32,18,14,78,14,64
208275,35,86,37,49,71,33,38,15,4,11
208318,35,311,145,166,153,82,71,158,63,95
208390,35,153,61,92,141,55,86,12,6,6
208406,35,753,299,454,331,144,187,422,155,267
208415,35,19,2,17,12,1,11,7,1,6
208512,35,143,22,121,143,22,121,,,
208646,35,376,149,227,250,101,149,126,48,78
208725,35,4,2,2,3,2,1,1,0,1
208822,35,146,58,88,118,48,70,28,10,18
209038,35,697,318,379,336,167,169,361,151,210
209056,35,51,20,31,51,20,31,,,
209065,35,139,48,91,111,40,71,28,8,20
209074,35,804,344,460,219,113,106,585,231,354
209241,35,7,7,0,7,7,0,,,
209250,35,75,22,53,32,7,25,43,15,28
209287,35,97,58,39,88,56,32,9,2,7
209409,35,48,25,23,47,24,23,1,1,0
209490,35,321,52,269,259,42,217,62,10,52
209506,35,409,175,234,254,114,140,155,61,94
209542,35,2578,1198,1380,1692,796,896,886,402,484
209551,35,940,456,484,837,405,432,103,51,52
209603,35,53,11,42,51,11,40,2,0,2
209612,35,125,41,84,113,39,74,12,2,10
209746,35,1219,491,728,605,254,351,614,237,377
209807,35,2201,889,1312,1778,723,1055,423,166,257
209825,35,106,49,57,106,49,57,,,
209922,35,14,8,6,14,8,6,,,
209940,35,94,30,64,48,14,34,46,16,30
210146,35,293,92,201,246,88,158,47,4,43
210155,35,77,31,46,56,25,31,21,6,15
210234,35,141,76,65,114,68,46,27,8,19
210270,35,92,27,65,20,5,15,72,22,50
210304,35,90,35,55,77,33,44,13,2,11
210331,35,77,40,37,68,36,32,9,4,5
210401,35,38,12,26,37,12,25,1,0,1
210429,35,412,156,256,338,132,206,74,24,50
210492,35,27,13,14,26,12,14,1,1,0
210571,35,54,30,24,54,30,24,,,
210599,35,141,70,71,141,70,71,,,
210605,35,263,119,144,141,67,74,122,52,70
210669,35,12,6,6,12,6,6,,,
210739,35,89,34,55,60,25,35,29,9,20
210775,35,66,40,26,66,40,26,,,
211024,35,37,16,21,23,10,13,14,6,8
211079,35,42,12,30,20,9,11,22,3,19
211088,35,59,24,35,57,23,34,2,1,1
211273,35,11,0,11,11,0,11,,,
211291,35,18,10,8,18,10,8,,,
211307,35,321,100,221,117,44,73,204,56,148
211343,35,204,90,114,124,63,61,80,27,53
211352,35,49,24,25,45,22,23,4,2,2
211431,35,172,24,148,104,16,88,68,8,60
211440,35,62,41,21,61,40,21,1,1,0
211468,35,100,14,86,60,10,50,40,4,36
211477,35,81,43,38,16,7,9,65,36,29
211556,35,68,29,39,63,28,35,5,1,4
211583,35,120,43,77,104,41,63,16,2,14
211608,35,58,12,46,33,9,24,25,3,22
211893,35,5,4,1,5,4,1,,,
211927,35,341,122,219,111,55,56,230,67,163
211981,35,106,45,61,106,45,61,,,
212009,35,10,6,4,10,6,4,,,
212045,35,47,13,34,47,13,34,,,
212054,35,574,228,346,455,192,263,119,36,83
212106,35,212,96,116,212,96,116,,,
212115,35,333,142,191,299,134,165,34,8,26
212133,35,195,49,146,70,19,51,125,30,95
212197,35,61,29,32,47,25,22,14,4,10
212577,35,14,10,4,14,10,4,,,
212601,35,84,47,37,80,46,34,4,1,3
212656,35,42,24,18,37,22,15,5,2,3
212674,35,13,6,7,13,6,7,,,
212771,35,45,0,45,20,0,20,25,0,25
212805,35,43,25,18,43,25,18,,,
212832,35,98,24,74,94,23,71,4,1,3
212869,35,201,26,175,111,15,96,90,11,79
212878,35,790,311,479,362,156,206,428,155,273
212911,35,12,5,7,12,5,7,,,
212975,35,1,1,0,1,1,0,,,
212984,35,220,55,165,212,51,161,8,4,4
212993,35,3,0,3,1,0,1,2,0,2
213011,35,78,24,54,57,17,40,21,7,14
213020,35,267,120,147,245,108,137,22,12,10
213181,35,44,4,40,40,4,36,4,0,4
213233,35,87,56,31,73,48,25,14,8,6
213251,35,24,12,12,24,12,12,,,
213303,35,76,38,38,58,36,22,18,2,16
213321,35,57,34,23,57,34,23,,,
213349,35,387,170,217,343,157,186,44,13,31
213358,35,82,38,44,54,29,25,28,9,19
213367,35,124,36,88,77,33,44,47,3,44
213376,35,257,99,158,185,86,99,72,13,59
213385,35,19,12,7,19,12,7,,,
213400,35,121,60,61,94,42,52,27,18,9
213507,35,52,22,30,50,21,29,2,1,1
213525,35,236,83,153,100,48,52,136,35,101
213534,35,13,10,3,13,10,3,,,
213543,35,53,33,20,53,33,20,,,
213570,35,5,0,5,5,0,5,,,
213589,35,1,1,0,1,1,0,,,
213598,35,52,19,33,43,18,25,9,1,8
213659,35,214,82,132,117,51,66,97,31,66
213668,35,25,17,8,24,16,8,1,1,0
213774,35,50,16,34,36,13,23,14,3,11
213826,35,89,23,66,84,22,62,5,1,4
213914,35,26,2,24,26,2,24,,,
213987,35,87,43,44,82,42,40,5,1,4
213996,35,81,23,58,74,21,53,7,2,5
214023,35,2,1,1,2,1,1,,,
214041,35,413,159,254,262,120,142,151,39,112
214069,35,63,21,42,49,16,33,14,5,9
214111,35,651,237,414,234,109,125,417,128,289
214148,35,15,0,15,15,0,15,,,
214157,35,119,43,76,98,41,57,21,2,19
214166,35,110,29,81,101,28,73,9,1,8
214175,35,42,13,29,42,13,29,,,
214272,35,57,27,30,53,27,26,4,0,4
214379,35,518,162,356,207,73,134,311,89,222
214582,35,37,2,35,20,1,19,17,1,16
214591,35,59,40,19,54,36,18,5,4,1
214625,35,31,20,11,24,16,8,7,4,3
214634,35,25,7,18,18,5,13,7,2,5
214643,35,32,21,11,31,20,11,1,1,0
214652,35,41,21,20,37,20,17,4,1,3
214670,35,68,34,34,63,33,30,5,1,4
214689,35,93,46,47,91,45,46,2,1,1
214698,35,26,13,13,23,11,12,3,2,1
214704,35,104,58,46,91,54,37,13,4,9
214713,35,238,133,105,216,120,96,22,13,9
214731,35,52,21,31,43,19,24,9,2,7
214740,35,11,7,4,10,7,3,1,0,1
214759,35,19,11,8,18,10,8,1,1,0
214768,35,36,14,22,32,12,20,4,2,2
214777,35,432,238,194,421,231,190,11,7,4
214786,35,20,11,9,19,10,9,1,1,0
214795,35,38,12,26,31,11,20,7,1,6
214801,35,184,102,82,166,97,69,18,5,13
214810,35,24,9,15,20,8,12,4,1,3
214829,35,48,28,20,41,25,16,7,3,4
214883,35,95,19,76,14,2,12,81,17,64
214892,35,34,14,20,34,14,20,,,
214971,35,11,4,7,11,4,7,,,
215053,35,24,11,13,22,11,11,2,0,2
215062,35,113,53,60,113,53,60,,,
215105,35,57,21,36,56,20,36,1,1,0
215114,35,38,19,19,36,19,17,2,0,2
215239,35,392,137,255,158,62,96,234,75,159
215266,35,59,29,30,52,29,23,7,0,7
215275,35,93,38,55,88,35,53,5,3,2
215284,35,122,57,65,120,57,63,2,0,2
215293,35,881,452,429,726,376,350,155,76,79
215309,35,4,1,3,1,0,1,3,1,2
215381,35,23,21,2,23,21,2,,,
215390,35,79,19,60,18,3,15,61,16,45
215415,35,164,85,79,140,75,65,24,10,14
215442,35,209,93,116,174,80,94,35,13,22
215585,35,282,83,199,85,31,54,197,52,145
215655,35,166,100,66,149,91,58,17,9,8
215682,35,33,31,2,33,31,2,,,
215691,35,66,31,35,35,22,13,31,9,22
215743,35,43,24,19,35,21,14,8,3,5
215770,35,110,55,55,92,49,43,18,6,12
215798,35,50,32,18,48,30,18,2,2,0
215929,35,59,28,31,51,21,30,8,7,1
215947,35,77,15,62,56,12,44,21,3,18
215992,35,22,4,18,22,4,18,,,
216010,35,244,115,129,214,102,112,30,13,17
216038,35,475,244,231,375,184,191,100,60,40
216047,35,1,1,0,1,1,0,,,
216083,35,27,8,19,24,8,16,3,0,3
216278,35,28,18,10,28,18,10,,,
216287,35,3,0,3,3,0,3,,,
216296,35,94,83,11,94,83,11,,,
216311,35,2,2,0,2,2,0,,,
216339,35,1230,600,630,1134,556,578,96,44,52
216357,35,19,11,8,19,11,8,,,
216366,35,719,149,570,578,118,460,141,31,110
216436,35,18,16,2,18,16,2,,,
216445,35,13,11,2,13,11,2,,,
216454,35,1,1,0,1,1,0,,,
216524,35,26,13,13,26,13,13,,,
216542,35,31,20,11,29,19,10,2,1,1
216551,35,13,10,3,12,9,3,1,1,0
216597,35,88,30,58,81,27,54,7,3,4
216667,35,24,16,8,24,16,8,,,
216694,35,29,16,13,25,14,11,4,2,2
216764,35,1021,448,573,826,398,428,195,50,145
216807,35,22,13,9,22,13,9,,,
216825,35,155,56,99,67,28,39,88,28,60
216852,35,162,41,121,130,35,95,32,6,26
216931,35,106,41,65,91,40,51,15,1,14
216940,35,8,8,0,8,8,0,,,
217013,35,45,10,35,24,8,16,21,2,19
217059,35,151,64,87,124,58,66,27,6,21
217077,35,83,31,52,83,31,52,,,
217156,35,112,54,58,112,54,58,,,
217165,35,78,50,28,78,50,28,,,
217235,35,151,68,83,141,63,78,10,5,5
217305,35,183,75,108,163,67,96,20,8,12
217402,35,101,54,47,75,43,32,26,11,15
217420,35,530,178,352,415,146,269,115,32,83
217475,35,515,198,317,141,61,80,374,137,237
217484,35,603,289,314,534,264,270,69,25,44
217493,35,14,4,10,14,4,10,,,
217518,35,476,244,232,290,139,151,186,105,81
217536,35,46,18,28,39,18,21,7,0,7
217606,35,21,4,17,18,4,14,3,0,3
217615,35,178,52,126,80,28,52,98,24,74
217624,35,33,10,23,33,10,23,,,
217633,35,130,60,70,108,50,58,22,10,12
217688,35,279,127,152,246,110,136,33,17,16
217712,35,124,31,93,33,15,18,91,16,75
217721,35,86,44,42,84,43,41,2,1,1
217749,35,88,41,47,87,41,46,1,0,1
217776,35,108,50,58,73,44,29,35,6,29
217819,35,546,245,301,512,235,277,34,10,24
217837,35,43,5,38,17,3,14,26,2,24
217864,35,110,80,30,81,62,19,29,18,11
217873,35,86,25,61,83,25,58,3,0,3
217882,35,1621,881,740,1577,853,724,44,28,16
217891,35,13,10,3,13,10,3,,,
217907,35,93,31,62,87,30,57,6,1,5
217925,35,49,23,26,49,23,26,,,
217934,35,185,30,155,130,23,107,55,7,48
217961,35,70,24,46,69,24,45,1,0,1
217998,35,66,52,14,63,50,13,3,2,1
218025,35,197,65,132,105,46,59,92,19,73
218061,35,174,74,100,164,70,94,10,4,6
218070,35,36,17,19,36,17,19,,,
218113,35,682,252,430,302,118,184,380,134,246
218140,35,590,212,378,288,126,162,302,86,216
218229,35,236,83,153,205,77,128,31,6,25
218238,35,171,78,93,139,63,76,32,15,17
218335,35,102,10,92,98,10,88,4,0,4
218353,35,839,299,540,425,176,249,414,123,291
218399,35,45,24,21,44,23,21,1,1,0
218414,35,90,42,48,83,40,43,7,2,5
218441,35,147,62,85,136,60,76,11,2,9
218487,35,167,40,127,63,26,37,104,14,90
218520,35,387,94,293,111,33,78,276,61,215
218539,35,34,19,15,34,19,15,,,
218645,35,406,147,259,312,123,189,94,24,70
218654,35,205,69,136,172,63,109,33,6,27
218663,35,1315,653,662,1236,624,612,79,29,50
218672,35,49,17,32,37,14,23,12,3,9
218681,35,27,11,16,21,9,12,6,2,4
218690,35,78,42,36,50,27,23,28,15,13
218706,35,25,10,15,19,6,13,6,4,2
218724,35,586,298,288,558,285,273,28,13,15
218733,35,118,51,67,108,48,60,10,3,7
218742,35,552,186,366,453,163,290,99,23,76
218821,35,54,27,27,46,25,21,8,2,6
218830,35,632,204,428,277,99,178,355,105,250
218858,35,135,39,96,36,13,23,99,26,73
218885,35,264,123,141,162,88,74,102,35,67
218894,35,1068,373,695,414,169,245,654,204,450
218919,35,107,45,62,100,41,59,7,4,3
218955,35,40,1,39,13,1,12,27,0,27
218964,35,230,96,134,215,91,124,15,5,10
218973,35,31,16,15,30,16,14,1,0,1
218991,35,283,107,176,141,61,80,142,46,96
219000,35,53,26,27,51,25,26,2,1,1
219046,35,164,60,104,121,46,75,43,14,29
219082,35,212,155,57,127,91,36,85,64,21
219091,35,69,29,40,47,28,19,22,1,21
219143,35,114,51,63,86,44,42,28,7,21
219189,35,109,37,72,81,31,50,28,6,22
219198,35,63,37,26,53,31,22,10,6,4
219204,35,61,32,29,8,7,1,53,25,28
219240,35,11,6,5,1,0,1,10,6,4
219259,35,67,26,41,50,23,27,17,3,14
219277,35,54,17,37,31,10,21,23,7,16
219295,35,114,35,79,78,32,46,36,3,33
219347,35,69,57,12,55,48,7,14,9,5
219356,35,414,171,243,315,147,168,99,24,75
219374,35,8,2,6,3,0,3,5,2,3
219383,35,104,46,58,72,34,38,32,12,20
219408,35,14,8,6,11,6,5,3,2,1
219426,35,312,151,161,190,106,84,122,45,77
219471,35,296,113,183,228,93,135,68,20,48
219480,35,95,38,57,51,24,27,44,14,30
219505,35,4,3,1,3,2,1,1,1,0
219602,35,723,337,386,438,185,253,285,152,133
219639,35,115,6,109,51,2,49,64,4,60
219709,35,393,151,242,371,136,235,22,15,7
219718,35,950,526,424,694,391,303,256,135,121
219790,35,70,40,30,50,30,20,20,10,10
219806,35,104,45,59,103,44,59,1,1,0
219824,35,324,113,211,170,69,101,154,44,110
219833,35,48,21,27,47,21,26,1,0,1
219879,35,103,42,61,69,30,39,34,12,22
219888,35,241,96,145,147,71,76,94,25,69
219949,35,124,61,63,111,60,51,13,1,12
219976,35,200,91,109,189,85,104,11,6,5
220002,35,1,0,1,1,0,1,,,
220057,35,174,59,115,82,34,48,92,25,67
220075,35,1049,411,638,835,353,482,214,58,156
220118,35,111,4,107,111,4,107,,,
220181,35,44,14,30,42,13,29,2,1,1
220206,35,17,9,8,16,8,8,1,1,0
220215,35,59,35,24,56,33,23,3,2,1
220400,35,158,52,106,62,27,35,96,25,71
220464,35,60,16,44,18,7,11,42,9,33
220473,35,68,26,42,65,25,40,3,1,2
220516,35,163,52,111,144,49,95,19,3,16
220552,35,1338,153,1185,884,113,771,454,40,414
220598,35,74,49,25,65,42,23,9,7,2
220604,35,81,27,54,76,24,52,5,3,2
220613,35,155,60,95,141,52,89,14,8,6
220631,35,222,34,188,163,27,136,59,7,52
220701,35,104,52,52,98,51,47,6,1,5
220710,35,58,25,33,58,25,33,,,
220862,35,1120,407,713,733,274,459,387,133,254
220978,35,1604,727,877,1329,611,718,275,116,159
221096,35,344,143,201,155,78,77,189,65,124
221148,35,6,5,1,6,5,1,,,
221184,35,499,169,330,215,81,134,284,88,196
221351,35,5,4,1,5,4,1,,,
221397,35,177,56,121,83,33,50,94,23,71
221485,35,322,95,227,162,48,114,160,47,113
221519,35,15,9,6,15,9,6,,,
221643,35,387,191,196,215,123,92,172,68,104
221661,35,152,59,93,138,56,82,14,3,11
221731,35,126,41,85,113,39,74,13,2,11
221740,35,704,318,386,615,280,335,89,38,51
221759,35,1616,849,767,1496,796,700,120,53,67
221768,35,373,149,224,324,136,188,49,13,36
221838,35,288,95,193,219,75,144,69,20,49
221847,35,559,288,271,508,266,242,51,22,29
221892,35,67,29,38,67,29,38,,,
221908,35,255,88,167,175,58,117,80,30,50
221953,35,52,30,22,44,28,16,8,2,6
221971,35,157,43,114,131,36,95,26,7,19
221999,35,243,112,131,242,112,130,1,0,1
222053,35,373,135,238,182,79,103,191,56,135
222062,35,167,71,96,101,49,52,66,22,44
222105,35,1,1,0,1,1,0,,,
222178,35,117,57,60,117,57,60,,,
222567,35,927,326,601,206,92,114,721,234,487
222576,35,196,69,127,83,34,49,113,35,78
222628,35,25,9,16,11,4,7,14,5,9
222822,35,149,59,90,84,36,48,65,23,42
222831,35,386,182,204,323,154,169,63,28,35
222877,35,28,18,10,28,18,10,,,
222938,35,41,18,23,25,15,10,16,3,13
222983,35,34,19,15,34,19,15,,,
222992,35,3121,1413,1708,1028,517,511,2093,896,1197
223083,35,140,15,125,23,5,18,117,10,107
223117,35,3,3,0,1,1,0,2,2,0
223232,35,367,158,209,364,155,209,3,3,0
223320,35,191,51,140,45,15,30,146,36,110
223427,35,2770,1356,1414,1553,804,749,1217,552,665
223463,35,4,2,2,4,2,2,,,
223472,35,29,2,27,29,2,27,,,
223506,35,157,63,94,40,16,24,117,47,70
223816,35,397,158,239,100,34,66,297,124,173
223898,35,201,86,115,107,55,52,94,31,63
223922,35,150,61,89,86,30,56,64,31,33
224004,35,185,55,130,137,44,93,48,11,37
224110,35,1312,504,808,331,143,188,981,361,620
224147,35,644,264,380,406,177,229,238,87,151
224226,35,161,66,95,142,58,84,19,8,11
224244,35,35,23,12,31,20,11,4,3,1
224271,35,380,74,306,377,71,306,3,3,0
224323,35,44,36,8,44,36,8,,,
224350,35,250,87,163,53,20,33,197,67,130
224527,35,105,55,50,87,51,36,18,4,14
224545,35,322,117,205,234,84,150,88,33,55
224554,35,1075,384,691,769,272,497,306,112,194
224615,35,2405,1082,1323,987,532,455,1418,550,868
224642,35,905,397,508,343,174,169,562,223,339
224660,35,45,20,25,36,20,16,9,0,9
224679,35,42,39,3,11,11,0,31,28,3
224776,35,52,25,27,32,15,17,20,10,10
224891,35,36,22,14,29,20,9,7,2,5
224961,35,171,73,98,71,34,37,100,39,61
225070,35,297,110,187,141,56,85,156,54,102
225201,35,189,112,77,189,112,77,,,
225247,35,78,36,42,76,36,40,2,0,2
225308,35,568,187,381,206,80,126,362,107,255
225371,35,118,42,76,53,24,29,65,18,47
225399,35,273,107,166,130,70,60,143,37,106
225414,35,1046,402,644,644,256,388,402,146,256
225423,35,4026,1579,2447,1561,670,891,2465,909,1556
225432,35,1994,704,1290,849,343,506,1145,361,784
225502,35,424,140,284,173,67,106,251,73,178
225511,35,4434,2159,2275,2800,1348,1452,1634,811,823
225520,35,116,43,73,56,27,29,60,16,44
225548,35,56,32,24,50,29,21,6,3,3
225575,35,95,39,56,93,37,56,2,2,0
225627,35,369,147,222,306,123,183,63,24,39
225876,35,13,5,8,13,5,8,,,
225885,35,51,23,28,45,21,24,6,2,4
225991,35,37,21,16,37,21,16,,,
226019,35,255,101,154,145,66,79,110,35,75
226091,35,760,305,455,464,191,273,296,114,182
226107,35,116,29,87,64,15,49,52,14,38
226116,35,235,63,172,103,37,66,132,26,106
226134,35,139,55,84,34,21,13,105,34,71
226152,35,479,183,296,346,135,211,133,48,85
226204,35,242,115,127,36,20,16,206,95,111
226231,35,90,46,44,72,42,30,18,4,14
226277,35,4,4,0,4,4,0,,,
226383,35,140,67,73,131,64,67,9,3,6
226408,35,295,101,194,78,38,40,217,63,154
226471,35,190,86,104,173,82,91,17,4,13
226578,35,302,106,196,147,60,87,155,46,109
226587,35,119,59,60,102,57,45,17,2,15
226806,35,172,62,110,69,30,39,103,32,71
226833,35,467,137,330,317,107,210,150,30,120
226879,35,5,0,5,2,0,2,3,0,3
227146,35,284,109,175,155,70,85,129,39,90
227182,35,3320,1288,2032,1372,618,754,1948,670,1278
227216,35,3752,1720,2032,2675,1243,1432,1077,477,600
227225,35,155,41,114,87,24,63,68,17,51
227304,35,509,168,341,199,74,125,310,94,216
227331,35,129,38,91,112,37,75,17,1,16
227368,35,1415,589,826,1008,413,595,407,176,231
227377,35,148,59,89,53,26,27,95,33,62
227386,35,164,47,117,119,41,78,45,6,39
227401,35,226,81,145,132,60,72,94,21,73
227429,35,161,36,125,18,9,9,143,27,116
227526,35,614,235,379,539,197,342,75,38,37
227687,35,149,69,80,109,58,51,40,11,29
227757,35,34,25,9,34,25,9,,,
227845,35,216,97,119,200,92,108,16,5,11
227854,35,710,251,459,83,34,49,627,217,410
227863,35,182,76,106,161,72,89,21,4,17
227881,35,2048,814,1234,1428,592,836,620,222,398
227924,35,1286,499,787,258,108,150,1028,391,637
227979,35,1167,418,749,333,139,194,834,279,555
228042,35,63,24,39,61,24,37,2,0,2
228149,35,88,38,50,86,38,48,2,0,2
228158,35,398,178,220,257,127,130,141,51,90
228246,35,269,134,135,260,131,129,9,3,6
228316,35,134,46,88,58,26,32,76,20,56
228325,35,145,84,61,136,79,57,9,5,4
228343,35,37,18,19,37,18,19,,,
228431,35,704,272,432,607,246,361,97,26,71
228459,35,2706,1223,1483,2051,956,1095,655,267,388
228468,35,33,15,18,25,13,12,8,2,6
228486,35,9,7,2,9,7,2,,,
228501,35,238,98,140,132,60,72,106,38,68
228529,35,1306,492,814,739,289,450,567,203,364
228547,35,1408,584,824,336,185,151,1072,399,673
228608,35,1147,284,863,389,116,273,758,168,590
228644,35,320,100,220,301,87,214,19,13,6
228653,35,177,28,149,133,22,111,44,6,38
228699,35,80,24,56,31,12,19,49,12,37
228705,35,307,133,174,260,110,150,47,23,24
228723,35,2548,1329,1219,2444,1283,1161,104,46,58
228769,35,4044,1371,2673,1853,773,1080,2191,598,1593
228778,35,2038,948,1090,1959,919,1040,79,29,50
228787,35,1764,975,789,1358,757,601,406,218,188
228796,35,1476,651,825,986,441,545,490,210,280
228802,35,956,377,579,620,281,339,336,96,240
228875,35,390,192,198,380,188,192,10,4,6
228884,35,100,67,33,100,67,33,,,
228909,35,5,3,2,,,,5,3,2
228981,35,50,23,27,49,23,26,1,0,1
229018,35,656,202,454,498,167,331,158,35,123
229027,35,2976,1497,1479,2167,1076,1091,809,421,388
229063,35,464,176,288,363,147,216,101,29,72
229115,35,2252,1083,1169,1992,983,1009,260,100,160
229160,35,196,87,109,167,76,91,29,11,18
229179,35,1240,122,1118,782,68,714,458,54,404
229267,35,22,13,9,22,13,9,,,
229300,35,42,5,37,39,5,34,3,0,3
229337,35,284,32,252,263,28,235,21,4,17
229355,35,703,240,463,311,129,182,392,111,281
229416,35,152,141,11,152,141,11,,,
229504,35,123,47,76,72,34,38,51,13,38
229540,35,145,44,101,48,19,29,97,25,72
229780,35,239,99,140,154,70,84,85,29,56
229799,35,310,87,223,116,47,69,194,40,154
229814,35,877,335,542,653,255,398,224,80,144
229832,35,12,4,8,6,3,3,6,1,5
229841,35,328,136,192,132,68,64,196,68,128
229887,35,61,28,33,57,27,30,4,1,3
230038,35,991,451,540,872,400,472,119,51,68
230047,35,178,72,106,177,72,105,1,0,1
230171,35,622,265,357,467,196,271,155,69,86
230366,35,30,0,30,30,0,30,,,
230418,35,641,272,369,399,179,220,242,93,149
230597,35,67,40,27,52,38,14,15,2,13
230603,35,582,284,298,394,206,188,188,78,110
230728,35,1193,498,695,863,382,481,330,116,214
230737,35,2378,1143,1235,1514,724,790,864,419,445
230746,35,2025,852,1173,675,303,372,1350,549,801
230764,35,1472,730,742,1099,570,529,373,160,213
230782,35,1007,344,663,599,233,366,408,111,297
230807,35,51,18,33,50,17,33,1,1,0
230816,35,13,3,10,13,3,10,,,
230834,35,107,51,56,100,50,50,7,1,6
230852,35,277,172,105,194,115,79,83,57,26
230861,35,398,112,286,80,31,49,318,81,237
230889,35,16,4,12,15,3,12,1,1,0
230913,35,86,23,63,46,17,29,40,6,34
230959,35,6,3,3,6,3,3,,,
230995,35,229,170,59,106,65,41,123,105,18
231059,35,24,11,13,24,11,13,,,
231095,35,11,1,10,11,1,10,,,
231165,35,304,85,219,252,73,179,52,12,40
231174,35,332,118,214,320,114,206,12,4,8
231411,35,5,5,0,5,5,0,,,
231420,35,141,49,92,114,46,68,27,3,24
231536,35,228,98,130,85,43,42,143,55,88
231554,35,59,26,33,54,25,29,5,1,4
231581,35,30,14,16,30,14,16,,,
231624,35,155,69,86,153,69,84,2,0,2
231651,35,1087,405,682,514,196,318,573,209,364
231697,35,128,36,92,37,18,19,91,18,73
231712,35,144,73,71,144,73,71,,,
231785,35,306,56,250,227,50,177,79,6,73
231873,35,27,11,16,13,8,5,14,3,11
231882,35,77,21,56,36,14,22,41,7,34
232025,35,69,45,24,65,44,21,4,1,3
232043,35,34,19,15,23,14,9,11,5,6
232052,35,15,5,10,7,2,5,8,3,5
232089,35,44,26,18,41,25,16,3,1,2
232186,35,2636,1308,1328,2057,1018,1039,579,290,289
232195,35,380,115,265,136,50,86,244,65,179
232256,35,38,38,0,38,38,0,,,
232265,35,148,54,94,99,42,57,49,12,37
232308,35,18,0,18,18,0,18,,,
232414,35,529,204,325,157,63,94,372,141,231
232423,35,761,344,417,643,326,317,118,18,100
232450,35,493,187,306,169,65,104,324,122,202
232557,35,5429,2351,3078,3161,1322,1839,2268,1029,1239
232566,35,138,48,90,129,46,83,9,2,7
232575,35,187,44,143,70,23,47,117,21,96
232609,35,77,30,47,70,26,44,7,4,3
232618,35,73,11,62,5,0,5,68,11,57
232672,35,110,18,92,76,11,65,34,7,27
232681,35,275,114,161,209,92,117,66,22,44
232706,35,177,49,128,169,47,122,8,2,6
232788,35,38,13,25,23,6,17,15,7,8
232797,35,173,27,146,71,14,57,102,13,89
232867,35,139,79,60,74,47,27,65,32,33
232885,35,27,2,25,23,2,21,4,0,4
232937,35,345,104,241,264,83,181,81,21,60
232946,35,1410,641,769,548,270,278,862,371,491
232982,35,1792,800,992,1226,543,683,566,257,309
233019,35,74,29,45,41,22,19,33,7,26
233037,35,63,14,49,31,9,22,32,5,27
233082,35,38,1,37,,,,38,1,37
233116,35,241,107,134,78,37,41,163,70,93
233277,35,560,209,351,455,182,273,105,27,78
233295,35,44,26,18,44,26,18,,,
233301,35,28,12,16,28,12,16,,,
233310,35,66,26,40,15,6,9,51,20,31
233329,35,69,5,64,69,5,64,,,
233338,35,38,19,19,33,17,16,5,2,3
233356,35,136,12,124,118,10,108,18,2,16
233374,35,92,42,50,60,28,32,32,14,18
233426,35,56,24,32,56,24,32,,,
233480,35,13,3,10,13,3,10,,,
233541,35,134,65,69,124,60,64,10,5,5
233602,35,8,6,2,8,6,2,,,
233611,35,72,39,33,69,39,30,3,0,3
233639,35,121,50,71,21,8,13,100,42,58
233648,35,103,30,73,54,17,37,49,13,36
233684,35,273,99,174,93,55,38,180,44,136
233718,35,15,0,15,15,0,15,,,
233754,35,403,170,233,152,69,83,251,101,150
233772,35,892,332,560,311,129,182,581,203,378
233897,35,90,55,35,89,55,34,1,0,1
233903,35,93,30,63,42,12,30,51,18,33
233921,35,997,621,376,973,606,367,24,15,9
233949,35,255,96,159,81,31,50,174,65,109
234030,35,1485,595,890,1249,503,746,236,92,144
234076,35,752,344,408,628,296,332,124,48,76
234085,35,14,13,1,14,13,1,,,
234137,35,274,83,191,241,55,186,33,28,5
234155,35,305,118,187,275,112,163,30,6,24
234164,35,126,65,61,101,58,43,25,7,18
234173,35,80,35,45,73,32,41,7,3,4
234207,35,1,0,1,1,0,1,,,
234377,35,69,11,58,28,5,23,41,6,35
234669,35,811,275,536,365,128,237,446,147,299
234696,35,226,96,130,129,68,61,97,28,69
234711,35,140,55,85,96,38,58,44,17,27
234827,35,951,409,542,815,361,454,136,48,88
234845,35,139,52,87,99,40,59,40,12,28
234915,35,213,86,127,34,14,20,179,72,107
234933,35,220,83,137,105,44,61,115,39,76
234951,35,294,105,189,201,76,125,93,29,64
234979,35,347,115,232,163,53,110,184,62,122
235024,35,40,17,23,37,17,20,3,0,3
235097,35,681,300,381,620,275,345,61,25,36
235103,35,433,170,263,187,83,104,246,87,159
235149,35,328,140,188,120,57,63,208,83,125
235167,35,315,125,190,297,117,180,18,8,10
235237,35,568,182,386,284,89,195,284,93,191
235316,35,165,98,67,164,98,66,1,0,1
235334,35,95,34,61,63,27,36,32,7,25
235343,35,397,156,241,197,80,117,200,76,124
235422,35,117,21,96,100,19,81,17,2,15
235431,35,388,113,275,165,53,112,223,60,163
235547,35,44,4,40,19,0,19,25,4,21
235671,35,206,96,110,139,81,58,67,15,52
235699,35,318,103,215,185,71,114,133,32,101
235750,35,200,42,158,56,20,36,144,22,122
236072,35,427,157,270,156,66,90,271,91,180
236133,35,70,32,38,66,31,35,4,1,3
236188,35,270,94,176,107,37,70,163,57,106
236212,35,50,37,13,50,37,13,,,
236230,35,131,45,86,129,43,86,2,2,0
236258,35,94,28,66,38,9,29,56,19,37
236328,35,40,24,16,39,23,16,1,1,0
236382,35,245,113,132,117,51,66,128,62,66
236452,35,163,97,66,147,87,60,16,10,6
236504,35,199,111,88,101,60,41,98,51,47
236513,35,444,158,286,240,105,135,204,53,151
236577,35,160,52,108,150,49,101,10,3,7
236595,35,302,131,171,293,128,165,9,3,6
236610,35,421,149,272,150,65,85,271,84,187
236638,35,225,82,143,121,54,67,104,28,76
236656,35,263,83,180,104,40,64,159,43,116
236692,35,329,125,204,207,79,128,122,46,76
236708,35,334,132,202,194,84,110,140,48,92
236753,35,451,141,310,255,92,163,196,49,147
236887,35,218,94,124,120,51,69,98,43,55
236896,35,61,26,35,59,24,35,2,2,0
236939,35,2010,930,1080,1675,805,870,335,125,210
236948,35,1420,655,765,1261,582,679,159,73,86
236975,35,144,37,107,79,26,53,65,11,54
237011,35,952,422,530,867,372,495,85,50,35
237039,35,248,101,147,113,46,67,135,55,80
237057,35,21,13,8,21,13,8,,,
237066,35,64,28,36,64,28,36,,,
237109,35,149,40,109,81,24,57,68,16,52
237118,35,56,36,20,53,35,18,3,1,2
237136,35,11,7,4,8,4,4,3,3,0
237181,35,19,13,6,19,13,6,,,
237215,35,136,56,80,116,46,70,20,10,10
237312,35,274,205,69,64,44,20,210,161,49
237330,35,117,48,69,107,44,63,10,4,6
237358,35,42,15,27,42,15,27,,,
237367,35,188,76,112,139,69,70,49,7,42
237385,35,100,55,45,82,40,42,18,15,3
237437,35,9,1,8,9,1,8,,,
237525,35,446,193,253,363,167,196,83,26,57
237686,35,154,50,104,89,25,64,65,25,40
237701,35,51,34,17,40,27,13,11,7,4
237783,35,136,60,76,116,52,64,20,8,12
237792,35,245,100,145,201,88,113,44,12,32
237817,35,40,11,29,34,10,24,6,1,5
237899,35,161,64,97,143,58,85,18,6,12
237932,35,116,56,60,105,52,53,11,4,7
237950,35,59,30,29,50,28,22,9,2,7
237969,35,11,7,4,11,7,4,,,
237987,35,47,4,43,47,4,43,,,
237996,35,165,31,134,165,31,134,,,
238014,35,96,34,62,61,24,37,35,10,25
238032,35,664,350,314,619,335,284,45,15,30
238078,35,54,29,25,32,17,15,22,12,10
238193,35,77,3,74,45,0,45,32,3,29
238263,35,558,255,303,221,108,113,337,147,190
238324,35,73,11,62,56,8,48,17,3,14
238333,35,17,10,7,17,10,7,,,
238397,35,58,26,32,24,16,8,34,10,24
238430,35,33,15,18,26,9,17,7,6,1
238458,35,95,29,66,85,25,60,10,4,6
238476,35,67,30,37,67,30,37,,,
238616,35,192,64,128,100,41,59,92,23,69
238661,35,96,38,58,89,34,55,7,4,3
238722,35,1555,688,867,536,269,267,1019,419,600
238759,35,178,58,120,44,21,23,134,37,97
238980,35,117,51,66,57,32,25,60,19,41
239008,35,171,78,93,40,19,21,131,59,72
239017,35,17,8,9,17,8,9,,,
239071,35,29,7,22,16,4,12,13,3,10
239080,35,96,36,60,61,30,31,35,6,29
239105,35,134,69,65,126,65,61,8,4,4
239220,35,78,22,56,32,11,21,46,11,35
239248,35,1227,505,722,440,210,230,787,295,492
239309,35,33,6,27,33,6,27,,,
239318,35,118,82,36,112,77,35,6,5,1
239372,35,218,71,147,86,34,52,132,37,95
239390,35,40,0,40,39,0,39,1,0,1
239442,35,70,21,49,15,6,9,55,15,40
239460,35,1151,431,720,373,164,209,778,267,511
239488,35,231,88,143,84,30,54,147,58,89
239512,35,47,30,17,47,30,17,,,
239628,35,12,5,7,12,5,7,,,
239716,35,35,19,16,34,19,15,1,0,1
239910,35,439,93,346,140,55,85,299,38,261
240107,35,155,44,111,99,30,69,56,14,42
240116,35,324,116,208,146,70,76,178,46,132
240125,35,181,92,89,85,47,38,96,45,51
240170,35,219,84,135,120,64,56,99,20,79
240189,35,481,226,255,398,194,204,83,32,51
240198,35,263,100,163,116,46,70,147,54,93
240268,35,337,156,181,297,151,146,40,5,35
240277,35,560,203,357,411,150,261,149,53,96
240329,35,333,196,137,312,185,127,21,11,10
240338,35,25,15,10,25,15,10,,,
240365,35,381,195,186,288,152,136,93,43,50
240374,35,324,147,177,241,122,119,83,25,58
240392,35,78,13,65,45,6,39,33,7,26
240417,35,399,197,202,272,150,122,127,47,80
240426,35,231,83,148,175,66,109,56,17,39
240444,35,1154,595,559,1086,567,519,68,28,40
240453,35,1076,518,558,895,443,452,181,75,106
240462,35,240,145,95,198,122,76,42,23,19
240471,35,215,98,117,194,89,105,21,9,12
240480,35,391,190,201,329,167,162,62,23,39
240505,35,152,57,95,76,36,40,76,21,55
240514,35,80,39,41,35,17,18,45,22,23
240596,35,48,18,30,31,12,19,17,6,11
240620,35,190,62,128,91,37,54,99,25,74
240657,35,88,29,59,52,24,28,36,5,31
240666,35,177,59,118,107,31,76,70,28,42
240693,35,58,23,35,30,14,16,28,9,19
240727,35,790,309,481,585,246,339,205,63,142
240736,35,13,3,10,2,0,2,11,3,8
240745,35,26,11,15,10,4,6,16,7,9
240754,35,78,28,50,64,24,40,14,4,10
240790,35,17,8,9,11,6,5,6,2,4
241100,35,19,6,13,17,5,12,2,1,1
241128,35,14,5,9,13,4,9,1,1,0
241191,35,40,15,25,32,12,20,8,3,5
241216,35,39,23,16,38,22,16,1,1,0
241225,35,30,9,21,25,7,18,5,2,3
241304,35,409,102,307,202,47,155,207,55,152
241331,35,154,30,124,68,14,54,86,16,70
241377,35,43,17,26,41,17,24,2,0,2
241386,35,4,0,4,4,0,4,,,
241395,35,28,13,15,25,12,13,3,1,2
241410,35,123,65,58,119,63,56,4,2,2
241517,35,41,6,35,28,4,24,13,2,11
241614,35,12,6,6,,,,12,6,6
241720,35,73,36,37,63,29,34,10,7,3
241739,35,291,93,198,192,67,125,99,26,73
241766,35,20,16,4,6,5,1,14,11,3
241836,35,129,46,83,40,12,28,89,34,55
241951,35,39,5,34,34,5,29,5,0,5
242112,35,113,46,67,100,44,56,13,2,11
242121,35,10,4,6,8,3,5,2,1,1
242130,35,67,13,54,62,12,50,5,1,4
242149,35,29,6,23,21,5,16,8,1,7
242617,35,82,42,40,76,37,39,6,5,1
242626,35,114,51,63,98,44,54,16,7,9
242635,35,97,33,64,86,28,58,11,5,6
242644,35,16,7,9,13,4,9,3,3,0
242653,35,206,89,117,176,77,99,30,12,18
242662,35,145,49,96,116,37,79,29,12,17
242680,35,37,14,23,32,12,20,5,2,3
242699,35,139,43,96,123,39,84,16,4,12
242705,35,116,62,54,108,58,50,8,4,4
242972,35,3957,1115,2842,2327,628,1699,1630,487,1143
243106,35,30,17,13,29,17,12,1,0,1
243115,35,50,19,31,47,18,29,3,1,2
243133,35,29,11,18,27,10,17,2,1,1
243142,35,135,47,88,107,34,73,28,13,15
243151,35,25,7,18,25,7,18,,,
243179,35,35,9,26,32,8,24,3,1,2
243188,35,10,7,3,10,7,3,,,
243197,35,131,79,52,125,77,48,6,2,4
243203,35,97,18,79,97,18,79,,,
243212,35,58,25,33,57,25,32,1,0,1
243221,35,154,58,96,142,54,88,12,4,8
243346,35,244,93,151,159,65,94,85,28,57
243443,35,324,127,197,248,99,149,76,28,48
243568,35,5,0,5,5,0,5,,,
243577,35,198,136,62,122,81,41,76,55,21
243586,35,38,21,17,36,20,16,2,1,1
243601,35,433,166,267,320,120,200,113,46,67
243647,35,1,0,1,,,,1,0,1
243665,35,66,21,45,44,18,26,22,3,19
243744,35,46,28,18,46,28,18,,,
243780,35,1042,564,478,869,515,354,173,49,124
243823,35,51,16,35,43,14,29,8,2,6
243832,35,193,54,139,92,33,59,101,21,80
243841,35,136,16,120,132,16,116,4,0,4
244233,35,1,0,1,1,0,1,,,
244279,35,14,1,13,14,1,13,,,
244437,35,1104,386,718,493,201,292,611,185,426
244446,35,414,149,265,125,66,59,289,83,206
245625,35,78,30,48,39,17,22,39,13,26
245652,35,11,8,3,11,8,3,,,
245777,35,4,4,0,4,4,0,,,
245838,35,9,5,4,5,4,1,4,1,3
245847,35,18,8,10,12,5,7,6,3,3
245883,35,22,6,16,3,1,2,19,5,14
245892,35,24,6,18,15,2,13,9,4,5
245953,35,261,84,177,120,48,72,141,36,105
245962,35,2,0,2,2,0,2,,,
246354,35,510,202,308,51,17,34,459,185,274
246813,35,444,164,280,96,50,46,348,114,234
246974,35,48,6,42,48,6,42,,,
247065,35,73,5,68,67,5,62,6,0,6
247603,35,128,67,61,79,50,29,49,17,32
247649,35,73,51,22,63,46,17,10,5,5
247773,35,2,2,0,2,2,0,,,
247834,35,1758,749,1009,665,315,350,1093,434,659
247940,35,188,74,114,86,34,52,102,40,62
248934,35,1404,539,865,1404,539,865,,,
249609,35,22,11,11,22,11,11,,,
250027,35,52,10,42,51,10,41,1,0,1
251260,35,397,187,210,242,132,110,155,55,100
251312,35,94,13,81,73,10,63,21,3,18
260372,35,13,2,11,7,0,7,6,2,4
260691,35,103,21,82,103,21,82,,,
260789,35,71,12,59,71,12,59,,,
260813,35,18,2,16,18,2,16,,,
260992,35,38,3,35,2,0,2,36,3,33
261861,35,1,0,1,1,0,1,,,
262031,35,362,149,213,247,115,132,115,34,81
262086,35,956,307,649,227,91,136,729,216,513
262129,35,61,19,42,61,19,42,,,
262457,35,39,4,35,39,4,35,,,
363633,35,14,8,6,11,8,3,3,0,3
363712,35,4,4,0,4,4,0,,,
363907,35,19,9,10,16,9,7,3,0,3
363916,35,11,5,6,10,5,5,1,0,1
363934,35,80,65,15,31,26,5,49,39,10
364016,35,531,234,297,137,69,68,394,165,229
364025,35,763,350,413,214,110,104,549,240,309
366003,35,5,1,4,4,0,4,1,1,0
366252,35,306,160,146,230,144,86,76,16,60
366261,35,47,20,27,34,14,20,13,6,7
366270,35,89,5,84,89,5,84,,,
366395,35,698,332,366,537,277,260,161,55,106
366401,35,648,275,373,123,65,58,525,210,315
366465,35,371,121,250,172,68,104,199,53,146
366535,35,3,1,2,3,1,2,,,
366553,35,3,1,2,3,1,2,,,
366711,35,1513,650,863,1200,513,687,313,137,176
367459,35,465,204,261,161,82,79,304,122,182
367884,35,43,13,30,31,10,21,12,3,9
368452,35,23,8,15,23,8,15,,,
368629,35,68,14,54,68,14,54,,,
368911,35,144,34,110,39,8,31,105,26,79
369400,35,101,94,7,101,94,7,,,
369455,35,78,17,61,78,17,61,,,
369516,35,27,7,20,27,7,20,,,
372073,35,55,21,34,55,21,34,,,
372921,35,74,23,51,74,23,51,,,
375230,35,42,42,0,42,42,0,,,
375416,35,5,1,4,5,1,4,,,
375939,35,7,2,5,7,2,5,,,
376224,35,35,11,24,31,10,21,4,1,3
376385,35,38,18,20,35,17,18,3,1,2
377111,35,15,4,11,15,4,11,,,
377218,35,9,9,0,9,9,0,,,
377546,35,14,7,7,11,7,4,3,0,3
377555,35,509,272,237,428,229,199,81,43,38
377564,35,645,336,309,575,305,270,70,31,39
377652,35,49,5,44,49,5,44,,,
377661,35,152,22,130,152,22,130,,,
378105,35,49,0,49,39,0,39,10,0,10
378576,35,2,0,2,,,,2,0,2
379782,35,32,3,29,32,3,29,,,
380359,35,38,7,31,12,3,9,26,4,22
380368,35,95,46,49,52,24,28,43,22,21
380377,35,17,1,16,15,1,14,2,0,2
380438,35,97,14,83,97,14,83,,,
382911,35,4,0,4,4,0,4,,,
382957,35,47,12,35,47,12,35,,,
383190,35,177,64,113,60,29,31,117,35,82
383996,35,48,20,28,10,3,7,38,17,21
384254,35,38,28,10,38,28,10,,,
384333,35,614,221,393,163,60,103,451,161,290
384342,35,273,127,146,155,79,76,118,48,70
384412,35,36,18,18,36,18,18,,,
385503,35,28,2,26,28,2,26,,,
385619,35,522,236,286,522,236,286,,,
386153,35,71,0,71,59,0,59,12,0,12
386472,35,38,6,32,16,1,15,22,5,17
388520,35,41,22,19,17,11,6,24,11,13
392415,35,54,11,43,54,11,43,,,
393649,35,172,45,127,172,45,127,,,
395362,35,138,38,100,35,11,24,103,27,76
399212,35,1323,789,534,111,57,54,1212,732,480
399869,35,8,7,1,8,7,1,,,
401223,35,33,17,16,12,3,9,21,14,7
403469,35,6,2,4,2,2,0,4,0,4
403478,35,16,5,11,11,3,8,5,2,3
403487,35,25,16,9,21,14,7,4,2,2
404055,35,60,4,56,60,4,56,,,
404338,35,13,7,6,13,7,6,,,
404426,35,310,152,158,130,69,61,180,83,97
404912,35,75,15,60,75,15,60,,,
405058,35,2,2,0,2,2,0,,,
405854,35,2,2,0,2,2,0,,,
405872,35,169,79,90,84,52,32,85,27,58
406024,35,619,84,535,234,25,209,385,59,326
406033,35,974,104,870,394,52,342,580,52,528
406547,35,9,0,9,2,0,2,7,0,7
407610,35,6,2,4,1,1,0,5,1,4
407629,35,10,1,9,10,1,9,,,
408844,35,172,80,92,131,66,65,41,14,27
409315,35,556,217,339,233,99,134,323,118,205
409698,35,889,407,482,758,336,422,131,71,60
412173,35,81,6,75,81,6,75,,,
412599,35,7,4,3,7,4,3,,,
413413,35,4836,672,4164,1308,156,1152,3528,516,3012
413617,35,7,2,5,2,1,1,5,1,4
413626,35,7,1,6,5,1,4,2,0,2
414461,35,157,146,11,64,57,7,93,89,4
414878,35,18,6,12,5,2,3,13,4,9
414911,35,49,21,28,34,14,20,15,7,8
416801,35,70,12,58,70,12,58,,,
417734,35,59,15,44,26,9,17,33,6,27
418126,35,13,3,10,5,3,2,8,0,8
418533,35,43,8,35,42,7,35,1,1,0
418889,35,12,10,2,4,3,1,8,7,1
419244,35,78,55,23,32,24,8,46,31,15
420325,35,7,7,0,7,7,0,,,
420398,35,960,411,549,177,80,97,783,331,452
420431,35,268,75,193,82,40,42,186,35,151
420440,35,14,2,12,3,1,2,11,1,10
420538,35,117,38,79,57,23,34,60,15,45
420556,35,26,5,21,10,0,10,16,5,11
420723,35,18,6,12,7,2,5,11,4,7
421708,35,172,22,150,117,14,103,55,8,47
421841,35,45,20,25,45,20,25,,,
421878,35,70,7,63,51,6,45,19,1,18
422020,35,33,29,4,33,29,4,,,
422695,35,77,1,76,77,1,76,,,
423120,35,44,6,38,42,5,37,2,1,1
423652,35,29,3,26,19,3,16,10,0,10
425250,35,6,1,5,4,0,4,2,1,1
426314,35,788,660,128,162,131,31,626,529,97
428170,35,14,2,12,11,2,9,3,0,3
428259,35,14,2,12,2,0,2,12,2,10
428392,35,51,20,31,31,13,18,20,7,13
429128,35,4,0,4,1,0,1,3,0,3
430184,35,147,50,97,42,24,18,105,26,79
430670,35,4,1,3,4,1,3,,,
430704,35,2,0,2,2,0,2,,,
430795,35,1,0,1,1,0,1,,,
430935,35,190,133,57,141,100,41,49,33,16
431141,35,51,26,25,51,26,25,,,
432384,35,14,3,11,14,3,11,,,
432524,35,7,4,3,5,3,2,2,1,1
433004,35,97,26,71,97,26,71,,,
433013,35,75,19,56,75,19,56,,,
433174,35,122,16,106,52,9,43,70,7,63
433387,35,34557,13526,21031,34557,13526,21031,,,
433420,35,29,23,6,29,23,6,,,
433536,35,36,5,31,16,2,14,20,3,17
433660,35,1158,537,621,872,411,461,286,126,160
434061,35,616,231,385,366,152,214,250,79,171
434140,35,82,19,63,82,19,63,,,
434159,35,2,1,1,2,1,1,,,
434432,35,5,0,5,5,0,5,,,
434584,35,5,0,5,2,0,2,3,0,3
434672,35,1254,459,795,461,207,254,793,252,541
434751,35,9,3,6,4,1,3,5,2,3
434900,35,13,5,8,3,1,2,10,4,6
434937,35,16,16,0,16,16,0,,,
435000,35,5,1,4,4,1,3,1,0,1
436304,35,200,87,113,116,49,67,84,38,46
436429,35,296,175,121,296,175,121,,,
436599,35,15,5,10,,,,15,5,10
436614,35,1,0,1,1,0,1,,,
436818,35,38,13,25,33,11,22,5,2,3
436827,35,22,12,10,22,12,10,,,
436836,35,108,56,52,98,53,45,10,3,7
437097,35,64,40,24,58,34,24,6,6,0
437103,35,1161,350,811,572,201,371,589,149,440
437732,35,7,0,7,7,0,7,,,
437769,35,2,0,2,2,0,2,,,
437936,35,62,10,52,62,10,52,,,
438179,35,39,8,31,39,8,31,,,
438221,35,1,0,1,1,0,1,,,
438258,35,69,20,49,69,20,49,,,
438504,35,106,100,6,106,100,6,,,
438586,35,217,31,186,188,25,163,29,6,23
438708,35,33,8,25,17,5,12,16,3,13
439118,35,38,3,35,38,3,35,,,
439190,35,121,62,59,62,32,30,59,30,29
439367,35,191,48,143,191,48,143,,,
439570,35,47,1,46,47,1,46,,,
439701,35,38,13,25,14,5,9,24,8,16
439738,35,111,15,96,111,15,96,,,
439783,35,1,0,1,,,,1,0,1
439792,35,41,9,32,40,9,31,1,0,1
439871,35,18,1,17,18,1,17,,,
439899,35,5,4,1,4,3,1,1,1,0
439969,35,1,1,0,1,1,0,,,
440271,35,1,1,0,1,1,0,,,
440396,35,9,2,7,9,2,7,,,
440402,35,136,38,98,60,16,44,76,22,54
440651,35,39,5,34,24,5,19,15,0,15
440749,35,5,4,1,,,,5,4,1
440794,35,40,16,24,30,8,22,10,8,2
440828,35,150,66,84,94,40,54,56,26,30
441025,35,12,11,1,12,11,1,,,
441052,35,54,8,46,54,8,46,,,
441229,35,63,14,49,63,14,49,,,
441371,35,2807,65,2742,2807,65,2742,,,
441487,35,12,0,12,12,0,12,,,
441609,35,31,31,0,31,31,0,,,
441636,35,107,20,87,94,15,79,13,5,8
441690,35,14,10,4,10,7,3,4,3,1
441760,35,306,133,173,161,85,76,145,48,97
441858,35,78,3,75,74,3,71,4,0,4
441900,35,520,107,413,205,49,156,315,58,257
441937,35,915,332,583,703,264,439,212,68,144
441982,35,1,1,0,1,1,0,,,
442134,35,25,6,19,25,6,19,,,
442356,35,252,30,222,88,13,75,164,17,147
442383,35,81,10,71,81,10,71,,,
442426,35,59,9,50,43,5,38,16,4,12
442444,35,88,40,48,88,40,48,,,
442569,35,697,203,494,181,51,130,516,152,364
442602,35,49,5,44,49,5,44,,,
442611,35,126,116,10,126,116,10,,,
442639,35,39,20,19,39,20,19,,,
442781,35,101,21,80,27,7,20,74,14,60
442879,35,419,45,374,407,42,365,12,3,9
442930,35,109,59,50,103,58,45,6,1,5
443049,35,46,27,19,32,18,14,14,9,5
443058,35,10,5,5,,,,10,5,5
443331,35,251,52,199,167,38,129,84,14,70
443340,35,3,2,1,3,2,1,,,
443377,35,1,1,0,1,1,0,,,
443410,35,123,93,30,119,89,30,4,4,0
443492,35,150,66,84,121,54,67,29,12,17
443562,35,10,3,7,7,2,5,3,1,2
443599,35,124,11,113,42,6,36,82,5,77
443650,35,17,8,9,16,8,8,1,0,1
443748,35,1,0,1,1,0,1,,,
443766,35,425,82,343,37,15,22,388,67,321
443784,35,183,47,136,15,5,10,168,42,126
444088,35,88,12,76,88,12,76,,,
444130,35,10,0,10,,,,10,0,10
444219,35,1684,727,957,146,80,66,1538,647,891
444325,35,10,2,8,10,2,8,,,
444398,35,10,3,7,6,3,3,4,0,4
444413,35,4,4,0,4,4,0,,,
444556,35,26,14,12,26,14,12,,,
444565,35,48,17,31,23,9,14,25,8,17
444778,35,5,2,3,4,2,2,1,0,1
444787,35,602,83,519,336,42,294,266,41,225
444866,35,1,0,1,1,0,1,,,
444954,35,173,69,104,107,47,60,66,22,44
445027,35,2319,571,1748,2124,530,1594,195,41,154
445133,35,30,7,23,16,3,13,14,4,10
445188,35,213,115,98,207,112,95,6,3,3
445203,35,4,0,4,4,0,4,,,
445230,35,33,8,25,33,8,25,,,
445249,35,10,3,7,10,3,7,,,
445267,35,395,87,308,214,43,171,181,44,137
445364,35,29,4,25,29,4,25,,,
445692,35,14,10,4,11,8,3,3,2,1
445708,35,45,16,29,45,16,29,,,
445735,35,177,53,124,177,53,124,,,
445744,35,57,3,54,57,3,54,,,
445799,35,69,65,4,69,65,4,,,
445948,35,235,30,205,235,30,205,,,
446048,35,73,44,29,73,44,29,,,
446109,35,51,7,44,31,5,26,20,2,18
446127,35,62,2,60,62,2,60,,,
446163,35,12,12,0,12,12,0,,,
446233,35,24,19,5,23,18,5,1,1,0
446385,35,11,8,3,11,8,3,,,
446525,35,45,30,15,45,30,15,,,
446552,35,33,17,16,33,17,16,,,
446561,35,90,15,75,90,15,75,,,
446604,35,234,234,0,234,234,0,,,
446640,35,73,55,18,40,36,4,33,19,14
446774,35,188,62,126,60,24,36,128,38,90
447014,35,54,4,50,54,4,50,,,
447050,35,36,12,24,19,7,12,17,5,12
447263,35,379,83,296,233,56,177,146,27,119
447351,35,51,22,29,51,22,29,,,
447421,35,34,5,29,34,5,29,,,
447582,35,138,42,96,99,32,67,39,10,29
447689,35,641,252,389,418,171,247,223,81,142
447713,35,19,6,13,19,6,13,,,
447759,35,72,21,51,66,18,48,6,3,3
447768,35,148,48,100,148,48,100,,,
447847,35,12,10,2,12,10,2,,,
447935,35,83,2,81,83,2,81,,,
447953,35,63,26,37,42,16,26,21,10,11
448372,35,19,4,15,19,4,15,,,
448433,35,77,69,8,77,69,8,,,
448594,35,387,160,227,116,48,68,271,112,159
448600,35,5,1,4,5,1,4,,,
448673,35,492,35,457,278,23,255,214,12,202
448859,35,9,8,1,9,8,1,,,
449038,35,242,91,151,68,35,33,174,56,118
449074,35,66,3,63,66,3,63,,,
449135,35,3,1,2,2,1,1,1,0,1
449339,35,5330,3275,2055,524,258,266,4806,3017,1789
449348,35,3,1,2,,,,3,1,2
449384,35,24,15,9,24,15,9,,,
449506,35,64,12,52,64,12,52,,,
449524,35,26,5,21,26,5,21,,,
449612,35,13,5,8,13,5,8,,,
449658,35,11,11,0,9,9,0,2,2,0
449728,35,15,1,14,15,1,14,,,
449764,35,14,7,7,13,7,6,1,0,1
449870,35,7,4,3,7,4,3,,,
449889,35,56,14,42,56,14,42,,,
449898,35,107,20,87,78,14,64,29,6,23
450058,35,147,29,118,147,29,118,,,
450067,35,78,17,61,75,17,58,3,0,3
450298,35,31,10,21,7,4,3,24,6,18
450377,35,207,42,165,22,12,10,185,30,155
450401,35,1,0,1,1,0,1,,,
450571,35,72,7,65,33,4,29,39,3,36
450696,35,30,3,27,30,3,27,,,
450933,35,1436,962,474,903,588,315,533,374,159
451103,35,82,14,68,31,4,27,51,10,41
451370,35,6,6,0,6,6,0,,,
451398,35,3,3,0,3,3,0,,,
451404,35,23,23,0,23,23,0,,,
451477,35,9,7,2,9,7,2,,,
451556,35,308,105,203,308,105,203,,,
451741,35,26,7,19,18,4,14,8,3,5
451750,35,233,56,177,193,51,142,40,5,35
451820,35,8,6,2,2,2,0,6,4,2
451857,35,1,0,1,1,0,1,,,
451866,35,10,2,8,10,2,8,,,
451927,35,3,2,1,2,1,1,1,1,0
452124,35,64,15,49,64,15,49,,,
452373,35,28,2,26,28,2,26,,,
452948,35,180,27,153,91,12,79,89,15,74
453163,35,426,111,315,48,25,23,378,86,292
453215,35,81,23,58,1,1,0,80,22,58
454184,35,22,8,14,21,8,13,1,0,1
454227,35,2501,297,2204,955,121,834,1546,176,1370
454236,35,73,6,67,45,2,43,28,4,24
454245,35,118,23,95,77,15,62,41,8,33
454582,35,11,6,5,1,0,1,10,6,4
454698,35,18,3,15,18,3,15,,,
454786,35,89,64,25,14,7,7,75,57,18
454810,35,179,44,135,179,44,135,,,
454829,35,3778,483,3295,526,71,455,3252,412,2840
454856,35,170,27,143,170,27,143,,,
454865,35,189,29,160,99,17,82,90,12,78
455114,35,427,169,258,174,86,88,253,83,170
455196,35,944,72,872,944,72,872,,,
455257,35,30,30,0,30,30,0,,,
455336,35,31,23,8,31,23,8,,,
455479,35,115,11,104,107,11,96,8,0,8
455512,35,456,160,296,47,21,26,409,139,270
455628,35,74,31,43,74,31,43,,,
455664,35,45,8,37,7,4,3,38,4,34
455770,35,20,13,7,20,13,7,,,
455868,35,21,3,18,21,3,18,,,
455983,35,2,0,2,2,0,2,,,
456038,35,40,4,36,40,4,36,,,
456153,35,8,8,0,8,8,0,,,
456205,35,12,9,3,12,9,3,,,
456214,35,27,10,17,27,10,17,,,
456454,35,27,13,14,25,13,12,2,0,2
456490,35,8,5,3,,,,8,5,3
456579,35,15,11,4,15,11,4,,,
456621,35,42,10,32,5,3,2,37,7,30
456852,35,29,11,18,29,11,18,,,
456959,35,35,13,22,33,12,21,2,1,1
457101,35,63,18,45,63,18,45,,,
457110,35,77,16,61,77,16,61,,,
457129,35,127,16,111,36,2,34,91,14,77
457226,35,12,9,3,6,5,1,6,4,2
457299,35,102,16,86,93,15,78,9,1,8
457402,35,50,50,0,17,17,0,33,33,0
457484,35,10,2,8,6,1,5,4,1,3
457527,35,64,3,61,9,0,9,55,3,52
457536,35,138,13,125,138,13,125,,,
457697,35,41,23,18,8,3,5,33,20,13
458034,35,20,5,15,20,5,15,,,
458113,35,10,5,5,,,,10,5,5
458140,35,42,36,6,42,36,6,,,
458210,35,296,67,229,172,43,129,124,24,100
458229,35,242,61,181,212,56,156,30,5,25
458405,35,14,9,5,14,9,5,,,
458496,35,15,10,5,8,6,2,7,4,3
458681,35,36,7,29,36,7,29,,,
458885,35,35,5,30,,,,35,5,30
458919,35,782,218,564,135,70,65,647,148,499
458955,35,61,16,45,3,2,1,58,14,44
458964,35,264,62,202,39,19,20,225,43,182
458973,35,420,138,282,103,57,46,317,81,236
458982,35,24,14,10,9,6,3,15,8,7
459204,35,980,160,820,980,160,820,,,
459213,35,255,52,203,255,52,203,,,
459259,35,87,16,71,63,12,51,24,4,20
459268,35,43,4,39,24,2,22,19,2,17
459417,35,4,3,1,4,3,1,,,
459727,35,68,22,46,27,7,20,41,15,26
459824,35,5,1,4,5,1,4,,,
459842,35,44,3,41,26,2,24,18,1,17
459851,35,25,5,20,13,4,9,12,1,11
459949,35,778,245,533,420,136,284,358,109,249
459958,35,58,12,46,58,12,46,,,
459994,35,1704,528,1176,80,47,33,1624,481,1143
460020,35,52,18,34,52,18,34,,,
460136,35,56,9,47,56,9,47,,,
460349,35,453,139,314,96,25,71,357,114,243
460376,35,4,2,2,4,2,2,,,
460394,35,1822,761,1061,203,103,100,1619,658,961
460464,35,1392,599,793,154,95,59,1238,504,734
460543,35,115,103,12,115,103,12,,,
460677,35,105,15,90,97,14,83,8,1,7
460756,35,51,1,50,48,1,47,3,0,3
460817,35,8,5,3,8,5,3,,,
460826,35,12,9,3,12,9,3,,,
460835,35,15,14,1,15,14,1,,,
460871,35,104,13,91,51,4,47,53,9,44
461023,35,45,8,37,40,7,33,5,1,4
461032,35,16,7,9,10,4,6,6,3,3
461148,35,142,82,60,142,82,60,,,
461218,35,103,4,99,103,4,99,,,
461263,35,23,1,22,23,1,22,,,
461281,35,9,1,8,5,1,4,4,0,4
461315,35,27,2,25,4,0,4,23,2,21
461528,35,26,10,16,9,5,4,17,5,12
461643,35,13,1,12,13,1,12,,,
461689,35,30,5,25,30,5,25,,,
461759,35,61,32,29,50,27,23,11,5,6
461795,35,68,45,23,64,43,21,4,2,2
461847,35,5,5,0,5,5,0,,,
461953,35,27,1,26,16,1,15,11,0,11
462354,35,51,25,26,49,24,25,2,1,1
463056,35,59,23,36,57,22,35,2,1,1
464226,35,162,89,73,139,81,58,23,8,15
466921,35,69,4,65,35,1,34,34,3,31
466930,35,407,51,356,142,15,127,265,36,229
469416,35,3,0,3,2,0,2,1,0,1
469629,35,7,6,1,7,6,1,,,
474863,35,394,70,324,223,45,178,171,25,146
475033,35,147,26,121,,,,147,26,121
475121,35,708,181,527,610,154,456,98,27,71
475176,35,79,47,32,79,47,32,,,
475200,35,35,14,21,,,,35,14,21
475273,35,62,17,45,15,4,11,47,13,34
475398,35,10,2,8,3,0,3,7,2,5
475422,35,29,0,29,,,,29,0,29
475477,35,82,20,62,14,2,12,68,18,50
475608,35,6,5,1,6,5,1,,,
475635,35,1,0,1,,,,1,0,1
475714,35,4,4,0,4,4,0,,,
475732,35,274,31,243,88,9,79,186,22,164
475741,35,28,1,27,22,1,21,6,0,6
475839,35,165,99,66,99,64,35,66,35,31
476601,35,1,1,0,1,1,0,,,
476683,35,59,5,54,59,5,54,,,
476717,35,2,2,0,2,2,0,,,
476726,35,133,23,110,133,23,110,,,
476975,35,1288,587,701,260,113,147,1028,474,554
477039,35,119,15,104,80,9,71,39,6,33
477233,35,1,0,1,1,0,1,,,
479956,35,1022,429,593,486,185,301,536,244,292
480028,35,122,93,29,122,93,29,,,
480073,35,53,9,44,45,6,39,8,3,5
480091,35,1970,194,1776,1806,171,1635,164,23,141
480198,35,34,12,22,10,4,6,24,8,16
480204,35,31,7,24,31,7,24,,,
480569,35,66,24,42,42,10,32,24,14,10
480657,35,117,15,102,56,8,48,61,7,54
480781,35,19,15,4,19,15,4,,,
480985,35,41,0,41,41,0,41,,,
481058,35,1,1,0,1,1,0,,,
481155,35,66,18,48,66,18,48,,,
481225,35,1,1,0,1,1,0,,,
481252,35,10,1,9,10,1,9,,,
481386,35,1,0,1,1,0,1,,,
481401,35,7,4,3,,,,7,4,3
481410,35,5,5,0,5,5,0,,,
481438,35,1,1,0,1,1,0,,,
481720,35,13,2,11,9,0,9,4,2,2
481775,35,26,7,19,26,7,19,,,
482149,35,523,162,361,445,133,312,78,29,49
482158,35,749,320,429,462,218,244,287,102,185
482228,35,17,8,9,5,3,2,12,5,7
482413,35,26,10,16,21,9,12,5,1,4
482422,35,2,0,2,1,0,1,1,0,1
482431,35,553,285,268,303,171,132,250,114,136
482459,35,16,7,9,15,6,9,1,1,0
482468,35,13,7,6,8,6,2,5,1,4
482477,35,7759,2639,5120,3854,1426,2428,3905,1213,2692
482556,35,17,10,7,15,8,7,2,2,0
482574,35,2,1,1,2,1,1,,,
482635,35,2,1,1,1,1,0,1,0,1
482653,35,8,4,4,7,3,4,1,1,0
482680,35,681,295,386,522,241,281,159,54,105
482699,35,81,23,58,49,14,35,32,9,23
482705,35,646,170,476,315,31,284,331,139,192
482936,35,63,50,13,54,43,11,9,7,2
482990,35,12,1,11,12,1,11,,,
483018,35,3,2,1,3,2,1,,,
483036,35,403,158,245,141,69,72,262,89,173
483045,35,960,409,551,294,155,139,666,254,412
483124,35,11615,4318,7297,4544,1493,3051,7071,2825,4246
483212,35,482,134,348,219,64,155,263,70,193
483221,35,2,1,1,2,1,1,,,
483373,35,11,0,11,10,0,10,1,0,1
483595,35,965,220,745,488,116,372,477,104,373
483780,35,40,26,14,40,26,14,,,
483814,35,101,6,95,101,6,95,,,
484002,35,2,0,2,2,0,2,,,
484066,35,105,5,100,105,5,100,,,
484367,35,6,0,6,6,0,6,,,
484376,35,11,1,10,11,1,10,,,
484473,35,640,259,381,311,127,184,329,132,197
484613,35,7383,2003,5380,7383,2003,5380,,,
484631,35,3,0,3,3,0,3,,,
484862,35,2,0,2,2,0,2,,,
484905,35,505,176,329,282,99,183,223,77,146
484932,35,392,226,166,123,37,86,269,189,80
485111,35,547,203,344,339,127,212,208,76,132
485272,35,83,10,73,37,4,33,46,6,40
485458,35,256,53,203,56,13,43,200,40,160
485500,35,49,43,6,1,1,0,48,42,6
485519,35,157,102,55,39,11,28,118,91,27
485546,35,15,3,12,2,2,0,13,1,12
485698,35,4,0,4,4,0,4,,,
485768,35,9,2,7,9,2,7,,,
485953,35,5,5,0,5,5,0,,,
485999,35,1,1,0,1,1,0,,,
486017,35,8,8,0,8,8,0,,,
486053,35,23,16,7,7,3,4,16,13,3
486123,35,5,2,3,5,2,3,,,
486196,35,11,11,0,11,11,0,,,
486239,35,8,3,5,8,3,5,,,
486257,35,53,21,32,34,13,21,19,8,11
486284,35,22,8,14,19,8,11,3,0,3
486372,35,15,12,3,15,12,3,,,
486415,35,25,5,20,25,5,20,,,
486424,35,35,9,26,19,5,14,16,4,12
486488,35,3,1,2,3,1,2,,,
486813,35,90,9,81,90,9,81,,,
486822,35,118,14,104,118,14,104,,,
486840,35,2886,1439,1447,2090,1021,1069,796,418,378
486901,35,53,34,19,52,34,18,1,0,1
486938,35,93,21,72,48,14,34,45,7,38
486947,35,115,12,103,48,6,42,67,6,61
486956,35,188,35,153,87,18,69,101,17,84
487010,35,215,13,202,213,12,201,2,1,1
487162,35,443,119,324,147,36,111,296,83,213
487302,35,67,13,54,67,13,54,,,
487311,35,15,15,0,15,15,0,,,
487320,35,807,550,257,486,382,104,321,168,153
487375,35,188,23,165,118,13,105,70,10,60
487393,35,57,19,38,57,19,38,,,
487409,35,39,17,22,39,17,22,,,
487418,35,37,16,21,37,16,21,,,
487445,35,46,19,27,46,19,27,,,
487454,35,35,8,27,35,8,27,,,
487490,35,70,19,51,70,19,51,,,
487524,35,87,36,51,60,30,30,27,6,21
487597,35,161,153,8,161,153,8,,,
487603,35,75,22,53,50,15,35,25,7,18
487746,35,9,9,0,9,9,0,,,
487977,35,480,19,461,404,5,399,76,14,62
487995,35,8,4,4,6,4,2,2,0,2
488004,35,15,15,0,15,15,0,,,
488031,35,15,6,9,15,6,9,,,
488059,35,34,9,25,34,9,25,,,
488068,35,4,0,4,4,0,4,,,
488077,35,1995,1943,52,1373,1334,39,622,609,13
488305,35,9,6,3,5,3,2,4,3,1
488314,35,24,24,0,24,24,0,,,
488332,35,13,0,13,13,0,13,,,
488350,35,9,9,0,9,9,0,,,
488448,35,21,15,6,20,15,5,1,0,1
488563,35,1,0,1,1,0,1,,,
488679,35,1083,237,846,1028,218,810,55,19,36
488721,35,1,0,1,1,0,1,,,
488730,35,387,165,222,69,44,25,318,121,197
488776,35,34,10,24,12,3,9,22,7,15
488785,35,40,21,19,39,20,19,1,1,0
488800,35,234,72,162,234,72,162,,,
488846,35,111,64,47,42,23,19,69,41,28
489201,35,1339,483,856,160,66,94,1179,417,762
489344,35,46,4,42,26,1,25,20,3,17
489353,35,86,18,68,40,9,31,46,9,37
489779,35,6634,2640,3994,532,172,360,6102,2468,3634
489812,35,7,0,7,7,0,7,,,
489937,35,31,18,13,28,17,11,3,1,2
490045,35,1,0,1,,,,1,0,1
490054,35,61,9,52,26,4,22,35,5,30
490133,35,144,90,54,134,85,49,10,5,5
490203,35,45,3,42,11,1,10,34,2,32
490230,35,11,6,5,11,6,5,,,
490276,35,42,42,0,42,42,0,,,
490285,35,44,36,8,44,36,8,,,
490328,35,11,11,0,11,11,0,,,
490498,35,9,7,2,9,7,2,,,
490513,35,1,1,0,1,1,0,,,
490753,35,11,5,6,11,5,6,,,
490805,35,454,191,263,305,149,156,149,42,107
490878,35,34,7,27,34,7,27,,,
490975,35,22,2,20,22,2,20,,,
491057,35,106,106,0,106,106,0,,,
491181,35,157,16,141,73,6,67,84,10,74
491190,35,1,0,1,1,0,1,,,
491288,35,172,55,117,22,8,14,150,47,103
491297,35,48,19,29,,,,48,19,29
491446,35,2,0,2,2,0,2,,,
491525,35,6,4,2,3,3,0,3,1,2
491622,35,1,1,0,1,1,0,,,
491631,35,26,0,26,23,0,23,3,0,3
491640,35,5,5,0,5,5,0,,,
491710,35,3,3,0,3,3,0,,,
491817,35,36,0,36,36,0,36,,,
491844,35,23,3,20,17,3,14,6,0,6
491914,35,20,20,0,20,20,0,,,
491941,35,28,1,27,28,1,27,,,
492069,35,24,13,11,20,13,7,4,0,4
492449,35,87,24,63,87,24,63,,,
492476,35,45,5,40,12,0,12,33,5,28
492607,35,1,0,1,,,,1,0,1
492689,35,76,8,68,68,8,60,8,0,8
492759,35,82,13,69,32,6,26,50,7,43
492801,35,106,27,79,63,18,45,43,9,34
492962,35,232,105,127,101,45,56,131,60,71
493080,35,90,48,42,9,5,4,81,43,38
493512,35,19,10,9,19,10,9,,,
493521,35,10,8,2,10,8,2,,,
493594,35,7,7,0,7,7,0,,,
493600,35,2,2,0,2,2,0,,,
493619,35,4,1,3,3,0,3,1,1,0
493646,35,9,0,9,9,0,9,,,
493664,35,3,3,0,1,1,0,2,2,0
493673,35,3,1,2,3,1,2,,,
493707,35,1,1,0,1,1,0,,,
493822,35,81,11,70,63,9,54,18,2,16
493895,35,96,84,12,51,46,5,45,38,7
494162,35,80,9,71,44,2,42,36,7,29
494250,35,140,14,126,140,14,126,,,
494278,35,29,4,25,16,2,14,13,2,11
494287,35,119,28,91,30,11,19,89,17,72
494436,35,60,5,55,60,5,55,,,
494588,35,27,4,23,27,4,23,,,
494597,35,11,6,5,11,6,5,,,
494621,35,51,7,44,8,3,5,43,4,39
494630,35,6,3,3,6,3,3,,,
494685,35,77,26,51,70,21,49,7,5,2
494737,35,13,13,0,13,13,0,,,
494746,35,28,4,24,28,4,24,,,
494755,35,23,2,21,23,2,21,,,
494807,35,1,0,1,1,0,1,,,
494843,35,43,1,42,43,1,42,,,
494852,35,3,1,2,3,1,2,,,
494959,35,7,1,6,4,0,4,3,1,2
495031,35,4,4,0,4,4,0,,,
495147,35,1,1,0,1,1,0,,,
495183,35,8,4,4,8,4,4,,,
495271,35,5,1,4,1,0,1,4,1,3
495280,35,3,1,2,3,1,2,,,
495420,35,62,9,53,34,5,29,28,4,24
495439,35,46,1,45,28,1,27,18,0,18
495448,35,64,7,57,40,6,34,24,1,23
495457,35,186,23,163,126,17,109,60,6,54
495952,35,25,6,19,25,6,19,,,
495961,35,9,1,8,9,1,8,,,
496186,35,39,35,4,38,34,4,1,1,0
496265,35,5,3,2,5,3,2,,,
496283,35,36,9,27,36,9,27,,,
496326,35,79,5,74,79,5,74,,,
496399,35,8,3,5,8,3,5,,,
496627,35,11,4,7,11,4,7,,,
496636,35,44,9,35,44,9,35,,,
496681,35,1,0,1,1,0,1,,,
496706,35,111,71,40,111,71,40,,,
496973,35,34,7,27,13,4,9,21,3,18
496991,35,220,31,189,112,12,100,108,19,89
497000,35,22,11,11,22,11,11,,,
497037,35,252,49,203,165,27,138,87,22,65
497046,35,1488,453,1035,55,12,43,1433,441,992
497116,35,371,44,327,161,18,143,210,26,184
497125,35,298,31,267,124,14,110,174,17,157
497213,35,9,4,5,6,4,2,3,0,3
497268,35,40,1,39,25,0,25,15,1,14
497277,35,14,2,12,14,2,12,,,
497286,35,39,35,4,39,35,4,,,
497338,35,6,1,5,6,1,5,,,
497408,35,15,7,8,12,7,5,3,0,3
497453,35,1,0,1,1,0,1,,,
497480,35,373,22,351,343,10,333,30,12,18
497790,35,2,2,0,2,2,0,,,
497824,35,16,5,11,13,4,9,3,1,2
497833,35,10,5,5,9,5,4,1,0,1
498030,35,44,44,0,44,44,0,,,
498049,35,77,7,70,39,2,37,38,5,33
498076,35,98,7,91,21,1,20,77,6,71
498085,35,178,16,162,42,5,37,136,11,125
498094,35,173,6,167,58,3,55,115,3,112
498100,35,216,16,200,15,0,15,201,16,185
498119,35,44,3,41,6,0,6,38,3,35
498243,35,1,0,1,1,0,1,,,
498340,35,3,1,2,3,1,2,,,
498447,35,56,2,54,28,2,26,28,0,28
498456,35,65,4,61,38,1,37,27,3,24
498483,35,4,0,4,1,0,1,3,0,3
498562,35,473,232,241,420,214,206,53,18,35
498571,35,704,282,422,487,210,277,217,72,145
100654,36,3430,1398,2032,3049,1236,1813,381,162,219
100663,36,9426,3585,5841,7308,2774,4534,2118,811,1307
100690,36,29,6,23,10,2,8,19,4,15
100706,36,5175,3093,2082,4222,2538,1684,953,555,398
100724,36,2229,765,1464,1982,676,1306,247,89,158
100751,36,22130,9713,12417,20048,8805,11243,2082,908,1174
100760,36,516,182,334,201,92,109,315,90,225
100812,36,1778,534,1244,686,200,486,1092,334,758
100830,36,2564,852,1712,1816,579,1237,748,273,475
100858,36,18810,9522,9288,16695,8367,8328,2115,1155,960
100937,36,698,350,348,692,349,343,6,1,5
101028,36,678,188,490,236,87,149,442,101,341
101116,36,228,31,197,151,25,126,77,6,71
101143,36,773,397,376,464,265,199,309,132,177
101161,36,2913,952,1961,1313,491,822,1600,461,1139
101189,36,1088,453,635,801,353,448,287,100,187
101240,36,2136,691,1445,993,394,599,1143,297,846
101277,36,8,0,8,8,0,8,,,
101286,36,2076,509,1567,664,186,478,1412,323,1089
101295,36,2410,747,1663,1053,389,664,1357,358,999
101301,36,519,133,386,226,86,140,293,47,246
101365,36,429,90,339,207,52,155,222,38,184
101435,36,513,280,233,494,273,221,19,7,12
101453,36,54,49,5,19,17,2,35,32,3
101462,36,395,148,247,99,42,57,296,106,190
101471,36,236,185,51,198,155,43,38,30,8
101480,36,4650,1864,2786,4006,1574,2432,644,290,354
101505,36,3626,1251,2375,1013,419,594,2613,832,1781
101514,36,4358,1819,2539,1435,695,740,2923,1124,1799
101569,36,1567,509,1058,555,218,337,1012,291,721
101587,36,1637,475,1162,1160,310,850,477,165,312
101602,36,613,204,409,326,114,212,287,90,197
101648,36,108,82,26,108,82,26,,,
101675,36,843,367,476,790,342,448,53,25,28
101693,36,828,298,530,775,281,494,53,17,36
101709,36,1451,523,928,1309,470,839,142,53,89
101736,36,1270,429,841,411,167,244,859,262,597
101879,36,3636,1335,2301,3018,1066,1952,618,269,349
101897,36,964,301,663,404,134,270,560,167,393
101912,36,963,396,567,894,363,531,69,33,36
101994,36,154,50,104,82,41,41,72,9,63
102030,36,1135,319,816,449,167,282,686,152,534
102049,36,2605,854,1751,2553,835,1718,52,19,33
102058,36,22,11,11,10,4,6,12,7,5
102067,36,2004,772,1232,828,392,436,1176,380,796
102076,36,754,255,499,398,139,259,356,116,240
102094,36,5843,2287,3556,4830,1835,2995,1013,452,561
102234,36,650,271,379,622,261,361,28,10,18
102270,36,510,218,292,412,175,237,98,43,55
102298,36,663,329,334,624,311,313,39,18,21
102313,36,988,368,620,436,186,250,552,182,370
102368,36,7599,2631,4968,5042,1733,3309,2557,898,1659
102377,36,1498,552,946,1385,501,884,113,51,62
102395,36,74,60,14,20,12,8,54,48,6
102429,36,1356,423,933,489,201,288,867,222,645
102553,36,5694,2217,3477,2828,1189,1639,2866,1028,1838
102580,36,24,18,6,15,12,3,9,6,3
102614,36,2922,1121,1801,1442,652,790,1480,469,1011
102632,36,666,196,470,262,88,174,404,108,296
102669,36,138,40,98,106,28,78,32,12,20
102711,36,34,25,9,24,21,3,10,4,6
102845,36,1564,409,1155,1564,409,1155,,,
103501,36,82,12,70,82,12,70,,,
103741,36,107,8,99,66,7,59,41,1,40
103893,36,752,147,605,752,147,605,,,
103909,36,375,47,328,375,47,328,,,
103927,36,334,63,271,334,63,271,,,
103954,36,30,2,28,30,2,28,,,
103963,36,241,206,35,241,206,35,,,
104090,36,661,81,580,661,81,580,,,
104151,36,45540,23225,22315,41279,20740,20539,4261,2485,1776
104160,36,5242,2046,3196,1290,580,710,3952,1466,2486
104179,36,26062,11556,14506,22243,9592,12651,3819,1964,1855
104346,36,1911,694,1217,489,195,294,1422,499,923
104391,36,16,0,16,16,0,16,,,
104425,36,2046,909,1137,784,305,479,1262,604,658
104443,36,34,5,29,26,4,22,8,1,7
104568,36,150,1,149,73,1,72,77,0,77
104577,36,1938,699,1239,570,255,315,1368,444,924
104586,36,2256,1647,609,2120,1534,586,136,113,23
104708,36,6800,2902,3898,1848,944,904,4952,1958,2994
104717,36,45368,13215,32153,14536,5741,8795,30832,7474,23358
105145,36,2223,700,1523,527,177,350,1696,523,1173
105154,36,7616,3423,4193,2105,1026,1079,5511,2397,3114
105206,36,2215,628,1587,481,164,317,1734,464,1270
105215,36,308,283,25,308,283,25,,,
105297,36,1116,246,870,535,123,412,581,123,458
105330,36,15738,5801,9937,13289,4962,8327,2449,839,1610
105349,36,670,187,483,145,51,94,525,136,389
105428,36,4364,1356,3008,1137,409,728,3227,947,2280
105525,36,9202,3851,5351,1921,868,1053,7281,2983,4298
105534,36,1824,367,1457,1824,367,1457,,,
105543,36,541,90,451,541,90,451,,,
105589,36,246,87,159,182,70,112,64,17,47
105659,36,648,597,51,648,597,51,,,
105668,36,2331,771,1560,331,107,224,2000,664,1336
105677,36,13,13,0,13,13,0,,,
105747,36,2757,1193,1564,734,354,380,2023,839,1184
105792,36,1289,517,772,332,140,192,957,377,580
105899,36,635,389,246,542,343,199,93,46,47
106041,36,1006,955,51,1006,955,51,,,
106148,36,2384,907,1477,625,332,293,1759,575,1184
106245,36,3412,1229,2183,1851,743,1108,1561,486,1075
106263,36,838,129,709,453,71,382,385,58,327
106306,36,279,213,66,265,202,63,14,11,3
106315,36,91,1,90,91,1,90,,,
106324,36,4,0,4,3,0,3,1,0,1
106342,36,305,176,129,300,173,127,5,3,2
106351,36,57,27,30,57,27,30,,,
106360,36,16,1,15,16,1,15,,,
106397,36,17435,7616,9819,15214,6724,8490,2221,892,1329
106412,36,1470,607,863,1238,523,715,232,84,148
106449,36,1064,349,715,638,228,410,426,121,305
106458,36,5338,1976,3362,3491,1406,2085,1847,570,1277
106467,36,4340,1808,2532,3388,1480,1908,952,328,624
106485,36,1264,481,783,1022,422,600,242,59,183
106494,36,31,0,31,31,0,31,,,
106546,36,342,33,309,304,29,275,38,4,34
106625,36,628,185,443,375,112,263,253,73,180
106704,36,5208,2019,3189,4314,1682,2632,894,337,557
106713,36,328,175,153,301,167,134,27,8,19
106795,36,537,136,401,247,72,175,290,64,226
106810,36,101,56,45,100,55,45,1,1,0
106883,36,357,78,279,200,49,151,157,29,128
106908,36,309,16,293,299,16,283,10,0,10
106980,36,1107,397,710,592,234,358,515,163,352
106999,36,412,119,293,242,71,171,170,48,122
107044,36,2279,1003,1276,2104,909,1195,175,94,81
107071,36,1266,616,650,1101,529,572,165,87,78
107080,36,752,359,393,745,352,393,7,7,0
107099,36,81,4,77,81,4,77,,,
107123,36,41,11,30,41,11,30,,,
107141,36,965,394,571,902,373,529,63,21,42
107220,36,57,0,57,57,0,57,,,
107293,36,46,0,46,46,0,46,,,
107318,36,301,101,200,84,16,68,217,85,132
107327,36,497,152,345,242,88,154,255,64,191
107442,36,25,12,13,25,12,13,,,
107460,36,669,227,442,368,139,229,301,88,213
107488,36,3,2,1,2,1,1,1,1,0
107512,36,1095,465,630,1075,455,620,20,10,10
107521,36,279,66,213,169,37,132,110,29,81
107549,36,412,82,330,282,61,221,130,21,109
107558,36,483,228,255,480,228,252,3,0,3
107585,36,886,312,574,483,184,299,403,128,275
107600,36,442,164,278,380,145,235,62,19,43
107619,36,435,115,320,262,75,187,173,40,133
107637,36,542,108,434,102,24,78,440,84,356
107655,36,25,0,25,25,0,25,,,
107664,36,2602,805,1797,1270,428,842,1332,377,955
107725,36,492,110,382,189,57,132,303,53,250
107743,36,243,78,165,164,53,111,79,25,54
107789,36,80,1,79,80,1,79,,,
107831,36,79,1,78,79,1,78,,,
107840,36,195,69,126,174,59,115,21,10,11
107877,36,368,176,192,363,173,190,5,3,2
107974,36,544,111,433,264,74,190,280,37,243
107983,36,1884,828,1056,1749,774,975,135,54,81
107992,36,354,132,222,214,76,138,140,56,84
108065,36,7,0,7,3,0,3,4,0,4
108092,36,3014,1155,1859,2249,863,1386,765,292,473
108232,36,3710,1590,2120,1810,848,962,1900,742,1158
108667,36,2343,962,1381,310,183,127,2033,779,1254
108807,36,5709,2517,3192,2035,935,1100,3674,1582,2092
108852,36,132,60,72,132,60,72,,,
108861,36,7,5,2,3,2,1,4,3,1
108977,36,201,44,157,104,23,81,97,21,76
109040,36,1580,371,1209,1580,371,1209,,,
109208,36,16868,8873,7995,2717,1197,1520,14151,7676,6475
109350,36,7170,2943,4227,1993,919,1074,5177,2024,3153
109651,36,1705,723,982,1425,596,829,280,127,153
109721,36,56,18,38,56,18,38,,,
109730,36,53,29,24,53,29,24,,,
109785,36,2692,837,1855,2307,718,1589,385,119,266
109819,36,13942,5843,8099,5130,2071,3059,8812,3772,5040
109907,36,1478,444,1034,705,203,502,773,241,532
109934,36,320,31,289,320,31,289,,,
110060,36,138,108,30,118,95,23,20,13,7
110097,36,2523,973,1550,2261,877,1384,262,96,166
110194,36,61,61,0,61,61,0,,,
110219,36,1252,279,973,1252,279,973,,,
110246,36,5767,2393,3374,2673,1178,1495,3094,1215,1879
110316,36,32,5,27,25,4,21,7,1,6
110334,36,5269,2233,3036,1058,443,615,4211,1790,2421
110361,36,5741,2107,3634,5057,1862,3195,684,245,439
110370,36,864,330,534,819,305,514,45,25,20
110404,36,750,416,334,750,416,334,,,
110413,36,1685,777,908,1639,759,880,46,18,28
110422,36,15043,7864,7179,14047,7263,6784,996,601,395
110468,36,227,82,145,,,,227,82,145
110486,36,5866,2022,3844,4612,1565,3047,1254,457,797
110495,36,6430,2142,4288,4901,1579,3322,1529,563,966
110510,36,11920,4523,7397,9344,3458,5886,2576,1065,1511
110529,36,18465,10131,8334,15243,8254,6989,3222,1877,1345
110538,36,9498,4367,5131,8410,3837,4573,1088,530,558
110547,36,9901,3767,6134,7053,2643,4410,2848,1124,1724
110556,36,15064,6167,8897,12301,4889,7412,2763,1278,1485
110565,36,25449,10764,14685,19301,8003,11298,6148,2761,3387
110574,36,7974,3246,4728,5839,2370,3469,2135,876,1259
110583,36,23451,9957,13494,18985,7833,11152,4466,2124,2342
110592,36,16135,6663,9472,12861,5165,7696,3274,1498,1776
110608,36,22055,10073,11982,17327,7653,9674,4728,2420,2308
110617,36,20897,9220,11677,15843,6749,9094,5054,2471,2583
110635,36,23043,10450,12593,21562,9740,11822,1481,710,771
110644,36,22338,8924,13414,21642,8602,13040,696,322,374
110653,36,20399,9113,11286,19738,8774,10964,661,339,322
110662,36,22274,8936,13338,21719,8643,13076,555,293,262
110671,36,15812,7604,8208,15021,7148,7873,791,456,335
110680,36,23478,11471,12007,22625,10982,11643,853,489,364
110705,36,16356,7181,9175,15828,6896,8932,528,285,243
110714,36,12416,6425,5991,11716,6007,5709,700,418,282
110778,36,1,0,1,,,,1,0,1
110875,36,41,0,41,41,0,41,,,
110918,36,11,6,5,3,1,2,8,5,3
111045,36,16,7,9,16,7,9,,,
111054,36,125,24,101,125,24,101,,,
111081,36,685,274,411,670,264,406,15,10,5
111188,36,593,464,129,564,442,122,29,22,7
111434,36,2696,970,1726,389,168,221,2307,802,1505
111461,36,12597,7386,5211,3095,1531,1564,9502,5855,3647
111513,36,173,3,170,133,1,132,40,2,38
111638,36,318,122,196,318,122,196,,,
111708,36,172,147,25,172,147,25,,,
111717,36,143,112,31,141,112,29,2,0,2
111726,36,126,98,28,126,98,28,,,
111744,36,70,66,4,70,66,4,,,
111762,36,85,49,36,85,49,36,,,
111799,36,133,22,111,133,22,111,,,
111887,36,11990,5619,6371,4846,2139,2707,7144,3480,3664
111896,36,2060,944,1116,419,192,227,1641,752,889
111920,36,6528,3126,3402,1663,750,913,4865,2376,2489
111939,36,10535,3905,6630,3187,1252,1935,7348,2653,4695
111948,36,5272,2159,3113,4959,2020,2939,313,139,174
111966,36,158,57,101,108,42,66,50,15,35
112075,36,1094,438,656,886,350,536,208,88,120
112084,36,208,101,107,159,86,73,49,15,34
112172,36,5614,2454,3160,2324,1022,1302,3290,1432,1858
112181,36,98,2,96,98,2,96,,,
112190,36,10667,4795,5872,3152,1636,1516,7515,3159,4356
112260,36,1051,515,536,1045,510,535,6,5,1
112288,36,39,0,39,39,0,39,,,
112367,36,161,23,138,,,,161,23,138
112385,36,3656,2128,1528,333,146,187,3323,1982,1341
112394,36,299,219,80,230,170,60,69,49,20
112455,36,101,26,75,101,26,75,,,
112561,36,1333,540,793,540,251,289,793,289,504
112570,36,252,149,103,158,98,60,94,51,43
112686,36,1774,557,1217,452,169,283,1322,388,934
112826,36,3092,1131,1961,877,387,490,2215,744,1471
113096,36,7539,3128,4411,1591,758,833,5948,2370,3578
113111,36,2832,1289,1543,822,354,468,2010,935,1075
113193,36,5283,2458,2825,1940,977,963,3343,1481,1862
113218,36,4370,1869,2501,934,444,490,3436,1425,2011
113236,36,8033,3386,4647,2812,1287,1525,5221,2099,3122
113333,36,9601,4844,4757,4625,2505,2120,4976,2339,2637
113449,36,143,37,106,143,37,106,,,
113537,36,8,1,7,8,1,7,,,
113573,36,6374,2570,3804,2448,1101,1347,3926,1469,2457
113582,36,73,6,67,55,6,49,18,0,18
113634,36,10442,5105,5337,3905,2011,1894,6537,3094,3443
113698,36,835,239,596,721,205,516,114,34,80
113856,36,17974,9370,8604,2991,1282,1709,14983,8088,6895
113980,36,11298,5159,6139,3677,1734,1943,7621,3425,4196
114266,36,4696,2076,2620,1144,554,590,3552,1522,2030
114354,36,1119,205,914,770,134,636,349,71,278
114433,36,755,403,352,276,129,147,479,274,205
114460,36,241,29,212,156,18,138,85,11,74
114637,36,76,5,71,76,5,71,,,
114716,36,6935,3791,3144,2125,1022,1103,4810,2769,2041
114761,36,55,8,47,55,8,47,,,
114789,36,13012,5825,7187,3337,1389,1948,9675,4436,5239
114813,36,1333,367,966,654,211,443,679,156,523
114859,36,11486,5310,6176,4130,2034,2096,7356,3276,4080
114938,36,2361,1032,1329,825,359,466,1536,673,863
114947,36,111,47,64,111,47,64,,,
115001,36,6968,3046,3922,3610,1646,1964,3358,1400,1958
115010,36,534,120,414,534,120,414,,,
115083,36,550,397,153,398,315,83,152,82,70
115126,36,5433,2413,3020,1683,815,868,3750,1598,2152
115296,36,7659,3050,4609,2174,946,1228,5485,2104,3381
115357,36,136,41,95,73,29,44,63,12,51
115393,36,5321,2409,2912,1980,873,1107,3341,1536,1805
115409,36,662,338,324,662,338,324,,,
115658,36,87,8,79,36,4,32,51,4,47
115728,36,331,115,216,265,94,171,66,21,45
115755,36,3601,1516,2085,3028,1243,1785,573,273,300
115773,36,126,23,103,58,13,45,68,10,58
115861,36,5090,2101,2989,2166,879,1287,2924,1222,1702
115931,36,458,369,89,458,369,89,,,
116226,36,94,6,88,36,4,32,58,2,56
116350,36,96,10,86,95,10,85,1,0,1
116439,36,5442,2809,2633,2022,1131,891,3420,1678,1742
116563,36,149,5,144,149,5,144,,,
116846,36,9,1,8,8,1,7,1,0,1
117052,36,3106,1389,1717,1057,553,504,2049,836,1213
117104,36,266,123,143,223,99,124,43,24,19
117140,36,2381,959,1422,1891,754,1137,490,205,285
117168,36,540,136,404,463,115,348,77,21,56
117195,36,1109,624,485,311,149,162,798,475,323
117238,36,33,1,32,33,1,32,,,
117247,36,4282,1897,2385,935,462,473,3347,1435,1912
117274,36,955,660,295,232,110,122,723,550,173
117283,36,33,13,20,19,6,13,14,7,7
117557,36,81,59,22,77,56,21,4,3,1
117575,36,26,16,10,2,1,1,24,15,9
117627,36,788,320,468,742,303,439,46,17,29
117636,36,685,186,499,590,156,434,95,30,65
117645,36,14337,6039,8298,4875,2061,2814,9462,3978,5484
117672,36,90,15,75,76,13,63,14,2,12
117690,36,3232,1233,1999,788,334,454,2444,899,1545
117706,36,8495,3657,4838,2391,1082,1309,6104,2575,3529
117715,36,1903,496,1407,261,75,186,1642,421,1221
117724,36,5214,2849,2365,1340,795,545,3874,2054,1820
117733,36,7646,3146,4500,1689,766,923,5957,2380,3577
117751,36,1000,540,460,729,349,380,271,191,80
117788,36,6733,2910,3823,1638,742,896,5095,2168,2927
117803,36,133,33,100,,,,133,33,100
117867,36,4235,1599,2636,961,392,569,3274,1207,2067
117894,36,4570,1897,2673,1513,675,838,3057,1222,1835
117946,36,5122,2437,2685,4981,2361,2620,141,76,65
117955,36,221,51,170,162,33,129,59,18,41
118134,36,70,4,66,24,4,20,46,0,46
118143,36,82,3,79,19,2,17,63,1,62
118161,36,112,2,110,112,2,110,,,
118198,36,639,121,518,639,121,518,,,
118347,36,2614,1061,1553,714,355,359,1900,706,1194
118684,36,1780,542,1238,500,179,321,1280,363,917
118693,36,481,277,204,461,267,194,20,10,10
118718,36,5942,2212,3730,2776,1001,1775,3166,1211,1955
118772,36,2989,905,2084,581,228,353,2408,677,1731
118912,36,6915,2744,4171,2461,1084,1377,4454,1660,2794
118930,36,3156,1375,1781,738,350,388,2418,1025,1393
118958,36,54,23,31,15,6,9,39,17,22
118976,36,12017,4426,7591,6002,2396,3606,6015,2030,3985
118994,36,377,224,153,377,224,153,,,
119058,36,9,4,5,8,4,4,1,0,1
119067,36,3912,1652,2260,1338,595,743,2574,1057,1517
119137,36,7308,3343,3965,2491,1217,1274,4817,2126,2691
119164,36,17014,7857,9157,5554,2747,2807,11460,5110,6350
119173,36,1205,66,1139,1003,46,957,202,20,182
119216,36,8334,3135,5199,2945,1214,1731,5389,1921,3468
119270,36,553,418,135,370,281,89,183,137,46
119331,36,2410,927,1483,876,371,505,1534,556,978
119553,36,920,254,666,902,251,651,18,3,15
119605,36,6352,3028,3324,3809,1771,2038,2543,1257,1286
119775,36,183,109,74,154,89,65,29,20,9
119951,36,124,13,111,124,13,111,,,
120069,36,287,45,242,287,45,242,,,
120078,36,477,78,399,477,78,399,,,
120087,36,183,26,157,183,26,157,,,
120166,36,7,5,2,7,5,2,,,
120254,36,1365,576,789,1343,563,780,22,13,9
120290,36,4241,2050,2191,1721,875,846,2520,1175,1345
120342,36,9963,4991,4972,3442,1806,1636,6521,3185,3336
120403,36,832,253,579,802,241,561,30,12,18
120421,36,3629,1575,2054,911,391,520,2718,1184,1534
120537,36,395,170,225,327,136,191,68,34,34
120661,36,550,141,409,524,140,384,26,1,25
120698,36,19,1,18,18,1,17,1,0,1
120768,36,325,24,301,,,,325,24,301
120838,36,5,1,4,5,1,4,,,
120865,36,571,206,365,493,190,303,78,16,62
120883,36,2222,1028,1194,2143,993,1150,79,35,44
120953,36,3009,2652,357,375,270,105,2634,2382,252
120971,36,10506,5376,5130,3261,1604,1657,7245,3772,3473
121044,36,13297,5955,7342,4374,2124,2250,8923,3831,5092
121150,36,2635,1133,1502,2455,1056,1399,180,77,103
121257,36,886,353,533,854,341,513,32,12,20
121275,36,18,11,7,18,11,7,,,
121309,36,2138,725,1413,1842,628,1214,296,97,199
121345,36,1267,582,685,1267,582,685,,,
121363,36,1982,660,1322,860,332,528,1122,328,794
121433,36,102,5,97,101,5,96,1,0,1
121619,36,15086,9125,5961,2341,1121,1220,12745,8004,4741
121637,36,100,10,90,94,10,84,6,0,6
121691,36,1397,550,847,1326,523,803,71,27,44
121707,36,2292,1065,1227,765,382,383,1527,683,844
121859,36,191,22,169,108,22,86,83,0,83
121868,36,183,2,181,91,0,91,92,2,90
121886,36,10353,6048,4305,2276,1109,1167,8077,4939,3138
121901,36,10706,4232,6474,2612,1130,1482,8094,3102,4992
122117,36,2,1,1,2,1,1,,,
122180,36,10699,4122,6577,2504,1011,1493,8195,3111,5084
122205,36,10209,4471,5738,3371,1668,1703,6838,2803,4035
122296,36,462,94,368,414,87,327,48,7,41
122339,36,6214,2701,3513,834,372,462,5380,2329,3051
122375,36,9996,4249,5747,2021,945,1076,7975,3304,4671
122384,36,6840,3888,2952,836,524,312,6004,3364,2640
122409,36,20964,9131,11833,18109,7713,10396,2855,1418,1437
122436,36,4052,1794,2258,3947,1744,2203,105,50,55
122506,36,168,104,64,168,104,64,,,
122597,36,15392,6912,8480,11958,5237,6721,3434,1675,1759
122612,36,4075,1442,2633,3901,1372,2529,174,70,104
122658,36,9175,3575,5600,4453,1871,2582,4722,1704,3018
122685,36,1644,412,1232,1644,412,1232,,,
122694,36,605,185,420,605,185,420,,,
122728,36,774,302,472,587,232,355,187,70,117
122746,36,3989,1545,2444,865,361,504,3124,1184,1940
122755,36,19409,10161,9248,15030,7816,7214,4379,2345,2034
122791,36,3992,1994,1998,1001,569,432,2991,1425,1566
122889,36,6989,2903,4086,3394,1514,1880,3595,1389,2206
122931,36,4266,2253,2013,4161,2184,1977,105,69,36
122977,36,14116,6153,7963,5010,2331,2679,9106,3822,5284
123013,36,10774,4700,6074,3270,1536,1734,7504,3164,4340
123165,36,806,0,806,804,0,804,2,0,2
123217,36,7433,3007,4426,2896,1220,1676,4537,1787,2750
123280,36,18,8,10,6,3,3,12,5,7
123299,36,3810,1347,2463,1834,660,1174,1976,687,1289
123341,36,9216,4026,5190,3650,1706,1944,5566,2320,3246
123350,36,115,26,89,93,25,68,22,1,21
123457,36,465,177,288,408,154,254,57,23,34
123484,36,589,283,306,283,144,139,306,139,167
123493,36,43,8,35,43,8,35,,,
123509,36,4158,1924,2234,1040,535,505,3118,1389,1729
123527,36,6321,2391,3930,1445,593,852,4876,1798,3078
123554,36,1412,601,811,1340,574,766,72,27,45
123563,36,5150,2147,3003,1506,599,907,3644,1548,2096
123572,36,4189,1564,2625,3520,1269,2251,669,295,374
123642,36,202,16,186,126,11,115,76,5,71
123651,36,1300,409,891,1161,366,795,139,43,96
123679,36,634,185,449,556,172,384,78,13,65
123800,36,10637,4652,5985,4101,1796,2305,6536,2856,3680
123952,36,193,118,75,173,105,68,20,13,7
123961,36,15788,7635,8153,15352,7386,7966,436,249,187
124113,36,2092,1119,973,477,150,327,1615,969,646
124292,36,361,173,188,361,173,188,,,
124487,36,68,26,42,11,5,6,57,21,36
124681,36,907,363,544,907,363,544,,,
124706,36,616,137,479,616,137,479,,,
124937,36,525,180,345,467,171,296,58,9,49
125028,36,6275,2565,3710,1799,831,968,4476,1734,2742
125082,36,73,12,61,70,10,60,3,2,1
125091,36,7062,2657,4405,2259,916,1343,4803,1741,3062
125170,36,2336,1010,1326,461,228,233,1875,782,1093
125231,36,4802,740,4062,1132,137,995,3670,603,3067
125310,36,34,12,22,34,12,22,,,
125462,36,1186,534,652,272,127,145,914,407,507
125471,36,4133,1644,2489,952,420,532,3181,1224,1957
125499,36,3639,1524,2115,1162,543,619,2477,981,1496
125532,36,1298,131,1167,1298,131,1167,,,
125727,36,883,351,532,876,345,531,7,6,1
125763,36,794,317,477,769,307,462,25,10,15
125897,36,641,306,335,580,278,302,61,28,33
126076,36,55,55,0,55,55,0,,,
126119,36,2896,985,1911,848,326,522,2048,659,1389
126182,36,859,468,391,658,344,314,201,124,77
126207,36,2162,885,1277,841,385,456,1321,500,821
126289,36,3327,1236,2091,903,386,517,2424,850,1574
126359,36,139,13,126,139,13,126,,,
126562,36,7653,3391,4262,5559,2467,3092,2094,924,1170
126580,36,6489,2981,3508,4936,2266,2670,1553,715,838
126605,36,226,199,27,226,199,27,,,
126614,36,22050,12077,9973,20360,11038,9322,1690,1039,651
126669,36,3736,1068,2668,1277,436,841,2459,632,1827
126678,36,1613,724,889,1578,708,870,35,16,19
126687,36,637,116,521,637,116,521,,,
126711,36,2118,754,1364,837,360,477,1281,394,887
126748,36,268,81,187,165,59,106,103,22,81
126775,36,4017,2723,1294,3778,2563,1215,239,160,79
126784,36,99,98,1,99,98,1,,,
126818,36,17907,8221,9686,15458,7009,8449,2449,1212,1237
126827,36,18043,6739,11304,10953,4184,6769,7090,2555,4535
126863,36,2095,807,1288,504,259,245,1591,548,1043
126915,36,17,7,10,11,6,5,6,1,5
126942,36,2932,1041,1891,951,336,615,1981,705,1276
126951,36,817,740,77,817,740,77,,,
127060,36,4182,1864,2318,3904,1721,2183,278,143,135
127158,36,3361,2981,380,1104,884,220,2257,2097,160
127185,36,2082,948,1134,1860,856,1004,222,92,130
127200,36,7205,2978,4227,2236,1067,1169,4969,1911,3058
127316,36,252,41,211,71,19,52,181,22,159
127389,36,170,73,97,109,53,56,61,20,41
127556,36,5471,2482,2989,4449,1998,2451,1022,484,538
127565,36,10872,4850,6022,6493,2961,3532,4379,1889,2490
127617,36,379,113,266,136,40,96,243,73,170
127653,36,208,54,154,184,44,140,24,10,14
127714,36,254,110,144,20,6,14,234,104,130
127732,36,470,171,299,319,139,180,151,32,119
127741,36,4297,1416,2881,3769,1246,2523,528,170,358
127778,36,397,149,248,260,106,154,137,43,94
127820,36,5529,2114,3415,1956,826,1130,3573,1288,2285
127884,36,2200,655,1545,801,296,505,1399,359,1040
127909,36,2523,1253,1270,853,462,391,1670,791,879
127918,36,1731,587,1144,1290,401,889,441,186,255
127945,36,1589,407,1182,852,227,625,737,180,557
127954,36,2,0,2,2,0,2,,,
128106,36,1967,900,1067,1575,701,874,392,199,193
128151,36,234,132,102,204,128,76,30,4,26
128179,36,511,368,143,511,368,143,,,
128188,36,812,309,503,812,309,503,,,
128258,36,614,267,347,284,139,145,330,128,202
128328,36,3031,2140,891,3031,2140,891,,,
128337,36,46,1,45,26,1,25,20,0,20
128391,36,1128,660,468,1035,601,434,93,59,34
128498,36,738,291,447,641,255,386,97,36,61
128577,36,532,232,300,173,90,83,359,142,217
128586,36,31,31,0,31,31,0,,,
128744,36,1150,336,814,920,294,626,230,42,188
128771,36,5466,2968,2498,4233,2307,1926,1233,661,572
128780,36,978,248,730,267,60,207,711,188,523
128896,36,93,10,83,93,10,83,,,
128902,36,1265,494,771,1265,494,771,,,
129002,36,333,190,143,309,183,126,24,7,17
129020,36,13990,6745,7245,13571,6507,7064,419,238,181
129154,36,1815,193,1622,180,40,140,1635,153,1482
129181,36,632,588,44,561,526,35,71,62,9
129215,36,2568,1085,1483,2338,975,1363,230,110,120
129242,36,3355,1409,1946,3308,1387,1921,47,22,25
129349,36,148,5,143,116,5,111,32,0,32
129367,36,1431,355,1076,244,79,165,1187,276,911
129482,36,280,19,261,280,19,261,,,
129525,36,2570,1152,1418,2420,1087,1333,150,65,85
129534,36,155,70,85,67,33,34,88,37,51
129543,36,1965,700,1265,595,238,357,1370,462,908
129695,36,2319,988,1331,744,335,409,1575,653,922
129729,36,2690,987,1703,804,351,453,1886,636,1250
129756,36,1036,404,632,356,166,190,680,238,442
129774,36,352,193,159,341,188,153,11,5,6
129808,36,1744,567,1177,471,208,263,1273,359,914
129923,36,476,221,255,304,136,168,172,85,87
129932,36,28,26,2,7,5,2,21,21,0
129941,36,3318,1451,1867,3087,1319,1768,231,132,99
130004,36,2412,973,1439,681,325,356,1731,648,1083
130040,36,592,199,393,203,83,120,389,116,273
130110,36,128,47,81,95,37,58,33,10,23
130174,36,1664,937,727,1185,682,503,479,255,224
130183,36,10836,2757,8079,4003,978,3025,6833,1779,5054
130217,36,611,219,392,169,62,107,442,157,285
130226,36,4216,1612,2604,4052,1540,2512,164,72,92
130253,36,4814,1588,3226,4375,1451,2924,439,137,302
130314,36,579,139,440,551,133,418,28,6,22
130396,36,3342,1185,2157,866,383,483,2476,802,1674
130493,36,4469,1693,2776,3696,1403,2293,773,290,483
130590,36,1547,777,770,1524,764,760,23,13,10
130606,36,1941,801,1140,716,301,415,1225,500,725
130624,36,748,445,303,748,445,303,,,
130697,36,2224,1007,1217,2218,1004,1214,6,3,3
130776,36,2738,1310,1428,2303,1108,1195,435,202,233
130794,36,5061,2482,2579,5010,2448,2562,51,34,17
130837,36,51,3,48,51,3,48,,,
130873,36,3,0,3,3,0,3,,,
130907,36,6975,1978,4997,1744,653,1091,5231,1325,3906
130934,36,2958,1057,1901,2592,880,1712,366,177,189
130943,36,13372,5588,7784,12764,5280,7484,608,308,300
130989,36,449,219,230,376,189,187,73,30,43
131061,36,96,5,91,54,4,50,42,1,41
131113,36,6027,2214,3813,1993,826,1167,4034,1388,2646
131159,36,5895,2167,3728,5645,2057,3588,250,110,140
131283,36,2129,877,1252,1960,834,1126,169,43,126
131399,36,2250,778,1472,950,407,543,1300,371,929
131450,36,692,330,362,635,304,331,57,26,31
131469,36,7500,2785,4715,7043,2592,4451,457,193,264
131496,36,5657,2414,3243,5465,2325,3140,192,89,103
131520,36,6582,1852,4730,6374,1755,4619,208,97,111
131803,36,257,56,201,16,7,9,241,49,192
131830,36,18,8,10,18,8,10,,,
131876,36,1052,22,1030,695,8,687,357,14,343
132374,36,1652,1444,208,1652,1444,208,,,
132408,36,197,105,92,123,59,64,74,46,28
132471,36,1749,615,1134,1496,511,985,253,104,149
132602,36,1535,571,964,1449,539,910,86,32,54
132657,36,1832,907,925,1692,841,851,140,66,74
132675,36,15,9,6,14,8,6,1,1,0
132693,36,7405,2911,4494,2350,1069,1281,5055,1842,3213
132709,36,18338,7215,11123,4725,2137,2588,13613,5078,8535
132842,36,133,22,111,75,9,66,58,13,45
132851,36,3090,1050,2040,1073,408,665,2017,642,1375
132879,36,94,55,39,87,49,38,7,6,1
132903,36,43463,19603,23860,29342,13157,16185,14121,6446,7675
132976,36,86,36,50,86,36,50,,,
133021,36,791,266,525,358,132,226,433,134,299
133155,36,296,139,157,146,89,57,150,50,100
133386,36,6733,2588,4145,2626,1216,1410,4107,1372,2735
133465,36,226,43,183,189,36,153,37,7,30
133492,36,1377,420,957,1321,398,923,56,22,34
133508,36,7207,2473,4734,2100,796,1304,5107,1677,3430
133526,36,715,371,344,641,338,303,74,33,41
133553,36,5077,3798,1279,4776,3549,1227,301,249,52
133650,36,5183,1763,3420,4517,1544,2973,666,219,447
133669,36,16423,6979,9444,11225,4804,6421,5198,2175,3023
133702,36,12848,4384,8464,3573,1360,2213,9275,3024,6251
133711,36,1664,554,1110,1597,530,1067,67,24,43
133809,36,338,157,181,331,156,175,7,1,6
133845,36,493,46,447,459,45,414,34,1,33
133854,36,259,58,201,259,58,201,,,
133863,36,356,51,305,356,51,305,,,
133872,36,716,126,590,274,50,224,442,76,366
133881,36,2169,1526,643,2033,1417,616,136,109,27
133951,36,29755,13254,16501,18874,8174,10700,10881,5080,5801
133960,36,595,238,357,210,106,104,385,132,253
133979,36,545,270,275,498,243,255,47,27,20
133997,36,246,81,165,246,81,165,,,
134024,36,48,10,38,48,10,38,,,
134079,36,1844,681,1163,1764,650,1114,80,31,49
134097,36,24815,10691,14124,21962,9297,12665,2853,1394,1459
134130,36,25632,11333,14299,22801,9834,12967,2831,1499,1332
134228,36,3,0,3,2,0,2,1,0,1
134237,36,17702,12295,5407,17702,12295,5407,,,
134291,36,110,82,28,96,69,27,14,13,1
134307,36,673,629,44,181,175,6,492,454,38
134343,36,2489,847,1642,1001,370,631,1488,477,1011
134422,36,10,0,10,4,0,4,6,0,6
134495,36,12860,5245,7615,4842,2269,2573,8018,2976,5042
134510,36,111,49,62,51,19,32,60,30,30
134529,36,200,21,179,200,21,179,,,
134574,36,88,16,72,88,16,72,,,
134608,36,7892,2922,4970,2295,1001,1294,5597,1921,3676
134714,36,242,32,210,90,18,72,152,14,138
134811,36,605,178,427,441,120,321,164,58,106
134945,36,1644,639,1005,1465,587,878,179,52,127
135081,36,14632,4075,10557,8360,2584,5776,6272,1491,4781
135142,36,132,2,130,7,0,7,125,2,123
135160,36,1394,396,998,476,134,342,918,262,656
135179,36,445,276,169,265,168,97,180,108,72
135188,36,2134,761,1373,643,237,406,1491,524,967
135267,36,159,119,40,155,118,37,4,1,3
135276,36,122,78,44,107,65,42,15,13,2
135294,36,306,148,158,243,146,97,63,2,61
135337,36,67,6,61,15,4,11,52,2,50
135364,36,165,115,50,15,11,4,150,104,46
135391,36,4990,1732,3258,1645,653,992,3345,1079,2266
135407,36,146,88,58,145,87,58,1,1,0
135522,36,96,36,60,96,36,60,,,
135559,36,43,6,37,24,5,19,19,1,18
135610,36,53,28,25,27,13,14,26,15,11
135647,36,542,476,66,419,383,36,123,93,30
135717,36,28847,11805,17042,10443,4337,6106,18404,7468,10936
135726,36,9247,4298,4949,8891,4121,4770,356,177,179
135735,36,954,883,71,216,193,23,738,690,48
136109,36,95,1,94,51,1,50,44,0,44
136145,36,494,104,390,152,29,123,342,75,267
136172,36,9504,4155,5349,6768,2900,3868,2736,1255,1481
136215,36,4424,1223,3201,3939,1137,2802,485,86,399
136233,36,2267,863,1404,948,401,547,1319,462,857
136303,36,9,1,8,9,1,8,,,
136330,36,1503,518,985,1409,481,928,94,37,57
136358,36,14409,5519,8890,3952,1810,2142,10457,3709,6748
136400,36,4724,1862,2862,1592,686,906,3132,1176,1956
136473,36,4619,1500,3119,1752,621,1131,2867,879,1988
136491,36,440,243,197,344,219,125,96,24,72
136516,36,4800,1578,3222,1499,524,975,3301,1054,2247
136659,36,117,91,26,98,76,22,19,15,4
136765,36,3,1,2,1,0,1,2,1,1
136774,36,1224,340,884,1201,335,866,23,5,18
136826,36,474,303,171,326,215,111,148,88,60
136950,36,1830,733,1097,1750,700,1050,80,33,47
137023,36,55,25,30,51,22,29,4,3,1
137032,36,4745,1862,2883,2663,997,1666,2082,865,1217
137078,36,14676,5324,9352,4227,1828,2399,10449,3496,6953
137087,36,409,217,192,387,212,175,22,5,17
137096,36,7375,3392,3983,2738,1407,1331,4637,1985,2652
137120,36,557,379,178,44,40,4,513,339,174
137209,36,8735,3694,5041,2622,1249,1373,6113,2445,3668
137245,36,658,356,302,658,356,302,,,
137272,36,34,32,2,34,32,2,,,
137281,36,2663,878,1785,763,291,472,1900,587,1313
137315,36,1512,461,1051,573,215,358,939,246,693
137351,36,26672,11722,14950,20644,8896,11748,6028,2826,3202
137476,36,1064,567,497,926,535,391,138,32,106
137546,36,1742,768,974,1698,739,959,44,29,15
137564,36,3392,1315,2077,2862,1078,1784,530,237,293
137591,36,157,39,118,100,31,69,57,8,49
137713,36,35,11,24,29,10,19,6,1,5
137759,36,5787,2428,3359,2586,1178,1408,3201,1250,1951
137777,36,25,25,0,25,25,0,,,
137801,36,211,108,103,211,108,103,,,
137847,36,7216,2780,4436,7004,2678,4326,212,102,110
137856,36,81,39,42,69,36,33,12,3,9
137865,36,239,127,112,239,127,112,,,
137953,36,198,108,90,105,65,40,93,43,50
137962,36,110,68,42,91,59,32,19,9,10
138187,36,23909,9544,14365,7151,3098,4053,16758,6446,10312
138275,36,375,195,180,338,176,162,37,19,18
138284,36,25,11,14,21,7,14,4,4,0
138293,36,692,485,207,514,360,154,178,125,53
138309,36,5957,797,5160,3094,433,2661,2863,364,2499
138354,36,6339,2697,3642,4305,1868,2437,2034,829,1205
138372,36,325,202,123,135,32,103,190,170,20
138479,36,270,169,101,270,169,101,,,
138488,36,103,30,73,78,14,64,25,16,9
138497,36,161,98,63,161,98,63,,,
138558,36,2103,859,1244,1440,678,762,663,181,482
138600,36,640,0,640,638,0,638,2,0,2
138655,36,394,262,132,375,251,124,19,11,8
138664,36,54,19,35,54,19,35,,,
138682,36,1477,359,1118,582,153,429,895,206,689
138716,36,3916,991,2925,2673,744,1929,1243,247,996
138761,36,120,48,72,80,43,37,40,5,35
138813,36,308,136,172,209,96,113,99,40,59
138822,36,509,18,491,509,18,491,,,
138840,36,1915,594,1321,571,247,324,1344,347,997
138868,36,530,246,284,366,185,181,164,61,103
138901,36,849,252,597,295,85,210,554,167,387
138938,36,304,24,280,173,7,166,131,17,114
138947,36,2129,507,1622,2006,462,1544,123,45,78
138956,36,2292,942,1350,794,333,461,1498,609,889
139144,36,1574,561,1013,1561,554,1007,13,7,6
139153,36,127,67,60,68,38,30,59,29,30
139199,36,766,51,715,531,30,501,235,21,214
139205,36,328,197,131,285,161,124,43,36,7
139250,36,1854,559,1295,1065,327,738,789,232,557
139278,36,3147,939,2208,837,308,529,2310,631,1679
139311,36,3429,1016,2413,2065,621,1444,1364,395,969
139357,36,1788,473,1315,529,149,380,1259,324,935
139366,36,4153,1728,2425,2843,1119,1724,1310,609,701
139384,36,2809,934,1875,967,359,608,1842,575,1267
139393,36,545,253,292,537,248,289,8,5,3
139463,36,3100,1164,1936,1789,683,1106,1311,481,830
139506,36,48,23,25,48,23,25,,,
139579,36,129,36,93,104,28,76,25,8,17
139621,36,706,307,399,465,209,256,241,98,143
139630,36,475,266,209,449,251,198,26,15,11
139658,36,5022,2127,2895,4958,2094,2864,64,33,31
139700,36,3026,1034,1992,1043,411,632,1983,623,1360
139719,36,1678,619,1059,1451,545,906,227,74,153
139746,36,61,12,49,61,12,49,,,
139755,36,12708,7647,5061,11501,6914,4587,1207,733,474
139764,36,1300,456,844,906,320,586,394,136,258
139861,36,3633,1270,2363,3237,1115,2122,396,155,241
139931,36,15426,6538,8888,12587,5316,7271,2839,1222,1617
139940,36,21552,8540,13012,15286,5997,9289,6266,2543,3723
139959,36,22486,9509,12977,20831,8695,12136,1655,814,841
139968,36,1550,457,1093,835,277,558,715,180,535
139986,36,2576,659,1917,782,210,572,1794,449,1345
139995,36,298,112,186,144,54,90,154,58,96
140003,36,94,13,81,45,5,40,49,8,41
140012,36,4618,1877,2741,1000,494,506,3618,1383,2235
140234,36,325,174,151,315,171,144,10,3,7
140243,36,2461,963,1498,620,255,365,1841,708,1133
140252,36,606,293,313,488,254,234,118,39,79
140331,36,4767,2017,2750,1397,657,740,3370,1360,2010
140340,36,506,73,433,249,45,204,257,28,229
140447,36,3156,1127,2029,2816,1043,1773,340,84,256
140553,36,1714,1713,1,1439,1439,0,275,274,1
140571,36,72,29,43,41,13,28,31,16,15
140678,36,1211,443,768,441,172,269,770,271,499
140696,36,962,350,612,930,337,593,32,13,19
140720,36,178,84,94,161,78,83,17,6,11
140818,36,768,230,538,703,216,487,65,14,51
140827,36,66,17,49,66,17,49,,,
140872,36,654,327,327,584,299,285,70,28,42
140942,36,2044,614,1430,612,241,371,1432,373,1059
140951,36,9222,2817,6405,7524,2281,5243,1698,536,1162
140960,36,1890,727,1163,1590,619,971,300,108,192
140988,36,765,335,430,708,320,388,57,15,42
141006,36,908,378,530,450,201,249,458,177,281
141015,36,37,16,21,36,15,21,1,1,0
141060,36,2502,168,2334,1729,0,1729,773,168,605
141167,36,467,213,254,306,140,166,161,73,88
141185,36,520,195,325,472,178,294,48,17,31
141237,36,579,272,307,538,247,291,41,25,16
141255,36,1685,480,1205,539,134,405,1146,346,800
141264,36,5573,1806,3767,4179,1382,2797,1394,424,970
141325,36,358,1,357,268,0,268,90,1,89
141334,36,5920,2086,3834,4430,1575,2855,1490,511,979
141361,36,551,246,305,547,245,302,4,1,3
141486,36,1018,263,755,841,214,627,177,49,128
141565,36,1654,597,1057,1230,463,767,424,134,290
141574,36,9362,3809,5553,7349,2901,4448,2013,908,1105
141608,36,45,33,12,45,33,12,,,
141644,36,1775,610,1165,1431,436,995,344,174,170
141680,36,1143,758,385,430,312,118,713,446,267
141796,36,2405,829,1576,822,327,495,1583,502,1081
141802,36,472,147,325,113,50,63,359,97,262
141811,36,2404,935,1469,969,429,540,1435,506,929
141839,36,1128,347,781,333,122,211,795,225,570
141981,36,1813,626,1187,1061,370,691,752,256,496
141990,36,523,161,362,201,51,150,322,110,212
142054,36,275,40,235,275,40,235,,,
142090,36,56,31,25,45,26,19,11,5,6
142115,36,12171,5299,6872,9310,4061,5249,2861,1238,1623
142179,36,843,284,559,352,143,209,491,141,350
142276,36,4877,1947,2930,3642,1438,2204,1235,509,726
142285,36,4653,2297,2356,4266,2094,2172,387,203,184
142294,36,742,376,366,734,371,363,8,5,3
142328,36,1549,540,1009,1187,432,755,362,108,254
142407,36,78,12,66,78,12,66,,,
142443,36,1830,618,1212,755,323,432,1075,295,780
142461,36,790,338,452,698,306,392,92,32,60
142489,36,53,7,46,53,7,46,,,
142522,36,34111,15171,18940,12136,5973,6163,21975,9198,12777
142559,36,2287,701,1586,951,354,597,1336,347,989
142887,36,71,29,42,56,21,35,15,8,7
142957,36,4,2,2,,,,4,2,2
143048,36,2057,526,1531,1838,462,1376,219,64,155
143084,36,1627,738,889,1612,729,883,15,9,6
143118,36,2773,892,1881,2539,825,1714,234,67,167
143215,36,3859,1558,2301,1492,628,864,2367,930,1437
143279,36,1425,448,977,606,235,371,819,213,606
143288,36,203,88,115,198,87,111,5,1,4
143297,36,137,14,123,114,11,103,23,3,20
143358,36,2949,1479,1470,2856,1419,1437,93,60,33
143376,36,226,10,216,153,10,143,73,0,73
143464,36,90,4,86,81,4,77,9,0,9
143473,36,26,2,24,7,1,6,19,1,18
143482,36,21,0,21,10,0,10,11,0,11
143491,36,24,0,24,8,0,8,16,0,16
143552,36,44,1,43,16,0,16,28,1,27
143613,36,759,225,534,411,152,259,348,73,275
143978,36,23,3,20,11,1,10,12,2,10
144005,36,1018,319,699,650,231,419,368,88,280
144050,36,5708,3006,2702,5704,3003,2701,4,3,1
144157,36,840,311,529,287,116,171,553,195,358
144166,36,3788,719,3069,1273,292,981,2515,427,2088
144175,36,724,265,459,250,108,142,474,157,317
144184,36,1455,541,914,500,206,294,955,335,620
144193,36,1361,684,677,516,326,190,845,358,487
144209,36,2736,1081,1655,1092,467,625,1644,614,1030
144218,36,2920,1345,1575,1029,534,495,1891,811,1080
144281,36,4281,1694,2587,4023,1584,2439,258,110,148
144351,36,880,375,505,775,333,442,105,42,63
144564,36,844,306,538,446,152,294,398,154,244
144573,36,108,2,106,75,0,75,33,2,31
144740,36,9940,4558,5382,8976,4067,4909,964,491,473
144795,36,257,57,200,232,53,179,25,4,21
144865,36,9552,4392,5160,3637,1808,1829,5915,2584,3331
144883,36,281,133,148,281,133,148,,,
144892,36,3105,1193,1912,2626,1037,1589,479,156,323
144944,36,4710,2103,2607,1541,753,788,3169,1350,1819
144962,36,1869,702,1167,1804,664,1140,65,38,27
144971,36,269,140,129,259,136,123,10,4,6
145099,36,201,11,190,201,11,190,,,
145239,36,165,14,151,165,14,151,,,
145309,36,22,6,16,22,6,16,,,
145336,36,1841,643,1198,1023,358,665,818,285,533
145354,36,41,2,39,6,0,6,35,2,33
145372,36,579,312,267,521,292,229,58,20,38
145406,36,375,7,368,110,5,105,265,2,263
145424,36,50,0,50,17,0,17,33,0,33
145433,36,86,1,85,36,1,35,50,0,50
145497,36,62,10,52,42,6,36,20,4,16
145521,36,488,154,334,233,80,153,255,74,181
145600,36,15213,7195,8018,13602,6393,7209,1611,802,809
145619,36,1349,696,653,1157,613,544,192,83,109
145637,36,24684,13283,11401,24063,12862,11201,621,421,200
145646,36,1103,539,564,1097,536,561,6,3,3
145682,36,3218,1172,2046,1050,494,556,2168,678,1490
145691,36,712,331,381,685,322,363,27,9,18
145707,36,341,132,209,219,102,117,122,30,92
145725,36,2134,1461,673,1969,1327,642,165,134,31
145813,36,12263,5230,7033,11332,4741,6591,931,489,442
145831,36,1167,489,678,452,205,247,715,284,431
146205,36,1352,522,830,735,303,432,617,219,398
146278,36,671,223,448,331,128,203,340,95,245
146296,36,7665,3302,4363,3126,1438,1688,4539,1864,2675
146339,36,535,248,287,485,235,250,50,13,37
146348,36,1252,439,813,466,189,277,786,250,536
146366,36,1011,346,665,515,186,329,496,160,336
146418,36,1128,456,672,486,223,263,642,233,409
146427,36,778,321,457,774,320,454,4,1,3
146454,36,10,0,10,10,0,10,,,
146472,36,6647,2893,3754,1982,1018,964,4665,1875,2790
146481,36,1195,493,702,1154,478,676,41,15,26
146506,36,1541,571,970,983,372,611,558,199,359
146533,36,91,14,77,64,11,53,27,3,24
146603,36,1575,587,988,714,316,398,861,271,590
146612,36,2551,1297,1254,2140,1070,1070,411,227,184
146667,36,79,47,32,48,30,18,31,17,14
146685,36,2552,928,1624,834,392,442,1718,536,1182
146700,36,850,677,173,850,677,173,,,
146719,36,8092,2544,5548,7679,2395,5284,413,149,264
146755,36,40,6,34,32,5,27,8,1,7
146807,36,56,7,49,17,2,15,39,5,34
146816,36,157,17,140,112,8,104,45,9,36
147004,36,3107,1424,1683,1388,668,720,1719,756,963
147013,36,879,431,448,776,396,380,103,35,68
147129,36,348,32,316,164,14,150,184,18,166
147244,36,1109,481,628,1066,469,597,43,12,31
147341,36,498,248,250,484,242,242,14,6,8
147369,36,1297,666,631,1026,502,524,271,164,107
147378,36,5149,2287,2862,2230,1025,1205,2919,1262,1657
147396,36,34,30,4,33,29,4,1,1,0
147411,36,1752,712,1040,574,267,307,1178,445,733
147536,36,2369,599,1770,1579,468,1111,790,131,659
147590,36,17,7,10,8,4,4,9,3,6
147642,36,42,5,37,4,0,4,38,5,33
147660,36,1600,773,827,1558,753,805,42,20,22
147679,36,1210,494,716,1116,456,660,94,38,56
147703,36,7716,3637,4079,6497,3011,3486,1219,626,593
147767,36,6571,3051,3520,6322,2942,3380,249,109,140
147776,36,2958,1190,1768,1595,637,958,1363,553,810
147800,36,4800,2332,2468,1410,780,630,3390,1552,1838
147819,36,16,1,15,16,1,15,,,
147828,36,1670,706,964,1604,684,920,66,22,44
147916,36,2085,953,1132,959,481,478,1126,472,654
148007,36,1762,630,1132,570,236,334,1192,394,798
148016,36,222,129,93,208,117,91,14,12,2
148098,36,41,1,40,26,1,25,15,0,15
148131,36,623,301,322,587,290,297,36,11,25
148256,36,753,291,462,525,205,320,228,86,142
148292,36,1069,327,742,323,108,215,746,219,527
148380,36,3187,1417,1770,1143,557,586,2044,860,1184
148405,36,629,276,353,588,260,328,41,16,25
148487,36,1596,608,988,1337,529,808,259,79,180
148496,36,1373,401,972,1273,376,897,100,25,75
148511,36,81,16,65,29,4,25,52,12,40
148575,36,164,24,140,137,22,115,27,2,25
148584,36,977,308,669,806,270,536,171,38,133
148593,36,38,2,36,32,2,30,6,0,6
148627,36,2065,760,1305,1892,692,1200,173,68,105
148654,36,1667,797,870,1121,503,618,546,294,252
148672,36,704,258,446,326,136,190,378,122,256
148821,36,373,121,252,188,57,131,185,64,121
148876,36,572,96,476,393,66,327,179,30,149
148937,36,395,163,232,264,124,140,131,39,92
148991,36,544,207,337,297,129,168,247,78,169
149028,36,137,14,123,87,12,75,50,2,48
149204,36,24,0,24,24,0,24,,,
149222,36,5332,2727,2605,4349,2155,2194,983,572,411
149231,36,6486,2752,3734,5142,2173,2969,1344,579,765
149310,36,54,24,30,54,24,30,,,
149329,36,45,45,0,45,45,0,,,
149365,36,1522,466,1056,454,164,290,1068,302,766
149505,36,556,208,348,498,195,303,58,13,45
149514,36,261,165,96,217,139,78,44,26,18
149532,36,4489,2213,2276,1339,589,750,3150,1624,1526
149550,36,120,13,107,81,13,68,39,0,39
149639,36,47,18,29,45,16,29,2,2,0
149727,36,3806,1594,2212,1250,598,652,2556,996,1560
149763,36,281,70,211,174,46,128,107,24,83
149772,36,3482,1498,1984,2895,1217,1678,587,281,306
149781,36,1591,717,874,1532,691,841,59,26,33
149842,36,6015,2517,3498,1934,967,967,4081,1550,2531
150066,36,735,345,390,660,317,343,75,28,47
150136,36,9467,3696,5771,8701,3407,5294,766,289,477
150145,36,770,289,481,694,271,423,76,18,58
150163,36,3025,1207,1818,2971,1173,1798,54,34,20
150172,36,335,186,149,219,109,110,116,77,39
150251,36,159,6,153,80,1,79,79,5,74
150303,36,228,2,226,107,0,107,121,2,119
150400,36,1189,602,587,1182,600,582,7,2,5
150428,36,12,0,12,12,0,12,,,
150455,36,404,184,220,402,182,220,2,2,0
150534,36,1026,390,636,986,376,610,40,14,26
150604,36,589,316,273,582,310,272,7,6,1
150668,36,496,188,308,462,176,286,34,12,22
150677,36,954,379,575,919,364,555,35,15,20
150756,36,650,338,312,646,335,311,4,3,1
150765,36,65,2,63,65,2,63,,,
150774,36,228,130,98,218,127,91,10,3,7
150853,36,177,3,174,95,3,92,82,0,82
150941,36,753,276,477,624,228,396,129,48,81
150987,36,37179,15486,21693,9446,3266,6180,27733,12220,15513
151102,36,3949,2020,1929,3077,1578,1499,872,442,430
151111,36,12730,5196,7534,10689,4239,6450,2041,957,1084
151263,36,2374,871,1503,2189,809,1380,185,62,123
151290,36,827,486,341,781,459,322,46,27,19
151306,36,3870,1383,2487,3302,1175,2127,568,208,360
151324,36,4864,2101,2763,3858,1641,2217,1006,460,546
151333,36,1712,583,1129,1395,464,931,317,119,198
151342,36,2614,905,1709,1947,652,1295,667,253,414
151351,36,25012,12601,12411,24190,12124,12066,822,477,345
151360,36,2096,526,1570,1449,365,1084,647,161,486
151379,36,2274,900,1374,1493,588,905,781,312,469
151388,36,1834,619,1215,1081,303,778,753,316,437
151467,36,116,13,103,116,13,103,,,
151564,36,3,0,3,2,0,2,1,0,1
151607,36,100,2,98,76,2,74,24,0,24
151661,36,640,545,95,640,545,95,,,
151777,36,627,304,323,605,296,309,22,8,14
151786,36,1667,585,1082,1444,550,894,223,35,188
151801,36,1451,513,938,1428,496,932,23,17,6
151810,36,137,44,93,57,18,39,80,26,54
151962,36,241,77,164,178,55,123,63,22,41
152044,36,16,13,3,6,5,1,10,8,2
152080,36,6691,3442,3249,6673,3429,3244,18,13,5
152099,36,411,224,187,379,197,182,32,27,5
152150,36,43,0,43,27,0,27,16,0,16
152275,36,100,35,65,52,2,50,48,33,15
152309,36,72,31,41,61,26,35,11,5,6
152318,36,1539,1145,394,1513,1126,387,26,19,7
152336,36,1076,334,742,957,316,641,119,18,101
152381,36,491,79,412,434,77,357,57,2,55
152390,36,962,0,962,956,0,956,6,0,6
152497,36,140,12,128,118,11,107,22,1,21
152530,36,1210,546,664,1164,519,645,46,27,19
152567,36,1537,964,573,1504,939,565,33,25,8
152600,36,1610,695,915,1577,679,898,33,16,17
152628,36,9,0,9,2,0,2,7,0,7
152637,36,2267,1131,1136,1566,807,759,701,324,377
152673,36,570,570,0,569,569,0,1,1,0
152798,36,129,14,115,113,11,102,16,3,13
152992,36,420,187,233,352,179,173,68,8,60
153001,36,983,332,651,872,305,567,111,27,84
153074,36,127,4,123,127,4,123,,,
153083,36,118,2,116,118,2,116,,,
153108,36,747,382,365,729,371,358,18,11,7
153126,36,454,238,216,443,231,212,11,7,4
153144,36,835,360,475,829,356,473,6,4,2
153162,36,699,356,343,698,355,343,1,1,0
153214,36,6225,2459,3766,2453,1129,1324,3772,1330,2442
153241,36,59,21,38,47,17,30,12,4,8
153250,36,1005,513,492,998,509,489,7,4,3
153269,36,1985,784,1201,1939,764,1175,46,20,26
153278,36,1029,605,424,825,522,303,204,83,121
153296,36,260,130,130,227,118,109,33,12,21
153302,36,125,59,66,109,51,58,16,8,8
153311,36,2150,642,1508,967,333,634,1183,309,874
153320,36,189,96,93,164,81,83,25,15,10
153366,36,574,280,294,541,273,268,33,7,26
153375,36,996,455,541,889,412,477,107,43,64
153384,36,1266,609,657,1260,607,653,6,2,4
153427,36,43,18,25,43,18,25,,,
153445,36,1521,589,932,932,416,516,589,173,416
153463,36,12,1,11,12,1,11,,,
153472,36,970,409,561,730,340,390,240,69,171
153524,36,1623,749,874,1162,584,578,461,165,296
153533,36,617,307,310,444,251,193,173,56,117
153542,36,19,2,17,19,2,17,,,
153597,36,56,1,55,56,1,55,,,
153603,36,17883,10034,7849,16944,9394,7550,939,640,299
153621,36,460,255,205,426,242,184,34,13,21
153630,36,1712,705,1007,949,503,446,763,202,561
153658,36,15328,6754,8574,14039,6144,7895,1289,610,679
153737,36,4951,1966,2985,2298,1054,1244,2653,912,1741
153746,36,21,0,21,21,0,21,,,
153764,36,29,0,29,29,0,29,,,
153773,36,8,1,7,8,1,7,,,
153782,36,9,0,9,9,0,9,,,
153825,36,857,489,368,811,454,357,46,35,11
153834,36,1183,531,652,1172,523,649,11,8,3
153861,36,455,112,343,340,88,252,115,24,91
153922,36,383,134,249,253,94,159,130,40,90
153977,36,521,57,464,198,26,172,323,31,292
154004,36,765,385,380,736,374,362,29,11,18
154013,36,822,286,536,652,240,412,170,46,124
154022,36,23058,8392,14666,18084,6582,11502,4974,1810,3164
154059,36,771,304,467,508,225,283,263,79,184
154095,36,5407,2054,3353,4871,1833,3038,536,221,315
154101,36,785,352,433,694,346,348,91,6,85
154110,36,1194,343,851,468,188,280,726,155,571
154129,36,441,184,257,242,140,102,199,44,155
154174,36,13,7,6,13,7,6,,,
154208,36,67,3,64,14,0,14,53,3,50
154235,36,1475,666,809,1410,635,775,65,31,34
154262,36,124,4,120,38,1,37,86,3,83
154332,36,61,2,59,61,2,59,,,
154350,36,761,354,407,713,333,380,48,21,27
154378,36,927,318,609,651,239,412,276,79,197
154396,36,399,130,269,276,109,167,123,21,102
154448,36,99,5,94,99,5,94,,,
154457,36,4,0,4,4,0,4,,,
154466,36,27,2,25,27,2,25,,,
154493,36,1633,650,983,848,336,512,785,314,471
154518,36,1707,1081,626,1146,676,470,561,405,156
154527,36,1025,496,529,985,469,516,40,27,13
154545,36,40,29,11,40,29,11,,,
154572,36,1441,475,966,731,327,404,710,148,562
154590,36,864,423,441,813,405,408,51,18,33
154642,36,650,283,367,356,210,146,294,73,221
154688,36,791,350,441,638,292,346,153,58,95
154697,36,1264,476,788,542,195,347,722,281,441
154712,36,1499,730,769,1478,719,759,21,11,10
154721,36,375,198,177,370,194,176,5,4,1
154749,36,343,185,158,334,183,151,9,2,7
154800,36,3829,1366,2463,1464,582,882,2365,784,1581
154855,36,313,135,178,286,124,162,27,11,16
154907,36,511,180,331,277,125,152,234,55,179
154925,36,397,210,187,334,184,150,63,26,37
154934,36,493,108,385,257,87,170,236,21,215
154952,36,977,363,614,540,248,292,437,115,322
154998,36,724,344,380,343,188,155,381,156,225
155007,36,253,64,189,112,39,73,141,25,116
155025,36,1839,676,1163,1710,632,1078,129,44,85
155052,36,174,80,94,121,50,71,53,30,23
155061,36,8232,3240,4992,3518,1405,2113,4714,1835,2879
155070,36,117,59,58,85,41,44,32,18,14
155089,36,624,296,328,548,270,278,76,26,50
155098,36,258,115,143,184,89,95,74,26,48
155104,36,723,301,422,482,228,254,241,73,168
155140,36,463,167,296,402,150,252,61,17,44
155159,36,46,0,46,46,0,46,,,
155177,36,180,71,109,166,67,99,14,4,10
155186,36,510,209,301,278,126,152,232,83,149
155195,36,1769,657,1112,797,354,443,972,303,669
155201,36,222,117,105,169,95,74,53,22,31
155210,36,7152,3167,3985,2606,1210,1396,4546,1957,2589
155283,36,406,55,351,357,51,306,49,4,45
155292,36,2402,903,1499,957,401,556,1445,502,943
155308,36,119,94,25,106,81,25,13,13,0
155317,36,12932,6107,6825,11437,5406,6031,1495,701,794
155335,36,547,194,353,515,178,337,32,16,16
155353,36,17,14,3,17,14,3,,,
155399,36,10680,5381,5299,9589,4885,4704,1091,496,595
155414,36,451,245,206,418,220,198,33,25,8
155423,36,909,550,359,688,457,231,221,93,128
155450,36,1091,417,674,274,106,168,817,311,506
155487,36,170,81,89,136,67,69,34,14,20
155496,36,87,46,41,67,37,30,20,9,11
155511,36,509,344,165,500,338,162,9,6,3
155520,36,580,268,312,535,258,277,45,10,35
155566,36,386,116,270,204,87,117,182,29,153
155593,36,193,105,88,164,99,65,29,6,23
155618,36,122,96,26,119,95,24,3,1,2
155627,36,493,297,196,441,264,177,52,33,19
155636,36,199,49,150,49,14,35,150,35,115
155681,36,3035,1541,1494,2833,1436,1397,202,105,97
155715,36,240,160,80,174,119,55,66,41,25
155812,36,479,234,245,446,219,227,33,15,18
155830,36,104,28,76,73,22,51,31,6,25
155858,36,585,191,394,320,116,204,265,75,190
155900,36,701,464,237,375,232,143,326,232,94
155937,36,360,217,143,308,190,118,52,27,25
155973,36,315,185,130,309,180,129,6,5,1
156082,36,2674,980,1694,2065,757,1308,609,223,386
156107,36,1311,637,674,598,354,244,713,283,430
156125,36,7233,3239,3994,5590,2475,3115,1643,764,879
156134,36,595,372,223,595,372,223,,,
156189,36,354,179,175,348,176,172,6,3,3
156213,36,900,366,534,743,308,435,157,58,99
156231,36,1123,386,737,663,259,404,460,127,333
156286,36,1577,587,990,1532,561,971,45,26,19
156295,36,1032,419,613,1026,417,609,6,2,4
156310,36,175,4,171,151,4,147,24,0,24
156338,36,1836,672,1164,862,345,517,974,327,647
156356,36,405,143,262,340,132,208,65,11,54
156365,36,1712,696,1016,1511,640,871,201,56,145
156392,36,4911,1921,2990,2049,897,1152,2862,1024,1838
156408,36,941,448,493,937,444,493,4,4,0
156417,36,78,65,13,54,46,8,24,19,5
156426,36,147,11,136,93,8,85,54,3,51
156471,36,1839,155,1684,833,73,760,1006,82,924
156541,36,3307,1070,2237,2746,889,1857,561,181,380
156620,36,7558,3106,4452,6269,2487,3782,1289,619,670
156648,36,2454,947,1507,1012,408,604,1442,539,903
156745,36,803,367,436,798,365,433,5,2,3
156754,36,39,1,38,39,1,38,,,
156790,36,988,335,653,464,183,281,524,152,372
156842,36,142,4,138,93,3,90,49,1,48
156851,36,603,123,480,190,47,143,413,76,337
156860,36,916,259,657,367,113,254,549,146,403
156921,36,4779,1954,2825,1558,718,840,3221,1236,1985
156967,36,90,1,89,90,1,89,,,
157021,36,152,11,141,58,4,54,94,7,87
157030,36,53,34,19,33,21,12,20,13,7
157058,36,892,347,545,803,308,495,89,39,50
157076,36,467,234,233,448,224,224,19,10,9
157085,36,15129,6545,8584,14018,6034,7984,1111,511,600
157100,36,270,173,97,258,165,93,12,8,4
157216,36,1052,447,605,996,426,570,56,21,35
157289,36,9915,4466,5449,7887,3507,4380,2028,959,1069
157304,36,1214,355,859,512,152,360,702,203,499
157331,36,1289,371,918,520,205,315,769,166,603
157377,36,804,259,545,677,238,439,127,21,106
157386,36,3408,1353,2055,2945,1183,1762,463,170,293
157401,36,4712,1820,2892,4022,1541,2481,690,279,411
157438,36,1735,737,998,625,313,312,1110,424,686
157447,36,6389,2623,3766,5109,2101,3008,1280,522,758
157483,36,1952,578,1374,909,319,590,1043,259,784
157535,36,659,292,367,632,282,350,27,10,17
157553,36,1149,446,703,714,315,399,435,131,304
157614,36,49,1,48,32,1,31,17,0,17
157650,36,56,0,56,38,0,38,18,0,18
157669,36,46,1,45,46,1,45,,,
157678,36,49,0,49,49,0,49,,,
157711,36,2357,766,1591,1194,477,717,1163,289,874
157739,36,1040,303,737,545,178,367,495,125,370
157748,36,687,380,307,498,260,238,189,120,69
157757,36,423,127,296,349,110,239,74,17,57
157793,36,1275,409,866,801,240,561,474,169,305
157809,36,960,459,501,843,420,423,117,39,78
157818,36,684,289,395,662,276,386,22,13,9
157863,36,432,231,201,405,218,187,27,13,14
157951,36,8637,3309,5328,7640,2913,4727,997,396,601
158088,36,561,220,341,401,164,237,160,56,104
158246,36,70,17,53,70,17,53,,,
158325,36,110,14,96,110,14,96,,,
158431,36,3509,1035,2474,1639,540,1099,1870,495,1375
158477,36,318,132,186,313,129,184,5,3,2
158538,36,51,0,51,51,0,51,,,
158617,36,236,69,167,236,69,167,,,
158662,36,8025,2034,5991,2285,669,1616,5740,1365,4375
158778,36,57,0,57,57,0,57,,,
158787,36,47,0,47,47,0,47,,,
158802,36,806,177,629,753,168,585,53,9,44
158884,36,858,251,607,342,121,221,516,130,386
159009,36,3136,1120,2016,2722,987,1735,414,133,281
159027,36,7,0,7,7,0,7,,,
159197,36,377,316,61,377,316,61,,,
159328,36,80,1,79,80,1,79,,,
159373,36,652,94,558,572,88,484,80,6,74
159382,36,2463,683,1780,1499,439,1060,964,244,720
159391,36,19330,8953,10377,18158,8342,9816,1172,611,561
159407,36,1517,337,1180,760,207,553,757,130,627
159416,36,1539,576,963,1115,421,694,424,155,269
159513,36,153,5,148,153,5,148,,,
159522,36,127,4,123,127,4,123,,,
159531,36,19,0,19,19,0,19,,,
159568,36,535,282,253,514,274,240,21,8,13
159601,36,10,0,10,10,0,10,,,
159647,36,5474,3074,2400,5010,2855,2155,464,219,245
159656,36,2237,750,1487,2062,693,1369,175,57,118
159717,36,3594,1391,2203,3137,1225,1912,457,166,291
159939,36,3521,1750,1771,2809,1383,1426,712,367,345
159948,36,663,412,251,229,151,78,434,261,173
159966,36,3605,1284,2321,3072,1102,1970,533,182,351
159993,36,3671,1226,2445,2824,1009,1815,847,217,630
160010,36,511,293,218,144,121,23,367,172,195
160038,36,4800,1287,3513,3369,1025,2344,1431,262,1169
160065,36,364,60,304,224,46,178,140,14,126
160074,36,635,94,541,337,48,289,298,46,252
160117,36,158,1,157,158,1,157,,,
160126,36,34,1,33,13,0,13,21,1,20
160199,36,36,1,35,36,1,35,,,
160320,36,2305,80,2225,2305,80,2225,,,
160409,36,67,67,0,66,66,0,1,1,0
160472,36,48,4,44,30,3,27,18,1,17
160481,36,1114,275,839,582,166,416,532,109,423
160524,36,160,44,116,160,44,116,,,
160579,36,1790,827,963,926,444,482,864,383,481
160597,36,158,48,110,79,24,55,79,24,55
160612,36,6714,2460,4254,5871,2163,3708,843,297,546
160621,36,3843,1234,2609,3236,1062,2174,607,172,435
160630,36,865,186,679,649,143,506,216,43,173
160649,36,1240,276,964,724,203,521,516,73,443
160658,36,8430,3580,4850,7223,3097,4126,1207,483,724
160667,36,1001,506,495,637,326,311,364,180,184
160755,36,6550,2590,3960,6141,2432,3709,409,158,251
160904,36,1785,414,1371,1712,396,1316,73,18,55
160959,36,259,74,185,247,69,178,12,5,7
160977,36,1268,607,661,1268,607,661,,,
160995,36,206,34,172,206,34,172,,,
161004,36,1393,691,702,1393,691,702,,,
161022,36,141,12,129,68,3,65,73,9,64
161077,36,1222,460,762,489,245,244,733,215,518
161086,36,1620,768,852,1620,768,852,,,
161138,36,764,333,431,344,159,185,420,174,246
161192,36,775,216,559,194,67,127,581,149,432
161208,36,8,8,0,8,8,0,,,
161217,36,2130,604,1526,882,241,641,1248,363,885
161226,36,905,300,605,828,276,552,77,24,53
161235,36,463,124,339,225,76,149,238,48,190
161253,36,6311,3240,3071,5395,2727,2668,916,513,403
161299,36,633,512,121,613,493,120,20,19,1
161341,36,634,209,425,413,153,260,221,56,165
161457,36,1422,444,978,1403,437,966,19,7,12
161484,36,303,120,183,140,78,62,163,42,121
161493,36,95,4,91,74,2,72,21,2,19
161509,36,265,67,198,257,65,192,8,2,6
161518,36,739,268,471,465,180,285,274,88,186
161527,36,181,18,163,122,7,115,59,11,48
161545,36,2661,1121,1540,983,471,512,1678,650,1028
161554,36,3068,1220,1848,2257,869,1388,811,351,460
161563,36,416,209,207,399,200,199,17,9,8
161572,36,2308,504,1804,2300,504,1796,8,0,8
161581,36,152,45,107,69,29,40,83,16,67
161688,36,1040,242,798,369,128,241,671,114,557
161767,36,6009,2263,3746,1568,743,825,4441,1520,2921
161800,36,101,27,74,30,8,22,71,19,52
161855,36,32,1,31,16,0,16,16,1,15
161864,36,1983,438,1545,445,126,319,1538,312,1226
161873,36,1080,440,640,558,219,339,522,221,301
162007,36,3600,1403,2197,2860,1097,1763,740,306,434
162061,36,222,181,41,167,134,33,55,47,8
162104,36,897,315,582,248,121,127,649,194,455
162122,36,2986,1080,1906,965,400,565,2021,680,1341
162168,36,818,224,594,192,63,129,626,161,465
162210,36,386,134,252,319,118,201,67,16,51
162283,36,1226,254,972,902,201,701,324,53,271
162335,36,51,0,51,51,0,51,,,
162371,36,327,301,26,327,301,26,,,
162557,36,2461,1003,1458,817,419,398,1644,584,1060
162584,36,2128,961,1167,1714,862,852,414,99,315
162609,36,172,83,89,112,55,57,60,28,32
162654,36,687,234,453,662,227,435,25,7,18
162690,36,1821,532,1289,500,195,305,1321,337,984
162706,36,2481,942,1539,804,366,438,1677,576,1101
162760,36,815,289,526,788,279,509,27,10,17
162779,36,5126,2081,3045,1407,687,720,3719,1394,2325
162830,36,76,4,72,76,4,72,,,
162928,36,4186,1940,2246,4176,1932,2244,10,8,2
163028,36,658,592,66,473,422,51,185,170,15
163046,36,2643,1156,1487,2622,1144,1478,21,12,9
163204,36,34247,19038,15209,7943,4185,3758,26304,14853,11451
163259,36,676,124,552,517,97,420,159,27,132
163268,36,7587,4158,3429,6244,3416,2828,1343,742,601
163286,36,22140,11267,10873,20320,10206,10114,1820,1061,759
163295,36,1129,270,859,1064,251,813,65,19,46
163338,36,1179,523,656,1077,472,605,102,51,51
163347,36,262,15,247,262,15,247,,,
163408,36,47,7,40,26,2,24,21,5,16
163426,36,10043,4791,5252,2812,1443,1369,7231,3348,3883
163453,36,4983,1902,3081,4471,1666,2805,512,236,276
163462,36,1306,613,693,1240,584,656,66,29,37
163532,36,149,149,0,149,149,0,,,
163541,36,211,87,124,104,46,58,107,41,66
163578,36,489,17,472,365,13,352,124,4,120
163657,36,6070,2082,3988,1766,665,1101,4304,1417,2887
163815,36,31,0,31,11,0,11,20,0,20
163851,36,4253,1933,2320,4003,1791,2212,250,142,108
163912,36,996,416,580,973,406,567,23,10,13
163976,36,325,167,158,323,167,156,2,0,2
164076,36,12316,5104,7212,10583,4310,6273,1733,794,939
164155,36,3282,2345,937,3282,2345,937,,,
164173,36,2025,744,1281,1765,674,1091,260,70,190
164216,36,680,283,397,673,280,393,7,3,4
164270,36,1237,509,728,1222,500,722,15,9,6
164313,36,1287,338,949,204,84,120,1083,254,829
164368,36,467,284,183,467,284,183,,,
164447,36,752,307,445,713,297,416,39,10,29
164465,36,1412,694,718,1412,694,718,,,
164492,36,666,381,285,547,283,264,119,98,21
164535,36,45,11,34,45,11,34,,,
164562,36,1273,551,722,1262,546,716,11,5,6
164580,36,2014,1191,823,2007,1188,819,7,3,4
164599,36,16,2,14,,,,16,2,14
164614,36,33,23,10,25,18,7,8,5,3
164632,36,991,0,991,601,0,601,390,0,390
164641,36,167,51,116,87,38,49,80,13,67
164739,36,2843,1728,1115,2788,1691,1097,55,37,18
164748,36,5387,3107,2280,4174,2308,1866,1213,799,414
164775,36,641,198,443,145,59,86,496,139,357
164845,36,38,1,37,29,1,28,9,0,9
164872,36,209,92,117,155,77,78,54,15,39
164924,36,7281,3456,3825,7141,3374,3767,140,82,58
164988,36,13352,5617,7735,13101,5493,7608,251,124,127
165015,36,2647,1110,1537,2643,1108,1535,4,2,2
165024,36,5682,2310,3372,4474,1811,2663,1208,499,709
165033,36,3342,1000,2342,1124,398,726,2218,602,1616
165060,36,149,14,135,90,9,81,59,5,54
165112,36,5030,2034,2996,1337,622,715,3693,1412,2281
165167,36,562,103,459,95,29,66,467,74,393
165194,36,1323,438,885,314,130,184,1009,308,701
165255,36,100,1,99,38,0,38,62,1,61
165264,36,717,46,671,68,3,65,649,43,606
165334,36,1603,660,943,1590,655,935,13,5,8
165529,36,1237,496,741,1110,460,650,127,36,91
165556,36,257,26,231,204,17,187,53,9,44
165574,36,788,393,395,720,358,362,68,35,33
165608,36,33,3,30,25,3,22,8,0,8
165635,36,148,139,9,148,139,9,,,
165644,36,309,168,141,287,160,127,22,8,14
165662,36,2958,1052,1906,2911,1033,1878,47,19,28
165671,36,1214,284,930,1177,276,901,37,8,29
165699,36,2053,749,1304,1960,716,1244,93,33,60
165750,36,5,1,4,2,1,1,3,0,3
165802,36,835,258,577,330,161,169,505,97,408
165820,36,2136,974,1162,1631,791,840,505,183,322
165866,36,2014,892,1122,1789,788,1001,225,104,121
165884,36,212,174,38,104,83,21,108,91,17
165936,36,889,355,534,859,338,521,30,17,13
165981,36,755,249,506,202,67,135,553,182,371
166018,36,241,98,143,241,98,143,,,
166027,36,6317,3068,3249,5747,2812,2935,570,256,314
166054,36,23,17,6,23,17,6,,,
166124,36,2149,961,1188,2149,961,1188,,,
166133,36,2110,677,1433,697,274,423,1413,403,1010
166391,36,868,309,559,829,293,536,39,16,23
166407,36,111,6,105,2,0,2,109,6,103
166452,36,1019,249,770,656,155,501,363,94,269
166489,36,30,15,15,21,13,8,9,2,7
166498,36,57,2,55,26,0,26,31,2,29
166513,36,8992,5269,3723,6978,4110,2868,2014,1159,855
166629,36,17284,8494,8790,16190,7985,8205,1094,509,585
166638,36,8177,3503,4674,6433,2710,3723,1744,793,951
166647,36,1747,802,945,528,271,257,1219,531,688
166656,36,2392,576,1816,2225,532,1693,167,44,123
166674,36,1262,332,930,1094,281,813,168,51,117
166683,36,3481,1805,1676,3425,1770,1655,56,35,21
166692,36,982,853,129,953,825,128,29,28,1
166717,36,25,6,19,7,2,5,18,4,14
166805,36,41,27,14,17,12,5,24,15,9
166823,36,2488,908,1580,819,371,448,1669,537,1132
166850,36,2774,1261,1513,2695,1233,1462,79,28,51
166869,36,140,22,118,140,22,118,,,
166887,36,3167,1150,2017,887,388,499,2280,762,1518
166911,36,224,53,171,218,52,166,6,1,5
166939,36,1595,0,1595,1584,0,1584,11,0,11
166957,36,1645,471,1174,376,153,223,1269,318,951
167039,36,1,0,1,1,0,1,,,
167057,36,307,169,138,297,162,135,10,7,3
167260,36,769,504,265,675,461,214,94,43,51
167288,36,504,207,297,438,190,248,66,17,49
167297,36,134,77,57,134,77,57,,,
167312,36,2509,830,1679,606,262,344,1903,568,1335
167358,36,12953,5817,7136,12953,5817,7136,,,
167376,36,2354,829,1525,573,273,300,1781,556,1225
167394,36,604,154,450,528,138,390,76,16,60
167525,36,1461,539,922,502,216,286,959,323,636
167534,36,3638,1261,2377,1082,430,652,2556,831,1725
167598,36,851,154,697,680,127,553,171,27,144
167631,36,898,268,630,197,72,125,701,196,505
167677,36,6,6,0,6,6,0,,,
167729,36,3378,1119,2259,2756,889,1867,622,230,392
167783,36,1271,0,1271,1127,0,1127,144,0,144
167792,36,169,65,104,164,62,102,5,3,2
167835,36,1864,1,1863,1860,1,1859,4,0,4
167871,36,73,12,61,39,5,34,34,7,27
167899,36,1429,701,728,1410,685,725,19,16,3
167905,36,2491,926,1565,808,361,447,1683,565,1118
167987,36,3625,1756,1869,3106,1536,1570,519,220,299
167996,36,1683,744,939,1667,733,934,16,11,5
168005,36,2821,1147,1674,2694,1078,1616,127,69,58
168032,36,1,0,1,1,0,1,,,
168148,36,4990,2225,2765,4861,2160,2701,129,65,64
168218,36,1747,0,1747,1743,0,1743,4,0,4
168227,36,2632,2050,582,2473,1914,559,159,136,23
168254,36,1707,978,729,1644,937,707,63,41,22
168263,36,2581,1137,1444,2215,947,1268,366,190,176
168281,36,1138,410,728,1136,408,728,2,2,0
168342,36,1550,735,815,1550,735,815,,,
168421,36,3729,2265,1464,3641,2201,1440,88,64,24
168430,36,2888,1091,1797,2342,865,1477,546,226,320
168528,36,1118,579,539,1106,570,536,12,9,3
168546,36,993,472,521,989,470,519,4,2,2
168555,36,9,1,8,7,1,6,2,0,2
168573,36,491,481,10,491,481,10,,,
168591,36,860,375,485,850,367,483,10,8,2
168607,36,417,208,209,176,102,74,241,106,135
168740,36,929,469,460,788,399,389,141,70,71
168786,36,745,319,426,679,294,385,66,25,41
168847,36,2477,595,1882,1026,261,765,1451,334,1117
168883,36,846,268,578,342,137,205,504,131,373
168892,36,95,4,91,51,3,48,44,1,43
169080,36,2101,1011,1090,1951,900,1051,150,111,39
169187,36,98,18,80,22,9,13,76,9,67
169248,36,7427,2857,4570,6295,2462,3833,1132,395,737
169275,36,3555,1156,2399,953,348,605,2602,808,1794
169284,36,149,7,142,113,2,111,36,5,31
169327,36,543,344,199,405,266,139,138,78,60
169363,36,567,277,290,542,269,273,25,8,17
169442,36,972,356,616,806,289,517,166,67,99
169479,36,2492,1093,1399,1356,705,651,1136,388,748
169503,36,242,3,239,242,3,239,,,
169521,36,4120,1472,2648,1102,419,683,3018,1053,1965
169576,36,101,2,99,101,2,99,,,
169655,36,739,687,52,739,687,52,,,
169716,36,1640,570,1070,1488,521,967,152,49,103
169761,36,351,60,291,351,60,291,,,
169798,36,8168,3207,4961,5646,2203,3443,2522,1004,1518
169813,36,46,1,45,46,1,45,,,
169910,36,5760,2797,2963,4250,2080,2170,1510,717,793
169974,36,330,130,200,144,54,90,186,76,110
169983,36,1073,856,217,1030,823,207,43,33,10
169992,36,319,101,218,146,59,87,173,42,131
170000,36,577,231,346,429,177,252,148,54,94
170037,36,982,372,610,769,305,464,213,67,146
170055,36,6981,2931,4050,1739,790,949,5242,2141,3101
170082,36,13317,5312,8005,11486,4452,7034,1831,860,971
170091,36,70,37,33,70,37,33,,,
170240,36,6468,2667,3801,2186,902,1284,4282,1765,2517
170286,36,1156,580,576,1135,572,563,21,8,13
170301,36,2168,848,1320,2119,824,1295,49,24,25
170444,36,2196,736,1460,513,180,333,1683,556,1127
170532,36,805,367,438,789,359,430,16,8,8
170541,36,3507,1532,1975,869,367,502,2638,1165,1473
170550,36,1747,450,1297,373,135,238,1374,315,1059
170587,36,680,191,489,316,97,219,364,94,270
170611,36,72,2,70,71,2,69,1,0,1
170620,36,1460,498,962,395,135,260,1065,363,702
170639,36,1080,476,604,933,419,514,147,57,90
170657,36,5707,2457,3250,1431,638,793,4276,1819,2457
170675,36,1346,960,386,1191,849,342,155,111,44
170736,36,34,0,34,12,0,12,22,0,22
170790,36,10821,4529,6292,2739,1175,1564,8082,3354,4728
170806,36,1191,415,776,932,339,593,259,76,183
170967,36,523,185,338,407,157,250,116,28,88
170976,36,24056,11677,12379,22818,10960,11858,1238,717,521
171012,36,126,98,28,126,98,28,,,
171100,36,27814,13475,14339,24966,11943,13023,2848,1532,1316
171128,36,4102,2895,1207,3884,2740,1144,218,155,63
171137,36,4437,2379,2058,3310,1749,1561,1127,630,497
171146,36,2988,1066,1922,1954,748,1206,1034,318,716
171155,36,1414,475,939,509,209,300,905,266,639
171225,36,1132,429,703,277,121,156,855,308,547
171234,36,747,243,504,156,43,113,591,200,391
171304,36,1852,694,1158,494,219,275,1358,475,883
171395,36,737,232,505,391,129,262,346,103,243
171456,36,4520,1798,2722,3857,1531,2326,663,267,396
171483,36,1903,877,1026,634,308,326,1269,569,700
171492,36,1378,868,510,876,580,296,502,288,214
171535,36,6306,2742,3564,1371,681,690,4935,2061,2874
171571,36,9166,3957,5209,7131,2939,4192,2035,1018,1017
171599,36,549,328,221,533,315,218,16,13,3
171775,36,30,0,30,21,0,21,9,0,9
171881,36,63,22,41,54,20,34,9,2,7
171988,36,58,4,54,58,4,54,,,
171997,36,68,2,66,68,2,66,,,
172015,36,40,0,40,40,0,40,,,
172033,36,136,69,67,31,30,1,105,39,66
172051,36,4558,1650,2908,3796,1336,2460,762,314,448
172200,36,4490,1832,2658,1074,537,537,3416,1295,2121
172264,36,1076,479,597,727,350,377,349,129,220
172291,36,1476,468,1008,589,165,424,887,303,584
172307,36,717,257,460,302,138,164,415,119,296
172334,36,700,221,479,594,197,397,106,24,82
172422,36,67,54,13,67,54,13,,,
172440,36,231,118,113,216,114,102,15,4,11
172495,36,185,2,183,115,2,113,70,0,70
172608,36,423,226,197,47,29,18,376,197,179
172617,36,5923,2519,3404,1363,669,694,4560,1850,2710
172635,36,7276,2068,5208,854,302,552,6422,1766,4656
172644,36,11641,4787,6854,8655,3457,5198,2986,1330,1656
172671,36,450,144,306,87,35,52,363,109,254
172680,36,90,5,85,53,4,49,37,1,36
172699,36,9671,4921,4750,7979,3999,3980,1692,922,770
172866,36,73,68,5,73,68,5,,,
172918,36,699,320,379,425,225,200,274,95,179
172954,36,803,359,444,403,223,180,400,136,264
172963,36,2420,864,1556,876,365,511,1544,499,1045
173045,36,1534,675,859,1421,634,787,113,41,72
173063,36,1321,625,696,463,225,238,858,400,458
173115,36,339,99,240,146,78,68,193,21,172
173124,36,2278,982,1296,1576,722,854,702,260,442
173142,36,439,203,236,426,196,230,13,7,6
173160,36,1547,613,934,1318,521,797,229,92,137
173203,36,875,340,535,393,207,186,482,133,349
173258,36,1467,725,742,1467,725,742,,,
173300,36,1317,604,713,1283,583,700,34,21,13
173328,36,1826,600,1226,1307,426,881,519,174,345
173416,36,1137,634,503,653,418,235,484,216,268
173452,36,529,256,273,461,228,233,68,28,40
173461,36,1543,634,909,684,338,346,859,296,563
173559,36,1870,665,1205,895,405,490,975,260,715
173638,36,1159,675,484,368,179,189,791,496,295
173647,36,1582,681,901,1541,658,883,41,23,18
173665,36,1167,444,723,1126,422,704,41,22,19
173708,36,1745,1123,622,666,467,199,1079,656,423
173735,36,1114,547,567,735,454,281,379,93,286
173744,36,399,23,376,399,23,376,,,
173799,36,1319,506,813,468,194,274,851,312,539
173902,36,1605,700,905,1577,681,896,28,19,9
173911,36,1161,458,703,489,248,241,672,210,462
173920,36,8017,3793,4224,6736,3271,3465,1281,522,759
173957,36,61,15,46,61,15,46,,,
174020,36,3835,1591,2244,1719,747,972,2116,844,1272
174066,36,22022,10164,11858,20067,9180,10887,1955,984,971
174075,36,1091,438,653,659,260,399,432,178,254
174127,36,483,167,316,478,165,313,5,2,3
174136,36,3041,1251,1790,891,428,463,2150,823,1327
174154,36,636,64,572,290,27,263,346,37,309
174190,36,48,0,48,37,0,37,11,0,11
174233,36,5436,2839,2597,5026,2604,2422,410,235,175
174251,36,720,312,408,672,294,378,48,18,30
174321,36,90,1,89,89,1,88,1,0,1
174358,36,2480,949,1531,1996,764,1232,484,185,299
174376,36,2172,855,1317,609,268,341,1563,587,976
174428,36,3652,1593,2059,1289,635,654,2363,958,1405
174437,36,607,266,341,538,235,303,69,31,38
174473,36,994,385,609,463,180,283,531,205,326
174491,36,1011,412,599,893,361,532,118,51,67
174507,36,156,43,113,28,10,18,128,33,95
174525,36,55,34,21,42,27,15,13,7,6
174570,36,323,111,212,179,70,109,144,41,103
174738,36,2060,699,1361,744,318,426,1316,381,935
174747,36,1088,0,1088,1080,0,1080,8,0,8
174756,36,1764,642,1122,752,300,452,1012,342,670
174783,36,4023,1994,2029,3079,1512,1567,944,482,462
174792,36,1093,1093,0,1069,1069,0,24,24,0
174817,36,802,348,454,617,285,332,185,63,122
174844,36,2132,882,1250,2124,878,1246,8,4,4
174862,36,464,226,238,336,165,171,128,61,67
174899,36,1273,393,880,1105,351,754,168,42,126
174914,36,4098,2133,1965,3957,2043,1914,141,90,51
174978,36,108,1,107,79,0,79,29,1,28
175005,36,1725,80,1645,1172,20,1152,553,60,493
175014,36,2077,338,1739,1093,178,915,984,160,824
175041,36,2432,1050,1382,1001,507,494,1431,543,888
175078,36,1303,469,834,916,377,539,387,92,295
175120,36,90,58,32,90,58,32,,,
175227,36,861,694,167,682,559,123,179,135,44
175236,36,1367,478,889,742,307,435,625,171,454
175263,36,640,246,394,276,124,152,364,122,242
175272,36,3728,1225,2503,3193,1039,2154,535,186,349
175315,36,3788,1570,2218,1397,627,770,2391,943,1448
175342,36,1637,551,1086,1378,475,903,259,76,183
175421,36,980,337,643,697,275,422,283,62,221
175430,36,371,191,180,353,184,169,18,7,11
175494,36,105,34,71,105,34,71,,,
175519,36,875,295,580,707,248,459,168,47,121
175573,36,1131,434,697,916,364,552,215,70,145
175616,36,1100,448,652,927,375,552,173,73,100
175643,36,886,299,587,693,245,448,193,54,139
175652,36,1533,584,949,1129,459,670,404,125,279
175698,36,5,3,2,3,2,1,2,1,1
175722,36,21,0,21,21,0,21,,,
175786,36,2493,974,1519,1890,770,1120,603,204,399
175810,36,1262,413,849,1007,344,663,255,69,186
175829,36,2130,758,1372,1459,560,899,671,198,473
175856,36,3333,1218,2115,2850,1060,1790,483,158,325
175883,36,2385,835,1550,1790,671,1119,595,164,431
175935,36,822,276,546,659,241,418,163,35,128
175980,36,414,211,203,411,210,201,3,1,2
176008,36,714,270,444,530,212,318,184,58,126
176017,36,11377,4910,6467,10525,4452,6073,852,458,394
176035,36,1061,201,860,922,169,753,139,32,107
176044,36,790,349,441,695,309,386,95,40,55
176053,36,1451,573,878,1352,534,818,99,39,60
176062,36,46,0,46,46,0,46,,,
176071,36,3901,1365,2536,2464,943,1521,1437,422,1015
176080,36,12958,6471,6487,11579,5706,5873,1379,765,614
176169,36,1557,590,967,1391,541,850,166,49,117
176178,36,3670,1264,2406,2850,1020,1830,820,244,576
176239,36,2333,884,1449,2011,788,1223,322,96,226
176318,36,423,157,266,333,117,216,90,40,50
176336,36,53,38,15,49,35,14,4,3,1
176354,36,941,335,606,792,304,488,149,31,118
176372,36,7183,2575,4608,5838,1995,3843,1345,580,765
176406,36,374,147,227,353,139,214,21,8,13
176433,36,54,2,52,41,2,39,13,0,13
176451,36,8,6,2,,,,8,6,2
176479,36,1309,370,939,1134,333,801,175,37,138
176628,36,656,249,407,591,234,357,65,15,50
176664,36,170,101,69,141,86,55,29,15,14
176716,36,125,1,124,125,1,124,,,
176770,36,508,63,445,243,36,207,265,27,238
176789,36,141,62,79,86,37,49,55,25,30
176798,36,191,48,143,109,22,87,82,26,56
176910,36,101,63,38,62,36,26,39,27,12
176947,36,687,325,362,680,322,358,7,3,4
176965,36,4250,1969,2281,3607,1650,1957,643,319,324
176983,36,31,17,14,28,15,13,3,2,1
177038,36,68,20,48,55,17,38,13,3,10
177065,36,3962,1564,2398,1646,614,1032,2316,950,1366
177083,36,17,17,0,17,17,0,,,
177117,36,200,0,200,198,0,198,2,0,2
177135,36,1515,511,1004,812,330,482,703,181,522
177144,36,528,288,240,519,284,235,9,4,5
177214,36,897,378,519,878,368,510,19,10,9
177250,36,1059,375,684,526,221,305,533,154,379
177302,36,233,221,12,233,221,12,,,
177339,36,842,395,447,842,395,447,,,
177418,36,434,174,260,387,164,223,47,10,37
177436,36,21,0,21,21,0,21,,,
177472,36,4612,1820,2792,2222,902,1320,2390,918,1472
177542,36,292,147,145,230,103,127,62,44,18
177551,36,773,215,558,656,182,474,117,33,84
177588,36,54,2,52,54,2,52,,,
177603,36,121,3,118,112,3,109,9,0,9
177676,36,1486,532,954,778,333,445,708,199,509
177685,36,123,9,114,123,9,114,,,
177719,36,263,29,234,226,26,200,37,3,34
177746,36,501,114,387,493,111,382,8,3,5
177931,36,24,1,23,24,1,23,,,
177940,36,857,307,550,737,272,465,120,35,85
177968,36,3133,1352,1781,2625,1140,1485,508,212,296
177977,36,869,726,143,769,646,123,100,80,20
177986,36,202,61,141,83,28,55,119,33,86
177995,36,6627,2548,4079,2625,1178,1447,4002,1370,2632
178059,36,3941,1287,2654,2329,848,1481,1612,439,1173
178077,36,67,1,66,67,1,66,,,
178183,36,145,12,133,145,12,133,,,
178208,36,667,433,234,292,207,85,375,226,149
178217,36,873,261,612,601,191,410,272,70,202
178244,36,958,411,547,833,374,459,125,37,88
178341,36,2322,889,1433,1715,658,1057,607,231,376
178369,36,773,454,319,722,439,283,51,15,36
178387,36,1834,702,1132,1562,596,966,272,106,166
178396,36,16962,7809,9153,15898,7290,8608,1064,519,545
178402,36,4468,1813,2655,3716,1447,2269,752,366,386
178411,36,4062,3101,961,3545,2710,835,517,391,126
178420,36,3911,1771,2140,2622,1157,1465,1289,614,675
178448,36,1766,623,1143,990,364,626,776,259,517
178527,36,19,2,17,14,2,12,5,0,5
178615,36,2158,855,1303,2069,811,1258,89,44,45
178624,36,3275,1275,2000,2930,1142,1788,345,133,212
178679,36,405,222,183,310,180,130,95,42,53
178697,36,1103,459,644,1090,454,636,13,5,8
178721,36,4957,2707,2250,2318,1067,1251,2639,1640,999
178767,36,77,12,65,31,6,25,46,6,40
178828,36,13,0,13,13,0,13,,,
178891,36,928,848,80,643,588,55,285,260,25
178989,36,227,27,200,216,27,189,11,0,11
179043,36,1263,459,804,1182,447,735,81,12,69
179159,36,5164,2009,3155,4757,1810,2947,407,199,208
179195,36,30,2,28,30,2,28,,,
179265,36,139,47,92,138,47,91,1,0,1
179308,36,7924,2476,5448,2617,985,1632,5307,1491,3816
179326,36,1018,360,658,798,316,482,220,44,176
179344,36,500,131,369,317,83,234,183,48,135
179511,36,49,0,49,29,0,29,20,0,20
179539,36,1465,444,1021,923,276,647,542,168,374
179548,36,270,0,270,249,0,249,21,0,21
179557,36,5057,2049,3008,4388,1755,2633,669,294,375
179566,36,9711,3914,5797,7979,3109,4870,1732,805,927
179645,36,1175,286,889,762,200,562,413,86,327
179715,36,617,126,491,368,100,268,249,26,223
179867,36,5794,2694,3100,5466,2592,2874,328,102,226
179894,36,1499,657,842,1188,511,677,311,146,165
179946,36,410,231,179,404,228,176,6,3,3
179955,36,532,261,271,519,251,268,13,10,3
179964,36,447,127,320,374,117,257,73,10,63
179991,36,19,1,18,19,1,18,,,
180054,36,300,65,235,158,33,125,142,32,110
180063,36,10,0,10,10,0,10,,,
180081,36,180,105,75,139,91,48,41,14,27
180090,36,25,0,25,25,0,25,,,
180106,36,768,300,468,751,291,460,17,9,8
180151,36,125,64,61,97,57,40,28,7,21
180160,36,188,68,120,77,32,45,111,36,75
180179,36,1885,657,1228,1193,479,714,692,178,514
180197,36,506,210,296,247,118,129,259,92,167
180203,36,81,32,49,65,29,36,16,3,13
180212,36,484,135,349,319,94,225,165,41,124
180249,36,499,111,388,247,64,183,252,47,205
180258,36,416,149,267,292,117,175,124,32,92
180276,36,364,135,229,167,78,89,197,57,140
180328,36,223,64,159,129,41,88,94,23,71
180373,36,208,69,139,129,51,78,79,18,61
180416,36,1051,644,407,968,590,378,83,54,29
180461,36,10118,5413,4705,8826,4710,4116,1292,703,589
180489,36,4716,1985,2731,3849,1614,2235,867,371,496
180522,36,478,272,206,380,238,142,98,34,64
180595,36,523,270,253,510,264,246,13,6,7
180647,36,400,103,297,335,88,247,65,15,50
180692,36,829,266,563,672,233,439,157,33,124
180814,36,6780,2927,3853,4727,2037,2690,2053,890,1163
180832,36,425,57,368,116,23,93,309,34,275
180878,36,400,33,367,241,18,223,159,15,144
180902,36,2154,801,1353,946,457,489,1208,344,864
180948,36,1165,440,725,989,386,603,176,54,122
180957,36,52,47,5,52,47,5,,,
180984,36,755,357,398,739,346,393,16,11,5
181002,36,3078,1282,1796,2996,1248,1748,82,34,48
181020,36,693,368,325,643,348,295,50,20,30
181127,36,614,273,341,608,270,338,6,3,3
181145,36,11,0,11,11,0,11,,,
181190,36,85,4,81,85,4,81,,,
181215,36,2971,1087,1884,2531,951,1580,440,136,304
181297,36,569,52,517,378,34,344,191,18,173
181303,36,4980,2392,2588,1478,750,728,3502,1642,1860
181312,36,523,182,341,272,131,141,251,51,200
181330,36,772,379,393,760,376,384,12,3,9
181394,36,8519,3844,4675,6896,2998,3898,1623,846,777
181419,36,179,45,134,49,12,37,130,33,97
181428,36,452,62,390,359,50,309,93,12,81
181446,36,1105,493,612,1039,472,567,66,21,45
181464,36,13711,6921,6790,12854,6397,6457,857,524,333
181491,36,1396,584,812,930,458,472,466,126,340
181534,36,832,345,487,689,294,395,143,51,92
181543,36,12,9,3,8,6,2,4,3,1
181604,36,368,0,368,363,0,363,5,0,5
181640,36,3738,1756,1982,1691,904,787,2047,852,1195
181738,36,355,154,201,344,149,195,11,5,6
181765,36,125,37,88,121,36,85,4,1,3
181783,36,2082,859,1223,1907,779,1128,175,80,95
181817,36,478,157,321,269,112,157,209,45,164
181853,36,272,138,134,244,130,114,28,8,20
181880,36,9,0,9,2,0,2,7,0,7
181941,36,186,114,72,186,114,72,,,
182005,36,20385,8326,12059,5258,2179,3079,15127,6147,8980
182148,36,515,112,403,515,112,403,,,
182281,36,17995,7909,10086,13805,5931,7874,4190,1978,2212
182290,36,11419,5413,6006,9569,4514,5055,1850,899,951
182306,36,1567,478,1089,581,214,367,986,264,722
182500,36,4538,2057,2481,1366,585,781,3172,1472,1700
182564,36,1299,523,776,397,181,216,902,342,560
182634,36,575,150,425,539,144,395,36,6,30
182670,36,3258,1663,1595,3257,1662,1595,1,1,0
182704,36,49,2,47,34,1,33,15,1,14
182722,36,142,12,130,108,12,96,34,0,34
182795,36,752,330,422,643,279,364,109,51,58
182892,36,20,0,20,12,0,12,8,0,8
182917,36,44,21,23,44,21,23,,,
182980,36,709,339,370,681,323,358,28,16,12
182999,36,7,0,7,7,0,7,,,
183026,36,101823,37142,64681,24206,9582,14624,77617,27560,50057
183035,36,27,2,25,27,2,25,,,
183044,36,8088,3522,4566,7884,3405,4479,204,117,87
183062,36,1886,855,1031,1825,820,1005,61,35,26
183071,36,392,197,195,319,152,167,73,45,28
183080,36,2259,1148,1111,2167,1093,1074,92,55,37
183099,36,1291,443,848,420,184,236,871,259,612
183105,36,250,73,177,56,25,31,194,48,146
183114,36,391,83,308,53,16,37,338,67,271
183123,36,277,130,147,85,51,34,192,79,113
183132,36,1021,448,573,277,176,101,744,272,472
183141,36,602,278,324,152,92,60,450,186,264
183150,36,800,288,512,198,100,98,602,188,414
183202,36,73,2,71,60,1,59,13,1,12
183211,36,944,191,753,622,156,466,322,35,287
183239,36,1389,541,848,1371,529,842,18,12,6
183248,36,110,10,100,70,7,63,40,3,37
183257,36,869,254,615,402,111,291,467,143,324
183275,36,60,33,27,60,33,27,,,
183488,36,359,17,342,303,14,289,56,3,53
183600,36,21,0,21,13,0,13,8,0,8
183655,36,2667,900,1767,864,332,532,1803,568,1235
183725,36,251,131,120,215,123,92,36,8,28
183743,36,6469,3048,3421,3023,1510,1513,3446,1538,1908
183789,36,1465,326,1139,882,223,659,583,103,480
183804,36,2795,2795,0,2785,2785,0,10,10,0
183822,36,818,339,479,745,308,437,73,31,42
183859,36,5799,2622,3177,2553,1270,1283,3246,1352,1894
183877,36,3868,1474,2394,1599,718,881,2269,756,1513
183910,36,1088,402,686,1039,380,659,49,22,27
183938,36,4682,1638,3044,1799,736,1063,2883,902,1981
183974,36,744,263,481,693,245,448,51,18,33
183983,36,6,5,1,6,5,1,,,
184056,36,374,76,298,231,50,181,143,26,117
184092,36,625,74,551,625,74,551,,,
184180,36,3554,1866,1688,1409,823,586,2145,1043,1102
184205,36,1338,413,925,511,175,336,827,238,589
184348,36,1045,431,614,1033,426,607,12,5,7
184427,36,218,203,15,140,134,6,78,69,9
184481,36,4074,1498,2576,1643,616,1027,2431,882,1549
184506,36,38,3,35,26,0,26,12,3,9
184603,36,1683,751,932,1240,548,692,443,203,240
184612,36,1263,333,930,1149,304,845,114,29,85
184694,36,1450,618,832,1385,583,802,65,35,30
184746,36,17,17,0,16,16,0,1,1,0
184773,36,805,181,624,741,163,578,64,18,46
184782,36,10414,5485,4929,8901,4763,4138,1513,722,791
184791,36,2780,1112,1668,1395,592,803,1385,520,865
184816,36,35,0,35,17,0,17,18,0,18
184959,36,445,68,377,183,33,150,262,35,227
184968,36,188,29,159,29,6,23,159,23,136
184995,36,4311,1592,2719,2163,839,1324,2148,753,1395
185129,36,3431,1428,2003,2945,1223,1722,486,205,281
185174,36,45,38,7,45,38,7,,,
185262,36,7306,2801,4505,5858,2226,3632,1448,575,873
185396,36,969,935,34,791,764,27,178,171,7
185466,36,13,0,13,7,0,7,6,0,6
185509,36,3529,1567,1962,1046,545,501,2483,1022,1461
185536,36,5132,2308,2824,2029,966,1063,3103,1342,1761
185572,36,2721,1014,1707,2589,951,1638,132,63,69
185590,36,11643,4545,7098,10251,3911,6340,1392,634,758
185679,36,576,88,488,43,5,38,533,83,450
185721,36,230,69,161,115,34,81,115,35,80
185767,36,264,34,230,132,15,117,132,19,113
185828,36,6161,4592,1569,5351,3936,1415,810,656,154
185873,36,3497,1441,2056,1486,698,788,2011,743,1268
185970,36,127,10,117,96,8,88,31,2,29
186016,36,408,23,385,218,14,204,190,9,181
186034,36,3733,1312,2421,1224,509,715,2509,803,1706
186052,36,467,394,73,249,212,37,218,182,36
186131,36,4003,2007,1996,4003,2007,1996,,,
186186,36,91,91,0,91,91,0,,,
186201,36,3395,1443,1952,3108,1300,1808,287,143,144
186274,36,188,14,174,106,8,98,82,6,76
186283,36,2105,884,1221,1980,840,1140,125,44,81
186371,36,3051,1124,1927,2544,946,1598,507,178,329
186380,36,26166,13188,12978,24821,12498,12323,1345,690,655
186399,36,5235,2415,2820,4474,2038,2436,761,377,384
186405,36,16,5,11,16,5,11,,,
186423,36,53,8,45,53,8,45,,,
186432,36,1292,505,787,1187,464,723,105,41,64
186469,36,498,171,327,241,113,128,257,58,199
186584,36,4182,1861,2321,4047,1790,2257,135,71,64
186593,36,68,16,52,43,15,28,25,1,24
186618,36,451,159,292,379,142,237,72,17,55
186645,36,3419,1770,1649,1329,714,615,2090,1056,1034
186867,36,3009,2093,916,2992,2080,912,17,13,4
186876,36,5735,2222,3513,5397,2062,3335,338,160,178
186900,36,50,50,0,50,50,0,,,
187000,36,315,298,17,199,186,13,116,112,4
187046,36,5405,3221,2184,60,13,47,5345,3208,2137
187134,36,4985,2135,2850,4824,2047,2777,161,88,73
187198,36,5028,1752,3276,1849,817,1032,3179,935,2244
187444,36,4995,1991,3004,3781,1542,2239,1214,449,765
187505,36,447,86,361,447,86,361,,,
187532,36,11472,4144,7328,2480,1063,1417,8992,3081,5911
187596,36,652,213,439,325,132,193,327,81,246
187620,36,3412,1278,2134,1548,628,920,1864,650,1214
187639,36,922,230,692,298,88,210,624,142,482
187648,36,2022,766,1256,1332,478,854,690,288,402
187666,36,815,280,535,363,146,217,452,134,318
187745,36,215,78,137,166,67,99,49,11,38
187897,36,961,307,654,577,222,355,384,85,299
187903,36,1104,484,620,357,135,222,747,349,398
187912,36,132,110,22,132,110,22,,,
187958,36,1048,329,719,255,91,164,793,238,555
187967,36,817,563,254,755,520,235,62,43,19
187976,36,678,312,366,40,13,27,638,299,339
187985,36,10938,4511,6427,7754,3232,4522,3184,1279,1905
187994,36,366,103,263,142,47,95,224,56,168
188003,36,318,71,247,106,29,77,212,42,170
188021,36,226,50,176,89,25,64,137,25,112
188030,36,8122,3401,4721,6565,2685,3880,1557,716,841
188049,36,928,314,614,145,54,91,783,260,523
188058,36,572,189,383,286,95,191,286,94,192
188100,36,3171,929,2242,1127,432,695,2044,497,1547
188137,36,1513,494,1019,358,115,243,1155,379,776
188182,36,201,126,75,187,116,71,14,10,4
188216,36,188,63,125,111,53,58,77,10,67
188225,36,587,201,386,73,35,38,514,166,348
188261,36,306,244,62,37,18,19,269,226,43
188289,36,47,3,44,45,3,42,2,0,2
188304,36,1208,338,870,694,244,450,514,94,420
188340,36,863,755,108,656,565,91,207,190,17
188429,36,3611,1111,2500,3405,1043,2362,206,68,138
188438,36,1186,473,713,678,309,369,508,164,344
188517,36,191,71,120,145,62,83,46,9,37
188526,36,418,147,271,415,145,270,3,2,1
188641,36,891,422,469,867,409,458,24,13,11
188650,36,73,1,72,73,1,72,,,
188669,36,46,9,37,46,9,37,,,
188678,36,103,37,66,103,37,66,,,
188687,36,327,103,224,75,26,49,252,77,175
188696,36,103,10,93,103,10,93,,,
188854,36,896,250,646,896,250,646,,,
188890,36,477,465,12,362,353,9,115,112,3
188915,36,4,2,2,2,2,0,2,0,2
188942,36,96,0,96,80,0,80,16,0,16
189088,36,1647,743,904,1530,663,867,117,80,37
189097,36,2267,0,2267,2233,0,2233,34,0,34
189219,36,20,20,0,20,20,0,,,
189228,36,1218,350,868,724,224,500,494,126,368
189255,36,38,0,38,22,0,22,16,0,16
189273,36,43,43,0,43,43,0,,,
189282,36,172,19,153,168,19,149,4,0,4
189404,36,133,1,132,44,0,44,89,1,88
189413,36,296,58,238,296,58,238,,,
189468,36,3,0,3,2,0,2,1,0,1
189477,36,133,3,130,50,2,48,83,1,82
189547,36,1819,659,1160,1157,476,681,662,183,479
189565,36,302,78,224,231,65,166,71,13,58
189583,36,431,100,331,293,67,226,138,33,105
189592,36,216,49,167,171,43,128,45,6,39
189705,36,1199,591,608,1161,566,595,38,25,13
189714,36,292,8,284,204,4,200,88,4,84
189811,36,651,137,514,651,137,514,,,
189839,36,695,257,438,376,148,228,319,109,210
189848,36,431,120,311,335,98,237,96,22,74
189857,36,282,282,0,282,282,0,,,
189990,36,691,5,686,130,2,128,561,3,558
190008,36,41,14,27,41,14,27,,,
190044,36,1936,1337,599,1927,1333,594,9,4,5
190053,36,267,101,166,131,60,71,136,41,95
190071,36,88,8,80,24,4,20,64,4,60
190099,36,2295,1038,1257,2283,1030,1253,12,8,4
190114,36,273,63,210,203,43,160,70,20,50
190150,36,6669,3371,3298,6204,3138,3066,465,233,232
190169,36,528,163,365,219,97,122,309,66,243
190239,36,86,2,84,64,1,63,22,1,21
190318,36,155,7,148,152,4,148,3,3,0
190372,36,681,359,322,681,359,322,,,
190415,36,11554,5287,6267,11505,5257,6248,49,30,19
190442,36,900,344,556,511,214,297,389,130,259
190451,36,175,30,145,50,11,39,125,19,106
190503,36,1916,1004,912,1778,926,852,138,78,60
190512,36,11356,5702,5654,8809,4439,4370,2547,1263,1284
190521,36,11021,4518,6503,6881,2929,3952,4140,1589,2551
190530,36,4216,1719,2497,2358,1013,1345,1858,706,1152
190549,36,8125,3482,4643,6010,2566,3444,2115,916,1199
190558,36,6553,2980,3573,5015,2292,2723,1538,688,850
190567,36,8075,3727,4348,6319,2870,3449,1756,857,899
190576,36,1785,434,1351,454,111,343,1331,323,1008
190585,36,2983,862,2121,1277,421,856,1706,441,1265
190594,36,11854,4098,7756,9163,3081,6082,2691,1017,1674
190600,36,8509,3204,5305,6655,2471,4184,1854,733,1121
190619,36,4687,1956,2731,3243,1379,1864,1444,577,867
190628,36,6486,2637,3849,3728,1574,2154,2758,1063,1695
190637,36,7648,2458,5190,5067,1685,3382,2581,773,1808
190646,36,2318,611,1707,1550,422,1128,768,189,579
190655,36,8329,4642,3687,5066,3034,2032,3263,1608,1655
190664,36,10000,4710,5290,7311,3374,3937,2689,1336,1353
190673,36,5738,2661,3077,3093,1546,1547,2645,1115,1530
190691,36,3563,1189,2374,2398,803,1595,1165,386,779
190707,36,7,1,6,7,1,6,,,
190716,36,938,231,707,670,171,499,268,60,208
190725,36,1034,279,755,937,256,681,97,23,74
190752,36,35,35,0,35,35,0,,,
190761,36,756,255,501,710,245,465,46,10,36
190840,36,2376,1062,1314,1243,606,637,1133,456,677
190956,36,61,7,54,9,2,7,52,5,47
190983,36,404,121,283,387,119,268,17,2,15
191083,36,3841,1782,2059,2675,1314,1361,1166,468,698
191126,36,5607,965,4642,4932,798,4134,675,167,508
191199,36,1608,667,941,963,444,519,645,223,422
191205,36,332,236,96,317,226,91,15,10,5
191241,36,6968,2817,4151,6779,2726,4053,189,91,98
191302,36,645,261,384,367,158,209,278,103,175
191311,36,108,32,76,108,32,76,,,
191339,36,1249,385,864,650,227,423,599,158,441
191515,36,1585,725,860,1584,724,860,1,1,0
191533,36,719,292,427,705,287,418,14,5,9
191597,36,306,49,257,206,38,168,100,11,89
191612,36,705,283,422,492,202,290,213,81,132
191621,36,462,203,259,440,192,248,22,11,11
191630,36,1074,520,554,1064,512,552,10,8,2
191649,36,4101,1781,2320,3910,1681,2229,191,100,91
191676,36,542,193,349,510,182,328,32,11,21
191719,36,3833,1886,1947,2320,1309,1011,1513,577,936
191728,36,630,127,503,393,84,309,237,43,194
191931,36,1710,816,894,1679,795,884,31,21,10
191940,36,89,7,82,89,7,82,,,
191959,36,37,26,11,37,26,11,,,
191968,36,3187,1430,1757,3109,1390,1719,78,40,38
191986,36,916,342,574,597,251,346,319,91,228
192004,36,178,45,133,170,42,128,8,3,5
192022,36,911,334,577,603,246,357,308,88,220
192040,36,107,43,64,103,41,62,4,2,2
192110,36,363,195,168,363,195,168,,,
192165,36,136,136,0,136,136,0,,,
192192,36,662,171,491,622,162,460,40,9,31
192271,36,734,69,665,647,65,582,87,4,83
192323,36,1725,666,1059,1477,623,854,248,43,205
192448,36,3918,1282,2636,3511,1181,2330,407,101,306
192484,36,137,3,134,59,1,58,78,2,76
192509,36,465,61,404,435,57,378,30,4,26
192624,36,98,98,0,98,98,0,,,
192688,36,271,47,224,192,25,167,79,22,57
192703,36,2179,1244,935,2049,1154,895,130,90,40
192712,36,332,168,164,331,167,164,1,1,0
192749,36,832,339,493,805,328,477,27,11,16
192785,36,445,57,388,91,17,74,354,40,314
192800,36,7,0,7,1,0,1,6,0,6
192819,36,3597,1509,2088,3442,1434,2008,155,75,80
192864,36,1088,196,892,943,187,756,145,9,136
192925,36,716,191,525,640,187,453,76,4,72
192961,36,88,17,71,1,0,1,87,17,70
192970,36,15,5,10,15,5,10,,,
193016,36,4015,1158,2857,3331,895,2436,684,263,421
193052,36,187,187,0,187,187,0,,,
193061,36,36,36,0,36,36,0,,,
193070,36,37,37,0,37,37,0,,,
193201,36,292,32,260,292,32,260,,,
193247,36,70,70,0,70,70,0,,,
193265,36,5,5,0,4,4,0,1,1,0
193283,36,1685,695,990,1088,491,597,597,204,393
193292,36,2375,668,1707,1839,557,1282,536,111,425
193308,36,3749,1134,2615,2176,796,1380,1573,338,1235
193326,36,5164,2058,3106,2621,1134,1487,2543,924,1619
193353,36,1073,303,770,841,250,591,232,53,179
193380,36,71,10,61,,,,71,10,61
193399,36,1229,311,918,1108,297,811,121,14,107
193478,36,7226,3389,3837,3560,1825,1735,3666,1564,2102
193584,36,1409,361,1048,1359,348,1011,50,13,37
193609,36,59,23,36,59,23,36,,,
193654,36,5314,1251,4063,4912,1144,3768,402,107,295
193858,36,183,15,168,183,15,168,,,
193900,36,22110,9232,12878,21235,8827,12408,875,405,470
193946,36,1647,619,1028,1067,440,627,580,179,401
193973,36,2016,695,1321,1971,677,1294,45,18,27
193991,36,28,3,25,21,1,20,7,2,5
194028,36,333,121,212,218,90,128,115,31,84
194091,36,2259,1332,927,2006,1168,838,253,164,89
194116,36,315,24,291,107,11,96,208,13,195
194161,36,516,215,301,377,143,234,139,72,67
194189,36,98,98,0,98,98,0,,,
194222,36,2363,1047,1316,1436,692,744,927,355,572
194240,36,2314,868,1446,961,440,521,1353,428,925
194259,36,8,1,7,8,1,7,,,
194310,36,5155,1776,3379,4892,1648,3244,263,128,135
194392,36,473,294,179,459,288,171,14,6,8
194435,36,60,2,58,60,2,58,,,
194499,36,491,98,393,491,98,393,,,
194569,36,68,46,22,41,26,15,27,20,7
194578,36,2919,826,2093,2868,805,2063,51,21,30
194657,36,90,90,0,90,90,0,,,
194666,36,315,315,0,315,315,0,,,
194693,36,24,24,0,24,24,0,,,
194718,36,35,35,0,35,35,0,,,
194736,36,110,110,0,110,110,0,,,
194763,36,256,256,0,256,256,0,,,
194824,36,3799,2618,1181,3766,2587,1179,33,31,2
194958,36,699,224,475,606,207,399,93,17,76
195003,36,9702,6400,3302,9361,6162,3199,341,238,103
195030,36,4843,2297,2546,4675,2252,2423,168,45,123
195058,36,2582,1103,1479,1295,647,648,1287,456,831
195067,36,148,9,139,103,5,98,45,4,41
195128,36,763,194,569,741,191,550,22,3,19
195164,36,1163,646,517,1146,636,510,17,10,7
195173,36,1614,570,1044,1511,529,982,103,41,62
195191,36,97,9,88,92,6,86,5,3,2
195216,36,1579,725,854,1576,722,854,3,3,0
195234,36,1064,354,710,1018,335,683,46,19,27
195243,36,699,365,334,665,337,328,34,28,6
195289,36,93,14,79,9,1,8,84,13,71
195304,36,994,213,781,980,207,773,14,6,8
195322,36,914,366,548,491,213,278,423,153,270
195438,36,79,79,0,79,79,0,,,
195474,36,2485,1104,1381,2433,1080,1353,52,24,28
195526,36,1945,830,1115,1925,822,1103,20,8,12
195544,36,2564,803,1761,2289,724,1565,275,79,196
195702,36,69,8,61,37,7,30,32,1,31
195720,36,1841,746,1095,1771,721,1050,70,25,45
195784,36,501,73,428,501,73,428,,,
195809,36,6857,3067,3790,6667,2963,3704,190,104,86
195988,36,444,183,261,260,127,133,184,56,128
196006,36,2061,1289,772,1839,1213,626,222,76,146
196015,36,1891,798,1093,1569,701,868,322,97,225
196024,36,1545,690,855,1188,622,566,357,68,289
196033,36,1125,478,647,1027,434,593,98,44,54
196042,36,6474,3895,2579,5069,3051,2018,1405,844,561
196051,36,1133,524,609,943,480,463,190,44,146
196060,36,8663,4003,4660,8082,3709,4373,581,294,287
196079,36,10490,5015,5475,10193,4838,5355,297,177,120
196088,36,15039,8198,6841,13637,7572,6065,1402,626,776
196097,36,12880,6436,6444,11879,5896,5983,1001,540,461
196103,36,1083,542,541,793,399,394,290,143,147
196112,36,1241,897,344,1112,821,291,129,76,53
196121,36,3514,1420,2094,3015,1259,1756,499,161,338
196130,36,3700,1575,2125,3227,1341,1886,473,234,239
196149,36,4135,1858,2277,4019,1787,2232,116,71,45
196158,36,2321,964,1357,2244,929,1315,77,35,42
196167,36,3030,1096,1934,2901,1038,1863,129,58,71
196176,36,4212,1509,2703,3822,1319,2503,390,190,200
196185,36,3457,1373,2084,3371,1324,2047,86,49,37
196194,36,3954,1858,2096,3601,1687,1914,353,171,182
196200,36,1475,568,907,1405,549,856,70,19,51
196219,36,2134,878,1256,1941,794,1147,193,84,109
196237,36,2686,1079,1607,2228,853,1375,458,226,232
196246,36,2744,1058,1686,2412,938,1474,332,120,212
196255,36,121,23,98,113,21,92,8,2,6
196264,36,5309,1805,3504,2171,588,1583,3138,1217,1921
196291,36,962,826,136,871,742,129,91,84,7
196307,36,88,19,69,63,14,49,25,5,20
196389,36,603,128,475,599,128,471,4,0,4
196413,36,10664,4868,5796,10274,4665,5609,390,203,187
196431,36,65,65,0,65,65,0,,,
196440,36,7,7,0,7,7,0,,,
196565,36,808,281,527,433,190,243,375,91,284
196583,36,36,36,0,36,36,0,,,
196592,36,2992,879,2113,2122,626,1496,870,253,617
196653,36,709,75,634,193,24,169,516,51,465
196680,36,12499,6396,6103,,,,12499,6396,6103
196699,36,786,319,467,408,184,224,378,135,243
196866,36,1479,815,664,1479,815,664,,,
197018,36,1495,1495,0,1495,1495,0,,,
197027,36,688,537,151,688,537,151,,,
197036,36,3155,2419,736,3155,2419,736,,,
197045,36,1843,758,1085,1512,644,868,331,114,217
197133,36,1737,652,1085,1727,645,1082,10,7,3
197142,36,307,154,153,261,138,123,46,16,30
197151,36,2568,676,1892,2509,655,1854,59,21,38
197197,36,1132,401,731,1062,377,685,70,24,46
197221,36,75,55,20,75,55,20,,,
197230,36,185,69,116,182,68,114,3,1,2
197285,36,537,148,389,472,128,344,65,20,45
197294,36,5042,2300,2742,2195,1089,1106,2847,1211,1636
197337,36,62,1,61,59,1,58,3,0,3
197531,36,167,84,83,167,84,83,,,
197601,36,78,78,0,78,78,0,,,
197647,36,76,76,0,76,76,0,,,
197674,36,111,111,0,111,111,0,,,
197692,36,47,47,0,47,47,0,,,
197708,36,2139,1173,966,2116,1157,959,23,16,7
197735,36,539,539,0,539,539,0,,,
197744,36,125,125,0,125,125,0,,,
197814,36,785,199,586,234,73,161,551,126,425
197850,36,932,298,634,212,93,119,720,205,515
197869,36,13052,5774,7278,12104,5319,6785,948,455,493
197887,36,2636,940,1696,855,335,520,1781,605,1176
197911,36,681,323,358,657,318,339,24,5,19
197966,36,1244,363,881,338,100,238,906,263,643
197984,36,913,472,441,855,449,406,58,23,35
197993,36,132,0,132,122,0,122,10,0,10
198011,36,656,242,414,261,85,176,395,157,238
198039,36,1264,462,802,451,174,277,813,288,525
198066,36,497,305,192,485,298,187,12,7,5
198084,36,643,230,413,299,137,162,344,93,251
198109,36,295,21,274,69,2,67,226,19,207
198118,36,1466,539,927,574,250,324,892,289,603
198136,36,2106,1021,1085,1751,814,937,355,207,148
198154,36,6852,2720,4132,2349,1002,1347,4503,1718,2785
198206,36,731,226,505,316,132,184,415,94,321
198215,36,663,316,347,602,300,302,61,16,45
198233,36,1701,708,993,625,283,342,1076,425,651
198251,36,2980,1035,1945,817,306,511,2163,729,1434
198260,36,10931,4571,6360,4366,1912,2454,6565,2659,3906
198303,36,544,320,224,512,310,202,32,10,22
198321,36,1120,360,760,420,126,294,700,234,466
198330,36,1767,616,1151,878,317,561,889,299,590
198367,36,1256,470,786,413,202,211,843,268,575
198376,36,1676,518,1158,677,239,438,999,279,720
198385,36,1364,641,723,1364,641,723,,,
198419,36,4766,2314,2452,4739,2299,2440,27,15,12
198455,36,2436,907,1529,463,214,249,1973,693,1280
198464,36,14956,6398,8558,12662,5388,7274,2294,1010,1284
198491,36,728,120,608,145,21,124,583,99,484
198507,36,1339,541,798,1166,490,676,173,51,122
198516,36,4549,1814,2735,4356,1723,2633,193,91,102
198534,36,5870,2046,3824,2461,944,1517,3409,1102,2307
198543,36,3412,999,2413,2353,683,1670,1059,316,743
198552,36,4588,1545,3043,1286,525,761,3302,1020,2282
198561,36,1167,400,767,977,376,601,190,24,166
198570,36,2322,733,1589,696,263,433,1626,470,1156
198598,36,395,223,172,375,217,158,20,6,14
198613,36,610,298,312,587,287,300,23,11,12
198622,36,5736,2275,3461,2184,948,1236,3552,1327,2225
198640,36,413,108,305,123,39,84,290,69,221
198668,36,504,158,346,206,97,109,298,61,237
198677,36,10,4,6,7,3,4,3,1,2
198695,36,3394,1493,1901,3354,1474,1880,40,19,21
198710,36,671,238,433,254,109,145,417,129,288
198729,36,762,189,573,267,73,194,495,116,379
198756,36,719,308,411,671,293,378,48,15,33
198774,36,1959,652,1307,853,323,530,1106,329,777
198808,36,537,179,358,511,175,336,26,4,22
198817,36,700,238,462,265,127,138,435,111,324
198835,36,943,394,549,889,380,509,54,14,40
198844,36,39,0,39,39,0,39,,,
198862,36,586,319,267,565,311,254,21,8,13
198871,36,159,122,37,153,117,36,6,5,1
198899,36,643,319,324,596,305,291,47,14,33
198905,36,298,76,222,134,29,105,164,47,117
198914,36,210,62,148,89,27,62,121,35,86
198923,36,415,146,269,117,44,73,298,102,196
198950,36,913,0,913,887,0,887,26,0,26
198969,36,946,491,455,842,450,392,104,41,63
198978,36,483,61,422,466,60,406,17,1,16
198987,36,1308,497,811,480,203,277,828,294,534
199005,36,2,0,2,2,0,2,,,
199023,36,219,96,123,101,49,52,118,47,71
199032,36,547,288,259,449,248,201,98,40,58
199069,36,1283,423,860,784,307,477,499,116,383
199078,36,139,15,124,137,15,122,2,0,2
199087,36,1039,348,691,329,128,201,710,220,490
199102,36,7815,3023,4792,6859,2554,4305,956,469,487
199111,36,2021,871,1150,1783,748,1035,238,123,115
199120,36,14497,5751,8746,13764,5405,8359,733,346,387
199139,36,16657,8815,7842,14037,7380,6657,2620,1435,1185
199148,36,10026,3381,6645,8106,2726,5380,1920,655,1265
199157,36,3624,1065,2559,3084,939,2145,540,126,414
199184,36,669,250,419,648,241,407,21,9,12
199193,36,18198,9209,8989,16849,8412,8437,1349,797,552
199209,36,864,410,454,726,370,356,138,40,98
199218,36,9889,3477,6412,8054,3015,5039,1835,462,1373
199263,36,177,50,127,47,7,40,130,43,87
199272,36,436,213,223,386,200,186,50,13,37
199281,36,4100,1532,2568,3036,1178,1858,1064,354,710
199306,36,460,191,269,442,184,258,18,7,11
199324,36,524,186,338,57,22,35,467,164,303
199333,36,3197,1115,2082,1413,581,832,1784,534,1250
199412,36,881,310,571,821,293,528,60,17,43
199421,36,883,278,605,306,104,202,577,174,403
199449,36,856,239,617,262,95,167,594,144,450
199458,36,84,59,25,82,58,24,2,1,1
199467,36,224,43,181,83,19,64,141,24,117
199476,36,357,71,286,93,21,72,264,50,214
199485,36,675,207,468,198,74,124,477,133,344
199494,36,2609,902,1707,777,306,471,1832,596,1236
199582,36,512,262,250,426,212,214,86,50,36
199607,36,217,3,214,173,0,173,44,3,41
199625,36,633,180,453,252,85,167,381,95,286
199634,36,1571,534,1037,626,265,361,945,269,676
199643,36,621,263,358,540,237,303,81,26,55
199689,36,168,7,161,130,1,129,38,6,32
199698,36,510,207,303,435,201,234,75,6,69
199722,36,663,201,462,259,111,148,404,90,314
199731,36,1083,338,745,353,118,235,730,220,510
199740,36,1018,255,763,209,70,139,809,185,624
199759,36,363,245,118,203,132,71,160,113,47
199768,36,997,356,641,411,168,243,586,188,398
199786,36,1961,705,1256,588,248,340,1373,457,916
199795,36,303,108,195,108,36,72,195,72,123
199838,36,1248,343,905,403,126,277,845,217,628
199847,36,4046,1810,2236,3988,1776,2212,58,34,24
199856,36,11826,5333,6493,3616,1827,1789,8210,3506,4704
199865,36,466,148,318,464,148,316,2,0,2
199883,36,123,13,110,123,13,110,,,
199892,36,1462,542,920,522,225,297,940,317,623
199908,36,802,306,496,283,107,176,519,199,320
199926,36,852,331,521,361,167,194,491,164,327
199953,36,711,199,512,232,76,156,479,123,356
199962,36,1565,642,923,1513,624,889,52,18,34
199971,36,26,11,15,26,11,15,,,
199980,36,20,19,1,20,19,1,,,
199999,36,3222,758,2464,2786,665,2121,436,93,343
200004,36,6827,2974,3853,5424,2398,3026,1403,576,827
200013,36,353,64,289,201,36,165,152,28,124
200022,36,1509,881,628,912,530,382,597,351,246
200059,36,747,330,417,609,284,325,138,46,92
200086,36,102,26,76,77,20,57,25,6,19
200110,36,25,1,24,25,1,24,,,
200156,36,658,365,293,630,348,282,28,17,11
200192,36,271,98,173,165,69,96,106,29,77
200208,36,239,65,174,130,48,82,109,17,92
200217,36,1583,635,948,1265,505,760,318,130,188
200226,36,522,206,316,389,175,214,133,31,102
200253,36,1534,552,982,1223,451,772,311,101,210
200280,36,6392,3666,2726,4779,2543,2236,1613,1123,490
200305,36,891,543,348,713,462,251,178,81,97
200314,36,232,52,180,153,41,112,79,11,68
200332,36,6739,3357,3382,5959,3053,2906,780,304,476
200341,36,344,110,234,250,87,163,94,23,71
200466,36,166,74,92,138,68,70,28,6,22
200484,36,109,50,59,94,44,50,15,6,9
200527,36,378,141,237,333,126,207,45,15,30
200554,36,297,109,188,275,97,178,22,12,10
200572,36,615,283,332,480,230,250,135,53,82
200590,36,70,10,60,68,9,59,2,1,1
200785,36,287,33,254,129,13,116,158,20,138
200800,36,7601,3997,3604,6144,3249,2895,1457,748,709
200846,36,453,179,274,343,126,217,110,53,57
200873,36,55,29,26,37,15,22,18,14,4
201034,36,314,132,182,83,24,59,231,108,123
201061,36,157,52,105,151,49,102,6,3,3
201098,36,34,13,21,19,5,14,15,8,7
201104,36,1660,708,952,1292,531,761,368,177,191
201131,36,22,7,15,15,0,15,7,7,0
201140,36,19,13,6,,,,19,13,6
201159,36,55,40,15,31,21,10,24,19,5
201177,36,155,10,145,60,5,55,95,5,90
201195,36,1940,858,1082,1847,811,1036,93,47,46
201283,36,322,110,212,159,72,87,163,38,125
201371,36,466,245,221,459,242,217,7,3,4
201432,36,516,171,345,324,101,223,192,70,122
201441,36,8829,3837,4992,8176,3476,4700,653,361,292
201469,36,329,53,276,224,45,179,105,8,97
201478,36,182,83,99,127,37,90,55,46,9
201496,36,183,121,62,183,121,62,,,
201539,36,68,6,62,45,4,41,23,2,21
201548,36,1297,530,767,1264,513,751,33,17,16
201645,36,4313,2235,2078,4267,2211,2056,46,24,22
201654,36,2602,1160,1442,2544,1132,1412,58,28,30
201672,36,934,196,738,177,49,128,757,147,610
201681,36,2,0,2,2,0,2,,,
201690,36,4338,1178,3160,2361,671,1690,1977,507,1470
201751,36,24,4,20,9,1,8,15,3,12
201803,36,23,3,20,23,3,20,,,
201821,36,553,45,508,405,35,370,148,10,138
201867,36,47,7,40,47,7,40,,,
201885,36,20248,10226,10022,17662,9149,8513,2586,1077,1509
201928,36,3876,1538,2338,1064,480,584,2812,1058,1754
201946,36,1315,447,868,564,246,318,751,201,550
201955,36,2226,830,1396,1348,576,772,878,254,624
201964,36,707,299,408,504,224,280,203,75,128
201973,36,2029,526,1503,422,132,290,1607,394,1213
202046,36,392,108,284,382,101,281,10,7,3
202073,36,151,73,78,151,73,78,,,
202134,36,6879,3142,3737,5403,2503,2900,1476,639,837
202152,36,61,6,55,61,6,55,,,
202170,36,674,213,461,662,212,450,12,1,11
202222,36,10656,4898,5758,2646,1254,1392,8010,3644,4366
202356,36,8347,3033,5314,2075,917,1158,6272,2116,4156
202435,36,55,9,46,30,6,24,25,3,22
202453,36,35,29,6,35,29,6,,,
202480,36,6157,3210,2947,5908,3088,2820,249,122,127
202514,36,303,177,126,289,168,121,14,9,5
202523,36,1700,811,889,1694,808,886,6,3,3
202648,36,785,245,540,203,96,107,582,149,433
202657,36,244,55,189,33,7,26,211,48,163
202763,36,1511,495,1016,1455,473,982,56,22,34
202806,36,3963,1581,2382,1648,595,1053,2315,986,1329
202888,36,24,3,21,17,3,14,7,0,7
202903,36,170,89,81,104,47,57,66,42,24
202912,36,209,7,202,80,2,78,129,5,124
202949,36,74,67,7,74,67,7,,,
202985,36,13,1,12,8,1,7,5,0,5
203030,36,29,0,29,29,0,29,,,
203085,36,658,335,323,643,329,314,15,6,9
203128,36,508,234,274,463,214,249,45,20,25
203146,36,69,62,7,69,62,7,,,
203155,36,909,442,467,684,362,322,225,80,145
203234,36,34,2,32,34,2,32,,,
203289,36,21,13,8,21,13,8,,,
203331,36,25741,7750,17991,8166,2409,5757,17575,5341,12234
203368,36,1731,945,786,1689,920,769,42,25,17
203386,36,1773,125,1648,991,72,919,782,53,729
203438,36,88,0,88,34,0,34,54,0,54
203447,36,1155,441,714,96,26,70,1059,415,644
203456,36,679,256,423,5,1,4,674,255,419
203465,36,2067,770,1297,605,244,361,1462,526,936
203474,36,1216,467,749,166,49,117,1050,418,632
203483,36,1302,546,756,197,90,107,1105,456,649
203492,36,842,221,621,153,22,131,689,199,490
203517,36,14063,5315,8748,11711,4324,7387,2352,991,1361
203526,36,1164,403,761,106,40,66,1058,363,695
203535,36,1326,592,734,1326,592,734,,,
203544,36,372,50,322,255,31,224,117,19,98
203580,36,397,212,185,371,200,171,26,12,14
203599,36,2604,990,1614,696,309,387,1908,681,1227
203614,36,264,58,206,264,58,206,,,
203678,36,902,205,697,220,82,138,682,123,559
203720,36,64,29,35,43,28,15,21,1,20
203739,36,39,7,32,33,5,28,6,2,4
203748,36,3945,1327,2618,1083,423,660,2862,904,1958
203757,36,523,226,297,472,211,261,51,15,36
203775,36,549,234,315,491,206,285,58,28,30
203845,36,724,351,373,687,330,357,37,21,16
203881,36,846,370,476,190,80,110,656,290,366
203942,36,21,11,10,21,11,10,,,
203960,36,829,92,737,276,37,239,553,55,498
204006,36,1391,690,701,1033,490,543,358,200,158
204015,36,699,325,374,511,232,279,188,93,95
204024,36,12460,6078,6382,12154,5903,6251,306,175,131
204121,36,39,0,39,17,0,17,22,0,22
204158,36,98,20,78,98,20,78,,,
204176,36,424,49,375,333,41,292,91,8,83
204185,36,1271,656,615,1254,646,608,17,10,7
204194,36,1086,428,658,956,392,564,130,36,94
204200,36,695,297,398,639,281,358,56,16,40
204255,36,484,210,274,245,123,122,239,87,152
204264,36,929,428,501,847,410,437,82,18,64
204334,36,78,1,77,1,0,1,77,1,76
204422,36,796,256,540,217,86,131,579,170,409
204431,36,25,3,22,25,3,22,,,
204440,36,725,358,367,177,89,88,548,269,279
204459,36,1,0,1,1,0,1,,,
204468,36,704,347,357,606,319,287,98,28,70
204486,36,1560,1301,259,1420,1204,216,140,97,43
204501,36,2095,860,1235,2087,856,1231,8,4,4
204608,36,240,215,25,240,215,25,,,
204617,36,531,267,264,481,244,237,50,23,27
204635,36,1685,927,758,1640,899,741,45,28,17
204662,36,186,78,108,162,64,98,24,14,10
204671,36,414,163,251,355,135,220,59,28,31
204680,36,374,166,208,321,144,177,53,22,31
204699,36,465,223,242,376,175,201,89,48,41
204705,36,853,401,452,648,303,345,205,98,107
204714,36,70,3,67,70,3,67,,,
204723,36,148,120,28,148,120,28,,,
204769,36,72,4,68,72,4,68,,,
204778,36,30,1,29,30,1,29,,,
204796,36,33619,16928,16691,31014,15482,15532,2605,1446,1159
204802,36,184,67,117,140,46,94,44,21,23
204820,36,585,182,403,390,119,271,195,63,132
204839,36,357,117,240,272,83,189,85,34,51
204848,36,427,154,273,290,91,199,137,63,74
204857,36,12226,4842,7384,9689,4249,5440,2537,593,1944
204866,36,409,90,319,280,57,223,129,33,96
204884,36,73,3,70,73,3,70,,,
204893,36,38,8,30,15,6,9,23,2,21
204909,36,922,404,518,911,398,513,11,6,5
204936,36,1471,603,868,1401,567,834,70,36,34
204945,36,2958,1055,1903,861,347,514,2097,708,1389
204963,36,8,1,7,8,1,7,,,
204981,36,51,13,38,14,2,12,37,11,26
205027,36,13,13,0,13,13,0,,,
205054,36,301,36,265,301,36,265,,,
205090,36,69,8,61,9,1,8,60,7,53
205124,36,27,27,0,27,27,0,,,
205142,36,102,32,70,98,32,66,4,0,4
205179,36,335,45,290,323,44,279,12,1,11
205203,36,423,154,269,255,122,133,168,32,136
205391,36,121,23,98,56,10,46,65,13,52
205443,36,1636,699,937,1295,569,726,341,130,211
205470,36,7235,2980,4255,1672,846,826,5563,2134,3429
205559,36,20,3,17,20,3,17,,,
205841,36,4078,1667,2411,1139,573,566,2939,1094,1845
205887,36,277,31,246,277,31,246,,,
205957,36,1782,729,1053,1642,670,972,140,59,81
205966,36,460,123,337,154,52,102,306,71,235
206011,36,676,368,308,199,105,94,477,263,214
206039,36,18,1,17,14,0,14,4,1,3
206048,36,1206,579,627,925,476,449,281,103,178
206084,36,8089,4023,4066,7052,3502,3550,1037,521,516
206154,36,11,10,1,,,,11,10,1
206172,36,5,0,5,5,0,5,,,
206181,36,129,34,95,50,4,46,79,30,49
206279,36,338,179,159,117,65,52,221,114,107
206321,36,70,18,52,41,1,40,29,17,12
206349,36,443,30,413,371,24,347,72,6,66
206394,36,31,8,23,14,5,9,17,3,14
206437,36,1006,452,554,896,420,476,110,32,78
206446,36,676,203,473,263,112,151,413,91,322
206491,36,283,115,168,232,90,142,51,25,26
206507,36,646,287,359,608,270,338,38,17,21
206525,36,806,368,438,782,357,425,24,11,13
206589,36,1366,644,722,1364,643,721,2,1,1
206604,36,4341,1986,2355,3324,1477,1847,1017,509,508
206613,36,584,241,343,437,165,272,147,76,71
206622,36,3521,1543,1978,3321,1454,1867,200,89,111
206695,36,5786,2637,3149,5040,2321,2719,746,316,430
206817,36,161,75,86,127,60,67,34,15,19
206835,36,449,242,207,344,196,148,105,46,59
206862,36,578,287,291,561,279,282,17,8,9
206905,36,31,11,20,31,11,20,,,
206914,36,1911,670,1241,1308,466,842,603,204,399
206923,36,1005,312,693,637,246,391,368,66,302
206932,36,335,26,309,148,22,126,187,4,183
206941,36,7715,2901,4814,5562,2045,3517,2153,856,1297
206996,36,881,215,666,452,131,321,429,84,345
207041,36,1267,520,747,1119,462,657,148,58,90
207050,36,610,173,437,365,118,247,245,55,190
207069,36,345,106,239,189,77,112,156,29,127
207087,36,8,1,7,8,1,7,,,
207102,36,71,20,51,71,20,51,,,
207157,36,167,86,81,135,75,60,32,11,21
207209,36,1151,428,723,1063,387,676,88,41,47
207236,36,935,264,671,481,182,299,454,82,372
207254,36,496,446,50,496,446,50,,,
207263,36,3411,1242,2169,2442,915,1527,969,327,642
207281,36,1146,394,752,635,251,384,511,143,368
207290,36,899,335,564,659,284,375,240,51,189
207306,36,929,377,552,769,322,447,160,55,105
207324,36,1311,534,777,1221,511,710,90,23,67
207342,36,413,37,376,389,34,355,24,3,21
207351,36,570,244,326,437,208,229,133,36,97
207388,36,14098,6827,7271,12526,6012,6514,1572,815,757
207397,36,2355,793,1562,512,236,276,1843,557,1286
207403,36,827,342,485,812,335,477,15,7,8
207449,36,6906,2459,4447,2145,866,1279,4761,1593,3168
207458,36,865,288,577,835,269,566,30,19,11
207500,36,15152,7565,7587,13537,6684,6853,1615,881,734
207564,36,1156,796,360,679,528,151,477,268,209
207582,36,2301,888,1413,1953,756,1197,348,132,216
207661,36,1782,690,1092,1307,507,800,475,183,292
207670,36,3032,973,2059,1263,480,783,1769,493,1276
207704,36,168,1,167,77,1,76,91,0,91
207722,36,501,178,323,455,162,293,46,16,30
207740,36,655,176,479,333,119,214,322,57,265
207786,36,1,0,1,1,0,1,,,
207847,36,2414,1037,1377,1607,745,862,807,292,515
207856,36,246,140,106,219,123,96,27,17,10
207865,36,2399,928,1471,2024,802,1222,375,126,249
207935,36,7386,2552,4834,2178,928,1250,5208,1624,3584
207962,36,481,423,58,481,423,58,,,
207971,36,1842,928,914,1719,853,866,123,75,48
208035,36,511,140,371,226,103,123,285,37,248
208044,36,37,6,31,37,6,31,,,
208053,36,15,7,8,,,,15,7,8
208275,36,554,189,365,278,104,174,276,85,191
208318,36,2195,977,1218,996,453,543,1199,524,675
208390,36,4481,1999,2482,1830,799,1031,2651,1200,1451
208406,36,2094,1101,993,675,322,353,1419,779,640
208415,36,355,116,239,161,51,110,194,65,129
208433,36,42,0,42,42,0,42,,,
208479,36,352,57,295,352,57,295,,,
208512,36,342,29,313,342,29,313,,,
208637,36,155,36,119,,,,155,36,119
208646,36,1634,672,962,982,411,571,652,261,391
208725,36,21,13,8,19,11,8,2,2,0
208822,36,1723,663,1060,1587,613,974,136,50,86
208859,36,5,0,5,5,0,5,,,
209038,36,3649,1732,1917,1432,656,776,2217,1076,1141
209056,36,1510,544,966,1494,536,958,16,8,8
209065,36,1149,386,763,1083,362,721,66,24,42
209074,36,2463,1114,1349,925,465,460,1538,649,889
209083,36,28,9,19,28,9,19,,,
209153,36,2,0,2,2,0,2,,,
209205,36,33,1,32,33,1,32,,,
209241,36,20,20,0,20,20,0,,,
209250,36,2185,832,1353,974,392,582,1211,440,771
209287,36,188,106,82,162,95,67,26,11,15
209296,36,12,3,9,12,3,9,,,
209409,36,363,149,214,313,138,175,50,11,39
209490,36,431,77,354,222,41,181,209,36,173
209506,36,2216,1181,1035,1429,783,646,787,398,389
209542,36,21316,11171,10145,13950,7294,6656,7366,3877,3489
209551,36,13190,5886,7304,12118,5367,6751,1072,519,553
209603,36,233,57,176,219,51,168,14,6,8
209612,36,1028,410,618,982,389,593,46,21,25
209667,36,11,0,11,11,0,11,,,
209676,36,10,0,10,10,0,10,,,
209694,36,7,0,7,7,0,7,,,
209700,36,169,20,149,169,20,149,,,
209719,36,38,0,38,38,0,38,,,
209746,36,12327,5183,7144,4603,1998,2605,7724,3185,4539
209807,36,10464,4582,5882,7670,3284,4386,2794,1298,1496
209825,36,2449,885,1564,2391,863,1528,58,22,36
209922,36,1086,463,623,1080,461,619,6,2,4
209940,36,2042,837,1205,671,268,403,1371,569,802
210146,36,2046,834,1212,1579,648,931,467,186,281
210155,36,696,255,441,363,162,201,333,93,240
210234,36,671,284,387,333,164,169,338,120,218
210270,36,1160,418,742,361,139,222,799,279,520
210304,36,303,110,193,285,100,185,18,10,8
210331,36,566,249,317,442,177,265,124,72,52
210401,36,773,319,454,755,311,444,18,8,10
210429,36,2317,767,1550,1984,649,1335,333,118,215
210438,36,2,2,0,,,,2,2,0
210492,36,166,86,80,153,79,74,13,7,6
210571,36,821,370,451,750,343,407,71,27,44
210599,36,498,250,248,498,250,248,,,
210605,36,6642,2936,3706,1920,899,1021,4722,2037,2685
210669,36,1023,470,553,1014,468,546,9,2,7
210711,36,33,2,31,33,2,31,,,
210739,36,1577,546,1031,1329,480,849,248,66,182
210748,36,52,2,50,24,0,24,28,2,26
210775,36,1437,467,970,1106,394,712,331,73,258
210784,36,115,1,114,94,1,93,21,0,21
211006,36,317,295,22,312,294,18,5,1,4
211024,36,262,128,134,180,80,100,82,48,34
211079,36,727,264,463,261,105,156,466,159,307
211088,36,1202,420,782,1088,362,726,114,58,56
211273,36,995,0,995,990,0,990,5,0,5
211291,36,2680,1283,1397,2679,1283,1396,1,0,1
211307,36,3667,1483,2184,1149,561,588,2518,922,1596
211316,36,74,1,73,54,1,53,20,0,20
211334,36,9,0,9,9,0,9,,,
211343,36,1234,427,807,415,183,232,819,244,575
211352,36,814,337,477,775,317,458,39,20,19
211431,36,872,129,743,612,93,519,260,36,224
211440,36,5227,2592,2635,5081,2520,2561,146,72,74
211468,36,700,45,655,503,32,471,197,13,184
211477,36,619,196,423,118,51,67,501,145,356
211556,36,833,230,603,801,219,582,32,11,21
211583,36,675,283,392,575,263,312,100,20,80
211608,36,432,153,279,395,140,255,37,13,24
211635,36,73,12,61,73,12,61,,,
211802,36,142,38,104,142,38,104,,,
211893,36,65,37,28,65,37,28,,,
211927,36,5390,1899,3491,1220,551,669,4170,1348,2822
211981,36,1087,420,667,993,387,606,94,33,61
212009,36,1496,621,875,1489,616,873,7,5,2
212045,36,76,17,59,74,17,57,2,0,2
212054,36,10421,5390,5031,9485,4997,4488,936,393,543
212106,36,3434,1256,2178,3365,1219,2146,69,37,32
212115,36,2838,1264,1574,2496,1110,1386,342,154,188
212133,36,1033,342,691,777,278,499,256,64,192
212197,36,1179,492,687,1088,457,631,91,35,56
212230,36,17,2,15,15,2,13,2,0,2
212267,36,39,1,38,22,0,22,17,1,16
212276,36,28,0,28,20,0,20,8,0,8
212294,36,34,0,34,27,0,27,7,0,7
212300,36,9,0,9,9,0,9,,,
212328,36,45,1,44,28,1,27,17,0,17
212337,36,68,3,65,39,1,38,29,2,27
212355,36,66,1,65,46,1,45,20,0,20
212382,36,81,1,80,47,1,46,34,0,34
212391,36,34,1,33,24,1,23,10,0,10
212434,36,98,92,6,98,92,6,,,
212577,36,1485,659,826,1483,657,826,2,2,0
212601,36,1863,755,1108,1799,734,1065,64,21,43
212656,36,695,354,341,651,331,320,44,23,21
212674,36,1579,772,807,1575,770,805,4,2,2
212753,36,38,0,38,22,0,22,16,0,16
212771,36,62,0,62,35,0,35,27,0,27
212805,36,1508,767,741,1494,758,736,14,9,5
212832,36,976,224,752,878,203,675,98,21,77
212869,36,505,79,426,311,56,255,194,23,171
212878,36,7551,2208,5343,2035,740,1295,5516,1468,4048
212911,36,1043,492,551,1043,492,551,,,
212975,36,54,37,17,54,37,17,,,
212984,36,1565,351,1214,1292,296,996,273,55,218
212993,36,56,28,28,48,25,23,8,3,5
213011,36,963,284,679,739,238,501,224,46,178
213020,36,4583,1754,2829,4155,1558,2597,428,196,232
213163,36,331,45,286,293,43,250,38,2,36
213181,36,225,19,206,181,15,166,44,4,40
213233,36,250,197,53,206,169,37,44,28,16
213251,36,796,365,431,793,364,429,3,1,2
213303,36,734,313,421,567,285,282,167,28,139
213321,36,1169,593,576,1137,577,560,32,16,16
213330,36,9,0,9,9,0,9,,,
213349,36,4348,1871,2477,3998,1708,2290,350,163,187
213358,36,584,224,360,498,196,302,86,28,58
213367,36,1594,586,1008,1362,529,833,232,57,175
213376,36,1102,398,704,795,314,481,307,84,223
213385,36,1949,988,961,1936,980,956,13,8,5
213400,36,979,466,513,574,270,304,405,196,209
213455,36,40,2,38,19,2,17,21,0,21
213473,36,79,9,70,45,0,45,34,9,25
213491,36,14,0,14,8,0,8,6,0,6
213507,36,1138,520,618,1109,508,601,29,12,17
213525,36,3021,1008,2013,900,441,459,2121,567,1554
213534,36,174,48,126,163,45,118,11,3,8
213543,36,4048,2198,1850,3986,2161,1825,62,37,25
213570,36,300,46,254,300,46,254,,,
213589,36,192,171,21,157,139,18,35,32,3
213598,36,1251,444,807,1153,408,745,98,36,62
213622,36,104,17,87,81,16,65,23,1,22
213659,36,2233,653,1580,701,268,433,1532,385,1147
213668,36,725,335,390,725,335,390,,,
213774,36,285,61,224,185,45,140,100,16,84
213826,36,1259,401,858,1179,379,800,80,22,58
213914,36,139,11,128,139,11,128,,,
213932,36,174,23,151,174,23,151,,,
213987,36,1737,702,1035,1625,678,947,112,24,88
213996,36,1659,652,1007,1615,630,985,44,22,22
214023,36,7,2,5,6,1,5,1,1,0
214041,36,4085,1673,2412,3196,1341,1855,889,332,557
214069,36,1293,406,887,969,346,623,324,60,264
214111,36,5029,1969,3060,1349,663,686,3680,1306,2374
214148,36,227,0,227,219,0,219,8,0,8
214157,36,1319,487,832,1260,476,784,59,11,48
214166,36,692,188,504,574,170,404,118,18,100
214175,36,1471,579,892,1428,556,872,43,23,20
214272,36,1146,438,708,882,332,550,264,106,158
214290,36,211,183,28,211,183,28,,,
214379,36,5078,1790,3288,1832,818,1014,3246,972,2274
214476,36,34,5,29,31,4,27,3,1,2
214528,36,182,172,10,127,118,9,55,54,1
214582,36,353,36,317,243,23,220,110,13,97
214591,36,2261,1473,788,2148,1391,757,113,82,31
214625,36,275,169,106,233,148,85,42,21,21
214634,36,147,45,102,112,36,76,35,9,26
214643,36,192,125,67,178,114,64,14,11,3
214652,36,590,300,290,560,283,277,30,17,13
214670,36,508,291,217,454,259,195,54,32,22
214689,36,1567,816,751,1511,779,732,56,37,19
214698,36,309,171,138,296,167,129,13,4,9
214704,36,1288,774,514,1161,696,465,127,78,49
214713,36,2618,1620,998,2381,1461,920,237,159,78
214731,36,738,437,301,667,390,277,71,47,24
214740,36,217,116,101,199,110,89,18,6,12
214759,36,299,125,174,276,111,165,23,14,9
214768,36,285,152,133,271,146,125,14,6,8
214777,36,31769,17015,14754,30873,16430,14443,896,585,311
214786,36,221,128,93,206,120,86,15,8,7
214795,36,398,162,236,353,142,211,45,20,25
214801,36,2003,1161,842,1787,1030,757,216,131,85
214810,36,392,147,245,358,139,219,34,8,26
214829,36,422,267,155,351,220,131,71,47,24
214883,36,654,161,493,147,35,112,507,126,381
214892,36,159,56,103,159,56,103,,,
214944,36,300,259,41,162,145,17,138,114,24
214971,36,84,23,61,80,22,58,4,1,3
215008,36,37,37,0,37,37,0,,,
215044,36,97,14,83,97,14,83,,,
215053,36,146,40,106,139,38,101,7,2,5
215062,36,8044,3633,4411,7625,3487,4138,419,146,273
215105,36,921,310,611,897,303,594,24,7,17
215114,36,540,270,270,510,247,263,30,23,7
215239,36,7908,2462,5446,2249,847,1402,5659,1615,4044
215266,36,695,310,385,656,296,360,39,14,25
215275,36,821,336,485,768,306,462,53,30,23
215284,36,1399,800,599,1357,776,581,42,24,18
215293,36,14683,6470,8213,14121,6166,7955,562,304,258
215309,36,12,1,11,6,1,5,6,0,6
215336,36,10,0,10,10,0,10,,,
215381,36,328,304,24,328,304,24,,,
215390,36,243,68,175,33,11,22,210,57,153
215415,36,507,304,203,424,262,162,83,42,41
215442,36,1642,587,1055,1470,506,964,172,81,91
215479,36,64,9,55,64,9,55,,,
215530,36,17,0,17,14,0,14,3,0,3
215585,36,2187,670,1517,467,195,272,1720,475,1245
215594,36,247,40,207,185,33,152,62,7,55
215637,36,95,42,53,95,42,53,,,
215655,36,1983,1107,876,1847,1036,811,136,71,65
215682,36,263,240,23,263,240,23,,,
215691,36,300,144,156,236,121,115,64,23,41
215743,36,1269,436,833,1128,411,717,141,25,116
215770,36,3772,1663,2109,3621,1599,2022,151,64,87
215798,36,943,525,418,923,514,409,20,11,9
215886,36,27,4,23,12,2,10,15,2,13
215929,36,2399,1012,1387,2339,977,1362,60,35,25
215947,36,1152,396,756,1048,366,682,104,30,74
215974,36,408,57,351,304,39,265,104,18,86
215983,36,23,5,18,23,5,18,,,
215992,36,39,18,21,38,18,20,1,0,1
216010,36,2960,1461,1499,2686,1315,1371,274,146,128
216038,36,4772,2134,2638,4477,1998,2479,295,136,159
216047,36,28,28,0,28,28,0,,,
216074,36,52,1,51,33,1,32,19,0,19
216083,36,172,55,117,155,54,101,17,1,16
216162,36,337,27,310,337,27,310,,,
216223,36,24,2,22,24,2,22,,,
216278,36,1533,652,881,1515,640,875,18,12,6
216287,36,1183,586,597,1183,586,597,,,
216296,36,660,598,62,633,574,59,27,24,3
216311,36,89,89,0,89,89,0,,,
216339,36,17803,7876,9927,16170,7020,9150,1633,856,777
216357,36,528,277,251,520,272,248,8,5,3
216366,36,2263,611,1652,1994,546,1448,269,65,204
216436,36,64,57,7,64,57,7,,,
216445,36,61,59,2,61,59,2,,,
216454,36,48,43,5,48,43,5,,,
216524,36,1098,576,522,1095,574,521,3,2,1
216542,36,325,143,182,285,130,155,40,13,27
216551,36,42,32,10,41,31,10,1,1,0
216579,36,57,2,55,57,2,55,,,
216597,36,5060,2309,2751,4909,2215,2694,151,94,57
216630,36,33,4,29,33,4,29,,,
216667,36,767,397,370,758,391,367,9,6,3
216694,36,738,302,436,731,299,432,7,3,4
216746,36,36,30,6,30,25,5,6,5,1
216764,36,9987,4047,5940,8762,3542,5220,1225,505,720
216773,36,95,12,83,95,12,83,,,
216807,36,712,329,383,695,322,373,17,7,10
216825,36,1953,604,1349,729,289,440,1224,315,909
216852,36,1815,769,1046,1661,724,937,154,45,109
216931,36,1320,600,720,1247,574,673,73,26,47
216940,36,154,154,0,154,154,0,,,
217013,36,454,82,372,366,77,289,88,5,83
217040,36,26,26,0,26,26,0,,,
217059,36,2319,1016,1303,2091,877,1214,228,139,89
217077,36,231,78,153,231,78,153,,,
217156,36,5393,2670,2723,5337,2649,2688,56,21,35
217165,36,2151,1350,801,2128,1332,796,23,18,5
217235,36,2990,1184,1806,2814,1099,1715,176,85,91
217305,36,1098,664,434,935,579,356,163,85,78
217323,36,27,27,0,27,27,0,,,
217402,36,2702,1227,1475,2598,1180,1418,104,47,57
217420,36,3392,1034,2358,2612,794,1818,780,240,540
217475,36,7586,2765,4821,2319,936,1383,5267,1829,3438
217484,36,9805,4268,5537,8962,3876,5086,843,392,451
217493,36,1613,531,1082,1613,531,1082,,,
217518,36,2421,1210,1211,2350,1173,1177,71,37,34
217536,36,1536,486,1050,1485,470,1015,51,16,35
217581,36,86,0,86,55,0,55,31,0,31
217606,36,126,70,56,89,47,42,37,23,14
217615,36,1123,354,769,338,128,210,785,226,559
217624,36,396,231,165,374,222,152,22,9,13
217633,36,2032,637,1395,1945,612,1333,87,25,62
217688,36,1765,619,1146,1614,559,1055,151,60,91
217712,36,1149,284,865,233,77,156,916,207,709
217721,36,1256,534,722,1240,526,714,16,8,8
217749,36,1703,782,921,1592,739,853,111,43,68
217776,36,542,183,359,423,154,269,119,29,90
217794,36,73,0,73,46,0,46,27,0,27
217819,36,6911,2343,4568,6432,2129,4303,479,214,265
217828,36,31,2,29,18,1,17,13,1,12
217837,36,583,118,465,132,35,97,451,83,368
217864,36,1870,1617,253,1712,1498,214,158,119,39
217873,36,1260,415,845,1151,368,783,109,47,62
217882,36,16258,7874,8384,15562,7465,8097,696,409,287
217891,36,129,49,80,124,47,77,5,2,3
217907,36,492,188,304,472,181,291,20,7,13
217925,36,547,282,265,351,193,158,196,89,107
217934,36,761,103,658,488,58,430,273,45,228
217961,36,509,91,418,487,90,397,22,1,21
217989,36,227,86,141,139,58,81,88,28,60
217998,36,447,282,165,433,273,160,14,9,5
218025,36,1596,511,1085,553,242,311,1043,269,774
218061,36,1898,650,1248,1762,598,1164,136,52,84
218070,36,1595,651,944,1576,637,939,19,14,5
218113,36,6208,2300,3908,2367,977,1390,3841,1323,2518
218140,36,4901,1543,3358,2308,906,1402,2593,637,1956
218159,36,106,2,104,78,2,76,28,0,28
218195,36,115,3,112,68,2,66,47,1,46
218229,36,2282,725,1557,2150,682,1468,132,43,89
218238,36,1046,497,549,842,416,426,204,81,123
218335,36,198,22,176,192,21,171,6,1,5
218353,36,4860,1646,3214,1721,736,985,3139,910,2229
218399,36,221,105,116,218,102,116,3,3,0
218414,36,787,432,355,766,426,340,21,6,15
218441,36,1009,474,535,950,444,506,59,30,29
218487,36,1002,231,771,284,115,169,718,116,602
218520,36,2946,744,2202,894,293,601,2052,451,1601
218539,36,574,274,300,570,273,297,4,1,3
218645,36,1859,671,1188,1522,563,959,337,108,229
218654,36,1204,377,827,1022,311,711,182,66,116
218663,36,18951,8462,10489,18157,8025,10132,794,437,357
218672,36,258,98,160,214,86,128,44,12,32
218681,36,131,65,66,102,57,45,29,8,21
218690,36,278,146,132,181,91,90,97,55,42
218706,36,118,60,58,99,50,49,19,10,9
218724,36,6247,2748,3499,5778,2505,3273,469,243,226
218733,36,1331,606,725,1189,537,652,142,69,73
218742,36,2806,930,1876,2376,752,1624,430,178,252
218821,36,505,235,270,461,214,247,44,21,23
218830,36,3139,1145,1994,1296,532,764,1843,613,1230
218858,36,1844,436,1408,425,152,273,1419,284,1135
218885,36,2515,1071,1444,1100,574,526,1415,497,918
218894,36,6172,2140,4032,2071,808,1263,4101,1332,2769
218919,36,229,98,131,198,90,108,31,8,23
218955,36,264,43,221,50,9,41,214,34,180
218964,36,2437,806,1631,2251,739,1512,186,67,119
218973,36,1285,618,667,1270,608,662,15,10,5
218991,36,2206,767,1439,880,367,513,1326,400,926
219000,36,1153,424,729,1120,409,711,33,15,18
219037,36,28,0,28,26,0,26,2,0,2
219046,36,1288,414,874,994,335,659,294,79,215
219082,36,1310,901,409,882,631,251,428,270,158
219091,36,384,180,204,366,174,192,18,6,12
219125,36,56,4,52,45,2,43,11,2,9
219143,36,1062,518,544,827,465,362,235,53,182
219170,36,23,3,20,23,3,20,,,
219189,36,468,314,154,357,254,103,111,60,51
219198,36,474,245,229,411,208,203,63,37,26
219204,36,733,325,408,84,49,35,649,276,373
219240,36,26,13,13,10,5,5,16,8,8
219259,36,892,371,521,687,294,393,205,77,128
219277,36,966,270,696,398,123,275,568,147,421
219295,36,392,129,263,229,109,120,163,20,143
219338,36,15,3,12,15,3,12,,,
219347,36,1440,1114,326,1143,897,246,297,217,80
219356,36,6022,2802,3220,5144,2434,2710,878,368,510
219374,36,277,59,218,88,22,66,189,37,152
219383,36,887,340,547,798,296,502,89,44,45
219392,36,27,4,23,27,4,23,,,
219408,36,132,42,90,78,30,48,54,12,42
219426,36,1125,498,627,569,336,233,556,162,394
219453,36,97,1,96,97,1,96,,,
219471,36,3643,1331,2312,3010,1106,1904,633,225,408
219480,36,475,205,270,319,163,156,156,42,114
219505,36,43,28,15,29,19,10,14,9,5
219587,36,53,0,53,53,0,53,,,
219596,36,175,131,44,175,131,44,,,
219602,36,4866,1957,2909,3512,1393,2119,1354,564,790
219639,36,624,55,569,216,23,193,408,32,376
219709,36,5039,1706,3333,4806,1604,3202,233,102,131
219718,36,1500,818,682,1300,724,576,200,94,106
219790,36,594,278,316,488,243,245,106,35,71
219806,36,1021,442,579,1000,430,570,21,12,9
219824,36,3058,1066,1992,1530,583,947,1528,483,1045
219833,36,809,357,452,764,335,429,45,22,23
219851,36,22,2,20,22,2,20,,,
219879,36,1203,537,666,686,326,360,517,211,306
219888,36,2187,789,1398,1219,505,714,968,284,684
219903,36,946,83,863,946,83,863,,,
219921,36,197,125,72,126,77,49,71,48,23
219949,36,1180,460,720,1100,432,668,80,28,52
219976,36,2051,800,1251,1906,745,1161,145,55,90
219994,36,500,311,189,466,278,188,34,33,1
220002,36,28,5,23,28,5,23,,,
220057,36,1176,302,874,541,195,346,635,107,528
220075,36,6667,2593,4074,5609,2189,3420,1058,404,654
220118,36,37,2,35,37,2,35,,,
220127,36,328,192,136,304,171,133,24,21,3
220163,36,27,0,27,21,0,21,6,0,6
220181,36,661,220,441,642,214,428,19,6,13
220206,36,177,101,76,129,69,60,48,32,16
220215,36,994,431,563,952,418,534,42,13,29
220251,36,154,91,63,119,75,44,35,16,19
220279,36,196,137,59,143,93,50,53,44,9
220321,36,284,143,141,237,129,108,47,14,33
220394,36,154,93,61,152,91,61,2,2,0
220400,36,1527,374,1153,547,151,396,980,223,757
220464,36,122,56,66,27,11,16,95,45,50
220473,36,437,206,231,384,178,206,53,28,25
220491,36,219,8,211,142,6,136,77,2,75
220516,36,750,275,475,682,254,428,68,21,47
220552,36,2823,416,2407,1983,295,1688,840,121,719
220598,36,622,330,292,596,320,276,26,10,16
220604,36,403,135,268,344,116,228,59,19,40
220613,36,2260,863,1397,2014,736,1278,246,127,119
220631,36,912,261,651,731,242,489,181,19,162
220640,36,292,155,137,251,118,133,41,37,4
220701,36,474,210,264,444,198,246,30,12,18
220710,36,640,286,354,632,283,349,8,3,5
220756,36,61,52,9,56,48,8,5,4,1
220765,36,265,68,197,144,41,103,121,27,94
220853,36,781,540,241,648,439,209,133,101,32
220862,36,10647,4167,6480,7857,3127,4730,2790,1040,1750
220978,36,11830,5611,6219,9751,4637,5114,2079,974,1105
221050,36,446,321,125,355,247,108,91,74,17
221096,36,2127,769,1358,1113,478,635,1014,291,723
221102,36,247,201,46,165,134,31,82,67,15
221148,36,789,730,59,789,730,59,,,
221184,36,3106,1063,2043,1224,466,758,1882,597,1285
221236,36,219,131,88,162,110,52,57,21,36
221281,36,135,56,79,129,55,74,6,1,5
221333,36,197,116,81,123,65,58,74,51,23
221351,36,1483,617,866,1444,608,836,39,9,30
221388,36,143,46,97,116,35,81,27,11,16
221397,36,1931,634,1297,1019,398,621,912,236,676
221430,36,244,153,91,162,104,58,82,49,33
221485,36,3366,1067,2299,1393,516,877,1973,551,1422
221494,36,329,249,80,282,223,59,47,26,21
221519,36,1168,552,616,1159,549,610,9,3,6
221582,36,107,73,34,94,63,31,13,10,3
221591,36,287,186,101,258,166,92,29,20,9
221607,36,204,131,73,151,91,60,53,40,13
221616,36,393,277,116,361,261,100,32,16,16
221625,36,589,360,229,568,344,224,21,16,5
221643,36,3865,1902,1963,1782,909,873,2083,993,1090
221661,36,1659,755,904,1428,672,756,231,83,148
221731,36,583,223,360,524,199,325,59,24,35
221740,36,6870,2909,3961,6035,2500,3535,835,409,426
221759,36,18443,8561,9882,17474,8030,9444,969,531,438
221768,36,3149,1205,1944,2834,1074,1760,315,131,184
221829,36,219,9,210,219,9,210,,,
221838,36,3490,1228,2262,2913,1009,1904,577,219,358
221847,36,5732,3074,2658,5160,2766,2394,572,308,264
221892,36,1293,470,823,987,381,606,306,89,217
221908,36,2776,1385,1391,1317,583,734,1459,802,657
221953,36,788,384,404,715,357,358,73,27,46
221971,36,1240,454,786,1082,384,698,158,70,88
221999,36,5282,2590,2692,5219,2550,2669,63,40,23
222053,36,3356,1220,2136,1762,670,1092,1594,550,1044
222062,36,2121,753,1368,1179,478,701,942,275,667
222105,36,219,205,14,110,104,6,109,101,8
222178,36,2130,812,1318,2044,776,1268,86,36,50
222567,36,1661,729,932,375,169,206,1286,560,726
222576,36,5632,1811,3821,2162,800,1362,3470,1011,2459
222628,36,89,30,59,15,3,12,74,27,47
222822,36,1544,447,1097,701,227,474,843,220,623
222831,36,3692,1582,2110,3205,1352,1853,487,230,257
222877,36,87,50,37,85,49,36,2,1,1
222886,36,105,5,100,103,5,98,2,0,2
222938,36,229,110,119,164,79,85,65,31,34
222983,36,802,381,421,800,379,421,2,2,0
222992,36,17678,7210,10468,3961,1908,2053,13717,5302,8415
223056,36,13,0,13,13,0,13,,,
223083,36,317,51,266,101,18,83,216,33,183
223117,36,36,30,6,4,3,1,32,27,5
223232,36,11471,4595,6876,11235,4488,6747,236,107,129
223320,36,1528,462,1066,486,181,305,1042,281,761
223427,36,7924,3861,4063,3575,1862,1713,4349,1999,2350
223463,36,187,37,150,187,37,150,,,
223472,36,125,13,112,125,13,112,,,
223506,36,1999,916,1083,289,130,159,1710,786,924
223816,36,3236,1334,1902,457,167,290,2779,1167,1612
223852,36,8,1,7,8,1,7,,,
223898,36,1713,581,1132,630,218,412,1083,363,720
223922,36,694,294,400,292,114,178,402,180,222
224004,36,1201,339,862,1013,293,720,188,46,142
224013,36,31,2,29,31,2,29,,,
224110,36,2911,1202,1709,772,350,422,2139,852,1287
224147,36,5190,2017,3173,3705,1415,2290,1485,602,883
224156,36,230,5,225,167,4,163,63,1,62
224226,36,1692,714,978,1420,595,825,272,119,153
224244,36,131,80,51,114,72,42,17,8,9
224271,36,222,69,153,221,68,153,1,1,0
224323,36,998,429,569,976,419,557,22,10,12
224350,36,8016,3308,4708,960,433,527,7056,2875,4181
224527,36,828,391,437,756,365,391,72,26,46
224545,36,1134,417,717,831,328,503,303,89,214
224554,36,5376,2202,3174,3732,1515,2217,1644,687,957
224615,36,26700,10123,16577,6757,2924,3833,19943,7199,12744
224642,36,18966,7842,11124,4005,1699,2306,14961,6143,8818
224660,36,469,236,233,360,187,173,109,49,60
224679,36,879,761,118,495,428,67,384,333,51
224758,36,15,0,15,13,0,13,2,0,2
224776,36,166,72,94,113,53,60,53,19,34
224828,36,56,0,56,34,0,34,22,0,22
224891,36,366,124,242,255,100,155,111,24,87
224961,36,1061,295,766,251,96,155,810,199,611
225043,36,3,3,0,3,3,0,,,
225070,36,1870,635,1235,742,267,475,1128,368,760
225201,36,457,278,179,457,278,179,,,
225247,36,895,419,476,837,391,446,58,28,30
225308,36,3431,1398,2033,787,308,479,2644,1090,1554
225371,36,1501,521,980,625,260,365,876,261,615
225399,36,1809,646,1163,1338,485,853,471,161,310
225414,36,4944,1801,3143,2260,840,1420,2684,961,1723
225423,36,25962,9945,16017,7084,2968,4116,18878,6977,11901
225432,36,9385,3401,5984,4073,1479,2594,5312,1922,3390
225502,36,2064,727,1337,910,361,549,1154,366,788
225511,36,27091,13298,13793,19161,9054,10107,7930,4244,3686
225520,36,1084,274,810,514,145,369,570,129,441
225548,36,449,230,219,401,209,192,48,21,27
225575,36,706,289,417,658,273,385,48,16,32
225627,36,3201,1140,2061,2678,932,1746,523,208,315
225876,36,77,35,42,64,32,32,13,3,10
225885,36,510,224,286,420,190,230,90,34,56
225991,36,45,27,18,45,27,18,,,
226019,36,2010,707,1303,1009,397,612,1001,310,691
226091,36,5833,2381,3452,4322,1713,2609,1511,668,843
226107,36,985,251,734,394,123,271,591,128,463
226116,36,1995,777,1218,383,139,244,1612,638,974
226125,36,62,3,59,62,3,59,,,
226134,36,6034,2444,3590,921,374,547,5113,2070,3043
226152,36,4673,1729,2944,3623,1372,2251,1050,357,693
226204,36,5906,2908,2998,619,315,304,5287,2593,2694
226231,36,1149,722,427,929,634,295,220,88,132
226277,36,870,799,71,870,799,71,,,
226383,36,802,272,530,728,249,479,74,23,51
226408,36,1985,694,1291,455,188,267,1530,506,1024
226471,36,2079,709,1370,1905,643,1262,174,66,108
226578,36,3621,976,2645,1354,435,919,2267,541,1726
226587,36,697,364,333,628,334,294,69,30,39
226675,36,336,47,289,336,47,289,,,
226806,36,3810,1556,2254,679,242,437,3131,1314,1817
226833,36,3169,1152,2017,2235,864,1371,934,288,646
226860,36,23,2,21,23,2,21,,,
226879,36,89,10,79,46,4,42,43,6,37
226903,36,839,298,541,839,298,541,,,
227058,36,42,0,42,42,0,42,,,
227146,36,4908,1840,3068,1333,573,760,3575,1267,2308
227182,36,33827,13264,20563,9405,4276,5129,24422,8988,15434
227216,36,22647,10513,12134,17125,7817,9308,5522,2696,2826
227225,36,1235,336,899,553,168,385,682,168,514
227298,36,68,60,8,68,60,8,,,
227304,36,2635,880,1755,1293,456,837,1342,424,918
227313,36,171,3,168,64,2,62,107,1,106
227322,36,193,2,191,76,1,75,117,1,116
227331,36,738,219,519,633,194,439,105,25,80
227368,36,19235,7781,11454,14052,5511,8541,5183,2270,2913
227377,36,2508,1058,1450,978,431,547,1530,627,903
227386,36,1017,232,785,460,137,323,557,95,462
227401,36,1431,453,978,661,238,423,770,215,555
227429,36,666,213,453,203,89,114,463,124,339
227526,36,5930,1885,4045,5098,1588,3510,832,297,535
227687,36,1024,436,588,313,147,166,711,289,422
227748,36,211,198,13,133,125,8,78,73,5
227757,36,3245,1662,1583,3145,1607,1538,100,55,45
227845,36,1895,713,1182,1762,657,1105,133,56,77
227854,36,6910,2599,4311,805,405,400,6105,2194,3911
227863,36,1827,701,1126,1501,503,998,326,198,128
227881,36,12742,4582,8160,9924,3538,6386,2818,1044,1774
227924,36,10717,3919,6798,1815,698,1117,8902,3221,5681
227979,36,15429,6100,9329,3855,1590,2265,11574,4510,7064
228042,36,620,278,342,586,266,320,34,12,22
228088,36,31,0,31,31,0,31,,,
228149,36,1374,556,818,1316,532,784,58,24,34
228158,36,4629,1702,2927,2377,989,1388,2252,713,1539
228185,36,2,1,1,2,1,1,,,
228200,36,268,119,149,252,114,138,16,5,11
228219,36,361,144,217,356,143,213,5,1,4
228246,36,5136,2602,2534,4984,2512,2472,152,90,62
228282,36,2,1,1,2,1,1,,,
228316,36,2298,824,1474,1010,390,620,1288,434,854
228325,36,990,467,523,842,405,437,148,62,86
228343,36,1007,460,547,989,452,537,18,8,10
228431,36,6390,2320,4070,5381,1947,3434,1009,373,636
228459,36,23524,9549,13975,18401,7360,11041,5123,2189,2934
228468,36,501,200,301,446,176,270,55,24,31
228486,36,36,21,15,33,21,12,3,0,3
228501,36,1008,363,645,542,254,288,466,109,357
228529,36,8126,2982,5144,5759,2013,3746,2367,969,1398
228547,36,31003,12702,18301,4694,2180,2514,26309,10522,15787
228608,36,1333,410,923,566,169,397,767,241,526
228644,36,465,122,343,371,82,289,94,40,54
228653,36,408,77,331,306,53,253,102,24,78
228699,36,1162,331,831,412,150,262,750,181,569
228705,36,3156,1569,1587,2578,1303,1275,578,266,312
228723,36,41754,22060,19694,37217,19504,17713,4537,2556,1981
228769,36,21601,8545,13056,12704,5601,7103,8897,2944,5953
228778,36,29833,12880,16953,27506,11680,15826,2327,1200,1127
228787,36,15604,8915,6689,12647,7122,5525,2957,1793,1164
228796,36,14865,6602,8263,9718,4216,5502,5147,2386,2761
228802,36,4494,1705,2789,2999,1152,1847,1495,553,942
228875,36,7629,2980,4649,7462,2897,4565,167,83,84
228884,36,407,227,180,358,203,155,49,24,25
228981,36,913,410,503,872,386,486,41,24,17
229018,36,2731,1077,1654,1941,739,1202,790,338,452
229027,36,20444,9895,10549,14954,6990,7964,5490,2905,2585
229063,36,3994,1409,2585,3182,1104,2078,812,305,507
229115,36,23281,12050,11231,20392,10481,9911,2889,1569,1320
229160,36,889,400,489,780,365,415,109,35,74
229179,36,6293,524,5769,4499,366,4133,1794,158,1636
229267,36,1814,851,963,1785,837,948,29,14,15
229300,36,512,70,442,434,62,372,78,8,70
229337,36,1164,159,1005,980,130,850,184,29,155
229355,36,5551,1818,3733,2282,823,1459,3269,995,2274
229416,36,875,837,38,875,837,38,,,
229425,36,79,2,77,22,0,22,57,2,55
229504,36,1516,497,1019,333,138,195,1183,359,824
229522,36,32,4,28,23,2,21,9,2,7
229540,36,1684,462,1222,398,160,238,1286,302,984
229656,36,280,11,269,125,4,121,155,7,148
229780,36,1637,748,889,900,402,498,737,346,391
229799,36,2672,849,1823,788,280,508,1884,569,1315
229814,36,4670,1912,2758,3406,1376,2030,1264,536,728
229832,36,299,167,132,164,85,79,135,82,53
229841,36,3038,1238,1800,1046,514,532,1992,724,1268
229887,36,393,180,213,355,173,182,38,7,31
230010,36,1029,663,366,390,196,194,639,467,172
230038,36,24855,12401,12454,22022,11005,11017,2833,1396,1437
230047,36,2198,896,1302,2071,850,1221,127,46,81
230065,36,49,3,46,20,2,18,29,1,28
230144,36,19,1,18,19,1,18,,,
230162,36,1645,1015,630,328,108,220,1317,907,410
230171,36,5615,2379,3236,4355,1839,2516,1260,540,720
230199,36,15,4,11,15,4,11,,,
230205,36,9,1,8,8,0,8,1,1,0
230214,36,304,43,261,101,9,92,203,34,169
230366,36,208,26,182,208,26,182,,,
230418,36,1305,699,606,484,296,188,821,403,418
230490,36,1510,868,642,208,64,144,1302,804,498
230597,36,1848,891,957,1477,736,741,371,155,216
230603,36,6342,2839,3503,5369,2367,3002,973,472,501
230676,36,153,98,55,42,23,19,111,75,36
230728,36,14754,6895,7859,11532,5474,6058,3222,1421,1801
230737,36,19829,10664,9165,12347,6661,5686,7482,4003,3479
230746,36,11799,5481,6318,3054,1443,1611,8745,4038,4707
230764,36,18400,9675,8725,14796,7776,7020,3604,1899,1705
230782,36,11510,5015,6495,7234,3213,4021,4276,1802,2474
230807,36,713,270,443,677,251,426,36,19,17
230816,36,502,181,321,480,160,320,22,21,1
230834,36,1056,467,589,895,407,488,161,60,101
230852,36,2174,1325,849,1501,926,575,673,399,274
230861,36,2205,535,1670,324,121,203,1881,414,1467
230889,36,79,25,54,59,20,39,20,5,15
230913,36,918,330,588,593,248,345,325,82,243
230959,36,2106,992,1114,2091,986,1105,15,6,9
230995,36,1919,1417,502,1586,1127,459,333,290,43
231004,36,49,1,48,49,1,48,,,
231059,36,918,428,490,908,420,488,10,8,2
231095,36,66,26,40,61,23,38,5,3,2
231165,36,681,321,360,304,196,108,377,125,252
231174,36,7994,3006,4988,7753,2885,4868,241,121,120
231280,36,82,1,81,60,1,59,22,0,22
231411,36,263,240,23,263,240,23,,,
231420,36,728,376,352,655,335,320,73,41,32
231536,36,1594,586,1008,489,198,291,1105,388,717
231554,36,407,203,204,365,189,176,42,14,28
231581,36,927,421,506,925,421,504,2,0,2
231624,36,4981,2033,2948,4916,1998,2918,65,35,30
231651,36,2673,1035,1638,1507,608,899,1166,427,739
231688,36,17,0,17,10,0,10,7,0,7
231697,36,1297,500,797,339,156,183,958,344,614
231712,36,3137,1417,1720,3041,1364,1677,96,53,43
231785,36,823,118,705,342,79,263,481,39,442
231873,36,276,99,177,122,59,63,154,40,114
231882,36,839,290,549,404,186,218,435,104,331
232016,36,92,30,62,56,24,32,36,6,30
232025,36,664,316,348,646,306,340,18,10,8
232043,36,589,240,349,557,220,337,32,20,12
232052,36,259,78,181,65,16,49,194,62,132
232089,36,498,291,207,476,279,197,22,12,10
232186,36,19667,10033,9634,15302,7701,7601,4365,2332,2033
232195,36,3412,1126,2286,1022,412,610,2390,714,1676
232256,36,529,526,3,521,518,3,8,8,0
232265,36,1831,643,1188,1708,550,1158,123,93,30
232308,36,461,0,461,460,0,460,1,0,1
232414,36,3552,1274,2278,989,417,572,2563,857,1706
232423,36,14344,6073,8271,13421,5619,7802,923,454,469
232450,36,3503,1406,2097,961,431,530,2542,975,1567
232557,36,36865,15945,20920,23139,9702,13437,13726,6243,7483
232566,36,2077,643,1434,1957,601,1356,120,42,78
232575,36,1973,649,1324,585,249,336,1388,400,988
232609,36,1056,398,658,1027,388,639,29,10,19
232618,36,151,19,132,19,1,18,132,18,114
232672,36,928,184,744,750,160,590,178,24,154
232681,36,2419,898,1521,2028,753,1275,391,145,246
232706,36,1232,446,786,1124,402,722,108,44,64
232724,36,23,1,22,23,1,22,,,
232788,36,786,241,545,391,141,250,395,100,295
232797,36,686,85,601,211,36,175,475,49,426
232867,36,1165,552,613,499,281,218,666,271,395
232885,36,214,11,203,194,8,186,20,3,17
232919,36,297,260,37,214,186,28,83,74,9
232937,36,3683,1161,2522,3159,1001,2158,524,160,364
232946,36,22063,10452,11611,7168,3586,3582,14895,6866,8029
232982,36,13276,5909,7367,9619,4287,5332,3657,1622,2035
233019,36,844,319,525,426,193,233,418,126,292
233037,36,374,104,270,114,44,70,260,60,200
233082,36,65,7,58,8,1,7,57,6,51
233116,36,2004,760,1244,442,211,231,1562,549,1013
233277,36,4159,1543,2616,3801,1412,2389,358,131,227
233286,36,100,17,83,83,16,67,17,1,16
233295,36,1017,457,560,984,437,547,33,20,13
233301,36,286,107,179,282,103,179,4,4,0
233310,36,851,212,639,186,73,113,665,139,526
233329,36,313,23,290,313,23,290,,,
233338,36,295,136,159,218,104,114,77,32,45
233356,36,345,27,318,264,19,245,81,8,73
233374,36,2126,993,1133,2043,957,1086,83,36,47
233408,36,327,39,288,260,36,224,67,3,64
233426,36,1243,590,653,1189,562,627,54,28,26
233480,36,14,3,11,14,3,11,,,
233541,36,1495,579,916,1437,560,877,58,19,39
233602,36,49,28,21,40,22,18,9,6,3
233611,36,654,344,310,616,322,294,38,22,16
233639,36,1151,293,858,298,59,239,853,234,619
233648,36,975,312,663,507,192,315,468,120,348
233666,36,2,0,2,1,0,1,1,0,1
233684,36,1874,630,1244,308,198,110,1566,432,1134
233718,36,282,0,282,281,0,281,1,0,1
233754,36,2863,1104,1759,956,434,522,1907,670,1237
233772,36,8220,3121,5099,2785,1112,1673,5435,2009,3426
233897,36,652,317,335,627,301,326,25,16,9
233903,36,901,311,590,347,159,188,554,152,402
233921,36,22176,12743,9433,21373,12207,9166,803,536,267
233949,36,2342,879,1463,794,329,465,1548,550,998
234030,36,14900,5448,9452,12836,4579,8257,2064,869,1195
234076,36,12329,5403,6926,11803,5159,6644,526,244,282
234085,36,1151,1000,151,1151,1000,151,,,
234119,36,112,44,68,81,29,52,31,15,16
234137,36,112,57,55,90,40,50,22,17,5
234155,36,2606,1047,1559,2436,976,1460,170,71,99
234164,36,808,401,407,675,335,340,133,66,67
234173,36,792,312,480,724,287,437,68,25,43
234207,36,1384,686,698,1379,683,696,5,3,2
234377,36,726,190,536,271,97,174,455,93,362
234669,36,5504,2487,3017,3044,1408,1636,2460,1079,1381
234696,36,971,476,495,669,365,304,302,111,191
234711,36,1102,446,656,773,317,456,329,129,200
234827,36,6289,3004,3285,5410,2582,2828,879,422,457
234845,36,1050,399,651,725,265,460,325,134,191
234915,36,838,352,486,111,46,65,727,306,421
234924,36,207,25,182,207,25,182,,,
234933,36,3603,1326,2277,2067,783,1284,1536,543,993
234951,36,1734,600,1134,1083,472,611,651,128,523
234979,36,3402,1301,2101,2040,822,1218,1362,479,883
235024,36,252,85,167,246,82,164,6,3,3
235088,36,116,108,8,116,108,8,,,
235097,36,4889,2159,2730,4292,1854,2438,597,305,292
235103,36,2596,1220,1376,1276,656,620,1320,564,756
235149,36,3792,1517,2275,1867,784,1083,1925,733,1192
235167,36,1213,464,749,1091,416,675,122,48,74
235237,36,4364,1567,2797,2809,997,1812,1555,570,985
235307,36,85,5,80,85,5,80,,,
235316,36,3636,1669,1967,3577,1634,1943,59,35,24
235334,36,818,333,485,520,217,303,298,116,182
235343,36,4079,1945,2134,2527,1254,1273,1552,691,861
235352,36,71,10,61,71,10,61,,,
235422,36,527,135,392,480,122,358,47,13,34
235431,36,3089,1136,1953,1741,639,1102,1348,497,851
235501,36,20,14,6,20,14,6,,,
235547,36,30,6,24,24,5,19,6,1,5
235583,36,23,0,23,23,0,23,,,
235671,36,1410,973,437,1158,872,286,252,101,151
235699,36,1551,660,891,946,469,477,605,191,414
235750,36,1406,390,1016,797,249,548,609,141,468
236018,36,39,4,35,39,4,35,,,
236072,36,1629,595,1034,613,275,338,1016,320,696
236133,36,440,141,299,429,137,292,11,4,7
236188,36,2760,1053,1707,1710,627,1083,1050,426,624
236212,36,597,516,81,597,516,81,,,
236230,36,1596,567,1029,1529,537,992,67,30,37
236258,36,787,270,517,436,146,290,351,124,227
236328,36,1267,539,728,1230,525,705,37,14,23
236382,36,1012,541,471,516,249,267,496,292,204
236452,36,887,324,563,817,295,522,70,29,41
236504,36,979,515,464,557,315,242,422,200,222
236513,36,2178,905,1273,1420,572,848,758,333,425
236577,36,1711,558,1153,1650,531,1119,61,27,34
236595,36,2727,1060,1667,2593,1002,1591,134,58,76
236610,36,2540,988,1552,1199,543,656,1341,445,896
236638,36,1789,651,1138,1080,416,664,709,235,474
236656,36,2523,945,1578,1494,608,886,1029,337,692
236692,36,2997,1123,1874,2053,808,1245,944,315,629
236708,36,2224,854,1370,1521,603,918,703,251,452
236744,36,21,1,20,21,1,20,,,
236753,36,3302,1135,2167,2027,744,1283,1275,391,884
236887,36,1571,809,762,920,433,487,651,376,275
236896,36,877,435,442,819,410,409,58,25,33
236939,36,16264,7637,8627,14163,6721,7442,2101,916,1185
236948,36,22125,9681,12444,20406,8840,11566,1719,841,878
236975,36,1586,527,1059,1166,402,764,420,125,295
237011,36,9511,4091,5420,8146,3363,4783,1365,728,637
237039,36,2050,907,1143,1094,501,593,956,406,550
237057,36,1115,487,628,1092,474,618,23,13,10
237066,36,1518,637,881,1475,614,861,43,23,20
237109,36,2391,642,1749,1488,432,1056,903,210,693
237118,36,385,210,175,368,207,161,17,3,14
237127,36,20,0,20,20,0,20,,,
237136,36,132,76,56,115,62,53,17,14,3
237145,36,5,0,5,5,0,5,,,
237172,36,30,15,15,22,10,12,8,5,3
237181,36,399,222,177,398,222,176,1,0,1
237215,36,844,316,528,593,230,363,251,86,165
237242,36,18,18,0,16,16,0,2,2,0
237303,36,24,11,13,24,11,13,,,
237312,36,1790,1111,679,1007,513,494,783,598,185
237321,36,51,4,47,51,4,47,,,
237330,36,824,332,492,768,308,460,56,24,32
237358,36,422,170,252,415,170,245,7,0,7
237367,36,1887,783,1104,1532,677,855,355,106,249
237385,36,835,483,352,592,308,284,243,175,68
237437,36,114,15,99,100,15,85,14,0,14
237473,36,56,35,21,56,35,21,,,
237491,36,8,1,7,8,1,7,,,
237525,36,4970,2095,2875,4419,1862,2557,551,233,318
237543,36,74,18,56,48,10,38,26,8,18
237561,36,25,8,17,25,8,17,,,
237570,36,58,1,57,58,1,57,,,
237598,36,18,2,16,18,2,16,,,
237686,36,1038,343,695,610,211,399,428,132,296
237701,36,514,217,297,458,196,262,56,21,35
237729,36,95,29,66,72,13,59,23,16,7
237783,36,433,194,239,411,184,227,22,10,12
237792,36,1527,573,954,1350,489,861,177,84,93
237817,36,718,204,514,425,125,300,293,79,214
237844,36,1,1,0,1,1,0,,,
237899,36,870,395,475,751,344,407,119,51,68
237905,36,55,12,43,55,12,43,,,
237932,36,1102,399,703,1038,381,657,64,18,46
237950,36,681,408,273,624,373,251,57,35,22
237969,36,600,288,312,591,281,310,9,7,2
237987,36,153,21,132,153,21,132,,,
237996,36,309,49,260,309,49,260,,,
238005,36,41,3,38,41,3,38,,,
238014,36,514,158,356,250,97,153,264,61,203
238032,36,13135,6352,6783,12363,5963,6400,772,389,383
238078,36,379,222,157,313,198,115,66,24,42
238096,36,30,2,28,30,2,28,,,
238175,36,53,1,52,53,1,52,,,
238193,36,507,8,499,407,3,404,100,5,95
238263,36,6420,2568,3852,2008,961,1047,4412,1607,2805
238324,36,227,16,211,162,9,153,65,7,58
238333,36,672,310,362,672,310,362,,,
238397,36,1527,498,1029,383,137,246,1144,361,783
238430,36,391,135,256,290,104,186,101,31,70
238458,36,1920,591,1329,1828,552,1276,92,39,53
238476,36,1742,759,983,1684,738,946,58,21,37
238616,36,1943,701,1242,1446,560,886,497,141,356
238661,36,790,245,545,709,224,485,81,21,60
238722,36,3370,1995,1375,956,535,421,2414,1460,954
238759,36,3224,1240,1984,651,300,351,2573,940,1633
238810,36,57,4,53,38,3,35,19,1,18
238980,36,935,388,547,470,228,242,465,160,305
239008,36,1210,553,657,229,121,108,981,432,549
239017,36,1030,471,559,1013,462,551,17,9,8
239071,36,385,168,217,310,135,175,75,33,42
239080,36,737,248,489,646,222,424,91,26,65
239105,36,5173,2232,2941,5057,2174,2883,116,58,58
239220,36,1404,615,789,344,178,166,1060,437,623
239248,36,7788,3067,4721,1721,772,949,6067,2295,3772
239309,36,641,154,487,628,149,479,13,5,8
239318,36,1772,1265,507,1730,1231,499,42,34,8
239372,36,1583,588,995,434,200,234,1149,388,761
239390,36,445,0,445,421,0,421,24,0,24
239442,36,483,145,338,104,39,65,379,106,273
239460,36,1167,440,727,377,181,196,790,259,531
239488,36,5340,2032,3308,1281,599,682,4059,1433,2626
239512,36,339,160,179,333,160,173,6,0,6
239628,36,546,282,264,546,282,264,,,
239716,36,1273,547,726,1263,540,723,10,7,3
239877,36,21,1,20,16,1,15,5,0,5
239910,36,525,185,340,275,103,172,250,82,168
240107,36,1066,234,832,869,205,664,197,29,168
240116,36,2755,944,1811,1122,474,648,1633,470,1163
240125,36,3283,1885,1398,1122,603,519,2161,1282,879
240170,36,2314,958,1356,808,395,413,1506,563,943
240189,36,6323,3210,3113,5589,2865,2724,734,345,389
240198,36,1359,454,905,444,186,258,915,268,647
240268,36,6667,2642,4025,6083,2423,3660,584,219,365
240277,36,4608,1679,2929,3324,1257,2067,1284,422,862
240329,36,6478,2778,3700,6093,2551,3542,385,227,158
240338,36,656,264,392,630,252,378,26,12,14
240365,36,5693,2388,3305,4716,1901,2815,977,487,490
240374,36,2203,971,1232,1722,762,960,481,209,272
240392,36,1422,221,1201,567,91,476,855,130,725
240417,36,4525,2624,1901,3593,2108,1485,932,516,416
240426,36,1471,513,958,1108,417,691,363,96,267
240444,36,25402,11994,13408,23856,11129,12727,1546,865,681
240453,36,12651,5800,6851,10591,4772,5819,2060,1028,1032
240462,36,4243,2697,1546,3704,2317,1387,539,380,159
240471,36,3098,1076,2022,2766,943,1823,332,133,199
240480,36,4882,2124,2758,4275,1897,2378,607,227,380
240505,36,1475,520,955,831,332,499,644,188,456
240514,36,644,261,383,293,107,186,351,154,197
240596,36,265,88,177,168,65,103,97,23,74
240620,36,1560,499,1061,753,267,486,807,232,575
240657,36,500,187,313,299,128,171,201,59,142
240666,36,989,376,613,551,235,316,438,141,297
240693,36,836,322,514,462,205,257,374,117,257
240709,36,8,0,8,6,0,6,2,0,2
240718,36,605,574,31,605,574,31,,,
240727,36,5946,2852,3094,4888,2406,2482,1058,446,612
240736,36,644,189,455,307,85,222,337,104,233
240745,36,695,285,410,252,96,156,443,189,254
240754,36,2090,875,1215,1522,622,900,568,253,315
240790,36,893,322,571,628,232,396,265,90,175
240879,36,2,1,1,2,1,1,,,
241100,36,149,82,67,124,68,56,25,14,11
241128,36,164,77,87,131,60,71,33,17,16
241146,36,68,34,34,64,33,31,4,1,3
241182,36,316,62,254,316,62,254,,,
241191,36,651,259,392,559,216,343,92,43,49
241216,36,1210,773,437,576,361,215,634,412,222
241225,36,495,153,342,327,104,223,168,49,119
241304,36,977,279,698,444,132,312,533,147,386
241331,36,394,46,348,334,41,293,60,5,55
241377,36,430,179,251,338,145,193,92,34,58
241386,36,112,24,88,85,20,65,27,4,23
241395,36,225,65,160,178,52,126,47,13,34
241410,36,3174,1123,2051,2653,908,1745,521,215,306
241517,36,137,39,98,89,25,64,48,14,34
241614,36,232,134,98,128,82,46,104,52,52
241720,36,459,170,289,309,97,212,150,73,77
241739,36,3811,1189,2622,2342,724,1618,1469,465,1004
241766,36,215,146,69,160,108,52,55,38,17
241836,36,683,209,474,265,98,167,418,111,307
241906,36,147,45,102,147,45,102,,,
241951,36,372,105,267,249,65,184,123,40,83
242042,36,123,70,53,116,65,51,7,5,2
242112,36,186,82,104,144,71,73,42,11,31
242121,36,176,59,117,91,28,63,85,31,54
242130,36,191,55,136,136,36,100,55,19,36
242149,36,215,48,167,149,36,113,66,12,54
242556,36,118,80,38,111,75,36,7,5,2
242583,36,112,82,30,77,56,21,35,26,9
242617,36,1972,893,1079,1649,752,897,323,141,182
242626,36,2165,898,1267,1698,690,1008,467,208,259
242635,36,1871,672,1199,1499,558,941,372,114,258
242644,36,725,221,504,536,168,368,189,53,136
242653,36,2432,1062,1370,1718,739,979,714,323,391
242662,36,2102,757,1345,1526,562,964,576,195,381
242680,36,886,327,559,700,258,442,186,69,117
242699,36,1057,315,742,823,246,577,234,69,165
242705,36,2763,1567,1196,2178,1217,961,585,350,235
242820,36,443,342,101,443,342,101,,,
242945,36,3,1,2,2,1,1,1,0,1
242954,36,3,1,2,2,1,1,1,0,1
242972,36,15044,5080,9964,9871,3232,6639,5173,1848,3325
243106,36,1427,609,818,1238,527,711,189,82,107
243115,36,2124,782,1342,1934,701,1233,190,81,109
243133,36,2308,1136,1172,1867,919,948,441,217,224
243142,36,1361,495,866,943,325,618,418,170,248
243151,36,1692,530,1162,1466,451,1015,226,79,147
243179,36,1953,649,1304,1729,567,1162,224,82,142
243188,36,254,126,128,215,105,110,39,21,18
243197,36,8201,4548,3653,7156,3907,3249,1045,641,404
243203,36,167,22,145,148,19,129,19,3,16
243212,36,1466,649,817,1356,605,751,110,44,66
243221,36,7209,2574,4635,6157,2142,4015,1052,432,620
243346,36,3484,1316,2168,2125,805,1320,1359,511,848
243443,36,2501,901,1600,1960,693,1267,541,208,333
243568,36,102,12,90,76,6,70,26,6,20
243577,36,2904,2094,810,1003,692,311,1901,1402,499
243586,36,498,167,331,408,137,271,90,30,60
243601,36,5984,2435,3549,3975,1534,2441,2009,901,1108
243638,36,1479,594,885,904,345,559,575,249,326
243647,36,329,145,184,184,91,93,145,54,91
243665,36,1008,269,739,630,184,446,378,85,293
243744,36,5982,2924,3058,5982,2924,3058,,,
243780,36,27949,16332,11617,26242,15333,10909,1707,999,708
243799,36,19,1,18,19,1,18,,,
243823,36,280,76,204,208,59,149,72,17,55
243832,36,927,259,668,423,109,314,504,150,354
243841,36,257,45,212,172,33,139,85,12,73
244279,36,100,1,99,100,1,99,,,
244437,36,8663,3073,5590,2665,1083,1582,5998,1990,4008
244446,36,1212,436,776,313,132,181,899,304,595
244613,36,132,125,7,62,58,4,70,67,3
245281,36,74,38,36,74,38,36,,,
245625,36,571,191,380,188,71,117,383,120,263
245652,36,265,137,128,256,136,120,9,1,8
245777,36,32,32,0,30,30,0,2,2,0
245838,36,65,25,40,21,7,14,44,18,26
245847,36,42,13,29,13,3,10,29,10,19
245883,36,58,11,47,7,2,5,51,9,42
245892,36,81,18,63,36,6,30,45,12,33
245953,36,923,302,621,490,174,316,433,128,305
245962,36,121,8,113,120,8,112,1,0,1
245980,36,17,2,15,17,2,15,,,
245999,36,561,290,271,209,78,131,352,212,140
246017,36,447,260,187,49,19,30,398,241,157
246035,36,228,33,195,228,33,195,,,
246071,36,40,7,33,40,7,33,,,
246354,36,5104,1895,3209,574,209,365,4530,1686,2844
246406,36,9,1,8,9,1,8,,,
246415,36,53,3,50,17,2,15,36,1,35
246460,36,74,8,66,74,8,66,,,
246813,36,2071,618,1453,394,144,250,1677,474,1203
246895,36,311,122,189,165,58,107,146,64,82
246974,36,279,30,249,279,30,249,,,
247010,36,27,0,27,27,0,27,,,
247047,36,24,0,24,24,0,24,,,
247065,36,538,41,497,274,14,260,264,27,237
247153,36,164,38,126,164,38,126,,,
247162,36,9,1,8,,,,9,1,8
247409,36,28,0,28,28,0,28,,,
247603,36,1153,590,563,655,333,322,498,257,241
247649,36,274,178,96,223,146,77,51,32,19
247773,36,45,45,0,45,45,0,,,
247834,36,17701,8101,9600,6612,3426,3186,11089,4675,6414
247940,36,1651,669,982,660,310,350,991,359,632
248192,36,4,0,4,4,0,4,,,
248527,36,68,0,68,68,0,68,,,
248606,36,46,17,29,35,10,25,11,7,4
248624,36,61,13,48,61,13,48,,,
248633,36,45,2,43,45,2,43,,,
248660,36,124,30,94,109,30,79,15,0,15
248703,36,96,2,94,48,1,47,48,1,47
248925,36,571,320,251,450,246,204,121,74,47
248934,36,8941,3538,5403,8941,3538,5403,,,
249061,36,42,0,42,20,0,20,22,0,22
249238,36,311,15,296,194,7,187,117,8,109
249609,36,108,69,39,108,69,39,,,
250027,36,137,47,90,137,47,90,,,
250285,36,242,216,26,115,104,11,127,112,15
250744,36,287,31,256,287,31,256,,,
250902,36,11,0,11,5,0,5,6,0,6
250993,36,511,288,223,17,5,12,494,283,211
251260,36,2143,877,1266,1038,518,520,1105,359,746
251312,36,307,47,260,234,36,198,73,11,62
260336,36,17,4,13,17,4,13,,,
260363,36,3,0,3,3,0,3,,,
260372,36,215,48,167,85,17,68,130,31,99
260664,36,75,43,32,75,43,32,,,
260691,36,601,171,430,601,171,430,,,
260789,36,525,106,419,525,106,419,,,
260813,36,204,22,182,204,22,182,,,
260929,36,159,12,147,158,12,146,1,0,1
260965,36,53,0,53,53,0,53,,,
260992,36,325,19,306,79,8,71,246,11,235
261436,36,479,33,446,479,33,446,,,
261676,36,8,1,7,8,1,7,,,
261685,36,23,1,22,23,1,22,,,
261719,36,126,0,126,126,0,126,,,
261773,36,23,1,22,22,0,22,1,1,0
261861,36,7,0,7,7,0,7,,,
262031,36,3431,1348,2083,1645,701,944,1786,647,1139
262086,36,3373,1154,2219,710,316,394,2663,838,1825
262129,36,420,144,276,412,138,274,8,6,2
262341,36,117,100,17,117,100,17,,,
262369,36,16,0,16,16,0,16,,,
262457,36,312,46,266,312,46,266,,,
262466,36,30,16,14,30,16,14,,,
362700,36,404,37,367,394,36,358,10,1,9
362782,36,198,5,193,58,2,56,140,3,137
363013,36,15,0,15,15,0,15,,,
363147,36,352,1,351,352,1,351,,,
363165,36,725,407,318,288,160,128,437,247,190
363633,36,309,107,202,134,45,89,175,62,113
363679,36,117,1,116,107,1,106,10,0,10
363712,36,6,6,0,6,6,0,,,
363882,36,69,1,68,69,1,68,,,
363907,36,324,207,117,223,134,89,101,73,28
363916,36,101,26,75,74,17,57,27,9,18
363934,36,579,461,118,283,226,57,296,235,61
364016,36,2587,1128,1459,713,378,335,1874,750,1124
364025,36,4560,2203,2357,1645,881,764,2915,1322,1593
364548,36,57,24,33,44,15,29,13,9,4
364575,36,18,0,18,18,0,18,,,
364627,36,54,29,25,27,8,19,27,21,6
364636,36,90,15,75,74,15,59,16,0,16
364760,36,20,3,17,10,2,8,10,1,9
364946,36,96,20,76,69,12,57,27,8,19
364964,36,15,2,13,15,2,13,,,
365091,36,316,14,302,316,14,302,,,
365125,36,162,5,157,162,5,157,,,
365198,36,118,45,73,36,2,34,82,43,39
365213,36,254,126,128,93,25,68,161,101,60
365240,36,15,10,5,15,10,5,,,
365374,36,553,316,237,168,70,98,385,246,139
365383,36,42,5,37,42,5,37,,,
365480,36,158,64,94,81,12,69,77,52,25
365505,36,2,0,2,2,0,2,,,
365693,36,122,0,122,122,0,122,,,
365763,36,8,3,5,8,3,5,,,
365824,36,43,4,39,43,4,39,,,
365833,36,55,3,52,55,3,52,,,
366003,36,214,91,123,74,25,49,140,66,74
366155,36,28,10,18,28,10,18,,,
366191,36,683,665,18,683,665,18,,,
366252,36,2775,1734,1041,2148,1513,635,627,221,406
366261,36,175,55,120,170,54,116,5,1,4
366270,36,198,6,192,198,6,192,,,
366289,36,25,19,6,25,19,6,,,
366340,36,196,58,138,142,45,97,54,13,41
366395,36,9691,4239,5452,5352,2533,2819,4339,1706,2633
366401,36,4039,1900,2139,1266,651,615,2773,1249,1524
366438,36,11,0,11,5,0,5,6,0,6
366465,36,1036,308,728,431,128,303,605,180,425
366535,36,152,20,132,152,20,132,,,
366553,36,349,134,215,346,134,212,3,0,3
366571,36,22,3,19,22,3,19,,,
366623,36,17,5,12,11,1,10,6,4,2
366632,36,1,0,1,1,0,1,,,
366711,36,9780,3844,5936,7509,2906,4603,2271,938,1333
367051,36,39,1,38,26,1,25,13,0,13
367088,36,78,2,76,42,2,40,36,0,36
367103,36,70,52,18,70,52,18,,,
367112,36,121,16,105,108,14,94,13,2,11
367158,36,27,1,26,27,1,26,,,
367334,36,41,34,7,33,27,6,8,7,1
367361,36,64,41,23,60,39,21,4,2,2
367431,36,17,1,16,17,1,16,,,
367459,36,3050,1197,1853,846,384,462,2204,813,1391
367875,36,384,142,242,191,70,121,193,72,121
367884,36,263,98,165,157,50,107,106,48,58
367972,36,106,3,103,106,3,103,,,
367981,36,54,0,54,30,0,30,24,0,24
368230,36,47,2,45,28,0,28,19,2,17
368364,36,166,90,76,70,36,34,96,54,42
368407,36,26,1,25,,,,26,1,25
368443,36,153,34,119,153,34,119,,,
368452,36,207,80,127,207,80,127,,,
368629,36,356,74,282,356,74,282,,,
368647,36,9,1,8,9,1,8,,,
368771,36,231,50,181,231,50,181,,,
368832,36,38,6,32,9,2,7,29,4,25
368911,36,714,123,591,162,35,127,552,88,464
369400,36,474,452,22,474,452,22,,,
369419,36,121,81,40,121,81,40,,,
369446,36,11,3,8,5,3,2,6,0,6
369455,36,100,23,77,100,23,77,,,
369516,36,74,15,59,74,15,59,,,
369668,36,21,6,15,6,6,0,15,0,15
369686,36,40,11,29,40,11,29,,,
369783,36,210,14,196,210,14,196,,,
369950,36,68,61,7,68,61,7,,,
371052,36,175,26,149,175,26,149,,,
371690,36,623,125,498,93,10,83,530,115,415
371830,36,95,82,13,93,82,11,2,0,2
371928,36,98,33,65,98,33,65,,,
371964,36,299,212,87,299,212,87,,,
372028,36,108,18,90,108,18,90,,,
372073,36,42,15,27,42,15,27,,,
372082,36,39,14,25,39,14,25,,,
372240,36,20,0,20,20,0,20,,,
372329,36,192,26,166,192,26,166,,,
372356,36,67,0,67,67,0,67,,,
372462,36,101,14,87,99,14,85,2,0,2
372921,36,308,101,207,308,101,207,,,
373085,36,19,0,19,15,0,15,4,0,4
373216,36,63,14,49,63,14,49,,,
373456,36,9,1,8,6,1,5,3,0,3
373526,36,121,86,35,121,86,35,,,
373678,36,50,18,32,35,16,19,15,2,13
373696,36,23,9,14,15,5,10,8,4,4
373711,36,46,5,41,46,5,41,,,
373784,36,317,172,145,317,172,145,,,
374316,36,56,43,13,36,33,3,20,10,10
374343,36,29,1,28,29,1,28,,,
374574,36,510,83,427,307,60,247,203,23,180
374592,36,2,0,2,2,0,2,,,
375106,36,18,13,5,16,12,4,2,1,1
375230,36,122,122,0,122,122,0,,,
375373,36,95,38,57,4,0,4,91,38,53
375407,36,61,16,45,55,13,42,6,3,3
375416,36,125,27,98,125,27,98,,,
375540,36,4,0,4,2,0,2,2,0,2
375568,36,3,3,0,2,2,0,1,1,0
375656,36,10,2,8,8,1,7,2,1,1
375683,36,109,82,27,70,51,19,39,31,8
375726,36,364,168,196,297,122,175,67,46,21
375939,36,106,21,85,106,21,85,,,
375966,36,114,11,103,64,6,58,50,5,45
375984,36,88,5,83,67,4,63,21,1,20
376224,36,99,12,87,73,9,64,26,3,23
376242,36,31,26,5,31,26,5,,,
376288,36,46,17,29,46,17,29,,,
376330,36,171,38,133,171,38,133,,,
376385,36,34,12,22,32,12,20,2,0,2
376446,36,67,1,66,14,1,13,53,0,53
376631,36,14,6,8,13,6,7,1,0,1
376677,36,126,47,79,124,45,79,2,2,0
376695,36,970,411,559,334,141,193,636,270,366
377111,36,91,31,60,91,31,60,,,
377193,36,22,1,21,5,0,5,17,1,16
377218,36,98,94,4,98,94,4,,,
377272,36,4,1,3,4,1,3,,,
377281,36,8,1,7,8,1,7,,,
377315,36,51,0,51,51,0,51,,,
377449,36,178,80,98,137,68,69,41,12,29
377458,36,185,74,111,124,61,63,61,13,48
377485,36,16,1,15,6,0,6,10,1,9
377546,36,59,19,40,57,18,39,2,1,1
377555,36,3677,2018,1659,3073,1672,1401,604,346,258
377564,36,2784,1448,1336,2419,1252,1167,365,196,169
377643,36,99,7,92,99,7,92,,,
377652,36,85,3,82,85,3,82,,,
377661,36,417,67,350,417,67,350,,,
377722,36,374,18,356,374,18,356,,,
377759,36,71,68,3,71,68,3,,,
378105,36,287,7,280,195,5,190,92,2,90
378576,36,180,32,148,26,10,16,154,22,132
378886,36,139,31,108,50,8,42,89,23,66
378956,36,465,431,34,465,431,34,,,
379621,36,65,5,60,49,5,44,16,0,16
379746,36,222,14,208,222,14,208,,,
379782,36,180,16,164,180,16,164,,,
380067,36,127,1,126,127,1,126,,,
380359,36,359,57,302,132,28,104,227,29,198
380368,36,283,88,195,143,49,94,140,39,101
380377,36,529,114,415,379,85,294,150,29,121
380438,36,591,78,513,591,78,513,,,
381255,36,61,47,14,61,47,14,,,
381282,36,65,22,43,65,22,43,,,
381325,36,96,33,63,96,33,63,,,
381370,36,89,7,82,40,4,36,49,3,46
381404,36,206,5,201,64,1,63,142,4,138
381486,36,12,0,12,12,0,12,,,
381699,36,11,0,11,7,0,7,4,0,4
381732,36,36,6,30,6,1,5,30,5,25
382258,36,82,10,72,38,2,36,44,8,36
382416,36,67,11,56,67,11,56,,,
382461,36,37,1,36,24,1,23,13,0,13
382780,36,97,6,91,85,4,81,12,2,10
382911,36,37,17,20,24,12,12,13,5,8
382957,36,236,53,183,225,51,174,11,2,9
383020,36,4,2,2,2,1,1,2,1,1
383084,36,44,13,31,36,10,26,8,3,5
383163,36,100,2,98,28,0,28,72,2,70
383190,36,901,367,534,362,191,171,539,176,363
383279,36,166,22,144,53,9,44,113,13,100
383297,36,164,8,156,31,0,31,133,8,125
383312,36,7,0,7,7,0,7,,,
383330,36,71,11,60,71,11,60,,,
383367,36,37,4,33,35,4,31,2,0,2
383464,36,76,5,71,76,5,71,,,
383765,36,44,0,44,24,0,24,20,0,20
383996,36,245,69,176,67,15,52,178,54,124
384236,36,809,288,521,809,288,521,,,
384245,36,584,204,380,584,204,380,,,
384254,36,329,217,112,317,209,108,12,8,4
384333,36,3888,1475,2413,1098,459,639,2790,1016,1774
384342,36,2036,847,1189,848,394,454,1188,453,735
384412,36,109,60,49,109,60,49,,,
384421,36,62,62,0,62,62,0,,,
385132,36,87,4,83,58,3,55,29,1,28
385503,36,144,9,135,144,9,135,,,
385619,36,1444,739,705,1444,739,705,,,
386153,36,44,0,44,38,0,38,6,0,6
386472,36,583,106,477,338,66,272,245,40,205
387925,36,80,6,74,80,6,74,,,
388520,36,105,54,51,33,21,12,72,33,39
389860,36,172,70,102,129,38,91,43,32,11
390905,36,86,47,39,21,15,6,65,32,33
391005,36,107,3,104,107,3,104,,,
391759,36,13,0,13,,,,13,0,13
392257,36,2458,198,2260,2458,198,2260,,,
392354,36,10,2,8,10,2,8,,,
392415,36,135,39,96,135,39,96,,,
393649,36,887,348,539,887,348,539,,,
393861,36,319,56,263,290,53,237,29,3,26
395362,36,769,236,533,236,73,163,533,163,370
395690,36,81,33,48,81,33,48,,,
397942,36,935,255,680,935,255,680,,,
399212,36,7070,4868,2202,1193,588,605,5877,4280,1597
399869,36,380,360,20,380,360,20,,,
399911,36,316,108,208,316,108,208,,,
400080,36,210,108,102,210,108,102,,,
400187,36,397,53,344,225,34,191,172,19,153
400558,36,57,18,39,57,18,39,,,
401223,36,139,35,104,72,20,52,67,15,52
401764,36,203,5,198,60,0,60,143,5,138
402563,36,186,11,175,186,11,175,,,
402800,36,126,4,122,116,3,113,10,1,9
403469,36,162,48,114,89,27,62,73,21,52
403478,36,136,45,91,87,31,56,49,14,35
403487,36,258,89,169,182,72,110,76,17,59
404055,36,173,23,150,173,23,150,,,
404338,36,6,1,5,6,1,5,,,
404426,36,1601,692,909,398,203,195,1203,489,714
404684,36,197,57,140,197,57,140,,,
404718,36,76,1,75,76,1,75,,,
404912,36,594,123,471,594,123,471,,,
405012,36,34,0,34,34,0,34,,,
405058,36,108,108,0,108,108,0,,,
405076,36,327,48,279,327,48,279,,,
405854,36,218,218,0,218,218,0,,,
405872,36,1254,497,757,367,181,186,887,316,571
406024,36,1144,137,1007,715,86,629,429,51,378
406033,36,1602,216,1386,970,126,844,632,90,542
406149,36,53,9,44,53,9,44,,,
406325,36,92,5,87,26,2,24,66,3,63
406361,36,8,1,7,8,1,7,,,
406422,36,46,3,43,12,0,12,34,3,31
406486,36,23,15,8,10,7,3,13,8,5
406547,36,27,3,24,15,3,12,12,0,12
407090,36,432,5,427,133,2,131,299,3,296
407142,36,87,1,86,87,1,86,,,
407151,36,51,0,51,51,0,51,,,
407179,36,37,1,36,26,0,26,11,1,10
407355,36,152,19,133,152,19,133,,,
407434,36,22,1,21,22,1,21,,,
407461,36,27,16,11,27,16,11,,,
407470,36,91,3,88,61,2,59,30,1,29
407489,36,55,40,15,6,0,6,49,40,9
407513,36,52,14,38,33,3,30,19,11,8
407522,36,1,1,0,,,,1,1,0
407568,36,109,6,103,90,2,88,19,4,15
407577,36,30,13,17,20,5,15,10,8,2
407595,36,3,0,3,3,0,3,,,
407610,36,30,23,7,1,1,0,29,22,7
407683,36,11,1,10,8,1,7,3,0,3
407708,36,120,2,118,120,2,118,,,
407735,36,36,0,36,36,0,36,,,
407832,36,108,62,46,34,17,17,74,45,29
408066,36,173,39,134,116,28,88,57,11,46
408163,36,37,2,35,37,2,35,,,
408385,36,497,197,300,497,197,300,,,
408729,36,13,1,12,12,0,12,1,1,0
408844,36,1903,528,1375,1130,350,780,773,178,595
408862,36,223,3,220,105,2,103,118,1,117
409032,36,3,0,3,3,0,3,,,
409120,36,38,10,28,38,10,28,,,
409193,36,116,112,4,116,112,4,,,
409315,36,13342,5379,7963,4074,1728,2346,9268,3651,5617
409537,36,12,4,8,,,,12,4,8
409591,36,38,5,33,23,2,21,15,3,12
409698,36,4336,1650,2686,3709,1353,2356,627,297,330
410797,36,59,30,29,59,30,29,,,
410964,36,31,0,31,28,0,28,3,0,3
411684,36,141,42,99,141,42,99,,,
411754,36,37,8,29,37,8,29,,,
412173,36,420,41,379,380,38,342,40,3,37
412535,36,27,2,25,25,2,23,2,0,2
412544,36,135,5,130,80,4,76,55,1,54
412599,36,186,42,144,186,42,144,,,
413176,36,17,7,10,17,7,10,,,
413413,36,8369,1544,6825,1960,314,1646,6409,1230,5179
413617,36,178,41,137,53,15,38,125,26,99
413626,36,72,17,55,40,9,31,32,8,24
413680,36,258,246,12,258,246,12,,,
413820,36,21,0,21,21,0,21,,,
413893,36,1070,363,707,1070,363,707,,,
413972,36,16,1,15,16,1,15,,,
414063,36,73,0,73,68,0,68,5,0,5
414124,36,189,145,44,129,102,27,60,43,17
414461,36,1180,1118,62,1060,1003,57,120,115,5
414489,36,14,0,14,14,0,14,,,
414540,36,70,4,66,54,3,51,16,1,15
414595,36,148,28,120,16,6,10,132,22,110
414869,36,313,4,309,95,3,92,218,1,217
414878,36,242,95,147,150,58,92,92,37,55
414911,36,537,204,333,331,141,190,206,63,143
414939,36,217,24,193,217,24,193,,,
415039,36,23,1,22,15,1,14,8,0,8
415057,36,3,3,0,3,3,0,,,
415987,36,39,4,35,39,4,35,,,
416458,36,100,34,66,100,34,66,,,
416801,36,267,58,209,225,47,178,42,11,31
417008,36,101,2,99,101,2,99,,,
417062,36,41,2,39,29,0,29,12,2,10
417105,36,208,150,58,123,77,46,85,73,12
417123,36,59,19,40,21,7,14,38,12,26
417248,36,34,33,1,34,33,1,,,
417275,36,17,16,1,17,16,1,,,
417327,36,135,15,120,74,9,65,61,6,55
417442,36,57,1,56,57,1,56,,,
417503,36,201,0,201,123,0,123,78,0,78
417600,36,3,0,3,3,0,3,,,
417628,36,7,0,7,6,0,6,1,0,1
417637,36,40,11,29,40,11,29,,,
417646,36,14,1,13,14,1,13,,,
417655,36,12,2,10,12,2,10,,,
417682,36,9,0,9,9,0,9,,,
417716,36,183,3,180,183,3,180,,,
417725,36,38,2,36,38,2,36,,,
417734,36,70,14,56,21,4,17,49,10,39
417752,36,15,6,9,13,5,8,2,1,1
417831,36,106,76,30,106,76,30,,,
417840,36,367,24,343,367,24,343,,,
417868,36,10,4,6,,,,10,4,6
417886,36,20,1,19,20,1,19,,,
417910,36,158,27,131,158,27,131,,,
417983,36,17,0,17,,,,17,0,17
417992,36,45,3,42,27,2,25,18,1,17
418001,36,81,3,78,81,3,78,,,
418010,36,48,4,44,26,1,25,22,3,19
418029,36,28,2,26,28,2,26,,,
418038,36,140,13,127,140,13,127,,,
418065,36,188,25,163,149,20,129,39,5,34
418083,36,42,4,38,42,4,38,,,
418126,36,107,35,72,63,17,46,44,18,26
418171,36,49,49,0,49,49,0,,,
418199,36,17,14,3,2,2,0,15,12,3
418205,36,167,95,72,115,64,51,52,31,21
418223,36,42,3,39,42,3,39,,,
418250,36,48,27,21,9,7,2,39,20,19
418269,36,57,24,33,57,24,33,,,
418278,36,57,8,49,21,3,18,36,5,31
418296,36,694,321,373,174,35,139,520,286,234
418302,36,99,33,66,69,12,57,30,21,9
418320,36,38,11,27,27,7,20,11,4,7
418348,36,35,30,5,29,27,2,6,3,3
418357,36,9,2,7,8,1,7,1,1,0
418409,36,78,29,49,51,11,40,27,18,9
418427,36,73,5,68,62,5,57,11,0,11
418445,36,18,0,18,10,0,10,8,0,8
418454,36,53,32,21,52,31,21,1,1,0
418481,36,23,0,23,23,0,23,,,
418515,36,14,1,13,12,1,11,2,0,2
418524,36,22,1,21,22,1,21,,,
418533,36,154,19,135,119,11,108,35,8,27
418542,36,47,6,41,21,1,20,26,5,21
418560,36,63,8,55,14,1,13,49,7,42
418588,36,16,0,16,16,0,16,,,
418612,36,7,0,7,7,0,7,,,
418658,36,222,184,38,222,184,38,,,
418773,36,214,99,115,162,89,73,52,10,42
418782,36,98,92,6,98,92,6,,,
418889,36,32,28,4,26,22,4,6,6,0
418913,36,3,1,2,3,1,2,,,
418968,36,82,1,81,82,1,81,,,
419031,36,4,0,4,4,0,4,,,
419095,36,28,3,25,28,3,25,,,
419183,36,25,0,25,25,0,25,,,
419217,36,57,10,47,57,10,47,,,
419226,36,269,123,146,205,103,102,64,20,44
419235,36,105,23,82,105,23,82,,,
419244,36,98,79,19,51,43,8,47,36,11
419253,36,18,14,4,18,14,4,,,
419280,36,23,0,23,19,0,19,4,0,4
419341,36,2,1,1,2,1,1,,,
419420,36,18,4,14,18,4,14,,,
419484,36,14,1,13,14,1,13,,,
419633,36,55,7,48,55,7,48,,,
419703,36,202,193,9,202,193,9,,,
419712,36,60,60,0,60,60,0,,,
419721,36,102,96,6,102,96,6,,,
420024,36,162,15,147,133,11,122,29,4,25
420042,36,24,14,10,24,14,10,,,
420130,36,252,11,241,252,11,241,,,
420255,36,51,50,1,51,50,1,,,
420325,36,51,51,0,51,51,0,,,
420343,36,500,483,17,400,388,12,100,95,5
420370,36,285,100,185,285,100,185,,,
420398,36,8812,3595,5217,1556,679,877,7256,2916,4340
420431,36,924,291,633,203,49,154,721,242,479
420440,36,539,163,376,154,61,93,385,102,283
420468,36,118,42,76,103,41,62,15,1,14
420538,36,524,168,356,247,92,155,277,76,201
420556,36,288,104,184,128,55,73,160,49,111
420723,36,132,53,79,32,8,24,100,45,55
420981,36,113,15,98,113,15,98,,,
421513,36,30,2,28,25,0,25,5,2,3
421610,36,109,8,101,103,8,95,6,0,6
421665,36,30,0,30,13,0,13,17,0,17
421708,36,982,118,864,791,84,707,191,34,157
421717,36,16,10,6,8,6,2,8,4,4
421771,36,39,0,39,26,0,26,13,0,13
421841,36,260,110,150,260,110,150,,,
421878,36,302,28,274,227,21,206,75,7,68
421896,36,93,29,64,93,29,64,,,
422020,36,155,150,5,155,150,5,,,
422695,36,172,16,156,172,16,156,,,
422835,36,8,4,4,8,4,4,,,
423120,36,575,59,516,571,59,512,4,0,4
423397,36,343,206,137,343,206,137,,,
423412,36,22,19,3,22,19,3,,,
423652,36,187,44,143,87,18,69,100,26,74
425250,36,55,8,47,33,6,27,22,2,20
425986,36,127,15,112,127,15,112,,,
426314,36,6974,5932,1042,1860,1545,315,5114,4387,727
427308,36,89,3,86,89,3,86,,,
427335,36,11,0,11,10,0,10,1,0,1
427894,36,49,48,1,49,48,1,,,
427973,36,198,177,21,118,105,13,80,72,8
427982,36,117,74,43,97,64,33,20,10,10
427991,36,38,30,8,31,24,7,7,6,1
428000,36,86,20,66,86,20,66,,,
428019,36,14,4,10,12,2,10,2,2,0
428055,36,98,20,78,98,20,78,,,
428125,36,41,28,13,40,27,13,1,1,0
428170,36,390,36,354,239,21,218,151,15,136
428259,36,48,5,43,10,1,9,38,4,34
428392,36,531,199,332,260,115,145,271,84,187
429128,36,216,1,215,6,0,6,210,1,209
430184,36,1111,331,780,120,76,44,991,255,736
430227,36,33,0,33,24,0,24,9,0,9
430245,36,484,129,355,484,129,355,,,
430306,36,32,14,18,23,11,12,9,3,6
430403,36,212,14,198,212,14,198,,,
430564,36,7,2,5,5,1,4,2,1,1
430582,36,164,69,95,164,69,95,,,
430670,36,53,15,38,53,15,38,,,
430704,36,21,5,16,20,5,15,1,0,1
430795,36,27,6,21,27,6,21,,,
430883,36,26,2,24,26,2,24,,,
430908,36,20,2,18,12,0,12,8,2,6
430935,36,316,241,75,205,159,46,111,82,29
430971,36,19,2,17,19,2,17,,,
431017,36,51,28,23,43,21,22,8,7,1
431071,36,7,3,4,2,2,0,5,1,4
431105,36,44,1,43,21,0,21,23,1,22
431123,36,54,53,1,54,53,1,,,
431141,36,1063,368,695,1022,365,657,41,3,38
431187,36,34,32,2,34,32,2,,,
431196,36,83,6,77,83,6,77,,,
431266,36,34,3,31,31,3,28,3,0,3
431275,36,28,3,25,5,0,5,23,3,20
431284,36,41,0,41,37,0,37,4,0,4
431558,36,89,24,65,85,23,62,4,1,3
431600,36,155,29,126,135,22,113,20,7,13
431716,36,99,57,42,99,57,42,,,
431983,36,74,74,0,74,74,0,,,
432117,36,159,1,158,100,1,99,59,0,59
432269,36,54,43,11,54,43,11,,,
432384,36,334,74,260,334,74,260,,,
432524,36,54,16,38,54,16,38,,,
433004,36,250,64,186,250,64,186,,,
433013,36,631,209,422,631,209,422,,,
433040,36,31,2,29,31,2,29,,,
433068,36,180,120,60,138,79,59,42,41,1
433101,36,438,51,387,285,39,246,153,12,141
433138,36,76,8,68,70,4,66,6,4,2
433174,36,266,31,235,20,3,17,246,28,218
433387,36,77160,31294,45866,77160,31294,45866,,,
433420,36,272,235,37,272,235,37,,,
433536,36,289,28,261,167,19,148,122,9,113
433660,36,9843,4254,5589,7493,3185,4308,2350,1069,1281
434016,36,107,31,76,45,16,29,62,15,47
434061,36,2989,1000,1989,1464,561,903,1525,439,1086
434140,36,529,119,410,529,119,410,,,
434159,36,306,256,50,306,256,50,,,
434274,36,8,0,8,4,0,4,4,0,4
434283,36,37,1,36,36,1,35,1,0,1
434308,36,169,11,158,169,11,158,,,
434344,36,180,7,173,180,7,173,,,
434362,36,17,16,1,17,16,1,,,
434432,36,5,1,4,5,1,4,,,
434469,36,123,10,113,123,10,113,,,
434496,36,23,0,23,23,0,23,,,
434539,36,6,4,2,2,2,0,4,2,2
434584,36,121,28,93,30,8,22,91,20,71
434672,36,9188,3114,6074,1950,913,1037,7238,2201,5037
434751,36,66,15,51,32,7,25,34,8,26
434821,36,423,19,404,423,19,404,,,
434830,36,91,0,91,61,0,61,30,0,30
434900,36,283,66,217,160,31,129,123,35,88
434937,36,17,17,0,17,17,0,,,
435000,36,18,8,10,18,8,10,,,
436030,36,135,68,67,74,52,22,61,16,45
436304,36,1029,560,469,541,299,242,488,261,227
436429,36,4183,2717,1466,4183,2717,1466,,,
436553,36,753,126,627,753,126,627,,,
436599,36,84,12,72,6,0,6,78,12,66
436614,36,44,24,20,21,11,10,23,13,10
436632,36,33,8,25,17,6,11,16,2,14
436641,36,20,8,12,20,8,12,,,
436650,36,132,11,121,132,11,121,,,
436775,36,80,3,77,80,3,77,,,
436818,36,473,182,291,428,161,267,45,21,24
436827,36,276,147,129,262,138,124,14,9,5
436836,36,1481,747,734,1361,685,676,120,62,58
437097,36,305,172,133,281,160,121,24,12,12
437103,36,4456,1278,3178,1862,657,1205,2594,621,1973
437237,36,62,49,13,62,49,13,,,
437556,36,864,363,501,801,355,446,63,8,55
437608,36,88,73,15,87,72,15,1,1,0
437635,36,524,56,468,524,56,468,,,
437723,36,1,1,0,1,1,0,,,
437732,36,45,3,42,29,1,28,16,2,14
437750,36,53,52,1,53,52,1,,,
437769,36,117,8,109,117,8,109,,,
437778,36,28,2,26,28,2,26,,,
437857,36,87,1,86,68,1,67,19,0,19
437936,36,515,60,455,515,60,455,,,
438179,36,167,23,144,167,23,144,,,
438221,36,102,9,93,91,8,83,11,1,10
438258,36,318,56,262,318,56,262,,,
438285,36,124,16,108,124,16,108,,,
438337,36,2,0,2,1,0,1,1,0,1
438504,36,669,641,28,669,641,28,,,
438586,36,678,280,398,557,233,324,121,47,74
438674,36,39,0,39,20,0,20,19,0,19
438708,36,118,18,100,62,10,52,56,8,48
438735,36,143,130,13,89,82,7,54,48,6
438984,36,8,4,4,8,4,4,,,
439020,36,3,1,2,2,0,2,1,1,0
439118,36,199,34,165,199,34,165,,,
439190,36,821,412,409,452,226,226,369,186,183
439367,36,968,282,686,968,282,686,,,
439446,36,1,1,0,1,1,0,,,
439455,36,300,13,287,153,8,145,147,5,142
439473,36,135,43,92,61,23,38,74,20,54
439491,36,172,24,148,172,24,148,,,
439570,36,293,12,281,293,12,281,,,
439622,36,329,51,278,329,51,278,,,
439668,36,157,145,12,157,145,12,,,
439686,36,1,0,1,1,0,1,,,
439701,36,208,80,128,98,37,61,110,43,67
439738,36,210,41,169,210,41,169,,,
439747,36,119,20,99,74,15,59,45,5,40
439774,36,13,3,10,5,2,3,8,1,7
439783,36,72,16,56,60,12,48,12,4,8
439792,36,271,25,246,266,25,241,5,0,5
439844,36,20,0,20,20,0,20,,,
439862,36,46,16,30,42,14,28,4,2,2
439871,36,154,3,151,151,3,148,3,0,3
439899,36,38,17,21,28,9,19,10,8,2
439932,36,11,0,11,11,0,11,,,
439969,36,12,5,7,12,5,7,,,
440059,36,575,533,42,333,306,27,242,227,15
440101,36,66,1,65,31,0,31,35,1,34
440262,36,341,325,16,244,231,13,97,94,3
440271,36,83,35,48,83,35,48,,,
440396,36,140,60,80,128,55,73,12,5,7
440402,36,711,197,514,295,98,197,416,99,317
440651,36,343,78,265,163,48,115,180,30,150
440730,36,262,72,190,262,72,190,,,
440749,36,39,26,13,5,4,1,34,22,12
440776,36,43,18,25,43,18,25,,,
440794,36,218,54,164,210,51,159,8,3,5
440819,36,11,8,3,11,8,3,,,
440828,36,702,379,323,344,183,161,358,196,162
440855,36,21,0,21,21,0,21,,,
440989,36,373,290,83,373,290,83,,,
441025,36,99,11,88,93,10,83,6,1,5
441052,36,1273,355,918,1273,355,918,,,
441070,36,81,29,52,26,8,18,55,21,34
441168,36,14,0,14,14,0,14,,,
441210,36,257,82,175,23,1,22,234,81,153
441229,36,1313,237,1076,1313,237,1076,,,
441256,36,27,1,26,27,1,26,,,
441371,36,1877,54,1823,1867,54,1813,10,0,10
441380,36,190,77,113,154,65,89,36,12,24
441414,36,65,15,50,16,6,10,49,9,40
441423,36,489,151,338,489,151,338,,,
441487,36,35,1,34,35,1,34,,,
441496,36,154,133,21,101,88,13,53,45,8
441502,36,242,17,225,242,17,225,,,
441575,36,222,16,206,222,16,206,,,
441593,36,12,1,11,12,1,11,,,
441609,36,100,100,0,100,100,0,,,
441618,36,6,0,6,3,0,3,3,0,3
441636,36,189,30,159,158,24,134,31,6,25
441645,36,108,3,105,85,3,82,23,0,23
441663,36,175,17,158,175,17,158,,,
441672,36,7,0,7,7,0,7,,,
441690,36,93,58,35,39,21,18,54,37,17
441706,36,151,59,92,151,59,92,,,
441742,36,584,60,524,525,54,471,59,6,53
441760,36,1956,756,1200,630,325,305,1326,431,895
441788,36,355,321,34,222,198,24,133,123,10
441830,36,30,7,23,30,7,23,,,
441858,36,81,5,76,60,1,59,21,4,17
441876,36,198,4,194,115,3,112,83,1,82
441900,36,3625,817,2808,1378,284,1094,2247,533,1714
441937,36,4167,1424,2743,3002,967,2035,1165,457,708
441982,36,280,134,146,280,134,146,,,
442073,36,454,87,367,294,69,225,160,18,142
442134,36,225,46,179,225,46,179,,,
442240,36,392,77,315,245,45,200,147,32,115
442329,36,560,497,63,560,497,63,,,
442356,36,1185,132,1053,397,46,351,788,86,702
442383,36,30,3,27,30,3,27,,,
442426,36,304,25,279,221,19,202,83,6,77
442435,36,45,7,38,45,7,38,,,
442444,36,700,368,332,700,368,332,,,
442523,36,58,21,37,55,20,35,3,1,2
442569,36,3310,1437,1873,1170,457,713,2140,980,1160
442602,36,306,44,262,306,44,262,,,
442611,36,536,510,26,536,510,26,,,
442639,36,105,68,37,105,68,37,,,
442657,36,66,1,65,66,1,65,,,
442781,36,549,106,443,147,29,118,402,77,325
442842,36,29,7,22,20,6,14,9,1,8
442879,36,396,22,374,389,22,367,7,0,7
442888,36,35,33,2,35,33,2,,,
442930,36,261,110,151,243,98,145,18,12,6
442976,36,59,6,53,59,6,53,,,
442985,36,4,2,2,4,2,2,,,
443021,36,8,7,1,8,7,1,,,
443049,36,117,64,53,50,26,24,67,38,29
443058,36,19,5,14,3,2,1,16,3,13
443100,36,28,17,11,28,17,11,,,
443137,36,68,19,49,68,19,49,,,
443146,36,35,26,9,22,17,5,13,9,4
443207,36,85,81,4,85,81,4,,,
443216,36,82,64,18,82,64,18,,,
443225,36,19,14,5,19,14,5,,,
443234,36,83,3,80,83,3,80,,,
443252,36,563,321,242,563,321,242,,,
443261,36,131,11,120,90,9,81,41,2,39
443289,36,89,5,84,89,5,84,,,
443298,36,2,2,0,2,2,0,,,
443322,36,156,27,129,156,27,129,,,
443331,36,2368,473,1895,1922,378,1544,446,95,351
443340,36,39,17,22,39,17,22,,,
443377,36,30,26,4,30,26,4,,,
443410,36,749,523,226,670,463,207,79,60,19
443492,36,508,225,283,380,179,201,128,46,82
443562,36,231,34,197,112,18,94,119,16,103
443571,36,368,177,191,368,177,191,,,
443599,36,572,45,527,126,18,108,446,27,419
443632,36,42,27,15,42,27,15,,,
443641,36,113,4,109,57,3,54,56,1,55
443650,36,1415,201,1214,1325,179,1146,90,22,68
443669,36,2,0,2,2,0,2,,,
443696,36,41,9,32,41,9,32,,,
443748,36,318,74,244,307,74,233,11,0,11
443766,36,1986,356,1630,103,46,57,1883,310,1573
443784,36,980,223,757,51,24,27,929,199,730
443951,36,39,15,24,39,15,24,,,
443979,36,17,0,17,1,0,1,16,0,16
444051,36,24,0,24,18,0,18,6,0,6
444088,36,428,55,373,428,55,373,,,
444130,36,96,25,71,15,3,12,81,22,59
444194,36,188,7,181,188,7,181,,,
444219,36,4562,2021,2541,979,473,506,3583,1548,2035
444228,36,15,0,15,15,0,15,,,
444255,36,53,3,50,53,3,50,,,
444282,36,54,1,53,18,0,18,36,1,35
444291,36,74,3,71,46,1,45,28,2,26
444307,36,40,2,38,31,1,30,9,1,8
444325,36,100,16,84,93,15,78,7,1,6
444334,36,63,10,53,63,10,53,,,
444361,36,29,13,16,29,13,16,,,
444370,36,22,20,2,22,20,2,,,
444398,36,86,42,44,62,31,31,24,11,13
444404,36,17,7,10,10,5,5,7,2,5
444413,36,94,94,0,94,94,0,,,
444440,36,27,4,23,27,4,23,,,
444468,36,21,0,21,19,0,19,2,0,2
444486,36,250,11,239,219,9,210,31,2,29
444510,36,53,0,53,53,0,53,,,
444529,36,16,2,14,16,2,14,,,
444556,36,304,149,155,304,149,155,,,
444565,36,274,124,150,211,92,119,63,32,31
444583,36,171,67,104,171,67,104,,,
444635,36,43,6,37,43,6,37,,,
444662,36,66,56,10,66,56,10,,,
444671,36,70,24,46,70,24,46,,,
444714,36,134,16,118,134,16,118,,,
444732,36,27,4,23,27,4,23,,,
444778,36,38,16,22,20,6,14,18,10,8
444787,36,2325,309,2016,1400,174,1226,925,135,790
444811,36,312,17,295,143,10,133,169,7,162
444857,36,116,2,114,66,1,65,50,1,49
444866,36,101,4,97,68,2,66,33,2,31
444893,36,29,0,29,29,0,29,,,
444936,36,85,15,70,84,14,70,1,1,0
444945,36,115,18,97,115,18,97,,,
444954,36,515,193,322,284,116,168,231,77,154
445027,36,7021,2879,4142,6458,2709,3749,563,170,393
445133,36,80,37,43,63,30,33,17,7,10
445188,36,5737,2804,2933,5624,2734,2890,113,70,43
445203,36,111,17,94,111,17,94,,,
445212,36,152,28,124,73,14,59,79,14,65
445230,36,575,180,395,575,180,395,,,
445249,36,153,35,118,153,35,118,,,
445267,36,1093,225,868,630,124,506,463,101,362
445364,36,456,44,412,456,44,412,,,
445461,36,260,78,182,257,78,179,3,0,3
445498,36,1,1,0,1,1,0,,,
445540,36,46,0,46,46,0,46,,,
445647,36,121,3,118,71,2,69,50,1,49
445656,36,155,7,148,94,3,91,61,4,57
445692,36,302,249,53,268,220,48,34,29,5
445708,36,703,237,466,665,224,441,38,13,25
445735,36,397,97,300,397,97,300,,,
445744,36,350,47,303,350,47,303,,,
445762,36,156,145,11,91,84,7,65,61,4
445780,36,19,4,15,19,4,15,,,
445799,36,465,450,15,465,450,15,,,
445841,36,136,2,134,106,2,104,30,0,30
445850,36,107,2,105,77,1,76,30,1,29
445911,36,545,230,315,359,157,202,186,73,113
445948,36,1210,192,1018,1210,192,1018,,,
445957,36,124,25,99,,,,124,25,99
446048,36,801,356,445,792,351,441,9,5,4
446084,36,41,4,37,,,,41,4,37
446093,36,17,0,17,17,0,17,,,
446109,36,210,33,177,162,29,133,48,4,44
446118,36,501,96,405,501,96,405,,,
446127,36,89,5,84,89,5,84,,,
446163,36,173,160,13,93,85,8,80,75,5
446206,36,10,0,10,7,0,7,3,0,3
446224,36,11,5,6,,,,11,5,6
446233,36,92,47,45,82,43,39,10,4,6
446242,36,122,29,93,122,29,93,,,
446251,36,6,6,0,6,6,0,,,
446260,36,651,13,638,651,13,638,,,
446288,36,73,0,73,47,0,47,26,0,26
446303,36,63,1,62,52,0,52,11,1,10
446349,36,12,2,10,12,2,10,,,
446385,36,167,88,79,153,80,73,14,8,6
446516,36,3,1,2,3,1,2,,,
446525,36,1149,983,166,1149,983,166,,,
446552,36,970,549,421,970,549,421,,,
446561,36,1712,371,1341,1712,371,1341,,,
446598,36,20,0,20,19,0,19,1,0,1
446604,36,1790,1790,0,1790,1790,0,,,
446640,36,417,284,133,406,274,132,11,10,1
446774,36,922,342,580,340,133,207,582,209,373
447014,36,96,8,88,96,8,88,,,
447023,36,1410,530,880,1396,526,870,14,4,10
447050,36,161,45,116,52,16,36,109,29,80
447148,36,120,3,117,80,3,77,40,0,40
447166,36,26,0,26,14,0,14,12,0,12
447175,36,39,3,36,21,2,19,18,1,17
447263,36,1644,237,1407,1004,139,865,640,98,542
447351,36,386,215,171,386,215,171,,,
447421,36,181,16,165,181,16,165,,,
447449,36,19,6,13,15,6,9,4,0,4
447467,36,16,2,14,16,2,14,,,
447582,36,408,108,300,264,77,187,144,31,113
447591,36,467,47,420,467,47,420,,,
447607,36,1275,670,605,1275,670,605,,,
447616,36,1015,588,427,1015,588,427,,,
447689,36,7493,3082,4411,4767,1951,2816,2726,1131,1595
447704,36,92,1,91,92,1,91,,,
447713,36,129,43,86,129,43,86,,,
447722,36,16,2,14,16,2,14,,,
447731,36,75,6,69,46,5,41,29,1,28
447759,36,177,44,133,165,44,121,12,0,12
447768,36,1268,292,976,1268,292,976,,,
447777,36,310,172,138,7,5,2,303,167,136
447795,36,2,0,2,2,0,2,,,
447810,36,6,2,4,6,2,4,,,
447847,36,136,126,10,136,126,10,,,
447865,36,10,7,3,10,7,3,,,
447883,36,81,9,72,34,4,30,47,5,42
447892,36,62,4,58,48,4,44,14,0,14
447908,36,61,1,60,34,0,34,27,1,26
447917,36,17,1,16,17,1,16,,,
447935,36,124,8,116,124,8,116,,,
447953,36,285,141,144,193,96,97,92,45,47
447962,36,98,8,90,98,8,90,,,
447971,36,10,0,10,10,0,10,,,
447980,36,48,1,47,32,1,31,16,0,16
447999,36,114,23,91,114,23,91,,,
448026,36,98,3,95,77,3,74,21,0,21
448071,36,111,6,105,111,6,105,,,
448123,36,13,8,5,13,8,5,,,
448196,36,103,8,95,100,8,92,3,0,3
448220,36,107,3,104,107,3,104,,,
448239,36,118,4,114,118,4,114,,,
448248,36,1522,994,528,186,31,155,1336,963,373
448257,36,10,0,10,1,0,1,9,0,9
448275,36,9,0,9,9,0,9,,,
448372,36,165,68,97,165,68,97,,,
448424,36,28,7,21,11,3,8,17,4,13
448433,36,610,587,23,610,587,23,,,
448594,36,1959,681,1278,736,264,472,1223,417,806
448600,36,155,12,143,155,12,143,,,
448646,36,16,0,16,16,0,16,,,
448673,36,1728,173,1555,650,58,592,1078,115,963
448770,36,240,227,13,231,221,10,9,6,3
448798,36,60,5,55,60,5,55,,,
448859,36,84,78,6,84,78,6,,,
448895,36,55,9,46,55,9,46,,,
449038,36,964,249,715,137,80,57,827,169,658
449074,36,384,54,330,384,54,330,,,
449083,36,100,100,0,100,100,0,,,
449092,36,34,34,0,34,34,0,,,
449135,36,180,51,129,121,45,76,59,6,53
449250,36,539,93,446,539,93,446,,,
449311,36,129,1,128,38,0,38,91,1,90
449320,36,474,460,14,339,329,10,135,131,4
449339,36,30483,19548,10935,2324,1246,1078,28159,18302,9857
449348,36,59,21,38,8,4,4,51,17,34
449357,36,76,4,72,76,4,72,,,
449384,36,239,142,97,226,136,90,13,6,7
449393,36,96,35,61,96,35,61,,,
449445,36,46,9,37,46,9,37,,,
449454,36,35,4,31,,,,35,4,31
449463,36,28,8,20,18,6,12,10,2,8
449472,36,42,1,41,42,1,41,,,
449490,36,41,6,35,41,6,35,,,
449506,36,38,16,22,38,16,22,,,
449524,36,259,19,240,259,19,240,,,
449533,36,35,6,29,35,6,29,,,
449597,36,1,0,1,1,0,1,,,
449603,36,69,46,23,69,46,23,,,
449612,36,72,39,33,72,39,33,,,
449658,36,66,66,0,65,65,0,1,1,0
449676,36,176,58,118,176,58,118,,,
449685,36,38,3,35,38,3,35,,,
449700,36,285,62,223,285,62,223,,,
449728,36,119,5,114,119,5,114,,,
449764,36,150,66,84,146,65,81,4,1,3
449773,36,12,3,9,12,3,9,,,
449782,36,3,1,2,2,1,1,1,0,1
449807,36,21,2,19,21,2,19,,,
449816,36,254,168,86,31,15,16,223,153,70
449834,36,1,1,0,,,,1,1,0
449861,36,24,1,23,24,1,23,,,
449870,36,47,18,29,45,18,27,2,0,2
449889,36,86,22,64,86,22,64,,,
449898,36,295,52,243,221,41,180,74,11,63
449904,36,27,1,26,27,1,26,,,
449959,36,130,33,97,71,18,53,59,15,44
449968,36,268,55,213,197,40,157,71,15,56
449977,36,193,3,190,150,2,148,43,1,42
449986,36,254,66,188,156,35,121,98,31,67
449995,36,118,5,113,65,3,62,53,2,51
450058,36,612,95,517,612,95,517,,,
450067,36,338,90,248,334,90,244,4,0,4
450128,36,426,10,416,426,10,416,,,
450298,36,199,44,155,12,8,4,187,36,151
450377,36,986,183,803,62,25,37,924,158,766
450395,36,116,1,115,82,1,81,34,0,34
450401,36,254,24,230,254,24,230,,,
450571,36,319,36,283,141,17,124,178,19,159
450599,36,30,0,30,30,0,30,,,
450605,36,30,1,29,15,0,15,15,1,14
450614,36,75,3,72,51,2,49,24,1,23
450632,36,53,10,43,,,,53,10,43
450641,36,246,19,227,153,16,137,93,3,90
450650,36,104,4,100,39,0,39,65,4,61
450696,36,296,45,251,296,45,251,,,
450702,36,34,4,30,34,4,30,,,
450711,36,2,1,1,2,1,1,,,
450720,36,454,7,447,187,4,183,267,3,264
450933,36,9476,6169,3307,5310,3244,2066,4166,2925,1241
450951,36,69,40,29,69,40,29,,,
450960,36,315,29,286,238,20,218,77,9,68
450988,36,133,12,121,89,8,81,44,4,40
451042,36,7,2,5,3,0,3,4,2,2
451051,36,83,7,76,,,,83,7,76
451097,36,11,2,9,4,0,4,7,2,5
451103,36,4,2,2,2,1,1,2,1,1
451121,36,111,9,102,51,4,47,60,5,55
451149,36,920,59,861,920,59,861,,,
451158,36,675,32,643,675,32,643,,,
451167,36,167,85,82,93,56,37,74,29,45
451194,36,26,3,23,26,3,23,,,
451228,36,74,57,17,74,57,17,,,
451237,36,165,3,162,165,3,162,,,
451255,36,37,1,36,19,0,19,18,1,17
451282,36,80,2,78,56,1,55,24,1,23
451291,36,4,0,4,,,,4,0,4
451307,36,29,0,29,2,0,2,27,0,27
451316,36,45,4,41,45,4,41,,,
451334,36,168,70,98,94,44,50,74,26,48
451343,36,74,4,70,44,2,42,30,2,28
451352,36,54,6,48,38,4,34,16,2,14
451370,36,43,43,0,43,43,0,,,
451398,36,151,151,0,151,151,0,,,
451404,36,284,284,0,284,284,0,,,
451413,36,389,100,289,389,100,289,,,
451468,36,356,3,353,356,3,353,,,
451477,36,1020,828,192,1020,828,192,,,
451495,36,256,63,193,256,63,193,,,
451501,36,138,40,98,138,40,98,,,
451529,36,16,1,15,9,0,9,7,1,6
451547,36,7,1,6,7,1,6,,,
451556,36,664,228,436,664,228,436,,,
451565,36,159,23,136,146,13,133,13,10,3
451574,36,127,5,122,97,4,93,30,1,29
451583,36,708,546,162,107,72,35,601,474,127
451626,36,14,1,13,14,1,13,,,
451714,36,259,50,209,148,11,137,111,39,72
451741,36,48,17,31,30,13,17,18,4,14
451750,36,681,127,554,318,92,226,363,35,328
451820,36,61,38,23,40,25,15,21,13,8
451857,36,42,1,41,42,1,41,,,
451866,36,216,38,178,216,38,178,,,
451918,36,100,11,89,100,11,89,,,
451927,36,270,136,134,254,128,126,16,8,8
452009,36,45,1,44,45,1,44,,,
452072,36,13,1,12,13,1,12,,,
452081,36,659,20,639,659,20,639,,,
452106,36,41,39,2,41,39,2,,,
452124,36,276,56,220,274,55,219,2,1,1
452373,36,249,14,235,249,14,235,,,
452771,36,2,0,2,,,,2,0,2
452780,36,5,1,4,,,,5,1,4
452887,36,36,34,2,36,34,2,,,
452948,36,356,22,334,255,15,240,101,7,94
453163,36,2102,360,1742,141,60,81,1961,300,1661
453215,36,362,72,290,14,2,12,348,70,278
453297,36,21,6,15,,,,21,6,15
453756,36,48,28,20,48,28,20,,,
453792,36,73,4,69,73,4,69,,,
454184,36,203,72,131,191,68,123,12,4,8
454227,36,9003,926,8077,1785,204,1581,7218,722,6496
454236,36,454,54,400,154,19,135,300,35,265
454245,36,691,117,574,210,33,177,481,84,397
454537,36,33,0,33,33,0,33,,,
454546,36,23,3,20,23,3,20,,,
454555,36,22,2,20,22,2,20,,,
454582,36,90,35,55,23,14,9,67,21,46
454607,36,304,10,294,304,10,294,,,
454652,36,127,3,124,127,3,124,,,
454689,36,2,1,1,2,1,1,,,
454698,36,218,66,152,218,66,152,,,
454722,36,18,3,15,16,2,14,2,1,1
454759,36,37,30,7,32,26,6,5,4,1
454768,36,208,34,174,118,22,96,90,12,78
454777,36,207,27,180,137,20,117,70,7,63
454786,36,425,258,167,114,74,40,311,184,127
454795,36,232,60,172,158,44,114,74,16,58
454801,36,172,33,139,172,33,139,,,
454810,36,6361,1654,4707,6361,1654,4707,,,
454829,36,115,21,94,49,6,43,66,15,51
454856,36,864,106,758,864,106,758,,,
454865,36,647,106,541,452,83,369,195,23,172
454874,36,9,0,9,3,0,3,6,0,6
454917,36,609,101,508,367,59,308,242,42,200
454926,36,284,16,268,242,14,228,42,2,40
454935,36,59,1,58,59,1,58,,,
454944,36,215,15,200,215,15,200,,,
454953,36,22,0,22,8,0,8,14,0,14
454962,36,36,2,34,16,1,15,20,1,19
454971,36,162,15,147,85,14,71,77,1,76
454980,36,139,0,139,26,0,26,113,0,113
454999,36,105,2,103,46,1,45,59,1,58
455008,36,117,3,114,46,2,44,71,1,70
455026,36,53,49,4,,,,53,49,4
455062,36,48,0,48,20,0,20,28,0,28
455071,36,55,17,38,,,,55,17,38
455080,36,237,26,211,236,26,210,1,0,1
455105,36,78,0,78,78,0,78,,,
455114,36,3858,1567,2291,1315,687,628,2543,880,1663
455141,36,179,4,175,179,4,175,,,
455187,36,59,18,41,36,13,23,23,5,18
455196,36,2219,200,2019,2219,200,2019,,,
455202,36,229,34,195,63,5,58,166,29,137
455211,36,267,8,259,267,8,259,,,
455220,36,19,1,18,19,1,18,,,
455257,36,302,302,0,302,302,0,,,
455275,36,213,5,208,213,5,208,,,
455284,36,180,5,175,121,4,117,59,1,58
455327,36,40,1,39,33,1,32,7,0,7
455336,36,132,109,23,132,109,23,,,
455354,36,224,4,220,224,4,220,,,
455381,36,92,0,92,64,0,64,28,0,28
455460,36,85,16,69,85,16,69,,,
455479,36,456,52,404,378,47,331,78,5,73
455488,36,152,58,94,152,58,94,,,
455512,36,1813,628,1185,361,147,214,1452,481,971
455628,36,229,60,169,229,60,169,,,
455664,36,212,26,186,7,2,5,205,24,181
455707,36,51,12,39,51,12,39,,,
455725,36,230,4,226,168,2,166,62,2,60
455734,36,107,23,84,107,23,84,,,
455761,36,301,42,259,182,28,154,119,14,105
455770,36,78,45,33,77,45,32,1,0,1
455798,36,75,1,74,35,1,34,40,0,40
455831,36,23,1,22,23,1,22,,,
455859,36,208,3,205,177,3,174,31,0,31
455868,36,252,36,216,252,36,216,,,
455877,36,61,5,56,61,5,56,,,
455886,36,136,7,129,56,1,55,80,6,74
455895,36,325,23,302,129,3,126,196,20,176
455901,36,151,11,140,65,2,63,86,9,77
455910,36,2,2,0,2,2,0,,,
455929,36,43,0,43,43,0,43,,,
455965,36,111,7,104,111,7,104,,,
455974,36,55,4,51,55,4,51,,,
455983,36,145,43,102,143,42,101,2,1,1
456001,36,25,23,2,25,23,2,,,
456029,36,223,9,214,163,9,154,60,0,60
456038,36,256,31,225,256,31,225,,,
456065,36,135,2,133,131,2,129,4,0,4
456074,36,114,7,107,113,7,106,1,0,1
456135,36,35,0,35,23,0,23,12,0,12
456153,36,46,39,7,46,39,7,,,
456205,36,97,6,91,94,6,88,3,0,3
456214,36,263,164,99,263,164,99,,,
456287,36,75,1,74,75,1,74,,,
456454,36,363,86,277,293,75,218,70,11,59
456481,36,34,18,16,,,,34,18,16
456490,36,99,67,32,31,23,8,68,44,24
456506,36,37,3,34,37,3,34,,,
456515,36,22,2,20,22,2,20,,,
456551,36,28,2,26,28,2,26,,,
456579,36,139,31,108,128,31,97,11,0,11
456588,36,32,1,31,32,1,31,,,
456597,36,211,5,206,103,2,101,108,3,105
456621,36,219,69,150,15,7,8,204,62,142
456825,36,168,8,160,120,4,116,48,4,44
456852,36,261,83,178,261,83,178,,,
456922,36,170,33,137,158,32,126,12,1,11
456931,36,232,113,119,228,113,115,4,0,4
456959,36,389,79,310,367,72,295,22,7,15
456968,36,1016,40,976,955,35,920,61,5,56
456977,36,18,11,7,18,11,7,,,
457031,36,57,0,57,38,0,38,19,0,19
457077,36,61,3,58,61,3,58,,,
457086,36,175,40,135,131,31,100,44,9,35
457101,36,211,61,150,211,61,150,,,
457110,36,367,65,302,367,65,302,,,
457129,36,786,78,708,195,12,183,591,66,525
457192,36,26,19,7,26,19,7,,,
457208,36,102,92,10,102,92,10,,,
457226,36,23,15,8,7,4,3,16,11,5
457253,36,111,6,105,38,2,36,73,4,69
457299,36,247,44,203,214,37,177,33,7,26
457314,36,79,16,63,79,16,63,,,
457323,36,333,38,295,333,38,295,,,
457332,36,36,3,33,36,3,33,,,
457341,36,156,7,149,156,7,149,,,
457350,36,74,0,74,,,,74,0,74
457378,36,105,55,50,55,20,35,50,35,15
457387,36,49,17,32,49,17,32,,,
457396,36,47,14,33,7,3,4,40,11,29
457402,36,74,60,14,7,6,1,67,54,13
457411,36,210,190,20,143,126,17,67,64,3
457420,36,159,11,148,114,10,104,45,1,44
457439,36,132,2,130,60,1,59,72,1,71
457448,36,60,1,59,60,1,59,,,
457466,36,28,21,7,28,21,7,,,
457475,36,91,3,88,91,3,88,,,
457484,36,71,33,38,32,18,14,39,15,24
457493,36,51,3,48,51,3,48,,,
457527,36,147,17,130,8,1,7,139,16,123
457536,36,458,79,379,458,79,379,,,
457545,36,76,3,73,59,2,57,17,1,16
457554,36,5,0,5,3,0,3,2,0,2
457563,36,199,4,195,199,4,195,,,
457572,36,110,2,108,110,2,108,,,
457581,36,110,1,109,106,1,105,4,0,4
457606,36,10,0,10,10,0,10,,,
457615,36,42,6,36,,,,42,6,36
457624,36,27,7,20,27,7,20,,,
457633,36,181,6,175,60,1,59,121,5,116
457642,36,33,0,33,33,0,33,,,
457679,36,21,1,20,21,1,20,,,
457697,36,66,28,38,9,3,6,57,25,32
457749,36,71,3,68,71,3,68,,,
457767,36,59,33,26,59,33,26,,,
457776,36,155,13,142,153,12,141,2,1,1
457785,36,19,0,19,19,0,19,,,
457794,36,5,0,5,5,0,5,,,
457800,36,7,0,7,7,0,7,,,
457819,36,520,197,323,,,,520,197,323
457837,36,112,5,107,49,4,45,63,1,62
457855,36,56,2,54,40,1,39,16,1,15
457873,36,84,63,21,43,34,9,41,29,12
457916,36,53,2,51,20,0,20,33,2,31
457925,36,11,5,6,11,5,6,,,
457943,36,26,6,20,26,6,20,,,
457952,36,150,2,148,121,2,119,29,0,29
457989,36,24,0,24,24,0,24,,,
458007,36,6,0,6,4,0,4,2,0,2
458034,36,18,2,16,18,2,16,,,
458043,36,73,1,72,49,1,48,24,0,24
458061,36,38,2,36,20,2,18,18,0,18
458070,36,237,13,224,224,13,211,13,0,13
458098,36,73,0,73,66,0,66,7,0,7
458104,36,224,1,223,4,0,4,220,1,219
458113,36,47,18,29,1,0,1,46,18,28
458122,36,13,0,13,13,0,13,,,
458131,36,40,1,39,40,1,39,,,
458140,36,11,10,1,11,10,1,,,
458168,36,49,3,46,49,3,46,,,
458210,36,2720,612,2108,2108,470,1638,612,142,470
458229,36,2330,500,1830,1877,397,1480,453,103,350
458274,36,173,5,168,145,5,140,28,0,28
458405,36,96,15,81,94,15,79,2,0,2
458441,36,208,28,180,205,28,177,3,0,3
458496,36,63,31,32,44,22,22,19,9,10
458681,36,216,26,190,216,26,190,,,
458803,36,99,0,99,64,0,64,35,0,35
458812,36,55,3,52,43,2,41,12,1,11
458821,36,25,1,24,25,1,24,,,
458830,36,97,1,96,75,0,75,22,1,21
458858,36,151,3,148,80,1,79,71,2,69
458867,36,117,2,115,79,2,77,38,0,38
458885,36,221,31,190,6,1,5,215,30,185
458919,36,3369,707,2662,318,149,169,3051,558,2493
458955,36,198,34,164,9,2,7,189,32,157
458964,36,1276,273,1003,92,54,38,1184,219,965
458973,36,1727,454,1273,192,106,86,1535,348,1187
458982,36,136,69,67,108,53,55,28,16,12
459019,36,30,2,28,23,1,22,7,1,6
459046,36,29,2,27,21,1,20,8,1,7
459055,36,30,1,29,16,0,16,14,1,13
459064,36,40,2,38,26,0,26,14,2,12
459116,36,81,7,74,81,7,74,,,
459170,36,255,27,228,127,25,102,128,2,126
459189,36,85,0,85,62,0,62,23,0,23
459198,36,322,55,267,230,50,180,92,5,87
459204,36,3022,430,2592,3022,430,2592,,,
459213,36,2233,492,1741,2233,492,1741,,,
459231,36,204,18,186,204,18,186,,,
459259,36,174,24,150,135,20,115,39,4,35
459268,36,154,22,132,122,14,108,32,8,24
459277,36,249,21,228,249,21,228,,,
459286,36,164,21,143,123,14,109,41,7,34
459295,36,41,1,40,13,1,12,28,0,28
459301,36,91,5,86,71,3,68,20,2,18
459329,36,144,109,35,144,109,35,,,
459347,36,74,1,73,15,0,15,59,1,58
459374,36,31,4,27,13,4,9,18,0,18
459392,36,129,6,123,77,6,71,52,0,52
459408,36,41,6,35,26,1,25,15,5,10
459417,36,35,24,11,25,19,6,10,5,5
459426,36,67,0,67,67,0,67,,,
459499,36,21,4,17,21,4,17,,,
459514,36,39,8,31,39,8,31,,,
459523,36,1,0,1,1,0,1,,,
459532,36,62,0,62,8,0,8,54,0,54
459541,36,15,0,15,4,0,4,11,0,11
459550,36,88,0,88,77,0,77,11,0,11
459578,36,99,29,70,70,17,53,29,12,17
459727,36,285,83,202,167,46,121,118,37,81
459824,36,10,0,10,10,0,10,,,
459842,36,522,56,466,270,29,241,252,27,225
459851,36,325,37,288,164,22,142,161,15,146
459949,36,4598,1590,3008,2503,859,1644,2095,731,1364
459958,36,167,45,122,167,45,122,,,
459967,36,450,184,266,450,184,266,,,
459985,36,389,192,197,389,192,197,,,
459994,36,6185,1932,4253,388,182,206,5797,1750,4047
460011,36,172,0,172,119,0,119,53,0,53
460020,36,308,46,262,308,46,262,,,
460093,36,16,1,15,16,1,15,,,
460109,36,49,0,49,49,0,49,,,
460118,36,31,0,31,31,0,31,,,
460127,36,35,0,35,35,0,35,,,
460136,36,700,114,586,700,114,586,,,
460145,36,82,47,35,82,47,35,,,
460172,36,408,361,47,406,359,47,2,2,0
460181,36,499,83,416,499,83,416,,,
460190,36,263,44,219,263,44,219,,,
460206,36,426,118,308,426,118,308,,,
460349,36,1210,341,869,360,87,273,850,254,596
460376,36,3,2,1,3,2,1,,,
460385,36,70,10,60,70,10,60,,,
460394,36,4245,1741,2504,682,282,400,3563,1459,2104
460464,36,4308,2043,2265,784,428,356,3524,1615,1909
460482,36,131,8,123,131,8,123,,,
460525,36,2,0,2,2,0,2,,,
460534,36,35,0,35,35,0,35,,,
460543,36,816,782,34,816,782,34,,,
460677,36,230,45,185,173,34,139,57,11,46
460701,36,165,19,146,40,8,32,125,11,114
460756,36,42,1,41,35,1,34,7,0,7
460765,36,1,0,1,1,0,1,,,
460808,36,1,0,1,1,0,1,,,
460817,36,90,19,71,89,19,70,1,0,1
460826,36,323,55,268,318,53,265,5,2,3
460835,36,119,17,102,117,17,100,2,0,2
460862,36,193,5,188,99,1,98,94,4,90
460871,36,558,59,499,162,16,146,396,43,353
460914,36,283,2,281,283,2,281,,,
460932,36,11,0,11,11,0,11,,,
460969,36,210,15,195,210,15,195,,,
460978,36,155,3,152,73,2,71,82,1,81
460987,36,71,0,71,71,0,71,,,
460996,36,159,2,157,119,2,117,40,0,40
461014,36,614,42,572,614,42,572,,,
461023,36,363,50,313,357,49,308,6,1,5
461032,36,94,46,48,33,20,13,61,26,35
461087,36,242,105,137,123,39,84,119,66,53
461111,36,16,14,2,15,14,1,1,0,1
461148,36,584,362,222,584,362,222,,,
461175,36,154,13,141,94,11,83,60,2,58
461193,36,175,1,174,170,1,169,5,0,5
461218,36,660,50,610,660,50,610,,,
461245,36,32,11,21,8,1,7,24,10,14
461254,36,13,1,12,13,1,12,,,
461263,36,130,10,120,130,10,120,,,
461272,36,77,0,77,42,0,42,35,0,35
461281,36,80,6,74,64,4,60,16,2,14
461306,36,33,8,25,12,5,7,21,3,18
461315,36,68,19,49,17,5,12,51,14,37
461324,36,791,169,622,754,161,593,37,8,29
461342,36,82,0,82,53,0,53,29,0,29
461379,36,26,5,21,3,0,3,23,5,18
461388,36,40,13,27,40,13,27,,,
461412,36,36,9,27,,,,36,9,27
461421,36,197,11,186,195,11,184,2,0,2
461430,36,454,420,34,,,,454,420,34
461494,36,137,13,124,76,6,70,61,7,54
461500,36,25,2,23,19,1,18,6,1,5
461528,36,130,68,62,53,27,26,77,41,36
461537,36,28,0,28,27,0,27,1,0,1
461555,36,82,2,80,82,2,80,,,
461573,36,66,66,0,66,66,0,,,
461582,36,126,2,124,126,2,124,,,
461591,36,113,5,108,112,5,107,1,0,1
461607,36,72,10,62,28,7,21,44,3,41
461625,36,10,10,0,10,10,0,,,
461643,36,4,0,4,4,0,4,,,
461652,36,78,5,73,78,5,73,,,
461689,36,217,22,195,217,22,195,,,
461704,36,79,4,75,74,3,71,5,1,4
461713,36,32,0,32,15,0,15,17,0,17
461722,36,6,0,6,6,0,6,,,
461740,36,16,14,2,16,14,2,,,
461759,36,90,51,39,71,41,30,19,10,9
461768,36,141,4,137,97,3,94,44,1,43
461786,36,4,0,4,4,0,4,,,
461795,36,231,173,58,215,161,54,16,12,4
461810,36,2,0,2,1,0,1,1,0,1
461829,36,82,20,62,82,20,62,,,
461838,36,101,2,99,53,1,52,48,1,47
461847,36,36,36,0,36,36,0,,,
461856,36,19,7,12,19,7,12,,,
461865,36,3,0,3,3,0,3,,,
461874,36,56,6,50,56,6,50,,,
461883,36,38,19,19,27,15,12,11,4,7
461892,36,63,8,55,63,8,55,,,
461908,36,74,0,74,73,0,73,1,0,1
461917,36,173,0,173,107,0,107,66,0,66
461926,36,61,1,60,43,1,42,18,0,18
461944,36,71,0,71,71,0,71,,,
461962,36,34,14,20,34,14,20,,,
461999,36,33,0,33,32,0,32,1,0,1
462008,36,221,13,208,144,11,133,77,2,75
462017,36,96,15,81,96,15,81,,,
462035,36,156,46,110,42,3,39,114,43,71
462053,36,42,1,41,42,1,41,,,
462062,36,90,0,90,50,0,50,40,0,40
462071,36,154,31,123,150,30,120,4,1,3
462336,36,54,4,50,54,4,50,,,
462345,36,9,0,9,4,0,4,5,0,5
462354,36,132,69,63,121,62,59,11,7,4
463056,36,825,383,442,759,349,410,66,34,32
464226,36,688,359,329,512,288,224,176,71,105
466921,36,302,17,285,77,2,75,225,15,210
466930,36,1740,231,1509,356,53,303,1384,178,1206
467094,36,136,1,135,136,1,135,,,
467368,36,40,4,36,40,4,36,,,
467863,36,222,39,183,175,30,145,47,9,38
467872,36,257,10,247,181,8,173,76,2,74
467906,36,139,2,137,106,2,104,33,0,33
468246,36,74,8,66,74,8,66,,,
468255,36,10,1,9,10,1,9,,,
468291,36,59,3,56,59,3,56,,,
468769,36,139,136,3,139,136,3,,,
468848,36,704,358,346,704,358,346,,,
468893,36,152,5,147,92,4,88,60,1,59
468909,36,828,326,502,828,326,502,,,
468963,36,155,142,13,155,142,13,,,
469416,36,231,46,185,144,39,105,87,7,80
469610,36,4,1,3,4,1,3,,,
469629,36,93,82,11,93,82,11,,,
469911,36,20,0,20,20,0,20,,,
469957,36,24,0,24,24,0,24,,,
470038,36,995,460,535,995,460,535,,,
470047,36,35,11,24,35,11,24,,,
470296,36,5,0,5,5,0,5,,,
470393,36,132,7,125,47,4,43,85,3,82
474863,36,946,189,757,314,63,251,632,126,506
474915,36,212,2,210,100,0,100,112,2,110
474924,36,90,3,87,20,1,19,70,2,68
475015,36,162,1,161,162,1,161,,,
475024,36,166,55,111,166,55,111,,,
475033,36,5,1,4,,,,5,1,4
475060,36,147,11,136,145,11,134,2,0,2
475121,36,4319,878,3441,2828,599,2229,1491,279,1212
475176,36,509,280,229,509,280,229,,,
475200,36,142,39,103,28,9,19,114,30,84
475273,36,245,42,203,36,5,31,209,37,172
475282,36,86,23,63,86,23,63,,,
475325,36,30,0,30,30,0,30,,,
475398,36,55,28,27,10,7,3,45,21,24
475404,36,131,2,129,69,1,68,62,1,61
475422,36,69,5,64,12,0,12,57,5,52
475431,36,30,3,27,30,3,27,,,
475468,36,275,4,271,75,2,73,200,2,198
475477,36,162,61,101,56,41,15,106,20,86
475486,36,238,45,193,142,17,125,96,28,68
475547,36,97,18,79,47,12,35,50,6,44
475556,36,136,10,126,81,5,76,55,5,50
475565,36,457,232,225,367,186,181,90,46,44
475574,36,33,14,19,16,4,12,17,10,7
475608,36,96,64,32,59,41,18,37,23,14
475635,36,18,5,13,4,2,2,14,3,11
475653,36,18,0,18,17,0,17,1,0,1
475662,36,36,0,36,20,0,20,16,0,16
475705,36,21,5,16,21,5,16,,,
475714,36,270,224,46,243,209,34,27,15,12
475723,36,223,132,91,77,33,44,146,99,47
475732,36,1136,101,1035,258,25,233,878,76,802
475741,36,172,14,158,68,5,63,104,9,95
475839,36,93,32,61,33,12,21,60,20,40
476063,36,161,150,11,161,150,11,,,
476179,36,99,8,91,64,4,60,35,4,31
476230,36,15,1,14,15,1,14,,,
476355,36,28,12,16,28,12,16,,,
476489,36,66,51,15,66,51,15,,,
476498,36,187,119,68,187,119,68,,,
476513,36,31,0,31,31,0,31,,,
476540,36,106,2,104,74,1,73,32,1,31
476559,36,102,6,96,60,4,56,42,2,40
476568,36,2,2,0,2,2,0,,,
476595,36,49,7,42,49,7,42,,,
476601,36,60,60,0,60,60,0,,,
476610,36,27,16,11,27,16,11,,,
476629,36,128,5,123,128,5,123,,,
476683,36,163,4,159,161,4,157,2,0,2
476692,36,24,24,0,24,24,0,,,
476708,36,135,103,32,116,88,28,19,15,4
476717,36,443,443,0,443,443,0,,,
476726,36,258,52,206,258,52,206,,,
476735,36,15,11,4,15,11,4,,,
476753,36,200,6,194,101,5,96,99,1,98
476780,36,75,4,71,64,4,60,11,0,11
476799,36,305,56,249,305,56,249,,,
476805,36,37,0,37,37,0,37,,,
476814,36,364,261,103,,,,364,261,103
476841,36,223,21,202,145,14,131,78,7,71
476850,36,64,45,19,64,45,19,,,
476869,36,33,2,31,33,2,31,,,
476878,36,67,0,67,30,0,30,37,0,37
476887,36,84,1,83,81,1,80,3,0,3
476896,36,115,54,61,115,54,61,,,
476902,36,54,1,53,34,0,34,20,1,19
476939,36,500,36,464,500,36,464,,,
476957,36,5,0,5,4,0,4,1,0,1
476975,36,4954,2283,2671,1249,604,645,3705,1679,2026
476984,36,208,12,196,165,9,156,43,3,40
476993,36,187,2,185,187,2,185,,,
477002,36,25,3,22,24,3,21,1,0,1
477039,36,851,110,741,537,71,466,314,39,275
477233,36,92,40,52,92,40,52,,,
478582,36,106,6,100,79,5,74,27,1,26
478591,36,68,1,67,38,0,38,30,1,29
478616,36,67,7,60,46,5,41,21,2,19
478917,36,33,1,32,33,1,32,,,
478953,36,166,4,162,166,4,162,,,
479062,36,78,75,3,50,48,2,28,27,1
479424,36,249,31,218,249,31,218,,,
479956,36,6477,3099,3378,2625,1139,1486,3852,1960,1892
479965,36,117,13,104,117,13,104,,,
479974,36,71,29,42,67,29,38,4,0,4
479983,36,94,14,80,94,14,80,,,
479992,36,19,18,1,2,1,1,17,17,0
480000,36,47,30,17,46,29,17,1,1,0
480019,36,323,263,60,265,210,55,58,53,5
480028,36,16,13,3,14,12,2,2,1,1
480037,36,758,547,211,758,547,211,,,
480073,36,216,35,181,165,25,140,51,10,41
480091,36,4012,336,3676,2666,218,2448,1346,118,1228
480125,36,244,9,235,109,2,107,135,7,128
480161,36,11,1,10,11,1,10,,,
480198,36,234,73,161,179,58,121,55,15,40
480204,36,326,53,273,326,53,273,,,
480310,36,53,0,53,45,0,45,8,0,8
480471,36,653,379,274,653,379,274,,,
480523,36,40,3,37,40,3,37,,,
480532,36,26,1,25,26,1,25,,,
480550,36,14,0,14,14,0,14,,,
480569,36,670,256,414,417,150,267,253,106,147
480657,36,411,47,364,197,22,175,214,25,189
480727,36,2,2,0,2,2,0,,,
480781,36,61,50,11,54,44,10,7,6,1
480824,36,354,34,320,354,34,320,,,
480833,36,683,75,608,683,75,608,,,
480842,36,14,5,9,14,5,9,,,
480851,36,23,9,14,23,9,14,,,
480879,36,46,4,42,46,4,42,,,
480888,36,108,46,62,108,46,62,,,
480903,36,327,290,37,292,258,34,35,32,3
480921,36,77,65,12,77,65,12,,,
480930,36,36,0,36,27,0,27,9,0,9
480967,36,137,45,92,67,28,39,70,17,53
480976,36,54,5,49,54,5,49,,,
480985,36,237,1,236,237,1,236,,,
480994,36,112,4,108,86,4,82,26,0,26
481003,36,75,57,18,75,57,18,,,
481021,36,15,14,1,14,13,1,1,1,0
481049,36,18,4,14,18,4,14,,,
481058,36,90,35,55,75,28,47,15,7,8
481085,36,226,19,207,226,19,207,,,
481100,36,15,2,13,6,1,5,9,1,8
481128,36,72,11,61,60,11,49,12,0,12
481137,36,46,21,25,46,21,25,,,
481146,36,49,5,44,25,0,25,24,5,19
481155,36,47,24,23,47,24,23,,,
481182,36,32,5,27,32,5,27,,,
481191,36,126,16,110,126,16,110,,,
481207,36,99,13,86,99,13,86,,,
481225,36,11,8,3,11,8,3,,,
481243,36,206,0,206,60,0,60,146,0,146
481252,36,53,7,46,53,7,46,,,
481289,36,88,22,66,88,22,66,,,
481298,36,45,1,44,45,1,44,,,
481313,36,34,0,34,19,0,19,15,0,15
481322,36,11,1,10,5,0,5,6,1,5
481331,36,31,22,9,31,22,9,,,
481340,36,12,0,12,12,0,12,,,
481368,36,62,5,57,62,5,57,,,
481386,36,205,22,183,4,0,4,201,22,179
481401,36,158,101,57,22,15,7,136,86,50
481410,36,56,56,0,56,56,0,,,
481429,36,50,11,39,50,11,39,,,
481438,36,43,43,0,43,43,0,,,
481447,36,5,1,4,3,1,2,2,0,2
481456,36,12,0,12,4,0,4,8,0,8
481465,36,68,2,66,51,1,50,17,1,16
481474,36,126,2,124,117,2,115,9,0,9
481483,36,70,3,67,36,1,35,34,2,32
481517,36,73,5,68,41,3,38,32,2,30
481526,36,177,1,176,177,1,176,,,
481571,36,3,1,2,3,1,2,,,
481678,36,41,1,40,25,1,24,16,0,16
481720,36,31,2,29,20,1,19,11,1,10
481739,36,31,2,29,21,2,19,10,0,10
481748,36,59,2,57,44,2,42,15,0,15
481775,36,179,56,123,179,56,123,,,
481845,36,46,2,44,31,1,30,15,1,14
481863,36,40,3,37,40,3,37,,,
481890,36,24,0,24,24,0,24,,,
481906,36,24,1,23,24,1,23,,,
481960,36,126,103,23,126,103,23,,,
482015,36,583,418,165,583,418,165,,,
482060,36,43,5,38,43,5,38,,,
482097,36,266,119,147,252,117,135,14,2,12
482149,36,3528,1225,2303,2855,959,1896,673,266,407
482158,36,4559,2025,2534,2658,1231,1427,1901,794,1107
482167,36,61,1,60,14,0,14,47,1,46
482176,36,198,8,190,148,6,142,50,2,48
482185,36,15,9,6,15,9,6,,,
482194,36,106,17,89,83,13,70,23,4,19
482200,36,43,11,32,43,11,32,,,
482228,36,94,60,34,28,20,8,66,40,26
482246,36,7,4,3,7,4,3,,,
482255,36,268,242,26,178,162,16,90,80,10
482291,36,1091,512,579,1091,512,579,,,
482413,36,394,201,193,215,127,88,179,74,105
482422,36,58,37,21,26,16,10,32,21,11
482431,36,923,548,375,473,284,189,450,264,186
482459,36,265,115,150,99,43,56,166,72,94
482468,36,492,204,288,216,96,120,276,108,168
482477,36,13462,4714,8748,4658,1846,2812,8804,2868,5936
482547,36,10,6,4,4,3,1,6,3,3
482556,36,69,42,27,30,16,14,39,26,13
482565,36,8,3,5,2,1,1,6,2,4
482574,36,215,108,107,102,59,43,113,49,64
482635,36,82,54,28,46,32,14,36,22,14
482653,36,49,27,22,29,15,14,20,12,8
482680,36,11261,4871,6390,7418,3176,4242,3843,1695,2148
482699,36,904,274,630,550,177,373,354,97,257
482705,36,1312,490,822,318,36,282,994,454,540
482936,36,1004,829,175,874,718,156,130,111,19
482963,36,315,44,271,315,44,271,,,
482981,36,112,95,17,78,66,12,34,29,5
482990,36,170,13,157,170,13,157,,,
483009,36,4,2,2,4,2,2,,,
483018,36,93,28,65,93,28,65,,,
483036,36,1270,505,765,430,197,233,840,308,532
483045,36,3619,1107,2512,1093,387,706,2526,720,1806
483054,36,89,65,24,89,65,24,,,
483106,36,151,21,130,102,15,87,49,6,43
483124,36,31824,11783,20041,13435,4278,9157,18389,7505,10884
483212,36,1931,600,1331,802,319,483,1129,281,848
483221,36,2,1,1,2,1,1,,,
483230,36,120,112,8,98,91,7,22,21,1
483258,36,2,2,0,2,2,0,,,
483276,36,38,32,6,38,32,6,,,
483328,36,81,11,70,61,9,52,20,2,18
483337,36,140,6,134,87,4,83,53,2,51
483346,36,48,3,45,48,3,45,,,
483355,36,182,6,176,182,6,176,,,
483364,36,120,8,112,120,8,112,,,
483373,36,127,18,109,113,17,96,14,1,13
483382,36,106,103,3,106,103,3,,,
483425,36,39,2,37,39,2,37,,,
483470,36,49,3,46,49,3,46,,,
483504,36,247,74,173,247,74,173,,,
483513,36,22,14,8,22,14,8,,,
483559,36,34,6,28,22,4,18,12,2,10
483577,36,8,1,7,4,1,3,4,0,4
483595,36,2919,672,2247,1804,423,1381,1115,249,866
483647,36,28,1,27,28,1,27,,,
483708,36,73,12,61,24,6,18,49,6,43
483726,36,15,0,15,5,0,5,10,0,10
483735,36,38,2,36,22,2,20,16,0,16
483744,36,62,51,11,62,51,11,,,
483753,36,38,34,4,14,11,3,24,23,1
483780,36,77,53,24,70,48,22,7,5,2
483799,36,34,5,29,34,5,29,,,
483814,36,474,37,437,424,32,392,50,5,45
483823,36,294,194,100,294,194,100,,,
483841,36,1,0,1,1,0,1,,,
483850,36,3,0,3,3,0,3,,,
483869,36,12,2,10,12,2,10,,,
483878,36,143,16,127,143,16,127,,,
483887,36,26,6,20,26,6,20,,,
483896,36,181,7,174,27,2,25,154,5,149
483911,36,16,0,16,16,0,16,,,
483920,36,96,51,45,96,51,45,,,
483948,36,32,24,8,28,21,7,4,3,1
483957,36,36,10,26,36,10,26,,,
484002,36,1236,92,1144,1209,91,1118,27,1,26
484011,36,94,16,78,78,16,62,16,0,16
484020,36,15,10,5,8,6,2,7,4,3
484048,36,42,27,15,42,27,15,,,
484057,36,186,6,180,27,1,26,159,5,154
484066,36,168,10,158,168,10,158,,,
484075,36,8,5,3,7,4,3,1,1,0
484084,36,54,0,54,41,0,41,13,0,13
484093,36,134,3,131,81,1,80,53,2,51
484109,36,87,1,86,87,1,86,,,
484127,36,83,12,71,83,12,71,,,
484136,36,15,4,11,15,4,11,,,
484163,36,46,13,33,29,7,22,17,6,11
484172,36,3,1,2,3,1,2,,,
484190,36,9,7,2,9,7,2,,,
484206,36,90,1,89,56,1,55,34,0,34
484233,36,134,82,52,,,,134,82,52
484330,36,16,0,16,16,0,16,,,
484349,36,25,0,25,25,0,25,,,
484358,36,36,1,35,36,1,35,,,
484367,36,239,32,207,239,32,207,,,
484376,36,412,46,366,412,46,366,,,
484394,36,105,15,90,64,6,58,41,9,32
484473,36,3124,1512,1612,1403,700,703,1721,812,909
484604,36,267,6,261,108,2,106,159,4,155
484613,36,57482,16895,40587,57482,16895,40587,,,
484631,36,435,276,159,435,276,159,,,
484710,36,30,22,8,30,22,8,,,
484756,36,54,26,28,54,26,28,,,
484844,36,473,202,271,473,202,271,,,
484862,36,1,0,1,1,0,1,,,
484871,36,79,79,0,79,79,0,,,
484899,36,137,5,132,137,5,132,,,
484905,36,2072,685,1387,1086,343,743,986,342,644
484923,36,44,0,44,34,0,34,10,0,10
484932,36,799,272,527,526,211,315,273,61,212
484950,36,64,5,59,64,5,59,,,
484996,36,99,1,98,99,1,98,,,
485014,36,64,3,61,39,3,36,25,0,25
485032,36,146,9,137,75,5,70,71,4,67
485111,36,2690,1075,1615,1426,605,821,1264,470,794
485166,36,71,16,55,71,16,55,,,
485236,36,61,2,59,20,0,20,41,2,39
485272,36,828,83,745,487,46,441,341,37,304
485342,36,109,82,27,109,82,27,,,
485360,36,33,1,32,33,1,32,,,
485379,36,155,35,120,155,35,120,,,
485388,36,170,19,151,170,19,151,,,
485397,36,82,1,81,51,1,50,31,0,31
485412,36,92,15,77,92,15,77,,,
485458,36,1125,316,809,298,74,224,827,242,585
485476,36,73,1,72,73,1,72,,,
485485,36,110,13,97,110,13,97,,,
485494,36,56,51,5,50,46,4,6,5,1
485500,36,49,48,1,6,6,0,43,42,1
485519,36,274,166,108,239,145,94,35,21,14
485546,36,94,50,44,4,1,3,90,49,41
485564,36,119,8,111,110,8,102,9,0,9
485573,36,167,23,144,161,22,139,6,1,5
485591,36,23,0,23,23,0,23,,,
485607,36,32,3,29,20,1,19,12,2,10
485698,36,114,102,12,112,102,10,2,0,2
485704,36,7,1,6,2,0,2,5,1,4
485768,36,276,180,96,276,180,96,,,
485801,36,49,7,42,49,7,42,,,
485856,36,37,9,28,14,4,10,23,5,18
485874,36,141,3,138,84,3,81,57,0,57
485926,36,159,44,115,158,43,115,1,1,0
485962,36,33,23,10,21,13,8,12,10,2
485999,36,62,62,0,62,62,0,,,
486017,36,11,11,0,11,11,0,,,
486026,36,75,75,0,75,75,0,,,
486053,36,82,48,34,68,40,28,14,8,6
486123,36,23,8,15,23,8,15,,,
486150,36,43,14,29,27,8,19,16,6,10
486169,36,26,21,5,26,21,5,,,
486196,36,94,94,0,94,94,0,,,
486202,36,12,1,11,12,1,11,,,
486239,36,59,28,31,45,22,23,14,6,8
486248,36,27,27,0,27,27,0,,,
486257,36,221,96,125,162,68,94,59,28,31
486284,36,156,41,115,145,39,106,11,2,9
486345,36,99,96,3,45,43,2,54,53,1
486354,36,28,13,15,28,13,15,,,
486372,36,83,62,21,76,57,19,7,5,2
486381,36,175,16,159,175,16,159,,,
486390,36,4,2,2,4,2,2,,,
486406,36,4,0,4,4,0,4,,,
486415,36,434,74,360,434,74,360,,,
486424,36,71,9,62,62,7,55,9,2,7
486442,36,1,1,0,1,1,0,,,
486488,36,20,17,3,17,15,2,3,2,1
486497,36,65,61,4,63,59,4,2,2,0
486503,36,31,1,30,31,1,30,,,
486512,36,269,132,137,269,132,137,,,
486530,36,129,2,127,129,2,127,,,
486558,36,192,177,15,112,100,12,80,77,3
486567,36,206,7,199,205,7,198,1,0,1
486576,36,32,12,20,32,12,20,,,
486619,36,133,5,128,102,5,97,31,0,31
486691,36,76,2,74,46,2,44,30,0,30
486707,36,44,3,41,44,3,41,,,
486716,36,39,1,38,39,1,38,,,
486752,36,31,2,29,31,2,29,,,
486770,36,67,14,53,67,14,53,,,
486798,36,776,687,89,776,687,89,,,
486813,36,524,101,423,524,101,423,,,
486822,36,600,62,538,600,62,538,,,
486840,36,28141,14116,14025,19795,9833,9962,8346,4283,4063
486859,36,25,0,25,25,0,25,,,
486877,36,4,0,4,4,0,4,,,
486886,36,9,0,9,5,0,5,4,0,4
486901,36,498,249,249,481,237,244,17,12,5
486938,36,467,76,391,159,26,133,308,50,258
486947,36,521,64,457,213,19,194,308,45,263
486956,36,1064,134,930,334,46,288,730,88,642
486965,36,225,86,139,225,86,139,,,
486983,36,39,18,21,39,18,21,,,
487010,36,80,9,71,68,7,61,12,2,10
487047,36,39,0,39,39,0,39,,,
487065,36,58,1,57,58,1,57,,,
487083,36,22,0,22,22,0,22,,,
487092,36,626,294,332,626,294,332,,,
487162,36,2054,497,1557,787,202,585,1267,295,972
487232,36,70,3,67,70,3,67,,,
487302,36,356,73,283,355,73,282,1,0,1
487311,36,411,365,46,411,365,46,,,
487320,36,5671,3742,1929,2222,1685,537,3449,2057,1392
487348,36,92,1,91,38,1,37,54,0,54
487375,36,921,128,793,654,95,559,267,33,234
487384,36,387,117,270,387,117,270,,,
487393,36,424,176,248,424,176,248,,,
487409,36,485,178,307,485,178,307,,,
487418,36,469,149,320,469,149,320,,,
487427,36,427,134,293,427,134,293,,,
487436,36,492,80,412,492,80,412,,,
487445,36,316,120,196,316,120,196,,,
487454,36,275,78,197,275,78,197,,,
487472,36,648,193,455,648,193,455,,,
487481,36,1138,358,780,1138,358,780,,,
487490,36,709,115,594,709,115,594,,,
487506,36,36,2,34,5,0,5,31,2,29
487524,36,1660,675,985,1417,591,826,243,84,159
487533,36,93,1,92,33,1,32,60,0,60
487588,36,229,7,222,229,7,222,,,
487597,36,801,773,28,801,773,28,,,
487603,36,361,137,224,192,65,127,169,72,97
487621,36,24,21,3,21,18,3,3,3,0
487658,36,63,58,5,63,58,5,,,
487676,36,183,12,171,93,1,92,90,11,79
487746,36,19,19,0,19,19,0,,,
487773,36,22,2,20,13,0,13,9,2,7
487791,36,348,321,27,193,178,15,155,143,12
487807,36,47,31,16,31,23,8,16,8,8
487816,36,10,0,10,10,0,10,,,
487852,36,13,3,10,,,,13,3,10
487861,36,233,33,200,179,26,153,54,7,47
487889,36,29,4,25,29,4,25,,,
487898,36,5,3,2,4,2,2,1,1,0
487904,36,11,8,3,11,8,3,,,
487922,36,56,0,56,44,0,44,12,0,12
487959,36,66,0,66,55,0,55,11,0,11
487968,36,72,6,66,72,6,66,,,
487977,36,1786,135,1651,1551,41,1510,235,94,141
487995,36,36,8,28,26,8,18,10,0,10
488004,36,13,13,0,13,13,0,,,
488013,36,39,1,38,36,1,35,3,0,3
488022,36,63,35,28,48,25,23,15,10,5
488031,36,31,13,18,30,13,17,1,0,1
488059,36,186,64,122,186,64,122,,,
488068,36,35,5,30,10,2,8,25,3,22
488077,36,639,612,27,441,418,23,198,194,4
488110,36,43,7,36,18,1,17,25,6,19
488129,36,7,0,7,3,0,3,4,0,4
488138,36,120,2,118,120,2,118,,,
488147,36,16,0,16,16,0,16,,,
488174,36,33,19,14,29,16,13,4,3,1
488183,36,14,1,13,14,1,13,,,
488192,36,30,29,1,30,29,1,,,
488217,36,66,4,62,66,4,62,,,
488226,36,4,2,2,4,2,2,,,
488253,36,42,25,17,25,17,8,17,8,9
488262,36,2,2,0,1,1,0,1,1,0
488271,36,30,0,30,30,0,30,,,
488280,36,34,28,6,34,28,6,,,
488299,36,9,0,9,8,0,8,1,0,1
488305,36,72,49,23,50,33,17,22,16,6
488314,36,49,49,0,49,49,0,,,
488332,36,190,23,167,190,23,167,,,
488350,36,58,58,0,58,58,0,,,
488369,36,61,46,15,61,46,15,,,
488378,36,43,1,42,42,1,41,1,0,1
488396,36,16,15,1,2,2,0,14,13,1
488411,36,73,1,72,73,1,72,,,
488420,36,146,18,128,,,,146,18,128
488439,36,27,18,9,23,16,7,4,2,2
488448,36,37,21,16,33,18,15,4,3,1
488563,36,9,5,4,8,4,4,1,1,0
488590,36,2,2,0,2,2,0,,,
488651,36,32,5,27,24,5,19,8,0,8
488679,36,3609,886,2723,3263,801,2462,346,85,261
488721,36,494,451,43,88,77,11,406,374,32
488730,36,3328,1376,1952,483,231,252,2845,1145,1700
488749,36,35,10,25,30,10,20,5,0,5
488776,36,114,39,75,68,22,46,46,17,29
488785,36,129,60,69,118,54,64,11,6,5
488800,36,642,173,469,642,173,469,,,
488837,36,12,0,12,12,0,12,,,
488846,36,13442,7372,6070,6680,3672,3008,6762,3700,3062
488891,36,102,41,61,102,41,61,,,
488916,36,38,0,38,38,0,38,,,
488934,36,909,569,340,477,233,244,432,336,96
488952,36,22,0,22,22,0,22,,,
488961,36,32,2,30,32,2,30,,,
488970,36,19,1,18,19,1,18,,,
488989,36,115,3,112,75,0,75,40,3,37
488998,36,85,15,70,84,15,69,1,0,1
489122,36,46,2,44,20,0,20,26,2,24
489131,36,63,6,57,32,1,31,31,5,26
489140,36,37,12,25,25,0,25,12,12,0
489159,36,126,1,125,87,1,86,39,0,39
489201,36,3906,1595,2311,1119,471,648,2787,1124,1663
489238,36,52,4,48,30,3,27,22,1,21
489247,36,36,6,30,11,2,9,25,4,21
489256,36,4,3,1,3,2,1,1,1,0
489283,36,474,81,393,474,81,393,,,
489344,36,219,18,201,56,4,52,163,14,149
489353,36,511,115,396,276,63,213,235,52,183
489371,36,182,164,18,182,164,18,,,
489779,36,25425,10607,14818,4808,1761,3047,20617,8846,11771
489812,36,37,0,37,37,0,37,,,
489830,36,61,3,58,61,3,58,,,
489937,36,235,111,124,191,96,95,44,15,29
490018,36,22,19,3,22,19,3,,,
490045,36,31,13,18,16,6,10,15,7,8
490054,36,29,7,22,21,7,14,8,0,8
490081,36,12,4,8,10,4,6,2,0,2
490090,36,28,11,17,19,4,15,9,7,2
490115,36,41,34,7,41,34,7,,,
490124,36,5,2,3,5,2,3,,,
490133,36,1254,783,471,1180,747,433,74,36,38
490142,36,41,6,35,14,4,10,27,2,25
490151,36,30,1,29,25,1,24,5,0,5
490160,36,57,5,52,57,5,52,,,
490197,36,42,12,30,42,12,30,,,
490203,36,73,5,68,42,2,40,31,3,28
490221,36,2,0,2,1,0,1,1,0,1
490230,36,229,98,131,228,97,131,1,1,0
490249,36,17,15,2,17,15,2,,,
490258,36,61,6,55,61,6,55,,,
490267,36,15,12,3,10,10,0,5,2,3
490276,36,43,43,0,43,43,0,,,
490285,36,167,132,35,167,132,35,,,
490294,36,86,27,59,82,25,57,4,2,2
490300,36,66,22,44,28,1,27,38,21,17
490319,36,10,10,0,10,10,0,,,
490328,36,83,83,0,83,83,0,,,
490382,36,23,6,17,23,6,17,,,
490391,36,49,2,47,49,2,47,,,
490407,36,41,1,40,21,1,20,20,0,20
490416,36,18,12,6,18,12,6,,,
490425,36,108,2,106,108,2,106,,,
490434,36,11,0,11,11,0,11,,,
490443,36,108,0,108,108,0,108,,,
490452,36,27,1,26,13,1,12,14,0,14
490461,36,46,2,44,46,2,44,,,
490470,36,13,2,11,13,2,11,,,
490489,36,30,25,5,26,22,4,4,3,1
490498,36,4,3,1,4,3,1,,,
490504,36,16,16,0,16,16,0,,,
490513,36,20,20,0,20,20,0,,,
490522,36,5,0,5,5,0,5,,,
490531,36,25,18,7,11,8,3,14,10,4
490559,36,315,12,303,315,12,303,,,
490674,36,3,0,3,3,0,3,,,
490692,36,44,36,8,44,36,8,,,
490717,36,35,3,32,35,3,32,,,
490735,36,35,3,32,35,3,32,,,
490744,36,13,11,2,13,11,2,,,
490805,36,4337,1907,2430,3144,1490,1654,1193,417,776
490814,36,50,0,50,50,0,50,,,
490832,36,164,10,154,117,6,111,47,4,43
490841,36,110,2,108,110,2,108,,,
490869,36,284,25,259,284,25,259,,,
490878,36,321,56,265,321,56,265,,,
490896,36,67,5,62,33,2,31,34,3,31
490948,36,5,3,2,5,3,2,,,
490975,36,320,46,274,297,42,255,23,4,19
491057,36,160,160,0,160,160,0,,,
491066,36,33,1,32,10,0,10,23,1,22
491075,36,13,12,1,13,12,1,,,
491084,36,13,0,13,13,0,13,,,
491136,36,48,2,46,26,1,25,22,1,21
491145,36,52,0,52,34,0,34,18,0,18
491181,36,217,28,189,131,20,111,86,8,78
491190,36,3,2,1,3,2,1,,,
491215,36,29,28,1,29,28,1,,,
491224,36,67,4,63,36,1,35,31,3,28
491233,36,22,0,22,15,0,15,7,0,7
491242,36,52,28,24,52,28,24,,,
491251,36,46,28,18,46,28,18,,,
491260,36,53,2,51,39,2,37,14,0,14
491288,36,431,115,316,54,14,40,377,101,276
491297,36,97,40,57,10,4,6,87,36,51
491394,36,86,69,17,82,66,16,4,3,1
491446,36,29,0,29,26,0,26,3,0,3
491464,36,85,19,66,85,19,66,,,
491473,36,381,211,170,6,1,5,375,210,165
491507,36,5,0,5,5,0,5,,,
491525,36,46,29,17,24,16,8,22,13,9
491534,36,2,1,1,,,,2,1,1
491543,36,80,17,63,44,10,34,36,7,29
491552,36,2,0,2,2,0,2,,,
491570,36,1,0,1,1,0,1,,,
491589,36,21,16,5,6,4,2,15,12,3
491598,36,13,1,12,13,1,12,,,
491613,36,50,50,0,50,50,0,,,
491622,36,65,65,0,65,65,0,,,
491631,36,57,0,57,47,0,47,10,0,10
491640,36,140,140,0,140,140,0,,,
491659,36,92,53,39,92,53,39,,,
491668,36,104,3,101,104,3,101,,,
491677,36,12,7,5,3,1,2,9,6,3
491686,36,24,20,4,24,20,4,,,
491695,36,32,0,32,32,0,32,,,
491701,36,22,5,17,,,,22,5,17
491710,36,50,50,0,50,50,0,,,
491729,36,13,0,13,13,0,13,,,
491738,36,43,5,38,41,4,37,2,1,1
491747,36,16,2,14,16,2,14,,,
491756,36,25,23,2,25,23,2,,,
491765,36,66,66,0,66,66,0,,,
491774,36,108,15,93,73,8,65,35,7,28
491783,36,23,14,9,2,1,1,21,13,8
491792,36,51,3,48,51,3,48,,,
491817,36,29,0,29,29,0,29,,,
491826,36,74,0,74,74,0,74,,,
491835,36,49,0,49,49,0,49,,,
491844,36,66,25,41,43,13,30,23,12,11
491853,36,34,0,34,34,0,34,,,
491871,36,9,0,9,7,0,7,2,0,2
491880,36,65,64,1,65,64,1,,,
491899,36,79,5,74,13,0,13,66,5,61
491905,36,62,2,60,62,2,60,,,
491914,36,135,135,0,135,135,0,,,
491923,36,160,0,160,142,0,142,18,0,18
491932,36,10,9,1,10,9,1,,,
491941,36,94,4,90,94,4,90,,,
491950,36,815,103,712,43,9,34,772,94,678
491978,36,36,15,21,6,3,3,30,12,18
491996,36,19,2,17,19,2,17,,,
492005,36,26,1,25,19,1,18,7,0,7
492023,36,260,37,223,,,,260,37,223
492032,36,16,0,16,,,,16,0,16
492069,36,44,26,18,42,25,17,2,1,1
492078,36,98,97,1,,,,98,97,1
492096,36,5,0,5,5,0,5,,,
492139,36,132,113,19,132,113,19,,,
492148,36,3,0,3,3,0,3,,,
492281,36,57,40,17,57,40,17,,,
492306,36,45,11,34,,,,45,11,34
492315,36,50,5,45,,,,50,5,45
492324,36,112,4,108,,,,112,4,108
492360,36,40,16,24,29,14,15,11,2,9
492421,36,7,7,0,7,7,0,,,
492449,36,444,97,347,444,97,347,,,
492476,36,119,31,88,41,9,32,78,22,56
492607,36,1,0,1,,,,1,0,1
492643,36,69,13,56,69,13,56,,,
492652,36,14,7,7,14,7,7,,,
492661,36,203,31,172,203,31,172,,,
492689,36,181,35,146,147,30,117,34,5,29
492722,36,250,20,230,250,20,230,,,
492731,36,135,24,111,92,18,74,43,6,37
492759,36,276,21,255,121,7,114,155,14,141
492801,36,563,191,372,337,109,228,226,82,144
492935,36,6,0,6,6,0,6,,,
492953,36,77,4,73,44,3,41,33,1,32
492962,36,1781,675,1106,846,289,557,935,386,549
493071,36,352,87,265,352,87,265,,,
493080,36,198,97,101,41,24,17,157,73,84
493132,36,619,605,14,619,605,14,,,
493150,36,149,14,135,149,14,135,,,
493372,36,17,6,11,17,6,11,,,
493451,36,49,12,37,49,12,37,,,
493479,36,6,2,4,6,2,4,,,
493488,36,4,2,2,4,2,2,,,
493512,36,95,66,29,77,58,19,18,8,10
493521,36,11,9,2,10,8,2,1,1,0
493530,36,35,7,28,24,4,20,11,3,8
493549,36,74,70,4,74,70,4,,,
493558,36,2,2,0,2,2,0,,,
493567,36,42,2,40,,,,42,2,40
493576,36,6,0,6,6,0,6,,,
493585,36,39,1,38,39,1,38,,,
493594,36,24,24,0,24,24,0,,,
493600,36,115,115,0,115,115,0,,,
493619,36,14,8,6,14,8,6,,,
493628,36,134,6,128,67,1,66,67,5,62
493637,36,18,0,18,18,0,18,,,
493646,36,78,0,78,78,0,78,,,
493655,36,9,5,4,9,5,4,,,
493664,36,49,49,0,48,48,0,1,1,0
493682,36,45,4,41,43,3,40,2,1,1
493691,36,18,0,18,11,0,11,7,0,7
493707,36,51,51,0,51,51,0,,,
493716,36,48,48,0,47,47,0,1,1,0
493743,36,138,104,34,55,42,13,83,62,21
493752,36,1,0,1,1,0,1,,,
493761,36,117,42,75,22,10,12,95,32,63
493770,36,14,0,14,14,0,14,,,
493798,36,14,0,14,,,,14,0,14
493804,36,1,0,1,1,0,1,,,
493813,36,1,0,1,1,0,1,,,
493822,36,157,40,117,94,22,72,63,18,45
493831,36,36,22,14,36,22,14,,,
493868,36,25,20,5,22,17,5,3,3,0
493895,36,203,181,22,85,78,7,118,103,15
493910,36,12,1,11,3,0,3,9,1,8
493992,36,180,40,140,180,40,140,,,
494001,36,82,1,81,16,0,16,66,1,65
494029,36,15,9,6,8,6,2,7,3,4
494162,36,191,19,172,125,11,114,66,8,58
494232,36,9,0,9,6,0,6,3,0,3
494250,36,508,26,482,508,26,482,,,
494278,36,180,29,151,46,2,44,134,27,107
494287,36,277,73,204,100,25,75,177,48,129
494357,36,783,271,512,783,271,512,,,
494436,36,212,48,164,212,48,164,,,
494463,36,76,0,76,76,0,76,,,
494472,36,4,0,4,3,0,3,1,0,1
494524,36,76,4,72,75,4,71,1,0,1
494588,36,244,28,216,244,28,216,,,
494597,36,28,11,17,21,8,13,7,3,4
494603,36,185,107,78,121,71,50,64,36,28
494621,36,14,0,14,4,0,4,10,0,10
494630,36,34,19,15,30,17,13,4,2,2
494649,36,16,0,16,6,0,6,10,0,10
494658,36,52,2,50,40,2,38,12,0,12
494685,36,336,145,191,267,110,157,69,35,34
494694,36,63,0,63,63,0,63,,,
494700,36,26,2,24,26,2,24,,,
494719,36,46,28,18,22,12,10,24,16,8
494728,36,47,38,9,46,37,9,1,1,0
494737,36,122,122,0,122,122,0,,,
494746,36,320,60,260,320,60,260,,,
494755,36,26,3,23,26,3,23,,,
494764,36,139,131,8,98,91,7,41,40,1
494807,36,25,2,23,25,2,23,,,
494843,36,395,34,361,395,34,361,,,
494852,36,300,56,244,300,56,244,,,
494898,36,65,11,54,65,11,54,,,
494904,36,49,13,36,23,9,14,26,4,22
494959,36,33,8,25,5,2,3,28,6,22
494986,36,35,1,34,25,1,24,10,0,10
494995,36,16,16,0,16,16,0,,,
495013,36,186,168,18,,,,186,168,18
495031,36,49,49,0,45,45,0,4,4,0
495040,36,25,2,23,25,2,23,,,
495059,36,30,15,15,28,14,14,2,1,1
495077,36,68,5,63,68,5,63,,,
495101,36,40,6,34,40,6,34,,,
495110,36,14,13,1,14,13,1,,,
495129,36,29,23,6,29,23,6,,,
495147,36,20,9,11,8,7,1,12,2,10
495165,36,22,4,18,22,4,18,,,
495174,36,36,17,19,,,,36,17,19
495183,36,94,45,49,94,45,49,,,
495208,36,3,2,1,3,2,1,,,
495217,36,23,18,5,23,18,5,,,
495226,36,4,0,4,4,0,4,,,
495235,36,19,2,17,9,0,9,10,2,8
495244,36,12,0,12,10,0,10,2,0,2
495253,36,42,10,32,41,10,31,1,0,1
495262,36,27,0,27,13,0,13,14,0,14
495271,36,38,9,29,3,0,3,35,9,26
495280,36,21,12,9,14,9,5,7,3,4
495299,36,40,8,32,40,8,32,,,
495305,36,45,6,39,23,4,19,22,2,20
495341,36,42,32,10,42,32,10,,,
495350,36,21,8,13,21,8,13,,,
495369,36,57,7,50,30,4,26,27,3,24
495378,36,57,1,56,8,0,8,49,1,48
495387,36,32,24,8,20,14,6,12,10,2
495396,36,9,0,9,9,0,9,,,
495411,36,75,8,67,74,8,66,1,0,1
495420,36,249,28,221,149,16,133,100,12,88
495439,36,255,19,236,169,14,155,86,5,81
495448,36,448,51,397,341,32,309,107,19,88
495457,36,540,53,487,362,32,330,178,21,157
495518,36,48,2,46,26,1,25,22,1,21
495730,36,77,3,74,43,1,42,34,2,32
495776,36,20,19,1,20,19,1,,,
495794,36,229,4,225,155,2,153,74,2,72
495837,36,76,8,68,76,8,68,,,
495925,36,50,4,46,50,4,46,,,
495934,36,55,7,48,55,7,48,,,
495943,36,14,1,13,14,1,13,,,
495952,36,102,28,74,102,28,74,,,
495961,36,83,5,78,83,5,78,,,
495970,36,242,74,168,242,74,168,,,
495998,36,59,2,57,59,2,57,,,
496052,36,2,2,0,2,2,0,,,
496061,36,177,6,171,76,3,73,101,3,98
496186,36,95,82,13,94,81,13,1,1,0
496265,36,34,31,3,34,31,3,,,
496283,36,133,15,118,133,15,118,,,
496326,36,226,26,200,226,26,200,,,
496371,36,7,7,0,7,7,0,,,
496399,36,16,1,15,16,1,15,,,
496478,36,30,20,10,,,,30,20,10
496520,36,64,15,49,,,,64,15,49
496539,36,56,1,55,36,0,36,20,1,19
496618,36,33,0,33,33,0,33,,,
496627,36,116,50,66,116,50,66,,,
496636,36,130,25,105,130,25,105,,,
496645,36,52,34,18,18,4,14,34,30,4
496654,36,17,2,15,8,0,8,9,2,7
496663,36,2,1,1,1,0,1,1,1,0
496672,36,37,4,33,17,4,13,20,0,20
496681,36,130,4,126,130,4,126,,,
496690,36,32,4,28,28,3,25,4,1,3
496706,36,43,29,14,43,29,14,,,
496715,36,16,1,15,16,1,15,,,
496724,36,30,0,30,30,0,30,,,
496733,36,55,1,54,55,1,54,,,
496751,36,10,10,0,10,10,0,,,
496803,36,2,2,0,2,2,0,,,
496894,36,33,2,31,10,0,10,23,2,21
496919,36,669,310,359,669,310,359,,,
496955,36,541,202,339,541,202,339,,,
496964,36,17,10,7,17,10,7,,,
496973,36,120,20,100,82,12,70,38,8,30
496991,36,159,22,137,104,10,94,55,12,43
497000,36,144,33,111,144,33,111,,,
497037,36,398,77,321,240,46,194,158,31,127
497046,36,2056,636,1420,380,120,260,1676,516,1160
497073,36,254,7,247,107,2,105,147,5,142
497107,36,85,14,71,,,,85,14,71
497116,36,124,13,111,68,11,57,56,2,54
497125,36,38,5,33,25,3,22,13,2,11
497161,36,76,65,11,61,51,10,15,14,1
497189,36,14,0,14,14,0,14,,,
497198,36,61,3,58,35,1,34,26,2,24
497204,36,84,68,16,21,12,9,63,56,7
497213,36,20,9,11,9,5,4,11,4,7
497222,36,21,2,19,16,2,14,5,0,5
497268,36,196,21,175,140,13,127,56,8,48
497277,36,258,43,215,258,43,215,,,
497286,36,50,47,3,50,47,3,,,
497301,36,151,6,145,81,2,79,70,4,66
497310,36,74,1,73,74,1,73,,,
497329,36,227,55,172,227,55,172,,,
497338,36,13,1,12,13,1,12,,,
497356,36,6,1,5,5,1,4,1,0,1
497365,36,18,15,3,18,15,3,,,
497374,36,60,12,48,60,12,48,,,
497383,36,2,2,0,2,2,0,,,
497392,36,46,36,10,10,9,1,36,27,9
497408,36,33,19,14,24,14,10,9,5,4
497417,36,7,0,7,7,0,7,,,
497426,36,59,8,51,43,1,42,16,7,9
497435,36,62,15,47,62,15,47,,,
497444,36,11,5,6,1,0,1,10,5,5
497453,36,1,0,1,,,,1,0,1
497462,36,22,17,5,8,7,1,14,10,4
497471,36,3,0,3,1,0,1,2,0,2
497480,36,363,23,340,327,13,314,36,10,26
497499,36,19,18,1,,,,19,18,1
497684,36,29,1,28,29,1,28,,,
497736,36,3,1,2,3,1,2,,,
497745,36,104,92,12,78,71,7,26,21,5
497790,36,3,0,3,3,0,3,,,
497824,36,199,88,111,72,29,43,127,59,68
497833,36,94,36,58,86,36,50,8,0,8
497888,36,83,6,77,49,2,47,34,4,30
497897,36,184,8,176,184,8,176,,,
497903,36,3,0,3,3,0,3,,,
497912,36,54,3,51,54,3,51,,,
497949,36,456,135,321,456,135,321,,,
497958,36,404,94,310,404,94,310,,,
498003,36,140,54,86,100,40,60,40,14,26
498012,36,137,129,8,137,129,8,,,
498049,36,184,8,176,123,6,117,61,2,59
498076,36,9,1,8,4,0,4,5,1,4
498085,36,18,1,17,12,1,11,6,0,6
498094,36,19,1,18,12,1,11,7,0,7
498100,36,1,0,1,1,0,1,,,
498322,36,76,0,76,76,0,76,,,
498331,36,114,54,60,14,5,9,100,49,51
498340,36,30,2,28,30,2,28,,,
498359,36,54,0,54,29,0,29,25,0,25
498368,36,3,0,3,,,,3,0,3
498377,36,5,5,0,5,5,0,,,
498386,36,21,17,4,19,17,2,2,0,2
498401,36,23,1,22,15,1,14,8,0,8
498410,36,1,0,1,1,0,1,,,
498447,36,72,7,65,33,6,27,39,1,38
498456,36,127,17,110,90,12,78,37,5,32
498465,36,5,0,5,5,0,5,,,
498483,36,5,1,4,5,1,4,,,
498553,36,67,20,47,67,20,47,,,
498562,36,7121,2730,4391,6472,2491,3981,649,239,410
498571,36,6464,2509,3955,5453,2113,3340,1011,396,615
100654,40,10,4,6,2,1,1,8,3,5
100663,40,256,90,166,24,14,10,232,76,156
100706,40,184,87,97,2,2,0,182,85,97
100751,40,1098,357,741,72,34,38,1026,323,703
100760,40,814,373,441,6,2,4,808,371,437
100812,40,55,22,33,,,,55,22,33
100830,40,447,126,321,124,46,78,323,80,243
100858,40,145,90,55,33,19,14,112,71,41
100937,40,7,4,3,7,4,3,,,
101028,40,540,222,318,21,10,11,519,212,307
101143,40,651,322,329,54,27,27,597,295,302
101161,40,1991,1192,799,22,12,10,1969,1180,789
101189,40,205,96,109,,,,205,96,109
101240,40,906,448,458,15,7,8,891,441,450
101286,40,763,330,433,5,2,3,758,328,430
101295,40,1758,798,960,103,43,60,1655,755,900
101301,40,1004,485,519,16,8,8,988,477,511
101435,40,2,0,2,1,0,1,1,0,1
101453,40,10,4,6,4,2,2,6,2,4
101462,40,278,120,158,,,,278,120,158
101480,40,1244,521,723,158,122,36,1086,399,687
101505,40,2881,1119,1762,38,13,25,2843,1106,1737
101514,40,1614,856,758,20,11,9,1594,845,749
101569,40,365,115,250,4,0,4,361,115,246
101587,40,3,0,3,1,0,1,2,0,2
101602,40,818,467,351,14,4,10,804,463,341
101675,40,1,1,0,1,1,0,,,
101693,40,476,212,264,,,,476,212,264
101709,40,44,16,28,5,4,1,39,12,27
101736,40,2006,1087,919,5,1,4,2001,1086,915
101879,40,1806,646,1160,53,19,34,1753,627,1126
101897,40,1025,354,671,63,26,37,962,328,634
101912,40,53,24,29,,,,53,24,29
101994,40,153,84,69,2,0,2,151,84,67
102030,40,1025,384,641,2,0,2,1023,384,639
102049,40,4,2,2,,,,4,2,2
102058,40,1,0,1,,,,1,0,1
102067,40,909,341,568,16,12,4,893,329,564
102076,40,1013,405,608,33,12,21,980,393,587
102094,40,309,100,209,9,1,8,300,99,201
102234,40,1,0,1,,,,1,0,1
102270,40,17,4,13,7,2,5,10,2,8
102298,40,3,2,1,2,1,1,1,1,0
102313,40,385,159,226,5,1,4,380,158,222
102368,40,452,192,260,68,28,40,384,164,220
102395,40,14,8,6,1,0,1,13,8,5
102429,40,1498,704,794,11,10,1,1487,694,793
102553,40,3147,1257,1890,353,153,200,2794,1104,1690
102580,40,8,3,5,,,,8,3,5
102614,40,1626,533,1093,82,33,49,1544,500,1044
102632,40,760,294,466,37,13,24,723,281,442
102669,40,33,18,15,5,2,3,28,16,12
103893,40,1,1,0,1,1,0,,,
104151,40,714,359,355,119,55,64,595,304,291
104160,40,455,198,257,41,22,19,414,176,238
104179,40,772,455,317,94,41,53,678,414,264
104346,40,250,90,160,21,7,14,229,83,146
104425,40,765,327,438,31,12,19,734,315,419
104577,40,1922,807,1115,203,83,120,1719,724,995
104586,40,6,6,0,,,,6,6,0
104708,40,3535,1598,1937,336,169,167,3199,1429,1770
104717,40,1622,542,1080,44,38,6,1578,504,1074
105145,40,1229,487,742,92,37,55,1137,450,687
105154,40,4421,1882,2539,418,190,228,4003,1692,2311
105206,40,1247,427,820,137,50,87,1110,377,733
105297,40,187,58,129,4,2,2,183,56,127
105330,40,114,53,61,1,1,0,113,52,61
105349,40,1665,683,982,256,137,119,1409,546,863
105428,40,3061,1266,1795,155,64,91,2906,1202,1704
105525,40,1965,844,1121,159,81,78,1806,763,1043
105659,40,16,13,3,16,13,3,,,
105668,40,13079,5426,7653,1358,494,864,11721,4932,6789
105747,40,2820,1247,1573,153,83,70,2667,1164,1503
105792,40,1514,601,913,93,32,61,1421,569,852
105899,40,54,24,30,5,1,4,49,23,26
106148,40,3420,1482,1938,130,61,69,3290,1421,1869
106245,40,1023,481,542,84,38,46,939,443,496
106263,40,12,2,10,2,0,2,10,2,8
106342,40,7,4,3,2,2,0,5,2,3
106397,40,267,163,104,51,35,16,216,128,88
106412,40,27,14,13,,,,27,14,13
106449,40,1099,520,579,34,20,14,1065,500,565
106458,40,738,317,421,43,20,23,695,297,398
106467,40,2614,1114,1500,27,7,20,2587,1107,1480
106485,40,451,193,258,2,1,1,449,192,257
106625,40,563,236,327,32,14,18,531,222,309
106704,40,431,168,263,42,14,28,389,154,235
106713,40,75,33,42,2,1,1,73,32,41
106795,40,445,198,247,57,14,43,388,184,204
106810,40,30,11,19,1,0,1,29,11,18
106883,40,660,243,417,24,5,19,636,238,398
106980,40,531,250,281,13,5,8,518,245,273
106999,40,314,131,183,11,4,7,303,127,176
107044,40,325,136,189,,,,325,136,189
107071,40,7,3,4,2,2,0,5,1,4
107080,40,5,4,1,,,,5,4,1
107141,40,447,195,252,,,,447,195,252
107318,40,524,229,295,7,4,3,517,225,292
107327,40,754,293,461,24,9,15,730,284,446
107460,40,735,389,346,19,10,9,716,379,337
107512,40,143,51,92,,,,143,51,92
107521,40,1386,765,621,18,7,11,1368,758,610
107549,40,369,152,217,12,2,10,357,150,207
107558,40,17,6,11,6,0,6,11,6,5
107585,40,369,179,190,19,11,8,350,168,182
107600,40,3,0,3,3,0,3,,,
107619,40,618,267,351,37,13,24,581,254,327
107637,40,109,39,70,21,4,17,88,35,53
107664,40,383,147,236,42,29,13,341,118,223
107725,40,484,224,260,81,29,52,403,195,208
107743,40,238,88,150,22,4,18,216,84,132
107877,40,6,3,3,,,,6,3,3
107974,40,269,136,133,1,0,1,268,136,132
107983,40,361,124,237,11,2,9,350,122,228
107992,40,271,105,166,,,,271,105,166
108092,40,1192,564,628,138,63,75,1054,501,553
108232,40,70,28,42,9,3,6,61,25,36
108667,40,1437,593,844,84,37,47,1353,556,797
108807,40,2832,1300,1532,71,37,34,2761,1263,1498
109208,40,3368,1369,1999,168,56,112,3200,1313,1887
109350,40,1649,765,884,37,16,21,1612,749,863
109651,40,22,11,11,16,8,8,6,3,3
109785,40,4,3,1,3,2,1,1,1,0
109819,40,8775,3741,5034,198,74,124,8577,3667,4910
109907,40,388,151,237,21,5,16,367,146,221
110097,40,25,13,12,,,,25,13,12
110246,40,686,328,358,54,36,18,632,292,340
110334,40,1874,752,1122,66,28,38,1808,724,1084
110361,40,257,93,164,4,1,3,253,92,161
110370,40,11,4,7,1,0,1,10,4,6
110413,40,3,0,3,1,0,1,2,0,2
110422,40,50,26,24,46,24,22,4,2,2
110486,40,80,24,56,9,2,7,71,22,49
110495,40,90,18,72,19,3,16,71,15,56
110510,40,322,118,204,15,6,9,307,112,195
110529,40,101,32,69,17,5,12,84,27,57
110538,40,128,51,77,30,14,16,98,37,61
110547,40,66,22,44,16,6,10,50,16,34
110556,40,369,172,197,6,4,2,363,168,195
110565,40,183,57,126,39,11,28,144,46,98
110574,40,87,32,55,16,6,10,71,26,45
110583,40,151,54,97,111,42,69,40,12,28
110592,40,47,21,26,26,12,14,21,9,12
110608,40,78,24,54,52,15,37,26,9,17
110617,40,377,174,203,41,15,26,336,159,177
110635,40,4,1,3,4,1,3,,,
110644,40,20,8,12,19,8,11,1,0,1
110653,40,11,4,7,11,4,7,,,
110671,40,69,27,42,15,11,4,54,16,38
110680,40,4,0,4,,,,4,0,4
110705,40,40,12,28,,,,40,12,28
111045,40,13,4,9,13,4,9,,,
111081,40,9,2,7,9,2,7,,,
111434,40,1117,511,606,34,16,18,1083,495,588
111461,40,2098,912,1186,46,18,28,2052,894,1158
111887,40,1468,588,880,49,20,29,1419,568,851
111896,40,1480,520,960,37,8,29,1443,512,931
111920,40,986,440,546,27,15,12,959,425,534
111939,40,3896,1560,2336,289,142,147,3607,1418,2189
111948,40,204,105,99,7,1,6,197,104,93
111966,40,8,6,2,2,2,0,6,4,2
112075,40,8,4,4,,,,8,4,4
112172,40,1836,741,1095,91,36,55,1745,705,1040
112190,40,1541,657,884,65,37,28,1476,620,856
112260,40,3,0,3,3,0,3,,,
112367,40,4,2,2,4,2,2,,,
112385,40,1406,735,671,27,8,19,1379,727,652
112394,40,6,5,1,,,,6,5,1
112561,40,548,240,308,43,22,21,505,218,287
112686,40,1585,623,962,10,2,8,1575,621,954
112826,40,1275,535,740,30,16,14,1245,519,726
113096,40,1221,483,738,61,14,47,1160,469,691
113111,40,801,318,483,61,31,30,740,287,453
113193,40,2899,1516,1383,33,15,18,2866,1501,1365
113218,40,1516,629,887,76,35,41,1440,594,846
113236,40,1658,761,897,53,25,28,1605,736,869
113333,40,2041,949,1092,259,134,125,1782,815,967
113573,40,1718,730,988,97,38,59,1621,692,929
113634,40,1710,730,980,66,31,35,1644,699,945
113856,40,4356,1766,2590,108,53,55,4248,1713,2535
113980,40,3592,1802,1790,700,381,319,2892,1421,1471
114266,40,1211,547,664,78,29,49,1133,518,615
114433,40,140,89,51,,,,140,89,51
114716,40,2241,1149,1092,124,71,53,2117,1078,1039
114789,40,4128,1763,2365,273,127,146,3855,1636,2219
114813,40,1,0,1,1,0,1,,,
114859,40,1944,838,1106,70,38,32,1874,800,1074
114938,40,756,318,438,43,20,23,713,298,415
115001,40,1308,545,763,134,37,97,1174,508,666
115126,40,1325,593,732,48,21,27,1277,572,705
115296,40,1868,752,1116,119,42,77,1749,710,1039
115393,40,1292,536,756,46,21,25,1246,515,731
115409,40,16,12,4,,,,16,12,4
115755,40,88,15,73,5,2,3,83,13,70
115773,40,1,0,1,,,,1,0,1
115861,40,795,304,491,259,87,172,536,217,319
116439,40,2066,991,1075,76,45,31,1990,946,1044
116846,40,27,15,12,,,,27,15,12
117052,40,2189,1012,1177,85,46,39,2104,966,1138
117104,40,2,1,1,,,,2,1,1
117140,40,2,0,2,,,,2,0,2
117195,40,285,162,123,33,17,16,252,145,107
117247,40,2904,1269,1635,160,66,94,2744,1203,1541
117274,40,263,157,106,4,2,2,259,155,104
117627,40,47,20,27,8,4,4,39,16,23
117636,40,105,12,93,,,,105,12,93
117645,40,1732,733,999,133,56,77,1599,677,922
117672,40,363,97,266,5,1,4,358,96,262
117690,40,1588,612,976,22,9,13,1566,603,963
117706,40,2476,1063,1413,70,32,38,2406,1031,1375
117715,40,1327,495,832,13,5,8,1314,490,824
117724,40,1812,933,879,24,17,7,1788,916,872
117733,40,3331,1498,1833,91,46,45,3240,1452,1788
117751,40,269,132,137,,,,269,132,137
117788,40,2641,1073,1568,52,19,33,2589,1054,1535
117867,40,2228,867,1361,33,12,21,2195,855,1340
117894,40,1082,433,649,49,24,25,1033,409,624
117946,40,161,92,69,125,64,61,36,28,8
118347,40,635,271,364,18,11,7,617,260,357
118684,40,1201,515,686,12,4,8,1189,511,678
118693,40,14,5,9,13,5,8,1,0,1
118718,40,1881,693,1188,99,44,55,1782,649,1133
118772,40,1730,757,973,89,37,52,1641,720,921
118912,40,766,293,473,21,13,8,745,280,465
118930,40,1014,404,610,64,28,36,950,376,574
118976,40,1569,607,962,198,59,139,1371,548,823
119058,40,5,2,3,4,2,2,1,0,1
119067,40,1167,500,667,28,11,17,1139,489,650
119137,40,1518,657,861,22,12,10,1496,645,851
119164,40,3183,1380,1803,181,93,88,3002,1287,1715
119173,40,19,5,14,,,,19,5,14
119216,40,2075,788,1287,160,67,93,1915,721,1194
119270,40,47,28,19,4,0,4,43,28,15
119331,40,740,346,394,91,45,46,649,301,348
119605,40,492,136,356,57,16,41,435,120,315
120254,40,7,3,4,,,,7,3,4
120290,40,1938,1003,935,81,43,38,1857,960,897
120342,40,978,487,491,68,38,30,910,449,461
120403,40,4,1,3,4,1,3,,,
120421,40,704,303,401,12,8,4,692,295,397
120838,40,5,3,2,5,3,2,,,
120865,40,76,36,40,2,1,1,74,35,39
120883,40,28,19,9,28,19,9,,,
120953,40,552,399,153,17,6,11,535,393,142
120971,40,2598,1363,1235,132,62,70,2466,1301,1165
121044,40,2419,1114,1305,64,37,27,2355,1077,1278
121150,40,6,4,2,2,2,0,4,2,2
121309,40,5,2,3,,,,5,2,3
121345,40,17,9,8,7,3,4,10,6,4
121363,40,1356,494,862,103,38,65,1253,456,797
121619,40,3543,1621,1922,84,38,46,3459,1583,1876
121691,40,12,3,9,1,1,0,11,2,9
121707,40,795,349,446,24,10,14,771,339,432
121886,40,1745,761,984,77,36,41,1668,725,943
121901,40,2830,1118,1712,134,62,72,2696,1056,1640
122180,40,1772,695,1077,41,11,30,1731,684,1047
122205,40,2353,1057,1296,134,80,54,2219,977,1242
122296,40,30,6,24,,,,30,6,24
122339,40,2226,945,1281,49,22,27,2177,923,1254
122375,40,3194,1447,1747,116,53,63,3078,1394,1684
122384,40,2440,1135,1305,73,48,25,2367,1087,1280
122409,40,384,167,217,186,81,105,198,86,112
122436,40,100,57,43,55,33,22,45,24,21
122597,40,926,370,556,269,93,176,657,277,380
122612,40,38,18,20,15,4,11,23,14,9
122658,40,3706,1384,2322,443,162,281,3263,1222,2041
122685,40,121,14,107,121,14,107,,,
122694,40,14,1,13,14,1,13,,,
122728,40,46,19,27,1,0,1,45,19,26
122746,40,1316,553,763,34,14,20,1282,539,743
122755,40,128,51,77,100,44,56,28,7,21
122791,40,1493,666,827,33,11,22,1460,655,805
122889,40,2161,1063,1098,169,76,93,1992,987,1005
122931,40,12,7,5,9,5,4,3,2,1
122977,40,1999,872,1127,157,80,77,1842,792,1050
123013,40,2388,1028,1360,112,57,55,2276,971,1305
123165,40,7,1,6,4,0,4,3,1,2
123217,40,2790,1065,1725,167,87,80,2623,978,1645
123299,40,2609,1097,1512,455,167,288,2154,930,1224
123341,40,3235,1453,1782,90,33,57,3145,1420,1725
123457,40,25,14,11,,,,25,14,11
123484,40,272,100,172,11,7,4,261,93,168
123509,40,2485,1183,1302,62,28,34,2423,1155,1268
123527,40,1573,660,913,86,34,52,1487,626,861
123554,40,9,5,4,4,3,1,5,2,3
123563,40,1213,524,689,39,17,22,1174,507,667
123572,40,42,19,23,10,2,8,32,17,15
123800,40,1845,810,1035,112,53,59,1733,757,976
123952,40,5,2,3,5,2,3,,,
123961,40,194,98,96,128,60,68,66,38,28
124113,40,759,242,517,37,10,27,722,232,490
125028,40,1108,446,662,24,15,9,1084,431,653
125091,40,2525,915,1610,162,62,100,2363,853,1510
125170,40,2026,876,1150,143,58,85,1883,818,1065
125231,40,24,5,19,1,0,1,23,5,18
125462,40,1159,460,699,13,6,7,1146,454,692
125471,40,1758,711,1047,18,9,9,1740,702,1038
125499,40,1033,494,539,23,14,9,1010,480,530
125532,40,31,19,12,31,19,12,,,
125763,40,7,1,6,7,1,6,,,
126119,40,1220,484,736,21,8,13,1199,476,723
126182,40,281,97,184,17,5,12,264,92,172
126207,40,3730,1775,1955,388,175,213,3342,1600,1742
126289,40,7267,3445,3822,597,195,402,6670,3250,3420
126562,40,3133,1285,1848,32,10,22,3101,1275,1826
126580,40,438,193,245,26,17,9,412,176,236
126614,40,436,207,229,74,49,25,362,158,204
126669,40,2203,939,1264,203,92,111,2000,847,1153
126678,40,6,1,5,4,0,4,2,1,1
126711,40,2483,1132,1351,242,138,104,2241,994,1247
126748,40,614,281,333,47,11,36,567,270,297
126775,40,52,46,6,38,33,5,14,13,1
126818,40,627,250,377,42,23,19,585,227,358
126827,40,78,7,71,,,,78,7,71
126863,40,5104,2193,2911,315,133,182,4789,2060,2729
126915,40,88,26,62,,,,88,26,62
126942,40,2273,956,1317,78,21,57,2195,935,1260
127060,40,165,58,107,6,2,4,159,56,103
127185,40,195,73,122,23,8,15,172,65,107
127200,40,8668,4027,4641,629,279,350,8039,3748,4291
127389,40,274,118,156,52,16,36,222,102,120
127556,40,1027,525,502,79,43,36,948,482,466
127565,40,901,354,547,148,63,85,753,291,462
127617,40,827,334,493,87,33,54,740,301,439
127653,40,5,2,3,,,,5,2,3
127714,40,250,137,113,,,,250,137,113
127732,40,619,166,453,32,9,23,587,157,430
127741,40,704,264,440,12,9,3,692,255,437
127778,40,357,153,204,28,8,20,329,145,184
127820,40,2746,1160,1586,524,210,314,2222,950,1272
127884,40,3244,1611,1633,448,250,198,2796,1361,1435
127909,40,2229,986,1243,202,120,82,2027,866,1161
127918,40,159,32,127,16,3,13,143,29,114
127945,40,9,4,5,,,,9,4,5
128106,40,1764,772,992,84,29,55,1680,743,937
128151,40,370,205,165,369,204,165,1,1,0
128258,40,430,187,243,31,10,21,399,177,222
128391,40,1422,608,814,27,20,7,1395,588,807
128498,40,9,4,5,,,,9,4,5
128577,40,251,123,128,,,,251,123,128
128744,40,33,20,13,,,,33,20,13
128771,40,165,95,70,4,2,2,161,93,68
128780,40,75,13,62,2,1,1,73,12,61
128902,40,33,12,21,,,,33,12,21
129020,40,215,104,111,78,28,50,137,76,61
129154,40,229,103,126,7,6,1,222,97,125
129215,40,392,148,244,10,4,6,382,144,238
129242,40,51,39,12,,,,51,39,12
129367,40,213,73,140,,,,213,73,140
129525,40,93,38,55,2,2,0,91,36,55
129534,40,75,39,36,,,,75,39,36
129543,40,405,152,253,2,1,1,403,151,252
129695,40,440,187,253,5,3,2,435,184,251
129729,40,338,146,192,2,1,1,336,145,191
129756,40,192,67,125,4,2,2,188,65,123
129774,40,59,34,25,,,,59,34,25
129808,40,201,73,128,6,2,4,195,71,124
129941,40,52,20,32,,,,52,20,32
130004,40,585,260,325,27,16,11,558,244,314
130040,40,184,68,116,,,,184,68,116
130110,40,19,7,12,4,2,2,15,5,10
130183,40,385,184,201,1,1,0,384,183,201
130217,40,172,57,115,12,3,9,160,54,106
130226,40,52,24,28,1,0,1,51,24,27
130253,40,53,13,40,,,,53,13,40
130314,40,10,2,8,,,,10,2,8
130396,40,464,184,280,19,10,9,445,174,271
130493,40,674,230,444,9,2,7,665,228,437
130590,40,26,19,7,16,13,3,10,6,4
130606,40,293,133,160,6,4,2,287,129,158
130697,40,63,29,34,6,0,6,57,29,28
130776,40,120,61,59,,,,120,61,59
130794,40,6,2,4,6,2,4,,,
130907,40,1696,535,1161,32,13,19,1664,522,1142
130934,40,408,158,250,35,13,22,373,145,228
130943,40,817,385,432,12,8,4,805,377,428
130989,40,3,1,2,,,,3,1,2
131113,40,881,386,495,4,1,3,877,385,492
131159,40,248,127,121,189,103,86,59,24,35
131283,40,53,29,24,3,3,0,50,26,24
131399,40,145,50,95,3,3,0,142,47,95
131450,40,4,1,3,,,,4,1,3
131469,40,684,168,516,107,30,77,577,138,439
131496,40,557,434,123,39,12,27,518,422,96
131520,40,566,206,360,3,0,3,563,206,357
131876,40,192,63,129,59,16,43,133,47,86
132374,40,248,112,136,248,112,136,,,
132408,40,131,67,64,16,4,12,115,63,52
132471,40,583,244,339,16,8,8,567,236,331
132657,40,3,0,3,1,0,1,2,0,2
132675,40,2,2,0,,,,2,2,0
132693,40,3400,1321,2079,442,159,283,2958,1162,1796
132709,40,5536,1991,3545,1097,351,746,4439,1640,2799
132851,40,973,397,576,280,102,178,693,295,398
132879,40,1,1,0,,,,1,1,0
132903,40,788,443,345,579,331,248,209,112,97
132976,40,168,67,101,168,67,101,,,
133021,40,580,228,352,40,21,19,540,207,333
133386,40,2700,955,1745,460,162,298,2240,793,1447
133492,40,7,5,2,5,3,2,2,2,0
133508,40,3703,1246,2457,1355,469,886,2348,777,1571
133553,40,2378,1639,739,8,8,0,2370,1631,739
133650,40,273,96,177,28,4,24,245,92,153
133669,40,1117,474,643,554,239,315,563,235,328
133702,40,3588,1407,2181,484,182,302,3104,1225,1879
133711,40,16,2,14,13,1,12,3,1,2
133809,40,72,35,37,,,,72,35,37
133872,40,193,60,133,28,8,20,165,52,113
133881,40,250,146,104,2,0,2,248,146,102
133951,40,6411,2767,3644,884,441,443,5527,2326,3201
133960,40,23,10,13,1,0,1,22,10,12
134079,40,19,8,11,1,0,1,18,8,10
134097,40,245,98,147,104,30,74,141,68,73
134130,40,879,376,503,327,142,185,552,234,318
134237,40,6,5,1,6,5,1,,,
134291,40,59,45,14,4,4,0,55,41,14
134343,40,1228,437,791,33,16,17,1195,421,774
134422,40,3,0,3,3,0,3,,,
134495,40,30,14,16,4,0,4,26,14,12
134608,40,3381,1313,2068,531,217,314,2850,1096,1754
134945,40,22,8,14,1,0,1,21,8,13
135081,40,311,146,165,8,4,4,303,142,161
135160,40,659,237,422,87,23,64,572,214,358
135179,40,76,40,36,9,3,6,67,37,30
135188,40,1272,501,771,280,94,186,992,407,585
135276,40,576,355,221,13,4,9,563,351,212
135391,40,1337,536,801,499,195,304,838,341,497
135522,40,15,14,1,15,14,1,,,
135610,40,1,0,1,,,,1,0,1
135717,40,6707,2546,4161,631,247,384,6076,2299,3777
135726,40,289,87,202,164,51,113,125,36,89
135735,40,1087,682,405,,,,1087,682,405
136145,40,371,128,243,101,28,73,270,100,170
136172,40,305,111,194,37,19,18,268,92,176
136215,40,86,31,55,5,0,5,81,31,50
136233,40,1749,686,1063,565,204,361,1184,482,702
136303,40,35,2,33,,,,35,2,33
136330,40,631,287,344,5,4,1,626,283,343
136358,40,3845,1405,2440,460,167,293,3385,1238,2147
136400,40,2572,893,1679,596,187,409,1976,706,1270
136473,40,1732,721,1011,314,127,187,1418,594,824
136516,40,2066,749,1317,771,280,491,1295,469,826
136659,40,195,163,32,,,,195,163,32
136774,40,1,1,0,1,1,0,,,
136950,40,16,6,10,9,3,6,7,3,4
137032,40,603,238,365,3,1,2,600,237,363
137078,40,4517,1916,2601,1039,438,601,3478,1478,2000
137096,40,1691,657,1034,331,131,200,1360,526,834
137209,40,2425,1061,1364,209,136,73,2216,925,1291
137245,40,178,75,103,178,75,103,,,
137281,40,2726,1015,1711,266,96,170,2460,919,1541
137315,40,794,312,482,225,90,135,569,222,347
137351,40,1284,550,734,416,207,209,868,343,525
137476,40,2054,803,1251,43,11,32,2011,792,1219
137546,40,44,26,18,15,8,7,29,18,11
137564,40,3909,1575,2334,116,48,68,3793,1527,2266
137759,40,1327,478,849,146,44,102,1181,434,747
137847,40,9,3,6,,,,9,3,6
137856,40,73,44,29,3,3,0,70,41,29
137865,40,37,34,3,14,12,2,23,22,1
137953,40,21,7,14,,,,21,7,14
137962,40,6,2,4,,,,6,2,4
138187,40,7503,2978,4525,1876,766,1110,5627,2212,3415
138275,40,23,13,10,2,0,2,21,13,8
138293,40,7,3,4,,,,7,3,4
138309,40,1,1,0,,,,1,1,0
138354,40,485,137,348,98,33,65,387,104,283
138372,40,1077,702,375,,,,1077,702,375
138479,40,247,154,93,247,154,93,,,
138488,40,1884,1110,774,,,,1884,1110,774
138497,40,70,51,19,70,51,19,,,
138558,40,487,156,331,10,1,9,477,155,322
138600,40,83,16,67,69,14,55,14,2,12
138682,40,408,124,284,27,6,21,381,118,263
138716,40,167,56,111,30,13,17,137,43,94
138761,40,5,0,5,3,0,3,2,0,2
138813,40,1,1,0,,,,1,1,0
138840,40,259,90,169,9,7,2,250,83,167
138868,40,902,412,490,36,16,20,866,396,470
138901,40,163,81,82,22,6,16,141,75,66
138947,40,8,1,7,1,1,0,7,0,7
138956,40,481,186,295,47,21,26,434,165,269
139144,40,11,1,10,2,0,2,9,1,8
139199,40,184,44,140,2,0,2,182,44,138
139205,40,265,120,145,3,1,2,262,119,143
139250,40,335,126,209,14,5,9,321,121,200
139278,40,1663,629,1034,289,106,183,1374,523,851
139311,40,743,274,469,99,33,66,644,241,403
139357,40,435,155,280,27,13,14,408,142,266
139366,40,366,153,213,74,22,52,292,131,161
139384,40,2269,941,1328,137,79,58,2132,862,1270
139393,40,39,16,23,,,,39,16,23
139463,40,267,126,141,60,24,36,207,102,105
139621,40,359,132,227,5,1,4,354,131,223
139630,40,110,40,70,1,1,0,109,39,70
139658,40,84,41,43,73,38,35,11,3,8
139700,40,349,125,224,22,7,15,327,118,209
139719,40,13,4,9,1,0,1,12,4,8
139755,40,1036,719,317,97,73,24,939,646,293
139764,40,381,161,220,9,4,5,372,157,215
139861,40,80,36,44,16,6,10,64,30,34
139931,40,983,363,620,100,42,58,883,321,562
139940,40,485,175,310,60,26,34,425,149,276
139959,40,148,64,84,65,29,36,83,35,48
139968,40,472,172,300,21,8,13,451,164,287
139986,40,1284,418,866,83,25,58,1201,393,808
140012,40,1801,694,1107,155,61,94,1646,633,1013
140234,40,10,4,6,4,2,2,6,2,4
140243,40,1732,631,1101,60,23,37,1672,608,1064
140252,40,5,2,3,,,,5,2,3
140331,40,1829,748,1081,271,128,143,1558,620,938
140340,40,1,0,1,,,,1,0,1
140447,40,291,49,242,71,10,61,220,39,181
140553,40,3,2,1,2,2,0,1,0,1
140571,40,1,0,1,,,,1,0,1
140678,40,598,223,375,12,6,6,586,217,369
140696,40,65,22,43,19,6,13,46,16,30
140720,40,11,2,9,,,,11,2,9
140818,40,33,7,26,3,1,2,30,6,24
140872,40,45,11,34,25,5,20,20,6,14
140942,40,514,230,284,120,57,63,394,173,221
140951,40,230,63,167,34,14,20,196,49,147
140960,40,92,24,68,3,2,1,89,22,67
140988,40,252,95,157,8,3,5,244,92,152
141006,40,364,129,235,15,6,9,349,123,226
141060,40,4,0,4,1,0,1,3,0,3
141167,40,67,28,39,,,,67,28,39
141185,40,1173,435,738,113,38,75,1060,397,663
141237,40,1855,829,1026,43,15,28,1812,814,998
141255,40,1618,635,983,49,25,24,1569,610,959
141264,40,296,127,169,27,12,15,269,115,154
141325,40,104,37,67,7,0,7,97,37,60
141334,40,727,253,474,54,31,23,673,222,451
141361,40,659,210,449,45,16,29,614,194,420
141486,40,78,29,49,18,7,11,60,22,38
141565,40,212,68,144,2,1,1,210,67,143
141574,40,283,73,210,207,47,160,76,26,50
141644,40,1501,583,918,456,147,309,1045,436,609
141680,40,1174,393,781,14,5,9,1160,388,772
141796,40,1965,629,1336,53,30,23,1912,599,1313
141802,40,552,212,340,3,0,3,549,212,337
141811,40,2600,870,1730,71,26,45,2529,844,1685
141839,40,836,277,559,13,3,10,823,274,549
141981,40,422,110,312,3,1,2,419,109,310
141990,40,1375,493,882,23,5,18,1352,488,864
142090,40,1,1,0,,,,1,1,0
142115,40,5943,2622,3321,31,15,16,5912,2607,3305
142179,40,1016,457,559,34,16,18,982,441,541
142276,40,3187,1324,1863,54,29,25,3133,1295,1838
142285,40,1689,769,920,13,4,9,1676,765,911
142328,40,1400,523,877,188,64,124,1212,459,753
142443,40,1564,644,920,249,98,151,1315,546,769
142461,40,25,11,14,5,1,4,20,10,10
142522,40,810,321,489,17,8,9,793,313,480
142559,40,4565,1853,2712,122,43,79,4443,1810,2633
142957,40,5,2,3,4,2,2,1,0,1
143084,40,44,27,17,34,24,10,10,3,7
143118,40,61,8,53,,,,61,8,53
143215,40,1895,864,1031,256,109,147,1639,755,884
143279,40,1571,613,958,22,8,14,1549,605,944
143288,40,40,11,29,39,11,28,1,0,1
143297,40,2,0,2,,,,2,0,2
143358,40,10,5,5,,,,10,5,5
143613,40,581,225,356,38,11,27,543,214,329
144005,40,86,41,45,,,,86,41,45
144050,40,84,38,46,56,25,31,28,13,15
144157,40,874,308,566,221,67,154,653,241,412
144166,40,1781,594,1187,277,101,176,1504,493,1011
144175,40,964,362,602,188,67,121,776,295,481
144184,40,3042,1193,1849,364,104,260,2678,1089,1589
144193,40,2526,983,1543,324,129,195,2202,854,1348
144209,40,1579,639,940,76,39,37,1503,600,903
144218,40,3184,1176,2008,305,112,193,2879,1064,1815
144281,40,46,14,32,28,9,19,18,5,13
144351,40,43,12,31,,,,43,12,31
144564,40,732,318,414,68,26,42,664,292,372
144740,40,166,34,132,26,6,20,140,28,112
144865,40,7537,3325,4212,590,279,311,6947,3046,3901
144892,40,2330,1050,1280,3,2,1,2327,1048,1279
144944,40,2639,994,1645,278,105,173,2361,889,1472
144962,40,130,53,77,7,0,7,123,53,70
144971,40,15,0,15,1,0,1,14,0,14
145336,40,20,8,12,2,2,0,18,6,12
145372,40,46,26,20,30,18,12,16,8,8
145497,40,87,6,81,1,0,1,86,6,80
145521,40,393,173,220,61,24,37,332,149,183
145600,40,240,143,97,163,112,51,77,31,46
145619,40,16,6,10,2,1,1,14,5,9
145637,40,1089,667,422,540,355,185,549,312,237
145646,40,9,5,4,6,3,3,3,2,1
145682,40,2414,933,1481,157,68,89,2257,865,1392
145691,40,17,5,12,5,3,2,12,2,10
145707,40,282,128,154,34,15,19,248,113,135
145725,40,248,183,65,24,14,10,224,169,55
145813,40,36,11,25,13,3,10,23,8,15
145831,40,563,172,391,45,10,35,518,162,356
146205,40,1205,500,705,62,15,47,1143,485,658
146278,40,388,178,210,7,2,5,381,176,205
146296,40,1692,744,948,39,24,15,1653,720,933
146339,40,17,4,13,3,1,2,14,3,11
146348,40,459,183,276,89,30,59,370,153,217
146366,40,1592,717,875,23,8,15,1569,709,860
146418,40,863,317,546,35,8,27,828,309,519
146427,40,7,3,4,,,,7,3,4
146472,40,2674,960,1714,310,121,189,2364,839,1525
146481,40,3,2,1,2,1,1,1,1,0
146506,40,1165,517,648,31,20,11,1134,497,637
146603,40,1763,849,914,87,53,34,1676,796,880
146612,40,283,171,112,4,1,3,279,170,109
146667,40,2,1,1,,,,2,1,1
146685,40,724,242,482,89,49,40,635,193,442
146719,40,77,31,46,29,12,17,48,19,29
147004,40,4508,1940,2568,143,57,86,4365,1883,2482
147013,40,6,4,2,2,1,1,4,3,1
147244,40,105,43,62,47,20,27,58,23,35
147341,40,6,1,5,6,1,5,,,
147369,40,37,19,18,2,0,2,35,19,16
147378,40,3331,1806,1525,118,60,58,3213,1746,1467
147411,40,1145,526,619,20,8,12,1125,518,607
147536,40,193,38,155,7,0,7,186,38,148
147590,40,3,1,2,,,,3,1,2
147660,40,64,32,32,1,1,0,63,31,32
147679,40,2,2,0,1,1,0,1,1,0
147703,40,21,6,15,6,2,4,15,4,11
147767,40,156,39,117,68,12,56,88,27,61
147776,40,149,52,97,39,16,23,110,36,74
147800,40,1727,530,1197,76,24,52,1651,506,1145
147828,40,59,21,38,16,8,8,43,13,30
147916,40,2439,968,1471,350,144,206,2089,824,1265
148007,40,331,163,168,39,19,20,292,144,148
148016,40,7,3,4,3,2,1,4,1,3
148131,40,120,47,73,,,,120,47,73
148256,40,739,317,422,71,24,47,668,293,375
148292,40,709,283,426,35,13,22,674,270,404
148380,40,1318,537,781,346,110,236,972,427,545
148405,40,43,22,21,4,1,3,39,21,18
148487,40,51,15,36,4,0,4,47,15,32
148496,40,17,5,12,1,0,1,16,5,11
148584,40,24,9,15,,,,24,9,15
148627,40,18,9,9,4,1,3,14,8,6
148654,40,45,16,29,21,8,13,24,8,16
148672,40,305,142,163,23,8,15,282,134,148
148821,40,468,181,287,48,10,38,420,171,249
148876,40,10,2,8,,,,10,2,8
148937,40,742,335,407,34,17,17,708,318,390
148991,40,477,209,268,17,4,13,460,205,255
149222,40,78,26,52,19,3,16,59,23,36
149231,40,38,20,18,16,11,5,22,9,13
149310,40,77,63,14,77,63,14,,,
149365,40,1979,973,1006,148,41,107,1831,932,899
149505,40,71,24,47,51,17,34,20,7,13
149514,40,41,18,23,25,9,16,16,9,7
149532,40,2324,861,1463,116,34,82,2208,827,1381
149639,40,27,22,5,1,0,1,26,22,4
149727,40,2091,891,1200,14,9,5,2077,882,1195
149772,40,113,45,68,,,,113,45,68
149781,40,22,11,11,,,,22,11,11
149842,40,3748,1603,2145,146,54,92,3602,1549,2053
150066,40,18,7,11,,,,18,7,11
150136,40,950,397,553,2,1,1,948,396,552
150145,40,66,25,41,,,,66,25,41
150163,40,123,25,98,11,3,8,112,22,90
150172,40,1,0,1,,,,1,0,1
150400,40,20,8,12,2,0,2,18,8,10
150455,40,23,9,14,22,9,13,1,0,1
150534,40,257,114,143,8,2,6,249,112,137
150604,40,37,13,24,,,,37,13,24
150668,40,13,4,9,,,,13,4,9
150677,40,251,93,158,43,1,42,208,92,116
150756,40,2,2,0,1,1,0,1,1,0
150774,40,12,0,12,,,,12,0,12
150941,40,163,77,86,,,,163,77,86
150987,40,37909,18286,19623,1751,777,974,36158,17509,18649
151102,40,2908,1231,1677,16,6,10,2892,1225,1667
151111,40,449,162,287,47,17,30,402,145,257
151263,40,271,95,176,1,1,0,270,94,176
151290,40,149,71,78,1,1,0,148,70,78
151306,40,1864,695,1169,41,12,29,1823,683,1140
151324,40,39,20,19,,,,39,20,19
151333,40,250,87,163,4,2,2,246,85,161
151342,40,87,29,58,5,2,3,82,27,55
151351,40,259,120,139,128,57,71,131,63,68
151360,40,149,42,107,11,3,8,138,39,99
151379,40,94,30,64,4,2,2,90,28,62
151388,40,314,109,205,15,7,8,299,102,197
151777,40,28,4,24,,,,28,4,24
151786,40,286,80,206,27,7,20,259,73,186
151801,40,139,57,82,,,,139,57,82
152080,40,54,21,33,54,21,33,,,
152099,40,95,41,54,75,34,41,20,7,13
152318,40,15,12,3,10,8,2,5,4,1
152336,40,4,2,2,,,,4,2,2
152381,40,14,1,13,2,1,1,12,0,12
152390,40,28,8,20,4,1,3,24,7,17
152530,40,421,191,230,12,2,10,409,189,220
152567,40,1569,591,978,45,23,22,1524,568,956
152600,40,7,4,3,4,3,1,3,1,2
152637,40,13127,6394,6733,1232,545,687,11895,5849,6046
152992,40,85,39,46,,,,85,39,46
153001,40,55,11,44,19,3,16,36,8,28
153108,40,34,14,20,1,1,0,33,13,20
153126,40,61,25,36,1,1,0,60,24,36
153144,40,40,15,25,24,6,18,16,9,7
153162,40,2,1,1,2,1,1,,,
153214,40,11527,5150,6377,426,143,283,11101,5007,6094
153250,40,146,54,92,,,,146,54,92
153269,40,41,24,17,5,2,3,36,22,14
153278,40,5,3,2,1,1,0,4,2,2
153296,40,158,58,100,4,2,2,154,56,98
153302,40,18,7,11,,,,18,7,11
153311,40,3996,1889,2107,324,124,200,3672,1765,1907
153320,40,64,29,35,1,1,0,63,28,35
153366,40,25,15,10,,,,25,15,10
153375,40,31,17,14,,,,31,17,14
153384,40,50,28,22,3,1,2,47,27,20
153445,40,2206,938,1268,80,23,57,2126,915,1211
153472,40,1666,801,865,269,103,166,1397,698,699
153524,40,2016,874,1142,233,90,143,1783,784,999
153533,40,983,393,590,28,11,17,955,382,573
153603,40,247,103,144,61,34,27,186,69,117
153621,40,51,22,29,3,2,1,48,20,28
153630,40,2105,962,1143,282,144,138,1823,818,1005
153658,40,428,188,240,119,62,57,309,126,183
153737,40,5036,2421,2615,212,67,145,4824,2354,2470
153825,40,35,9,26,4,2,2,31,7,24
153834,40,7,1,6,1,0,1,6,1,5
153922,40,933,398,535,123,64,59,810,334,476
154004,40,11,5,6,5,1,4,6,4,2
154013,40,70,27,43,,,,70,27,43
154022,40,1088,713,375,124,82,42,964,631,333
154059,40,1109,513,596,104,60,44,1005,453,552
154095,40,164,63,101,13,5,8,151,58,93
154101,40,47,19,28,4,1,3,43,18,25
154110,40,2547,1218,1329,98,32,66,2449,1186,1263
154129,40,994,383,611,24,9,15,970,374,596
154174,40,3,3,0,,,,3,3,0
154235,40,10,4,6,4,1,3,6,3,3
154350,40,12,5,7,,,,12,5,7
154378,40,931,400,531,54,13,41,877,387,490
154396,40,794,346,448,58,15,43,736,331,405
154493,40,260,127,133,4,0,4,256,127,129
154518,40,64,32,32,6,6,0,58,26,32
154527,40,14,5,9,2,0,2,12,5,7
154572,40,2709,1151,1558,235,77,158,2474,1074,1400
154590,40,42,18,24,4,3,1,38,15,23
154642,40,910,282,628,193,57,136,717,225,492
154688,40,394,180,214,1,1,0,393,179,214
154697,40,2146,1036,1110,166,64,102,1980,972,1008
154712,40,134,53,81,1,1,0,133,52,81
154721,40,60,23,37,,,,60,23,37
154800,40,894,368,526,69,37,32,825,331,494
154855,40,73,30,43,4,1,3,69,29,40
154907,40,793,343,450,31,11,20,762,332,430
154925,40,565,314,251,85,75,10,480,239,241
154934,40,510,167,343,29,11,18,481,156,325
154952,40,590,266,324,110,79,31,480,187,293
154998,40,385,161,224,43,27,16,342,134,208
155007,40,4,3,1,,,,4,3,1
155025,40,77,37,40,24,8,16,53,29,24
155052,40,1262,705,557,47,13,34,1215,692,523
155061,40,361,165,196,34,18,16,327,147,180
155089,40,285,104,181,26,10,16,259,94,165
155098,40,668,292,376,52,32,20,616,260,356
155104,40,538,249,289,44,28,16,494,221,273
155177,40,2,1,1,,,,2,1,1
155186,40,986,438,548,25,10,15,961,428,533
155195,40,1927,943,984,90,43,47,1837,900,937
155201,40,299,83,216,15,2,13,284,81,203
155210,40,6201,2712,3489,630,337,293,5571,2375,3196
155292,40,1543,665,878,191,61,130,1352,604,748
155317,40,702,334,368,72,33,39,630,301,329
155335,40,1561,618,943,26,9,17,1535,609,926
155399,40,284,120,164,43,30,13,241,90,151
155414,40,4,3,1,,,,4,3,1
155450,40,16,10,6,1,1,0,15,9,6
155487,40,587,348,239,24,16,8,563,332,231
155496,40,11,7,4,,,,11,7,4
155511,40,3,0,3,1,0,1,2,0,2
155520,40,184,92,92,7,5,2,177,87,90
155566,40,862,411,451,36,15,21,826,396,430
155593,40,528,312,216,15,5,10,513,307,206
155618,40,362,230,132,89,74,15,273,156,117
155627,40,2,1,1,1,1,0,1,0,1
155636,40,3,1,2,,,,3,1,2
155681,40,268,102,166,37,11,26,231,91,140
155715,40,598,237,361,36,18,18,562,219,343
155812,40,105,43,62,,,,105,43,62
155830,40,585,290,295,39,24,15,546,266,280
155858,40,711,259,452,82,36,46,629,223,406
155900,40,17,10,7,1,1,0,16,9,7
155937,40,116,51,65,9,1,8,107,50,57
155973,40,64,16,48,5,3,2,59,13,46
156082,40,861,328,533,27,6,21,834,322,512
156107,40,2625,1476,1149,273,175,98,2352,1301,1051
156125,40,1745,689,1056,67,31,36,1678,658,1020
156189,40,27,11,16,,,,27,11,16
156213,40,148,47,101,6,1,5,142,46,96
156231,40,904,360,544,30,13,17,874,347,527
156286,40,68,28,40,13,3,10,55,25,30
156295,40,21,13,8,2,1,1,19,12,7
156338,40,1944,794,1150,40,16,24,1904,778,1126
156365,40,3662,1448,2214,3,1,2,3659,1447,2212
156392,40,2889,1192,1697,156,45,111,2733,1147,1586
156408,40,10,4,6,9,4,5,1,0,1
156417,40,31,29,2,,,,31,29,2
156541,40,565,241,324,40,13,27,525,228,297
156620,40,857,341,516,5,1,4,852,340,512
156648,40,1971,876,1095,379,142,237,1592,734,858
156745,40,29,13,16,2,0,2,27,13,14
156790,40,1177,591,586,53,18,35,1124,573,551
156851,40,656,222,434,33,12,21,623,210,413
156860,40,548,203,345,28,13,15,520,190,330
156921,40,5006,2242,2764,188,74,114,4818,2168,2650
157021,40,9,8,1,9,8,1,,,
157030,40,7,2,5,,,,7,2,5
157058,40,267,129,138,2,1,1,265,128,137
157076,40,53,36,17,7,2,5,46,34,12
157085,40,620,253,367,46,26,20,574,227,347
157100,40,129,60,69,31,13,18,98,47,51
157216,40,145,47,98,12,6,6,133,41,92
157289,40,2099,755,1344,70,46,24,2029,709,1320
157304,40,1701,1001,700,157,57,100,1544,944,600
157331,40,2045,940,1105,112,55,57,1933,885,1048
157377,40,16,6,10,,,,16,6,10
157386,40,3351,1286,2065,172,71,101,3179,1215,1964
157401,40,1091,303,788,35,10,25,1056,293,763
157438,40,1763,770,993,160,56,104,1603,714,889
157447,40,2099,795,1304,292,111,181,1807,684,1123
157483,40,2414,1343,1071,16,8,8,2398,1335,1063
157535,40,382,158,224,2,0,2,380,158,222
157553,40,937,439,498,56,21,35,881,418,463
157711,40,2035,950,1085,43,22,21,1992,928,1064
157739,40,1141,553,588,135,44,91,1006,509,497
157748,40,144,56,88,3,1,2,141,55,86
157757,40,132,68,64,1,0,1,131,68,63
157793,40,17,7,10,13,6,7,4,1,3
157809,40,409,164,245,,,,409,164,245
157818,40,3,2,1,,,,3,2,1
157863,40,13,8,5,3,2,1,10,6,4
157951,40,2291,830,1461,208,106,102,2083,724,1359
158088,40,324,242,82,20,19,1,304,223,81
158431,40,795,327,468,76,56,20,719,271,448
158477,40,12,6,6,12,6,6,,,
158662,40,1091,508,583,73,36,37,1018,472,546
158802,40,4,1,3,,,,4,1,3
158884,40,1012,419,593,39,18,21,973,401,572
159009,40,38,15,23,1,0,1,37,15,22
159382,40,689,259,430,47,15,32,642,244,398
159391,40,3223,1371,1852,120,78,42,3103,1293,1810
159407,40,503,158,345,9,0,9,494,158,336
159416,40,328,108,220,1,1,0,327,107,220
159568,40,65,28,37,2,2,0,63,26,37
159647,40,2490,1009,1481,376,158,218,2114,851,1263
159656,40,129,40,89,47,13,34,82,27,55
159717,40,768,309,459,101,42,59,667,267,400
159939,40,879,396,483,68,29,39,811,367,444
159966,40,506,169,337,10,5,5,496,164,332
159993,40,1520,550,970,71,22,49,1449,528,921
160010,40,179,104,75,55,43,12,124,61,63
160038,40,2162,776,1386,262,96,166,1900,680,1220
160065,40,321,139,182,6,3,3,315,136,179
160074,40,47,30,17,,,,47,30,17
160409,40,1,1,0,,,,1,1,0
160481,40,259,93,166,4,3,1,255,90,165
160579,40,472,214,258,46,21,25,426,193,233
160612,40,2859,1099,1760,8,4,4,2851,1095,1756
160621,40,670,250,420,16,8,8,654,242,412
160630,40,536,220,316,,,,536,220,316
160649,40,1085,414,671,121,46,75,964,368,596
160658,40,1018,466,552,52,30,22,966,436,530
160667,40,3293,1503,1790,44,36,8,3249,1467,1782
160755,40,295,127,168,103,54,49,192,73,119
160904,40,15,4,11,4,1,3,11,3,8
160959,40,5,1,4,4,0,4,1,1,0
160995,40,4,1,3,4,1,3,,,
161004,40,6,2,4,,,,6,2,4
161077,40,1127,519,608,15,12,3,1112,507,605
161138,40,897,450,447,34,23,11,863,427,436
161192,40,808,283,525,14,8,6,794,275,519
161217,40,1514,583,931,24,10,14,1490,573,917
161226,40,341,88,253,15,2,13,326,86,240
161235,40,544,187,357,1,1,0,543,186,357
161253,40,1054,403,651,21,9,12,1033,394,639
161299,40,4,2,2,,,,4,2,2
161341,40,724,272,452,33,9,24,691,263,428
161457,40,1446,437,1009,28,12,16,1418,425,993
161484,40,261,143,118,,,,261,143,118
161518,40,27,11,16,,,,27,11,16
161545,40,1480,619,861,33,6,27,1447,613,834
161554,40,1294,597,697,49,17,32,1245,580,665
161563,40,950,403,547,,,,950,403,547
161572,40,19,2,17,19,2,17,,,
161581,40,232,77,155,3,1,2,229,76,153
161688,40,814,315,499,28,15,13,786,300,486
161767,40,1866,736,1130,76,28,48,1790,708,1082
161864,40,944,344,600,178,80,98,766,264,502
161873,40,18,8,10,,,,18,8,10
162007,40,89,35,54,6,0,6,83,35,48
162061,40,5,2,3,,,,5,2,3
162104,40,508,210,298,62,35,27,446,175,271
162122,40,490,180,310,107,45,62,383,135,248
162168,40,521,169,352,12,2,10,509,167,342
162210,40,83,40,43,2,1,1,81,39,42
162283,40,49,18,31,,,,49,18,31
162557,40,2158,938,1220,135,61,74,2023,877,1146
162584,40,390,211,179,132,78,54,258,133,125
162609,40,212,96,116,4,1,3,208,95,113
162654,40,20,8,12,19,8,11,1,0,1
162690,40,809,296,513,95,31,64,714,265,449
162706,40,971,363,608,59,34,25,912,329,583
162760,40,20,9,11,3,1,2,17,8,9
162779,40,1272,513,759,89,42,47,1183,471,712
162928,40,401,113,288,11,2,9,390,111,279
163046,40,9,4,5,2,0,2,7,4,3
163204,40,2276,1410,866,49,32,17,2227,1378,849
163259,40,7,2,5,1,0,1,6,2,4
163268,40,68,24,44,,,,68,24,44
163286,40,371,208,163,157,80,77,214,128,86
163295,40,2,2,0,,,,2,2,0
163338,40,56,36,20,,,,56,36,20
163426,40,3780,1328,2452,963,378,585,2817,950,1867
163453,40,10,7,3,3,1,2,7,6,1
163462,40,72,34,38,25,17,8,47,17,30
163578,40,26,5,21,3,0,3,23,5,18
163657,40,1626,622,1004,75,36,39,1551,586,965
163851,40,233,115,118,7,0,7,226,115,111
163912,40,21,9,12,4,2,2,17,7,10
164076,40,127,50,77,36,15,21,91,35,56
164173,40,6,3,3,,,,6,3,3
164216,40,20,8,12,13,2,11,7,6,1
164270,40,18,9,9,6,1,5,12,8,4
164313,40,552,190,362,7,1,6,545,189,356
164447,40,25,13,12,,,,25,13,12
164492,40,78,36,42,3,2,1,75,34,41
164562,40,28,4,24,,,,28,4,24
164580,40,52,21,31,35,17,18,17,4,13
164614,40,4,3,1,1,0,1,3,3,0
164632,40,52,7,45,1,0,1,51,7,44
164641,40,1,0,1,,,,1,0,1
164739,40,61,20,41,60,19,41,1,1,0
164748,40,104,54,50,4,2,2,100,52,48
164775,40,275,86,189,11,2,9,264,84,180
164872,40,38,19,19,2,0,2,36,19,17
164924,40,231,94,137,164,61,103,67,33,34
164988,40,791,373,418,319,136,183,472,237,235
165015,40,12,5,7,4,1,3,8,4,4
165024,40,205,80,125,40,16,24,165,64,101
165033,40,902,341,561,58,21,37,844,320,524
165112,40,1179,376,803,67,18,49,1112,358,754
165167,40,184,65,119,2,1,1,182,64,118
165194,40,338,125,213,21,11,10,317,114,203
165264,40,21,1,20,,,,21,1,20
165334,40,26,13,13,6,4,2,20,9,11
165529,40,29,17,12,27,17,10,2,0,2
165574,40,9,1,8,,,,9,1,8
165644,40,1,0,1,,,,1,0,1
165662,40,8,1,7,4,1,3,4,0,4
165671,40,92,20,72,1,1,0,91,19,72
165699,40,63,34,29,14,6,8,49,28,21
165802,40,181,25,156,,,,181,25,156
165820,40,257,130,127,12,5,7,245,125,120
165866,40,258,103,155,4,3,1,254,100,154
165884,40,75,46,29,13,9,4,62,37,25
165936,40,39,13,26,17,2,15,22,11,11
165981,40,346,123,223,41,13,28,305,110,195
166018,40,3,1,2,3,1,2,,,
166027,40,1395,687,708,113,56,57,1282,631,651
166045,40,123,59,64,63,31,32,60,28,32
166054,40,8,8,0,8,8,0,,,
166124,40,21,8,13,,,,21,8,13
166133,40,543,207,336,31,14,17,512,193,319
166391,40,11,5,6,,,,11,5,6
166452,40,148,39,109,,,,148,39,109
166513,40,404,200,204,17,10,7,387,190,197
166629,40,280,116,164,91,37,54,189,79,110
166638,40,472,214,258,128,71,57,344,143,201
166647,40,759,256,503,53,31,22,706,225,481
166656,40,34,1,33,,,,34,1,33
166674,40,80,31,49,,,,80,31,49
166683,40,19,12,7,19,12,7,,,
166692,40,3,2,1,,,,3,2,1
166823,40,1175,428,747,153,61,92,1022,367,655
166850,40,164,60,104,,,,164,60,104
166887,40,3212,1387,1825,135,59,76,3077,1328,1749
166911,40,5,3,2,,,,5,3,2
166939,40,10,2,8,5,0,5,5,2,3
166957,40,526,153,373,96,30,66,430,123,307
167057,40,19,9,10,,,,19,9,10
167288,40,78,28,50,3,1,2,75,27,48
167312,40,776,248,528,38,20,18,738,228,510
167358,40,130,53,77,106,38,68,24,15,9
167376,40,1049,382,667,60,19,41,989,363,626
167394,40,65,14,51,,,,65,14,51
167525,40,504,216,288,47,25,22,457,191,266
167534,40,1217,434,783,54,21,33,1163,413,750
167598,40,26,2,24,,,,26,2,24
167631,40,66,20,46,3,1,2,63,19,44
167677,40,12,12,0,12,12,0,,,
167729,40,486,185,301,35,13,22,451,172,279
167783,40,2,0,2,1,0,1,1,0,1
167792,40,35,17,18,,,,35,17,18
167835,40,8,0,8,8,0,8,,,
167871,40,1,0,1,,,,1,0,1
167899,40,3,1,2,,,,3,1,2
167905,40,267,95,172,14,10,4,253,85,168
167987,40,186,76,110,8,3,5,178,73,105
167996,40,34,14,20,1,0,1,33,14,19
168005,40,56,19,37,27,8,19,29,11,18
168148,40,68,46,22,22,14,8,46,32,14
168218,40,94,35,59,14,0,14,80,35,45
168227,40,156,107,49,3,2,1,153,105,48
168254,40,4,2,2,,,,4,2,2
168263,40,250,95,155,9,3,6,241,92,149
168281,40,14,4,10,5,1,4,9,3,6
168342,40,31,13,18,8,2,6,23,11,12
168421,40,100,63,37,57,34,23,43,29,14
168430,40,453,214,239,5,3,2,448,211,237
168528,40,59,23,36,1,1,0,58,22,36
168546,40,9,4,5,1,0,1,8,4,4
168591,40,23,10,13,11,1,10,12,9,3
168607,40,810,337,473,92,28,64,718,309,409
168740,40,46,16,30,18,5,13,28,11,17
168786,40,62,32,30,2,2,0,60,30,30
168847,40,548,198,350,45,14,31,503,184,319
168883,40,833,366,467,77,35,42,756,331,425
169080,40,127,55,72,1,0,1,126,55,71
169248,40,104,35,69,12,5,7,92,30,62
169275,40,1279,439,840,274,97,177,1005,342,663
169327,40,3,0,3,,,,3,0,3
169363,40,108,42,66,,,,108,42,66
169442,40,134,52,82,11,5,6,123,47,76
169479,40,657,273,384,57,18,39,600,255,345
169521,40,1432,509,923,162,58,104,1270,451,819
169716,40,834,598,236,6,0,6,828,598,230
169798,40,411,176,235,117,55,62,294,121,173
169910,40,610,207,403,2,1,1,608,206,402
169974,40,504,205,299,63,32,31,441,173,268
169983,40,21,17,4,14,12,2,7,5,2
169992,40,301,123,178,54,23,31,247,100,147
170000,40,152,63,89,,,,152,63,89
170037,40,50,25,25,1,1,0,49,24,25
170055,40,1531,680,851,76,40,36,1455,640,815
170082,40,178,65,113,9,9,0,169,56,113
170091,40,1,1,0,,,,1,1,0
170240,40,2425,1056,1369,459,205,254,1966,851,1115
170286,40,11,8,3,1,0,1,10,8,2
170301,40,78,27,51,3,2,1,75,25,50
170444,40,1291,449,842,124,39,85,1167,410,757
170532,40,18,5,13,16,5,11,2,0,2
170541,40,1411,613,798,225,95,130,1186,518,668
170550,40,925,321,604,59,22,37,866,299,567
170587,40,491,243,248,8,4,4,483,239,244
170620,40,452,165,287,10,6,4,442,159,283
170639,40,187,72,115,7,3,4,180,69,111
170657,40,1363,510,853,185,65,120,1178,445,733
170675,40,434,230,204,4,4,0,430,226,204
170790,40,1590,599,991,113,62,51,1477,537,940
170806,40,73,59,14,1,0,1,72,59,13
170967,40,292,117,175,37,10,27,255,107,148
170976,40,247,130,117,171,97,74,76,33,43
171100,40,180,75,105,110,42,68,70,33,37
171128,40,66,40,26,,,,66,40,26
171137,40,154,63,91,11,2,9,143,61,82
171146,40,580,236,344,85,31,54,495,205,290
171155,40,1274,437,837,72,24,48,1202,413,789
171225,40,730,265,465,58,24,34,672,241,431
171234,40,572,178,394,6,1,5,566,177,389
171304,40,745,241,504,110,34,76,635,207,428
171395,40,572,202,370,16,7,9,556,195,361
171456,40,112,36,76,15,6,9,97,30,67
171483,40,409,150,259,16,9,7,393,141,252
171492,40,29,15,14,2,0,2,27,15,12
171535,40,1927,979,948,315,193,122,1612,786,826
171571,40,215,96,119,23,14,9,192,82,110
171599,40,1,1,0,,,,1,1,0
171881,40,1,1,0,,,,1,1,0
172033,40,32,26,6,,,,32,26,6
172051,40,257,72,185,95,27,68,162,45,117
172200,40,1015,382,633,71,34,37,944,348,596
172264,40,148,54,94,8,1,7,140,53,87
172291,40,1061,357,704,178,61,117,883,296,587
172307,40,510,247,263,31,16,15,479,231,248
172334,40,106,38,68,12,4,8,94,34,60
172440,40,64,18,46,33,10,23,31,8,23
172608,40,9,3,6,,,,9,3,6
172617,40,2672,1315,1357,546,291,255,2126,1024,1102
172635,40,3344,1392,1952,158,71,87,3186,1321,1865
172644,40,289,104,185,18,5,13,271,99,172
172671,40,329,128,201,39,14,25,290,114,176
172699,40,325,144,181,47,20,27,278,124,154
172866,40,2,2,0,2,2,0,,,
172918,40,1444,606,838,188,73,115,1256,533,723
172954,40,176,67,109,22,17,5,154,50,104
172963,40,3885,1596,2289,824,297,527,3061,1299,1762
173045,40,24,6,18,10,2,8,14,4,10
173063,40,1225,544,681,219,68,151,1006,476,530
173115,40,167,39,128,3,2,1,164,37,127
173124,40,490,165,325,32,14,18,458,151,307
173142,40,151,64,87,4,2,2,147,62,85
173160,40,502,200,302,212,92,120,290,108,182
173203,40,3085,1210,1875,614,194,420,2471,1016,1455
173258,40,52,25,27,34,19,15,18,6,12
173300,40,27,12,15,5,3,2,22,9,13
173328,40,311,112,199,67,22,45,244,90,154
173416,40,628,388,240,42,28,14,586,360,226
173452,40,58,15,43,2,1,1,56,14,42
173461,40,1384,614,770,188,74,114,1196,540,656
173559,40,2332,912,1420,262,97,165,2070,815,1255
173638,40,1651,634,1017,224,62,162,1427,572,855
173647,40,3,1,2,3,1,2,,,
173665,40,20,7,13,7,1,6,13,6,7
173708,40,1200,688,512,137,106,31,1063,582,481
173735,40,1012,369,643,427,143,284,585,226,359
173799,40,1352,484,868,205,76,129,1147,408,739
173902,40,11,1,10,8,1,7,3,0,3
173911,40,665,258,407,67,25,42,598,233,365
173920,40,1322,462,860,180,67,113,1142,395,747
174020,40,336,137,199,33,20,13,303,117,186
174066,40,8688,3642,5046,599,278,321,8089,3364,4725
174075,40,814,328,486,39,15,24,775,313,462
174127,40,13,6,7,3,0,3,10,6,4
174136,40,1415,550,865,173,66,107,1242,484,758
174233,40,1056,448,608,139,59,80,917,389,528
174251,40,44,17,27,24,11,13,20,6,14
174358,40,267,78,189,26,7,19,241,71,170
174376,40,1644,609,1035,311,123,188,1333,486,847
174428,40,3376,1247,2129,743,278,465,2633,969,1664
174437,40,66,33,33,29,10,19,37,23,14
174473,40,983,394,589,40,16,24,943,378,565
174491,40,1649,572,1077,511,180,331,1138,392,746
174507,40,114,35,79,53,21,32,61,14,47
174525,40,11,5,6,4,4,0,7,1,6
174570,40,1277,503,774,93,31,62,1184,472,712
174738,40,1342,468,874,318,97,221,1024,371,653
174747,40,15,0,15,2,0,2,13,0,13
174756,40,641,246,395,179,65,114,462,181,281
174783,40,3174,1226,1948,314,99,215,2860,1127,1733
174792,40,27,27,0,3,3,0,24,24,0
174817,40,20,12,8,4,2,2,16,10,6
174844,40,27,7,20,11,4,7,16,3,13
174862,40,494,188,306,83,29,54,411,159,252
174899,40,15,4,11,3,0,3,12,4,8
174914,40,38,17,21,5,3,2,33,14,19
175005,40,55,8,47,,,,55,8,47
175014,40,14,1,13,2,0,2,12,1,11
175041,40,1538,643,895,241,93,148,1297,550,747
175078,40,4562,1823,2739,111,52,59,4451,1771,2680
175227,40,8,6,2,,,,8,6,2
175236,40,729,232,497,263,75,188,466,157,309
175263,40,817,340,477,75,37,38,742,303,439
175272,40,149,44,105,45,14,31,104,30,74
175315,40,1773,729,1044,351,153,198,1422,576,846
175342,40,87,26,61,4,1,3,83,25,58
175421,40,87,40,47,9,1,8,78,39,39
175430,40,352,170,182,16,7,9,336,163,173
175519,40,434,149,285,,,,434,149,285
175573,40,828,290,538,96,23,73,732,267,465
175616,40,262,80,182,5,1,4,257,79,178
175643,40,742,279,463,115,50,65,627,229,398
175652,40,728,330,398,96,54,42,632,276,356
175786,40,2893,1250,1643,194,68,126,2699,1182,1517
175810,40,1047,396,651,19,10,9,1028,386,642
175829,40,869,325,544,32,10,22,837,315,522
175856,40,22,10,12,5,4,1,17,6,11
175883,40,925,390,535,31,7,24,894,383,511
175935,40,478,191,287,16,10,6,462,181,281
175980,40,5,3,2,2,1,1,3,2,1
176008,40,347,120,227,25,7,18,322,113,209
176017,40,145,77,68,91,43,48,54,34,20
176035,40,379,162,217,3,0,3,376,162,214
176044,40,485,181,304,17,6,11,468,175,293
176053,40,298,144,154,3,0,3,295,144,151
176071,40,1561,584,977,289,104,185,1272,480,792
176080,40,151,79,72,40,24,16,111,55,56
176169,40,496,177,319,1,0,1,495,177,318
176178,40,2042,773,1269,74,24,50,1968,749,1219
176239,40,883,339,544,113,50,63,770,289,481
176318,40,24,10,14,,,,24,10,14
176336,40,1,1,0,1,1,0,,,
176354,40,179,57,122,7,1,6,172,56,116
176372,40,109,32,77,6,2,4,103,30,73
176406,40,116,41,75,49,14,35,67,27,40
176479,40,1519,594,925,145,54,91,1374,540,834
176628,40,41,13,28,,,,41,13,28
176789,40,24,11,13,4,1,3,20,10,10
176910,40,5,2,3,,,,5,2,3
176947,40,6,4,2,,,,6,4,2
176965,40,1425,518,907,42,8,34,1383,510,873
177065,40,189,87,102,13,5,8,176,82,94
177083,40,2,2,0,,,,2,2,0
177135,40,1329,489,840,56,23,33,1273,466,807
177144,40,46,19,27,,,,46,19,27
177214,40,6,1,5,5,1,4,1,0,1
177250,40,942,390,552,144,60,84,798,330,468
177418,40,16,7,9,3,1,2,13,6,7
177472,40,2952,1280,1672,168,69,99,2784,1211,1573
177542,40,55,14,41,1,0,1,54,14,40
177551,40,6,2,4,2,0,2,4,2,2
177676,40,1140,487,653,138,43,95,1002,444,558
177746,40,3,2,1,1,1,0,2,1,1
177940,40,407,171,236,8,6,2,399,165,234
177968,40,181,64,117,4,3,1,177,61,116
177977,40,218,123,95,,,,218,123,95
177986,40,22,10,12,5,2,3,17,8,9
177995,40,2286,985,1301,401,184,217,1885,801,1084
178059,40,28,6,22,,,,28,6,22
178208,40,130,70,60,9,5,4,121,65,56
178217,40,800,270,530,142,41,101,658,229,429
178244,40,3041,1225,1816,64,29,35,2977,1196,1781
178341,40,807,281,526,65,13,52,742,268,474
178369,40,225,70,155,3,1,2,222,69,153
178387,40,1213,415,798,47,24,23,1166,391,775
178396,40,539,296,243,46,18,28,493,278,215
178402,40,3700,1556,2144,45,27,18,3655,1529,2126
178411,40,45,19,26,5,2,3,40,17,23
178420,40,7037,2845,4192,339,141,198,6698,2704,3994
178448,40,1994,722,1272,287,104,183,1707,618,1089
178615,40,702,290,412,12,4,8,690,286,404
178624,40,629,246,383,15,6,9,614,240,374
178679,40,11,8,3,,,,11,8,3
178697,40,6,1,5,2,0,2,4,1,3
178721,40,177,119,58,5,4,1,172,115,57
178767,40,1,1,0,,,,1,1,0
179043,40,813,294,519,4,0,4,809,294,515
179159,40,3330,1455,1875,29,25,4,3301,1430,1871
179308,40,3061,1165,1896,604,238,366,2457,927,1530
179326,40,361,148,213,24,10,14,337,138,199
179344,40,888,304,584,42,13,29,846,291,555
179539,40,1262,502,760,70,28,42,1192,474,718
179548,40,3,0,3,,,,3,0,3
179557,40,1444,537,907,110,30,80,1334,507,827
179566,40,5087,2100,2987,91,37,54,4996,2063,2933
179645,40,785,282,503,47,10,37,738,272,466
179715,40,659,212,447,20,6,14,639,206,433
179867,40,331,79,252,44,18,26,287,61,226
179894,40,23,7,16,2,0,2,21,7,14
179946,40,3,2,1,1,1,0,2,1,1
179964,40,37,26,11,1,0,1,36,26,10
180054,40,9,2,7,,,,9,2,7
180081,40,333,161,172,1,0,1,332,161,171
180106,40,17,7,10,11,5,6,6,2,4
180151,40,215,111,104,4,1,3,211,110,101
180160,40,4,2,2,2,0,2,2,2,0
180179,40,923,348,575,27,10,17,896,338,558
180197,40,1039,490,549,35,14,21,1004,476,528
180212,40,117,43,74,,,,117,43,74
180249,40,428,141,287,26,13,13,402,128,274
180276,40,815,349,466,12,6,6,803,343,460
180328,40,1,1,0,,,,1,1,0
180373,40,196,54,142,7,6,1,189,48,141
180416,40,13,5,8,,,,13,5,8
180461,40,282,124,158,70,38,32,212,86,126
180489,40,278,124,154,31,14,17,247,110,137
180522,40,289,169,120,,,,289,169,120
180595,40,11,4,7,5,2,3,6,2,4
180647,40,77,29,48,11,10,1,66,19,47
180692,40,222,57,165,3,2,1,219,55,164
180814,40,490,176,314,57,23,34,433,153,280
180878,40,63,11,52,,,,63,11,52
180902,40,3415,1440,1975,78,27,51,3337,1413,1924
180948,40,125,44,81,1,0,1,124,44,80
180984,40,1530,691,839,,,,1530,691,839
181002,40,29,16,13,12,5,7,17,11,6
181020,40,2,0,2,,,,2,0,2
181127,40,1,0,1,,,,1,0,1
181215,40,110,42,68,37,9,28,73,33,40
181303,40,7888,3839,4049,1634,770,864,6254,3069,3185
181312,40,1137,470,667,49,8,41,1088,462,626
181330,40,136,46,90,,,,136,46,90
181394,40,160,81,79,32,15,17,128,66,62
181419,40,245,106,139,5,1,4,240,105,135
181428,40,25,7,18,24,7,17,1,0,1
181446,40,15,5,10,12,4,8,3,1,2
181464,40,92,42,50,5,1,4,87,41,46
181491,40,3053,1771,1282,74,31,43,2979,1740,1239
181534,40,383,133,250,,,,383,133,250
181543,40,4,2,2,,,,4,2,2
181604,40,37,16,21,,,,37,16,21
181640,40,3434,1476,1958,96,39,57,3338,1437,1901
181738,40,132,38,94,,,,132,38,94
181765,40,61,32,29,,,,61,32,29
181783,40,803,325,478,5,1,4,798,324,474
181817,40,662,278,384,44,18,26,618,260,358
182005,40,1647,1004,643,91,45,46,1556,959,597
182281,40,1036,383,653,52,16,36,984,367,617
182290,40,1077,508,569,41,13,28,1036,495,541
182306,40,1259,478,781,152,63,89,1107,415,692
182500,40,3190,1496,1694,286,139,147,2904,1357,1547
182564,40,1675,872,803,432,154,278,1243,718,525
182634,40,53,8,45,,,,53,8,45
182670,40,46,29,17,46,29,17,,,
182795,40,3,1,2,1,0,1,2,1,1
182980,40,7,3,4,3,3,0,4,0,4
183026,40,2727,1159,1568,87,31,56,2640,1128,1512
183044,40,116,62,54,37,16,21,79,46,33
183062,40,47,29,18,6,1,5,41,28,13
183071,40,17,4,13,,,,17,4,13
183080,40,22,13,9,1,1,0,21,12,9
183099,40,411,160,251,11,8,3,400,152,248
183105,40,99,27,72,1,1,0,98,26,72
183114,40,79,31,48,6,3,3,73,28,45
183123,40,142,50,92,6,3,3,136,47,89
183132,40,286,143,143,25,19,6,261,124,137
183141,40,216,108,108,12,7,5,204,101,103
183150,40,151,64,87,11,7,4,140,57,83
183211,40,11,3,8,,,,11,3,8
183239,40,4,1,3,1,0,1,3,1,2
183248,40,2,0,2,,,,2,0,2
183257,40,61,6,55,2,0,2,59,6,53
183655,40,433,175,258,156,58,98,277,117,160
183743,40,1181,503,678,214,101,113,967,402,565
183789,40,88,34,54,1,0,1,87,34,53
183822,40,3,0,3,1,0,1,2,0,2
183859,40,1982,845,1137,52,28,24,1930,817,1113
183877,40,352,165,187,77,45,32,275,120,155
183910,40,10,5,5,,,,10,5,5
183938,40,1392,561,831,152,58,94,1240,503,737
183974,40,11,2,9,5,1,4,6,1,5
184180,40,664,317,347,127,64,63,537,253,284
184205,40,475,194,281,40,14,26,435,180,255
184348,40,94,57,37,60,46,14,34,11,23
184481,40,736,292,444,298,102,196,438,190,248
184603,40,2965,1271,1694,16,4,12,2949,1267,1682
184612,40,50,10,40,2,0,2,48,10,38
184694,40,41,21,20,3,2,1,38,19,19
184773,40,305,137,168,,,,305,137,168
184782,40,317,127,190,5,1,4,312,126,186
184791,40,931,318,613,86,29,57,845,289,556
184959,40,2,2,0,,,,2,2,0
184995,40,567,208,359,53,27,26,514,181,333
185129,40,218,67,151,39,11,28,179,56,123
185262,40,321,103,218,121,27,94,200,76,124
185509,40,876,384,492,74,44,30,802,340,462
185536,40,1836,819,1017,116,58,58,1720,761,959
185572,40,12,5,7,3,2,1,9,3,6
185590,40,388,130,258,40,13,27,348,117,231
185828,40,654,391,263,32,27,5,622,364,258
185873,40,1683,676,1007,143,49,94,1540,627,913
186034,40,476,183,293,92,32,60,384,151,233
186131,40,77,41,36,13,7,6,64,34,30
186186,40,1,1,0,1,1,0,,,
186201,40,321,95,226,17,8,9,304,87,217
186283,40,64,34,30,14,6,8,50,28,22
186371,40,108,93,15,2,1,1,106,92,14
186380,40,254,107,147,37,14,23,217,93,124
186399,40,323,121,202,7,6,1,316,115,201
186432,40,153,67,86,25,12,13,128,55,73
186469,40,244,84,160,41,9,32,203,75,128
186584,40,138,82,56,110,65,45,28,17,11
186618,40,65,2,63,,,,65,2,63
186645,40,1269,552,717,69,35,34,1200,517,683
186867,40,16,16,0,13,13,0,3,3,0
186876,40,33,9,24,10,5,5,23,4,19
187046,40,90,52,38,,,,90,52,38
187134,40,199,123,76,175,107,68,24,16,8
187198,40,342,156,186,34,20,14,308,136,172
187444,40,13,5,8,3,1,2,10,4,6
187532,40,3539,1515,2024,116,49,67,3423,1466,1957
187596,40,393,166,227,3,2,1,390,164,226
187620,40,1921,733,1188,222,90,132,1699,643,1056
187639,40,969,400,569,79,40,39,890,360,530
187648,40,934,398,536,7,2,5,927,396,531
187666,40,549,297,252,138,84,54,411,213,198
187745,40,489,212,277,1,1,0,488,211,277
187897,40,125,48,77,5,3,2,120,45,75
187903,40,93,34,59,11,4,7,82,30,52
187912,40,79,46,33,,,,79,46,33
187958,40,719,322,397,154,60,94,565,262,303
187967,40,58,15,43,,,,58,15,43
187976,40,142,68,74,5,3,2,137,65,72
187985,40,733,319,414,128,66,62,605,253,352
187994,40,488,194,294,4,3,1,484,191,293
188003,40,1172,474,698,45,19,26,1127,455,672
188021,40,464,154,310,11,2,9,453,152,301
188030,40,526,195,331,18,13,5,508,182,326
188049,40,735,340,395,7,1,6,728,339,389
188058,40,342,204,138,3,1,2,339,203,136
188100,40,1467,518,949,109,49,60,1358,469,889
188137,40,1198,491,707,86,40,46,1112,451,661
188216,40,13,4,9,12,4,8,1,0,1
188225,40,461,169,292,14,5,9,447,164,283
188261,40,401,222,179,,,,401,222,179
188304,40,595,295,300,93,60,33,502,235,267
188429,40,51,26,25,11,8,3,40,18,22
188438,40,675,341,334,28,21,7,647,320,327
188517,40,19,1,18,,,,19,1,18
188641,40,42,20,22,4,1,3,38,19,19
188942,40,1,0,1,1,0,1,,,
189088,40,122,64,58,46,24,22,76,40,36
189097,40,316,114,202,7,0,7,309,114,195
189228,40,304,155,149,224,108,116,80,47,33
189547,40,2165,1004,1161,97,47,50,2068,957,1111
189565,40,8,1,7,,,,8,1,7
189583,40,185,71,114,3,0,3,182,71,111
189592,40,2,1,1,,,,2,1,1
189705,40,38,22,16,16,8,8,22,14,8
189839,40,2328,988,1340,86,33,53,2242,955,1287
189848,40,85,44,41,8,3,5,77,41,36
190044,40,81,51,30,48,31,17,33,20,13
190053,40,572,251,321,41,21,20,531,230,301
190099,40,6,1,5,,,,6,1,5
190114,40,54,18,36,,,,54,18,36
190169,40,569,279,290,7,2,5,562,277,285
190372,40,7,2,5,6,1,5,1,1,0
190415,40,59,27,32,58,27,31,1,0,1
190442,40,2442,1054,1388,427,181,246,2015,873,1142
190512,40,342,117,225,48,13,35,294,104,190
190521,40,1142,494,648,66,30,36,1076,464,612
190530,40,646,230,416,9,8,1,637,222,415
190549,40,876,313,563,111,28,83,765,285,480
190558,40,312,160,152,19,4,15,293,156,137
190567,40,448,231,217,88,44,44,360,187,173
190576,40,127,47,80,,,,127,47,80
190585,40,512,174,338,66,35,31,446,139,307
190594,40,707,283,424,17,10,7,690,273,417
190600,40,335,80,255,2,1,1,333,79,254
190619,40,7893,4039,3854,163,76,87,7730,3963,3767
190628,40,3149,2033,1116,221,112,109,2928,1921,1007
190637,40,726,222,504,10,5,5,716,217,499
190646,40,401,160,241,114,33,81,287,127,160
190655,40,775,337,438,25,13,12,750,324,426
190664,40,893,417,476,39,17,22,854,400,454
190673,40,1193,444,749,16,5,11,1177,439,738
190691,40,1377,592,785,157,81,76,1220,511,709
190716,40,6,2,4,,,,6,2,4
190725,40,100,33,67,,,,100,33,67
190761,40,18,3,15,,,,18,3,15
190840,40,3416,1455,1961,253,94,159,3163,1361,1802
190983,40,6,4,2,1,0,1,5,4,1
191083,40,1757,785,972,67,39,28,1690,746,944
191126,40,236,51,185,19,5,14,217,46,171
191199,40,2487,1022,1465,64,31,33,2423,991,1432
191205,40,24,4,20,,,,24,4,20
191241,40,255,86,169,71,32,39,184,54,130
191302,40,819,332,487,20,8,12,799,324,475
191339,40,2297,960,1337,177,58,119,2120,902,1218
191515,40,1,0,1,,,,1,0,1
191533,40,14,2,12,8,1,7,6,1,5
191612,40,732,284,448,51,19,32,681,265,416
191621,40,14,3,11,1,0,1,13,3,10
191630,40,20,8,12,18,7,11,2,1,1
191649,40,59,39,20,24,12,12,35,27,8
191676,40,60,27,33,2,1,1,58,26,32
191719,40,2951,1319,1632,133,69,64,2818,1250,1568
191931,40,399,165,234,2,1,1,397,164,233
191968,40,18,5,13,2,1,1,16,4,12
191986,40,2160,969,1191,211,82,129,1949,887,1062
192022,40,745,303,442,45,31,14,700,272,428
192110,40,110,57,53,,,,110,57,53
192192,40,2,0,2,,,,2,0,2
192271,40,5,1,4,5,1,4,,,
192323,40,141,38,103,10,4,6,131,34,97
192448,40,5568,2533,3035,79,34,45,5489,2499,2990
192509,40,30,8,22,5,3,2,25,5,20
192712,40,5,0,5,1,0,1,4,0,4
192749,40,14,7,7,1,1,0,13,6,7
192785,40,3,0,3,,,,3,0,3
192819,40,406,189,217,5,3,2,401,186,215
192864,40,40,11,29,10,4,6,30,7,23
192925,40,2,0,2,2,0,2,,,
193016,40,869,317,552,55,17,38,814,300,514
193283,40,2687,1258,1429,205,105,100,2482,1153,1329
193292,40,64,18,46,6,3,3,58,15,43
193308,40,482,182,300,21,7,14,461,175,286
193326,40,823,397,426,18,10,8,805,387,418
193353,40,76,40,36,,,,76,40,36
193399,40,26,9,17,2,0,2,24,9,15
193478,40,1456,559,897,356,139,217,1100,420,680
193584,40,9,4,5,2,0,2,7,4,3
193654,40,35,19,16,7,5,2,28,14,14
193900,40,265,95,170,148,53,95,117,42,75
193946,40,1075,443,632,97,41,56,978,402,576
193973,40,41,12,29,38,10,28,3,2,1
194028,40,867,317,550,72,26,46,795,291,504
194091,40,174,96,78,,,,174,96,78
194116,40,29,3,26,,,,29,3,26
194161,40,7,2,5,,,,7,2,5
194222,40,3455,1747,1708,100,63,37,3355,1684,1671
194240,40,1437,619,818,81,50,31,1356,569,787
194310,40,457,201,256,30,8,22,427,193,234
194499,40,17,3,14,,,,17,3,14
194569,40,43,18,25,9,5,4,34,13,21
194578,40,47,9,38,23,6,17,24,3,21
194693,40,1,1,0,1,1,0,,,
194718,40,10,10,0,10,10,0,,,
194824,40,16,9,7,,,,16,9,7
194958,40,15,6,9,,,,15,6,9
195003,40,788,567,221,13,9,4,775,558,217
195030,40,198,88,110,24,14,10,174,74,100
195058,40,1393,619,774,28,15,13,1365,604,761
195128,40,6,1,5,,,,6,1,5
195164,40,65,28,37,,,,65,28,37
195173,40,31,10,21,19,7,12,12,3,9
195216,40,15,4,11,3,1,2,12,3,9
195234,40,12,7,5,,,,12,7,5
195243,40,843,376,467,,,,843,376,467
195304,40,45,11,34,43,11,32,2,0,2
195322,40,2166,972,1194,88,40,48,2078,932,1146
195474,40,36,12,24,2,0,2,34,12,22
195526,40,14,4,10,5,0,5,9,4,5
195544,40,25,8,17,4,1,3,21,7,14
195720,40,13,4,9,,,,13,4,9
195809,40,5571,2406,3165,28,13,15,5543,2393,3150
195988,40,872,375,497,95,42,53,777,333,444
196006,40,14,13,1,,,,14,13,1
196015,40,78,38,40,6,4,2,72,34,38
196024,40,19,10,9,,,,19,10,9
196033,40,9,5,4,,,,9,5,4
196042,40,349,157,192,104,69,35,245,88,157
196051,40,27,16,11,15,11,4,12,5,7
196060,40,89,42,47,6,0,6,83,42,41
196079,40,4,3,1,2,1,1,2,2,0
196088,40,192,88,104,35,9,26,157,79,78
196097,40,103,40,63,92,30,62,11,10,1
196103,40,17,10,7,16,10,6,1,0,1
196112,40,130,38,92,6,2,4,124,36,88
196121,40,42,14,28,2,1,1,40,13,27
196130,40,94,43,51,23,13,10,71,30,41
196149,40,13,4,9,,,,13,4,9
196158,40,19,6,13,3,1,2,16,5,11
196167,40,32,16,16,23,12,11,9,4,5
196176,40,100,23,77,1,0,1,99,23,76
196185,40,10,5,5,6,2,4,4,3,1
196194,40,28,17,11,,,,28,17,11
196200,40,4,1,3,,,,4,1,3
196219,40,57,29,28,11,8,3,46,21,25
196237,40,107,46,61,16,10,6,91,36,55
196246,40,79,39,40,13,4,9,66,35,31
196264,40,708,293,415,64,24,40,644,269,375
196291,40,4,3,1,,,,4,3,1
196307,40,1,1,0,,,,1,1,0
196389,40,2,1,1,2,1,1,,,
196413,40,350,163,187,205,64,141,145,99,46
196431,40,1,1,0,1,1,0,,,
196565,40,3026,1311,1715,138,56,82,2888,1255,1633
196592,40,855,183,672,24,3,21,831,180,651
196653,40,58,27,31,1,0,1,57,27,30
196699,40,1651,892,759,224,111,113,1427,781,646
196866,40,30,10,20,15,3,12,15,7,8
197036,40,65,49,16,65,49,16,,,
197045,40,152,33,119,16,4,12,136,29,107
197133,40,29,9,20,16,5,11,13,4,9
197142,40,10,4,6,,,,10,4,6
197151,40,15,6,9,15,6,9,,,
197197,40,15,9,6,11,7,4,4,2,2
197230,40,8,2,6,5,0,5,3,2,1
197285,40,86,26,60,,,,86,26,60
197294,40,1171,558,613,163,109,54,1008,449,559
197708,40,46,46,0,,,,46,46,0
197814,40,1153,470,683,251,96,155,902,374,528
197850,40,1774,685,1089,144,34,110,1630,651,979
197869,40,91,37,54,46,21,25,45,16,29
197887,40,2454,978,1476,359,126,233,2095,852,1243
197911,40,130,13,117,,,,130,13,117
197966,40,244,101,143,27,8,19,217,93,124
197984,40,62,28,34,2,2,0,60,26,34
198011,40,182,49,133,57,14,43,125,35,90
198039,40,959,383,576,79,33,46,880,350,530
198066,40,4,2,2,1,0,1,3,2,1
198084,40,608,225,383,100,39,61,508,186,322
198109,40,2,1,1,,,,2,1,1
198118,40,1406,612,794,278,113,165,1128,499,629
198136,40,32,21,11,3,2,1,29,19,10
198154,40,5220,3357,1863,254,219,35,4966,3138,1828
198206,40,403,138,265,24,7,17,379,131,248
198215,40,18,3,15,,,,18,3,15
198233,40,1596,719,877,151,63,88,1445,656,789
198251,40,1088,375,713,47,12,35,1041,363,678
198260,40,4172,1526,2646,797,305,492,3375,1221,2154
198321,40,574,184,390,45,16,29,529,168,361
198330,40,839,261,578,63,20,43,776,241,535
198367,40,879,367,512,127,65,62,752,302,450
198376,40,1467,576,891,337,116,221,1130,460,670
198385,40,5,1,4,5,1,4,,,
198419,40,70,24,46,46,14,32,24,10,14
198455,40,1040,363,677,79,26,53,961,337,624
198464,40,1303,323,980,32,12,20,1271,311,960
198491,40,405,174,231,20,8,12,385,166,219
198507,40,121,48,73,3,1,2,118,47,71
198534,40,1712,702,1010,152,64,88,1560,638,922
198543,40,530,165,365,150,45,105,380,120,260
198552,40,1483,513,970,197,64,133,1286,449,837
198561,40,1,1,0,,,,1,1,0
198570,40,2330,854,1476,229,83,146,2101,771,1330
198598,40,111,34,77,2,0,2,109,34,75
198613,40,107,46,61,98,43,55,9,3,6
198622,40,2032,841,1191,285,118,167,1747,723,1024
198640,40,476,190,286,63,20,43,413,170,243
198668,40,483,168,315,26,11,15,457,157,300
198695,40,71,18,53,9,3,6,62,15,47
198710,40,758,297,461,83,27,56,675,270,405
198729,40,405,179,226,60,22,38,345,157,188
198756,40,11,2,9,3,1,2,8,1,7
198774,40,1623,612,1011,202,69,133,1421,543,878
198808,40,1,1,0,,,,1,1,0
198817,40,955,371,584,185,60,125,770,311,459
198835,40,136,59,77,21,6,15,115,53,62
198899,40,14,6,8,1,0,1,13,6,7
198905,40,490,184,306,50,9,41,440,175,265
198914,40,433,211,222,68,27,41,365,184,181
198923,40,535,236,299,69,36,33,466,200,266
198950,40,28,4,24,2,0,2,26,4,22
198969,40,6,2,4,2,0,2,4,2,2
198987,40,1699,667,1032,156,64,92,1543,603,940
199023,40,460,235,225,129,60,69,331,175,156
199032,40,4,4,0,,,,4,4,0
199069,40,235,52,183,10,1,9,225,51,174
199087,40,1080,420,660,115,41,74,965,379,586
199102,40,280,164,116,114,67,47,166,97,69
199111,40,111,34,77,16,5,11,95,29,66
199120,40,108,51,57,15,4,11,93,47,46
199139,40,398,203,195,100,44,56,298,159,139
199148,40,336,115,221,134,51,83,202,64,138
199157,40,533,176,357,170,54,116,363,122,241
199184,40,5,3,2,,,,5,3,2
199193,40,1145,620,525,183,105,78,962,515,447
199209,40,45,25,20,2,0,2,43,25,18
199218,40,334,117,217,214,82,132,120,35,85
199263,40,95,29,66,13,2,11,82,27,55
199272,40,73,11,62,5,0,5,68,11,57
199281,40,99,19,80,10,2,8,89,17,72
199324,40,507,201,306,78,34,44,429,167,262
199333,40,2183,1030,1153,260,91,169,1923,939,984
199412,40,16,7,9,7,3,4,9,4,5
199421,40,1107,393,714,67,15,52,1040,378,662
199449,40,1044,417,627,241,96,145,803,321,482
199458,40,8,4,4,8,4,4,,,
199467,40,303,123,180,16,10,6,287,113,174
199476,40,298,87,211,27,10,17,271,77,194
199485,40,697,249,448,56,20,36,641,229,412
199494,40,2559,996,1563,350,138,212,2209,858,1351
199582,40,148,60,88,98,32,66,50,28,22
199607,40,33,2,31,,,,33,2,31
199625,40,699,247,452,56,22,34,643,225,418
199634,40,1408,550,858,78,21,57,1330,529,801
199643,40,6,2,4,5,1,4,1,1,0
199722,40,474,188,286,76,31,45,398,157,241
199731,40,846,377,469,62,29,33,784,348,436
199740,40,921,342,579,112,31,81,809,311,498
199759,40,221,102,119,4,2,2,217,100,117
199768,40,1283,492,791,177,74,103,1106,418,688
199786,40,1214,504,710,241,93,148,973,411,562
199795,40,468,201,267,89,32,57,379,169,210
199838,40,1137,405,732,346,124,222,791,281,510
199847,40,1,1,0,1,1,0,,,
199856,40,3549,1327,2222,276,88,188,3273,1239,2034
199865,40,26,6,20,15,6,9,11,0,11
199892,40,828,291,537,40,16,24,788,275,513
199908,40,469,171,298,42,19,23,427,152,275
199926,40,1073,463,610,70,37,33,1003,426,577
199953,40,886,344,542,57,21,36,829,323,506
199962,40,1,0,1,,,,1,0,1
199999,40,64,23,41,2,1,1,62,22,40
200004,40,147,31,116,54,25,29,93,6,87
200013,40,1,0,1,,,,1,0,1
200022,40,1210,496,714,23,16,7,1187,480,707
200059,40,263,117,146,1,0,1,262,117,145
200086,40,35,9,26,1,0,1,34,9,25
200156,40,10,6,4,4,3,1,6,3,3
200192,40,1116,461,655,9,3,6,1107,458,649
200208,40,45,9,36,5,2,3,40,7,33
200217,40,357,161,196,,,,357,161,196
200226,40,310,104,206,4,2,2,306,102,204
200253,40,362,130,232,1,1,0,361,129,232
200280,40,862,529,333,13,6,7,849,523,326
200305,40,1174,541,633,18,7,11,1156,534,622
200314,40,672,276,396,8,2,6,664,274,390
200332,40,301,165,136,45,23,22,256,142,114
200341,40,276,97,179,3,1,2,273,96,177
200466,40,4,2,2,,,,4,2,2
200484,40,8,5,3,,,,8,5,3
200527,40,89,29,60,1,1,0,88,28,60
200554,40,4,0,4,,,,4,0,4
200572,40,607,217,390,97,5,92,510,212,298
200800,40,1224,502,722,85,40,45,1139,462,677
200846,40,819,333,486,38,16,22,781,317,464
200873,40,9,5,4,,,,9,5,4
201104,40,751,253,498,100,21,79,651,232,419
201140,40,3,3,0,,,,3,3,0
201177,40,5,3,2,2,0,2,3,3,0
201195,40,36,16,20,20,9,11,16,7,9
201283,40,233,71,162,9,3,6,224,68,156
201371,40,15,9,6,1,1,0,14,8,6
201432,40,763,275,488,46,15,31,717,260,457
201441,40,1630,701,929,85,29,56,1545,672,873
201548,40,33,12,21,12,2,10,21,10,11
201645,40,90,47,43,29,19,10,61,28,33
201654,40,682,289,393,20,9,11,662,280,382
201672,40,1149,440,709,71,30,41,1078,410,668
201690,40,11,3,8,1,1,0,10,2,8
201751,40,105,40,65,30,14,16,75,26,49
201821,40,6,1,5,,,,6,1,5
201885,40,1783,831,952,151,68,83,1632,763,869
201928,40,2903,1034,1869,89,34,55,2814,1000,1814
201946,40,5248,2294,2954,97,41,56,5151,2253,2898
201955,40,2642,1042,1600,41,22,19,2601,1020,1581
201964,40,510,195,315,17,6,11,493,189,304
201973,40,1586,640,946,95,34,61,1491,606,885
202046,40,9,6,3,4,2,2,5,4,1
202073,40,4,3,1,4,3,1,,,
202134,40,274,139,135,28,14,14,246,125,121
202222,40,8917,3645,5272,505,229,276,8412,3416,4996
202356,40,4130,1559,2571,266,108,158,3864,1451,2413
202435,40,21,0,21,15,0,15,6,0,6
202480,40,67,30,37,16,5,11,51,25,26
202514,40,8,2,6,7,2,5,1,0,1
202523,40,10,4,6,,,,10,4,6
202648,40,3020,1184,1836,660,263,397,2360,921,1439
202763,40,1538,615,923,43,16,27,1495,599,896
202806,40,530,111,419,46,18,28,484,93,391
202903,40,151,76,75,6,1,5,145,75,70
202912,40,24,0,24,7,0,7,17,0,17
203085,40,20,3,17,1,0,1,19,3,16
203128,40,265,102,163,7,2,5,258,100,158
203155,40,186,62,124,31,8,23,155,54,101
203331,40,1690,647,1043,90,36,54,1600,611,989
203368,40,59,18,41,31,7,24,28,11,17
203447,40,392,124,268,5,1,4,387,123,264
203456,40,288,81,207,1,1,0,287,80,207
203465,40,841,290,551,23,5,18,818,285,533
203474,40,263,100,163,7,3,4,256,97,159
203483,40,349,134,215,28,14,14,321,120,201
203492,40,307,121,186,1,0,1,306,121,185
203517,40,1239,481,758,133,62,71,1106,419,687
203526,40,578,203,375,7,0,7,571,203,368
203535,40,8,2,6,,,,8,2,6
203544,40,73,32,41,,,,73,32,41
203580,40,76,35,41,11,5,6,65,30,35
203599,40,1429,534,895,241,101,140,1188,433,755
203678,40,2150,929,1221,92,31,61,2058,898,1160
203748,40,3687,1483,2204,332,119,213,3355,1364,1991
203757,40,204,57,147,2,0,2,202,57,145
203775,40,129,67,62,3,0,3,126,67,59
203845,40,45,13,32,1,0,1,44,13,31
203881,40,1491,577,914,59,25,34,1432,552,880
203960,40,14,6,8,,,,14,6,8
204006,40,186,62,124,41,14,27,145,48,97
204015,40,323,124,199,63,24,39,260,100,160
204024,40,143,64,79,32,16,16,111,48,63
204185,40,24,9,15,8,2,6,16,7,9
204194,40,147,64,83,21,11,10,126,53,73
204200,40,378,164,214,5,2,3,373,162,211
204255,40,963,358,605,120,37,83,843,321,522
204264,40,48,21,27,,,,48,21,27
204422,40,1189,505,684,208,107,101,981,398,583
204440,40,3002,903,2099,281,242,39,2721,661,2060
204468,40,262,92,170,19,7,12,243,85,158
204486,40,1,1,0,,,,1,1,0
204617,40,51,23,28,8,5,3,43,18,25
204635,40,167,76,91,12,5,7,155,71,84
204662,40,25,7,18,8,2,6,17,5,12
204671,40,87,37,50,20,10,10,67,27,40
204680,40,105,43,62,5,1,4,100,42,58
204699,40,67,32,35,12,6,6,55,26,29
204705,40,144,70,74,15,7,8,129,63,66
204796,40,983,465,518,174,87,87,809,378,431
204802,40,855,309,546,8,2,6,847,307,540
204820,40,1170,420,750,20,8,12,1150,412,738
204839,40,1472,489,983,14,3,11,1458,486,972
204848,40,1361,482,879,16,4,12,1345,478,867
204857,40,502,179,323,43,20,23,459,159,300
204866,40,1363,474,889,17,6,11,1346,468,878
204909,40,9,1,8,8,1,7,1,0,1
204936,40,76,28,48,31,10,21,45,18,27
204945,40,3261,2222,1039,170,99,71,3091,2123,968
205203,40,1070,371,699,574,204,370,496,167,329
205443,40,666,244,422,81,28,53,585,216,369
205470,40,4968,2300,2668,257,145,112,4711,2155,2556
205841,40,3823,1619,2204,307,115,192,3516,1504,2012
205957,40,180,77,103,17,9,8,163,68,95
205966,40,1199,419,780,142,44,98,1057,375,682
206011,40,1112,668,444,59,22,37,1053,646,407
206048,40,354,126,228,5,2,3,349,124,225
206084,40,1178,440,738,129,45,84,1049,395,654
206279,40,13,0,13,,,,13,0,13
206349,40,7,1,6,,,,7,1,6
206394,40,4,0,4,,,,4,0,4
206437,40,104,47,57,13,9,4,91,38,53
206446,40,620,234,386,10,6,4,610,228,382
206491,40,4,0,4,,,,4,0,4
206507,40,4,2,2,1,0,1,3,2,1
206525,40,23,12,11,7,3,4,16,9,7
206589,40,7,1,6,,,,7,1,6
206604,40,611,264,347,37,18,19,574,246,328
206613,40,310,111,199,10,1,9,300,110,190
206622,40,15,8,7,,,,15,8,7
206695,40,1081,434,647,89,21,68,992,413,579
206862,40,4,2,2,,,,4,2,2
206905,40,243,145,98,,,,243,145,98
206914,40,490,190,300,16,4,12,474,186,288
206923,40,690,226,464,182,61,121,508,165,343
206941,40,339,138,201,10,6,4,329,132,197
206996,40,341,133,208,11,3,8,330,130,200
207041,40,146,54,92,3,1,2,143,53,90
207050,40,299,121,178,3,1,2,296,120,176
207069,40,982,390,592,77,40,37,905,350,555
207157,40,27,13,14,1,0,1,26,13,13
207236,40,982,323,659,167,49,118,815,274,541
207263,40,357,144,213,10,3,7,347,141,206
207281,40,1366,563,803,19,7,12,1347,556,791
207290,40,188,74,114,9,4,5,179,70,109
207306,40,217,93,124,4,2,2,213,91,122
207324,40,94,56,38,12,5,7,82,51,31
207351,40,118,42,76,2,1,1,116,41,75
207388,40,424,169,255,45,25,20,379,144,235
207397,40,766,300,466,6,1,5,760,299,461
207403,40,84,68,16,39,36,3,45,32,13
207449,40,1969,638,1331,188,87,101,1781,551,1230
207458,40,17,5,12,,,,17,5,12
207500,40,440,195,245,145,64,81,295,131,164
207564,40,336,145,191,5,2,3,331,143,188
207582,40,1039,461,578,6,3,3,1033,458,575
207661,40,539,218,321,2,2,0,537,216,321
207670,40,2280,825,1455,18,9,9,2262,816,1446
207722,40,17,6,11,,,,17,6,11
207740,40,430,164,266,20,6,14,410,158,252
207847,40,169,55,114,5,1,4,164,54,110
207856,40,1,0,1,,,,1,0,1
207865,40,345,125,220,4,2,2,341,123,218
207935,40,2910,1087,1823,251,90,161,2659,997,1662
207971,40,35,14,21,21,6,15,14,8,6
208035,40,420,132,288,23,5,18,397,127,270
208053,40,206,106,100,,,,206,106,100
208275,40,338,214,124,20,11,9,318,203,115
208318,40,881,394,487,25,12,13,856,382,474
208390,40,1054,436,618,211,86,125,843,350,493
208406,40,539,294,245,69,34,35,470,260,210
208415,40,232,146,86,23,12,11,209,134,75
208646,40,153,48,105,2,0,2,151,48,103
208725,40,1,0,1,,,,1,0,1
208822,40,36,14,22,5,0,5,31,14,17
209038,40,894,408,486,31,17,14,863,391,472
209056,40,17,7,10,13,5,8,4,2,2
209065,40,53,17,36,28,14,14,25,3,22
209074,40,46,12,34,43,10,33,3,2,1
209241,40,5,5,0,,,,5,5,0
209250,40,2667,2013,654,234,118,116,2433,1895,538
209287,40,3,0,3,,,,3,0,3
209409,40,7,7,0,1,1,0,6,6,0
209506,40,1714,730,984,18,11,7,1696,719,977
209542,40,498,212,286,138,67,71,360,145,215
209551,40,122,85,37,,,,122,85,37
209612,40,93,23,70,23,7,16,70,16,54
209746,40,1577,633,944,135,74,61,1442,559,883
209807,40,2563,1110,1453,233,95,138,2330,1015,1315
209825,40,22,16,6,,,,22,16,6
209922,40,29,11,18,4,1,3,25,10,15
209940,40,448,157,291,57,14,43,391,143,248
210146,40,1387,507,880,80,18,62,1307,489,818
210155,40,211,72,139,26,10,16,185,62,123
210234,40,235,105,130,22,10,12,213,95,118
210270,40,370,131,239,21,9,12,349,122,227
210304,40,4,1,3,4,1,3,,,
210331,40,23,16,7,7,5,2,16,11,5
210401,40,32,14,18,22,9,13,10,5,5
210429,40,28,10,18,4,2,2,24,8,16
210492,40,1,0,1,,,,1,0,1
210571,40,22,6,16,6,0,6,16,6,10
210605,40,1082,512,570,91,48,43,991,464,527
210669,40,29,11,18,7,2,5,22,9,13
210739,40,50,24,26,7,3,4,43,21,22
210775,40,18,7,11,1,1,0,17,6,11
211079,40,569,198,371,3,1,2,566,197,369
211088,40,120,47,73,,,,120,47,73
211273,40,7,0,7,6,0,6,1,0,1
211291,40,15,1,14,2,0,2,13,1,12
211307,40,864,344,520,39,21,18,825,323,502
211343,40,524,201,323,6,2,4,518,199,319
211352,40,41,16,25,,,,41,16,25
211431,40,4,1,3,,,,4,1,3
211440,40,54,40,14,,,,54,40,14
211468,40,20,3,17,,,,20,3,17
211477,40,74,23,51,,,,74,23,51
211556,40,292,54,238,23,5,18,269,49,220
211583,40,50,17,33,12,7,5,38,10,28
211608,40,11,1,10,1,1,0,10,0,10
211981,40,146,11,135,,,,146,11,135
212009,40,42,14,28,19,9,10,23,5,18
212054,40,88,43,45,16,6,10,72,37,35
212106,40,8,2,6,,,,8,2,6
212115,40,68,22,46,8,1,7,60,21,39
212133,40,156,26,130,2,1,1,154,25,129
212197,40,34,13,21,10,1,9,24,12,12
212577,40,4,1,3,,,,4,1,3
212601,40,503,207,296,15,8,7,488,199,289
212656,40,110,61,49,,,,110,61,49
212674,40,5,3,2,3,2,1,2,1,1
212771,40,20,1,19,3,0,3,17,1,16
212805,40,129,60,69,1,0,1,128,60,68
212832,40,195,117,78,,,,195,117,78
212869,40,23,7,16,7,5,2,16,2,14
212878,40,2722,1006,1716,118,37,81,2604,969,1635
212911,40,4,1,3,2,0,2,2,1,1
212984,40,31,5,26,,,,31,5,26
213011,40,248,68,180,2,1,1,246,67,179
213020,40,427,225,202,23,9,14,404,216,188
213233,40,61,53,8,16,14,2,45,39,6
213251,40,63,22,41,31,4,27,32,18,14
213303,40,51,7,44,1,0,1,50,7,43
213321,40,76,25,51,1,0,1,75,25,50
213349,40,163,58,105,1,1,0,162,57,105
213358,40,945,372,573,,,,945,372,573
213367,40,498,143,355,6,0,6,492,143,349
213376,40,68,27,41,35,17,18,33,10,23
213385,40,4,1,3,,,,4,1,3
213400,40,260,116,144,,,,260,116,144
213507,40,65,29,36,2,0,2,63,29,34
213525,40,1668,599,1069,162,53,109,1506,546,960
213543,40,12,4,8,7,1,6,5,3,2
213598,40,8,1,7,,,,8,1,7
213659,40,925,356,569,28,12,16,897,344,553
213668,40,13,3,10,7,2,5,6,1,5
213774,40,122,50,72,,,,122,50,72
213826,40,64,13,51,4,1,3,60,12,48
213987,40,79,22,57,3,1,2,76,21,55
213996,40,168,55,113,1,0,1,167,55,112
214041,40,117,61,56,36,18,18,81,43,38
214069,40,49,15,34,,,,49,15,34
214111,40,1486,588,898,90,38,52,1396,550,846
214157,40,40,17,23,6,0,6,34,17,17
214166,40,1623,609,1014,70,25,45,1553,584,969
214175,40,12,2,10,,,,12,2,10
214272,40,87,22,65,,,,87,22,65
214379,40,1202,487,715,36,11,25,1166,476,690
214582,40,1,0,1,,,,1,0,1
214591,40,39,23,16,5,5,0,34,18,16
214625,40,20,6,14,,,,20,6,14
214634,40,58,18,40,,,,58,18,40
214643,40,12,7,5,1,1,0,11,6,5
214652,40,15,9,6,1,1,0,14,8,6
214670,40,45,12,33,,,,45,12,33
214689,40,12,9,3,,,,12,9,3
214698,40,19,7,12,,,,19,7,12
214704,40,47,11,36,,,,47,11,36
214713,40,10,3,7,2,1,1,8,2,6
214731,40,7,5,2,,,,7,5,2
214740,40,40,12,28,,,,40,12,28
214759,40,4,2,2,,,,4,2,2
214768,40,3,2,1,,,,3,2,1
214777,40,328,227,101,53,25,28,275,202,73
214786,40,7,2,5,,,,7,2,5
214795,40,44,22,22,1,0,1,43,22,21
214801,40,18,10,8,1,1,0,17,9,8
214810,40,30,13,17,,,,30,13,17
214829,40,49,26,23,,,,49,26,23
214883,40,1,0,1,,,,1,0,1
215053,40,9,3,6,,,,9,3,6
215062,40,678,287,391,259,107,152,419,180,239
215105,40,10,4,6,5,1,4,5,3,2
215114,40,40,15,25,13,7,6,27,8,19
215239,40,815,249,566,76,21,55,739,228,511
215266,40,23,7,16,10,4,6,13,3,10
215275,40,5,3,2,3,2,1,2,1,1
215284,40,4,1,3,2,0,2,2,1,1
215293,40,4466,1847,2619,58,20,38,4408,1827,2581
215390,40,20,8,12,20,8,12,,,
215415,40,69,46,23,,,,69,46,23
215442,40,8,3,5,,,,8,3,5
215585,40,1335,555,780,53,31,22,1282,524,758
215655,40,29,11,18,2,2,0,27,9,18
215743,40,822,341,481,,,,822,341,481
215770,40,93,58,35,1,0,1,92,58,34
215798,40,24,11,13,5,4,1,19,7,12
215929,40,78,29,49,12,1,11,66,28,38
215947,40,12,3,9,1,1,0,11,2,9
216010,40,160,41,119,10,6,4,150,35,115
216038,40,50,15,35,15,5,10,35,10,25
216083,40,1,1,0,,,,1,1,0
216278,40,85,35,50,12,4,8,73,31,42
216287,40,6,0,6,6,0,6,,,
216296,40,2,2,0,,,,2,2,0
216339,40,409,177,232,108,43,65,301,134,167
216357,40,28,6,22,13,1,12,15,5,10
216366,40,32,7,25,6,0,6,26,7,19
216524,40,22,13,9,,,,22,13,9
216542,40,19,8,11,,,,19,8,11
216597,40,63,28,35,4,1,3,59,27,32
216667,40,10,2,8,8,0,8,2,2,0
216694,40,50,18,32,,,,50,18,32
216764,40,378,156,222,14,8,6,364,148,216
216807,40,138,27,111,14,3,11,124,24,100
216825,40,1423,523,900,120,42,78,1303,481,822
216852,40,42,17,25,15,5,10,27,12,15
216931,40,96,49,47,5,2,3,91,47,44
217013,40,331,105,226,56,17,39,275,88,187
217059,40,116,47,69,2,1,1,114,46,68
217156,40,417,122,295,23,6,17,394,116,278
217165,40,11,5,6,10,5,5,1,0,1
217235,40,23,8,15,15,7,8,8,1,7
217402,40,37,23,14,3,3,0,34,20,14
217420,40,123,31,92,21,7,14,102,24,78
217475,40,992,302,690,175,55,120,817,247,570
217484,40,940,408,532,31,9,22,909,399,510
217518,40,132,76,56,4,0,4,128,76,52
217536,40,16,3,13,12,2,10,4,1,3
217606,40,1,1,0,,,,1,1,0
217615,40,264,106,158,4,1,3,260,105,155
217633,40,277,90,187,8,5,3,269,85,184
217688,40,65,31,34,,,,65,31,34
217712,40,487,162,325,39,6,33,448,156,292
217721,40,70,34,36,,,,70,34,36
217749,40,291,127,164,10,4,6,281,123,158
217776,40,98,42,56,1,0,1,97,42,55
217819,40,305,113,192,37,15,22,268,98,170
217837,40,523,179,344,12,9,3,511,170,341
217864,40,37,21,16,,,,37,21,16
217873,40,19,8,11,,,,19,8,11
217882,40,99,50,49,27,11,16,72,39,33
217907,40,287,150,137,,,,287,150,137
217925,40,226,89,137,2,0,2,224,89,135
217934,40,37,1,36,2,0,2,35,1,34
217989,40,317,114,203,28,8,20,289,106,183
218025,40,492,200,292,26,8,18,466,192,274
218061,40,951,315,636,46,11,35,905,304,601
218070,40,5,2,3,5,2,3,,,
218113,40,2502,1100,1402,73,35,38,2429,1065,1364
218140,40,1356,502,854,150,61,89,1206,441,765
218229,40,202,67,135,4,0,4,198,67,131
218238,40,51,14,37,9,7,2,42,7,35
218353,40,1293,448,845,90,26,64,1203,422,781
218414,40,4,3,1,,,,4,3,1
218441,40,188,51,137,1,0,1,187,51,136
218487,40,609,234,375,39,11,28,570,223,347
218520,40,960,400,560,152,55,97,808,345,463
218539,40,78,21,57,20,5,15,58,16,42
218645,40,328,110,218,70,27,43,258,83,175
218654,40,168,55,113,2,1,1,166,54,112
218663,40,503,269,234,282,159,123,221,110,111
218672,40,1124,448,676,90,31,59,1034,417,617
218681,40,452,155,297,34,9,25,418,146,272
218690,40,974,382,592,71,21,50,903,361,542
218706,40,845,365,480,70,30,40,775,335,440
218724,40,299,158,141,26,15,11,273,143,130
218733,40,23,4,19,,,,23,4,19
218742,40,435,133,302,71,19,52,364,114,250
218821,40,1,1,0,,,,1,1,0
218830,40,1288,505,783,134,59,75,1154,446,708
218858,40,639,206,433,73,25,48,566,181,385
218885,40,791,367,424,15,4,11,776,363,413
218894,40,2595,1055,1540,361,150,211,2234,905,1329
218955,40,260,148,112,11,5,6,249,143,106
218964,40,365,127,238,6,2,4,359,125,234
218991,40,1027,475,552,217,81,136,810,394,416
219000,40,72,31,41,18,3,15,54,28,26
219046,40,1328,562,766,43,20,23,1285,542,743
219082,40,863,392,471,24,4,20,839,388,451
219091,40,91,25,66,3,0,3,88,25,63
219143,40,432,184,248,9,8,1,423,176,247
219189,40,207,119,88,17,11,6,190,108,82
219198,40,387,163,224,1,0,1,386,163,223
219204,40,7,6,1,,,,7,6,1
219259,40,1593,587,1006,40,11,29,1553,576,977
219277,40,38,8,30,1,0,1,37,8,29
219295,40,14,4,10,7,2,5,7,2,5
219347,40,116,64,52,6,5,1,110,59,51
219356,40,1290,432,858,25,7,18,1265,425,840
219374,40,35,16,19,,,,35,16,19
219383,40,26,12,14,,,,26,12,14
219408,40,15,6,9,,,,15,6,9
219426,40,324,127,197,4,0,4,320,127,193
219471,40,1867,685,1182,44,18,26,1823,667,1156
219480,40,510,210,300,10,6,4,500,204,296
219505,40,1,0,1,,,,1,0,1
219602,40,1066,417,649,54,22,32,1012,395,617
219709,40,35,15,20,13,5,8,22,10,12
219718,40,1132,388,744,6,1,5,1126,387,739
219790,40,600,284,316,18,11,7,582,273,309
219806,40,93,42,51,6,3,3,87,39,48
219824,40,1739,695,1044,144,63,81,1595,632,963
219833,40,221,98,123,16,3,13,205,95,110
219842,40,132,75,57,,,,132,75,57
219879,40,1138,493,645,100,41,59,1038,452,586
219888,40,1293,488,805,41,26,15,1252,462,790
219921,40,140,108,32,,,,140,108,32
219949,40,377,152,225,36,13,23,341,139,202
219976,40,5,0,5,,,,5,0,5
219994,40,326,249,77,,,,326,249,77
220057,40,820,300,520,108,40,68,712,260,452
220075,40,782,290,492,29,14,15,753,276,477
220127,40,55,53,2,,,,55,53,2
220206,40,98,37,61,3,1,2,95,36,59
220215,40,466,190,276,12,3,9,454,187,267
220251,40,379,225,154,,,,379,225,154
220279,40,387,262,125,,,,387,262,125
220321,40,562,245,317,,,,562,245,317
220394,40,92,66,26,,,,92,66,26
220400,40,1023,324,699,87,20,67,936,304,632
220473,40,1,1,0,1,1,0,,,
220516,40,55,17,38,5,0,5,50,17,33
220552,40,51,11,40,6,0,6,45,11,34
220604,40,4,0,4,,,,4,0,4
220613,40,514,209,305,2,0,2,512,209,303
220631,40,99,35,64,,,,99,35,64
220640,40,1058,699,359,,,,1058,699,359
220701,40,109,37,72,,,,109,37,72
220710,40,88,38,50,6,1,5,82,37,45
220756,40,31,30,1,,,,31,30,1
220853,40,536,337,199,,,,536,337,199
220862,40,2527,973,1554,42,20,22,2485,953,1532
220978,40,1199,465,734,40,14,26,1159,451,708
221050,40,235,196,39,,,,235,196,39
221096,40,1589,553,1036,164,70,94,1425,483,942
221102,40,5,3,2,1,0,1,4,3,1
221184,40,1597,590,1007,121,51,70,1476,539,937
221236,40,164,136,28,,,,164,136,28
221281,40,78,48,30,,,,78,48,30
221333,40,287,256,31,,,,287,256,31
221351,40,30,10,20,16,5,11,14,5,9
221388,40,195,175,20,,,,195,175,20
221397,40,1382,467,915,181,89,92,1201,378,823
221430,40,1065,706,359,,,,1065,706,359
221485,40,1515,614,901,11,5,6,1504,609,895
221494,40,118,106,12,,,,118,106,12
221519,40,14,7,7,,,,14,7,7
221582,40,280,215,65,,,,280,215,65
221591,40,143,114,29,,,,143,114,29
221607,40,320,277,43,,,,320,277,43
221616,40,1699,1043,656,,,,1699,1043,656
221625,40,393,258,135,,,,393,258,135
221643,40,2136,853,1283,98,41,57,2038,812,1226
221661,40,132,51,81,,,,132,51,81
221731,40,23,13,10,,,,23,13,10
221740,40,64,34,30,4,3,1,60,31,29
221759,40,134,61,73,27,11,16,107,50,57
221768,40,1536,552,984,14,6,8,1522,546,976
221838,40,332,119,213,6,1,5,326,118,208
221847,40,196,92,104,14,8,6,182,84,98
221892,40,129,67,62,,,,129,67,62
221908,40,996,433,563,91,32,59,905,401,504
221953,40,130,43,87,,,,130,43,87
221971,40,169,68,101,3,2,1,166,66,100
221999,40,7,2,5,4,2,2,3,0,3
222053,40,1626,592,1034,113,44,69,1513,548,965
222062,40,1892,643,1249,95,35,60,1797,608,1189
222105,40,7,5,2,,,,7,5,2
222178,40,70,25,45,9,0,9,61,25,36
222567,40,2260,913,1347,142,57,85,2118,856,1262
222576,40,1717,693,1024,115,47,68,1602,646,956
222628,40,4,2,2,,,,4,2,2
222822,40,1549,625,924,110,40,70,1439,585,854
222831,40,3752,1504,2248,150,31,119,3602,1473,2129
222983,40,1,1,0,,,,1,1,0
222992,40,9195,3988,5207,712,370,342,8483,3618,4865
223083,40,10,1,9,4,1,3,6,0,6
223117,40,6,4,2,3,2,1,3,2,1
223232,40,79,30,49,33,16,17,46,14,32
223320,40,1663,702,961,81,27,54,1582,675,907
223427,40,2188,1035,1153,118,54,64,2070,981,1089
223506,40,1146,528,618,65,35,30,1081,493,588
223816,40,3508,1485,2023,718,307,411,2790,1178,1612
223898,40,80,27,53,22,10,12,58,17,41
223922,40,52,28,24,18,8,10,34,20,14
224004,40,2,1,1,1,1,0,1,0,1
224110,40,1903,847,1056,34,22,12,1869,825,1044
224147,40,6,3,3,,,,6,3,3
224226,40,297,123,174,3,2,1,294,121,173
224244,40,2,1,1,,,,2,1,1
224323,40,7,1,6,4,1,3,3,0,3
224350,40,621,291,330,72,39,33,549,252,297
224527,40,255,87,168,,,,255,87,168
224545,40,3,3,0,,,,3,3,0
224554,40,66,28,38,34,12,22,32,16,16
224615,40,29447,12331,17116,5045,2271,2774,24402,10060,14342
224642,40,269,100,169,39,15,24,230,85,145
224891,40,908,427,481,103,32,71,805,395,410
224961,40,504,206,298,126,51,75,378,155,223
225070,40,1231,513,718,89,38,51,1142,475,667
225247,40,24,9,15,1,0,1,23,9,14
225308,40,771,290,481,167,63,104,604,227,377
225371,40,1764,730,1034,117,50,67,1647,680,967
225399,40,9,5,4,1,1,0,8,4,4
225414,40,9,2,7,3,1,2,6,1,5
225423,40,10288,4322,5966,1036,379,657,9252,3943,5309
225432,40,104,35,69,11,2,9,93,33,60
225502,40,146,64,82,11,3,8,135,61,74
225511,40,863,448,415,257,119,138,606,329,277
225520,40,2612,1240,1372,80,30,50,2532,1210,1322
225548,40,52,24,28,,,,52,24,28
225627,40,177,61,116,52,14,38,125,47,78
225876,40,261,91,170,2,0,2,259,91,168
226019,40,2006,820,1186,94,22,72,1912,798,1114
226091,40,189,71,118,7,2,5,182,69,113
226107,40,1236,478,758,96,24,72,1140,454,686
226116,40,33,11,22,12,6,6,21,5,16
226134,40,1753,822,931,220,106,114,1533,716,817
226152,40,520,219,301,75,25,50,445,194,251
226204,40,81,22,59,,,,81,22,59
226231,40,1797,828,969,76,33,43,1721,795,926
226383,40,125,60,65,,,,125,60,65
226408,40,1321,551,770,169,59,110,1152,492,660
226471,40,59,28,31,1,1,0,58,27,31
226578,40,1963,777,1186,59,25,34,1904,752,1152
226587,40,139,75,64,12,8,4,127,67,60
226806,40,667,280,387,262,121,141,405,159,246
226833,40,397,188,209,8,5,3,389,183,206
227182,40,20929,8864,12065,2604,1096,1508,18325,7768,10557
227225,40,1097,497,600,131,49,82,966,448,518
227304,40,3699,1780,1919,465,181,284,3234,1599,1635
227331,40,32,7,25,4,1,3,28,6,22
227368,40,14,4,10,4,1,3,10,3,7
227377,40,4004,1577,2427,141,59,82,3863,1518,2345
227386,40,897,400,497,76,37,39,821,363,458
227401,40,2088,841,1247,135,49,86,1953,792,1161
227687,40,193,107,86,24,11,13,169,96,73
227757,40,14,6,8,13,5,8,1,1,0
227845,40,18,7,11,14,5,9,4,2,2
227854,40,3309,1640,1669,415,182,233,2894,1458,1436
227863,40,122,108,14,1,1,0,121,107,14
227881,40,51,18,33,,,,51,18,33
227924,40,2665,1057,1608,234,105,129,2431,952,1479
227979,40,7803,3163,4640,1297,489,808,6506,2674,3832
228042,40,42,6,36,9,0,9,33,6,27
228149,40,10,7,3,4,2,2,6,5,1
228158,40,2202,941,1261,134,47,87,2068,894,1174
228246,40,12,2,10,,,,12,2,10
228316,40,3179,1433,1746,481,191,290,2698,1242,1456
228325,40,56,19,37,6,5,1,50,14,36
228343,40,3,0,3,3,0,3,,,
228431,40,944,374,570,23,10,13,921,364,557
228468,40,127,48,79,,,,127,48,79
228486,40,4,3,1,,,,4,3,1
228501,40,55,20,35,4,2,2,51,18,33
228547,40,1216,598,618,145,83,62,1071,515,556
228608,40,1404,534,870,378,142,236,1026,392,634
228699,40,2165,894,1271,299,103,196,1866,791,1075
228705,40,285,127,158,8,1,7,277,126,151
228723,40,720,568,152,107,69,38,613,499,114
228769,40,288,117,171,35,17,18,253,100,153
228778,40,329,163,166,147,81,66,182,82,100
228787,40,31,14,17,31,14,17,,,
228796,40,42,15,27,8,1,7,34,14,20
228802,40,403,172,231,8,5,3,395,167,228
228875,40,13,6,7,,,,13,6,7
228981,40,22,7,15,,,,22,7,15
229018,40,580,224,356,6,3,3,574,221,353
229027,40,574,287,287,133,78,55,441,209,232
229115,40,233,107,126,58,26,32,175,81,94
229160,40,330,138,192,7,2,5,323,136,187
229179,40,1277,515,762,20,9,11,1257,506,751
229267,40,21,4,17,9,3,6,12,1,11
229355,40,2856,1156,1700,282,117,165,2574,1039,1535
229504,40,312,140,172,59,29,30,253,111,142
229540,40,718,251,467,12,5,7,706,246,460
229780,40,137,59,78,2,1,1,135,58,77
229799,40,1841,821,1020,366,163,203,1475,658,817
229814,40,73,52,21,,,,73,52,21
229832,40,905,429,476,138,64,74,767,365,402
229841,40,738,291,447,33,13,20,705,278,427
230010,40,108,43,65,,,,108,43,65
230047,40,19,8,11,8,2,6,11,6,5
230162,40,1246,845,401,54,39,15,1192,806,386
230171,40,3875,1769,2106,363,162,201,3512,1607,1905
230366,40,13,2,11,13,2,11,,,
230418,40,11,5,6,1,0,1,10,5,5
230490,40,1118,746,372,51,16,35,1067,730,337
230597,40,2343,1037,1306,314,125,189,2029,912,1117
230603,40,3560,1132,2428,265,111,154,3295,1021,2274
230676,40,956,670,286,7,0,7,949,670,279
230728,40,4262,1722,2540,143,56,87,4119,1666,2453
230737,40,15335,6895,8440,1448,682,766,13887,6213,7674
230746,40,9010,3973,5037,424,209,215,8586,3764,4822
230764,40,963,459,504,102,56,46,861,403,458
230782,40,13363,6211,7152,1430,647,783,11933,5564,6369
230807,40,6,4,2,3,2,1,3,2,1
230816,40,44,17,27,4,1,3,40,16,24
230834,40,143,56,87,45,14,31,98,42,56
230852,40,29,22,7,1,1,0,28,21,7
230861,40,2377,781,1596,225,61,164,2152,720,1432
230889,40,7,2,5,7,2,5,,,
230913,40,216,75,141,65,21,44,151,54,97
230959,40,22,7,15,12,4,8,10,3,7
230995,40,93,48,45,58,31,27,35,17,18
231059,40,9,5,4,3,2,1,6,3,3
231068,40,542,124,418,534,124,410,8,0,8
231095,40,15,7,8,4,1,3,11,6,5
231165,40,300,199,101,63,38,25,237,161,76
231174,40,572,208,364,89,48,41,483,160,323
231420,40,19,8,11,4,2,2,15,6,9
231536,40,938,388,550,62,22,40,876,366,510
231554,40,90,41,49,60,28,32,30,13,17
231581,40,6,2,4,3,0,3,3,2,1
231624,40,19,8,11,5,3,2,14,5,9
231651,40,260,91,169,10,2,8,250,89,161
231697,40,1348,593,755,403,137,266,945,456,489
231712,40,7,2,5,1,0,1,6,2,4
231785,40,12,0,12,5,0,5,7,0,7
231873,40,498,221,277,28,14,14,470,207,263
231882,40,984,475,509,200,102,98,784,373,411
232025,40,2,1,1,,,,2,1,1
232043,40,66,30,36,,,,66,30,36
232052,40,249,128,121,32,10,22,217,118,99
232089,40,55,21,34,7,3,4,48,18,30
232186,40,567,309,258,145,85,60,422,224,198
232195,40,2505,988,1517,274,117,157,2231,871,1360
232308,40,2,0,2,2,0,2,,,
232414,40,2255,955,1300,636,278,358,1619,677,942
232423,40,378,193,185,14,5,9,364,188,176
232450,40,3354,1414,1940,103,45,58,3251,1369,1882
232557,40,498,283,215,46,24,22,452,259,193
232566,40,145,35,110,2,0,2,143,35,108
232575,40,2609,1100,1509,573,260,313,2036,840,1196
232609,40,46,11,35,4,3,1,42,8,34
232672,40,16,3,13,3,0,3,13,3,10
232681,40,50,6,44,13,0,13,37,6,31
232706,40,511,382,129,1,1,0,510,381,129
232788,40,780,320,460,161,72,89,619,248,371
232867,40,2092,1075,1017,352,162,190,1740,913,827
232885,40,45,6,39,10,1,9,35,5,30
232937,40,9,6,3,,,,9,6,3
232946,40,19685,9323,10362,794,452,342,18891,8871,10020
232982,40,223,108,115,28,10,18,195,98,97
233019,40,478,195,283,204,74,130,274,121,153
233037,40,597,229,368,52,21,31,545,208,337
233116,40,2068,972,1096,152,56,96,1916,916,1000
233277,40,63,37,26,10,4,6,53,33,20
233295,40,14,8,6,8,4,4,6,4,2
233301,40,17,7,10,4,2,2,13,5,8
233310,40,1316,541,775,269,104,165,1047,437,610
233338,40,1323,537,786,112,34,78,1211,503,708
233374,40,76,32,44,66,29,37,10,3,7
233426,40,25,13,12,12,3,9,13,10,3
233541,40,357,75,282,4,3,1,353,72,281
233639,40,1417,558,859,430,163,267,987,395,592
233648,40,635,260,375,91,36,55,544,224,320
233684,40,1,1,0,,,,1,1,0
233718,40,6,0,6,,,,6,0,6
233754,40,1791,777,1014,159,75,84,1632,702,930
233772,40,4034,1811,2223,313,136,177,3721,1675,2046
233897,40,711,196,515,88,38,50,623,158,465
233903,40,718,281,437,107,25,82,611,256,355
233921,40,95,44,51,65,27,38,30,17,13
233949,40,2179,1021,1158,76,35,41,2103,986,1117
234030,40,406,181,225,60,27,33,346,154,192
234076,40,341,199,142,71,40,31,270,159,111
234155,40,5,2,3,,,,5,2,3
234164,40,32,12,20,3,1,2,29,11,18
234173,40,325,173,152,18,5,13,307,168,139
234207,40,6,2,4,3,0,3,3,2,1
234377,40,971,470,501,160,38,122,811,432,379
234669,40,2794,1195,1599,1159,566,593,1635,629,1006
234696,40,89,57,32,8,4,4,81,53,28
234711,40,91,47,44,4,2,2,87,45,42
234827,40,93,26,67,39,15,24,54,11,43
234845,40,616,231,385,75,38,37,541,193,348
234915,40,197,69,128,4,2,2,193,67,126
234933,40,1152,497,655,327,135,192,825,362,463
234951,40,406,194,212,28,12,16,378,182,196
234979,40,1088,843,245,190,87,103,898,756,142
235024,40,27,6,21,1,0,1,26,6,20
235097,40,666,269,397,433,183,250,233,86,147
235103,40,2004,856,1148,603,292,311,1401,564,837
235149,40,684,338,346,213,95,118,471,243,228
235167,40,52,22,30,2,1,1,50,21,29
235237,40,2326,952,1374,339,162,177,1987,790,1197
235316,40,66,26,40,41,13,28,25,13,12
235334,40,255,149,106,138,78,60,117,71,46
235343,40,734,321,413,380,173,207,354,148,206
235431,40,366,117,249,139,52,87,227,65,162
235671,40,2223,1245,978,575,297,278,1648,948,700
235699,40,913,354,559,124,72,52,789,282,507
235750,40,314,136,178,28,8,20,286,128,158
236072,40,1931,656,1275,259,139,120,1672,517,1155
236133,40,58,20,38,56,18,38,2,2,0
236188,40,889,485,404,502,301,201,387,184,203
236230,40,48,24,24,8,2,6,40,22,18
236258,40,478,148,330,131,43,88,347,105,242
236382,40,1472,1245,227,107,57,50,1365,1188,177
236452,40,21,10,11,11,3,8,10,7,3
236504,40,3241,2700,541,316,205,111,2925,2495,430
236513,40,978,391,587,428,173,255,550,218,332
236577,40,23,13,10,,,,23,13,10
236595,40,13,7,6,1,1,0,12,6,6
236610,40,852,366,486,224,124,100,628,242,386
236638,40,1097,678,419,111,56,55,986,622,364
236656,40,177,64,113,47,20,27,130,44,86
236692,40,1987,921,1066,100,42,58,1887,879,1008
236708,40,157,71,86,17,10,7,140,61,79
236753,40,389,130,259,169,66,103,220,64,156
236887,40,402,225,177,124,72,52,278,153,125
236896,40,66,38,28,,,,66,38,28
236939,40,347,139,208,77,25,52,270,114,156
236948,40,5282,4465,817,248,138,110,5034,4327,707
236975,40,221,87,134,34,10,24,187,77,110
237011,40,115,47,68,65,23,42,50,24,26
237039,40,519,200,319,115,55,60,404,145,259
237057,40,21,11,10,1,1,0,20,10,10
237066,40,10,5,5,5,2,3,5,3,2
237109,40,38,16,22,5,3,2,33,13,20
237118,40,41,10,31,,,,41,10,31
237136,40,38,15,23,,,,38,15,23
237181,40,5,1,4,,,,5,1,4
237215,40,42,13,29,12,3,9,30,10,20
237312,40,35,13,22,,,,35,13,22
237330,40,88,40,48,2,1,1,86,39,47
237358,40,6,3,3,,,,6,3,3
237367,40,421,160,261,3,2,1,418,158,260
237385,40,351,123,228,20,2,18,331,121,210
237437,40,3,1,2,,,,3,1,2
237525,40,987,397,590,44,25,19,943,372,571
237686,40,802,290,512,39,14,25,763,276,487
237701,40,191,60,131,,,,191,60,131
237783,40,6,2,4,,,,6,2,4
237792,40,393,148,245,,,,393,148,245
237817,40,272,95,177,141,47,94,131,48,83
237899,40,2272,907,1365,101,42,59,2171,865,1306
237932,40,271,96,175,12,2,10,259,94,165
237950,40,443,157,286,1,1,0,442,156,286
237969,40,3,1,2,,,,3,1,2
238014,40,354,125,229,23,10,13,331,115,216
238032,40,689,255,434,,,,689,255,434
238078,40,16,4,12,16,4,12,,,
238193,40,71,7,64,14,1,13,57,6,51
238263,40,4364,2136,2228,251,114,137,4113,2022,2091
238324,40,217,55,162,,,,217,55,162
238333,40,43,15,28,12,5,7,31,10,21
238397,40,118,66,52,3,1,2,115,65,50
238430,40,229,75,154,,,,229,75,154
238458,40,82,35,47,23,9,14,59,26,33
238476,40,18,8,10,,,,18,8,10
238616,40,261,106,155,2,0,2,259,106,153
238661,40,93,55,38,17,8,9,76,47,29
238722,40,5656,3205,2451,117,68,49,5539,3137,2402
238759,40,5315,2982,2333,91,49,42,5224,2933,2291
238980,40,617,271,346,11,6,5,606,265,341
239008,40,1407,830,577,6,3,3,1401,827,574
239017,40,15,7,8,11,5,6,4,2,2
239071,40,165,64,101,15,7,8,150,57,93
239080,40,10,1,9,,,,10,1,9
239105,40,238,113,125,24,6,18,214,107,107
239220,40,744,378,366,8,5,3,736,373,363
239248,40,1129,425,704,171,93,78,958,332,626
239309,40,1,0,1,,,,1,0,1
239318,40,13,7,6,,,,13,7,6
239372,40,805,363,442,24,13,11,781,350,431
239390,40,76,6,70,,,,76,6,70
239442,40,448,189,259,6,3,3,442,186,256
239460,40,3111,1455,1656,135,51,84,2976,1404,1572
239488,40,3695,1889,1806,169,64,105,3526,1825,1701
239512,40,10,5,5,,,,10,5,5
239628,40,12,2,10,6,0,6,6,2,4
239716,40,30,17,13,10,4,6,20,13,7
239910,40,1329,611,718,45,24,21,1284,587,697
240107,40,29,4,25,,,,29,4,25
240116,40,4290,2218,2072,180,82,98,4110,2136,1974
240125,40,3088,1430,1658,67,16,51,3021,1414,1607
240170,40,365,129,236,12,7,5,353,122,231
240189,40,474,147,327,69,32,37,405,115,290
240198,40,585,289,296,20,8,12,565,281,284
240268,40,285,98,187,27,13,14,258,85,173
240277,40,2841,754,2087,189,57,132,2652,697,1955
240329,40,210,81,129,31,12,19,179,69,110
240338,40,13,10,3,,,,13,10,3
240365,40,4815,1790,3025,74,32,42,4741,1758,2983
240374,40,267,114,153,3,2,1,264,112,152
240392,40,20,3,17,,,,20,3,17
240417,40,78,32,46,24,10,14,54,22,32
240426,40,192,79,113,10,6,4,182,73,109
240444,40,1122,563,559,291,161,130,831,402,429
240453,40,1272,417,855,162,50,112,1110,367,743
240462,40,108,45,63,11,5,6,97,40,57
240471,40,449,182,267,41,17,24,408,165,243
240480,40,318,103,215,9,3,6,309,100,209
240505,40,1132,650,482,26,9,17,1106,641,465
240514,40,936,454,482,78,33,45,858,421,437
240596,40,912,403,509,79,22,57,833,381,452
240620,40,1376,618,758,30,13,17,1346,605,741
240657,40,534,253,281,34,17,17,500,236,264
240666,40,1896,969,927,155,43,112,1741,926,815
240693,40,1152,491,661,26,8,18,1126,483,643
240727,40,155,64,91,1,0,1,154,64,90
240736,40,85,13,72,,,,85,13,72
240745,40,145,102,43,11,9,2,134,93,41
240754,40,40,21,19,13,7,6,27,14,13
240790,40,18,8,10,5,1,4,13,7,6
241100,40,5,2,3,1,1,0,4,1,3
241128,40,1,0,1,,,,1,0,1
241191,40,9,2,7,1,0,1,8,2,6
241225,40,9,3,6,,,,9,3,6
241331,40,2,0,2,,,,2,0,2
241377,40,3,0,3,1,0,1,2,0,2
241395,40,18,4,14,2,0,2,16,4,12
241410,40,64,19,45,6,2,4,58,17,41
241614,40,1,1,0,,,,1,1,0
241766,40,9,7,2,,,,9,7,2
241836,40,2,1,1,,,,2,1,1
242042,40,154,86,68,154,86,68,,,
242617,40,48,23,25,4,2,2,44,21,23
242626,40,60,19,41,2,2,0,58,17,41
242635,40,93,21,72,4,0,4,89,21,68
242644,40,4,1,3,,,,4,1,3
242653,40,179,67,112,31,16,15,148,51,97
242662,40,27,6,21,,,,27,6,21
242680,40,26,6,20,2,1,1,24,5,19
242699,40,15,4,11,3,1,2,12,3,9
242705,40,22,9,13,1,0,1,21,9,12
242972,40,41,18,23,9,2,7,32,16,16
243106,40,25,11,14,7,4,3,18,7,11
243115,40,42,11,31,4,1,3,38,10,28
243142,40,73,24,49,7,3,4,66,21,45
243151,40,16,7,9,2,1,1,14,6,8
243179,40,43,14,29,2,0,2,41,14,27
243188,40,2,1,1,,,,2,1,1
243197,40,202,83,119,70,19,51,132,64,68
243212,40,98,26,72,9,4,5,89,22,67
243221,40,100,41,59,28,14,14,72,27,45
243443,40,56,23,33,24,12,12,32,11,21
243577,40,16,10,6,,,,16,10,6
243586,40,12,2,10,1,1,0,11,1,10
243638,40,10,3,7,,,,10,3,7
243665,40,53,17,36,5,1,4,48,16,32
243744,40,288,168,120,,,,288,168,120
243780,40,155,85,70,9,7,2,146,78,68
243823,40,4,2,2,,,,4,2,2
243832,40,6,1,5,,,,6,1,5
244437,40,2476,1069,1407,185,72,113,2291,997,1294
244446,40,916,300,616,67,39,28,849,261,588
245625,40,2497,1156,1341,231,94,137,2266,1062,1204
245953,40,452,268,184,8,5,3,444,263,181
245999,40,1635,797,838,,,,1635,797,838
246354,40,2885,1179,1706,584,213,371,2301,966,1335
246813,40,868,322,546,38,19,19,830,303,527
247603,40,232,114,118,55,28,27,177,86,91
247649,40,127,85,42,,,,127,85,42
247834,40,9966,4054,5912,600,270,330,9366,3784,5582
247940,40,2070,1010,1060,363,127,236,1707,883,824
248606,40,1265,734,531,,,,1265,734,531
248925,40,269,221,48,,,,269,221,48
248934,40,124,46,78,,,,124,46,78
251260,40,619,277,342,17,13,4,602,264,338
260372,40,34,10,24,,,,34,10,24
262031,40,550,211,339,52,25,27,498,186,312
262086,40,277,81,196,8,2,6,269,79,190
262457,40,16,0,16,16,0,16,,,
363633,40,344,173,171,20,4,16,324,169,155
364016,40,1592,678,914,162,76,86,1430,602,828
364025,40,6765,3125,3640,656,324,332,6109,2801,3308
364627,40,319,176,143,,,,319,176,143
364946,40,262,153,109,,,,262,153,109
365198,40,403,220,183,,,,403,220,183
365374,40,863,466,397,,,,863,466,397
365480,40,538,308,230,,,,538,308,230
366003,40,2,1,1,,,,2,1,1
366252,40,41,27,14,2,2,0,39,25,14
366340,40,50,20,30,1,1,0,49,19,30
366395,40,6189,2673,3516,196,102,94,5993,2571,3422
366401,40,636,279,357,15,5,10,621,274,347
366465,40,429,190,239,45,39,6,384,151,233
366623,40,220,112,108,1,1,0,219,111,108
366711,40,70,20,50,25,6,19,45,14,31
367459,40,2693,1090,1603,163,63,100,2530,1027,1503
367884,40,2,0,2,,,,2,0,2
368911,40,739,271,468,15,10,5,724,261,463
372082,40,10,0,10,,,,10,0,10
375656,40,134,68,66,,,,134,68,66
375683,40,664,369,295,,,,664,369,295
377485,40,25,3,22,,,,25,3,22
377555,40,26,11,15,1,1,0,25,10,15
377564,40,29,13,16,3,2,1,26,11,15
378105,40,66,7,59,64,7,57,2,0,2
378576,40,17,7,10,1,0,1,16,7,9
380359,40,61,20,41,7,3,4,54,17,37
380368,40,1167,489,678,135,40,95,1032,449,583
380377,40,11,1,10,1,0,1,10,1,9
380438,40,1,1,0,1,1,0,,,
383190,40,671,219,452,12,8,4,659,211,448
383996,40,329,138,191,34,12,22,295,126,169
384254,40,32,20,12,,,,32,20,12
384333,40,3532,1389,2143,257,96,161,3275,1293,1982
384342,40,1761,725,1036,118,59,59,1643,666,977
384421,40,1,1,0,1,1,0,,,
395362,40,343,135,208,41,10,31,302,125,177
399212,40,1277,596,681,55,30,25,1222,566,656
399869,40,1,1,0,1,1,0,,,
403469,40,1453,958,495,27,10,17,1426,948,478
403478,40,227,101,126,25,17,8,202,84,118
403487,40,430,152,278,27,11,16,403,141,262
404426,40,139,55,84,21,12,9,118,43,75
405872,40,915,345,570,41,20,21,874,325,549
407610,40,7,2,5,,,,7,2,5
408844,40,1,0,1,,,,1,0,1
409315,40,10048,4534,5514,2004,849,1155,8044,3685,4359
409698,40,119,57,62,65,20,45,54,37,17
413413,40,5,4,1,2,2,0,3,2,1
413617,40,60,14,46,2,1,1,58,13,45
414595,40,46,11,35,7,2,5,39,9,30
414878,40,204,85,119,1,0,1,203,85,118
414911,40,1435,502,933,60,19,41,1375,483,892
418302,40,367,194,173,,,,367,194,173
418320,40,761,412,349,,,,761,412,349
418348,40,386,255,131,,,,386,255,131
418409,40,18,9,9,18,9,9,,,
419226,40,39,24,15,1,0,1,38,24,14
420370,40,50,11,39,50,11,39,,,
420398,40,4258,1650,2608,204,91,113,4054,1559,2495
420431,40,403,167,236,5,2,3,398,165,233
420440,40,680,259,421,4,1,3,676,258,418
420538,40,376,177,199,7,1,6,369,176,193
420556,40,503,162,341,43,13,30,460,149,311
420723,40,317,137,180,35,14,21,282,123,159
423652,40,74,18,56,7,2,5,67,16,51
426314,40,201,158,43,14,10,4,187,148,39
427991,40,227,111,116,9,5,4,218,106,112
428019,40,192,101,91,,,,192,101,91
428170,40,31,5,26,4,0,4,27,5,22
428259,40,1,0,1,,,,1,0,1
428392,40,663,286,377,13,5,8,650,281,369
429128,40,308,18,290,,,,308,18,290
431017,40,257,162,95,,,,257,162,95
432524,40,3,1,2,,,,3,1,2
433174,40,14,6,8,,,,14,6,8
433660,40,342,162,180,272,131,141,70,31,39
434016,40,63,27,36,9,2,7,54,25,29
434061,40,939,337,602,337,142,195,602,195,407
434469,40,2,0,2,,,,2,0,2
434584,40,17,11,6,1,1,0,16,10,6
434672,40,2096,736,1360,136,57,79,1960,679,1281
434751,40,11,3,8,,,,11,3,8
436304,40,664,292,372,189,72,117,475,220,255
436818,40,17,9,8,,,,17,9,8
436827,40,13,5,8,,,,13,5,8
436836,40,51,34,17,,,,51,34,17
437097,40,1,1,0,,,,1,1,0
437103,40,1913,819,1094,84,50,34,1829,769,1060
438708,40,177,44,133,5,3,2,172,41,131
439190,40,629,288,341,344,171,173,285,117,168
439783,40,1,0,1,,,,1,0,1
439862,40,85,66,19,1,1,0,84,65,19
439899,40,5,3,2,,,,5,3,2
440262,40,2,2,0,,,,2,2,0
440396,40,10,7,3,6,5,1,4,2,2
440402,40,448,167,281,22,6,16,426,161,265
440749,40,14,11,3,,,,14,11,3
440794,40,84,33,51,12,6,6,72,27,45
440828,40,2,1,1,,,,2,1,1
441070,40,35,12,23,5,2,3,30,10,20
441609,40,42,42,0,42,42,0,,,
441690,40,30,20,10,,,,30,20,10
441760,40,1837,923,914,157,67,90,1680,856,824
441900,40,2534,927,1607,58,15,43,2476,912,1564
441937,40,17,7,10,12,6,6,5,1,4
441982,40,30,16,14,,,,30,16,14
442356,40,111,13,98,3,0,3,108,13,95
442444,40,74,14,60,74,14,60,,,
442781,40,141,38,103,11,2,9,130,36,94
442842,40,3,1,2,,,,3,1,2
443058,40,1,1,0,,,,1,1,0
443340,40,5,2,3,5,2,3,,,
443410,40,9,7,2,,,,9,7,2
443492,40,543,184,359,22,8,14,521,176,345
443599,40,8,1,7,,,,8,1,7
444219,40,924,381,543,51,16,35,873,365,508
444413,40,2,2,0,2,2,0,,,
444565,40,7,2,5,,,,7,2,5
444954,40,254,92,162,15,6,9,239,86,153
445027,40,130,66,64,130,66,64,,,
445267,40,1315,497,818,47,5,42,1268,492,776
446048,40,17,5,12,3,1,2,14,4,10
446233,40,6,2,4,,,,6,2,4
446640,40,20,8,12,,,,20,8,12
446774,40,2769,1110,1659,166,75,91,2603,1035,1568
447050,40,15,3,12,1,0,1,14,3,11
447582,40,254,86,168,27,6,21,227,80,147
447689,40,579,189,390,85,34,51,494,155,339
447847,40,81,76,5,81,76,5,,,
448248,40,968,389,579,86,3,83,882,386,496
448594,40,841,283,558,18,5,13,823,278,545
449339,40,1637,990,647,11,4,7,1626,986,640
449384,40,249,159,90,22,14,8,227,145,82
449764,40,3,1,2,2,0,2,1,1,0
449816,40,339,246,93,1,1,0,338,245,93
449870,40,3,0,3,3,0,3,,,
450933,40,122,88,34,18,12,6,104,76,28
451583,40,129,76,53,19,17,2,110,59,51
451927,40,33,10,23,1,0,1,32,10,22
454184,40,36,12,24,7,2,5,29,10,19
454227,40,126,24,102,1,0,1,125,24,101
454582,40,71,29,42,,,,71,29,42
454829,40,19,3,16,3,0,3,16,3,13
455114,40,4094,1883,2211,90,54,36,4004,1829,2175
455512,40,609,231,378,9,3,6,600,228,372
456959,40,13,1,12,5,0,5,8,1,7
457226,40,1,0,1,,,,1,0,1
457387,40,158,83,75,,,,158,83,75
457402,40,25,17,8,1,0,1,24,17,7
458113,40,31,0,31,,,,31,0,31
459204,40,581,83,498,581,83,498,,,
459259,40,63,62,1,1,0,1,62,62,0
459329,40,88,63,25,,,,88,63,25
459727,40,26,13,13,,,,26,13,13
459842,40,1,0,1,,,,1,0,1
459851,40,2,0,2,,,,2,0,2
459949,40,212,91,121,13,7,6,199,84,115
459994,40,10,2,8,,,,10,2,8
460349,40,5,3,2,,,,5,3,2
460394,40,1272,539,733,51,20,31,1221,519,702
460464,40,2264,904,1360,64,25,39,2200,879,1321
461023,40,1,0,1,,,,1,0,1
461245,40,30,22,8,,,,30,22,8
461281,40,14,0,14,,,,14,0,14
461315,40,17,3,14,,,,17,3,14
461528,40,11,5,6,,,,11,5,6
461759,40,25,14,11,20,12,8,5,2,3
463056,40,35,23,12,,,,35,23,12
464226,40,8,2,6,2,0,2,6,2,4
474863,40,319,47,272,24,2,22,295,45,250
475033,40,1,0,1,,,,1,0,1
475273,40,2,0,2,1,0,1,1,0,1
475398,40,5,5,0,1,1,0,4,4,0
475608,40,1,0,1,,,,1,0,1
475723,40,307,189,118,22,16,6,285,173,112
475732,40,1,1,0,,,,1,1,0
475839,40,3,1,2,,,,3,1,2
476692,40,2,2,0,2,2,0,,,
476726,40,147,11,136,147,11,136,,,
476975,40,100,41,59,,,,100,41,59
479956,40,412,261,151,13,5,8,399,256,143
480091,40,2382,531,1851,361,78,283,2021,453,1568
480569,40,3,1,2,,,,3,1,2
480967,40,15,3,12,,,,15,3,12
481021,40,1,0,1,,,,1,0,1
482149,40,280,120,160,31,12,19,249,108,141
482158,40,670,262,408,46,18,28,624,244,380
482228,40,15,8,7,1,1,0,14,7,7
482431,40,1,0,1,,,,1,0,1
482468,40,1,0,1,1,0,1,,,
482477,40,193,87,106,86,38,48,107,49,58
482680,40,1425,556,869,129,55,74,1296,501,795
482699,40,223,61,162,4,0,4,219,61,158
482705,40,1266,571,695,1175,537,638,91,34,57
482936,40,14,10,4,,,,14,10,4
483036,40,6,5,1,,,,6,5,1
483045,40,4290,1903,2387,144,52,92,4146,1851,2295
483124,40,267,132,135,2,2,0,265,130,135
483212,40,945,578,367,17,10,7,928,568,360
484002,40,63,7,56,61,7,54,2,0,2
484473,40,706,309,397,,,,706,309,397
484613,40,3074,1185,1889,3074,1185,1889,,,
484905,40,78,19,59,57,14,43,21,5,16
484932,40,56,29,27,,,,56,29,27
485111,40,2864,968,1896,82,20,62,2782,948,1834
485342,40,166,62,104,,,,166,62,104
485458,40,2167,848,1319,161,68,93,2006,780,1226
486026,40,10,10,0,10,10,0,,,
486150,40,27,14,13,10,8,2,17,6,11
486239,40,49,23,26,49,23,26,,,
486840,40,876,357,519,217,93,124,659,264,395
486901,40,29,10,19,,,,29,10,19
487162,40,1828,797,1031,52,27,25,1776,770,1006
487320,40,1826,1368,458,874,725,149,952,643,309
487524,40,91,22,69,,,,91,22,69
487603,40,567,280,287,27,15,12,540,265,275
487995,40,4,1,3,,,,4,1,3
488068,40,11,1,10,,,,11,1,10
488305,40,8,2,6,,,,8,2,6
488314,40,2,2,0,2,2,0,,,
488679,40,70,32,38,,,,70,32,38
488730,40,2122,794,1328,141,45,96,1981,749,1232
488776,40,6,2,4,4,2,2,2,0,2
488785,40,1,1,0,,,,1,1,0
488846,40,10967,5851,5116,2782,1476,1306,8185,4375,3810
488891,40,168,53,115,168,53,115,,,
488934,40,2737,1344,1393,,,,2737,1344,1393
489201,40,1324,524,800,90,46,44,1234,478,756
489779,40,171,81,90,18,9,9,153,72,81
490346,40,5,0,5,5,0,5,,,
490504,40,18,18,0,18,18,0,,,
490805,40,2093,856,1237,26,12,14,2067,844,1223
491288,40,6,2,4,,,,6,2,4
491297,40,1,0,1,,,,1,0,1
491525,40,10,7,3,,,,10,7,3
491631,40,39,0,39,,,,39,0,39
491659,40,59,52,7,59,52,7,,,
491710,40,8,8,0,8,8,0,,,
491765,40,4,4,0,4,4,0,,,
491844,40,9,0,9,,,,9,0,9
491950,40,3,0,3,,,,3,0,3
492069,40,5,3,2,5,3,2,,,
492689,40,1,0,1,,,,1,0,1
492759,40,4,0,4,,,,4,0,4
492801,40,30,11,19,3,0,3,27,11,16
492962,40,147,60,87,,,,147,60,87
493664,40,1,1,0,1,1,0,,,
493822,40,38,25,13,1,0,1,37,25,12
493895,40,2,1,1,,,,2,1,1
494597,40,28,8,20,17,4,13,11,4,7
494603,40,21,10,11,3,2,1,18,8,10
494685,40,6,3,3,2,1,1,4,2,2
494959,40,21,8,13,,,,21,8,13
495013,40,4,3,1,,,,4,3,1
495147,40,1,0,1,1,0,1,,,
495271,40,19,4,15,,,,19,4,15
495280,40,5,3,2,,,,5,3,2
496283,40,12,6,6,12,6,6,,,
496326,40,25,5,20,25,5,20,,,
496645,40,90,67,23,,,,90,67,23
497046,40,1318,470,848,26,10,16,1292,460,832
497107,40,29,5,24,,,,29,5,24
497408,40,1,1,0,1,1,0,,,
497462,40,116,50,66,116,50,66,,,
497824,40,14,6,8,,,,14,6,8
497833,40,1,0,1,,,,1,0,1
498562,40,1238,467,771,195,81,114,1043,386,657
498571,40,201,83,118,6,4,2,195,79,116
100654,50,801,258,543,468,137,331,333,121,212
100663,50,8607,3019,5588,4817,1850,2967,3790,1169,2621
100690,50,419,195,224,131,65,66,288,130,158
100706,50,2068,1068,1000,726,401,325,1342,667,675
100724,50,532,162,370,383,114,269,149,48,101
100751,50,6186,2354,3832,3635,1571,2064,2551,783,1768
100812,50,374,143,231,46,15,31,328,128,200
100830,50,1355,701,654,692,441,251,663,260,403
100858,50,6385,2994,3391,3500,1455,2045,2885,1539,1346
101116,50,46,7,39,27,4,23,19,3,16
101189,50,1025,359,666,861,285,576,164,74,90
101365,50,8,1,7,7,1,6,1,0,1
101435,50,5,1,4,5,1,4,,,
101453,50,61,54,7,11,10,1,50,44,6
101480,50,1322,471,851,479,162,317,843,309,534
101587,50,3433,717,2716,3085,622,2463,348,95,253
101693,50,220,77,143,91,24,67,129,53,76
101709,50,414,86,328,156,29,127,258,57,201
101879,50,2616,840,1776,797,229,568,1819,611,1208
101912,50,39,20,19,25,13,12,14,7,7
102049,50,2010,639,1371,1842,590,1252,168,49,119
102058,50,19,10,9,12,8,4,7,2,5
102094,50,4958,1017,3941,3992,855,3137,966,162,804
102234,50,113,66,47,20,13,7,93,53,40
102298,50,68,18,50,64,17,47,4,1,3
102368,50,3388,1260,2128,1083,293,790,2305,967,1338
102377,50,470,111,359,426,100,326,44,11,33
102395,50,132,90,42,35,27,8,97,63,34
102553,50,539,188,351,148,56,92,391,132,259
102614,50,971,389,582,343,152,191,628,237,391
102632,50,199,54,145,42,14,28,157,40,117
102669,50,105,33,72,57,14,43,48,19,29
104090,50,47,11,36,47,11,36,,,
104151,50,14573,8063,6510,11453,6567,4886,3120,1496,1624
104179,50,10652,4772,5880,6093,2622,3471,4559,2150,2409
104586,50,42,29,13,39,28,11,3,1,2
104665,50,6,5,1,6,5,1,,,
104717,50,35047,7869,27178,6,3,3,35041,7866,27175
105297,50,4,2,2,4,2,2,,,
105330,50,4882,1724,3158,2724,1009,1715,2158,715,1443
105534,50,112,16,96,112,16,96,,,
105589,50,656,131,525,236,38,198,420,93,327
106245,50,2372,938,1434,1140,509,631,1232,429,803
106263,50,1941,713,1228,1572,616,956,369,97,272
106397,50,4667,2088,2579,1768,718,1050,2899,1370,1529
106412,50,205,100,105,128,67,61,77,33,44
106458,50,4989,1466,3523,549,181,368,4440,1285,3155
106467,50,723,253,470,149,71,78,574,182,392
106485,50,449,150,299,151,61,90,298,89,209
106704,50,1919,469,1450,723,197,526,1196,272,924
107044,50,1282,464,818,559,183,376,723,281,442
107071,50,712,149,563,118,12,106,594,137,457
107080,50,12,10,2,11,9,2,1,1,0
107141,50,525,143,382,111,28,83,414,115,299
107512,50,54,6,48,46,4,42,8,2,6
107877,50,22,8,14,,,,22,8,14
107983,50,1946,947,999,707,437,270,1239,510,729
108092,50,44,8,36,12,1,11,32,7,25
108232,50,2231,749,1482,1071,416,655,1160,333,827
108269,50,111,33,78,80,30,50,31,3,28
108861,50,69,38,31,12,5,7,57,33,24
108870,50,423,189,234,422,188,234,1,1,0
109651,50,285,135,150,263,123,140,22,12,10
109785,50,3821,968,2853,1894,498,1396,1927,470,1457
110060,50,83,47,36,57,33,24,26,14,12
110097,50,1888,1033,855,747,379,368,1141,654,487
110316,50,2058,386,1672,1066,247,819,992,139,853
110361,50,3161,858,2303,2122,541,1581,1039,317,722
110370,50,356,103,253,334,96,238,22,7,15
110398,50,1193,472,721,1160,458,702,33,14,19
110404,50,1419,927,492,1419,927,492,,,
110413,50,1102,386,716,902,316,586,200,70,130
110422,50,974,497,477,712,328,384,262,169,93
110468,50,3325,740,2585,1687,338,1349,1638,402,1236
110486,50,1425,389,1036,983,253,730,442,136,306
110495,50,1228,316,912,801,162,639,427,154,273
110510,50,2769,935,1834,1657,494,1163,1112,441,671
110529,50,2322,1072,1250,1042,412,630,1280,660,620
110538,50,1202,398,804,722,225,497,480,173,307
110547,50,2457,749,1708,1389,402,987,1068,347,721
110556,50,2645,888,1757,1849,587,1262,796,301,495
110565,50,4954,1855,3099,2267,792,1475,2687,1063,1624
110574,50,2877,1112,1765,1951,754,1197,926,358,568
110583,50,6042,2315,3727,3661,1385,2276,2381,930,1451
110592,50,3723,1388,2335,2344,827,1517,1379,561,818
110608,50,5398,1872,3526,2709,940,1769,2689,932,1757
110617,50,2897,939,1958,1655,463,1192,1242,476,766
110635,50,12828,6550,6278,10198,4992,5206,2630,1558,1072
110644,50,8147,3562,4585,7399,3208,4191,748,354,394
110653,50,7275,3673,3602,6801,3440,3361,474,233,241
110662,50,14007,7016,6991,12627,6146,6481,1380,870,510
110671,50,3898,2129,1769,3587,1952,1635,311,177,134
110680,50,8910,5119,3791,8114,4636,3478,796,483,313
110699,50,3140,1119,2021,3140,1119,2021,,,
110705,50,2961,1545,1416,2721,1428,1293,240,117,123
110714,50,1976,1043,933,1918,1008,910,58,35,23
110778,50,937,318,619,15,1,14,922,317,605
111045,50,41,14,27,33,12,21,8,2,6
111081,50,500,180,320,479,172,307,21,8,13
111188,50,41,28,13,,,,41,28,13
111391,50,623,241,382,531,204,327,92,37,55
111948,50,2145,795,1350,1689,621,1068,456,174,282
111966,50,531,133,398,484,122,362,47,11,36
112075,50,2045,698,1347,1550,458,1092,495,240,255
112084,50,27,11,16,13,7,6,14,4,10
112127,50,64,26,38,19,10,9,45,16,29
112251,50,1903,764,1139,1135,463,672,768,301,467
112260,50,3,0,3,3,0,3,,,
112394,50,11,8,3,9,7,2,2,1,1
112525,50,3724,1354,2370,3683,1344,2339,41,10,31
113582,50,11,1,10,11,1,10,,,
113698,50,738,212,526,638,196,442,100,16,84
113704,50,62,53,9,43,39,4,19,14,5
114114,50,198,35,163,81,12,69,117,23,94
114123,50,78,26,52,77,26,51,1,0,1
114354,50,34,3,31,20,1,19,14,2,12
114549,50,1000,215,785,737,160,577,263,55,208
114585,50,335,73,262,205,48,157,130,25,105
114734,50,66,38,28,22,16,6,44,22,22
114813,50,1288,304,984,578,122,456,710,182,528
114840,50,2089,1125,964,380,157,223,1709,968,741
115083,50,2060,1063,997,1293,727,566,767,336,431
115214,50,172,84,88,121,74,47,51,10,41
115728,50,395,100,295,191,46,145,204,54,150
115746,50,851,229,622,584,159,425,267,70,197
115755,50,564,174,390,395,131,264,169,43,126
115773,50,234,65,169,127,43,84,107,22,85
116846,50,66,26,40,42,15,27,24,11,13
117104,50,103,51,52,92,46,46,11,5,6
117140,50,2297,667,1630,1351,406,945,946,261,685
117168,50,31,11,20,27,9,18,4,2,2
117520,50,587,327,260,553,301,252,34,26,8
117557,50,200,133,67,199,132,67,1,1,0
117575,50,122,60,62,31,14,17,91,46,45
117627,50,351,125,226,232,77,155,119,48,71
117636,50,3265,1167,2098,2635,1006,1629,630,161,469
117672,50,1159,569,590,1083,538,545,76,31,45
117751,50,841,733,108,228,217,11,613,516,97
117946,50,2866,1048,1818,2264,816,1448,602,232,370
119058,50,639,193,446,498,141,357,141,52,89
119173,50,643,148,495,507,117,390,136,31,105
119270,50,32,14,18,32,14,18,,,
119605,50,10146,2909,7237,7104,1983,5121,3042,926,2116
119678,50,2670,2091,579,1445,1180,265,1225,911,314
119775,50,65,40,25,51,35,16,14,5,9
120166,50,140,61,79,136,60,76,4,1,3
120184,50,201,50,151,54,8,46,147,42,105
120403,50,44,9,35,44,9,35,,,
120537,50,526,136,390,365,86,279,161,50,111
120698,50,1097,162,935,861,122,739,236,40,196
120768,50,670,90,580,30,7,23,640,83,557
120795,50,109,36,73,27,8,19,82,28,54
120838,50,4,2,2,4,2,2,,,
120865,50,22,10,12,1,1,0,21,9,12
120883,50,2983,1182,1801,2328,928,1400,655,254,401
121150,50,6368,1835,4533,2547,877,1670,3821,958,2863
121309,50,1165,376,789,509,156,353,656,220,436
121628,50,126,74,52,126,74,52,,,
121691,50,1147,396,751,907,308,599,240,88,152
122117,50,92,34,58,66,26,40,26,8,18
122296,50,1207,303,904,801,215,586,406,88,318
122409,50,5208,1877,3331,3173,1004,2169,2035,873,1162
122436,50,3146,1288,1858,1576,579,997,1570,709,861
122506,50,216,103,113,213,101,112,3,2,1
122597,50,3321,1185,2136,2084,707,1377,1237,478,759
122612,50,3670,1230,2440,1789,580,1209,1881,650,1231
122649,50,145,58,87,131,55,76,14,3,11
122728,50,455,204,251,336,161,175,119,43,76
122755,50,8888,3301,5587,4404,1768,2636,4484,1533,2951
122931,50,3063,1408,1655,2009,981,1028,1054,427,627
123095,50,1013,170,843,234,44,190,779,126,653
123165,50,19,7,12,15,6,9,4,1,3
123280,50,9,6,3,1,1,0,8,5,3
123448,50,382,127,255,204,60,144,178,67,111
123457,50,145,47,98,56,14,42,89,33,56
123554,50,762,272,490,377,161,216,385,111,274
123572,50,703,207,496,342,84,258,361,123,238
123633,50,188,57,131,133,38,95,55,19,36
123651,50,255,80,175,71,12,59,184,68,116
123916,50,85,19,66,32,8,24,53,11,42
123943,50,685,197,488,665,190,475,20,7,13
123952,50,257,148,109,252,145,107,5,3,2
123961,50,28246,12658,15588,22784,10192,12592,5462,2466,2996
123970,50,927,376,551,722,308,414,205,68,137
124283,50,196,114,82,141,88,53,55,26,29
124487,50,39,21,18,2,1,1,37,20,17
125037,50,255,90,165,239,89,150,16,1,15
125231,50,36014,6353,29661,15475,2615,12860,20539,3738,16801
125718,50,101,89,12,70,61,9,31,28,3
125763,50,61,19,42,23,6,17,38,13,25
125897,50,75,34,41,59,25,34,16,9,7
126012,50,520,108,412,520,108,412,,,
126049,50,271,98,173,214,81,133,57,17,40
126182,50,1266,371,895,680,148,532,586,223,363
126562,50,9689,3409,6280,4048,1546,2502,5641,1863,3778
126580,50,1891,782,1109,530,176,354,1361,606,755
126614,50,8551,5078,3473,2909,1557,1352,5642,3521,2121
126669,50,1362,327,1035,553,144,409,809,183,626
126678,50,23,2,21,8,0,8,15,2,13
126775,50,1689,1186,503,1291,880,411,398,306,92
126818,50,7626,3177,4449,3080,1100,1980,4546,2077,2469
126827,50,2415,902,1513,2006,726,1280,409,176,233
126979,50,874,450,424,250,115,135,624,335,289
127060,50,7583,2503,5080,2971,816,2155,4612,1687,2925
127185,50,92,19,73,20,4,16,72,15,57
127273,50,185,73,112,123,46,77,62,27,35
127556,50,224,74,150,129,40,89,95,34,61
127565,50,1147,242,905,663,105,558,484,137,347
127653,50,722,189,533,372,101,271,350,88,262
127741,50,2652,634,2018,819,238,581,1833,396,1437
127909,50,95,24,71,95,24,71,,,
127918,50,2270,701,1569,1691,519,1172,579,182,397
127954,50,34,5,29,34,5,29,,,
128106,50,1845,446,1399,398,112,286,1447,334,1113
128391,50,453,154,299,315,116,199,138,38,100
128498,50,288,67,221,191,50,141,97,17,80
128744,50,2351,1065,1286,1485,847,638,866,218,648
128771,50,1803,648,1155,470,167,303,1333,481,852
128780,50,101,19,82,8,0,8,93,19,74
129020,50,8020,3607,4413,5472,2446,3026,2548,1161,1387
129154,50,127,26,101,23,4,19,104,22,82
129215,50,156,42,114,81,27,54,75,15,60
129242,50,1262,441,821,606,247,359,656,194,462
129428,50,115,84,31,,,,115,84,31
129491,50,92,53,39,43,30,13,49,23,26
129525,50,1763,623,1140,723,256,467,1040,367,673
129534,50,448,318,130,39,29,10,409,289,120
129941,50,4002,2131,1871,3055,1688,1367,947,443,504
130110,50,4,2,2,2,1,1,2,1,1
130183,50,2352,533,1819,1195,163,1032,1157,370,787
130226,50,2715,844,1871,1732,612,1120,983,232,751
130253,50,3939,1475,2464,2396,1116,1280,1543,359,1184
130314,50,1161,232,929,647,144,503,514,88,426
130493,50,1969,490,1479,858,198,660,1111,292,819
130590,50,38,25,13,5,2,3,33,23,10
130697,50,184,71,113,124,52,72,60,19,41
130776,50,618,160,458,69,21,48,549,139,410
130794,50,8131,3703,4428,7944,3612,4332,187,91,96
130934,50,830,229,601,699,200,499,131,29,102
130943,50,4557,2150,2407,3638,1766,1872,919,384,535
130989,50,392,166,226,85,23,62,307,143,164
131113,50,4929,1743,3186,1388,665,723,3541,1078,2463
131159,50,5968,2230,3738,3240,1210,2030,2728,1020,1708
131283,50,1957,971,986,825,423,402,1132,548,584
131399,50,520,204,316,322,118,204,198,86,112
131405,50,73,65,8,62,55,7,11,10,1
131450,50,408,110,298,257,61,196,151,49,102
131469,50,14457,5598,8859,7326,3071,4255,7131,2527,4604
131496,50,13084,5950,7134,8275,3816,4459,4809,2134,2675
131520,50,3077,1036,2041,2528,885,1643,549,151,398
131803,50,47,14,33,15,6,9,32,8,24
131876,50,334,34,300,109,8,101,225,26,199
131973,50,454,245,209,186,103,83,268,142,126
132408,50,25,14,11,8,3,5,17,11,6
132471,50,3836,1089,2747,2404,731,1673,1432,358,1074
132602,50,99,36,63,79,27,52,20,9,11
132657,50,728,275,453,409,137,272,319,138,181
132842,50,647,84,563,435,59,376,212,25,187
132903,50,9684,4023,5661,4759,2120,2639,4925,1903,3022
133465,50,225,59,166,197,58,139,28,1,27
133526,50,39,25,14,36,24,12,3,1,2
133553,50,768,542,226,646,454,192,122,88,34
133650,50,1506,489,1017,1244,399,845,262,90,172
133669,50,5401,2112,3289,2568,1043,1525,2833,1069,1764
133711,50,16,2,14,1,1,0,15,1,14
133872,50,500,141,359,310,101,209,190,40,150
133881,50,4951,1593,3358,1089,559,530,3862,1034,2828
133951,50,9921,3896,6025,7456,2929,4527,2465,967,1498
133979,50,39,8,31,15,5,10,24,3,21
134079,50,560,193,367,363,141,222,197,52,145
134097,50,11225,4252,6973,6452,2694,3758,4773,1558,3215
134130,50,20659,8681,11978,12952,6024,6928,7707,2657,5050
134237,50,1205,664,541,1205,664,541,,,
134510,50,5,2,3,,,,5,2,3
134811,50,43,13,30,21,3,18,22,10,12
134945,50,1274,340,934,653,178,475,621,162,459
135081,50,2060,647,1413,1548,514,1034,512,133,379
135364,50,369,270,99,82,58,24,287,212,75
135610,50,53,18,35,19,4,15,34,14,20
135726,50,6898,3003,3895,6137,2724,3413,761,279,482
136172,50,2235,631,1604,976,281,695,1259,350,909
136215,50,13977,3977,10000,9031,2922,6109,4946,1055,3891
136330,50,801,273,528,505,156,349,296,117,179
136701,50,137,134,3,115,114,1,22,20,2
136950,50,446,205,241,231,114,117,215,91,124
137032,50,2922,1150,1772,1564,681,883,1358,469,889
137272,50,9,9,0,9,9,0,,,
137351,50,11553,4523,7030,6834,2931,3903,4719,1592,3127
137476,50,2420,858,1562,2061,748,1313,359,110,249
137546,50,1367,585,782,1001,442,559,366,143,223
137564,50,1204,495,709,485,206,279,719,289,430
137777,50,1,1,0,1,1,0,,,
137847,50,964,417,547,446,214,232,518,203,315
137953,50,10,6,4,,,,10,6,4
138275,50,88,54,34,8,5,3,80,49,31
138293,50,33,15,18,29,14,15,4,1,3
138309,50,229,38,191,137,27,110,92,11,81
138354,50,4230,1315,2915,599,162,437,3631,1153,2478
138600,50,108,8,100,84,7,77,24,1,23
138716,50,522,83,439,310,47,263,212,36,176
138868,50,72,45,27,6,3,3,66,42,24
138929,50,342,120,222,227,80,147,115,40,75
138947,50,573,162,411,392,113,279,181,49,132
139144,50,117,35,82,40,11,29,77,24,53
139153,50,228,108,120,161,73,88,67,35,32
139199,50,1336,223,1113,837,148,689,499,75,424
139311,50,564,162,402,255,68,187,309,94,215
139348,50,158,60,98,121,40,81,37,20,17
139366,50,1476,469,1007,444,161,283,1032,308,724
139393,50,39,11,28,29,9,20,10,2,8
139579,50,527,130,397,485,124,361,42,6,36
139630,50,10,0,10,10,0,10,,,
139658,50,7740,2706,5034,6320,2146,4174,1420,560,860
139719,50,245,60,185,143,36,107,102,24,78
139755,50,26881,19526,7355,7705,5167,2538,19176,14359,4817
139764,50,597,136,461,298,38,260,299,98,201
139861,50,1050,313,737,311,110,201,739,203,536
139931,50,3502,962,2540,1511,460,1051,1991,502,1489
139940,50,7592,2694,4898,5416,1999,3417,2176,695,1481
139959,50,9893,3758,6135,7507,2969,4538,2386,789,1597
140146,50,193,107,86,97,55,42,96,52,44
140234,50,72,21,51,64,18,46,8,3,5
140252,50,1838,882,956,1597,783,814,241,99,142
140340,50,48,19,29,45,17,28,3,2,1
140447,50,4030,1232,2798,2842,924,1918,1188,308,880
140562,50,891,307,584,819,290,529,72,17,55
140818,50,598,139,459,131,33,98,467,106,361
140872,50,82,42,40,66,35,31,16,7,9
140951,50,2832,853,1979,2167,663,1504,665,190,475
140960,50,205,66,139,111,34,77,94,32,62
140988,50,142,64,78,112,50,62,30,14,16
141167,50,738,136,602,355,68,287,383,68,315
141185,50,38,8,30,16,2,14,22,6,16
141237,50,113,68,45,71,45,26,42,23,19
141264,50,2636,658,1978,773,175,598,1863,483,1380
141325,50,46,2,44,37,2,35,9,0,9
141334,50,3227,751,2476,612,177,435,2615,574,2041
141361,50,15,9,6,15,9,6,,,
141486,50,786,215,571,559,133,426,227,82,145
141565,50,384,120,264,231,68,163,153,52,101
141574,50,4876,1838,3038,2317,868,1449,2559,970,1589
141644,50,725,253,472,498,184,314,227,69,158
142115,50,3193,1113,2080,1188,433,755,2005,680,1325
142276,50,2284,860,1424,1471,576,895,813,284,529
142285,50,2698,1343,1355,1766,859,907,932,484,448
142294,50,30,10,20,21,7,14,9,3,6
142328,50,2,2,0,,,,2,2,0
142461,50,638,167,471,216,47,169,422,120,302
142832,50,1832,336,1496,1072,186,886,760,150,610
142957,50,9,4,5,3,1,2,6,3,3
143048,50,713,186,527,641,166,475,72,20,52
143084,50,31,0,31,31,0,31,,,
143118,50,1870,370,1500,925,164,761,945,206,739
143233,50,79,36,43,21,9,12,58,27,31
143297,50,14,1,13,,,,14,1,13
143358,50,1409,441,968,505,289,216,904,152,752
143659,50,213,134,79,110,88,22,103,46,57
143853,50,2758,913,1845,2714,901,1813,44,12,32
143978,50,1262,242,1020,825,144,681,437,98,339
144005,50,867,275,592,461,159,302,406,116,290
144014,50,195,74,121,52,22,30,143,52,91
144050,50,10744,5897,4847,8829,4694,4135,1915,1203,712
144281,50,222,89,133,177,72,105,45,17,28
144351,50,4026,1275,2751,211,80,131,3815,1195,2620
144740,50,6783,2936,3847,4954,2100,2854,1829,836,993
144892,50,1941,897,1044,948,518,430,993,379,614
144962,50,704,251,453,260,46,214,444,205,239
145275,50,280,129,151,209,99,110,71,30,41
145336,50,1818,639,1179,964,432,532,854,207,647
145372,50,140,44,96,29,6,23,111,38,73
145558,50,1940,798,1142,1885,784,1101,55,14,41
145600,50,11940,4743,7197,8332,3430,4902,3608,1313,2295
145619,50,1081,313,768,214,62,152,867,251,616
145628,50,481,130,351,461,127,334,20,3,17
145637,50,21796,12179,9617,13233,7356,5877,8563,4823,3740
145691,50,1,0,1,1,0,1,,,
145725,50,3818,2279,1539,2726,1541,1185,1092,738,354
145813,50,2628,880,1748,1406,568,838,1222,312,910
145886,50,119,26,93,112,22,90,7,4,3
146339,50,175,75,100,141,64,77,34,11,23
146481,50,26,5,21,13,2,11,13,3,10
146490,50,295,127,168,,,,295,127,168
146612,50,2580,1209,1371,1415,875,540,1165,334,831
146667,50,171,100,71,50,16,34,121,84,37
146719,50,5196,1632,3564,3923,1294,2629,1273,338,935
146728,50,133,68,65,127,66,61,6,2,4
146755,50,20,5,15,19,5,14,1,0,1
146977,50,162,97,65,128,82,46,34,15,19
147013,50,426,129,297,153,62,91,273,67,206
147031,50,69,21,48,43,13,30,26,8,18
147129,50,23,1,22,18,0,18,5,1,4
147244,50,99,35,64,67,25,42,32,10,22
147369,50,657,393,264,204,121,83,453,272,181
147536,50,3541,620,2921,1517,310,1207,2024,310,1714
147590,50,465,187,278,434,179,255,31,8,23
147660,50,327,90,237,277,71,206,50,19,31
147679,50,792,285,507,105,34,71,687,251,436
147697,50,374,225,149,234,131,103,140,94,46
147703,50,4220,1730,2490,1977,952,1025,2243,778,1465
147767,50,14168,6585,7583,10608,4906,5702,3560,1679,1881
147776,50,1549,490,1059,422,150,272,1127,340,787
147828,50,736,201,535,42,17,25,694,184,510
148131,50,160,85,75,32,19,13,128,66,62
148405,50,230,91,139,74,39,35,156,52,104
148487,50,1312,346,966,740,222,518,572,124,448
148496,50,1060,211,849,355,61,294,705,150,555
148511,50,2755,624,2131,1761,501,1260,994,123,871
148575,50,127,13,114,,,,127,13,114
148584,50,1883,407,1476,238,63,175,1645,344,1301
148593,50,12,2,10,,,,12,2,10
148627,50,542,125,417,170,33,137,372,92,280
148654,50,1805,946,859,815,449,366,990,497,493
148885,50,204,182,22,135,132,3,69,50,19
148982,50,99,35,64,26,5,21,73,30,43
149028,50,61,6,55,3,0,3,58,6,52
149222,50,3107,1462,1645,2098,948,1150,1009,514,495
149231,50,3198,1274,1924,1566,688,878,1632,586,1046
149329,50,11,11,0,11,11,0,,,
149505,50,54,8,46,43,5,38,11,3,8
149514,50,792,574,218,281,193,88,511,381,130
149639,50,169,61,108,12,4,8,157,57,100
149763,50,58,7,51,45,4,41,13,3,10
149772,50,2334,1043,1291,1267,694,573,1067,349,718
149781,50,722,289,433,226,83,143,496,206,290
150066,50,161,82,79,10,6,4,151,76,75
150136,50,5361,1260,4101,1175,363,812,4186,897,3289
150145,50,111,46,65,28,14,14,83,32,51
150163,50,1098,384,714,437,130,307,661,254,407
150172,50,95,40,55,38,14,24,57,26,31
150215,50,152,50,102,104,32,72,48,18,30
150288,50,294,260,34,221,196,25,73,64,9
150455,50,65,26,39,29,13,16,36,13,23
150534,50,300,99,201,292,96,196,8,3,5
150604,50,63,15,48,57,10,47,6,5,1
150668,50,51,10,41,13,6,7,38,4,34
150677,50,356,195,161,72,20,52,284,175,109
150756,50,173,72,101,173,72,101,,,
150941,50,243,62,181,114,21,93,129,41,88
151102,50,679,325,354,307,166,141,372,159,213
151111,50,8252,3084,5168,5033,2093,2940,3219,991,2228
151263,50,1303,310,993,651,161,490,652,149,503
151290,50,1105,643,462,609,360,249,496,283,213
151306,50,1823,660,1163,363,118,245,1460,542,918
151324,50,1693,606,1087,802,285,517,891,321,570
151333,50,177,67,110,52,17,35,125,50,75
151342,50,573,131,442,181,33,148,392,98,294
151351,50,11345,6055,5290,7258,3877,3381,4087,2178,1909
151360,50,338,79,259,99,19,80,239,60,179
151379,50,445,157,288,77,19,58,368,138,230
151388,50,253,80,173,20,4,16,233,76,157
151777,50,275,100,175,232,87,145,43,13,30
151786,50,1068,414,654,775,330,445,293,84,209
151801,50,367,76,291,178,41,137,189,35,154
151810,50,26,9,17,17,6,11,9,3,6
151865,50,132,73,59,24,10,14,108,63,45
152080,50,4134,2340,1794,3856,2207,1649,278,133,145
152099,50,181,73,108,60,22,38,121,51,70
152318,50,19,15,4,15,11,4,4,4,0
152336,50,327,86,241,148,42,106,179,44,135
152381,50,332,45,287,119,19,100,213,26,187
152390,50,113,2,111,60,1,59,53,1,52
152451,50,175,151,24,110,110,0,65,41,24
152530,50,33,17,16,14,7,7,19,10,9
152567,50,269,67,202,249,65,184,20,2,18
152600,50,609,319,290,438,229,209,171,90,81
152798,50,219,32,187,145,22,123,74,10,64
152992,50,218,67,151,112,49,63,106,18,88
153001,50,499,88,411,9,0,9,490,88,402
153126,50,180,60,120,92,25,67,88,35,53
153162,50,15,7,8,8,2,6,7,5,2
153250,50,243,76,167,23,2,21,220,74,146
153269,50,1850,612,1238,840,289,551,1010,323,687
153278,50,332,136,196,284,116,168,48,20,28
153320,50,71,61,10,28,26,2,43,35,8
153366,50,352,64,288,158,29,129,194,35,159
153375,50,271,87,184,134,56,78,137,31,106
153603,50,4728,2345,2383,3029,1447,1582,1699,898,801
153621,50,86,50,36,73,43,30,13,7,6
153658,50,8042,3665,4377,5051,2213,2838,2991,1452,1539
153825,50,92,28,64,81,25,56,11,3,8
153861,50,1992,1220,772,1289,942,347,703,278,425
153977,50,2,0,2,,,,2,0,2
154004,50,1063,192,871,59,9,50,1004,183,821
154013,50,255,70,185,105,26,79,150,44,106
154022,50,6989,2241,4748,6989,2241,4748,,,
154095,50,1210,284,926,399,109,290,811,175,636
154101,50,498,108,390,96,20,76,402,88,314
154156,50,1527,706,821,1392,673,719,135,33,102
154174,50,2146,1216,930,2113,1194,919,33,22,11
154235,50,629,180,449,441,102,339,188,78,110
154350,50,24,11,13,16,7,9,8,4,4
154493,50,609,196,413,468,144,324,141,52,89
154518,50,468,260,208,195,117,78,273,143,130
154527,50,28,8,20,23,7,16,5,1,4
154536,50,186,76,110,169,70,99,17,6,11
154590,50,69,46,23,43,32,11,26,14,12
154688,50,596,203,393,15,1,14,581,202,379
154712,50,73,43,30,33,25,8,40,18,22
154855,50,34,26,8,34,26,8,,,
155025,50,2584,745,1839,638,204,434,1946,541,1405
155061,50,2522,740,1782,612,155,457,1910,585,1325
155070,50,17,13,4,10,8,2,7,5,2
155089,50,446,124,322,145,30,115,301,94,207
155317,50,7467,3155,4312,5505,2396,3109,1962,759,1203
155335,50,404,114,290,320,96,224,84,18,66
155399,50,4676,1800,2876,2530,1022,1508,2146,778,1368
155414,50,68,46,22,,,,68,46,22
155511,50,7,2,5,1,0,1,6,2,4
155520,50,349,63,286,69,16,53,280,47,233
155627,50,100,61,39,92,55,37,8,6,2
155636,50,193,85,108,146,69,77,47,16,31
155681,50,1369,549,820,387,191,196,982,358,624
155812,50,364,141,223,187,76,111,177,65,112
155900,50,107,58,49,41,31,10,66,27,39
155937,50,24,10,14,18,6,12,6,4,2
155973,50,66,35,31,,,,66,35,31
156082,50,727,252,475,472,198,274,255,54,201
156125,50,4167,1963,2204,2400,1316,1084,1767,647,1120
156213,50,246,93,153,16,7,9,230,86,144
156222,50,1747,1021,726,508,274,234,1239,747,492
156286,50,627,208,419,294,113,181,333,95,238
156356,50,95,14,81,52,1,51,43,13,30
156365,50,5364,3092,2272,4803,2842,1961,561,250,311
156417,50,14,13,1,14,13,1,,,
156471,50,444,38,406,375,34,341,69,4,65
156541,50,12879,6466,6413,2838,974,1864,10041,5492,4549
156620,50,2252,674,1578,654,207,447,1598,467,1131
156727,50,2335,143,2192,1634,90,1544,701,53,648
156745,50,315,63,252,1,0,1,314,63,251
157021,50,59,26,33,46,21,25,13,5,8
157058,50,116,58,58,54,30,24,62,28,34
157085,50,8812,3140,5672,6830,2568,4262,1982,572,1410
157100,50,52,21,31,9,7,2,43,14,29
157207,50,90,44,46,9,5,4,81,39,42
157216,50,1406,774,632,1024,675,349,382,99,283
157289,50,6096,2756,3340,4164,1853,2311,1932,903,1029
157298,50,100,31,69,72,22,50,28,9,19
157377,50,238,82,156,99,41,58,139,41,98
157386,50,592,239,353,155,80,75,437,159,278
157401,50,1800,667,1133,541,168,373,1259,499,760
157447,50,5025,1368,3657,1221,372,849,3804,996,2808
157535,50,943,413,530,932,406,526,11,7,4
157748,50,3248,2757,491,1426,1238,188,1822,1519,303
157757,50,765,160,605,508,110,398,257,50,207
157793,50,465,165,300,379,126,253,86,39,47
157809,50,129,56,73,61,30,31,68,26,42
157863,50,246,115,131,107,48,59,139,67,72
157951,50,2053,693,1360,741,222,519,1312,471,841
158477,50,33,14,19,,,,33,14,19
159009,50,857,222,635,206,71,135,651,151,500
159373,50,1860,666,1194,1774,650,1124,86,16,70
159391,50,6396,2498,3898,4556,1763,2793,1840,735,1105
159416,50,6256,2403,3853,1483,514,969,4773,1889,2884
159568,50,194,49,145,89,26,63,105,23,82
159647,50,915,425,490,613,293,320,302,132,170
159656,50,1108,383,725,691,281,410,417,102,315
159717,50,534,135,399,244,85,159,290,50,240
159939,50,1307,558,749,641,299,342,666,259,407
159948,50,1054,753,301,458,301,157,596,452,144
159966,50,569,120,449,235,51,184,334,69,265
159993,50,1846,424,1422,1006,281,725,840,143,697
160038,50,984,210,774,211,92,119,773,118,655
160065,50,346,62,284,146,24,122,200,38,162
160074,50,337,93,244,258,80,178,79,13,66
160612,50,1039,235,804,412,114,298,627,121,506
160621,50,1756,667,1089,1075,406,669,681,261,420
160630,50,270,78,192,171,50,121,99,28,71
160658,50,2269,1005,1264,1093,518,575,1176,487,689
160755,50,5242,2062,3180,3291,1319,1972,1951,743,1208
160904,50,723,176,547,693,168,525,30,8,22
160959,50,3,2,1,3,2,1,,,
160995,50,1,0,1,1,0,1,,,
161217,50,62,28,34,4,2,2,58,26,32
161226,50,279,42,237,24,1,23,255,41,214
161235,50,16,3,13,14,1,13,2,2,0
161253,50,2457,924,1533,745,295,450,1712,629,1083
161299,50,19,15,4,8,6,2,11,9,2
161341,50,23,13,10,3,2,1,20,11,9
161457,50,2716,759,1957,2273,661,1612,443,98,345
161509,50,56,13,43,53,12,41,3,1,2
161518,50,488,180,308,112,41,71,376,139,237
161554,50,1967,492,1475,608,189,419,1359,303,1056
161563,50,114,49,65,66,33,33,48,16,32
161572,50,583,117,466,197,36,161,386,81,305
161873,50,1919,667,1252,958,359,599,961,308,653
162007,50,897,274,623,351,121,230,546,153,393
162061,50,522,414,108,356,288,68,166,126,40
162210,50,89,25,64,22,5,17,67,20,47
162283,50,249,62,187,75,16,59,174,46,128
162584,50,804,283,521,279,107,172,525,176,349
162654,50,726,134,592,51,24,27,675,110,565
162760,50,854,270,584,234,104,130,620,166,454
162928,50,25231,11759,13472,11244,4965,6279,13987,6794,7193
163046,50,1261,382,879,419,94,325,842,288,554
163204,50,9104,4314,4790,89,37,52,9015,4277,4738
163259,50,5968,1708,4260,4193,1291,2902,1775,417,1358
163268,50,3366,1770,1596,2215,1216,999,1151,554,597
163286,50,10439,5349,5090,8096,4219,3877,2343,1130,1213
163295,50,549,147,402,231,66,165,318,81,237
163338,50,585,191,394,346,116,230,239,75,164
163453,50,1492,600,892,1178,480,698,314,120,194
163462,50,560,309,251,283,217,66,277,92,185
163532,50,176,176,0,161,161,0,15,15,0
163578,50,1073,226,847,276,62,214,797,164,633
163851,50,745,176,569,433,99,334,312,77,235
163912,50,23,4,19,23,4,19,,,
163976,50,79,60,19,46,34,12,33,26,7
164076,50,2932,664,2268,1025,257,768,1907,407,1500
164085,50,701,57,644,81,12,69,620,45,575
164173,50,498,100,398,108,27,81,390,73,317
164270,50,1234,290,944,626,177,449,608,113,495
164368,50,1494,867,627,1133,652,481,361,215,146
164447,50,843,206,637,741,189,552,102,17,85
164492,50,367,237,130,105,48,57,262,189,73
164562,50,355,96,259,149,48,101,206,48,158
164580,50,1228,700,528,668,403,265,560,297,263
164632,50,1150,114,1036,450,47,403,700,67,633
164739,50,1034,524,510,421,234,187,613,290,323
164748,50,783,418,365,582,294,288,201,124,77
164872,50,450,174,276,425,165,260,25,9,16
164915,50,155,52,103,57,23,34,98,29,69
164924,50,5305,2241,3064,3680,1493,2187,1625,748,877
164988,50,18255,7904,10351,11517,4905,6612,6738,2999,3739
165015,50,1894,833,1061,1470,665,805,424,168,256
165024,50,1488,364,1124,484,94,390,1004,270,734
165167,50,1295,290,1005,378,92,286,917,198,719
165334,50,1381,719,662,1178,623,555,203,96,107
165495,50,18,7,11,18,7,11,,,
165529,50,219,76,143,68,16,52,151,60,91
165644,50,126,41,85,66,18,48,60,23,37
165662,50,1736,220,1516,1236,169,1067,500,51,449
165671,50,65,11,54,13,1,12,52,10,42
165699,50,944,227,717,315,98,217,629,129,500
165802,50,109,35,74,25,13,12,84,22,62
165820,50,3386,1041,2345,602,232,370,2784,809,1975
165866,50,1141,263,878,91,25,66,1050,238,812
165936,50,334,94,240,97,20,77,237,74,163
165945,50,1334,837,497,283,166,117,1051,671,380
166027,50,21263,9709,11554,13690,6326,7364,7573,3383,4190
166045,50,89,40,49,72,32,40,17,8,9
166054,50,92,80,12,69,62,7,23,18,5
166391,50,344,145,199,28,16,12,316,129,187
166452,50,1852,265,1587,551,94,457,1301,171,1130
166489,50,275,96,179,249,85,164,26,11,15
166513,50,4764,2552,2212,1734,962,772,3030,1590,1440
166629,50,7838,3846,3992,2848,1377,1471,4990,2469,2521
166638,50,3365,1190,2175,1498,613,885,1867,577,1290
166656,50,3302,831,2471,2105,571,1534,1197,260,937
166674,50,106,31,75,96,27,69,10,4,6
166683,50,7201,4371,2830,7024,4244,2780,177,127,50
166692,50,99,80,19,99,80,19,,,
166708,50,1352,464,888,1249,445,804,103,19,84
166717,50,857,173,684,542,94,448,315,79,236
166850,50,1276,413,863,888,306,582,388,107,281
166869,50,1213,192,1021,804,113,691,409,79,330
166939,50,199,28,171,20,4,16,179,24,155
167057,50,414,214,200,396,203,193,18,11,7
167093,50,536,128,408,536,128,408,,,
167215,50,1060,381,679,814,284,530,246,97,149
167260,50,239,134,105,70,35,35,169,99,70
167288,50,100,34,66,53,18,35,47,16,31
167358,50,13711,7113,6598,12570,6566,6004,1141,547,594
167394,50,295,64,231,92,26,66,203,38,165
167464,50,47,47,0,47,47,0,,,
167598,50,2109,211,1898,390,44,346,1719,167,1552
167677,50,74,57,17,55,51,4,19,6,13
167729,50,1461,304,1157,561,89,472,900,215,685
167783,50,3922,440,3482,1433,173,1260,2489,267,2222
167835,50,350,51,299,317,42,275,33,9,24
167899,50,916,278,638,738,221,517,178,57,121
167987,50,1940,894,1046,859,438,421,1081,456,625
167996,50,43,17,26,28,11,17,15,6,9
168005,50,2353,855,1498,1377,488,889,976,367,609
168148,50,6616,2500,4116,5369,1987,3382,1247,513,734
168227,50,207,131,76,147,88,59,60,43,17
168254,50,1024,407,617,634,249,385,390,158,232
168263,50,759,221,538,395,103,292,364,118,246
168342,50,53,22,31,52,22,30,1,0,1
168421,50,2062,1400,662,856,573,283,1206,827,379
168430,50,833,147,686,162,19,143,671,128,543
168528,50,74,38,36,59,32,27,15,6,9
168546,50,2,0,2,2,0,2,,,
168591,50,15,6,9,15,6,9,,,
168740,50,1563,990,573,563,380,183,1000,610,390
168786,50,96,24,72,50,16,34,46,8,38
168847,50,328,87,241,86,17,69,242,70,172
169080,50,271,62,209,127,30,97,144,32,112
169099,50,239,168,71,132,102,30,107,66,41
169220,50,178,42,136,120,30,90,58,12,46
169248,50,4156,1737,2419,2075,977,1098,2081,760,1321
169327,50,172,75,97,160,71,89,12,4,8
169363,50,252,64,188,166,41,125,86,23,63
169424,50,129,47,82,129,47,82,,,
169442,50,66,41,25,59,38,21,7,3,4
169479,50,1004,386,618,133,38,95,871,348,523
169716,50,2204,874,1330,1679,688,991,525,186,339
169798,50,2401,745,1656,757,226,531,1644,519,1125
169910,50,1072,354,718,694,245,449,378,109,269
169983,50,347,262,85,88,70,18,259,192,67
170000,50,62,28,34,41,17,24,21,11,10
170037,50,348,162,186,34,14,20,314,148,166
170082,50,2983,861,2122,1594,458,1136,1389,403,986
170286,50,105,76,29,59,49,10,46,27,19
170675,50,668,450,218,73,26,47,595,424,171
170806,50,343,81,262,102,26,76,241,55,186
170967,50,27,19,8,26,19,7,1,0,1
170976,50,18530,9159,9371,16026,7715,8311,2504,1444,1060
171100,50,10822,4597,6225,8310,3709,4601,2512,888,1624
171128,50,1364,940,424,889,601,288,475,339,136
171137,50,2107,1320,787,663,401,262,1444,919,525
171146,50,1376,439,937,702,206,496,674,233,441
171456,50,536,183,353,206,74,132,330,109,221
171492,50,306,169,137,72,42,30,234,127,107
171571,50,3267,1368,1899,1955,777,1178,1312,591,721
171599,50,59,29,30,,,,59,29,30
171881,50,3,3,0,2,2,0,1,1,0
172033,50,166,126,40,65,64,1,101,62,39
172051,50,679,127,552,237,52,185,442,75,367
172264,50,155,55,100,47,12,35,108,43,65
172334,50,1269,158,1111,1115,138,977,154,20,134
172477,50,564,241,323,108,42,66,456,199,257
172608,50,640,304,336,11,7,4,629,297,332
172644,50,7672,2962,4710,4879,1907,2972,2793,1055,1738
172699,50,3411,1286,2125,1275,419,856,2136,867,1269
172705,50,433,260,173,79,37,42,354,223,131
173045,50,730,220,510,499,162,337,231,58,173
173124,50,346,144,202,81,38,43,265,106,159
173142,50,38,20,18,35,19,16,3,1,2
173160,50,954,312,642,319,70,249,635,242,393
173300,50,76,23,53,,,,76,23,53
173328,50,2473,931,1542,2275,841,1434,198,90,108
173452,50,125,57,68,1,1,0,124,56,68
173665,50,873,235,638,38,9,29,835,226,609
173683,50,147,46,101,63,23,40,84,23,61
173896,50,410,173,237,355,144,211,55,29,26
173920,50,1914,629,1285,651,210,441,1263,419,844
173957,50,1021,456,565,968,435,533,53,21,32
174020,50,806,335,471,180,70,110,626,265,361
174066,50,15707,6728,8979,9304,3747,5557,6403,2981,3422
174127,50,119,27,92,40,12,28,79,15,64
174154,50,7,2,5,6,2,4,1,0,1
174233,50,865,356,509,557,196,361,308,160,148
174358,50,953,270,683,196,58,138,757,212,545
174437,50,99,47,52,71,37,34,28,10,18
174491,50,92,51,41,4,3,1,88,48,40
174507,50,690,296,394,639,287,352,51,9,42
174747,50,27,1,26,21,1,20,6,0,6
174783,50,1851,695,1156,731,281,450,1120,414,706
174792,50,117,75,42,54,33,21,63,42,21
174817,50,3033,861,2172,1866,501,1365,1167,360,807
174862,50,332,157,175,219,106,113,113,51,62
174899,50,1269,291,978,862,193,669,407,98,309
174914,50,3119,1385,1734,1065,414,651,2054,971,1083
175005,50,1173,119,1054,497,64,433,676,55,621
175014,50,409,89,320,259,55,204,150,34,116
175078,50,412,132,280,208,55,153,204,77,127
175139,50,224,90,134,97,39,58,127,51,76
175272,50,751,144,607,286,43,243,465,101,364
175281,50,1192,487,705,1070,438,632,122,49,73
175342,50,502,135,367,173,63,110,329,72,257
175421,50,2126,591,1535,112,41,71,2014,550,1464
175430,50,30,12,18,22,9,13,8,3,5
175616,50,667,180,487,247,75,172,420,105,315
175856,50,1979,507,1472,840,230,610,1139,277,862
175980,50,34,21,13,26,16,10,8,5,3
176017,50,4998,1896,3102,3502,1445,2057,1496,451,1045
176035,50,259,34,225,139,12,127,120,22,98
176044,50,225,72,153,94,34,60,131,38,93
176053,50,1550,485,1065,1092,369,723,458,116,342
176080,50,4344,1919,2425,2175,886,1289,2169,1033,1136
176372,50,3268,1112,2156,1462,564,898,1806,548,1258
176406,50,20,3,17,2,0,2,18,3,15
176451,50,161,111,50,33,28,5,128,83,45
176479,50,2371,714,1657,1550,544,1006,821,170,651
176600,50,95,57,38,61,47,14,34,10,24
176628,50,328,82,246,250,60,190,78,22,56
176664,50,32,26,6,17,14,3,15,12,3
176770,50,175,22,153,86,12,74,89,10,79
176789,50,73,57,16,32,24,8,41,33,8
176910,50,33,29,4,24,20,4,9,9,0
176965,50,4292,2050,2242,1918,1058,860,2374,992,1382
177038,50,524,275,249,503,263,240,21,12,9
177065,50,371,135,236,61,22,39,310,113,197
177092,50,582,529,53,260,242,18,322,287,35
177126,50,608,377,231,184,118,66,424,259,165
177144,50,99,43,56,90,39,51,9,4,5
177214,50,220,64,156,13,1,12,207,63,144
177278,50,93,42,51,62,26,36,31,16,15
177339,50,622,287,335,280,133,147,342,154,188
177418,50,260,57,203,147,25,122,113,32,81
177542,50,42,21,21,20,13,7,22,8,14
177719,50,78,16,62,67,16,51,11,0,11
177816,50,67,67,0,67,67,0,,,
177834,50,3723,1353,2370,3096,1167,1929,627,186,441
177940,50,103,50,53,52,24,28,51,26,25
177968,50,2192,595,1597,589,187,402,1603,408,1195
177986,50,1425,668,757,1033,548,485,392,120,272
178059,50,4150,808,3342,675,184,491,3475,624,2851
178208,50,2763,2392,371,1509,1349,160,1254,1043,211
178244,50,682,161,521,125,29,96,557,132,425
178341,50,92,34,58,22,7,15,70,27,43
178369,50,33,12,21,6,1,5,27,11,16
178387,50,182,69,113,14,6,8,168,63,105
178396,50,7559,2902,4657,4260,1764,2496,3299,1138,2161
178402,50,5524,2518,3006,3535,1718,1817,1989,800,1189
178411,50,1582,1178,404,1026,758,268,556,420,136
178420,50,2766,908,1858,945,337,608,1821,571,1250
178518,50,177,109,68,73,40,33,104,69,35
178615,50,338,94,244,229,60,169,109,34,75
178624,50,3197,1183,2014,1032,465,567,2165,718,1447
178679,50,81,56,25,,,,81,56,25
178721,50,1424,681,743,233,125,108,1191,556,635
178989,50,91,10,81,1,0,1,90,10,80
179043,50,860,306,554,390,103,287,470,203,267
179159,50,5093,2115,2978,4521,1919,2602,572,196,376
179265,50,431,153,278,409,147,262,22,6,16
179317,50,102,51,51,60,31,29,42,20,22
179326,50,550,187,363,242,98,144,308,89,219
179548,50,183,29,154,158,26,132,25,3,22
179557,50,1473,648,825,821,430,391,652,218,434
179566,50,4116,1533,2583,1794,695,1099,2322,838,1484
179812,50,1306,624,682,1292,621,671,14,3,11
179867,50,8880,4279,4601,7184,3456,3728,1696,823,873
179894,50,4199,1910,2289,1307,705,602,2892,1205,1687
179955,50,29,10,19,21,10,11,8,0,8
179964,50,717,286,431,57,24,33,660,262,398
180106,50,43,9,34,40,8,32,3,1,2
180179,50,392,92,300,156,27,129,236,65,171
180258,50,362,79,283,148,32,116,214,47,167
180416,50,188,118,70,65,45,20,123,73,50
180461,50,2056,881,1175,624,260,364,1432,621,811
180489,50,2740,920,1820,1129,399,730,1611,521,1090
180522,50,35,5,30,13,1,12,22,4,18
180595,50,209,52,157,209,52,157,,,
180647,50,28,7,21,21,4,17,7,3,4
180814,50,3033,1200,1833,2279,871,1408,754,329,425
180832,50,502,68,434,26,10,16,476,58,418
180878,50,127,21,106,67,17,50,60,4,56
180948,50,445,138,307,127,41,86,318,97,221
180984,50,379,80,299,309,66,243,70,14,56
181002,50,4107,1626,2481,3038,1221,1817,1069,405,664
181020,50,889,213,676,335,106,229,554,107,447
181127,50,17,14,3,15,12,3,2,2,0
181215,50,1772,510,1262,265,70,195,1507,440,1067
181297,50,338,37,301,305,32,273,33,5,28
181330,50,275,78,197,39,21,18,236,57,179
181394,50,3032,1186,1846,1035,406,629,1997,780,1217
181428,50,2774,944,1830,2129,749,1380,645,195,450
181446,50,143,24,119,43,8,35,100,16,84
181464,50,4616,2253,2363,2520,1294,1226,2096,959,1137
181534,50,230,55,175,30,4,26,200,51,149
181604,50,318,45,273,241,33,208,77,12,65
181738,50,87,10,77,86,10,76,1,0,1
181783,50,913,282,631,181,67,114,732,215,517
181853,50,184,63,121,9,3,6,175,60,115
182281,50,5295,2142,3153,3075,1252,1823,2220,890,1330
182290,50,3972,1540,2432,1689,649,1040,2283,891,1392
182634,50,76,14,62,5,0,5,71,14,57
182670,50,2286,1131,1155,2244,1110,1134,42,21,21
182795,50,545,211,334,373,136,237,172,75,97
182829,50,651,366,285,428,232,196,223,134,89
182980,50,1809,1218,591,1688,1163,525,121,55,66
183026,50,23226,7238,15988,7060,2276,4784,16166,4962,11204
183044,50,2441,986,1455,1371,540,831,1070,446,624
183062,50,135,52,83,16,3,13,119,49,70
183071,50,10,6,4,,,,10,6,4
183080,50,564,160,404,202,67,135,362,93,269
183211,50,1211,486,725,585,393,192,626,93,533
183239,50,18,7,11,17,7,10,1,0,1
183257,50,230,54,176,34,5,29,196,49,147
183789,50,134,40,94,56,16,40,78,24,54
183804,50,4763,4763,0,4426,4426,0,337,337,0
183822,50,1,1,0,1,1,0,,,
183910,50,423,77,346,113,21,92,310,56,254
183974,50,472,122,350,30,0,30,442,122,320
184348,50,579,279,300,250,128,122,329,151,178
184603,50,1905,575,1330,609,239,370,1296,336,960
184612,50,402,105,297,95,27,68,307,78,229
184694,50,770,223,547,590,152,438,180,71,109
184773,50,491,100,391,151,35,116,340,65,275
184782,50,4304,1791,2513,2533,1252,1281,1771,539,1232
185129,50,1644,390,1254,330,110,220,1314,280,1034
185262,50,2039,440,1599,988,237,751,1051,203,848
185572,50,1216,296,920,597,153,444,619,143,476
185590,50,4494,1322,3172,1693,466,1227,2801,856,1945
185758,50,132,63,69,21,9,12,111,54,57
185828,50,3313,2261,1052,2235,1522,713,1078,739,339
186122,50,323,162,161,313,155,158,10,7,3
186131,50,3238,1865,1373,3238,1865,1373,,,
186186,50,9,9,0,9,9,0,,,
186201,50,546,141,405,232,65,167,314,76,238
186283,50,885,284,601,309,98,211,576,186,390
186371,50,1781,764,1017,846,380,466,935,384,551
186380,50,14293,5198,9095,8696,3515,5181,5597,1683,3914
186399,50,3506,1755,1751,1723,893,830,1783,862,921
186432,50,1359,751,608,1012,630,382,347,121,226
186584,50,3611,1333,2278,1622,619,1003,1989,714,1275
186618,50,385,93,292,195,39,156,190,54,136
186867,50,5244,3813,1431,3798,2782,1016,1446,1031,415
186876,50,942,233,709,408,108,300,534,125,409
187046,50,890,382,508,7,2,5,883,380,503
187134,50,590,128,462,245,47,198,345,81,264
187444,50,2466,567,1899,624,164,460,1842,403,1439
187596,50,24,10,14,16,7,9,8,3,5
187648,50,1273,320,953,395,87,308,878,233,645
187745,50,68,23,45,66,23,43,2,0,2
187897,50,1052,259,793,610,152,458,442,107,335
187967,50,471,276,195,249,167,82,222,109,113
187985,50,5578,2441,3137,3029,1264,1765,2549,1177,1372
188030,50,2677,1107,1570,1426,633,793,1251,474,777
188182,50,697,195,502,170,46,124,527,149,378
188207,50,193,16,177,125,11,114,68,5,63
188304,50,1001,238,763,323,59,264,678,179,499
188340,50,12,6,6,5,3,2,7,3,4
188429,50,2197,538,1659,1103,279,824,1094,259,835
188526,50,346,130,216,330,127,203,16,3,13
188535,50,643,284,359,572,257,315,71,27,44
188580,50,837,322,515,837,322,515,,,
188641,50,466,132,334,201,63,138,265,69,196
188854,50,9,3,6,9,3,6,,,
189015,50,683,99,584,351,52,299,332,47,285
189088,50,410,156,254,370,147,223,40,9,31
189228,50,64,30,34,47,25,22,17,5,12
189413,50,70,5,65,70,5,65,,,
189501,50,1210,478,732,1110,441,669,100,37,63
189705,50,704,283,421,380,159,221,324,124,200
189848,50,27,4,23,26,4,22,1,0,1
189857,50,89,89,0,89,89,0,,,
190044,50,1051,558,493,603,308,295,448,250,198
190080,50,37,20,17,4,2,2,33,18,15
190099,50,11,2,9,8,0,8,3,2,1
190114,50,206,53,153,176,49,127,30,4,26
190150,50,25880,11620,14260,20120,8733,11387,5760,2887,2873
190372,50,59,47,12,40,29,11,19,18,1
190415,50,10163,5051,5112,9413,4656,4757,750,395,355
190424,50,1327,546,781,1286,530,756,41,16,25
190503,50,119,44,75,117,42,75,2,2,0
190512,50,3958,1756,2202,684,317,367,3274,1439,1835
190549,50,2534,801,1733,545,172,373,1989,629,1360
190558,50,949,274,675,206,65,141,743,209,534
190567,50,2560,933,1627,812,332,480,1748,601,1147
190576,50,5940,2130,3810,3291,1345,1946,2649,785,1864
190594,50,5714,1364,4350,1552,349,1203,4162,1015,3147
190600,50,1860,675,1185,478,124,354,1382,551,831
190637,50,1804,501,1303,186,34,152,1618,467,1151
190664,50,2595,742,1853,397,90,307,2198,652,1546
190682,50,699,237,462,497,162,335,202,75,127
190691,50,247,54,193,183,41,142,64,13,51
190716,50,1140,352,788,563,229,334,577,123,454
190725,50,860,163,697,608,129,479,252,34,218
190761,50,310,64,246,179,40,139,131,24,107
190983,50,48,18,30,25,11,14,23,7,16
191126,50,254,34,220,190,29,161,64,5,59
191205,50,50,32,18,15,10,5,35,22,13
191241,50,6458,2274,4184,3734,1495,2239,2724,779,1945
191533,50,4,0,4,,,,4,0,4
191621,50,36,13,23,31,9,22,5,4,1
191630,50,48,30,18,42,27,15,6,3,3
191649,50,4128,1498,2630,3016,1151,1865,1112,347,765
191676,50,28,10,18,8,2,6,20,8,12
191931,50,589,206,383,396,112,284,193,94,99
191968,50,435,108,327,410,91,319,25,17,8
192040,50,169,81,88,82,38,44,87,43,44
192110,50,400,206,194,379,195,184,21,11,10
192192,50,265,42,223,80,10,70,185,32,153
192271,50,230,21,209,155,16,139,75,5,70
192323,50,603,157,446,311,92,219,292,65,227
192448,50,4418,988,3430,2605,650,1955,1813,338,1475
192703,50,509,246,263,424,207,217,85,39,46
192712,50,607,269,338,589,264,325,18,5,13
192749,50,950,302,648,314,108,206,636,194,442
192785,50,44,4,40,43,4,39,1,0,1
192819,50,989,432,557,587,277,310,402,155,247
192925,50,540,134,406,413,110,303,127,24,103
193016,50,2236,456,1780,1096,270,826,1140,186,954
193052,50,205,205,0,204,204,0,1,1,0
193070,50,29,29,0,29,29,0,,,
193247,50,24,24,0,24,24,0,,,
193292,50,1536,295,1241,294,60,234,1242,235,1007
193308,50,1095,396,699,487,194,293,608,202,406
193353,50,376,68,308,62,25,37,314,43,271
193399,50,618,107,511,289,69,220,329,38,291
193405,50,1253,503,750,1253,503,750,,,
193584,50,535,100,435,346,61,285,189,39,150
193654,50,2937,915,2022,2605,806,1799,332,109,223
193751,50,551,269,282,405,229,176,146,40,106
193821,50,1050,397,653,884,326,558,166,71,95
193830,50,1454,608,846,1267,549,718,187,59,128
193894,50,140,61,79,112,51,61,28,10,18
193900,50,29743,12447,17296,22316,9279,13037,7427,3168,4259
193973,50,1149,413,736,751,267,484,398,146,252
194073,50,334,156,178,330,154,176,4,2,2
194091,50,3453,1693,1760,3059,1510,1549,394,183,211
194116,50,153,23,130,150,21,129,3,2,1
194161,50,827,344,483,323,153,170,504,191,313
194310,50,5386,1977,3409,3237,1322,1915,2149,655,1494
194392,50,18,13,5,6,3,3,12,10,2
194578,50,1560,373,1187,1402,346,1056,158,27,131
194657,50,112,112,0,112,112,0,,,
194666,50,71,71,0,71,71,0,,,
194763,50,244,244,0,244,244,0,,,
194824,50,1066,708,358,1030,681,349,36,27,9
194958,50,525,80,445,347,49,298,178,31,147
195003,50,2675,1619,1056,2125,1297,828,550,322,228
195030,50,5430,2486,2944,3755,1903,1852,1675,583,1092
195049,50,273,149,124,273,149,124,,,
195128,50,1036,180,856,374,73,301,662,107,555
195155,50,171,119,52,12,11,1,159,108,51
195164,50,746,275,471,252,88,164,494,187,307
195173,50,385,265,120,364,255,109,21,10,11
195216,50,30,16,14,9,5,4,21,11,10
195234,50,1354,368,986,565,157,408,789,211,578
195243,50,174,64,110,76,28,48,98,36,62
195304,50,234,33,201,192,27,165,42,6,36
195438,50,49,49,0,49,49,0,,,
195474,50,132,76,56,78,47,31,54,29,25
195544,50,792,173,619,148,49,99,644,124,520
195580,50,95,82,13,70,57,13,25,25,0
195720,50,992,249,743,552,159,393,440,90,350
195809,50,4011,1492,2519,2738,1043,1695,1273,449,824
196024,50,134,11,123,15,0,15,119,11,108
196042,50,50,40,10,13,9,4,37,31,6
196060,50,4394,1596,2798,2219,864,1355,2175,732,1443
196079,50,3910,1990,1920,2469,1295,1174,1441,695,746
196088,50,11338,5475,5863,7460,3584,3876,3878,1891,1987
196097,50,8201,3571,4630,5587,2769,2818,2614,802,1812
196103,50,355,153,202,177,70,107,178,83,95
196112,50,860,347,513,296,153,143,564,194,370
196121,50,1275,417,858,366,114,252,909,303,606
196130,50,981,256,725,386,92,294,595,164,431
196149,50,697,169,528,236,60,176,461,109,352
196158,50,279,57,222,131,23,108,148,34,114
196167,50,74,17,57,40,10,30,34,7,27
196176,50,874,267,607,506,169,337,368,98,270
196185,50,571,100,471,164,28,136,407,72,335
196194,50,921,361,560,384,153,231,537,208,329
196200,50,345,80,265,200,47,153,145,33,112
196219,50,75,39,36,62,35,27,13,4,9
196228,50,409,100,309,407,98,309,2,2,0
196237,50,363,143,220,158,75,83,205,68,137
196246,50,470,129,341,320,77,243,150,52,98
196255,50,1903,629,1274,1434,515,919,469,114,355
196264,50,1672,469,1203,168,58,110,1504,411,1093
196291,50,132,107,25,76,62,14,56,45,11
196307,50,1273,488,785,1161,468,693,112,20,92
196413,50,7277,3408,3869,5301,2586,2715,1976,822,1154
196440,50,2,2,0,2,2,0,,,
196468,50,4514,954,3560,3224,632,2592,1290,322,968
196592,50,6251,1766,4485,3569,1259,2310,2682,507,2175
196680,50,1850,1011,839,,,,1850,1011,839
196884,50,229,95,134,167,66,101,62,29,33
197027,50,12,9,3,,,,12,9,3
197045,50,1183,311,872,289,65,224,894,246,648
197151,50,594,138,456,517,123,394,77,15,62
197197,50,296,67,229,81,39,42,215,28,187
197601,50,32,32,0,32,32,0,,,
197647,50,26,26,0,22,22,0,4,4,0
197674,50,28,28,0,27,27,0,1,1,0
197692,50,14,14,0,14,14,0,,,
197708,50,3190,1027,2163,2489,762,1727,701,265,436
197735,50,213,213,0,213,213,0,,,
197744,50,45,45,0,33,33,0,12,12,0
197869,50,1878,553,1325,858,301,557,1020,252,768
197911,50,78,30,48,43,25,18,35,5,30
197984,50,26,6,20,17,5,12,9,1,8
198066,50,24,14,10,20,11,9,4,3,1
198109,50,77,7,70,60,6,54,17,1,16
198136,50,2307,909,1398,1925,797,1128,382,112,270
198215,50,78,38,40,76,37,39,2,1,1
198303,50,86,46,40,38,21,17,48,25,23
198419,50,11383,5008,6375,10836,4722,6114,547,286,261
198464,50,5463,1715,3748,2776,962,1814,2687,753,1934
198507,50,116,26,90,31,9,22,85,17,68
198516,50,786,283,503,747,260,487,39,23,16
198543,50,1039,359,680,397,117,280,642,242,400
198561,50,1332,370,962,390,103,287,942,267,675
198598,50,96,22,74,44,10,34,52,12,40
198613,50,38,15,23,27,13,14,11,2,9
198695,50,945,334,611,898,317,581,47,17,30
198756,50,41,7,34,41,7,34,,,
198835,50,825,211,614,429,106,323,396,105,291
198899,50,38,14,24,21,9,12,17,5,12
198950,50,265,26,239,103,10,93,162,16,146
198969,50,363,115,248,297,101,196,66,14,52
199032,50,152,42,110,136,39,97,16,3,13
199069,50,220,39,181,118,17,101,102,22,80
199102,50,1654,654,1000,907,351,556,747,303,444
199120,50,11676,4653,7023,9307,3644,5663,2369,1009,1360
199139,50,6090,2413,3677,2879,1300,1579,3211,1113,2098
199148,50,3780,1160,2620,1841,594,1247,1939,566,1373
199157,50,1919,525,1394,1323,379,944,596,146,450
199184,50,184,87,97,178,85,93,6,2,4
199193,50,10446,5356,5090,7219,3770,3449,3227,1586,1641
199209,50,88,27,61,61,19,42,27,8,19
199218,50,3549,987,2562,1638,437,1201,1911,550,1361
199281,50,2023,555,1468,572,142,430,1451,413,1038
199306,50,393,93,300,139,18,121,254,75,179
199412,50,556,156,400,126,40,86,430,116,314
199582,50,23,9,14,13,5,8,10,4,6
199607,50,105,9,96,1,0,1,104,9,95
199643,50,143,68,75,67,35,32,76,33,43
199698,50,29,12,17,19,5,14,10,7,3
199759,50,2085,1545,540,1000,793,207,1085,752,333
199847,50,3516,1431,2085,2563,1126,1437,953,305,648
199865,50,70,20,50,64,20,44,6,0,6
199962,50,886,250,636,716,183,533,170,67,103
199971,50,23,12,11,23,12,11,,,
199999,50,491,92,399,335,66,269,156,26,130
200004,50,1679,522,1157,865,249,616,814,273,541
200013,50,29,7,22,19,6,13,10,1,9
200059,50,62,35,27,13,6,7,49,29,20
200156,50,264,96,168,112,49,63,152,47,105
200217,50,1146,366,780,638,193,445,508,173,335
200226,50,46,10,36,12,3,9,34,7,27
200253,50,247,66,181,114,32,82,133,34,99
200280,50,3948,1453,2495,1773,725,1048,2175,728,1447
200332,50,2146,1031,1115,962,444,518,1184,587,597
200466,50,26,3,23,6,0,6,20,3,17
200484,50,119,83,36,89,57,32,30,26,4
200572,50,137,42,95,5,2,3,132,40,92
200697,50,1048,859,189,502,429,73,546,430,116
200800,50,2142,913,1229,1218,549,669,924,364,560
201061,50,4,1,3,2,0,2,2,1,1
201104,50,1091,448,643,716,308,408,375,140,235
201140,50,104,93,11,74,74,0,30,19,11
201195,50,476,141,335,358,107,251,118,34,84
201371,50,81,13,68,78,13,65,3,0,3
201441,50,3067,1195,1872,1455,623,832,1612,572,1040
201548,50,679,276,403,478,193,285,201,83,118
201645,50,6184,2772,3412,5173,2360,2813,1011,412,599
201654,50,427,199,228,221,117,104,206,82,124
201690,50,28,10,18,14,8,6,14,2,12
201885,50,11492,4420,7072,6170,2748,3422,5322,1672,3650
201964,50,161,85,76,123,66,57,38,19,19
202073,50,143,68,75,139,66,73,4,2,2
202134,50,4609,2182,2427,2912,1523,1389,1697,659,1038
202170,50,16,5,11,14,4,10,2,1,1
202480,50,3258,1680,1578,2490,1318,1172,768,362,406
202514,50,54,28,26,14,9,5,40,19,21
202763,50,1074,415,659,739,289,450,335,126,209
202806,50,2397,882,1515,1401,522,879,996,360,636
202903,50,24,20,4,,,,24,20,4
203067,50,318,119,199,248,102,146,70,17,53
203085,50,153,65,88,98,44,54,55,21,34
203128,50,16,5,11,13,5,8,3,0,3
203368,50,505,195,310,232,79,153,273,116,157
203465,50,3,0,3,,,,3,0,3
203517,50,5436,1825,3611,2989,1165,1824,2447,660,1787
203544,50,187,24,163,184,23,161,3,1,2
203580,50,168,77,91,71,25,46,97,52,45
203757,50,183,61,122,174,59,115,9,2,7
203775,50,252,58,194,69,25,44,183,33,150
203845,50,89,18,71,80,14,66,9,4,5
203960,50,141,23,118,48,10,38,93,13,80
203997,50,136,41,95,84,21,63,52,20,32
204006,50,17,2,15,10,2,8,7,0,7
204024,50,2243,650,1593,924,361,563,1319,289,1030
204176,50,138,19,119,121,16,105,17,3,14
204185,50,239,94,145,166,53,113,73,41,32
204194,50,313,99,214,193,70,123,120,29,91
204200,50,604,112,492,222,73,149,382,39,343
204264,50,633,104,529,200,44,156,433,60,373
204468,50,115,45,70,,,,115,45,70
204477,50,1001,469,532,978,459,519,23,10,13
204486,50,39,13,26,20,10,10,19,3,16
204501,50,6,6,0,6,6,0,,,
204617,50,430,118,312,157,58,99,273,60,213
204635,50,446,177,269,439,175,264,7,2,5
204680,50,1,0,1,,,,1,0,1
204796,50,14417,5998,8419,10042,4040,6002,4375,1958,2417
204857,50,6032,2491,3541,3151,1349,1802,2881,1142,1739
204936,50,285,93,192,84,37,47,201,56,145
204990,50,187,86,101,102,54,48,85,32,53
205027,50,127,125,2,22,22,0,105,103,2
205124,50,19,19,0,18,18,0,1,1,0
205203,50,26,19,7,8,6,2,18,13,5
205443,50,206,72,134,75,16,59,131,56,75
205957,50,871,404,467,208,110,98,663,294,369
206048,50,705,272,433,199,79,120,506,193,313
206084,50,3580,1481,2099,2635,1096,1539,945,385,560
206279,50,306,83,223,173,49,124,133,34,99
206288,50,467,282,185,324,196,128,143,86,57
206349,50,325,36,289,50,5,45,275,31,244
206437,50,751,161,590,382,98,284,369,63,306
206491,50,13,7,6,10,6,4,3,1,2
206507,50,31,10,21,25,6,19,6,4,2
206516,50,121,64,57,92,47,45,29,17,12
206525,50,41,16,25,10,5,5,31,11,20
206604,50,2740,1289,1451,1199,508,691,1541,781,760
206622,50,1262,473,789,462,171,291,800,302,498
206695,50,2249,855,1394,1021,419,602,1228,436,792
206835,50,126,43,83,37,10,27,89,33,56
206862,50,595,230,365,334,124,210,261,106,155
206914,50,285,67,218,121,27,94,164,40,124
206941,50,1511,481,1030,634,223,411,877,258,619
207041,50,646,190,456,269,89,180,377,101,276
207157,50,12,10,2,6,4,2,6,6,0
207209,50,129,49,80,72,23,49,57,26,31
207263,50,1460,366,1094,643,172,471,817,194,623
207306,50,205,53,152,69,20,49,136,33,103
207315,50,1459,633,826,966,403,563,493,230,263
207324,50,587,380,207,334,231,103,253,149,104
207342,50,2404,832,1572,1914,721,1193,490,111,379
207388,50,4586,2251,2335,1954,805,1149,2632,1446,1186
207403,50,69,32,37,18,6,12,51,26,25
207458,50,1189,477,712,976,402,574,213,75,138
207500,50,7026,2961,4065,3840,1599,2241,3186,1362,1824
207582,50,762,371,391,571,277,294,191,94,97
207661,50,109,38,71,79,26,53,30,12,18
207847,50,2457,879,1578,781,260,521,1676,619,1057
207856,50,21,9,12,6,4,2,15,5,10
207865,50,836,243,593,458,163,295,378,80,298
207971,50,1122,606,516,854,445,409,268,161,107
208646,50,259,86,173,108,37,71,151,49,102
208822,50,1497,492,1005,642,208,434,855,284,571
209056,50,1391,386,1005,1028,291,737,363,95,268
209065,50,34,14,20,15,10,5,19,4,15
209241,50,87,85,2,55,55,0,32,30,2
209287,50,230,119,111,120,60,60,110,59,51
209296,50,362,50,312,328,45,283,34,5,29
209409,50,190,61,129,164,52,112,26,9,17
209490,50,2118,755,1363,1679,599,1080,439,156,283
209506,50,109,40,69,43,15,28,66,25,41
209542,50,5387,2507,2880,3344,1634,1710,2043,873,1170
209551,50,3598,1562,2036,3244,1442,1802,354,120,234
209603,50,111,29,82,105,29,76,6,0,6
209612,50,1920,494,1426,1705,434,1271,215,60,155
209807,50,4747,1708,3039,2442,898,1544,2305,810,1495
209825,50,403,146,257,116,49,67,287,97,190
209922,50,11,6,5,,,,11,6,5
210146,50,919,251,668,149,41,108,770,210,560
210331,50,145,64,81,63,27,36,82,37,45
210368,50,817,559,258,56,25,31,761,534,227
210401,50,542,271,271,513,264,249,29,7,22
210429,50,431,141,290,245,83,162,186,58,128
210438,50,1094,374,720,517,241,276,577,133,444
210492,50,13,6,7,10,6,4,3,0,3
210571,50,200,67,133,70,19,51,130,48,82
210739,50,766,233,533,406,104,302,360,129,231
210775,50,466,142,324,263,87,176,203,55,148
211024,50,176,96,80,58,38,20,118,58,60
211088,50,1156,310,846,547,151,396,609,159,450
211130,50,160,81,79,101,53,48,59,28,31
211273,50,333,63,270,269,50,219,64,13,51
211291,50,40,16,24,27,13,14,13,3,10
211352,50,427,122,305,78,24,54,349,98,251
211431,50,857,92,765,324,37,287,533,55,478
211440,50,8943,5461,3482,8148,4986,3162,795,475,320
211468,50,371,54,317,163,29,134,208,25,183
211477,50,25,5,20,,,,25,5,20
211556,50,888,174,714,661,126,535,227,48,179
211583,50,431,100,331,209,43,166,222,57,165
211893,50,48,23,25,48,23,25,,,
211981,50,401,134,267,39,9,30,362,125,237
212009,50,12,6,6,1,1,0,11,5,6
212054,50,8323,3010,5313,4393,1790,2603,3930,1220,2710
212106,50,3012,1064,1948,2726,992,1734,286,72,214
212115,50,751,226,525,248,91,157,503,135,368
212133,50,3921,1696,2225,1029,458,571,2892,1238,1654
212197,50,284,68,216,149,24,125,135,44,91
212601,50,1574,705,869,1192,581,611,382,124,258
212656,50,109,40,69,69,26,43,40,14,26
212674,50,613,273,340,3,2,1,610,271,339
212771,50,250,53,197,67,22,45,183,31,152
212805,50,27,18,9,,,,27,18,9
212832,50,679,156,523,651,154,497,28,2,26
212984,50,757,125,632,153,24,129,604,101,503
213011,50,865,174,691,183,32,151,682,142,540
213020,50,1778,662,1116,689,290,399,1089,372,717
213251,50,33,18,15,12,7,5,21,11,10
213303,50,71,33,38,25,15,10,46,18,28
213321,50,322,71,251,111,20,91,211,51,160
213349,50,958,254,704,296,107,189,662,147,515
213358,50,329,89,240,256,61,195,73,28,45
213367,50,1276,372,904,280,71,209,996,301,695
213400,50,520,289,231,88,44,44,432,245,187
213446,50,73,28,45,44,15,29,29,13,16
213507,50,397,145,252,217,70,147,180,75,105
213543,50,1770,955,815,1054,602,452,716,353,363
213598,50,112,23,89,92,20,72,20,3,17
213631,50,263,123,140,82,38,44,181,85,96
213826,50,872,259,613,739,222,517,133,37,96
213987,50,355,142,213,228,84,144,127,58,69
213996,50,736,220,516,269,60,209,467,160,307
214041,50,961,242,719,183,54,129,778,188,590
214069,50,466,127,339,232,63,169,234,64,170
214148,50,13,1,12,7,1,6,6,0,6
214157,50,629,184,445,253,80,173,376,104,272
214166,50,32,17,15,26,13,13,6,4,2
214175,50,14,9,5,14,9,5,,,
214272,50,473,137,336,174,59,115,299,78,221
214564,50,1165,234,931,1070,223,847,95,11,84
214591,50,107,63,44,30,12,18,77,51,26
214607,50,271,178,93,99,72,27,172,106,66
214643,50,5,1,4,,,,5,1,4
214704,50,6,0,6,,,,6,0,6
214713,50,509,225,284,206,97,109,303,128,175
214777,50,8283,4207,4076,7742,3969,3773,541,238,303
214829,50,7,4,3,,,,7,4,3
214883,50,94,16,78,9,1,8,85,15,70
214971,50,58,17,41,44,12,32,14,5,9
215062,50,16951,7322,9629,13147,5716,7431,3804,1606,2198
215105,50,143,48,95,90,29,61,53,19,34
215114,50,211,81,130,36,16,20,175,65,110
215123,50,3036,1146,1890,2906,1112,1794,130,34,96
215293,50,9347,3775,5572,7339,3022,4317,2008,753,1255
215424,50,223,122,101,185,100,85,38,22,16
215442,50,870,287,583,141,61,80,729,226,503
215619,50,48,15,33,39,12,27,9,3,6
215655,50,664,309,355,166,96,70,498,213,285
215691,50,308,76,232,105,23,82,203,53,150
215743,50,396,116,280,212,59,153,184,57,127
215770,50,2790,897,1893,1041,325,716,1749,572,1177
215798,50,177,70,107,112,41,71,65,29,36
215813,50,86,67,19,57,57,0,29,10,19
215929,50,1138,444,694,504,196,308,634,248,386
215947,50,361,123,238,281,95,186,80,28,52
216010,50,719,249,470,216,71,145,503,178,325
216038,50,1464,330,1134,609,167,442,855,163,692
216047,50,126,120,6,100,100,0,26,20,6
216278,50,7,0,7,,,,7,0,7
216339,50,9090,3597,5493,6882,2855,4027,2208,742,1466
216348,50,28,26,2,5,5,0,23,21,2
216357,50,103,33,70,101,32,69,2,1,1
216366,50,4515,1255,3260,2802,909,1893,1713,346,1367
216463,50,254,182,72,53,40,13,201,142,59
216542,50,75,35,40,4,1,3,71,34,37
216597,50,3394,1565,1829,1540,672,868,1854,893,961
216667,50,2,1,1,,,,2,1,1
216694,50,250,80,170,102,28,74,148,52,96
216764,50,2883,922,1961,993,289,704,1890,633,1257
216807,50,50,21,29,28,11,17,22,10,12
216816,50,986,653,333,245,174,71,741,479,262
216852,50,2861,801,2060,1742,623,1119,1119,178,941
216931,50,3207,676,2531,531,171,360,2676,505,2171
217013,50,394,83,311,25,10,15,369,73,296
217040,50,2,2,0,2,2,0,,,
217059,50,321,72,249,72,27,45,249,45,204
217156,50,3550,1706,1844,3396,1633,1763,154,73,81
217165,50,332,167,165,179,82,97,153,85,68
217235,50,408,118,290,282,74,208,126,44,82
217305,50,175,33,142,147,29,118,28,4,24
217402,50,477,187,290,214,97,117,263,90,173
217420,50,1068,222,846,280,58,222,788,164,624
217484,50,2705,1002,1703,1683,580,1103,1022,422,600
217493,50,512,166,346,512,166,346,,,
217518,50,294,112,182,201,68,133,93,44,49
217536,50,682,235,447,164,69,95,518,166,352
217606,50,43,26,17,,,,43,26,17
217624,50,54,28,26,26,16,10,28,12,16
217633,50,884,368,516,759,294,465,125,74,51
217688,50,582,208,374,206,65,141,376,143,233
217721,50,44,29,15,44,29,15,,,
217749,50,430,218,212,74,38,36,356,180,176
217776,50,279,52,227,51,16,35,228,36,192
217819,50,913,217,696,279,85,194,634,132,502
217864,50,1026,534,492,183,89,94,843,445,398
217873,50,81,16,65,47,9,38,34,7,27
217882,50,5900,2837,3063,3293,1867,1426,2607,970,1637
217907,50,100,29,71,33,10,23,67,19,48
217925,50,1480,661,819,181,81,100,1299,580,719
217934,50,341,45,296,167,29,138,174,16,158
217961,50,480,104,376,120,27,93,360,77,283
217998,50,139,103,36,11,10,1,128,93,35
218061,50,410,85,325,112,12,100,298,73,225
218070,50,160,39,121,117,28,89,43,11,32
218229,50,605,167,438,120,46,74,485,121,364
218238,50,184,75,109,159,62,97,25,13,12
218335,50,2875,911,1964,2614,868,1746,261,43,218
218414,50,16,9,7,9,4,5,7,5,2
218441,50,286,149,137,241,125,116,45,24,21
218539,50,244,49,195,237,48,189,7,1,6
218645,50,695,231,464,158,56,102,537,175,362
218654,50,71,11,60,8,4,4,63,7,56
218663,50,8310,3095,5215,5699,2345,3354,2611,750,1861
218724,50,543,187,356,148,70,78,395,117,278
218733,50,275,80,195,171,48,123,104,32,72
218742,50,432,75,357,47,10,37,385,65,320
218751,50,375,177,198,374,177,197,1,0,1
218919,50,34,4,30,34,4,30,,,
218964,50,971,189,782,318,74,244,653,115,538
219000,50,255,59,196,82,28,54,173,31,142
219046,50,164,59,105,17,9,8,147,50,97
219082,50,484,363,121,94,71,23,390,292,98
219091,50,164,73,91,78,38,40,86,35,51
219198,50,172,61,111,148,58,90,24,3,21
219204,50,222,113,109,95,39,56,127,74,53
219240,50,879,526,353,141,77,64,738,449,289
219259,50,493,115,378,59,30,29,434,85,349
219277,50,30,7,23,,,,30,7,23
219295,50,15,2,13,7,1,6,8,1,7
219347,50,329,241,88,193,135,58,136,106,30
219356,50,1410,544,866,548,235,313,862,309,553
219374,50,62,15,47,30,7,23,32,8,24
219383,50,269,112,157,67,36,31,202,76,126
219471,50,2724,1071,1653,1465,665,800,1259,406,853
219602,50,1206,400,806,446,153,293,760,247,513
219639,50,20,4,16,11,2,9,9,2,7
219709,50,1526,455,1071,1188,305,883,338,150,188
219718,50,648,238,410,169,60,109,479,178,301
219790,50,174,64,110,18,9,9,156,55,101
219806,50,1067,266,801,170,95,75,897,171,726
219833,50,681,403,278,529,330,199,152,73,79
219842,50,433,280,153,176,115,61,257,165,92
219949,50,277,121,156,76,28,48,201,93,108
219976,50,1749,508,1241,1515,409,1106,234,99,135
220075,50,2929,957,1972,1796,640,1156,1133,317,816
220181,50,46,13,33,34,7,27,12,6,6
220206,50,49,28,21,10,6,4,39,22,17
220215,50,480,178,302,117,66,51,363,112,251
220473,50,270,145,125,121,56,65,149,89,60
220516,50,237,60,177,196,53,143,41,7,34
220552,50,1276,384,892,1171,344,827,105,40,65
220613,50,481,203,278,180,75,105,301,128,173
220631,50,3858,1326,2532,3493,1195,2298,365,131,234
220701,50,38,21,17,20,11,9,18,10,8
220710,50,4,1,3,2,0,2,2,1,1
220792,50,962,335,627,962,335,627,,,
220862,50,5209,2195,3014,2689,1333,1356,2520,862,1658
220871,50,203,91,112,150,64,86,53,27,26
220978,50,2648,973,1675,729,287,442,1919,686,1233
220996,50,295,133,162,219,108,111,76,25,51
221351,50,12,10,2,12,10,2,,,
221519,50,91,48,43,67,36,31,24,12,12
221661,50,332,94,238,108,27,81,224,67,157
221670,50,532,166,366,532,166,366,,,
221731,50,123,33,90,79,18,61,44,15,29
221740,50,1399,575,824,729,249,480,670,326,344
221759,50,6766,2938,3828,3988,1693,2295,2778,1245,1533
221768,50,703,217,486,246,71,175,457,146,311
221838,50,1540,538,1002,649,238,411,891,300,591
221847,50,1365,592,773,333,161,172,1032,431,601
221892,50,1460,404,1056,1090,305,785,370,99,271
221953,50,192,79,113,138,62,76,54,17,37
221971,50,831,234,597,434,106,328,397,128,269
221999,50,6559,2604,3955,5404,2225,3179,1155,379,776
222178,50,1868,524,1344,394,63,331,1474,461,1013
222628,50,791,219,572,86,17,69,705,202,503
222831,50,1533,505,1028,811,227,584,722,278,444
222877,50,2,2,0,1,1,0,1,1,0
222983,50,15,5,10,15,5,10,,,
223001,50,172,60,112,41,17,24,131,43,88
223117,50,45,42,3,7,6,1,38,36,2
223223,50,1610,656,954,1603,650,953,7,6,1
223232,50,5496,1892,3604,3809,1441,2368,1687,451,1236
224004,50,290,76,214,63,17,46,227,59,168
224147,50,2954,1144,1810,582,251,331,2372,893,1479
224226,50,1377,599,778,616,266,350,761,333,428
224305,50,2569,1491,1078,794,466,328,1775,1025,750
224323,50,875,478,397,280,171,109,595,307,288
224527,50,192,95,97,67,33,34,125,62,63
224545,50,349,101,248,90,31,59,259,70,189
224554,50,3923,1391,2532,1468,614,854,2455,777,1678
224660,50,15,8,7,,,,15,8,7
224712,50,115,36,79,55,23,32,60,13,47
224776,50,2,0,2,,,,2,0,2
225201,50,84,41,43,84,41,43,,,
225247,50,418,136,282,313,94,219,105,42,63
225399,50,1434,347,1087,191,50,141,1243,297,946
225414,50,2210,795,1415,902,341,561,1308,454,854
225432,50,1352,507,845,127,50,77,1225,457,768
225502,50,1212,347,865,322,75,247,890,272,618
225511,50,8757,4069,4688,6085,2871,3214,2672,1198,1474
225548,50,65,48,17,16,13,3,49,35,14
225575,50,34,10,24,34,10,24,,,
225627,50,2581,1048,1533,2148,846,1302,433,202,231
226091,50,8539,2356,6183,2926,1179,1747,5613,1177,4436
226152,50,1526,496,1030,371,102,269,1155,394,761
226231,50,186,40,146,39,7,32,147,33,114
226383,50,250,44,206,39,6,33,211,38,173
226471,50,503,134,369,362,91,271,141,43,98
226587,50,6,1,5,5,1,4,1,0,1
226833,50,966,319,647,435,150,285,531,169,362
227216,50,11744,5445,6299,7669,3928,3741,4075,1517,2558
227289,50,157,101,56,79,66,13,78,35,43
227331,50,1131,207,924,974,182,792,157,25,132
227368,50,5125,1766,3359,1792,696,1096,3333,1070,2263
227526,50,953,342,611,423,170,253,530,172,358
227757,50,4178,2638,1540,3605,2272,1333,573,366,207
227845,50,701,176,525,193,63,130,508,113,395
227863,50,942,373,569,309,123,186,633,250,383
227881,50,3245,1004,2241,955,320,635,2290,684,1606
228042,50,95,30,65,77,24,53,18,6,12
228149,50,1252,555,697,877,391,486,375,164,211
228194,50,1003,457,546,812,371,441,191,86,105
228246,50,4997,2562,2435,2404,1174,1230,2593,1388,1205
228325,50,303,137,166,41,18,23,262,119,143
228431,50,1422,421,1001,616,186,430,806,235,571
228459,50,4337,1505,2832,2540,906,1634,1797,599,1198
228468,50,7,3,4,3,1,2,4,2,2
228501,50,437,144,293,97,47,50,340,97,243
228529,50,2212,705,1507,624,207,417,1588,498,1090
228635,50,2354,1079,1275,1747,743,1004,607,336,271
228644,50,2733,1038,1695,2398,944,1454,335,94,241
228653,50,2776,878,1898,1736,666,1070,1040,212,828
228705,50,1245,626,619,637,374,263,608,252,356
228723,50,16502,8705,7797,12692,6869,5823,3810,1836,1974
228769,50,13155,5172,7983,5932,3233,2699,7223,1939,5284
228778,50,11075,5489,5586,10490,5227,5263,585,262,323
228787,50,9953,5645,4308,7338,4191,3147,2615,1454,1161
228796,50,3715,1563,2152,1471,666,805,2244,897,1347
228802,50,2351,721,1630,802,288,514,1549,433,1116
228866,50,257,123,134,253,121,132,4,2,2
228875,50,1750,699,1051,1632,654,978,118,45,73
228909,50,2332,813,1519,2161,763,1398,171,50,121
228981,50,40,4,36,36,3,33,4,1,3
229018,50,1208,481,727,356,163,193,852,318,534
229027,50,4707,2133,2574,2135,999,1136,2572,1134,1438
229063,50,1802,596,1206,1350,448,902,452,148,304
229115,50,7799,3452,4347,4996,2465,2531,2803,987,1816
229160,50,699,258,441,446,187,259,253,71,182
229179,50,5805,544,5261,2191,244,1947,3614,300,3314
229267,50,180,74,106,130,51,79,50,23,27
229300,50,4800,1523,3277,3021,1097,1924,1779,426,1353
229337,50,3688,1059,2629,2470,828,1642,1218,231,987
229780,50,703,299,404,283,115,168,420,184,236
229814,50,2341,888,1453,598,171,427,1743,717,1026
230038,50,3053,1658,1395,1893,1015,878,1160,643,517
230171,50,75,36,39,49,25,24,26,11,15
230366,50,46,15,31,46,15,31,,,
230603,50,1681,780,901,403,184,219,1278,596,682
230728,50,3108,1323,1785,1331,546,785,1777,777,1000
230737,50,803,355,448,390,129,261,413,226,187
230764,50,8379,4066,4313,6779,3251,3528,1600,815,785
230782,50,1011,383,628,480,176,304,531,207,324
230807,50,319,101,218,237,72,165,82,29,53
230816,50,103,19,84,103,19,84,,,
230834,50,635,157,478,38,20,18,597,137,460
230852,50,483,228,255,20,6,14,463,222,241
230889,50,208,53,155,193,52,141,15,1,14
230913,50,297,70,227,45,6,39,252,64,188
230959,50,70,10,60,2,1,1,68,9,59
230995,50,564,309,255,416,277,139,148,32,116
231059,50,190,53,137,38,15,23,152,38,114
231068,50,75,21,54,18,9,9,57,12,45
231147,50,653,201,452,589,180,409,64,21,43
231165,50,2,2,0,,,,2,2,0
231174,50,2190,827,1363,1695,665,1030,495,162,333
231420,50,223,54,169,18,5,13,205,49,156
231554,50,286,86,200,271,81,190,15,5,10
231581,50,36,10,26,33,9,24,3,1,2
231624,50,2857,1217,1640,1693,764,929,1164,453,711
231651,50,5796,2028,3768,2201,782,1419,3595,1246,2349
231712,50,110,46,64,85,33,52,25,13,12
231970,50,1319,488,831,1077,428,649,242,60,182
232025,50,276,84,192,271,81,190,5,3,2
232043,50,442,80,362,93,29,64,349,51,298
232089,50,20,6,14,11,5,6,9,1,8
232186,50,12035,5028,7007,5609,2644,2965,6426,2384,4042
232265,50,440,130,310,353,101,252,87,29,58
232308,50,112,34,78,31,10,21,81,24,57
232423,50,1878,556,1322,1047,288,759,831,268,563
232557,50,47803,18647,29156,22957,8921,14036,24846,9726,15120
232566,50,1204,363,841,313,87,226,891,276,615
232609,50,805,288,517,571,214,357,234,74,160
232672,50,643,120,523,375,89,286,268,31,237
232681,50,264,81,183,98,16,82,166,65,101
232706,50,1436,415,1021,642,190,452,794,225,569
232797,50,163,88,75,118,71,47,45,17,28
232885,50,45,5,40,41,5,36,4,0,4
232937,50,446,180,266,276,93,183,170,87,83
232982,50,4732,1821,2911,1686,576,1110,3046,1245,1801
233277,50,1710,293,1417,703,136,567,1007,157,850
233301,50,75,24,51,71,22,49,4,2,2
233374,50,731,287,444,476,200,276,255,87,168
233541,50,1799,408,1391,864,226,638,935,182,753
233684,50,410,122,288,108,35,73,302,87,215
233718,50,3,0,3,3,0,3,,,
233842,50,177,63,114,102,39,63,75,24,51
233921,50,7736,4309,3427,5713,3134,2579,2023,1175,848
234030,50,7124,2365,4759,4902,1648,3254,2222,717,1505
234076,50,8638,4065,4573,6725,3373,3352,1913,692,1221
234137,50,358,146,212,317,128,189,41,18,23
234155,50,348,114,234,199,76,123,149,38,111
234164,50,531,273,258,383,203,180,148,70,78
234173,50,59,18,41,20,4,16,39,14,25
234207,50,376,188,188,376,188,188,,,
234827,50,514,204,310,184,77,107,330,127,203
234915,50,821,272,549,89,30,59,732,242,490
235097,50,3306,1004,2302,2351,679,1672,955,325,630
235167,50,254,93,161,213,78,135,41,15,26
235316,50,2169,757,1412,1639,591,1048,530,166,364
235422,50,57,15,42,25,8,17,32,7,25
235547,50,654,97,557,592,86,506,62,11,51
236133,50,294,103,191,207,67,140,87,36,51
236230,50,332,88,244,227,63,164,105,25,80
236328,50,311,87,224,260,82,178,51,5,46
236452,50,244,104,140,55,32,23,189,72,117
236577,50,686,180,506,315,67,248,371,113,258
236595,50,3075,1029,2046,1615,480,1135,1460,549,911
236896,50,132,28,104,115,23,92,17,5,12
236939,50,4927,2094,2833,3316,1336,1980,1611,758,853
236948,50,16106,7000,9106,13206,5644,7562,2900,1356,1544
237011,50,946,362,584,716,270,446,230,92,138
237066,50,368,124,244,162,67,95,206,57,149
237118,50,93,30,63,89,29,60,4,1,3
237136,50,12,7,5,3,2,1,9,5,4
237181,50,24,13,11,,,,24,13,11
237215,50,20,10,10,13,7,6,7,3,4
237312,50,694,410,284,546,316,230,148,94,54
237330,50,349,87,262,125,28,97,224,59,165
237367,50,301,101,200,101,45,56,200,56,144
237385,50,22,6,16,13,6,7,9,0,9
237525,50,2739,931,1808,1758,652,1106,981,279,702
237783,50,222,107,115,203,95,108,19,12,7
237792,50,517,130,387,220,64,156,297,66,231
237880,50,793,398,395,793,398,395,,,
237899,50,151,59,92,82,40,42,69,19,50
237905,50,6,0,6,6,0,6,,,
237932,50,396,141,255,196,78,118,200,63,137
237969,50,62,21,41,48,19,29,14,2,12
238032,50,5682,2508,3174,4142,1844,2298,1540,664,876
238078,50,155,78,77,68,36,32,87,42,45
238193,50,808,110,698,581,77,504,227,33,194
238263,50,46,8,38,16,3,13,30,5,25
238324,50,185,58,127,59,12,47,126,46,80
238430,50,577,111,466,72,16,56,505,95,410
238458,50,512,139,373,384,100,284,128,39,89
238476,50,108,48,60,51,24,27,57,24,33
238616,50,2171,598,1573,1236,389,847,935,209,726
238661,50,656,151,505,435,90,345,221,61,160
238980,50,508,152,356,65,15,50,443,137,306
239071,50,229,127,102,27,18,9,202,109,93
239080,50,272,57,215,20,2,18,252,55,197
239105,50,3639,1437,2202,2561,998,1563,1078,439,639
239169,50,1615,663,952,1524,634,890,91,29,62
239318,50,154,81,73,56,18,38,98,63,35
239390,50,482,42,440,391,32,359,91,10,81
239424,50,130,111,19,84,70,14,46,41,5
239716,50,68,32,36,15,9,6,53,23,30
240107,50,971,227,744,552,149,403,419,78,341
240189,50,1712,715,997,483,175,308,1229,540,689
240213,50,83,11,72,35,3,32,48,8,40
240268,50,681,299,382,121,10,111,560,289,271
240277,50,453,160,293,158,45,113,295,115,180
240329,50,927,295,632,377,102,275,550,193,357
240338,50,83,26,57,5,1,4,78,25,53
240365,50,1078,335,743,277,57,220,801,278,523
240374,50,711,332,379,151,69,82,560,263,297
240392,50,1670,286,1384,1187,213,974,483,73,410
240417,50,980,297,683,218,51,167,762,246,516
240426,50,497,99,398,127,19,108,370,80,290
240444,50,12650,5923,6727,10424,4902,5522,2226,1021,1205
240453,50,4328,1646,2682,2611,1039,1572,1717,607,1110
240462,50,458,238,220,82,18,64,376,220,156
240471,50,412,99,313,193,46,147,219,53,166
240480,50,651,166,485,195,55,140,456,111,345
240727,50,2582,1112,1470,1581,721,860,1001,391,610
240754,50,293,101,192,99,37,62,194,64,130
241100,50,22,2,20,5,1,4,17,1,16
241128,50,11,1,10,6,0,6,5,1,4
241191,50,42,13,29,36,11,25,6,2,4
241216,50,76,41,35,49,25,24,27,16,11
241225,50,173,55,118,91,31,60,82,24,58
241304,50,283,57,226,195,35,160,88,22,66
241331,50,1756,273,1483,1533,238,1295,223,35,188
241377,50,182,41,141,73,17,56,109,24,85
241386,50,16,4,12,8,2,6,8,2,6
241395,50,333,69,264,157,31,126,176,38,138
241410,50,1637,499,1138,1070,351,719,567,148,419
241614,50,100,51,49,49,26,23,51,25,26
241739,50,1340,438,902,934,302,632,406,136,270
241766,50,35,21,14,28,17,11,7,4,3
241793,50,334,177,157,205,103,102,129,74,55
241836,50,35,5,30,20,4,16,15,1,14
242617,50,502,167,335,318,106,212,184,61,123
242626,50,210,74,136,186,60,126,24,14,10
242635,50,260,69,191,209,56,153,51,13,38
242644,50,74,32,42,52,21,31,22,11,11
242653,50,1723,508,1215,1221,344,877,502,164,338
242662,50,488,151,337,258,82,176,230,69,161
242680,50,103,41,62,91,37,54,12,4,8
242699,50,117,67,50,94,50,44,23,17,6
242705,50,68,23,45,50,18,32,18,5,13
242723,50,656,244,412,320,122,198,336,122,214
242972,50,1320,320,1000,568,138,430,752,182,570
243081,50,820,305,515,813,303,510,7,2,5
243197,50,861,448,413,782,416,366,79,32,47
243203,50,1770,608,1162,1681,588,1093,89,20,69
243221,50,2825,1269,1556,2108,945,1163,717,324,393
243346,50,907,212,695,676,156,520,231,56,175
243443,50,493,149,344,84,27,57,409,122,287
243498,50,128,81,47,71,44,27,57,37,20
243568,50,410,172,238,410,172,238,,,
243577,50,579,366,213,335,213,122,244,153,91
243586,50,66,15,51,35,11,24,31,4,27
243601,50,2210,683,1527,1650,501,1149,560,182,378
243665,50,258,55,203,82,14,68,176,41,135
243744,50,10234,5738,4496,9231,5058,4173,1003,680,323
243780,50,12935,7580,5355,6869,3909,2960,6066,3671,2395
243823,50,1648,786,862,1569,756,813,79,30,49
243832,50,95,49,46,69,33,36,26,16,10
245652,50,75,43,32,43,27,16,32,16,16
245777,50,52,52,0,52,52,0,,,
245838,50,793,197,596,724,172,552,69,25,44
245847,50,219,44,175,207,40,167,12,4,8
245865,50,1045,173,872,742,130,612,303,43,260
245883,50,719,111,608,509,80,429,210,31,179
245892,50,338,65,273,259,53,206,79,12,67
245953,50,575,140,435,274,69,205,301,71,230
246345,50,55,18,37,22,9,13,33,9,24
246789,50,117,72,45,25,14,11,92,58,34
247162,50,55,25,30,31,15,16,24,10,14
247649,50,39,4,35,,,,39,4,35
248934,50,341,172,169,341,172,169,,,
251312,50,90,19,71,73,17,56,17,2,15
260372,50,15,0,15,15,0,15,,,
262086,50,3867,937,2930,1387,316,1071,2480,621,1859
262129,50,20,13,7,20,13,7,,,
363907,50,101,25,76,38,12,26,63,13,50
363916,50,18,2,16,7,0,7,11,2,9
363934,50,58,43,15,17,13,4,41,30,11
366003,50,78,39,39,27,7,20,51,32,19
366252,50,7,0,7,7,0,7,,,
366368,50,104,31,73,103,31,72,1,0,1
366605,50,7,5,2,7,5,2,,,
366711,50,1195,335,860,831,236,595,364,99,265
367884,50,104,19,85,76,14,62,28,5,23
367954,50,5152,1499,3653,4768,1408,3360,384,91,293
369002,50,295,110,185,109,38,71,186,72,114
369516,50,8,2,6,8,2,6,,,
369659,50,160,29,131,132,25,107,28,4,24
372073,50,8,4,4,8,4,4,,,
374024,50,227,52,175,13,1,12,214,51,163
377555,50,543,277,266,276,129,147,267,148,119
377564,50,711,297,414,503,227,276,208,70,138
378576,50,697,101,596,325,50,275,372,51,321
381352,50,65,16,49,55,11,44,10,5,5
381459,50,321,219,102,67,48,19,254,171,83
383020,50,52,10,42,40,7,33,12,3,9
384306,50,116,20,96,77,12,65,39,8,31
384412,50,306,204,102,306,204,102,,,
385415,50,1303,560,743,1088,464,624,215,96,119
385619,50,378,188,190,332,170,162,46,18,28
386472,50,11,3,8,10,2,8,1,1,0
399911,50,10,7,3,10,7,3,,,
401223,50,232,87,145,94,30,64,138,57,81
401250,50,107,25,82,59,14,45,48,11,37
404222,50,216,76,140,213,74,139,3,2,1
404338,50,20,9,11,20,9,11,,,
407629,50,4297,1867,2430,4297,1867,2430,,,
408844,50,252,58,194,168,39,129,84,19,65
409254,50,331,7,324,39,0,39,292,7,285
409616,50,552,230,322,550,230,320,2,0,2
409698,50,797,212,585,526,119,407,271,93,178
413413,50,26447,4360,22087,5895,1053,4842,20552,3307,17245
414595,50,371,76,295,254,50,204,117,26,91
414878,50,3874,2979,895,1356,1066,290,2518,1913,605
414966,50,133,64,69,24,11,13,109,53,56
416801,50,27,5,22,20,3,17,7,2,5
418126,50,69,24,45,40,14,26,29,10,19
420042,50,1,0,1,1,0,1,,,
420246,50,591,80,511,548,70,478,43,10,33
420705,50,149,101,48,61,41,20,88,60,28
422695,50,15,2,13,,,,15,2,13
423643,50,3782,1486,2296,3698,1459,2239,84,27,57
426314,50,3095,2253,842,1834,1342,492,1261,911,350
428259,50,61,21,40,36,13,23,25,8,17
429085,50,87,23,64,37,11,26,50,12,38
429094,50,135,24,111,95,16,79,40,8,32
430184,50,237,52,185,59,15,44,178,37,141
430670,50,334,144,190,334,144,190,,,
430704,50,68,23,45,67,23,44,1,0,1
432348,50,152,83,69,152,83,69,,,
433004,50,163,51,112,163,51,112,,,
433387,50,44128,12577,31551,44128,12577,31551,,,
433420,50,3,1,2,3,1,2,,,
433536,50,11,1,10,9,1,8,2,0,2
433660,50,1839,590,1249,808,223,585,1031,367,664
434441,50,77,15,62,77,15,62,,,
435000,50,992,376,616,906,356,550,86,20,66
436261,50,25,3,22,25,3,22,,,
436614,50,27,22,5,4,4,0,23,18,5
437097,50,816,528,288,808,521,287,8,7,1
438586,50,92,27,65,41,9,32,51,18,33
439020,50,43,9,34,32,7,25,11,2,9
439394,50,55,10,45,55,10,45,,,
439446,50,144,25,119,144,25,119,,,
439701,50,277,117,160,76,28,48,201,89,112
439783,50,116,37,79,51,18,33,65,19,46
439817,50,193,83,110,54,27,27,139,56,83
439914,50,33,5,28,33,5,28,,,
439969,50,71,20,51,71,20,51,,,
440004,50,34,8,26,34,8,26,,,
440031,50,668,202,466,638,195,443,30,7,23
440396,50,58,36,22,22,13,9,36,23,13
440794,50,96,24,72,90,22,68,6,2,4
440828,50,231,62,169,167,48,119,64,14,50
441104,50,343,73,270,181,28,153,162,45,117
441131,50,283,69,214,169,44,125,114,25,89
441636,50,24,2,22,24,2,22,,,
441690,50,12,6,6,1,1,0,11,5,6
441900,50,54,2,52,17,1,16,37,1,36
441937,50,394,151,243,149,50,99,245,101,144
442064,50,92,14,78,86,10,76,6,4,2
442295,50,265,132,133,240,124,116,25,8,17
442356,50,135,23,112,1,0,1,134,23,111
442426,50,18,2,16,10,1,9,8,1,7
442569,50,838,392,446,522,242,280,316,150,166
442639,50,346,231,115,346,231,115,,,
442806,50,2446,1044,1402,2446,1044,1402,,,
442842,50,173,25,148,74,11,63,99,14,85
442930,50,30,15,15,26,14,12,4,1,3
443030,50,75,23,52,75,23,52,,,
443049,50,158,91,67,80,44,36,78,47,31
443058,50,177,83,94,62,26,36,115,57,58
443076,50,146,76,70,79,43,36,67,33,34
443340,50,9,3,6,8,2,6,1,1,0
443410,50,57,40,17,40,27,13,17,13,4
443562,50,163,55,108,151,52,99,12,3,9
443599,50,236,10,226,48,4,44,188,6,182
443702,50,62,32,30,14,6,8,48,26,22
443766,50,284,46,238,46,8,38,238,38,200
443784,50,152,45,107,38,14,24,114,31,83
444103,50,35,29,6,13,12,1,22,17,5
444130,50,11472,2759,8713,5176,1392,3784,6296,1367,4929
444398,50,1,1,0,,,,1,1,0
444413,50,17,17,0,17,17,0,,,
444699,50,59,7,52,57,6,51,2,1,1
444778,50,69,19,50,37,10,27,32,9,23
444787,50,6,0,6,5,0,5,1,0,1
445027,50,3886,1695,2191,3626,1617,2009,260,78,182
445054,50,40,31,9,40,31,9,,,
445133,50,49,16,33,16,4,12,33,12,21
445188,50,760,423,337,755,418,337,5,5,0
445267,50,337,89,248,87,26,61,250,63,187
445735,50,905,397,508,905,397,508,,,
445869,50,407,149,258,188,62,126,219,87,132
446002,50,23,6,17,11,3,8,12,3,9
446039,50,33,9,24,33,9,24,,,
446048,50,63,44,19,42,29,13,21,15,6
446224,50,44,5,39,42,5,37,2,0,2
446561,50,224,47,177,224,47,177,,,
446640,50,2433,1250,1183,2338,1197,1141,95,53,42
447050,50,2578,459,2119,1954,342,1612,624,117,507
447263,50,126,33,93,117,28,89,9,5,4
447698,50,130,23,107,86,13,73,44,10,34
447801,50,93,25,68,60,17,43,33,8,25
447953,50,246,170,76,176,121,55,70,49,21
448673,50,91,11,80,54,7,47,37,4,33
448691,50,161,36,125,,,,161,36,125
449038,50,188,50,138,42,12,30,146,38,108
449135,50,6,2,4,3,2,1,3,0,3
449339,50,9462,5856,3606,802,479,323,8660,5377,3283
449348,50,26,13,13,1,0,1,25,13,12
449481,50,45,6,39,45,6,39,,,
449764,50,19,16,3,14,11,3,5,5,0
449834,50,38,37,1,10,10,0,28,27,1
449870,50,102,53,49,89,44,45,13,9,4
449889,50,9861,2321,7540,9861,2321,7540,,,
449898,50,291,45,246,193,32,161,98,13,85
449922,50,130,51,79,124,51,73,6,0,6
450298,50,31,13,18,10,4,6,21,9,12
450304,50,109,47,62,58,30,28,51,17,34
450377,50,143,28,115,27,7,20,116,21,95
450571,50,56,4,52,34,0,34,22,4,18
450933,50,4618,2526,2092,4618,2526,2092,,,
451079,50,73,14,59,73,14,59,,,
451103,50,534,193,341,304,102,202,230,91,139
451510,50,619,237,382,573,214,359,46,23,23
453163,50,428,82,346,57,16,41,371,66,305
453215,50,56,12,44,11,5,6,45,7,38
454227,50,15026,1414,13612,810,77,733,14216,1337,12879
454582,50,52,15,37,33,12,21,19,3,16
454689,50,524,237,287,524,237,287,,,
454829,50,3300,532,2768,689,137,552,2611,395,2216
454838,50,34,8,26,34,8,26,,,
454856,50,50,9,41,50,9,41,,,
455099,50,108,66,42,28,16,12,80,50,30
455178,50,88,26,62,86,26,60,2,0,2
455406,50,620,280,340,619,280,339,1,0,1
455433,50,500,98,402,416,77,339,84,21,63
455664,50,3042,516,2526,509,90,419,2533,426,2107
455804,50,131,88,43,80,53,27,51,35,16
455813,50,64,36,28,50,23,27,14,13,1
455992,50,305,83,222,305,83,222,,,
456481,50,27,10,17,8,2,6,19,8,11
456490,50,19,10,9,8,4,4,11,6,5
456542,50,708,289,419,590,259,331,118,30,88
456621,50,12,4,8,3,3,0,9,1,8
457226,50,8,7,1,,,,8,7,1
457271,50,68,22,46,27,11,16,41,11,30
457299,50,4,3,1,4,3,1,,,
457402,50,13,9,4,1,1,0,12,8,4
457484,50,36,19,17,9,4,5,27,15,12
457697,50,50,29,21,4,1,3,46,28,18
458210,50,1452,269,1183,1158,216,942,294,53,241
458885,50,32,4,28,5,0,5,27,4,23
458919,50,585,104,481,145,28,117,440,76,364
458955,50,25,2,23,3,0,3,22,2,20
458964,50,216,37,179,35,6,29,181,31,150
458973,50,209,53,156,46,13,33,163,40,123
459259,50,105,19,86,93,17,76,12,2,10
459268,50,35,5,30,27,5,22,8,0,8
459727,50,1836,451,1385,909,194,715,927,257,670
459736,50,1144,432,712,1033,388,645,111,44,67
459745,50,652,106,546,420,56,364,232,50,182
459824,50,1545,645,900,1255,570,685,290,75,215
459842,50,3,1,2,2,1,1,1,0,1
459851,50,2,2,0,1,1,0,1,1,0
459949,50,693,198,495,201,57,144,492,141,351
459994,50,2649,1151,1498,418,193,225,2231,958,1273
460349,50,662,211,451,98,21,77,564,190,374
460376,50,32,16,16,30,14,16,2,2,0
461023,50,51,5,46,50,5,45,1,0,1
461032,50,40,20,20,6,4,2,34,16,18
461120,50,77,43,34,65,35,30,12,8,4
461139,50,83,16,67,83,16,67,,,
461148,50,289,148,141,289,148,141,,,
461281,50,11,2,9,7,2,5,4,0,4
461485,50,161,139,22,64,53,11,97,86,11
461528,50,65,43,22,9,6,3,56,37,19
461643,50,7,1,6,7,1,6,,,
461795,50,374,200,174,208,116,92,166,84,82
461883,50,67,28,39,62,26,36,5,2,3
462044,50,92,22,70,45,11,34,47,11,36
464226,50,630,233,397,540,203,337,90,30,60
474863,50,224,59,165,163,44,119,61,15,46
475033,50,2484,620,1864,,,,2484,620,1864
475121,50,1969,387,1582,1055,206,849,914,181,733
475228,50,76,26,50,76,26,50,,,
475273,50,152,48,104,53,14,39,99,34,65
475398,50,93,55,38,27,16,11,66,39,27
475495,50,1455,431,1024,1455,431,1024,,,
475608,50,41,24,17,23,14,9,18,10,8
476975,50,3132,1213,1919,194,88,106,2938,1125,1813
477039,50,493,79,414,416,67,349,77,12,65
479956,50,5769,3070,2699,441,231,210,5328,2839,2489
480073,50,12,2,10,9,2,7,3,0,3
480198,50,107,40,67,98,37,61,9,3,6
480569,50,451,226,225,7,4,3,444,222,222
480657,50,22,3,19,15,2,13,7,1,6
480781,50,117,73,44,116,72,44,1,1,0
480790,50,1531,748,783,1525,746,779,6,2,4
480985,50,3,0,3,3,0,3,,,
481030,50,42,24,18,2,1,1,40,23,17
481058,50,242,123,119,168,86,82,74,37,37
481094,50,199,25,174,199,25,174,,,
481401,50,427,290,137,59,44,15,368,246,122
481535,50,44,20,24,44,20,24,,,
481720,50,4,0,4,2,0,2,2,0,2
482149,50,3762,1198,2564,3028,1014,2014,734,184,550
482158,50,429,199,230,238,106,132,191,93,98
482228,50,44,31,13,4,3,1,40,28,12
482413,50,145,56,89,28,12,16,117,44,73
482422,50,13,5,8,2,1,1,11,4,7
482431,50,94,50,44,10,6,4,84,44,40
482459,50,13,7,6,2,2,0,11,5,6
482468,50,23,9,14,4,3,1,19,6,13
482477,50,3027,1224,1803,435,190,245,2592,1034,1558
482556,50,7,3,4,1,1,0,6,2,4
482565,50,4,3,1,1,1,0,3,2,1
482574,50,8,5,3,,,,8,5,3
482635,50,24,10,14,2,0,2,22,10,12
482653,50,17,7,10,2,1,1,15,6,9
482680,50,789,220,569,229,64,165,560,156,404
482705,50,5040,2018,3022,228,62,166,4812,1956,2856
482936,50,62,47,15,45,36,9,17,11,6
483036,50,486,168,318,124,36,88,362,132,230
483124,50,15872,5141,10731,4097,1155,2942,11775,3986,7789
483221,50,1,0,1,1,0,1,,,
483595,50,3242,881,2361,2488,669,1819,754,212,542
483780,50,469,300,169,450,286,164,19,14,5
483975,50,761,362,399,753,356,397,8,6,2
484613,50,19025,4769,14256,19025,4769,14256,,,
484631,50,197,53,144,197,53,144,,,
484756,50,3,2,1,3,2,1,,,
484844,50,47,30,17,,,,47,30,17
484862,50,226,103,123,100,53,47,126,50,76
484905,50,684,244,440,280,100,180,404,144,260
485403,50,108,28,80,50,17,33,58,11,47
485546,50,351,186,165,238,122,116,113,64,49
485768,50,407,165,242,407,165,242,,,
486053,50,127,116,11,98,88,10,29,28,1
486080,50,9,6,3,9,6,3,,,
486239,50,88,38,50,77,33,44,11,5,6
486284,50,39,16,23,8,2,6,31,14,17
486354,50,15,7,8,15,7,8,,,
486433,50,159,53,106,127,44,83,32,9,23
486460,50,27,7,20,27,7,20,,,
486840,50,4263,1844,2419,1582,694,888,2681,1150,1531
486901,50,350,136,214,254,97,157,96,39,57
487010,50,2844,1047,1797,2639,995,1644,205,52,153
487153,50,42,7,35,42,7,35,,,
487524,50,636,184,452,277,82,195,359,102,257
487603,50,136,45,91,55,19,36,81,26,55
487649,50,131,45,86,129,44,85,2,1,1
487995,50,95,24,71,37,6,31,58,18,40
488031,50,129,60,69,129,60,69,,,
488068,50,21,2,19,2,0,2,19,2,17
488387,50,220,46,174,40,8,32,180,38,142
488448,50,31,21,10,31,21,10,,,
488527,50,758,361,397,758,361,397,,,
488554,50,662,281,381,662,281,381,,,
488572,50,391,188,203,387,186,201,4,2,2
488679,50,4491,1607,2884,4228,1532,2696,263,75,188
488721,50,678,599,79,178,160,18,500,439,61
488776,50,99,33,66,59,20,39,40,13,27
488785,50,27,19,8,22,17,5,5,2,3
488800,50,232,67,165,221,65,156,11,2,9
488846,50,6972,3663,3309,1485,818,667,5487,2845,2642
488907,50,30,1,29,23,0,23,7,1,6
489335,50,53,35,18,4,1,3,49,34,15
489779,50,11615,3215,8400,5806,1916,3890,5809,1299,4510
489858,50,591,192,399,587,190,397,4,2,2
489937,50,476,331,145,202,114,88,274,217,57
490045,50,179,97,82,99,54,45,80,43,37
490081,50,110,73,37,91,60,31,19,13,6
490106,50,393,145,248,138,45,93,255,100,155
490133,50,3808,1957,1851,3660,1885,1775,148,72,76
490230,50,29,17,12,29,17,12,,,
490373,50,332,160,172,332,160,172,,,
490601,50,642,339,303,638,335,303,4,4,0
490753,50,32,7,25,32,7,25,,,
490805,50,735,299,436,281,168,113,454,131,323
491190,50,135,26,109,75,16,59,60,10,50
491808,50,195,38,157,166,32,134,29,6,23
492209,50,36,7,29,31,7,24,5,0,5
492607,50,143,37,106,49,6,43,94,31,63
492689,50,597,271,326,594,270,324,3,1,2
492704,50,208,36,172,203,33,170,5,3,2
493512,50,5,2,3,5,2,3,,,
493673,50,159,70,89,69,32,37,90,38,52
493895,50,668,606,62,589,533,56,79,73,6
493947,50,619,379,240,619,379,240,,,
494010,50,104,36,68,101,35,66,3,1,2
494551,50,34,4,30,11,2,9,23,2,21
494597,50,37,21,16,21,11,10,16,10,6
494603,50,1977,1356,621,369,258,111,1608,1098,510
494807,50,634,102,532,618,99,519,16,3,13
495192,50,322,72,250,311,70,241,11,2,9
495314,50,491,261,230,491,261,230,,,
496043,50,536,270,266,536,270,266,,,
496283,50,8,5,3,8,5,3,,,
496326,50,18,3,15,18,3,15,,,
496469,50,151,15,136,69,6,63,82,9,73
496627,50,816,365,451,691,301,390,125,64,61
497107,50,114,18,96,,,,114,18,96
497453,50,7,5,2,5,4,1,2,1,1
497462,50,30,15,15,27,15,12,3,0,3
497480,50,122,36,86,,,,122,36,86
497666,50,22,5,17,20,4,16,2,1,1
497693,50,91,43,48,91,43,48,,,
497718,50,69,26,43,11,4,7,58,22,36
497790,50,4,0,4,4,0,4,,,
498234,50,116,30,86,113,29,84,3,1,2
498289,50,111,53,58,20,9,11,91,44,47
498562,50,1058,302,756,549,170,379,509,132,377
498571,50,3374,861,2513,1328,304,1024,2046,557,1489
