UNITID,SNHCAT,OCCUPCAT,FACSTAT,SGTYPE,HRTOTLT,HRTOTLM,HRTOTLW,HRAIANT,HRAIANM,HRAIANW,HRASIAT,HRASIAM,HRASIAW,HRBKAAT,HRBKAAM,HRBKAAW,HRHISPT,HRHISPM,HRHISPW,HRNHPIT,HRNHPIM,HRNHPIW,HRWHITT,HRWHITM,HRWHITW,HR2MORT,HR2MORM,HR2MORW,HRUNKNT,HRUNKNM,HRUNKNW,HRNRALT,HRNRALM,HRNRALW
100654,10000,100,0,1,86,37,49,0,0,0,1,1,0,53,21,32,0,0,0,0,0,0,27,13,14,0,0,0,2,2,0,3,0,3
100663,10000,100,0,1,1000,402,598,1,1,0,50,28,22,270,79,191,27,12,15,0,0,0,491,199,292,24,12,12,33,8,25,104,63,41
100690,10000,100,0,1,3,3,0,0,0,0,0,0,0,0,0,0,0,0,0,0,0,0,3,3,0,0,0,0,0,0,0,0,0,0
100706,10000,100,0,1,212,98,114,2,0,2,11,2,9,20,6,14,8,3,5,0,0,0,162,79,83,2,2,0,0,0,0,7,6,1
100724,10000,100,0,1,110,42,68,0,0,0,3,2,1,77,32,45,0,0,0,0,0,0,5,2,3,0,0,0,25,6,19,0,0,0
100733,10000,100,0,1,6,1,5,0,0,0,0,0,0,0,0,0,0,0,0,0,0,0,6,1,5,0,0,0,0,0,0,0,0,0
100751,10000,100,0,1,811,315,496,0,0,0,30,18,12,172,36,136,23,9,14,1,0,1,514,214,300,8,1,7,3,0,3,60,37,23
100760,10000,100,0,1,18,7,11,0,0,0,0,0,0,4,1,3,0,0,0,0,0,0,14,6,8,0,0,0,0,0,0,0,0,0
100812,10000,100,0,1,42,13,29,0,0,0,3,2,1,4,1,3,0,0,0,0,0,0,35,10,25,0,0,0,0,0,0,0,0,0
100830,10000,100,0,1,86,32,54,0,0,0,3,0,3,27,12,15,0,0,0,0,0,0,35,13,22,0,0,0,17,3,14,4,4,0
100858,10000,100,0,1,296,119,177,0,0,0,6,2,4,56,8,48,7,2,5,1,1,0,194,88,106,2,1,1,3,1,2,27,16,11
100937,10000,100,0,1,42,14,28,0,0,0,2,1,1,7,5,2,1,0,1,0,0,0,30,6,24,0,0,0,2,2,0,0,0,0
101028,10000,100,0,1,19,7,12,0,0,0,0,0,0,8,4,4,0,0,0,0,0,0,11,3,8,0,0,0,0,0,0,0,0,0
101116,10000,100,0,1,6,2,4,0,0,0,0,0,0,4,1,3,0,0,0,0,0,0,2,1,1,0,0,0,0,0,0,0,0,0
101143,10000,100,0,1,14,7,7,0,0,0,1,1,0,2,1,1,0,0,0,0,0,0,11,5,6,0,0,0,0,0,0,0,0,0
101161,10000,100,0,1,57,19,38,1,1,0,0,0,0,16,4,12,1,1,0,0,0,0,38,13,25,1,0,1,0,0,0,0,0,0
101189,10000,100,0,1,42,20,22,1,0,1,0,0,0,7,4,3,1,1,0,0,0,0,33,15,18,0,0,0,0,0,0,0,0,0
101240,10000,100,0,1,39,17,22,1,1,0,0,0,0,6,2,4,2,0,2,0,0,0,29,14,15,1,0,1,0,0,0,0,0,0
101286,10000,100,0,1,37,8,29,0,0,0,0,0,0,8,1,7,0,0,0,0,0,0,23,6,17,2,0,2,4,1,3,0,0,0
101295,10000,100,0,1,36,15,21,0,0,0,0,0,0,1,0,1,2,1,1,0,0,0,33,14,19,0,0,0,0,0,0,0,0,0
101301,10000,100,0,1,8,2,6,0,0,0,0,0,0,5,0,5,0,0,0,0,0,0,1,1,0,0,0,0,2,1,1,0,0,0
101365,10000,100,0,1,4,1,3,0,0,0,0,0,0,3,1,2,0,0,0,0,0,0,1,0,1,0,0,0,0,0,0,0,0,0
101435,10000,100,0,1,8,7,1,0,0,0,0,0,0,2,1,1,0,0,0,0,0,0,0,0,0,0,0,0,6,6,0,0,0,0
101462,10000,100,0,1,13,2,11,0,0,0,0,0,0,8,2,6,0,0,0,0,0,0,4,0,4,0,0,0,1,0,1,0,0,0
101471,10000,100,0,1,18,10,8,0,0,0,0,0,0,8,4,4,0,0,0,0,0,0,10,6,4,0,0,0,0,0,0,0,0,0
101480,10000,100,0,1,122,51,71,1,1,0,4,2,2,11,6,5,3,1,2,0,0,0,96,38,58,0,0,0,2,0,2,5,3,2
101505,10000,100,0,1,34,15,19,0,0,0,0,0,0,9,2,7,1,1,0,0,0,0,24,12,12,0,0,0,0,0,0,0,0,0
101514,10000,100,0,1,29,7,22,0,0,0,0,0,0,5,2,3,0,0,0,0,0,0,21,5,16,1,0,1,2,0,2,0,0,0
101569,10000,100,0,1,20,10,10,0,0,0,0,0,0,16,6,10,0,0,0,0,0,0,3,3,0,0,0,0,1,1,0,0,0,0
101587,10000,100,0,1,26,7,19,0,0,0,1,0,1,3,0,3,0,0,0,0,0,0,12,3,9,0,0,0,8,2,6,2,2,0
101602,10000,100,0,1,15,6,9,0,0,0,0,0,0,1,0,1,0,0,0,0,0,0,14,6,8,0,0,0,0,0,0,0,0,0
101648,10000,100,0,1,8,5,3,0,0,0,0,0,0,2,1,1,0,0,0,0,0,0,6,4,2,0,0,0,0,0,0,0,0,0
101675,10000,100,0,1,42,21,21,0,0,0,0,0,0,36,19,17,0,0,0,0,0,0,6,2,4,0,0,0,0,0,0,0,0,0
101693,10000,100,0,1,6,3,3,0,0,0,0,0,0,0,0,0,1,1,0,0,0,0,5,2,3,0,0,0,0,0,0,0,0,0
101709,10000,100,0,1,66,25,41,1,0,1,1,1,0,19,6,13,0,0,0,0,0,0,44,17,27,0,0,0,0,0,0,1,1,0
101736,10000,100,0,1,32,9,23,0,0,0,0,0,0,3,0,3,1,0,1,0,0,0,26,8,18,0,0,0,2,1,1,0,0,0
101879,10000,100,0,1,72,35,37,0,0,0,2,2,0,8,1,7,1,1,0,0,0,0,61,31,30,0,0,0,0,0,0,0,0,0
101897,10000,100,0,1,13,4,9,1,0,1,0,0,0,0,0,0,2,0,2,0,0,0,10,4,6,0,0,0,0,0,0,0,0,0
101912,10000,100,0,1,4,2,2,0,0,0,0,0,0,4,2,2,0,0,0,0,0,0,0,0,0,0,0,0,0,0,0,0,0,0
101994,10000,100,0,1,6,4,2,0,0,0,0,0,0,0,0,0,0,0,0,0,0,0,6,4,2,0,0,0,0,0,0,0,0,0
102030,10000,100,0,1,22,4,18,0,0,0,0,0,0,11,2,9,0,0,0,0,0,0,9,2,7,1,0,1,1,0,1,0,0,0
102049,10000,100,0,1,28,8,20,0,0,0,0,0,0,2,0,2,1,0,1,0,0,0,25,8,17,0,0,0,0,0,0,0,0,0
102067,10000,100,0,1,27,8,19,1,1,0,1,1,0,11,3,8,0,0,0,0,0,0,14,3,11,0,0,0,0,0,0,0,0,0
102076,10000,100,0,1,15,10,5,0,0,0,0,0,0,0,0,0,0,0,0,0,0,0,15,10,5,0,0,0,0,0,0,0,0,0
102094,10000,100,0,1,249,133,116,0,0,0,23,14,9,52,27,25,1,0,1,1,1,0,163,89,74,6,0,6,3,2,1,0,0,0
102234,10000,100,0,1,41,11,30,0,0,0,0,0,0,11,1,10,1,0,1,0,0,0,29,10,19,0,0,0,0,0,0,0,0,0
102270,10000,100,0,1,48,22,26,0,0,0,0,0,0,46,22,24,0,0,0,0,0,0,2,0,2,0,0,0,0,0,0,0,0,0
102298,10000,100,0,1,29,10,19,0,0,0,0,0,0,28,9,19,0,0,0,0,0,0,1,1,0,0,0,0,0,0,0,0,0,0
102313,10000,100,0,1,18,5,13,0,0,0,0,0,0,15,4,11,0,0,0,0,0,0,3,1,2,0,0,0,0,0,0,0,0,0
102368,10000,100,0,1,78,33,45,0,0,0,0,0,0,9,3,6,0,0,0,0,0,0,59,23,36,1,0,1,2,1,1,7,6,1
102377,10000,100,0,1,33,18,15,0,0,0,0,0,0,32,17,15,0,0,0,0,0,0,1,1,0,0,0,0,0,0,0,0,0,0
102395,10000,100,0,1,10,5,5,0,0,0,0,0,0,3,1,2,0,0,0,0,0,0,7,4,3,0,0,0,0,0,0,0,0,0
102429,10000,100,0,1,19,9,10,0,0,0,0,0,0,2,0,2,0,0,0,0,0,0,17,9,8,0,0,0,0,0,0,0,0,0
102553,10000,100,0,1,132,58,74,6,1,5,2,0,2,2,0,2,7,4,3,2,0,2,92,44,48,8,5,3,11,4,7,2,0,2
102614,10000,100,0,1,106,63,43,6,3,3,2,0,2,0,0,0,4,2,2,0,0,0,65,40,25,7,2,5,10,7,3,12,9,3
102632,10000,100,0,1,24,8,16,1,0,1,1,0,1,0,0,0,0,0,0,0,0,0,22,8,14,0,0,0,0,0,0,0,0,0
102669,10000,100,0,1,22,7,15,5,1,4,0,0,0,0,0,0,0,0,0,0,0,0,15,6,9,2,0,2,0,0,0,0,0,0
102845,10000,100,0,1,75,27,48,2,0,2,2,0,2,12,4,8,16,3,13,3,0,3,40,20,20,0,0,0,0,0,0,0,0,0
103501,10000,100,0,1,5,1,4,0,0,0,1,0,1,1,1,0,0,0,0,0,0,0,3,0,3,0,0,0,0,0,0,0,0,0
103529,10000,100,0,1,18,10,8,2,0,2,2,2,0,0,0,0,0,0,0,0,0,0,10,6,4,0,0,0,3,2,1,1,0,1
103893,10000,100,0,1,32,6,26,2,1,1,0,0,0,4,2,2,6,1,5,0,0,0,18,2,16,1,0,1,1,0,1,0,0,0
103909,10000,100,0,1,17,5,12,0,0,0,0,0,0,2,0,2,4,1,3,0,0,0,10,3,7,0,0,0,1,1,0,0,0,0
103927,10000,100,0,1,15,0,15,0,0,0,0,0,0,1,0,1,3,0,3,1,0,1,8,0,8,2,0,2,0,0,0,0,0,0
104090,10000,100,0,1,21,4,17,0,0,0,1,1,0,3,0,3,3,0,3,0,0,0,12,3,9,2,0,2,0,0,0,0,0,0
104151,10000,100,0,1,1608,687,921,24,7,17,76,28,48,78,27,51,237,79,158,4,0,4,583,242,341,40,22,18,417,201,216,149,81,68
104160,10000,100,0,1,49,16,33,0,0,0,1,0,1,0,0,0,20,6,14,0,0,0,18,7,11,0,0,0,10,3,7,0,0,0
104179,10000,100,0,1,435,182,253,6,3,3,26,10,16,25,11,14,97,32,65,1,0,1,210,85,125,12,6,6,15,9,6,43,26,17
104346,10000,100,0,1,29,18,11,0,0,0,1,1,0,2,2,0,12,6,6,0,0,0,12,7,5,2,2,0,0,0,0,0,0,0
104425,10000,100,0,1,44,17,27,0,0,0,1,1,0,6,2,4,6,2,4,0,0,0,27,11,16,1,0,1,1,0,1,2,1,1
104577,10000,100,0,1,25,14,11,1,1,0,0,0,0,0,0,0,3,2,1,0,0,0,21,11,10,0,0,0,0,0,0,0,0,0
104586,10000,100,0,1,133,89,44,0,0,0,11,10,1,3,3,0,12,6,6,1,0,1,80,48,32,3,3,0,20,17,3,3,2,1
104708,10000,100,0,1,48,21,27,0,0,0,0,0,0,2,2,0,11,3,8,0,0,0,29,13,16,1,1,0,4,1,3,1,1,0
104717,10000,100,0,1,340,176,164,4,2,2,7,5,2,25,8,17,77,47,30,1,1,0,192,91,101,14,8,6,20,14,6,0,0,0
105136,10000,100,0,1,48,20,28,1,0,1,5,2,3,5,3,2,13,4,9,0,0,0,17,6,11,1,0,1,6,5,1,0,0,0
105145,10000,100,0,1,34,14,20,1,1,0,0,0,0,3,0,3,9,5,4,0,0,0,21,8,13,0,0,0,0,0,0,0,0,0
105154,10000,100,0,1,59,27,32,0,0,0,3,1,2,2,1,1,14,5,9,1,0,1,35,18,17,2,1,1,2,1,1,0,0,0
105206,10000,100,0,1,35,14,21,0,0,0,1,0,1,2,1,1,3,2,1,0,0,0,25,8,17,1,0,1,3,3,0,0,0,0
105215,10000,100,0,1,6,2,4,0,0,0,0,0,0,0,0,0,1,1,0,0,0,0,5,1,4,0,0,0,0,0,0,0,0,0
105297,10000,100,0,1,28,16,12,26,14,12,0,0,0,0,0,0,0,0,0,0,0,0,1,1,0,0,0,0,1,1,0,0,0,0
105330,10000,100,0,1,342,157,185,17,6,11,11,2,9,11,4,7,33,13,20,0,0,0,238,112,126,5,3,2,14,9,5,13,8,5
105349,10000,100,0,1,23,13,10,0,0,0,0,0,0,0,0,0,2,2,0,2,1,1,17,9,8,0,0,0,2,1,1,0,0,0
105428,10000,100,0,1,26,8,18,0,0,0,3,3,0,1,0,1,9,2,7,0,0,0,12,3,9,0,0,0,1,0,1,0,0,0
105525,10000,100,0,1,79,38,41,1,1,0,2,1,1,7,2,5,22,10,12,0,0,0,42,23,19,3,1,2,2,0,2,0,0,0
105534,10000,100,0,1,38,17,21,1,0,1,1,1,0,1,0,1,13,4,9,0,0,0,19,9,10,3,3,0,0,0,0,0,0,0
105543,10000,100,0,1,17,4,13,1,1,0,1,0,1,0,0,0,6,2,4,0,0,0,8,1,7,1,0,1,0,0,0,0,0,0
105589,10000,100,0,1,20,6,14,1,0,1,0,0,0,3,1,2,0,0,0,0,0,0,10,4,6,0,0,0,6,1,5,0,0,0
105659,10000,100,0,1,13,9,4,2,1,1,0,0,0,2,2,0,3,3,0,0,0,0,6,3,3,0,0,0,0,0,0,0,0,0
105668,10000,100,0,1,42,10,32,1,0,1,4,1,3,2,0,2,7,3,4,0,0,0,28,6,22,0,0,0,0,0,0,0,0,0
105747,10000,100,0,1,27,8,19,0,0,0,0,0,0,3,1,2,8,2,6,0,0,0,16,5,11,0,0,0,0,0,0,0,0,0
105792,10000,100,0,1,13,9,4,1,0,1,0,0,0,0,0,0,6,5,1,0,0,0,5,3,2,0,0,0,1,1,0,0,0,0
105899,10000,100,0,1,36,23,13,0,0,0,0,0,0,2,1,1,4,2,2,0,0,0,27,18,9,0,0,0,3,2,1,0,0,0
106041,10000,100,0,1,22,13,9,0,0,0,1,1,0,0,0,0,11,7,4,0,0,0,10,5,5,0,0,0,0,0,0,0,0,0
106148,10000,100,0,1,67,35,32,0,0,0,2,1,1,1,1,0,14,7,7,2,1,1,44,23,21,0,0,0,4,2,2,0,0,0
106245,10000,100,0,1,121,51,70,1,0,1,0,0,0,34,12,22,8,4,4,0,0,0,69,28,41,1,1,0,6,4,2,2,2,0
106263,10000,100,0,1,568,210,358,2,0,2,36,19,17,117,24,93,24,7,17,2,1,1,322,127,195,16,4,12,8,4,4,41,24,17
106306,10000,100,0,1,11,3,8,0,0,0,0,0,0,11,3,8,0,0,0,0,0,0,0,0,0,0,0,0,0,0,0,0,0,0
106342,10000,100,0,1,1,1,0,0,0,0,0,0,0,0,0,0,0,0,0,0,0,0,1,1,0,0,0,0,0,0,0,0,0,0
106397,10000,100,0,1,610,280,330,8,5,3,16,4,12,68,33,35,49,20,29,1,0,1,392,177,215,8,3,5,17,7,10,51,31,20
106412,10000,100,0,1,53,24,29,1,0,1,1,1,0,43,17,26,0,0,0,0,0,0,6,5,1,0,0,0,0,0,0,2,1,1
106449,10000,100,0,1,46,20,26,1,1,0,1,0,1,2,1,1,1,1,0,0,0,0,38,14,24,3,3,0,0,0,0,0,0,0
106458,10000,100,0,1,195,88,107,1,1,0,4,4,0,35,12,23,10,1,9,0,0,0,126,57,69,1,0,1,4,4,0,14,9,5
106467,10000,100,0,1,39,9,30,1,0,1,6,2,4,1,0,1,1,0,1,0,0,0,29,7,22,0,0,0,1,0,1,0,0,0
106485,10000,100,0,1,60,31,29,1,1,0,2,2,0,8,3,5,1,0,1,0,0,0,43,21,22,0,0,0,2,1,1,3,3,0
106546,10000,100,0,1,15,2,13,0,0,0,0,0,0,2,0,2,0,0,0,0,0,0,13,2,11,0,0,0,0,0,0,0,0,0
106625,10000,100,0,1,9,3,6,0,0,0,0,0,0,0,0,0,0,0,0,0,0,0,9,3,6,0,0,0,0,0,0,0,0,0
106704,10000,100,0,1,166,74,92,0,0,0,1,1,0,25,8,17,3,1,2,1,1,0,125,57,68,6,3,3,0,0,0,5,3,2
106713,10000,100,0,1,9,3,6,0,0,0,0,0,0,0,0,0,0,0,0,0,0,0,9,3,6,0,0,0,0,0,0,0,0,0
106795,10000,100,0,1,16,4,12,1,0,1,0,0,0,2,1,1,1,0,1,0,0,0,12,3,9,0,0,0,0,0,0,0,0,0
106810,10000,100,0,1,7,4,3,0,0,0,0,0,0,0,0,0,0,0,0,0,0,0,7,4,3,0,0,0,0,0,0,0,0,0
106883,10000,100,0,1,15,6,9,0,0,0,0,0,0,7,3,4,0,0,0,0,0,0,8,3,5,0,0,0,0,0,0,0,0,0
106980,10000,100,0,1,24,11,13,0,0,0,0,0,0,1,0,1,0,0,0,0,0,0,23,11,12,0,0,0,0,0,0,0,0,0
106999,10000,100,0,1,11,2,9,0,0,0,0,0,0,0,0,0,0,0,0,0,0,0,11,2,9,0,0,0,0,0,0,0,0,0
107044,10000,100,0,1,72,25,47,0,0,0,0,0,0,1,0,1,1,0,1,0,0,0,67,24,43,1,0,1,1,1,0,1,0,1
107071,10000,100,0,1,38,16,22,0,0,0,0,0,0,4,1,3,1,1,0,0,0,0,32,14,18,0,0,0,1,0,1,0,0,0
107080,10000,100,0,1,60,25,35,0,0,0,0,0,0,9,4,5,6,0,6,1,0,1,39,17,22,4,4,0,0,0,0,1,0,1
107141,10000,100,0,1,24,10,14,1,1,0,0,0,0,1,0,1,4,1,3,0,0,0,17,8,9,0,0,0,1,0,1,0,0,0
107318,10000,100,0,1,14,5,9,0,0,0,0,0,0,6,3,3,0,0,0,0,0,0,8,2,6,0,0,0,0,0,0,0,0,0
107327,10000,100,0,1,7,2,5,0,0,0,0,0,0,2,1,1,0,0,0,0,0,0,5,1,4,0,0,0,0,0,0,0,0,0
107460,10000,100,0,1,10,3,7,1,0,1,0,0,0,0,0,0,0,0,0,1,0,1,8,3,5,0,0,0,0,0,0,0,0,0
107512,10000,100,0,1,33,13,20,0,0,0,0,0,0,1,1,0,2,0,2,0,0,0,29,12,17,1,0,1,0,0,0,0,0,0
107521,10000,100,0,1,25,12,13,0,0,0,0,0,0,6,3,3,0,0,0,0,0,0,19,9,10,0,0,0,0,0,0,0,0,0
107549,10000,100,0,1,17,9,8,0,0,0,0,0,0,0,0,0,0,0,0,0,0,0,17,9,8,0,0,0,0,0,0,0,0,0
107558,10000,100,0,1,23,15,8,1,1,0,0,0,0,1,0,1,5,4,1,1,1,0,15,9,6,0,0,0,0,0,0,0,0,0
107585,10000,100,0,1,17,5,12,0,0,0,0,0,0,0,0,0,0,0,0,0,0,0,17,5,12,0,0,0,0,0,0,0,0,0
107600,10000,100,0,1,26,10,16,0,0,0,1,0,1,23,9,14,1,0,1,0,0,0,1,1,0,0,0,0,0,0,0,0,0,0
107619,10000,100,0,1,19,6,13,0,0,0,0,0,0,8,3,5,0,0,0,0,0,0,11,3,8,0,0,0,0,0,0,0,0,0
107637,10000,100,0,1,25,8,17,0,0,0,0,0,0,16,7,9,1,1,0,0,0,0,7,0,7,1,0,1,0,0,0,0,0,0
107664,10000,100,0,1,35,18,17,0,0,0,0,0,0,13,5,8,0,0,0,0,0,0,19,10,9,0,0,0,3,3,0,0,0,0
107725,10000,100,0,1,21,6,15,0,0,0,0,0,0,3,1,2,1,1,0,0,0,0,17,4,13,0,0,0,0,0,0,0,0,0
107743,10000,100,0,1,9,3,6,0,0,0,0,0,0,0,0,0,0,0,0,0,0,0,9,3,6,0,0,0,0,0,0,0,0,0
107840,10000,100,0,1,23,9,14,0,0,0,0,0,0,21,9,12,0,0,0,0,0,0,2,0,2,0,0,0,0,0,0,0,0,0
107877,10000,100,0,1,14,3,11,0,0,0,0,0,0,0,0,0,1,0,1,0,0,0,13,3,10,0,0,0,0,0,0,0,0,0
107974,10000,100,0,1,28,9,19,0,0,0,0,0,0,11,4,7,0,0,0,0,0,0,17,5,12,0,0,0,0,0,0,0,0,0
107983,10000,100,0,1,60,36,24,0,0,0,2,2,0,12,8,4,1,1,0,0,0,0,44,25,19,0,0,0,1,0,1,0,0,0
107992,10000,100,0,1,21,9,12,0,0,0,0,0,0,6,2,4,0,0,0,0,0,0,15,7,8,0,0,0,0,0,0,0,0,0
108056,10000,100,0,1,13,5,8,1,0,1,2,0,2,1,1,0,0,0,0,0,0,0,7,3,4,0,0,0,2,1,1,0,0,0
108092,10000,100,0,1,37,16,21,2,1,1,3,3,0,1,0,1,1,0,1,0,0,0,28,10,18,0,0,0,0,0,0,2,2,0
108232,10000,100,0,1,64,31,33,0,0,0,12,6,6,10,4,6,12,6,6,0,0,0,23,9,14,5,4,1,2,2,0,0,0,0
108667,10000,100,0,1,2,2,0,0,0,0,0,0,0,2,2,0,0,0,0,0,0,0,0,0,0,0,0,0,0,0,0,0,0,0
108807,10000,100,0,1,5,3,2,0,0,0,0,0,0,0,0,0,3,2,1,0,0,0,1,0,1,0,0,0,1,1,0,0,0,0
108852,10000,100,0,1,4,3,1,0,0,0,0,0,0,1,1,0,1,1,0,0,0,0,2,1,1,0,0,0,0,0,0,0,0,0
108870,10000,100,0,1,23,11,12,0,0,0,1,1,0,5,0,5,7,5,2,0,0,0,9,4,5,1,1,0,0,0,0,0,0,0
109040,10000,100,0,1,24,7,17,0,0,0,2,1,1,3,1,2,12,1,11,0,0,0,6,3,3,0,0,0,1,1,0,0,0,0
109086,10000,100,0,1,5,2,3,0,0,0,3,1,2,0,0,0,0,0,0,0,0,0,1,1,0,1,0,1,0,0,0,0,0,0
109208,10000,100,0,1,18,7,11,0,0,0,2,1,1,4,2,2,7,2,5,0,0,0,3,1,2,0,0,0,1,0,1,1,1,0
109350,10000,100,0,1,20,9,11,0,0,0,1,1,0,1,0,1,3,3,0,0,0,0,9,3,6,5,2,3,1,0,1,0,0,0
109651,10000,100,0,1,37,13,24,0,0,0,13,5,8,1,0,1,6,2,4,0,0,0,8,4,4,1,0,1,7,2,5,1,0,1
109785,10000,100,0,1,58,23,35,1,0,1,12,4,8,7,3,4,16,8,8,0,0,0,13,3,10,2,1,1,7,4,3,0,0,0
109819,10000,100,0,1,38,15,23,0,0,0,3,1,2,3,0,3,16,5,11,0,0,0,14,7,7,1,1,0,0,0,0,1,1,0
109907,10000,100,0,1,5,3,2,0,0,0,0,0,0,2,1,1,2,1,1,0,0,0,1,1,0,0,0,0,0,0,0,0,0,0
110097,10000,100,0,1,89,40,49,0,0,0,18,10,8,3,1,2,22,8,14,0,0,0,35,16,19,0,0,0,5,2,3,6,3,3
110219,10000,100,0,1,73,25,48,1,0,1,0,0,0,19,6,13,12,5,7,1,0,1,39,13,26,1,1,0,0,0,0,0,0,0
110246,10000,100,0,1,24,11,13,1,0,1,3,1,2,3,1,2,3,1,2,0,0,0,11,6,5,1,0,1,2,2,0,0,0,0
110316,10000,100,0,1,19,4,15,0,0,0,4,1,3,4,1,3,2,0,2,0,0,0,8,2,6,0,0,0,1,0,1,0,0,0
110334,10000,100,0,1,5,2,3,0,0,0,0,0,0,0,0,0,3,1,2,0,0,0,2,1,1,0,0,0,0,0,0,0,0,0
110361,10000,100,0,1,118,51,67,0,0,0,7,4,3,12,5,7,41,15,26,1,0,1,55,26,29,2,1,1,0,0,0,0,0,0
110370,10000,100,0,1,64,26,38,1,0,1,11,6,5,6,3,3,21,10,11,0,0,0,19,6,13,2,0,2,0,0,0,4,1,3
110398,10000,100,0,1,37,14,23,0,0,0,9,3,6,2,0,2,5,3,2,0,0,0,15,6,9,3,2,1,3,0,3,0,0,0
110404,10000,100,0,1,423,258,165,0,0,0,50,23,27,9,3,6,58,30,28,2,0,2,117,70,47,11,3,8,15,10,5,161,119,42
110413,10000,100,0,1,79,24,55,0,0,0,7,2,5,4,1,3,32,9,23,0,0,0,29,9,20,5,2,3,2,1,1,0,0,0
110422,10000,100,0,1,167,84,83,0,0,0,15,8,7,5,3,2,40,16,24,0,0,0,72,41,31,3,2,1,16,5,11,16,9,7
110468,10000,100,0,1,36,10,26,0,0,0,5,1,4,5,1,4,9,1,8,1,0,1,16,7,9,0,0,0,0,0,0,0,0,0
110486,10000,100,0,1,60,23,37,0,0,0,3,1,2,2,0,2,19,6,13,0,0,0,26,11,15,4,2,2,5,3,2,1,0,1
110495,10000,100,0,1,76,27,49,2,2,0,6,0,6,3,2,1,28,13,15,0,0,0,31,9,22,2,0,2,1,1,0,3,0,3
110501,10000,100,0,1,56,29,27,0,0,0,15,9,6,7,2,5,12,6,6,0,0,0,19,11,8,1,0,1,2,1,1,0,0,0
110510,10000,100,0,1,87,37,50,0,0,0,8,2,6,12,4,8,30,15,15,0,0,0,31,15,16,2,0,2,4,1,3,0,0,0
110529,10000,100,0,1,76,24,52,0,0,0,9,4,5,10,4,6,38,11,27,0,0,0,16,4,12,1,0,1,1,1,0,1,0,1
110538,10000,100,0,1,95,50,45,1,0,1,5,5,0,5,2,3,21,9,12,0,0,0,46,26,20,4,0,4,8,3,5,5,5,0
110547,10000,100,0,1,66,27,39,0,0,0,8,4,4,14,6,8,23,10,13,0,0,0,15,5,10,3,2,1,1,0,1,2,0,2
110556,10000,100,0,1,71,26,45,0,0,0,9,5,4,5,2,3,25,10,15,0,0,0,24,7,17,0,0,0,5,1,4,3,1,2
110565,10000,100,0,1,176,74,102,0,0,0,31,13,18,18,7,11,40,13,27,0,0,0,74,34,40,3,1,2,1,1,0,9,5,4
110574,10000,100,0,1,64,22,42,1,0,1,15,7,8,7,3,4,9,3,6,1,0,1,11,3,8,1,0,1,14,5,9,5,1,4
110583,10000,100,0,1,206,83,123,3,1,2,24,6,18,23,9,14,63,29,34,0,0,0,65,28,37,6,1,5,12,4,8,10,5,5
110592,10000,100,0,1,87,30,57,0,0,0,14,10,4,20,5,15,35,10,25,0,0,0,6,1,5,0,0,0,9,4,5,3,0,3
110608,10000,100,0,1,154,72,82,0,0,0,13,6,7,13,8,5,51,25,26,0,0,0,46,14,32,5,2,3,18,10,8,8,7,1
110617,10000,100,0,1,134,61,73,2,0,2,21,10,11,18,12,6,24,7,17,1,1,0,42,20,22,5,3,2,18,6,12,3,2,1
110635,10000,100,0,1,1524,709,815,4,3,1,200,84,116,97,40,57,190,81,109,1,1,0,461,200,261,61,24,37,97,39,58,413,237,176
110644,10000,100,0,1,1779,733,1046,6,4,2,246,93,153,64,23,41,309,117,192,5,1,4,665,256,409,59,22,37,94,41,53,331,176,155
110653,10000,100,0,1,1010,429,581,2,0,2,192,79,113,32,13,19,204,63,141,3,2,1,293,117,176,28,9,19,46,23,23,210,123,87
110662,10000,100,0,1,3397,1283,2114,7,3,4,556,217,339,231,62,169,996,293,703,10,3,7,766,321,445,89,29,60,173,69,104,569,286,283
110671,10000,100,0,1,502,251,251,1,0,1,61,35,26,19,10,9,138,49,89,2,2,0,138,64,74,8,6,2,17,12,5,118,73,45
110680,10000,100,0,1,2438,981,1457,6,2,4,417,136,281,81,24,57,471,171,300,6,3,3,811,319,492,63,18,45,84,33,51,499,275,224
110699,10000,100,0,1,2029,771,1258,2,1,1,508,186,322,106,37,69,287,109,178,5,1,4,565,213,352,79,28,51,93,37,56,384,159,225
110705,10000,100,0,1,493,245,248,0,0,0,27,10,17,18,5,13,85,41,44,0,0,0,174,84,90,13,5,8,32,13,19,144,87,57
110714,10000,100,0,1,420,192,228,0,0,0,45,17,28,12,8,4,67,24,43,1,1,0,181,83,98,22,7,15,28,18,10,64,34,30
110778,10000,100,0,1,6,0,6,0,0,0,4,0,4,0,0,0,0,0,0,0,0,0,2,0,2,0,0,0,0,0,0,0,0,0
111081,10000,100,0,1,60,22,38,0,0,0,8,2,6,7,3,4,14,6,8,0,0,0,27,10,17,0,0,0,0,0,0,4,1,3
111188,10000,100,0,1,26,13,13,0,0,0,5,2,3,3,1,2,2,0,2,0,0,0,13,8,5,1,0,1,2,2,0,0,0,0
111391,10000,100,0,1,23,7,16,0,0,0,2,0,2,4,1,3,6,3,3,0,0,0,11,3,8,0,0,0,0,0,0,0,0,0
111434,10000,100,0,1,10,6,4,0,0,0,0,0,0,1,1,0,8,4,4,0,0,0,0,0,0,0,0,0,1,1,0,0,0,0
111461,10000,100,0,1,37,13,24,0,0,0,1,0,1,5,3,2,13,5,8,0,0,0,18,5,13,0,0,0,0,0,0,0,0,0
111638,10000,100,0,1,3,2,1,0,0,0,0,0,0,1,1,0,2,1,1,0,0,0,0,0,0,0,0,0,0,0,0,0,0,0
111887,10000,100,0,1,8,4,4,0,0,0,1,1,0,0,0,0,4,1,3,0,0,0,3,2,1,0,0,0,0,0,0,0,0,0
111896,10000,100,0,1,5,3,2,0,0,0,0,0,0,0,0,0,1,1,0,0,0,0,3,1,2,0,0,0,1,1,0,0,0,0
111920,10000,100,0,1,9,3,6,0,0,0,1,0,1,0,0,0,3,1,2,0,0,0,4,2,2,1,0,1,0,0,0,0,0,0
111939,10000,100,0,1,19,8,11,0,0,0,2,1,1,1,0,1,6,2,4,0,0,0,10,5,5,0,0,0,0,0,0,0,0,0
111948,10000,100,0,1,132,55,77,0,0,0,9,2,7,2,1,1,24,6,18,0,0,0,25,13,12,2,0,2,54,24,30,16,9,7
111966,10000,100,0,1,74,30,44,0,0,0,6,2,4,15,5,10,18,8,10,0,0,0,5,2,3,0,0,0,30,13,17,0,0,0
112075,10000,100,0,1,35,10,25,0,0,0,1,0,1,1,0,1,4,1,3,0,0,0,10,4,6,0,0,0,19,5,14,0,0,0
112084,10000,100,0,1,3,2,1,0,0,0,0,0,0,0,0,0,2,1,1,0,0,0,1,1,0,0,0,0,0,0,0,0,0,0
112127,10000,100,0,1,2,0,2,0,0,0,1,0,1,0,0,0,1,0,1,0,0,0,0,0,0,0,0,0,0,0,0,0,0,0
112172,10000,100,0,1,11,4,7,0,0,0,0,0,0,0,0,0,4,1,3,0,0,0,7,3,4,0,0,0,0,0,0,0,0,0
112190,10000,100,0,1,1,1,0,0,0,0,0,0,0,0,0,0,0,0,0,0,0,0,1,1,0,0,0,0,0,0,0,0,0,0
112251,10000,100,0,1,27,9,18,0,0,0,3,0,3,2,1,1,8,2,6,0,0,0,10,3,7,0,0,0,4,3,1,0,0,0
112260,10000,100,0,1,50,23,27,1,1,0,7,3,4,10,6,4,11,5,6,1,0,1,14,7,7,0,0,0,2,1,1,4,0,4
112376,10000,100,0,1,1,0,1,0,0,0,0,0,0,0,0,0,1,0,1,0,0,0,0,0,0,0,0,0,0,0,0,0,0,0
112394,10000,100,0,1,16,8,8,0,0,0,0,0,0,1,0,1,7,3,4,0,0,0,7,4,3,1,1,0,0,0,0,0,0,0
112525,10000,100,0,1,116,43,73,0,0,0,30,13,17,5,1,4,40,14,26,0,0,0,30,9,21,2,1,1,4,3,1,5,2,3
112561,10000,100,0,1,47,19,28,0,0,0,0,0,0,1,0,1,4,1,3,0,0,0,39,16,23,2,1,1,1,1,0,0,0,0
112570,10000,100,0,1,9,5,4,0,0,0,0,0,0,3,2,1,2,0,2,0,0,0,4,3,1,0,0,0,0,0,0,0,0,0
112686,10000,100,0,1,26,12,14,0,0,0,2,1,1,13,5,8,8,5,3,0,0,0,2,1,1,0,0,0,1,0,1,0,0,0
112817,10000,100,0,1,5,2,3,0,0,0,0,0,0,2,0,2,2,1,1,0,0,0,1,1,0,0,0,0,0,0,0,0,0,0
112826,10000,100,0,1,15,4,11,0,0,0,0,0,0,4,0,4,4,1,3,0,0,0,5,3,2,1,0,1,1,0,1,0,0,0
113096,10000,100,0,1,10,4,6,0,0,0,4,1,3,2,0,2,0,0,0,0,0,0,2,1,1,2,2,0,0,0,0,0,0,0
113111,10000,100,0,1,4,2,2,0,0,0,1,0,1,0,0,0,1,0,1,0,0,0,1,1,0,0,0,0,1,1,0,0,0,0
113193,10000,100,0,1,11,3,8,0,0,0,0,0,0,0,0,0,4,2,2,0,0,0,6,1,5,0,0,0,0,0,0,1,0,1
113218,10000,100,0,1,2,0,2,0,0,0,0,0,0,0,0,0,1,0,1,0,0,0,1,0,1,0,0,0,0,0,0,0,0,0
113236,10000,100,0,1,4,2,2,0,0,0,0,0,0,2,1,1,0,0,0,0,0,0,1,1,0,0,0,0,1,0,1,0,0,0
113333,10000,100,0,1,7,3,4,0,0,0,2,0,2,0,0,0,1,1,0,0,0,0,3,2,1,0,0,0,0,0,0,1,0,1
113573,10000,100,0,1,52,16,36,0,0,0,0,0,0,5,0,5,28,11,17,0,0,0,11,3,8,1,0,1,2,0,2,5,2,3
113582,10000,100,0,1,3,0,3,0,0,0,0,0,0,0,0,0,0,0,0,0,0,0,3,0,3,0,0,0,0,0,0,0,0,0
113634,10000,100,0,1,13,2,11,0,0,0,2,0,2,3,1,2,3,1,2,0,0,0,5,0,5,0,0,0,0,0,0,0,0,0
113698,10000,100,0,1,40,19,21,0,0,0,3,2,1,1,0,1,7,4,3,1,0,1,20,10,10,1,0,1,6,3,3,1,0,1
113704,10000,100,0,1,2,0,2,0,0,0,0,0,0,0,0,0,0,0,0,0,0,0,2,0,2,0,0,0,0,0,0,0,0,0
113856,10000,100,0,1,81,49,32,1,0,1,5,3,2,4,1,3,14,11,3,0,0,0,12,6,6,0,0,0,43,27,16,2,1,1
113980,10000,100,0,1,43,24,19,0,0,0,6,2,4,11,5,6,16,13,3,0,0,0,7,3,4,2,0,2,1,1,0,0,0,0
114266,10000,100,0,1,24,11,13,0,0,0,6,2,4,1,1,0,10,4,6,0,0,0,4,3,1,0,0,0,3,1,2,0,0,0
114354,10000,100,0,1,8,3,5,0,0,0,2,0,2,0,0,0,1,1,0,0,0,0,4,2,2,0,0,0,1,0,1,0,0,0
114433,10000,100,0,1,14,6,8,0,0,0,0,0,0,0,0,0,2,1,1,0,0,0,12,5,7,0,0,0,0,0,0,0,0,0
114549,10000,100,0,1,16,8,8,0,0,0,0,0,0,2,2,0,2,0,2,0,0,0,10,5,5,2,1,1,0,0,0,0,0,0
114585,10000,100,0,1,2,0,2,0,0,0,0,0,0,0,0,0,1,0,1,0,0,0,1,0,1,0,0,0,0,0,0,0,0,0
114716,10000,100,0,1,10,5,5,0,0,0,1,0,1,2,2,0,3,1,2,0,0,0,4,2,2,0,0,0,0,0,0,0,0,0
114789,10000,100,0,1,21,9,12,1,1,0,1,0,1,1,0,1,8,4,4,0,0,0,9,4,5,1,0,1,0,0,0,0,0,0
114813,10000,100,0,1,48,18,30,2,1,1,6,2,4,3,1,2,20,7,13,0,0,0,17,7,10,0,0,0,0,0,0,0,0,0
114831,10000,100,0,1,2,2,0,0,0,0,1,1,0,0,0,0,0,0,0,0,0,0,1,1,0,0,0,0,0,0,0,0,0,0
114840,10000,100,0,1,21,6,15,0,0,0,5,2,3,7,1,6,2,0,2,0,0,0,7,3,4,0,0,0,0,0,0,0,0,0
114859,10000,100,0,1,2,0,2,0,0,0,0,0,0,1,0,1,1,0,1,0,0,0,0,0,0,0,0,0,0,0,0,0,0,0
114938,10000,100,0,1,4,2,2,0,0,0,0,0,0,1,1,0,3,1,2,0,0,0,0,0,0,0,0,0,0,0,0,0,0,0
115001,10000,100,0,1,8,5,3,0,0,0,1,1,0,0,0,0,3,1,2,0,0,0,3,2,1,0,0,0,1,1,0,0,0,0
115010,10000,100,0,1,30,5,25,0,0,0,4,1,3,1,1,0,7,1,6,1,0,1,3,0,3,4,0,4,10,2,8,0,0,0
115083,10000,100,0,1,27,13,14,0,0,0,3,1,2,3,1,2,5,5,0,0,0,0,15,6,9,1,0,1,0,0,0,0,0,0
115126,10000,100,0,1,3,1,2,0,0,0,1,0,1,0,0,0,0,0,0,0,0,0,2,1,1,0,0,0,0,0,0,0,0,0
115214,10000,100,0,1,8,2,6,0,0,0,1,0,1,0,0,0,1,0,1,0,0,0,4,2,2,2,0,2,0,0,0,0,0,0
115287,10000,100,0,1,3,0,3,0,0,0,0,0,0,0,0,0,0,0,0,0,0,0,3,0,3,0,0,0,0,0,0,0,0,0
115296,10000,100,0,1,7,4,3,1,1,0,0,0,0,1,0,1,1,1,0,0,0,0,2,1,1,0,0,0,2,1,1,0,0,0
115393,10000,100,0,1,19,9,10,0,0,0,0,0,0,0,0,0,10,4,6,0,0,0,6,3,3,0,0,0,3,2,1,0,0,0
115409,10000,100,0,1,36,10,26,2,0,2,8,2,6,0,0,0,8,4,4,0,0,0,16,4,12,0,0,0,2,0,2,0,0,0
115728,10000,100,0,1,26,11,15,0,0,0,5,3,2,5,0,5,4,2,2,0,0,0,10,5,5,1,1,0,1,0,1,0,0,0
115746,10000,100,0,1,16,4,12,0,0,0,0,0,0,0,0,0,4,1,3,0,0,0,11,3,8,1,0,1,0,0,0,0,0,0
115755,10000,100,0,1,64,31,33,0,0,0,2,2,0,3,1,2,8,4,4,0,0,0,45,20,25,1,0,1,5,4,1,0,0,0
115861,10000,100,0,1,128,67,61,0,0,0,9,6,3,5,3,2,60,27,33,0,0,0,51,28,23,2,2,0,1,1,0,0,0,0
115931,10000,100,0,1,25,11,14,0,0,0,2,1,1,6,3,3,10,3,7,0,0,0,7,4,3,0,0,0,0,0,0,0,0,0
116439,10000,100,0,1,18,7,11,0,0,0,3,0,3,0,0,0,4,2,2,0,0,0,8,3,5,0,0,0,1,0,1,2,2,0
116846,10000,100,0,1,5,1,4,0,0,0,0,0,0,0,0,0,1,0,1,0,0,0,4,1,3,0,0,0,0,0,0,0,0,0
117052,10000,100,0,1,4,1,3,0,0,0,0,0,0,0,0,0,2,0,2,0,0,0,1,1,0,0,0,0,1,0,1,0,0,0
117104,10000,100,0,1,9,3,6,0,0,0,0,0,0,0,0,0,2,1,1,0,0,0,7,2,5,0,0,0,0,0,0,0,0,0
117140,10000,100,0,1,37,17,20,0,0,0,0,0,0,4,3,1,11,3,8,0,0,0,7,4,3,1,0,1,14,7,7,0,0,0
117168,10000,100,0,1,14,5,9,0,0,0,3,0,3,0,0,0,2,1,1,0,0,0,8,4,4,0,0,0,1,0,1,0,0,0
117195,10000,100,0,1,16,6,10,0,0,0,0,0,0,0,0,0,4,2,2,0,0,0,12,4,8,0,0,0,0,0,0,0,0,0
117247,10000,100,0,1,21,6,15,0,0,0,7,0,7,2,1,1,5,3,2,0,0,0,1,0,1,0,0,0,6,2,4,0,0,0
117274,10000,100,0,1,12,5,7,1,0,1,0,0,0,0,0,0,0,0,0,1,1,0,8,3,5,1,0,1,1,1,0,0,0,0
117520,10000,100,0,1,8,1,7,0,0,0,2,0,2,3,1,2,2,0,2,0,0,0,1,0,1,0,0,0,0,0,0,0,0,0
117557,10000,100,0,1,8,8,0,0,0,0,1,1,0,6,6,0,0,0,0,0,0,0,1,1,0,0,0,0,0,0,0,0,0,0
117627,10000,100,0,1,25,8,17,0,0,0,4,1,3,1,0,1,10,3,7,3,2,1,3,0,3,0,0,0,0,0,0,4,2,2
117636,10000,100,0,1,103,26,77,0,0,0,15,5,10,6,1,5,40,6,34,0,0,0,33,12,21,6,2,4,0,0,0,3,0,3
117645,10000,100,0,1,27,10,17,1,1,0,2,1,1,6,2,4,13,5,8,0,0,0,5,1,4,0,0,0,0,0,0,0,0,0
117672,10000,100,0,1,39,11,28,0,0,0,4,1,3,3,1,2,11,5,6,0,0,0,20,4,16,1,0,1,0,0,0,0,0,0
117681,10000,100,0,1,49,29,20,0,0,0,6,5,1,6,1,5,6,4,2,0,0,0,3,2,1,0,0,0,27,17,10,1,0,1
117690,10000,100,0,1,30,18,12,0,0,0,3,1,2,6,4,2,3,1,2,0,0,0,4,3,1,0,0,0,14,9,5,0,0,0
117706,10000,100,0,1,75,38,37,0,0,0,9,7,2,7,4,3,14,7,7,0,0,0,35,12,23,2,1,1,7,6,1,1,1,0
117715,10000,100,0,1,25,15,10,1,1,0,3,1,2,1,1,0,3,1,2,0,0,0,1,1,0,0,0,0,16,10,6,0,0,0
117724,10000,100,0,1,55,36,19,0,0,0,5,2,3,11,8,3,8,5,3,0,0,0,10,6,4,0,0,0,21,15,6,0,0,0
117733,10000,100,0,1,60,34,26,0,0,0,4,2,2,8,6,2,17,13,4,0,0,0,23,9,14,2,1,1,5,3,2,1,0,1
117751,10000,100,0,1,17,11,6,0,0,0,0,0,0,2,1,1,2,2,0,0,0,0,12,7,5,1,1,0,0,0,0,0,0,0
117788,10000,100,0,1,50,37,13,0,0,0,6,6,0,3,2,1,4,4,0,0,0,0,5,2,3,1,1,0,31,22,9,0,0,0
117803,10000,100,0,1,1,1,0,0,0,0,0,0,0,0,0,0,0,0,0,0,0,0,1,1,0,0,0,0,0,0,0,0,0,0
117867,10000,100,0,1,26,15,11,0,0,0,3,1,2,1,0,1,8,6,2,1,1,0,12,6,6,0,0,0,1,1,0,0,0,0
117894,10000,100,0,1,10,5,5,0,0,0,2,1,1,2,1,1,0,0,0,0,0,0,5,2,3,1,1,0,0,0,0,0,0,0
117900,10000,100,0,1,19,13,6,0,0,0,7,5,2,2,1,1,6,4,2,0,0,0,3,3,0,0,0,0,0,0,0,1,0,1
117946,10000,100,0,1,178,72,106,1,1,0,14,3,11,33,14,19,34,13,21,1,0,1,46,20,26,4,2,2,45,19,26,0,0,0
118198,10000,100,0,1,3,1,2,0,0,0,0,0,0,1,0,1,0,0,0,0,0,0,2,1,1,0,0,0,0,0,0,0,0,0
118347,10000,100,0,1,5,3,2,0,0,0,0,0,0,0,0,0,0,0,0,0,0,0,1,1,0,0,0,0,4,2,2,0,0,0
118541,10000,100,0,1,11,6,5,1,0,1,0,0,0,0,0,0,4,1,3,0,0,0,5,4,1,1,1,0,0,0,0,0,0,0
118684,10000,100,0,1,13,5,8,0,0,0,1,0,1,0,0,0,7,4,3,0,0,0,4,1,3,0,0,0,1,0,1,0,0,0
118693,10000,100,0,1,30,15,15,0,0,0,8,2,6,1,0,1,7,5,2,0,0,0,13,8,5,0,0,0,1,0,1,0,0,0
118718,10000,100,0,1,18,9,9,0,0,0,2,0,2,1,1,0,8,3,5,0,0,0,3,1,2,0,0,0,3,3,0,1,1,0
118888,10000,100,0,1,39,9,30,0,0,0,7,1,6,8,2,6,6,0,6,0,0,0,12,4,8,4,1,3,2,1,1,0,0,0
118912,10000,100,0,1,10,7,3,0,0,0,2,2,0,2,2,0,2,2,0,0,0,0,3,1,2,0,0,0,0,0,0,1,0,1
118930,10000,100,0,1,4,2,2,0,0,0,0,0,0,0,0,0,1,1,0,0,0,0,1,1,0,0,0,0,2,0,2,0,0,0
118976,10000,100,0,1,163,67,96,1,1,0,8,2,6,6,1,5,54,22,32,1,1,0,88,38,50,3,0,3,1,1,0,1,1,0
119058,10000,100,0,1,10,5,5,0,0,0,1,0,1,0,0,0,0,0,0,0,0,0,5,3,2,1,0,1,3,2,1,0,0,0
119067,10000,100,0,1,16,6,10,0,0,0,2,0,2,2,1,1,9,2,7,0,0,0,0,0,0,3,3,0,0,0,0,0,0,0
119137,10000,100,0,1,25,9,16,0,0,0,3,2,1,0,0,0,6,1,5,0,0,0,10,2,8,0,0,0,1,1,0,5,3,2
119164,10000,100,0,1,91,39,52,2,0,2,13,6,7,5,3,2,32,9,23,0,0,0,20,11,9,0,0,0,19,10,9,0,0,0
119173,10000,100,0,1,49,6,43,3,0,3,6,0,6,3,0,3,19,3,16,0,0,0,16,3,13,1,0,1,1,0,1,0,0,0
119216,10000,100,0,1,38,19,19,2,1,1,3,1,2,3,1,2,15,8,7,0,0,0,15,8,7,0,0,0,0,0,0,0,0,0
119270,10000,100,0,1,2,0,2,0,0,0,0,0,0,0,0,0,0,0,0,2,0,2,0,0,0,0,0,0,0,0,0,0,0,0
119331,10000,100,0,1,16,5,11,0,0,0,0,0,0,1,0,1,3,1,2,0,0,0,10,3,7,0,0,0,2,1,1,0,0,0
119605,10000,100,0,1,66,25,41,0,0,0,6,3,3,2,2,0,8,1,7,0,0,0,41,17,24,2,0,2,7,2,5,0,0,0
119678,10000,100,0,1,87,52,35,1,1,0,10,7,3,10,6,4,13,8,5,1,1,0,48,25,23,2,2,0,2,2,0,0,0,0
119775,10000,100,0,1,9,4,5,0,0,0,0,0,0,1,1,0,5,1,4,0,0,0,3,2,1,0,0,0,0,0,0,0,0,0
120078,10000,100,0,1,32,3,29,0,0,0,3,1,2,2,0,2,14,0,14,0,0,0,2,2,0,1,0,1,10,0,10,0,0,0
120166,10000,100,0,1,3,3,0,0,0,0,2,2,0,0,0,0,0,0,0,0,0,0,1,1,0,0,0,0,0,0,0,0,0,0
120184,10000,100,0,1,5,4,1,0,0,0,0,0,0,0,0,0,2,2,0,0,0,0,3,2,1,0,0,0,0,0,0,0,0,0
120254,10000,100,0,1,85,33,52,0,0,0,5,3,2,4,1,3,30,10,20,0,0,0,25,12,13,1,0,1,12,5,7,8,2,6
120290,10000,100,0,1,30,7,23,0,0,0,7,1,6,3,1,2,9,1,8,0,0,0,7,3,4,0,0,0,4,1,3,0,0,0
120342,10000,100,0,1,5,2,3,0,0,0,0,0,0,0,0,0,1,1,0,0,0,0,4,1,3,0,0,0,0,0,0,0,0,0
120403,10000,100,0,1,46,18,28,0,0,0,9,3,6,6,3,3,9,4,5,0,0,0,15,3,12,4,4,0,3,1,2,0,0,0
120421,10000,100,0,1,25,9,16,0,0,0,2,1,1,0,0,0,10,2,8,0,0,0,7,3,4,0,0,0,3,2,1,3,1,2
120537,10000,100,0,1,13,3,10,0,0,0,1,1,0,1,0,1,3,0,3,0,0,0,5,2,3,0,0,0,3,0,3,0,0,0
120661,10000,100,0,1,16,3,13,2,0,2,2,0,2,1,1,0,5,1,4,0,0,0,4,1,3,1,0,1,1,0,1,0,0,0
120698,10000,100,0,1,14,5,9,0,0,0,4,2,2,0,0,0,2,1,1,0,0,0,7,2,5,1,0,1,0,0,0,0,0,0
120795,10000,100,0,1,5,3,2,0,0,0,0,0,0,1,1,0,1,1,0,0,0,0,3,1,2,0,0,0,0,0,0,0,0,0
120865,10000,100,0,1,22,10,12,0,0,0,1,0,1,1,0,1,5,3,2,0,0,0,11,5,6,1,0,1,3,2,1,0,0,0
120883,10000,100,0,1,172,71,101,0,0,0,25,8,17,16,3,13,42,12,30,0,0,0,73,39,34,12,6,6,2,1,1,2,2,0
120953,10000,100,0,1,14,7,7,0,0,0,1,1,0,0,0,0,6,2,4,0,0,0,7,4,3,0,0,0,0,0,0,0,0,0
120971,10000,100,0,1,10,3,7,1,1,0,0,0,0,0,0,0,4,0,4,1,0,1,3,2,1,0,0,0,1,0,1,0,0,0
121044,10000,100,0,1,25,9,16,1,0,1,3,1,2,1,1,0,3,1,2,0,0,0,11,6,5,2,0,2,3,0,3,1,0,1
121150,10000,100,0,1,188,74,114,0,0,0,22,10,12,16,5,11,35,19,16,0,0,0,103,35,68,6,3,3,4,0,4,2,2,0
121178,10000,100,0,1,4,1,3,0,0,0,1,0,1,1,1,0,1,0,1,0,0,0,1,0,1,0,0,0,0,0,0,0,0,0
121257,10000,100,0,1,40,16,24,0,0,0,3,2,1,1,0,1,24,10,14,0,0,0,6,2,4,1,0,1,5,2,3,0,0,0
121309,10000,100,0,1,71,20,51,0,0,0,4,1,3,2,1,1,21,6,15,1,1,0,41,10,31,2,1,1,0,0,0,0,0,0
121345,10000,100,0,1,110,47,63,0,0,0,10,6,4,11,5,6,46,21,25,0,0,0,24,8,16,0,0,0,19,7,12,0,0,0
121363,10000,100,0,1,6,2,4,0,0,0,0,0,0,1,0,1,2,1,1,0,0,0,3,1,2,0,0,0,0,0,0,0,0,0
121619,10000,100,0,1,8,3,5,0,0,0,1,0,1,1,1,0,2,1,1,0,0,0,1,1,0,0,0,0,3,0,3,0,0,0
121691,10000,100,0,1,74,33,41,0,0,0,8,3,5,3,2,1,18,5,13,0,0,0,32,18,14,2,1,1,11,4,7,0,0,0
121707,10000,100,0,1,24,11,13,0,0,0,1,0,1,0,0,0,1,1,0,0,0,0,21,10,11,1,0,1,0,0,0,0,0,0
121886,10000,100,0,1,15,4,11,0,0,0,4,0,4,0,0,0,7,2,5,0,0,0,1,1,0,0,0,0,1,0,1,2,1,1
121901,10000,100,0,1,18,7,11,0,0,0,1,0,1,3,1,2,8,4,4,0,0,0,6,2,4,0,0,0,0,0,0,0,0,0
122180,10000,100,0,1,10,5,5,0,0,0,0,0,0,3,2,1,2,0,2,0,0,0,2,1,1,1,1,0,2,1,1,0,0,0
122205,10000,100,0,1,20,12,8,0,0,0,3,2,1,0,0,0,4,3,1,0,0,0,10,5,5,0,0,0,1,1,0,2,1,1
122296,10000,100,0,1,35,9,26,0,0,0,6,3,3,1,0,1,4,2,2,0,0,0,5,1,4,0,0,0,19,3,16,0,0,0
122320,10000,100,0,1,2,1,1,0,0,0,1,0,1,0,0,0,1,1,0,0,0,0,0,0,0,0,0,0,0,0,0,0,0,0
122375,10000,100,0,1,1,0,1,0,0,0,1,0,1,0,0,0,0,0,0,0,0,0,0,0,0,0,0,0,0,0,0,0,0,0
122384,10000,100,0,1,1,0,1,0,0,0,0,0,0,0,0,0,1,0,1,0,0,0,0,0,0,0,0,0,0,0,0,0,0,0
122409,10000,100,0,1,334,150,184,5,2,3,33,13,20,27,15,12,109,47,62,1,0,1,109,44,65,10,2,8,27,18,9,13,9,4
122436,10000,100,0,1,124,52,72,0,0,0,11,7,4,14,2,12,35,16,19,1,1,0,53,22,31,4,1,3,4,3,1,2,0,2
122454,10000,100,0,1,2,0,2,0,0,0,0,0,0,1,0,1,0,0,0,0,0,0,1,0,1,0,0,0,0,0,0,0,0,0
122506,10000,100,0,1,20,10,10,0,0,0,1,1,0,0,0,0,2,2,0,0,0,0,15,6,9,2,1,1,0,0,0,0,0,0
122597,10000,100,0,1,119,45,74,0,0,0,25,10,15,12,2,10,27,8,19,0,0,0,44,20,24,1,0,1,7,3,4,3,2,1
122612,10000,100,0,1,181,77,104,1,0,1,26,11,15,24,8,16,43,17,26,2,2,0,61,27,34,17,8,9,4,3,1,3,1,2
122649,10000,100,0,1,1,1,0,0,0,0,0,0,0,0,0,0,0,0,0,0,0,0,1,1,0,0,0,0,0,0,0,0,0,0
122685,10000,100,0,1,41,12,29,0,0,0,3,1,2,7,4,3,13,4,9,0,0,0,16,3,13,1,0,1,1,0,1,0,0,0
122694,10000,100,0,1,12,3,9,0,0,0,1,0,1,1,1,0,5,2,3,0,0,0,4,0,4,1,0,1,0,0,0,0,0,0
122728,10000,100,0,1,33,18,15,0,0,0,2,1,1,4,3,1,2,2,0,1,1,0,18,8,10,4,1,3,2,2,0,0,0,0
122737,10000,100,0,1,5,2,3,0,0,0,1,0,1,0,0,0,3,1,2,0,0,0,0,0,0,0,0,0,1,1,0,0,0,0
122746,10000,100,0,1,19,11,8,0,0,0,2,1,1,4,2,2,8,6,2,0,0,0,1,0,1,0,0,0,4,2,2,0,0,0
122755,10000,100,0,1,223,106,117,1,1,0,49,18,31,21,10,11,40,16,24,1,1,0,70,35,35,10,7,3,16,9,7,15,9,6
122782,10000,100,0,1,21,13,8,0,0,0,6,2,4,3,2,1,4,2,2,0,0,0,5,4,1,0,0,0,1,1,0,2,2,0
122791,10000,100,0,1,13,2,11,0,0,0,4,1,3,3,1,2,4,0,4,0,0,0,2,0,2,0,0,0,0,0,0,0,0,0
122889,10000,100,0,1,8,4,4,0,0,0,1,1,0,0,0,0,2,1,1,0,0,0,5,2,3,0,0,0,0,0,0,0,0,0
122931,10000,100,0,1,164,70,94,1,1,0,37,13,24,14,6,8,14,5,9,1,0,1,70,35,35,5,2,3,10,3,7,12,5,7
122977,10000,100,0,1,9,1,8,0,0,0,1,0,1,2,0,2,1,0,1,0,0,0,4,1,3,0,0,0,1,0,1,0,0,0
123013,10000,100,0,1,18,8,10,0,0,0,0,0,0,3,3,0,6,3,3,0,0,0,8,1,7,0,0,0,1,1,0,0,0,0
123095,10000,100,0,1,49,18,31,0,0,0,6,2,4,9,2,7,6,4,2,0,0,0,22,8,14,2,2,0,4,0,4,0,0,0
123165,10000,100,0,1,29,9,20,0,0,0,3,0,3,3,1,2,19,6,13,0,0,0,4,2,2,0,0,0,0,0,0,0,0,0
123217,10000,100,0,1,16,7,9,0,0,0,0,0,0,0,0,0,10,3,7,0,0,0,4,2,2,1,1,0,0,0,0,1,1,0
123299,10000,100,0,1,11,5,6,0,0,0,0,0,0,0,0,0,0,0,0,0,0,0,9,3,6,1,1,0,1,1,0,0,0,0
123341,10000,100,0,1,18,8,10,0,0,0,0,0,0,0,0,0,5,2,3,0,0,0,8,3,5,0,0,0,4,2,2,1,1,0
123448,10000,100,0,1,3,0,3,0,0,0,0,0,0,0,0,0,0,0,0,0,0,0,3,0,3,0,0,0,0,0,0,0,0,0
123457,10000,100,0,1,34,14,20,0,0,0,1,1,0,2,2,0,3,3,0,0,0,0,27,7,20,0,0,0,1,1,0,0,0,0
123484,10000,100,0,1,18,8,10,0,0,0,0,0,0,2,1,1,2,1,1,0,0,0,13,6,7,0,0,0,1,0,1,0,0,0
123509,10000,100,0,1,18,7,11,0,0,0,7,2,5,5,3,2,2,0,2,0,0,0,2,1,1,0,0,0,1,0,1,1,1,0
123527,10000,100,0,1,14,8,6,0,0,0,0,0,0,5,2,3,7,5,2,0,0,0,2,1,1,0,0,0,0,0,0,0,0,0
123554,10000,100,0,1,53,29,24,1,1,0,5,3,2,6,2,4,7,2,5,0,0,0,11,8,3,3,2,1,20,11,9,0,0,0
123563,10000,100,0,1,16,5,11,0,0,0,2,0,2,4,1,3,3,2,1,0,0,0,5,1,4,2,1,1,0,0,0,0,0,0
123572,10000,100,0,1,41,13,28,0,0,0,2,2,0,3,0,3,8,3,5,0,0,0,19,4,15,1,0,1,6,3,3,2,1,1
123633,10000,100,0,1,3,2,1,0,0,0,0,0,0,0,0,0,0,0,0,0,0,0,3,2,1,0,0,0,0,0,0,0,0,0
123651,10000,100,0,1,22,8,14,0,0,0,1,0,1,0,0,0,4,1,3,0,0,0,16,7,9,1,0,1,0,0,0,0,0,0
123679,10000,100,0,1,16,2,14,0,0,0,4,0,4,1,0,1,4,1,3,0,0,0,5,0,5,1,0,1,1,1,0,0,0,0
123800,10000,100,0,1,50,21,29,0,0,0,6,3,3,9,6,3,19,6,13,1,1,0,11,4,7,1,0,1,3,1,2,0,0,0
123943,10000,100,0,1,36,10,26,0,0,0,8,1,7,2,0,2,14,6,8,0,0,0,8,2,6,1,0,1,3,1,2,0,0,0
123952,10000,100,0,1,11,8,3,0,0,0,2,2,0,2,1,1,4,4,0,0,0,0,3,1,2,0,0,0,0,0,0,0,0,0
123961,10000,100,0,1,1642,762,880,4,0,4,305,144,161,169,66,103,506,231,275,2,1,1,472,227,245,77,31,46,35,14,21,72,48,24
123970,10000,100,0,1,21,9,12,0,0,0,3,2,1,4,1,3,3,1,2,0,0,0,8,4,4,2,0,2,0,0,0,1,1,0
124113,10000,100,0,1,4,1,3,0,0,0,1,1,0,0,0,0,0,0,0,0,0,0,2,0,2,0,0,0,1,0,1,0,0,0
124283,10000,100,0,1,10,4,6,0,0,0,4,2,2,1,0,1,2,0,2,0,0,0,2,1,1,0,0,0,1,1,0,0,0,0
124292,10000,100,0,1,17,7,10,0,0,0,0,0,0,0,0,0,2,0,2,0,0,0,15,7,8,0,0,0,0,0,0,0,0,0
124557,10000,100,0,1,214,91,123,0,0,0,40,14,26,19,8,11,32,13,19,0,0,0,91,41,50,2,1,1,7,4,3,23,10,13
124706,10000,100,0,1,7,3,4,0,0,0,0,0,0,1,0,1,2,1,1,0,0,0,1,0,1,1,0,1,2,2,0,0,0,0
124937,10000,100,0,1,15,6,9,0,0,0,2,1,1,2,1,1,5,3,2,0,0,0,3,1,2,2,0,2,1,0,1,0,0,0
125019,10000,100,0,1,9,5,4,0,0,0,0,0,0,0,0,0,2,0,2,0,0,0,6,4,2,0,0,0,1,1,0,0,0,0
125028,10000,100,0,1,30,12,18,1,0,1,1,0,1,0,0,0,13,6,7,0,0,0,8,4,4,0,0,0,6,2,4,1,0,1
125091,10000,100,0,1,10,3,7,0,0,0,0,0,0,3,1,2,1,0,1,0,0,0,6,2,4,0,0,0,0,0,0,0,0,0
125170,10000,100,0,1,1,1,0,0,0,0,0,0,0,0,0,0,0,0,0,0,0,0,1,1,0,0,0,0,0,0,0,0,0,0
125231,10000,100,0,1,162,47,115,1,0,1,5,3,2,43,11,32,12,5,7,0,0,0,79,22,57,11,3,8,11,3,8,0,0,0
125462,10000,100,0,1,5,3,2,1,0,1,0,0,0,0,0,0,3,2,1,0,0,0,1,1,0,0,0,0,0,0,0,0,0,0
125471,10000,100,0,1,34,16,18,0,0,0,1,0,1,5,3,2,7,0,7,0,0,0,6,3,3,0,0,0,15,10,5,0,0,0
125499,10000,100,0,1,4,0,4,0,0,0,1,0,1,0,0,0,0,0,0,0,0,0,2,0,2,0,0,0,1,0,1,0,0,0
125532,10000,100,0,1,44,8,36,1,0,1,3,0,3,7,1,6,10,3,7,1,0,1,16,1,15,1,0,1,5,3,2,0,0,0
125718,10000,100,0,1,1,1,0,0,0,0,0,0,0,0,0,0,0,0,0,0,0,0,1,1,0,0,0,0,0,0,0,0,0,0
125727,10000,100,0,1,40,23,17,0,0,0,2,2,0,2,1,1,8,2,6,0,0,0,16,9,7,1,0,1,11,9,2,0,0,0
125763,10000,100,0,1,47,24,23,1,1,0,1,1,0,5,4,1,20,7,13,1,0,1,18,11,7,0,0,0,1,0,1,0,0,0
125897,10000,100,0,1,11,4,7,0,0,0,1,0,1,0,0,0,3,0,3,0,0,0,7,4,3,0,0,0,0,0,0,0,0,0
126012,10000,100,0,1,1,0,1,0,0,0,0,0,0,0,0,0,0,0,0,0,0,0,1,0,1,0,0,0,0,0,0,0,0,0
126049,10000,100,0,1,8,2,6,0,0,0,0,0,0,1,0,1,1,0,1,0,0,0,6,2,4,0,0,0,0,0,0,0,0,0
126100,10000,100,0,1,48,29,19,0,0,0,2,2,0,1,0,1,22,17,5,0,0,0,20,10,10,0,0,0,2,0,2,1,0,1
126119,10000,100,0,1,14,4,10,0,0,0,1,0,1,0,0,0,1,1,0,0,0,0,11,3,8,0,0,0,1,0,1,0,0,0
126182,10000,100,0,1,38,21,17,0,0,0,2,1,1,3,2,1,13,8,5,0,0,0,17,7,10,0,0,0,2,2,0,1,1,0
126207,10000,100,0,1,35,14,21,0,0,0,0,0,0,1,0,1,7,2,5,0,0,0,23,10,13,2,1,1,2,1,1,0,0,0
126289,10000,100,0,1,46,18,28,0,0,0,3,1,2,2,0,2,10,5,5,0,0,0,26,9,17,2,1,1,3,2,1,0,0,0
126359,10000,100,0,1,3,1,2,0,0,0,0,0,0,0,0,0,1,0,1,0,0,0,2,1,1,0,0,0,0,0,0,0,0,0
126562,10000,100,0,1,1986,688,1298,13,2,11,173,59,114,80,26,54,215,60,155,5,2,3,992,328,664,20,7,13,433,176,257,55,28,27
126580,10000,100,0,1,131,64,67,0,0,0,6,4,2,9,4,5,22,11,11,0,0,0,79,36,43,6,5,1,6,2,4,3,2,1
126605,10000,100,0,1,15,11,4,0,0,0,0,0,0,1,1,0,3,2,1,0,0,0,8,6,2,1,0,1,2,2,0,0,0,0
126614,10000,100,0,1,623,316,307,3,1,2,57,36,21,24,9,15,59,28,31,0,0,0,348,164,184,11,4,7,29,14,15,92,60,32
126669,10000,100,0,1,107,41,66,0,0,0,3,2,1,5,3,2,8,3,5,0,0,0,87,32,55,4,1,3,0,0,0,0,0,0
126678,10000,100,0,1,128,52,76,1,0,1,8,1,7,9,6,3,24,9,15,0,0,0,71,30,41,7,2,5,2,1,1,6,3,3
126687,10000,100,0,1,17,3,14,1,0,1,1,0,1,0,0,0,5,1,4,0,0,0,8,2,6,2,0,2,0,0,0,0,0,0
126711,10000,100,0,1,46,16,30,0,0,0,0,0,0,0,0,0,8,2,6,0,0,0,33,12,21,0,0,0,4,2,2,1,0,1
126748,10000,100,0,1,12,4,8,0,0,0,0,0,0,3,2,1,1,0,1,0,0,0,8,2,6,0,0,0,0,0,0,0,0,0
126775,10000,100,0,1,146,79,67,1,1,0,8,5,3,3,1,2,18,11,7,1,1,0,79,34,45,4,3,1,14,6,8,18,17,1
126784,10000,100,0,1,2,2,0,0,0,0,0,0,0,0,0,0,0,0,0,0,0,0,2,2,0,0,0,0,0,0,0,0,0,0
126818,10000,100,0,1,482,222,260,4,2,2,16,11,5,20,10,10,43,16,27,2,2,0,293,132,161,17,10,7,73,31,42,14,8,6
126827,10000,100,0,1,96,24,72,3,2,1,0,0,0,27,3,24,12,1,11,0,0,0,51,18,33,0,0,0,3,0,3,0,0,0
126863,10000,100,0,1,40,20,20,2,2,0,6,1,5,3,3,0,6,4,2,0,0,0,22,9,13,0,0,0,0,0,0,1,1,0
126942,10000,100,0,1,55,16,39,2,0,2,4,1,3,6,2,4,8,3,5,0,0,0,31,9,22,3,0,3,1,1,0,0,0,0
126951,10000,100,0,1,42,22,20,1,0,1,0,0,0,5,2,3,6,2,4,0,0,0,29,18,11,1,0,1,0,0,0,0,0,0
126979,10000,100,0,1,19,8,11,0,0,0,1,0,1,3,0,3,0,0,0,0,0,0,14,8,6,0,0,0,1,0,1,0,0,0
127060,10000,100,0,1,377,150,227,43,13,30,20,9,11,18,4,14,50,23,27,0,0,0,137,54,83,93,37,56,12,9,3,4,1,3
127185,10000,100,0,1,58,26,32,3,2,1,0,0,0,1,1,0,4,2,2,0,0,0,48,19,29,1,1,0,1,1,0,0,0,0
127200,10000,100,0,1,58,17,41,1,0,1,5,1,4,2,1,1,7,2,5,0,0,0,41,13,28,1,0,1,1,0,1,0,0,0
127273,10000,100,0,1,8,1,7,0,0,0,1,1,0,0,0,0,0,0,0,0,0,0,7,0,7,0,0,0,0,0,0,0,0,0
127389,10000,100,0,1,18,10,8,0,0,0,1,1,0,0,0,0,7,3,4,0,0,0,8,4,4,1,1,0,0,0,0,1,1,0
127556,10000,100,0,1,105,47,58,1,1,0,1,0,1,3,2,1,7,4,3,0,0,0,75,30,45,0,0,0,12,6,6,6,4,2
127565,10000,100,0,1,143,48,95,4,3,1,10,5,5,13,9,4,22,3,19,0,0,0,80,22,58,10,3,7,4,3,1,0,0,0
127617,10000,100,0,1,12,6,6,0,0,0,0,0,0,0,0,0,2,1,1,0,0,0,10,5,5,0,0,0,0,0,0,0,0,0
127653,10000,100,0,1,45,9,36,1,0,1,1,0,1,2,0,2,4,1,3,1,0,1,17,5,12,0,0,0,19,3,16,0,0,0
127714,10000,100,0,1,6,3,3,0,0,0,0,0,0,1,0,1,0,0,0,0,0,0,5,3,2,0,0,0,0,0,0,0,0,0
127732,10000,100,0,1,29,14,15,0,0,0,2,2,0,1,1,0,6,2,4,0,0,0,20,9,11,0,0,0,0,0,0,0,0,0
127741,10000,100,0,1,174,80,94,0,0,0,4,3,1,10,4,6,31,16,15,0,0,0,103,44,59,4,2,2,22,11,11,0,0,0
127778,10000,100,0,1,49,10,39,1,0,1,0,0,0,2,0,2,25,5,20,0,0,0,21,5,16,0,0,0,0,0,0,0,0,0
127820,10000,100,0,1,134,43,91,3,2,1,7,1,6,16,6,10,17,4,13,0,0,0,86,28,58,3,1,2,2,1,1,0,0,0
127884,10000,100,0,1,27,5,22,1,0,1,1,1,0,0,0,0,14,3,11,0,0,0,11,1,10,0,0,0,0,0,0,0,0,0
127909,10000,100,0,1,34,10,24,0,0,0,5,2,3,3,2,1,4,1,3,0,0,0,21,4,17,0,0,0,1,1,0,0,0,0
127918,10000,100,0,1,86,31,55,1,0,1,2,1,1,5,2,3,18,6,12,0,0,0,50,19,31,5,2,3,5,1,4,0,0,0
127945,10000,100,0,1,40,11,29,0,0,0,1,0,1,3,1,2,1,0,1,1,1,0,31,8,23,2,0,2,1,1,0,0,0,0
128106,10000,100,0,1,65,24,41,0,0,0,8,3,5,1,1,0,20,6,14,0,0,0,32,12,20,1,0,1,3,2,1,0,0,0
128179,10000,100,0,1,11,2,9,1,1,0,0,0,0,1,0,1,3,0,3,0,0,0,6,1,5,0,0,0,0,0,0,0,0,0
128188,10000,100,0,1,23,7,16,0,0,0,0,0,0,1,1,0,5,1,4,0,0,0,13,4,9,0,0,0,4,1,3,0,0,0
128258,10000,100,0,1,17,8,9,0,0,0,0,0,0,0,0,0,6,3,3,0,0,0,11,5,6,0,0,0,0,0,0,0,0,0
128300,10000,100,0,1,52,26,26,1,0,1,9,5,4,2,2,0,5,3,2,0,0,0,33,15,18,1,0,1,1,1,0,0,0,0
128328,10000,100,0,1,77,38,39,0,0,0,1,0,1,2,0,2,0,0,0,0,0,0,62,33,29,2,0,2,10,5,5,0,0,0
128391,10000,100,0,1,65,28,37,0,0,0,0,0,0,0,0,0,11,5,6,0,0,0,49,22,27,3,0,3,0,0,0,2,1,1
128498,10000,100,0,1,35,14,21,0,0,0,1,0,1,6,3,3,4,1,3,0,0,0,21,10,11,0,0,0,3,0,3,0,0,0
128577,10000,100,0,1,4,1,3,0,0,0,0,0,0,0,0,0,0,0,0,0,0,0,4,1,3,0,0,0,0,0,0,0,0,0
128744,10000,100,0,1,284,113,171,0,0,0,22,15,7,29,8,21,39,9,30,1,0,1,175,70,105,4,3,1,14,8,6,0,0,0
128771,10000,100,0,1,34,19,15,0,0,0,3,2,1,4,2,2,2,2,0,0,0,0,21,11,10,1,0,1,0,0,0,3,2,1
128780,10000,100,0,1,6,4,2,0,0,0,0,0,0,0,0,0,0,0,0,0,0,0,6,4,2,0,0,0,0,0,0,0,0,0
128902,10000,100,0,1,44,22,22,0,0,0,1,0,1,2,1,1,0,0,0,0,0,0,34,19,15,0,0,0,5,1,4,2,1,1
129020,10000,100,0,1,663,269,394,1,0,1,46,18,28,56,18,38,62,24,38,0,0,0,347,128,219,12,4,8,61,30,31,78,47,31
129154,10000,100,0,1,53,18,35,0,0,0,1,0,1,11,4,7,8,2,6,0,0,0,32,12,20,1,0,1,0,0,0,0,0,0
129215,10000,100,0,1,38,15,23,0,0,0,2,1,1,6,3,3,7,2,5,0,0,0,22,9,13,0,0,0,1,0,1,0,0,0
129242,10000,100,0,1,89,31,58,0,0,0,8,1,7,10,4,6,10,4,6,0,0,0,58,20,38,1,0,1,0,0,0,2,2,0
129428,10000,100,0,1,1,0,1,0,0,0,0,0,0,0,0,0,0,0,0,0,0,0,1,0,1,0,0,0,0,0,0,0,0,0
129491,10000,100,0,1,7,2,5,0,0,0,0,0,0,1,1,0,1,1,0,0,0,0,5,0,5,0,0,0,0,0,0,0,0,0
129525,10000,100,0,1,140,55,85,0,0,0,2,1,1,20,11,9,9,4,5,0,0,0,90,31,59,4,1,3,4,2,2,11,5,6
129543,10000,100,0,1,15,9,6,0,0,0,1,0,1,3,2,1,3,1,2,0,0,0,4,3,1,1,1,0,3,2,1,0,0,0
129695,10000,100,0,1,9,2,7,0,0,0,0,0,0,1,0,1,0,0,0,1,0,1,5,1,4,0,0,0,2,1,1,0,0,0
129729,10000,100,0,1,3,1,2,0,0,0,0,0,0,0,0,0,1,0,1,0,0,0,1,1,0,0,0,0,1,0,1,0,0,0
129756,10000,100,0,1,2,0,2,0,0,0,0,0,0,0,0,0,0,0,0,0,0,0,2,0,2,0,0,0,0,0,0,0,0,0
129774,10000,100,0,1,12,6,6,0,0,0,0,0,0,0,0,0,2,1,1,0,0,0,8,4,4,0,0,0,2,1,1,0,0,0
129808,10000,100,0,1,2,1,1,0,0,0,0,0,0,0,0,0,0,0,0,0,0,0,2,1,1,0,0,0,0,0,0,0,0,0
129941,10000,100,0,1,82,36,46,0,0,0,11,4,7,15,5,10,10,4,6,0,0,0,46,23,23,0,0,0,0,0,0,0,0,0
130040,10000,100,0,1,8,3,5,0,0,0,2,2,0,0,0,0,0,0,0,0,0,0,5,0,5,0,0,0,1,1,0,0,0,0
130110,10000,100,0,1,17,5,12,0,0,0,1,0,1,3,1,2,3,1,2,0,0,0,10,3,7,0,0,0,0,0,0,0,0,0
130183,10000,100,0,1,44,16,28,0,0,0,1,1,0,8,2,6,12,3,9,0,0,0,23,10,13,0,0,0,0,0,0,0,0,0
130217,10000,100,0,1,8,7,1,0,0,0,0,0,0,1,1,0,0,0,0,0,0,0,6,5,1,0,0,0,1,1,0,0,0,0
130226,10000,100,0,1,84,35,49,0,0,0,4,2,2,21,10,11,16,7,9,1,0,1,42,16,26,0,0,0,0,0,0,0,0,0
130253,10000,100,0,1,154,65,89,0,0,0,7,3,4,8,2,6,8,1,7,0,0,0,60,22,38,2,0,2,67,36,31,2,1,1
130314,10000,100,0,1,87,13,74,0,0,0,4,1,3,11,3,8,11,2,9,0,0,0,57,7,50,4,0,4,0,0,0,0,0,0
130396,10000,100,0,1,14,0,14,0,0,0,1,0,1,4,0,4,4,0,4,0,0,0,3,0,3,0,0,0,2,0,2,0,0,0
130493,10000,100,0,1,72,30,42,0,0,0,2,0,2,8,5,3,9,3,6,0,0,0,37,13,24,0,0,0,12,6,6,4,3,1
130590,10000,100,0,1,57,16,41,0,0,0,4,1,3,12,3,9,4,1,3,0,0,0,31,11,20,2,0,2,3,0,3,1,0,1
130606,10000,100,0,1,4,3,1,0,0,0,0,0,0,0,0,0,0,0,0,0,0,0,3,2,1,0,0,0,1,1,0,0,0,0
130624,10000,100,0,1,379,283,96,4,3,1,6,4,2,15,12,3,20,16,4,2,2,0,171,129,42,9,7,2,151,109,42,1,1,0
130697,10000,100,0,1,70,32,38,1,0,1,8,1,7,6,1,5,9,6,3,0,0,0,33,17,16,0,0,0,6,2,4,7,5,2
130776,10000,100,0,1,15,8,7,0,0,0,1,1,0,2,2,0,3,1,2,0,0,0,7,3,4,2,1,1,0,0,0,0,0,0
130794,10000,100,0,1,980,399,581,1,0,1,114,45,69,84,23,61,78,29,49,0,0,0,399,146,253,23,9,14,39,17,22,242,130,112
130882,10000,100,0,1,5,2,3,1,0,1,0,0,0,3,1,2,0,0,0,0,0,0,1,1,0,0,0,0,0,0,0,0,0,0
130907,10000,100,0,1,44,16,28,1,0,1,0,0,0,13,6,7,0,0,0,0,0,0,29,9,20,1,1,0,0,0,0,0,0,0
130934,10000,100,0,1,147,57,90,0,0,0,6,3,3,73,27,46,1,0,1,0,0,0,65,26,39,2,1,1,0,0,0,0,0,0
130943,10000,100,0,1,424,197,227,1,1,0,32,15,17,41,14,27,20,9,11,0,0,0,258,111,147,8,6,2,0,0,0,64,41,23
130989,10000,100,0,1,7,2,5,0,0,0,0,0,0,1,0,1,0,0,0,0,0,0,6,2,4,0,0,0,0,0,0,0,0,0
131113,10000,100,0,1,17,5,12,0,0,0,1,1,0,2,0,2,2,1,1,0,0,0,12,3,9,0,0,0,0,0,0,0,0,0
131159,10000,100,0,1,288,101,187,3,3,0,26,9,17,75,22,53,4,2,2,0,0,0,144,49,95,1,0,1,24,14,10,11,2,9
131283,10000,100,0,1,108,44,64,0,0,0,3,2,1,12,4,8,9,6,3,0,0,0,66,25,41,0,0,0,7,2,5,11,5,6
131399,10000,100,0,1,34,18,16,0,0,0,6,4,2,16,8,8,2,2,0,0,0,0,8,3,5,0,0,0,2,1,1,0,0,0
131405,10000,100,0,1,5,2,3,0,0,0,0,0,0,0,0,0,1,1,0,0,0,0,4,1,3,0,0,0,0,0,0,0,0,0
131450,10000,100,0,1,127,61,66,0,0,0,20,11,9,36,20,16,16,9,7,0,0,0,51,21,30,4,0,4,0,0,0,0,0,0
131469,10000,100,0,1,680,286,394,0,0,0,101,43,58,126,46,80,58,26,32,1,1,0,356,154,202,19,6,13,19,10,9,0,0,0
131496,10000,100,0,1,351,146,205,0,0,0,37,9,28,55,22,33,15,3,12,0,0,0,153,65,88,6,3,3,35,18,17,50,26,24
131520,10000,100,0,1,359,109,250,0,0,0,27,13,14,195,49,146,23,7,16,0,0,0,24,15,9,14,5,9,75,20,55,1,0,1
131803,10000,100,0,1,143,41,102,2,1,1,6,3,3,65,14,51,3,1,2,0,0,0,48,15,33,1,1,0,18,6,12,0,0,0
131876,10000,100,0,1,15,5,10,0,0,0,0,0,0,9,4,5,2,0,2,0,0,0,3,1,2,1,0,1,0,0,0,0,0,0
131973,10000,100,0,1,8,2,6,0,0,0,1,0,1,4,2,2,1,0,1,0,0,0,2,0,2,0,0,0,0,0,0,0,0,0
132408,10000,100,0,1,5,2,3,0,0,0,0,0,0,0,0,0,0,0,0,0,0,0,5,2,3,0,0,0,0,0,0,0,0,0
132471,10000,100,0,1,84,22,62,0,0,0,2,1,1,19,4,15,24,4,20,1,0,1,23,9,14,1,1,0,10,2,8,4,1,3
132602,10000,100,0,1,60,31,29,0,0,0,1,1,0,44,19,25,1,0,1,0,0,0,13,10,3,0,0,0,1,1,0,0,0,0
132657,10000,100,0,1,76,44,32,0,0,0,0,0,0,6,5,1,10,7,3,1,0,1,32,18,14,4,2,2,23,12,11,0,0,0
132693,10000,100,0,1,17,3,14,0,0,0,0,0,0,3,1,2,3,1,2,0,0,0,11,1,10,0,0,0,0,0,0,0,0,0
132709,10000,100,0,1,31,5,26,0,0,0,3,1,2,10,0,10,7,1,6,0,0,0,10,3,7,0,0,0,1,0,1,0,0,0
132842,10000,100,0,1,7,2,5,0,0,0,0,0,0,0,0,0,7,2,5,0,0,0,0,0,0,0,0,0,0,0,0,0,0,0
132851,10000,100,0,1,48,17,31,0,0,0,2,1,1,1,0,1,6,2,4,0,0,0,38,14,24,1,0,1,0,0,0,0,0,0
132879,10000,100,0,1,4,1,3,0,0,0,0,0,0,0,0,0,1,0,1,0,0,0,2,0,2,1,1,0,0,0,0,0,0,0
132903,10000,100,0,1,52,17,35,0,0,0,3,1,2,5,4,1,15,2,13,0,0,0,22,7,15,1,0,1,0,0,0,6,3,3
133021,10000,100,0,1,8,5,3,0,0,0,0,0,0,1,1,0,0,0,0,0,0,0,7,4,3,0,0,0,0,0,0,0,0,0
133386,10000,100,0,1,101,46,55,0,0,0,2,2,0,25,12,13,6,3,3,1,1,0,62,24,38,0,0,0,5,4,1,0,0,0
133465,10000,100,0,1,22,8,14,0,0,0,0,0,0,8,0,8,2,0,2,0,0,0,11,7,4,0,0,0,1,1,0,0,0,0
133492,10000,100,0,1,74,31,43,1,0,1,2,1,1,7,2,5,3,2,1,0,0,0,55,25,30,4,1,3,2,0,2,0,0,0
133508,10000,100,0,1,72,39,33,0,0,0,0,0,0,6,4,2,10,6,4,0,0,0,53,27,26,0,0,0,3,2,1,0,0,0
133526,10000,100,0,1,23,12,11,0,0,0,0,0,0,20,10,10,0,0,0,0,0,0,3,2,1,0,0,0,0,0,0,0,0,0
133553,10000,100,0,1,299,168,131,0,0,0,18,12,6,15,8,7,28,13,15,1,0,1,181,95,86,2,1,1,34,24,10,20,15,5
133650,10000,100,0,1,110,58,52,0,0,0,5,4,1,81,38,43,3,2,1,0,0,0,12,8,4,1,1,0,0,0,0,8,5,3
133669,10000,100,0,1,209,86,123,0,0,0,11,8,3,62,24,38,36,9,27,0,0,0,89,38,51,3,2,1,0,0,0,8,5,3
133702,10000,100,0,1,109,47,62,0,0,0,1,1,0,32,17,15,10,3,7,1,1,0,57,22,35,6,2,4,1,0,1,1,1,0
133711,10000,100,0,1,53,28,25,0,0,0,1,1,0,8,5,3,5,1,4,0,0,0,36,19,17,0,0,0,3,2,1,0,0,0
133809,10000,100,0,1,20,5,15,0,0,0,0,0,0,0,0,0,0,0,0,0,0,0,20,5,15,0,0,0,0,0,0,0,0,0
133845,10000,100,0,1,17,3,14,0,0,0,1,1,0,4,1,3,2,0,2,0,0,0,9,1,8,0,0,0,1,0,1,0,0,0
133854,10000,100,0,1,4,1,3,0,0,0,0,0,0,1,1,0,2,0,2,0,0,0,1,0,1,0,0,0,0,0,0,0,0,0
133863,10000,100,0,1,12,3,9,0,0,0,1,1,0,4,2,2,3,0,3,0,0,0,3,0,3,0,0,0,1,0,1,0,0,0
133872,10000,100,0,1,33,7,26,0,0,0,1,0,1,4,1,3,14,2,12,0,0,0,13,3,10,1,1,0,0,0,0,0,0,0
133881,10000,100,0,1,117,55,62,1,1,0,6,2,4,13,4,9,9,4,5,1,1,0,78,39,39,4,0,4,3,2,1,2,2,0
133951,10000,100,0,1,215,110,105,1,1,0,19,13,6,19,5,14,45,21,24,0,0,0,97,46,51,0,0,0,0,0,0,34,24,10
133960,10000,100,0,1,28,17,11,0,0,0,0,0,0,2,0,2,1,1,0,0,0,0,22,14,8,0,0,0,3,2,1,0,0,0
133979,10000,100,0,1,74,34,40,0,0,0,0,0,0,60,27,33,9,7,2,0,0,0,1,0,1,4,0,4,0,0,0,0,0,0
133997,10000,100,0,1,10,4,6,0,0,0,0,0,0,3,1,2,5,1,4,0,0,0,0,0,0,2,2,0,0,0,0,0,0,0
134079,10000,100,0,1,92,48,44,0,0,0,0,0,0,8,6,2,23,12,11,0,0,0,59,29,30,1,0,1,1,1,0,0,0,0
134097,10000,100,0,1,359,147,212,0,0,0,7,3,4,54,19,35,30,10,20,0,0,0,220,93,127,9,3,6,7,3,4,32,16,16
134130,10000,100,0,1,978,412,566,1,1,0,64,26,38,111,37,74,134,57,77,1,0,1,551,225,326,1,0,1,51,26,25,64,40,24
134237,10000,100,0,1,406,198,208,1,0,1,21,11,10,60,28,32,99,46,53,3,0,3,187,95,92,31,14,17,4,4,0,0,0,0
134343,10000,100,0,1,33,15,18,0,0,0,0,0,0,2,0,2,2,0,2,0,0,0,24,13,11,0,0,0,4,1,3,1,1,0
134495,10000,100,0,1,36,13,23,0,0,0,1,1,0,4,0,4,4,2,2,0,0,0,25,9,16,2,1,1,0,0,0,0,0,0
134608,10000,100,0,1,47,23,24,0,0,0,0,0,0,11,4,7,10,8,2,1,0,1,25,11,14,0,0,0,0,0,0,0,0,0
134811,10000,100,0,1,3,1,2,0,0,0,1,0,1,1,1,0,0,0,0,0,0,0,0,0,0,1,0,1,0,0,0,0,0,0
134945,10000,100,0,1,57,17,40,2,1,1,4,2,2,12,4,8,4,1,3,0,0,0,35,9,26,0,0,0,0,0,0,0,0,0
135081,10000,100,0,1,109,51,58,1,1,0,7,3,4,26,11,15,24,12,12,1,0,1,41,20,21,9,4,5,0,0,0,0,0,0
135160,10000,100,0,1,27,8,19,0,0,0,0,0,0,3,1,2,1,0,1,0,0,0,22,7,15,0,0,0,1,0,1,0,0,0
135188,10000,100,0,1,52,22,30,0,0,0,1,1,0,11,3,8,5,1,4,0,0,0,33,16,17,0,0,0,1,0,1,1,1,0
135364,10000,100,0,1,1,1,0,0,0,0,0,0,0,0,0,0,0,0,0,0,0,0,1,1,0,0,0,0,0,0,0,0,0,0
135391,10000,100,0,1,62,20,42,0,0,0,1,1,0,6,2,4,8,2,6,0,0,0,46,15,31,1,0,1,0,0,0,0,0,0
135717,10000,100,0,1,126,43,83,0,0,0,5,3,2,23,7,16,82,28,54,0,0,0,12,4,8,1,0,1,1,1,0,2,0,2
135726,10000,100,0,1,1844,670,1174,0,0,0,87,34,53,233,65,168,825,276,549,2,0,2,366,171,195,38,10,28,98,27,71,195,87,108
136145,10000,100,0,1,2,0,2,0,0,0,0,0,0,0,0,0,0,0,0,0,0,0,2,0,2,0,0,0,0,0,0,0,0,0
136172,10000,100,0,1,173,71,102,0,0,0,7,3,4,20,9,11,9,4,5,1,0,1,116,46,70,12,4,8,0,0,0,8,5,3
136215,10000,100,0,1,647,209,438,0,0,0,41,21,20,134,28,106,174,50,124,0,0,0,254,93,161,5,1,4,8,4,4,31,12,19
136233,10000,100,0,1,69,29,40,1,0,1,2,0,2,3,0,3,7,3,4,1,1,0,49,23,26,5,2,3,0,0,0,1,0,1
136330,10000,100,0,1,59,30,29,0,0,0,0,0,0,6,3,3,10,7,3,0,0,0,37,15,22,0,0,0,1,1,0,5,4,1
136358,10000,100,0,1,66,27,39,1,0,1,2,0,2,27,9,18,8,3,5,0,0,0,27,15,12,0,0,0,0,0,0,1,0,1
136400,10000,100,0,1,21,4,17,0,0,0,0,0,0,2,0,2,1,0,1,0,0,0,13,3,10,0,0,0,5,1,4,0,0,0
136473,10000,100,0,1,64,28,36,0,0,0,0,0,0,10,3,7,3,1,2,0,0,0,46,24,22,4,0,4,1,0,1,0,0,0
136516,10000,100,0,1,32,9,23,0,0,0,0,0,0,3,0,3,3,2,1,0,0,0,24,7,17,1,0,1,1,0,1,0,0,0
136701,10000,100,0,1,9,5,4,0,0,0,1,1,0,0,0,0,4,1,3,0,0,0,3,2,1,0,0,0,0,0,0,1,1,0
136774,10000,100,0,1,50,33,17,1,0,1,0,0,0,1,1,0,8,8,0,0,0,0,40,24,16,0,0,0,0,0,0,0,0,0
136950,10000,100,0,1,105,39,66,0,0,0,3,1,2,16,7,9,14,4,10,1,0,1,57,23,34,5,2,3,2,0,2,7,2,5
137032,10000,100,0,1,102,43,59,1,0,1,0,0,0,13,5,8,18,8,10,0,0,0,53,23,30,4,2,2,13,5,8,0,0,0
137078,10000,100,0,1,87,28,59,1,0,1,4,1,3,16,4,12,10,5,5,0,0,0,49,17,32,0,0,0,7,1,6,0,0,0
137096,10000,100,0,1,69,29,40,0,0,0,1,0,1,12,7,5,11,5,6,0,0,0,38,15,23,2,0,2,5,2,3,0,0,0
137209,10000,100,0,1,18,9,9,0,0,0,2,2,0,2,0,2,2,1,1,0,0,0,12,6,6,0,0,0,0,0,0,0,0,0
137272,10000,100,0,1,3,2,1,0,0,0,0,0,0,0,0,0,3,2,1,0,0,0,0,0,0,0,0,0,0,0,0,0,0,0
137281,10000,100,0,1,49,16,33,0,0,0,1,1,0,7,1,6,5,0,5,0,0,0,35,14,21,1,0,1,0,0,0,0,0,0
137315,10000,100,0,1,26,11,15,0,0,0,1,0,1,2,1,1,3,1,2,0,0,0,17,8,9,0,0,0,3,1,2,0,0,0
137351,10000,100,0,1,954,401,553,1,1,0,91,47,44,106,43,63,57,24,33,0,0,0,451,185,266,120,37,83,11,3,8,117,61,56
137476,10000,100,0,1,88,44,44,0,0,0,0,0,0,23,13,10,35,17,18,1,1,0,20,9,11,3,2,1,5,1,4,1,1,0
137546,10000,100,0,1,152,83,69,0,0,0,3,2,1,15,9,6,17,8,9,0,0,0,107,60,47,3,3,0,5,1,4,2,0,2
137564,10000,100,0,1,68,26,42,0,0,0,1,0,1,5,4,1,13,3,10,0,0,0,45,17,28,3,2,1,1,0,1,0,0,0
137759,10000,100,0,1,85,31,54,0,0,0,1,0,1,28,9,19,6,3,3,0,0,0,47,17,30,0,0,0,2,2,0,1,0,1
137801,10000,100,0,1,13,0,13,0,0,0,0,0,0,2,0,2,1,0,1,0,0,0,7,0,7,3,0,3,0,0,0,0,0,0
137847,10000,100,0,1,142,57,85,0,0,0,7,4,3,16,4,12,21,10,11,1,1,0,80,29,51,4,2,2,13,7,6,0,0,0
137962,10000,100,0,1,5,4,1,0,0,0,0,0,0,1,1,0,0,0,0,0,0,0,4,3,1,0,0,0,0,0,0,0,0,0
138187,10000,100,0,1,92,42,50,0,0,0,5,3,2,23,9,14,21,8,13,0,0,0,32,16,16,0,0,0,7,5,2,4,1,3
138275,10000,100,0,1,28,19,9,0,0,0,0,0,0,5,3,2,3,2,1,0,0,0,20,14,6,0,0,0,0,0,0,0,0,0
138293,10000,100,0,1,27,18,9,0,0,0,0,0,0,7,7,0,2,2,0,0,0,0,18,9,9,0,0,0,0,0,0,0,0,0
138309,10000,100,0,1,75,13,62,0,0,0,0,0,0,16,1,15,4,2,2,0,0,0,49,8,41,5,1,4,1,1,0,0,0,0
138354,10000,100,0,1,80,31,49,0,0,0,5,1,4,9,6,3,4,0,4,0,0,0,60,24,36,2,0,2,0,0,0,0,0,0
138558,10000,100,0,1,30,13,17,0,0,0,0,0,0,5,3,2,1,1,0,0,0,0,23,9,14,0,0,0,1,0,1,0,0,0
138600,10000,100,0,1,47,8,39,0,0,0,2,1,1,19,4,15,1,0,1,0,0,0,13,3,10,2,0,2,9,0,9,1,0,1
138655,10000,100,0,1,4,0,4,0,0,0,0,0,0,0,0,0,2,0,2,0,0,0,2,0,2,0,0,0,0,0,0,0,0,0
138682,10000,100,0,1,42,9,33,0,0,0,2,1,1,34,5,29,0,0,0,0,0,0,5,2,3,0,0,0,1,1,0,0,0,0
138716,10000,100,0,1,57,19,38,0,0,0,3,3,0,33,9,24,1,0,1,0,0,0,18,6,12,0,0,0,2,1,1,0,0,0
138761,10000,100,0,1,6,3,3,0,0,0,0,0,0,3,2,1,0,0,0,0,0,0,3,1,2,0,0,0,0,0,0,0,0,0
138813,10000,100,0,1,1,1,0,0,0,0,0,0,0,1,1,0,0,0,0,0,0,0,0,0,0,0,0,0,0,0,0,0,0,0
138840,10000,100,0,1,47,11,36,1,0,1,0,0,0,39,10,29,2,0,2,0,0,0,5,1,4,0,0,0,0,0,0,0,0,0
138868,10000,100,0,1,34,22,12,0,0,0,0,0,0,10,8,2,0,0,0,0,0,0,24,14,10,0,0,0,0,0,0,0,0,0
138901,10000,100,0,1,6,4,2,0,0,0,0,0,0,6,4,2,0,0,0,0,0,0,0,0,0,0,0,0,0,0,0,0,0,0
138929,10000,100,0,1,9,3,6,0,0,0,0,0,0,4,0,4,0,0,0,0,0,0,5,3,2,0,0,0,0,0,0,0,0,0
138947,10000,100,0,1,90,46,44,0,0,0,5,4,1,68,33,35,1,1,0,0,0,0,2,2,0,0,0,0,13,5,8,1,1,0
138956,10000,100,0,1,34,12,22,0,0,0,0,0,0,20,5,15,3,1,2,0,0,0,11,6,5,0,0,0,0,0,0,0,0,0
139144,10000,100,0,1,80,35,45,0,0,0,2,1,1,6,2,4,7,3,4,0,0,0,58,27,31,2,0,2,4,1,3,1,1,0
139199,10000,100,0,1,38,6,32,0,0,0,3,2,1,5,1,4,5,0,5,0,0,0,25,3,22,0,0,0,0,0,0,0,0,0
139205,10000,100,0,1,18,12,6,0,0,0,0,0,0,4,4,0,1,1,0,0,0,0,13,7,6,0,0,0,0,0,0,0,0,0
139250,10000,100,0,1,27,12,15,0,0,0,0,0,0,5,3,2,4,2,2,0,0,0,18,7,11,0,0,0,0,0,0,0,0,0
139278,10000,100,0,1,42,13,29,0,0,0,1,0,1,9,3,6,0,0,0,0,0,0,31,10,21,1,0,1,0,0,0,0,0,0
139311,10000,100,0,1,64,26,38,0,0,0,6,4,2,32,8,24,2,0,2,0,0,0,21,12,9,1,1,0,2,1,1,0,0,0
139348,10000,100,0,1,3,2,1,0,0,0,0,0,0,1,0,1,0,0,0,0,0,0,2,2,0,0,0,0,0,0,0,0,0,0
139357,10000,100,0,1,26,10,16,0,0,0,1,1,0,10,2,8,1,1,0,0,0,0,14,6,8,0,0,0,0,0,0,0,0,0
139366,10000,100,0,1,78,41,37,0,0,0,4,3,1,24,11,13,4,1,3,0,0,0,42,23,19,2,1,1,2,2,0,0,0,0
139384,10000,100,0,1,34,15,19,0,0,0,0,0,0,2,0,2,2,1,1,0,0,0,30,14,16,0,0,0,0,0,0,0,0,0
139393,10000,100,0,1,32,16,16,0,0,0,0,0,0,1,1,0,2,1,1,0,0,0,26,12,14,0,0,0,0,0,0,3,2,1
139463,10000,100,0,1,11,3,8,0,0,0,1,0,1,0,0,0,1,0,1,0,0,0,9,3,6,0,0,0,0,0,0,0,0,0
139579,10000,100,0,1,21,7,14,0,0,0,1,0,1,8,4,4,1,0,1,0,0,0,9,3,6,1,0,1,1,0,1,0,0,0
139621,10000,100,0,1,5,1,4,0,0,0,0,0,0,2,1,1,0,0,0,0,0,0,3,0,3,0,0,0,0,0,0,0,0,0
139630,10000,100,0,1,25,17,8,0,0,0,1,1,0,7,5,2,0,0,0,0,0,0,17,11,6,0,0,0,0,0,0,0,0,0
139658,10000,100,0,1,1731,557,1174,2,0,2,225,85,140,537,129,408,106,33,73,2,1,1,667,222,445,29,9,20,5,2,3,158,76,82
139700,10000,100,0,1,20,9,11,0,0,0,0,0,0,5,4,1,1,0,1,0,0,0,13,5,8,1,0,1,0,0,0,0,0,0
139719,10000,100,0,1,64,19,45,0,0,0,1,1,0,51,13,38,2,1,1,0,0,0,8,4,4,0,0,0,2,0,2,0,0,0
139755,10000,100,0,1,1089,564,525,0,0,0,87,42,45,449,172,277,67,35,32,0,0,0,341,225,116,28,11,17,36,27,9,81,52,29
139764,10000,100,0,1,23,9,14,0,0,0,1,0,1,3,1,2,1,1,0,0,0,0,17,6,11,0,0,0,1,1,0,0,0,0
139861,10000,100,0,1,71,36,35,0,0,0,1,0,1,16,9,7,3,0,3,0,0,0,45,25,20,1,0,1,2,1,1,3,1,2
139931,10000,100,0,1,277,118,159,0,0,0,12,4,8,88,33,55,14,4,10,0,0,0,147,66,81,10,8,2,6,3,3,0,0,0
139940,10000,100,0,1,374,141,233,0,0,0,33,16,17,171,52,119,13,5,8,1,0,1,134,57,77,4,2,2,6,2,4,12,7,5
139959,10000,100,0,1,783,303,480,0,0,0,43,24,19,121,35,86,44,19,25,3,0,3,440,169,271,20,7,13,35,7,28,77,42,35
139968,10000,100,0,1,10,6,4,0,0,0,0,0,0,5,3,2,0,0,0,0,0,0,5,3,2,0,0,0,0,0,0,0,0,0
139986,10000,100,0,1,46,15,31,0,0,0,1,1,0,17,5,12,2,1,1,0,0,0,26,8,18,0,0,0,0,0,0,0,0,0
140012,10000,100,0,1,49,21,28,0,0,0,3,0,3,20,10,10,4,2,2,0,0,0,22,9,13,0,0,0,0,0,0,0,0,0
140146,10000,100,0,1,9,2,7,0,0,0,0,0,0,8,1,7,1,1,0,0,0,0,0,0,0,0,0,0,0,0,0,0,0,0
140234,10000,100,0,1,15,7,8,0,0,0,0,0,0,7,4,3,0,0,0,0,0,0,8,3,5,0,0,0,0,0,0,0,0,0
140243,10000,100,0,1,28,5,23,0,0,0,3,1,2,5,0,5,2,1,1,0,0,0,18,3,15,0,0,0,0,0,0,0,0,0
140252,10000,100,0,1,78,33,45,0,0,0,3,2,1,33,16,17,4,0,4,0,0,0,36,14,22,2,1,1,0,0,0,0,0,0
140331,10000,100,0,1,60,24,36,0,0,0,0,0,0,10,1,9,6,1,5,0,0,0,44,22,22,0,0,0,0,0,0,0,0,0
140340,10000,100,0,1,2,0,2,0,0,0,0,0,0,2,0,2,0,0,0,0,0,0,0,0,0,0,0,0,0,0,0,0,0,0
140447,10000,100,0,1,182,85,97,1,0,1,11,7,4,36,4,32,7,1,6,0,0,0,120,68,52,2,1,1,0,0,0,5,4,1
140553,10000,100,0,1,77,31,46,0,0,0,3,0,3,61,24,37,1,0,1,0,0,0,9,4,5,0,0,0,3,3,0,0,0,0
140562,10000,100,0,1,284,83,201,0,0,0,7,3,4,245,67,178,11,5,6,0,0,0,17,7,10,2,0,2,0,0,0,2,1,1
140678,10000,100,0,1,24,12,12,0,0,0,0,0,0,0,0,0,0,0,0,0,0,0,24,12,12,0,0,0,0,0,0,0,0,0
140696,10000,100,0,1,55,28,27,0,0,0,2,1,1,20,6,14,5,2,3,1,1,0,26,17,9,1,1,0,0,0,0,0,0,0
140720,10000,100,0,1,21,12,9,0,0,0,0,0,0,20,12,8,0,0,0,0,0,0,1,0,1,0,0,0,0,0,0,0,0,0
140818,10000,100,0,1,52,21,31,0,0,0,0,0,0,1,0,1,0,0,0,0,0,0,50,20,30,1,1,0,0,0,0,0,0,0
140872,10000,100,0,1,42,17,25,0,0,0,1,1,0,3,1,2,3,1,2,0,0,0,35,14,21,0,0,0,0,0,0,0,0,0
140942,10000,100,0,1,43,17,26,0,0,0,1,0,1,16,3,13,2,1,1,0,0,0,22,12,10,2,1,1,0,0,0,0,0,0
140951,10000,100,0,1,258,109,149,0,0,0,8,2,6,39,14,25,14,6,8,0,0,0,141,65,76,7,2,5,33,11,22,16,9,7
140960,10000,100,0,1,35,12,23,0,0,0,1,1,0,24,8,16,1,1,0,0,0,0,8,2,6,1,0,1,0,0,0,0,0,0
140988,10000,100,0,1,25,5,20,0,0,0,0,0,0,1,1,0,0,0,0,0,0,0,24,4,20,0,0,0,0,0,0,0,0,0
141006,10000,100,0,1,8,5,3,0,0,0,0,0,0,3,1,2,0,0,0,0,0,0,5,4,1,0,0,0,0,0,0,0,0,0
141060,10000,100,0,1,25,10,15,0,0,0,4,1,3,12,3,9,3,2,1,0,0,0,6,4,2,0,0,0,0,0,0,0,0,0
141167,10000,100,0,1,25,10,15,0,0,0,0,0,0,5,4,1,1,0,1,0,0,0,19,6,13,0,0,0,0,0,0,0,0,0
141185,10000,100,0,1,11,7,4,0,0,0,0,0,0,2,1,1,0,0,0,0,0,0,9,6,3,0,0,0,0,0,0,0,0,0
141237,10000,100,0,1,16,9,7,0,0,0,0,0,0,0,0,0,1,1,0,0,0,0,15,8,7,0,0,0,0,0,0,0,0,0
141255,10000,100,0,1,50,15,35,0,0,0,0,0,0,16,4,12,0,0,0,0,0,0,34,11,23,0,0,0,0,0,0,0,0,0
141264,10000,100,0,1,76,27,49,0,0,0,7,4,3,18,7,11,5,2,3,0,0,0,41,12,29,3,1,2,2,1,1,0,0,0
141325,10000,100,0,1,18,5,13,0,0,0,0,0,0,9,1,8,0,0,0,0,0,0,9,4,5,0,0,0,0,0,0,0,0,0
141334,10000,100,0,1,93,29,64,0,0,0,1,0,1,20,5,15,4,2,2,0,0,0,65,21,44,2,0,2,1,1,0,0,0,0
141361,10000,100,0,1,6,2,4,0,0,0,0,0,0,0,0,0,0,0,0,0,0,0,4,1,3,0,0,0,2,1,1,0,0,0
141486,10000,100,0,1,31,9,22,0,0,0,5,0,5,1,1,0,7,2,5,2,1,1,9,4,5,7,1,6,0,0,0,0,0,0
141565,10000,100,0,1,9,2,7,0,0,0,2,1,1,1,0,1,1,0,1,2,0,2,2,1,1,1,0,1,0,0,0,0,0,0
141574,10000,100,0,1,86,43,43,0,0,0,27,9,18,4,4,0,6,4,2,6,1,5,29,18,11,14,7,7,0,0,0,0,0,0
141644,10000,100,0,1,87,32,55,2,1,1,25,11,14,4,2,2,7,2,5,8,4,4,35,10,25,6,2,4,0,0,0,0,0,0
141680,10000,100,0,1,3,2,1,0,0,0,2,1,1,0,0,0,0,0,0,0,0,0,0,0,0,1,1,0,0,0,0,0,0,0
141796,10000,100,0,1,3,0,3,0,0,0,1,0,1,0,0,0,0,0,0,1,0,1,0,0,0,1,0,1,0,0,0,0,0,0
141802,10000,100,0,1,3,3,0,0,0,0,1,1,0,0,0,0,0,0,0,1,1,0,0,0,0,1,1,0,0,0,0,0,0,0
141811,10000,100,0,1,6,1,5,0,0,0,3,1,2,0,0,0,0,0,0,1,0,1,2,0,2,0,0,0,0,0,0,0,0,0
141839,10000,100,0,1,4,1,3,0,0,0,0,0,0,0,0,0,0,0,0,1,1,0,2,0,2,1,0,1,0,0,0,0,0,0
141963,10000,100,0,1,16,8,8,0,0,0,8,3,5,0,0,0,0,0,0,0,0,0,5,3,2,3,2,1,0,0,0,0,0,0
141981,10000,100,0,1,12,8,4,0,0,0,5,2,3,0,0,0,1,1,0,1,0,1,2,2,0,3,3,0,0,0,0,0,0,0
141990,10000,100,0,1,3,1,2,0,0,0,0,0,0,0,0,0,1,0,1,0,0,0,2,1,1,0,0,0,0,0,0,0,0,0
142054,10000,100,0,1,19,4,15,0,0,0,0,0,0,0,0,0,3,1,2,0,0,0,13,3,10,2,0,2,1,0,1,0,0,0
142090,10000,100,0,1,1,1,0,0,0,0,0,0,0,0,0,0,0,0,0,0,0,0,1,1,0,0,0,0,0,0,0,0,0,0
142115,10000,100,0,1,297,127,170,0,0,0,7,2,5,8,8,0,33,10,23,1,0,1,214,91,123,16,5,11,11,6,5,7,5,2
142179,10000,100,0,1,38,20,18,0,0,0,1,0,1,0,0,0,4,2,2,0,0,0,31,16,15,0,0,0,2,2,0,0,0,0
142276,10000,100,0,1,82,36,46,1,0,1,4,1,3,0,0,0,0,0,0,0,0,0,53,23,30,0,0,0,24,12,12,0,0,0
142285,10000,100,0,1,162,76,86,2,0,2,2,1,1,3,2,1,8,7,1,0,0,0,124,58,66,5,3,2,14,4,10,4,1,3
142294,10000,100,0,1,41,19,22,0,0,0,2,1,1,2,1,1,6,4,2,0,0,0,26,12,14,4,0,4,0,0,0,1,1,0
142328,10000,100,0,1,41,19,22,0,0,0,0,0,0,0,0,0,4,4,0,0,0,0,36,15,21,1,0,1,0,0,0,0,0,0
142443,10000,100,0,1,62,27,35,0,0,0,1,1,0,0,0,0,3,1,2,0,0,0,48,20,28,2,1,1,7,4,3,1,0,1
142461,10000,100,0,1,39,12,27,0,0,0,1,0,1,0,0,0,1,1,0,0,0,0,32,10,22,0,0,0,5,1,4,0,0,0
142522,10000,100,0,1,71,44,27,0,0,0,0,0,0,0,0,0,3,3,0,0,0,0,60,36,24,0,0,0,8,5,3,0,0,0
142559,10000,100,0,1,81,20,61,0,0,0,1,0,1,0,0,0,18,2,16,0,0,0,53,14,39,3,1,2,5,2,3,1,1,0
142832,10000,100,0,1,44,14,30,0,0,0,3,2,1,12,2,10,6,2,4,0,0,0,15,5,10,0,0,0,8,3,5,0,0,0
143048,10000,100,0,1,37,10,27,0,0,0,2,1,1,3,1,2,5,3,2,0,0,0,22,5,17,3,0,3,0,0,0,2,0,2
143084,10000,100,0,1,56,25,31,0,0,0,3,2,1,7,4,3,6,1,5,0,0,0,38,17,21,0,0,0,2,1,1,0,0,0
143118,10000,100,0,1,58,18,40,0,0,0,1,1,0,6,0,6,7,2,5,0,0,0,42,14,28,0,0,0,2,1,1,0,0,0
143215,10000,100,0,1,56,27,29,0,0,0,1,1,0,7,3,4,2,2,0,1,0,1,40,21,19,1,0,1,4,0,4,0,0,0
143233,10000,100,0,1,3,2,1,0,0,0,0,0,0,0,0,0,0,0,0,0,0,0,3,2,1,0,0,0,0,0,0,0,0,0
143279,10000,100,0,1,24,10,14,0,0,0,0,0,0,0,0,0,0,0,0,0,0,0,11,5,6,0,0,0,13,5,8,0,0,0
143288,10000,100,0,1,22,10,12,0,0,0,0,0,0,4,0,4,1,0,1,0,0,0,17,10,7,0,0,0,0,0,0,0,0,0
143297,10000,100,0,1,3,0,3,0,0,0,0,0,0,0,0,0,0,0,0,0,0,0,3,0,3,0,0,0,0,0,0,0,0,0
143358,10000,100,0,1,102,55,47,1,0,1,7,5,2,7,3,4,1,1,0,0,0,0,84,44,40,2,2,0,0,0,0,0,0,0
143613,10000,100,0,1,11,5,6,0,0,0,1,0,1,1,1,0,0,0,0,0,0,0,9,4,5,0,0,0,0,0,0,0,0,0
143659,10000,100,0,1,5,0,5,0,0,0,0,0,0,0,0,0,0,0,0,0,0,0,5,0,5,0,0,0,0,0,0,0,0,0
143853,10000,100,0,1,14,7,7,0,0,0,3,1,2,0,0,0,1,1,0,0,0,0,8,4,4,0,0,0,2,1,1,0,0,0
143978,10000,100,0,1,11,4,7,0,0,0,1,1,0,2,1,1,2,1,1,0,0,0,5,1,4,1,0,1,0,0,0,0,0,0
144005,10000,100,0,1,50,30,20,0,0,0,1,0,1,18,10,8,3,0,3,0,0,0,8,6,2,0,0,0,19,13,6,1,1,0
144014,10000,100,0,1,4,3,1,0,0,0,1,0,1,2,2,0,1,1,0,0,0,0,0,0,0,0,0,0,0,0,0,0,0,0
144050,10000,100,0,1,1457,648,809,0,0,0,160,61,99,182,56,126,124,48,76,0,0,0,604,254,350,37,17,20,48,22,26,302,190,112
144157,10000,100,0,1,6,4,2,0,0,0,1,0,1,3,2,1,0,0,0,0,0,0,1,1,0,1,1,0,0,0,0,0,0,0
144166,10000,100,0,1,22,8,14,0,0,0,0,0,0,13,4,9,4,1,3,0,0,0,4,2,2,0,0,0,0,0,0,1,1,0
144175,10000,100,0,1,5,2,3,0,0,0,0,0,0,1,1,0,0,0,0,0,0,0,4,1,3,0,0,0,0,0,0,0,0,0
144184,10000,100,0,1,17,7,10,0,0,0,0,0,0,7,4,3,3,0,3,0,0,0,4,1,3,1,0,1,2,2,0,0,0,0
144193,10000,100,0,1,4,2,2,0,0,0,1,0,1,0,0,0,0,0,0,0,0,0,2,1,1,1,1,0,0,0,0,0,0,0
144209,10000,100,0,1,13,1,12,0,0,0,1,0,1,6,1,5,0,0,0,0,0,0,5,0,5,1,0,1,0,0,0,0,0,0
144218,10000,100,0,1,3,1,2,0,0,0,0,0,0,0,0,0,2,0,2,0,0,0,1,1,0,0,0,0,0,0,0,0,0,0
144281,10000,100,0,1,44,20,24,0,0,0,2,1,1,9,4,5,5,3,2,0,0,0,20,8,12,1,1,0,7,3,4,0,0,0
144351,10000,100,0,1,69,30,39,0,0,0,0,0,0,7,4,3,9,2,7,0,0,0,48,22,26,2,1,1,1,1,0,2,0,2
144485,10000,100,0,1,2,1,1,0,0,0,1,1,0,0,0,0,0,0,0,0,0,0,1,0,1,0,0,0,0,0,0,0,0,0
144500,10000,100,0,1,45,14,31,0,0,0,2,1,1,19,6,13,9,2,7,0,0,0,13,4,9,2,1,1,0,0,0,0,0,0
144564,10000,100,0,1,11,5,6,0,0,0,0,0,0,0,0,0,0,0,0,0,0,0,10,5,5,1,0,1,0,0,0,0,0,0
144740,10000,100,0,1,126,53,73,0,0,0,9,3,6,20,8,12,20,9,11,0,0,0,56,20,36,2,1,1,16,11,5,3,1,2
144777,10000,100,0,1,99,22,77,0,0,0,2,0,2,18,3,15,11,2,9,0,0,0,57,17,40,2,0,2,9,0,9,0,0,0
144865,10000,100,0,1,49,18,31,0,0,0,2,2,0,6,2,4,8,3,5,0,0,0,33,11,22,0,0,0,0,0,0,0,0,0
144892,10000,100,0,1,60,29,31,0,0,0,1,1,0,3,3,0,1,1,0,0,0,0,43,19,24,0,0,0,9,4,5,3,1,2
144944,10000,100,0,1,48,16,32,0,0,0,7,2,5,5,2,3,6,1,5,0,0,0,28,10,18,2,1,1,0,0,0,0,0,0
144962,10000,100,0,1,47,17,30,0,0,0,1,1,0,1,1,0,6,1,5,0,0,0,33,13,20,0,0,0,6,1,5,0,0,0
144971,10000,100,0,1,19,7,12,0,0,0,0,0,0,2,2,0,1,1,0,0,0,0,14,3,11,1,1,0,1,0,1,0,0,0
145239,10000,100,0,1,4,0,4,0,0,0,0,0,0,1,0,1,0,0,0,0,0,0,3,0,3,0,0,0,0,0,0,0,0,0
145275,10000,100,0,1,9,2,7,0,0,0,0,0,0,5,0,5,2,1,1,0,0,0,2,1,1,0,0,0,0,0,0,0,0,0
145336,10000,100,0,1,73,25,48,1,0,1,7,3,4,23,5,18,5,2,3,0,0,0,27,12,15,0,0,0,10,3,7,0,0,0
145372,10000,100,0,1,52,22,30,0,0,0,2,0,2,6,2,4,0,0,0,0,0,0,44,20,24,0,0,0,0,0,0,0,0,0
145497,10000,100,0,1,5,2,3,0,0,0,0,0,0,0,0,0,2,1,1,0,0,0,2,0,2,0,0,0,1,1,0,0,0,0
145521,10000,100,0,1,10,6,4,0,0,0,0,0,0,1,1,0,2,2,0,0,0,0,7,3,4,0,0,0,0,0,0,0,0,0
145558,10000,100,0,1,102,50,52,0,0,0,37,19,18,11,6,5,8,5,3,0,0,0,45,19,26,1,1,0,0,0,0,0,0,0
145600,10000,100,0,1,1050,301,749,4,1,3,183,58,125,220,52,168,196,58,138,0,0,0,372,106,266,27,9,18,18,5,13,30,12,18
145619,10000,100,0,1,26,13,13,0,0,0,0,0,0,2,2,0,3,1,2,1,1,0,20,9,11,0,0,0,0,0,0,0,0,0
145628,10000,100,0,1,19,7,12,0,0,0,1,1,0,4,2,2,10,3,7,0,0,0,4,1,3,0,0,0,0,0,0,0,0,0
145637,10000,100,0,1,714,321,393,4,3,1,44,19,25,72,41,31,50,19,31,0,0,0,476,204,272,22,11,11,4,2,2,42,22,20
145646,10000,100,0,1,47,19,28,0,0,0,1,0,1,7,2,5,3,1,2,0,0,0,32,13,19,3,2,1,0,0,0,1,1,0
145682,10000,100,0,1,46,16,30,0,0,0,1,0,1,3,0,3,0,0,0,0,0,0,40,15,25,1,0,1,0,0,0,1,1,0
145691,10000,100,0,1,44,19,25,0,0,0,1,0,1,2,1,1,3,1,2,0,0,0,37,16,21,1,1,0,0,0,0,0,0,0
145707,10000,100,0,1,6,2,4,0,0,0,0,0,0,0,0,0,0,0,0,0,0,0,6,2,4,0,0,0,0,0,0,0,0,0
145725,10000,100,0,1,99,53,46,0,0,0,8,5,3,13,7,6,1,1,0,0,0,0,12,7,5,2,0,2,50,24,26,13,9,4
145813,10000,100,0,1,136,54,82,0,0,0,1,1,0,7,3,4,5,1,4,0,0,0,81,33,48,2,2,0,35,12,23,5,2,3
145831,10000,100,0,1,17,9,8,0,0,0,0,0,0,0,0,0,1,1,0,0,0,0,16,8,8,0,0,0,0,0,0,0,0,0
146205,10000,100,0,1,30,12,18,0,0,0,1,1,0,0,0,0,0,0,0,0,0,0,29,11,18,0,0,0,0,0,0,0,0,0
146278,10000,100,0,1,10,4,6,0,0,0,0,0,0,0,0,0,0,0,0,0,0,0,9,4,5,0,0,0,1,0,1,0,0,0
146296,10000,100,0,1,32,17,15,0,0,0,1,0,1,8,3,5,3,1,2,0,0,0,16,11,5,0,0,0,4,2,2,0,0,0
146339,10000,100,0,1,26,13,13,0,0,0,0,0,0,5,1,4,2,1,1,0,0,0,14,10,4,2,0,2,1,0,1,2,1,1
146348,10000,100,0,1,22,11,11,0,0,0,0,0,0,5,3,2,5,2,3,0,0,0,10,4,6,0,0,0,2,2,0,0,0,0
146366,10000,100,0,1,18,5,13,0,0,0,0,0,0,0,0,0,0,0,0,0,0,0,17,5,12,1,0,1,0,0,0,0,0,0
146418,10000,100,0,1,17,5,12,0,0,0,0,0,0,2,0,2,4,2,2,0,0,0,11,3,8,0,0,0,0,0,0,0,0,0
146427,10000,100,0,1,55,20,35,0,0,0,1,1,0,8,5,3,3,2,1,0,0,0,38,9,29,0,0,0,4,2,2,1,1,0
146472,10000,100,0,1,90,34,56,0,0,0,8,1,7,9,3,6,26,9,17,0,0,0,45,20,25,2,1,1,0,0,0,0,0,0
146481,10000,100,0,1,35,22,13,0,0,0,5,3,2,6,4,2,5,3,2,0,0,0,17,11,6,1,1,0,0,0,0,1,0,1
146490,10000,100,0,1,7,2,5,0,0,0,0,0,0,1,0,1,0,0,0,0,0,0,6,2,4,0,0,0,0,0,0,0,0,0
146506,10000,100,0,1,31,18,13,0,0,0,0,0,0,1,1,0,0,0,0,0,0,0,27,16,11,0,0,0,3,1,2,0,0,0
146533,10000,100,0,1,2,0,2,0,0,0,0,0,0,0,0,0,0,0,0,0,0,0,2,0,2,0,0,0,0,0,0,0,0,0
146603,10000,100,0,1,19,4,15,0,0,0,0,0,0,2,0,2,2,0,2,0,0,0,12,3,9,0,0,0,3,1,2,0,0,0
146612,10000,100,0,1,55,26,29,0,0,0,0,0,0,2,0,2,5,3,2,0,0,0,39,19,20,0,0,0,9,4,5,0,0,0
146667,10000,100,0,1,9,2,7,0,0,0,0,0,0,0,0,0,0,0,0,0,0,0,9,2,7,0,0,0,0,0,0,0,0,0
146676,10000,100,0,1,28,18,10,0,0,0,0,0,0,4,3,1,0,0,0,0,0,0,24,15,9,0,0,0,0,0,0,0,0,0
146685,10000,100,0,1,39,19,20,0,0,0,2,2,0,4,2,2,1,1,0,0,0,0,30,12,18,0,0,0,2,2,0,0,0,0
146700,10000,100,0,1,19,9,10,0,0,0,0,0,0,7,2,5,5,1,4,0,0,0,7,6,1,0,0,0,0,0,0,0,0,0
146719,10000,100,0,1,311,133,178,0,0,0,28,15,13,37,15,22,42,20,22,0,0,0,164,68,96,4,1,3,11,2,9,25,12,13
146728,10000,100,0,1,7,4,3,0,0,0,0,0,0,3,1,2,3,2,1,0,0,0,1,1,0,0,0,0,0,0,0,0,0,0
146755,10000,100,0,1,7,1,6,0,0,0,0,0,0,0,0,0,0,0,0,0,0,0,7,1,6,0,0,0,0,0,0,0,0,0
146816,10000,100,0,1,4,2,2,0,0,0,1,0,1,1,1,0,0,0,0,0,0,0,2,1,1,0,0,0,0,0,0,0,0,0
146977,10000,100,0,1,3,0,3,0,0,0,0,0,0,3,0,3,0,0,0,0,0,0,0,0,0,0,0,0,0,0,0,0,0,0
147004,10000,100,0,1,25,11,14,0,0,0,0,0,0,2,2,0,5,3,2,0,0,0,17,6,11,0,0,0,1,0,1,0,0,0
147013,10000,100,0,1,46,21,25,1,0,1,0,0,0,6,4,2,2,2,0,1,1,0,36,14,22,0,0,0,0,0,0,0,0,0
147129,10000,100,0,1,4,1,3,0,0,0,0,0,0,1,0,1,0,0,0,0,0,0,3,1,2,0,0,0,0,0,0,0,0,0
147244,10000,100,0,1,57,27,30,0,0,0,1,1,0,4,3,1,2,2,0,0,0,0,47,19,28,2,2,0,0,0,0,1,0,1
147341,10000,100,0,1,13,8,5,0,0,0,0,0,0,0,0,0,0,0,0,0,0,0,12,7,5,0,0,0,0,0,0,1,1,0
147369,10000,100,0,1,59,35,24,0,0,0,4,3,1,8,4,4,11,6,5,1,1,0,35,21,14,0,0,0,0,0,0,0,0,0
147378,10000,100,0,1,18,8,10,0,0,0,1,0,1,3,1,2,5,3,2,0,0,0,9,4,5,0,0,0,0,0,0,0,0,0
147411,10000,100,0,1,4,2,2,0,0,0,0,0,0,0,0,0,1,0,1,0,0,0,2,1,1,0,0,0,1,1,0,0,0,0
147536,10000,100,0,1,119,42,77,0,0,0,6,2,4,27,10,17,25,8,17,0,0,0,52,17,35,2,1,1,0,0,0,7,4,3
147590,10000,100,0,1,8,1,7,0,0,0,0,0,0,0,0,0,1,0,1,0,0,0,6,1,5,1,0,1,0,0,0,0,0,0
147660,10000,100,0,1,40,19,21,0,0,0,3,1,2,5,2,3,4,2,2,0,0,0,23,12,11,1,1,0,2,0,2,2,1,1
147679,10000,100,0,1,26,10,16,0,0,0,5,2,3,4,1,3,8,3,5,0,0,0,9,4,5,0,0,0,0,0,0,0,0,0
147697,10000,100,0,1,9,4,5,0,0,0,0,0,0,1,0,1,0,0,0,0,0,0,8,4,4,0,0,0,0,0,0,0,0,0
147703,10000,100,0,1,103,45,58,0,0,0,5,2,3,13,5,8,7,2,5,0,0,0,58,27,31,1,0,1,2,1,1,17,8,9
147767,10000,100,0,1,1687,746,941,0,0,0,180,74,106,158,56,102,158,63,95,0,0,0,686,267,419,35,10,25,25,9,16,445,267,178
147776,10000,100,0,1,28,17,11,0,0,0,5,2,3,3,2,1,6,4,2,0,0,0,9,6,3,0,0,0,5,3,2,0,0,0
147800,10000,100,0,1,28,7,21,0,0,0,2,0,2,0,0,0,2,1,1,0,0,0,13,3,10,0,0,0,11,3,8,0,0,0
147828,10000,100,0,1,30,14,16,0,0,0,1,0,1,2,1,1,0,0,0,0,0,0,27,13,14,0,0,0,0,0,0,0,0,0
147916,10000,100,0,1,16,9,7,0,0,0,0,0,0,1,1,0,1,1,0,0,0,0,7,3,4,0,0,0,7,4,3,0,0,0
148007,10000,100,0,1,4,0,4,0,0,0,0,0,0,3,0,3,0,0,0,0,0,0,1,0,1,0,0,0,0,0,0,0,0,0
148016,10000,100,0,1,8,4,4,0,0,0,0,0,0,0,0,0,0,0,0,0,0,0,3,1,2,0,0,0,5,3,2,0,0,0
148131,10000,100,0,1,27,13,14,0,0,0,0,0,0,1,1,0,0,0,0,0,0,0,26,12,14,0,0,0,0,0,0,0,0,0
148256,10000,100,0,1,14,3,11,0,0,0,0,0,0,1,1,0,0,0,0,0,0,0,13,2,11,0,0,0,0,0,0,0,0,0
148292,10000,100,0,1,14,6,8,0,0,0,1,0,1,2,2,0,0,0,0,0,0,0,10,4,6,1,0,1,0,0,0,0,0,0
148380,10000,100,0,1,31,15,16,0,0,0,0,0,0,9,5,4,5,2,3,0,0,0,15,7,8,0,0,0,2,1,1,0,0,0
148405,10000,100,0,1,20,1,19,0,0,0,0,0,0,0,0,0,0,0,0,0,0,0,19,1,18,1,0,1,0,0,0,0,0,0
148487,10000,100,0,1,70,32,38,0,0,0,1,1,0,7,2,5,7,4,3,0,0,0,15,7,8,1,1,0,34,14,20,5,3,2
148496,10000,100,0,1,54,15,39,0,0,0,5,2,3,7,2,5,16,3,13,0,0,0,22,7,15,3,1,2,1,0,1,0,0,0
148511,10000,100,0,1,267,86,181,1,0,1,50,17,33,36,9,27,43,8,35,0,0,0,124,47,77,8,4,4,5,1,4,0,0,0
148575,10000,100,0,1,6,3,3,0,0,0,0,0,0,0,0,0,0,0,0,0,0,0,6,3,3,0,0,0,0,0,0,0,0,0
148584,10000,100,0,1,12,1,11,0,0,0,1,0,1,4,0,4,0,0,0,0,0,0,7,1,6,0,0,0,0,0,0,0,0,0
148593,10000,100,0,1,3,0,3,0,0,0,0,0,0,0,0,0,0,0,0,0,0,0,3,0,3,0,0,0,0,0,0,0,0,0
148627,10000,100,0,1,33,12,21,0,0,0,2,0,2,2,0,2,3,0,3,0,0,0,5,2,3,1,0,1,20,10,10,0,0,0
148654,10000,100,0,1,50,20,30,0,0,0,1,1,0,3,2,1,1,1,0,0,0,0,42,16,26,3,0,3,0,0,0,0,0,0
148672,10000,100,0,1,11,6,5,0,0,0,0,0,0,0,0,0,1,1,0,0,0,0,10,5,5,0,0,0,0,0,0,0,0,0
148821,10000,100,0,1,9,1,8,0,0,0,0,0,0,0,0,0,0,0,0,0,0,0,9,1,8,0,0,0,0,0,0,0,0,0
148876,10000,100,0,1,15,6,9,0,0,0,2,1,1,0,0,0,10,4,6,0,0,0,3,1,2,0,0,0,0,0,0,0,0,0
148885,10000,100,0,1,17,8,9,0,0,0,1,1,0,1,1,0,8,1,7,0,0,0,7,5,2,0,0,0,0,0,0,0,0,0
148937,10000,100,0,1,3,2,1,0,0,0,0,0,0,0,0,0,0,0,0,0,0,0,3,2,1,0,0,0,0,0,0,0,0,0
148982,10000,100,0,1,3,2,1,0,0,0,0,0,0,0,0,0,0,0,0,0,0,0,3,2,1,0,0,0,0,0,0,0,0,0
148991,10000,100,0,1,5,1,4,0,0,0,0,0,0,0,0,0,0,0,0,0,0,0,5,1,4,0,0,0,0,0,0,0,0,0
149028,10000,100,0,1,2,0,2,0,0,0,0,0,0,1,0,1,0,0,0,0,0,0,1,0,1,0,0,0,0,0,0,0,0,0
149222,10000,100,0,1,523,173,350,1,0,1,21,10,11,65,22,43,17,7,10,0,0,0,394,123,271,14,3,11,0,0,0,11,8,3
149231,10000,100,0,1,119,47,72,0,0,0,2,1,1,31,9,22,5,1,4,0,0,0,77,33,44,1,1,0,1,1,0,2,1,1
149240,10000,100,0,1,1,0,1,0,0,0,0,0,0,1,0,1,0,0,0,0,0,0,0,0,0,0,0,0,0,0,0,0,0,0
149329,10000,100,0,1,6,6,0,0,0,0,0,0,0,0,0,0,4,4,0,0,0,0,2,2,0,0,0,0,0,0,0,0,0,0
149365,10000,100,0,1,56,11,45,0,0,0,1,1,0,26,3,23,4,1,3,1,0,1,23,5,18,0,0,0,1,1,0,0,0,0
149505,10000,100,0,1,22,8,14,0,0,0,1,1,0,4,1,3,5,3,2,0,0,0,11,2,9,1,1,0,0,0,0,0,0,0
149514,10000,100,0,1,21,9,12,1,0,1,1,0,1,3,3,0,1,0,1,0,0,0,15,6,9,0,0,0,0,0,0,0,0,0
149532,10000,100,0,1,17,8,9,0,0,0,3,3,0,3,2,1,4,1,3,0,0,0,5,1,4,0,0,0,2,1,1,0,0,0
149587,10000,100,0,1,88,41,47,0,0,0,6,4,2,20,7,13,7,3,4,0,0,0,51,25,26,2,1,1,1,1,0,1,0,1
149639,10000,100,0,1,2,1,1,0,0,0,0,0,0,0,0,0,1,0,1,0,0,0,1,1,0,0,0,0,0,0,0,0,0,0
149727,10000,100,0,1,49,24,25,0,0,0,4,1,3,3,1,2,13,6,7,0,0,0,26,15,11,0,0,0,1,0,1,2,1,1
149763,10000,100,0,1,9,3,6,0,0,0,2,1,1,2,1,1,1,0,1,0,0,0,4,1,3,0,0,0,0,0,0,0,0,0
149772,10000,100,0,1,81,38,43,2,1,1,3,3,0,2,1,1,0,0,0,0,0,0,73,33,40,0,0,0,1,0,1,0,0,0
149781,10000,100,0,1,66,28,38,0,0,0,10,4,6,7,3,4,3,2,1,0,0,0,38,15,23,0,0,0,7,4,3,1,0,1
149842,10000,100,0,1,55,21,34,0,0,0,2,2,0,6,0,6,11,3,8,0,0,0,34,15,19,0,0,0,2,1,1,0,0,0
150066,10000,100,0,1,34,17,17,0,0,0,1,1,0,3,1,2,2,1,1,0,0,0,28,14,14,0,0,0,0,0,0,0,0,0
150136,10000,100,0,1,28,9,19,0,0,0,1,1,0,5,2,3,1,1,0,0,0,0,20,5,15,1,0,1,0,0,0,0,0,0
150145,10000,100,0,1,26,9,17,0,0,0,1,1,0,0,0,0,0,0,0,0,0,0,25,8,17,0,0,0,0,0,0,0,0,0
150163,10000,100,0,1,120,45,75,0,0,0,8,3,5,14,5,9,5,1,4,0,0,0,88,34,54,1,1,0,4,1,3,0,0,0
150172,10000,100,0,1,14,9,5,0,0,0,0,0,0,0,0,0,3,1,2,0,0,0,11,8,3,0,0,0,0,0,0,0,0,0
150215,10000,100,0,1,1,0,1,0,0,0,0,0,0,1,0,1,0,0,0,0,0,0,0,0,0,0,0,0,0,0,0,0,0,0
150288,10000,100,0,1,7,6,1,0,0,0,0,0,0,0,0,0,1,0,1,0,0,0,6,6,0,0,0,0,0,0,0,0,0,0
150400,10000,100,0,1,44,19,25,0,0,0,4,1,3,5,4,1,5,4,1,0,0,0,30,10,20,0,0,0,0,0,0,0,0,0
150455,10000,100,0,1,68,30,38,0,0,0,2,2,0,11,5,6,4,3,1,0,0,0,45,18,27,1,1,0,0,0,0,5,1,4
150534,10000,100,0,1,54,24,30,0,0,0,0,0,0,0,0,0,0,0,0,0,0,0,18,6,12,1,0,1,35,18,17,0,0,0
150604,10000,100,0,1,35,13,22,0,0,0,0,0,0,3,2,1,1,0,1,0,0,0,29,10,19,0,0,0,1,1,0,1,0,1
150668,10000,100,0,1,21,9,12,0,0,0,0,0,0,1,0,1,2,1,1,0,0,0,18,8,10,0,0,0,0,0,0,0,0,0
150677,10000,100,0,1,8,5,3,0,0,0,0,0,0,1,1,0,0,0,0,0,0,0,6,4,2,0,0,0,1,0,1,0,0,0
150756,10000,100,0,1,26,16,10,0,0,0,0,0,0,3,2,1,2,2,0,0,0,0,21,12,9,0,0,0,0,0,0,0,0,0
150774,10000,100,0,1,10,5,5,0,0,0,0,0,0,1,0,1,1,1,0,0,0,0,8,4,4,0,0,0,0,0,0,0,0,0
150941,10000,100,0,1,30,9,21,0,0,0,2,1,1,0,0,0,3,2,1,0,0,0,25,6,19,0,0,0,0,0,0,0,0,0
150987,10000,100,0,1,384,140,244,0,0,0,6,1,5,50,12,38,13,2,11,0,0,0,308,123,185,3,1,2,4,1,3,0,0,0
151102,10000,100,0,1,71,32,39,0,0,0,2,2,0,5,2,3,2,0,2,0,0,0,58,26,32,1,0,1,1,1,0,2,1,1
151111,10000,100,0,1,880,338,542,0,0,0,83,27,56,77,26,51,46,16,30,0,0,0,564,208,356,22,5,17,0,0,0,88,56,32
151263,10000,100,0,1,80,30,50,0,0,0,2,0,2,8,5,3,3,1,2,0,0,0,63,22,41,4,2,2,0,0,0,0,0,0
151290,10000,100,0,1,43,15,28,0,0,0,3,2,1,5,1,4,1,1,0,0,0,0,32,10,22,0,0,0,0,0,0,2,1,1
151306,10000,100,0,1,85,32,53,0,0,0,4,1,3,3,2,1,0,0,0,0,0,0,69,24,45,4,2,2,1,0,1,4,3,1
151324,10000,100,0,1,146,65,81,0,0,0,5,0,5,12,6,6,8,3,5,0,0,0,114,53,61,7,3,4,0,0,0,0,0,0
151333,10000,100,0,1,23,10,13,0,0,0,1,1,0,1,1,0,0,0,0,0,0,0,17,6,11,1,1,0,0,0,0,3,1,2
151342,10000,100,0,1,46,20,26,0,0,0,0,0,0,6,1,5,2,2,0,0,0,0,35,15,20,3,2,1,0,0,0,0,0,0
151351,10000,100,0,1,690,318,372,4,2,2,30,11,19,41,19,22,44,18,26,0,0,0,472,217,255,12,5,7,2,1,1,85,45,40
151360,10000,100,0,1,28,11,17,0,0,0,0,0,0,9,3,6,5,1,4,0,0,0,13,6,7,0,0,0,0,0,0,1,1,0
151379,10000,100,0,1,28,8,20,0,0,0,1,0,1,3,1,2,0,0,0,0,0,0,23,7,16,0,0,0,0,0,0,1,0,1
151388,10000,100,0,1,14,10,4,0,0,0,0,0,0,0,0,0,0,0,0,0,0,0,14,10,4,0,0,0,0,0,0,0,0,0
151467,10000,100,0,1,1,0,1,0,0,0,0,0,0,0,0,0,0,0,0,0,0,0,1,0,1,0,0,0,0,0,0,0,0,0
151661,10000,100,0,1,37,19,18,0,0,0,1,0,1,3,2,1,2,0,2,0,0,0,30,17,13,1,0,1,0,0,0,0,0,0
151777,10000,100,0,1,53,26,27,1,0,1,1,1,0,1,0,1,2,0,2,0,0,0,45,23,22,2,1,1,1,1,0,0,0,0
151786,10000,100,0,1,133,48,85,0,0,0,1,1,0,14,3,11,13,6,7,0,0,0,102,38,64,1,0,1,2,0,2,0,0,0
151801,10000,100,0,1,93,33,60,0,0,0,1,1,0,9,1,8,5,3,2,0,0,0,74,26,48,1,0,1,3,2,1,0,0,0
151810,10000,100,0,1,17,7,10,0,0,0,0,0,0,15,6,9,0,0,0,0,0,0,2,1,1,0,0,0,0,0,0,0,0,0
151865,10000,100,0,1,3,1,2,0,0,0,0,0,0,0,0,0,0,0,0,0,0,0,3,1,2,0,0,0,0,0,0,0,0,0
152080,10000,100,0,1,664,329,335,3,2,1,23,12,11,48,24,24,61,29,32,0,0,0,341,166,175,23,9,14,57,26,31,108,61,47
152099,10000,100,0,1,52,31,21,0,0,0,2,0,2,2,2,0,0,0,0,0,0,0,47,28,19,0,0,0,1,1,0,0,0,0
152318,10000,100,0,1,39,22,17,0,0,0,1,0,1,2,0,2,0,0,0,0,0,0,32,20,12,0,0,0,0,0,0,4,2,2
152336,10000,100,0,1,21,5,16,0,0,0,0,0,0,0,0,0,2,1,1,0,0,0,19,4,15,0,0,0,0,0,0,0,0,0
152381,10000,100,0,1,25,10,15,0,0,0,0,0,0,2,2,0,2,0,2,0,0,0,21,8,13,0,0,0,0,0,0,0,0,0
152390,10000,100,0,1,73,21,52,0,0,0,0,0,0,3,2,1,2,1,1,0,0,0,49,9,40,0,0,0,3,2,1,16,7,9
152451,10000,100,0,1,1,1,0,0,0,0,0,0,0,0,0,0,0,0,0,0,0,0,1,1,0,0,0,0,0,0,0,0,0,0
152530,10000,100,0,1,42,21,21,0,0,0,1,0,1,0,0,0,0,0,0,0,0,0,38,19,19,1,1,0,0,0,0,2,1,1
152567,10000,100,0,1,59,29,30,0,0,0,0,0,0,0,0,0,0,0,0,0,0,0,53,24,29,1,1,0,5,4,1,0,0,0
152600,10000,100,0,1,16,4,12,0,0,0,0,0,0,0,0,0,1,0,1,0,0,0,7,1,6,0,0,0,8,3,5,0,0,0
152637,10000,100,0,1,149,58,91,1,0,1,1,1,0,10,3,7,1,1,0,0,0,0,134,53,81,1,0,1,0,0,0,1,0,1
152673,10000,100,0,1,25,15,10,0,0,0,1,0,1,2,2,0,0,0,0,0,0,0,22,13,9,0,0,0,0,0,0,0,0,0
152798,10000,100,0,1,9,4,5,0,0,0,0,0,0,0,0,0,0,0,0,0,0,0,9,4,5,0,0,0,0,0,0,0,0,0
152992,10000,100,0,1,34,19,15,0,0,0,0,0,0,2,2,0,1,0,1,0,0,0,22,13,9,1,0,1,7,3,4,1,1,0
153001,10000,100,0,1,44,21,23,0,0,0,0,0,0,3,1,2,7,2,5,0,0,0,34,18,16,0,0,0,0,0,0,0,0,0
153108,10000,100,0,1,27,10,17,0,0,0,0,0,0,1,0,1,0,0,0,0,0,0,25,9,16,0,0,0,0,0,0,1,1,0
153126,10000,100,0,1,32,10,22,0,0,0,2,0,2,1,0,1,1,0,1,0,0,0,28,10,18,0,0,0,0,0,0,0,0,0
153144,10000,100,0,1,56,26,30,0,0,0,1,0,1,9,5,4,4,1,3,0,0,0,40,20,20,1,0,1,1,0,1,0,0,0
153162,10000,100,0,1,32,15,17,0,0,0,1,0,1,1,1,0,1,1,0,0,0,0,27,13,14,0,0,0,0,0,0,2,0,2
153214,10000,100,0,1,69,30,39,0,0,0,4,2,2,4,2,2,4,4,0,0,0,0,56,22,34,1,0,1,0,0,0,0,0,0
153241,10000,100,0,1,4,1,3,0,0,0,0,0,0,0,0,0,0,0,0,0,0,0,3,1,2,0,0,0,0,0,0,1,0,1
153250,10000,100,0,1,23,10,13,0,0,0,0,0,0,0,0,0,1,1,0,0,0,0,22,9,13,0,0,0,0,0,0,0,0,0
153269,10000,100,0,1,125,53,72,0,0,0,3,1,2,13,6,7,8,3,5,0,0,0,89,37,52,1,1,0,2,1,1,9,4,5
153278,10000,100,0,1,56,29,27,0,0,0,0,0,0,1,1,0,5,3,2,0,0,0,48,23,25,1,1,0,1,1,0,0,0,0
153296,10000,100,0,1,8,4,4,0,0,0,1,1,0,0,0,0,0,0,0,0,0,0,7,3,4,0,0,0,0,0,0,0,0,0
153302,10000,100,0,1,6,2,4,0,0,0,0,0,0,0,0,0,0,0,0,0,0,0,6,2,4,0,0,0,0,0,0,0,0,0
153311,10000,100,0,1,44,12,32,0,0,0,0,0,0,3,1,2,1,0,1,0,0,0,39,11,28,1,0,1,0,0,0,0,0,0
153320,10000,100,0,1,7,2,5,0,0,0,0,0,0,0,0,0,0,0,0,0,0,0,7,2,5,0,0,0,0,0,0,0,0,0
153366,10000,100,0,1,54,22,32,0,0,0,3,2,1,1,0,1,2,1,1,0,0,0,48,19,29,0,0,0,0,0,0,0,0,0
153375,10000,100,0,1,26,9,17,0,0,0,3,1,2,2,1,1,0,0,0,0,0,0,20,7,13,1,0,1,0,0,0,0,0,0
153384,10000,100,0,1,66,29,37,0,0,0,3,0,3,3,2,1,2,1,1,0,0,0,56,25,31,1,0,1,1,1,0,0,0,0
153445,10000,100,0,1,24,6,18,0,0,0,0,0,0,3,3,0,4,1,3,0,0,0,16,2,14,1,0,1,0,0,0,0,0,0
153472,10000,100,0,1,51,25,26,0,0,0,0,0,0,3,3,0,4,1,3,0,0,0,44,21,23,0,0,0,0,0,0,0,0,0
153524,10000,100,0,1,39,20,19,0,0,0,0,0,0,4,3,1,2,1,1,0,0,0,31,15,16,0,0,0,2,1,1,0,0,0
153533,10000,100,0,1,24,15,9,0,0,0,0,0,0,1,1,0,0,0,0,0,0,0,23,14,9,0,0,0,0,0,0,0,0,0
153603,10000,100,0,1,728,323,405,4,4,0,29,14,15,16,6,10,28,13,15,0,0,0,538,213,325,14,6,8,1,0,1,98,67,31
153621,10000,100,0,1,32,13,19,0,0,0,2,1,1,4,3,1,2,0,2,0,0,0,24,9,15,0,0,0,0,0,0,0,0,0
153630,10000,100,0,1,70,34,36,0,0,0,2,0,2,4,3,1,5,4,1,0,0,0,58,27,31,0,0,0,1,0,1,0,0,0
153658,10000,100,0,1,892,392,500,3,0,3,55,25,30,45,25,20,49,16,33,1,0,1,524,211,313,6,0,6,84,38,46,125,77,48
153737,10000,100,0,1,91,37,54,1,0,1,4,2,2,6,5,1,3,1,2,0,0,0,66,24,42,1,0,1,9,5,4,1,0,1
153825,10000,100,0,1,38,18,20,0,0,0,4,2,2,3,2,1,1,0,1,0,0,0,29,14,15,0,0,0,0,0,0,1,0,1
153834,10000,100,0,1,27,9,18,0,0,0,1,0,1,1,0,1,4,1,3,0,0,0,20,8,12,0,0,0,1,0,1,0,0,0
153861,10000,100,0,1,67,32,35,1,1,0,11,8,3,2,1,1,3,2,1,0,0,0,44,16,28,2,2,0,4,2,2,0,0,0
153922,10000,100,0,1,10,4,6,0,0,0,0,0,0,0,0,0,1,0,1,0,0,0,9,4,5,0,0,0,0,0,0,0,0,0
153977,10000,100,0,1,16,5,11,0,0,0,0,0,0,0,0,0,2,0,2,0,0,0,13,5,8,1,0,1,0,0,0,0,0,0
154004,10000,100,0,1,33,14,19,0,0,0,0,0,0,2,0,2,2,1,1,0,0,0,29,13,16,0,0,0,0,0,0,0,0,0
154013,10000,100,0,1,50,22,28,0,0,0,1,1,0,7,3,4,1,1,0,0,0,0,41,17,24,0,0,0,0,0,0,0,0,0
154022,10000,100,0,1,44,17,27,0,0,0,2,1,1,12,2,10,7,3,4,0,0,0,21,11,10,0,0,0,2,0,2,0,0,0
154059,10000,100,0,1,30,14,16,0,0,0,1,0,1,0,0,0,0,0,0,0,0,0,27,13,14,1,0,1,0,0,0,1,1,0
154095,10000,100,0,1,74,31,43,0,0,0,2,1,1,2,2,0,3,1,2,0,0,0,61,25,36,0,0,0,0,0,0,6,2,4
154101,10000,100,0,1,21,8,13,0,0,0,0,0,0,0,0,0,0,0,0,0,0,0,20,7,13,0,0,0,0,0,0,1,1,0
154110,10000,100,0,1,27,12,15,0,0,0,0,0,0,1,1,0,0,0,0,0,0,0,22,9,13,0,0,0,4,2,2,0,0,0
154129,10000,100,0,1,15,5,10,1,0,1,1,0,1,1,1,0,0,0,0,0,0,0,12,4,8,0,0,0,0,0,0,0,0,0
154156,10000,100,0,1,30,11,19,0,0,0,0,0,0,1,0,1,1,0,1,0,0,0,27,11,16,1,0,1,0,0,0,0,0,0
154174,10000,100,0,1,58,21,37,0,0,0,4,2,2,1,0,1,2,0,2,0,0,0,48,17,31,2,2,0,1,0,1,0,0,0
154235,10000,100,0,1,43,17,26,0,0,0,1,0,1,3,1,2,0,0,0,0,0,0,36,15,21,0,0,0,3,1,2,0,0,0
154350,10000,100,0,1,49,24,25,0,0,0,3,3,0,3,1,2,5,3,2,0,0,0,36,15,21,0,0,0,2,2,0,0,0,0
154378,10000,100,0,1,37,14,23,0,0,0,0,0,0,1,1,0,2,1,1,0,0,0,34,12,22,0,0,0,0,0,0,0,0,0
154396,10000,100,0,1,26,10,16,0,0,0,0,0,0,3,2,1,0,0,0,0,0,0,23,8,15,0,0,0,0,0,0,0,0,0
154493,10000,100,0,1,41,19,22,0,0,0,1,0,1,4,1,3,0,0,0,1,0,1,20,9,11,0,0,0,14,9,5,1,0,1
154518,10000,100,0,1,59,21,38,0,0,0,4,1,3,11,3,8,3,2,1,0,0,0,40,15,25,1,0,1,0,0,0,0,0,0
154527,10000,100,0,1,39,16,23,0,0,0,0,0,0,2,1,1,0,0,0,0,0,0,36,15,21,1,0,1,0,0,0,0,0,0
154536,10000,100,0,1,8,1,7,0,0,0,0,0,0,0,0,0,0,0,0,0,0,0,8,1,7,0,0,0,0,0,0,0,0,0
154572,10000,100,0,1,20,10,10,0,0,0,1,0,1,0,0,0,3,1,2,0,0,0,13,8,5,1,0,1,2,1,1,0,0,0
154590,10000,100,0,1,11,3,8,0,0,0,1,0,1,0,0,0,1,1,0,0,0,0,9,2,7,0,0,0,0,0,0,0,0,0
154642,10000,100,0,1,12,8,4,0,0,0,0,0,0,2,0,2,1,1,0,0,0,0,9,7,2,0,0,0,0,0,0,0,0,0
154688,10000,100,0,1,37,16,21,0,0,0,0,0,0,2,0,2,0,0,0,0,0,0,33,15,18,0,0,0,2,1,1,0,0,0
154697,10000,100,0,1,35,14,21,0,0,0,0,0,0,3,2,1,3,1,2,0,0,0,29,11,18,0,0,0,0,0,0,0,0,0
154712,10000,100,0,1,4,3,1,0,0,0,0,0,0,0,0,0,0,0,0,0,0,0,4,3,1,0,0,0,0,0,0,0,0,0
154721,10000,100,0,1,45,24,21,0,0,0,0,0,0,7,5,2,6,1,5,0,0,0,30,16,14,2,2,0,0,0,0,0,0,0
154749,10000,100,0,1,20,9,11,0,0,0,0,0,0,3,2,1,0,0,0,0,0,0,17,7,10,0,0,0,0,0,0,0,0,0
154800,10000,100,0,1,45,24,21,1,1,0,0,0,0,1,1,0,2,2,0,0,0,0,37,18,19,4,2,2,0,0,0,0,0,0
154855,10000,100,0,1,10,5,5,0,0,0,0,0,0,0,0,0,1,1,0,0,0,0,9,4,5,0,0,0,0,0,0,0,0,0
154907,10000,100,0,1,30,18,12,0,0,0,0,0,0,1,0,1,1,0,1,0,0,0,28,18,10,0,0,0,0,0,0,0,0,0
154925,10000,100,0,1,6,3,3,0,0,0,0,0,0,0,0,0,0,0,0,0,0,0,6,3,3,0,0,0,0,0,0,0,0,0
154934,10000,100,0,1,11,4,7,0,0,0,0,0,0,0,0,0,1,0,1,1,0,1,9,4,5,0,0,0,0,0,0,0,0,0
154952,10000,100,0,1,27,14,13,0,0,0,0,0,0,2,1,1,3,1,2,0,0,0,22,12,10,0,0,0,0,0,0,0,0,0
154998,10000,100,0,1,45,16,29,0,0,0,0,0,0,3,2,1,4,2,2,0,0,0,38,12,26,0,0,0,0,0,0,0,0,0
155007,10000,100,0,1,23,8,15,0,0,0,0,0,0,3,0,3,4,2,2,0,0,0,13,4,9,2,1,1,1,1,0,0,0,0
155025,10000,100,0,1,64,22,42,0,0,0,4,2,2,2,0,2,4,1,3,0,0,0,49,17,32,1,1,0,4,1,3,0,0,0
155052,10000,100,0,1,6,1,5,0,0,0,0,0,0,0,0,0,1,0,1,0,0,0,5,1,4,0,0,0,0,0,0,0,0,0
155061,10000,100,0,1,55,25,30,0,0,0,4,1,3,2,1,1,2,1,1,0,0,0,38,19,19,5,2,3,2,1,1,2,0,2
155070,10000,100,0,1,3,1,2,0,0,0,0,0,0,0,0,0,0,0,0,0,0,0,3,1,2,0,0,0,0,0,0,0,0,0
155089,10000,100,0,1,39,17,22,1,0,1,0,0,0,5,3,2,1,1,0,0,0,0,32,13,19,0,0,0,0,0,0,0,0,0
155098,10000,100,0,1,39,19,20,0,0,0,0,0,0,1,0,1,9,5,4,0,0,0,29,14,15,0,0,0,0,0,0,0,0,0
155104,10000,100,0,1,40,24,16,0,0,0,0,0,0,5,5,0,12,5,7,0,0,0,21,13,8,2,1,1,0,0,0,0,0,0
155177,10000,100,0,1,14,6,8,0,0,0,1,1,0,0,0,0,2,1,1,0,0,0,10,3,7,1,1,0,0,0,0,0,0,0
155186,10000,100,0,1,33,14,19,0,0,0,0,0,0,1,0,1,3,2,1,0,0,0,29,12,17,0,0,0,0,0,0,0,0,0
155195,10000,100,0,1,47,24,23,1,1,0,0,0,0,4,3,1,1,1,0,0,0,0,41,19,22,0,0,0,0,0,0,0,0,0
155201,10000,100,0,1,16,8,8,0,0,0,1,1,0,0,0,0,2,0,2,0,0,0,13,7,6,0,0,0,0,0,0,0,0,0
155210,10000,100,0,1,61,19,42,0,0,0,1,1,0,5,3,2,3,0,3,0,0,0,46,13,33,3,0,3,3,2,1,0,0,0
155283,10000,100,0,1,16,5,11,0,0,0,0,0,0,3,1,2,3,0,3,0,0,0,10,4,6,0,0,0,0,0,0,0,0,0
155292,10000,100,0,1,41,13,28,0,0,0,0,0,0,6,2,4,9,2,7,0,0,0,25,8,17,1,1,0,0,0,0,0,0,0
155308,10000,100,0,1,4,3,1,0,0,0,1,1,0,0,0,0,1,1,0,0,0,0,2,1,1,0,0,0,0,0,0,0,0,0
155317,10000,100,0,1,1081,460,621,8,4,4,80,35,45,80,29,51,59,26,33,2,1,1,688,296,392,39,10,29,27,5,22,98,54,44
155335,10000,100,0,1,21,11,10,0,0,0,1,0,1,1,0,1,2,0,2,0,0,0,17,11,6,0,0,0,0,0,0,0,0,0
155399,10000,100,0,1,455,200,255,1,0,1,14,5,9,17,8,9,30,12,18,1,0,1,312,124,188,7,2,5,3,1,2,70,48,22
155414,10000,100,0,1,23,6,17,0,0,0,1,0,1,1,1,0,2,0,2,0,0,0,18,5,13,1,0,1,0,0,0,0,0,0
155450,10000,100,0,1,10,1,9,0,0,0,0,0,0,1,1,0,0,0,0,0,0,0,8,0,8,1,0,1,0,0,0,0,0,0
155487,10000,100,0,1,5,0,5,0,0,0,0,0,0,0,0,0,0,0,0,0,0,0,0,0,0,0,0,0,5,0,5,0,0,0
155511,10000,100,0,1,22,13,9,0,0,0,2,2,0,1,0,1,1,1,0,0,0,0,17,10,7,1,0,1,0,0,0,0,0,0
155566,10000,100,0,1,31,15,16,1,0,1,1,1,0,1,1,0,0,0,0,0,0,0,24,11,13,2,0,2,0,0,0,2,2,0
155593,10000,100,0,1,19,7,12,0,0,0,0,0,0,0,0,0,0,0,0,0,0,0,19,7,12,0,0,0,0,0,0,0,0,0
155618,10000,100,0,1,9,5,4,0,0,0,0,0,0,1,1,0,0,0,0,0,0,0,8,4,4,0,0,0,0,0,0,0,0,0
155627,10000,100,0,1,21,12,9,0,0,0,1,1,0,1,1,0,0,0,0,0,0,0,19,10,9,0,0,0,0,0,0,0,0,0
155636,10000,100,0,1,1,0,1,0,0,0,0,0,0,0,0,0,1,0,1,0,0,0,0,0,0,0,0,0,0,0,0,0,0,0
155681,10000,100,0,1,25,11,14,1,1,0,2,1,1,1,0,1,0,0,0,0,0,0,21,9,12,0,0,0,0,0,0,0,0,0
155715,10000,100,0,1,27,16,11,0,0,0,0,0,0,5,4,1,3,0,3,0,0,0,19,12,7,0,0,0,0,0,0,0,0,0
155812,10000,100,0,1,43,22,21,0,0,0,1,0,1,4,2,2,1,1,0,0,0,0,35,18,17,2,1,1,0,0,0,0,0,0
155830,10000,100,0,1,8,2,6,0,0,0,0,0,0,0,0,0,1,1,0,0,0,0,7,1,6,0,0,0,0,0,0,0,0,0
155858,10000,100,0,1,26,8,18,0,0,0,0,0,0,0,0,0,6,3,3,0,0,0,16,4,12,3,0,3,1,1,0,0,0,0
155900,10000,100,0,1,22,8,14,0,0,0,1,1,0,4,2,2,0,0,0,0,0,0,16,5,11,1,0,1,0,0,0,0,0,0
155937,10000,100,0,1,12,5,7,0,0,0,0,0,0,1,1,0,2,0,2,0,0,0,9,4,5,0,0,0,0,0,0,0,0,0
155973,10000,100,0,1,12,8,4,0,0,0,0,0,0,1,1,0,0,0,0,0,0,0,11,7,4,0,0,0,0,0,0,0,0,0
156082,10000,100,0,1,37,15,22,2,1,1,0,0,0,1,0,1,1,0,1,0,0,0,21,11,10,0,0,0,12,3,9,0,0,0
156107,10000,100,0,1,28,17,11,0,0,0,1,1,0,2,0,2,1,0,1,0,0,0,23,16,7,1,0,1,0,0,0,0,0,0
156125,10000,100,0,1,369,231,138,3,2,1,16,8,8,28,14,14,37,26,11,0,0,0,249,156,93,6,3,3,15,11,4,15,11,4
156134,10000,100,0,1,13,5,8,1,1,0,0,0,0,3,2,1,2,0,2,0,0,0,7,2,5,0,0,0,0,0,0,0,0,0
156189,10000,100,0,1,15,7,8,0,0,0,0,0,0,0,0,0,0,0,0,0,0,0,15,7,8,0,0,0,0,0,0,0,0,0
156213,10000,100,0,1,38,9,29,0,0,0,3,1,2,2,0,2,1,0,1,0,0,0,32,8,24,0,0,0,0,0,0,0,0,0
156222,10000,100,0,1,19,10,9,0,0,0,2,1,1,2,1,1,1,0,1,0,0,0,14,8,6,0,0,0,0,0,0,0,0,0
156231,10000,100,0,1,5,1,4,0,0,0,0,0,0,0,0,0,0,0,0,0,0,0,4,0,4,0,0,0,1,1,0,0,0,0
156286,10000,100,0,1,60,26,34,0,0,0,2,0,2,6,2,4,2,1,1,0,0,0,45,23,22,4,0,4,0,0,0,1,0,1
156295,10000,100,0,1,86,26,60,1,1,0,4,1,3,9,1,8,4,1,3,0,0,0,65,21,44,1,0,1,0,0,0,2,1,1
156338,10000,100,0,1,18,5,13,0,0,0,0,0,0,2,1,1,0,0,0,0,0,0,11,3,8,1,1,0,4,0,4,0,0,0
156356,10000,100,0,1,19,8,11,0,0,0,0,0,0,2,1,1,0,0,0,0,0,0,14,6,8,0,0,0,3,1,2,0,0,0
156365,10000,100,0,1,68,31,37,0,0,0,0,0,0,5,3,2,0,0,0,0,0,0,55,24,31,0,0,0,8,4,4,0,0,0
156392,10000,100,0,1,37,12,25,0,0,0,2,1,1,3,1,2,2,1,1,0,0,0,27,8,19,2,1,1,1,0,1,0,0,0
156408,10000,100,0,1,72,34,38,0,0,0,3,1,2,11,5,6,1,1,0,0,0,0,51,24,27,3,2,1,3,1,2,0,0,0
156471,10000,100,0,1,26,3,23,0,0,0,0,0,0,4,0,4,0,0,0,0,0,0,21,2,19,1,1,0,0,0,0,0,0,0
156541,10000,100,0,1,92,45,47,0,0,0,1,1,0,11,8,3,0,0,0,0,0,0,77,36,41,0,0,0,3,0,3,0,0,0
156620,10000,100,0,1,353,157,196,0,0,0,1,1,0,17,5,12,7,2,5,0,0,0,289,135,154,20,8,12,3,2,1,16,4,12
156648,10000,100,0,1,15,4,11,0,0,0,0,0,0,0,0,0,0,0,0,0,0,0,14,4,10,0,0,0,1,0,1,0,0,0
156727,10000,100,0,1,34,10,24,0,0,0,1,0,1,6,1,5,1,0,1,0,0,0,24,9,15,2,0,2,0,0,0,0,0,0
156745,10000,100,0,1,27,13,14,0,0,0,1,1,0,3,3,0,1,1,0,0,0,0,19,6,13,1,1,0,1,1,0,1,0,1
156790,10000,100,0,1,6,1,5,0,0,0,0,0,0,0,0,0,1,0,1,0,0,0,5,1,4,0,0,0,0,0,0,0,0,0
156851,10000,100,0,1,5,1,4,0,0,0,0,0,0,0,0,0,0,0,0,0,0,0,4,1,3,0,0,0,1,0,1,0,0,0
156860,10000,100,0,1,17,4,13,0,0,0,0,0,0,1,0,1,2,2,0,0,0,0,14,2,12,0,0,0,0,0,0,0,0,0
156921,10000,100,0,1,43,14,29,1,1,0,2,1,1,15,4,11,0,0,0,0,0,0,24,8,16,1,0,1,0,0,0,0,0,0
157021,10000,100,0,1,18,5,13,0,0,0,0,0,0,7,1,6,1,0,1,0,0,0,10,4,6,0,0,0,0,0,0,0,0,0
157030,10000,100,0,1,1,1,0,0,0,0,0,0,0,0,0,0,0,0,0,0,0,0,1,1,0,0,0,0,0,0,0,0,0,0
157058,10000,100,0,1,76,36,40,1,0,1,2,0,2,27,10,17,2,2,0,0,0,0,16,6,10,1,1,0,27,17,10,0,0,0
157076,10000,100,0,1,26,12,14,0,0,0,0,0,0,4,2,2,0,0,0,0,0,0,22,10,12,0,0,0,0,0,0,0,0,0
157085,10000,100,0,1,896,368,528,2,2,0,33,19,14,81,37,44,35,18,17,1,1,0,631,227,404,10,5,5,1,1,0,102,58,44
157100,10000,100,0,1,26,12,14,0,0,0,0,0,0,3,3,0,0,0,0,0,0,0,23,9,14,0,0,0,0,0,0,0,0,0
157216,10000,100,0,1,59,25,34,0,0,0,0,0,0,3,2,1,1,0,1,0,0,0,53,23,30,0,0,0,2,0,2,0,0,0
157289,10000,100,0,1,712,338,374,1,1,0,45,21,24,75,34,41,32,16,16,0,0,0,404,165,239,14,6,8,91,62,29,50,33,17
157304,10000,100,0,1,11,8,3,0,0,0,0,0,0,1,0,1,0,0,0,0,0,0,7,5,2,0,0,0,3,3,0,0,0,0
157331,10000,100,0,1,12,3,9,0,0,0,0,0,0,0,0,0,0,0,0,0,0,0,11,3,8,0,0,0,1,0,1,0,0,0
157377,10000,100,0,1,21,6,15,0,0,0,1,1,0,0,0,0,0,0,0,0,0,0,19,5,14,0,0,0,1,0,1,0,0,0
157386,10000,100,0,1,48,22,26,1,1,0,2,2,0,3,0,3,1,0,1,0,0,0,38,17,21,1,0,1,1,1,0,1,1,0
157401,10000,100,0,1,9,4,5,0,0,0,0,0,0,1,1,0,0,0,0,0,0,0,7,3,4,0,0,0,1,0,1,0,0,0
157438,10000,100,0,1,17,9,8,0,0,0,0,0,0,2,1,1,0,0,0,0,0,0,14,8,6,0,0,0,1,0,1,0,0,0
157447,10000,100,0,1,131,58,73,1,0,1,0,0,0,16,8,8,2,2,0,0,0,0,104,45,59,4,0,4,0,0,0,4,3,1
157483,10000,100,0,1,14,6,8,0,0,0,0,0,0,2,1,1,0,0,0,0,0,0,12,5,7,0,0,0,0,0,0,0,0,0
157535,10000,100,0,1,64,36,28,0,0,0,4,1,3,4,3,1,0,0,0,0,0,0,54,30,24,0,0,0,2,2,0,0,0,0
157553,10000,100,0,1,19,9,10,0,0,0,0,0,0,0,0,0,0,0,0,0,0,0,19,9,10,0,0,0,0,0,0,0,0,0
157711,10000,100,0,1,6,4,2,0,0,0,0,0,0,0,0,0,1,1,0,0,0,0,5,3,2,0,0,0,0,0,0,0,0,0
157739,10000,100,0,1,9,3,6,0,0,0,0,0,0,0,0,0,0,0,0,0,0,0,9,3,6,0,0,0,0,0,0,0,0,0
157748,10000,100,0,1,53,25,28,0,0,0,1,0,1,2,2,0,0,0,0,0,0,0,38,19,19,0,0,0,12,4,8,0,0,0
157757,10000,100,0,1,42,13,29,0,0,0,3,1,2,7,2,5,0,0,0,0,0,0,31,9,22,0,0,0,1,1,0,0,0,0
157809,10000,100,0,1,35,18,17,0,0,0,1,1,0,0,0,0,1,0,1,0,0,0,32,17,15,1,0,1,0,0,0,0,0,0
157818,10000,100,0,1,44,19,25,0,0,0,0,0,0,3,1,2,0,0,0,0,0,0,39,18,21,1,0,1,1,0,1,0,0,0
157854,10000,100,0,1,15,8,7,0,0,0,0,0,0,2,1,1,1,1,0,0,0,0,5,1,4,1,0,1,6,5,1,0,0,0
157863,10000,100,0,1,29,13,16,0,0,0,0,0,0,1,0,1,0,0,0,0,0,0,27,13,14,0,0,0,0,0,0,1,0,1
157951,10000,100,0,1,128,60,68,0,0,0,6,1,5,6,4,2,2,1,1,0,0,0,108,51,57,1,1,0,5,2,3,0,0,0
158088,10000,100,0,1,29,7,22,2,0,2,0,0,0,6,1,5,1,0,1,0,0,0,14,4,10,0,0,0,6,2,4,0,0,0
158431,10000,100,0,1,41,16,25,0,0,0,0,0,0,13,3,10,3,1,2,0,0,0,24,11,13,0,0,0,0,0,0,1,1,0
158477,10000,100,0,1,23,13,10,0,0,0,2,2,0,5,3,2,1,1,0,0,0,0,15,7,8,0,0,0,0,0,0,0,0,0
158662,10000,100,0,1,64,20,44,0,0,0,2,0,2,34,12,22,3,3,0,0,0,0,23,4,19,0,0,0,0,0,0,2,1,1
158802,10000,100,0,1,33,19,14,0,0,0,2,1,1,24,13,11,0,0,0,0,0,0,5,4,1,0,0,0,2,1,1,0,0,0
158884,10000,100,0,1,18,9,9,0,0,0,1,1,0,5,3,2,0,0,0,0,0,0,12,5,7,0,0,0,0,0,0,0,0,0
159009,10000,100,0,1,75,31,44,0,0,0,2,1,1,61,21,40,0,0,0,0,0,0,9,7,2,0,0,0,1,1,0,2,1,1
159197,10000,100,0,1,7,3,4,0,0,0,0,0,0,2,0,2,0,0,0,0,0,0,5,3,2,0,0,0,0,0,0,0,0,0
159373,10000,100,0,1,163,51,112,1,0,1,13,7,6,53,12,41,2,1,1,0,0,0,86,30,56,0,0,0,2,0,2,6,1,5
159382,10000,100,0,1,44,21,23,0,0,0,1,0,1,6,1,5,1,0,1,0,0,0,35,19,16,0,0,0,0,0,0,1,1,0
159391,10000,100,0,1,923,367,556,2,1,1,24,12,12,245,81,164,37,19,18,1,1,0,505,202,303,23,7,16,15,7,8,71,37,34
159407,10000,100,0,1,27,9,18,0,0,0,0,0,0,4,3,1,0,0,0,0,0,0,19,4,15,3,1,2,0,0,0,1,1,0
159416,10000,100,0,1,67,21,46,0,0,0,5,3,2,19,1,18,2,0,2,0,0,0,36,15,21,1,0,1,3,2,1,1,0,1
159568,10000,100,0,1,42,23,19,0,0,0,0,0,0,6,3,3,1,1,0,0,0,0,34,18,16,0,0,0,0,0,0,1,1,0
159647,10000,100,0,1,108,53,55,0,0,0,2,1,1,34,18,16,1,1,0,0,0,0,67,31,36,1,1,0,0,0,0,3,1,2
159656,10000,100,0,1,107,45,62,0,0,0,7,4,3,35,15,20,7,6,1,0,0,0,46,17,29,2,1,1,7,2,5,3,0,3
159717,10000,100,0,1,68,30,38,1,0,1,0,0,0,13,8,5,1,1,0,0,0,0,45,18,27,1,1,0,7,2,5,0,0,0
159939,10000,100,0,1,107,32,75,0,0,0,4,0,4,37,7,30,4,4,0,0,0,0,58,18,40,2,1,1,0,0,0,2,2,0
159948,10000,100,0,1,30,14,16,0,0,0,0,0,0,3,0,3,0,0,0,0,0,0,26,13,13,0,0,0,1,1,0,0,0,0
159966,10000,100,0,1,79,41,38,0,0,0,2,1,1,19,13,6,0,0,0,0,0,0,55,26,29,0,0,0,2,1,1,1,0,1
159993,10000,100,0,1,80,36,44,0,0,0,10,5,5,16,8,8,3,2,1,0,0,0,49,19,30,0,0,0,2,2,0,0,0,0
160010,10000,100,0,1,14,4,10,0,0,0,0,0,0,3,1,2,1,1,0,0,0,0,10,2,8,0,0,0,0,0,0,0,0,0
160038,10000,100,0,1,109,44,65,0,0,0,0,0,0,15,7,8,6,2,4,0,0,0,55,17,38,0,0,0,26,14,12,7,4,3
160065,10000,100,0,1,11,3,8,0,0,0,0,0,0,4,1,3,1,1,0,0,0,0,6,1,5,0,0,0,0,0,0,0,0,0
160074,10000,100,0,1,17,4,13,0,0,0,1,0,1,2,1,1,0,0,0,0,0,0,14,3,11,0,0,0,0,0,0,0,0,0
160481,10000,100,0,1,27,8,19,0,0,0,0,0,0,2,1,1,0,0,0,0,0,0,24,7,17,1,0,1,0,0,0,0,0,0
160524,10000,100,0,1,3,0,3,0,0,0,0,0,0,3,0,3,0,0,0,0,0,0,0,0,0,0,0,0,0,0,0,0,0,0
160533,10000,100,0,1,3,0,3,0,0,0,0,0,0,3,0,3,0,0,0,0,0,0,0,0,0,0,0,0,0,0,0,0,0,0
160579,10000,100,0,1,29,5,24,0,0,0,0,0,0,4,0,4,2,0,2,0,0,0,23,5,18,0,0,0,0,0,0,0,0,0
160612,10000,100,0,1,132,52,80,0,0,0,1,0,1,22,6,16,7,2,5,0,0,0,93,38,55,1,1,0,0,0,0,8,5,3
160621,10000,100,0,1,120,53,67,0,0,0,1,1,0,100,41,59,1,1,0,1,1,0,17,9,8,0,0,0,0,0,0,0,0,0
160630,10000,100,0,1,39,18,21,0,0,0,0,0,0,36,17,19,1,0,1,0,0,0,2,1,1,0,0,0,0,0,0,0,0,0
160649,10000,100,0,1,26,8,18,0,0,0,0,0,0,26,8,18,0,0,0,0,0,0,0,0,0,0,0,0,0,0,0,0,0,0
160658,10000,100,0,1,175,80,95,1,0,1,5,2,3,47,21,26,14,4,10,0,0,0,95,44,51,2,1,1,1,0,1,10,8,2
160667,10000,100,0,1,20,6,14,0,0,0,1,0,1,2,0,2,0,0,0,0,0,0,17,6,11,0,0,0,0,0,0,0,0,0
160755,10000,100,0,1,650,229,421,8,3,5,42,19,23,148,38,110,56,19,37,0,0,0,349,135,214,17,4,13,4,2,2,26,9,17
160904,10000,100,0,1,68,23,45,0,0,0,0,0,0,54,16,38,0,0,0,2,1,1,7,2,5,0,0,0,0,0,0,5,4,1
160959,10000,100,0,1,6,2,4,0,0,0,1,0,1,0,0,0,0,0,0,0,0,0,5,2,3,0,0,0,0,0,0,0,0,0
160977,10000,100,0,1,75,33,42,0,0,0,5,1,4,7,5,2,6,4,2,0,0,0,54,21,33,3,2,1,0,0,0,0,0,0
160995,10000,100,0,1,14,6,8,0,0,0,0,0,0,0,0,0,0,0,0,0,0,0,14,6,8,0,0,0,0,0,0,0,0,0
161004,10000,100,0,1,131,48,83,0,0,0,9,2,7,7,2,5,7,4,3,0,0,0,79,28,51,2,2,0,20,9,11,7,1,6
161022,10000,100,0,1,3,1,2,0,0,0,0,0,0,0,0,0,0,0,0,0,0,0,3,1,2,0,0,0,0,0,0,0,0,0
161077,10000,100,0,1,22,12,10,0,0,0,0,0,0,0,0,0,0,0,0,1,1,0,19,9,10,0,0,0,2,2,0,0,0,0
161086,10000,100,0,1,112,43,69,0,0,0,1,0,1,4,1,3,8,2,6,0,0,0,77,30,47,3,1,2,8,4,4,11,5,6
161138,10000,100,0,1,12,9,3,0,0,0,0,0,0,1,0,1,0,0,0,0,0,0,11,9,2,0,0,0,0,0,0,0,0,0
161192,10000,100,0,1,13,6,7,0,0,0,0,0,0,0,0,0,0,0,0,0,0,0,13,6,7,0,0,0,0,0,0,0,0,0
161208,10000,100,0,1,2,1,1,0,0,0,0,0,0,0,0,0,0,0,0,0,0,0,2,1,1,0,0,0,0,0,0,0,0,0
161217,10000,100,0,1,17,5,12,0,0,0,0,0,0,0,0,0,0,0,0,0,0,0,14,4,10,0,0,0,2,1,1,1,0,1
161226,10000,100,0,1,24,9,15,0,0,0,0,0,0,0,0,0,0,0,0,0,0,0,24,9,15,0,0,0,0,0,0,0,0,0
161235,10000,100,0,1,10,4,6,0,0,0,0,0,0,1,0,1,0,0,0,0,0,0,7,4,3,0,0,0,1,0,1,1,0,1
161253,10000,100,0,1,276,159,117,3,2,1,11,7,4,6,4,2,7,3,4,0,0,0,207,112,95,5,3,2,22,16,6,15,12,3
161280,10000,100,0,1,28,15,13,0,0,0,0,0,0,1,0,1,0,0,0,0,0,0,23,13,10,1,0,1,3,2,1,0,0,0
161299,10000,100,0,1,17,13,4,0,0,0,0,0,0,0,0,0,0,0,0,0,0,0,17,13,4,0,0,0,0,0,0,0,0,0
161341,10000,100,0,1,9,3,6,0,0,0,1,0,1,0,0,0,0,0,0,0,0,0,8,3,5,0,0,0,0,0,0,0,0,0
161457,10000,100,0,1,122,40,82,0,0,0,3,0,3,3,2,1,4,1,3,0,0,0,104,34,70,0,0,0,6,2,4,2,1,1
161484,10000,100,0,1,8,4,4,0,0,0,0,0,0,0,0,0,0,0,0,0,0,0,8,4,4,0,0,0,0,0,0,0,0,0
161509,10000,100,0,1,16,5,11,0,0,0,1,1,0,1,0,1,0,0,0,0,0,0,14,4,10,0,0,0,0,0,0,0,0,0
161518,10000,100,0,1,24,11,13,0,0,0,0,0,0,0,0,0,0,0,0,0,0,0,20,10,10,1,1,0,3,0,3,0,0,0
161545,10000,100,0,1,29,17,12,0,0,0,1,1,0,1,1,0,0,0,0,0,0,0,25,13,12,0,0,0,2,2,0,0,0,0
161554,10000,100,0,1,102,41,61,0,0,0,2,1,1,2,2,0,3,1,2,0,0,0,89,35,54,1,0,1,3,2,1,2,0,2
161563,10000,100,0,1,15,6,9,0,0,0,0,0,0,0,0,0,1,0,1,0,0,0,14,6,8,0,0,0,0,0,0,0,0,0
161572,10000,100,0,1,48,18,30,0,0,0,2,1,1,3,2,1,0,0,0,0,0,0,40,14,26,0,0,0,3,1,2,0,0,0
161581,10000,100,0,1,2,2,0,0,0,0,0,0,0,0,0,0,0,0,0,0,0,0,2,2,0,0,0,0,0,0,0,0,0,0
161688,10000,100,0,1,13,6,7,0,0,0,0,0,0,0,0,0,0,0,0,0,0,0,12,5,7,0,0,0,1,1,0,0,0,0
161767,10000,100,0,1,62,26,36,0,0,0,3,2,1,17,9,8,5,2,3,1,0,1,34,13,21,1,0,1,0,0,0,1,0,1
161864,10000,100,0,1,43,20,23,0,0,0,2,1,1,29,11,18,1,0,1,0,0,0,11,8,3,0,0,0,0,0,0,0,0,0
161873,10000,100,0,1,58,22,36,0,0,0,7,4,3,20,6,14,5,1,4,0,0,0,25,11,14,0,0,0,1,0,1,0,0,0
162007,10000,100,0,1,91,26,65,1,1,0,0,0,0,67,21,46,2,0,2,0,0,0,3,1,2,0,0,0,10,1,9,8,2,6
162061,10000,100,0,1,20,8,12,0,0,0,0,0,0,13,5,8,0,0,0,0,0,0,7,3,4,0,0,0,0,0,0,0,0,0
162104,10000,100,0,1,9,5,4,0,0,0,0,0,0,1,1,0,0,0,0,0,0,0,8,4,4,0,0,0,0,0,0,0,0,0
162122,10000,100,0,1,35,16,19,0,0,0,0,0,0,12,6,6,1,1,0,0,0,0,21,9,12,0,0,0,1,0,1,0,0,0
162168,10000,100,0,1,12,6,6,0,0,0,0,0,0,1,1,0,1,0,1,0,0,0,8,4,4,0,0,0,2,1,1,0,0,0
162210,10000,100,0,1,8,3,5,0,0,0,1,1,0,3,1,2,0,0,0,0,0,0,4,1,3,0,0,0,0,0,0,0,0,0
162283,10000,100,0,1,40,17,23,0,0,0,3,2,1,31,13,18,1,0,1,0,0,0,5,2,3,0,0,0,0,0,0,0,0,0
162557,10000,100,0,1,45,14,31,1,0,1,2,1,1,6,2,4,4,2,2,1,1,0,26,6,20,0,0,0,5,2,3,0,0,0
162584,10000,100,0,1,33,13,20,0,0,0,1,0,1,1,1,0,0,0,0,1,1,0,28,9,19,0,0,0,0,0,0,2,2,0
162609,10000,100,0,1,10,4,6,0,0,0,0,0,0,0,0,0,0,0,0,0,0,0,9,3,6,0,0,0,1,1,0,0,0,0
162654,10000,100,0,1,39,17,22,0,0,0,3,1,2,11,4,7,3,1,2,1,1,0,20,10,10,0,0,0,1,0,1,0,0,0
162690,10000,100,0,1,31,10,21,0,0,0,0,0,0,4,1,3,2,1,1,0,0,0,21,6,15,0,0,0,4,2,2,0,0,0
162706,10000,100,0,1,16,3,13,0,0,0,0,0,0,1,0,1,0,0,0,0,0,0,15,3,12,0,0,0,0,0,0,0,0,0
162760,10000,100,0,1,40,16,24,0,0,0,5,1,4,6,3,3,0,0,0,0,0,0,27,11,16,0,0,0,2,1,1,0,0,0
162779,10000,100,0,1,42,10,32,0,0,0,2,1,1,11,1,10,2,0,2,0,0,0,25,7,18,2,1,1,0,0,0,0,0,0
162928,10000,100,0,1,2262,734,1528,14,3,11,293,108,185,512,119,393,139,44,95,2,1,1,1049,362,687,72,24,48,17,8,9,164,65,99
163028,10000,100,0,1,35,24,11,0,0,0,3,1,2,14,11,3,1,0,1,0,0,0,12,9,3,3,1,2,2,2,0,0,0,0
163046,10000,100,0,1,86,49,37,0,0,0,3,1,2,22,13,9,5,3,2,0,0,0,51,30,21,3,2,1,2,0,2,0,0,0
163204,10000,100,0,1,56,18,38,0,0,0,6,0,6,7,1,6,0,0,0,0,0,0,18,8,10,0,0,0,25,9,16,0,0,0
163259,10000,100,0,1,776,288,488,2,1,1,95,39,56,207,63,144,54,12,42,2,1,1,301,116,185,20,2,18,1,1,0,94,53,41
163268,10000,100,0,1,120,53,67,0,0,0,10,2,8,22,10,12,3,1,2,1,0,1,53,24,29,2,1,1,20,9,11,9,6,3
163286,10000,100,0,1,636,322,314,0,0,0,45,22,23,98,50,48,49,21,28,0,0,0,249,120,129,6,0,6,78,36,42,111,73,38
163295,10000,100,0,1,65,24,41,0,0,0,7,2,5,27,10,17,4,1,3,0,0,0,17,6,11,2,0,2,4,3,1,4,2,2
163338,10000,100,0,1,16,8,8,0,0,0,2,1,1,8,6,2,1,1,0,0,0,0,3,0,3,1,0,1,1,0,1,0,0,0
163426,10000,100,0,1,68,24,44,0,0,0,4,2,2,31,11,20,6,4,2,0,0,0,17,6,11,1,0,1,1,0,1,8,1,7
163453,10000,100,0,1,121,51,70,0,0,0,1,1,0,83,34,49,5,1,4,0,0,0,6,5,1,2,0,2,12,6,6,12,4,8
163462,10000,100,0,1,55,33,22,0,0,0,1,0,1,7,5,2,1,1,0,0,0,0,42,26,16,4,1,3,0,0,0,0,0,0
163532,10000,100,0,1,9,7,2,0,0,0,0,0,0,0,0,0,7,5,2,0,0,0,2,2,0,0,0,0,0,0,0,0,0,0
163578,10000,100,0,1,53,15,38,0,0,0,4,1,3,13,3,10,3,1,2,0,0,0,31,8,23,2,2,0,0,0,0,0,0,0
163657,10000,100,0,1,29,9,20,0,0,0,1,0,1,13,3,10,1,0,1,0,0,0,12,5,7,1,0,1,1,1,0,0,0,0
163851,10000,100,0,1,58,22,36,0,0,0,4,2,2,7,1,6,3,3,0,0,0,0,36,13,23,0,0,0,0,0,0,8,3,5
163912,10000,100,0,1,42,15,27,0,0,0,2,1,1,8,4,4,4,2,2,0,0,0,25,6,19,0,0,0,0,0,0,3,2,1
163976,10000,100,0,1,16,10,6,0,0,0,2,1,1,0,0,0,0,0,0,0,0,0,14,9,5,0,0,0,0,0,0,0,0,0
164076,10000,100,0,1,215,87,128,1,0,1,17,7,10,49,14,35,6,1,5,0,0,0,122,55,67,5,1,4,14,9,5,1,0,1
164085,10000,100,0,1,7,3,4,0,0,0,0,0,0,5,2,3,0,0,0,0,0,0,2,1,1,0,0,0,0,0,0,0,0,0
164146,10000,100,0,1,1,1,0,0,0,0,0,0,0,0,0,0,0,0,0,0,0,0,1,1,0,0,0,0,0,0,0,0,0,0
164155,10000,100,0,1,93,55,38,0,0,0,6,3,3,15,9,6,6,3,3,0,0,0,63,38,25,0,0,0,3,2,1,0,0,0
164173,10000,100,0,1,51,25,26,0,0,0,0,0,0,13,6,7,1,0,1,1,1,0,35,17,18,1,1,0,0,0,0,0,0,0
164216,10000,100,0,1,66,32,34,0,0,0,3,2,1,8,3,5,2,1,1,0,0,0,53,26,27,0,0,0,0,0,0,0,0,0
164270,10000,100,0,1,73,29,44,0,0,0,3,1,2,12,6,6,4,1,3,0,0,0,54,21,33,0,0,0,0,0,0,0,0,0
164313,10000,100,0,1,11,2,9,0,0,0,3,1,2,1,0,1,0,0,0,0,0,0,7,1,6,0,0,0,0,0,0,0,0,0
164368,10000,100,0,1,48,25,23,0,0,0,8,3,5,7,3,4,5,3,2,0,0,0,22,13,9,0,0,0,6,3,3,0,0,0
164447,10000,100,0,1,30,15,15,0,0,0,1,0,1,2,1,1,2,1,1,0,0,0,24,13,11,1,0,1,0,0,0,0,0,0
164465,10000,100,0,1,115,51,64,1,1,0,8,4,4,16,9,7,13,7,6,1,0,1,62,24,38,0,0,0,4,1,3,10,5,5
164492,10000,100,0,1,23,7,16,0,0,0,0,0,0,1,1,0,1,0,1,0,0,0,20,5,15,1,1,0,0,0,0,0,0,0
164562,10000,100,0,1,37,16,21,0,0,0,0,0,0,1,1,0,4,2,2,0,0,0,31,13,18,1,0,1,0,0,0,0,0,0
164580,10000,100,0,1,50,21,29,0,0,0,3,1,2,7,6,1,8,2,6,0,0,0,31,12,19,1,0,1,0,0,0,0,0,0
164632,10000,100,0,1,19,7,12,0,0,0,0,0,0,2,1,1,2,1,1,0,0,0,13,5,8,0,0,0,2,0,2,0,0,0
164739,10000,100,0,1,88,37,51,0,0,0,11,6,5,12,9,3,4,3,1,0,0,0,54,17,37,1,0,1,2,1,1,4,1,3
164748,10000,100,0,1,102,40,62,1,1,0,11,4,7,16,7,9,11,5,6,0,0,0,48,19,29,4,0,4,8,3,5,3,1,2
164775,10000,100,0,1,22,7,15,0,0,0,0,0,0,2,0,2,2,0,2,0,0,0,18,7,11,0,0,0,0,0,0,0,0,0
164872,10000,100,0,1,13,6,7,0,0,0,0,0,0,1,0,1,8,4,4,0,0,0,4,2,2,0,0,0,0,0,0,0,0,0
164924,10000,100,0,1,405,212,193,1,1,0,23,13,10,52,32,20,30,13,17,0,0,0,238,116,122,10,6,4,21,13,8,30,18,12
164988,10000,100,0,1,1295,479,816,3,1,2,140,49,91,99,31,68,131,45,86,0,0,0,611,211,400,35,11,24,112,43,69,164,88,76
165015,10000,100,0,1,143,60,83,0,0,0,7,3,4,15,5,10,12,4,8,0,0,0,93,39,54,0,0,0,10,6,4,6,3,3
165024,10000,100,0,1,27,7,20,0,0,0,2,1,1,3,0,3,1,1,0,0,0,0,18,4,14,1,0,1,2,1,1,0,0,0
165033,10000,100,0,1,35,8,27,0,0,0,1,0,1,4,0,4,1,0,1,0,0,0,28,8,20,0,0,0,1,0,1,0,0,0
165112,10000,100,0,1,27,8,19,0,0,0,4,1,3,4,2,2,5,2,3,0,0,0,13,3,10,1,0,1,0,0,0,0,0,0
165167,10000,100,0,1,4,3,1,0,0,0,0,0,0,0,0,0,1,1,0,0,0,0,2,2,0,1,0,1,0,0,0,0,0,0
165194,10000,100,0,1,18,5,13,0,0,0,0,0,0,1,0,1,1,0,1,0,0,0,13,3,10,0,0,0,3,2,1,0,0,0
165264,10000,100,0,1,12,4,8,0,0,0,0,0,0,4,1,3,1,0,1,0,0,0,7,3,4,0,0,0,0,0,0,0,0,0
165334,10000,100,0,1,115,59,56,1,0,1,4,1,3,16,9,7,10,8,2,0,0,0,68,33,35,4,1,3,1,1,0,11,6,5
165529,10000,100,0,1,43,24,19,0,0,0,1,1,0,2,0,2,0,0,0,0,0,0,38,22,16,0,0,0,2,1,1,0,0,0
165574,10000,100,0,1,41,18,23,0,0,0,1,0,1,1,1,0,1,1,0,0,0,0,37,15,22,0,0,0,1,1,0,0,0,0
165644,10000,100,0,1,4,3,1,0,0,0,1,1,0,0,0,0,0,0,0,0,0,0,1,0,1,0,0,0,2,2,0,0,0,0
165662,10000,100,0,1,72,23,49,1,0,1,7,0,7,13,4,9,1,1,0,0,0,0,42,13,29,6,4,2,2,1,1,0,0,0
165671,10000,100,0,1,39,18,21,0,0,0,2,1,1,4,2,2,1,0,1,0,0,0,32,15,17,0,0,0,0,0,0,0,0,0
165699,10000,100,0,1,62,25,37,0,0,0,2,0,2,2,2,0,8,5,3,0,0,0,36,14,22,2,0,2,12,4,8,0,0,0
165802,10000,100,0,1,27,9,18,0,0,0,1,0,1,5,0,5,2,0,2,1,0,1,18,9,9,0,0,0,0,0,0,0,0,0
165820,10000,100,0,1,34,6,28,0,0,0,4,3,1,2,0,2,5,1,4,0,0,0,23,2,21,0,0,0,0,0,0,0,0,0
165866,10000,100,0,1,28,10,18,0,0,0,3,1,2,2,2,0,1,1,0,0,0,0,22,6,16,0,0,0,0,0,0,0,0,0
165884,10000,100,0,1,8,4,4,0,0,0,1,1,0,1,1,0,1,0,1,1,0,1,4,2,2,0,0,0,0,0,0,0,0,0
165936,10000,100,0,1,46,14,32,0,0,0,4,1,3,1,0,1,0,0,0,0,0,0,27,8,19,0,0,0,14,5,9,0,0,0
165945,10000,100,0,1,11,5,6,0,0,0,0,0,0,2,2,0,1,1,0,0,0,0,8,2,6,0,0,0,0,0,0,0,0,0
165981,10000,100,0,1,27,6,21,0,0,0,1,0,1,1,0,1,0,0,0,0,0,0,25,6,19,0,0,0,0,0,0,0,0,0
166018,10000,100,0,1,39,20,19,0,0,0,0,0,0,2,2,0,8,6,2,0,0,0,27,10,17,1,1,0,1,1,0,0,0,0
166027,10000,100,0,1,1936,825,1111,2,0,2,233,87,146,143,60,83,191,63,128,0,0,0,922,370,552,44,13,31,4,2,2,397,230,167
166045,10000,100,0,1,2,0,2,0,0,0,0,0,0,1,0,1,0,0,0,0,0,0,1,0,1,0,0,0,0,0,0,0,0,0
166054,10000,100,0,1,5,3,2,0,0,0,0,0,0,0,0,0,0,0,0,0,0,0,5,3,2,0,0,0,0,0,0,0,0,0
166124,10000,100,0,1,115,61,54,1,1,0,4,1,3,7,5,2,8,2,6,0,0,0,80,44,36,3,0,3,10,6,4,2,2,0
166133,10000,100,0,1,12,4,8,0,0,0,2,0,2,2,0,2,2,1,1,0,0,0,6,3,3,0,0,0,0,0,0,0,0,0
166391,10000,100,0,1,40,17,23,0,0,0,1,1,0,1,0,1,4,0,4,0,0,0,24,9,15,1,1,0,9,6,3,0,0,0
166407,10000,100,0,1,2,0,2,0,0,0,0,0,0,0,0,0,0,0,0,0,0,0,2,0,2,0,0,0,0,0,0,0,0,0
166452,10000,100,0,1,35,16,19,0,0,0,4,3,1,8,2,6,5,2,3,0,0,0,18,9,9,0,0,0,0,0,0,0,0,0
166489,10000,100,0,1,1,0,1,0,0,0,0,0,0,0,0,0,0,0,0,0,0,0,1,0,1,0,0,0,0,0,0,0,0,0
166513,10000,100,0,1,157,85,72,0,0,0,8,2,6,6,3,3,11,6,5,0,0,0,83,48,35,2,1,1,13,4,9,34,21,13
166629,10000,100,0,1,426,187,239,2,1,1,29,13,16,28,13,15,25,7,18,0,0,0,256,105,151,5,4,1,8,5,3,73,39,34
166638,10000,100,0,1,128,45,83,2,0,2,11,3,8,12,2,10,11,2,9,0,0,0,67,28,39,2,0,2,12,4,8,11,6,5
166647,10000,100,0,1,23,5,18,0,0,0,2,0,2,6,1,5,1,0,1,0,0,0,12,4,8,0,0,0,2,0,2,0,0,0
166656,10000,100,0,1,104,35,69,0,0,0,27,7,20,8,4,4,3,1,2,1,0,1,46,14,32,2,0,2,8,5,3,9,4,5
166665,10000,100,0,1,37,17,20,0,0,0,2,0,2,5,2,3,1,0,1,0,0,0,27,14,13,1,0,1,0,0,0,1,1,0
166674,10000,100,0,1,41,18,23,0,0,0,2,1,1,6,5,1,4,1,3,0,0,0,25,11,14,0,0,0,4,0,4,0,0,0
166683,10000,100,0,1,1583,873,710,1,1,0,144,63,81,76,37,39,91,37,54,0,0,0,712,365,347,33,14,19,76,50,26,450,306,144
166692,10000,100,0,1,10,5,5,0,0,0,0,0,0,0,0,0,0,0,0,0,0,0,10,5,5,0,0,0,0,0,0,0,0,0
166708,10000,100,0,1,937,400,537,0,0,0,136,63,73,57,23,34,64,25,39,0,0,0,530,221,309,0,0,0,32,10,22,118,58,60
166717,10000,100,0,1,37,6,31,0,0,0,1,0,1,5,0,5,1,0,1,0,0,0,16,4,12,0,0,0,14,2,12,0,0,0
166823,10000,100,0,1,18,4,14,0,0,0,3,1,2,3,0,3,0,0,0,0,0,0,12,3,9,0,0,0,0,0,0,0,0,0
166850,10000,100,0,1,69,25,44,0,0,0,2,0,2,4,2,2,4,2,2,0,0,0,54,19,35,2,0,2,3,2,1,0,0,0
166869,10000,100,0,1,29,6,23,0,0,0,3,0,3,1,0,1,3,1,2,0,0,0,21,5,16,1,0,1,0,0,0,0,0,0
166887,10000,100,0,1,10,4,6,0,0,0,0,0,0,2,1,1,1,0,1,0,0,0,7,3,4,0,0,0,0,0,0,0,0,0
166911,10000,100,0,1,18,6,12,0,0,0,1,0,1,0,0,0,0,0,0,0,0,0,1,0,1,0,0,0,16,6,10,0,0,0
166939,10000,100,0,1,73,25,48,0,0,0,4,1,3,4,1,3,4,2,2,0,0,0,33,10,23,2,1,1,21,8,13,5,2,3
166957,10000,100,0,1,23,8,15,0,0,0,0,0,0,0,0,0,3,0,3,0,0,0,20,8,12,0,0,0,0,0,0,0,0,0
167057,10000,100,0,1,39,14,25,0,0,0,0,0,0,4,2,2,1,0,1,0,0,0,31,12,19,1,0,1,2,0,2,0,0,0
167093,10000,100,0,1,16,2,14,0,0,0,0,0,0,1,1,0,0,0,0,0,0,0,7,1,6,0,0,0,8,0,8,0,0,0
167215,10000,100,0,1,15,7,8,0,0,0,1,0,1,0,0,0,1,0,1,0,0,0,13,7,6,0,0,0,0,0,0,0,0,0
167260,10000,100,0,1,15,14,1,0,0,0,0,0,0,1,1,0,1,1,0,0,0,0,13,12,1,0,0,0,0,0,0,0,0,0
167288,10000,100,0,1,26,13,13,0,0,0,0,0,0,4,1,3,2,1,1,0,0,0,19,10,9,0,0,0,1,1,0,0,0,0
167312,10000,100,0,1,31,9,22,0,0,0,2,1,1,1,0,1,7,3,4,0,0,0,16,3,13,0,0,0,5,2,3,0,0,0
167358,10000,100,0,1,560,267,293,0,0,0,59,29,30,40,18,22,33,14,19,0,0,0,287,127,160,9,2,7,69,30,39,63,47,16
167376,10000,100,0,1,44,21,23,1,0,1,1,0,1,4,2,2,10,6,4,0,0,0,25,12,13,0,0,0,3,1,2,0,0,0
167394,10000,100,0,1,24,6,18,0,0,0,2,0,2,2,0,2,3,3,0,0,0,0,17,3,14,0,0,0,0,0,0,0,0,0
167525,10000,100,0,1,23,12,11,0,0,0,3,2,1,0,0,0,3,3,0,0,0,0,16,7,9,1,0,1,0,0,0,0,0,0
167534,10000,100,0,1,41,17,24,0,0,0,5,3,2,7,2,5,3,2,1,0,0,0,26,10,16,0,0,0,0,0,0,0,0,0
167598,10000,100,0,1,48,15,33,0,0,0,1,1,0,10,2,8,9,2,7,0,0,0,27,10,17,0,0,0,1,0,1,0,0,0
167631,10000,100,0,1,10,5,5,0,0,0,1,0,1,5,2,3,1,1,0,0,0,0,3,2,1,0,0,0,0,0,0,0,0,0
167677,10000,100,0,1,3,3,0,0,0,0,0,0,0,0,0,0,0,0,0,0,0,0,3,3,0,0,0,0,0,0,0,0,0,0
167729,10000,100,0,1,37,10,27,0,0,0,1,0,1,2,2,0,7,1,6,0,0,0,25,7,18,0,0,0,2,0,2,0,0,0
167783,10000,100,0,1,97,26,71,0,0,0,6,0,6,19,5,14,4,2,2,0,0,0,61,16,45,1,0,1,4,2,2,2,1,1
167792,10000,100,0,1,22,11,11,0,0,0,3,1,2,1,0,1,1,0,1,0,0,0,16,9,7,0,0,0,0,0,0,1,1,0
167835,10000,100,0,1,135,48,87,0,0,0,4,1,3,8,3,5,18,6,12,0,0,0,92,34,58,6,1,5,1,1,0,6,2,4
167899,10000,100,0,1,85,37,48,0,0,0,6,3,3,14,5,9,5,2,3,0,0,0,51,24,27,3,2,1,6,1,5,0,0,0
167905,10000,100,0,1,33,13,20,0,0,0,1,0,1,6,1,5,6,2,4,0,0,0,17,8,9,0,0,0,3,2,1,0,0,0
167987,10000,100,0,1,82,21,61,0,0,0,3,1,2,14,1,13,0,0,0,0,0,0,52,15,37,5,1,4,5,1,4,3,2,1
167996,10000,100,0,1,44,17,27,0,0,0,2,1,1,3,0,3,2,2,0,0,0,0,12,4,8,0,0,0,25,10,15,0,0,0
168005,10000,100,0,1,109,41,68,1,0,1,5,2,3,13,5,8,8,3,5,0,0,0,81,30,51,0,0,0,1,1,0,0,0,0
168148,10000,100,0,1,635,224,411,2,0,2,58,22,36,62,29,33,69,31,38,0,0,0,345,105,240,12,4,8,57,20,37,30,13,17
168218,10000,100,0,1,65,12,53,1,0,1,6,0,6,7,2,5,5,1,4,1,1,0,39,7,32,2,1,1,1,0,1,3,0,3
168227,10000,100,0,1,74,26,48,0,0,0,4,2,2,6,3,3,4,2,2,0,0,0,45,13,32,1,0,1,14,6,8,0,0,0
168254,10000,100,0,1,59,20,39,0,0,0,2,1,1,6,2,4,5,0,5,0,0,0,37,13,24,1,1,0,8,3,5,0,0,0
168263,10000,100,0,1,49,16,33,0,0,0,1,0,1,4,2,2,6,3,3,0,0,0,38,11,27,0,0,0,0,0,0,0,0,0
168281,10000,100,0,1,41,20,21,0,0,0,2,0,2,6,4,2,1,1,0,0,0,0,31,14,17,1,1,0,0,0,0,0,0,0
168342,10000,100,0,1,63,30,33,0,0,0,3,1,2,5,1,4,12,3,9,0,0,0,35,21,14,2,0,2,0,0,0,6,4,2
168421,10000,100,0,1,125,68,57,0,0,0,9,5,4,7,2,5,8,6,2,0,0,0,53,25,28,2,1,1,19,10,9,27,19,8
168430,10000,100,0,1,75,22,53,1,1,0,0,0,0,2,1,1,5,2,3,0,0,0,65,18,47,2,0,2,0,0,0,0,0,0
168528,10000,100,0,1,52,27,25,0,0,0,1,0,1,2,2,0,2,1,1,0,0,0,46,24,22,1,0,1,0,0,0,0,0,0
168546,10000,100,0,1,77,42,35,0,0,0,6,3,3,17,10,7,7,4,3,0,0,0,46,24,22,0,0,0,0,0,0,1,1,0
168591,10000,100,0,1,32,17,15,0,0,0,2,1,1,5,4,1,0,0,0,0,0,0,25,12,13,0,0,0,0,0,0,0,0,0
168607,10000,100,0,1,5,2,3,0,0,0,0,0,0,0,0,0,0,0,0,0,0,0,5,2,3,0,0,0,0,0,0,0,0,0
168740,10000,100,0,1,85,35,50,0,0,0,8,4,4,17,10,7,13,6,7,1,0,1,32,10,22,3,2,1,4,1,3,7,2,5
168786,10000,100,0,1,29,13,16,0,0,0,0,0,0,0,0,0,3,1,2,0,0,0,10,3,7,0,0,0,16,9,7,0,0,0
168847,10000,100,0,1,17,6,11,0,0,0,1,0,1,1,0,1,0,0,0,0,0,0,15,6,9,0,0,0,0,0,0,0,0,0
168883,10000,100,0,1,14,7,7,0,0,0,0,0,0,0,0,0,0,0,0,0,0,0,14,7,7,0,0,0,0,0,0,0,0,0
169080,10000,100,0,1,43,21,22,0,0,0,2,1,1,3,2,1,0,0,0,0,0,0,38,18,20,0,0,0,0,0,0,0,0,0
169099,10000,100,0,1,1,0,1,0,0,0,0,0,0,0,0,0,1,0,1,0,0,0,0,0,0,0,0,0,0,0,0,0,0,0
169220,10000,100,0,1,3,1,2,0,0,0,0,0,0,1,1,0,0,0,0,0,0,0,2,0,2,0,0,0,0,0,0,0,0,0
169248,10000,100,0,1,32,17,15,0,0,0,3,1,2,3,3,0,0,0,0,0,0,0,23,11,12,1,1,0,1,0,1,1,1,0
169275,10000,100,0,1,13,3,10,0,0,0,0,0,0,7,1,6,1,0,1,0,0,0,5,2,3,0,0,0,0,0,0,0,0,0
169327,10000,100,0,1,9,5,4,0,0,0,0,0,0,0,0,0,0,0,0,0,0,0,9,5,4,0,0,0,0,0,0,0,0,0
169363,10000,100,0,1,32,12,20,0,0,0,0,0,0,2,1,1,0,0,0,0,0,0,30,11,19,0,0,0,0,0,0,0,0,0
169424,10000,100,0,1,1,1,0,0,0,0,0,0,0,0,0,0,0,0,0,0,0,0,1,1,0,0,0,0,0,0,0,0,0,0
169442,10000,100,0,1,15,4,11,0,0,0,0,0,0,6,3,3,0,0,0,0,0,0,8,1,7,1,0,1,0,0,0,0,0,0
169479,10000,100,0,1,59,23,36,0,0,0,2,1,1,10,7,3,2,1,1,0,0,0,40,11,29,2,0,2,2,2,0,1,1,0
169521,10000,100,0,1,26,10,16,0,0,0,0,0,0,3,3,0,0,0,0,0,0,0,22,6,16,0,0,0,1,1,0,0,0,0
169655,10000,100,0,1,24,14,10,0,0,0,0,0,0,8,6,2,1,1,0,0,0,0,14,6,8,1,1,0,0,0,0,0,0,0
169716,10000,100,0,1,69,19,50,0,0,0,4,2,2,14,5,9,4,1,3,0,0,0,25,4,21,0,0,0,4,0,4,18,7,11
169761,10000,100,0,1,4,2,2,0,0,0,0,0,0,2,1,1,0,0,0,0,0,0,2,1,1,0,0,0,0,0,0,0,0,0
169798,10000,100,0,1,81,41,40,1,1,0,4,1,3,12,6,6,3,3,0,0,0,0,46,24,22,0,0,0,15,6,9,0,0,0
169910,10000,100,0,1,63,28,35,1,0,1,0,0,0,4,0,4,3,2,1,1,0,1,53,25,28,0,0,0,0,0,0,1,1,0
169974,10000,100,0,1,7,3,4,0,0,0,0,0,0,1,1,0,0,0,0,0,0,0,5,1,4,1,1,0,0,0,0,0,0,0
169983,10000,100,0,1,32,9,23,0,0,0,3,1,2,5,1,4,0,0,0,0,0,0,22,7,15,2,0,2,0,0,0,0,0,0
169992,10000,100,0,1,3,2,1,0,0,0,0,0,0,0,0,0,0,0,0,0,0,0,3,2,1,0,0,0,0,0,0,0,0,0
170000,10000,100,0,1,14,7,7,0,0,0,0,0,0,0,0,0,1,0,1,0,0,0,12,7,5,1,0,1,0,0,0,0,0,0
170037,10000,100,0,1,27,13,14,0,0,0,0,0,0,0,0,0,4,2,2,0,0,0,21,11,10,0,0,0,0,0,0,2,0,2
170055,10000,100,0,1,47,21,26,1,1,0,1,0,1,6,2,4,1,1,0,0,0,0,38,17,21,0,0,0,0,0,0,0,0,0
170082,10000,100,0,1,107,50,57,0,0,0,5,2,3,10,1,9,6,4,2,0,0,0,79,37,42,1,1,0,3,3,0,3,2,1
170240,10000,100,0,1,70,33,37,0,0,0,3,2,1,18,7,11,0,0,0,0,0,0,46,23,23,1,0,1,1,1,0,1,0,1
170286,10000,100,0,1,99,56,43,0,0,0,0,0,0,0,0,0,0,0,0,0,0,0,0,0,0,0,0,0,99,56,43,0,0,0
170301,10000,100,0,1,63,22,41,0,0,0,4,0,4,6,4,2,5,3,2,1,1,0,44,14,30,2,0,2,0,0,0,1,0,1
170444,10000,100,0,1,15,5,10,1,1,0,0,0,0,1,0,1,0,0,0,0,0,0,11,4,7,0,0,0,1,0,1,1,0,1
170532,10000,100,0,1,44,26,18,0,0,0,2,1,1,7,4,3,2,1,1,0,0,0,23,11,12,2,1,1,8,8,0,0,0,0
170541,10000,100,0,1,50,26,24,0,0,0,0,0,0,6,3,3,0,0,0,0,0,0,36,20,16,0,0,0,6,3,3,2,0,2
170550,10000,100,0,1,38,24,14,0,0,0,3,3,0,4,2,2,3,1,2,0,0,0,27,18,9,0,0,0,1,0,1,0,0,0
170587,10000,100,0,1,8,5,3,0,0,0,0,0,0,0,0,0,0,0,0,0,0,0,8,5,3,0,0,0,0,0,0,0,0,0
170620,10000,100,0,1,16,6,10,0,0,0,0,0,0,6,3,3,0,0,0,0,0,0,9,3,6,0,0,0,1,0,1,0,0,0
170639,10000,100,0,1,77,35,42,6,3,3,2,2,0,0,0,0,1,1,0,0,0,0,62,24,38,0,0,0,5,4,1,1,1,0
170657,10000,100,0,1,41,15,26,0,0,0,1,0,1,7,3,4,5,2,3,0,0,0,25,8,17,1,0,1,2,2,0,0,0,0
170675,10000,100,0,1,63,26,37,0,0,0,1,1,0,9,0,9,1,1,0,0,0,0,46,22,24,1,1,0,3,1,2,2,0,2
170790,10000,100,0,1,17,2,15,0,0,0,0,0,0,2,0,2,1,0,1,0,0,0,8,2,6,0,0,0,6,0,6,0,0,0
170806,10000,100,0,1,32,10,22,0,0,0,1,0,1,5,3,2,1,0,1,1,0,1,19,4,15,3,2,1,2,1,1,0,0,0
170967,10000,100,0,1,16,7,9,0,0,0,0,0,0,5,2,3,1,0,1,0,0,0,10,5,5,0,0,0,0,0,0,0,0,0
170976,10000,100,0,1,2221,948,1273,6,3,3,190,65,125,213,89,124,101,34,67,1,0,1,1243,482,761,63,27,36,27,14,13,377,234,143
171100,10000,100,0,1,642,295,347,6,2,4,38,17,21,53,27,26,40,19,21,0,0,0,373,155,218,5,3,2,1,1,0,126,71,55
171128,10000,100,0,1,95,61,34,0,0,0,2,1,1,2,2,0,4,3,1,0,0,0,63,37,26,0,0,0,17,14,3,7,4,3
171137,10000,100,0,1,60,22,38,0,0,0,2,0,2,9,2,7,2,0,2,0,0,0,42,18,24,3,0,3,0,0,0,2,2,0
171146,10000,100,0,1,68,22,46,0,0,0,1,0,1,12,4,8,2,2,0,0,0,0,48,15,33,1,0,1,1,0,1,3,1,2
171155,10000,100,0,1,7,4,3,0,0,0,0,0,0,0,0,0,0,0,0,0,0,0,7,4,3,0,0,0,0,0,0,0,0,0
171225,10000,100,0,1,14,7,7,0,0,0,0,0,0,1,1,0,1,0,1,0,0,0,10,4,6,1,1,0,1,1,0,0,0,0
171234,10000,100,0,1,6,3,3,0,0,0,0,0,0,0,0,0,1,1,0,0,0,0,5,2,3,0,0,0,0,0,0,0,0,0
171304,10000,100,0,1,12,5,7,0,0,0,1,0,1,3,2,1,0,0,0,0,0,0,8,3,5,0,0,0,0,0,0,0,0,0
171395,10000,100,0,1,17,9,8,1,1,0,0,0,0,0,0,0,0,0,0,0,0,0,16,8,8,0,0,0,0,0,0,0,0,0
171456,10000,100,0,1,54,30,24,2,0,2,0,0,0,0,0,0,2,1,1,0,0,0,47,27,20,0,0,0,2,1,1,1,1,0
171483,10000,100,0,1,11,3,8,0,0,0,0,0,0,0,0,0,0,0,0,0,0,0,11,3,8,0,0,0,0,0,0,0,0,0
171492,10000,100,0,1,25,13,12,1,0,1,0,0,0,3,3,0,0,0,0,0,0,0,21,10,11,0,0,0,0,0,0,0,0,0
171535,10000,100,0,1,52,20,32,0,0,0,2,1,1,12,5,7,1,1,0,0,0,0,35,12,23,0,0,0,2,1,1,0,0,0
171571,10000,100,0,1,83,38,45,1,1,0,8,6,2,10,4,6,3,2,1,0,0,0,52,20,32,1,1,0,0,0,0,8,4,4
171599,10000,100,0,1,33,17,16,0,0,0,2,0,2,4,3,1,2,1,1,0,0,0,25,13,12,0,0,0,0,0,0,0,0,0
171881,10000,100,0,1,5,2,3,0,0,0,0,0,0,1,1,0,0,0,0,0,0,0,4,1,3,0,0,0,0,0,0,0,0,0
172033,10000,100,0,1,6,4,2,0,0,0,0,0,0,0,0,0,0,0,0,0,0,0,6,4,2,0,0,0,0,0,0,0,0,0
172051,10000,100,0,1,58,26,32,0,0,0,1,0,1,6,2,4,2,1,1,0,0,0,49,23,26,0,0,0,0,0,0,0,0,0
172200,10000,100,0,1,23,12,11,0,0,0,0,0,0,3,1,2,0,0,0,0,0,0,19,11,8,0,0,0,1,0,1,0,0,0
172264,10000,100,0,1,40,21,19,0,0,0,1,0,1,4,3,1,1,1,0,0,0,0,34,17,17,0,0,0,0,0,0,0,0,0
172291,10000,100,0,1,28,11,17,0,0,0,1,0,1,5,2,3,2,1,1,0,0,0,19,7,12,0,0,0,1,1,0,0,0,0
172307,10000,100,0,1,19,8,11,0,0,0,0,0,0,2,1,1,1,0,1,0,0,0,13,5,8,1,1,0,2,1,1,0,0,0
172334,10000,100,0,1,32,13,19,0,0,0,0,0,0,0,0,0,0,0,0,0,0,0,31,12,19,0,0,0,1,1,0,0,0,0
172440,10000,100,0,1,29,14,15,1,0,1,0,0,0,0,0,0,0,0,0,0,0,0,28,14,14,0,0,0,0,0,0,0,0,0
172477,10000,100,0,1,5,3,2,0,0,0,0,0,0,1,1,0,1,0,1,0,0,0,3,2,1,0,0,0,0,0,0,0,0,0
172608,10000,100,0,1,16,10,6,0,0,0,2,1,1,2,1,1,0,0,0,0,0,0,12,8,4,0,0,0,0,0,0,0,0,0
172617,10000,100,0,1,25,10,15,1,1,0,1,0,1,6,4,2,2,1,1,0,0,0,14,3,11,0,0,0,1,1,0,0,0,0
172635,10000,100,0,1,10,5,5,0,0,0,0,0,0,7,5,2,0,0,0,0,0,0,2,0,2,0,0,0,1,0,1,0,0,0
172644,10000,100,0,1,389,166,223,0,0,0,37,12,25,57,14,43,11,5,6,0,0,0,192,92,100,13,3,10,8,5,3,71,35,36
172671,10000,100,0,1,8,4,4,0,0,0,0,0,0,0,0,0,0,0,0,0,0,0,8,4,4,0,0,0,0,0,0,0,0,0
172699,10000,100,0,1,87,44,43,1,0,1,4,0,4,10,4,6,5,3,2,0,0,0,66,37,29,1,0,1,0,0,0,0,0,0
172705,10000,100,0,1,1,1,0,0,0,0,0,0,0,0,0,0,1,1,0,0,0,0,0,0,0,0,0,0,0,0,0,0,0,0
172918,10000,100,0,1,3,3,0,0,0,0,0,0,0,0,0,0,0,0,0,0,0,0,3,3,0,0,0,0,0,0,0,0,0,0
172963,10000,100,0,1,8,2,6,0,0,0,1,0,1,2,1,1,0,0,0,0,0,0,4,0,4,0,0,0,1,1,0,0,0,0
173045,10000,100,0,1,53,12,41,0,0,0,8,1,7,5,2,3,4,0,4,1,0,1,32,9,23,1,0,1,2,0,2,0,0,0
173063,10000,100,0,1,10,3,7,0,0,0,0,0,0,2,0,2,0,0,0,0,0,0,8,3,5,0,0,0,0,0,0,0,0,0
173115,10000,100,0,1,1,1,0,0,0,0,0,0,0,0,0,0,0,0,0,0,0,0,1,1,0,0,0,0,0,0,0,0,0,0
173124,10000,100,0,1,24,12,12,2,1,1,2,1,1,1,1,0,1,1,0,0,0,0,14,7,7,1,0,1,3,1,2,0,0,0
173142,10000,100,0,1,12,5,7,0,0,0,0,0,0,0,0,0,1,1,0,0,0,0,9,3,6,0,0,0,2,1,1,0,0,0
173160,10000,100,0,1,67,34,33,1,1,0,0,0,0,3,2,1,0,0,0,0,0,0,46,22,24,3,1,2,14,8,6,0,0,0
173203,10000,100,0,1,7,3,4,0,0,0,0,0,0,0,0,0,0,0,0,0,0,0,6,2,4,0,0,0,1,1,0,0,0,0
173258,10000,100,0,1,78,32,46,0,0,0,6,1,5,7,2,5,15,7,8,0,0,0,47,21,26,1,0,1,1,0,1,1,1,0
173300,10000,100,0,1,53,23,30,0,0,0,1,0,1,1,1,0,2,0,2,0,0,0,45,19,26,2,1,1,1,1,0,1,1,0
173328,10000,100,0,1,39,10,29,0,0,0,0,0,0,3,1,2,1,0,1,0,0,0,27,6,21,1,1,0,4,2,2,3,0,3
173416,10000,100,0,1,6,5,1,1,1,0,1,0,1,0,0,0,0,0,0,0,0,0,4,4,0,0,0,0,0,0,0,0,0,0
173452,10000,100,0,1,10,7,3,0,0,0,0,0,0,1,1,0,0,0,0,0,0,0,8,6,2,1,0,1,0,0,0,0,0,0
173461,10000,100,0,1,6,1,5,0,0,0,0,0,0,0,0,0,0,0,0,0,0,0,4,1,3,1,0,1,1,0,1,0,0,0
173559,10000,100,0,1,4,3,1,0,0,0,0,0,0,0,0,0,1,1,0,0,0,0,3,2,1,0,0,0,0,0,0,0,0,0
173638,10000,100,0,1,7,4,3,0,0,0,0,0,0,0,0,0,0,0,0,0,0,0,7,4,3,0,0,0,0,0,0,0,0,0
173647,10000,100,0,1,10,2,8,0,0,0,0,0,0,1,0,1,0,0,0,0,0,0,8,2,6,0,0,0,1,0,1,0,0,0
173665,10000,100,0,1,47,23,24,0,0,0,1,0,1,4,3,1,4,1,3,0,0,0,36,17,19,1,1,0,1,1,0,0,0,0
173708,10000,100,0,1,19,9,10,0,0,0,2,0,2,1,0,1,0,0,0,0,0,0,13,7,6,1,1,0,2,1,1,0,0,0
173799,10000,100,0,1,10,5,5,0,0,0,1,1,0,2,1,1,2,1,1,0,0,0,4,2,2,0,0,0,1,0,1,0,0,0
173805,10000,100,0,1,2,2,0,0,0,0,0,0,0,0,0,0,0,0,0,0,0,0,2,2,0,0,0,0,0,0,0,0,0,0
173896,10000,100,0,1,1,1,0,0,0,0,0,0,0,0,0,0,0,0,0,0,0,0,1,1,0,0,0,0,0,0,0,0,0,0
173902,10000,100,0,1,77,26,51,0,0,0,7,2,5,7,2,5,4,1,3,0,0,0,52,19,33,3,1,2,0,0,0,4,1,3
173911,10000,100,0,1,16,9,7,0,0,0,0,0,0,2,2,0,0,0,0,0,0,0,14,7,7,0,0,0,0,0,0,0,0,0
173920,10000,100,0,1,59,24,35,0,0,0,4,1,3,3,0,3,8,3,5,0,0,0,41,17,24,2,2,0,1,1,0,0,0,0
173957,10000,100,0,1,34,8,26,0,0,0,1,0,1,4,1,3,5,0,5,0,0,0,24,7,17,0,0,0,0,0,0,0,0,0
173993,10000,100,0,1,1,1,0,0,0,0,0,0,0,0,0,0,0,0,0,0,0,0,1,1,0,0,0,0,0,0,0,0,0,0
174020,10000,100,0,1,29,7,22,0,0,0,9,0,9,2,0,2,1,0,1,0,0,0,12,4,8,2,2,0,3,1,2,0,0,0
174066,10000,100,0,1,1815,747,1068,6,0,6,158,70,88,160,75,85,84,32,52,4,2,2,1038,389,649,72,29,43,113,51,62,180,99,81
174075,10000,100,0,1,31,16,15,0,0,0,1,1,0,0,0,0,3,0,3,0,0,0,26,14,12,0,0,0,0,0,0,1,1,0
174127,10000,100,0,1,30,15,15,0,0,0,2,1,1,5,2,3,4,4,0,0,0,0,13,4,9,2,1,1,4,3,1,0,0,0
174136,10000,100,0,1,13,6,7,0,0,0,5,1,4,1,1,0,0,0,0,0,0,0,7,4,3,0,0,0,0,0,0,0,0,0
174154,10000,100,0,1,12,0,12,1,0,1,0,0,0,0,0,0,0,0,0,0,0,0,11,0,11,0,0,0,0,0,0,0,0,0
174233,10000,100,0,1,104,54,50,1,0,1,6,2,4,2,1,1,2,1,1,0,0,0,83,42,41,1,1,0,2,2,0,7,5,2
174251,10000,100,0,1,21,10,11,2,1,1,1,0,1,2,1,1,0,0,0,0,0,0,12,7,5,2,0,2,2,1,1,0,0,0
174358,10000,100,0,1,25,10,15,0,0,0,0,0,0,0,0,0,1,1,0,0,0,0,21,7,14,0,0,0,2,2,0,1,0,1
174376,10000,100,0,1,14,8,6,0,0,0,2,1,1,1,0,1,0,0,0,0,0,0,9,6,3,1,1,0,1,0,1,0,0,0
174428,10000,100,0,1,21,6,15,0,0,0,3,1,2,3,3,0,0,0,0,0,0,0,13,1,12,1,1,0,1,0,1,0,0,0
174437,10000,100,0,1,17,5,12,0,0,0,0,0,0,0,0,0,0,0,0,0,0,0,17,5,12,0,0,0,0,0,0,0,0,0
174473,10000,100,0,1,6,4,2,0,0,0,0,0,0,0,0,0,0,0,0,0,0,0,5,3,2,0,0,0,0,0,0,1,1,0
174491,10000,100,0,1,30,13,17,0,0,0,3,0,3,1,1,0,3,1,2,0,0,0,21,10,11,0,0,0,2,1,1,0,0,0
174507,10000,100,0,1,14,3,11,0,0,0,0,0,0,0,0,0,2,2,0,0,0,0,12,1,11,0,0,0,0,0,0,0,0,0
174525,10000,100,0,1,4,2,2,0,0,0,0,0,0,0,0,0,0,0,0,0,0,0,4,2,2,0,0,0,0,0,0,0,0,0
174570,10000,100,0,1,2,1,1,0,0,0,0,0,0,0,0,0,0,0,0,0,0,0,2,1,1,0,0,0,0,0,0,0,0,0
174738,10000,100,0,1,7,2,5,0,0,0,0,0,0,0,0,0,0,0,0,0,0,0,7,2,5,0,0,0,0,0,0,0,0,0
174747,10000,100,0,1,29,11,18,0,0,0,2,1,1,3,0,3,0,0,0,0,0,0,18,8,10,1,0,1,5,2,3,0,0,0
174756,10000,100,0,1,11,5,6,0,0,0,0,0,0,1,1,0,0,0,0,0,0,0,10,4,6,0,0,0,0,0,0,0,0,0
174783,10000,100,0,1,52,26,26,0,0,0,7,5,2,6,4,2,1,1,0,0,0,0,32,12,20,1,1,0,5,3,2,0,0,0
174792,10000,100,0,1,45,23,22,1,1,0,2,0,2,0,0,0,3,3,0,0,0,0,35,17,18,1,1,0,3,1,2,0,0,0
174817,10000,100,0,1,85,37,48,0,0,0,4,3,1,5,2,3,0,0,0,0,0,0,68,27,41,0,0,0,8,5,3,0,0,0
174844,10000,100,0,1,65,35,30,1,0,1,3,1,2,2,2,0,6,6,0,1,1,0,50,24,26,0,0,0,1,1,0,1,0,1
174862,10000,100,0,1,14,8,6,0,0,0,1,1,0,0,0,0,0,0,0,0,0,0,12,7,5,1,0,1,0,0,0,0,0,0
174899,10000,100,0,1,24,13,11,2,0,2,1,1,0,0,0,0,1,0,1,0,0,0,16,10,6,4,2,2,0,0,0,0,0,0
174914,10000,100,0,1,167,89,78,0,0,0,11,4,7,13,5,8,22,10,12,0,0,0,111,63,48,8,6,2,1,1,0,1,0,1
175005,10000,100,0,1,95,22,73,0,0,0,6,2,4,11,3,8,2,0,2,1,0,1,73,17,56,2,0,2,0,0,0,0,0,0
175014,10000,100,0,1,47,8,39,0,0,0,5,1,4,2,1,1,2,0,2,0,0,0,35,5,30,2,1,1,1,0,1,0,0,0
175041,10000,100,0,1,12,7,5,0,0,0,3,2,1,1,1,0,1,1,0,0,0,0,6,3,3,0,0,0,1,0,1,0,0,0
175078,10000,100,0,1,9,6,3,0,0,0,0,0,0,1,1,0,0,0,0,0,0,0,8,5,3,0,0,0,0,0,0,0,0,0
175157,10000,100,0,1,1,1,0,0,0,0,0,0,0,1,1,0,0,0,0,0,0,0,0,0,0,0,0,0,0,0,0,0,0,0
175227,10000,100,0,1,17,9,8,0,0,0,1,0,1,0,0,0,1,0,1,0,0,0,14,8,6,1,1,0,0,0,0,0,0,0
175236,10000,100,0,1,6,3,3,0,0,0,0,0,0,0,0,0,0,0,0,0,0,0,5,3,2,0,0,0,1,0,1,0,0,0
175263,10000,100,0,1,7,2,5,0,0,0,1,1,0,0,0,0,0,0,0,0,0,0,6,1,5,0,0,0,0,0,0,0,0,0
175272,10000,100,0,1,36,13,23,0,0,0,2,1,1,0,0,0,1,0,1,0,0,0,30,11,19,1,0,1,2,1,1,0,0,0
175281,10000,100,0,1,118,48,70,0,0,0,7,4,3,20,12,8,3,1,2,0,0,0,79,27,52,3,2,1,6,2,4,0,0,0
175315,10000,100,0,1,13,4,9,0,0,0,2,0,2,3,1,2,3,1,2,0,0,0,4,2,2,0,0,0,1,0,1,0,0,0
175342,10000,100,0,1,54,22,32,0,0,0,0,0,0,46,17,29,4,3,1,0,0,0,4,2,2,0,0,0,0,0,0,0,0,0
175421,10000,100,0,1,46,16,30,0,0,0,1,1,0,16,3,13,0,0,0,0,0,0,29,12,17,0,0,0,0,0,0,0,0,0
175430,10000,100,0,1,21,16,5,0,0,0,0,0,0,4,4,0,0,0,0,0,0,0,17,12,5,0,0,0,0,0,0,0,0,0
175519,10000,100,0,1,28,21,7,0,0,0,0,0,0,22,16,6,0,0,0,0,0,0,5,4,1,0,0,0,1,1,0,0,0,0
175573,10000,100,0,1,36,22,14,0,0,0,0,0,0,11,7,4,0,0,0,0,0,0,23,14,9,1,0,1,1,1,0,0,0,0
175616,10000,100,0,1,89,44,45,1,0,1,2,2,0,30,12,18,2,1,1,0,0,0,52,28,24,0,0,0,0,0,0,2,1,1
175643,10000,100,0,1,18,13,5,0,0,0,0,0,0,1,1,0,0,0,0,0,0,0,17,12,5,0,0,0,0,0,0,0,0,0
175652,10000,100,0,1,11,4,7,0,0,0,0,0,0,7,1,6,0,0,0,0,0,0,4,3,1,0,0,0,0,0,0,0,0,0
175786,10000,100,0,1,136,55,81,1,0,1,0,0,0,72,22,50,1,0,1,0,0,0,55,31,24,0,0,0,7,2,5,0,0,0
175810,10000,100,0,1,31,8,23,0,0,0,1,0,1,8,2,6,0,0,0,0,0,0,22,6,16,0,0,0,0,0,0,0,0,0
175829,10000,100,0,1,44,18,26,0,0,0,0,0,0,5,1,4,1,0,1,0,0,0,38,17,21,0,0,0,0,0,0,0,0,0
175856,10000,100,0,1,234,101,133,2,1,1,4,3,1,196,76,120,1,1,0,0,0,0,27,18,9,0,0,0,0,0,0,4,2,2
175883,10000,100,0,1,52,28,24,0,0,0,2,2,0,10,1,9,0,0,0,1,1,0,39,24,15,0,0,0,0,0,0,0,0,0
175935,10000,100,0,1,32,7,25,0,0,0,0,0,0,9,2,7,1,1,0,0,0,0,21,4,17,0,0,0,1,0,1,0,0,0
175980,10000,100,0,1,26,13,13,0,0,0,0,0,0,5,3,2,1,0,1,0,0,0,18,9,9,2,1,1,0,0,0,0,0,0
175999,10000,100,0,1,2,0,2,0,0,0,0,0,0,1,0,1,0,0,0,0,0,0,1,0,1,0,0,0,0,0,0,0,0,0
176008,10000,100,0,1,50,24,26,0,0,0,0,0,0,30,18,12,0,0,0,0,0,0,20,6,14,0,0,0,0,0,0,0,0,0
176017,10000,100,0,1,1821,510,1311,1,0,1,50,23,27,626,110,516,28,9,19,0,0,0,997,308,689,27,10,17,19,12,7,73,38,35
176035,10000,100,0,1,41,11,30,0,0,0,1,1,0,6,1,5,0,0,0,0,0,0,33,8,25,0,0,0,0,0,0,1,1,0
176044,10000,100,0,1,48,19,29,0,0,0,1,1,0,44,17,27,0,0,0,0,0,0,3,1,2,0,0,0,0,0,0,0,0,0
176053,10000,100,0,1,69,30,39,0,0,0,0,0,0,6,2,4,2,1,1,0,0,0,28,10,18,0,0,0,32,16,16,1,1,0
176071,10000,100,0,1,115,35,80,0,0,0,3,1,2,22,4,18,3,0,3,0,0,0,68,21,47,2,1,1,17,8,9,0,0,0
176080,10000,100,0,1,605,288,317,2,1,1,15,8,7,122,41,81,15,8,7,0,0,0,383,187,196,8,4,4,4,1,3,56,38,18
176169,10000,100,0,1,26,6,20,0,0,0,0,0,0,3,0,3,0,0,0,0,0,0,17,3,14,0,0,0,6,3,3,0,0,0
176178,10000,100,0,1,60,24,36,0,0,0,0,0,0,20,5,15,1,0,1,0,0,0,39,19,20,0,0,0,0,0,0,0,0,0
176239,10000,100,0,1,72,22,50,0,0,0,0,0,0,14,4,10,2,0,2,0,0,0,56,18,38,0,0,0,0,0,0,0,0,0
176318,10000,100,0,1,49,26,23,0,0,0,0,0,0,43,26,17,1,0,1,0,0,0,2,0,2,0,0,0,3,0,3,0,0,0
176354,10000,100,0,1,26,11,15,0,0,0,0,0,0,8,3,5,0,0,0,0,0,0,18,8,10,0,0,0,0,0,0,0,0,0
176406,10000,100,0,1,45,17,28,0,0,0,0,0,0,43,17,26,1,0,1,0,0,0,0,0,0,0,0,0,1,0,1,0,0,0
176451,10000,100,0,1,3,1,2,0,0,0,0,0,0,0,0,0,0,0,0,0,0,0,3,1,2,0,0,0,0,0,0,0,0,0
176479,10000,100,0,1,44,19,25,0,0,0,1,1,0,9,5,4,1,1,0,1,0,1,31,11,20,0,0,0,1,1,0,0,0,0
176600,10000,100,0,1,3,2,1,0,0,0,0,0,0,0,0,0,0,0,0,0,0,0,3,2,1,0,0,0,0,0,0,0,0,0
176628,10000,100,0,1,37,12,25,0,0,0,0,0,0,6,1,5,2,0,2,0,0,0,29,11,18,0,0,0,0,0,0,0,0,0
176664,10000,100,0,1,6,4,2,0,0,0,0,0,0,1,0,1,0,0,0,0,0,0,5,4,1,0,0,0,0,0,0,0,0,0
176789,10000,100,0,1,12,7,5,0,0,0,1,1,0,1,0,1,1,1,0,0,0,0,8,5,3,0,0,0,1,0,1,0,0,0
176910,10000,100,0,1,12,8,4,0,0,0,0,0,0,0,0,0,1,1,0,0,0,0,11,7,4,0,0,0,0,0,0,0,0,0
176947,10000,100,0,1,35,18,17,0,0,0,0,0,0,3,2,1,0,0,0,0,0,0,32,16,16,0,0,0,0,0,0,0,0,0
176965,10000,100,0,1,101,52,49,1,1,0,2,0,2,5,3,2,5,2,3,0,0,0,77,39,38,4,1,3,1,0,1,6,6,0
177038,10000,100,0,1,9,3,6,0,0,0,0,0,0,1,1,0,2,0,2,0,0,0,5,1,4,1,1,0,0,0,0,0,0,0
177065,10000,100,0,1,79,24,55,0,0,0,2,2,0,4,1,3,3,0,3,0,0,0,53,18,35,5,1,4,11,2,9,1,0,1
177092,10000,100,0,1,14,9,5,0,0,0,1,0,1,1,1,0,1,1,0,0,0,0,11,7,4,0,0,0,0,0,0,0,0,0
177117,10000,100,0,1,9,2,7,0,0,0,0,0,0,0,0,0,0,0,0,0,0,0,6,1,5,0,0,0,0,0,0,3,1,2
177126,10000,100,0,1,5,3,2,0,0,0,0,0,0,0,0,0,0,0,0,0,0,0,5,3,2,0,0,0,0,0,0,0,0,0
177135,10000,100,0,1,31,10,21,1,1,0,0,0,0,0,0,0,1,0,1,0,0,0,25,8,17,1,0,1,3,1,2,0,0,0
177144,10000,100,0,1,31,16,15,0,0,0,1,1,0,3,3,0,0,0,0,0,0,0,27,12,15,0,0,0,0,0,0,0,0,0
177214,10000,100,0,1,53,28,25,0,0,0,0,0,0,0,0,0,0,0,0,0,0,0,23,13,10,0,0,0,30,15,15,0,0,0
177250,10000,100,0,1,17,5,12,0,0,0,0,0,0,0,0,0,0,0,0,0,0,0,15,4,11,1,0,1,1,1,0,0,0,0
177302,10000,100,0,1,51,15,36,1,0,1,1,1,0,16,4,12,5,2,3,0,0,0,22,5,17,6,3,3,0,0,0,0,0,0
177339,10000,100,0,1,32,19,13,0,0,0,0,0,0,1,1,0,2,2,0,0,0,0,19,10,9,4,2,2,6,4,2,0,0,0
177418,10000,100,0,1,34,13,21,1,0,1,2,1,1,6,3,3,4,1,3,0,0,0,21,8,13,0,0,0,0,0,0,0,0,0
177472,10000,100,0,1,75,33,42,0,0,0,0,0,0,3,2,1,2,0,2,1,0,1,53,25,28,2,1,1,14,5,9,0,0,0
177542,10000,100,0,1,10,4,6,0,0,0,0,0,0,1,1,0,0,0,0,0,0,0,9,3,6,0,0,0,0,0,0,0,0,0
177551,10000,100,0,1,58,34,24,0,0,0,1,1,0,38,20,18,0,0,0,0,0,0,18,12,6,1,1,0,0,0,0,0,0,0
177676,10000,100,0,1,35,13,22,0,0,0,0,0,0,0,0,0,0,0,0,0,0,0,34,12,22,1,1,0,0,0,0,0,0,0
177719,10000,100,0,1,5,0,5,0,0,0,0,0,0,2,0,2,0,0,0,0,0,0,3,0,3,0,0,0,0,0,0,0,0,0
177746,10000,100,0,1,17,8,9,0,0,0,0,0,0,3,1,2,4,1,3,0,0,0,10,6,4,0,0,0,0,0,0,0,0,0
177940,10000,100,0,1,47,26,21,2,2,0,2,2,0,16,9,7,1,0,1,0,0,0,23,13,10,2,0,2,1,0,1,0,0,0
177968,10000,100,0,1,108,45,63,0,0,0,4,3,1,15,5,10,6,5,1,1,1,0,77,29,48,2,0,2,0,0,0,3,2,1
177977,10000,100,0,1,36,23,13,0,0,0,1,1,0,0,0,0,0,0,0,0,0,0,34,21,13,1,1,0,0,0,0,0,0,0
177986,10000,100,0,1,80,32,48,0,0,0,3,1,2,7,3,4,5,2,3,0,0,0,63,25,38,2,1,1,0,0,0,0,0,0
177995,10000,100,0,1,41,19,22,0,0,0,3,3,0,3,1,2,2,2,0,0,0,0,28,12,16,2,1,1,3,0,3,0,0,0
178059,10000,100,0,1,39,14,25,0,0,0,0,0,0,5,2,3,1,1,0,0,0,0,32,11,21,1,0,1,0,0,0,0,0,0
178183,10000,100,0,1,2,0,2,0,0,0,0,0,0,0,0,0,0,0,0,0,0,0,2,0,2,0,0,0,0,0,0,0,0,0
178208,10000,100,0,1,22,14,8,0,0,0,0,0,0,0,0,0,1,1,0,0,0,0,20,12,8,1,1,0,0,0,0,0,0,0
178217,10000,100,0,1,10,2,8,0,0,0,0,0,0,0,0,0,0,0,0,0,0,0,10,2,8,0,0,0,0,0,0,0,0,0
178244,10000,100,0,1,32,15,17,0,0,0,1,0,1,6,4,2,0,0,0,0,0,0,25,11,14,0,0,0,0,0,0,0,0,0
178341,10000,100,0,1,79,33,46,3,2,1,0,0,0,9,6,3,3,2,1,1,1,0,54,16,38,0,0,0,6,4,2,3,2,1
178369,10000,100,0,1,40,21,19,0,0,0,2,2,0,4,4,0,2,0,2,0,0,0,32,15,17,0,0,0,0,0,0,0,0,0
178387,10000,100,0,1,84,36,48,0,0,0,0,0,0,2,1,1,4,2,2,0,0,0,35,13,22,1,0,1,40,20,20,2,0,2
178396,10000,100,0,1,1200,461,739,5,1,4,52,22,30,107,44,63,57,24,33,1,0,1,775,277,498,23,7,16,76,24,52,104,62,42
178402,10000,100,0,1,427,187,240,0,0,0,25,14,11,56,22,34,24,10,14,0,0,0,215,87,128,15,5,10,54,23,31,38,26,12
178411,10000,100,0,1,134,68,66,2,2,0,7,3,4,3,1,2,5,3,2,0,0,0,87,37,50,2,1,1,7,2,5,21,19,2
178420,10000,100,0,1,176,65,111,0,0,0,9,4,5,41,15,26,10,3,7,0,0,0,100,35,65,4,1,3,7,3,4,5,4,1
178439,10000,100,0,1,75,28,47,0,0,0,4,1,3,4,1,3,7,3,4,0,0,0,56,20,36,1,0,1,3,3,0,0,0,0
178448,10000,100,0,1,35,16,19,0,0,0,0,0,0,3,2,1,0,0,0,0,0,0,31,14,17,0,0,0,1,0,1,0,0,0
178518,10000,100,0,1,1,1,0,0,0,0,0,0,0,1,1,0,0,0,0,0,0,0,0,0,0,0,0,0,0,0,0,0,0,0
178615,10000,100,0,1,78,43,35,0,0,0,3,2,1,3,2,1,2,2,0,0,0,0,67,36,31,0,0,0,0,0,0,3,1,2
178624,10000,100,0,1,108,36,72,2,1,1,3,1,2,4,3,1,5,2,3,0,0,0,86,25,61,1,0,1,0,0,0,7,4,3
178679,10000,100,0,1,4,3,1,0,0,0,0,0,0,0,0,0,0,0,0,0,0,0,4,3,1,0,0,0,0,0,0,0,0,0
178697,10000,100,0,1,24,15,9,0,0,0,0,0,0,0,0,0,0,0,0,0,0,0,24,15,9,0,0,0,0,0,0,0,0,0
178721,10000,100,0,1,64,22,42,2,0,2,1,1,0,3,2,1,5,2,3,0,0,0,47,15,32,5,2,3,1,0,1,0,0,0
178891,10000,100,0,1,16,8,8,0,0,0,0,0,0,7,2,5,0,0,0,0,0,0,9,6,3,0,0,0,0,0,0,0,0,0
178989,10000,100,0,1,6,2,4,0,0,0,0,0,0,0,0,0,1,0,1,0,0,0,5,2,3,0,0,0,0,0,0,0,0,0
179043,10000,100,0,1,48,11,37,0,0,0,0,0,0,4,1,3,2,0,2,0,0,0,36,9,27,0,0,0,5,1,4,1,0,1
179159,10000,100,0,1,774,312,462,2,0,2,61,30,31,146,35,111,32,14,18,0,0,0,437,187,250,27,8,19,2,2,0,67,36,31
179308,10000,100,0,1,152,45,107,0,0,0,3,0,3,50,14,36,7,5,2,0,0,0,74,21,53,4,1,3,11,2,9,3,2,1
179317,10000,100,0,1,1,1,0,0,0,0,0,0,0,1,1,0,0,0,0,0,0,0,0,0,0,0,0,0,0,0,0,0,0,0
179326,10000,100,0,1,43,19,24,0,0,0,1,1,0,0,0,0,0,0,0,0,0,0,40,17,23,1,0,1,1,1,0,0,0,0
179344,10000,100,0,1,15,7,8,0,0,0,0,0,0,1,1,0,1,1,0,0,0,0,11,3,8,0,0,0,2,2,0,0,0,0
179539,10000,100,0,1,54,15,39,0,0,0,0,0,0,2,1,1,5,1,4,0,0,0,44,10,34,0,0,0,3,3,0,0,0,0
179548,10000,100,0,1,39,15,24,0,0,0,1,0,1,4,3,1,0,0,0,1,0,1,31,10,21,2,2,0,0,0,0,0,0,0
179557,10000,100,0,1,104,54,50,0,0,0,2,2,0,13,7,6,3,1,2,0,0,0,78,38,40,0,0,0,8,6,2,0,0,0
179566,10000,100,0,1,160,61,99,2,1,1,6,2,4,11,5,6,6,4,2,0,0,0,121,46,75,4,1,3,2,1,1,8,1,7
179645,10000,100,0,1,17,6,11,0,0,0,0,0,0,1,1,0,0,0,0,0,0,0,16,5,11,0,0,0,0,0,0,0,0,0
179715,10000,100,0,1,18,7,11,0,0,0,0,0,0,0,0,0,0,0,0,0,0,0,18,7,11,0,0,0,0,0,0,0,0,0
179812,10000,100,0,1,31,15,16,0,0,0,0,0,0,3,2,1,7,5,2,0,0,0,20,8,12,1,0,1,0,0,0,0,0,0
179867,10000,100,0,1,2672,871,1801,5,3,2,258,123,135,492,106,386,94,34,60,1,1,0,1571,476,1095,65,29,36,40,15,25,146,84,62
179894,10000,100,0,1,54,19,35,0,0,0,3,1,2,9,4,5,5,0,5,0,0,0,33,12,21,2,0,2,2,2,0,0,0,0
179946,10000,100,0,1,21,7,14,0,0,0,0,0,0,2,0,2,0,0,0,0,0,0,19,7,12,0,0,0,0,0,0,0,0,0
179955,10000,100,0,1,25,14,11,0,0,0,1,0,1,4,2,2,0,0,0,0,0,0,20,12,8,0,0,0,0,0,0,0,0,0
179964,10000,100,0,1,28,15,13,0,0,0,0,0,0,1,1,0,2,1,1,0,0,0,20,11,9,0,0,0,5,2,3,0,0,0
180054,10000,100,0,1,9,3,6,9,3,6,0,0,0,0,0,0,0,0,0,0,0,0,0,0,0,0,0,0,0,0,0,0,0,0
180106,10000,100,0,1,60,19,41,0,0,0,0,0,0,0,0,0,0,0,0,1,0,1,29,9,20,0,0,0,30,10,20,0,0,0
180151,10000,100,0,1,4,2,2,0,0,0,0,0,0,0,0,0,0,0,0,0,0,0,4,2,2,0,0,0,0,0,0,0,0,0
180179,10000,100,0,1,89,34,55,3,2,1,2,0,2,3,2,1,2,2,0,0,0,0,78,28,50,0,0,0,1,0,1,0,0,0
180197,10000,100,0,1,27,10,17,0,0,0,1,0,1,0,0,0,1,1,0,0,0,0,24,9,15,0,0,0,1,0,1,0,0,0
180203,10000,100,0,1,6,4,2,5,3,2,0,0,0,0,0,0,0,0,0,0,0,0,1,1,0,0,0,0,0,0,0,0,0,0
180212,10000,100,0,1,12,5,7,8,4,4,0,0,0,0,0,0,0,0,0,0,0,0,4,1,3,0,0,0,0,0,0,0,0,0
180249,10000,100,0,1,11,2,9,0,0,0,0,0,0,0,0,0,0,0,0,0,0,0,11,2,9,0,0,0,0,0,0,0,0,0
180258,10000,100,0,1,26,12,14,0,0,0,0,0,0,0,0,0,3,2,1,0,0,0,15,8,7,4,0,4,3,2,1,1,0,1
180276,10000,100,0,1,6,1,5,0,0,0,0,0,0,0,0,0,0,0,0,0,0,0,6,1,5,0,0,0,0,0,0,0,0,0
180328,10000,100,0,1,14,7,7,13,7,6,0,0,0,0,0,0,0,0,0,0,0,0,0,0,0,1,0,1,0,0,0,0,0,0
180373,10000,100,0,1,14,6,8,1,0,1,0,0,0,0,0,0,0,0,0,0,0,0,8,3,5,0,0,0,5,3,2,0,0,0
180416,10000,100,0,1,32,14,18,0,0,0,0,0,0,0,0,0,2,0,2,0,0,0,30,14,16,0,0,0,0,0,0,0,0,0
180461,10000,100,0,1,351,168,183,5,2,3,7,4,3,2,1,1,14,7,7,0,0,0,275,125,150,14,5,9,22,16,6,12,8,4
180489,10000,100,0,1,223,95,128,8,1,7,16,2,14,2,2,0,9,5,4,0,0,0,180,83,97,3,0,3,3,1,2,2,1,1
180522,10000,100,0,1,14,8,6,0,0,0,0,0,0,3,2,1,0,0,0,0,0,0,9,4,5,0,0,0,2,2,0,0,0,0
180595,10000,100,0,1,21,10,11,0,0,0,0,0,0,0,0,0,0,0,0,1,0,1,16,8,8,0,0,0,4,2,2,0,0,0
180647,10000,100,0,1,18,7,11,9,4,5,0,0,0,0,0,0,1,0,1,0,0,0,8,3,5,0,0,0,0,0,0,0,0,0
180692,10000,100,0,1,26,11,15,0,0,0,1,0,1,0,0,0,1,1,0,0,0,0,11,5,6,1,1,0,12,4,8,0,0,0
180814,10000,100,0,1,40,17,23,0,0,0,0,0,0,0,0,0,0,0,0,0,0,0,33,12,21,2,1,1,5,4,1,0,0,0
180832,10000,100,0,1,11,1,10,0,0,0,0,0,0,0,0,0,0,0,0,0,0,0,11,1,10,0,0,0,0,0,0,0,0,0
180878,10000,100,0,1,4,0,4,0,0,0,0,0,0,0,0,0,0,0,0,0,0,0,4,0,4,0,0,0,0,0,0,0,0,0
180902,10000,100,0,1,24,10,14,0,0,0,2,1,1,0,0,0,0,0,0,0,0,0,21,9,12,1,0,1,0,0,0,0,0,0
180948,10000,100,0,1,29,17,12,1,1,0,0,0,0,1,0,1,0,0,0,0,0,0,27,16,11,0,0,0,0,0,0,0,0,0
180984,10000,100,0,1,31,9,22,0,0,0,1,1,0,2,0,2,0,0,0,0,0,0,28,8,20,0,0,0,0,0,0,0,0,0
181002,10000,100,0,1,286,104,182,1,0,1,23,9,14,15,3,12,26,7,19,1,0,1,158,55,103,3,1,2,58,28,30,1,1,0
181020,10000,100,0,1,42,23,19,0,0,0,3,2,1,1,1,0,2,2,0,0,0,0,30,13,17,3,2,1,3,3,0,0,0,0
181127,10000,100,0,1,28,12,16,0,0,0,0,0,0,1,1,0,0,0,0,0,0,0,27,11,16,0,0,0,0,0,0,0,0,0
181215,10000,100,0,1,75,37,38,0,0,0,4,3,1,0,0,0,1,0,1,0,0,0,63,30,33,0,0,0,0,0,0,7,4,3
181303,10000,100,0,1,85,37,48,2,1,1,2,0,2,8,4,4,10,2,8,0,0,0,60,28,32,2,1,1,1,1,0,0,0,0
181312,10000,100,0,1,20,14,6,0,0,0,0,0,0,0,0,0,0,0,0,0,0,0,20,14,6,0,0,0,0,0,0,0,0,0
181330,10000,100,0,1,37,17,20,0,0,0,2,1,1,2,2,0,2,1,1,0,0,0,31,13,18,0,0,0,0,0,0,0,0,0
181394,10000,100,0,1,76,36,40,0,0,0,2,0,2,4,2,2,12,7,5,0,0,0,41,19,22,1,1,0,4,2,2,12,5,7
181419,10000,100,0,1,16,6,10,11,4,7,1,1,0,0,0,0,0,0,0,0,0,0,4,1,3,0,0,0,0,0,0,0,0,0
181428,10000,100,0,1,692,327,365,2,0,2,59,28,31,30,12,18,51,22,29,0,0,0,448,204,244,12,2,10,7,3,4,83,56,27
181446,10000,100,0,1,35,15,20,0,0,0,3,1,2,3,1,2,1,0,1,0,0,0,26,13,13,1,0,1,0,0,0,1,0,1
181464,10000,100,0,1,455,232,223,2,0,2,14,8,6,21,13,8,32,11,21,0,0,0,320,157,163,5,2,3,2,1,1,59,40,19
181491,10000,100,0,1,29,16,13,0,0,0,0,0,0,0,0,0,0,0,0,0,0,0,29,16,13,0,0,0,0,0,0,0,0,0
181534,10000,100,0,1,34,19,15,0,0,0,0,0,0,2,2,0,1,0,1,0,0,0,30,17,13,0,0,0,1,0,1,0,0,0
181604,10000,100,0,1,27,8,19,0,0,0,0,0,0,5,2,3,1,1,0,0,0,0,20,5,15,1,0,1,0,0,0,0,0,0
181640,10000,100,0,1,42,20,22,0,0,0,2,1,1,1,1,0,0,0,0,0,0,0,39,18,21,0,0,0,0,0,0,0,0,0
181738,10000,100,0,1,23,7,16,0,0,0,0,0,0,2,0,2,2,0,2,0,0,0,19,7,12,0,0,0,0,0,0,0,0,0
181747,10000,100,0,1,41,23,18,0,0,0,4,2,2,4,1,3,2,1,1,0,0,0,28,17,11,2,1,1,0,0,0,1,1,0
181765,10000,100,0,1,1,1,0,0,0,0,0,0,0,0,0,0,0,0,0,0,0,0,1,1,0,0,0,0,0,0,0,0,0,0
181783,10000,100,0,1,60,34,26,0,0,0,0,0,0,4,3,1,2,1,1,1,0,1,53,30,23,0,0,0,0,0,0,0,0,0
181817,10000,100,0,1,24,10,14,0,0,0,0,0,0,0,0,0,2,0,2,0,0,0,22,10,12,0,0,0,0,0,0,0,0,0
181853,10000,100,0,1,13,7,6,0,0,0,0,0,0,1,0,1,1,0,1,0,0,0,11,7,4,0,0,0,0,0,0,0,0,0
181941,10000,100,0,1,10,7,3,1,1,0,0,0,0,0,0,0,2,1,1,0,0,0,7,5,2,0,0,0,0,0,0,0,0,0
182005,10000,100,0,1,63,22,41,0,0,0,6,3,3,12,4,8,16,6,10,0,0,0,23,8,15,4,1,3,2,0,2,0,0,0
182148,10000,100,0,1,27,5,22,0,0,0,1,1,0,5,2,3,5,0,5,0,0,0,16,2,14,0,0,0,0,0,0,0,0,0
182281,10000,100,0,1,224,99,125,3,2,1,32,12,20,35,17,18,35,14,21,2,1,1,88,35,53,13,9,4,2,1,1,14,8,6
182290,10000,100,0,1,245,83,162,3,2,1,17,1,16,8,3,5,49,12,37,0,0,0,142,53,89,15,5,10,0,0,0,11,7,4
182306,10000,100,0,1,27,12,15,2,1,1,0,0,0,0,0,0,5,2,3,0,0,0,17,7,10,1,1,0,1,0,1,1,1,0
182458,10000,100,0,1,7,2,5,0,0,0,0,0,0,1,0,1,0,0,0,1,0,1,5,2,3,0,0,0,0,0,0,0,0,0
182500,10000,100,0,1,22,8,14,0,0,0,0,0,0,1,1,0,7,2,5,0,0,0,11,4,7,3,1,2,0,0,0,0,0,0
182519,10000,100,0,1,6,4,2,0,0,0,0,0,0,1,1,0,2,2,0,0,0,0,3,1,2,0,0,0,0,0,0,0,0,0
182564,10000,100,0,1,8,2,6,1,1,0,0,0,0,0,0,0,0,0,0,0,0,0,7,1,6,0,0,0,0,0,0,0,0,0
182634,10000,100,0,1,37,14,23,0,0,0,0,0,0,2,1,1,2,1,1,0,0,0,33,12,21,0,0,0,0,0,0,0,0,0
182670,10000,100,0,1,400,159,241,1,1,0,9,4,5,9,3,6,7,3,4,0,0,0,335,134,201,6,0,6,0,0,0,33,14,19
182795,10000,100,0,1,40,21,19,0,0,0,1,0,1,2,2,0,4,3,1,0,0,0,32,15,17,1,1,0,0,0,0,0,0,0
182829,10000,100,0,1,14,4,10,0,0,0,1,0,1,1,0,1,0,0,0,0,0,0,9,1,8,1,1,0,2,2,0,0,0,0
182980,10000,100,0,1,51,21,30,0,0,0,2,1,1,3,1,2,1,1,0,0,0,0,45,18,27,0,0,0,0,0,0,0,0,0
183026,10000,100,0,1,937,311,626,7,3,4,28,6,22,87,21,66,55,17,38,0,0,0,664,231,433,30,12,18,66,21,45,0,0,0
183044,10000,100,0,1,338,141,197,1,0,1,9,4,5,7,3,4,18,7,11,0,0,0,243,97,146,6,2,4,22,8,14,32,20,12
183062,10000,100,0,1,52,25,27,0,0,0,1,0,1,0,0,0,1,1,0,0,0,0,41,18,23,0,0,0,6,3,3,3,3,0
183071,10000,100,0,1,4,3,1,0,0,0,0,0,0,0,0,0,0,0,0,0,0,0,4,3,1,0,0,0,0,0,0,0,0,0
183080,10000,100,0,1,45,17,28,0,0,0,0,0,0,0,0,0,1,0,1,0,0,0,38,16,22,0,0,0,4,1,3,2,0,2
183099,10000,100,0,1,7,4,3,0,0,0,0,0,0,0,0,0,0,0,0,0,0,0,7,4,3,0,0,0,0,0,0,0,0,0
183105,10000,100,0,1,2,2,0,0,0,0,0,0,0,0,0,0,0,0,0,0,0,0,2,2,0,0,0,0,0,0,0,0,0,0
183114,10000,100,0,1,2,0,2,0,0,0,0,0,0,0,0,0,0,0,0,0,0,0,2,0,2,0,0,0,0,0,0,0,0,0
183123,10000,100,0,1,9,4,5,0,0,0,0,0,0,0,0,0,0,0,0,0,0,0,7,3,4,0,0,0,2,1,1,0,0,0
183132,10000,100,0,1,6,0,6,0,0,0,0,0,0,1,0,1,0,0,0,0,0,0,4,0,4,1,0,1,0,0,0,0,0,0
183141,10000,100,0,1,4,2,2,0,0,0,0,0,0,0,0,0,1,1,0,0,0,0,3,1,2,0,0,0,0,0,0,0,0,0
183150,10000,100,0,1,4,2,2,0,0,0,0,0,0,0,0,0,0,0,0,0,0,0,4,2,2,0,0,0,0,0,0,0,0,0
183211,10000,100,0,1,42,14,28,0,0,0,2,0,2,1,1,0,0,0,0,0,0,0,38,13,25,1,0,1,0,0,0,0,0,0
183239,10000,100,0,1,62,25,37,0,0,0,2,0,2,2,2,0,3,0,3,0,0,0,51,21,30,0,0,0,4,2,2,0,0,0
183248,10000,100,0,1,2,0,2,0,0,0,0,0,0,0,0,0,0,0,0,0,0,0,2,0,2,0,0,0,0,0,0,0,0,0
183257,10000,100,0,1,15,4,11,0,0,0,0,0,0,0,0,0,0,0,0,0,0,0,13,4,9,0,0,0,2,0,2,0,0,0
183275,10000,100,0,1,1,0,1,0,0,0,0,0,0,0,0,0,0,0,0,0,0,0,1,0,1,0,0,0,0,0,0,0,0,0
183327,10000,100,0,1,23,5,18,0,0,0,1,0,1,0,0,0,1,0,1,0,0,0,15,4,11,2,0,2,4,1,3,0,0,0
183488,10000,100,0,1,2,0,2,0,0,0,1,0,1,0,0,0,1,0,1,0,0,0,0,0,0,0,0,0,0,0,0,0,0,0
183655,10000,100,0,1,35,14,21,0,0,0,2,1,1,9,5,4,4,1,3,0,0,0,20,7,13,0,0,0,0,0,0,0,0,0
183743,10000,100,0,1,16,10,6,0,0,0,0,0,0,4,1,3,2,2,0,0,0,0,9,6,3,0,0,0,1,1,0,0,0,0
183789,10000,100,0,1,17,3,14,0,0,0,0,0,0,2,0,2,5,0,5,0,0,0,7,2,5,1,1,0,2,0,2,0,0,0
183804,10000,100,0,1,2,1,1,0,0,0,0,0,0,0,0,0,0,0,0,0,0,0,2,1,1,0,0,0,0,0,0,0,0,0
183822,10000,100,0,1,23,10,13,0,0,0,0,0,0,13,6,7,4,1,3,0,0,0,6,3,3,0,0,0,0,0,0,0,0,0
183859,10000,100,0,1,38,17,21,0,0,0,1,0,1,1,0,1,0,0,0,0,0,0,34,15,19,1,1,0,1,1,0,0,0,0
183910,10000,100,0,1,25,13,12,0,0,0,1,0,1,1,0,1,2,2,0,0,0,0,21,11,10,0,0,0,0,0,0,0,0,0
183938,10000,100,0,1,26,15,11,0,0,0,2,1,1,5,3,2,3,2,1,0,0,0,15,9,6,0,0,0,1,0,1,0,0,0
183974,10000,100,0,1,29,13,16,0,0,0,0,0,0,2,1,1,3,0,3,0,0,0,24,12,12,0,0,0,0,0,0,0,0,0
184180,10000,100,0,1,18,4,14,0,0,0,0,0,0,1,1,0,6,0,6,0,0,0,11,3,8,0,0,0,0,0,0,0,0,0
184205,10000,100,0,1,15,5,10,1,0,1,0,0,0,1,1,0,2,1,1,0,0,0,11,3,8,0,0,0,0,0,0,0,0,0
184348,10000,100,0,1,30,18,12,0,0,0,2,2,0,4,1,3,0,0,0,0,0,0,23,15,8,0,0,0,0,0,0,1,0,1
184481,10000,100,0,1,35,16,19,0,0,0,0,0,0,18,8,10,9,3,6,0,0,0,6,3,3,0,0,0,2,2,0,0,0,0
184603,10000,100,0,1,46,19,27,0,0,0,1,1,0,4,2,2,3,2,1,0,0,0,27,11,16,7,3,4,4,0,4,0,0,0
184612,10000,100,0,1,50,17,33,0,0,0,3,1,2,9,2,7,14,5,9,0,0,0,19,6,13,1,1,0,2,0,2,2,2,0
184694,10000,100,0,1,37,13,24,0,0,0,4,1,3,5,3,2,1,0,1,0,0,0,21,8,13,1,1,0,5,0,5,0,0,0
184773,10000,100,0,1,27,9,18,0,0,0,2,1,1,1,0,1,4,1,3,0,0,0,18,6,12,2,1,1,0,0,0,0,0,0
184782,10000,100,0,1,276,109,167,0,0,0,13,8,5,49,17,32,22,2,20,0,0,0,158,62,96,13,6,7,3,3,0,18,11,7
184791,10000,100,0,1,39,14,25,0,0,0,2,0,2,10,4,6,0,0,0,1,1,0,22,7,15,0,0,0,4,2,2,0,0,0
184959,10000,100,0,1,9,1,8,0,0,0,0,0,0,1,0,1,1,0,1,0,0,0,7,1,6,0,0,0,0,0,0,0,0,0
184995,10000,100,0,1,28,10,18,1,0,1,1,1,0,8,2,6,7,1,6,0,0,0,10,5,5,1,1,0,0,0,0,0,0,0
185129,10000,100,0,1,54,27,27,0,0,0,8,5,3,16,7,9,12,7,5,0,0,0,14,8,6,2,0,2,2,0,2,0,0,0
185262,10000,100,0,1,128,48,80,0,0,0,14,6,8,35,8,27,23,7,16,0,0,0,42,20,22,2,1,1,8,3,5,4,3,1
185509,10000,100,0,1,25,13,12,0,0,0,2,2,0,8,4,4,3,1,2,0,0,0,12,6,6,0,0,0,0,0,0,0,0,0
185536,10000,100,0,1,16,10,6,0,0,0,2,0,2,4,3,1,1,1,0,0,0,0,9,6,3,0,0,0,0,0,0,0,0,0
185572,10000,100,0,1,47,16,31,1,0,1,2,1,1,3,0,3,4,2,2,0,0,0,35,13,22,2,0,2,0,0,0,0,0,0
185590,10000,100,0,1,122,48,74,0,0,0,8,4,4,21,8,13,19,6,13,0,0,0,46,21,25,3,0,3,20,7,13,5,2,3
185721,10000,100,0,1,12,3,9,0,0,0,1,0,1,1,1,0,0,0,0,0,0,0,10,2,8,0,0,0,0,0,0,0,0,0
185828,10000,100,0,1,148,79,69,0,0,0,21,11,10,22,9,13,18,6,12,0,0,0,57,32,25,1,1,0,10,6,4,19,14,5
185873,10000,100,0,1,43,13,30,0,0,0,4,2,2,0,0,0,4,1,3,0,0,0,32,8,24,1,1,0,2,1,1,0,0,0
186034,10000,100,0,1,30,10,20,0,0,0,3,1,2,8,3,5,8,4,4,0,0,0,10,1,9,1,1,0,0,0,0,0,0,0
186122,10000,100,0,1,9,6,3,0,0,0,0,0,0,1,1,0,1,1,0,0,0,0,7,4,3,0,0,0,0,0,0,0,0,0
186131,10000,100,0,1,475,267,208,2,1,1,32,19,13,44,25,19,31,18,13,0,0,0,179,80,99,7,3,4,29,16,13,151,105,46
186186,10000,100,0,1,2,0,2,0,0,0,0,0,0,0,0,0,2,0,2,0,0,0,0,0,0,0,0,0,0,0,0,0,0,0
186201,10000,100,0,1,22,11,11,0,0,0,1,0,1,3,0,3,2,2,0,0,0,0,16,9,7,0,0,0,0,0,0,0,0,0
186283,10000,100,0,1,44,15,29,0,0,0,3,1,2,14,3,11,9,4,5,0,0,0,16,6,10,0,0,0,0,0,0,2,1,1
186371,10000,100,0,1,59,33,26,0,0,0,0,0,0,3,1,2,2,2,0,0,0,0,9,5,4,0,0,0,41,24,17,4,1,3
186380,10000,100,0,1,1851,791,1060,1,0,1,71,30,41,59,16,43,55,15,40,3,2,1,138,62,76,12,5,7,1298,536,762,214,125,89
186399,10000,100,0,1,103,50,53,0,0,0,3,2,1,3,0,3,3,1,2,1,0,1,10,2,8,2,2,0,59,29,30,22,14,8
186432,10000,100,0,1,37,17,20,0,0,0,5,4,1,8,2,6,5,3,2,0,0,0,19,8,11,0,0,0,0,0,0,0,0,0
186469,10000,100,0,1,5,2,3,0,0,0,0,0,0,0,0,0,0,0,0,0,0,0,5,2,3,0,0,0,0,0,0,0,0,0
186584,10000,100,0,1,107,42,65,0,0,0,2,1,1,19,6,13,21,8,13,0,0,0,55,25,30,3,0,3,4,0,4,3,2,1
186618,10000,100,0,1,37,9,28,0,0,0,2,0,2,7,5,2,2,0,2,0,0,0,22,2,20,0,0,0,4,2,2,0,0,0
186645,10000,100,0,1,23,7,16,0,0,0,1,0,1,3,0,3,4,2,2,0,0,0,12,4,8,1,1,0,0,0,0,2,0,2
186867,10000,100,0,1,116,55,61,0,0,0,11,6,5,7,0,7,8,6,2,0,0,0,53,21,32,1,0,1,12,6,6,24,16,8
186876,10000,100,0,1,79,40,39,0,0,0,4,1,3,8,6,2,11,6,5,0,0,0,54,26,28,0,0,0,1,0,1,1,1,0
187046,10000,100,0,1,19,9,10,0,0,0,3,1,2,5,3,2,4,1,3,0,0,0,7,4,3,0,0,0,0,0,0,0,0,0
187134,10000,100,0,1,54,26,28,0,0,0,2,2,0,13,6,7,7,4,3,0,0,0,26,11,15,0,0,0,6,3,3,0,0,0
187198,10000,100,0,1,46,19,27,0,0,0,1,0,1,20,7,13,8,6,2,0,0,0,12,5,7,1,0,1,4,1,3,0,0,0
187444,10000,100,0,1,41,12,29,0,0,0,3,1,2,7,1,6,12,3,9,0,0,0,15,5,10,1,1,0,3,1,2,0,0,0
187532,10000,100,0,1,81,38,43,3,2,1,1,0,1,4,3,1,31,11,20,0,0,0,37,20,17,1,0,1,4,2,2,0,0,0
187596,10000,100,0,1,57,35,22,43,24,19,0,0,0,3,2,1,0,0,0,0,0,0,7,6,1,0,0,0,1,1,0,3,2,1
187620,10000,100,0,1,7,1,6,0,0,0,0,0,0,1,0,1,5,1,4,0,0,0,1,0,1,0,0,0,0,0,0,0,0,0
187639,10000,100,0,1,44,10,34,2,0,2,3,0,3,2,1,1,14,3,11,1,0,1,22,6,16,0,0,0,0,0,0,0,0,0
187648,10000,100,0,1,57,25,32,0,0,0,0,0,0,1,1,0,10,7,3,0,0,0,34,12,22,1,0,1,5,3,2,6,2,4
187666,10000,100,0,1,31,13,18,1,1,0,0,0,0,0,0,0,21,9,12,0,0,0,8,3,5,1,0,1,0,0,0,0,0,0
187745,10000,100,0,1,3,0,3,2,0,2,0,0,0,0,0,0,1,0,1,0,0,0,0,0,0,0,0,0,0,0,0,0,0,0
187897,10000,100,0,1,60,23,37,2,1,1,3,2,1,1,1,0,16,3,13,1,1,0,26,9,17,1,1,0,8,4,4,2,1,1
187903,10000,100,0,1,20,8,12,0,0,0,0,0,0,2,0,2,5,2,3,0,0,0,13,6,7,0,0,0,0,0,0,0,0,0
187912,10000,100,0,1,37,25,12,1,0,1,1,0,1,2,2,0,12,7,5,0,0,0,19,14,5,0,0,0,0,0,0,2,2,0
187958,10000,100,0,1,3,1,2,1,0,1,0,0,0,0,0,0,1,0,1,0,0,0,0,0,0,0,0,0,0,0,0,1,1,0
187967,10000,100,0,1,125,65,60,7,1,6,4,2,2,5,4,1,49,28,21,0,0,0,58,29,29,0,0,0,0,0,0,2,1,1
187976,10000,100,0,1,3,1,2,0,0,0,0,0,0,0,0,0,0,0,0,0,0,0,3,1,2,0,0,0,0,0,0,0,0,0
187985,10000,100,0,1,586,205,381,18,7,11,35,14,21,18,6,12,200,66,134,0,0,0,237,75,162,21,10,11,15,9,6,42,18,24
187994,10000,100,0,1,10,5,5,1,0,1,0,0,0,1,1,0,6,3,3,0,0,0,2,1,1,0,0,0,0,0,0,0,0,0
188003,10000,100,0,1,8,4,4,0,0,0,0,0,0,0,0,0,4,3,1,0,0,0,4,1,3,0,0,0,0,0,0,0,0,0
188021,10000,100,0,1,2,1,1,0,0,0,0,0,0,0,0,0,2,1,1,0,0,0,0,0,0,0,0,0,0,0,0,0,0,0
188030,10000,100,0,1,148,62,86,2,1,1,3,2,1,8,3,5,45,18,27,0,0,0,80,33,47,0,0,0,0,0,0,10,5,5
188049,10000,100,0,1,4,4,0,0,0,0,0,0,0,0,0,0,3,3,0,0,0,0,1,1,0,0,0,0,0,0,0,0,0,0
188058,10000,100,0,1,7,3,4,0,0,0,0,0,0,0,0,0,1,0,1,0,0,0,0,0,0,0,0,0,6,3,3,0,0,0
188100,10000,100,0,1,46,21,25,15,6,9,1,1,0,1,1,0,8,7,1,0,0,0,10,3,7,2,0,2,9,3,6,0,0,0
188137,10000,100,0,1,57,24,33,1,1,0,0,0,0,0,0,0,38,15,23,0,0,0,11,6,5,1,1,0,2,1,1,4,0,4
188182,10000,100,0,1,13,4,9,0,0,0,0,0,0,0,0,0,2,0,2,0,0,0,0,0,0,0,0,0,11,4,7,0,0,0
188225,10000,100,0,1,7,3,4,0,0,0,0,0,0,0,0,0,1,1,0,0,0,0,5,2,3,1,0,1,0,0,0,0,0,0
188261,10000,100,0,1,2,1,1,0,0,0,0,0,0,0,0,0,0,0,0,0,0,0,2,1,1,0,0,0,0,0,0,0,0,0
188304,10000,100,0,1,84,39,45,2,2,0,3,2,1,6,6,0,35,14,21,0,0,0,30,12,18,0,0,0,7,3,4,1,0,1
188340,10000,100,0,1,9,6,3,0,0,0,1,1,0,2,1,1,1,0,1,1,1,0,4,3,1,0,0,0,0,0,0,0,0,0
188429,10000,100,0,1,75,22,53,0,0,0,8,2,6,10,1,9,13,5,8,0,0,0,43,14,29,0,0,0,1,0,1,0,0,0
188438,10000,100,0,1,35,12,23,0,0,0,1,1,0,2,1,1,0,0,0,0,0,0,32,10,22,0,0,0,0,0,0,0,0,0
188517,10000,100,0,1,17,7,10,0,0,0,0,0,0,4,1,3,1,1,0,0,0,0,11,5,6,0,0,0,1,0,1,0,0,0
188526,10000,100,0,1,31,13,18,0,0,0,2,1,1,5,2,3,0,0,0,0,0,0,20,8,12,1,0,1,0,0,0,3,2,1
188535,10000,100,0,1,18,9,9,0,0,0,1,1,0,2,0,2,3,2,1,0,0,0,10,5,5,2,1,1,0,0,0,0,0,0
188580,10000,100,0,1,298,58,240,1,0,1,20,10,10,28,3,25,22,4,18,2,1,1,176,28,148,9,3,6,39,9,30,1,0,1
188641,10000,100,0,1,78,33,45,0,0,0,4,1,3,3,2,1,4,2,2,0,0,0,64,26,38,1,0,1,0,0,0,2,2,0
188854,10000,100,0,1,29,15,14,0,0,0,1,1,0,5,4,1,3,2,1,0,0,0,15,6,9,3,2,1,2,0,2,0,0,0
189015,10000,100,0,1,14,3,11,0,0,0,0,0,0,5,2,3,0,0,0,1,1,0,8,0,8,0,0,0,0,0,0,0,0,0
189088,10000,100,0,1,88,35,53,0,0,0,7,2,5,12,5,7,0,0,0,0,0,0,65,27,38,0,0,0,3,1,2,1,0,1
189097,10000,100,0,1,107,35,72,1,0,1,13,3,10,15,10,5,12,4,8,0,0,0,50,14,36,0,0,0,16,4,12,0,0,0
189228,10000,100,0,1,17,5,12,0,0,0,1,0,1,4,2,2,4,0,4,0,0,0,6,1,5,2,2,0,0,0,0,0,0,0
189413,10000,100,0,1,11,3,8,0,0,0,0,0,0,5,1,4,6,2,4,0,0,0,0,0,0,0,0,0,0,0,0,0,0,0
189501,10000,100,0,1,6,2,4,0,0,0,0,0,0,1,0,1,3,2,1,0,0,0,2,0,2,0,0,0,0,0,0,0,0,0
189547,10000,100,0,1,23,7,16,1,1,0,0,0,0,0,0,0,0,0,0,0,0,0,22,6,16,0,0,0,0,0,0,0,0,0
189565,10000,100,0,1,12,3,9,0,0,0,0,0,0,1,1,0,2,1,1,0,0,0,7,1,6,0,0,0,2,0,2,0,0,0
189583,10000,100,0,1,14,6,8,0,0,0,0,0,0,6,2,4,1,1,0,0,0,0,7,3,4,0,0,0,0,0,0,0,0,0
189592,10000,100,0,1,7,4,3,0,0,0,0,0,0,0,0,0,0,0,0,0,0,0,6,3,3,0,0,0,1,1,0,0,0,0
189705,10000,100,0,1,26,11,15,0,0,0,1,0,1,2,0,2,1,1,0,0,0,0,22,10,12,0,0,0,0,0,0,0,0,0
189811,10000,100,0,1,7,0,7,1,0,1,2,0,2,1,0,1,3,0,3,0,0,0,0,0,0,0,0,0,0,0,0,0,0,0
189839,10000,100,0,1,3,0,3,0,0,0,0,0,0,0,0,0,0,0,0,0,0,0,3,0,3,0,0,0,0,0,0,0,0,0
189848,10000,100,0,1,16,9,7,0,0,0,0,0,0,1,1,0,0,0,0,0,0,0,15,8,7,0,0,0,0,0,0,0,0,0
189857,10000,100,0,1,8,8,0,0,0,0,0,0,0,2,2,0,0,0,0,0,0,0,6,6,0,0,0,0,0,0,0,0,0,0
190035,10000,100,0,1,48,25,23,0,0,0,8,5,3,9,5,4,8,4,4,0,0,0,23,11,12,0,0,0,0,0,0,0,0,0
190044,10000,100,0,1,68,24,44,0,0,0,0,0,0,5,3,2,2,1,1,0,0,0,50,15,35,0,0,0,2,0,2,9,5,4
190053,10000,100,0,1,3,2,1,0,0,0,0,0,0,0,0,0,0,0,0,0,0,0,3,2,1,0,0,0,0,0,0,0,0,0
190071,10000,100,0,1,3,0,3,0,0,0,0,0,0,1,0,1,0,0,0,0,0,0,2,0,2,0,0,0,0,0,0,0,0,0
190080,10000,100,0,1,3,0,3,0,0,0,0,0,0,2,0,2,0,0,0,0,0,0,1,0,1,0,0,0,0,0,0,0,0,0
190099,10000,100,0,1,112,53,59,1,1,0,5,1,4,13,4,9,5,3,2,1,1,0,74,36,38,2,1,1,1,0,1,10,6,4
190114,10000,100,0,1,14,4,10,0,0,0,2,0,2,6,2,4,0,0,0,0,0,0,3,1,2,0,0,0,3,1,2,0,0,0
190150,10000,100,0,1,2386,981,1405,5,3,2,325,119,206,292,110,182,433,158,275,2,1,1,739,287,452,52,27,25,83,39,44,455,237,218
190169,10000,100,0,1,11,3,8,0,0,0,2,1,1,0,0,0,0,0,0,0,0,0,9,2,7,0,0,0,0,0,0,0,0,0
190372,10000,100,0,1,11,3,8,0,0,0,3,2,1,1,1,0,1,0,1,0,0,0,5,0,5,0,0,0,1,0,1,0,0,0
190415,10000,100,0,1,1170,546,624,5,2,3,96,43,53,74,29,45,83,28,55,0,0,0,676,309,367,30,10,20,13,11,2,193,114,79
190424,10000,100,0,1,1279,331,948,9,2,7,293,97,196,232,45,187,288,61,227,2,1,1,372,89,283,1,1,0,5,0,5,77,35,42
190442,10000,100,0,1,19,11,8,0,0,0,0,0,0,3,2,1,0,0,0,0,0,0,15,9,6,0,0,0,1,0,1,0,0,0
190451,10000,100,0,1,1,0,1,0,0,0,0,0,0,0,0,0,0,0,0,0,0,0,1,0,1,0,0,0,0,0,0,0,0,0
190503,10000,100,0,1,105,51,54,0,0,0,4,0,4,9,8,1,10,2,8,3,3,0,73,32,41,0,0,0,6,6,0,0,0,0
190512,10000,100,0,1,58,26,32,0,0,0,13,6,7,7,3,4,11,3,8,0,0,0,20,9,11,2,1,1,0,0,0,5,4,1
190521,10000,100,0,1,86,37,49,0,0,0,8,4,4,35,18,17,23,8,15,1,0,1,17,7,10,1,0,1,0,0,0,1,0,1
190530,10000,100,0,1,22,16,6,0,0,0,0,0,0,6,5,1,11,6,5,0,0,0,5,5,0,0,0,0,0,0,0,0,0,0
190549,10000,100,0,1,45,23,22,0,0,0,1,1,0,12,7,5,7,2,5,1,1,0,20,10,10,0,0,0,0,0,0,4,2,2
190558,10000,100,0,1,20,8,12,0,0,0,2,2,0,5,2,3,3,0,3,0,0,0,9,3,6,0,0,0,0,0,0,1,1,0
190567,10000,100,0,1,48,32,16,0,0,0,6,6,0,8,4,4,12,9,3,0,0,0,19,10,9,2,2,0,0,0,0,1,1,0
190576,10000,100,0,1,78,29,49,0,0,0,7,0,7,23,5,18,19,10,9,0,0,0,25,12,13,3,1,2,0,0,0,1,1,0
190585,10000,100,0,1,41,19,22,1,1,0,2,0,2,8,3,5,23,11,12,0,0,0,6,4,2,1,0,1,0,0,0,0,0,0
190594,10000,100,0,1,46,25,21,0,0,0,8,5,3,9,6,3,10,6,4,0,0,0,19,8,11,0,0,0,0,0,0,0,0,0
190600,10000,100,0,1,64,28,36,0,0,0,4,3,1,14,10,4,15,3,12,0,0,0,27,10,17,1,0,1,0,0,0,3,2,1
190619,10000,100,0,1,45,18,27,0,0,0,3,1,2,14,4,10,10,4,6,1,0,1,16,8,8,0,0,0,0,0,0,1,1,0
190628,10000,100,0,1,49,19,30,1,0,1,8,6,2,12,4,8,18,6,12,0,0,0,9,3,6,0,0,0,0,0,0,1,0,1
190637,10000,100,0,1,51,32,19,1,0,1,5,3,2,17,12,5,13,9,4,0,0,0,12,8,4,0,0,0,0,0,0,3,0,3
190646,10000,100,0,1,24,13,11,0,0,0,1,1,0,18,9,9,2,1,1,0,0,0,2,1,1,1,1,0,0,0,0,0,0,0
190655,10000,100,0,1,21,8,13,0,0,0,4,2,2,7,3,4,5,1,4,0,0,0,4,1,3,0,0,0,0,0,0,1,1,0
190664,10000,100,0,1,57,20,37,0,0,0,8,3,5,9,3,6,11,4,7,0,0,0,28,9,19,1,1,0,0,0,0,0,0,0
190673,10000,100,0,1,25,12,13,0,0,0,7,4,3,3,2,1,3,1,2,0,0,0,12,5,7,0,0,0,0,0,0,0,0,0
190682,10000,100,0,1,9,5,4,0,0,0,2,1,1,4,2,2,1,1,0,0,0,0,2,1,1,0,0,0,0,0,0,0,0,0
190691,10000,100,0,1,25,12,13,0,0,0,5,4,1,12,4,8,0,0,0,0,0,0,7,4,3,1,0,1,0,0,0,0,0,0
190716,10000,100,0,1,59,19,40,1,1,0,2,0,2,7,1,6,1,1,0,0,0,0,48,16,32,0,0,0,0,0,0,0,0,0
190725,10000,100,0,1,42,10,32,0,0,0,0,0,0,5,1,4,4,2,2,0,0,0,31,7,24,1,0,1,1,0,1,0,0,0
190761,10000,100,0,1,14,4,10,0,0,0,0,0,0,0,0,0,0,0,0,0,0,0,12,3,9,0,0,0,2,1,1,0,0,0
190840,10000,100,0,1,24,13,11,0,0,0,0,0,0,1,1,0,5,3,2,0,0,0,7,2,5,1,0,1,9,6,3,1,1,0
190956,10000,100,0,1,5,0,5,0,0,0,0,0,0,0,0,0,0,0,0,0,0,0,5,0,5,0,0,0,0,0,0,0,0,0
190983,10000,100,0,1,41,17,24,2,0,2,0,0,0,1,1,0,1,0,1,0,0,0,36,16,20,0,0,0,1,0,1,0,0,0
191083,10000,100,0,1,11,7,4,0,0,0,0,0,0,1,1,0,0,0,0,0,0,0,9,6,3,0,0,0,1,0,1,0,0,0
191126,10000,100,0,1,15,3,12,0,0,0,2,1,1,2,0,2,0,0,0,0,0,0,5,2,3,0,0,0,5,0,5,1,0,1
191199,10000,100,0,1,7,3,4,0,0,0,0,0,0,0,0,0,0,0,0,0,0,0,4,2,2,0,0,0,3,1,2,0,0,0
191205,10000,100,0,1,13,9,4,0,0,0,1,0,1,2,2,0,0,0,0,0,0,0,10,7,3,0,0,0,0,0,0,0,0,0
191241,10000,100,0,1,163,66,97,0,0,0,12,2,10,18,10,8,27,12,15,0,0,0,84,31,53,3,0,3,13,8,5,6,3,3
191302,10000,100,0,1,8,0,8,0,0,0,0,0,0,0,0,0,0,0,0,0,0,0,8,0,8,0,0,0,0,0,0,0,0,0
191320,10000,100,0,1,4,1,3,0,0,0,0,0,0,2,1,1,0,0,0,0,0,0,2,0,2,0,0,0,0,0,0,0,0,0
191339,10000,100,0,1,27,11,16,0,0,0,0,0,0,0,0,0,1,0,1,0,0,0,25,11,14,1,0,1,0,0,0,0,0,0
191515,10000,100,0,1,83,40,43,0,0,0,5,1,4,1,1,0,3,1,2,0,0,0,52,27,25,2,0,2,7,3,4,13,7,6
191533,10000,100,0,1,59,27,32,0,0,0,1,0,1,5,4,1,1,0,1,0,0,0,43,20,23,0,0,0,8,2,6,1,1,0
191597,10000,100,0,1,12,3,9,0,0,0,2,1,1,8,1,7,1,0,1,0,0,0,1,1,0,0,0,0,0,0,0,0,0,0
191612,10000,100,0,1,8,2,6,0,0,0,0,0,0,0,0,0,0,0,0,0,0,0,8,2,6,0,0,0,0,0,0,0,0,0
191621,10000,100,0,1,16,5,11,0,0,0,0,0,0,1,0,1,0,0,0,0,0,0,15,5,10,0,0,0,0,0,0,0,0,0
191630,10000,100,0,1,73,40,33,0,0,0,2,2,0,8,5,3,3,2,1,0,0,0,58,31,27,0,0,0,2,0,2,0,0,0
191649,10000,100,0,1,112,46,66,0,0,0,8,4,4,15,4,11,16,9,7,0,0,0,65,24,41,0,0,0,0,0,0,8,5,3
191676,10000,100,0,1,25,15,10,0,0,0,1,1,0,3,3,0,1,0,1,0,0,0,18,10,8,0,0,0,1,1,0,1,0,1
191719,10000,100,0,1,26,13,13,0,0,0,1,1,0,0,0,0,0,0,0,0,0,0,25,12,13,0,0,0,0,0,0,0,0,0
191931,10000,100,0,1,86,39,47,0,0,0,5,3,2,10,3,7,13,4,9,0,0,0,54,26,28,0,0,0,4,3,1,0,0,0
191968,10000,100,0,1,111,52,59,0,0,0,0,0,0,3,2,1,0,0,0,2,1,1,35,13,22,0,0,0,71,36,35,0,0,0
191986,10000,100,0,1,19,6,13,0,0,0,0,0,0,1,1,0,1,0,1,0,0,0,17,5,12,0,0,0,0,0,0,0,0,0
192022,10000,100,0,1,18,8,10,0,0,0,1,0,1,1,1,0,2,1,1,0,0,0,13,6,7,0,0,0,1,0,1,0,0,0
192040,10000,100,0,1,16,8,8,0,0,0,1,1,0,2,2,0,0,0,0,0,0,0,12,5,7,1,0,1,0,0,0,0,0,0
192110,10000,100,0,1,40,14,26,0,0,0,4,1,3,8,4,4,4,2,2,0,0,0,22,6,16,0,0,0,1,0,1,1,1,0
192192,10000,100,0,1,25,9,16,0,0,0,1,1,0,2,2,0,1,1,0,0,0,0,21,5,16,0,0,0,0,0,0,0,0,0
192271,10000,100,0,1,9,3,6,0,0,0,1,1,0,1,0,1,1,0,1,0,0,0,6,2,4,0,0,0,0,0,0,0,0,0
192323,10000,100,0,1,35,14,21,0,0,0,2,0,2,2,0,2,2,2,0,0,0,0,27,12,15,1,0,1,1,0,1,0,0,0
192448,10000,100,0,1,166,67,99,0,0,0,14,8,6,18,5,13,9,1,8,0,0,0,95,40,55,1,1,0,23,9,14,6,3,3
192509,10000,100,0,1,7,1,6,0,0,0,4,0,4,0,0,0,3,1,2,0,0,0,0,0,0,0,0,0,0,0,0,0,0,0
192688,10000,100,0,1,4,1,3,0,0,0,1,0,1,0,0,0,2,1,1,0,0,0,1,0,1,0,0,0,0,0,0,0,0,0
192703,10000,100,0,1,35,19,16,0,0,0,1,1,0,8,5,3,10,4,6,0,0,0,15,9,6,0,0,0,1,0,1,0,0,0
192712,10000,100,0,1,24,9,15,0,0,0,3,1,2,4,2,2,2,2,0,0,0,0,14,4,10,1,0,1,0,0,0,0,0,0
192749,10000,100,0,1,41,16,25,0,0,0,2,0,2,5,3,2,6,1,5,0,0,0,24,11,13,0,0,0,4,1,3,0,0,0
192785,10000,100,0,1,18,3,15,0,0,0,0,0,0,0,0,0,0,0,0,0,0,0,18,3,15,0,0,0,0,0,0,0,0,0
192819,10000,100,0,1,67,28,39,0,0,0,2,1,1,11,7,4,10,5,5,0,0,0,44,15,29,0,0,0,0,0,0,0,0,0
192864,10000,100,0,1,32,14,18,0,0,0,1,1,0,1,0,1,0,0,0,0,0,0,5,0,5,0,0,0,25,13,12,0,0,0
192925,10000,100,0,1,50,14,36,1,1,0,0,0,0,7,2,5,1,0,1,2,0,2,38,10,28,1,1,0,0,0,0,0,0,0
193016,10000,100,0,1,113,38,75,0,0,0,6,3,3,24,14,10,23,6,17,0,0,0,43,8,35,4,1,3,5,4,1,8,2,6
193201,10000,100,0,1,1,0,1,0,0,0,0,0,0,0,0,0,0,0,0,0,0,0,1,0,1,0,0,0,0,0,0,0,0,0
193247,10000,100,0,1,1,1,0,0,0,0,0,0,0,0,0,0,0,0,0,0,0,0,1,1,0,0,0,0,0,0,0,0,0,0
193283,10000,100,0,1,33,14,19,0,0,0,0,0,0,4,2,2,0,0,0,0,0,0,29,12,17,0,0,0,0,0,0,0,0,0
193292,10000,100,0,1,39,11,28,0,0,0,0,0,0,6,1,5,4,3,1,0,0,0,29,7,22,0,0,0,0,0,0,0,0,0
193308,10000,100,0,1,44,15,29,0,0,0,4,1,3,19,4,15,10,6,4,0,0,0,11,4,7,0,0,0,0,0,0,0,0,0
193326,10000,100,0,1,18,6,12,0,0,0,0,0,0,1,0,1,3,1,2,0,0,0,14,5,9,0,0,0,0,0,0,0,0,0
193353,10000,100,0,1,19,7,12,0,0,0,1,0,1,3,2,1,3,1,2,0,0,0,12,4,8,0,0,0,0,0,0,0,0,0
193399,10000,100,0,1,75,29,46,0,0,0,0,0,0,10,4,6,37,11,26,0,0,0,25,12,13,1,1,0,2,1,1,0,0,0
193405,10000,100,0,1,1956,553,1403,1,0,1,154,48,106,91,13,78,421,72,349,0,0,0,191,66,125,16,3,13,916,267,649,166,84,82
193478,10000,100,0,1,4,3,1,0,0,0,0,0,0,0,0,0,0,0,0,0,0,0,4,3,1,0,0,0,0,0,0,0,0,0
193584,10000,100,0,1,23,12,11,0,0,0,2,1,1,3,2,1,3,1,2,0,0,0,15,8,7,0,0,0,0,0,0,0,0,0
193654,10000,100,0,1,80,36,44,0,0,0,6,2,4,22,9,13,15,7,8,0,0,0,26,12,14,3,0,3,3,1,2,5,5,0
193751,10000,100,0,1,16,5,11,0,0,0,0,0,0,0,0,0,0,0,0,0,0,0,16,5,11,0,0,0,0,0,0,0,0,0
193821,10000,100,0,1,13,4,9,0,0,0,2,1,1,1,0,1,1,1,0,0,0,0,6,1,5,0,0,0,3,1,2,0,0,0
193830,10000,100,0,1,30,18,12,0,0,0,11,6,5,8,4,4,3,2,1,0,0,0,8,6,2,0,0,0,0,0,0,0,0,0
193894,10000,100,0,1,7,2,5,0,0,0,0,0,0,6,1,5,0,0,0,0,0,0,1,1,0,0,0,0,0,0,0,0,0,0
193900,10000,100,0,1,2559,767,1792,6,1,5,462,162,300,352,86,266,427,88,339,4,2,2,965,293,672,52,9,43,79,28,51,212,98,114
193946,10000,100,0,1,20,11,9,0,0,0,0,0,0,0,0,0,0,0,0,0,0,0,19,11,8,1,0,1,0,0,0,0,0,0
193973,10000,100,0,1,78,28,50,2,1,1,0,0,0,9,5,4,1,0,1,0,0,0,58,17,41,0,0,0,4,3,1,4,2,2
194028,10000,100,0,1,10,3,7,0,0,0,0,0,0,0,0,0,0,0,0,0,0,0,10,3,7,0,0,0,0,0,0,0,0,0
194073,10000,100,0,1,14,8,6,0,0,0,3,2,1,4,1,3,2,2,0,1,1,0,3,2,1,0,0,0,1,0,1,0,0,0
194091,10000,100,0,1,77,25,52,0,0,0,4,1,3,8,3,5,17,6,11,0,0,0,43,12,31,2,1,1,0,0,0,3,2,1
194116,10000,100,0,1,5,0,5,0,0,0,0,0,0,1,0,1,1,0,1,0,0,0,3,0,3,0,0,0,0,0,0,0,0,0
194161,10000,100,0,1,10,6,4,0,0,0,1,1,0,3,1,2,1,1,0,0,0,0,4,3,1,0,0,0,1,0,1,0,0,0
194222,10000,100,0,1,35,15,20,1,0,1,1,1,0,7,3,4,0,0,0,0,0,0,26,11,15,0,0,0,0,0,0,0,0,0
194240,10000,100,0,1,11,2,9,0,0,0,0,0,0,2,1,1,2,0,2,0,0,0,6,1,5,1,0,1,0,0,0,0,0,0
194310,10000,100,0,1,120,41,79,0,0,0,10,1,9,21,14,7,23,11,12,0,0,0,60,15,45,0,0,0,4,0,4,2,0,2
194392,10000,100,0,1,24,11,13,0,0,0,2,2,0,0,0,0,0,0,0,0,0,0,22,9,13,0,0,0,0,0,0,0,0,0
194499,10000,100,0,1,15,4,11,0,0,0,1,1,0,1,0,1,5,2,3,0,0,0,8,1,7,0,0,0,0,0,0,0,0,0
194578,10000,100,0,1,50,21,29,0,0,0,8,2,6,7,4,3,7,2,5,1,1,0,22,11,11,0,0,0,4,1,3,1,0,1
194763,10000,100,0,1,2,2,0,0,0,0,0,0,0,0,0,0,2,2,0,0,0,0,0,0,0,0,0,0,0,0,0,0,0,0
194824,10000,100,0,1,87,53,34,0,0,0,17,12,5,10,8,2,5,3,2,0,0,0,55,30,25,0,0,0,0,0,0,0,0,0
194958,10000,100,0,1,30,13,17,0,0,0,0,0,0,7,3,4,0,0,0,0,0,0,21,8,13,1,1,0,1,1,0,0,0,0
195003,10000,100,0,1,267,123,144,0,0,0,20,10,10,33,12,21,26,9,17,1,1,0,159,76,83,9,3,6,6,2,4,13,10,3
195030,10000,100,0,1,999,448,551,0,0,0,78,32,46,110,45,65,60,27,33,0,0,0,603,261,342,27,7,20,0,0,0,121,76,45
195049,10000,100,0,1,134,63,71,0,0,0,22,6,16,8,4,4,19,7,12,0,0,0,52,28,24,3,2,1,0,0,0,30,16,14
195058,10000,100,0,1,25,15,10,0,0,0,1,0,1,4,3,1,5,2,3,0,0,0,15,10,5,0,0,0,0,0,0,0,0,0
195128,10000,100,0,1,49,21,28,0,0,0,2,0,2,3,0,3,4,1,3,0,0,0,40,20,20,0,0,0,0,0,0,0,0,0
195164,10000,100,0,1,77,35,42,0,0,0,4,2,2,6,3,3,4,2,2,1,1,0,62,27,35,0,0,0,0,0,0,0,0,0
195173,10000,100,0,1,38,19,19,1,1,0,4,3,1,9,5,4,2,2,0,1,0,1,17,5,12,3,2,1,0,0,0,1,1,0
195191,10000,100,0,1,2,0,2,0,0,0,0,0,0,0,0,0,0,0,0,0,0,0,2,0,2,0,0,0,0,0,0,0,0,0
195216,10000,100,0,1,63,28,35,1,1,0,3,1,2,2,1,1,4,4,0,0,0,0,51,21,30,0,0,0,1,0,1,1,0,1
195234,10000,100,0,1,43,23,20,0,0,0,2,1,1,8,6,2,2,1,1,0,0,0,26,14,12,2,0,2,2,0,2,1,1,0
195243,10000,100,0,1,23,9,14,0,0,0,1,0,1,6,3,3,5,1,4,0,0,0,10,5,5,1,0,1,0,0,0,0,0,0
195304,10000,100,0,1,34,11,23,0,0,0,2,0,2,8,3,5,7,4,3,0,0,0,16,4,12,1,0,1,0,0,0,0,0,0
195322,10000,100,0,1,18,7,11,0,0,0,0,0,0,4,2,2,1,0,1,0,0,0,13,5,8,0,0,0,0,0,0,0,0,0
195438,10000,100,0,1,5,4,1,0,0,0,0,0,0,0,0,0,1,1,0,0,0,0,4,3,1,0,0,0,0,0,0,0,0,0
195474,10000,100,0,1,80,28,52,1,0,1,3,2,1,8,3,5,3,1,2,0,0,0,59,20,39,0,0,0,0,0,0,6,2,4
195526,10000,100,0,1,58,29,29,1,1,0,2,0,2,8,6,2,2,2,0,0,0,0,43,19,24,0,0,0,1,0,1,1,1,0
195544,10000,100,0,1,38,15,23,0,0,0,1,1,0,3,2,1,4,1,3,0,0,0,18,6,12,0,0,0,12,5,7,0,0,0
195580,10000,100,0,1,1,0,1,0,0,0,0,0,0,0,0,0,0,0,0,0,0,0,1,0,1,0,0,0,0,0,0,0,0,0
195720,10000,100,0,1,68,28,40,0,0,0,3,1,2,10,4,6,3,1,2,0,0,0,50,20,30,0,0,0,2,2,0,0,0,0
195784,10000,100,0,1,8,3,5,0,0,0,0,0,0,2,2,0,0,0,0,0,0,0,6,1,5,0,0,0,0,0,0,0,0,0
195809,10000,100,0,1,95,43,52,0,0,0,19,9,10,17,7,10,15,9,6,0,0,0,41,17,24,1,0,1,1,0,1,1,1,0
195827,10000,100,0,1,36,14,22,1,0,1,3,3,0,6,4,2,5,1,4,0,0,0,20,6,14,1,0,1,0,0,0,0,0,0
195988,10000,100,0,1,12,6,6,0,0,0,1,1,0,0,0,0,0,0,0,0,0,0,11,5,6,0,0,0,0,0,0,0,0,0
196006,10000,100,0,1,73,40,33,0,0,0,1,1,0,2,2,0,8,6,2,0,0,0,61,30,31,0,0,0,0,0,0,1,1,0
196015,10000,100,0,1,20,10,10,0,0,0,1,1,0,1,0,1,0,0,0,0,0,0,15,6,9,1,1,0,0,0,0,2,2,0
196024,10000,100,0,1,28,12,16,0,0,0,1,1,0,0,0,0,3,2,1,0,0,0,21,7,14,3,2,1,0,0,0,0,0,0
196033,10000,100,0,1,37,20,17,0,0,0,0,0,0,1,0,1,3,1,2,0,0,0,33,19,14,0,0,0,0,0,0,0,0,0
196042,10000,100,0,1,47,26,21,0,0,0,2,1,1,7,1,6,9,6,3,0,0,0,28,18,10,0,0,0,0,0,0,1,0,1
196051,10000,100,0,1,26,11,15,1,1,0,0,0,0,1,1,0,0,0,0,0,0,0,22,9,13,2,0,2,0,0,0,0,0,0
196060,10000,100,0,1,100,53,47,0,0,0,13,5,8,13,10,3,4,3,1,0,0,0,62,30,32,3,1,2,0,0,0,5,4,1
196079,10000,100,0,1,255,119,136,0,0,0,7,5,2,16,8,8,2,1,1,0,0,0,200,81,119,1,1,0,0,0,0,29,23,6
196088,10000,100,0,1,205,108,97,2,1,1,10,6,4,45,22,23,8,5,3,0,0,0,126,65,61,2,2,0,0,0,0,12,7,5
196097,10000,100,0,1,299,158,141,0,0,0,31,18,13,24,14,10,21,11,10,0,0,0,173,88,85,5,1,4,26,12,14,19,14,5
196103,10000,100,0,1,46,30,16,0,0,0,4,3,1,3,3,0,0,0,0,0,0,0,38,24,14,0,0,0,0,0,0,1,0,1
196112,10000,100,0,1,27,14,13,0,0,0,3,2,1,0,0,0,3,1,2,0,0,0,18,9,9,1,1,0,0,0,0,2,1,1
196121,10000,100,0,1,53,16,37,0,0,0,0,0,0,5,1,4,1,0,1,0,0,0,47,15,32,0,0,0,0,0,0,0,0,0
196130,10000,100,0,1,66,31,35,0,0,0,0,0,0,13,8,5,2,2,0,0,0,0,48,20,28,1,0,1,0,0,0,2,1,1
196149,10000,100,0,1,37,16,21,0,0,0,0,0,0,7,6,1,0,0,0,0,0,0,30,10,20,0,0,0,0,0,0,0,0,0
196158,10000,100,0,1,22,12,10,0,0,0,0,0,0,1,1,0,0,0,0,0,0,0,20,10,10,0,0,0,0,0,0,1,1,0
196167,10000,100,0,1,57,26,31,0,0,0,1,1,0,0,0,0,1,1,0,0,0,0,55,24,31,0,0,0,0,0,0,0,0,0
196176,10000,100,0,1,37,11,26,0,0,0,3,2,1,6,1,5,4,1,3,0,0,0,22,7,15,1,0,1,0,0,0,1,0,1
196185,10000,100,0,1,99,42,57,1,0,1,4,1,3,7,5,2,7,5,2,0,0,0,76,30,46,1,1,0,0,0,0,3,0,3
196194,10000,100,0,1,35,12,23,0,0,0,1,0,1,3,2,1,1,0,1,0,0,0,29,10,19,0,0,0,0,0,0,1,0,1
196200,10000,100,0,1,39,19,20,0,0,0,1,0,1,3,2,1,2,2,0,0,0,0,33,15,18,0,0,0,0,0,0,0,0,0
196219,10000,100,0,1,38,18,20,0,0,0,0,0,0,3,0,3,16,8,8,0,0,0,18,10,8,0,0,0,0,0,0,1,0,1
196228,10000,100,0,1,50,12,38,0,0,0,11,4,7,19,3,16,11,5,6,0,0,0,9,0,9,0,0,0,0,0,0,0,0,0
196237,10000,100,0,1,21,6,15,0,0,0,0,0,0,7,3,4,5,1,4,0,0,0,9,2,7,0,0,0,0,0,0,0,0,0
196246,10000,100,0,1,24,12,12,0,0,0,0,0,0,0,0,0,1,1,0,0,0,0,16,8,8,3,1,2,0,0,0,4,2,2
196255,10000,100,0,1,111,66,45,0,0,0,24,16,8,35,16,19,10,8,2,0,0,0,25,20,5,5,3,2,0,0,0,12,3,9
196264,10000,100,0,1,40,19,21,0,0,0,2,0,2,5,1,4,2,1,1,0,0,0,31,17,14,0,0,0,0,0,0,0,0,0
196291,10000,100,0,1,17,11,6,0,0,0,2,2,0,1,0,1,5,4,1,0,0,0,9,5,4,0,0,0,0,0,0,0,0,0
196307,10000,100,0,1,180,101,79,1,0,1,23,12,11,11,3,8,7,2,5,0,0,0,110,65,45,0,0,0,1,1,0,27,18,9
196389,10000,100,0,1,8,3,5,0,0,0,1,1,0,3,1,2,2,0,2,0,0,0,2,1,1,0,0,0,0,0,0,0,0,0
196413,10000,100,0,1,320,143,177,1,1,0,24,10,14,53,28,25,15,8,7,0,0,0,172,71,101,14,5,9,7,0,7,34,20,14
196431,10000,100,0,1,3,3,0,0,0,0,0,0,0,1,1,0,0,0,0,0,0,0,2,2,0,0,0,0,0,0,0,0,0,0
196468,10000,100,0,1,88,20,68,0,0,0,12,1,11,13,1,12,16,4,12,0,0,0,30,9,21,6,2,4,0,0,0,11,3,8
196565,10000,100,0,1,10,5,5,0,0,0,0,0,0,3,2,1,1,0,1,0,0,0,6,3,3,0,0,0,0,0,0,0,0,0
196592,10000,100,0,1,104,30,74,1,0,1,12,4,8,6,2,4,24,6,18,0,0,0,49,15,34,4,1,3,8,2,6,0,0,0
196653,10000,100,0,1,21,5,16,0,0,0,1,1,0,3,2,1,0,0,0,0,0,0,17,2,15,0,0,0,0,0,0,0,0,0
196680,10000,100,0,1,32,14,18,0,0,0,1,0,1,5,4,1,1,0,1,1,0,1,24,10,14,0,0,0,0,0,0,0,0,0
196699,10000,100,0,1,16,5,11,0,0,0,0,0,0,1,0,1,0,0,0,0,0,0,15,5,10,0,0,0,0,0,0,0,0,0
196866,10000,100,0,1,84,38,46,1,1,0,2,1,1,7,3,4,3,1,2,1,0,1,62,28,34,5,3,2,0,0,0,3,1,2
196884,10000,100,0,1,10,5,5,0,0,0,1,0,1,5,3,2,1,0,1,0,0,0,3,2,1,0,0,0,0,0,0,0,0,0
197027,10000,100,0,1,16,11,5,0,0,0,0,0,0,2,0,2,2,2,0,0,0,0,11,9,2,0,0,0,1,0,1,0,0,0
197036,10000,100,0,1,178,111,67,3,1,2,4,2,2,15,9,6,11,6,5,0,0,0,143,93,50,2,0,2,0,0,0,0,0,0
197045,10000,100,0,1,66,19,47,0,0,0,5,3,2,5,2,3,2,0,2,0,0,0,52,14,38,2,0,2,0,0,0,0,0,0
197133,10000,100,0,1,116,52,64,1,0,1,5,0,5,8,4,4,12,7,5,0,0,0,63,27,36,4,2,2,14,7,7,9,5,4
197142,10000,100,0,1,6,3,3,0,0,0,0,0,0,0,0,0,0,0,0,0,0,0,6,3,3,0,0,0,0,0,0,0,0,0
197151,10000,100,0,1,28,12,16,0,0,0,0,0,0,7,4,3,7,2,5,0,0,0,12,6,6,0,0,0,1,0,1,1,0,1
197197,10000,100,0,1,32,17,15,0,0,0,2,1,1,5,3,2,0,0,0,0,0,0,25,13,12,0,0,0,0,0,0,0,0,0
197230,10000,100,0,1,23,11,12,0,0,0,0,0,0,1,1,0,3,2,1,0,0,0,18,7,11,1,1,0,0,0,0,0,0,0
197285,10000,100,0,1,8,3,5,0,0,0,0,0,0,1,1,0,5,2,3,0,0,0,2,0,2,0,0,0,0,0,0,0,0,0
197294,10000,100,0,1,15,6,9,0,0,0,1,1,0,3,2,1,3,0,3,0,0,0,8,3,5,0,0,0,0,0,0,0,0,0
197708,10000,100,0,1,75,35,40,0,0,0,4,2,2,9,5,4,18,11,7,0,0,0,44,17,27,0,0,0,0,0,0,0,0,0
197735,10000,100,0,1,10,10,0,0,0,0,0,0,0,0,0,0,4,4,0,0,0,0,6,6,0,0,0,0,0,0,0,0,0,0
197814,10000,100,0,1,12,5,7,0,0,0,0,0,0,3,0,3,1,1,0,0,0,0,8,4,4,0,0,0,0,0,0,0,0,0
197850,10000,100,0,1,39,12,27,0,0,0,1,0,1,9,1,8,1,0,1,0,0,0,28,11,17,0,0,0,0,0,0,0,0,0
197869,10000,100,0,1,280,119,161,1,1,0,9,4,5,21,11,10,3,1,2,2,1,1,214,83,131,8,2,6,10,7,3,12,9,3
197887,10000,100,0,1,28,12,16,0,0,0,0,0,0,0,0,0,2,0,2,0,0,0,26,12,14,0,0,0,0,0,0,0,0,0
197911,10000,100,0,1,50,16,34,0,0,0,2,1,1,13,5,8,5,1,4,0,0,0,24,6,18,1,1,0,4,1,3,1,1,0
197966,10000,100,0,1,10,3,7,0,0,0,0,0,0,3,0,3,0,0,0,0,0,0,7,3,4,0,0,0,0,0,0,0,0,0
197984,10000,100,0,1,95,55,40,0,0,0,0,0,0,6,4,2,6,5,1,0,0,0,83,46,37,0,0,0,0,0,0,0,0,0
197993,10000,100,0,1,21,12,9,0,0,0,0,0,0,15,10,5,1,0,1,0,0,0,5,2,3,0,0,0,0,0,0,0,0,0
198011,10000,100,0,1,15,10,5,2,0,2,0,0,0,2,1,1,2,1,1,0,0,0,9,8,1,0,0,0,0,0,0,0,0,0
198039,10000,100,0,1,45,19,26,0,0,0,0,0,0,2,1,1,1,1,0,0,0,0,41,16,25,0,0,0,1,1,0,0,0,0
198066,10000,100,0,1,42,26,16,0,0,0,0,0,0,3,2,1,5,4,1,0,0,0,34,20,14,0,0,0,0,0,0,0,0,0
198084,10000,100,0,1,26,7,19,0,0,0,0,0,0,4,0,4,0,0,0,0,0,0,21,7,14,0,0,0,1,0,1,0,0,0
198109,10000,100,0,1,7,2,5,0,0,0,0,0,0,4,2,2,0,0,0,0,0,0,3,0,3,0,0,0,0,0,0,0,0,0
198118,10000,100,0,1,30,12,18,0,0,0,0,0,0,2,0,2,0,0,0,0,0,0,28,12,16,0,0,0,0,0,0,0,0,0
198136,10000,100,0,1,96,51,45,1,0,1,4,3,1,14,6,8,3,2,1,0,0,0,74,40,34,0,0,0,0,0,0,0,0,0
198154,10000,100,0,1,45,14,31,0,0,0,0,0,0,2,1,1,5,1,4,0,0,0,37,11,26,1,1,0,0,0,0,0,0,0
198206,10000,100,0,1,15,7,8,0,0,0,0,0,0,2,1,1,0,0,0,0,0,0,13,6,7,0,0,0,0,0,0,0,0,0
198215,10000,100,0,1,50,24,26,1,1,0,0,0,0,9,6,3,0,0,0,0,0,0,40,17,23,0,0,0,0,0,0,0,0,0
198233,10000,100,0,1,24,8,16,0,0,0,2,1,1,2,1,1,0,0,0,0,0,0,19,6,13,0,0,0,1,0,1,0,0,0
198251,10000,100,0,1,40,11,29,0,0,0,1,0,1,12,2,10,0,0,0,0,0,0,25,7,18,0,0,0,2,2,0,0,0,0
198260,10000,100,0,1,68,26,42,0,0,0,1,0,1,26,9,17,4,0,4,0,0,0,31,15,16,1,0,1,5,2,3,0,0,0
198303,10000,100,0,1,32,21,11,1,0,1,0,0,0,11,6,5,1,0,1,0,0,0,16,14,2,0,0,0,3,1,2,0,0,0
198321,10000,100,0,1,16,5,11,0,0,0,0,0,0,2,1,1,1,0,1,0,0,0,13,4,9,0,0,0,0,0,0,0,0,0
198330,10000,100,0,1,36,13,23,0,0,0,0,0,0,4,1,3,8,2,6,0,0,0,23,9,14,1,1,0,0,0,0,0,0,0
198367,10000,100,0,1,22,6,16,0,0,0,0,0,0,6,2,4,1,0,1,0,0,0,15,4,11,0,0,0,0,0,0,0,0,0
198376,10000,100,0,1,36,17,19,0,0,0,0,0,0,6,4,2,0,0,0,0,0,0,27,12,15,1,0,1,2,1,1,0,0,0
198385,10000,100,0,1,114,57,57,0,0,0,5,1,4,22,15,7,14,8,6,0,0,0,64,29,35,4,2,2,4,1,3,1,1,0
198419,10000,100,0,1,778,317,461,2,1,1,71,19,52,133,42,91,66,31,35,0,0,0,430,183,247,30,13,17,1,0,1,45,28,17
198455,10000,100,0,1,23,13,10,0,0,0,0,0,0,17,8,9,0,0,0,0,0,0,5,4,1,0,0,0,0,0,0,1,1,0
198464,10000,100,0,1,392,128,264,1,0,1,11,3,8,60,12,48,102,37,65,0,0,0,180,59,121,8,3,5,17,6,11,13,8,5
198491,10000,100,0,1,12,3,9,0,0,0,0,0,0,5,1,4,0,0,0,0,0,0,7,2,5,0,0,0,0,0,0,0,0,0
198507,10000,100,0,1,46,23,23,0,0,0,1,1,0,33,16,17,0,0,0,0,0,0,9,5,4,0,0,0,2,0,2,1,1,0
198516,10000,100,0,1,160,66,94,0,0,0,4,2,2,33,11,22,9,3,6,0,0,0,98,45,53,3,1,2,10,4,6,3,0,3
198534,10000,100,0,1,97,41,56,6,3,3,3,3,0,35,13,22,5,3,2,0,0,0,48,19,29,0,0,0,0,0,0,0,0,0
198543,10000,100,0,1,90,39,51,5,2,3,1,1,0,58,24,34,2,0,2,0,0,0,18,10,8,0,0,0,2,1,1,4,1,3
198552,10000,100,0,1,60,28,32,0,0,0,2,1,1,18,8,10,4,0,4,2,2,0,33,17,16,1,0,1,0,0,0,0,0,0
198561,10000,100,0,1,74,33,41,0,0,0,0,0,0,8,3,5,2,1,1,0,0,0,61,27,34,3,2,1,0,0,0,0,0,0
198570,10000,100,0,1,51,17,34,0,0,0,0,0,0,8,4,4,0,0,0,0,0,0,43,13,30,0,0,0,0,0,0,0,0,0
198598,10000,100,0,1,20,12,8,0,0,0,0,0,0,5,3,2,0,0,0,0,0,0,15,9,6,0,0,0,0,0,0,0,0,0
198613,10000,100,0,1,57,26,31,1,0,1,4,1,3,15,4,11,2,2,0,0,0,0,35,19,16,0,0,0,0,0,0,0,0,0
198622,10000,100,0,1,73,26,47,0,0,0,2,1,1,40,11,29,0,0,0,0,0,0,31,14,17,0,0,0,0,0,0,0,0,0
198640,10000,100,0,1,8,2,6,1,0,1,0,0,0,3,0,3,0,0,0,0,0,0,4,2,2,0,0,0,0,0,0,0,0,0
198668,10000,100,0,1,15,3,12,0,0,0,0,0,0,0,0,0,0,0,0,0,0,0,15,3,12,0,0,0,0,0,0,0,0,0
198695,10000,100,0,1,186,82,104,0,0,0,3,2,1,33,15,18,7,3,4,0,0,0,138,60,78,5,2,3,0,0,0,0,0,0
198710,10000,100,0,1,6,1,5,0,0,0,0,0,0,0,0,0,0,0,0,0,0,0,6,1,5,0,0,0,0,0,0,0,0,0
198729,10000,100,0,1,14,3,11,0,0,0,0,0,0,4,1,3,1,0,1,0,0,0,9,2,7,0,0,0,0,0,0,0,0,0
198756,10000,100,0,1,25,11,14,0,0,0,1,1,0,16,5,11,0,0,0,0,0,0,7,5,2,0,0,0,1,0,1,0,0,0
198774,10000,100,0,1,34,10,24,0,0,0,1,1,0,5,1,4,2,0,2,0,0,0,25,8,17,0,0,0,1,0,1,0,0,0
198808,10000,100,0,1,36,18,18,0,0,0,0,0,0,1,1,0,1,1,0,1,1,0,33,15,18,0,0,0,0,0,0,0,0,0
198817,10000,100,0,1,26,13,13,0,0,0,0,0,0,9,6,3,2,0,2,0,0,0,15,7,8,0,0,0,0,0,0,0,0,0
198835,10000,100,0,1,39,18,21,0,0,0,2,1,1,6,5,1,0,0,0,0,0,0,28,9,19,1,1,0,2,2,0,0,0,0
198862,10000,100,0,1,29,10,19,0,0,0,0,0,0,25,9,16,0,0,0,0,0,0,4,1,3,0,0,0,0,0,0,0,0,0
198871,10000,100,0,1,32,18,14,0,0,0,1,1,0,7,3,4,0,0,0,0,0,0,24,14,10,0,0,0,0,0,0,0,0,0
198899,10000,100,0,1,28,16,12,0,0,0,0,0,0,2,1,1,2,1,1,0,0,0,24,14,10,0,0,0,0,0,0,0,0,0
198905,10000,100,0,1,9,6,3,0,0,0,0,0,0,0,0,0,0,0,0,0,0,0,9,6,3,0,0,0,0,0,0,0,0,0
198914,10000,100,0,1,5,0,5,0,0,0,0,0,0,0,0,0,0,0,0,0,0,0,5,0,5,0,0,0,0,0,0,0,0,0
198923,10000,100,0,1,5,2,3,0,0,0,0,0,0,0,0,0,1,0,1,0,0,0,4,2,2,0,0,0,0,0,0,0,0,0
198950,10000,100,0,1,41,8,33,0,0,0,0,0,0,8,0,8,4,1,3,1,1,0,27,6,21,0,0,0,1,0,1,0,0,0
198969,10000,100,0,1,41,15,26,0,0,0,2,1,1,7,4,3,0,0,0,0,0,0,29,9,20,2,0,2,1,1,0,0,0,0
198978,10000,100,0,1,38,10,28,0,0,0,0,0,0,16,6,10,2,1,1,0,0,0,17,3,14,3,0,3,0,0,0,0,0,0
198987,10000,100,0,1,12,7,5,0,0,0,0,0,0,1,1,0,0,0,0,0,0,0,11,6,5,0,0,0,0,0,0,0,0,0
199023,10000,100,0,1,7,0,7,0,0,0,0,0,0,0,0,0,0,0,0,0,0,0,7,0,7,0,0,0,0,0,0,0,0,0
199032,10000,100,0,1,34,13,21,0,0,0,0,0,0,6,1,5,2,2,0,0,0,0,26,10,16,0,0,0,0,0,0,0,0,0
199069,10000,100,0,1,18,8,10,0,0,0,0,0,0,3,3,0,0,0,0,0,0,0,14,5,9,1,0,1,0,0,0,0,0,0
199087,10000,100,0,1,22,6,16,0,0,0,0,0,0,7,2,5,0,0,0,0,0,0,14,4,10,1,0,1,0,0,0,0,0,0
199102,10000,100,0,1,140,67,73,0,0,0,3,3,0,59,22,37,7,3,4,0,0,0,12,9,3,1,1,0,45,21,24,13,8,5
199111,10000,100,0,1,78,30,48,0,0,0,2,2,0,7,0,7,2,0,2,0,0,0,55,22,33,4,0,4,7,5,2,1,1,0
199120,10000,100,0,1,1163,362,801,2,0,2,77,33,44,143,32,111,64,22,42,0,0,0,480,155,325,38,8,30,318,95,223,41,17,24
199139,10000,100,0,1,282,125,157,3,2,1,9,4,5,92,31,61,20,9,11,1,0,1,145,71,74,2,0,2,0,0,0,10,8,2
199148,10000,100,0,1,254,105,149,0,0,0,10,1,9,62,23,39,17,8,9,0,0,0,134,59,75,8,1,7,8,2,6,15,11,4
199157,10000,100,0,1,145,73,72,0,0,0,4,0,4,51,31,20,5,3,2,0,0,0,11,5,6,1,1,0,71,32,39,2,1,1
199175,10000,100,0,1,60,26,34,0,0,0,0,0,0,16,7,9,1,1,0,0,0,0,38,16,22,0,0,0,5,2,3,0,0,0
199184,10000,100,0,1,44,17,27,0,0,0,1,0,1,12,5,7,0,0,0,1,0,1,24,10,14,0,0,0,6,2,4,0,0,0
199193,10000,100,0,1,855,346,509,6,3,3,44,19,25,140,49,91,46,20,26,3,2,1,536,212,324,22,11,11,17,8,9,41,22,19
199209,10000,100,0,1,33,19,14,0,0,0,0,0,0,11,8,3,0,0,0,0,0,0,22,11,11,0,0,0,0,0,0,0,0,0
199218,10000,100,0,1,266,96,170,1,0,1,7,4,3,26,13,13,11,2,9,0,0,0,172,59,113,7,2,5,27,10,17,15,6,9
199263,10000,100,0,1,3,3,0,0,0,0,0,0,0,0,0,0,0,0,0,0,0,0,3,3,0,0,0,0,0,0,0,0,0,0
199272,10000,100,0,1,28,11,17,0,0,0,0,0,0,6,3,3,3,3,0,0,0,0,16,3,13,0,0,0,3,2,1,0,0,0
199281,10000,100,0,1,96,37,59,28,10,18,2,1,1,15,5,10,0,0,0,0,0,0,47,20,27,1,0,1,1,0,1,2,1,1
199306,10000,100,0,1,28,14,14,0,0,0,0,0,0,6,3,3,0,0,0,0,0,0,21,11,10,1,0,1,0,0,0,0,0,0
199324,10000,100,0,1,30,11,19,0,0,0,0,0,0,5,2,3,2,0,2,0,0,0,23,9,14,0,0,0,0,0,0,0,0,0
199333,10000,100,0,1,25,8,17,0,0,0,0,0,0,7,2,5,0,0,0,0,0,0,18,6,12,0,0,0,0,0,0,0,0,0
199412,10000,100,0,1,60,22,38,2,1,1,1,0,1,13,6,7,3,0,3,0,0,0,39,15,24,2,0,2,0,0,0,0,0,0
199421,10000,100,0,1,19,8,11,0,0,0,0,0,0,1,1,0,0,0,0,0,0,0,7,3,4,0,0,0,11,4,7,0,0,0
199449,10000,100,0,1,35,17,18,2,2,0,0,0,0,5,3,2,1,0,1,0,0,0,26,11,15,1,1,0,0,0,0,0,0,0
199458,10000,100,0,1,6,5,1,0,0,0,0,0,0,1,1,0,0,0,0,0,0,0,5,4,1,0,0,0,0,0,0,0,0,0
199467,10000,100,0,1,12,3,9,0,0,0,0,0,0,8,3,5,0,0,0,0,0,0,4,0,4,0,0,0,0,0,0,0,0,0
199476,10000,100,0,1,22,4,18,6,1,5,0,0,0,3,0,3,1,0,1,0,0,0,12,3,9,0,0,0,0,0,0,0,0,0
199485,10000,100,0,1,6,3,3,0,0,0,0,0,0,1,0,1,2,1,1,0,0,0,3,2,1,0,0,0,0,0,0,0,0,0
199494,10000,100,0,1,35,10,25,0,0,0,0,0,0,9,3,6,0,0,0,1,0,1,25,7,18,0,0,0,0,0,0,0,0,0
199582,10000,100,0,1,41,22,19,0,0,0,0,0,0,2,2,0,0,0,0,0,0,0,0,0,0,0,0,0,39,20,19,0,0,0
199607,10000,100,0,1,20,9,11,0,0,0,0,0,0,0,0,0,4,1,3,0,0,0,15,7,8,1,1,0,0,0,0,0,0,0
199625,10000,100,0,1,13,6,7,1,0,1,0,0,0,1,1,0,1,1,0,0,0,0,10,4,6,0,0,0,0,0,0,0,0,0
199634,10000,100,0,1,15,7,8,0,0,0,0,0,0,5,2,3,0,0,0,0,0,0,10,5,5,0,0,0,0,0,0,0,0,0
199643,10000,100,0,1,38,17,21,0,0,0,0,0,0,36,16,20,0,0,0,0,0,0,1,1,0,1,0,1,0,0,0,0,0,0
199698,10000,100,0,1,32,10,22,0,0,0,0,0,0,11,0,11,7,4,3,0,0,0,14,6,8,0,0,0,0,0,0,0,0,0
199722,10000,100,0,1,32,15,17,2,1,1,0,0,0,7,3,4,1,1,0,0,0,0,22,10,12,0,0,0,0,0,0,0,0,0
199731,10000,100,0,1,22,8,14,1,0,1,0,0,0,0,0,0,1,0,1,0,0,0,20,8,12,0,0,0,0,0,0,0,0,0
199740,10000,100,0,1,9,2,7,0,0,0,0,0,0,2,1,1,0,0,0,0,0,0,7,1,6,0,0,0,0,0,0,0,0,0
199759,10000,100,0,1,21,15,6,0,0,0,0,0,0,0,0,0,0,0,0,0,0,0,21,15,6,0,0,0,0,0,0,0,0,0
199768,10000,100,0,1,14,6,8,0,0,0,0,0,0,0,0,0,0,0,0,0,0,0,14,6,8,0,0,0,0,0,0,0,0,0
199786,10000,100,0,1,23,7,16,0,0,0,0,0,0,5,3,2,2,0,2,0,0,0,16,4,12,0,0,0,0,0,0,0,0,0
199795,10000,100,0,1,13,6,7,0,0,0,0,0,0,0,0,0,0,0,0,0,0,0,13,6,7,0,0,0,0,0,0,0,0,0
199838,10000,100,0,1,19,9,10,1,0,1,1,1,0,4,4,0,1,0,1,0,0,0,12,4,8,0,0,0,0,0,0,0,0,0
199847,10000,100,0,1,615,244,371,1,1,0,46,26,20,108,27,81,41,12,29,0,0,0,373,159,214,19,6,13,5,1,4,22,12,10
199856,10000,100,0,1,115,55,60,0,0,0,4,3,1,21,4,17,3,1,2,0,0,0,63,34,29,0,0,0,24,13,11,0,0,0
199865,10000,100,0,1,31,11,20,0,0,0,0,0,0,4,1,3,3,3,0,0,0,0,16,6,10,0,0,0,7,1,6,1,0,1
199883,10000,100,0,1,2,0,2,0,0,0,0,0,0,2,0,2,0,0,0,0,0,0,0,0,0,0,0,0,0,0,0,0,0,0
199892,10000,100,0,1,26,9,17,0,0,0,0,0,0,7,3,4,1,1,0,0,0,0,18,5,13,0,0,0,0,0,0,0,0,0
199908,10000,100,0,1,10,3,7,0,0,0,0,0,0,1,0,1,0,0,0,0,0,0,9,3,6,0,0,0,0,0,0,0,0,0
199926,10000,100,0,1,17,6,11,0,0,0,0,0,0,0,0,0,1,0,1,0,0,0,16,6,10,0,0,0,0,0,0,0,0,0
199953,10000,100,0,1,11,3,8,0,0,0,0,0,0,5,3,2,1,0,1,0,0,0,5,0,5,0,0,0,0,0,0,0,0,0
199962,10000,100,0,1,54,16,38,0,0,0,2,1,1,6,1,5,10,2,8,0,0,0,36,12,24,0,0,0,0,0,0,0,0,0
199999,10000,100,0,1,75,30,45,0,0,0,2,0,2,44,18,26,1,0,1,0,0,0,7,5,2,0,0,0,21,7,14,0,0,0
200004,10000,100,0,1,173,93,80,0,0,0,3,0,3,22,17,5,12,6,6,0,0,0,130,68,62,3,0,3,0,0,0,3,2,1
200022,10000,100,0,1,34,14,20,1,1,0,0,0,0,1,1,0,0,0,0,0,0,0,29,10,19,1,0,1,1,1,0,1,1,0
200059,10000,100,0,1,12,6,6,0,0,0,0,0,0,0,0,0,0,0,0,0,0,0,12,6,6,0,0,0,0,0,0,0,0,0
200086,10000,100,0,1,2,0,2,0,0,0,0,0,0,0,0,0,0,0,0,0,0,0,2,0,2,0,0,0,0,0,0,0,0,0
200156,10000,100,0,1,28,13,15,0,0,0,0,0,0,0,0,0,0,0,0,0,0,0,28,13,15,0,0,0,0,0,0,0,0,0
200192,10000,100,0,1,19,6,13,0,0,0,0,0,0,0,0,0,0,0,0,0,0,0,18,6,12,1,0,1,0,0,0,0,0,0
200208,10000,100,0,1,11,4,7,8,3,5,0,0,0,0,0,0,0,0,0,0,0,0,3,1,2,0,0,0,0,0,0,0,0,0
200217,10000,100,0,1,37,15,22,0,0,0,1,1,0,0,0,0,2,1,1,0,0,0,33,13,20,0,0,0,1,0,1,0,0,0
200226,10000,100,0,1,25,5,20,0,0,0,0,0,0,0,0,0,2,0,2,0,0,0,18,3,15,3,1,2,2,1,1,0,0,0
200253,10000,100,0,1,46,17,29,0,0,0,0,0,0,1,1,0,2,1,1,0,0,0,42,15,27,0,0,0,1,0,1,0,0,0
200280,10000,100,0,1,278,132,146,8,4,4,16,5,11,9,5,4,5,2,3,2,2,0,193,90,103,12,4,8,3,1,2,30,19,11
200305,10000,100,0,1,28,12,16,0,0,0,0,0,0,0,0,0,0,0,0,0,0,0,28,12,16,0,0,0,0,0,0,0,0,0
200314,10000,100,0,1,7,2,5,2,0,2,0,0,0,0,0,0,0,0,0,0,0,0,5,2,3,0,0,0,0,0,0,0,0,0
200332,10000,100,0,1,239,112,127,7,5,2,28,14,14,6,2,4,6,1,5,0,0,0,145,55,90,3,1,2,12,8,4,32,26,6
200341,10000,100,0,1,18,5,13,0,0,0,0,0,0,1,1,0,0,0,0,0,0,0,16,4,12,1,0,1,0,0,0,0,0,0
200466,10000,100,0,1,6,2,4,3,1,2,0,0,0,1,0,1,0,0,0,0,0,0,2,1,1,0,0,0,0,0,0,0,0,0
200484,10000,100,0,1,2,2,0,0,0,0,0,0,0,0,0,0,0,0,0,0,0,0,2,2,0,0,0,0,0,0,0,0,0,0
200527,10000,100,0,1,10,6,4,9,5,4,0,0,0,0,0,0,0,0,0,0,0,0,1,1,0,0,0,0,0,0,0,0,0,0
200554,10000,100,0,1,8,5,3,4,2,2,0,0,0,0,0,0,0,0,0,0,0,0,3,3,0,0,0,0,1,0,1,0,0,0
200572,10000,100,0,1,26,12,14,0,0,0,0,0,0,0,0,0,0,0,0,1,1,0,25,11,14,0,0,0,0,0,0,0,0,0
200590,10000,100,0,1,2,0,2,0,0,0,0,0,0,0,0,0,0,0,0,0,0,0,2,0,2,0,0,0,0,0,0,0,0,0
200785,10000,100,0,1,2,0,2,0,0,0,0,0,0,1,0,1,0,0,0,0,0,0,1,0,1,0,0,0,0,0,0,0,0,0
200800,10000,100,0,1,144,68,76,0,0,0,7,2,5,17,9,8,3,2,1,0,0,0,110,52,58,0,0,0,0,0,0,7,3,4
201061,10000,100,0,1,9,2,7,0,0,0,0,0,0,3,1,2,0,0,0,0,0,0,5,1,4,1,0,1,0,0,0,0,0,0
201104,10000,100,0,1,121,56,65,0,0,0,1,1,0,13,4,9,4,4,0,0,0,0,101,46,55,0,0,0,0,0,0,2,1,1
201140,10000,100,0,1,7,5,2,0,0,0,0,0,0,1,1,0,0,0,0,0,0,0,6,4,2,0,0,0,0,0,0,0,0,0
201177,10000,100,0,1,5,1,4,0,0,0,0,0,0,0,0,0,0,0,0,0,0,0,5,1,4,0,0,0,0,0,0,0,0,0
201195,10000,100,0,1,72,28,44,0,0,0,1,0,1,5,2,3,3,2,1,0,0,0,61,23,38,2,1,1,0,0,0,0,0,0
201283,10000,100,0,1,8,5,3,0,0,0,0,0,0,0,0,0,0,0,0,0,0,0,8,5,3,0,0,0,0,0,0,0,0,0
201371,10000,100,0,1,23,5,18,0,0,0,0,0,0,0,0,0,1,0,1,0,0,0,22,5,17,0,0,0,0,0,0,0,0,0
201432,10000,100,0,1,3,3,0,0,0,0,0,0,0,0,0,0,0,0,0,0,0,0,2,2,0,0,0,0,1,1,0,0,0,0
201441,10000,100,0,1,124,55,69,1,1,0,1,0,1,4,1,3,5,3,2,0,0,0,90,38,52,1,1,0,22,11,11,0,0,0
201469,10000,100,0,1,16,4,12,0,0,0,0,0,0,2,0,2,1,0,1,0,0,0,13,4,9,0,0,0,0,0,0,0,0,0
201548,10000,100,0,1,55,20,35,0,0,0,2,2,0,6,1,5,1,0,1,0,0,0,43,16,27,1,1,0,2,0,2,0,0,0
201645,10000,100,0,1,390,158,232,0,0,0,67,31,36,67,25,42,26,12,14,1,1,0,205,77,128,0,0,0,11,6,5,13,6,7
201654,10000,100,0,1,67,26,41,0,0,0,0,0,0,2,2,0,0,0,0,0,0,0,62,21,41,1,1,0,2,2,0,0,0,0
201672,10000,100,0,1,13,7,6,0,0,0,0,0,0,2,2,0,0,0,0,0,0,0,11,5,6,0,0,0,0,0,0,0,0,0
201690,10000,100,0,1,94,38,56,0,0,0,6,3,3,51,20,31,2,2,0,0,0,0,29,11,18,0,0,0,6,2,4,0,0,0
201751,10000,100,0,1,10,1,9,0,0,0,0,0,0,1,0,1,0,0,0,0,0,0,8,1,7,0,0,0,1,0,1,0,0,0
201821,10000,100,0,1,19,4,15,0,0,0,0,0,0,2,0,2,0,0,0,0,0,0,17,4,13,0,0,0,0,0,0,0,0,0
201885,10000,100,0,1,879,340,539,1,0,1,50,25,25,108,33,75,42,21,21,0,0,0,561,206,355,21,8,13,27,9,18,69,38,31
201928,10000,100,0,1,16,1,15,1,0,1,2,1,1,4,0,4,0,0,0,0,0,0,9,0,9,0,0,0,0,0,0,0,0,0
201946,10000,100,0,1,14,5,9,0,0,0,0,0,0,1,0,1,1,0,1,0,0,0,11,5,6,0,0,0,1,0,1,0,0,0
201955,10000,100,0,1,13,3,10,0,0,0,0,0,0,3,1,2,0,0,0,0,0,0,8,2,6,1,0,1,1,0,1,0,0,0
201964,10000,100,0,1,11,7,4,0,0,0,0,0,0,1,1,0,0,0,0,0,0,0,10,6,4,0,0,0,0,0,0,0,0,0
201973,10000,100,0,1,37,16,21,0,0,0,0,0,0,9,5,4,0,0,0,0,0,0,25,9,16,0,0,0,3,2,1,0,0,0
202046,10000,100,0,1,18,8,10,0,0,0,0,0,0,3,1,2,2,2,0,0,0,0,13,5,8,0,0,0,0,0,0,0,0,0
202073,10000,100,0,1,13,5,8,0,0,0,1,0,1,1,0,1,0,0,0,0,0,0,11,5,6,0,0,0,0,0,0,0,0,0
202134,10000,100,0,1,93,58,35,0,0,0,3,2,1,14,7,7,5,4,1,0,0,0,64,41,23,2,1,1,1,1,0,4,2,2
202170,10000,100,0,1,24,6,18,0,0,0,0,0,0,5,2,3,1,0,1,0,0,0,17,4,13,1,0,1,0,0,0,0,0,0
202222,10000,100,0,1,61,24,37,0,0,0,1,1,0,12,4,8,3,0,3,3,0,3,40,17,23,0,0,0,2,2,0,0,0,0
202356,10000,100,0,1,84,31,53,0,0,0,2,1,1,20,6,14,5,2,3,0,0,0,53,20,33,2,1,1,1,1,0,1,0,1
202480,10000,100,0,1,336,194,142,0,0,0,14,9,5,22,14,8,7,6,1,0,0,0,259,148,111,6,3,3,20,9,11,8,5,3
202514,10000,100,0,1,28,10,18,0,0,0,0,0,0,2,2,0,0,0,0,0,0,0,25,7,18,0,0,0,1,1,0,0,0,0
202523,10000,100,0,1,111,45,66,0,0,0,5,3,2,10,3,7,2,1,1,0,0,0,90,35,55,4,3,1,0,0,0,0,0,0
202648,10000,100,0,1,11,4,7,0,0,0,1,0,1,0,0,0,1,0,1,0,0,0,5,1,4,0,0,0,4,3,1,0,0,0
202763,10000,100,0,1,53,23,30,0,0,0,2,1,1,2,2,0,3,3,0,0,0,0,46,17,29,0,0,0,0,0,0,0,0,0
202806,10000,100,0,1,26,6,20,0,0,0,0,0,0,1,1,0,0,0,0,0,0,0,24,5,19,1,0,1,0,0,0,0,0,0
202903,10000,100,0,1,10,6,4,0,0,0,0,0,0,0,0,0,0,0,0,0,0,0,10,6,4,0,0,0,0,0,0,0,0,0
202912,10000,100,0,1,14,1,13,0,0,0,1,0,1,3,0,3,1,1,0,0,0,0,9,0,9,0,0,0,0,0,0,0,0,0
203067,10000,100,0,1,18,8,10,0,0,0,2,2,0,2,0,2,0,0,0,0,0,0,14,6,8,0,0,0,0,0,0,0,0,0
203085,10000,100,0,1,23,11,12,0,0,0,0,0,0,1,0,1,0,0,0,0,0,0,22,11,11,0,0,0,0,0,0,0,0,0
203128,10000,100,0,1,28,12,16,0,0,0,1,0,1,1,1,0,1,0,1,0,0,0,24,10,14,1,1,0,0,0,0,0,0,0
203155,10000,100,0,1,41,25,16,0,0,0,1,1,0,3,1,2,0,0,0,0,0,0,37,23,14,0,0,0,0,0,0,0,0,0
203331,10000,100,0,1,7,1,6,0,0,0,0,0,0,0,0,0,0,0,0,0,0,0,7,1,6,0,0,0,0,0,0,0,0,0
203368,10000,100,0,1,59,25,34,0,0,0,3,1,2,5,0,5,2,1,1,0,0,0,46,21,25,2,1,1,0,0,0,1,1,0
203386,10000,100,0,1,55,17,38,0,0,0,0,0,0,5,0,5,0,0,0,0,0,0,48,16,32,1,1,0,1,0,1,0,0,0
203447,10000,100,0,1,3,2,1,0,0,0,0,0,0,0,0,0,0,0,0,0,0,0,2,1,1,0,0,0,1,1,0,0,0,0
203465,10000,100,0,1,3,0,3,0,0,0,0,0,0,0,0,0,0,0,0,0,0,0,3,0,3,0,0,0,0,0,0,0,0,0
203474,10000,100,0,1,1,0,1,0,0,0,0,0,0,0,0,0,0,0,0,0,0,0,1,0,1,0,0,0,0,0,0,0,0,0
203483,10000,100,0,1,1,1,0,0,0,0,0,0,0,0,0,0,0,0,0,0,0,0,1,1,0,0,0,0,0,0,0,0,0,0
203492,10000,100,0,1,2,1,1,0,0,0,0,0,0,0,0,0,0,0,0,0,0,0,1,0,1,0,0,0,0,0,0,1,1,0
203517,10000,100,0,1,255,112,143,0,0,0,2,0,2,27,16,11,11,5,6,0,0,0,181,70,111,4,2,2,16,13,3,14,6,8
203526,10000,100,0,1,4,4,0,0,0,0,0,0,0,1,1,0,0,0,0,0,0,0,3,3,0,0,0,0,0,0,0,0,0,0
203535,10000,100,0,1,89,26,63,1,0,1,1,0,1,1,0,1,6,4,2,0,0,0,26,4,22,0,0,0,51,17,34,3,1,2
203544,10000,100,0,1,10,4,6,0,0,0,0,0,0,2,1,1,1,1,0,0,0,0,6,2,4,0,0,0,0,0,0,1,0,1
203580,10000,100,0,1,18,9,9,0,0,0,0,0,0,3,2,1,0,0,0,0,0,0,15,7,8,0,0,0,0,0,0,0,0,0
203599,10000,100,0,1,13,4,9,0,0,0,0,0,0,1,0,1,0,0,0,0,0,0,10,4,6,1,0,1,1,0,1,0,0,0
203678,10000,100,0,1,29,6,23,0,0,0,1,1,0,1,0,1,0,0,0,0,0,0,26,5,21,1,0,1,0,0,0,0,0,0
203720,10000,100,0,1,9,7,2,0,0,0,0,0,0,2,2,0,1,0,1,0,0,0,6,5,1,0,0,0,0,0,0,0,0,0
203748,10000,100,0,1,11,2,9,0,0,0,0,0,0,0,0,0,1,0,1,0,0,0,10,2,8,0,0,0,0,0,0,0,0,0
203757,10000,100,0,1,31,7,24,0,0,0,0,0,0,2,0,2,0,0,0,0,0,0,27,6,21,0,0,0,2,1,1,0,0,0
203775,10000,100,0,1,32,10,22,0,0,0,0,0,0,5,3,2,0,0,0,0,0,0,25,7,18,2,0,2,0,0,0,0,0,0
203845,10000,100,0,1,34,15,19,1,1,0,0,0,0,1,0,1,1,1,0,0,0,0,29,11,18,0,0,0,2,2,0,0,0,0
203881,10000,100,0,1,7,3,4,0,0,0,0,0,0,0,0,0,0,0,0,0,0,0,7,3,4,0,0,0,0,0,0,0,0,0
203960,10000,100,0,1,14,3,11,0,0,0,0,0,0,2,1,1,0,0,0,0,0,0,11,1,10,0,0,0,1,1,0,0,0,0
204006,10000,100,0,1,6,2,4,0,0,0,0,0,0,1,1,0,0,0,0,0,0,0,5,1,4,0,0,0,0,0,0,0,0,0
204015,10000,100,0,1,8,5,3,0,0,0,0,0,0,0,0,0,0,0,0,0,0,0,7,5,2,0,0,0,1,0,1,0,0,0
204024,10000,100,0,1,182,88,94,0,0,0,5,2,3,14,4,10,7,5,2,0,0,0,136,69,67,1,0,1,15,4,11,4,4,0
204176,10000,100,0,1,9,2,7,0,0,0,0,0,0,1,1,0,0,0,0,0,0,0,8,1,7,0,0,0,0,0,0,0,0,0
204185,10000,100,0,1,30,13,17,0,0,0,2,1,1,3,1,2,3,2,1,0,0,0,21,8,13,0,0,0,0,0,0,1,1,0
204194,10000,100,0,1,46,22,24,0,0,0,1,1,0,2,1,1,1,1,0,0,0,0,39,19,20,1,0,1,2,0,2,0,0,0
204200,10000,100,0,1,40,17,23,0,0,0,2,0,2,2,2,0,0,0,0,0,0,0,35,15,20,1,0,1,0,0,0,0,0,0
204255,10000,100,0,1,5,1,4,0,0,0,0,0,0,0,0,0,0,0,0,0,0,0,5,1,4,0,0,0,0,0,0,0,0,0
204264,10000,100,0,1,27,9,18,0,0,0,1,0,1,1,1,0,0,0,0,0,0,0,25,8,17,0,0,0,0,0,0,0,0,0
204422,10000,100,0,1,18,8,10,0,0,0,1,1,0,2,1,1,0,0,0,2,1,1,11,4,7,0,0,0,2,1,1,0,0,0
204440,10000,100,0,1,21,8,13,0,0,0,0,0,0,0,0,0,0,0,0,0,0,0,21,8,13,0,0,0,0,0,0,0,0,0
204468,10000,100,0,1,22,12,10,0,0,0,0,0,0,5,3,2,0,0,0,0,0,0,16,8,8,1,1,0,0,0,0,0,0,0
204477,10000,100,0,1,72,26,46,0,0,0,2,1,1,0,0,0,2,0,2,0,0,0,51,18,33,0,0,0,8,3,5,9,4,5
204486,10000,100,0,1,18,11,7,0,0,0,0,0,0,1,1,0,0,0,0,0,0,0,17,10,7,0,0,0,0,0,0,0,0,0
204501,10000,100,0,1,269,83,186,0,0,0,5,2,3,18,6,12,12,6,6,0,0,0,206,59,147,0,0,0,8,1,7,20,9,11
204608,10000,100,0,1,9,6,3,0,0,0,0,0,0,2,1,1,0,0,0,0,0,0,6,4,2,0,0,0,1,1,0,0,0,0
204617,10000,100,0,1,18,12,6,0,0,0,1,1,0,2,2,0,1,1,0,0,0,0,12,7,5,1,0,1,1,1,0,0,0,0
204635,10000,100,0,1,53,21,32,0,0,0,1,0,1,1,1,0,1,1,0,0,0,0,49,19,30,1,0,1,0,0,0,0,0,0
204662,10000,100,0,1,1,0,1,0,0,0,0,0,0,0,0,0,0,0,0,0,0,0,1,0,1,0,0,0,0,0,0,0,0,0
204671,10000,100,0,1,5,2,3,0,0,0,0,0,0,2,0,2,0,0,0,0,0,0,3,2,1,0,0,0,0,0,0,0,0,0
204680,10000,100,0,1,2,0,2,0,0,0,0,0,0,0,0,0,0,0,0,0,0,0,2,0,2,0,0,0,0,0,0,0,0,0
204699,10000,100,0,1,1,0,1,0,0,0,0,0,0,0,0,0,0,0,0,0,0,0,1,0,1,0,0,0,0,0,0,0,0,0
204705,10000,100,0,1,9,1,8,0,0,0,0,0,0,0,0,0,0,0,0,0,0,0,9,1,8,0,0,0,0,0,0,0,0,0
204796,10000,100,0,1,2988,979,2009,2,0,2,208,82,126,477,164,313,134,53,81,1,0,1,1865,575,1290,79,25,54,177,57,120,45,23,22
204820,10000,100,0,1,2,0,2,0,0,0,0,0,0,0,0,0,0,0,0,0,0,0,1,0,1,1,0,1,0,0,0,0,0,0
204839,10000,100,0,1,3,2,1,0,0,0,0,0,0,0,0,0,0,0,0,0,0,0,3,2,1,0,0,0,0,0,0,0,0,0
204848,10000,100,0,1,1,1,0,0,0,0,0,0,0,0,0,0,0,0,0,0,0,0,1,1,0,0,0,0,0,0,0,0,0,0
204857,10000,100,0,1,144,64,80,0,0,0,3,1,2,9,2,7,7,4,3,0,0,0,105,46,59,1,0,1,10,6,4,9,5,4
204866,10000,100,0,1,2,1,1,0,0,0,0,0,0,0,0,0,0,0,0,0,0,0,2,1,1,0,0,0,0,0,0,0,0,0
204884,10000,100,0,1,4,1,3,0,0,0,0,0,0,0,0,0,0,0,0,0,0,0,4,1,3,0,0,0,0,0,0,0,0,0
204909,10000,100,0,1,52,20,32,0,0,0,2,0,2,8,2,6,3,0,3,0,0,0,36,17,19,2,1,1,1,0,1,0,0,0
204936,10000,100,0,1,22,13,9,0,0,0,0,0,0,3,2,1,0,0,0,0,0,0,15,9,6,1,1,0,2,0,2,1,1,0
204945,10000,100,0,1,62,18,44,0,0,0,1,0,1,4,1,3,2,0,2,0,0,0,54,17,37,1,0,1,0,0,0,0,0,0
204990,10000,100,0,1,6,3,3,0,0,0,0,0,0,6,3,3,0,0,0,0,0,0,0,0,0,0,0,0,0,0,0,0,0,0
205027,10000,100,0,1,2,1,1,0,0,0,0,0,0,0,0,0,0,0,0,0,0,0,2,1,1,0,0,0,0,0,0,0,0,0
205054,10000,100,0,1,6,1,5,0,0,0,0,0,0,1,0,1,1,0,1,0,0,0,4,1,3,0,0,0,0,0,0,0,0,0
205179,10000,100,0,1,14,5,9,0,0,0,0,0,0,0,0,0,2,0,2,0,0,0,10,5,5,2,0,2,0,0,0,0,0,0
205203,10000,100,0,1,30,15,15,0,0,0,0,0,0,3,2,1,0,0,0,0,0,0,26,13,13,1,0,1,0,0,0,0,0,0
205391,10000,100,0,1,7,4,3,0,0,0,1,0,1,0,0,0,0,0,0,0,0,0,6,4,2,0,0,0,0,0,0,0,0,0
205443,10000,100,0,1,24,13,11,0,0,0,0,0,0,2,2,0,0,0,0,0,0,0,22,11,11,0,0,0,0,0,0,0,0,0
205470,10000,100,0,1,79,35,44,1,1,0,2,1,1,14,4,10,0,0,0,0,0,0,61,29,32,1,0,1,0,0,0,0,0,0
205841,10000,100,0,1,11,5,6,0,0,0,0,0,0,0,0,0,0,0,0,0,0,0,10,4,6,0,0,0,1,1,0,0,0,0
205887,10000,100,0,1,14,2,12,0,0,0,0,0,0,1,0,1,1,0,1,0,0,0,12,2,10,0,0,0,0,0,0,0,0,0
205957,10000,100,0,1,33,18,15,0,0,0,0,0,0,0,0,0,2,1,1,0,0,0,30,16,14,0,0,0,1,1,0,0,0,0
205966,10000,100,0,1,11,6,5,0,0,0,0,0,0,0,0,0,0,0,0,0,0,0,11,6,5,0,0,0,0,0,0,0,0,0
206011,10000,100,0,1,21,11,10,0,0,0,0,0,0,1,0,1,1,0,1,0,0,0,19,11,8,0,0,0,0,0,0,0,0,0
206048,10000,100,0,1,46,25,21,0,0,0,1,0,1,3,1,2,3,1,2,0,0,0,37,22,15,2,1,1,0,0,0,0,0,0
206084,10000,100,0,1,551,215,336,0,0,0,64,35,29,103,27,76,29,13,16,0,0,0,348,138,210,3,1,2,3,0,3,1,1,0
206279,10000,100,0,1,7,1,6,0,0,0,1,0,1,0,0,0,1,0,1,0,0,0,5,1,4,0,0,0,0,0,0,0,0,0
206288,10000,100,0,1,4,1,3,0,0,0,1,0,1,1,0,1,1,1,0,0,0,0,1,0,1,0,0,0,0,0,0,0,0,0
206349,10000,100,0,1,21,6,15,0,0,0,0,0,0,3,2,1,0,0,0,0,0,0,17,4,13,1,0,1,0,0,0,0,0,0
206437,10000,100,0,1,27,12,15,0,0,0,0,0,0,3,2,1,0,0,0,0,0,0,22,8,14,0,0,0,2,2,0,0,0,0
206446,10000,100,0,1,31,13,18,0,0,0,0,0,0,0,0,0,1,1,0,0,0,0,29,11,18,0,0,0,1,1,0,0,0,0
206491,10000,100,0,1,4,3,1,0,0,0,0,0,0,4,3,1,0,0,0,0,0,0,0,0,0,0,0,0,0,0,0,0,0,0
206507,10000,100,0,1,35,15,20,0,0,0,0,0,0,3,1,2,1,0,1,0,0,0,28,14,14,3,0,3,0,0,0,0,0,0
206525,10000,100,0,1,56,23,33,0,0,0,2,2,0,4,2,2,3,2,1,0,0,0,45,16,29,2,1,1,0,0,0,0,0,0
206589,10000,100,0,1,57,25,32,1,0,1,1,0,1,8,3,5,4,2,2,0,0,0,38,16,22,0,0,0,1,1,0,4,3,1
206604,10000,100,0,1,107,55,52,0,0,0,6,4,2,15,8,7,3,2,1,0,0,0,77,37,40,1,1,0,0,0,0,5,3,2
206622,10000,100,0,1,109,46,63,0,0,0,4,1,3,25,10,15,2,1,1,0,0,0,71,32,39,3,1,2,2,1,1,2,0,2
206695,10000,100,0,1,115,63,52,0,0,0,0,0,0,5,3,2,5,3,2,0,0,0,90,47,43,4,1,3,2,2,0,9,7,2
206835,10000,100,0,1,13,6,7,0,0,0,0,0,0,0,0,0,0,0,0,0,0,0,10,5,5,1,0,1,2,1,1,0,0,0
206862,10000,100,0,1,48,19,29,1,0,1,1,0,1,2,0,2,5,3,2,1,1,0,36,15,21,2,0,2,0,0,0,0,0,0
206914,10000,100,0,1,68,24,44,0,0,0,3,1,2,11,4,7,10,6,4,0,0,0,36,11,25,8,2,6,0,0,0,0,0,0
206923,10000,100,0,1,9,2,7,1,0,1,0,0,0,0,0,0,0,0,0,0,0,0,8,2,6,0,0,0,0,0,0,0,0,0
206932,10000,100,0,1,7,1,6,0,0,0,1,0,1,1,0,1,0,0,0,0,0,0,5,1,4,0,0,0,0,0,0,0,0,0
206941,10000,100,0,1,220,91,129,4,0,4,5,3,2,16,7,9,7,3,4,2,1,1,107,40,67,1,1,0,76,34,42,2,2,0
206996,10000,100,0,1,24,7,17,4,1,3,1,1,0,0,0,0,1,0,1,0,0,0,17,5,12,1,0,1,0,0,0,0,0,0
207041,10000,100,0,1,33,14,19,2,1,1,1,1,0,0,0,0,1,0,1,0,0,0,24,11,13,0,0,0,5,1,4,0,0,0
207050,10000,100,0,1,20,8,12,4,0,4,0,0,0,1,0,1,2,2,0,0,0,0,11,6,5,1,0,1,1,0,1,0,0,0
207069,10000,100,0,1,14,8,6,0,0,0,0,0,0,1,1,0,3,1,2,0,0,0,9,6,3,1,0,1,0,0,0,0,0,0
207157,10000,100,0,1,6,5,1,1,1,0,0,0,0,0,0,0,0,0,0,0,0,0,5,4,1,0,0,0,0,0,0,0,0,0
207209,10000,100,0,1,47,16,31,0,0,0,1,1,0,28,13,15,1,0,1,0,0,0,13,0,13,1,1,0,0,0,0,3,1,2
207236,10000,100,0,1,27,9,18,7,2,5,0,0,0,0,0,0,3,1,2,0,0,0,16,5,11,0,0,0,1,1,0,0,0,0
207254,10000,100,0,1,47,31,16,6,4,2,4,4,0,6,1,5,5,4,1,0,0,0,26,18,8,0,0,0,0,0,0,0,0,0
207263,10000,100,0,1,134,49,85,24,5,19,5,0,5,5,5,0,7,4,3,0,0,0,75,32,43,13,2,11,1,0,1,4,1,3
207281,10000,100,0,1,25,8,17,0,0,0,0,0,0,0,0,0,1,0,1,0,0,0,24,8,16,0,0,0,0,0,0,0,0,0
207290,10000,100,0,1,55,25,30,8,5,3,0,0,0,3,3,0,4,1,3,1,1,0,35,14,21,4,1,3,0,0,0,0,0,0
207306,10000,100,0,1,18,8,10,1,0,1,0,0,0,1,1,0,0,0,0,0,0,0,14,6,8,0,0,0,2,1,1,0,0,0
207315,10000,100,0,1,142,50,92,6,1,5,8,2,6,8,0,8,10,1,9,0,0,0,102,42,60,6,3,3,1,1,0,1,0,1
207324,10000,100,0,1,25,10,15,0,0,0,0,0,0,4,1,3,2,1,1,0,0,0,18,8,10,0,0,0,1,0,1,0,0,0
207342,10000,100,0,1,219,64,155,8,2,6,12,4,8,15,2,13,32,7,25,1,0,1,118,32,86,15,7,8,2,0,2,16,10,6
207351,10000,100,0,1,23,10,13,0,0,0,1,1,0,1,1,0,4,2,2,0,0,0,15,6,9,0,0,0,1,0,1,1,0,1
207388,10000,100,0,1,596,261,335,19,7,12,20,9,11,28,20,8,42,13,29,0,0,0,402,165,237,37,15,22,4,2,2,44,30,14
207397,10000,100,0,1,38,18,20,2,1,1,0,0,0,3,0,3,1,1,0,0,0,0,28,12,16,4,4,0,0,0,0,0,0,0
207403,10000,100,0,1,32,21,11,0,0,0,1,0,1,2,1,1,0,0,0,0,0,0,27,20,7,1,0,1,1,0,1,0,0,0
207449,10000,100,0,1,82,32,50,3,1,2,5,1,4,11,3,8,6,1,5,0,0,0,50,23,27,5,3,2,2,0,2,0,0,0
207458,10000,100,0,1,83,39,44,1,1,0,3,2,1,6,4,2,2,2,0,0,0,0,64,26,38,2,1,1,0,0,0,5,3,2
207500,10000,100,0,1,555,277,278,13,9,4,17,10,7,49,27,22,40,20,20,0,0,0,324,145,179,35,19,16,22,13,9,55,34,21
207564,10000,100,0,1,36,19,17,1,0,1,0,0,0,6,3,3,0,0,0,0,0,0,26,13,13,3,3,0,0,0,0,0,0,0
207582,10000,100,0,1,80,40,40,2,0,2,1,0,1,6,3,3,6,3,3,0,0,0,60,31,29,1,1,0,0,0,0,4,2,2
207661,10000,100,0,1,44,17,27,8,2,6,2,0,2,1,0,1,1,1,0,0,0,0,30,13,17,1,1,0,1,0,1,0,0,0
207670,10000,100,0,1,33,13,20,2,2,0,3,1,2,3,1,2,0,0,0,0,0,0,25,9,16,0,0,0,0,0,0,0,0,0
207722,10000,100,0,1,14,7,7,4,4,0,0,0,0,1,1,0,1,0,1,0,0,0,8,2,6,0,0,0,0,0,0,0,0,0
207740,10000,100,0,1,18,5,13,0,0,0,0,0,0,2,0,2,1,0,1,0,0,0,15,5,10,0,0,0,0,0,0,0,0,0
207847,10000,100,0,1,37,17,20,3,2,1,0,0,0,3,3,0,1,0,1,0,0,0,28,12,16,0,0,0,0,0,0,2,0,2
207856,10000,100,0,1,15,6,9,0,0,0,0,0,0,0,0,0,0,0,0,0,0,0,11,5,6,0,0,0,0,0,0,4,1,3
207865,10000,100,0,1,49,19,30,0,0,0,0,0,0,0,0,0,2,0,2,0,0,0,45,19,26,2,0,2,0,0,0,0,0,0
207935,10000,100,0,1,76,30,46,2,2,0,3,2,1,7,2,5,8,2,6,0,0,0,45,13,32,11,9,2,0,0,0,0,0,0
207962,10000,100,0,1,13,6,7,1,1,0,1,0,1,1,0,1,1,0,1,0,0,0,8,4,4,0,0,0,1,1,0,0,0,0
207971,10000,100,0,1,124,51,73,8,4,4,3,2,1,11,8,3,3,1,2,0,0,0,76,26,50,9,3,6,12,7,5,2,0,2
208035,10000,100,0,1,14,5,9,1,1,0,0,0,0,1,1,0,3,0,3,0,0,0,9,3,6,0,0,0,0,0,0,0,0,0
208318,10000,100,0,1,16,10,6,0,0,0,1,1,0,1,1,0,1,0,1,0,0,0,12,7,5,1,1,0,0,0,0,0,0,0
208390,10000,100,0,1,70,35,35,0,0,0,1,0,1,1,0,1,16,6,10,0,0,0,37,21,16,3,1,2,9,5,4,3,2,1
208406,10000,100,0,1,21,6,15,1,0,1,0,0,0,1,0,1,3,2,1,0,0,0,16,4,12,0,0,0,0,0,0,0,0,0
208415,10000,100,0,1,10,3,7,0,0,0,0,0,0,0,0,0,3,1,2,0,0,0,7,2,5,0,0,0,0,0,0,0,0,0
208479,10000,100,0,1,12,4,8,0,0,0,2,2,0,0,0,0,2,0,2,0,0,0,6,2,4,0,0,0,2,0,2,0,0,0
208512,10000,100,0,1,8,3,5,0,0,0,0,0,0,0,0,0,0,0,0,0,0,0,0,0,0,8,3,5,0,0,0,0,0,0
208646,10000,100,0,1,35,15,20,0,0,0,2,1,1,1,1,0,0,0,0,0,0,0,29,11,18,0,0,0,3,2,1,0,0,0
208822,10000,100,0,1,84,35,49,0,0,0,3,2,1,5,3,2,10,5,5,0,0,0,59,21,38,3,2,1,4,2,2,0,0,0
209038,10000,100,0,1,30,13,17,0,0,0,1,1,0,0,0,0,2,2,0,0,0,0,23,7,16,1,1,0,2,2,0,1,0,1
209056,10000,100,0,1,52,29,23,0,0,0,4,2,2,4,2,2,10,7,3,1,0,1,32,18,14,1,0,1,0,0,0,0,0,0
209065,10000,100,0,1,43,15,28,0,0,0,2,0,2,2,1,1,5,2,3,0,0,0,32,11,21,1,1,0,1,0,1,0,0,0
209074,10000,100,0,1,41,13,28,2,2,0,0,0,0,0,0,0,3,0,3,0,0,0,18,6,12,1,0,1,16,5,11,1,0,1
209241,10000,100,0,1,4,3,1,0,0,0,0,0,0,0,0,0,2,2,0,0,0,0,2,1,1,0,0,0,0,0,0,0,0,0
209250,10000,100,0,1,30,13,17,0,0,0,2,2,0,1,1,0,4,0,4,0,0,0,19,10,9,2,0,2,2,0,2,0,0,0
209287,10000,100,0,1,15,6,9,0,0,0,2,1,1,1,1,0,0,0,0,0,0,0,10,2,8,2,2,0,0,0,0,0,0,0
209409,10000,100,0,1,19,10,9,0,0,0,1,1,0,0,0,0,1,1,0,0,0,0,16,8,8,1,0,1,0,0,0,0,0,0
209490,10000,100,0,1,1477,585,892,8,1,7,220,84,136,57,26,31,134,63,71,12,6,6,786,286,500,54,19,35,131,68,63,75,32,43
209506,10000,100,0,1,60,27,33,0,0,0,5,2,3,0,0,0,4,2,2,1,0,1,45,20,25,2,0,2,0,0,0,3,3,0
209542,10000,100,0,1,513,219,294,1,0,1,18,9,9,5,3,2,32,15,17,1,0,1,190,79,111,17,4,13,202,83,119,47,26,21
209551,10000,100,0,1,691,260,431,5,2,3,25,4,21,37,18,19,65,26,39,1,1,0,476,172,304,25,4,21,27,13,14,30,20,10
209612,10000,100,0,1,51,14,37,0,0,0,2,2,0,2,0,2,6,2,4,0,0,0,36,9,27,2,1,1,0,0,0,3,0,3
209746,10000,100,0,1,78,30,48,0,0,0,8,2,6,9,3,6,6,3,3,0,0,0,44,18,26,3,1,2,8,3,5,0,0,0
209807,10000,100,0,1,112,50,62,0,0,0,13,6,7,13,9,4,16,5,11,1,1,0,55,23,32,9,3,6,0,0,0,5,3,2
209825,10000,100,0,1,154,76,78,0,0,0,4,1,3,6,3,3,19,12,7,0,0,0,89,41,48,4,3,1,19,8,11,13,8,5
209922,10000,100,0,1,71,29,42,1,0,1,4,1,3,6,3,3,4,2,2,0,0,0,44,15,29,6,4,2,0,0,0,6,4,2
210146,10000,100,0,1,37,19,18,2,0,2,2,0,2,0,0,0,1,1,0,0,0,0,31,18,13,0,0,0,1,0,1,0,0,0
210155,10000,100,0,1,12,3,9,1,0,1,0,0,0,0,0,0,1,0,1,0,0,0,9,3,6,0,0,0,1,0,1,0,0,0
210234,10000,100,0,1,17,7,10,0,0,0,0,0,0,0,0,0,3,1,2,0,0,0,9,5,4,0,0,0,5,1,4,0,0,0
210270,10000,100,0,1,26,6,20,0,0,0,0,0,0,0,0,0,0,0,0,0,0,0,16,4,12,6,2,4,4,0,4,0,0,0
210304,10000,100,0,1,12,5,7,1,0,1,1,1,0,2,1,1,1,0,1,0,0,0,6,2,4,0,0,0,1,1,0,0,0,0
210331,10000,100,0,1,17,11,6,0,0,0,0,0,0,0,0,0,1,0,1,0,0,0,16,11,5,0,0,0,0,0,0,0,0,0
210368,10000,100,0,1,16,6,10,0,0,0,0,0,0,0,0,0,1,1,0,0,0,0,15,5,10,0,0,0,0,0,0,0,0,0
210401,10000,100,0,1,59,25,34,1,0,1,2,1,1,3,1,2,6,3,3,0,0,0,38,15,23,2,1,1,7,4,3,0,0,0
210429,10000,100,0,1,42,20,22,1,1,0,2,1,1,0,0,0,10,4,6,1,0,1,22,10,12,2,1,1,2,2,0,2,1,1
210438,10000,100,0,1,34,12,22,0,0,0,2,2,0,3,3,0,3,0,3,1,1,0,22,6,16,1,0,1,2,0,2,0,0,0
210492,10000,100,0,1,7,3,4,0,0,0,0,0,0,0,0,0,0,0,0,0,0,0,6,2,4,0,0,0,1,1,0,0,0,0
210571,10000,100,0,1,48,21,27,0,0,0,2,0,2,7,3,4,10,6,4,0,0,0,26,10,16,1,1,0,2,1,1,0,0,0
210599,10000,100,0,1,23,9,14,0,0,0,0,0,0,7,1,6,1,0,1,0,0,0,11,5,6,2,1,1,2,2,0,0,0,0
210605,10000,100,0,1,59,23,36,0,0,0,2,0,2,8,2,6,3,2,1,0,0,0,45,19,26,0,0,0,1,0,1,0,0,0
210669,10000,100,0,1,59,29,30,1,0,1,3,0,3,6,5,1,3,2,1,0,0,0,45,22,23,1,0,1,0,0,0,0,0,0
210739,10000,100,0,1,48,23,25,0,0,0,0,0,0,1,0,1,3,2,1,0,0,0,42,20,22,2,1,1,0,0,0,0,0,0
210775,10000,100,0,1,41,20,21,0,0,0,1,1,0,3,1,2,2,2,0,0,0,0,33,16,17,2,0,2,0,0,0,0,0,0
210809,10000,100,0,1,28,10,18,0,0,0,0,0,0,7,3,4,0,0,0,0,0,0,20,7,13,0,0,0,1,0,1,0,0,0
211024,10000,100,0,1,6,2,4,0,0,0,0,0,0,0,0,0,0,0,0,0,0,0,5,2,3,1,0,1,0,0,0,0,0,0
211079,10000,100,0,1,21,10,11,0,0,0,1,1,0,2,1,1,0,0,0,0,0,0,18,8,10,0,0,0,0,0,0,0,0,0
211088,10000,100,0,1,54,19,35,0,0,0,1,0,1,10,3,7,3,2,1,0,0,0,37,14,23,2,0,2,1,0,1,0,0,0
211130,10000,100,0,1,2,0,2,0,0,0,0,0,0,1,0,1,0,0,0,0,0,0,1,0,1,0,0,0,0,0,0,0,0,0
211158,10000,100,0,1,19,11,8,0,0,0,1,1,0,2,2,0,1,0,1,0,0,0,14,7,7,1,1,0,0,0,0,0,0,0
211273,10000,100,0,1,37,13,24,0,0,0,7,2,5,9,5,4,1,1,0,0,0,0,11,2,9,3,1,2,6,2,4,0,0,0
211291,10000,100,0,1,95,43,52,0,0,0,6,2,4,10,4,6,2,1,1,0,0,0,67,32,35,1,0,1,2,1,1,7,3,4
211307,10000,100,0,1,26,8,18,0,0,0,0,0,0,2,0,2,0,0,0,0,0,0,21,6,15,0,0,0,3,2,1,0,0,0
211343,10000,100,0,1,11,4,7,0,0,0,0,0,0,0,0,0,0,0,0,0,0,0,11,4,7,0,0,0,0,0,0,0,0,0
211352,10000,100,0,1,24,9,15,0,0,0,1,1,0,2,1,1,1,0,1,0,0,0,18,7,11,0,0,0,2,0,2,0,0,0
211361,10000,100,0,1,11,7,4,0,0,0,0,0,0,2,1,1,0,0,0,0,0,0,9,6,3,0,0,0,0,0,0,0,0,0
211431,10000,100,0,1,43,9,34,0,0,0,1,0,1,7,0,7,1,1,0,0,0,0,32,8,24,1,0,1,1,0,1,0,0,0
211440,10000,100,0,1,554,299,255,0,0,0,44,28,16,39,11,28,22,12,10,0,0,0,299,141,158,14,8,6,18,9,9,118,90,28
211468,10000,100,0,1,23,5,18,0,0,0,0,0,0,1,0,1,1,0,1,0,0,0,19,4,15,2,1,1,0,0,0,0,0,0
211477,10000,100,0,1,20,7,13,0,0,0,0,0,0,5,1,4,1,0,1,0,0,0,14,6,8,0,0,0,0,0,0,0,0,0
211556,10000,100,0,1,35,13,22,0,0,0,0,0,0,2,2,0,5,4,1,0,0,0,27,6,21,1,1,0,0,0,0,0,0,0
211583,10000,100,0,1,29,12,17,0,0,0,2,0,2,8,5,3,0,0,0,0,0,0,19,7,12,0,0,0,0,0,0,0,0,0
211608,10000,100,0,1,14,6,8,0,0,0,0,0,0,13,6,7,0,0,0,0,0,0,1,0,1,0,0,0,0,0,0,0,0,0
211644,10000,100,0,1,11,7,4,0,0,0,0,0,0,2,2,0,1,1,0,0,0,0,7,3,4,0,0,0,1,1,0,0,0,0
211893,10000,100,0,1,16,6,10,0,0,0,0,0,0,0,0,0,0,0,0,0,0,0,16,6,10,0,0,0,0,0,0,0,0,0
211927,10000,100,0,1,26,11,15,0,0,0,1,0,1,7,0,7,0,0,0,0,0,0,16,10,6,1,1,0,1,0,1,0,0,0
211981,10000,100,0,1,34,13,21,0,0,0,0,0,0,5,5,0,1,0,1,0,0,0,25,7,18,1,1,0,2,0,2,0,0,0
212009,10000,100,0,1,96,34,62,0,0,0,6,2,4,6,1,5,6,1,5,0,0,0,70,26,44,0,0,0,1,0,1,7,4,3
212045,10000,100,0,1,7,3,4,0,0,0,0,0,0,0,0,0,0,0,0,0,0,0,7,3,4,0,0,0,0,0,0,0,0,0
212054,10000,100,0,1,265,98,167,0,0,0,10,3,7,52,19,33,8,3,5,0,0,0,143,51,92,10,1,9,5,3,2,37,18,19
212106,10000,100,0,1,134,47,87,0,0,0,5,0,5,10,1,9,4,2,2,0,0,0,108,40,68,2,1,1,2,1,1,3,2,1
212115,10000,100,0,1,37,24,13,0,0,0,0,0,0,5,4,1,6,4,2,0,0,0,23,15,8,2,0,2,0,0,0,1,1,0
212133,10000,100,0,1,87,39,48,0,0,0,2,1,1,18,10,8,0,0,0,0,0,0,60,27,33,3,0,3,3,0,3,1,1,0
212160,10000,100,0,1,23,8,15,0,0,0,0,0,0,1,0,1,0,0,0,0,0,0,21,8,13,1,0,1,0,0,0,0,0,0
212197,10000,100,0,1,41,18,23,0,0,0,2,0,2,1,0,1,4,3,1,0,0,0,28,11,17,0,0,0,6,4,2,0,0,0
212434,10000,100,0,1,8,5,3,0,0,0,0,0,0,0,0,0,0,0,0,0,0,0,8,5,3,0,0,0,0,0,0,0,0,0
212577,10000,100,0,1,77,26,51,0,0,0,10,5,5,6,5,1,8,3,5,0,0,0,44,9,35,1,0,1,4,2,2,4,2,2
212601,10000,100,0,1,99,44,55,0,0,0,5,3,2,3,1,2,2,2,0,0,0,0,85,35,50,0,0,0,4,3,1,0,0,0
212656,10000,100,0,1,14,5,9,0,0,0,0,0,0,1,0,1,0,0,0,0,0,0,13,5,8,0,0,0,0,0,0,0,0,0
212674,10000,100,0,1,78,35,43,1,0,1,4,1,3,4,2,2,0,0,0,0,0,0,61,29,32,0,0,0,0,0,0,8,3,5
212771,10000,100,0,1,3,2,1,0,0,0,0,0,0,0,0,0,0,0,0,0,0,0,3,2,1,0,0,0,0,0,0,0,0,0
212832,10000,100,0,1,25,13,12,0,0,0,1,1,0,3,0,3,0,0,0,0,0,0,21,12,9,0,0,0,0,0,0,0,0,0
212869,10000,100,0,1,19,10,9,0,0,0,0,0,0,2,0,2,2,1,1,0,0,0,15,9,6,0,0,0,0,0,0,0,0,0
212878,10000,100,0,1,17,9,8,0,0,0,1,1,0,3,3,0,2,0,2,0,0,0,11,5,6,0,0,0,0,0,0,0,0,0
212911,10000,100,0,1,60,30,30,0,0,0,5,3,2,11,6,5,4,1,3,0,0,0,29,13,16,2,1,1,2,1,1,7,5,2
212975,10000,100,0,1,10,7,3,0,0,0,0,0,0,0,0,0,0,0,0,0,0,0,10,7,3,0,0,0,0,0,0,0,0,0
212984,10000,100,0,1,37,15,22,0,0,0,2,2,0,8,3,5,1,1,0,0,0,0,26,9,17,0,0,0,0,0,0,0,0,0
213011,10000,100,0,1,37,18,19,0,0,0,3,2,1,2,1,1,1,0,1,0,0,0,29,14,15,1,1,0,1,0,1,0,0,0
213020,10000,100,0,1,22,12,10,0,0,0,1,1,0,0,0,0,0,0,0,0,0,0,16,9,7,0,0,0,5,2,3,0,0,0
213181,10000,100,0,1,13,0,13,0,0,0,0,0,0,0,0,0,0,0,0,0,0,0,13,0,13,0,0,0,0,0,0,0,0,0
213233,10000,100,0,1,20,7,13,0,0,0,0,0,0,0,0,0,2,0,2,0,0,0,18,7,11,0,0,0,0,0,0,0,0,0
213251,10000,100,0,1,32,15,17,1,1,0,2,1,1,4,1,3,1,1,0,0,0,0,24,11,13,0,0,0,0,0,0,0,0,0
213303,10000,100,0,1,14,5,9,0,0,0,0,0,0,0,0,0,0,0,0,0,0,0,14,5,9,0,0,0,0,0,0,0,0,0
213321,10000,100,0,1,20,10,10,0,0,0,0,0,0,1,0,1,0,0,0,0,0,0,19,10,9,0,0,0,0,0,0,0,0,0
213349,10000,100,0,1,32,12,20,0,0,0,0,0,0,0,0,0,3,1,2,0,0,0,24,11,13,3,0,3,2,0,2,0,0,0
213358,10000,100,0,1,38,16,22,0,0,0,0,0,0,1,0,1,0,0,0,0,0,0,36,15,21,0,0,0,1,1,0,0,0,0
213367,10000,100,0,1,102,43,59,0,0,0,3,2,1,22,12,10,7,3,4,0,0,0,69,26,43,0,0,0,0,0,0,1,0,1
213376,10000,100,0,1,25,10,15,0,0,0,1,0,1,1,1,0,2,0,2,0,0,0,21,9,12,0,0,0,0,0,0,0,0,0
213385,10000,100,0,1,39,24,15,0,0,0,4,2,2,2,2,0,0,0,0,0,0,0,27,16,11,1,0,1,1,0,1,4,4,0
213400,10000,100,0,1,32,14,18,0,0,0,1,0,1,5,3,2,1,1,0,0,0,0,25,10,15,0,0,0,0,0,0,0,0,0
213446,10000,100,0,1,1,0,1,0,0,0,0,0,0,1,0,1,0,0,0,0,0,0,0,0,0,0,0,0,0,0,0,0,0,0
213507,10000,100,0,1,33,14,19,0,0,0,0,0,0,1,0,1,3,1,2,0,0,0,27,11,16,1,1,0,0,0,0,1,1,0
213525,10000,100,0,1,15,8,7,0,0,0,3,2,1,1,0,1,0,0,0,0,0,0,11,6,5,0,0,0,0,0,0,0,0,0
213534,10000,100,0,1,4,0,4,0,0,0,0,0,0,0,0,0,3,0,3,0,0,0,1,0,1,0,0,0,0,0,0,0,0,0
213543,10000,100,0,1,179,91,88,0,0,0,5,1,4,12,4,8,7,4,3,0,0,0,102,43,59,3,1,2,17,12,5,33,26,7
213570,10000,100,0,1,7,2,5,0,0,0,0,0,0,2,0,2,0,0,0,0,0,0,5,2,3,0,0,0,0,0,0,0,0,0
213589,10000,100,0,1,8,6,2,0,0,0,0,0,0,2,2,0,0,0,0,0,0,0,6,4,2,0,0,0,0,0,0,0,0,0
213598,10000,100,0,1,34,10,24,0,0,0,0,0,0,21,7,14,2,1,1,1,0,1,8,2,6,2,0,2,0,0,0,0,0,0
213613,10000,100,0,1,10,5,5,0,0,0,0,0,0,0,0,0,0,0,0,0,0,0,9,5,4,1,0,1,0,0,0,0,0,0
213631,10000,100,0,1,8,3,5,0,0,0,1,0,1,3,2,1,0,0,0,0,0,0,4,1,3,0,0,0,0,0,0,0,0,0
213659,10000,100,0,1,4,1,3,0,0,0,0,0,0,0,0,0,0,0,0,0,0,0,4,1,3,0,0,0,0,0,0,0,0,0
213668,10000,100,0,1,55,27,28,0,0,0,1,0,1,1,0,1,6,4,2,0,0,0,43,21,22,0,0,0,4,2,2,0,0,0
213774,10000,100,0,1,12,7,5,0,0,0,0,0,0,2,0,2,0,0,0,0,0,0,10,7,3,0,0,0,0,0,0,0,0,0
213783,10000,100,0,1,9,5,4,0,0,0,0,0,0,1,1,0,0,0,0,0,0,0,8,4,4,0,0,0,0,0,0,0,0,0
213826,10000,100,0,1,55,22,33,0,0,0,4,2,2,4,1,3,5,5,0,0,0,0,39,13,26,0,0,0,3,1,2,0,0,0
213987,10000,100,0,1,46,16,30,0,0,0,2,0,2,3,1,2,0,0,0,0,0,0,37,15,22,1,0,1,3,0,3,0,0,0
213996,10000,100,0,1,48,25,23,0,0,0,0,0,0,6,4,2,1,1,0,0,0,0,41,20,21,0,0,0,0,0,0,0,0,0
214041,10000,100,0,1,51,21,30,0,0,0,0,0,0,4,3,1,6,5,1,0,0,0,35,9,26,1,0,1,4,3,1,1,1,0
214069,10000,100,0,1,27,13,14,0,0,0,2,1,1,2,1,1,0,0,0,0,0,0,23,11,12,0,0,0,0,0,0,0,0,0
214111,10000,100,0,1,40,19,21,0,0,0,1,1,0,6,4,2,1,1,0,0,0,0,25,11,14,0,0,0,7,2,5,0,0,0
214148,10000,100,0,1,23,5,18,0,0,0,1,0,1,3,0,3,1,1,0,0,0,0,17,3,14,1,1,0,0,0,0,0,0,0
214157,10000,100,0,1,37,13,24,0,0,0,2,0,2,3,2,1,3,0,3,0,0,0,19,7,12,3,0,3,6,4,2,1,0,1
214166,10000,100,0,1,22,8,14,0,0,0,0,0,0,0,0,0,0,0,0,0,0,0,21,8,13,1,0,1,0,0,0,0,0,0
214175,10000,100,0,1,64,25,39,0,0,0,3,0,3,9,4,5,9,2,7,0,0,0,39,15,24,1,1,0,0,0,0,3,3,0
214272,10000,100,0,1,29,8,21,0,0,0,1,1,0,7,1,6,1,0,1,0,0,0,20,6,14,0,0,0,0,0,0,0,0,0
214290,10000,100,0,1,16,11,5,0,0,0,0,0,0,0,0,0,0,0,0,0,0,0,16,11,5,0,0,0,0,0,0,0,0,0
214379,10000,100,0,1,15,8,7,0,0,0,1,1,0,2,2,0,1,0,1,0,0,0,10,5,5,1,0,1,0,0,0,0,0,0
214564,10000,100,0,1,32,12,20,0,0,0,4,2,2,9,5,4,0,0,0,0,0,0,15,4,11,4,1,3,0,0,0,0,0,0
214582,10000,100,0,1,7,0,7,0,0,0,0,0,0,2,0,2,0,0,0,0,0,0,5,0,5,0,0,0,0,0,0,0,0,0
214661,10000,100,0,1,10,5,5,0,0,0,0,0,0,0,0,0,0,0,0,0,0,0,10,5,5,0,0,0,0,0,0,0,0,0
214883,10000,100,0,1,11,5,6,0,0,0,0,0,0,8,3,5,0,0,0,0,0,0,3,2,1,0,0,0,0,0,0,0,0,0
214892,10000,100,0,1,16,5,11,0,0,0,0,0,0,1,0,1,0,0,0,0,0,0,15,5,10,0,0,0,0,0,0,0,0,0
214944,10000,100,0,1,31,19,12,1,0,1,3,1,2,1,0,1,1,1,0,1,1,0,24,16,8,0,0,0,0,0,0,0,0,0
214971,10000,100,0,1,22,6,16,0,0,0,1,1,0,5,2,3,2,1,1,0,0,0,12,2,10,2,0,2,0,0,0,0,0,0
215053,10000,100,0,1,10,2,8,0,0,0,0,0,0,0,0,0,1,0,1,0,0,0,9,2,7,0,0,0,0,0,0,0,0,0
215062,10000,100,0,1,2359,953,1406,4,3,1,298,117,181,346,125,221,157,57,100,1,1,0,1075,405,670,55,17,38,114,53,61,309,175,134
215105,10000,100,0,1,31,7,24,0,0,0,2,1,1,4,0,4,1,1,0,0,0,0,22,5,17,1,0,1,1,0,1,0,0,0
215114,10000,100,0,1,15,9,6,0,0,0,0,0,0,1,1,0,1,0,1,0,0,0,12,8,4,1,0,1,0,0,0,0,0,0
215123,10000,100,0,1,40,16,24,1,1,0,4,0,4,11,5,6,2,0,2,0,0,0,19,9,10,2,1,1,1,0,1,0,0,0
215132,10000,100,0,1,48,23,25,0,0,0,11,5,6,7,3,4,0,0,0,0,0,0,30,15,15,0,0,0,0,0,0,0,0,0
215239,10000,100,0,1,56,33,23,0,0,0,10,7,3,21,13,8,6,1,5,0,0,0,18,12,6,0,0,0,1,0,1,0,0,0
215266,10000,100,0,1,22,12,10,1,1,0,0,0,0,2,2,0,2,2,0,0,0,0,11,4,7,0,0,0,3,0,3,3,3,0
215275,10000,100,0,1,13,7,6,0,0,0,0,0,0,0,0,0,1,1,0,0,0,0,10,5,5,0,0,0,2,1,1,0,0,0
215284,10000,100,0,1,12,3,9,0,0,0,0,0,0,0,0,0,0,0,0,0,0,0,10,3,7,1,0,1,0,0,0,1,0,1
215293,10000,100,0,1,1307,533,774,0,0,0,91,41,50,97,32,65,50,20,30,2,1,1,728,275,453,20,2,18,113,49,64,206,113,93
215309,10000,100,0,1,2,2,0,0,0,0,0,0,0,0,0,0,0,0,0,0,0,0,1,1,0,0,0,0,1,1,0,0,0,0
215381,10000,100,0,1,15,10,5,0,0,0,0,0,0,0,0,0,0,0,0,0,0,0,15,10,5,0,0,0,0,0,0,0,0,0
215415,10000,100,0,1,20,8,12,0,0,0,1,1,0,3,1,2,1,0,1,0,0,0,14,6,8,1,0,1,0,0,0,0,0,0
215424,10000,100,0,1,6,3,3,0,0,0,0,0,0,2,1,1,0,0,0,0,0,0,4,2,2,0,0,0,0,0,0,0,0,0
215442,10000,100,0,1,37,16,21,0,0,0,1,0,1,1,1,0,1,1,0,0,0,0,33,13,20,1,1,0,0,0,0,0,0,0
215585,10000,100,0,1,25,8,17,0,0,0,0,0,0,4,2,2,3,1,2,0,0,0,18,5,13,0,0,0,0,0,0,0,0,0
215619,10000,100,0,1,3,0,3,0,0,0,0,0,0,1,0,1,0,0,0,0,0,0,2,0,2,0,0,0,0,0,0,0,0,0
215655,10000,100,0,1,55,39,16,0,0,0,0,0,0,3,3,0,10,8,2,0,0,0,33,22,11,1,0,1,0,0,0,8,6,2
215682,10000,100,0,1,8,6,2,0,0,0,0,0,0,0,0,0,0,0,0,0,0,0,8,6,2,0,0,0,0,0,0,0,0,0
215691,10000,100,0,1,55,22,33,0,0,0,1,1,0,15,6,9,3,2,1,0,0,0,35,13,22,1,0,1,0,0,0,0,0,0
215743,10000,100,0,1,82,38,44,0,0,0,0,0,0,3,1,2,1,1,0,0,0,0,77,35,42,0,0,0,0,0,0,1,1,0
215770,10000,100,0,1,96,40,56,0,0,0,6,3,3,18,8,10,4,2,2,0,0,0,62,25,37,0,0,0,6,2,4,0,0,0
215798,10000,100,0,1,29,9,20,0,0,0,0,0,0,1,1,0,0,0,0,0,0,0,25,8,17,0,0,0,3,0,3,0,0,0
215929,10000,100,0,1,62,31,31,0,0,0,3,2,1,5,1,4,2,0,2,0,0,0,44,24,20,0,0,0,3,1,2,5,3,2
215947,10000,100,0,1,35,16,19,0,0,0,0,0,0,3,1,2,0,0,0,0,0,0,31,15,16,0,0,0,0,0,0,1,0,1
215992,10000,100,0,1,4,1,3,0,0,0,0,0,0,0,0,0,0,0,0,0,0,0,4,1,3,0,0,0,0,0,0,0,0,0
216010,10000,100,0,1,23,13,10,0,0,0,1,1,0,2,2,0,2,1,1,0,0,0,18,9,9,0,0,0,0,0,0,0,0,0
216038,10000,100,0,1,67,31,36,0,0,0,1,1,0,3,0,3,0,0,0,1,1,0,61,29,32,1,0,1,0,0,0,0,0,0
216278,10000,100,0,1,47,24,23,0,0,0,2,1,1,2,1,1,0,0,0,0,0,0,40,21,19,2,1,1,0,0,0,1,0,1
216287,10000,100,0,1,83,33,50,3,1,2,3,1,2,6,1,5,6,4,2,0,0,0,50,21,29,5,3,2,3,1,2,7,1,6
216296,10000,100,0,1,24,15,9,0,0,0,2,2,0,3,1,2,3,1,2,0,0,0,16,11,5,0,0,0,0,0,0,0,0,0
216339,10000,100,0,1,552,231,321,0,0,0,53,22,31,115,49,66,31,11,20,1,1,0,279,120,159,10,3,7,39,15,24,24,10,14
216357,10000,100,0,1,38,19,19,0,0,0,1,0,1,0,0,0,0,0,0,0,0,0,37,19,18,0,0,0,0,0,0,0,0,0
216366,10000,100,0,1,600,254,346,1,0,1,98,50,48,98,39,59,15,2,13,0,0,0,294,126,168,70,21,49,20,14,6,4,2,2
216436,10000,100,0,1,7,7,0,0,0,0,0,0,0,1,1,0,0,0,0,0,0,0,6,6,0,0,0,0,0,0,0,0,0,0
216445,10000,100,0,1,5,2,3,0,0,0,0,0,0,0,0,0,0,0,0,0,0,0,5,2,3,0,0,0,0,0,0,0,0,0
216454,10000,100,0,1,7,3,4,0,0,0,0,0,0,0,0,0,0,0,0,0,0,0,7,3,4,0,0,0,0,0,0,0,0,0
216463,10000,100,0,1,4,2,2,0,0,0,0,0,0,0,0,0,0,0,0,0,0,0,4,2,2,0,0,0,0,0,0,0,0,0
216524,10000,100,0,1,51,21,30,0,0,0,2,0,2,3,1,2,2,1,1,0,0,0,39,16,23,2,1,1,2,1,1,1,1,0
216542,10000,100,0,1,17,8,9,0,0,0,0,0,0,1,1,0,3,3,0,0,0,0,13,4,9,0,0,0,0,0,0,0,0,0
216597,10000,100,0,1,256,94,162,1,0,1,24,11,13,41,17,24,8,3,5,0,0,0,167,53,114,4,1,3,0,0,0,11,9,2
216667,10000,100,0,1,39,17,22,1,0,1,1,0,1,4,1,3,0,0,0,0,0,0,32,16,16,0,0,0,1,0,1,0,0,0
216694,10000,100,0,1,15,7,8,0,0,0,0,0,0,2,2,0,1,0,1,0,0,0,12,5,7,0,0,0,0,0,0,0,0,0
216764,10000,100,0,1,121,64,57,0,0,0,5,5,0,28,17,11,4,4,0,0,0,0,81,36,45,1,0,1,0,0,0,2,2,0
216782,10000,100,0,1,21,7,14,0,0,0,0,0,0,4,2,2,0,0,0,0,0,0,16,5,11,1,0,1,0,0,0,0,0,0
216807,10000,100,0,1,30,18,12,0,0,0,0,0,0,0,0,0,0,0,0,0,0,0,30,18,12,0,0,0,0,0,0,0,0,0
216816,10000,100,0,1,11,3,8,0,0,0,2,0,2,1,1,0,1,1,0,0,0,0,7,1,6,0,0,0,0,0,0,0,0,0
216825,10000,100,0,1,17,9,8,0,0,0,0,0,0,0,0,0,0,0,0,0,0,0,15,9,6,1,0,1,1,0,1,0,0,0
216852,10000,100,0,1,109,38,71,0,0,0,7,3,4,21,5,16,6,4,2,0,0,0,67,21,46,0,0,0,0,0,0,8,5,3
216931,10000,100,0,1,41,16,25,1,0,1,3,0,3,3,2,1,0,0,0,0,0,0,31,13,18,1,0,1,2,1,1,0,0,0
216940,10000,100,0,1,7,3,4,0,0,0,0,0,0,0,0,0,0,0,0,0,0,0,7,3,4,0,0,0,0,0,0,0,0,0
217013,10000,100,0,1,16,4,12,0,0,0,0,0,0,1,0,1,0,0,0,0,0,0,14,3,11,0,0,0,1,1,0,0,0,0
217059,10000,100,0,1,38,16,22,0,0,0,3,2,1,2,1,1,5,3,2,0,0,0,27,9,18,0,0,0,0,0,0,1,1,0
217077,10000,100,0,1,5,0,5,0,0,0,0,0,0,0,0,0,0,0,0,0,0,0,5,0,5,0,0,0,0,0,0,0,0,0
217156,10000,100,0,1,669,268,401,1,1,0,56,25,31,66,20,46,62,24,38,0,0,0,326,118,208,22,10,12,43,21,22,93,49,44
217165,10000,100,0,1,51,16,35,0,0,0,1,0,1,7,3,4,1,0,1,0,0,0,38,12,26,1,0,1,2,1,1,1,0,1
217235,10000,100,0,1,68,30,38,0,0,0,1,1,0,8,4,4,2,2,0,0,0,0,52,22,30,1,0,1,3,1,2,1,0,1
217402,10000,100,0,1,98,43,55,0,0,0,4,2,2,11,5,6,8,2,6,0,0,0,70,31,39,2,1,1,0,0,0,3,2,1
217420,10000,100,0,1,27,14,13,0,0,0,1,0,1,7,2,5,2,1,1,0,0,0,17,11,6,0,0,0,0,0,0,0,0,0
217475,10000,100,0,1,51,11,40,0,0,0,1,0,1,5,1,4,7,1,6,0,0,0,36,9,27,2,0,2,0,0,0,0,0,0
217484,10000,100,0,1,188,77,111,2,2,0,13,6,7,10,4,6,4,1,3,0,0,0,151,60,91,1,1,0,0,0,0,7,3,4
217493,10000,100,0,1,95,29,66,1,0,1,1,0,1,14,1,13,7,4,3,0,0,0,48,19,29,2,1,1,14,2,12,8,2,6
217518,10000,100,0,1,69,32,37,1,1,0,2,0,2,6,3,3,9,4,5,0,0,0,45,22,23,2,1,1,0,0,0,4,1,3
217536,10000,100,0,1,48,15,33,0,0,0,2,2,0,2,2,0,4,1,3,0,0,0,38,10,28,0,0,0,2,0,2,0,0,0
217615,10000,100,0,1,8,3,5,0,0,0,0,0,0,1,1,0,0,0,0,0,0,0,7,2,5,0,0,0,0,0,0,0,0,0
217624,10000,100,0,1,49,28,21,0,0,0,1,0,1,44,25,19,0,0,0,0,0,0,4,3,1,0,0,0,0,0,0,0,0,0
217633,10000,100,0,1,89,39,50,0,0,0,1,0,1,8,4,4,4,2,2,0,0,0,72,31,41,0,0,0,4,2,2,0,0,0
217688,10000,100,0,1,76,34,42,2,1,1,0,0,0,12,8,4,1,0,1,1,1,0,58,23,35,2,1,1,0,0,0,0,0,0
217712,10000,100,0,1,16,4,12,0,0,0,0,0,0,4,1,3,1,0,1,0,0,0,11,3,8,0,0,0,0,0,0,0,0,0
217721,10000,100,0,1,42,23,19,0,0,0,1,1,0,38,21,17,1,0,1,0,0,0,1,1,0,1,0,1,0,0,0,0,0,0
217749,10000,100,0,1,44,22,22,0,0,0,0,0,0,0,0,0,2,1,1,0,0,0,42,21,21,0,0,0,0,0,0,0,0,0
217776,10000,100,0,1,11,8,3,0,0,0,0,0,0,1,1,0,1,1,0,0,0,0,7,5,2,2,1,1,0,0,0,0,0,0
217819,10000,100,0,1,136,64,72,0,0,0,1,0,1,21,8,13,7,6,1,1,0,1,91,41,50,5,2,3,0,0,0,10,7,3
217837,10000,100,0,1,17,4,13,0,0,0,0,0,0,8,1,7,0,0,0,0,0,0,9,3,6,0,0,0,0,0,0,0,0,0
217864,10000,100,0,1,72,39,33,0,0,0,0,0,0,5,4,1,4,0,4,0,0,0,27,15,12,1,0,1,34,19,15,1,1,0
217873,10000,100,0,1,26,12,14,0,0,0,2,2,0,20,7,13,1,1,0,0,0,0,3,2,1,0,0,0,0,0,0,0,0,0
217882,10000,100,0,1,479,230,249,0,0,0,9,4,5,0,0,0,0,0,0,0,0,0,429,202,227,0,0,0,0,0,0,41,24,17
217891,10000,100,0,1,14,6,8,0,0,0,0,0,0,14,6,8,0,0,0,0,0,0,0,0,0,0,0,0,0,0,0,0,0,0
217907,10000,100,0,1,25,12,13,0,0,0,0,0,0,5,2,3,0,0,0,0,0,0,19,10,9,1,0,1,0,0,0,0,0,0
217925,10000,100,0,1,33,16,17,0,0,0,2,0,2,1,1,0,4,2,2,2,2,0,24,11,13,0,0,0,0,0,0,0,0,0
217934,10000,100,0,1,39,8,31,0,0,0,0,0,0,20,3,17,0,0,0,0,0,0,18,5,13,1,0,1,0,0,0,0,0,0
217961,10000,100,0,1,33,10,23,0,0,0,0,0,0,3,0,3,1,0,1,0,0,0,29,10,19,0,0,0,0,0,0,0,0,0
217998,10000,100,0,1,10,5,5,0,0,0,0,0,0,1,1,0,0,0,0,0,0,0,9,4,5,0,0,0,0,0,0,0,0,0
218025,10000,100,0,1,11,3,8,0,0,0,0,0,0,6,2,4,0,0,0,0,0,0,5,1,4,0,0,0,0,0,0,0,0,0
218061,10000,100,0,1,53,27,26,0,0,0,0,0,0,19,10,9,4,2,2,0,0,0,30,15,15,0,0,0,0,0,0,0,0,0
218070,10000,100,0,1,96,31,65,1,0,1,3,1,2,18,6,12,6,0,6,0,0,0,66,23,43,1,0,1,0,0,0,1,1,0
218113,10000,100,0,1,71,20,51,1,0,1,3,1,2,14,3,11,3,1,2,0,0,0,50,15,35,0,0,0,0,0,0,0,0,0
218140,10000,100,0,1,32,10,22,0,0,0,0,0,0,4,1,3,1,0,1,0,0,0,26,9,17,0,0,0,0,0,0,1,0,1
218229,10000,100,0,1,88,38,50,0,0,0,0,0,0,15,6,9,1,1,0,0,0,0,66,29,37,3,1,2,3,1,2,0,0,0
218238,10000,100,0,1,46,24,22,0,0,0,0,0,0,15,5,10,0,0,0,0,0,0,24,14,10,0,0,0,6,4,2,1,1,0
218335,10000,100,0,1,50,22,28,0,0,0,2,2,0,5,0,5,3,2,1,0,0,0,40,18,22,0,0,0,0,0,0,0,0,0
218353,10000,100,0,1,25,11,14,0,0,0,1,0,1,10,6,4,2,1,1,0,0,0,12,4,8,0,0,0,0,0,0,0,0,0
218399,10000,100,0,1,38,18,20,0,0,0,0,0,0,38,18,20,0,0,0,0,0,0,0,0,0,0,0,0,0,0,0,0,0,0
218414,10000,100,0,1,24,15,9,0,0,0,0,0,0,9,6,3,0,0,0,0,0,0,15,9,6,0,0,0,0,0,0,0,0,0
218441,10000,100,0,1,52,34,18,0,0,0,0,0,0,2,2,0,2,1,1,0,0,0,47,31,16,0,0,0,1,0,1,0,0,0
218487,10000,100,0,1,23,8,15,0,0,0,0,0,0,10,3,7,0,0,0,0,0,0,13,5,8,0,0,0,0,0,0,0,0,0
218520,10000,100,0,1,31,11,20,0,0,0,0,0,0,9,2,7,1,0,1,0,0,0,21,9,12,0,0,0,0,0,0,0,0,0
218539,10000,100,0,1,56,28,28,0,0,0,4,2,2,10,3,7,0,0,0,0,0,0,42,23,19,0,0,0,0,0,0,0,0,0
218645,10000,100,0,1,38,12,26,0,0,0,1,0,1,9,3,6,0,0,0,0,0,0,28,9,19,0,0,0,0,0,0,0,0,0
218654,10000,100,0,1,18,8,10,0,0,0,0,0,0,3,0,3,2,2,0,0,0,0,11,6,5,1,0,1,0,0,0,1,0,1
218663,10000,100,0,1,595,257,338,1,1,0,17,7,10,130,45,85,16,7,9,2,1,1,328,145,183,22,5,17,4,0,4,75,46,29
218672,10000,100,0,1,1,0,1,0,0,0,0,0,0,1,0,1,0,0,0,0,0,0,0,0,0,0,0,0,0,0,0,0,0,0
218681,10000,100,0,1,8,1,7,0,0,0,0,0,0,4,0,4,0,0,0,0,0,0,3,1,2,1,0,1,0,0,0,0,0,0
218690,10000,100,0,1,11,4,7,0,0,0,1,0,1,2,1,1,1,0,1,0,0,0,7,3,4,0,0,0,0,0,0,0,0,0
218706,10000,100,0,1,1,0,1,0,0,0,0,0,0,0,0,0,0,0,0,0,0,0,1,0,1,0,0,0,0,0,0,0,0,0
218724,10000,100,0,1,159,95,64,0,0,0,5,5,0,21,13,8,9,5,4,0,0,0,115,69,46,5,2,3,4,1,3,0,0,0
218733,10000,100,0,1,47,28,19,0,0,0,1,1,0,39,22,17,0,0,0,0,0,0,6,5,1,1,0,1,0,0,0,0,0,0
218742,10000,100,0,1,54,19,35,1,1,0,1,0,1,16,7,9,0,0,0,0,0,0,33,10,23,2,0,2,0,0,0,1,1,0
218751,10000,100,0,1,12,5,7,0,0,0,0,0,0,0,0,0,1,0,1,0,0,0,10,4,6,1,1,0,0,0,0,0,0,0
218821,10000,100,0,1,46,19,27,0,0,0,0,0,0,17,6,11,2,1,1,0,0,0,26,11,15,1,1,0,0,0,0,0,0,0
218830,10000,100,0,1,50,16,34,0,0,0,4,2,2,7,0,7,2,0,2,0,0,0,37,14,23,0,0,0,0,0,0,0,0,0
218858,10000,100,0,1,44,18,26,0,0,0,0,0,0,19,8,11,0,0,0,0,0,0,25,10,15,0,0,0,0,0,0,0,0,0
218885,10000,100,0,1,35,15,20,0,0,0,1,0,1,5,2,3,2,1,1,0,0,0,27,12,15,0,0,0,0,0,0,0,0,0
218894,10000,100,0,1,35,13,22,0,0,0,1,0,1,11,2,9,0,0,0,0,0,0,22,10,12,1,1,0,0,0,0,0,0,0
218919,10000,100,0,1,31,13,18,0,0,0,0,0,0,30,13,17,0,0,0,0,0,0,1,0,1,0,0,0,0,0,0,0,0,0
218955,10000,100,0,1,14,4,10,0,0,0,0,0,0,6,2,4,0,0,0,0,0,0,8,2,6,0,0,0,0,0,0,0,0,0
218964,10000,100,0,1,65,31,34,0,0,0,0,0,0,12,6,6,2,1,1,0,0,0,50,23,27,1,1,0,0,0,0,0,0,0
218973,10000,100,0,1,59,30,29,0,0,0,3,1,2,12,6,6,3,1,2,0,0,0,35,18,17,1,1,0,5,3,2,0,0,0
218991,10000,100,0,1,24,11,13,0,0,0,0,0,0,5,2,3,1,0,1,0,0,0,18,9,9,0,0,0,0,0,0,0,0,0
219000,10000,100,0,1,44,17,27,0,0,0,2,2,0,5,3,2,2,1,1,0,0,0,34,10,24,1,1,0,0,0,0,0,0,0
219046,10000,100,0,1,14,8,6,1,0,1,0,0,0,0,0,0,0,0,0,0,0,0,13,8,5,0,0,0,0,0,0,0,0,0
219082,10000,100,0,1,36,25,11,0,0,0,1,1,0,0,0,0,0,0,0,0,0,0,32,23,9,2,1,1,0,0,0,1,0,1
219091,10000,100,0,1,29,14,15,0,0,0,0,0,0,0,0,0,0,0,0,0,0,0,29,14,15,0,0,0,0,0,0,0,0,0
219143,10000,100,0,1,31,15,16,0,0,0,0,0,0,1,0,1,0,0,0,0,0,0,30,15,15,0,0,0,0,0,0,0,0,0
219189,10000,100,0,1,15,5,10,1,0,1,0,0,0,0,0,0,0,0,0,0,0,0,14,5,9,0,0,0,0,0,0,0,0,0
219198,10000,100,0,1,23,11,12,0,0,0,0,0,0,0,0,0,3,1,2,0,0,0,19,9,10,0,0,0,0,0,0,1,1,0
219204,10000,100,0,1,11,2,9,0,0,0,0,0,0,0,0,0,2,1,1,0,0,0,7,1,6,2,0,2,0,0,0,0,0,0
219259,10000,100,0,1,19,5,14,0,0,0,0,0,0,1,0,1,2,0,2,0,0,0,14,5,9,0,0,0,0,0,0,2,0,2
219277,10000,100,0,1,16,5,11,12,4,8,0,0,0,0,0,0,0,0,0,0,0,0,4,1,3,0,0,0,0,0,0,0,0,0
219295,10000,100,0,1,14,9,5,0,0,0,0,0,0,0,0,0,0,0,0,1,1,0,12,7,5,1,1,0,0,0,0,0,0,0
219347,10000,100,0,1,50,33,17,0,0,0,1,1,0,1,1,0,2,0,2,0,0,0,33,21,12,0,0,0,0,0,0,13,10,3
219356,10000,100,0,1,189,96,93,5,0,5,9,5,4,8,6,2,2,1,1,0,0,0,142,72,70,2,0,2,10,3,7,11,9,2
219374,10000,100,0,1,15,5,10,14,5,9,0,0,0,0,0,0,0,0,0,0,0,0,1,0,1,0,0,0,0,0,0,0,0,0
219383,10000,100,0,1,16,14,2,0,0,0,0,0,0,1,1,0,0,0,0,0,0,0,15,13,2,0,0,0,0,0,0,0,0,0
219408,10000,100,0,1,6,3,3,5,2,3,0,0,0,0,0,0,0,0,0,0,0,0,1,1,0,0,0,0,0,0,0,0,0,0
219426,10000,100,0,1,29,9,20,0,0,0,0,0,0,0,0,0,2,1,1,0,0,0,27,8,19,0,0,0,0,0,0,0,0,0
219471,10000,100,0,1,169,72,97,3,0,3,4,2,2,11,5,6,8,5,3,0,0,0,128,51,77,4,2,2,0,0,0,11,7,4
219480,10000,100,0,1,28,10,18,0,0,0,0,0,0,0,0,0,0,0,0,0,0,0,25,8,17,2,2,0,1,0,1,0,0,0
219505,10000,100,0,1,7,3,4,0,0,0,0,0,0,5,1,4,1,1,0,0,0,0,1,1,0,0,0,0,0,0,0,0,0,0
219602,10000,100,0,1,128,53,75,0,0,0,2,0,2,33,12,21,3,2,1,0,0,0,77,31,46,4,2,2,8,5,3,1,1,0
219639,10000,100,0,1,13,3,10,0,0,0,0,0,0,6,0,6,1,0,1,0,0,0,6,3,3,0,0,0,0,0,0,0,0,0
219709,10000,100,0,1,128,47,81,1,0,1,5,1,4,31,11,20,2,2,0,0,0,0,79,30,49,2,0,2,5,2,3,3,1,2
219718,10000,100,0,1,49,26,23,0,0,0,0,0,0,5,2,3,4,3,1,0,0,0,40,21,19,0,0,0,0,0,0,0,0,0
219790,10000,100,0,1,25,11,14,0,0,0,1,0,1,1,1,0,0,0,0,0,0,0,23,10,13,0,0,0,0,0,0,0,0,0
219806,10000,100,0,1,34,16,18,0,0,0,0,0,0,1,0,1,1,1,0,0,0,0,31,15,16,1,0,1,0,0,0,0,0,0
219824,10000,100,0,1,58,22,36,1,1,0,2,0,2,5,0,5,3,3,0,0,0,0,45,17,28,2,1,1,0,0,0,0,0,0
219833,10000,100,0,1,67,26,41,0,0,0,2,1,1,28,10,18,0,0,0,0,0,0,35,14,21,0,0,0,2,1,1,0,0,0
219842,10000,100,0,1,2,0,2,0,0,0,0,0,0,0,0,0,1,0,1,0,0,0,1,0,1,0,0,0,0,0,0,0,0,0
219879,10000,100,0,1,31,13,18,0,0,0,0,0,0,2,1,1,1,0,1,0,0,0,27,11,16,0,0,0,0,0,0,1,1,0
219888,10000,100,0,1,37,10,27,1,0,1,3,1,2,2,0,2,0,0,0,0,0,0,30,9,21,0,0,0,1,0,1,0,0,0
219903,10000,100,0,1,38,7,31,0,0,0,0,0,0,21,5,16,5,1,4,0,0,0,11,0,11,0,0,0,1,1,0,0,0,0
219949,10000,100,0,1,33,17,16,0,0,0,0,0,0,3,2,1,0,0,0,0,0,0,25,12,13,0,0,0,5,3,2,0,0,0
219976,10000,100,0,1,90,44,46,0,0,0,2,1,1,3,1,2,1,0,1,0,0,0,55,24,31,0,0,0,29,18,11,0,0,0
220057,10000,100,0,1,26,11,15,0,0,0,0,0,0,4,3,1,0,0,0,0,0,0,15,4,11,0,0,0,6,4,2,1,0,1
220075,10000,100,0,1,511,181,330,3,3,0,7,4,3,28,12,16,9,1,8,0,0,0,433,145,288,7,1,6,5,2,3,19,13,6
220118,10000,100,0,1,8,0,8,0,0,0,0,0,0,1,0,1,0,0,0,0,0,0,7,0,7,0,0,0,0,0,0,0,0,0
220181,10000,100,0,1,15,7,8,0,0,0,0,0,0,9,6,3,2,0,2,0,0,0,3,0,3,0,0,0,1,1,0,0,0,0
220206,10000,100,0,1,4,3,1,0,0,0,0,0,0,0,0,0,0,0,0,0,0,0,4,3,1,0,0,0,0,0,0,0,0,0
220215,10000,100,0,1,41,20,21,0,0,0,0,0,0,4,3,1,0,0,0,0,0,0,33,16,17,0,0,0,4,1,3,0,0,0
220400,10000,100,0,1,20,12,8,0,0,0,0,0,0,7,4,3,0,0,0,0,0,0,13,8,5,0,0,0,0,0,0,0,0,0
220473,10000,100,0,1,23,6,17,0,0,0,1,0,1,0,0,0,0,0,0,0,0,0,22,6,16,0,0,0,0,0,0,0,0,0
220516,10000,100,0,1,22,9,13,0,0,0,0,0,0,1,0,1,1,1,0,0,0,0,20,8,12,0,0,0,0,0,0,0,0,0
220552,10000,100,0,1,157,53,104,1,1,0,4,0,4,32,13,19,4,1,3,1,0,1,107,35,72,8,3,5,0,0,0,0,0,0
220598,10000,100,0,1,42,21,21,0,0,0,1,1,0,28,14,14,3,1,2,0,0,0,8,4,4,2,1,1,0,0,0,0,0,0
220604,10000,100,0,1,33,12,21,0,0,0,0,0,0,30,12,18,0,0,0,0,0,0,3,0,3,0,0,0,0,0,0,0,0,0
220613,10000,100,0,1,54,22,32,0,0,0,2,0,2,2,0,2,5,3,2,0,0,0,40,17,23,0,0,0,5,2,3,0,0,0
220631,10000,100,0,1,213,91,122,0,0,0,1,1,0,5,5,0,5,3,2,0,0,0,190,78,112,2,0,2,10,4,6,0,0,0
220710,10000,100,0,1,40,20,20,0,0,0,0,0,0,3,2,1,1,1,0,0,0,0,33,17,16,1,0,1,2,0,2,0,0,0
220792,10000,100,0,1,161,53,108,0,0,0,6,4,2,121,31,90,11,3,8,0,0,0,23,15,8,0,0,0,0,0,0,0,0,0
220862,10000,100,0,1,289,125,164,0,0,0,18,10,8,96,31,65,11,6,5,0,0,0,149,73,76,6,1,5,7,2,5,2,2,0
220978,10000,100,0,1,194,89,105,0,0,0,4,2,2,24,11,13,6,3,3,0,0,0,145,63,82,5,3,2,1,1,0,9,6,3
220996,10000,100,0,1,9,2,7,0,0,0,0,0,0,3,0,3,1,0,1,0,0,0,5,2,3,0,0,0,0,0,0,0,0,0
221096,10000,100,0,1,32,14,18,0,0,0,1,1,0,4,0,4,1,1,0,0,0,0,26,12,14,0,0,0,0,0,0,0,0,0
221148,10000,100,0,1,48,33,15,0,0,0,0,0,0,3,0,3,0,0,0,0,0,0,45,33,12,0,0,0,0,0,0,0,0,0
221184,10000,100,0,1,54,16,38,0,0,0,0,0,0,12,3,9,2,0,2,0,0,0,32,11,21,1,0,1,4,2,2,3,0,3
221351,10000,100,0,1,76,33,43,0,0,0,2,2,0,23,7,16,6,1,5,0,0,0,29,14,15,3,3,0,9,3,6,4,3,1
221397,10000,100,0,1,43,19,24,0,0,0,0,0,0,0,0,0,0,0,0,0,0,0,42,19,23,0,0,0,1,0,1,0,0,0
221485,10000,100,0,1,57,17,40,0,0,0,0,0,0,34,6,28,3,1,2,0,0,0,19,10,9,1,0,1,0,0,0,0,0,0
221519,10000,100,0,1,111,54,57,0,0,0,4,2,2,6,2,4,3,2,1,0,0,0,89,42,47,1,0,1,6,5,1,2,1,1
221643,10000,100,0,1,21,15,6,0,0,0,0,0,0,5,3,2,2,1,1,0,0,0,11,10,1,2,0,2,1,1,0,0,0,0
221661,10000,100,0,1,30,16,14,0,0,0,4,2,2,4,2,2,4,3,1,0,0,0,16,7,9,1,1,0,1,1,0,0,0,0
221670,10000,100,0,1,9,3,6,0,0,0,1,0,1,1,0,1,0,0,0,0,0,0,7,3,4,0,0,0,0,0,0,0,0,0
221731,10000,100,0,1,15,4,11,0,0,0,0,0,0,0,0,0,0,0,0,0,0,0,14,4,10,0,0,0,1,0,1,0,0,0
221740,10000,100,0,1,162,67,95,2,0,2,6,2,4,27,4,23,3,2,1,0,0,0,110,52,58,3,1,2,1,1,0,10,5,5
221759,10000,100,0,1,861,399,462,1,0,1,22,14,8,105,53,52,31,10,21,0,0,0,623,271,352,14,6,8,1,1,0,64,44,20
221768,10000,100,0,1,102,40,62,0,0,0,0,0,0,17,9,8,1,0,1,0,0,0,83,31,52,0,0,0,0,0,0,1,0,1
221838,10000,100,0,1,156,73,83,0,0,0,4,3,1,84,37,47,7,1,6,0,0,0,53,29,24,3,1,2,1,0,1,4,2,2
221847,10000,100,0,1,122,51,71,0,0,0,2,2,0,6,5,1,9,3,6,0,0,0,89,31,58,3,1,2,4,2,2,9,7,2
221892,10000,100,0,1,53,25,28,0,0,0,1,1,0,5,3,2,1,1,0,0,0,0,44,19,25,2,1,1,0,0,0,0,0,0
221908,10000,100,0,1,24,11,13,0,0,0,0,0,0,1,1,0,0,0,0,0,0,0,22,10,12,1,0,1,0,0,0,0,0,0
221953,10000,100,0,1,46,21,25,0,0,0,1,1,0,2,2,0,0,0,0,0,0,0,39,14,25,0,0,0,2,2,0,2,2,0
221971,10000,100,0,1,52,28,24,0,0,0,0,0,0,5,3,2,0,0,0,0,0,0,43,23,20,0,0,0,4,2,2,0,0,0
221999,10000,100,0,1,891,402,489,2,1,1,25,10,15,187,82,105,35,12,23,1,0,1,415,188,227,20,7,13,124,52,72,82,50,32
222053,10000,100,0,1,37,21,16,0,0,0,0,0,0,4,3,1,1,1,0,0,0,0,30,16,14,0,0,0,2,1,1,0,0,0
222062,10000,100,0,1,26,14,12,0,0,0,0,0,0,0,0,0,0,0,0,0,0,0,24,12,12,0,0,0,2,2,0,0,0,0
222105,10000,100,0,1,7,7,0,0,0,0,0,0,0,3,3,0,0,0,0,0,0,0,4,4,0,0,0,0,0,0,0,0,0,0
222178,10000,100,0,1,88,49,39,0,0,0,5,3,2,12,6,6,5,2,3,0,0,0,54,30,24,1,0,1,11,8,3,0,0,0
222497,10000,100,0,1,67,23,44,0,0,0,0,0,0,9,2,7,37,13,24,0,0,0,19,7,12,2,1,1,0,0,0,0,0,0
222567,10000,100,0,1,27,15,12,0,0,0,0,0,0,2,2,0,4,3,1,0,0,0,17,8,9,0,0,0,4,2,2,0,0,0
222576,10000,100,0,1,57,29,28,1,1,0,1,0,1,4,0,4,12,4,8,0,0,0,35,22,13,0,0,0,4,2,2,0,0,0
222628,10000,100,0,1,1,0,1,0,0,0,0,0,0,0,0,0,0,0,0,0,0,0,1,0,1,0,0,0,0,0,0,0,0,0
222822,10000,100,0,1,37,14,23,0,0,0,1,0,1,6,5,1,8,1,7,0,0,0,22,8,14,0,0,0,0,0,0,0,0,0
222831,10000,100,0,1,90,32,58,1,1,0,4,0,4,5,3,2,22,7,15,0,0,0,56,20,36,0,0,0,2,1,1,0,0,0
222877,10000,100,0,1,8,6,2,1,0,1,0,0,0,1,0,1,0,0,0,0,0,0,6,6,0,0,0,0,0,0,0,0,0,0
222938,10000,100,0,1,13,5,8,0,0,0,0,0,0,6,2,4,4,2,2,0,0,0,3,1,2,0,0,0,0,0,0,0,0,0
222983,10000,100,0,1,36,18,18,0,0,0,1,1,0,5,2,3,3,2,1,0,0,0,22,10,12,1,0,1,3,3,0,1,0,1
222992,10000,100,0,1,109,46,63,0,0,0,9,2,7,17,8,9,28,14,14,0,0,0,49,21,28,0,0,0,6,1,5,0,0,0
223001,10000,100,0,1,2,1,1,0,0,0,0,0,0,0,0,0,0,0,0,0,0,0,2,1,1,0,0,0,0,0,0,0,0,0
223083,10000,100,0,1,7,1,6,0,0,0,1,0,1,1,0,1,1,1,0,0,0,0,4,0,4,0,0,0,0,0,0,0,0,0
223223,10000,100,0,1,1449,393,1056,3,1,2,294,108,186,278,36,242,242,53,189,5,3,2,393,111,282,48,12,36,186,69,117,0,0,0
223232,10000,100,0,1,297,112,185,2,0,2,10,5,5,28,8,20,31,7,24,1,1,0,189,73,116,11,4,7,19,10,9,6,4,2
223320,10000,100,0,1,28,13,15,0,0,0,0,0,0,2,2,0,12,6,6,0,0,0,12,5,7,0,0,0,2,0,2,0,0,0
223427,10000,100,0,1,36,14,22,0,0,0,0,0,0,8,2,6,3,1,2,0,0,0,25,11,14,0,0,0,0,0,0,0,0,0
223463,10000,100,0,1,9,1,8,0,0,0,0,0,0,6,1,5,2,0,2,0,0,0,1,0,1,0,0,0,0,0,0,0,0,0
223506,10000,100,0,1,22,12,10,0,0,0,0,0,0,2,1,1,5,2,3,0,0,0,14,8,6,1,1,0,0,0,0,0,0,0
223816,10000,100,0,1,52,22,30,0,0,0,2,0,2,9,7,2,10,1,9,4,1,3,25,13,12,2,0,2,0,0,0,0,0,0
223898,10000,100,0,1,24,11,13,0,0,0,0,0,0,1,1,0,7,4,3,0,0,0,14,6,8,0,0,0,2,0,2,0,0,0
223922,10000,100,0,1,9,5,4,0,0,0,0,0,0,0,0,0,0,0,0,0,0,0,9,5,4,0,0,0,0,0,0,0,0,0
224004,10000,100,0,1,21,6,15,0,0,0,1,0,1,3,0,3,2,1,1,0,0,0,15,5,10,0,0,0,0,0,0,0,0,0
224110,10000,100,0,1,23,9,14,1,0,1,0,0,0,2,0,2,2,0,2,0,0,0,15,7,8,2,1,1,1,1,0,0,0,0
224147,10000,100,0,1,126,57,69,0,0,0,7,2,5,8,4,4,42,17,25,1,0,1,51,25,26,3,1,2,2,1,1,12,7,5
224226,10000,100,0,1,56,30,26,0,0,0,2,1,1,3,1,2,2,1,1,0,0,0,49,27,22,0,0,0,0,0,0,0,0,0
224244,10000,100,0,1,3,2,1,0,0,0,0,0,0,0,0,0,0,0,0,0,0,0,3,2,1,0,0,0,0,0,0,0,0,0
224305,10000,100,0,1,47,22,25,0,0,0,4,4,0,9,4,5,3,1,2,0,0,0,31,13,18,0,0,0,0,0,0,0,0,0
224323,10000,100,0,1,42,21,21,0,0,0,3,1,2,2,1,1,9,5,4,0,0,0,26,14,12,1,0,1,1,0,1,0,0,0
224350,10000,100,0,1,36,17,19,0,0,0,1,1,0,3,1,2,15,6,9,0,0,0,17,9,8,0,0,0,0,0,0,0,0,0
224527,10000,100,0,1,54,25,29,1,0,1,1,1,0,1,0,1,4,3,1,1,0,1,41,17,24,1,1,0,4,3,1,0,0,0
224545,10000,100,0,1,15,7,8,0,0,0,1,1,0,1,0,1,0,0,0,0,0,0,10,4,6,0,0,0,1,0,1,2,2,0
224554,10000,100,0,1,99,35,64,1,0,1,7,3,4,10,3,7,12,3,9,1,0,1,59,23,36,1,0,1,1,0,1,7,3,4
224615,10000,100,0,1,278,112,166,1,1,0,13,3,10,119,37,82,52,29,23,0,0,0,76,34,42,2,1,1,15,7,8,0,0,0
224642,10000,100,0,1,61,25,36,0,0,0,0,0,0,0,0,0,47,20,27,0,0,0,11,3,8,0,0,0,0,0,0,3,2,1
224660,10000,100,0,1,21,13,8,0,0,0,0,0,0,0,0,0,13,9,4,0,0,0,6,3,3,1,0,1,1,1,0,0,0,0
224679,10000,100,0,1,27,21,6,0,0,0,0,0,0,0,0,0,25,21,4,0,0,0,1,0,1,1,0,1,0,0,0,0,0,0
224712,10000,100,0,1,5,1,4,0,0,0,1,0,1,2,1,1,1,0,1,0,0,0,1,0,1,0,0,0,0,0,0,0,0,0
224776,10000,100,0,1,4,0,4,0,0,0,0,0,0,1,0,1,1,0,1,0,0,0,1,0,1,1,0,1,0,0,0,0,0,0
224891,10000,100,0,1,25,9,16,0,0,0,0,0,0,3,1,2,5,1,4,0,0,0,17,7,10,0,0,0,0,0,0,0,0,0
224961,10000,100,0,1,21,9,12,0,0,0,1,1,0,1,0,1,10,6,4,0,0,0,9,2,7,0,0,0,0,0,0,0,0,0
225070,10000,100,0,1,46,20,26,1,1,0,1,0,1,2,0,2,2,0,2,0,0,0,39,18,21,0,0,0,1,1,0,0,0,0
225201,10000,100,0,1,27,12,15,0,0,0,1,1,0,4,4,0,14,4,10,0,0,0,8,3,5,0,0,0,0,0,0,0,0,0
225247,10000,100,0,1,36,15,21,0,0,0,0,0,0,0,0,0,5,2,3,0,0,0,28,11,17,2,1,1,0,0,0,1,1,0
225308,10000,100,0,1,30,9,21,1,1,0,0,0,0,4,2,2,1,0,1,0,0,0,23,5,18,1,1,0,0,0,0,0,0,0
225371,10000,100,0,1,19,8,11,0,0,0,1,1,0,0,0,0,1,0,1,0,0,0,17,7,10,0,0,0,0,0,0,0,0,0
225399,10000,100,0,1,94,40,54,0,0,0,1,1,0,20,5,15,19,10,9,0,0,0,50,23,27,1,0,1,0,0,0,3,1,2
225414,10000,100,0,1,32,7,25,0,0,0,4,1,3,4,1,3,8,1,7,0,0,0,14,4,10,0,0,0,0,0,0,2,0,2
225423,10000,100,0,1,93,35,58,0,0,0,11,2,9,37,12,25,17,6,11,0,0,0,22,13,9,3,1,2,3,1,2,0,0,0
225432,10000,100,0,1,61,32,29,0,0,0,2,1,1,19,10,9,14,7,7,0,0,0,17,11,6,2,0,2,1,1,0,6,2,4
225502,10000,100,0,1,26,9,17,0,0,0,1,0,1,3,0,3,9,3,6,0,0,0,13,6,7,0,0,0,0,0,0,0,0,0
225511,10000,100,0,1,468,230,238,0,0,0,52,23,29,105,39,66,98,40,58,2,1,1,131,75,56,5,1,4,9,3,6,66,48,18
225520,10000,100,0,1,25,12,13,0,0,0,1,1,0,3,2,1,5,1,4,0,0,0,16,8,8,0,0,0,0,0,0,0,0,0
225548,10000,100,0,1,41,20,21,0,0,0,0,0,0,1,0,1,11,4,7,0,0,0,29,16,13,0,0,0,0,0,0,0,0,0
225575,10000,100,0,1,17,4,13,0,0,0,0,0,0,14,4,10,1,0,1,0,0,0,0,0,0,0,0,0,2,0,2,0,0,0
225627,10000,100,0,1,218,103,115,0,0,0,15,8,7,14,5,9,97,42,55,0,0,0,78,42,36,8,3,5,1,0,1,5,3,2
225876,10000,100,0,1,17,8,9,0,0,0,0,0,0,0,0,0,4,0,4,0,0,0,13,8,5,0,0,0,0,0,0,0,0,0
225885,10000,100,0,1,27,9,18,0,0,0,0,0,0,17,5,12,4,2,2,0,0,0,6,2,4,0,0,0,0,0,0,0,0,0
226019,10000,100,0,1,32,11,21,0,0,0,0,0,0,1,0,1,1,1,0,0,0,0,30,10,20,0,0,0,0,0,0,0,0,0
226091,10000,100,0,1,154,71,83,1,1,0,5,3,2,38,15,23,11,6,5,0,0,0,83,32,51,3,1,2,9,9,0,4,4,0
226116,10000,100,0,1,42,12,30,1,0,1,0,0,0,14,2,12,8,3,5,0,0,0,19,7,12,0,0,0,0,0,0,0,0,0
226134,10000,100,0,1,31,14,17,0,0,0,1,1,0,0,0,0,30,13,17,0,0,0,0,0,0,0,0,0,0,0,0,0,0,0
226152,10000,100,0,1,98,47,51,0,0,0,4,1,3,2,1,1,65,29,36,0,0,0,18,13,5,1,0,1,3,2,1,5,1,4
226204,10000,100,0,1,56,22,34,0,0,0,1,1,0,13,7,6,16,4,12,0,0,0,25,10,15,0,0,0,1,0,1,0,0,0
226231,10000,100,0,1,46,27,19,0,0,0,1,0,1,0,0,0,0,0,0,0,0,0,44,26,18,0,0,0,1,1,0,0,0,0
226277,10000,100,0,1,63,39,24,0,0,0,1,1,0,3,2,1,17,9,8,0,0,0,39,25,14,2,1,1,1,1,0,0,0,0
226383,10000,100,0,1,37,14,23,0,0,0,0,0,0,1,0,1,7,4,3,0,0,0,27,9,18,0,0,0,2,1,1,0,0,0
226408,10000,100,0,1,17,7,10,0,0,0,0,0,0,4,3,1,4,2,2,0,0,0,6,2,4,3,0,3,0,0,0,0,0,0
226471,10000,100,0,1,67,29,38,1,0,1,2,1,1,6,1,5,9,6,3,0,0,0,45,20,25,2,0,2,2,1,1,0,0,0
226578,10000,100,0,1,45,14,31,1,0,1,1,0,1,4,2,2,13,3,10,0,0,0,26,9,17,0,0,0,0,0,0,0,0,0
226587,10000,100,0,1,39,17,22,0,0,0,1,1,0,5,2,3,6,2,4,1,0,1,25,11,14,1,1,0,0,0,0,0,0,0
226806,10000,100,0,1,56,14,42,0,0,0,2,1,1,4,1,3,21,4,17,0,0,0,26,8,18,0,0,0,2,0,2,1,0,1
226833,10000,100,0,1,88,35,53,0,0,0,0,0,0,11,6,5,9,2,7,1,0,1,54,22,32,5,2,3,1,1,0,7,2,5
226879,10000,100,0,1,2,0,2,0,0,0,0,0,0,0,0,0,0,0,0,0,0,0,2,0,2,0,0,0,0,0,0,0,0,0
226903,10000,100,0,1,160,64,96,0,0,0,3,1,2,9,2,7,92,33,59,0,0,0,46,24,22,6,3,3,4,1,3,0,0,0
227146,10000,100,0,1,27,11,16,0,0,0,0,0,0,3,1,2,5,3,2,0,0,0,19,7,12,0,0,0,0,0,0,0,0,0
227182,10000,100,0,1,141,63,78,0,0,0,5,2,3,36,14,22,37,21,16,1,0,1,55,25,30,5,1,4,2,0,2,0,0,0
227216,10000,100,0,1,567,250,317,1,1,0,45,27,18,69,33,36,98,33,65,1,0,1,298,125,173,20,9,11,28,17,11,7,5,2
227225,10000,100,0,1,26,9,17,1,0,1,0,0,0,1,1,0,3,0,3,0,0,0,21,8,13,0,0,0,0,0,0,0,0,0
227304,10000,100,0,1,36,14,22,0,0,0,1,1,0,7,1,6,11,4,7,1,1,0,16,7,9,0,0,0,0,0,0,0,0,0
227331,10000,100,0,1,44,14,30,1,0,1,1,0,1,6,3,3,26,7,19,0,0,0,10,4,6,0,0,0,0,0,0,0,0,0
227368,10000,100,0,1,573,268,305,0,0,0,48,22,26,16,9,7,317,122,195,0,0,0,128,70,58,3,2,1,8,5,3,53,38,15
227377,10000,100,0,1,22,9,13,0,0,0,0,0,0,0,0,0,17,5,12,0,0,0,1,1,0,0,0,0,1,0,1,3,3,0
227386,10000,100,0,1,18,7,11,1,0,1,0,0,0,1,0,1,0,0,0,0,0,0,16,7,9,0,0,0,0,0,0,0,0,0
227401,10000,100,0,1,30,16,14,0,0,0,0,0,0,4,2,2,6,4,2,0,0,0,20,10,10,0,0,0,0,0,0,0,0,0
227429,10000,100,0,1,1,0,1,0,0,0,0,0,0,1,0,1,0,0,0,0,0,0,0,0,0,0,0,0,0,0,0,0,0,0
227526,10000,100,0,1,116,48,68,0,0,0,4,2,2,65,23,42,16,8,8,0,0,0,20,12,8,4,0,4,2,0,2,5,3,2
227687,10000,100,0,1,23,16,7,0,0,0,2,2,0,3,2,1,2,1,1,0,0,0,16,11,5,0,0,0,0,0,0,0,0,0
227757,10000,100,0,1,435,225,210,1,0,1,34,15,19,61,23,38,85,34,51,1,1,0,149,78,71,5,1,4,17,11,6,82,62,20
227845,10000,100,0,1,96,39,57,0,0,0,6,2,4,6,1,5,31,12,19,0,0,0,50,22,28,1,0,1,1,1,0,1,1,0
227854,10000,100,0,1,41,17,24,0,0,0,3,1,2,9,3,6,19,8,11,0,0,0,9,4,5,1,1,0,0,0,0,0,0,0
227863,10000,100,0,1,91,36,55,0,0,0,5,0,5,24,9,15,31,16,15,0,0,0,28,10,18,0,0,0,0,0,0,3,1,2
227881,10000,100,0,1,379,166,213,2,0,2,12,6,6,47,22,25,56,22,34,0,0,0,241,103,138,3,2,1,0,0,0,18,11,7
227924,10000,100,0,1,40,22,18,1,1,0,1,0,1,2,0,2,26,14,12,0,0,0,10,7,3,0,0,0,0,0,0,0,0,0
227979,10000,100,0,1,136,46,90,0,0,0,6,4,2,40,12,28,41,14,27,0,0,0,44,15,29,1,1,0,0,0,0,4,0,4
228042,10000,100,0,1,31,18,13,0,0,0,0,0,0,2,1,1,6,4,2,0,0,0,23,13,10,0,0,0,0,0,0,0,0,0
228149,10000,100,0,1,82,42,40,1,0,1,1,0,1,4,1,3,46,22,24,0,0,0,24,14,10,1,1,0,3,3,0,2,1,1
228158,10000,100,0,1,49,16,33,0,0,0,2,1,1,0,0,0,18,4,14,0,0,0,29,11,18,0,0,0,0,0,0,0,0,0
228194,10000,100,0,1,21,7,14,0,0,0,0,0,0,6,3,3,3,2,1,0,0,0,11,2,9,0,0,0,1,0,1,0,0,0
228246,10000,100,0,1,249,115,134,1,1,0,27,14,13,45,19,26,28,11,17,1,0,1,125,60,65,5,0,5,0,0,0,17,10,7
228316,10000,100,0,1,34,15,19,0,0,0,0,0,0,0,0,0,27,11,16,0,0,0,5,3,2,0,0,0,1,1,0,1,0,1
228325,10000,100,0,1,37,20,17,3,2,1,1,1,0,1,0,1,5,3,2,0,0,0,26,14,12,1,0,1,0,0,0,0,0,0
228343,10000,100,0,1,50,19,31,0,0,0,3,0,3,3,2,1,17,4,13,0,0,0,26,12,14,1,1,0,0,0,0,0,0,0
228431,10000,100,0,1,97,43,54,1,1,0,0,0,0,13,7,6,12,4,8,0,0,0,65,28,37,5,2,3,0,0,0,1,1,0
228459,10000,100,0,1,314,136,178,1,1,0,18,10,8,17,9,8,79,30,49,0,0,0,146,58,88,9,4,5,42,23,19,2,1,1
228468,10000,100,0,1,19,9,10,0,0,0,0,0,0,0,0,0,6,1,5,1,1,0,11,7,4,0,0,0,1,0,1,0,0,0
228501,10000,100,0,1,74,32,42,0,0,0,1,1,0,2,1,1,29,14,15,0,0,0,38,13,25,1,1,0,2,2,0,1,0,1
228529,10000,100,0,1,150,69,81,1,1,0,3,0,3,12,5,7,17,8,9,0,0,0,109,49,60,2,2,0,1,0,1,5,4,1
228547,10000,100,0,1,114,45,69,0,0,0,6,3,3,26,9,17,29,8,21,1,0,1,49,24,25,0,0,0,3,1,2,0,0,0
228608,10000,100,0,1,22,8,14,1,1,0,2,1,1,1,1,0,4,0,4,0,0,0,14,5,9,0,0,0,0,0,0,0,0,0
228635,10000,100,0,1,974,391,583,4,1,3,226,98,128,147,40,107,139,55,84,2,1,1,342,149,193,36,12,24,5,1,4,73,34,39
228644,10000,100,0,1,1095,299,796,6,3,3,69,27,42,44,16,28,433,94,339,0,0,0,224,75,149,6,4,2,308,78,230,5,2,3
228653,10000,100,0,1,196,99,97,0,0,0,20,12,8,28,14,14,37,17,20,0,0,0,100,51,49,0,0,0,2,1,1,9,4,5
228699,10000,100,0,1,14,3,11,0,0,0,0,0,0,4,1,3,1,0,1,0,0,0,9,2,7,0,0,0,0,0,0,0,0,0
228705,10000,100,0,1,72,38,34,0,0,0,2,2,0,1,0,1,33,16,17,0,0,0,25,14,11,0,0,0,4,3,1,7,3,4
228723,10000,100,0,1,1088,488,600,3,3,0,128,67,61,99,33,66,205,83,122,0,0,0,566,254,312,20,10,10,49,31,18,18,7,11
228732,10000,100,0,1,13,5,8,0,0,0,1,1,0,3,0,3,1,0,1,0,0,0,8,4,4,0,0,0,0,0,0,0,0,0
228769,10000,100,0,1,368,154,214,0,0,0,40,22,18,42,9,33,50,21,29,2,0,2,116,48,68,18,8,10,90,39,51,10,7,3
228778,10000,100,0,1,1460,629,831,3,3,0,85,29,56,105,50,55,315,119,196,0,0,0,794,342,452,40,12,28,1,0,1,117,74,43
228787,10000,100,0,1,287,129,158,3,2,1,46,27,19,33,11,22,17,7,10,0,0,0,121,52,69,20,6,14,46,23,23,1,1,0
228796,10000,100,0,1,367,172,195,0,0,0,33,17,16,10,9,1,237,90,147,2,2,0,57,37,20,5,1,4,7,5,2,16,11,5
228802,10000,100,0,1,511,181,330,0,0,0,52,26,26,83,18,65,48,17,31,1,0,1,299,107,192,2,1,1,12,5,7,14,7,7
228866,10000,100,0,1,11,1,10,0,0,0,0,0,0,0,0,0,4,0,4,0,0,0,7,1,6,0,0,0,0,0,0,0,0,0
228875,10000,100,0,1,237,92,145,1,0,1,9,3,6,33,9,24,67,27,40,0,0,0,105,44,61,5,0,5,14,8,6,3,1,2
228884,10000,100,0,1,14,8,6,0,0,0,0,0,0,14,8,6,0,0,0,0,0,0,0,0,0,0,0,0,0,0,0,0,0,0
228909,10000,100,0,1,206,44,162,1,0,1,18,5,13,23,7,16,55,9,46,2,0,2,84,18,66,5,1,4,13,3,10,5,1,4
228981,10000,100,0,1,33,15,18,0,0,0,0,0,0,3,2,1,13,6,7,0,0,0,17,7,10,0,0,0,0,0,0,0,0,0
229018,10000,100,0,1,33,16,17,1,1,0,1,1,0,4,0,4,4,1,3,0,0,0,21,11,10,0,0,0,1,1,0,1,1,0
229027,10000,100,0,1,344,167,177,1,0,1,16,9,7,20,12,8,126,55,71,0,0,0,85,40,45,4,1,3,64,32,32,28,18,10
229063,10000,100,0,1,117,49,68,1,0,1,6,3,3,86,37,49,9,4,5,0,0,0,14,5,9,0,0,0,0,0,0,1,0,1
229090,10000,100,0,1,44,21,23,0,0,0,5,5,0,2,1,1,16,3,13,0,0,0,20,11,9,1,1,0,0,0,0,0,0,0
229115,10000,100,0,1,431,200,231,3,0,3,11,6,5,29,15,14,97,43,54,2,0,2,239,108,131,7,1,6,0,0,0,43,27,16
229160,10000,100,0,1,40,14,26,0,0,0,0,0,0,9,2,7,6,3,3,0,0,0,23,8,15,0,0,0,2,1,1,0,0,0
229179,10000,100,0,1,118,37,81,0,0,0,9,1,8,26,4,22,20,5,15,2,2,0,49,18,31,3,2,1,9,5,4,0,0,0
229267,10000,100,0,1,72,27,45,0,0,0,1,0,1,9,5,4,32,9,23,0,0,0,30,13,17,0,0,0,0,0,0,0,0,0
229300,10000,100,0,1,1281,355,926,3,2,1,163,74,89,263,31,232,396,73,323,3,2,1,250,94,156,31,7,24,52,16,36,120,56,64
229337,10000,100,0,1,260,84,176,2,0,2,31,17,14,20,7,13,77,15,62,0,0,0,130,45,85,0,0,0,0,0,0,0,0,0
229355,10000,100,0,1,83,28,55,0,0,0,0,0,0,10,4,6,6,2,4,0,0,0,66,21,45,1,1,0,0,0,0,0,0,0
229407,10000,100,0,1,2,0,2,0,0,0,0,0,0,1,0,1,1,0,1,0,0,0,0,0,0,0,0,0,0,0,0,0,0,0
229504,10000,100,0,1,28,12,16,0,0,0,0,0,0,3,1,2,4,2,2,0,0,0,18,8,10,2,1,1,1,0,1,0,0,0
229540,10000,100,0,1,27,14,13,0,0,0,0,0,0,2,0,2,11,7,4,0,0,0,13,7,6,0,0,0,1,0,1,0,0,0
229780,10000,100,0,1,19,7,12,0,0,0,0,0,0,3,1,2,3,1,2,1,0,1,11,4,7,1,1,0,0,0,0,0,0,0
229799,10000,100,0,1,26,8,18,0,0,0,2,1,1,2,1,1,0,0,0,0,0,0,14,3,11,0,0,0,8,3,5,0,0,0
229814,10000,100,0,1,95,38,57,1,1,0,3,2,1,4,2,2,13,4,9,0,0,0,62,21,41,1,1,0,0,0,0,11,7,4
229832,10000,100,0,1,10,6,4,0,0,0,0,0,0,0,0,0,3,1,2,0,0,0,7,5,2,0,0,0,0,0,0,0,0,0
229841,10000,100,0,1,25,6,19,0,0,0,0,0,0,5,0,5,4,2,2,0,0,0,14,3,11,0,0,0,2,1,1,0,0,0
229887,10000,100,0,1,38,22,16,0,0,0,0,0,0,27,16,11,7,5,2,0,0,0,4,1,3,0,0,0,0,0,0,0,0,0
230038,10000,100,0,1,274,159,115,0,0,0,4,3,1,1,0,1,18,11,7,7,5,2,221,127,94,7,3,4,11,8,3,5,2,3
230047,10000,100,0,1,33,18,15,0,0,0,1,1,0,0,0,0,2,0,2,17,11,6,11,4,7,1,1,0,0,0,0,1,1,0
230171,10000,100,0,1,115,59,56,3,1,2,4,2,2,3,2,1,5,2,3,4,2,2,93,47,46,0,0,0,2,2,0,1,1,0
230366,10000,100,0,1,14,3,11,0,0,0,0,0,0,0,0,0,3,0,3,0,0,0,10,3,7,0,0,0,1,0,1,0,0,0
230418,10000,100,0,1,12,6,6,0,0,0,0,0,0,1,1,0,0,0,0,0,0,0,11,5,6,0,0,0,0,0,0,0,0,0
230597,10000,100,0,1,29,17,12,0,0,0,0,0,0,1,0,1,0,0,0,1,0,1,27,17,10,0,0,0,0,0,0,0,0,0
230603,10000,100,0,1,157,103,54,0,0,0,1,1,0,6,5,1,12,6,6,1,1,0,134,88,46,2,1,1,0,0,0,1,1,0
230728,10000,100,0,1,443,207,236,7,2,5,18,9,9,12,11,1,34,14,20,2,2,0,348,159,189,10,4,6,10,6,4,2,0,2
230737,10000,100,0,1,314,150,164,1,1,0,11,4,7,7,4,3,24,9,15,2,0,2,233,112,121,8,3,5,18,11,7,10,6,4
230746,10000,100,0,1,151,72,79,3,1,2,8,1,7,6,3,3,27,12,15,2,1,1,101,53,48,4,1,3,0,0,0,0,0,0
230764,10000,100,0,1,1926,809,1117,19,12,7,113,42,71,48,17,31,230,64,166,13,8,5,1170,496,674,54,22,32,131,64,67,148,84,64
230782,10000,100,0,1,160,71,89,0,0,0,3,1,2,1,1,0,15,5,10,1,1,0,127,58,69,6,1,5,2,1,1,5,3,2
230807,10000,100,0,1,41,16,25,0,0,0,3,1,2,0,0,0,10,7,3,0,0,0,27,8,19,0,0,0,1,0,1,0,0,0
230816,10000,100,0,1,27,7,20,2,0,2,2,0,2,1,1,0,6,2,4,0,0,0,16,4,12,0,0,0,0,0,0,0,0,0
230834,10000,100,0,1,15,4,11,0,0,0,0,0,0,0,0,0,0,0,0,0,0,0,10,2,8,0,0,0,5,2,3,0,0,0
230852,10000,100,0,1,39,18,21,0,0,0,1,1,0,0,0,0,0,0,0,0,0,0,27,12,15,1,0,1,10,5,5,0,0,0
230861,10000,100,0,1,12,5,7,0,0,0,1,0,1,1,1,0,0,0,0,0,0,0,10,4,6,0,0,0,0,0,0,0,0,0
230889,10000,100,0,1,7,1,6,0,0,0,0,0,0,0,0,0,1,0,1,0,0,0,5,0,5,1,1,0,0,0,0,0,0,0
230913,10000,100,0,1,27,16,11,0,0,0,1,1,0,3,3,0,0,0,0,0,0,0,19,10,9,0,0,0,4,2,2,0,0,0
230959,10000,100,0,1,100,41,59,0,0,0,2,0,2,3,2,1,2,0,2,0,0,0,59,22,37,1,0,1,30,17,13,3,0,3
230995,10000,100,0,1,113,53,60,0,0,0,1,1,0,1,1,0,4,1,3,0,0,0,94,43,51,0,0,0,12,7,5,1,0,1
231059,10000,100,0,1,37,17,20,0,0,0,3,1,2,1,1,0,1,0,1,0,0,0,21,9,12,1,0,1,8,5,3,2,1,1
231068,10000,100,0,1,8,2,6,0,0,0,0,0,0,1,0,1,0,0,0,0,0,0,7,2,5,0,0,0,0,0,0,0,0,0
231095,10000,100,0,1,1,0,1,0,0,0,0,0,0,0,0,0,0,0,0,0,0,0,1,0,1,0,0,0,0,0,0,0,0,0
231147,10000,100,0,1,21,8,13,0,0,0,0,0,0,1,0,1,0,0,0,0,0,0,18,7,11,1,1,0,1,0,1,0,0,0
231156,10000,100,0,1,2,1,1,0,0,0,0,0,0,0,0,0,0,0,0,0,0,0,2,1,1,0,0,0,0,0,0,0,0,0
231165,10000,100,0,1,17,9,8,0,0,0,0,0,0,0,0,0,0,0,0,0,0,0,16,8,8,0,0,0,1,1,0,0,0,0
231174,10000,100,0,1,345,141,204,0,0,0,17,6,11,14,7,7,16,4,12,0,0,0,244,103,141,6,1,5,25,9,16,23,11,12
231411,10000,100,0,1,3,2,1,0,0,0,0,0,0,1,0,1,0,0,0,0,0,0,2,2,0,0,0,0,0,0,0,0,0,0
231420,10000,100,0,1,42,21,21,0,0,0,1,1,0,7,3,4,1,0,1,0,0,0,33,17,16,0,0,0,0,0,0,0,0,0
231536,10000,100,0,1,19,5,14,0,0,0,0,0,0,2,1,1,0,0,0,0,0,0,16,4,12,0,0,0,1,0,1,0,0,0
231554,10000,100,0,1,13,6,7,0,0,0,0,0,0,4,2,2,0,0,0,0,0,0,9,4,5,0,0,0,0,0,0,0,0,0
231581,10000,100,0,1,61,36,25,0,0,0,3,2,1,3,2,1,0,0,0,0,0,0,51,29,22,1,1,0,1,1,0,2,1,1
231624,10000,100,0,1,208,86,122,2,2,0,7,4,3,33,10,23,6,2,4,0,0,0,125,50,75,6,3,3,21,11,10,8,4,4
231651,10000,100,0,1,139,54,85,1,1,0,0,0,0,44,16,28,6,3,3,6,1,5,81,33,48,1,0,1,0,0,0,0,0,0
231697,10000,100,0,1,15,7,8,0,0,0,0,0,0,5,1,4,0,0,0,0,0,0,10,6,4,0,0,0,0,0,0,0,0,0
231712,10000,100,0,1,11,4,7,0,0,0,3,1,2,0,0,0,0,0,0,0,0,0,8,3,5,0,0,0,0,0,0,0,0,0
231785,10000,100,0,1,35,8,27,0,0,0,1,0,1,16,1,15,2,1,1,0,0,0,10,4,6,3,1,2,3,1,2,0,0,0
231873,10000,100,0,1,10,3,7,0,0,0,0,0,0,0,0,0,0,0,0,0,0,0,10,3,7,0,0,0,0,0,0,0,0,0
231882,10000,100,0,1,32,21,11,0,0,0,0,0,0,10,6,4,0,0,0,0,0,0,21,14,7,0,0,0,1,1,0,0,0,0
231970,10000,100,0,1,174,33,141,1,0,1,13,3,10,64,9,55,7,3,4,0,0,0,77,18,59,12,0,12,0,0,0,0,0,0
232016,10000,100,0,1,8,4,4,0,0,0,0,0,0,6,2,4,0,0,0,0,0,0,2,2,0,0,0,0,0,0,0,0,0,0
232025,10000,100,0,1,57,20,37,0,0,0,0,0,0,3,0,3,1,0,1,0,0,0,19,3,16,0,0,0,34,17,17,0,0,0
232043,10000,100,0,1,25,10,15,0,0,0,2,1,1,2,1,1,1,0,1,0,0,0,20,8,12,0,0,0,0,0,0,0,0,0
232052,10000,100,0,1,5,1,4,0,0,0,1,0,1,2,0,2,0,0,0,0,0,0,2,1,1,0,0,0,0,0,0,0,0,0
232089,10000,100,0,1,22,13,9,0,0,0,2,2,0,0,0,0,1,1,0,0,0,0,16,8,8,0,0,0,3,2,1,0,0,0
232186,10000,100,0,1,526,231,295,2,1,1,67,28,39,81,26,55,43,20,23,0,0,0,262,118,144,18,7,11,4,2,2,49,29,20
232195,10000,100,0,1,29,10,19,1,0,1,1,1,0,7,4,3,1,0,1,0,0,0,19,5,14,0,0,0,0,0,0,0,0,0
232256,10000,100,0,1,28,19,9,0,0,0,1,1,0,2,1,1,1,1,0,0,0,0,23,16,7,1,0,1,0,0,0,0,0,0
232265,10000,100,0,1,84,23,61,0,0,0,7,3,4,57,14,43,5,3,2,0,0,0,15,3,12,0,0,0,0,0,0,0,0,0
232308,10000,100,0,1,50,10,40,0,0,0,1,0,1,5,1,4,1,0,1,0,0,0,40,9,31,1,0,1,0,0,0,2,0,2
232414,10000,100,0,1,43,15,28,0,0,0,1,1,0,14,5,9,1,1,0,0,0,0,25,7,18,2,1,1,0,0,0,0,0,0
232423,10000,100,0,1,187,74,113,1,0,1,3,1,2,16,7,9,15,5,10,0,0,0,142,58,84,6,1,5,2,1,1,2,1,1
232450,10000,100,0,1,15,2,13,0,0,0,0,0,0,8,1,7,0,0,0,0,0,0,7,1,6,0,0,0,0,0,0,0,0,0
232557,10000,100,0,1,797,381,416,5,2,3,28,16,12,80,30,50,31,13,18,0,0,0,635,312,323,0,0,0,16,6,10,2,2,0
232566,10000,100,0,1,36,16,20,0,0,0,0,0,0,5,1,4,0,0,0,0,0,0,30,14,16,0,0,0,0,0,0,1,1,0
232575,10000,100,0,1,22,8,14,1,0,1,0,0,0,2,2,0,0,0,0,0,0,0,18,6,12,1,0,1,0,0,0,0,0,0
232609,10000,100,0,1,41,23,18,0,0,0,2,2,0,3,0,3,0,0,0,0,0,0,23,14,9,0,0,0,13,7,6,0,0,0
232618,10000,100,0,1,12,2,10,0,0,0,0,0,0,0,0,0,0,0,0,0,0,0,12,2,10,0,0,0,0,0,0,0,0,0
232672,10000,100,0,1,56,20,36,0,0,0,1,1,0,4,2,2,1,0,1,0,0,0,47,16,31,3,1,2,0,0,0,0,0,0
232681,10000,100,0,1,32,14,18,0,0,0,3,3,0,5,1,4,1,1,0,0,0,0,19,7,12,0,0,0,4,2,2,0,0,0
232706,10000,100,0,1,97,37,60,0,0,0,8,3,5,20,9,11,18,8,10,0,0,0,45,14,31,2,0,2,4,3,1,0,0,0
232788,10000,100,0,1,13,5,8,0,0,0,0,0,0,0,0,0,0,0,0,0,0,0,12,5,7,1,0,1,0,0,0,0,0,0
232797,10000,100,0,1,38,9,29,1,0,1,3,1,2,13,1,12,4,0,4,0,0,0,16,6,10,0,0,0,1,1,0,0,0,0
232867,10000,100,0,1,7,2,5,0,0,0,0,0,0,1,0,1,0,0,0,0,0,0,6,2,4,0,0,0,0,0,0,0,0,0
232885,10000,100,0,1,4,1,3,0,0,0,0,0,0,2,0,2,0,0,0,0,0,0,2,1,1,0,0,0,0,0,0,0,0,0
232937,10000,100,0,1,11,4,7,0,0,0,2,0,2,8,3,5,0,0,0,0,0,0,1,1,0,0,0,0,0,0,0,0,0,0
232946,10000,100,0,1,80,37,43,0,0,0,12,9,3,26,12,14,2,2,0,0,0,0,33,12,21,5,1,4,2,1,1,0,0,0
232982,10000,100,0,1,173,73,100,0,0,0,11,6,5,59,19,40,5,1,4,0,0,0,85,39,46,1,1,0,1,0,1,11,7,4
233019,10000,100,0,1,11,4,7,0,0,0,0,0,0,3,1,2,0,0,0,0,0,0,8,3,5,0,0,0,0,0,0,0,0,0
233037,10000,100,0,1,7,6,1,0,0,0,0,0,0,3,2,1,0,0,0,0,0,0,4,4,0,0,0,0,0,0,0,0,0,0
233082,10000,100,0,1,4,1,3,0,0,0,0,0,0,1,1,0,0,0,0,0,0,0,3,0,3,0,0,0,0,0,0,0,0,0
233116,10000,100,0,1,28,6,22,0,0,0,1,1,0,7,2,5,0,0,0,0,0,0,18,3,15,1,0,1,1,0,1,0,0,0
233277,10000,100,0,1,141,67,74,0,0,0,4,2,2,14,11,3,7,1,6,1,1,0,111,51,60,3,0,3,1,1,0,0,0,0
233295,10000,100,0,1,79,37,42,0,0,0,2,0,2,13,6,7,4,2,2,0,0,0,59,29,30,1,0,1,0,0,0,0,0,0
233301,10000,100,0,1,21,10,11,0,0,0,0,0,0,6,4,2,0,0,0,0,0,0,12,5,7,3,1,2,0,0,0,0,0,0
233310,10000,100,0,1,18,4,14,0,0,0,0,0,0,6,2,4,0,0,0,0,0,0,12,2,10,0,0,0,0,0,0,0,0,0
233329,10000,100,0,1,18,3,15,0,0,0,2,0,2,3,1,2,5,0,5,0,0,0,7,1,6,0,0,0,1,1,0,0,0,0
233338,10000,100,0,1,5,4,1,0,0,0,0,0,0,2,2,0,0,0,0,0,0,0,3,2,1,0,0,0,0,0,0,0,0,0
233356,10000,100,0,1,4,2,2,0,0,0,0,0,0,1,1,0,0,0,0,0,0,0,3,1,2,0,0,0,0,0,0,0,0,0
233374,10000,100,0,1,174,87,87,0,0,0,2,1,1,41,24,17,7,2,5,0,0,0,114,55,59,1,0,1,4,3,1,5,2,3
233408,10000,100,0,1,4,0,4,1,0,1,0,0,0,0,0,0,0,0,0,0,0,0,3,0,3,0,0,0,0,0,0,0,0,0
233426,10000,100,0,1,41,18,23,0,0,0,0,0,0,4,0,4,2,1,1,0,0,0,34,16,18,1,1,0,0,0,0,0,0,0
233541,10000,100,0,1,73,28,45,0,0,0,2,0,2,7,6,1,6,1,5,1,0,1,41,15,26,1,0,1,13,6,7,2,0,2
233611,10000,100,0,1,3,3,0,0,0,0,0,0,0,0,0,0,0,0,0,0,0,0,3,3,0,0,0,0,0,0,0,0,0,0
233639,10000,100,0,1,16,4,12,0,0,0,0,0,0,5,1,4,0,0,0,0,0,0,11,3,8,0,0,0,0,0,0,0,0,0
233648,10000,100,0,1,15,6,9,0,0,0,0,0,0,1,0,1,0,0,0,0,0,0,14,6,8,0,0,0,0,0,0,0,0,0
233718,10000,100,0,1,41,13,28,0,0,0,1,0,1,6,1,5,2,1,1,0,0,0,28,10,18,0,0,0,4,1,3,0,0,0
233754,10000,100,0,1,15,3,12,0,0,0,0,0,0,9,1,8,0,0,0,0,0,0,5,2,3,1,0,1,0,0,0,0,0,0
233772,10000,100,0,1,44,21,23,0,0,0,1,0,1,19,7,12,1,0,1,0,0,0,23,14,9,0,0,0,0,0,0,0,0,0
233842,10000,100,0,1,6,2,4,0,0,0,0,0,0,3,1,2,0,0,0,0,0,0,3,1,2,0,0,0,0,0,0,0,0,0
233897,10000,100,0,1,37,17,20,0,0,0,0,0,0,1,1,0,0,0,0,0,0,0,35,15,20,0,0,0,1,1,0,0,0,0
233903,10000,100,0,1,9,2,7,0,0,0,0,0,0,0,0,0,0,0,0,0,0,0,9,2,7,0,0,0,0,0,0,0,0,0
233921,10000,100,0,1,863,416,447,3,1,2,38,24,14,62,37,25,41,23,18,0,0,0,575,245,330,16,9,7,0,0,0,128,77,51
233949,10000,100,0,1,21,8,13,0,0,0,1,1,0,3,1,2,0,0,0,0,0,0,15,6,9,2,0,2,0,0,0,0,0,0
234030,10000,100,0,1,660,241,419,1,0,1,41,15,26,150,44,106,36,14,22,0,0,0,344,116,228,12,6,6,4,3,1,72,43,29
234076,10000,100,0,1,885,400,485,0,0,0,61,31,30,103,41,62,39,16,23,1,1,0,499,223,276,37,17,20,43,21,22,102,50,52
234085,10000,100,0,1,91,45,46,0,0,0,5,1,4,7,4,3,2,1,1,0,0,0,77,39,38,0,0,0,0,0,0,0,0,0
234155,10000,100,0,1,87,42,45,0,0,0,4,3,1,66,28,38,3,1,2,0,0,0,14,10,4,0,0,0,0,0,0,0,0,0
234164,10000,100,0,1,6,3,3,0,0,0,0,0,0,3,1,2,0,0,0,0,0,0,0,0,0,0,0,0,3,2,1,0,0,0
234173,10000,100,0,1,21,7,14,0,0,0,0,0,0,2,0,2,0,0,0,1,1,0,17,5,12,1,1,0,0,0,0,0,0,0
234207,10000,100,0,1,114,44,70,0,0,0,2,0,2,12,2,10,10,4,6,0,0,0,71,28,43,5,4,1,8,4,4,6,2,4
234377,10000,100,0,1,12,2,10,0,0,0,0,0,0,1,0,1,0,0,0,0,0,0,11,2,9,0,0,0,0,0,0,0,0,0
234669,10000,100,0,1,58,25,33,0,0,0,13,5,8,7,3,4,7,4,3,1,1,0,24,11,13,5,1,4,1,0,1,0,0,0
234696,10000,100,0,1,20,7,13,0,0,0,1,0,1,1,1,0,1,0,1,0,0,0,14,5,9,2,0,2,1,1,0,0,0,0
234711,10000,100,0,1,18,8,10,0,0,0,1,1,0,0,0,0,9,3,6,0,0,0,7,4,3,1,0,1,0,0,0,0,0,0
234827,10000,100,0,1,109,55,54,1,0,1,8,6,2,4,1,3,14,6,8,0,0,0,76,39,37,6,3,3,0,0,0,0,0,0
234845,10000,100,0,1,20,6,14,1,0,1,0,0,0,3,0,3,0,0,0,1,0,1,11,4,7,3,1,2,1,1,0,0,0,0
234915,10000,100,0,1,18,11,7,0,0,0,3,2,1,2,0,2,0,0,0,0,0,0,12,8,4,0,0,0,1,1,0,0,0,0
234933,10000,100,0,1,47,19,28,0,0,0,5,2,3,3,2,1,2,0,2,0,0,0,27,11,16,7,3,4,3,1,2,0,0,0
234951,10000,100,0,1,35,16,19,0,0,0,5,2,3,4,2,2,0,0,0,1,0,1,23,12,11,1,0,1,1,0,1,0,0,0
234979,10000,100,0,1,59,23,36,1,1,0,1,0,1,1,0,1,14,6,8,2,1,1,35,13,22,5,2,3,0,0,0,0,0,0
235024,10000,100,0,1,10,4,6,0,0,0,0,0,0,2,1,1,3,1,2,0,0,0,4,2,2,1,0,1,0,0,0,0,0,0
235097,10000,100,0,1,123,67,56,4,1,3,7,3,4,5,4,1,12,6,6,1,1,0,91,49,42,1,1,0,0,0,0,2,2,0
235103,10000,100,0,1,73,28,45,0,0,0,6,1,5,2,1,1,5,3,2,0,0,0,39,11,28,9,3,6,12,9,3,0,0,0
235149,10000,100,0,1,24,6,18,0,0,0,5,1,4,0,0,0,1,0,1,0,0,0,8,2,6,4,1,3,6,2,4,0,0,0
235167,10000,100,0,1,33,12,21,0,0,0,0,0,0,1,0,1,3,0,3,0,0,0,2,1,1,1,1,0,26,10,16,0,0,0
235237,10000,100,0,1,43,20,23,1,0,1,5,1,4,6,4,2,4,1,3,1,0,1,12,2,10,0,0,0,14,12,2,0,0,0
235316,10000,100,0,1,173,77,96,2,1,1,5,5,0,11,9,2,7,1,6,1,1,0,84,30,54,1,0,1,56,25,31,6,5,1
235334,10000,100,0,1,16,9,7,0,0,0,0,0,0,0,0,0,0,0,0,0,0,0,16,9,7,0,0,0,0,0,0,0,0,0
235343,10000,100,0,1,50,25,25,0,0,0,7,2,5,5,3,2,4,2,2,1,0,1,21,12,9,6,4,2,6,2,4,0,0,0
235422,10000,100,0,1,16,3,13,1,0,1,1,0,1,0,0,0,8,3,5,0,0,0,6,0,6,0,0,0,0,0,0,0,0,0
235431,10000,100,0,1,33,13,20,0,0,0,4,2,2,5,0,5,2,0,2,1,1,0,16,8,8,2,0,2,3,2,1,0,0,0
235547,10000,100,0,1,17,1,16,0,0,0,0,0,0,2,1,1,0,0,0,0,0,0,7,0,7,1,0,1,7,0,7,0,0,0
235671,10000,100,0,1,15,8,7,1,1,0,2,1,1,2,2,0,2,1,1,0,0,0,8,3,5,0,0,0,0,0,0,0,0,0
235699,10000,100,0,1,45,15,30,0,0,0,7,1,6,5,2,3,3,1,2,0,0,0,25,9,16,4,1,3,1,1,0,0,0,0
235750,10000,100,0,1,29,6,23,0,0,0,1,0,1,0,0,0,4,0,4,0,0,0,19,5,14,3,0,3,2,1,1,0,0,0
236072,10000,100,0,1,9,6,3,0,0,0,0,0,0,2,1,1,0,0,0,0,0,0,2,1,1,1,0,1,4,4,0,0,0,0
236133,10000,100,0,1,27,12,15,0,0,0,4,2,2,0,0,0,1,0,1,0,0,0,21,9,12,1,1,0,0,0,0,0,0,0
236188,10000,100,0,1,47,16,31,1,1,0,1,0,1,2,0,2,1,1,0,1,0,1,38,12,26,3,2,1,0,0,0,0,0,0
236212,10000,100,0,1,22,13,9,0,0,0,0,0,0,0,0,0,5,2,3,0,0,0,16,10,6,0,0,0,1,1,0,0,0,0
236230,10000,100,0,1,60,26,34,1,0,1,2,0,2,5,3,2,6,3,3,0,0,0,43,20,23,2,0,2,1,0,1,0,0,0
236258,10000,100,0,1,42,13,29,0,0,0,1,0,1,1,0,1,0,0,0,0,0,0,26,7,19,4,1,3,10,5,5,0,0,0
236328,10000,100,0,1,57,19,38,0,0,0,4,1,3,3,2,1,3,2,1,0,0,0,43,12,31,2,1,1,2,1,1,0,0,0
236382,10000,100,0,1,25,11,14,1,1,0,4,3,1,4,2,2,0,0,0,0,0,0,14,5,9,2,0,2,0,0,0,0,0,0
236452,10000,100,0,1,35,10,25,0,0,0,4,1,3,5,2,3,0,0,0,0,0,0,21,6,15,0,0,0,5,1,4,0,0,0
236504,10000,100,0,1,9,7,2,0,0,0,3,3,0,0,0,0,1,0,1,0,0,0,1,0,1,0,0,0,4,4,0,0,0,0
236513,10000,100,0,1,32,22,10,0,0,0,4,2,2,3,1,2,2,2,0,0,0,0,4,3,1,1,1,0,18,13,5,0,0,0
236577,10000,100,0,1,85,33,52,0,0,0,6,1,5,9,5,4,10,7,3,0,0,0,40,14,26,3,2,1,8,3,5,9,1,8
236595,10000,100,0,1,164,74,90,1,0,1,25,15,10,16,7,9,13,9,4,1,0,1,88,36,52,2,2,0,18,5,13,0,0,0
236610,10000,100,0,1,24,9,15,0,0,0,3,1,2,2,1,1,1,1,0,0,0,0,11,4,7,1,0,1,6,2,4,0,0,0
236638,10000,100,0,1,33,9,24,0,0,0,2,1,1,0,0,0,2,0,2,0,0,0,22,5,17,7,3,4,0,0,0,0,0,0
236656,10000,100,0,1,23,11,12,0,0,0,4,1,3,2,1,1,2,0,2,0,0,0,11,6,5,4,3,1,0,0,0,0,0,0
236692,10000,100,0,1,89,33,56,3,2,1,4,1,3,3,1,2,6,2,4,0,0,0,63,20,43,4,2,2,6,5,1,0,0,0
236708,10000,100,0,1,29,4,25,1,0,1,2,1,1,0,0,0,2,0,2,2,0,2,20,2,18,1,0,1,1,1,0,0,0,0
236753,10000,100,0,1,37,20,17,1,0,1,0,0,0,4,3,1,3,3,0,2,0,2,20,11,9,3,1,2,4,2,2,0,0,0
236887,10000,100,0,1,27,11,16,0,0,0,0,0,0,1,0,1,4,1,3,1,0,1,20,10,10,0,0,0,1,0,1,0,0,0
236896,10000,100,0,1,15,9,6,0,0,0,2,2,0,0,0,0,3,0,3,0,0,0,10,7,3,0,0,0,0,0,0,0,0,0
236939,10000,100,0,1,361,173,188,3,1,2,17,9,8,9,5,4,31,17,14,3,1,2,159,70,89,8,3,5,126,64,62,5,3,2
236948,10000,100,0,1,2315,1004,1311,10,5,5,326,119,207,139,59,80,170,79,91,11,4,7,1065,450,615,103,38,65,265,121,144,226,129,97
236975,10000,100,0,1,31,11,20,2,0,2,0,0,0,0,0,0,15,5,10,0,0,0,13,5,8,0,0,0,1,1,0,0,0,0
237011,10000,100,0,1,96,40,56,0,0,0,13,6,7,2,0,2,5,3,2,0,0,0,52,21,31,11,3,8,11,6,5,2,1,1
237039,10000,100,0,1,22,9,13,0,0,0,4,2,2,0,0,0,0,0,0,0,0,0,14,5,9,3,2,1,1,0,1,0,0,0
237057,10000,100,0,1,44,17,27,0,0,0,3,2,1,4,3,1,3,0,3,0,0,0,28,10,18,0,0,0,4,1,3,2,1,1
237066,10000,100,0,1,40,21,19,0,0,0,2,1,1,5,3,2,1,0,1,2,1,1,29,15,14,1,1,0,0,0,0,0,0,0
237109,10000,100,0,1,23,9,14,1,1,0,1,0,1,1,0,1,12,5,7,0,0,0,8,3,5,0,0,0,0,0,0,0,0,0
237118,10000,100,0,1,26,15,11,0,0,0,0,0,0,1,1,0,0,0,0,0,0,0,24,14,10,1,0,1,0,0,0,0,0,0
237181,10000,100,0,1,16,10,6,0,0,0,0,0,0,1,1,0,1,0,1,0,0,0,14,9,5,0,0,0,0,0,0,0,0,0
237215,10000,100,0,1,8,3,5,0,0,0,0,0,0,0,0,0,0,0,0,0,0,0,8,3,5,0,0,0,0,0,0,0,0,0
237312,10000,100,0,1,53,27,26,0,0,0,0,0,0,5,2,3,1,1,0,0,0,0,46,24,22,0,0,0,1,0,1,0,0,0
237330,10000,100,0,1,25,13,12,0,0,0,1,1,0,1,0,1,0,0,0,0,0,0,23,12,11,0,0,0,0,0,0,0,0,0
237358,10000,100,0,1,36,14,22,0,0,0,0,0,0,0,0,0,0,0,0,0,0,0,36,14,22,0,0,0,0,0,0,0,0,0
237367,10000,100,0,1,32,16,16,0,0,0,0,0,0,3,2,1,1,1,0,0,0,0,28,13,15,0,0,0,0,0,0,0,0,0
237385,10000,100,0,1,5,1,4,0,0,0,0,0,0,1,0,1,0,0,0,0,0,0,4,1,3,0,0,0,0,0,0,0,0,0
237525,10000,100,0,1,146,88,58,2,1,1,15,7,8,19,15,4,6,2,4,0,0,0,102,62,40,0,0,0,2,1,1,0,0,0
237686,10000,100,0,1,30,8,22,0,0,0,0,0,0,0,0,0,0,0,0,0,0,0,29,7,22,1,1,0,0,0,0,0,0,0
237701,10000,100,0,1,19,7,12,0,0,0,0,0,0,1,0,1,0,0,0,0,0,0,16,5,11,0,0,0,1,1,0,1,1,0
237783,10000,100,0,1,16,9,7,0,0,0,0,0,0,3,1,2,0,0,0,0,0,0,11,6,5,1,1,0,1,1,0,0,0,0
237792,10000,100,0,1,47,19,28,0,0,0,0,0,0,4,2,2,2,0,2,0,0,0,40,16,24,0,0,0,0,0,0,1,1,0
237817,10000,100,0,1,28,13,15,0,0,0,0,0,0,0,0,0,0,0,0,0,0,0,28,13,15,0,0,0,0,0,0,0,0,0
237880,10000,100,0,1,16,9,7,0,0,0,0,0,0,0,0,0,2,2,0,0,0,0,14,7,7,0,0,0,0,0,0,0,0,0
237899,10000,100,0,1,34,16,18,0,0,0,2,2,0,12,5,7,0,0,0,0,0,0,19,9,10,0,0,0,1,0,1,0,0,0
237932,10000,100,0,1,17,11,6,0,0,0,1,1,0,3,3,0,1,1,0,0,0,0,11,6,5,0,0,0,1,0,1,0,0,0
237950,10000,100,0,1,29,16,13,0,0,0,3,2,1,3,1,2,1,1,0,0,0,0,20,10,10,0,0,0,0,0,0,2,2,0
237969,10000,100,0,1,28,15,13,0,0,0,0,0,0,1,0,1,0,0,0,0,0,0,25,13,12,1,1,0,1,1,0,0,0,0
237987,10000,100,0,1,2,0,2,0,0,0,0,0,0,0,0,0,0,0,0,0,0,0,2,0,2,0,0,0,0,0,0,0,0,0
237996,10000,100,0,1,29,3,26,0,0,0,0,0,0,1,0,1,0,0,0,0,0,0,26,3,23,2,0,2,0,0,0,0,0,0
238014,10000,100,0,1,15,2,13,0,0,0,1,1,0,1,0,1,0,0,0,0,0,0,13,1,12,0,0,0,0,0,0,0,0,0
238032,10000,100,0,1,506,251,255,0,0,0,41,25,16,27,15,12,11,4,7,0,0,0,344,161,183,3,2,1,35,17,18,45,27,18
238078,10000,100,0,1,16,10,6,0,0,0,0,0,0,2,2,0,1,1,0,0,0,0,13,7,6,0,0,0,0,0,0,0,0,0
238193,10000,100,0,1,39,7,32,0,0,0,0,0,0,7,2,5,9,2,7,0,0,0,23,3,20,0,0,0,0,0,0,0,0,0
238263,10000,100,0,1,72,23,49,0,0,0,8,2,6,9,4,5,6,2,4,0,0,0,47,14,33,0,0,0,2,1,1,0,0,0
238324,10000,100,0,1,7,3,4,0,0,0,0,0,0,0,0,0,0,0,0,0,0,0,7,3,4,0,0,0,0,0,0,0,0,0
238333,10000,100,0,1,37,15,22,0,0,0,0,0,0,3,2,1,4,0,4,0,0,0,28,13,15,0,0,0,0,0,0,2,0,2
238397,10000,100,0,1,24,13,11,0,0,0,0,0,0,2,2,0,1,0,1,0,0,0,20,11,9,0,0,0,1,0,1,0,0,0
238430,10000,100,0,1,26,11,15,0,0,0,0,0,0,4,0,4,3,1,2,0,0,0,19,10,9,0,0,0,0,0,0,0,0,0
238458,10000,100,0,1,76,38,38,0,0,0,0,0,0,6,5,1,2,1,1,0,0,0,59,27,32,0,0,0,6,3,3,3,2,1
238476,10000,100,0,1,62,25,37,0,0,0,2,2,0,4,2,2,3,1,2,0,0,0,31,13,18,1,0,1,21,7,14,0,0,0
238616,10000,100,0,1,59,25,34,0,0,0,0,0,0,1,0,1,1,0,1,0,0,0,57,25,32,0,0,0,0,0,0,0,0,0
238661,10000,100,0,1,27,9,18,0,0,0,0,0,0,4,3,1,5,3,2,0,0,0,17,3,14,0,0,0,0,0,0,1,0,1
238722,10000,100,0,1,49,20,29,0,0,0,2,2,0,2,2,0,1,1,0,0,0,0,40,15,25,0,0,0,4,0,4,0,0,0
238759,10000,100,0,1,41,14,27,0,0,0,2,0,2,4,3,1,6,3,3,1,1,0,28,7,21,0,0,0,0,0,0,0,0,0
238980,10000,100,0,1,4,1,3,0,0,0,1,1,0,0,0,0,0,0,0,0,0,0,1,0,1,0,0,0,2,0,2,0,0,0
239008,10000,100,0,1,18,8,10,0,0,0,1,1,0,1,0,1,2,1,1,0,0,0,14,6,8,0,0,0,0,0,0,0,0,0
239017,10000,100,0,1,41,16,25,0,0,0,1,0,1,0,0,0,1,0,1,0,0,0,37,15,22,1,0,1,1,1,0,0,0,0
239071,10000,100,0,1,10,6,4,0,0,0,0,0,0,0,0,0,0,0,0,0,0,0,10,6,4,0,0,0,0,0,0,0,0,0
239080,10000,100,0,1,23,8,15,0,0,0,0,0,0,1,1,0,2,1,1,0,0,0,16,6,10,0,0,0,4,0,4,0,0,0
239105,10000,100,0,1,97,39,58,0,0,0,5,1,4,8,4,4,11,4,7,0,0,0,64,26,38,5,1,4,0,0,0,4,3,1
239169,10000,100,0,1,458,142,316,1,0,1,67,29,38,32,11,21,41,9,32,1,0,1,303,89,214,13,4,9,0,0,0,0,0,0
239220,10000,100,0,1,33,12,21,0,0,0,2,1,1,0,0,0,0,0,0,0,0,0,31,11,20,0,0,0,0,0,0,0,0,0
239248,10000,100,0,1,80,31,49,0,0,0,6,3,3,19,5,14,14,2,12,0,0,0,40,20,20,0,0,0,1,1,0,0,0,0
239309,10000,100,0,1,21,8,13,0,0,0,0,0,0,2,1,1,2,1,1,0,0,0,13,6,7,4,0,4,0,0,0,0,0,0
239318,10000,100,0,1,53,28,25,0,0,0,2,0,2,5,4,1,4,3,1,1,1,0,38,19,19,3,1,2,0,0,0,0,0,0
239372,10000,100,0,1,18,5,13,0,0,0,0,0,0,0,0,0,0,0,0,0,0,0,18,5,13,0,0,0,0,0,0,0,0,0
239390,10000,100,0,1,29,4,25,0,0,0,1,0,1,4,0,4,3,1,2,0,0,0,19,3,16,0,0,0,2,0,2,0,0,0
239424,10000,100,0,1,4,3,1,0,0,0,0,0,0,0,0,0,1,1,0,0,0,0,3,2,1,0,0,0,0,0,0,0,0,0
239442,10000,100,0,1,10,5,5,0,0,0,0,0,0,1,1,0,0,0,0,0,0,0,9,4,5,0,0,0,0,0,0,0,0,0
239460,10000,100,0,1,45,14,31,0,0,0,4,0,4,0,0,0,0,0,0,0,0,0,40,14,26,0,0,0,1,0,1,0,0,0
239488,10000,100,0,1,58,27,31,3,1,2,7,5,2,4,3,1,2,0,2,0,0,0,42,18,24,0,0,0,0,0,0,0,0,0
239512,10000,100,0,1,10,1,9,2,0,2,0,0,0,0,0,0,0,0,0,0,0,0,7,1,6,0,0,0,1,0,1,0,0,0
239628,10000,100,0,1,39,22,17,0,0,0,1,0,1,0,0,0,1,1,0,0,0,0,33,18,15,0,0,0,4,3,1,0,0,0
239637,10000,100,0,1,3,2,1,0,0,0,0,0,0,0,0,0,0,0,0,0,0,0,3,2,1,0,0,0,0,0,0,0,0,0
239716,10000,100,0,1,68,28,40,1,0,1,2,0,2,3,2,1,1,0,1,0,0,0,55,25,30,1,0,1,2,0,2,3,1,2
239910,10000,100,0,1,14,6,8,0,0,0,0,0,0,1,0,1,0,0,0,0,0,0,13,6,7,0,0,0,0,0,0,0,0,0
240107,10000,100,0,1,55,18,37,1,0,1,2,1,1,2,1,1,2,0,2,0,0,0,44,15,29,1,0,1,3,1,2,0,0,0
240116,10000,100,0,1,66,27,39,0,0,0,5,1,4,1,1,0,4,2,2,0,0,0,55,23,32,0,0,0,1,0,1,0,0,0
240125,10000,100,0,1,53,25,28,0,0,0,4,2,2,2,2,0,3,3,0,0,0,0,42,16,26,0,0,0,2,2,0,0,0,0
240189,10000,100,0,1,28,14,14,0,0,0,0,0,0,3,0,3,2,0,2,0,0,0,22,13,9,0,0,0,1,1,0,0,0,0
240198,10000,100,0,1,27,7,20,1,1,0,0,0,0,0,0,0,0,0,0,0,0,0,26,6,20,0,0,0,0,0,0,0,0,0
240268,10000,100,0,1,84,31,53,0,0,0,7,1,6,2,0,2,1,0,1,0,0,0,52,20,32,2,0,2,18,9,9,2,1,1
240277,10000,100,0,1,89,39,50,2,0,2,12,4,8,1,0,1,5,2,3,0,0,0,63,27,36,3,3,0,0,0,0,3,3,0
240329,10000,100,0,1,49,20,29,1,0,1,4,2,2,0,0,0,0,0,0,0,0,0,23,8,15,1,0,1,20,10,10,0,0,0
240338,10000,100,0,1,10,3,7,0,0,0,0,0,0,1,1,0,0,0,0,0,0,0,7,2,5,0,0,0,2,0,2,0,0,0
240365,10000,100,0,1,89,43,46,2,2,0,3,1,2,7,4,3,0,0,0,0,0,0,57,24,33,3,2,1,16,9,7,1,1,0
240374,10000,100,0,1,48,28,20,0,0,0,2,2,0,4,3,1,4,2,2,0,0,0,31,18,13,1,1,0,3,2,1,3,0,3
240392,10000,100,0,1,80,17,63,1,0,1,1,0,1,11,2,9,4,0,4,0,0,0,59,14,45,3,1,2,1,0,1,0,0,0
240417,10000,100,0,1,32,16,16,0,0,0,3,1,2,0,0,0,0,0,0,0,0,0,25,13,12,0,0,0,1,0,1,3,2,1
240426,10000,100,0,1,42,20,22,0,0,0,2,1,1,0,0,0,1,0,1,0,0,0,34,17,17,2,0,2,2,2,0,1,0,1
240435,10000,100,0,1,487,191,296,3,2,1,26,9,17,10,4,6,7,2,5,0,0,0,398,160,238,10,5,5,31,9,22,2,0,2
240444,10000,100,0,1,1176,484,692,4,1,3,88,31,57,63,30,33,78,29,49,0,0,0,799,322,477,14,5,9,69,32,37,61,34,27
240453,10000,100,0,1,137,59,78,1,1,0,9,4,5,27,10,17,11,5,6,0,0,0,83,36,47,4,1,3,1,1,0,1,1,0
240462,10000,100,0,1,39,16,23,0,0,0,1,0,1,1,1,0,1,0,1,0,0,0,31,14,17,2,0,2,1,0,1,2,1,1
240471,10000,100,0,1,53,24,29,1,0,1,3,1,2,1,1,0,2,2,0,0,0,0,41,18,23,2,0,2,1,1,0,2,1,1
240480,10000,100,0,1,49,27,22,0,0,0,1,0,1,1,1,0,2,1,1,1,1,0,43,24,19,1,0,1,0,0,0,0,0,0
240505,10000,100,0,1,22,13,9,0,0,0,1,0,1,0,0,0,3,1,2,0,0,0,10,6,4,0,0,0,7,6,1,1,0,1
240514,10000,100,0,1,17,7,10,0,0,0,1,1,0,0,0,0,0,0,0,0,0,0,14,4,10,0,0,0,2,2,0,0,0,0
240596,10000,100,0,1,8,4,4,0,0,0,0,0,0,0,0,0,1,1,0,0,0,0,7,3,4,0,0,0,0,0,0,0,0,0
240620,10000,100,0,1,61,20,41,1,0,1,0,0,0,1,0,1,7,0,7,0,0,0,49,19,30,2,1,1,1,0,1,0,0,0
240657,10000,100,0,1,12,9,3,0,0,0,0,0,0,0,0,0,0,0,0,0,0,0,12,9,3,0,0,0,0,0,0,0,0,0
240666,10000,100,0,1,24,9,15,0,0,0,0,0,0,0,0,0,1,0,1,0,0,0,23,9,14,0,0,0,0,0,0,0,0,0
240693,10000,100,0,1,19,5,14,0,0,0,0,0,0,0,0,0,2,0,2,0,0,0,16,5,11,1,0,1,0,0,0,0,0,0
240718,10000,100,0,1,35,23,12,1,0,1,0,0,0,0,0,0,2,2,0,0,0,0,32,21,11,0,0,0,0,0,0,0,0,0
240727,10000,100,0,1,362,155,207,1,1,0,12,3,9,7,4,3,19,9,10,0,0,0,213,83,130,2,1,1,90,41,49,18,13,5
240736,10000,100,0,1,9,6,3,0,0,0,0,0,0,0,0,0,0,0,0,9,6,3,0,0,0,0,0,0,0,0,0,0,0,0
240745,10000,100,0,1,39,20,19,0,0,0,17,8,9,0,0,0,0,0,0,14,9,5,5,2,3,1,1,0,0,0,0,2,0,2
240754,10000,100,0,1,28,10,18,0,0,0,15,4,11,0,0,0,0,0,0,11,4,7,2,2,0,0,0,0,0,0,0,0,0,0
240790,10000,100,0,1,29,15,14,0,0,0,6,2,4,0,0,0,1,0,1,17,10,7,2,2,0,0,0,0,0,0,0,3,1,2
241100,10000,100,0,1,6,3,3,0,0,0,0,0,0,0,0,0,6,3,3,0,0,0,0,0,0,0,0,0,0,0,0,0,0,0
241191,10000,100,0,1,8,5,3,0,0,0,0,0,0,0,0,0,8,5,3,0,0,0,0,0,0,0,0,0,0,0,0,0,0,0
241216,10000,100,0,1,1,0,1,0,0,0,0,0,0,0,0,0,1,0,1,0,0,0,0,0,0,0,0,0,0,0,0,0,0,0
241225,10000,100,0,1,17,6,11,0,0,0,0,0,0,0,0,0,17,6,11,0,0,0,0,0,0,0,0,0,0,0,0,0,0,0
241304,10000,100,0,1,16,4,12,0,0,0,0,0,0,0,0,0,16,4,12,0,0,0,0,0,0,0,0,0,0,0,0,0,0,0
241331,10000,100,0,1,12,2,10,0,0,0,0,0,0,0,0,0,12,2,10,0,0,0,0,0,0,0,0,0,0,0,0,0,0,0
241377,10000,100,0,1,11,1,10,0,0,0,0,0,0,0,0,0,11,1,10,0,0,0,0,0,0,0,0,0,0,0,0,0,0,0
241395,10000,100,0,1,6,1,5,0,0,0,0,0,0,0,0,0,6,1,5,0,0,0,0,0,0,0,0,0,0,0,0,0,0,0
241410,10000,100,0,1,13,4,9,0,0,0,0,0,0,0,0,0,13,4,9,0,0,0,0,0,0,0,0,0,0,0,0,0,0,0
241517,10000,100,0,1,3,1,2,0,0,0,0,0,0,0,0,0,3,1,2,0,0,0,0,0,0,0,0,0,0,0,0,0,0,0
241614,10000,100,0,1,1,0,1,0,0,0,0,0,0,0,0,0,1,0,1,0,0,0,0,0,0,0,0,0,0,0,0,0,0,0
241739,10000,100,0,1,28,5,23,0,0,0,0,0,0,0,0,0,28,5,23,0,0,0,0,0,0,0,0,0,0,0,0,0,0,0
241766,10000,100,0,1,2,1,1,0,0,0,0,0,0,0,0,0,2,1,1,0,0,0,0,0,0,0,0,0,0,0,0,0,0,0
241793,10000,100,0,1,5,2,3,0,0,0,0,0,0,0,0,0,5,2,3,0,0,0,0,0,0,0,0,0,0,0,0,0,0,0
241836,10000,100,0,1,22,5,17,0,0,0,0,0,0,0,0,0,22,5,17,0,0,0,0,0,0,0,0,0,0,0,0,0,0,0
241951,10000,100,0,1,6,3,3,0,0,0,0,0,0,0,0,0,6,3,3,0,0,0,0,0,0,0,0,0,0,0,0,0,0,0
242060,10000,100,0,1,9,8,1,0,0,0,0,0,0,0,0,0,9,8,1,0,0,0,0,0,0,0,0,0,0,0,0,0,0,0
242112,10000,100,0,1,10,4,6,0,0,0,0,0,0,0,0,0,10,4,6,0,0,0,0,0,0,0,0,0,0,0,0,0,0,0
242130,10000,100,0,1,4,2,2,0,0,0,0,0,0,0,0,0,4,2,2,0,0,0,0,0,0,0,0,0,0,0,0,0,0,0
242149,10000,100,0,1,3,2,1,0,0,0,0,0,0,0,0,0,3,2,1,0,0,0,0,0,0,0,0,0,0,0,0,0,0,0
242565,10000,100,0,1,14,5,9,0,0,0,0,0,0,0,0,0,14,5,9,0,0,0,0,0,0,0,0,0,0,0,0,0,0,0
242617,10000,100,0,1,18,5,13,0,0,0,0,0,0,0,0,0,18,5,13,0,0,0,0,0,0,0,0,0,0,0,0,0,0,0
242635,10000,100,0,1,30,10,20,0,0,0,0,0,0,0,0,0,30,10,20,0,0,0,0,0,0,0,0,0,0,0,0,0,0,0
242644,10000,100,0,1,19,8,11,0,0,0,0,0,0,0,0,0,19,8,11,0,0,0,0,0,0,0,0,0,0,0,0,0,0,0
242653,10000,100,0,1,51,16,35,0,0,0,0,0,0,0,0,0,51,16,35,0,0,0,0,0,0,0,0,0,0,0,0,0,0,0
242662,10000,100,0,1,32,8,24,0,0,0,0,0,0,0,0,0,32,8,24,0,0,0,0,0,0,0,0,0,0,0,0,0,0,0
242671,10000,100,0,1,13,4,9,0,0,0,0,0,0,0,0,0,13,4,9,0,0,0,0,0,0,0,0,0,0,0,0,0,0,0
242680,10000,100,0,1,9,1,8,0,0,0,0,0,0,0,0,0,9,1,8,0,0,0,0,0,0,0,0,0,0,0,0,0,0,0
242699,10000,100,0,1,11,7,4,0,0,0,0,0,0,0,0,0,11,7,4,0,0,0,0,0,0,0,0,0,0,0,0,0,0,0
242705,10000,100,0,1,15,8,7,0,0,0,0,0,0,0,0,0,15,8,7,0,0,0,0,0,0,0,0,0,0,0,0,0,0,0
242723,10000,100,0,1,6,5,1,0,0,0,0,0,0,0,0,0,6,5,1,0,0,0,0,0,0,0,0,0,0,0,0,0,0,0
242972,10000,100,0,1,291,83,208,0,0,0,2,1,1,5,3,2,259,68,191,2,0,2,23,11,12,0,0,0,0,0,0,0,0,0
243081,10000,100,0,1,87,21,66,0,0,0,0,0,0,0,0,0,87,21,66,0,0,0,0,0,0,0,0,0,0,0,0,0,0,0
243151,10000,100,0,1,2,1,1,0,0,0,0,0,0,0,0,0,2,1,1,0,0,0,0,0,0,0,0,0,0,0,0,0,0,0
243160,10000,100,0,1,17,8,9,0,0,0,0,0,0,0,0,0,7,4,3,1,0,1,0,0,0,0,0,0,8,3,5,1,1,0
243179,10000,100,0,1,4,3,1,0,0,0,0,0,0,0,0,0,2,1,1,0,0,0,0,0,0,0,0,0,1,1,0,1,1,0
243197,10000,100,0,1,114,59,55,0,0,0,0,0,0,0,0,0,30,19,11,0,0,0,0,0,0,0,0,0,84,40,44,0,0,0
243346,10000,100,0,1,11,7,4,0,0,0,0,0,0,0,0,0,11,7,4,0,0,0,0,0,0,0,0,0,0,0,0,0,0,0
243443,10000,100,0,1,82,28,54,0,0,0,0,0,0,0,0,0,82,28,54,0,0,0,0,0,0,0,0,0,0,0,0,0,0,0
243568,10000,100,0,1,40,20,20,0,0,0,0,0,0,0,0,0,40,20,20,0,0,0,0,0,0,0,0,0,0,0,0,0,0,0
243577,10000,100,0,1,16,9,7,0,0,0,0,0,0,0,0,0,16,9,7,0,0,0,0,0,0,0,0,0,0,0,0,0,0,0
243586,10000,100,0,1,2,0,2,0,0,0,0,0,0,0,0,0,2,0,2,0,0,0,0,0,0,0,0,0,0,0,0,0,0,0
243601,10000,100,0,1,19,8,11,0,0,0,0,0,0,0,0,0,18,8,10,0,0,0,1,0,1,0,0,0,0,0,0,0,0,0
243638,10000,100,0,1,31,17,14,0,0,0,2,2,0,0,0,0,0,0,0,29,15,14,0,0,0,0,0,0,0,0,0,0,0,0
243647,10000,100,0,1,8,1,7,0,0,0,0,0,0,0,0,0,0,0,0,8,1,7,0,0,0,0,0,0,0,0,0,0,0,0
243744,10000,100,0,1,2430,966,1464,5,1,4,487,177,310,98,39,59,229,87,142,7,3,4,669,274,395,64,22,42,688,276,412,183,87,96
243780,10000,100,0,1,903,450,453,3,2,1,57,29,28,56,30,26,48,18,30,0,0,0,543,238,305,20,10,10,23,11,12,153,112,41
243823,10000,100,0,1,42,18,24,0,0,0,0,0,0,7,3,4,8,2,6,0,0,0,14,8,6,0,0,0,13,5,8,0,0,0
243832,10000,100,0,1,35,10,25,0,0,0,0,0,0,0,0,0,35,10,25,0,0,0,0,0,0,0,0,0,0,0,0,0,0,0
243841,10000,100,0,1,12,3,9,0,0,0,0,0,0,0,0,0,12,3,9,0,0,0,0,0,0,0,0,0,0,0,0,0,0,0
244233,10000,100,0,1,1,1,0,0,0,0,0,0,0,1,1,0,0,0,0,0,0,0,0,0,0,0,0,0,0,0,0,0,0,0
244437,10000,100,0,1,21,12,9,0,0,0,2,0,2,8,5,3,2,2,0,0,0,0,9,5,4,0,0,0,0,0,0,0,0,0
244446,10000,100,0,1,63,17,46,0,0,0,2,2,0,45,12,33,0,0,0,0,0,0,16,3,13,0,0,0,0,0,0,0,0,0
245625,10000,100,0,1,1,1,0,0,0,0,0,0,0,0,0,0,0,0,0,0,0,0,1,1,0,0,0,0,0,0,0,0,0,0
245652,10000,100,0,1,20,13,7,1,0,1,2,1,1,2,2,0,3,3,0,0,0,0,12,7,5,0,0,0,0,0,0,0,0,0
245953,10000,100,0,1,31,10,21,0,0,0,0,0,0,4,2,2,4,1,3,0,0,0,23,7,16,0,0,0,0,0,0,0,0,0
245962,10000,100,0,1,4,2,2,0,0,0,0,0,0,3,2,1,1,0,1,0,0,0,0,0,0,0,0,0,0,0,0,0,0,0
246354,10000,100,0,1,42,20,22,0,0,0,2,1,1,1,0,1,33,15,18,0,0,0,5,3,2,1,1,0,0,0,0,0,0,0
246813,10000,100,0,1,61,34,27,2,2,0,3,1,2,15,8,7,1,1,0,0,0,0,40,22,18,0,0,0,0,0,0,0,0,0
246974,10000,100,0,1,15,4,11,0,0,0,1,0,1,3,3,0,4,0,4,0,0,0,4,1,3,2,0,2,1,0,1,0,0,0
247083,10000,100,0,1,2,1,1,0,0,0,0,0,0,0,0,0,0,0,0,0,0,0,2,1,1,0,0,0,0,0,0,0,0,0
247603,10000,100,0,1,4,3,1,0,0,0,0,0,0,0,0,0,2,1,1,0,0,0,2,2,0,0,0,0,0,0,0,0,0,0
247649,10000,100,0,1,29,14,15,0,0,0,2,2,0,0,0,0,1,0,1,0,0,0,26,12,14,0,0,0,0,0,0,0,0,0
247834,10000,100,0,1,176,85,91,1,0,1,9,3,6,35,19,16,11,5,6,0,0,0,107,52,55,3,1,2,10,5,5,0,0,0
247940,10000,100,0,1,11,3,8,0,0,0,0,0,0,1,1,0,0,0,0,0,0,0,10,2,8,0,0,0,0,0,0,0,0,0
248934,10000,100,0,1,223,54,169,0,0,0,11,2,9,60,13,47,16,5,11,1,1,0,118,28,90,10,3,7,7,2,5,0,0,0
250027,10000,100,0,1,8,1,7,0,0,0,0,0,0,0,0,0,0,0,0,0,0,0,8,1,7,0,0,0,0,0,0,0,0,0
251260,10000,100,0,1,28,9,19,0,0,0,1,0,1,6,2,4,1,0,1,0,0,0,19,7,12,1,0,1,0,0,0,0,0,0
251312,10000,100,0,1,11,3,8,0,0,0,0,0,0,6,2,4,0,0,0,0,0,0,5,1,4,0,0,0,0,0,0,0,0,0
260372,10000,100,0,1,15,3,12,8,2,6,0,0,0,0,0,0,0,0,0,0,0,0,7,1,6,0,0,0,0,0,0,0,0,0
260691,10000,100,0,1,10,3,7,0,0,0,0,0,0,1,0,1,1,0,1,0,0,0,8,3,5,0,0,0,0,0,0,0,0,0
260789,10000,100,0,1,18,2,16,0,0,0,3,0,3,2,1,1,5,0,5,0,0,0,8,1,7,0,0,0,0,0,0,0,0,0
260813,10000,100,0,1,3,0,3,0,0,0,0,0,0,1,0,1,0,0,0,0,0,0,1,0,1,0,0,0,1,0,1,0,0,0
260992,10000,100,0,1,9,2,7,0,0,0,0,0,0,5,1,4,0,0,0,0,0,0,4,1,3,0,0,0,0,0,0,0,0,0
261861,10000,100,0,1,3,0,3,0,0,0,0,0,0,0,0,0,0,0,0,0,0,0,3,0,3,0,0,0,0,0,0,0,0,0
262031,10000,100,0,1,26,15,11,0,0,0,1,0,1,5,3,2,0,0,0,0,0,0,20,12,8,0,0,0,0,0,0,0,0,0
262086,10000,100,0,1,46,15,31,0,0,0,5,3,2,7,1,6,9,3,6,0,0,0,22,8,14,2,0,2,0,0,0,1,0,1
262129,10000,100,0,1,40,11,29,1,0,1,4,1,3,7,2,5,1,0,1,0,0,0,24,7,17,0,0,0,0,0,0,3,1,2
262457,10000,100,0,1,9,0,9,0,0,0,0,0,0,1,0,1,7,0,7,0,0,0,1,0,1,0,0,0,0,0,0,0,0,0
363633,10000,100,0,1,10,5,5,0,0,0,0,0,0,0,0,0,7,5,2,0,0,0,3,0,3,0,0,0,0,0,0,0,0,0
363934,10000,100,0,1,28,8,20,0,0,0,1,0,1,1,1,0,3,0,3,0,0,0,19,5,14,4,2,2,0,0,0,0,0,0
364016,10000,100,0,1,28,10,18,2,0,2,0,0,0,1,1,0,3,0,3,0,0,0,20,9,11,1,0,1,1,0,1,0,0,0
364025,10000,100,0,1,34,13,21,1,0,1,2,2,0,1,0,1,6,1,5,0,0,0,20,9,11,2,0,2,2,1,1,0,0,0
366003,10000,100,0,1,1,1,0,0,0,0,0,0,0,0,0,0,0,0,0,0,0,0,1,1,0,0,0,0,0,0,0,0,0,0
366252,10000,100,0,1,69,39,30,0,0,0,2,0,2,1,1,0,1,0,1,0,0,0,63,37,26,0,0,0,2,1,1,0,0,0
366270,10000,100,0,1,7,2,5,0,0,0,0,0,0,5,1,4,0,0,0,0,0,0,2,1,1,0,0,0,0,0,0,0,0,0
366340,10000,100,0,1,14,3,11,11,3,8,0,0,0,0,0,0,0,0,0,0,0,0,2,0,2,0,0,0,0,0,0,1,0,1
366395,10000,100,0,1,9,5,4,0,0,0,2,1,1,1,1,0,0,0,0,0,0,0,6,3,3,0,0,0,0,0,0,0,0,0
366401,10000,100,0,1,5,2,3,0,0,0,0,0,0,1,0,1,1,0,1,0,0,0,3,2,1,0,0,0,0,0,0,0,0,0
366465,10000,100,0,1,14,8,6,0,0,0,0,0,0,5,1,4,1,1,0,0,0,0,8,6,2,0,0,0,0,0,0,0,0,0
366553,10000,100,0,1,45,15,30,0,0,0,0,0,0,5,2,3,6,4,2,0,0,0,30,7,23,4,2,2,0,0,0,0,0,0
366711,10000,100,0,1,92,35,57,2,1,1,6,0,6,10,5,5,33,12,21,0,0,0,33,12,21,2,2,0,2,0,2,4,3,1
367112,10000,100,0,1,1,1,0,0,0,0,0,0,0,1,1,0,0,0,0,0,0,0,0,0,0,0,0,0,0,0,0,0,0,0
367459,10000,100,0,1,61,17,44,1,1,0,3,0,3,1,1,0,3,1,2,0,0,0,50,14,36,0,0,0,3,0,3,0,0,0
367884,10000,100,0,1,24,9,15,0,0,0,0,0,0,3,0,3,7,4,3,0,0,0,11,4,7,0,0,0,3,1,2,0,0,0
367954,10000,100,0,1,104,31,73,1,0,1,6,3,3,9,4,5,15,6,9,1,0,1,66,15,51,4,1,3,2,2,0,0,0,0
368629,10000,100,0,1,7,0,7,0,0,0,1,0,1,0,0,0,1,0,1,0,0,0,3,0,3,2,0,2,0,0,0,0,0,0
368911,10000,100,0,1,18,4,14,0,0,0,1,1,0,1,0,1,0,0,0,0,0,0,16,3,13,0,0,0,0,0,0,0,0,0
369400,10000,100,0,1,25,14,11,0,0,0,1,0,1,1,0,1,10,6,4,0,0,0,11,7,4,2,1,1,0,0,0,0,0,0
372329,10000,100,0,1,3,0,3,0,0,0,0,0,0,0,0,0,1,0,1,0,0,0,2,0,2,0,0,0,0,0,0,0,0,0
372921,10000,100,0,1,1,1,0,0,0,0,0,0,0,0,0,0,0,0,0,0,0,0,0,0,0,1,1,0,0,0,0,0,0,0
376224,10000,100,0,1,1,0,1,0,0,0,0,0,0,0,0,0,1,0,1,0,0,0,0,0,0,0,0,0,0,0,0,0,0,0
376695,10000,100,0,1,33,23,10,0,0,0,1,0,1,1,0,1,0,0,0,28,21,7,3,2,1,0,0,0,0,0,0,0,0,0
377111,10000,100,0,1,6,2,4,0,0,0,0,0,0,2,0,2,3,2,1,0,0,0,1,0,1,0,0,0,0,0,0,0,0,0
377449,10000,100,0,1,6,2,4,0,0,0,0,0,0,5,1,4,0,0,0,0,0,0,1,1,0,0,0,0,0,0,0,0,0,0
377458,10000,100,0,1,20,7,13,0,0,0,0,0,0,11,1,10,0,0,0,0,0,0,9,6,3,0,0,0,0,0,0,0,0,0
377555,10000,100,0,1,43,13,30,0,0,0,5,1,4,2,2,0,5,2,3,0,0,0,22,6,16,3,1,2,3,1,2,3,0,3
377564,10000,100,0,1,43,18,25,0,0,0,3,1,2,5,3,2,2,1,1,1,1,0,19,7,12,7,3,4,3,1,2,3,1,2
377661,10000,100,0,1,4,1,3,0,0,0,0,0,0,2,0,2,0,0,0,0,0,0,1,0,1,1,1,0,0,0,0,0,0,0
378105,10000,100,0,1,8,3,5,0,0,0,0,0,0,1,0,1,5,2,3,0,0,0,2,1,1,0,0,0,0,0,0,0,0,0
378576,10000,100,0,1,29,11,18,0,0,0,0,0,0,0,0,0,0,0,0,0,0,0,0,0,0,0,0,0,29,11,18,0,0,0
379746,10000,100,0,1,5,1,4,0,0,0,0,0,0,1,0,1,1,0,1,0,0,0,3,1,2,0,0,0,0,0,0,0,0,0
380359,10000,100,0,1,8,2,6,5,2,3,0,0,0,0,0,0,0,0,0,0,0,0,3,0,3,0,0,0,0,0,0,0,0,0
380368,10000,100,0,1,5,0,5,2,0,2,0,0,0,0,0,0,0,0,0,0,0,0,3,0,3,0,0,0,0,0,0,0,0,0
380377,10000,100,0,1,29,13,16,22,10,12,0,0,0,1,1,0,0,0,0,0,0,0,3,1,2,3,1,2,0,0,0,0,0,0
380438,10000,100,0,1,12,3,9,0,0,0,0,0,0,0,0,0,1,1,0,0,0,0,10,1,9,1,1,0,0,0,0,0,0,0
382957,10000,100,0,1,10,4,6,0,0,0,0,0,0,2,0,2,0,0,0,0,0,0,5,2,3,1,1,0,2,1,1,0,0,0
383190,10000,100,0,1,1,1,0,0,0,0,0,0,0,0,0,0,0,0,0,1,1,0,0,0,0,0,0,0,0,0,0,0,0,0
383996,10000,100,0,1,10,0,10,0,0,0,0,0,0,2,0,2,7,0,7,0,0,0,1,0,1,0,0,0,0,0,0,0,0,0
384254,10000,100,0,1,44,13,31,0,0,0,1,0,1,10,1,9,4,0,4,0,0,0,29,12,17,0,0,0,0,0,0,0,0,0
384333,10000,100,0,1,17,6,11,0,0,0,0,0,0,1,0,1,8,2,6,0,0,0,8,4,4,0,0,0,0,0,0,0,0,0
384342,10000,100,0,1,37,10,27,0,0,0,1,0,1,2,0,2,4,1,3,0,0,0,29,9,20,0,0,0,1,0,1,0,0,0
384412,10000,100,0,1,2,0,2,0,0,0,0,0,0,2,0,2,0,0,0,0,0,0,0,0,0,0,0,0,0,0,0,0,0,0
385415,10000,100,0,1,214,90,124,0,0,0,24,11,13,24,10,14,38,13,25,1,0,1,60,27,33,3,1,2,1,0,1,63,28,35
385503,10000,100,0,1,4,1,3,0,0,0,0,0,0,1,0,1,0,0,0,0,0,0,3,1,2,0,0,0,0,0,0,0,0,0
385619,10000,100,0,1,83,32,51,0,0,0,3,2,1,25,6,19,21,4,17,0,0,0,26,15,11,8,5,3,0,0,0,0,0,0
386153,10000,100,0,1,2,0,2,0,0,0,0,0,0,0,0,0,0,0,0,0,0,0,2,0,2,0,0,0,0,0,0,0,0,0
386472,10000,100,0,1,9,1,8,0,0,0,0,0,0,3,1,2,0,0,0,0,0,0,5,0,5,0,0,0,1,0,1,0,0,0
388520,10000,100,0,1,6,2,4,0,0,0,0,0,0,2,1,1,0,0,0,0,0,0,3,1,2,1,0,1,0,0,0,0,0,0
392257,10000,100,0,1,41,5,36,0,0,0,1,0,1,23,2,21,8,3,5,0,0,0,8,0,8,1,0,1,0,0,0,0,0,0
392415,10000,100,0,1,5,0,5,0,0,0,0,0,0,1,0,1,4,0,4,0,0,0,0,0,0,0,0,0,0,0,0,0,0,0
395362,10000,100,0,1,7,1,6,0,0,0,0,0,0,1,0,1,3,0,3,0,0,0,3,1,2,0,0,0,0,0,0,0,0,0
399212,10000,100,0,1,5,3,2,0,0,0,0,0,0,0,0,0,0,0,0,1,0,1,4,3,1,0,0,0,0,0,0,0,0,0
399869,10000,100,0,1,6,4,2,0,0,0,0,0,0,0,0,0,2,2,0,0,0,0,4,2,2,0,0,0,0,0,0,0,0,0
399911,10000,100,0,1,12,3,9,0,0,0,6,1,5,0,0,0,2,1,1,0,0,0,4,1,3,0,0,0,0,0,0,0,0,0
403469,10000,100,0,1,6,1,5,0,0,0,0,0,0,0,0,0,0,0,0,0,0,0,6,1,5,0,0,0,0,0,0,0,0,0
403478,10000,100,0,1,13,8,5,0,0,0,0,0,0,1,1,0,0,0,0,0,0,0,12,7,5,0,0,0,0,0,0,0,0,0
403487,10000,100,0,1,6,4,2,0,0,0,0,0,0,0,0,0,0,0,0,0,0,0,6,4,2,0,0,0,0,0,0,0,0,0
404055,10000,100,0,1,13,4,9,0,0,0,1,1,0,1,0,1,2,0,2,0,0,0,7,2,5,1,0,1,1,1,0,0,0,0
404222,10000,100,0,1,5,3,2,0,0,0,0,0,0,0,0,0,5,3,2,0,0,0,0,0,0,0,0,0,0,0,0,0,0,0
404426,10000,100,0,1,27,11,16,7,4,3,0,0,0,1,1,0,4,1,3,0,0,0,14,5,9,0,0,0,1,0,1,0,0,0
404480,10000,100,0,1,9,5,4,0,0,0,0,0,0,0,0,0,0,0,0,0,0,0,4,4,0,0,0,0,3,1,2,2,0,2
404912,10000,100,0,1,7,1,6,0,0,0,0,0,0,1,1,0,0,0,0,0,0,0,6,0,6,0,0,0,0,0,0,0,0,0
404994,10000,100,0,1,11,4,7,0,0,0,0,0,0,4,2,2,4,1,3,0,0,0,3,1,2,0,0,0,0,0,0,0,0,0
405872,10000,100,0,1,16,7,9,0,0,0,0,0,0,4,3,1,0,0,0,0,0,0,11,4,7,1,0,1,0,0,0,0,0,0
406024,10000,100,0,1,33,2,31,0,0,0,1,0,1,1,0,1,3,1,2,0,0,0,21,1,20,7,0,7,0,0,0,0,0,0
406033,10000,100,0,1,35,4,31,0,0,0,4,1,3,7,0,7,12,1,11,0,0,0,11,2,9,0,0,0,1,0,1,0,0,0
407629,10000,100,0,1,69,29,40,0,0,0,5,2,3,4,1,3,3,0,3,0,0,0,56,26,30,1,0,1,0,0,0,0,0,0
408729,10000,100,0,1,2,0,2,0,0,0,0,0,0,0,0,0,0,0,0,0,0,0,2,0,2,0,0,0,0,0,0,0,0,0
408844,10000,100,0,1,99,44,55,0,0,0,1,1,0,5,4,1,93,39,54,0,0,0,0,0,0,0,0,0,0,0,0,0,0,0
409254,10000,100,0,1,20,3,17,0,0,0,0,0,0,7,0,7,5,1,4,0,0,0,8,2,6,0,0,0,0,0,0,0,0,0
409315,10000,100,0,1,180,85,95,0,0,0,4,1,3,0,0,0,147,66,81,0,0,0,16,9,7,0,0,0,3,3,0,10,6,4
409379,10000,100,0,1,37,7,30,0,0,0,1,0,1,7,0,7,2,0,2,0,0,0,27,7,20,0,0,0,0,0,0,0,0,0
409616,10000,100,0,1,4,0,4,0,0,0,1,0,1,0,0,0,0,0,0,0,0,0,3,0,3,0,0,0,0,0,0,0,0,0
409698,10000,100,0,1,59,30,29,0,0,0,4,1,3,4,3,1,15,8,7,0,0,0,27,14,13,1,0,1,7,3,4,1,1,0
412173,10000,100,0,1,4,1,3,0,0,0,0,0,0,0,0,0,0,0,0,0,0,0,4,1,3,0,0,0,0,0,0,0,0,0
412599,10000,100,0,1,6,2,4,0,0,0,0,0,0,5,1,4,0,0,0,0,0,0,1,1,0,0,0,0,0,0,0,0,0,0
413413,10000,100,0,1,126,34,92,2,0,2,3,0,3,19,6,13,2,1,1,0,0,0,85,23,62,0,0,0,15,4,11,0,0,0
413617,10000,100,0,1,12,3,9,10,3,7,0,0,0,0,0,0,1,0,1,0,0,0,1,0,1,0,0,0,0,0,0,0,0,0
413626,10000,100,0,1,1,1,0,0,0,0,0,0,0,0,0,0,0,0,0,0,0,0,1,1,0,0,0,0,0,0,0,0,0,0
413680,10000,100,0,1,15,10,5,0,0,0,1,1,0,4,3,1,6,3,3,0,0,0,3,3,0,1,0,1,0,0,0,0,0,0
414461,10000,100,0,1,38,15,23,0,0,0,0,0,0,0,0,0,38,15,23,0,0,0,0,0,0,0,0,0,0,0,0,0,0,0
414595,10000,100,0,1,6,1,5,0,0,0,0,0,0,0,0,0,0,0,0,0,0,0,0,0,0,0,0,0,6,1,5,0,0,0
414911,10000,100,0,1,7,4,3,0,0,0,0,0,0,0,0,0,0,0,0,0,0,0,7,4,3,0,0,0,0,0,0,0,0,0
414939,10000,100,0,1,13,2,11,0,0,0,0,0,0,1,0,1,2,0,2,0,0,0,0,0,0,0,0,0,10,2,8,0,0,0
414966,10000,100,0,1,3,1,2,0,0,0,0,0,0,0,0,0,0,0,0,0,0,0,3,1,2,0,0,0,0,0,0,0,0,0
416458,10000,100,0,1,7,2,5,0,0,0,5,2,3,0,0,0,2,0,2,0,0,0,0,0,0,0,0,0,0,0,0,0,0,0
416801,10000,100,0,1,3,1,2,0,0,0,1,0,1,0,0,0,0,0,0,0,0,0,2,1,1,0,0,0,0,0,0,0,0,0
417734,10000,100,0,1,1,1,0,0,0,0,0,0,0,0,0,0,0,0,0,0,0,0,1,1,0,0,0,0,0,0,0,0,0,0
418126,10000,100,0,1,2,0,2,0,0,0,0,0,0,0,0,0,0,0,0,0,0,0,2,0,2,0,0,0,0,0,0,0,0,0
418533,10000,100,0,1,11,4,7,0,0,0,0,0,0,0,0,0,0,0,0,0,0,0,11,4,7,0,0,0,0,0,0,0,0,0
419244,10000,100,0,1,2,1,1,0,0,0,0,0,0,1,0,1,0,0,0,0,0,0,1,1,0,0,0,0,0,0,0,0,0,0
420024,10000,100,0,1,15,1,14,0,0,0,1,0,1,9,1,8,0,0,0,0,0,0,3,0,3,2,0,2,0,0,0,0,0,0
420246,10000,100,0,1,20,6,14,0,0,0,1,0,1,3,1,2,5,3,2,0,0,0,11,2,9,0,0,0,0,0,0,0,0,0
420398,10000,100,0,1,29,10,19,0,0,0,1,0,1,1,0,1,19,6,13,0,0,0,7,4,3,1,0,1,0,0,0,0,0,0
420431,10000,100,0,1,27,7,20,0,0,0,0,0,0,13,3,10,0,0,0,0,0,0,14,4,10,0,0,0,0,0,0,0,0,0
420440,10000,100,0,1,10,3,7,0,0,0,0,0,0,0,0,0,0,0,0,0,0,0,10,3,7,0,0,0,0,0,0,0,0,0
420538,10000,100,0,1,7,6,1,0,0,0,0,0,0,0,0,0,0,0,0,0,0,0,7,6,1,0,0,0,0,0,0,0,0,0
420556,10000,100,0,1,16,5,11,0,0,0,0,0,0,0,0,0,2,1,1,0,0,0,14,4,10,0,0,0,0,0,0,0,0,0
420802,10000,100,0,1,1,1,0,0,0,0,0,0,0,0,0,0,0,0,0,0,0,0,1,1,0,0,0,0,0,0,0,0,0,0
421708,10000,100,0,1,31,8,23,1,0,1,0,0,0,7,0,7,2,1,1,0,0,0,18,7,11,2,0,2,1,0,1,0,0,0
422020,10000,100,0,1,6,5,1,0,0,0,0,0,0,2,1,1,2,2,0,0,0,0,1,1,0,0,0,0,1,1,0,0,0,0
422695,10000,100,0,1,11,2,9,0,0,0,3,0,3,1,0,1,2,0,2,0,0,0,4,1,3,1,1,0,0,0,0,0,0,0
423643,10000,100,0,1,94,27,67,1,0,1,7,4,3,5,4,1,26,6,20,0,0,0,51,13,38,3,0,3,1,0,1,0,0,0
423652,10000,100,0,1,9,3,6,0,0,0,0,0,0,0,0,0,1,1,0,0,0,0,8,2,6,0,0,0,0,0,0,0,0,0
426314,10000,100,0,1,51,23,28,0,0,0,3,2,1,4,4,0,5,2,3,0,0,0,32,11,21,2,2,0,5,2,3,0,0,0
427982,10000,100,0,1,19,14,5,0,0,0,0,0,0,13,8,5,0,0,0,0,0,0,6,6,0,0,0,0,0,0,0,0,0,0
428170,10000,100,0,1,24,7,17,0,0,0,1,0,1,3,0,3,13,4,9,0,0,0,7,3,4,0,0,0,0,0,0,0,0,0
428392,10000,100,0,1,32,9,23,0,0,0,0,0,0,2,0,2,9,2,7,0,0,0,20,7,13,0,0,0,1,0,1,0,0,0
428426,10000,100,0,1,1,1,0,0,0,0,1,1,0,0,0,0,0,0,0,0,0,0,0,0,0,0,0,0,0,0,0,0,0,0
428453,10000,100,0,1,10,2,8,0,0,0,1,0,1,2,1,1,0,0,0,0,0,0,7,1,6,0,0,0,0,0,0,0,0,0
429094,10000,100,0,1,5,0,5,0,0,0,1,0,1,1,0,1,1,0,1,0,0,0,2,0,2,0,0,0,0,0,0,0,0,0
429128,10000,100,0,1,8,3,5,0,0,0,0,0,0,1,1,0,3,1,2,0,0,0,4,1,3,0,0,0,0,0,0,0,0,0
430704,10000,100,0,1,2,0,2,0,0,0,0,0,0,0,0,0,0,0,0,0,0,0,2,0,2,0,0,0,0,0,0,0,0,0
431141,10000,100,0,1,37,7,30,0,0,0,3,0,3,1,0,1,9,1,8,1,0,1,22,6,16,0,0,0,1,0,1,0,0,0
432144,10000,100,0,1,6,2,4,0,0,0,0,0,0,0,0,0,1,0,1,0,0,0,4,2,2,1,0,1,0,0,0,0,0,0
432348,10000,100,0,1,4,2,2,0,0,0,0,0,0,0,0,0,0,0,0,0,0,0,4,2,2,0,0,0,0,0,0,0,0,0
432384,10000,100,0,1,5,2,3,0,0,0,1,0,1,0,0,0,3,1,2,0,0,0,1,1,0,0,0,0,0,0,0,0,0,0
432524,10000,100,0,1,9,5,4,0,0,0,0,0,0,4,3,1,0,0,0,0,0,0,5,2,3,0,0,0,0,0,0,0,0,0
433004,10000,100,0,1,9,6,3,1,1,0,3,1,2,0,0,0,0,0,0,0,0,0,5,4,1,0,0,0,0,0,0,0,0,0
433013,10000,100,0,1,10,2,8,0,0,0,0,0,0,0,0,0,4,1,3,0,0,0,6,1,5,0,0,0,0,0,0,0,0,0
433174,10000,100,0,1,14,2,12,0,0,0,1,1,0,4,1,3,0,0,0,0,0,0,9,0,9,0,0,0,0,0,0,0,0,0
433387,10000,100,0,1,716,298,418,3,1,2,34,16,18,105,45,60,76,29,47,4,1,3,432,180,252,28,9,19,34,17,17,0,0,0
433420,10000,100,0,1,33,19,14,1,0,1,0,0,0,4,2,2,8,4,4,0,0,0,17,12,5,3,1,2,0,0,0,0,0,0
433536,10000,100,0,1,4,0,4,0,0,0,0,0,0,2,0,2,0,0,0,0,0,0,2,0,2,0,0,0,0,0,0,0,0,0
433660,10000,100,0,1,170,64,106,0,0,0,10,4,6,17,9,8,18,6,12,0,0,0,112,41,71,4,0,4,0,0,0,9,4,5
434016,10000,100,0,1,16,7,9,8,5,3,0,0,0,0,0,0,0,0,0,0,0,0,8,2,6,0,0,0,0,0,0,0,0,0
434061,10000,100,0,1,87,23,64,0,0,0,2,0,2,46,8,38,4,1,3,1,0,1,33,13,20,0,0,0,0,0,0,1,1,0
434140,10000,100,0,1,10,1,9,0,0,0,0,0,0,0,0,0,3,0,3,0,0,0,4,1,3,3,0,3,0,0,0,0,0,0
434159,10000,100,0,1,6,2,4,0,0,0,0,0,0,5,1,4,1,1,0,0,0,0,0,0,0,0,0,0,0,0,0,0,0,0
434584,10000,100,0,1,18,8,10,3,1,2,4,3,1,0,0,0,1,1,0,4,1,3,6,2,4,0,0,0,0,0,0,0,0,0
434672,10000,100,0,1,79,34,45,0,0,0,3,1,2,28,15,13,7,3,4,0,0,0,36,13,23,2,0,2,1,1,0,2,1,1
434751,10000,100,0,1,1,1,0,1,1,0,0,0,0,0,0,0,0,0,0,0,0,0,0,0,0,0,0,0,0,0,0,0,0,0
434821,10000,100,0,1,7,0,7,0,0,0,0,0,0,7,0,7,0,0,0,0,0,0,0,0,0,0,0,0,0,0,0,0,0,0
435000,10000,100,0,1,242,102,140,1,0,1,29,17,12,39,12,27,9,5,4,0,0,0,122,43,79,2,0,2,0,0,0,40,25,15
436304,10000,100,0,1,36,10,26,0,0,0,0,0,0,14,1,13,3,2,1,0,0,0,19,7,12,0,0,0,0,0,0,0,0,0
436429,10000,100,0,1,97,40,57,1,1,0,7,4,3,16,8,8,30,13,17,0,0,0,28,7,21,7,4,3,8,3,5,0,0,0
437103,10000,100,0,1,17,8,9,0,0,0,1,1,0,10,3,7,0,0,0,0,0,0,5,3,2,1,1,0,0,0,0,0,0,0
437635,10000,100,0,1,30,7,23,0,0,0,1,0,1,7,0,7,12,3,9,0,0,0,9,3,6,1,1,0,0,0,0,0,0,0
437936,10000,100,0,1,20,5,15,0,0,0,3,1,2,2,0,2,6,2,4,1,1,0,5,1,4,2,0,2,1,0,1,0,0,0
438179,10000,100,0,1,10,0,10,0,0,0,0,0,0,1,0,1,2,0,2,0,0,0,7,0,7,0,0,0,0,0,0,0,0,0
438258,10000,100,0,1,13,2,11,0,0,0,0,0,0,1,0,1,1,0,1,1,0,1,7,1,6,1,0,1,2,1,1,0,0,0
438498,10000,100,0,1,18,4,14,0,0,0,1,1,0,4,0,4,1,0,1,0,0,0,11,3,8,0,0,0,1,0,1,0,0,0
438504,10000,100,0,1,14,6,8,0,0,0,0,0,0,1,1,0,9,5,4,0,0,0,4,0,4,0,0,0,0,0,0,0,0,0
438586,10000,100,0,1,4,2,2,0,0,0,0,0,0,4,2,2,0,0,0,0,0,0,0,0,0,0,0,0,0,0,0,0,0,0
438665,10000,100,0,1,11,7,4,0,0,0,0,0,0,1,0,1,6,3,3,0,0,0,1,1,0,0,0,0,3,3,0,0,0,0
438708,10000,100,0,1,10,6,4,0,0,0,0,0,0,0,0,0,0,0,0,0,0,0,10,6,4,0,0,0,0,0,0,0,0,0
439118,10000,100,0,1,13,1,12,1,0,1,0,0,0,0,0,0,2,1,1,1,0,1,8,0,8,0,0,0,1,0,1,0,0,0
439154,10000,100,0,1,20,10,10,0,0,0,0,0,0,0,0,0,7,2,5,0,0,0,11,6,5,0,0,0,0,0,0,2,2,0
439190,10000,100,0,1,11,6,5,0,0,0,2,1,1,1,0,1,0,0,0,0,0,0,1,1,0,3,0,3,4,4,0,0,0,0
439367,10000,100,0,1,12,3,9,0,0,0,0,0,0,1,0,1,2,0,2,0,0,0,9,3,6,0,0,0,0,0,0,0,0,0
439446,10000,100,0,1,1,1,0,0,0,0,1,1,0,0,0,0,0,0,0,0,0,0,0,0,0,0,0,0,0,0,0,0,0,0
439570,10000,100,0,1,11,1,10,0,0,0,0,0,0,2,0,2,0,0,0,0,0,0,9,1,8,0,0,0,0,0,0,0,0,0
439701,10000,100,0,1,5,3,2,0,0,0,0,0,0,1,0,1,0,0,0,0,0,0,4,3,1,0,0,0,0,0,0,0,0,0
439738,10000,100,0,1,2,0,2,0,0,0,0,0,0,2,0,2,0,0,0,0,0,0,0,0,0,0,0,0,0,0,0,0,0,0
439792,10000,100,0,1,7,1,6,0,0,0,0,0,0,3,0,3,1,1,0,0,0,0,3,0,3,0,0,0,0,0,0,0,0,0
440031,10000,100,0,1,37,11,26,1,0,1,11,5,6,3,0,3,1,1,0,0,0,0,15,2,13,3,1,2,3,2,1,0,0,0
440059,10000,100,0,1,35,21,14,0,0,0,1,1,0,17,8,9,1,1,0,0,0,0,13,10,3,1,1,0,2,0,2,0,0,0
440262,10000,100,0,1,2,1,1,0,0,0,0,0,0,0,0,0,1,1,0,0,0,0,1,0,1,0,0,0,0,0,0,0,0,0
440396,10000,100,0,1,6,4,2,0,0,0,0,0,0,0,0,0,0,0,0,0,0,0,6,4,2,0,0,0,0,0,0,0,0,0
440402,10000,100,0,1,21,7,14,0,0,0,0,0,0,3,1,2,1,1,0,0,0,0,17,5,12,0,0,0,0,0,0,0,0,0
440651,10000,100,0,1,13,2,11,0,0,0,0,0,0,0,0,0,13,2,11,0,0,0,0,0,0,0,0,0,0,0,0,0,0,0
440794,10000,100,0,1,7,2,5,0,0,0,0,0,0,2,0,2,4,1,3,0,0,0,1,1,0,0,0,0,0,0,0,0,0,0
440916,10000,100,0,1,21,10,11,0,0,0,1,1,0,15,5,10,0,0,0,0,0,0,5,4,1,0,0,0,0,0,0,0,0,0
441025,10000,100,0,1,6,4,2,0,0,0,0,0,0,0,0,0,1,1,0,0,0,0,4,3,1,1,0,1,0,0,0,0,0,0
441052,10000,100,0,1,18,6,12,0,0,0,2,2,0,0,0,0,8,3,5,0,0,0,7,1,6,1,0,1,0,0,0,0,0,0
441070,10000,100,0,1,2,2,0,0,0,0,0,0,0,0,0,0,0,0,0,0,0,0,1,1,0,1,1,0,0,0,0,0,0,0
441104,10000,100,0,1,4,2,2,0,0,0,0,0,0,2,1,1,0,0,0,0,0,0,2,1,1,0,0,0,0,0,0,0,0,0
441131,10000,100,0,1,5,1,4,0,0,0,0,0,0,0,0,0,1,0,1,0,0,0,4,1,3,0,0,0,0,0,0,0,0,0
441229,10000,100,0,1,70,19,51,0,0,0,3,1,2,5,2,3,20,7,13,0,0,0,29,4,25,1,1,0,12,4,8,0,0,0
441371,10000,100,0,1,494,99,395,2,0,2,13,5,8,183,26,157,112,30,82,0,0,0,135,32,103,31,5,26,18,1,17,0,0,0
441423,10000,100,0,1,10,3,7,0,0,0,0,0,0,0,0,0,10,3,7,0,0,0,0,0,0,0,0,0,0,0,0,0,0,0
441609,10000,100,0,1,5,5,0,0,0,0,0,0,0,0,0,0,4,4,0,0,0,0,1,1,0,0,0,0,0,0,0,0,0,0
441636,10000,100,0,1,6,1,5,0,0,0,0,0,0,2,0,2,0,0,0,0,0,0,4,1,3,0,0,0,0,0,0,0,0,0
441742,10000,100,0,1,15,2,13,0,0,0,1,1,0,7,0,7,3,0,3,0,0,0,4,1,3,0,0,0,0,0,0,0,0,0
441760,10000,100,0,1,42,12,30,1,0,1,2,0,2,6,1,5,5,2,3,0,0,0,21,7,14,0,0,0,6,2,4,1,0,1
441858,10000,100,0,1,2,0,2,0,0,0,0,0,0,0,0,0,0,0,0,0,0,0,2,0,2,0,0,0,0,0,0,0,0,0
441900,10000,100,0,1,33,10,23,1,0,1,2,0,2,4,1,3,7,2,5,0,0,0,19,7,12,0,0,0,0,0,0,0,0,0
441937,10000,100,0,1,63,21,42,0,0,0,8,5,3,4,1,3,33,9,24,0,0,0,9,2,7,4,1,3,4,3,1,1,0,1
441982,10000,100,0,1,5,0,5,0,0,0,0,0,0,1,0,1,2,0,2,0,0,0,2,0,2,0,0,0,0,0,0,0,0,0
442064,10000,100,0,1,2,1,1,0,0,0,0,0,0,0,0,0,0,0,0,0,0,0,2,1,1,0,0,0,0,0,0,0,0,0
442134,10000,100,0,1,4,1,3,0,0,0,0,0,0,0,0,0,2,1,1,0,0,0,2,0,2,0,0,0,0,0,0,0,0,0
442295,10000,100,0,1,9,2,7,0,0,0,0,0,0,0,0,0,1,0,1,0,0,0,8,2,6,0,0,0,0,0,0,0,0,0
442356,10000,100,0,1,26,3,23,0,0,0,2,0,2,2,0,2,0,0,0,0,0,0,22,3,19,0,0,0,0,0,0,0,0,0
442383,10000,100,0,1,12,2,10,0,0,0,0,0,0,0,0,0,0,0,0,0,0,0,12,2,10,0,0,0,0,0,0,0,0,0
442426,10000,100,0,1,5,1,4,0,0,0,0,0,0,0,0,0,0,0,0,0,0,0,5,1,4,0,0,0,0,0,0,0,0,0
442444,10000,100,0,1,19,4,15,0,0,0,0,0,0,3,1,2,10,1,9,0,0,0,5,2,3,0,0,0,1,0,1,0,0,0
442569,10000,100,0,1,41,8,33,0,0,0,2,0,2,8,2,6,3,0,3,0,0,0,24,6,18,3,0,3,1,0,1,0,0,0
442602,10000,100,0,1,7,1,6,1,0,1,0,0,0,0,0,0,2,1,1,0,0,0,3,0,3,1,0,1,0,0,0,0,0,0
442781,10000,100,0,1,17,7,10,12,3,9,2,2,0,2,1,1,0,0,0,0,0,0,1,1,0,0,0,0,0,0,0,0,0,0
442806,10000,100,0,1,75,32,43,0,0,0,4,1,3,5,2,3,1,0,1,0,0,0,65,29,36,0,0,0,0,0,0,0,0,0
442842,10000,100,0,1,3,0,3,0,0,0,0,0,0,0,0,0,0,0,0,0,0,0,0,0,0,0,0,0,3,0,3,0,0,0
442930,10000,100,0,1,22,7,15,0,0,0,1,0,1,2,0,2,13,4,9,0,0,0,5,3,2,1,0,1,0,0,0,0,0,0
443076,10000,100,0,1,1,0,1,0,0,0,0,0,0,1,0,1,0,0,0,0,0,0,0,0,0,0,0,0,0,0,0,0,0,0
443128,10000,100,0,1,5,3,2,0,0,0,1,1,0,0,0,0,0,0,0,0,0,0,2,2,0,0,0,0,0,0,0,2,0,2
443261,10000,100,0,1,10,2,8,0,0,0,0,0,0,5,2,3,1,0,1,0,0,0,4,0,4,0,0,0,0,0,0,0,0,0
443331,10000,100,0,1,14,2,12,0,0,0,2,0,2,1,0,1,5,1,4,0,0,0,5,1,4,0,0,0,1,0,1,0,0,0
443368,10000,100,0,1,3,0,3,0,0,0,0,0,0,0,0,0,0,0,0,0,0,0,3,0,3,0,0,0,0,0,0,0,0,0
443377,10000,100,0,1,3,3,0,0,0,0,0,0,0,0,0,0,0,0,0,0,0,0,3,3,0,0,0,0,0,0,0,0,0,0
443410,10000,100,0,1,19,8,11,1,0,1,1,1,0,0,0,0,3,1,2,0,0,0,12,5,7,2,1,1,0,0,0,0,0,0
443492,10000,100,0,1,7,3,4,0,0,0,0,0,0,0,0,0,0,0,0,0,0,0,7,3,4,0,0,0,0,0,0,0,0,0
443571,10000,100,0,1,11,4,7,0,0,0,0,0,0,2,0,2,8,3,5,0,0,0,1,1,0,0,0,0,0,0,0,0,0,0
443599,10000,100,0,1,3,2,1,0,0,0,0,0,0,0,0,0,1,0,1,0,0,0,2,2,0,0,0,0,0,0,0,0,0,0
443650,10000,100,0,1,4,1,3,0,0,0,0,0,0,0,0,0,0,0,0,0,0,0,4,1,3,0,0,0,0,0,0,0,0,0
443711,10000,100,0,1,48,14,34,0,0,0,4,2,2,16,3,13,8,1,7,0,0,0,17,6,11,1,1,0,2,1,1,0,0,0
443748,10000,100,0,1,13,3,10,1,0,1,0,0,0,7,2,5,2,1,1,0,0,0,1,0,1,2,0,2,0,0,0,0,0,0
444088,10000,100,0,1,15,1,14,1,0,1,1,0,1,1,0,1,3,0,3,1,0,1,7,0,7,1,1,0,0,0,0,0,0,0
444130,10000,100,0,1,26,7,19,0,0,0,1,0,1,5,3,2,0,0,0,0,0,0,20,4,16,0,0,0,0,0,0,0,0,0
444219,10000,100,0,1,1,0,1,0,0,0,0,0,0,1,0,1,0,0,0,0,0,0,0,0,0,0,0,0,0,0,0,0,0,0
444556,10000,100,0,1,8,4,4,0,0,0,0,0,0,1,0,1,1,0,1,1,0,1,1,0,1,2,2,0,2,2,0,0,0,0
444565,10000,100,0,1,2,1,1,0,0,0,0,0,0,0,0,0,1,0,1,0,0,0,1,1,0,0,0,0,0,0,0,0,0,0
444787,10000,100,0,1,186,37,149,1,1,0,5,1,4,21,1,20,12,3,9,2,0,2,125,24,101,8,3,5,12,4,8,0,0,0
444811,10000,100,0,1,8,3,5,0,0,0,0,0,0,5,3,2,0,0,0,0,0,0,3,0,3,0,0,0,0,0,0,0,0,0
444866,10000,100,0,1,7,1,6,0,0,0,0,0,0,3,0,3,0,0,0,0,0,0,3,1,2,1,0,1,0,0,0,0,0,0
444954,10000,100,0,1,17,7,10,0,0,0,1,0,1,0,0,0,1,0,1,0,0,0,15,7,8,0,0,0,0,0,0,0,0,0
445027,10000,100,0,1,87,29,58,4,1,3,1,0,1,32,11,21,8,3,5,1,1,0,36,12,24,0,0,0,5,1,4,0,0,0
445188,10000,100,0,1,169,76,93,1,0,1,20,8,12,7,4,3,53,17,36,0,0,0,45,18,27,5,3,2,10,9,1,28,17,11
445203,10000,100,0,1,1,0,1,0,0,0,0,0,0,0,0,0,0,0,0,0,0,0,1,0,1,0,0,0,0,0,0,0,0,0
445230,10000,100,0,1,6,2,4,0,0,0,0,0,0,1,0,1,1,1,0,0,0,0,4,1,3,0,0,0,0,0,0,0,0,0
445249,10000,100,0,1,4,0,4,0,0,0,0,0,0,4,0,4,0,0,0,0,0,0,0,0,0,0,0,0,0,0,0,0,0,0
445267,10000,100,0,1,5,2,3,0,0,0,0,0,0,0,0,0,0,0,0,0,0,0,5,2,3,0,0,0,0,0,0,0,0,0
445461,10000,100,0,1,17,6,11,0,0,0,0,0,0,10,3,7,2,1,1,0,0,0,2,1,1,2,0,2,1,1,0,0,0,0
445692,10000,100,0,1,11,6,5,0,0,0,1,1,0,0,0,0,0,0,0,0,0,0,10,5,5,0,0,0,0,0,0,0,0,0
445708,10000,100,0,1,21,10,11,0,0,0,0,0,0,9,5,4,2,1,1,0,0,0,8,3,5,1,0,1,1,1,0,0,0,0
445735,10000,100,0,1,65,11,54,1,0,1,2,0,2,5,0,5,23,3,20,1,0,1,31,8,23,2,0,2,0,0,0,0,0,0
445744,10000,100,0,1,4,2,2,0,0,0,0,0,0,2,1,1,0,0,0,0,0,0,2,1,1,0,0,0,0,0,0,0,0,0
445869,10000,100,0,1,13,7,6,0,0,0,1,1,0,1,0,1,0,0,0,0,0,0,9,6,3,1,0,1,1,0,1,0,0,0
445948,10000,100,0,1,46,18,28,0,0,0,2,1,1,10,4,6,16,3,13,1,1,0,12,5,7,4,3,1,1,1,0,0,0,0
446048,10000,100,0,1,29,16,13,0,0,0,2,0,2,1,1,0,1,1,0,0,0,0,25,14,11,0,0,0,0,0,0,0,0,0
446118,10000,100,0,1,27,6,21,0,0,0,6,2,4,4,1,3,12,2,10,1,0,1,4,1,3,0,0,0,0,0,0,0,0,0
446127,10000,100,0,1,3,0,3,0,0,0,0,0,0,0,0,0,0,0,0,0,0,0,3,0,3,0,0,0,0,0,0,0,0,0
446233,10000,100,0,1,4,3,1,0,0,0,0,0,0,1,1,0,0,0,0,0,0,0,3,2,1,0,0,0,0,0,0,0,0,0
446385,10000,100,0,1,8,4,4,0,0,0,2,0,2,0,0,0,2,2,0,0,0,0,2,1,1,0,0,0,2,1,1,0,0,0
446552,10000,100,0,1,49,18,31,0,0,0,0,0,0,9,3,6,13,6,7,0,0,0,25,8,17,2,1,1,0,0,0,0,0,0
446561,10000,100,0,1,28,15,13,0,0,0,3,1,2,1,1,0,7,5,2,0,0,0,17,8,9,0,0,0,0,0,0,0,0,0
446604,10000,100,0,1,13,13,0,0,0,0,0,0,0,0,0,0,0,0,0,0,0,0,13,13,0,0,0,0,0,0,0,0,0,0
446640,10000,100,0,1,43,26,17,0,0,0,2,1,1,5,5,0,0,0,0,0,0,0,17,11,6,0,0,0,19,9,10,0,0,0
446774,10000,100,0,1,12,3,9,0,0,0,0,0,0,0,0,0,0,0,0,0,0,0,12,3,9,0,0,0,0,0,0,0,0,0
446978,10000,100,0,1,7,3,4,0,0,0,0,0,0,0,0,0,1,0,1,0,0,0,4,2,2,1,1,0,1,0,1,0,0,0
447014,10000,100,0,1,3,0,3,0,0,0,0,0,0,1,0,1,0,0,0,0,0,0,1,0,1,1,0,1,0,0,0,0,0,0
447050,10000,100,0,1,20,6,14,0,0,0,1,0,1,2,0,2,3,1,2,0,0,0,10,3,7,1,1,0,3,1,2,0,0,0
447263,10000,100,0,1,88,22,66,1,0,1,2,0,2,3,2,1,5,1,4,0,0,0,57,15,42,1,0,1,19,4,15,0,0,0
447351,10000,100,0,1,9,3,6,0,0,0,0,0,0,0,0,0,3,0,3,0,0,0,6,3,3,0,0,0,0,0,0,0,0,0
447421,10000,100,0,1,6,1,5,0,0,0,1,0,1,1,1,0,0,0,0,0,0,0,4,0,4,0,0,0,0,0,0,0,0,0
447582,10000,100,0,1,17,10,7,0,0,0,0,0,0,1,1,0,0,0,0,0,0,0,16,9,7,0,0,0,0,0,0,0,0,0
447591,10000,100,0,1,16,6,10,0,0,0,0,0,0,12,3,9,1,1,0,0,0,0,2,1,1,1,1,0,0,0,0,0,0,0
447689,10000,100,0,1,60,20,40,0,0,0,5,2,3,22,7,15,3,1,2,0,0,0,26,8,18,3,2,1,1,0,1,0,0,0
447698,10000,100,0,1,8,1,7,0,0,0,0,0,0,0,0,0,0,0,0,0,0,0,7,1,6,0,0,0,1,0,1,0,0,0
447768,10000,100,0,1,16,4,12,0,0,0,4,2,2,6,0,6,3,1,2,1,1,0,2,0,2,0,0,0,0,0,0,0,0,0
447777,10000,100,0,1,13,4,9,0,0,0,2,1,1,2,1,1,3,0,3,0,0,0,4,1,3,2,1,1,0,0,0,0,0,0
447935,10000,100,0,1,3,2,1,0,0,0,0,0,0,0,0,0,0,0,0,0,0,0,3,2,1,0,0,0,0,0,0,0,0,0
447953,10000,100,0,1,7,5,2,0,0,0,1,1,0,0,0,0,2,1,1,0,0,0,4,3,1,0,0,0,0,0,0,0,0,0
448336,10000,100,0,1,1,1,0,0,0,0,0,0,0,0,0,0,0,0,0,0,0,0,1,1,0,0,0,0,0,0,0,0,0,0
448354,10000,100,0,1,5,1,4,0,0,0,0,0,0,0,0,0,2,0,2,0,0,0,3,1,2,0,0,0,0,0,0,0,0,0
448381,10000,100,0,1,7,1,6,0,0,0,0,0,0,2,0,2,2,1,1,0,0,0,2,0,2,0,0,0,1,0,1,0,0,0
448433,10000,100,0,1,1,0,1,0,0,0,0,0,0,0,0,0,0,0,0,0,0,0,1,0,1,0,0,0,0,0,0,0,0,0
448594,10000,100,0,1,6,2,4,0,0,0,1,1,0,2,0,2,1,1,0,0,0,0,0,0,0,1,0,1,1,0,1,0,0,0
448600,10000,100,0,1,12,2,10,0,0,0,0,0,0,1,0,1,0,0,0,0,0,0,11,2,9,0,0,0,0,0,0,0,0,0
448637,10000,100,0,1,2,1,1,0,0,0,0,0,0,0,0,0,1,1,0,0,0,0,1,0,1,0,0,0,0,0,0,0,0,0
448673,10000,100,0,1,31,9,22,0,0,0,2,2,0,3,0,3,4,1,3,0,0,0,20,6,14,1,0,1,1,0,1,0,0,0
448691,10000,100,0,1,6,0,6,0,0,0,0,0,0,0,0,0,1,0,1,0,0,0,4,0,4,1,0,1,0,0,0,0,0,0
448859,10000,100,0,1,2,2,0,0,0,0,0,0,0,0,0,0,0,0,0,0,0,0,2,2,0,0,0,0,0,0,0,0,0,0
449074,10000,100,0,1,11,2,9,0,0,0,0,0,0,2,0,2,2,0,2,0,0,0,5,2,3,2,0,2,0,0,0,0,0,0
449250,10000,100,0,1,15,2,13,0,0,0,0,0,0,1,0,1,8,1,7,1,0,1,5,1,4,0,0,0,0,0,0,0,0,0
449339,10000,100,0,1,71,21,50,0,0,0,1,1,0,5,3,2,4,0,4,0,0,0,60,16,44,0,0,0,1,1,0,0,0,0
449384,10000,100,0,1,4,2,2,0,0,0,0,0,0,1,0,1,1,0,1,0,0,0,2,2,0,0,0,0,0,0,0,0,0,0
449524,10000,100,0,1,6,2,4,0,0,0,0,0,0,0,0,0,2,1,1,0,0,0,4,1,3,0,0,0,0,0,0,0,0,0
449728,10000,100,0,1,2,0,2,0,0,0,0,0,0,0,0,0,0,0,0,0,0,0,2,0,2,0,0,0,0,0,0,0,0,0
449764,10000,100,0,1,1,1,0,0,0,0,0,0,0,0,0,0,0,0,0,0,0,0,1,1,0,0,0,0,0,0,0,0,0,0
449870,10000,100,0,1,2,1,1,0,0,0,1,0,1,0,0,0,0,0,0,0,0,0,1,1,0,0,0,0,0,0,0,0,0,0
449889,10000,100,0,1,25,9,16,0,0,0,0,0,0,6,1,5,1,1,0,0,0,0,18,7,11,0,0,0,0,0,0,0,0,0
449898,10000,100,0,1,13,4,9,0,0,0,1,0,1,2,0,2,1,0,1,0,0,0,8,3,5,0,0,0,1,1,0,0,0,0
449922,10000,100,0,1,1,1,0,0,0,0,1,1,0,0,0,0,0,0,0,0,0,0,0,0,0,0,0,0,0,0,0,0,0,0
450058,10000,100,0,1,30,5,25,1,1,0,2,1,1,6,0,6,0,0,0,0,0,0,20,3,17,1,0,1,0,0,0,0,0,0
450067,10000,100,0,1,13,2,11,0,0,0,0,0,0,1,1,0,0,0,0,0,0,0,11,1,10,1,0,1,0,0,0,0,0,0
450128,10000,100,0,1,9,1,8,0,0,0,0,0,0,1,0,1,0,0,0,0,0,0,8,1,7,0,0,0,0,0,0,0,0,0
450304,10000,100,0,1,4,2,2,0,0,0,0,0,0,1,1,0,0,0,0,0,0,0,3,1,2,0,0,0,0,0,0,0,0,0
450571,10000,100,0,1,7,1,6,0,0,0,0,0,0,0,0,0,0,0,0,0,0,0,7,1,6,0,0,0,0,0,0,0,0,0
450696,10000,100,0,1,13,2,11,0,0,0,2,0,2,2,1,1,5,1,4,0,0,0,4,0,4,0,0,0,0,0,0,0,0,0
450702,10000,100,0,1,7,3,4,0,0,0,0,0,0,1,1,0,2,2,0,0,0,0,3,0,3,0,0,0,1,0,1,0,0,0
450933,10000,100,0,1,56,11,45,2,1,1,0,0,0,6,0,6,2,0,2,0,0,0,36,7,29,2,1,1,8,2,6,0,0,0
451103,10000,100,0,1,24,6,18,0,0,0,0,0,0,2,0,2,22,6,16,0,0,0,0,0,0,0,0,0,0,0,0,0,0,0
451228,10000,100,0,1,1,1,0,0,0,0,0,0,0,0,0,0,0,0,0,0,0,0,1,1,0,0,0,0,0,0,0,0,0,0
451404,10000,100,0,1,6,6,0,0,0,0,0,0,0,0,0,0,0,0,0,0,0,0,6,6,0,0,0,0,0,0,0,0,0,0
451477,10000,100,0,1,18,11,7,0,0,0,0,0,0,3,1,2,2,1,1,1,1,0,10,7,3,2,1,1,0,0,0,0,0,0
451510,10000,100,0,1,6,3,3,0,0,0,0,0,0,2,0,2,0,0,0,0,0,0,4,3,1,0,0,0,0,0,0,0,0,0
451556,10000,100,0,1,67,22,45,0,0,0,0,0,0,1,0,1,62,20,42,0,0,0,4,2,2,0,0,0,0,0,0,0,0,0
451741,10000,100,0,1,1,0,1,0,0,0,0,0,0,0,0,0,1,0,1,0,0,0,0,0,0,0,0,0,0,0,0,0,0,0
451750,10000,100,0,1,25,7,18,0,0,0,3,0,3,3,2,1,2,2,0,0,0,0,17,3,14,0,0,0,0,0,0,0,0,0
451866,10000,100,0,1,7,1,6,0,0,0,0,0,0,5,1,4,0,0,0,0,0,0,2,0,2,0,0,0,0,0,0,0,0,0
451927,10000,100,0,1,11,6,5,0,0,0,0,0,0,0,0,0,0,0,0,0,0,0,11,6,5,0,0,0,0,0,0,0,0,0
452124,10000,100,0,1,9,1,8,0,0,0,0,0,0,2,0,2,0,0,0,0,0,0,7,1,6,0,0,0,0,0,0,0,0,0
452373,10000,100,0,1,5,1,4,0,0,0,0,0,0,3,0,3,0,0,0,0,0,0,2,1,1,0,0,0,0,0,0,0,0,0
452948,10000,100,0,1,10,1,9,0,0,0,0,0,0,1,0,1,0,0,0,0,0,0,8,1,7,0,0,0,1,0,1,0,0,0
454184,10000,100,0,1,16,6,10,1,0,1,1,0,1,5,1,4,2,1,1,0,0,0,3,2,1,1,1,0,3,1,2,0,0,0
454218,10000,100,0,1,381,85,296,0,0,0,22,10,12,74,8,66,41,11,30,0,0,0,186,39,147,14,4,10,44,13,31,0,0,0
454698,10000,100,0,1,14,2,12,0,0,0,0,0,0,1,0,1,10,1,9,0,0,0,3,1,2,0,0,0,0,0,0,0,0,0
454786,10000,100,0,1,8,3,5,0,0,0,0,0,0,4,1,3,1,0,1,0,0,0,3,2,1,0,0,0,0,0,0,0,0,0
454810,10000,100,0,1,229,76,153,2,0,2,7,0,7,58,14,44,18,8,10,2,0,2,119,46,73,17,6,11,6,2,4,0,0,0
454829,10000,100,0,1,44,11,33,3,1,2,2,1,1,5,2,3,7,2,5,0,0,0,24,4,20,1,0,1,2,1,1,0,0,0
454856,10000,100,0,1,8,0,8,0,0,0,0,0,0,0,0,0,1,0,1,0,0,0,7,0,7,0,0,0,0,0,0,0,0,0
455114,10000,100,0,1,67,38,29,0,0,0,2,1,1,0,0,0,8,5,3,1,1,0,54,29,25,0,0,0,2,2,0,0,0,0
455196,10000,100,0,1,48,13,35,0,0,0,1,1,0,20,3,17,3,0,3,0,0,0,23,8,15,1,1,0,0,0,0,0,0,0
455257,10000,100,0,1,2,2,0,0,0,0,0,0,0,0,0,0,0,0,0,0,0,0,2,2,0,0,0,0,0,0,0,0,0,0
455336,10000,100,0,1,1,1,0,0,0,0,0,0,0,0,0,0,0,0,0,1,1,0,0,0,0,0,0,0,0,0,0,0,0,0
455406,10000,100,0,1,27,5,22,0,0,0,2,0,2,1,0,1,7,1,6,0,0,0,15,3,12,1,1,0,1,0,1,0,0,0
455433,10000,100,0,1,4,1,3,0,0,0,0,0,0,0,0,0,1,0,1,0,0,0,1,0,1,2,1,1,0,0,0,0,0,0
455479,10000,100,0,1,5,1,4,0,0,0,0,0,0,0,0,0,1,0,1,0,0,0,4,1,3,0,0,0,0,0,0,0,0,0
455512,10000,100,0,1,1,0,1,0,0,0,0,0,0,0,0,0,0,0,0,0,0,0,1,0,1,0,0,0,0,0,0,0,0,0
455628,10000,100,0,1,11,5,6,0,0,0,0,0,0,9,4,5,0,0,0,0,0,0,1,1,0,0,0,0,1,0,1,0,0,0
455664,10000,100,0,1,42,14,28,0,0,0,2,0,2,8,1,7,5,2,3,0,0,0,21,7,14,6,4,2,0,0,0,0,0,0
455770,10000,100,0,1,6,6,0,0,0,0,1,1,0,0,0,0,0,0,0,0,0,0,4,4,0,0,0,0,1,1,0,0,0,0
455804,10000,100,0,1,7,3,4,0,0,0,0,0,0,1,0,1,1,0,1,0,0,0,5,3,2,0,0,0,0,0,0,0,0,0
455813,10000,100,0,1,1,0,1,0,0,0,0,0,0,0,0,0,0,0,0,0,0,0,1,0,1,0,0,0,0,0,0,0,0,0
455983,10000,100,0,1,4,0,4,0,0,0,2,0,2,1,0,1,1,0,1,0,0,0,0,0,0,0,0,0,0,0,0,0,0,0
455992,10000,100,0,1,9,6,3,1,0,1,1,1,0,1,1,0,0,0,0,0,0,0,4,3,1,1,1,0,1,0,1,0,0,0
456038,10000,100,0,1,4,0,4,0,0,0,0,0,0,0,0,0,3,0,3,0,0,0,1,0,1,0,0,0,0,0,0,0,0,0
456205,10000,100,0,1,11,2,9,0,0,0,0,0,0,5,0,5,1,0,1,0,0,0,5,2,3,0,0,0,0,0,0,0,0,0
456214,10000,100,0,1,13,6,7,0,0,0,0,0,0,1,0,1,7,3,4,0,0,0,5,3,2,0,0,0,0,0,0,0,0,0
456454,10000,100,0,1,7,3,4,0,0,0,0,0,0,0,0,0,0,0,0,0,0,0,7,3,4,0,0,0,0,0,0,0,0,0
456490,10000,100,0,1,4,2,2,0,0,0,0,0,0,0,0,0,4,2,2,0,0,0,0,0,0,0,0,0,0,0,0,0,0,0
456542,10000,100,0,1,13,4,9,0,0,0,0,0,0,2,0,2,0,0,0,0,0,0,10,4,6,1,0,1,0,0,0,0,0,0
456579,10000,100,0,1,3,1,2,0,0,0,0,0,0,0,0,0,1,0,1,0,0,0,2,1,1,0,0,0,0,0,0,0,0,0
456852,10000,100,0,1,11,5,6,0,0,0,0,0,0,4,2,2,5,2,3,0,0,0,1,0,1,1,1,0,0,0,0,0,0,0
456959,10000,100,0,1,6,1,5,0,0,0,1,0,1,1,0,1,2,1,1,0,0,0,1,0,1,1,0,1,0,0,0,0,0,0
457086,10000,100,0,1,2,1,1,0,0,0,1,1,0,0,0,0,0,0,0,0,0,0,0,0,0,0,0,0,1,0,1,0,0,0
457101,10000,100,0,1,20,6,14,0,0,0,1,1,0,5,1,4,5,3,2,0,0,0,7,0,7,1,1,0,1,0,1,0,0,0
457110,10000,100,0,1,10,3,7,0,0,0,0,0,0,0,0,0,1,1,0,0,0,0,8,1,7,0,0,0,1,1,0,0,0,0
457299,10000,100,0,1,15,2,13,0,0,0,10,1,9,0,0,0,5,1,4,0,0,0,0,0,0,0,0,0,0,0,0,0,0,0
457402,10000,100,0,1,1,0,1,0,0,0,0,0,0,1,0,1,0,0,0,0,0,0,0,0,0,0,0,0,0,0,0,0,0,0
457527,10000,100,0,1,5,1,4,0,0,0,0,0,0,0,0,0,2,1,1,0,0,0,3,0,3,0,0,0,0,0,0,0,0,0
457536,10000,100,0,1,10,1,9,0,0,0,0,0,0,3,0,3,4,0,4,0,0,0,2,1,1,1,0,1,0,0,0,0,0,0
458210,10000,100,0,1,35,8,27,0,0,0,8,1,7,2,0,2,9,2,7,0,0,0,15,5,10,0,0,0,1,0,1,0,0,0
458229,10000,100,0,1,21,4,17,0,0,0,3,1,2,0,0,0,8,3,5,0,0,0,8,0,8,0,0,0,2,0,2,0,0,0
458405,10000,100,0,1,6,3,3,0,0,0,0,0,0,3,2,1,1,1,0,0,0,0,1,0,1,1,0,1,0,0,0,0,0,0
458441,10000,100,0,1,5,2,3,0,0,0,0,0,0,5,2,3,0,0,0,0,0,0,0,0,0,0,0,0,0,0,0,0,0,0
458681,10000,100,0,1,9,2,7,0,0,0,0,0,0,4,1,3,0,0,0,0,0,0,5,1,4,0,0,0,0,0,0,0,0,0
458982,10000,100,0,1,2,2,0,0,0,0,0,0,0,1,1,0,0,0,0,0,0,0,1,1,0,0,0,0,0,0,0,0,0,0
459204,10000,100,0,1,42,6,36,0,0,0,15,2,13,6,0,6,5,0,5,0,0,0,14,4,10,2,0,2,0,0,0,0,0,0
459213,10000,100,0,1,59,15,44,0,0,0,10,3,7,9,1,8,5,0,5,1,0,1,19,5,14,3,1,2,12,5,7,0,0,0
459259,10000,100,0,1,12,2,10,0,0,0,3,1,2,2,0,2,2,1,1,0,0,0,5,0,5,0,0,0,0,0,0,0,0,0
459268,10000,100,0,1,10,2,8,0,0,0,0,0,0,4,0,4,1,1,0,0,0,0,5,1,4,0,0,0,0,0,0,0,0,0
459727,10000,100,0,1,5,2,3,0,0,0,1,1,0,2,0,2,0,0,0,0,0,0,2,1,1,0,0,0,0,0,0,0,0,0
459736,10000,100,0,1,31,11,20,0,0,0,6,2,4,3,2,1,6,3,3,2,0,2,12,4,8,2,0,2,0,0,0,0,0,0
459745,10000,100,0,1,8,0,8,0,0,0,1,0,1,2,0,2,0,0,0,0,0,0,4,0,4,0,0,0,1,0,1,0,0,0
459824,10000,100,0,1,46,13,33,0,0,0,3,1,2,7,2,5,5,2,3,2,0,2,26,7,19,3,1,2,0,0,0,0,0,0
459842,10000,100,0,1,10,2,8,0,0,0,0,0,0,1,0,1,0,0,0,0,0,0,8,2,6,0,0,0,1,0,1,0,0,0
459851,10000,100,0,1,14,4,10,0,0,0,0,0,0,0,0,0,1,0,1,0,0,0,12,4,8,1,0,1,0,0,0,0,0,0
459949,10000,100,0,1,123,55,68,0,0,0,5,3,2,11,5,6,61,27,34,0,0,0,37,18,19,1,0,1,6,1,5,2,1,1
459958,10000,100,0,1,3,1,2,0,0,0,0,0,0,2,0,2,1,1,0,0,0,0,0,0,0,0,0,0,0,0,0,0,0,0
460020,10000,100,0,1,6,3,3,0,0,0,0,0,0,5,2,3,0,0,0,0,0,0,1,1,0,0,0,0,0,0,0,0,0,0
460136,10000,100,0,1,17,2,15,0,0,0,0,0,0,4,1,3,8,1,7,0,0,0,2,0,2,3,0,3,0,0,0,0,0,0
460181,10000,100,0,1,9,2,7,0,0,0,0,0,0,3,0,3,3,2,1,0,0,0,3,0,3,0,0,0,0,0,0,0,0,0
460190,10000,100,0,1,6,3,3,0,0,0,0,0,0,4,1,3,1,1,0,0,0,0,1,1,0,0,0,0,0,0,0,0,0,0
460206,10000,100,0,1,13,3,10,0,0,0,0,0,0,2,0,2,7,3,4,0,0,0,4,0,4,0,0,0,0,0,0,0,0,0
460349,10000,100,0,1,17,6,11,0,0,0,1,0,1,0,0,0,2,0,2,0,0,0,12,6,6,0,0,0,0,0,0,2,0,2
460376,10000,100,0,1,23,9,14,0,0,0,1,0,1,6,3,3,1,0,1,0,0,0,13,5,8,2,1,1,0,0,0,0,0,0
460394,10000,100,0,1,15,9,6,0,0,0,1,1,0,3,1,2,6,4,2,0,0,0,4,2,2,0,0,0,0,0,0,1,1,0
460464,10000,100,0,1,6,4,2,1,1,0,0,0,0,0,0,0,3,2,1,0,0,0,1,0,1,0,0,0,0,0,0,1,1,0
460543,10000,100,0,1,10,5,5,0,0,0,1,0,1,1,0,1,0,0,0,0,0,0,7,4,3,1,1,0,0,0,0,0,0,0
460677,10000,100,0,1,3,0,3,0,0,0,0,0,0,0,0,0,3,0,3,0,0,0,0,0,0,0,0,0,0,0,0,0,0,0
460738,10000,100,0,1,10,3,7,0,0,0,0,0,0,0,0,0,0,0,0,0,0,0,8,2,6,0,0,0,2,1,1,0,0,0
460756,10000,100,0,1,10,3,7,0,0,0,3,1,2,0,0,0,2,0,2,0,0,0,1,1,0,2,1,1,2,0,2,0,0,0
460817,10000,100,0,1,6,1,5,0,0,0,0,0,0,1,0,1,1,0,1,0,0,0,3,0,3,1,1,0,0,0,0,0,0,0
460826,10000,100,0,1,11,3,8,0,0,0,0,0,0,8,2,6,1,0,1,0,0,0,2,1,1,0,0,0,0,0,0,0,0,0
460835,10000,100,0,1,4,1,3,0,0,0,0,0,0,0,0,0,0,0,0,0,0,0,4,1,3,0,0,0,0,0,0,0,0,0
461014,10000,100,0,1,18,5,13,0,0,0,1,1,0,11,2,9,1,0,1,0,0,0,4,2,2,1,0,1,0,0,0,0,0,0
461148,10000,100,0,1,32,11,21,0,0,0,4,0,4,7,4,3,12,2,10,0,0,0,9,5,4,0,0,0,0,0,0,0,0,0
461218,10000,100,0,1,11,3,8,0,0,0,0,0,0,3,0,3,0,0,0,0,0,0,7,3,4,0,0,0,1,0,1,0,0,0
461528,10000,100,0,1,3,1,2,0,0,0,0,0,0,0,0,0,1,0,1,0,0,0,1,1,0,1,0,1,0,0,0,0,0,0
461689,10000,100,0,1,8,3,5,0,0,0,0,0,0,0,0,0,2,1,1,0,0,0,6,2,4,0,0,0,0,0,0,0,0,0
461795,10000,100,0,1,14,8,6,0,0,0,3,1,2,4,2,2,1,1,0,0,0,0,3,3,0,0,0,0,0,0,0,3,1,2
462354,10000,100,0,1,8,6,2,0,0,0,0,0,0,0,0,0,5,3,2,0,0,0,3,3,0,0,0,0,0,0,0,0,0,0
464226,10000,100,0,1,24,12,12,0,0,0,1,1,0,1,1,0,10,6,4,0,0,0,12,4,8,0,0,0,0,0,0,0,0,0
475033,10000,100,0,1,32,10,22,0,0,0,2,0,2,6,0,6,7,3,4,0,0,0,13,4,9,1,0,1,3,3,0,0,0,0
475121,10000,100,0,1,109,18,91,1,0,1,2,0,2,15,6,9,13,3,10,1,0,1,72,9,63,4,0,4,1,0,1,0,0,0
475176,10000,100,0,1,12,3,9,0,0,0,1,1,0,0,0,0,5,1,4,1,0,1,3,0,3,2,1,1,0,0,0,0,0,0
475273,10000,100,0,1,2,0,2,0,0,0,0,0,0,1,0,1,0,0,0,0,0,0,1,0,1,0,0,0,0,0,0,0,0,0
475398,10000,100,0,1,2,1,1,0,0,0,0,0,0,0,0,0,0,0,0,0,0,0,2,1,1,0,0,0,0,0,0,0,0,0
475495,10000,100,0,1,34,13,21,0,0,0,0,0,0,0,0,0,3,1,2,1,0,1,29,12,17,1,0,1,0,0,0,0,0,0
475565,10000,100,0,1,12,6,6,0,0,0,1,0,1,6,4,2,3,0,3,0,0,0,2,2,0,0,0,0,0,0,0,0,0,0
475608,10000,100,0,1,9,6,3,1,1,0,0,0,0,1,1,0,0,0,0,0,0,0,7,4,3,0,0,0,0,0,0,0,0,0
475714,10000,100,0,1,6,2,4,0,0,0,0,0,0,0,0,0,6,2,4,0,0,0,0,0,0,0,0,0,0,0,0,0,0,0
475839,10000,100,0,1,2,1,1,0,0,0,0,0,0,0,0,0,0,0,0,0,0,0,2,1,1,0,0,0,0,0,0,0,0,0
476717,10000,100,0,1,3,2,1,0,0,0,0,0,0,0,0,0,0,0,0,0,0,0,3,2,1,0,0,0,0,0,0,0,0,0
476726,10000,100,0,1,29,9,20,0,0,0,0,0,0,1,0,1,27,9,18,1,0,1,0,0,0,0,0,0,0,0,0,0,0,0
476975,10000,100,0,1,46,9,37,0,0,0,1,0,1,5,1,4,4,1,3,0,0,0,35,7,28,1,0,1,0,0,0,0,0,0
477039,10000,100,0,1,33,4,29,0,0,0,2,0,2,15,1,14,5,0,5,0,0,0,10,3,7,1,0,1,0,0,0,0,0,0
480073,10000,100,0,1,16,4,12,0,0,0,1,1,0,7,2,5,2,0,2,1,0,1,5,1,4,0,0,0,0,0,0,0,0,0
480091,10000,100,0,1,77,27,50,1,0,1,2,1,1,2,1,1,5,3,2,0,0,0,64,21,43,3,1,2,0,0,0,0,0,0
480204,10000,100,0,1,11,2,9,0,0,0,1,1,0,1,0,1,6,1,5,0,0,0,3,0,3,0,0,0,0,0,0,0,0,0
480657,10000,100,0,1,4,0,4,0,0,0,0,0,0,0,0,0,0,0,0,0,0,0,4,0,4,0,0,0,0,0,0,0,0,0
480790,10000,100,0,1,49,13,36,0,0,0,3,1,2,5,3,2,4,1,3,0,0,0,37,8,29,0,0,0,0,0,0,0,0,0
480824,10000,100,0,1,6,0,6,0,0,0,0,0,0,2,0,2,1,0,1,0,0,0,3,0,3,0,0,0,0,0,0,0,0,0
480833,10000,100,0,1,15,4,11,0,0,0,0,0,0,5,1,4,4,3,1,0,0,0,5,0,5,1,0,1,0,0,0,0,0,0
480967,10000,100,0,1,10,4,6,8,2,6,0,0,0,0,0,0,0,0,0,0,0,0,2,2,0,0,0,0,0,0,0,0,0,0
481030,10000,100,0,1,5,2,3,0,0,0,0,0,0,0,0,0,0,0,0,0,0,0,5,2,3,0,0,0,0,0,0,0,0,0
481094,10000,100,0,1,8,3,5,0,0,0,1,1,0,0,0,0,1,0,1,0,0,0,3,0,3,0,0,0,3,2,1,0,0,0
481225,10000,100,0,1,1,0,1,0,0,0,0,0,0,1,0,1,0,0,0,0,0,0,0,0,0,0,0,0,0,0,0,0,0,0
481535,10000,100,0,1,91,32,59,0,0,0,15,4,11,2,1,1,15,8,7,0,0,0,33,14,19,4,1,3,0,0,0,22,4,18
481775,10000,100,0,1,9,3,6,0,0,0,1,1,0,2,1,1,5,1,4,0,0,0,1,0,1,0,0,0,0,0,0,0,0,0
482149,10000,100,0,1,551,232,319,2,1,1,55,26,29,118,22,96,36,16,20,0,0,0,268,128,140,9,5,4,16,10,6,47,24,23
482158,10000,100,0,1,74,28,46,0,0,0,4,3,1,17,5,12,3,0,3,0,0,0,49,19,30,0,0,0,1,1,0,0,0,0
482413,10000,100,0,1,4,0,4,0,0,0,1,0,1,1,0,1,1,0,1,0,0,0,0,0,0,0,0,0,1,0,1,0,0,0
482422,10000,100,0,1,4,1,3,0,0,0,0,0,0,1,0,1,0,0,0,0,0,0,2,1,1,0,0,0,1,0,1,0,0,0
482431,10000,100,0,1,13,2,11,1,0,1,2,0,2,1,0,1,3,2,1,0,0,0,3,0,3,0,0,0,3,0,3,0,0,0
482459,10000,100,0,1,10,3,7,0,0,0,0,0,0,3,1,2,2,1,1,0,0,0,5,1,4,0,0,0,0,0,0,0,0,0
482468,10000,100,0,1,13,2,11,0,0,0,0,0,0,11,2,9,0,0,0,1,0,1,1,0,1,0,0,0,0,0,0,0,0,0
482477,10000,100,0,1,27,8,19,0,0,0,1,0,1,10,2,8,2,1,1,0,0,0,12,4,8,1,1,0,1,0,1,0,0,0
482556,10000,100,0,1,3,0,3,0,0,0,0,0,0,2,0,2,0,0,0,0,0,0,1,0,1,0,0,0,0,0,0,0,0,0
482574,10000,100,0,1,4,2,2,0,0,0,0,0,0,2,0,2,0,0,0,0,0,0,2,2,0,0,0,0,0,0,0,0,0,0
482608,10000,100,0,1,9,0,9,0,0,0,0,0,0,2,0,2,2,0,2,0,0,0,3,0,3,0,0,0,2,0,2,0,0,0
482635,10000,100,0,1,7,1,6,1,0,1,0,0,0,2,0,2,1,0,1,0,0,0,3,1,2,0,0,0,0,0,0,0,0,0
482653,10000,100,0,1,2,1,1,0,0,0,0,0,0,1,0,1,0,0,0,0,0,0,1,1,0,0,0,0,0,0,0,0,0,0
482680,10000,100,0,1,121,53,68,0,0,0,4,4,0,14,3,11,7,1,6,0,0,0,88,40,48,1,0,1,6,4,2,1,1,0
482699,10000,100,0,1,10,3,7,0,0,0,0,0,0,0,0,0,0,0,0,0,0,0,9,3,6,1,0,1,0,0,0,0,0,0
482705,10000,100,0,1,20,8,12,0,0,0,1,0,1,3,2,1,1,0,1,0,0,0,6,2,4,0,0,0,7,3,4,2,1,1
482936,10000,100,0,1,33,18,15,0,0,0,2,1,1,1,1,0,2,0,2,0,0,0,24,12,12,0,0,0,0,0,0,4,4,0
482990,10000,100,0,1,5,3,2,0,0,0,0,0,0,2,2,0,0,0,0,0,0,0,3,1,2,0,0,0,0,0,0,0,0,0
483018,10000,100,0,1,14,5,9,0,0,0,0,0,0,1,0,1,0,0,0,0,0,0,11,4,7,2,1,1,0,0,0,0,0,0
483036,10000,100,0,1,31,12,19,0,0,0,1,0,1,9,1,8,5,3,2,1,0,1,9,4,5,2,1,1,0,0,0,4,3,1
483045,10000,100,0,1,72,31,41,0,0,0,1,1,0,38,13,25,0,0,0,1,1,0,32,16,16,0,0,0,0,0,0,0,0,0
483124,10000,100,0,1,159,60,99,1,0,1,6,3,3,6,3,3,24,8,16,0,0,0,61,25,36,4,0,4,46,16,30,11,5,6
483212,10000,100,0,1,51,23,28,0,0,0,0,0,0,18,8,10,1,0,1,0,0,0,29,12,17,2,2,0,0,0,0,1,1,0
483595,10000,100,0,1,32,15,17,0,0,0,0,0,0,0,0,0,31,15,16,0,0,0,1,0,1,0,0,0,0,0,0,0,0,0
483647,10000,100,0,1,15,2,13,0,0,0,0,0,0,0,0,0,0,0,0,0,0,0,15,2,13,0,0,0,0,0,0,0,0,0
483975,10000,100,0,1,8,5,3,0,0,0,0,0,0,1,1,0,0,0,0,0,0,0,7,4,3,0,0,0,0,0,0,0,0,0
484002,10000,100,0,1,33,9,24,1,1,0,6,1,5,2,0,2,11,3,8,1,0,1,11,4,7,1,0,1,0,0,0,0,0,0
484066,10000,100,0,1,26,3,23,0,0,0,0,0,0,4,2,2,0,0,0,0,0,0,22,1,21,0,0,0,0,0,0,0,0,0
484473,10000,100,0,1,4,1,3,0,0,0,0,0,0,0,0,0,0,0,0,0,0,0,3,1,2,0,0,0,1,0,1,0,0,0
484613,10000,100,0,1,241,93,148,3,0,3,8,5,3,20,9,11,6,1,5,0,0,0,112,38,74,24,11,13,49,14,35,19,15,4
484835,10000,100,0,1,2,1,1,0,0,0,0,0,0,0,0,0,2,1,1,0,0,0,0,0,0,0,0,0,0,0,0,0,0,0
484844,10000,100,0,1,21,8,13,0,0,0,3,0,3,0,0,0,0,0,0,0,0,0,6,2,4,0,0,0,0,0,0,12,6,6
484905,10000,100,0,1,53,20,33,0,0,0,1,1,0,14,5,9,7,4,3,0,0,0,25,10,15,3,0,3,3,0,3,0,0,0
484932,10000,100,0,1,2,1,1,0,0,0,0,0,0,0,0,0,0,0,0,0,0,0,2,1,1,0,0,0,0,0,0,0,0,0
485111,10000,100,0,1,33,10,23,0,0,0,0,0,0,8,3,5,0,0,0,0,0,0,24,7,17,0,0,0,1,0,1,0,0,0
485272,10000,100,0,1,13,7,6,0,0,0,0,0,0,3,2,1,7,5,2,0,0,0,3,0,3,0,0,0,0,0,0,0,0,0
485458,10000,100,0,1,38,19,19,0,0,0,2,1,1,5,1,4,0,0,0,0,0,0,31,17,14,0,0,0,0,0,0,0,0,0
485467,10000,100,0,1,5,1,4,0,0,0,1,0,1,0,0,0,1,0,1,0,0,0,2,0,2,1,1,0,0,0,0,0,0,0
485519,10000,100,0,1,2,2,0,0,0,0,0,0,0,0,0,0,0,0,0,0,0,0,2,2,0,0,0,0,0,0,0,0,0,0
485546,10000,100,0,1,6,2,4,0,0,0,0,0,0,1,0,1,1,0,1,0,0,0,4,2,2,0,0,0,0,0,0,0,0,0
485698,10000,100,0,1,5,4,1,0,0,0,0,0,0,1,1,0,0,0,0,0,0,0,4,3,1,0,0,0,0,0,0,0,0,0
485768,10000,100,0,1,24,13,11,0,0,0,0,0,0,2,1,1,19,11,8,0,0,0,3,1,2,0,0,0,0,0,0,0,0,0
486053,10000,100,0,1,4,2,2,0,0,0,0,0,0,0,0,0,0,0,0,0,0,0,4,2,2,0,0,0,0,0,0,0,0,0
486196,10000,100,0,1,1,1,0,0,0,0,0,0,0,0,0,0,1,1,0,0,0,0,0,0,0,0,0,0,0,0,0,0,0,0
486239,10000,100,0,1,2,1,1,0,0,0,0,0,0,0,0,0,2,1,1,0,0,0,0,0,0,0,0,0,0,0,0,0,0,0
486257,10000,100,0,1,2,1,1,0,0,0,0,0,0,2,1,1,0,0,0,0,0,0,0,0,0,0,0,0,0,0,0,0,0,0
486284,10000,100,0,1,17,8,9,0,0,0,0,0,0,1,0,1,0,0,0,0,0,0,16,8,8,0,0,0,0,0,0,0,0,0
486424,10000,100,0,1,5,1,4,0,0,0,0,0,0,5,1,4,0,0,0,0,0,0,0,0,0,0,0,0,0,0,0,0,0,0
486433,10000,100,0,1,1,0,1,0,0,0,0,0,0,0,0,0,0,0,0,0,0,0,1,0,1,0,0,0,0,0,0,0,0,0
486813,10000,100,0,1,9,2,7,0,0,0,0,0,0,0,0,0,7,1,6,0,0,0,2,1,1,0,0,0,0,0,0,0,0,0
486822,10000,100,0,1,22,6,16,0,0,0,0,0,0,0,0,0,6,2,4,0,0,0,16,4,12,0,0,0,0,0,0,0,0,0
486840,10000,100,0,1,453,195,258,2,0,2,30,13,17,100,38,62,36,19,17,2,0,2,247,105,142,6,4,2,12,8,4,18,8,10
486901,10000,100,0,1,31,15,16,0,0,0,0,0,0,3,0,3,0,0,0,0,0,0,28,15,13,0,0,0,0,0,0,0,0,0
487010,10000,100,0,1,819,393,426,0,0,0,67,30,37,131,40,91,37,18,19,0,0,0,448,229,219,10,7,3,2,1,1,124,68,56
487092,10000,100,0,1,27,11,16,0,0,0,1,1,0,13,6,7,1,0,1,0,0,0,11,3,8,1,1,0,0,0,0,0,0,0
487162,10000,100,0,1,39,15,24,0,0,0,0,0,0,8,3,5,0,0,0,0,0,0,31,12,19,0,0,0,0,0,0,0,0,0
487302,10000,100,0,1,7,1,6,0,0,0,0,0,0,2,0,2,0,0,0,0,0,0,5,1,4,0,0,0,0,0,0,0,0,0
487320,10000,100,0,1,209,112,97,0,0,0,10,2,8,15,7,8,63,33,30,1,0,1,112,67,45,0,0,0,8,3,5,0,0,0
487375,10000,100,0,1,20,8,12,1,1,0,2,1,1,3,0,3,3,1,2,0,0,0,10,5,5,1,0,1,0,0,0,0,0,0
487384,10000,100,0,1,12,4,8,0,0,0,0,0,0,5,2,3,0,0,0,0,0,0,1,0,1,4,1,3,2,1,1,0,0,0
487393,10000,100,0,1,20,5,15,0,0,0,0,0,0,12,4,8,4,1,3,0,0,0,1,0,1,2,0,2,1,0,1,0,0,0
487409,10000,100,0,1,20,8,12,0,0,0,0,0,0,8,5,3,9,2,7,0,0,0,2,1,1,0,0,0,1,0,1,0,0,0
487418,10000,100,0,1,18,6,12,0,0,0,0,0,0,8,0,8,3,1,2,0,0,0,4,3,1,1,0,1,2,2,0,0,0,0
487427,10000,100,0,1,21,3,18,1,0,1,0,0,0,4,1,3,3,0,3,0,0,0,10,2,8,2,0,2,1,0,1,0,0,0
487445,10000,100,0,1,5,2,3,0,0,0,0,0,0,1,0,1,1,1,0,0,0,0,1,1,0,2,0,2,0,0,0,0,0,0
487454,10000,100,0,1,11,2,9,0,0,0,2,0,2,2,1,1,5,1,4,0,0,0,1,0,1,1,0,1,0,0,0,0,0,0
487472,10000,100,0,1,28,14,14,0,0,0,1,1,0,10,4,6,11,6,5,0,0,0,4,2,2,1,0,1,1,1,0,0,0,0
487490,10000,100,0,1,3,1,2,0,0,0,0,0,0,1,0,1,1,0,1,0,0,0,0,0,0,0,0,0,1,1,0,0,0,0
487524,10000,100,0,1,53,29,24,0,0,0,1,1,0,2,2,0,0,0,0,0,0,0,49,25,24,0,0,0,1,1,0,0,0,0
487588,10000,100,0,1,8,2,6,0,0,0,0,0,0,7,2,5,0,0,0,0,0,0,1,0,1,0,0,0,0,0,0,0,0,0
487597,10000,100,0,1,29,17,12,0,0,0,1,0,1,2,1,1,13,7,6,2,1,1,9,7,2,1,0,1,1,1,0,0,0,0
487603,10000,100,0,1,4,1,3,0,0,0,1,0,1,0,0,0,1,0,1,0,0,0,1,1,0,1,0,1,0,0,0,0,0,0
487649,10000,100,0,1,5,1,4,0,0,0,0,0,0,0,0,0,4,1,3,0,0,0,1,0,1,0,0,0,0,0,0,0,0,0
487861,10000,100,0,1,8,4,4,0,0,0,0,0,0,4,2,2,0,0,0,0,0,0,4,2,2,0,0,0,0,0,0,0,0,0
487977,10000,100,0,1,24,1,23,0,0,0,0,0,0,4,0,4,2,0,2,0,0,0,18,1,17,0,0,0,0,0,0,0,0,0
488077,10000,100,0,1,72,31,41,0,0,0,2,1,1,3,0,3,5,2,3,0,0,0,21,7,14,3,3,0,38,18,20,0,0,0
488305,10000,100,0,1,8,4,4,0,0,0,0,0,0,0,0,0,0,0,0,0,0,0,8,4,4,0,0,0,0,0,0,0,0,0
488387,10000,100,0,1,4,1,3,0,0,0,0,0,0,1,0,1,1,0,1,0,0,0,2,1,1,0,0,0,0,0,0,0,0,0
488527,10000,100,0,1,40,16,24,0,0,0,4,2,2,2,1,1,3,1,2,0,0,0,27,11,16,0,0,0,3,1,2,1,0,1
488554,10000,100,0,1,12,4,8,0,0,0,0,0,0,0,0,0,5,1,4,0,0,0,7,3,4,0,0,0,0,0,0,0,0,0
488572,10000,100,0,1,28,11,17,0,0,0,10,6,4,2,1,1,7,1,6,0,0,0,8,2,6,1,1,0,0,0,0,0,0,0
488730,10000,100,0,1,17,8,9,0,0,0,0,0,0,1,0,1,9,3,6,0,0,0,7,5,2,0,0,0,0,0,0,0,0,0
488785,10000,100,0,1,5,1,4,0,0,0,0,0,0,0,0,0,2,1,1,0,0,0,3,0,3,0,0,0,0,0,0,0,0,0
488846,10000,100,0,1,15,4,11,0,0,0,1,0,1,3,0,3,0,0,0,0,0,0,3,0,3,0,0,0,8,4,4,0,0,0
489201,10000,100,0,1,9,5,4,0,0,0,1,0,1,1,1,0,1,0,1,0,0,0,5,4,1,0,0,0,1,0,1,0,0,0
489283,10000,100,0,1,16,5,11,0,0,0,0,0,0,0,0,0,14,4,10,0,0,0,2,1,1,0,0,0,0,0,0,0,0,0
489779,10000,100,0,1,55,17,38,0,0,0,2,1,1,7,3,4,7,4,3,1,0,1,35,8,27,1,0,1,2,1,1,0,0,0
489858,10000,100,0,1,11,3,8,0,0,0,5,1,4,1,0,1,2,0,2,0,0,0,3,2,1,0,0,0,0,0,0,0,0,0
489937,10000,100,0,1,25,15,10,0,0,0,6,5,1,2,0,2,3,2,1,0,0,0,14,8,6,0,0,0,0,0,0,0,0,0
490106,10000,100,0,1,5,2,3,0,0,0,5,2,3,0,0,0,0,0,0,0,0,0,0,0,0,0,0,0,0,0,0,0,0,0
490133,10000,100,0,1,54,25,29,0,0,0,6,1,5,6,3,3,8,6,2,0,0,0,17,6,11,6,4,2,11,5,6,0,0,0
490373,10000,100,0,1,167,66,101,0,0,0,11,9,2,4,0,4,10,4,6,0,0,0,83,36,47,7,3,4,27,6,21,25,8,17
490559,10000,100,0,1,5,2,3,0,0,0,0,0,0,3,1,2,1,0,1,0,0,0,1,1,0,0,0,0,0,0,0,0,0,0
490805,10000,100,0,1,46,20,26,0,0,0,0,0,0,8,2,6,6,2,4,0,0,0,27,13,14,1,0,1,1,1,0,3,2,1
490878,10000,100,0,1,8,2,6,0,0,0,0,0,0,0,0,0,3,1,2,0,0,0,5,1,4,0,0,0,0,0,0,0,0,0
490975,10000,100,0,1,6,2,4,0,0,0,2,1,1,0,0,0,4,1,3,0,0,0,0,0,0,0,0,0,0,0,0,0,0,0
491057,10000,100,0,1,3,2,1,0,0,0,0,0,0,0,0,0,0,0,0,0,0,0,3,2,1,0,0,0,0,0,0,0,0,0
491181,10000,100,0,1,4,1,3,0,0,0,0,0,0,0,0,0,0,0,0,0,0,0,4,1,3,0,0,0,0,0,0,0,0,0
491525,10000,100,0,1,10,4,6,0,0,0,0,0,0,0,0,0,3,0,3,0,0,0,7,4,3,0,0,0,0,0,0,0,0,0
491808,10000,100,0,1,8,2,6,0,0,0,1,0,1,2,1,1,0,0,0,0,0,0,5,1,4,0,0,0,0,0,0,0,0,0
491844,10000,100,0,1,15,9,6,12,6,6,1,1,0,0,0,0,0,0,0,0,0,0,2,2,0,0,0,0,0,0,0,0,0,0
492263,10000,100,0,1,40,15,25,0,0,0,1,1,0,3,1,2,2,1,1,0,0,0,34,12,22,0,0,0,0,0,0,0,0,0
492449,10000,100,0,1,6,1,5,0,0,0,0,0,0,0,0,0,4,1,3,0,0,0,1,0,1,1,0,1,0,0,0,0,0,0
492476,10000,100,0,1,4,1,3,0,0,0,0,0,0,0,0,0,4,1,3,0,0,0,0,0,0,0,0,0,0,0,0,0,0,0
492607,10000,100,0,1,7,2,5,0,0,0,0,0,0,3,1,2,2,1,1,0,0,0,2,0,2,0,0,0,0,0,0,0,0,0
492689,10000,100,0,1,331,116,215,1,1,0,32,12,20,7,2,5,201,60,141,0,0,0,59,26,33,4,1,3,1,0,1,26,14,12
492722,10000,100,0,1,9,2,7,0,0,0,0,0,0,1,0,1,6,2,4,0,0,0,1,0,1,1,0,1,0,0,0,0,0,0
492801,10000,100,0,1,3,0,3,0,0,0,0,0,0,1,0,1,0,0,0,0,0,0,1,0,1,0,0,0,1,0,1,0,0,0
493080,10000,100,0,1,8,5,3,0,0,0,0,0,0,1,1,0,4,1,3,0,0,0,2,2,0,1,1,0,0,0,0,0,0,0
493646,10000,100,0,1,7,0,7,0,0,0,0,0,0,0,0,0,0,0,0,0,0,0,7,0,7,0,0,0,0,0,0,0,0,0
493822,10000,100,0,1,5,3,2,0,0,0,0,0,0,1,0,1,0,0,0,0,0,0,4,3,1,0,0,0,0,0,0,0,0,0
493895,10000,100,0,1,3,1,2,0,0,0,0,0,0,1,0,1,0,0,0,0,0,0,2,1,1,0,0,0,0,0,0,0,0,0
494010,10000,100,0,1,7,0,7,0,0,0,0,0,0,2,0,2,0,0,0,0,0,0,3,0,3,0,0,0,2,0,2,0,0,0
494162,10000,100,0,1,13,1,12,0,0,0,1,0,1,6,0,6,0,0,0,0,0,0,6,1,5,0,0,0,0,0,0,0,0,0
494250,10000,100,0,1,22,3,19,0,0,0,0,0,0,3,0,3,4,1,3,0,0,0,14,2,12,1,0,1,0,0,0,0,0,0
494278,10000,100,0,1,4,1,3,0,0,0,0,0,0,0,0,0,4,1,3,0,0,0,0,0,0,0,0,0,0,0,0,0,0,0
494287,10000,100,0,1,15,0,15,0,0,0,0,0,0,0,0,0,15,0,15,0,0,0,0,0,0,0,0,0,0,0,0,0,0,0
494436,10000,100,0,1,6,1,5,0,0,0,0,0,0,0,0,0,0,0,0,0,0,0,6,1,5,0,0,0,0,0,0,0,0,0
494588,10000,100,0,1,4,1,3,0,0,0,0,0,0,0,0,0,2,0,2,0,0,0,1,1,0,1,0,1,0,0,0,0,0,0
494603,10000,100,0,1,45,38,7,0,0,0,1,1,0,1,1,0,3,3,0,0,0,0,38,31,7,0,0,0,2,2,0,0,0,0
494746,10000,100,0,1,4,2,2,0,0,0,0,0,0,0,0,0,0,0,0,1,1,0,0,0,0,0,0,0,3,1,2,0,0,0
494755,10000,100,0,1,8,1,7,0,0,0,0,0,0,0,0,0,0,0,0,0,0,0,8,1,7,0,0,0,0,0,0,0,0,0
494843,10000,100,0,1,11,4,7,0,0,0,1,0,1,9,3,6,0,0,0,0,0,0,0,0,0,0,0,0,1,1,0,0,0,0
494852,10000,100,0,1,20,6,14,0,0,0,1,0,1,3,1,2,0,0,0,0,0,0,16,5,11,0,0,0,0,0,0,0,0,0
494959,10000,100,0,1,8,3,5,0,0,0,0,0,0,2,2,0,0,0,0,0,0,0,6,1,5,0,0,0,0,0,0,0,0,0
495192,10000,100,0,1,3,0,3,0,0,0,0,0,0,1,0,1,2,0,2,0,0,0,0,0,0,0,0,0,0,0,0,0,0,0
495314,10000,100,0,1,26,10,16,0,0,0,2,0,2,4,4,0,9,4,5,0,0,0,6,2,4,0,0,0,5,0,5,0,0,0
495420,10000,100,0,1,10,1,9,0,0,0,1,0,1,1,0,1,1,1,0,0,0,0,6,0,6,1,0,1,0,0,0,0,0,0
495439,10000,100,0,1,10,3,7,0,0,0,0,0,0,5,1,4,2,1,1,0,0,0,1,0,1,2,1,1,0,0,0,0,0,0
495448,10000,100,0,1,13,4,9,0,0,0,0,0,0,0,0,0,3,1,2,0,0,0,9,2,7,1,1,0,0,0,0,0,0,0
495457,10000,100,0,1,9,3,6,0,0,0,1,1,0,2,2,0,2,0,2,0,0,0,3,0,3,0,0,0,1,0,1,0,0,0
495767,10000,100,0,1,1371,628,743,1,1,0,125,62,63,86,38,48,81,35,46,0,0,0,890,382,508,33,12,21,25,12,13,130,86,44
496043,10000,100,0,1,19,8,11,0,0,0,5,1,4,1,1,0,7,3,4,0,0,0,6,3,3,0,0,0,0,0,0,0,0,0
496186,10000,100,0,1,19,7,12,0,0,0,3,0,3,1,0,1,4,1,3,1,1,0,4,1,3,0,0,0,6,4,2,0,0,0
496283,10000,100,0,1,6,3,3,0,0,0,0,0,0,0,0,0,0,0,0,0,0,0,6,3,3,0,0,0,0,0,0,0,0,0
496326,10000,100,0,1,12,1,11,0,0,0,1,1,0,1,0,1,0,0,0,0,0,0,9,0,9,0,0,0,1,0,1,0,0,0
496627,10000,100,0,1,27,12,15,0,0,0,8,5,3,2,0,2,2,1,1,0,0,0,9,4,5,4,0,4,2,2,0,0,0,0
496991,10000,100,0,1,19,3,16,0,0,0,1,0,1,12,1,11,2,0,2,0,0,0,2,1,1,2,1,1,0,0,0,0,0,0
497000,10000,100,0,1,8,4,4,0,0,0,0,0,0,0,0,0,1,1,0,0,0,0,7,3,4,0,0,0,0,0,0,0,0,0
497046,10000,100,0,1,4,2,2,0,0,0,1,1,0,0,0,0,2,0,2,0,0,0,1,1,0,0,0,0,0,0,0,0,0,0
497277,10000,100,0,1,12,1,11,0,0,0,0,0,0,4,1,3,1,0,1,0,0,0,3,0,3,3,0,3,1,0,1,0,0,0
497286,10000,100,0,1,10,7,3,0,0,0,0,0,0,0,0,0,3,1,2,0,0,0,6,6,0,1,0,1,0,0,0,0,0,0
100654,20000,200,0,2,19,10,9,0,0,0,1,1,0,6,3,3,0,0,0,0,0,0,10,5,5,0,0,0,1,1,0,1,0,1
100663,20000,200,0,2,177,102,75,1,1,0,23,19,4,15,6,9,4,2,2,0,0,0,99,47,52,4,3,1,0,0,0,31,24,7
100690,20000,200,0,2,3,3,0,0,0,0,0,0,0,0,0,0,0,0,0,0,0,0,3,3,0,0,0,0,0,0,0,0,0,0
100706,20000,200,0,2,22,6,16,0,0,0,2,1,1,1,0,1,2,0,2,0,0,0,16,4,12,0,0,0,0,0,0,1,1,0
100724,20000,200,0,2,14,9,5,0,0,0,3,2,1,8,5,3,0,0,0,0,0,0,1,1,0,0,0,0,2,1,1,0,0,0
100751,20000,200,0,2,163,83,80,0,0,0,14,9,5,13,5,8,3,1,2,0,0,0,96,49,47,3,1,2,1,0,1,33,18,15
100760,20000,200,0,2,5,2,3,0,0,0,0,0,0,1,1,0,0,0,0,0,0,0,4,1,3,0,0,0,0,0,0,0,0,0
100812,20000,200,0,2,6,4,2,0,0,0,3,2,1,0,0,0,0,0,0,0,0,0,3,2,1,0,0,0,0,0,0,0,0,0
100830,20000,200,0,2,18,8,10,0,0,0,1,0,1,0,0,0,0,0,0,0,0,0,6,4,2,0,0,0,7,0,7,4,4,0
100858,20000,200,0,2,85,41,44,0,0,0,3,1,2,5,0,5,0,0,0,1,1,0,56,28,28,1,1,0,0,0,0,19,10,9
100937,20000,200,0,2,10,4,6,0,0,0,2,1,1,2,2,0,0,0,0,0,0,0,6,1,5,0,0,0,0,0,0,0,0,0
101028,20000,200,0,2,2,0,2,0,0,0,0,0,0,0,0,0,0,0,0,0,0,0,2,0,2,0,0,0,0,0,0,0,0,0
101116,20000,200,0,2,1,1,0,0,0,0,0,0,0,0,0,0,0,0,0,0,0,0,1,1,0,0,0,0,0,0,0,0,0,0
101143,20000,200,0,2,8,7,1,0,0,0,1,1,0,1,1,0,0,0,0,0,0,0,6,5,1,0,0,0,0,0,0,0,0,0
101161,20000,200,0,2,15,8,7,1,1,0,0,0,0,2,1,1,0,0,0,0,0,0,12,6,6,0,0,0,0,0,0,0,0,0
101189,20000,200,0,2,15,4,11,1,0,1,0,0,0,2,1,1,0,0,0,0,0,0,12,3,9,0,0,0,0,0,0,0,0,0
101240,20000,200,0,2,8,6,2,0,0,0,0,0,0,1,1,0,1,0,1,0,0,0,6,5,1,0,0,0,0,0,0,0,0,0
101286,20000,200,0,2,10,5,5,0,0,0,0,0,0,0,0,0,0,0,0,0,0,0,10,5,5,0,0,0,0,0,0,0,0,0
101295,20000,200,0,2,13,9,4,0,0,0,0,0,0,1,0,1,1,1,0,0,0,0,11,8,3,0,0,0,0,0,0,0,0,0
101301,20000,200,0,2,5,2,3,0,0,0,0,0,0,2,0,2,0,0,0,0,0,0,1,1,0,0,0,0,2,1,1,0,0,0
101435,20000,200,0,2,5,4,1,0,0,0,0,0,0,2,1,1,0,0,0,0,0,0,0,0,0,0,0,0,3,3,0,0,0,0
101462,20000,200,0,2,4,0,4,0,0,0,0,0,0,3,0,3,0,0,0,0,0,0,1,0,1,0,0,0,0,0,0,0,0,0
101471,20000,200,0,2,6,4,2,0,0,0,0,0,0,3,1,2,0,0,0,0,0,0,3,3,0,0,0,0,0,0,0,0,0,0
101480,20000,200,0,2,37,13,24,0,0,0,2,1,1,3,1,2,1,0,1,0,0,0,27,9,18,0,0,0,0,0,0,4,2,2
101505,20000,200,0,2,9,3,6,0,0,0,0,0,0,2,1,1,0,0,0,0,0,0,7,2,5,0,0,0,0,0,0,0,0,0
101514,20000,200,0,2,10,2,8,0,0,0,0,0,0,0,0,0,0,0,0,0,0,0,10,2,8,0,0,0,0,0,0,0,0,0
101569,20000,200,0,2,7,5,2,0,0,0,0,0,0,4,2,2,0,0,0,0,0,0,3,3,0,0,0,0,0,0,0,0,0,0
101587,20000,200,0,2,10,2,8,0,0,0,1,0,1,0,0,0,0,0,0,0,0,0,4,0,4,0,0,0,3,0,3,2,2,0
101602,20000,200,0,2,6,4,2,0,0,0,0,0,0,0,0,0,0,0,0,0,0,0,6,4,2,0,0,0,0,0,0,0,0,0
101648,20000,200,0,2,2,2,0,0,0,0,0,0,0,0,0,0,0,0,0,0,0,0,2,2,0,0,0,0,0,0,0,0,0,0
101675,20000,200,0,2,12,3,9,0,0,0,0,0,0,7,2,5,0,0,0,0,0,0,5,1,4,0,0,0,0,0,0,0,0,0
101693,20000,200,0,2,4,2,2,0,0,0,0,0,0,0,0,0,0,0,0,0,0,0,4,2,2,0,0,0,0,0,0,0,0,0
101709,20000,200,0,2,13,4,9,1,0,1,1,1,0,3,0,3,0,0,0,0,0,0,7,2,5,0,0,0,0,0,0,1,1,0
101736,20000,200,0,2,2,1,1,0,0,0,0,0,0,1,0,1,0,0,0,0,0,0,1,1,0,0,0,0,0,0,0,0,0,0
101879,20000,200,0,2,25,16,9,0,0,0,2,2,0,4,1,3,1,1,0,0,0,0,18,12,6,0,0,0,0,0,0,0,0,0
101897,20000,200,0,2,2,2,0,0,0,0,0,0,0,0,0,0,0,0,0,0,0,0,2,2,0,0,0,0,0,0,0,0,0,0
101912,20000,200,0,2,4,2,2,0,0,0,0,0,0,4,2,2,0,0,0,0,0,0,0,0,0,0,0,0,0,0,0,0,0,0
102030,20000,200,0,2,4,1,3,0,0,0,0,0,0,1,0,1,0,0,0,0,0,0,2,1,1,0,0,0,1,0,1,0,0,0
102049,20000,200,0,2,24,8,16,0,0,0,0,0,0,2,0,2,1,0,1,0,0,0,21,8,13,0,0,0,0,0,0,0,0,0
102067,20000,200,0,2,14,4,10,0,0,0,0,0,0,6,3,3,0,0,0,0,0,0,8,1,7,0,0,0,0,0,0,0,0,0
102076,20000,200,0,2,9,7,2,0,0,0,0,0,0,0,0,0,0,0,0,0,0,0,9,7,2,0,0,0,0,0,0,0,0,0
102094,20000,200,0,2,84,46,38,0,0,0,20,14,6,6,1,5,1,0,1,0,0,0,53,31,22,3,0,3,1,0,1,0,0,0
102234,20000,200,0,2,12,1,11,0,0,0,0,0,0,1,0,1,0,0,0,0,0,0,11,1,10,0,0,0,0,0,0,0,0,0
102270,20000,200,0,2,5,2,3,0,0,0,0,0,0,5,2,3,0,0,0,0,0,0,0,0,0,0,0,0,0,0,0,0,0,0
102298,20000,200,0,2,3,1,2,0,0,0,0,0,0,3,1,2,0,0,0,0,0,0,0,0,0,0,0,0,0,0,0,0,0,0
102313,20000,200,0,2,4,1,3,0,0,0,0,0,0,4,1,3,0,0,0,0,0,0,0,0,0,0,0,0,0,0,0,0,0,0
102368,20000,200,0,2,24,11,13,0,0,0,0,0,0,0,0,0,0,0,0,0,0,0,17,6,11,1,0,1,0,0,0,6,5,1
102377,20000,200,0,2,10,7,3,0,0,0,0,0,0,9,6,3,0,0,0,0,0,0,1,1,0,0,0,0,0,0,0,0,0,0
102429,20000,200,0,2,9,6,3,0,0,0,0,0,0,0,0,0,0,0,0,0,0,0,9,6,3,0,0,0,0,0,0,0,0,0
102553,20000,200,0,2,42,15,27,2,0,2,1,0,1,1,0,1,1,1,0,0,0,0,32,12,20,2,0,2,2,2,0,1,0,1
102614,20000,200,0,2,44,29,15,2,2,0,0,0,0,0,0,0,1,1,0,0,0,0,22,15,7,4,0,4,3,2,1,12,9,3
102632,20000,200,0,2,7,3,4,0,0,0,1,0,1,0,0,0,0,0,0,0,0,0,6,3,3,0,0,0,0,0,0,0,0,0
102669,20000,200,0,2,7,1,6,1,0,1,0,0,0,0,0,0,0,0,0,0,0,0,6,1,5,0,0,0,0,0,0,0,0,0
102845,20000,200,0,2,29,13,16,1,0,1,1,0,1,5,2,3,3,1,2,0,0,0,19,10,9,0,0,0,0,0,0,0,0,0
103893,20000,200,0,2,15,2,13,0,0,0,0,0,0,0,0,0,1,1,0,0,0,0,12,1,11,1,0,1,1,0,1,0,0,0
103909,20000,200,0,2,7,3,4,0,0,0,0,0,0,0,0,0,1,0,1,0,0,0,5,2,3,0,0,0,1,1,0,0,0,0
103927,20000,200,0,2,6,0,6,0,0,0,0,0,0,1,0,1,0,0,0,0,0,0,5,0,5,0,0,0,0,0,0,0,0,0
104090,20000,200,0,2,8,2,6,0,0,0,0,0,0,0,0,0,0,0,0,0,0,0,7,2,5,1,0,1,0,0,0,0,0,0
104151,20000,200,0,2,291,132,159,1,0,1,14,10,4,18,5,13,27,13,14,0,0,0,100,45,55,5,1,4,94,42,52,32,16,16
104160,20000,200,0,2,14,6,8,0,0,0,1,0,1,0,0,0,3,1,2,0,0,0,6,4,2,0,0,0,4,1,3,0,0,0
104179,20000,200,0,2,130,71,59,2,1,1,11,7,4,5,3,2,11,6,5,0,0,0,63,31,32,1,0,1,6,5,1,31,18,13
104346,20000,200,0,2,3,3,0,0,0,0,0,0,0,1,1,0,0,0,0,0,0,0,2,2,0,0,0,0,0,0,0,0,0,0
104425,20000,200,0,2,17,8,9,0,0,0,0,0,0,1,0,1,3,2,1,0,0,0,12,6,6,0,0,0,1,0,1,0,0,0
104577,20000,200,0,2,3,2,1,0,0,0,0,0,0,0,0,0,0,0,0,0,0,0,3,2,1,0,0,0,0,0,0,0,0,0
104586,20000,200,0,2,27,21,6,0,0,0,5,5,0,1,1,0,1,0,1,0,0,0,17,14,3,0,0,0,2,1,1,1,0,1
104708,20000,200,0,2,16,7,9,0,0,0,0,0,0,0,0,0,1,0,1,0,0,0,14,6,8,1,1,0,0,0,0,0,0,0
104717,20000,200,0,2,55,13,42,0,0,0,3,3,0,13,2,11,2,0,2,0,0,0,34,8,26,2,0,2,1,0,1,0,0,0
105136,20000,200,0,2,3,1,2,0,0,0,0,0,0,0,0,0,1,0,1,0,0,0,1,0,1,0,0,0,1,1,0,0,0,0
105145,20000,200,0,2,10,3,7,0,0,0,0,0,0,0,0,0,1,1,0,0,0,0,9,2,7,0,0,0,0,0,0,0,0,0
105154,20000,200,0,2,28,13,15,0,0,0,1,1,0,2,1,1,3,0,3,0,0,0,20,10,10,2,1,1,0,0,0,0,0,0
105206,20000,200,0,2,6,1,5,0,0,0,1,0,1,0,0,0,0,0,0,0,0,0,3,0,3,1,0,1,1,1,0,0,0,0
105215,20000,200,0,2,1,1,0,0,0,0,0,0,0,0,0,0,0,0,0,0,0,0,1,1,0,0,0,0,0,0,0,0,0,0
105297,20000,200,0,2,4,4,0,3,3,0,0,0,0,0,0,0,0,0,0,0,0,0,1,1,0,0,0,0,0,0,0,0,0,0
105330,20000,200,0,2,84,35,49,0,0,0,5,0,5,2,1,1,3,0,3,0,0,0,68,30,38,0,0,0,3,2,1,3,2,1
105428,20000,200,0,2,8,2,6,0,0,0,1,1,0,0,0,0,1,0,1,0,0,0,5,1,4,0,0,0,1,0,1,0,0,0
105525,20000,200,0,2,5,2,3,1,1,0,0,0,0,1,0,1,0,0,0,0,0,0,3,1,2,0,0,0,0,0,0,0,0,0
105534,20000,200,0,2,12,5,7,0,0,0,0,0,0,0,0,0,4,0,4,0,0,0,5,2,3,3,3,0,0,0,0,0,0,0
105543,20000,200,0,2,10,1,9,0,0,0,0,0,0,0,0,0,3,0,3,0,0,0,7,1,6,0,0,0,0,0,0,0,0,0
105589,20000,200,0,2,3,1,2,0,0,0,0,0,0,1,0,1,0,0,0,0,0,0,1,1,0,0,0,0,1,0,1,0,0,0
105659,20000,200,0,2,7,6,1,1,0,1,0,0,0,2,2,0,2,2,0,0,0,0,2,2,0,0,0,0,0,0,0,0,0,0
105668,20000,200,0,2,4,0,4,0,0,0,0,0,0,0,0,0,0,0,0,0,0,0,4,0,4,0,0,0,0,0,0,0,0,0
105747,20000,200,0,2,6,3,3,0,0,0,0,0,0,0,0,0,0,0,0,0,0,0,6,3,3,0,0,0,0,0,0,0,0,0
105792,20000,200,0,2,1,1,0,0,0,0,0,0,0,0,0,0,0,0,0,0,0,0,1,1,0,0,0,0,0,0,0,0,0,0
105899,20000,200,0,2,1,1,0,0,0,0,0,0,0,0,0,0,0,0,0,0,0,0,1,1,0,0,0,0,0,0,0,0,0,0
106041,20000,200,0,2,9,9,0,0,0,0,1,1,0,0,0,0,4,4,0,0,0,0,4,4,0,0,0,0,0,0,0,0,0,0
106148,20000,200,0,2,12,8,4,0,0,0,0,0,0,0,0,0,0,0,0,0,0,0,12,8,4,0,0,0,0,0,0,0,0,0
106245,20000,200,0,2,19,8,11,0,0,0,0,0,0,2,1,1,0,0,0,0,0,0,13,5,8,0,0,0,3,1,2,1,1,0
106263,20000,200,0,2,24,12,12,0,0,0,8,5,3,2,0,2,1,0,1,0,0,0,10,5,5,0,0,0,0,0,0,3,2,1
106306,20000,200,0,2,1,1,0,0,0,0,0,0,0,1,1,0,0,0,0,0,0,0,0,0,0,0,0,0,0,0,0,0,0,0
106342,20000,200,0,2,1,1,0,0,0,0,0,0,0,0,0,0,0,0,0,0,0,0,1,1,0,0,0,0,0,0,0,0,0,0
106397,20000,200,0,2,94,45,49,0,0,0,3,2,1,7,4,3,7,4,3,0,0,0,55,24,31,0,0,0,8,3,5,14,8,6
106412,20000,200,0,2,9,4,5,0,0,0,1,1,0,5,1,4,0,0,0,0,0,0,3,2,1,0,0,0,0,0,0,0,0,0
106449,20000,200,0,2,15,8,7,0,0,0,0,0,0,0,0,0,0,0,0,0,0,0,14,7,7,1,1,0,0,0,0,0,0,0
106458,20000,200,0,2,27,14,13,0,0,0,1,1,0,1,1,0,0,0,0,0,0,0,18,6,12,0,0,0,2,2,0,5,4,1
106467,20000,200,0,2,16,7,9,0,0,0,6,2,4,0,0,0,0,0,0,0,0,0,9,5,4,0,0,0,1,0,1,0,0,0
106485,20000,200,0,2,19,13,6,0,0,0,1,1,0,0,0,0,0,0,0,0,0,0,14,9,5,0,0,0,1,0,1,3,3,0
106546,20000,200,0,2,11,1,10,0,0,0,0,0,0,0,0,0,0,0,0,0,0,0,11,1,10,0,0,0,0,0,0,0,0,0
106625,20000,200,0,2,6,3,3,0,0,0,0,0,0,0,0,0,0,0,0,0,0,0,6,3,3,0,0,0,0,0,0,0,0,0
106704,20000,200,0,2,31,15,16,0,0,0,1,1,0,4,2,2,0,0,0,0,0,0,23,11,12,1,1,0,0,0,0,2,0,2
106713,20000,200,0,2,3,0,3,0,0,0,0,0,0,0,0,0,0,0,0,0,0,0,3,0,3,0,0,0,0,0,0,0,0,0
106795,20000,200,0,2,6,2,4,0,0,0,0,0,0,0,0,0,0,0,0,0,0,0,6,2,4,0,0,0,0,0,0,0,0,0
106810,20000,200,0,2,5,2,3,0,0,0,0,0,0,0,0,0,0,0,0,0,0,0,5,2,3,0,0,0,0,0,0,0,0,0
106883,20000,200,0,2,5,2,3,0,0,0,0,0,0,0,0,0,0,0,0,0,0,0,5,2,3,0,0,0,0,0,0,0,0,0
106980,20000,200,0,2,13,7,6,0,0,0,0,0,0,0,0,0,0,0,0,0,0,0,13,7,6,0,0,0,0,0,0,0,0,0
106999,20000,200,0,2,5,2,3,0,0,0,0,0,0,0,0,0,0,0,0,0,0,0,5,2,3,0,0,0,0,0,0,0,0,0
107044,20000,200,0,2,14,4,10,0,0,0,0,0,0,0,0,0,1,0,1,0,0,0,12,4,8,0,0,0,0,0,0,1,0,1
107071,20000,200,0,2,7,4,3,0,0,0,0,0,0,1,0,1,0,0,0,0,0,0,6,4,2,0,0,0,0,0,0,0,0,0
107080,20000,200,0,2,5,2,3,0,0,0,0,0,0,0,0,0,0,0,0,0,0,0,4,2,2,0,0,0,0,0,0,1,0,1
107141,20000,200,0,2,4,1,3,0,0,0,0,0,0,0,0,0,0,0,0,0,0,0,3,1,2,0,0,0,1,0,1,0,0,0
107318,20000,200,0,2,2,2,0,0,0,0,0,0,0,1,1,0,0,0,0,0,0,0,1,1,0,0,0,0,0,0,0,0,0,0
107327,20000,200,0,2,2,1,1,0,0,0,0,0,0,0,0,0,0,0,0,0,0,0,2,1,1,0,0,0,0,0,0,0,0,0
107460,20000,200,0,2,4,1,3,0,0,0,0,0,0,0,0,0,0,0,0,0,0,0,4,1,3,0,0,0,0,0,0,0,0,0
107512,20000,200,0,2,10,5,5,0,0,0,0,0,0,0,0,0,0,0,0,0,0,0,10,5,5,0,0,0,0,0,0,0,0,0
107521,20000,200,0,2,14,8,6,0,0,0,0,0,0,4,2,2,0,0,0,0,0,0,10,6,4,0,0,0,0,0,0,0,0,0
107549,20000,200,0,2,7,4,3,0,0,0,0,0,0,0,0,0,0,0,0,0,0,0,7,4,3,0,0,0,0,0,0,0,0,0
107558,20000,200,0,2,8,6,2,1,1,0,0,0,0,0,0,0,2,2,0,1,1,0,4,2,2,0,0,0,0,0,0,0,0,0
107585,20000,200,0,2,5,3,2,0,0,0,0,0,0,0,0,0,0,0,0,0,0,0,5,3,2,0,0,0,0,0,0,0,0,0
107600,20000,200,0,2,3,0,3,0,0,0,1,0,1,2,0,2,0,0,0,0,0,0,0,0,0,0,0,0,0,0,0,0,0,0
107619,20000,200,0,2,4,0,4,0,0,0,0,0,0,1,0,1,0,0,0,0,0,0,3,0,3,0,0,0,0,0,0,0,0,0
107637,20000,200,0,2,12,4,8,0,0,0,0,0,0,5,3,2,1,1,0,0,0,0,5,0,5,1,0,1,0,0,0,0,0,0
107664,20000,200,0,2,9,7,2,0,0,0,0,0,0,2,1,1,0,0,0,0,0,0,6,5,1,0,0,0,1,1,0,0,0,0
107725,20000,200,0,2,4,2,2,0,0,0,0,0,0,0,0,0,0,0,0,0,0,0,4,2,2,0,0,0,0,0,0,0,0,0
107743,20000,200,0,2,1,0,1,0,0,0,0,0,0,0,0,0,0,0,0,0,0,0,1,0,1,0,0,0,0,0,0,0,0,0
107840,20000,200,0,2,2,1,1,0,0,0,0,0,0,2,1,1,0,0,0,0,0,0,0,0,0,0,0,0,0,0,0,0,0,0
107974,20000,200,0,2,4,1,3,0,0,0,0,0,0,2,1,1,0,0,0,0,0,0,2,0,2,0,0,0,0,0,0,0,0,0
107983,20000,200,0,2,18,12,6,0,0,0,2,2,0,3,1,2,1,1,0,0,0,0,12,8,4,0,0,0,0,0,0,0,0,0
107992,20000,200,0,2,12,6,6,0,0,0,0,0,0,2,0,2,0,0,0,0,0,0,10,6,4,0,0,0,0,0,0,0,0,0
108092,20000,200,0,2,10,4,6,0,0,0,3,3,0,0,0,0,0,0,0,0,0,0,7,1,6,0,0,0,0,0,0,0,0,0
108232,20000,200,0,2,2,2,0,0,0,0,0,0,0,0,0,0,0,0,0,0,0,0,2,2,0,0,0,0,0,0,0,0,0,0
108870,20000,200,0,2,1,1,0,0,0,0,0,0,0,0,0,0,0,0,0,0,0,0,1,1,0,0,0,0,0,0,0,0,0,0
109040,20000,200,0,2,15,5,10,0,0,0,2,1,1,2,1,1,6,0,6,0,0,0,5,3,2,0,0,0,0,0,0,0,0,0
109208,20000,200,0,2,5,2,3,0,0,0,1,0,1,1,1,0,3,1,2,0,0,0,0,0,0,0,0,0,0,0,0,0,0,0
109350,20000,200,0,2,8,5,3,0,0,0,0,0,0,0,0,0,1,1,0,0,0,0,5,3,2,1,1,0,1,0,1,0,0,0
109785,20000,200,0,2,12,3,9,0,0,0,4,1,3,3,1,2,1,1,0,0,0,0,4,0,4,0,0,0,0,0,0,0,0,0
109819,20000,200,0,2,8,2,6,0,0,0,1,0,1,0,0,0,0,0,0,0,0,0,7,2,5,0,0,0,0,0,0,0,0,0
110097,20000,200,0,2,6,5,1,0,0,0,0,0,0,0,0,0,1,1,0,0,0,0,2,2,0,0,0,0,3,2,1,0,0,0
110219,20000,200,0,2,3,0,3,0,0,0,0,0,0,1,0,1,0,0,0,0,0,0,2,0,2,0,0,0,0,0,0,0,0,0
110316,20000,200,0,2,3,1,2,0,0,0,0,0,0,2,1,1,0,0,0,0,0,0,1,0,1,0,0,0,0,0,0,0,0,0
110361,20000,200,0,2,34,12,22,0,0,0,3,2,1,4,1,3,8,2,6,0,0,0,19,7,12,0,0,0,0,0,0,0,0,0
110370,20000,200,0,2,1,0,1,0,0,0,0,0,0,0,0,0,0,0,0,0,0,0,0,0,0,0,0,0,0,0,0,1,0,1
110398,20000,200,0,2,8,4,4,0,0,0,2,1,1,1,0,1,0,0,0,0,0,0,5,3,2,0,0,0,0,0,0,0,0,0
110404,20000,200,0,2,233,160,73,0,0,0,15,4,11,2,1,1,9,6,3,1,0,1,59,39,20,4,1,3,3,2,1,140,107,33
110413,20000,200,0,2,14,6,8,0,0,0,1,0,1,1,1,0,5,3,2,0,0,0,6,2,4,1,0,1,0,0,0,0,0,0
110422,20000,200,0,2,34,21,13,0,0,0,3,3,0,2,2,0,4,2,2,0,0,0,11,5,6,0,0,0,0,0,0,14,9,5
110468,20000,200,0,2,9,3,6,0,0,0,1,0,1,1,0,1,1,0,1,0,0,0,6,3,3,0,0,0,0,0,0,0,0,0
110486,20000,200,0,2,12,4,8,0,0,0,1,0,1,0,0,0,4,2,2,0,0,0,3,1,2,2,1,1,1,0,1,1,0,1
110495,20000,200,0,2,27,8,19,1,1,0,4,0,4,2,1,1,4,3,1,0,0,0,11,2,9,1,0,1,1,1,0,3,0,3
110510,20000,200,0,2,28,14,14,0,0,0,4,2,2,2,1,1,4,2,2,0,0,0,16,8,8,0,0,0,2,1,1,0,0,0
110529,20000,200,0,2,1,1,0,0,0,0,0,0,0,0,0,0,0,0,0,0,0,0,0,0,0,0,0,0,1,1,0,0,0,0
110538,20000,200,0,2,21,14,7,0,0,0,0,0,0,3,1,2,0,0,0,0,0,0,12,7,5,0,0,0,1,1,0,5,5,0
110547,20000,200,0,2,12,3,9,0,0,0,0,0,0,1,0,1,2,0,2,0,0,0,3,1,2,3,2,1,1,0,1,2,0,2
110556,20000,200,0,2,25,8,17,0,0,0,6,4,2,1,0,1,5,1,4,0,0,0,8,2,6,0,0,0,2,0,2,3,1,2
110565,20000,200,0,2,82,43,39,0,0,0,19,10,9,7,2,5,10,4,6,0,0,0,38,22,16,1,0,1,0,0,0,7,5,2
110574,20000,200,0,2,11,5,6,0,0,0,1,1,0,1,1,0,1,0,1,0,0,0,3,1,2,0,0,0,3,2,1,2,0,2
110583,20000,200,0,2,38,9,29,2,0,2,6,1,5,4,1,3,4,1,3,0,0,0,14,1,13,1,1,0,1,0,1,6,4,2
110592,20000,200,0,2,13,6,7,0,0,0,6,4,2,0,0,0,3,1,2,0,0,0,3,0,3,0,0,0,1,1,0,0,0,0
110608,20000,200,0,2,27,14,13,0,0,0,4,3,1,1,1,0,4,2,2,0,0,0,8,0,8,1,0,1,1,1,0,8,7,1
110617,20000,200,0,2,29,17,12,1,0,1,4,2,2,5,4,1,2,1,1,0,0,0,8,5,3,0,0,0,6,3,3,3,2,1
110635,20000,200,0,2,695,389,306,2,1,1,57,30,27,16,6,10,43,25,18,0,0,0,183,86,97,16,7,9,33,16,17,345,218,127
110644,20000,200,0,2,783,356,427,2,1,1,86,28,58,14,7,7,64,26,38,2,0,2,268,112,156,22,5,17,38,15,23,287,162,125
110653,20000,200,0,2,494,264,230,0,0,0,70,33,37,17,7,10,43,15,28,2,1,1,144,75,69,14,5,9,18,13,5,186,115,71
110662,20000,200,0,2,870,474,396,0,0,0,166,73,93,23,13,10,58,32,26,1,0,1,244,137,107,16,7,9,40,18,22,322,194,128
110671,20000,200,0,2,215,125,90,0,0,0,27,16,11,1,1,0,19,7,12,0,0,0,53,25,28,3,3,0,5,4,1,107,69,38
110680,20000,200,0,2,793,412,381,1,0,1,77,37,40,16,3,13,45,20,25,1,0,1,227,109,118,9,2,7,15,7,8,402,234,168
110699,20000,200,0,2,805,354,451,0,0,0,156,70,86,35,9,26,59,34,25,1,0,1,207,84,123,25,14,11,27,8,19,295,135,160
110705,20000,200,0,2,241,142,99,0,0,0,11,3,8,3,1,2,15,8,7,0,0,0,70,41,29,4,1,3,13,6,7,125,82,43
110714,20000,200,0,2,165,85,80,0,0,0,10,5,5,3,1,2,19,4,15,0,0,0,61,34,27,10,4,6,9,6,3,53,31,22
111081,20000,200,0,2,8,4,4,0,0,0,2,1,1,1,1,0,0,0,0,0,0,0,3,1,2,0,0,0,0,0,0,2,1,1
111188,20000,200,0,2,7,6,1,0,0,0,0,0,0,0,0,0,0,0,0,0,0,0,5,4,1,0,0,0,2,2,0,0,0,0
111391,20000,200,0,2,5,3,2,0,0,0,0,0,0,1,1,0,1,1,0,0,0,0,3,1,2,0,0,0,0,0,0,0,0,0
111434,20000,200,0,2,4,4,0,0,0,0,0,0,0,1,1,0,2,2,0,0,0,0,0,0,0,0,0,0,1,1,0,0,0,0
111461,20000,200,0,2,5,3,2,0,0,0,0,0,0,2,2,0,0,0,0,0,0,0,3,1,2,0,0,0,0,0,0,0,0,0
111887,20000,200,0,2,2,2,0,0,0,0,0,0,0,0,0,0,0,0,0,0,0,0,2,2,0,0,0,0,0,0,0,0,0,0
111896,20000,200,0,2,3,1,2,0,0,0,0,0,0,0,0,0,0,0,0,0,0,0,2,0,2,0,0,0,1,1,0,0,0,0
111920,20000,200,0,2,3,1,2,0,0,0,1,0,1,0,0,0,0,0,0,0,0,0,2,1,1,0,0,0,0,0,0,0,0,0
111939,20000,200,0,2,17,7,10,0,0,0,2,1,1,1,0,1,4,1,3,0,0,0,10,5,5,0,0,0,0,0,0,0,0,0
111948,20000,200,0,2,41,18,23,0,0,0,3,0,3,2,1,1,7,1,6,0,0,0,12,7,5,1,0,1,11,8,3,5,1,4
111966,20000,200,0,2,26,12,14,0,0,0,4,2,2,5,1,4,3,2,1,0,0,0,2,0,2,0,0,0,12,7,5,0,0,0
112075,20000,200,0,2,9,4,5,0,0,0,0,0,0,1,0,1,0,0,0,0,0,0,4,2,2,0,0,0,4,2,2,0,0,0
112127,20000,200,0,2,1,0,1,0,0,0,1,0,1,0,0,0,0,0,0,0,0,0,0,0,0,0,0,0,0,0,0,0,0,0
112172,20000,200,0,2,2,1,1,0,0,0,0,0,0,0,0,0,1,0,1,0,0,0,1,1,0,0,0,0,0,0,0,0,0,0
112251,20000,200,0,2,5,3,2,0,0,0,0,0,0,0,0,0,1,0,1,0,0,0,0,0,0,0,0,0,4,3,1,0,0,0
112260,20000,200,0,2,14,6,8,0,0,0,4,2,2,1,1,0,1,0,1,0,0,0,4,2,2,0,0,0,1,1,0,3,0,3
112394,20000,200,0,2,1,1,0,0,0,0,0,0,0,0,0,0,0,0,0,0,0,0,1,1,0,0,0,0,0,0,0,0,0,0
112525,20000,200,0,2,24,9,15,0,0,0,8,4,4,2,0,2,1,1,0,0,0,0,8,2,6,1,0,1,3,2,1,1,0,1
112561,20000,200,0,2,24,11,13,0,0,0,0,0,0,1,0,1,2,0,2,0,0,0,19,10,9,2,1,1,0,0,0,0,0,0
112570,20000,200,0,2,1,1,0,0,0,0,0,0,0,1,1,0,0,0,0,0,0,0,0,0,0,0,0,0,0,0,0,0,0,0
112686,20000,200,0,2,8,4,4,0,0,0,1,0,1,4,1,3,2,2,0,0,0,0,1,1,0,0,0,0,0,0,0,0,0,0
112826,20000,200,0,2,6,1,5,0,0,0,0,0,0,1,0,1,1,0,1,0,0,0,3,1,2,1,0,1,0,0,0,0,0,0
113111,20000,200,0,2,3,2,1,0,0,0,1,0,1,0,0,0,0,0,0,0,0,0,1,1,0,0,0,0,1,1,0,0,0,0
113193,20000,200,0,2,4,0,4,0,0,0,0,0,0,0,0,0,1,0,1,0,0,0,3,0,3,0,0,0,0,0,0,0,0,0
113236,20000,200,0,2,3,2,1,0,0,0,0,0,0,2,1,1,0,0,0,0,0,0,1,1,0,0,0,0,0,0,0,0,0,0
113333,20000,200,0,2,5,3,2,0,0,0,1,0,1,0,0,0,1,1,0,0,0,0,2,2,0,0,0,0,0,0,0,1,0,1
113573,20000,200,0,2,26,8,18,0,0,0,0,0,0,5,0,5,9,5,4,0,0,0,9,3,6,0,0,0,2,0,2,1,0,1
113634,20000,200,0,2,1,0,1,0,0,0,1,0,1,0,0,0,0,0,0,0,0,0,0,0,0,0,0,0,0,0,0,0,0,0
113698,20000,200,0,2,8,4,4,0,0,0,0,0,0,0,0,0,0,0,0,0,0,0,4,3,1,0,0,0,3,1,2,1,0,1
113856,20000,200,0,2,26,13,13,0,0,0,2,1,1,2,0,2,3,1,2,0,0,0,6,4,2,0,0,0,12,6,6,1,1,0
113980,20000,200,0,2,1,1,0,0,0,0,1,1,0,0,0,0,0,0,0,0,0,0,0,0,0,0,0,0,0,0,0,0,0,0
114266,20000,200,0,2,8,3,5,0,0,0,3,0,3,0,0,0,2,1,1,0,0,0,2,2,0,0,0,0,1,0,1,0,0,0
114433,20000,200,0,2,7,2,5,0,0,0,0,0,0,0,0,0,2,1,1,0,0,0,5,1,4,0,0,0,0,0,0,0,0,0
114549,20000,200,0,2,2,2,0,0,0,0,0,0,0,0,0,0,0,0,0,0,0,0,2,2,0,0,0,0,0,0,0,0,0,0
114716,20000,200,0,2,6,1,5,0,0,0,1,0,1,0,0,0,2,0,2,0,0,0,3,1,2,0,0,0,0,0,0,0,0,0
114789,20000,200,0,2,13,6,7,1,1,0,0,0,0,1,0,1,3,1,2,0,0,0,7,4,3,1,0,1,0,0,0,0,0,0
114813,20000,200,0,2,12,5,7,1,1,0,2,1,1,1,0,1,2,0,2,0,0,0,6,3,3,0,0,0,0,0,0,0,0,0
114840,20000,200,0,2,2,1,1,0,0,0,0,0,0,2,1,1,0,0,0,0,0,0,0,0,0,0,0,0,0,0,0,0,0,0
114859,20000,200,0,2,2,0,2,0,0,0,0,0,0,1,0,1,1,0,1,0,0,0,0,0,0,0,0,0,0,0,0,0,0,0
114938,20000,200,0,2,1,0,1,0,0,0,0,0,0,0,0,0,1,0,1,0,0,0,0,0,0,0,0,0,0,0,0,0,0,0
115001,20000,200,0,2,2,1,1,0,0,0,0,0,0,0,0,0,1,1,0,0,0,0,1,0,1,0,0,0,0,0,0,0,0,0
115010,20000,200,0,2,12,2,10,0,0,0,4,1,3,1,1,0,4,0,4,0,0,0,2,0,2,1,0,1,0,0,0,0,0,0
115083,20000,200,0,2,3,0,3,0,0,0,0,0,0,0,0,0,0,0,0,0,0,0,3,0,3,0,0,0,0,0,0,0,0,0
115296,20000,200,0,2,1,1,0,0,0,0,0,0,0,0,0,0,0,0,0,0,0,0,0,0,0,0,0,0,1,1,0,0,0,0
115393,20000,200,0,2,3,2,1,0,0,0,0,0,0,0,0,0,1,1,0,0,0,0,0,0,0,0,0,0,2,1,1,0,0,0
115409,20000,200,0,2,4,1,3,0,0,0,0,0,0,0,0,0,0,0,0,0,0,0,3,1,2,0,0,0,1,0,1,0,0,0
115728,20000,200,0,2,2,1,1,0,0,0,1,1,0,1,0,1,0,0,0,0,0,0,0,0,0,0,0,0,0,0,0,0,0,0
115746,20000,200,0,2,6,2,4,0,0,0,0,0,0,0,0,0,0,0,0,0,0,0,6,2,4,0,0,0,0,0,0,0,0,0
115755,20000,200,0,2,14,8,6,0,0,0,1,1,0,0,0,0,1,0,1,0,0,0,9,4,5,0,0,0,3,3,0,0,0,0
115861,20000,200,0,2,108,58,50,0,0,0,9,6,3,5,3,2,43,20,23,0,0,0,48,26,22,2,2,0,1,1,0,0,0,0
115931,20000,200,0,2,7,5,2,0,0,0,0,0,0,2,1,1,3,2,1,0,0,0,2,2,0,0,0,0,0,0,0,0,0,0
116439,20000,200,0,2,5,1,4,0,0,0,1,0,1,0,0,0,0,0,0,0,0,0,3,1,2,0,0,0,1,0,1,0,0,0
117052,20000,200,0,2,2,1,1,0,0,0,0,0,0,0,0,0,0,0,0,0,0,0,1,1,0,0,0,0,1,0,1,0,0,0
117140,20000,200,0,2,3,2,1,0,0,0,0,0,0,0,0,0,0,0,0,0,0,0,2,1,1,0,0,0,1,1,0,0,0,0
117168,20000,200,0,2,1,0,1,0,0,0,1,0,1,0,0,0,0,0,0,0,0,0,0,0,0,0,0,0,0,0,0,0,0,0
117195,20000,200,0,2,3,2,1,0,0,0,0,0,0,0,0,0,2,1,1,0,0,0,1,1,0,0,0,0,0,0,0,0,0,0
117247,20000,200,0,2,9,2,7,0,0,0,3,0,3,0,0,0,3,2,1,0,0,0,0,0,0,0,0,0,3,0,3,0,0,0
117274,20000,200,0,2,2,1,1,0,0,0,0,0,0,0,0,0,0,0,0,0,0,0,1,0,1,0,0,0,1,1,0,0,0,0
117557,20000,200,0,2,1,1,0,0,0,0,0,0,0,0,0,0,0,0,0,0,0,0,1,1,0,0,0,0,0,0,0,0,0,0
117627,20000,200,0,2,6,2,4,0,0,0,1,1,0,0,0,0,1,0,1,2,1,1,2,0,2,0,0,0,0,0,0,0,0,0
117636,20000,200,0,2,29,9,20,0,0,0,3,0,3,2,1,1,4,3,1,0,0,0,15,5,10,2,0,2,0,0,0,3,0,3
117672,20000,200,0,2,1,0,1,0,0,0,0,0,0,0,0,0,0,0,0,0,0,0,0,0,0,1,0,1,0,0,0,0,0,0
117690,20000,200,0,2,7,5,2,0,0,0,0,0,0,1,0,1,0,0,0,0,0,0,1,1,0,0,0,0,5,4,1,0,0,0
117706,20000,200,0,2,32,17,15,0,0,0,6,4,2,3,2,1,1,0,1,0,0,0,18,7,11,0,0,0,4,4,0,0,0,0
117715,20000,200,0,2,5,0,5,0,0,0,1,0,1,0,0,0,2,0,2,0,0,0,0,0,0,0,0,0,2,0,2,0,0,0
117724,20000,200,0,2,17,12,5,0,0,0,1,1,0,1,1,0,4,3,1,0,0,0,4,3,1,0,0,0,7,4,3,0,0,0
117733,20000,200,0,2,23,10,13,0,0,0,1,0,1,1,1,0,3,2,1,0,0,0,14,5,9,2,1,1,2,1,1,0,0,0
117751,20000,200,0,2,3,1,2,0,0,0,0,0,0,1,0,1,0,0,0,0,0,0,2,1,1,0,0,0,0,0,0,0,0,0
117788,20000,200,0,2,15,7,8,0,0,0,1,1,0,0,0,0,1,1,0,0,0,0,5,2,3,0,0,0,8,3,5,0,0,0
117867,20000,200,0,2,13,7,6,0,0,0,2,1,1,0,0,0,3,3,0,0,0,0,7,2,5,0,0,0,1,1,0,0,0,0
117894,20000,200,0,2,8,4,4,0,0,0,2,1,1,2,1,1,0,0,0,0,0,0,4,2,2,0,0,0,0,0,0,0,0,0
117946,20000,200,0,2,26,9,17,0,0,0,2,1,1,5,3,2,1,0,1,0,0,0,9,1,8,0,0,0,9,4,5,0,0,0
118198,20000,200,0,2,1,1,0,0,0,0,0,0,0,0,0,0,0,0,0,0,0,0,1,1,0,0,0,0,0,0,0,0,0,0
118347,20000,200,0,2,3,2,1,0,0,0,0,0,0,0,0,0,0,0,0,0,0,0,1,1,0,0,0,0,2,1,1,0,0,0
118684,20000,200,0,2,6,3,3,0,0,0,1,0,1,0,0,0,4,2,2,0,0,0,1,1,0,0,0,0,0,0,0,0,0,0
118693,20000,200,0,2,4,2,2,0,0,0,0,0,0,0,0,0,0,0,0,0,0,0,3,2,1,0,0,0,1,0,1,0,0,0
118718,20000,200,0,2,5,3,2,0,0,0,0,0,0,1,1,0,2,0,2,0,0,0,0,0,0,0,0,0,2,2,0,0,0,0
118888,20000,200,0,2,2,0,2,0,0,0,0,0,0,1,0,1,1,0,1,0,0,0,0,0,0,0,0,0,0,0,0,0,0,0
118912,20000,200,0,2,3,2,1,0,0,0,1,1,0,0,0,0,0,0,0,0,0,0,1,1,0,0,0,0,0,0,0,1,0,1
118976,20000,200,0,2,92,35,57,0,0,0,4,1,3,3,1,2,21,6,15,0,0,0,63,27,36,1,0,1,0,0,0,0,0,0
119058,20000,200,0,2,1,0,1,0,0,0,0,0,0,0,0,0,0,0,0,0,0,0,1,0,1,0,0,0,0,0,0,0,0,0
119067,20000,200,0,2,2,1,1,0,0,0,1,0,1,0,0,0,0,0,0,0,0,0,0,0,0,1,1,0,0,0,0,0,0,0
119137,20000,200,0,2,8,5,3,0,0,0,1,1,0,0,0,0,0,0,0,0,0,0,4,1,3,0,0,0,0,0,0,3,3,0
119164,20000,200,0,2,11,6,5,1,0,1,1,0,1,0,0,0,2,1,1,0,0,0,5,4,1,0,0,0,2,1,1,0,0,0
119173,20000,200,0,2,8,2,6,0,0,0,2,0,2,0,0,0,2,1,1,0,0,0,4,1,3,0,0,0,0,0,0,0,0,0
119216,20000,200,0,2,3,2,1,0,0,0,0,0,0,1,1,0,1,1,0,0,0,0,1,0,1,0,0,0,0,0,0,0,0,0
119270,20000,200,0,2,1,0,1,0,0,0,0,0,0,0,0,0,0,0,0,1,0,1,0,0,0,0,0,0,0,0,0,0,0,0
119331,20000,200,0,2,7,1,6,0,0,0,0,0,0,0,0,0,0,0,0,0,0,0,6,1,5,0,0,0,1,0,1,0,0,0
119605,20000,200,0,2,7,3,4,0,0,0,0,0,0,1,1,0,0,0,0,0,0,0,4,2,2,0,0,0,2,0,2,0,0,0
119678,20000,200,0,2,25,17,8,0,0,0,1,1,0,1,0,1,2,2,0,0,0,0,19,12,7,0,0,0,2,2,0,0,0,0
120078,20000,200,0,2,16,3,13,0,0,0,2,1,1,2,0,2,8,0,8,0,0,0,2,2,0,1,0,1,1,0,1,0,0,0
120254,20000,200,0,2,17,9,8,0,0,0,0,0,0,1,0,1,2,2,0,0,0,0,5,3,2,0,0,0,8,3,5,1,1,0
120290,20000,200,0,2,7,2,5,0,0,0,1,0,1,2,0,2,2,1,1,0,0,0,2,1,1,0,0,0,0,0,0,0,0,0
120403,20000,200,0,2,2,0,2,0,0,0,0,0,0,0,0,0,0,0,0,0,0,0,2,0,2,0,0,0,0,0,0,0,0,0
120421,20000,200,0,2,10,4,6,0,0,0,2,1,1,0,0,0,3,1,2,0,0,0,4,2,2,0,0,0,1,0,1,0,0,0
120661,20000,200,0,2,3,1,2,1,0,1,0,0,0,0,0,0,1,0,1,0,0,0,1,1,0,0,0,0,0,0,0,0,0,0
120698,20000,200,0,2,2,1,1,0,0,0,0,0,0,0,0,0,0,0,0,0,0,0,2,1,1,0,0,0,0,0,0,0,0,0
120865,20000,200,0,2,7,3,4,0,0,0,1,0,1,1,0,1,1,0,1,0,0,0,4,3,1,0,0,0,0,0,0,0,0,0
120883,20000,200,0,2,35,15,20,0,0,0,6,1,5,4,0,4,4,1,3,0,0,0,18,11,7,1,1,0,2,1,1,0,0,0
120953,20000,200,0,2,7,4,3,0,0,0,1,1,0,0,0,0,2,1,1,0,0,0,4,2,2,0,0,0,0,0,0,0,0,0
120971,20000,200,0,2,2,1,1,0,0,0,0,0,0,0,0,0,1,0,1,0,0,0,1,1,0,0,0,0,0,0,0,0,0,0
121044,20000,200,0,2,11,3,8,1,0,1,0,0,0,0,0,0,0,0,0,0,0,0,7,3,4,1,0,1,1,0,1,1,0,1
121150,20000,200,0,2,40,16,24,0,0,0,3,3,0,4,2,2,6,3,3,0,0,0,26,7,19,0,0,0,0,0,0,1,1,0
121309,20000,200,0,2,6,1,5,0,0,0,0,0,0,0,0,0,1,1,0,0,0,0,4,0,4,1,0,1,0,0,0,0,0,0
121345,20000,200,0,2,18,8,10,0,0,0,2,1,1,5,3,2,4,2,2,0,0,0,5,2,3,0,0,0,2,0,2,0,0,0
121363,20000,200,0,2,4,1,3,0,0,0,0,0,0,1,0,1,1,0,1,0,0,0,2,1,1,0,0,0,0,0,0,0,0,0
121619,20000,200,0,2,1,0,1,0,0,0,0,0,0,0,0,0,0,0,0,0,0,0,0,0,0,0,0,0,1,0,1,0,0,0
121691,20000,200,0,2,11,4,7,0,0,0,3,1,2,1,0,1,2,1,1,0,0,0,4,2,2,0,0,0,1,0,1,0,0,0
121707,20000,200,0,2,6,4,2,0,0,0,0,0,0,0,0,0,0,0,0,0,0,0,6,4,2,0,0,0,0,0,0,0,0,0
121886,20000,200,0,2,3,0,3,0,0,0,1,0,1,0,0,0,1,0,1,0,0,0,0,0,0,0,0,0,1,0,1,0,0,0
121901,20000,200,0,2,8,2,6,0,0,0,1,0,1,0,0,0,5,2,3,0,0,0,2,0,2,0,0,0,0,0,0,0,0,0
122180,20000,200,0,2,5,2,3,0,0,0,0,0,0,1,0,1,0,0,0,0,0,0,2,1,1,1,1,0,1,0,1,0,0,0
122205,20000,200,0,2,5,2,3,0,0,0,2,1,1,0,0,0,0,0,0,0,0,0,3,1,2,0,0,0,0,0,0,0,0,0
122296,20000,200,0,2,9,2,7,0,0,0,3,2,1,0,0,0,1,0,1,0,0,0,2,0,2,0,0,0,3,0,3,0,0,0
122384,20000,200,0,2,1,0,1,0,0,0,0,0,0,0,0,0,1,0,1,0,0,0,0,0,0,0,0,0,0,0,0,0,0,0
122409,20000,200,0,2,80,41,39,2,2,0,6,4,2,9,6,3,10,6,4,0,0,0,34,10,24,1,0,1,7,5,2,11,8,3
122436,20000,200,0,2,3,0,3,0,0,0,0,0,0,0,0,0,0,0,0,0,0,0,2,0,2,0,0,0,0,0,0,1,0,1
122506,20000,200,0,2,2,2,0,0,0,0,0,0,0,0,0,0,0,0,0,0,0,0,2,2,0,0,0,0,0,0,0,0,0,0
122597,20000,200,0,2,21,10,11,0,0,0,4,2,2,2,0,2,3,1,2,0,0,0,8,5,3,0,0,0,2,0,2,2,2,0
122612,20000,200,0,2,16,4,12,0,0,0,1,0,1,3,1,2,3,0,3,0,0,0,8,2,6,0,0,0,1,1,0,0,0,0
122649,20000,200,0,2,1,1,0,0,0,0,0,0,0,0,0,0,0,0,0,0,0,0,1,1,0,0,0,0,0,0,0,0,0,0
122685,20000,200,0,2,7,2,5,0,0,0,0,0,0,1,0,1,2,2,0,0,0,0,3,0,3,1,0,1,0,0,0,0,0,0
122694,20000,200,0,2,4,0,4,0,0,0,1,0,1,0,0,0,0,0,0,0,0,0,2,0,2,1,0,1,0,0,0,0,0,0
122728,20000,200,0,2,2,2,0,0,0,0,1,1,0,0,0,0,0,0,0,0,0,0,1,1,0,0,0,0,0,0,0,0,0,0
122746,20000,200,0,2,2,1,1,0,0,0,0,0,0,2,1,1,0,0,0,0,0,0,0,0,0,0,0,0,0,0,0,0,0,0
122755,20000,200,0,2,68,32,36,1,1,0,13,7,6,7,2,5,8,6,2,0,0,0,22,6,16,1,0,1,2,1,1,14,9,5
122791,20000,200,0,2,7,2,5,0,0,0,2,1,1,3,1,2,1,0,1,0,0,0,1,0,1,0,0,0,0,0,0,0,0,0
122931,20000,200,0,2,50,25,25,0,0,0,6,4,2,8,2,6,4,1,3,0,0,0,22,14,8,0,0,0,0,0,0,10,4,6
122977,20000,200,0,2,8,0,8,0,0,0,1,0,1,2,0,2,1,0,1,0,0,0,3,0,3,0,0,0,1,0,1,0,0,0
123013,20000,200,0,2,11,5,6,0,0,0,0,0,0,2,2,0,2,1,1,0,0,0,6,1,5,0,0,0,1,1,0,0,0,0
123095,20000,200,0,2,42,15,27,0,0,0,4,1,3,8,2,6,4,3,1,0,0,0,20,7,13,2,2,0,4,0,4,0,0,0
123217,20000,200,0,2,1,1,0,0,0,0,0,0,0,0,0,0,0,0,0,0,0,0,0,0,0,1,1,0,0,0,0,0,0,0
123299,20000,200,0,2,2,1,1,0,0,0,0,0,0,0,0,0,0,0,0,0,0,0,1,0,1,0,0,0,1,1,0,0,0,0
123341,20000,200,0,2,4,1,3,0,0,0,0,0,0,0,0,0,2,0,2,0,0,0,2,1,1,0,0,0,0,0,0,0,0,0
123457,20000,200,0,2,3,3,0,0,0,0,0,0,0,0,0,0,0,0,0,0,0,0,2,2,0,0,0,0,1,1,0,0,0,0
123484,20000,200,0,2,4,2,2,0,0,0,0,0,0,1,0,1,0,0,0,0,0,0,3,2,1,0,0,0,0,0,0,0,0,0
123509,20000,200,0,2,4,2,2,0,0,0,1,0,1,2,2,0,1,0,1,0,0,0,0,0,0,0,0,0,0,0,0,0,0,0
123527,20000,200,0,2,6,3,3,0,0,0,0,0,0,1,0,1,4,3,1,0,0,0,1,0,1,0,0,0,0,0,0,0,0,0
123554,20000,200,0,2,8,4,4,0,0,0,3,2,1,1,0,1,1,1,0,0,0,0,2,1,1,0,0,0,1,0,1,0,0,0
123563,20000,200,0,2,1,0,1,0,0,0,0,0,0,1,0,1,0,0,0,0,0,0,0,0,0,0,0,0,0,0,0,0,0,0
123572,20000,200,0,2,6,1,5,0,0,0,0,0,0,0,0,0,2,0,2,0,0,0,2,0,2,0,0,0,0,0,0,2,1,1
123633,20000,200,0,2,2,1,1,0,0,0,0,0,0,0,0,0,0,0,0,0,0,0,2,1,1,0,0,0,0,0,0,0,0,0
123651,20000,200,0,2,2,2,0,0,0,0,0,0,0,0,0,0,0,0,0,0,0,0,2,2,0,0,0,0,0,0,0,0,0,0
123679,20000,200,0,2,10,2,8,0,0,0,2,0,2,0,0,0,3,1,2,0,0,0,3,0,3,1,0,1,1,1,0,0,0,0
123800,20000,200,0,2,10,4,6,0,0,0,0,0,0,2,2,0,2,0,2,1,1,0,3,0,3,0,0,0,2,1,1,0,0,0
123943,20000,200,0,2,3,1,2,0,0,0,2,0,2,0,0,0,0,0,0,0,0,0,1,1,0,0,0,0,0,0,0,0,0,0
123952,20000,200,0,2,2,2,0,0,0,0,0,0,0,1,1,0,0,0,0,0,0,0,1,1,0,0,0,0,0,0,0,0,0,0
123961,20000,200,0,2,334,169,165,2,0,2,85,43,42,23,4,19,20,8,12,0,0,0,146,82,64,19,7,12,14,7,7,25,18,7
123970,20000,200,0,2,8,4,4,0,0,0,2,1,1,2,0,2,0,0,0,0,0,0,3,2,1,0,0,0,0,0,0,1,1,0
124113,20000,200,0,2,1,0,1,0,0,0,0,0,0,0,0,0,0,0,0,0,0,0,1,0,1,0,0,0,0,0,0,0,0,0
124283,20000,200,0,2,3,1,2,0,0,0,2,0,2,0,0,0,0,0,0,0,0,0,1,1,0,0,0,0,0,0,0,0,0,0
124292,20000,200,0,2,1,1,0,0,0,0,0,0,0,0,0,0,0,0,0,0,0,0,1,1,0,0,0,0,0,0,0,0,0,0
124557,20000,200,0,2,26,20,6,0,0,0,2,1,1,0,0,0,1,0,1,0,0,0,17,14,3,0,0,0,1,1,0,5,4,1
124706,20000,200,0,2,4,1,3,0,0,0,0,0,0,0,0,0,1,0,1,0,0,0,1,0,1,1,0,1,1,1,0,0,0,0
124937,20000,200,0,2,4,2,2,0,0,0,1,0,1,0,0,0,2,2,0,0,0,0,1,0,1,0,0,0,0,0,0,0,0,0
125028,20000,200,0,2,8,4,4,0,0,0,1,0,1,0,0,0,1,1,0,0,0,0,4,2,2,0,0,0,2,1,1,0,0,0
125091,20000,200,0,2,2,1,1,0,0,0,0,0,0,0,0,0,0,0,0,0,0,0,2,1,1,0,0,0,0,0,0,0,0,0
125231,20000,200,0,2,14,5,9,0,0,0,0,0,0,9,3,6,1,0,1,0,0,0,2,1,1,1,0,1,1,1,0,0,0,0
125471,20000,200,0,2,8,4,4,0,0,0,0,0,0,0,0,0,2,0,2,0,0,0,3,2,1,0,0,0,3,2,1,0,0,0
125532,20000,200,0,2,8,0,8,1,0,1,1,0,1,2,0,2,0,0,0,1,0,1,3,0,3,0,0,0,0,0,0,0,0,0
125718,20000,200,0,2,1,1,0,0,0,0,0,0,0,0,0,0,0,0,0,0,0,0,1,1,0,0,0,0,0,0,0,0,0,0
125727,20000,200,0,2,8,6,2,0,0,0,1,1,0,2,1,1,0,0,0,0,0,0,1,1,0,0,0,0,4,3,1,0,0,0
125763,20000,200,0,2,3,2,1,0,0,0,0,0,0,0,0,0,1,1,0,0,0,0,2,1,1,0,0,0,0,0,0,0,0,0
125897,20000,200,0,2,2,2,0,0,0,0,0,0,0,0,0,0,0,0,0,0,0,0,2,2,0,0,0,0,0,0,0,0,0,0
126119,20000,200,0,2,14,4,10,0,0,0,1,0,1,0,0,0,1,1,0,0,0,0,11,3,8,0,0,0,1,0,1,0,0,0
126182,20000,200,0,2,5,4,1,0,0,0,0,0,0,0,0,0,0,0,0,0,0,0,4,3,1,0,0,0,0,0,0,1,1,0
126207,20000,200,0,2,8,4,4,0,0,0,0,0,0,0,0,0,0,0,0,0,0,0,7,3,4,0,0,0,1,1,0,0,0,0
126289,20000,200,0,2,9,5,4,0,0,0,0,0,0,0,0,0,0,0,0,0,0,0,8,4,4,0,0,0,1,1,0,0,0,0
126562,20000,200,0,2,569,202,367,2,0,2,53,20,33,6,3,3,33,12,21,1,0,1,310,104,206,9,2,7,115,40,75,40,21,19
126580,20000,200,0,2,34,15,19,0,0,0,5,4,1,1,0,1,2,1,1,0,0,0,22,8,14,0,0,0,1,0,1,3,2,1
126605,20000,200,0,2,8,8,0,0,0,0,0,0,0,0,0,0,1,1,0,0,0,0,6,6,0,0,0,0,1,1,0,0,0,0
126614,20000,200,0,2,223,126,97,1,1,0,26,20,6,8,4,4,12,4,8,0,0,0,82,40,42,4,1,3,8,5,3,82,51,31
126669,20000,200,0,2,13,4,9,0,0,0,1,1,0,0,0,0,0,0,0,0,0,0,11,3,8,1,0,1,0,0,0,0,0,0
126678,20000,200,0,2,10,5,5,0,0,0,1,0,1,0,0,0,3,2,1,0,0,0,2,0,2,2,1,1,0,0,0,2,2,0
126687,20000,200,0,2,6,0,6,0,0,0,1,0,1,0,0,0,1,0,1,0,0,0,3,0,3,1,0,1,0,0,0,0,0,0
126711,20000,200,0,2,8,2,6,0,0,0,0,0,0,0,0,0,1,1,0,0,0,0,7,1,6,0,0,0,0,0,0,0,0,0
126748,20000,200,0,2,4,1,3,0,0,0,0,0,0,1,1,0,1,0,1,0,0,0,2,0,2,0,0,0,0,0,0,0,0,0
126775,20000,200,0,2,50,34,16,0,0,0,3,3,0,0,0,0,4,3,1,0,0,0,18,10,8,0,0,0,7,1,6,18,17,1
126784,20000,200,0,2,2,2,0,0,0,0,0,0,0,0,0,0,0,0,0,0,0,0,2,2,0,0,0,0,0,0,0,0,0,0
126818,20000,200,0,2,224,105,119,2,1,1,12,9,3,4,2,2,16,4,12,0,0,0,122,56,66,7,3,4,47,22,25,14,8,6
126827,20000,200,0,2,3,1,2,0,0,0,0,0,0,0,0,0,0,0,0,0,0,0,3,1,2,0,0,0,0,0,0,0,0,0
126863,20000,200,0,2,9,4,5,1,1,0,2,0,2,0,0,0,0,0,0,0,0,0,5,2,3,0,0,0,0,0,0,1,1,0
126942,20000,200,0,2,14,4,10,0,0,0,1,0,1,0,0,0,1,1,0,0,0,0,10,2,8,1,0,1,1,1,0,0,0,0
126951,20000,200,0,2,17,15,2,0,0,0,0,0,0,1,1,0,0,0,0,0,0,0,16,14,2,0,0,0,0,0,0,0,0,0
126979,20000,200,0,2,3,1,2,0,0,0,0,0,0,1,0,1,0,0,0,0,0,0,2,1,1,0,0,0,0,0,0,0,0,0
127060,20000,200,0,2,60,24,36,6,0,6,2,1,1,6,2,4,5,1,4,0,0,0,23,11,12,11,5,6,3,3,0,4,1,3
127185,20000,200,0,2,12,4,8,0,0,0,0,0,0,0,0,0,0,0,0,0,0,0,11,3,8,0,0,0,1,1,0,0,0,0
127200,20000,200,0,2,12,3,9,0,0,0,2,1,1,1,0,1,1,0,1,0,0,0,8,2,6,0,0,0,0,0,0,0,0,0
127389,20000,200,0,2,6,5,1,0,0,0,0,0,0,0,0,0,0,0,0,0,0,0,4,3,1,1,1,0,0,0,0,1,1,0
127556,20000,200,0,2,32,12,20,0,0,0,0,0,0,0,0,0,1,0,1,0,0,0,27,9,18,0,0,0,1,0,1,3,3,0
127565,20000,200,0,2,25,11,14,1,0,1,6,4,2,3,2,1,3,0,3,0,0,0,11,4,7,0,0,0,1,1,0,0,0,0
127617,20000,200,0,2,3,3,0,0,0,0,0,0,0,0,0,0,1,1,0,0,0,0,2,2,0,0,0,0,0,0,0,0,0,0
127653,20000,200,0,2,13,2,11,0,0,0,0,0,0,2,0,2,2,0,2,0,0,0,5,1,4,0,0,0,4,1,3,0,0,0
127732,20000,200,0,2,8,3,5,0,0,0,0,0,0,0,0,0,0,0,0,0,0,0,8,3,5,0,0,0,0,0,0,0,0,0
127741,20000,200,0,2,18,10,8,0,0,0,3,2,1,0,0,0,2,1,1,0,0,0,13,7,6,0,0,0,0,0,0,0,0,0
127778,20000,200,0,2,3,0,3,1,0,1,0,0,0,0,0,0,1,0,1,0,0,0,1,0,1,0,0,0,0,0,0,0,0,0
127820,20000,200,0,2,24,11,13,1,1,0,1,0,1,4,1,3,1,0,1,0,0,0,16,9,7,1,0,1,0,0,0,0,0,0
127884,20000,200,0,2,8,2,6,1,0,1,1,1,0,0,0,0,1,0,1,0,0,0,5,1,4,0,0,0,0,0,0,0,0,0
127909,20000,200,0,2,6,3,3,0,0,0,2,1,1,0,0,0,0,0,0,0,0,0,4,2,2,0,0,0,0,0,0,0,0,0
127918,20000,200,0,2,19,6,13,0,0,0,0,0,0,2,0,2,2,0,2,0,0,0,12,5,7,1,1,0,2,0,2,0,0,0
127945,20000,200,0,2,6,1,5,0,0,0,0,0,0,0,0,0,0,0,0,0,0,0,6,1,5,0,0,0,0,0,0,0,0,0
128106,20000,200,0,2,18,9,9,0,0,0,5,2,3,0,0,0,2,1,1,0,0,0,10,5,5,0,0,0,1,1,0,0,0,0
128179,20000,200,0,2,6,2,4,1,1,0,0,0,0,1,0,1,2,0,2,0,0,0,2,1,1,0,0,0,0,0,0,0,0,0
128188,20000,200,0,2,15,5,10,0,0,0,0,0,0,0,0,0,3,1,2,0,0,0,8,3,5,0,0,0,4,1,3,0,0,0
128258,20000,200,0,2,4,2,2,0,0,0,0,0,0,0,0,0,0,0,0,0,0,0,4,2,2,0,0,0,0,0,0,0,0,0
128328,20000,200,0,2,54,32,22,0,0,0,1,0,1,0,0,0,0,0,0,0,0,0,44,27,17,0,0,0,9,5,4,0,0,0
128391,20000,200,0,2,16,9,7,0,0,0,0,0,0,0,0,0,2,1,1,0,0,0,11,7,4,1,0,1,0,0,0,2,1,1
128498,20000,200,0,2,5,1,4,0,0,0,1,0,1,1,1,0,2,0,2,0,0,0,1,0,1,0,0,0,0,0,0,0,0,0
128744,20000,200,0,2,132,68,64,0,0,0,12,9,3,9,4,5,9,3,6,0,0,0,91,44,47,2,2,0,9,6,3,0,0,0
128771,20000,200,0,2,14,9,5,0,0,0,2,2,0,0,0,0,1,1,0,0,0,0,7,4,3,1,0,1,0,0,0,3,2,1
128902,20000,200,0,2,7,4,3,0,0,0,0,0,0,0,0,0,0,0,0,0,0,0,4,3,1,0,0,0,1,0,1,2,1,1
129020,20000,200,0,2,275,119,156,1,0,1,33,12,21,12,2,10,19,7,12,0,0,0,114,43,71,9,4,5,11,5,6,76,46,30
129154,20000,200,0,2,4,0,4,0,0,0,1,0,1,0,0,0,0,0,0,0,0,0,2,0,2,1,0,1,0,0,0,0,0,0
129215,20000,200,0,2,3,1,2,0,0,0,1,0,1,0,0,0,0,0,0,0,0,0,2,1,1,0,0,0,0,0,0,0,0,0
129242,20000,200,0,2,22,10,12,0,0,0,3,0,3,1,1,0,2,1,1,0,0,0,14,6,8,0,0,0,0,0,0,2,2,0
129491,20000,200,0,2,2,0,2,0,0,0,0,0,0,0,0,0,0,0,0,0,0,0,2,0,2,0,0,0,0,0,0,0,0,0
129525,20000,200,0,2,35,17,18,0,0,0,0,0,0,2,2,0,3,2,1,0,0,0,17,7,10,1,0,1,2,1,1,10,5,5
129543,20000,200,0,2,4,2,2,0,0,0,1,0,1,1,0,1,0,0,0,0,0,0,1,1,0,1,1,0,0,0,0,0,0,0
129695,20000,200,0,2,3,0,3,0,0,0,0,0,0,0,0,0,0,0,0,1,0,1,2,0,2,0,0,0,0,0,0,0,0,0
129774,20000,200,0,2,2,1,1,0,0,0,0,0,0,0,0,0,0,0,0,0,0,0,2,1,1,0,0,0,0,0,0,0,0,0
129941,20000,200,0,2,26,11,15,0,0,0,9,4,5,1,0,1,1,0,1,0,0,0,15,7,8,0,0,0,0,0,0,0,0,0
130040,20000,200,0,2,6,1,5,0,0,0,1,1,0,0,0,0,0,0,0,0,0,0,5,0,5,0,0,0,0,0,0,0,0,0
130110,20000,200,0,2,6,2,4,0,0,0,1,0,1,0,0,0,0,0,0,0,0,0,5,2,3,0,0,0,0,0,0,0,0,0
130183,20000,200,0,2,2,0,2,0,0,0,0,0,0,0,0,0,0,0,0,0,0,0,2,0,2,0,0,0,0,0,0,0,0,0
130217,20000,200,0,2,2,2,0,0,0,0,0,0,0,1,1,0,0,0,0,0,0,0,1,1,0,0,0,0,0,0,0,0,0,0
130226,20000,200,0,2,19,8,11,0,0,0,1,1,0,1,0,1,1,0,1,0,0,0,16,7,9,0,0,0,0,0,0,0,0,0
130253,20000,200,0,2,40,12,28,0,0,0,4,2,2,3,0,3,4,0,4,0,0,0,22,8,14,1,0,1,4,1,3,2,1,1
130314,20000,200,0,2,12,0,12,0,0,0,2,0,2,0,0,0,2,0,2,0,0,0,7,0,7,1,0,1,0,0,0,0,0,0
130396,20000,200,0,2,1,0,1,0,0,0,0,0,0,0,0,0,1,0,1,0,0,0,0,0,0,0,0,0,0,0,0,0,0,0
130493,20000,200,0,2,29,10,19,0,0,0,1,0,1,1,0,1,2,1,1,0,0,0,21,6,15,0,0,0,0,0,0,4,3,1
130590,20000,200,0,2,25,10,15,0,0,0,4,1,3,6,2,4,3,1,2,0,0,0,9,6,3,1,0,1,1,0,1,1,0,1
130606,20000,200,0,2,2,2,0,0,0,0,0,0,0,0,0,0,0,0,0,0,0,0,1,1,0,0,0,0,1,1,0,0,0,0
130624,20000,200,0,2,42,28,14,0,0,0,0,0,0,3,2,1,1,1,0,0,0,0,38,25,13,0,0,0,0,0,0,0,0,0
130697,20000,200,0,2,32,16,16,1,0,1,6,1,5,4,1,3,6,5,1,0,0,0,11,6,5,0,0,0,1,1,0,3,2,1
130776,20000,200,0,2,1,0,1,0,0,0,0,0,0,0,0,0,0,0,0,0,0,0,0,0,0,1,0,1,0,0,0,0,0,0
130794,20000,200,0,2,644,292,352,1,0,1,80,36,44,35,7,28,33,11,22,0,0,0,223,94,129,15,5,10,25,12,13,232,127,105
130907,20000,200,0,2,21,6,15,1,0,1,0,0,0,6,3,3,0,0,0,0,0,0,14,3,11,0,0,0,0,0,0,0,0,0
130934,20000,200,0,2,29,14,15,0,0,0,5,3,2,2,0,2,0,0,0,0,0,0,22,11,11,0,0,0,0,0,0,0,0,0
130943,20000,200,0,2,35,22,13,0,0,0,3,2,1,3,2,1,3,3,0,0,0,0,19,10,9,1,1,0,0,0,0,6,4,2
131113,20000,200,0,2,3,1,2,0,0,0,1,1,0,0,0,0,1,0,1,0,0,0,1,0,1,0,0,0,0,0,0,0,0,0
131159,20000,200,0,2,66,22,44,0,0,0,10,4,6,16,6,10,1,1,0,0,0,0,33,8,25,0,0,0,2,2,0,4,1,3
131283,20000,200,0,2,21,13,8,0,0,0,1,1,0,0,0,0,2,2,0,0,0,0,11,6,5,0,0,0,1,1,0,6,3,3
131399,20000,200,0,2,7,3,4,0,0,0,2,1,1,1,0,1,0,0,0,0,0,0,3,1,2,0,0,0,1,1,0,0,0,0
131405,20000,200,0,2,2,1,1,0,0,0,0,0,0,0,0,0,0,0,0,0,0,0,2,1,1,0,0,0,0,0,0,0,0,0
131450,20000,200,0,2,11,6,5,0,0,0,4,2,2,1,1,0,2,2,0,0,0,0,3,1,2,1,0,1,0,0,0,0,0,0
131469,20000,200,0,2,57,23,34,0,0,0,8,4,4,7,1,6,3,0,3,0,0,0,34,16,18,0,0,0,5,2,3,0,0,0
131496,20000,200,0,2,132,64,68,0,0,0,10,4,6,14,7,7,5,1,4,0,0,0,46,20,26,0,0,0,15,7,8,42,25,17
131520,20000,200,0,2,152,57,95,0,0,0,23,11,12,69,20,49,13,5,8,0,0,0,15,9,6,6,3,3,25,9,16,1,0,1
131803,20000,200,0,2,11,8,3,0,0,0,3,2,1,2,1,1,0,0,0,0,0,0,3,3,0,0,0,0,3,2,1,0,0,0
131876,20000,200,0,2,5,1,4,0,0,0,0,0,0,3,1,2,1,0,1,0,0,0,1,0,1,0,0,0,0,0,0,0,0,0
132408,20000,200,0,2,1,0,1,0,0,0,0,0,0,0,0,0,0,0,0,0,0,0,1,0,1,0,0,0,0,0,0,0,0,0
132471,20000,200,0,2,16,5,11,0,0,0,0,0,0,3,0,3,2,0,2,0,0,0,7,3,4,0,0,0,1,1,0,3,1,2
132602,20000,200,0,2,8,5,3,0,0,0,1,1,0,5,3,2,0,0,0,0,0,0,2,1,1,0,0,0,0,0,0,0,0,0
132657,20000,200,0,2,11,7,4,0,0,0,0,0,0,0,0,0,3,2,1,1,0,1,5,4,1,2,1,1,0,0,0,0,0,0
132693,20000,200,0,2,14,2,12,0,0,0,0,0,0,3,1,2,2,0,2,0,0,0,9,1,8,0,0,0,0,0,0,0,0,0
132709,20000,200,0,2,2,1,1,0,0,0,1,1,0,1,0,1,0,0,0,0,0,0,0,0,0,0,0,0,0,0,0,0,0,0
132842,20000,200,0,2,4,2,2,0,0,0,0,0,0,0,0,0,4,2,2,0,0,0,0,0,0,0,0,0,0,0,0,0,0,0
132851,20000,200,0,2,11,3,8,0,0,0,1,1,0,0,0,0,0,0,0,0,0,0,9,2,7,1,0,1,0,0,0,0,0,0
132879,20000,200,0,2,1,0,1,0,0,0,0,0,0,0,0,0,0,0,0,0,0,0,1,0,1,0,0,0,0,0,0,0,0,0
132903,20000,200,0,2,17,6,11,0,0,0,2,1,1,1,1,0,2,0,2,0,0,0,6,2,4,1,0,1,0,0,0,5,2,3
133021,20000,200,0,2,1,0,1,0,0,0,0,0,0,0,0,0,0,0,0,0,0,0,1,0,1,0,0,0,0,0,0,0,0,0
133386,20000,200,0,2,5,1,4,0,0,0,0,0,0,0,0,0,1,1,0,0,0,0,4,0,4,0,0,0,0,0,0,0,0,0
133465,20000,200,0,2,8,2,6,0,0,0,0,0,0,4,0,4,1,0,1,0,0,0,2,1,1,0,0,0,1,1,0,0,0,0
133492,20000,200,0,2,15,4,11,0,0,0,1,1,0,0,0,0,0,0,0,0,0,0,12,3,9,1,0,1,1,0,1,0,0,0
133508,20000,200,0,2,7,2,5,0,0,0,0,0,0,1,1,0,0,0,0,0,0,0,5,1,4,0,0,0,1,0,1,0,0,0
133553,20000,200,0,2,40,22,18,0,0,0,4,3,1,0,0,0,3,1,2,0,0,0,19,10,9,0,0,0,4,2,2,10,6,4
133650,20000,200,0,2,52,30,22,0,0,0,5,4,1,34,18,16,1,1,0,0,0,0,7,4,3,0,0,0,0,0,0,5,3,2
133669,20000,200,0,2,24,10,14,0,0,0,3,2,1,3,1,2,5,0,5,0,0,0,11,6,5,0,0,0,0,0,0,2,1,1
133702,20000,200,0,2,13,6,7,0,0,0,1,1,0,3,1,2,0,0,0,0,0,0,9,4,5,0,0,0,0,0,0,0,0,0
133711,20000,200,0,2,14,9,5,0,0,0,1,1,0,1,0,1,0,0,0,0,0,0,11,7,4,0,0,0,1,1,0,0,0,0
133809,20000,200,0,2,9,3,6,0,0,0,0,0,0,0,0,0,0,0,0,0,0,0,9,3,6,0,0,0,0,0,0,0,0,0
133845,20000,200,0,2,5,0,5,0,0,0,0,0,0,1,0,1,2,0,2,0,0,0,2,0,2,0,0,0,0,0,0,0,0,0
133854,20000,200,0,2,1,1,0,0,0,0,0,0,0,1,1,0,0,0,0,0,0,0,0,0,0,0,0,0,0,0,0,0,0,0
133863,20000,200,0,2,4,1,3,0,0,0,1,1,0,0,0,0,2,0,2,0,0,0,0,0,0,0,0,0,1,0,1,0,0,0
133872,20000,200,0,2,7,1,6,0,0,0,0,0,0,1,0,1,3,0,3,0,0,0,3,1,2,0,0,0,0,0,0,0,0,0
133881,20000,200,0,2,16,11,5,1,1,0,4,2,2,0,0,0,0,0,0,0,0,0,9,6,3,0,0,0,1,1,0,1,1,0
133951,20000,200,0,2,203,107,96,1,1,0,19,13,6,18,5,13,41,20,21,0,0,0,90,44,46,0,0,0,0,0,0,34,24,10
133960,20000,200,0,2,4,1,3,0,0,0,0,0,0,0,0,0,0,0,0,0,0,0,3,1,2,0,0,0,1,0,1,0,0,0
133979,20000,200,0,2,5,1,4,0,0,0,0,0,0,4,1,3,0,0,0,0,0,0,1,0,1,0,0,0,0,0,0,0,0,0
134079,20000,200,0,2,10,7,3,0,0,0,0,0,0,1,0,1,1,1,0,0,0,0,7,5,2,0,0,0,1,1,0,0,0,0
134097,20000,200,0,2,130,64,66,0,0,0,3,1,2,8,5,3,12,5,7,0,0,0,74,37,37,2,1,1,1,0,1,30,15,15
134130,20000,200,0,2,244,126,118,0,0,0,25,16,9,20,6,14,30,13,17,0,0,0,99,44,55,0,0,0,18,11,7,52,36,16
134237,20000,200,0,2,24,19,5,0,0,0,1,1,0,2,1,1,5,3,2,0,0,0,15,13,2,1,1,0,0,0,0,0,0,0
134343,20000,200,0,2,12,3,9,0,0,0,0,0,0,1,0,1,1,0,1,0,0,0,8,2,6,0,0,0,2,1,1,0,0,0
134495,20000,200,0,2,5,2,3,0,0,0,0,0,0,0,0,0,0,0,0,0,0,0,5,2,3,0,0,0,0,0,0,0,0,0
134608,20000,200,0,2,2,1,1,0,0,0,0,0,0,1,0,1,0,0,0,0,0,0,1,1,0,0,0,0,0,0,0,0,0,0
134945,20000,200,0,2,16,3,13,0,0,0,2,1,1,5,1,4,0,0,0,0,0,0,9,1,8,0,0,0,0,0,0,0,0,0
135081,20000,200,0,2,37,16,21,1,1,0,2,0,2,9,3,6,8,4,4,0,0,0,15,7,8,2,1,1,0,0,0,0,0,0
135160,20000,200,0,2,10,2,8,0,0,0,0,0,0,1,0,1,0,0,0,0,0,0,9,2,7,0,0,0,0,0,0,0,0,0
135188,20000,200,0,2,1,0,1,0,0,0,0,0,0,0,0,0,0,0,0,0,0,0,1,0,1,0,0,0,0,0,0,0,0,0
135391,20000,200,0,2,8,2,6,0,0,0,0,0,0,1,1,0,0,0,0,0,0,0,7,1,6,0,0,0,0,0,0,0,0,0
135717,20000,200,0,2,18,3,15,0,0,0,1,0,1,4,1,3,11,1,10,0,0,0,1,1,0,0,0,0,0,0,0,1,0,1
135726,20000,200,0,2,194,109,85,0,0,0,33,18,15,17,6,11,35,16,19,0,0,0,70,47,23,5,1,4,12,6,6,22,15,7
136145,20000,200,0,2,2,0,2,0,0,0,0,0,0,0,0,0,0,0,0,0,0,0,2,0,2,0,0,0,0,0,0,0,0,0
136172,20000,200,0,2,39,16,23,0,0,0,5,3,2,5,1,4,1,0,1,1,0,1,20,8,12,1,0,1,0,0,0,6,4,2
136215,20000,200,0,2,108,46,62,0,0,0,6,2,4,9,1,8,14,7,7,0,0,0,65,28,37,0,0,0,1,1,0,13,7,6
136233,20000,200,0,2,15,7,8,0,0,0,0,0,0,1,0,1,3,2,1,0,0,0,9,4,5,1,1,0,0,0,0,1,0,1
136330,20000,200,0,2,11,6,5,0,0,0,0,0,0,2,2,0,2,1,1,0,0,0,6,2,4,0,0,0,0,0,0,1,1,0
136358,20000,200,0,2,3,1,2,1,0,1,0,0,0,1,0,1,0,0,0,0,0,0,1,1,0,0,0,0,0,0,0,0,0,0
136400,20000,200,0,2,8,0,8,0,0,0,0,0,0,1,0,1,0,0,0,0,0,0,7,0,7,0,0,0,0,0,0,0,0,0
136473,20000,200,0,2,15,9,6,0,0,0,0,0,0,0,0,0,0,0,0,0,0,0,14,9,5,1,0,1,0,0,0,0,0,0
136516,20000,200,0,2,13,1,12,0,0,0,0,0,0,2,0,2,2,1,1,0,0,0,8,0,8,1,0,1,0,0,0,0,0,0
136701,20000,200,0,2,4,4,0,0,0,0,1,1,0,0,0,0,1,1,0,0,0,0,1,1,0,0,0,0,0,0,0,1,1,0
136774,20000,200,0,2,6,3,3,0,0,0,0,0,0,0,0,0,1,1,0,0,0,0,5,2,3,0,0,0,0,0,0,0,0,0
136950,20000,200,0,2,32,12,20,0,0,0,1,0,1,2,1,1,2,1,1,0,0,0,20,8,12,0,0,0,1,0,1,6,2,4
137032,20000,200,0,2,1,0,1,0,0,0,0,0,0,0,0,0,0,0,0,0,0,0,1,0,1,0,0,0,0,0,0,0,0,0
137078,20000,200,0,2,15,0,15,0,0,0,0,0,0,2,0,2,1,0,1,0,0,0,10,0,10,0,0,0,2,0,2,0,0,0
137096,20000,200,0,2,19,7,12,0,0,0,1,0,1,2,1,1,2,1,1,0,0,0,13,5,8,0,0,0,1,0,1,0,0,0
137209,20000,200,0,2,6,3,3,0,0,0,2,2,0,0,0,0,0,0,0,0,0,0,4,1,3,0,0,0,0,0,0,0,0,0
137281,20000,200,0,2,11,5,6,0,0,0,0,0,0,0,0,0,1,0,1,0,0,0,10,5,5,0,0,0,0,0,0,0,0,0
137315,20000,200,0,2,9,3,6,0,0,0,0,0,0,1,0,1,0,0,0,0,0,0,7,3,4,0,0,0,1,0,1,0,0,0
137351,20000,200,0,2,234,113,121,1,1,0,30,17,13,6,1,5,8,4,4,0,0,0,99,40,59,14,5,9,4,1,3,72,44,28
137476,20000,200,0,2,16,9,7,0,0,0,0,0,0,1,1,0,5,2,3,0,0,0,10,6,4,0,0,0,0,0,0,0,0,0
137546,20000,200,0,2,13,7,6,0,0,0,1,1,0,0,0,0,0,0,0,0,0,0,8,5,3,0,0,0,2,1,1,2,0,2
137564,20000,200,0,2,6,3,3,0,0,0,0,0,0,0,0,0,0,0,0,0,0,0,6,3,3,0,0,0,0,0,0,0,0,0
137759,20000,200,0,2,21,5,16,0,0,0,1,0,1,2,0,2,2,1,1,0,0,0,15,3,12,0,0,0,1,1,0,0,0,0
137801,20000,200,0,2,3,0,3,0,0,0,0,0,0,0,0,0,0,0,0,0,0,0,2,0,2,1,0,1,0,0,0,0,0,0
137847,20000,200,0,2,47,26,21,0,0,0,6,4,2,5,1,4,2,2,0,1,1,0,24,12,12,1,1,0,8,5,3,0,0,0
137962,20000,200,0,2,1,1,0,0,0,0,0,0,0,0,0,0,0,0,0,0,0,0,1,1,0,0,0,0,0,0,0,0,0,0
138187,20000,200,0,2,5,0,5,0,0,0,0,0,0,3,0,3,0,0,0,0,0,0,2,0,2,0,0,0,0,0,0,0,0,0
138275,20000,200,0,2,4,2,2,0,0,0,0,0,0,2,0,2,0,0,0,0,0,0,2,2,0,0,0,0,0,0,0,0,0,0
138293,20000,200,0,2,5,2,3,0,0,0,0,0,0,0,0,0,0,0,0,0,0,0,5,2,3,0,0,0,0,0,0,0,0,0
138309,20000,200,0,2,35,5,30,0,0,0,0,0,0,8,0,8,0,0,0,0,0,0,26,5,21,1,0,1,0,0,0,0,0,0
138354,20000,200,0,2,11,5,6,0,0,0,2,1,1,1,0,1,0,0,0,0,0,0,8,4,4,0,0,0,0,0,0,0,0,0
138558,20000,200,0,2,9,3,6,0,0,0,0,0,0,1,0,1,0,0,0,0,0,0,8,3,5,0,0,0,0,0,0,0,0,0
138600,20000,200,0,2,4,2,2,0,0,0,2,1,1,0,0,0,0,0,0,0,0,0,2,1,1,0,0,0,0,0,0,0,0,0
138682,20000,200,0,2,18,8,10,0,0,0,2,1,1,12,4,8,0,0,0,0,0,0,3,2,1,0,0,0,1,1,0,0,0,0
138716,20000,200,0,2,21,7,14,0,0,0,3,3,0,9,1,8,1,0,1,0,0,0,8,3,5,0,0,0,0,0,0,0,0,0
138761,20000,200,0,2,4,2,2,0,0,0,0,0,0,1,1,0,0,0,0,0,0,0,3,1,2,0,0,0,0,0,0,0,0,0
138840,20000,200,0,2,19,3,16,1,0,1,0,0,0,16,3,13,1,0,1,0,0,0,1,0,1,0,0,0,0,0,0,0,0,0
138868,20000,200,0,2,4,3,1,0,0,0,0,0,0,0,0,0,0,0,0,0,0,0,4,3,1,0,0,0,0,0,0,0,0,0
138901,20000,200,0,2,1,1,0,0,0,0,0,0,0,1,1,0,0,0,0,0,0,0,0,0,0,0,0,0,0,0,0,0,0,0
138929,20000,200,0,2,3,1,2,0,0,0,0,0,0,0,0,0,0,0,0,0,0,0,3,1,2,0,0,0,0,0,0,0,0,0
138947,20000,200,0,2,29,15,14,0,0,0,5,4,1,21,8,13,0,0,0,0,0,0,1,1,0,0,0,0,1,1,0,1,1,0
138956,20000,200,0,2,16,7,9,0,0,0,0,0,0,7,2,5,2,1,1,0,0,0,7,4,3,0,0,0,0,0,0,0,0,0
139144,20000,200,0,2,19,10,9,0,0,0,1,1,0,2,0,2,1,0,1,0,0,0,11,7,4,1,0,1,2,1,1,1,1,0
139199,20000,200,0,2,20,4,16,0,0,0,3,2,1,2,0,2,1,0,1,0,0,0,14,2,12,0,0,0,0,0,0,0,0,0
139205,20000,200,0,2,4,3,1,0,0,0,0,0,0,0,0,0,0,0,0,0,0,0,4,3,1,0,0,0,0,0,0,0,0,0
139250,20000,200,0,2,10,6,4,0,0,0,0,0,0,2,2,0,2,2,0,0,0,0,6,2,4,0,0,0,0,0,0,0,0,0
139278,20000,200,0,2,18,5,13,0,0,0,0,0,0,4,1,3,0,0,0,0,0,0,14,4,10,0,0,0,0,0,0,0,0,0
139311,20000,200,0,2,13,4,9,0,0,0,1,0,1,4,0,4,0,0,0,0,0,0,8,4,4,0,0,0,0,0,0,0,0,0
139357,20000,200,0,2,19,6,13,0,0,0,1,1,0,9,2,7,1,1,0,0,0,0,8,2,6,0,0,0,0,0,0,0,0,0
139366,20000,200,0,2,17,10,7,0,0,0,2,1,1,4,2,2,0,0,0,0,0,0,10,6,4,0,0,0,1,1,0,0,0,0
139384,20000,200,0,2,13,5,8,0,0,0,0,0,0,0,0,0,1,1,0,0,0,0,12,4,8,0,0,0,0,0,0,0,0,0
139393,20000,200,0,2,2,1,1,0,0,0,0,0,0,0,0,0,1,0,1,0,0,0,1,1,0,0,0,0,0,0,0,0,0,0
139463,20000,200,0,2,3,1,2,0,0,0,1,0,1,0,0,0,0,0,0,0,0,0,2,1,1,0,0,0,0,0,0,0,0,0
139579,20000,200,0,2,5,2,3,0,0,0,0,0,0,2,1,1,0,0,0,0,0,0,3,1,2,0,0,0,0,0,0,0,0,0
139630,20000,200,0,2,3,2,1,0,0,0,0,0,0,0,0,0,0,0,0,0,0,0,3,2,1,0,0,0,0,0,0,0,0,0
139658,20000,200,0,2,451,200,251,1,0,1,72,31,41,46,16,30,33,9,24,1,1,0,193,91,102,7,5,2,4,2,2,94,45,49
139700,20000,200,0,2,5,1,4,0,0,0,0,0,0,0,0,0,1,0,1,0,0,0,3,1,2,1,0,1,0,0,0,0,0,0
139719,20000,200,0,2,11,3,8,0,0,0,0,0,0,8,1,7,1,1,0,0,0,0,2,1,1,0,0,0,0,0,0,0,0,0
139755,20000,200,0,2,439,316,123,0,0,0,58,34,24,37,26,11,29,23,6,0,0,0,203,152,51,9,6,3,29,25,4,74,50,24
139764,20000,200,0,2,6,1,5,0,0,0,0,0,0,0,0,0,0,0,0,0,0,0,6,1,5,0,0,0,0,0,0,0,0,0
139861,20000,200,0,2,20,12,8,0,0,0,0,0,0,1,0,1,1,0,1,0,0,0,15,11,4,0,0,0,0,0,0,3,1,2
139931,20000,200,0,2,66,26,40,0,0,0,10,4,6,6,0,6,5,2,3,0,0,0,41,17,24,1,1,0,3,2,1,0,0,0
139940,20000,200,0,2,84,41,43,0,0,0,16,8,8,21,7,14,3,0,3,0,0,0,34,19,15,0,0,0,1,1,0,9,6,3
139959,20000,200,0,2,111,54,57,0,0,0,15,11,4,12,7,5,9,3,6,0,0,0,46,22,24,4,1,3,5,1,4,20,9,11
139968,20000,200,0,2,1,0,1,0,0,0,0,0,0,0,0,0,0,0,0,0,0,0,1,0,1,0,0,0,0,0,0,0,0,0
139986,20000,200,0,2,11,5,6,0,0,0,1,1,0,2,0,2,1,1,0,0,0,0,7,3,4,0,0,0,0,0,0,0,0,0
140012,20000,200,0,2,13,6,7,0,0,0,0,0,0,5,2,3,1,1,0,0,0,0,7,3,4,0,0,0,0,0,0,0,0,0
140146,20000,200,0,2,2,1,1,0,0,0,0,0,0,1,0,1,1,1,0,0,0,0,0,0,0,0,0,0,0,0,0,0,0,0
140243,20000,200,0,2,13,2,11,0,0,0,2,0,2,1,0,1,1,1,0,0,0,0,9,1,8,0,0,0,0,0,0,0,0,0
140252,20000,200,0,2,9,5,4,0,0,0,0,0,0,0,0,0,0,0,0,0,0,0,9,5,4,0,0,0,0,0,0,0,0,0
140331,20000,200,0,2,18,7,11,0,0,0,0,0,0,4,0,4,1,0,1,0,0,0,13,7,6,0,0,0,0,0,0,0,0,0
140447,20000,200,0,2,61,27,34,0,0,0,9,5,4,13,0,13,2,0,2,0,0,0,34,20,14,0,0,0,0,0,0,3,2,1
140553,20000,200,0,2,9,7,2,0,0,0,0,0,0,7,5,2,0,0,0,0,0,0,1,1,0,0,0,0,1,1,0,0,0,0
140562,20000,200,0,2,19,6,13,0,0,0,3,1,2,13,4,9,0,0,0,0,0,0,2,1,1,1,0,1,0,0,0,0,0,0
140678,20000,200,0,2,11,6,5,0,0,0,0,0,0,0,0,0,0,0,0,0,0,0,11,6,5,0,0,0,0,0,0,0,0,0
140696,20000,200,0,2,14,8,6,0,0,0,1,1,0,3,2,1,0,0,0,0,0,0,9,4,5,1,1,0,0,0,0,0,0,0
140720,20000,200,0,2,2,1,1,0,0,0,0,0,0,2,1,1,0,0,0,0,0,0,0,0,0,0,0,0,0,0,0,0,0,0
140818,20000,200,0,2,13,5,8,0,0,0,0,0,0,1,0,1,0,0,0,0,0,0,11,4,7,1,1,0,0,0,0,0,0,0
140872,20000,200,0,2,6,4,2,0,0,0,1,1,0,1,0,1,0,0,0,0,0,0,4,3,1,0,0,0,0,0,0,0,0,0
140942,20000,200,0,2,28,12,16,0,0,0,1,0,1,7,1,6,2,1,1,0,0,0,16,9,7,2,1,1,0,0,0,0,0,0
140951,20000,200,0,2,78,39,39,0,0,0,4,2,2,10,2,8,2,2,0,0,0,0,47,24,23,4,2,2,6,3,3,5,4,1
140960,20000,200,0,2,5,3,2,0,0,0,1,1,0,3,2,1,0,0,0,0,0,0,1,0,1,0,0,0,0,0,0,0,0,0
140988,20000,200,0,2,8,4,4,0,0,0,0,0,0,0,0,0,0,0,0,0,0,0,8,4,4,0,0,0,0,0,0,0,0,0
141006,20000,200,0,2,4,3,1,0,0,0,0,0,0,1,1,0,0,0,0,0,0,0,3,2,1,0,0,0,0,0,0,0,0,0
141060,20000,200,0,2,25,10,15,0,0,0,4,1,3,12,3,9,3,2,1,0,0,0,6,4,2,0,0,0,0,0,0,0,0,0
141167,20000,200,0,2,10,3,7,0,0,0,0,0,0,2,2,0,0,0,0,0,0,0,8,1,7,0,0,0,0,0,0,0,0,0
141185,20000,200,0,2,2,2,0,0,0,0,0,0,0,0,0,0,0,0,0,0,0,0,2,2,0,0,0,0,0,0,0,0,0,0
141237,20000,200,0,2,3,1,2,0,0,0,0,0,0,0,0,0,0,0,0,0,0,0,3,1,2,0,0,0,0,0,0,0,0,0
141255,20000,200,0,2,24,7,17,0,0,0,0,0,0,3,1,2,0,0,0,0,0,0,21,6,15,0,0,0,0,0,0,0,0,0
141264,20000,200,0,2,27,8,19,0,0,0,7,4,3,2,0,2,1,0,1,0,0,0,17,4,13,0,0,0,0,0,0,0,0,0
141325,20000,200,0,2,2,1,1,0,0,0,0,0,0,2,1,1,0,0,0,0,0,0,0,0,0,0,0,0,0,0,0,0,0,0
141334,20000,200,0,2,16,5,11,0,0,0,0,0,0,5,2,3,0,0,0,0,0,0,9,2,7,1,0,1,1,1,0,0,0,0
141361,20000,200,0,2,3,2,1,0,0,0,0,0,0,0,0,0,0,0,0,0,0,0,1,1,0,0,0,0,2,1,1,0,0,0
141486,20000,200,0,2,9,2,7,0,0,0,1,0,1,0,0,0,1,0,1,1,1,0,4,1,3,2,0,2,0,0,0,0,0,0
141565,20000,200,0,2,1,0,1,0,0,0,0,0,0,1,0,1,0,0,0,0,0,0,0,0,0,0,0,0,0,0,0,0,0,0
141574,20000,200,0,2,15,9,6,0,0,0,4,2,2,0,0,0,0,0,0,0,0,0,9,7,2,2,0,2,0,0,0,0,0,0
141644,20000,200,0,2,21,4,17,0,0,0,3,0,3,1,0,1,2,0,2,2,1,1,13,3,10,0,0,0,0,0,0,0,0,0
141811,20000,200,0,2,1,0,1,0,0,0,0,0,0,0,0,0,0,0,0,0,0,0,1,0,1,0,0,0,0,0,0,0,0,0
142054,20000,200,0,2,10,0,10,0,0,0,0,0,0,0,0,0,1,0,1,0,0,0,7,0,7,1,0,1,1,0,1,0,0,0
142115,20000,200,0,2,50,19,31,0,0,0,2,1,1,0,0,0,4,2,2,0,0,0,36,11,25,2,0,2,1,0,1,5,5,0
142179,20000,200,0,2,4,2,2,0,0,0,0,0,0,0,0,0,0,0,0,0,0,0,4,2,2,0,0,0,0,0,0,0,0,0
142276,20000,200,0,2,25,13,12,0,0,0,2,1,1,0,0,0,0,0,0,0,0,0,15,8,7,0,0,0,8,4,4,0,0,0
142285,20000,200,0,2,16,7,9,0,0,0,1,0,1,1,0,1,0,0,0,0,0,0,9,6,3,0,0,0,3,0,3,2,1,1
142294,20000,200,0,2,13,9,4,0,0,0,1,1,0,0,0,0,4,3,1,0,0,0,7,4,3,0,0,0,0,0,0,1,1,0
142328,20000,200,0,2,6,0,6,0,0,0,0,0,0,0,0,0,0,0,0,0,0,0,5,0,5,1,0,1,0,0,0,0,0,0
142443,20000,200,0,2,5,2,3,0,0,0,0,0,0,0,0,0,0,0,0,0,0,0,4,2,2,1,0,1,0,0,0,0,0,0
142461,20000,200,0,2,11,3,8,0,0,0,1,0,1,0,0,0,0,0,0,0,0,0,7,2,5,0,0,0,3,1,2,0,0,0
142522,20000,200,0,2,21,15,6,0,0,0,0,0,0,0,0,0,1,1,0,0,0,0,19,14,5,0,0,0,1,0,1,0,0,0
142559,20000,200,0,2,17,6,11,0,0,0,0,0,0,0,0,0,1,0,1,0,0,0,13,4,9,1,1,0,2,1,1,0,0,0
142832,20000,200,0,2,9,2,7,0,0,0,0,0,0,3,0,3,1,0,1,0,0,0,4,1,3,0,0,0,1,1,0,0,0,0
143048,20000,200,0,2,3,0,3,0,0,0,0,0,0,1,0,1,0,0,0,0,0,0,0,0,0,1,0,1,0,0,0,1,0,1
143084,20000,200,0,2,12,4,8,0,0,0,2,1,1,2,1,1,0,0,0,0,0,0,8,2,6,0,0,0,0,0,0,0,0,0
143118,20000,200,0,2,19,4,15,0,0,0,1,1,0,3,0,3,1,0,1,0,0,0,14,3,11,0,0,0,0,0,0,0,0,0
143215,20000,200,0,2,10,4,6,0,0,0,0,0,0,1,1,0,0,0,0,0,0,0,9,3,6,0,0,0,0,0,0,0,0,0
143279,20000,200,0,2,6,3,3,0,0,0,0,0,0,0,0,0,0,0,0,0,0,0,3,1,2,0,0,0,3,2,1,0,0,0
143288,20000,200,0,2,3,2,1,0,0,0,0,0,0,0,0,0,0,0,0,0,0,0,3,2,1,0,0,0,0,0,0,0,0,0
143297,20000,200,0,2,1,0,1,0,0,0,0,0,0,0,0,0,0,0,0,0,0,0,1,0,1,0,0,0,0,0,0,0,0,0
143358,20000,200,0,2,26,13,13,0,0,0,5,4,1,1,0,1,1,1,0,0,0,0,18,7,11,1,1,0,0,0,0,0,0,0
143613,20000,200,0,2,1,0,1,0,0,0,0,0,0,0,0,0,0,0,0,0,0,0,1,0,1,0,0,0,0,0,0,0,0,0
143659,20000,200,0,2,1,0,1,0,0,0,0,0,0,0,0,0,0,0,0,0,0,0,1,0,1,0,0,0,0,0,0,0,0,0
143853,20000,200,0,2,14,7,7,0,0,0,3,1,2,0,0,0,1,1,0,0,0,0,8,4,4,0,0,0,2,1,1,0,0,0
143978,20000,200,0,2,3,1,2,0,0,0,1,1,0,0,0,0,0,0,0,0,0,0,2,0,2,0,0,0,0,0,0,0,0,0
144005,20000,200,0,2,9,8,1,0,0,0,0,0,0,3,3,0,0,0,0,0,0,0,2,2,0,0,0,0,4,3,1,0,0,0
144014,20000,200,0,2,1,0,1,0,0,0,1,0,1,0,0,0,0,0,0,0,0,0,0,0,0,0,0,0,0,0,0,0,0,0
144050,20000,200,0,2,634,343,291,0,0,0,71,29,42,20,7,13,23,8,15,0,0,0,218,110,108,13,8,5,26,15,11,263,166,97
144157,20000,200,0,2,3,2,1,0,0,0,1,0,1,1,1,0,0,0,0,0,0,0,1,1,0,0,0,0,0,0,0,0,0,0
144166,20000,200,0,2,9,2,7,0,0,0,0,0,0,7,1,6,2,1,1,0,0,0,0,0,0,0,0,0,0,0,0,0,0,0
144184,20000,200,0,2,2,2,0,0,0,0,0,0,0,0,0,0,0,0,0,0,0,0,0,0,0,0,0,0,2,2,0,0,0,0
144193,20000,200,0,2,2,1,1,0,0,0,1,0,1,0,0,0,0,0,0,0,0,0,0,0,0,1,1,0,0,0,0,0,0,0
144209,20000,200,0,2,2,1,1,0,0,0,0,0,0,1,1,0,0,0,0,0,0,0,1,0,1,0,0,0,0,0,0,0,0,0
144218,20000,200,0,2,1,1,0,0,0,0,0,0,0,0,0,0,0,0,0,0,0,0,1,1,0,0,0,0,0,0,0,0,0,0
144281,20000,200,0,2,4,2,2,0,0,0,1,1,0,0,0,0,0,0,0,0,0,0,3,1,2,0,0,0,0,0,0,0,0,0
144351,20000,200,0,2,5,2,3,0,0,0,0,0,0,0,0,0,0,0,0,0,0,0,5,2,3,0,0,0,0,0,0,0,0,0
144485,20000,200,0,2,1,1,0,0,0,0,1,1,0,0,0,0,0,0,0,0,0,0,0,0,0,0,0,0,0,0,0,0,0,0
144564,20000,200,0,2,2,0,2,0,0,0,0,0,0,0,0,0,0,0,0,0,0,0,2,0,2,0,0,0,0,0,0,0,0,0
144740,20000,200,0,2,21,10,11,0,0,0,3,1,2,3,1,2,1,1,0,0,0,0,9,3,6,0,0,0,4,4,0,1,0,1
144865,20000,200,0,2,7,2,5,0,0,0,0,0,0,0,0,0,1,1,0,0,0,0,6,1,5,0,0,0,0,0,0,0,0,0
144892,20000,200,0,2,22,8,14,0,0,0,1,1,0,0,0,0,0,0,0,0,0,0,11,2,9,0,0,0,8,4,4,2,1,1
144944,20000,200,0,2,12,6,6,0,0,0,1,0,1,1,1,0,1,1,0,0,0,0,8,3,5,1,1,0,0,0,0,0,0,0
144962,20000,200,0,2,7,3,4,0,0,0,0,0,0,1,1,0,0,0,0,0,0,0,5,2,3,0,0,0,1,0,1,0,0,0
144971,20000,200,0,2,3,2,1,0,0,0,0,0,0,0,0,0,0,0,0,0,0,0,3,2,1,0,0,0,0,0,0,0,0,0
145239,20000,200,0,2,4,0,4,0,0,0,0,0,0,1,0,1,0,0,0,0,0,0,3,0,3,0,0,0,0,0,0,0,0,0
145275,20000,200,0,2,4,1,3,0,0,0,0,0,0,1,0,1,2,1,1,0,0,0,1,0,1,0,0,0,0,0,0,0,0,0
145336,20000,200,0,2,16,7,9,1,0,1,3,2,1,3,0,3,0,0,0,0,0,0,9,5,4,0,0,0,0,0,0,0,0,0
145372,20000,200,0,2,5,0,5,0,0,0,1,0,1,2,0,2,0,0,0,0,0,0,2,0,2,0,0,0,0,0,0,0,0,0
145558,20000,200,0,2,8,2,6,0,0,0,4,1,3,0,0,0,0,0,0,0,0,0,4,1,3,0,0,0,0,0,0,0,0,0
145600,20000,200,0,2,106,47,59,0,0,0,26,14,12,12,6,6,8,2,6,0,0,0,46,16,30,2,0,2,2,2,0,10,7,3
145619,20000,200,0,2,1,0,1,0,0,0,0,0,0,0,0,0,0,0,0,0,0,0,1,0,1,0,0,0,0,0,0,0,0,0
145628,20000,200,0,2,1,1,0,0,0,0,0,0,0,1,1,0,0,0,0,0,0,0,0,0,0,0,0,0,0,0,0,0,0,0
145637,20000,200,0,2,105,50,55,3,2,1,10,6,4,10,3,7,10,6,4,0,0,0,46,19,27,3,1,2,2,1,1,21,12,9
145646,20000,200,0,2,5,2,3,0,0,0,0,0,0,1,0,1,0,0,0,0,0,0,3,1,2,0,0,0,0,0,0,1,1,0
145682,20000,200,0,2,11,1,10,0,0,0,0,0,0,0,0,0,0,0,0,0,0,0,11,1,10,0,0,0,0,0,0,0,0,0
145691,20000,200,0,2,4,0,4,0,0,0,1,0,1,0,0,0,0,0,0,0,0,0,3,0,3,0,0,0,0,0,0,0,0,0
145707,20000,200,0,2,2,0,2,0,0,0,0,0,0,0,0,0,0,0,0,0,0,0,2,0,2,0,0,0,0,0,0,0,0,0
145725,20000,200,0,2,17,12,5,0,0,0,2,2,0,1,1,0,0,0,0,0,0,0,3,2,1,0,0,0,8,4,4,3,3,0
145813,20000,200,0,2,16,1,15,0,0,0,0,0,0,0,0,0,1,0,1,0,0,0,10,1,9,0,0,0,5,0,5,0,0,0
145831,20000,200,0,2,6,0,6,0,0,0,0,0,0,0,0,0,0,0,0,0,0,0,6,0,6,0,0,0,0,0,0,0,0,0
146205,20000,200,0,2,5,3,2,0,0,0,0,0,0,0,0,0,0,0,0,0,0,0,5,3,2,0,0,0,0,0,0,0,0,0
146278,20000,200,0,2,2,1,1,0,0,0,0,0,0,0,0,0,0,0,0,0,0,0,2,1,1,0,0,0,0,0,0,0,0,0
146296,20000,200,0,2,7,2,5,0,0,0,0,0,0,1,0,1,0,0,0,0,0,0,2,0,2,0,0,0,4,2,2,0,0,0
146339,20000,200,0,2,4,3,1,0,0,0,0,0,0,0,0,0,1,1,0,0,0,0,1,1,0,0,0,0,0,0,0,2,1,1
146348,20000,200,0,2,3,2,1,0,0,0,0,0,0,0,0,0,0,0,0,0,0,0,2,1,1,0,0,0,1,1,0,0,0,0
146366,20000,200,0,2,3,1,2,0,0,0,0,0,0,0,0,0,0,0,0,0,0,0,3,1,2,0,0,0,0,0,0,0,0,0
146418,20000,200,0,2,3,0,3,0,0,0,0,0,0,0,0,0,0,0,0,0,0,0,3,0,3,0,0,0,0,0,0,0,0,0
146427,20000,200,0,2,3,1,2,0,0,0,0,0,0,0,0,0,0,0,0,0,0,0,1,0,1,0,0,0,1,0,1,1,1,0
146472,20000,200,0,2,17,11,6,0,0,0,2,1,1,2,2,0,3,3,0,0,0,0,9,4,5,1,1,0,0,0,0,0,0,0
146481,20000,200,0,2,4,2,2,0,0,0,0,0,0,1,1,0,0,0,0,0,0,0,2,1,1,0,0,0,0,0,0,1,0,1
146506,20000,200,0,2,3,3,0,0,0,0,0,0,0,0,0,0,0,0,0,0,0,0,3,3,0,0,0,0,0,0,0,0,0,0
146533,20000,200,0,2,2,0,2,0,0,0,0,0,0,0,0,0,0,0,0,0,0,0,2,0,2,0,0,0,0,0,0,0,0,0
146603,20000,200,0,2,1,0,1,0,0,0,0,0,0,0,0,0,0,0,0,0,0,0,1,0,1,0,0,0,0,0,0,0,0,0
146612,20000,200,0,2,15,3,12,0,0,0,0,0,0,0,0,0,0,0,0,0,0,0,13,3,10,0,0,0,2,0,2,0,0,0
146667,20000,200,0,2,1,1,0,0,0,0,0,0,0,0,0,0,0,0,0,0,0,0,1,1,0,0,0,0,0,0,0,0,0,0
146676,20000,200,0,2,5,4,1,0,0,0,0,0,0,0,0,0,0,0,0,0,0,0,5,4,1,0,0,0,0,0,0,0,0,0
146685,20000,200,0,2,10,4,6,0,0,0,1,1,0,0,0,0,0,0,0,0,0,0,9,3,6,0,0,0,0,0,0,0,0,0
146700,20000,200,0,2,8,7,1,0,0,0,0,0,0,2,1,1,1,1,0,0,0,0,5,5,0,0,0,0,0,0,0,0,0,0
146719,20000,200,0,2,105,56,49,0,0,0,11,7,4,9,4,5,16,10,6,0,0,0,42,22,20,2,1,1,4,1,3,21,11,10
146728,20000,200,0,2,1,1,0,0,0,0,0,0,0,0,0,0,1,1,0,0,0,0,0,0,0,0,0,0,0,0,0,0,0,0
146755,20000,200,0,2,5,1,4,0,0,0,0,0,0,0,0,0,0,0,0,0,0,0,5,1,4,0,0,0,0,0,0,0,0,0
146816,20000,200,0,2,1,1,0,0,0,0,0,0,0,0,0,0,0,0,0,0,0,0,1,1,0,0,0,0,0,0,0,0,0,0
147004,20000,200,0,2,5,1,4,0,0,0,0,0,0,0,0,0,0,0,0,0,0,0,5,1,4,0,0,0,0,0,0,0,0,0
147013,20000,200,0,2,7,2,5,1,0,1,0,0,0,0,0,0,0,0,0,0,0,0,6,2,4,0,0,0,0,0,0,0,0,0
147129,20000,200,0,2,2,0,2,0,0,0,0,0,0,0,0,0,0,0,0,0,0,0,2,0,2,0,0,0,0,0,0,0,0,0
147244,20000,200,0,2,15,5,10,0,0,0,1,1,0,1,0,1,0,0,0,0,0,0,12,4,8,0,0,0,0,0,0,1,0,1
147341,20000,200,0,2,1,1,0,0,0,0,0,0,0,0,0,0,0,0,0,0,0,0,0,0,0,0,0,0,0,0,0,1,1,0
147369,20000,200,0,2,2,1,1,0,0,0,0,0,0,0,0,0,0,0,0,0,0,0,2,1,1,0,0,0,0,0,0,0,0,0
147378,20000,200,0,2,4,1,3,0,0,0,1,0,1,0,0,0,1,1,0,0,0,0,2,0,2,0,0,0,0,0,0,0,0,0
147411,20000,200,0,2,2,0,2,0,0,0,0,0,0,0,0,0,1,0,1,0,0,0,1,0,1,0,0,0,0,0,0,0,0,0
147536,20000,200,0,2,24,2,22,0,0,0,0,0,0,6,1,5,4,0,4,0,0,0,10,1,9,1,0,1,0,0,0,3,0,3
147590,20000,200,0,2,1,0,1,0,0,0,0,0,0,0,0,0,0,0,0,0,0,0,1,0,1,0,0,0,0,0,0,0,0,0
147660,20000,200,0,2,10,5,5,0,0,0,1,1,0,0,0,0,0,0,0,0,0,0,6,3,3,0,0,0,1,0,1,2,1,1
147679,20000,200,0,2,4,2,2,0,0,0,2,1,1,0,0,0,1,1,0,0,0,0,1,0,1,0,0,0,0,0,0,0,0,0
147697,20000,200,0,2,2,0,2,0,0,0,0,0,0,0,0,0,0,0,0,0,0,0,2,0,2,0,0,0,0,0,0,0,0,0
147703,20000,200,0,2,16,8,8,0,0,0,1,1,0,2,1,1,0,0,0,0,0,0,6,4,2,0,0,0,0,0,0,7,2,5
147767,20000,200,0,2,600,355,245,0,0,0,41,27,14,17,7,10,25,13,12,0,0,0,154,80,74,7,5,2,6,2,4,350,221,129
147776,20000,200,0,2,8,4,4,0,0,0,3,1,2,0,0,0,0,0,0,0,0,0,2,1,1,0,0,0,3,2,1,0,0,0
147800,20000,200,0,2,5,3,2,0,0,0,0,0,0,0,0,0,1,1,0,0,0,0,1,1,0,0,0,0,3,1,2,0,0,0
147828,20000,200,0,2,6,3,3,0,0,0,0,0,0,0,0,0,0,0,0,0,0,0,6,3,3,0,0,0,0,0,0,0,0,0
147916,20000,200,0,2,4,3,1,0,0,0,0,0,0,1,1,0,0,0,0,0,0,0,2,1,1,0,0,0,1,1,0,0,0,0
148007,20000,200,0,2,2,0,2,0,0,0,0,0,0,2,0,2,0,0,0,0,0,0,0,0,0,0,0,0,0,0,0,0,0,0
148016,20000,200,0,2,4,2,2,0,0,0,0,0,0,0,0,0,0,0,0,0,0,0,2,0,2,0,0,0,2,2,0,0,0,0
148131,20000,200,0,2,3,2,1,0,0,0,0,0,0,0,0,0,0,0,0,0,0,0,3,2,1,0,0,0,0,0,0,0,0,0
148292,20000,200,0,2,5,3,2,0,0,0,0,0,0,0,0,0,0,0,0,0,0,0,5,3,2,0,0,0,0,0,0,0,0,0
148380,20000,200,0,2,4,3,1,0,0,0,0,0,0,0,0,0,0,0,0,0,0,0,3,2,1,0,0,0,1,1,0,0,0,0
148405,20000,200,0,2,3,0,3,0,0,0,0,0,0,0,0,0,0,0,0,0,0,0,3,0,3,0,0,0,0,0,0,0,0,0
148487,20000,200,0,2,10,6,4,0,0,0,1,1,0,1,1,0,0,0,0,0,0,0,2,2,0,0,0,0,5,2,3,1,0,1
148496,20000,200,0,2,7,2,5,0,0,0,1,1,0,3,1,2,0,0,0,0,0,0,2,0,2,0,0,0,1,0,1,0,0,0
148511,20000,200,0,2,62,28,34,0,0,0,12,4,8,4,2,2,4,2,2,0,0,0,40,20,20,2,0,2,0,0,0,0,0,0
148575,20000,200,0,2,1,1,0,0,0,0,0,0,0,0,0,0,0,0,0,0,0,0,1,1,0,0,0,0,0,0,0,0,0,0
148584,20000,200,0,2,6,0,6,0,0,0,1,0,1,3,0,3,0,0,0,0,0,0,2,0,2,0,0,0,0,0,0,0,0,0
148593,20000,200,0,2,2,0,2,0,0,0,0,0,0,0,0,0,0,0,0,0,0,0,2,0,2,0,0,0,0,0,0,0,0,0
148627,20000,200,0,2,8,1,7,0,0,0,1,0,1,0,0,0,0,0,0,0,0,0,2,0,2,0,0,0,5,1,4,0,0,0
148654,20000,200,0,2,4,2,2,0,0,0,0,0,0,0,0,0,0,0,0,0,0,0,4,2,2,0,0,0,0,0,0,0,0,0
148672,20000,200,0,2,3,2,1,0,0,0,0,0,0,0,0,0,0,0,0,0,0,0,3,2,1,0,0,0,0,0,0,0,0,0
148821,20000,200,0,2,2,0,2,0,0,0,0,0,0,0,0,0,0,0,0,0,0,0,2,0,2,0,0,0,0,0,0,0,0,0
148876,20000,200,0,2,2,2,0,0,0,0,1,1,0,0,0,0,1,1,0,0,0,0,0,0,0,0,0,0,0,0,0,0,0,0
148982,20000,200,0,2,1,1,0,0,0,0,0,0,0,0,0,0,0,0,0,0,0,0,1,1,0,0,0,0,0,0,0,0,0,0
149028,20000,200,0,2,1,0,1,0,0,0,0,0,0,0,0,0,0,0,0,0,0,0,1,0,1,0,0,0,0,0,0,0,0,0
149222,20000,200,0,2,121,72,49,0,0,0,13,8,5,8,3,5,5,5,0,0,0,0,85,49,36,1,0,1,0,0,0,9,7,2
149231,20000,200,0,2,10,6,4,0,0,0,0,0,0,2,2,0,2,1,1,0,0,0,4,2,2,0,0,0,0,0,0,2,1,1
149329,20000,200,0,2,1,1,0,0,0,0,0,0,0,0,0,0,0,0,0,0,0,0,1,1,0,0,0,0,0,0,0,0,0,0
149365,20000,200,0,2,4,1,3,0,0,0,0,0,0,2,0,2,0,0,0,0,0,0,1,0,1,0,0,0,1,1,0,0,0,0
149505,20000,200,0,2,5,2,3,0,0,0,0,0,0,0,0,0,1,1,0,0,0,0,4,1,3,0,0,0,0,0,0,0,0,0
149532,20000,200,0,2,2,0,2,0,0,0,0,0,0,0,0,0,0,0,0,0,0,0,1,0,1,0,0,0,1,0,1,0,0,0
149639,20000,200,0,2,1,0,1,0,0,0,0,0,0,0,0,0,1,0,1,0,0,0,0,0,0,0,0,0,0,0,0,0,0,0
149727,20000,200,0,2,2,2,0,0,0,0,0,0,0,0,0,0,0,0,0,0,0,0,2,2,0,0,0,0,0,0,0,0,0,0
149772,20000,200,0,2,7,2,5,0,0,0,0,0,0,0,0,0,0,0,0,0,0,0,6,2,4,0,0,0,1,0,1,0,0,0
149781,20000,200,0,2,11,7,4,0,0,0,4,2,2,0,0,0,0,0,0,0,0,0,6,5,1,0,0,0,0,0,0,1,0,1
149842,20000,200,0,2,8,1,7,0,0,0,0,0,0,2,0,2,0,0,0,0,0,0,5,1,4,0,0,0,1,0,1,0,0,0
150066,20000,200,0,2,8,2,6,0,0,0,0,0,0,1,0,1,0,0,0,0,0,0,7,2,5,0,0,0,0,0,0,0,0,0
150136,20000,200,0,2,1,0,1,0,0,0,0,0,0,0,0,0,0,0,0,0,0,0,1,0,1,0,0,0,0,0,0,0,0,0
150145,20000,200,0,2,11,2,9,0,0,0,0,0,0,0,0,0,0,0,0,0,0,0,11,2,9,0,0,0,0,0,0,0,0,0
150163,20000,200,0,2,40,18,22,0,0,0,6,2,4,2,1,1,2,1,1,0,0,0,30,14,16,0,0,0,0,0,0,0,0,0
150172,20000,200,0,2,4,2,2,0,0,0,0,0,0,0,0,0,1,0,1,0,0,0,3,2,1,0,0,0,0,0,0,0,0,0
150215,20000,200,0,2,1,0,1,0,0,0,0,0,0,1,0,1,0,0,0,0,0,0,0,0,0,0,0,0,0,0,0,0,0,0
150288,20000,200,0,2,1,1,0,0,0,0,0,0,0,0,0,0,0,0,0,0,0,0,1,1,0,0,0,0,0,0,0,0,0,0
150400,20000,200,0,2,10,5,5,0,0,0,3,1,2,0,0,0,3,2,1,0,0,0,4,2,2,0,0,0,0,0,0,0,0,0
150455,20000,200,0,2,13,8,5,0,0,0,1,1,0,5,3,2,1,1,0,0,0,0,3,2,1,0,0,0,0,0,0,3,1,2
150534,20000,200,0,2,18,8,10,0,0,0,0,0,0,0,0,0,0,0,0,0,0,0,5,2,3,0,0,0,13,6,7,0,0,0
150604,20000,200,0,2,6,2,4,0,0,0,0,0,0,0,0,0,0,0,0,0,0,0,6,2,4,0,0,0,0,0,0,0,0,0
150668,20000,200,0,2,4,1,3,0,0,0,0,0,0,1,0,1,0,0,0,0,0,0,3,1,2,0,0,0,0,0,0,0,0,0
150677,20000,200,0,2,2,1,1,0,0,0,0,0,0,0,0,0,0,0,0,0,0,0,1,1,0,0,0,0,1,0,1,0,0,0
150756,20000,200,0,2,11,9,2,0,0,0,0,0,0,2,2,0,1,1,0,0,0,0,8,6,2,0,0,0,0,0,0,0,0,0
150774,20000,200,0,2,3,2,1,0,0,0,0,0,0,1,0,1,0,0,0,0,0,0,2,2,0,0,0,0,0,0,0,0,0,0
150941,20000,200,0,2,10,2,8,0,0,0,1,1,0,0,0,0,0,0,0,0,0,0,9,1,8,0,0,0,0,0,0,0,0,0
150987,20000,200,0,2,62,24,38,0,0,0,1,0,1,8,2,6,1,1,0,0,0,0,52,21,31,0,0,0,0,0,0,0,0,0
151102,20000,200,0,2,12,7,5,0,0,0,1,1,0,0,0,0,0,0,0,0,0,0,7,4,3,1,0,1,1,1,0,2,1,1
151111,20000,200,0,2,338,167,171,0,0,0,58,23,35,14,2,12,10,2,8,0,0,0,177,85,92,6,4,2,0,0,0,73,51,22
151263,20000,200,0,2,19,7,12,0,0,0,1,0,1,1,1,0,0,0,0,0,0,0,16,6,10,1,0,1,0,0,0,0,0,0
151290,20000,200,0,2,6,3,3,0,0,0,2,2,0,0,0,0,0,0,0,0,0,0,2,0,2,0,0,0,0,0,0,2,1,1
151306,20000,200,0,2,15,5,10,0,0,0,1,1,0,0,0,0,0,0,0,0,0,0,10,1,9,0,0,0,0,0,0,4,3,1
151324,20000,200,0,2,16,8,8,0,0,0,4,0,4,3,2,1,2,2,0,0,0,0,7,4,3,0,0,0,0,0,0,0,0,0
151333,20000,200,0,2,7,1,6,0,0,0,0,0,0,0,0,0,0,0,0,0,0,0,4,0,4,0,0,0,0,0,0,3,1,2
151342,20000,200,0,2,16,7,9,0,0,0,0,0,0,2,0,2,0,0,0,0,0,0,14,7,7,0,0,0,0,0,0,0,0,0
151351,20000,200,0,2,218,100,118,2,1,1,16,6,10,8,3,5,21,7,14,0,0,0,95,44,51,2,0,2,0,0,0,74,39,35
151360,20000,200,0,2,6,2,4,0,0,0,0,0,0,3,0,3,0,0,0,0,0,0,2,1,1,0,0,0,0,0,0,1,1,0
151379,20000,200,0,2,6,0,6,0,0,0,0,0,0,0,0,0,0,0,0,0,0,0,5,0,5,0,0,0,0,0,0,1,0,1
151388,20000,200,0,2,2,1,1,0,0,0,0,0,0,0,0,0,0,0,0,0,0,0,2,1,1,0,0,0,0,0,0,0,0,0
151467,20000,200,0,2,1,0,1,0,0,0,0,0,0,0,0,0,0,0,0,0,0,0,1,0,1,0,0,0,0,0,0,0,0,0
151661,20000,200,0,2,14,12,2,0,0,0,0,0,0,2,2,0,0,0,0,0,0,0,12,10,2,0,0,0,0,0,0,0,0,0
151777,20000,200,0,2,9,2,7,0,0,0,0,0,0,0,0,0,1,0,1,0,0,0,7,1,6,0,0,0,1,1,0,0,0,0
151786,20000,200,0,2,47,17,30,0,0,0,0,0,0,3,0,3,5,3,2,0,0,0,39,14,25,0,0,0,0,0,0,0,0,0
151801,20000,200,0,2,11,5,6,0,0,0,1,1,0,2,1,1,0,0,0,0,0,0,7,2,5,0,0,0,1,1,0,0,0,0
151810,20000,200,0,2,6,4,2,0,0,0,0,0,0,5,3,2,0,0,0,0,0,0,1,1,0,0,0,0,0,0,0,0,0,0
152080,20000,200,0,2,207,123,84,0,0,0,7,3,4,6,2,4,8,4,4,0,0,0,85,54,31,4,1,3,9,4,5,88,55,33
152099,20000,200,0,2,5,2,3,0,0,0,2,0,2,0,0,0,0,0,0,0,0,0,2,1,1,0,0,0,1,1,0,0,0,0
152318,20000,200,0,2,10,5,5,0,0,0,1,0,1,0,0,0,0,0,0,0,0,0,5,3,2,0,0,0,0,0,0,4,2,2
152336,20000,200,0,2,8,1,7,0,0,0,0,0,0,0,0,0,0,0,0,0,0,0,8,1,7,0,0,0,0,0,0,0,0,0
152381,20000,200,0,2,7,2,5,0,0,0,0,0,0,0,0,0,1,0,1,0,0,0,6,2,4,0,0,0,0,0,0,0,0,0
152390,20000,200,0,2,13,3,10,0,0,0,0,0,0,0,0,0,0,0,0,0,0,0,9,2,7,0,0,0,1,0,1,3,1,2
152530,20000,200,0,2,7,3,4,0,0,0,0,0,0,0,0,0,0,0,0,0,0,0,5,2,3,0,0,0,0,0,0,2,1,1
152567,20000,200,0,2,8,4,4,0,0,0,0,0,0,0,0,0,0,0,0,0,0,0,8,4,4,0,0,0,0,0,0,0,0,0
152600,20000,200,0,2,7,1,6,0,0,0,0,0,0,0,0,0,1,0,1,0,0,0,6,1,5,0,0,0,0,0,0,0,0,0
152637,20000,200,0,2,14,7,7,0,0,0,0,0,0,0,0,0,0,0,0,0,0,0,14,7,7,0,0,0,0,0,0,0,0,0
152673,20000,200,0,2,2,0,2,0,0,0,0,0,0,0,0,0,0,0,0,0,0,0,2,0,2,0,0,0,0,0,0,0,0,0
152798,20000,200,0,2,5,2,3,0,0,0,0,0,0,0,0,0,0,0,0,0,0,0,5,2,3,0,0,0,0,0,0,0,0,0
152992,20000,200,0,2,6,4,2,0,0,0,0,0,0,0,0,0,0,0,0,0,0,0,6,4,2,0,0,0,0,0,0,0,0,0
153001,20000,200,0,2,10,7,3,0,0,0,0,0,0,1,0,1,2,2,0,0,0,0,7,5,2,0,0,0,0,0,0,0,0,0
153108,20000,200,0,2,1,1,0,0,0,0,0,0,0,0,0,0,0,0,0,0,0,0,0,0,0,0,0,0,0,0,0,1,1,0
153126,20000,200,0,2,6,1,5,0,0,0,0,0,0,1,0,1,0,0,0,0,0,0,5,1,4,0,0,0,0,0,0,0,0,0
153144,20000,200,0,2,5,2,3,0,0,0,0,0,0,1,1,0,0,0,0,0,0,0,4,1,3,0,0,0,0,0,0,0,0,0
153162,20000,200,0,2,3,1,2,0,0,0,0,0,0,0,0,0,0,0,0,0,0,0,2,1,1,0,0,0,0,0,0,1,0,1
153214,20000,200,0,2,22,10,12,0,0,0,3,2,1,0,0,0,1,1,0,0,0,0,18,7,11,0,0,0,0,0,0,0,0,0
153241,20000,200,0,2,3,1,2,0,0,0,0,0,0,0,0,0,0,0,0,0,0,0,2,1,1,0,0,0,0,0,0,1,0,1
153250,20000,200,0,2,5,4,1,0,0,0,0,0,0,0,0,0,0,0,0,0,0,0,5,4,1,0,0,0,0,0,0,0,0,0
153269,20000,200,0,2,26,14,12,0,0,0,2,1,1,0,0,0,2,1,1,0,0,0,17,9,8,0,0,0,0,0,0,5,3,2
153278,20000,200,0,2,5,3,2,0,0,0,0,0,0,0,0,0,1,1,0,0,0,0,4,2,2,0,0,0,0,0,0,0,0,0
153296,20000,200,0,2,3,1,2,0,0,0,0,0,0,0,0,0,0,0,0,0,0,0,3,1,2,0,0,0,0,0,0,0,0,0
153311,20000,200,0,2,6,2,4,0,0,0,0,0,0,1,0,1,1,0,1,0,0,0,4,2,2,0,0,0,0,0,0,0,0,0
153320,20000,200,0,2,1,0,1,0,0,0,0,0,0,0,0,0,0,0,0,0,0,0,1,0,1,0,0,0,0,0,0,0,0,0
153366,20000,200,0,2,17,8,9,0,0,0,3,2,1,1,0,1,2,1,1,0,0,0,11,5,6,0,0,0,0,0,0,0,0,0
153375,20000,200,0,2,9,4,5,0,0,0,3,1,2,0,0,0,0,0,0,0,0,0,6,3,3,0,0,0,0,0,0,0,0,0
153384,20000,200,0,2,19,7,12,0,0,0,2,0,2,1,1,0,2,1,1,0,0,0,12,4,8,1,0,1,1,1,0,0,0,0
153445,20000,200,0,2,5,1,4,0,0,0,0,0,0,0,0,0,0,0,0,0,0,0,4,1,3,1,0,1,0,0,0,0,0,0
153472,20000,200,0,2,4,2,2,0,0,0,0,0,0,0,0,0,0,0,0,0,0,0,4,2,2,0,0,0,0,0,0,0,0,0
153524,20000,200,0,2,5,1,4,0,0,0,0,0,0,0,0,0,0,0,0,0,0,0,4,1,3,0,0,0,1,0,1,0,0,0
153533,20000,200,0,2,7,4,3,0,0,0,0,0,0,1,1,0,0,0,0,0,0,0,6,3,3,0,0,0,0,0,0,0,0,0
153603,20000,200,0,2,236,129,107,1,1,0,13,6,7,1,0,1,11,8,3,0,0,0,119,50,69,2,1,1,0,0,0,89,63,26
153621,20000,200,0,2,5,3,2,0,0,0,0,0,0,0,0,0,0,0,0,0,0,0,5,3,2,0,0,0,0,0,0,0,0,0
153630,20000,200,0,2,15,8,7,0,0,0,1,0,1,2,2,0,2,2,0,0,0,0,9,4,5,0,0,0,1,0,1,0,0,0
153658,20000,200,0,2,193,101,92,0,0,0,17,13,4,8,4,4,6,3,3,0,0,0,63,25,38,0,0,0,23,8,15,76,48,28
153737,20000,200,0,2,15,6,9,0,0,0,1,1,0,2,1,1,0,0,0,0,0,0,12,4,8,0,0,0,0,0,0,0,0,0
153825,20000,200,0,2,7,3,4,0,0,0,3,1,2,0,0,0,0,0,0,0,0,0,4,2,2,0,0,0,0,0,0,0,0,0
153834,20000,200,0,2,1,0,1,0,0,0,1,0,1,0,0,0,0,0,0,0,0,0,0,0,0,0,0,0,0,0,0,0,0,0
153861,20000,200,0,2,19,13,6,0,0,0,6,5,1,1,0,1,0,0,0,0,0,0,10,6,4,0,0,0,2,2,0,0,0,0
153922,20000,200,0,2,3,2,1,0,0,0,0,0,0,0,0,0,0,0,0,0,0,0,3,2,1,0,0,0,0,0,0,0,0,0
153977,20000,200,0,2,4,0,4,0,0,0,0,0,0,0,0,0,0,0,0,0,0,0,3,0,3,1,0,1,0,0,0,0,0,0
154004,20000,200,0,2,8,1,7,0,0,0,0,0,0,2,0,2,0,0,0,0,0,0,6,1,5,0,0,0,0,0,0,0,0,0
154013,20000,200,0,2,10,4,6,0,0,0,0,0,0,0,0,0,1,1,0,0,0,0,9,3,6,0,0,0,0,0,0,0,0,0
154022,20000,200,0,2,7,2,5,0,0,0,1,1,0,2,0,2,2,1,1,0,0,0,2,0,2,0,0,0,0,0,0,0,0,0
154059,20000,200,0,2,9,5,4,0,0,0,0,0,0,0,0,0,0,0,0,0,0,0,9,5,4,0,0,0,0,0,0,0,0,0
154095,20000,200,0,2,18,5,13,0,0,0,2,1,1,0,0,0,0,0,0,0,0,0,11,3,8,0,0,0,0,0,0,5,1,4
154101,20000,200,0,2,4,2,2,0,0,0,0,0,0,0,0,0,0,0,0,0,0,0,3,1,2,0,0,0,0,0,0,1,1,0
154110,20000,200,0,2,7,4,3,0,0,0,0,0,0,0,0,0,0,0,0,0,0,0,5,2,3,0,0,0,2,2,0,0,0,0
154129,20000,200,0,2,2,1,1,0,0,0,1,0,1,1,1,0,0,0,0,0,0,0,0,0,0,0,0,0,0,0,0,0,0,0
154156,20000,200,0,2,9,4,5,0,0,0,0,0,0,0,0,0,0,0,0,0,0,0,9,4,5,0,0,0,0,0,0,0,0,0
154174,20000,200,0,2,12,6,6,0,0,0,2,2,0,0,0,0,0,0,0,0,0,0,10,4,6,0,0,0,0,0,0,0,0,0
154235,20000,200,0,2,9,4,5,0,0,0,1,0,1,0,0,0,0,0,0,0,0,0,8,4,4,0,0,0,0,0,0,0,0,0
154350,20000,200,0,2,8,4,4,0,0,0,2,2,0,1,1,0,1,0,1,0,0,0,4,1,3,0,0,0,0,0,0,0,0,0
154378,20000,200,0,2,9,3,6,0,0,0,0,0,0,0,0,0,0,0,0,0,0,0,9,3,6,0,0,0,0,0,0,0,0,0
154396,20000,200,0,2,5,3,2,0,0,0,0,0,0,1,1,0,0,0,0,0,0,0,4,2,2,0,0,0,0,0,0,0,0,0
154493,20000,200,0,2,4,2,2,0,0,0,1,0,1,0,0,0,0,0,0,0,0,0,0,0,0,0,0,0,3,2,1,0,0,0
154518,20000,200,0,2,2,2,0,0,0,0,1,1,0,0,0,0,0,0,0,0,0,0,1,1,0,0,0,0,0,0,0,0,0,0
154527,20000,200,0,2,8,4,4,0,0,0,0,0,0,0,0,0,0,0,0,0,0,0,8,4,4,0,0,0,0,0,0,0,0,0
154572,20000,200,0,2,3,1,2,0,0,0,0,0,0,0,0,0,0,0,0,0,0,0,3,1,2,0,0,0,0,0,0,0,0,0
154590,20000,200,0,2,6,3,3,0,0,0,0,0,0,0,0,0,1,1,0,0,0,0,5,2,3,0,0,0,0,0,0,0,0,0
154642,20000,200,0,2,2,1,1,0,0,0,0,0,0,0,0,0,1,1,0,0,0,0,1,0,1,0,0,0,0,0,0,0,0,0
154688,20000,200,0,2,4,1,3,0,0,0,0,0,0,0,0,0,0,0,0,0,0,0,3,1,2,0,0,0,1,0,1,0,0,0
154697,20000,200,0,2,5,3,2,0,0,0,0,0,0,0,0,0,0,0,0,0,0,0,5,3,2,0,0,0,0,0,0,0,0,0
154712,20000,200,0,2,1,1,0,0,0,0,0,0,0,0,0,0,0,0,0,0,0,0,1,1,0,0,0,0,0,0,0,0,0,0
154721,20000,200,0,2,5,0,5,0,0,0,0,0,0,1,0,1,0,0,0,0,0,0,4,0,4,0,0,0,0,0,0,0,0,0
154749,20000,200,0,2,4,0,4,0,0,0,0,0,0,0,0,0,0,0,0,0,0,0,4,0,4,0,0,0,0,0,0,0,0,0
154800,20000,200,0,2,11,9,2,0,0,0,0,0,0,0,0,0,1,1,0,0,0,0,10,8,2,0,0,0,0,0,0,0,0,0
154855,20000,200,0,2,2,1,1,0,0,0,0,0,0,0,0,0,0,0,0,0,0,0,2,1,1,0,0,0,0,0,0,0,0,0
154907,20000,200,0,2,8,6,2,0,0,0,0,0,0,0,0,0,0,0,0,0,0,0,8,6,2,0,0,0,0,0,0,0,0,0
154925,20000,200,0,2,4,3,1,0,0,0,0,0,0,0,0,0,0,0,0,0,0,0,4,3,1,0,0,0,0,0,0,0,0,0
154934,20000,200,0,2,4,2,2,0,0,0,0,0,0,0,0,0,0,0,0,0,0,0,4,2,2,0,0,0,0,0,0,0,0,0
154952,20000,200,0,2,4,3,1,0,0,0,0,0,0,0,0,0,0,0,0,0,0,0,4,3,1,0,0,0,0,0,0,0,0,0
154998,20000,200,0,2,7,2,5,0,0,0,0,0,0,0,0,0,0,0,0,0,0,0,7,2,5,0,0,0,0,0,0,0,0,0
155007,20000,200,0,2,5,2,3,0,0,0,0,0,0,1,0,1,0,0,0,0,0,0,3,1,2,0,0,0,1,1,0,0,0,0
155025,20000,200,0,2,17,5,12,0,0,0,4,2,2,1,0,1,0,0,0,0,0,0,12,3,9,0,0,0,0,0,0,0,0,0
155052,20000,200,0,2,3,1,2,0,0,0,0,0,0,0,0,0,0,0,0,0,0,0,3,1,2,0,0,0,0,0,0,0,0,0
155061,20000,200,0,2,25,15,10,0,0,0,3,1,2,1,1,0,1,1,0,0,0,0,14,10,4,4,1,3,1,1,0,1,0,1
155089,20000,200,0,2,11,4,7,1,0,1,0,0,0,1,1,0,0,0,0,0,0,0,9,3,6,0,0,0,0,0,0,0,0,0
155098,20000,200,0,2,10,5,5,0,0,0,0,0,0,0,0,0,1,1,0,0,0,0,9,4,5,0,0,0,0,0,0,0,0,0
155104,20000,200,0,2,8,5,3,0,0,0,0,0,0,0,0,0,2,0,2,0,0,0,6,5,1,0,0,0,0,0,0,0,0,0
155177,20000,200,0,2,4,3,1,0,0,0,0,0,0,0,0,0,0,0,0,0,0,0,3,2,1,1,1,0,0,0,0,0,0,0
155186,20000,200,0,2,8,1,7,0,0,0,0,0,0,0,0,0,0,0,0,0,0,0,8,1,7,0,0,0,0,0,0,0,0,0
155195,20000,200,0,2,15,7,8,0,0,0,0,0,0,0,0,0,0,0,0,0,0,0,15,7,8,0,0,0,0,0,0,0,0,0
155201,20000,200,0,2,6,3,3,0,0,0,1,1,0,0,0,0,1,0,1,0,0,0,4,2,2,0,0,0,0,0,0,0,0,0
155210,20000,200,0,2,17,8,9,0,0,0,0,0,0,0,0,0,0,0,0,0,0,0,13,6,7,2,0,2,2,2,0,0,0,0
155283,20000,200,0,2,6,1,5,0,0,0,0,0,0,2,0,2,1,0,1,0,0,0,3,1,2,0,0,0,0,0,0,0,0,0
155292,20000,200,0,2,6,2,4,0,0,0,0,0,0,1,0,1,3,0,3,0,0,0,2,2,0,0,0,0,0,0,0,0,0,0
155308,20000,200,0,2,1,0,1,0,0,0,0,0,0,0,0,0,0,0,0,0,0,0,1,0,1,0,0,0,0,0,0,0,0,0
155317,20000,200,0,2,391,155,236,1,0,1,31,19,12,21,7,14,26,7,19,0,0,0,222,79,143,16,2,14,11,1,10,63,40,23
155335,20000,200,0,2,2,1,1,0,0,0,0,0,0,0,0,0,0,0,0,0,0,0,2,1,1,0,0,0,0,0,0,0,0,0
155399,20000,200,0,2,43,20,23,0,0,0,5,3,2,2,0,2,3,2,1,0,0,0,26,11,15,0,0,0,0,0,0,7,4,3
155414,20000,200,0,2,10,4,6,0,0,0,1,0,1,0,0,0,0,0,0,0,0,0,9,4,5,0,0,0,0,0,0,0,0,0
155450,20000,200,0,2,2,0,2,0,0,0,0,0,0,0,0,0,0,0,0,0,0,0,2,0,2,0,0,0,0,0,0,0,0,0
155487,20000,200,0,2,1,0,1,0,0,0,0,0,0,0,0,0,0,0,0,0,0,0,0,0,0,0,0,0,1,0,1,0,0,0
155511,20000,200,0,2,4,3,1,0,0,0,1,1,0,0,0,0,0,0,0,0,0,0,2,2,0,1,0,1,0,0,0,0,0,0
155566,20000,200,0,2,11,7,4,0,0,0,0,0,0,0,0,0,0,0,0,0,0,0,9,5,4,0,0,0,0,0,0,2,2,0
155593,20000,200,0,2,7,5,2,0,0,0,0,0,0,0,0,0,0,0,0,0,0,0,7,5,2,0,0,0,0,0,0,0,0,0
155618,20000,200,0,2,2,2,0,0,0,0,0,0,0,0,0,0,0,0,0,0,0,0,2,2,0,0,0,0,0,0,0,0,0,0
155627,20000,200,0,2,1,1,0,0,0,0,0,0,0,0,0,0,0,0,0,0,0,0,1,1,0,0,0,0,0,0,0,0,0,0
155681,20000,200,0,2,8,6,2,1,1,0,1,0,1,0,0,0,0,0,0,0,0,0,6,5,1,0,0,0,0,0,0,0,0,0
155715,20000,200,0,2,7,5,2,0,0,0,0,0,0,0,0,0,1,0,1,0,0,0,6,5,1,0,0,0,0,0,0,0,0,0
155812,20000,200,0,2,14,4,10,0,0,0,0,0,0,2,0,2,0,0,0,0,0,0,12,4,8,0,0,0,0,0,0,0,0,0
155830,20000,200,0,2,3,0,3,0,0,0,0,0,0,0,0,0,0,0,0,0,0,0,3,0,3,0,0,0,0,0,0,0,0,0
155858,20000,200,0,2,4,2,2,0,0,0,0,0,0,0,0,0,1,1,0,0,0,0,3,1,2,0,0,0,0,0,0,0,0,0
155900,20000,200,0,2,3,2,1,0,0,0,1,1,0,1,0,1,0,0,0,0,0,0,1,1,0,0,0,0,0,0,0,0,0,0
155937,20000,200,0,2,3,2,1,0,0,0,0,0,0,0,0,0,0,0,0,0,0,0,3,2,1,0,0,0,0,0,0,0,0,0
155973,20000,200,0,2,4,3,1,0,0,0,0,0,0,0,0,0,0,0,0,0,0,0,4,3,1,0,0,0,0,0,0,0,0,0
156082,20000,200,0,2,7,2,5,0,0,0,0,0,0,1,0,1,0,0,0,0,0,0,6,2,4,0,0,0,0,0,0,0,0,0
156107,20000,200,0,2,12,8,4,0,0,0,0,0,0,0,0,0,1,0,1,0,0,0,11,8,3,0,0,0,0,0,0,0,0,0
156125,20000,200,0,2,31,16,15,0,0,0,1,0,1,1,1,0,1,1,0,0,0,0,19,8,11,0,0,0,1,1,0,8,5,3
156134,20000,200,0,2,7,3,4,1,1,0,0,0,0,1,1,0,0,0,0,0,0,0,5,1,4,0,0,0,0,0,0,0,0,0
156189,20000,200,0,2,5,3,2,0,0,0,0,0,0,0,0,0,0,0,0,0,0,0,5,3,2,0,0,0,0,0,0,0,0,0
156213,20000,200,0,2,8,2,6,0,0,0,1,0,1,1,0,1,0,0,0,0,0,0,6,2,4,0,0,0,0,0,0,0,0,0
156222,20000,200,0,2,4,3,1,0,0,0,1,1,0,0,0,0,1,0,1,0,0,0,2,2,0,0,0,0,0,0,0,0,0,0
156231,20000,200,0,2,3,1,2,0,0,0,0,0,0,0,0,0,0,0,0,0,0,0,2,0,2,0,0,0,1,1,0,0,0,0
156286,20000,200,0,2,11,1,10,0,0,0,2,0,2,1,1,0,0,0,0,0,0,0,7,0,7,0,0,0,0,0,0,1,0,1
156295,20000,200,0,2,14,4,10,0,0,0,2,1,1,2,0,2,1,0,1,0,0,0,7,2,5,0,0,0,0,0,0,2,1,1
156338,20000,200,0,2,6,1,5,0,0,0,0,0,0,1,0,1,0,0,0,0,0,0,4,1,3,0,0,0,1,0,1,0,0,0
156356,20000,200,0,2,4,2,2,0,0,0,0,0,0,0,0,0,0,0,0,0,0,0,3,2,1,0,0,0,1,0,1,0,0,0
156365,20000,200,0,2,16,8,8,0,0,0,0,0,0,1,1,0,0,0,0,0,0,0,13,6,7,0,0,0,2,1,1,0,0,0
156392,20000,200,0,2,12,3,9,0,0,0,0,0,0,0,0,0,0,0,0,0,0,0,11,3,8,0,0,0,1,0,1,0,0,0
156408,20000,200,0,2,13,5,8,0,0,0,1,0,1,1,0,1,1,1,0,0,0,0,7,2,5,1,1,0,2,1,1,0,0,0
156471,20000,200,0,2,18,1,17,0,0,0,0,0,0,3,0,3,0,0,0,0,0,0,15,1,14,0,0,0,0,0,0,0,0,0
156541,20000,200,0,2,35,18,17,0,0,0,0,0,0,7,4,3,0,0,0,0,0,0,27,14,13,0,0,0,1,0,1,0,0,0
156620,20000,200,0,2,63,28,35,0,0,0,0,0,0,1,0,1,1,1,0,0,0,0,47,22,25,3,1,2,1,0,1,10,4,6
156648,20000,200,0,2,7,4,3,0,0,0,0,0,0,0,0,0,0,0,0,0,0,0,7,4,3,0,0,0,0,0,0,0,0,0
156727,20000,200,0,2,18,5,13,0,0,0,0,0,0,2,0,2,1,0,1,0,0,0,14,5,9,1,0,1,0,0,0,0,0,0
156745,20000,200,0,2,6,2,4,0,0,0,1,1,0,0,0,0,0,0,0,0,0,0,4,1,3,0,0,0,0,0,0,1,0,1
156790,20000,200,0,2,4,0,4,0,0,0,0,0,0,0,0,0,0,0,0,0,0,0,4,0,4,0,0,0,0,0,0,0,0,0
156851,20000,200,0,2,4,0,4,0,0,0,0,0,0,0,0,0,0,0,0,0,0,0,3,0,3,0,0,0,1,0,1,0,0,0
156860,20000,200,0,2,10,2,8,0,0,0,0,0,0,0,0,0,0,0,0,0,0,0,10,2,8,0,0,0,0,0,0,0,0,0
156921,20000,200,0,2,18,7,11,1,1,0,2,1,1,2,1,1,0,0,0,0,0,0,12,4,8,1,0,1,0,0,0,0,0,0
157021,20000,200,0,2,3,1,2,0,0,0,0,0,0,1,0,1,0,0,0,0,0,0,2,1,1,0,0,0,0,0,0,0,0,0
157058,20000,200,0,2,9,4,5,0,0,0,1,0,1,0,0,0,0,0,0,0,0,0,2,1,1,0,0,0,6,3,3,0,0,0
157076,20000,200,0,2,5,2,3,0,0,0,0,0,0,0,0,0,0,0,0,0,0,0,5,2,3,0,0,0,0,0,0,0,0,0
157085,20000,200,0,2,236,126,110,1,1,0,23,15,8,12,4,8,9,7,2,1,1,0,92,42,50,2,1,1,0,0,0,96,55,41
157100,20000,200,0,2,4,1,3,0,0,0,0,0,0,0,0,0,0,0,0,0,0,0,4,1,3,0,0,0,0,0,0,0,0,0
157216,20000,200,0,2,13,4,9,0,0,0,0,0,0,1,0,1,1,0,1,0,0,0,11,4,7,0,0,0,0,0,0,0,0,0
157289,20000,200,0,2,108,58,50,0,0,0,10,6,4,5,1,4,6,4,2,0,0,0,75,38,37,0,0,0,1,1,0,11,8,3
157304,20000,200,0,2,6,5,1,0,0,0,0,0,0,0,0,0,0,0,0,0,0,0,4,3,1,0,0,0,2,2,0,0,0,0
157331,20000,200,0,2,5,1,4,0,0,0,0,0,0,0,0,0,0,0,0,0,0,0,5,1,4,0,0,0,0,0,0,0,0,0
157377,20000,200,0,2,11,4,7,0,0,0,1,1,0,0,0,0,0,0,0,0,0,0,9,3,6,0,0,0,1,0,1,0,0,0
157386,20000,200,0,2,22,10,12,0,0,0,2,2,0,0,0,0,1,0,1,0,0,0,17,7,10,1,0,1,1,1,0,0,0,0
157438,20000,200,0,2,9,6,3,0,0,0,0,0,0,1,1,0,0,0,0,0,0,0,8,5,3,0,0,0,0,0,0,0,0,0
157447,20000,200,0,2,28,10,18,1,0,1,0,0,0,4,2,2,0,0,0,0,0,0,19,5,14,0,0,0,0,0,0,4,3,1
157483,20000,200,0,2,8,3,5,0,0,0,0,0,0,1,0,1,0,0,0,0,0,0,7,3,4,0,0,0,0,0,0,0,0,0
157535,20000,200,0,2,21,8,13,0,0,0,4,1,3,1,1,0,0,0,0,0,0,0,15,5,10,0,0,0,1,1,0,0,0,0
157553,20000,200,0,2,5,3,2,0,0,0,0,0,0,0,0,0,0,0,0,0,0,0,5,3,2,0,0,0,0,0,0,0,0,0
157711,20000,200,0,2,6,4,2,0,0,0,0,0,0,0,0,0,1,1,0,0,0,0,5,3,2,0,0,0,0,0,0,0,0,0
157739,20000,200,0,2,4,1,3,0,0,0,0,0,0,0,0,0,0,0,0,0,0,0,4,1,3,0,0,0,0,0,0,0,0,0
157748,20000,200,0,2,1,1,0,0,0,0,0,0,0,0,0,0,0,0,0,0,0,0,0,0,0,0,0,0,1,1,0,0,0,0
157757,20000,200,0,2,10,3,7,0,0,0,1,1,0,2,1,1,0,0,0,0,0,0,7,1,6,0,0,0,0,0,0,0,0,0
157809,20000,200,0,2,8,4,4,0,0,0,1,1,0,0,0,0,0,0,0,0,0,0,7,3,4,0,0,0,0,0,0,0,0,0
157818,20000,200,0,2,4,1,3,0,0,0,0,0,0,0,0,0,0,0,0,0,0,0,4,1,3,0,0,0,0,0,0,0,0,0
157863,20000,200,0,2,4,1,3,0,0,0,0,0,0,0,0,0,0,0,0,0,0,0,3,1,2,0,0,0,0,0,0,1,0,1
157951,20000,200,0,2,55,23,32,0,0,0,5,0,5,2,2,0,2,1,1,0,0,0,43,19,24,0,0,0,3,1,2,0,0,0
158088,20000,200,0,2,17,5,12,0,0,0,0,0,0,4,1,3,0,0,0,0,0,0,7,2,5,0,0,0,6,2,4,0,0,0
158431,20000,200,0,2,15,3,12,0,0,0,0,0,0,0,0,0,1,0,1,0,0,0,14,3,11,0,0,0,0,0,0,0,0,0
158477,20000,200,0,2,1,1,0,0,0,0,1,1,0,0,0,0,0,0,0,0,0,0,0,0,0,0,0,0,0,0,0,0,0,0
158662,20000,200,0,2,11,2,9,0,0,0,0,0,0,1,1,0,0,0,0,0,0,0,10,1,9,0,0,0,0,0,0,0,0,0
158802,20000,200,0,2,9,5,4,0,0,0,0,0,0,6,2,4,0,0,0,0,0,0,3,3,0,0,0,0,0,0,0,0,0,0
158884,20000,200,0,2,8,5,3,0,0,0,1,1,0,2,2,0,0,0,0,0,0,0,5,2,3,0,0,0,0,0,0,0,0,0
159009,20000,200,0,2,15,6,9,0,0,0,2,1,1,10,3,7,0,0,0,0,0,0,2,1,1,0,0,0,0,0,0,1,1,0
159197,20000,200,0,2,3,2,1,0,0,0,0,0,0,0,0,0,0,0,0,0,0,0,3,2,1,0,0,0,0,0,0,0,0,0
159373,20000,200,0,2,55,23,32,0,0,0,9,5,4,6,0,6,1,1,0,0,0,0,33,16,17,0,0,0,1,0,1,5,1,4
159382,20000,200,0,2,7,4,3,0,0,0,0,0,0,0,0,0,0,0,0,0,0,0,7,4,3,0,0,0,0,0,0,0,0,0
159391,20000,200,0,2,138,64,74,1,0,1,8,4,4,13,5,8,12,6,6,0,0,0,78,34,44,3,1,2,4,3,1,19,11,8
159407,20000,200,0,2,12,5,7,0,0,0,0,0,0,1,1,0,0,0,0,0,0,0,9,3,6,1,0,1,0,0,0,1,1,0
159416,20000,200,0,2,20,10,10,0,0,0,3,3,0,2,0,2,2,0,2,0,0,0,13,7,6,0,0,0,0,0,0,0,0,0
159568,20000,200,0,2,7,5,2,0,0,0,0,0,0,0,0,0,0,0,0,0,0,0,6,4,2,0,0,0,0,0,0,1,1,0
159647,20000,200,0,2,19,14,5,0,0,0,2,1,1,0,0,0,0,0,0,0,0,0,16,12,4,0,0,0,0,0,0,1,1,0
159656,20000,200,0,2,21,6,15,0,0,0,3,1,2,5,1,4,1,1,0,0,0,0,8,3,5,0,0,0,1,0,1,3,0,3
159717,20000,200,0,2,13,2,11,1,0,1,0,0,0,0,0,0,0,0,0,0,0,0,11,2,9,0,0,0,1,0,1,0,0,0
159939,20000,200,0,2,69,19,50,0,0,0,4,0,4,23,4,19,3,3,0,0,0,0,35,9,26,2,1,1,0,0,0,2,2,0
159948,20000,200,0,2,2,2,0,0,0,0,0,0,0,0,0,0,0,0,0,0,0,0,2,2,0,0,0,0,0,0,0,0,0,0
159966,20000,200,0,2,15,4,11,0,0,0,1,0,1,1,0,1,0,0,0,0,0,0,12,4,8,0,0,0,0,0,0,1,0,1
159993,20000,200,0,2,32,15,17,0,0,0,7,5,2,6,4,2,2,1,1,0,0,0,17,5,12,0,0,0,0,0,0,0,0,0
160010,20000,200,0,2,6,0,6,0,0,0,0,0,0,2,0,2,0,0,0,0,0,0,4,0,4,0,0,0,0,0,0,0,0,0
160038,20000,200,0,2,38,13,25,0,0,0,0,0,0,0,0,0,2,2,0,0,0,0,20,3,17,0,0,0,14,6,8,2,2,0
160065,20000,200,0,2,4,1,3,0,0,0,0,0,0,1,0,1,1,1,0,0,0,0,2,0,2,0,0,0,0,0,0,0,0,0
160074,20000,200,0,2,3,1,2,0,0,0,0,0,0,0,0,0,0,0,0,0,0,0,3,1,2,0,0,0,0,0,0,0,0,0
160481,20000,200,0,2,6,3,3,0,0,0,0,0,0,0,0,0,0,0,0,0,0,0,6,3,3,0,0,0,0,0,0,0,0,0
160579,20000,200,0,2,9,0,9,0,0,0,0,0,0,3,0,3,1,0,1,0,0,0,5,0,5,0,0,0,0,0,0,0,0,0
160612,20000,200,0,2,49,17,32,0,0,0,1,0,1,7,3,4,1,0,1,0,0,0,33,9,24,0,0,0,0,0,0,7,5,2
160621,20000,200,0,2,45,14,31,0,0,0,1,1,0,37,11,26,1,1,0,0,0,0,6,1,5,0,0,0,0,0,0,0,0,0
160630,20000,200,0,2,6,2,4,0,0,0,0,0,0,6,2,4,0,0,0,0,0,0,0,0,0,0,0,0,0,0,0,0,0,0
160649,20000,200,0,2,5,2,3,0,0,0,0,0,0,5,2,3,0,0,0,0,0,0,0,0,0,0,0,0,0,0,0,0,0,0
160658,20000,200,0,2,31,9,22,0,0,0,1,0,1,1,0,1,5,1,4,0,0,0,21,6,15,0,0,0,1,0,1,2,2,0
160667,20000,200,0,2,12,6,6,0,0,0,0,0,0,0,0,0,0,0,0,0,0,0,12,6,6,0,0,0,0,0,0,0,0,0
160755,20000,200,0,2,104,57,47,2,2,0,16,8,8,10,5,5,8,1,7,0,0,0,59,36,23,1,0,1,0,0,0,8,5,3
160904,20000,200,0,2,17,7,10,0,0,0,0,0,0,8,2,6,0,0,0,1,1,0,4,1,3,0,0,0,0,0,0,4,3,1
160959,20000,200,0,2,1,0,1,0,0,0,1,0,1,0,0,0,0,0,0,0,0,0,0,0,0,0,0,0,0,0,0,0,0,0
160977,20000,200,0,2,9,4,5,0,0,0,3,0,3,1,1,0,0,0,0,0,0,0,3,1,2,2,2,0,0,0,0,0,0,0
160995,20000,200,0,2,5,2,3,0,0,0,0,0,0,0,0,0,0,0,0,0,0,0,5,2,3,0,0,0,0,0,0,0,0,0
161004,20000,200,0,2,22,12,10,0,0,0,5,2,3,1,1,0,2,2,0,0,0,0,8,5,3,0,0,0,3,1,2,3,1,2
161022,20000,200,0,2,2,0,2,0,0,0,0,0,0,0,0,0,0,0,0,0,0,0,2,0,2,0,0,0,0,0,0,0,0,0
161077,20000,200,0,2,8,5,3,0,0,0,0,0,0,0,0,0,0,0,0,0,0,0,7,4,3,0,0,0,1,1,0,0,0,0
161086,20000,200,0,2,35,16,19,0,0,0,1,0,1,0,0,0,1,1,0,0,0,0,18,8,10,2,0,2,3,2,1,10,5,5
161138,20000,200,0,2,6,4,2,0,0,0,0,0,0,0,0,0,0,0,0,0,0,0,6,4,2,0,0,0,0,0,0,0,0,0
161192,20000,200,0,2,10,4,6,0,0,0,0,0,0,0,0,0,0,0,0,0,0,0,10,4,6,0,0,0,0,0,0,0,0,0
161208,20000,200,0,2,1,1,0,0,0,0,0,0,0,0,0,0,0,0,0,0,0,0,1,1,0,0,0,0,0,0,0,0,0,0
161217,20000,200,0,2,4,1,3,0,0,0,0,0,0,0,0,0,0,0,0,0,0,0,4,1,3,0,0,0,0,0,0,0,0,0
161226,20000,200,0,2,4,1,3,0,0,0,0,0,0,0,0,0,0,0,0,0,0,0,4,1,3,0,0,0,0,0,0,0,0,0
161235,20000,200,0,2,3,1,2,0,0,0,0,0,0,0,0,0,0,0,0,0,0,0,2,1,1,0,0,0,1,0,1,0,0,0
161253,20000,200,0,2,35,19,16,0,0,0,4,3,1,1,0,1,0,0,0,0,0,0,23,10,13,2,1,1,1,1,0,4,4,0
161299,20000,200,0,2,5,4,1,0,0,0,0,0,0,0,0,0,0,0,0,0,0,0,5,4,1,0,0,0,0,0,0,0,0,0
161457,20000,200,0,2,35,14,21,0,0,0,0,0,0,0,0,0,1,0,1,0,0,0,31,13,18,0,0,0,1,0,1,2,1,1
161484,20000,200,0,2,3,3,0,0,0,0,0,0,0,0,0,0,0,0,0,0,0,0,3,3,0,0,0,0,0,0,0,0,0,0
161509,20000,200,0,2,2,2,0,0,0,0,0,0,0,0,0,0,0,0,0,0,0,0,2,2,0,0,0,0,0,0,0,0,0,0
161518,20000,200,0,2,2,0,2,0,0,0,0,0,0,0,0,0,0,0,0,0,0,0,2,0,2,0,0,0,0,0,0,0,0,0
161545,20000,200,0,2,8,5,3,0,0,0,0,0,0,0,0,0,0,0,0,0,0,0,8,5,3,0,0,0,0,0,0,0,0,0
161554,20000,200,0,2,15,4,11,0,0,0,1,1,0,0,0,0,0,0,0,0,0,0,13,3,10,0,0,0,0,0,0,1,0,1
161563,20000,200,0,2,2,1,1,0,0,0,0,0,0,0,0,0,0,0,0,0,0,0,2,1,1,0,0,0,0,0,0,0,0,0
161572,20000,200,0,2,2,1,1,0,0,0,0,0,0,0,0,0,0,0,0,0,0,0,2,1,1,0,0,0,0,0,0,0,0,0
161688,20000,200,0,2,6,1,5,0,0,0,0,0,0,0,0,0,0,0,0,0,0,0,6,1,5,0,0,0,0,0,0,0,0,0
161767,20000,200,0,2,13,4,9,0,0,0,1,1,0,5,1,4,1,0,1,0,0,0,6,2,4,0,0,0,0,0,0,0,0,0
161864,20000,200,0,2,7,3,4,0,0,0,1,1,0,3,0,3,0,0,0,0,0,0,3,2,1,0,0,0,0,0,0,0,0,0
161873,20000,200,0,2,17,8,9,0,0,0,4,2,2,2,1,1,1,0,1,0,0,0,9,5,4,0,0,0,1,0,1,0,0,0
162007,20000,200,0,2,13,5,8,0,0,0,0,0,0,10,5,5,1,0,1,0,0,0,1,0,1,0,0,0,1,0,1,0,0,0
162061,20000,200,0,2,1,1,0,0,0,0,0,0,0,1,1,0,0,0,0,0,0,0,0,0,0,0,0,0,0,0,0,0,0,0
162122,20000,200,0,2,7,6,1,0,0,0,0,0,0,3,3,0,0,0,0,0,0,0,4,3,1,0,0,0,0,0,0,0,0,0
162168,20000,200,0,2,3,2,1,0,0,0,0,0,0,0,0,0,0,0,0,0,0,0,1,1,0,0,0,0,2,1,1,0,0,0
162210,20000,200,0,2,1,0,1,0,0,0,0,0,0,0,0,0,0,0,0,0,0,0,1,0,1,0,0,0,0,0,0,0,0,0
162283,20000,200,0,2,9,5,4,0,0,0,2,1,1,7,4,3,0,0,0,0,0,0,0,0,0,0,0,0,0,0,0,0,0,0
162557,20000,200,0,2,8,1,7,0,0,0,0,0,0,0,0,0,1,0,1,0,0,0,7,1,6,0,0,0,0,0,0,0,0,0
162584,20000,200,0,2,13,4,9,0,0,0,1,0,1,0,0,0,0,0,0,0,0,0,10,2,8,0,0,0,0,0,0,2,2,0
162654,20000,200,0,2,6,3,3,0,0,0,1,1,0,1,1,0,0,0,0,0,0,0,4,1,3,0,0,0,0,0,0,0,0,0
162690,20000,200,0,2,2,2,0,0,0,0,0,0,0,0,0,0,0,0,0,0,0,0,1,1,0,0,0,0,1,1,0,0,0,0
162706,20000,200,0,2,2,1,1,0,0,0,0,0,0,0,0,0,0,0,0,0,0,0,2,1,1,0,0,0,0,0,0,0,0,0
162760,20000,200,0,2,13,6,7,0,0,0,3,1,2,1,0,1,0,0,0,0,0,0,8,5,3,0,0,0,1,0,1,0,0,0
162779,20000,200,0,2,8,4,4,0,0,0,1,1,0,2,1,1,0,0,0,0,0,0,4,2,2,1,0,1,0,0,0,0,0,0
162928,20000,200,0,2,385,187,198,7,2,5,78,35,43,31,12,19,17,6,11,0,0,0,193,100,93,7,6,1,1,1,0,51,25,26
163028,20000,200,0,2,21,21,0,0,0,0,1,1,0,10,10,0,0,0,0,0,0,0,7,7,0,1,1,0,2,2,0,0,0,0
163046,20000,200,0,2,21,10,11,0,0,0,2,0,2,2,0,2,3,2,1,0,0,0,14,8,6,0,0,0,0,0,0,0,0,0
163204,20000,200,0,2,10,4,6,0,0,0,1,0,1,0,0,0,0,0,0,0,0,0,4,2,2,0,0,0,5,2,3,0,0,0
163259,20000,200,0,2,295,150,145,0,0,0,57,33,24,24,13,11,18,6,12,0,0,0,109,48,61,4,0,4,1,1,0,82,49,33
163268,20000,200,0,2,32,18,14,0,0,0,1,0,1,2,0,2,1,1,0,0,0,0,16,10,6,0,0,0,4,1,3,8,6,2
163286,20000,200,0,2,333,180,153,0,0,0,30,13,17,14,6,8,19,7,12,0,0,0,128,64,64,2,0,2,33,19,14,107,71,36
163295,20000,200,0,2,12,6,6,0,0,0,2,1,1,2,1,1,1,0,1,0,0,0,2,1,1,0,0,0,1,1,0,4,2,2
163338,20000,200,0,2,14,6,8,0,0,0,2,1,1,6,4,2,1,1,0,0,0,0,3,0,3,1,0,1,1,0,1,0,0,0
163426,20000,200,0,2,29,12,17,0,0,0,2,1,1,13,5,8,3,3,0,0,0,0,7,3,4,0,0,0,1,0,1,3,0,3
163453,20000,200,0,2,14,10,4,0,0,0,1,1,0,7,5,2,1,0,1,0,0,0,1,1,0,0,0,0,2,2,0,2,1,1
163462,20000,200,0,2,9,5,4,0,0,0,1,0,1,2,2,0,1,1,0,0,0,0,4,2,2,1,0,1,0,0,0,0,0,0
163532,20000,200,0,2,1,1,0,0,0,0,0,0,0,0,0,0,0,0,0,0,0,0,1,1,0,0,0,0,0,0,0,0,0,0
163578,20000,200,0,2,15,5,10,0,0,0,3,1,2,3,1,2,0,0,0,0,0,0,8,2,6,1,1,0,0,0,0,0,0,0
163657,20000,200,0,2,11,5,6,0,0,0,1,0,1,4,1,3,0,0,0,0,0,0,5,4,1,1,0,1,0,0,0,0,0,0
163851,20000,200,0,2,27,11,16,0,0,0,3,1,2,1,0,1,2,2,0,0,0,0,13,5,8,0,0,0,0,0,0,8,3,5
163912,20000,200,0,2,11,5,6,0,0,0,0,0,0,0,0,0,2,1,1,0,0,0,6,2,4,0,0,0,0,0,0,3,2,1
163976,20000,200,0,2,4,2,2,0,0,0,0,0,0,0,0,0,0,0,0,0,0,0,4,2,2,0,0,0,0,0,0,0,0,0
164076,20000,200,0,2,64,33,31,1,0,1,12,5,7,2,1,1,3,1,2,0,0,0,42,25,17,1,0,1,2,1,1,1,0,1
164155,20000,200,0,2,32,23,9,0,0,0,3,1,2,2,2,0,2,0,2,0,0,0,22,18,4,0,0,0,3,2,1,0,0,0
164173,20000,200,0,2,6,3,3,0,0,0,0,0,0,2,1,1,0,0,0,0,0,0,4,2,2,0,0,0,0,0,0,0,0,0
164216,20000,200,0,2,7,2,5,0,0,0,3,2,1,1,0,1,1,0,1,0,0,0,2,0,2,0,0,0,0,0,0,0,0,0
164270,20000,200,0,2,20,6,14,0,0,0,2,0,2,3,1,2,2,1,1,0,0,0,13,4,9,0,0,0,0,0,0,0,0,0
164313,20000,200,0,2,4,1,3,0,0,0,2,1,1,0,0,0,0,0,0,0,0,0,2,0,2,0,0,0,0,0,0,0,0,0
164368,20000,200,0,2,16,11,5,0,0,0,5,3,2,1,1,0,2,1,1,0,0,0,5,4,1,0,0,0,3,2,1,0,0,0
164447,20000,200,0,2,3,0,3,0,0,0,0,0,0,0,0,0,0,0,0,0,0,0,3,0,3,0,0,0,0,0,0,0,0,0
164465,20000,200,0,2,23,10,13,0,0,0,1,0,1,7,5,2,2,1,1,0,0,0,9,2,7,0,0,0,0,0,0,4,2,2
164492,20000,200,0,2,5,0,5,0,0,0,0,0,0,0,0,0,0,0,0,0,0,0,5,0,5,0,0,0,0,0,0,0,0,0
164562,20000,200,0,2,5,2,3,0,0,0,0,0,0,0,0,0,1,0,1,0,0,0,3,2,1,1,0,1,0,0,0,0,0,0
164580,20000,200,0,2,1,1,0,0,0,0,0,0,0,0,0,0,0,0,0,0,0,0,1,1,0,0,0,0,0,0,0,0,0,0
164632,20000,200,0,2,2,0,2,0,0,0,0,0,0,0,0,0,0,0,0,0,0,0,2,0,2,0,0,0,0,0,0,0,0,0
164739,20000,200,0,2,20,11,9,0,0,0,5,3,2,2,2,0,0,0,0,0,0,0,10,5,5,0,0,0,1,0,1,2,1,1
164748,20000,200,0,2,9,8,1,1,1,0,1,1,0,0,0,0,2,2,0,0,0,0,5,4,1,0,0,0,0,0,0,0,0,0
164775,20000,200,0,2,1,0,1,0,0,0,0,0,0,0,0,0,1,0,1,0,0,0,0,0,0,0,0,0,0,0,0,0,0,0
164924,20000,200,0,2,129,56,73,0,0,0,7,3,4,13,6,7,5,3,2,0,0,0,69,25,44,2,1,1,4,1,3,29,17,12
164988,20000,200,0,2,438,203,235,0,0,0,52,23,29,20,5,15,27,11,16,0,0,0,171,79,92,8,4,4,33,10,23,127,71,56
165015,20000,200,0,2,26,13,13,0,0,0,1,1,0,2,1,1,2,0,2,0,0,0,15,8,7,0,0,0,2,1,1,4,2,2
165024,20000,200,0,2,8,1,7,0,0,0,1,1,0,1,0,1,0,0,0,0,0,0,5,0,5,0,0,0,1,0,1,0,0,0
165033,20000,200,0,2,7,2,5,0,0,0,0,0,0,0,0,0,0,0,0,0,0,0,7,2,5,0,0,0,0,0,0,0,0,0
165112,20000,200,0,2,9,1,8,0,0,0,1,0,1,0,0,0,2,1,1,0,0,0,6,0,6,0,0,0,0,0,0,0,0,0
165194,20000,200,0,2,3,0,3,0,0,0,0,0,0,0,0,0,1,0,1,0,0,0,2,0,2,0,0,0,0,0,0,0,0,0
165264,20000,200,0,2,1,0,1,0,0,0,0,0,0,0,0,0,0,0,0,0,0,0,1,0,1,0,0,0,0,0,0,0,0,0
165334,20000,200,0,2,35,19,16,0,0,0,1,0,1,7,4,3,1,1,0,0,0,0,16,9,7,2,0,2,0,0,0,8,5,3
165529,20000,200,0,2,5,2,3,0,0,0,0,0,0,2,0,2,0,0,0,0,0,0,2,1,1,0,0,0,1,1,0,0,0,0
165574,20000,200,0,2,2,1,1,0,0,0,0,0,0,0,0,0,0,0,0,0,0,0,2,1,1,0,0,0,0,0,0,0,0,0
165644,20000,200,0,2,4,3,1,0,0,0,1,1,0,0,0,0,0,0,0,0,0,0,1,0,1,0,0,0,2,2,0,0,0,0
165662,20000,200,0,2,9,4,5,0,0,0,1,0,1,4,2,2,0,0,0,0,0,0,2,1,1,0,0,0,2,1,1,0,0,0
165671,20000,200,0,2,4,1,3,0,0,0,0,0,0,0,0,0,1,0,1,0,0,0,3,1,2,0,0,0,0,0,0,0,0,0
165699,20000,200,0,2,5,1,4,0,0,0,1,0,1,0,0,0,0,0,0,0,0,0,2,1,1,0,0,0,2,0,2,0,0,0
165802,20000,200,0,2,3,1,2,0,0,0,1,0,1,0,0,0,0,0,0,0,0,0,2,1,1,0,0,0,0,0,0,0,0,0
165820,20000,200,0,2,3,0,3,0,0,0,0,0,0,0,0,0,0,0,0,0,0,0,3,0,3,0,0,0,0,0,0,0,0,0
165866,20000,200,0,2,3,0,3,0,0,0,0,0,0,0,0,0,0,0,0,0,0,0,3,0,3,0,0,0,0,0,0,0,0,0
165884,20000,200,0,2,1,1,0,0,0,0,0,0,0,0,0,0,0,0,0,0,0,0,1,1,0,0,0,0,0,0,0,0,0,0
165936,20000,200,0,2,8,2,6,0,0,0,2,0,2,0,0,0,0,0,0,0,0,0,4,2,2,0,0,0,2,0,2,0,0,0
165945,20000,200,0,2,2,0,2,0,0,0,0,0,0,0,0,0,0,0,0,0,0,0,2,0,2,0,0,0,0,0,0,0,0,0
165981,20000,200,0,2,2,1,1,0,0,0,0,0,0,0,0,0,0,0,0,0,0,0,2,1,1,0,0,0,0,0,0,0,0,0
166018,20000,200,0,2,2,1,1,0,0,0,0,0,0,0,0,0,1,1,0,0,0,0,1,0,1,0,0,0,0,0,0,0,0,0
166027,20000,200,0,2,716,394,322,1,0,1,67,36,31,23,12,11,37,14,23,0,0,0,238,123,115,10,3,7,4,2,2,336,204,132
166045,20000,200,0,2,1,0,1,0,0,0,0,0,0,0,0,0,0,0,0,0,0,0,1,0,1,0,0,0,0,0,0,0,0,0
166124,20000,200,0,2,20,11,9,0,0,0,2,1,1,0,0,0,3,1,2,0,0,0,10,6,4,1,0,1,2,1,1,2,2,0
166133,20000,200,0,2,2,0,2,0,0,0,1,0,1,0,0,0,0,0,0,0,0,0,1,0,1,0,0,0,0,0,0,0,0,0
166391,20000,200,0,2,2,1,1,0,0,0,0,0,0,0,0,0,0,0,0,0,0,0,0,0,0,1,1,0,1,0,1,0,0,0
166407,20000,200,0,2,2,0,2,0,0,0,0,0,0,0,0,0,0,0,0,0,0,0,2,0,2,0,0,0,0,0,0,0,0,0
166452,20000,200,0,2,9,5,4,0,0,0,2,1,1,2,0,2,0,0,0,0,0,0,5,4,1,0,0,0,0,0,0,0,0,0
166513,20000,200,0,2,48,28,20,0,0,0,2,1,1,0,0,0,3,1,2,0,0,0,13,7,6,1,0,1,3,3,0,26,16,10
166629,20000,200,0,2,142,68,74,1,1,0,4,2,2,5,1,4,7,1,6,0,0,0,58,28,30,0,0,0,0,0,0,67,35,32
166638,20000,200,0,2,34,11,23,1,0,1,4,0,4,2,0,2,2,1,1,0,0,0,14,7,7,0,0,0,4,1,3,7,2,5
166647,20000,200,0,2,6,0,6,0,0,0,1,0,1,2,0,2,0,0,0,0,0,0,2,0,2,0,0,0,1,0,1,0,0,0
166656,20000,200,0,2,11,1,10,0,0,0,1,1,0,0,0,0,0,0,0,0,0,0,8,0,8,1,0,1,1,0,1,0,0,0
166674,20000,200,0,2,17,5,12,0,0,0,2,1,1,1,1,0,3,1,2,0,0,0,8,2,6,0,0,0,3,0,3,0,0,0
166683,20000,200,0,2,903,592,311,0,0,0,78,42,36,28,15,13,23,10,13,0,0,0,298,191,107,12,4,8,42,33,9,422,297,125
166692,20000,200,0,2,1,1,0,0,0,0,0,0,0,0,0,0,0,0,0,0,0,0,1,1,0,0,0,0,0,0,0,0,0,0
166708,20000,200,0,2,377,164,213,0,0,0,73,36,37,16,6,10,22,8,14,0,0,0,175,72,103,0,0,0,11,4,7,80,38,42
166717,20000,200,0,2,14,3,11,0,0,0,0,0,0,2,0,2,1,0,1,0,0,0,8,3,5,0,0,0,3,0,3,0,0,0
166823,20000,200,0,2,1,0,1,0,0,0,0,0,0,0,0,0,0,0,0,0,0,0,1,0,1,0,0,0,0,0,0,0,0,0
166850,20000,200,0,2,15,3,12,0,0,0,1,0,1,2,1,1,0,0,0,0,0,0,9,1,8,2,0,2,1,1,0,0,0,0
166869,20000,200,0,2,12,2,10,0,0,0,0,0,0,0,0,0,0,0,0,0,0,0,12,2,10,0,0,0,0,0,0,0,0,0
166911,20000,200,0,2,4,1,3,0,0,0,1,0,1,0,0,0,0,0,0,0,0,0,1,0,1,0,0,0,2,1,1,0,0,0
166939,20000,200,0,2,24,7,17,0,0,0,3,1,2,3,1,2,0,0,0,0,0,0,8,2,6,0,0,0,5,1,4,5,2,3
166957,20000,200,0,2,5,2,3,0,0,0,0,0,0,0,0,0,1,0,1,0,0,0,4,2,2,0,0,0,0,0,0,0,0,0
167057,20000,200,0,2,3,2,1,0,0,0,0,0,0,1,0,1,0,0,0,0,0,0,2,2,0,0,0,0,0,0,0,0,0,0
167093,20000,200,0,2,2,0,2,0,0,0,0,0,0,0,0,0,0,0,0,0,0,0,1,0,1,0,0,0,1,0,1,0,0,0
167215,20000,200,0,2,6,1,5,0,0,0,0,0,0,0,0,0,1,0,1,0,0,0,5,1,4,0,0,0,0,0,0,0,0,0
167260,20000,200,0,2,4,4,0,0,0,0,0,0,0,1,1,0,0,0,0,0,0,0,3,3,0,0,0,0,0,0,0,0,0,0
167288,20000,200,0,2,4,3,1,0,0,0,0,0,0,0,0,0,0,0,0,0,0,0,4,3,1,0,0,0,0,0,0,0,0,0
167312,20000,200,0,2,6,0,6,0,0,0,0,0,0,0,0,0,1,0,1,0,0,0,5,0,5,0,0,0,0,0,0,0,0,0
167358,20000,200,0,2,199,134,65,0,0,0,31,19,12,5,3,2,4,3,1,0,0,0,73,45,28,3,1,2,31,22,9,52,41,11
167376,20000,200,0,2,8,2,6,0,0,0,0,0,0,1,0,1,0,0,0,0,0,0,7,2,5,0,0,0,0,0,0,0,0,0
167394,20000,200,0,2,4,0,4,0,0,0,0,0,0,1,0,1,0,0,0,0,0,0,3,0,3,0,0,0,0,0,0,0,0,0
167525,20000,200,0,2,7,4,3,0,0,0,1,1,0,0,0,0,1,1,0,0,0,0,5,2,3,0,0,0,0,0,0,0,0,0
167534,20000,200,0,2,9,3,6,0,0,0,2,0,2,0,0,0,1,1,0,0,0,0,6,2,4,0,0,0,0,0,0,0,0,0
167598,20000,200,0,2,9,1,8,0,0,0,0,0,0,5,1,4,2,0,2,0,0,0,2,0,2,0,0,0,0,0,0,0,0,0
167631,20000,200,0,2,1,1,0,0,0,0,0,0,0,1,1,0,0,0,0,0,0,0,0,0,0,0,0,0,0,0,0,0,0,0
167677,20000,200,0,2,1,1,0,0,0,0,0,0,0,0,0,0,0,0,0,0,0,0,1,1,0,0,0,0,0,0,0,0,0,0
167729,20000,200,0,2,16,6,10,0,0,0,0,0,0,1,1,0,1,1,0,0,0,0,14,4,10,0,0,0,0,0,0,0,0,0
167783,20000,200,0,2,27,9,18,0,0,0,1,0,1,6,1,5,2,1,1,0,0,0,16,6,10,0,0,0,0,0,0,2,1,1
167792,20000,200,0,2,3,1,2,0,0,0,1,0,1,0,0,0,0,0,0,0,0,0,1,0,1,0,0,0,0,0,0,1,1,0
167835,20000,200,0,2,19,3,16,0,0,0,1,0,1,6,1,5,0,0,0,0,0,0,5,1,4,2,0,2,0,0,0,5,1,4
167899,20000,200,0,2,26,11,15,0,0,0,4,3,1,2,0,2,1,0,1,0,0,0,15,6,9,3,2,1,1,0,1,0,0,0
167905,20000,200,0,2,3,0,3,0,0,0,0,0,0,0,0,0,1,0,1,0,0,0,2,0,2,0,0,0,0,0,0,0,0,0
167987,20000,200,0,2,13,4,9,0,0,0,0,0,0,1,0,1,0,0,0,0,0,0,12,4,8,0,0,0,0,0,0,0,0,0
167996,20000,200,0,2,12,6,6,0,0,0,1,1,0,0,0,0,0,0,0,0,0,0,1,0,1,0,0,0,10,5,5,0,0,0
168005,20000,200,0,2,9,3,6,0,0,0,2,0,2,0,0,0,1,0,1,0,0,0,6,3,3,0,0,0,0,0,0,0,0,0
168148,20000,200,0,2,155,72,83,0,0,0,23,9,14,15,9,6,21,9,12,0,0,0,62,30,32,4,3,1,6,2,4,24,10,14
168218,20000,200,0,2,13,3,10,0,0,0,1,0,1,0,0,0,1,0,1,1,1,0,5,1,4,1,1,0,1,0,1,3,0,3
168227,20000,200,0,2,8,4,4,0,0,0,1,1,0,0,0,0,0,0,0,0,0,0,5,2,3,0,0,0,2,1,1,0,0,0
168254,20000,200,0,2,3,1,2,0,0,0,1,1,0,0,0,0,0,0,0,0,0,0,1,0,1,0,0,0,1,0,1,0,0,0
168263,20000,200,0,2,3,0,3,0,0,0,1,0,1,0,0,0,0,0,0,0,0,0,2,0,2,0,0,0,0,0,0,0,0,0
168281,20000,200,0,2,9,2,7,0,0,0,1,0,1,2,1,1,1,1,0,0,0,0,5,0,5,0,0,0,0,0,0,0,0,0
168342,20000,200,0,2,20,8,12,0,0,0,2,0,2,4,0,4,4,2,2,0,0,0,4,2,2,0,0,0,0,0,0,6,4,2
168421,20000,200,0,2,53,34,19,0,0,0,4,2,2,1,0,1,3,1,2,0,0,0,12,8,4,1,0,1,6,4,2,26,19,7
168430,20000,200,0,2,30,5,25,1,1,0,0,0,0,0,0,0,0,0,0,0,0,0,28,4,24,1,0,1,0,0,0,0,0,0
168528,20000,200,0,2,4,1,3,0,0,0,0,0,0,0,0,0,0,0,0,0,0,0,4,1,3,0,0,0,0,0,0,0,0,0
168546,20000,200,0,2,17,8,9,0,0,0,3,1,2,1,1,0,3,1,2,0,0,0,9,4,5,0,0,0,0,0,0,1,1,0
168591,20000,200,0,2,7,2,5,0,0,0,2,1,1,1,1,0,0,0,0,0,0,0,4,0,4,0,0,0,0,0,0,0,0,0
168607,20000,200,0,2,4,2,2,0,0,0,0,0,0,0,0,0,0,0,0,0,0,0,4,2,2,0,0,0,0,0,0,0,0,0
168740,20000,200,0,2,17,7,10,0,0,0,1,1,0,3,2,1,3,2,1,0,0,0,6,2,4,1,0,1,0,0,0,3,0,3
168847,20000,200,0,2,12,4,8,0,0,0,0,0,0,1,0,1,0,0,0,0,0,0,11,4,7,0,0,0,0,0,0,0,0,0
168883,20000,200,0,2,1,1,0,0,0,0,0,0,0,0,0,0,0,0,0,0,0,0,1,1,0,0,0,0,0,0,0,0,0,0
169080,20000,200,0,2,4,1,3,0,0,0,1,0,1,0,0,0,0,0,0,0,0,0,3,1,2,0,0,0,0,0,0,0,0,0
169220,20000,200,0,2,2,1,1,0,0,0,0,0,0,1,1,0,0,0,0,0,0,0,1,0,1,0,0,0,0,0,0,0,0,0
169248,20000,200,0,2,21,11,10,0,0,0,3,1,2,0,0,0,0,0,0,0,0,0,17,9,8,0,0,0,0,0,0,1,1,0
169275,20000,200,0,2,1,1,0,0,0,0,0,0,0,0,0,0,0,0,0,0,0,0,1,1,0,0,0,0,0,0,0,0,0,0
169327,20000,200,0,2,2,1,1,0,0,0,0,0,0,0,0,0,0,0,0,0,0,0,2,1,1,0,0,0,0,0,0,0,0,0
169363,20000,200,0,2,8,4,4,0,0,0,0,0,0,0,0,0,0,0,0,0,0,0,8,4,4,0,0,0,0,0,0,0,0,0
169424,20000,200,0,2,1,1,0,0,0,0,0,0,0,0,0,0,0,0,0,0,0,0,1,1,0,0,0,0,0,0,0,0,0,0
169442,20000,200,0,2,1,0,1,0,0,0,0,0,0,0,0,0,0,0,0,0,0,0,1,0,1,0,0,0,0,0,0,0,0,0
169479,20000,200,0,2,11,5,6,0,0,0,0,0,0,2,2,0,0,0,0,0,0,0,6,1,5,1,0,1,1,1,0,1,1,0
169521,20000,200,0,2,2,0,2,0,0,0,0,0,0,0,0,0,0,0,0,0,0,0,2,0,2,0,0,0,0,0,0,0,0,0
169655,20000,200,0,2,14,11,3,0,0,0,0,0,0,5,5,0,1,1,0,0,0,0,7,4,3,1,1,0,0,0,0,0,0,0
169716,20000,200,0,2,24,7,17,0,0,0,1,0,1,0,0,0,1,0,1,0,0,0,5,1,4,0,0,0,2,0,2,15,6,9
169761,20000,200,0,2,3,1,2,0,0,0,0,0,0,1,0,1,0,0,0,0,0,0,2,1,1,0,0,0,0,0,0,0,0,0
169798,20000,200,0,2,19,9,10,1,1,0,2,0,2,2,1,1,1,1,0,0,0,0,12,6,6,0,0,0,1,0,1,0,0,0
169910,20000,200,0,2,3,2,1,0,0,0,0,0,0,0,0,0,0,0,0,0,0,0,2,1,1,0,0,0,0,0,0,1,1,0
169983,20000,200,0,2,12,5,7,0,0,0,3,1,2,1,0,1,0,0,0,0,0,0,7,4,3,1,0,1,0,0,0,0,0,0
169992,20000,200,0,2,3,2,1,0,0,0,0,0,0,0,0,0,0,0,0,0,0,0,3,2,1,0,0,0,0,0,0,0,0,0
170037,20000,200,0,2,4,3,1,0,0,0,0,0,0,0,0,0,1,0,1,0,0,0,3,3,0,0,0,0,0,0,0,0,0,0
170055,20000,200,0,2,17,7,10,0,0,0,0,0,0,1,0,1,0,0,0,0,0,0,16,7,9,0,0,0,0,0,0,0,0,0
170082,20000,200,0,2,49,27,22,0,0,0,2,1,1,1,0,1,2,1,1,0,0,0,39,21,18,0,0,0,2,2,0,3,2,1
170240,20000,200,0,2,18,7,11,0,0,0,2,2,0,3,1,2,0,0,0,0,0,0,12,4,8,0,0,0,0,0,0,1,0,1
170286,20000,200,0,2,22,19,3,0,0,0,0,0,0,0,0,0,0,0,0,0,0,0,0,0,0,0,0,0,22,19,3,0,0,0
170301,20000,200,0,2,20,7,13,0,0,0,2,0,2,1,1,0,1,1,0,1,1,0,12,4,8,2,0,2,0,0,0,1,0,1
170532,20000,200,0,2,9,6,3,0,0,0,2,1,1,4,2,2,0,0,0,0,0,0,3,3,0,0,0,0,0,0,0,0,0,0
170541,20000,200,0,2,2,2,0,0,0,0,0,0,0,0,0,0,0,0,0,0,0,0,1,1,0,0,0,0,1,1,0,0,0,0
170550,20000,200,0,2,9,5,4,0,0,0,1,1,0,0,0,0,0,0,0,0,0,0,8,4,4,0,0,0,0,0,0,0,0,0
170587,20000,200,0,2,4,2,2,0,0,0,0,0,0,0,0,0,0,0,0,0,0,0,4,2,2,0,0,0,0,0,0,0,0,0
170620,20000,200,0,2,4,2,2,0,0,0,0,0,0,2,1,1,0,0,0,0,0,0,2,1,1,0,0,0,0,0,0,0,0,0
170639,20000,200,0,2,17,7,10,0,0,0,0,0,0,0,0,0,0,0,0,0,0,0,15,5,10,0,0,0,1,1,0,1,1,0
170657,20000,200,0,2,8,4,4,0,0,0,0,0,0,2,1,1,0,0,0,0,0,0,6,3,3,0,0,0,0,0,0,0,0,0
170675,20000,200,0,2,17,11,6,0,0,0,1,1,0,0,0,0,1,1,0,0,0,0,12,8,4,0,0,0,1,1,0,2,0,2
170806,20000,200,0,2,4,2,2,0,0,0,0,0,0,0,0,0,0,0,0,0,0,0,4,2,2,0,0,0,0,0,0,0,0,0
170967,20000,200,0,2,5,1,4,0,0,0,0,0,0,1,0,1,0,0,0,0,0,0,4,1,3,0,0,0,0,0,0,0,0,0
170976,20000,200,0,2,667,379,288,2,2,0,49,19,30,24,12,12,14,9,5,0,0,0,255,116,139,12,7,5,18,11,7,293,203,90
171100,20000,200,0,2,248,129,119,1,0,1,16,13,3,8,3,5,13,6,7,0,0,0,109,41,68,1,0,1,0,0,0,100,66,34
171128,20000,200,0,2,27,20,7,0,0,0,1,1,0,0,0,0,1,1,0,0,0,0,9,7,2,0,0,0,9,7,2,7,4,3
171137,20000,200,0,2,7,5,2,0,0,0,1,0,1,0,0,0,0,0,0,0,0,0,4,4,0,1,0,1,0,0,0,1,1,0
171146,20000,200,0,2,8,2,6,0,0,0,0,0,0,1,0,1,0,0,0,0,0,0,6,2,4,0,0,0,0,0,0,1,0,1
171234,20000,200,0,2,2,0,2,0,0,0,0,0,0,0,0,0,0,0,0,0,0,0,2,0,2,0,0,0,0,0,0,0,0,0
171304,20000,200,0,2,1,1,0,0,0,0,0,0,0,0,0,0,0,0,0,0,0,0,1,1,0,0,0,0,0,0,0,0,0,0
171395,20000,200,0,2,3,2,1,0,0,0,0,0,0,0,0,0,0,0,0,0,0,0,3,2,1,0,0,0,0,0,0,0,0,0
171456,20000,200,0,2,16,8,8,0,0,0,0,0,0,0,0,0,0,0,0,0,0,0,14,7,7,0,0,0,1,0,1,1,1,0
171483,20000,200,0,2,3,0,3,0,0,0,0,0,0,0,0,0,0,0,0,0,0,0,3,0,3,0,0,0,0,0,0,0,0,0
171535,20000,200,0,2,11,4,7,0,0,0,0,0,0,2,1,1,0,0,0,0,0,0,9,3,6,0,0,0,0,0,0,0,0,0
171571,20000,200,0,2,28,11,17,1,1,0,3,3,0,1,1,0,0,0,0,0,0,0,17,4,13,0,0,0,0,0,0,6,2,4
171599,20000,200,0,2,3,0,3,0,0,0,0,0,0,1,0,1,1,0,1,0,0,0,1,0,1,0,0,0,0,0,0,0,0,0
171881,20000,200,0,2,1,0,1,0,0,0,0,0,0,0,0,0,0,0,0,0,0,0,1,0,1,0,0,0,0,0,0,0,0,0
172033,20000,200,0,2,4,3,1,0,0,0,0,0,0,0,0,0,0,0,0,0,0,0,4,3,1,0,0,0,0,0,0,0,0,0
172051,20000,200,0,2,13,8,5,0,0,0,0,0,0,0,0,0,0,0,0,0,0,0,13,8,5,0,0,0,0,0,0,0,0,0
172200,20000,200,0,2,5,3,2,0,0,0,0,0,0,1,1,0,0,0,0,0,0,0,3,2,1,0,0,0,1,0,1,0,0,0
172264,20000,200,0,2,4,1,3,0,0,0,0,0,0,0,0,0,0,0,0,0,0,0,4,1,3,0,0,0,0,0,0,0,0,0
172291,20000,200,0,2,5,2,3,0,0,0,0,0,0,0,0,0,0,0,0,0,0,0,5,2,3,0,0,0,0,0,0,0,0,0
172307,20000,200,0,2,4,2,2,0,0,0,0,0,0,0,0,0,0,0,0,0,0,0,2,1,1,0,0,0,2,1,1,0,0,0
172334,20000,200,0,2,8,3,5,0,0,0,0,0,0,0,0,0,0,0,0,0,0,0,7,2,5,0,0,0,1,1,0,0,0,0
172440,20000,200,0,2,11,2,9,0,0,0,0,0,0,0,0,0,0,0,0,0,0,0,11,2,9,0,0,0,0,0,0,0,0,0
172617,20000,200,0,2,1,1,0,1,1,0,0,0,0,0,0,0,0,0,0,0,0,0,0,0,0,0,0,0,0,0,0,0,0,0
172635,20000,200,0,2,3,1,2,0,0,0,0,0,0,2,1,1,0,0,0,0,0,0,1,0,1,0,0,0,0,0,0,0,0,0
172644,20000,200,0,2,208,91,117,0,0,0,21,5,16,11,5,6,7,4,3,0,0,0,95,45,50,9,2,7,2,1,1,63,29,34
172671,20000,200,0,2,1,1,0,0,0,0,0,0,0,0,0,0,0,0,0,0,0,0,1,1,0,0,0,0,0,0,0,0,0,0
172699,20000,200,0,2,17,6,11,0,0,0,2,0,2,4,1,3,0,0,0,0,0,0,11,5,6,0,0,0,0,0,0,0,0,0
172705,20000,200,0,2,1,1,0,0,0,0,0,0,0,0,0,0,1,1,0,0,0,0,0,0,0,0,0,0,0,0,0,0,0,0
172918,20000,200,0,2,2,2,0,0,0,0,0,0,0,0,0,0,0,0,0,0,0,0,2,2,0,0,0,0,0,0,0,0,0,0
172963,20000,200,0,2,3,0,3,0,0,0,1,0,1,0,0,0,0,0,0,0,0,0,2,0,2,0,0,0,0,0,0,0,0,0
173045,20000,200,0,2,11,1,10,0,0,0,2,0,2,0,0,0,1,0,1,1,0,1,4,1,3,1,0,1,2,0,2,0,0,0
173063,20000,200,0,2,4,2,2,0,0,0,0,0,0,0,0,0,0,0,0,0,0,0,4,2,2,0,0,0,0,0,0,0,0,0
173115,20000,200,0,2,1,1,0,0,0,0,0,0,0,0,0,0,0,0,0,0,0,0,1,1,0,0,0,0,0,0,0,0,0,0
173124,20000,200,0,2,17,9,8,2,1,1,1,1,0,0,0,0,1,1,0,0,0,0,9,5,4,1,0,1,3,1,2,0,0,0
173142,20000,200,0,2,3,1,2,0,0,0,0,0,0,0,0,0,0,0,0,0,0,0,3,1,2,0,0,0,0,0,0,0,0,0
173160,20000,200,0,2,11,5,6,0,0,0,0,0,0,0,0,0,0,0,0,0,0,0,9,4,5,0,0,0,2,1,1,0,0,0
173203,20000,200,0,2,3,1,2,0,0,0,0,0,0,0,0,0,0,0,0,0,0,0,2,0,2,0,0,0,1,1,0,0,0,0
173258,20000,200,0,2,25,12,13,0,0,0,4,1,3,0,0,0,7,5,2,0,0,0,13,6,7,1,0,1,0,0,0,0,0,0
173300,20000,200,0,2,6,2,4,0,0,0,0,0,0,0,0,0,1,0,1,0,0,0,5,2,3,0,0,0,0,0,0,0,0,0
173328,20000,200,0,2,5,1,4,0,0,0,0,0,0,0,0,0,0,0,0,0,0,0,4,1,3,0,0,0,1,0,1,0,0,0
173416,20000,200,0,2,5,4,1,0,0,0,1,0,1,0,0,0,0,0,0,0,0,0,4,4,0,0,0,0,0,0,0,0,0,0
173452,20000,200,0,2,5,5,0,0,0,0,0,0,0,1,1,0,0,0,0,0,0,0,4,4,0,0,0,0,0,0,0,0,0,0
173461,20000,200,0,2,2,1,1,0,0,0,0,0,0,0,0,0,0,0,0,0,0,0,1,1,0,0,0,0,1,0,1,0,0,0
173638,20000,200,0,2,5,4,1,0,0,0,0,0,0,0,0,0,0,0,0,0,0,0,5,4,1,0,0,0,0,0,0,0,0,0
173647,20000,200,0,2,4,0,4,0,0,0,0,0,0,1,0,1,0,0,0,0,0,0,3,0,3,0,0,0,0,0,0,0,0,0
173665,20000,200,0,2,4,2,2,0,0,0,0,0,0,0,0,0,1,0,1,0,0,0,2,1,1,0,0,0,1,1,0,0,0,0
173708,20000,200,0,2,1,1,0,0,0,0,0,0,0,0,0,0,0,0,0,0,0,0,1,1,0,0,0,0,0,0,0,0,0,0
173799,20000,200,0,2,6,3,3,0,0,0,1,1,0,1,0,1,1,1,0,0,0,0,2,1,1,0,0,0,1,0,1,0,0,0
173805,20000,200,0,2,2,2,0,0,0,0,0,0,0,0,0,0,0,0,0,0,0,0,2,2,0,0,0,0,0,0,0,0,0,0
173902,20000,200,0,2,14,7,7,0,0,0,2,0,2,1,1,0,1,0,1,0,0,0,6,5,1,0,0,0,0,0,0,4,1,3
173911,20000,200,0,2,9,6,3,0,0,0,0,0,0,1,1,0,0,0,0,0,0,0,8,5,3,0,0,0,0,0,0,0,0,0
173920,20000,200,0,2,32,11,21,0,0,0,4,1,3,2,0,2,4,2,2,0,0,0,22,8,14,0,0,0,0,0,0,0,0,0
174020,20000,200,0,2,11,3,8,0,0,0,2,0,2,1,0,1,1,0,1,0,0,0,5,2,3,0,0,0,2,1,1,0,0,0
174066,20000,200,0,2,607,321,286,3,0,3,61,41,20,24,13,11,18,8,10,1,1,0,257,124,133,19,6,13,68,35,33,156,93,63
174075,20000,200,0,2,6,3,3,0,0,0,0,0,0,0,0,0,0,0,0,0,0,0,5,2,3,0,0,0,0,0,0,1,1,0
174127,20000,200,0,2,2,0,2,0,0,0,0,0,0,1,0,1,0,0,0,0,0,0,1,0,1,0,0,0,0,0,0,0,0,0
174136,20000,200,0,2,3,2,1,0,0,0,0,0,0,0,0,0,0,0,0,0,0,0,3,2,1,0,0,0,0,0,0,0,0,0
174154,20000,200,0,2,7,0,7,0,0,0,0,0,0,0,0,0,0,0,0,0,0,0,7,0,7,0,0,0,0,0,0,0,0,0
174233,20000,200,0,2,34,19,15,0,0,0,2,1,1,0,0,0,1,1,0,0,0,0,23,10,13,0,0,0,2,2,0,6,5,1
174251,20000,200,0,2,4,2,2,0,0,0,0,0,0,0,0,0,0,0,0,0,0,0,1,1,0,1,0,1,2,1,1,0,0,0
174358,20000,200,0,2,13,4,9,0,0,0,0,0,0,0,0,0,0,0,0,0,0,0,11,3,8,0,0,0,1,1,0,1,0,1
174376,20000,200,0,2,2,1,1,0,0,0,0,0,0,0,0,0,0,0,0,0,0,0,1,1,0,0,0,0,1,0,1,0,0,0
174428,20000,200,0,2,5,1,4,0,0,0,2,1,1,0,0,0,0,0,0,0,0,0,3,0,3,0,0,0,0,0,0,0,0,0
174437,20000,200,0,2,1,0,1,0,0,0,0,0,0,0,0,0,0,0,0,0,0,0,1,0,1,0,0,0,0,0,0,0,0,0
174473,20000,200,0,2,3,2,1,0,0,0,0,0,0,0,0,0,0,0,0,0,0,0,3,2,1,0,0,0,0,0,0,0,0,0
174491,20000,200,0,2,3,2,1,0,0,0,0,0,0,0,0,0,1,1,0,0,0,0,2,1,1,0,0,0,0,0,0,0,0,0
174507,20000,200,0,2,2,0,2,0,0,0,0,0,0,0,0,0,0,0,0,0,0,0,2,0,2,0,0,0,0,0,0,0,0,0
174525,20000,200,0,2,1,1,0,0,0,0,0,0,0,0,0,0,0,0,0,0,0,0,1,1,0,0,0,0,0,0,0,0,0,0
174570,20000,200,0,2,1,0,1,0,0,0,0,0,0,0,0,0,0,0,0,0,0,0,1,0,1,0,0,0,0,0,0,0,0,0
174738,20000,200,0,2,1,0,1,0,0,0,0,0,0,0,0,0,0,0,0,0,0,0,1,0,1,0,0,0,0,0,0,0,0,0
174747,20000,200,0,2,6,3,3,0,0,0,1,0,1,1,0,1,0,0,0,0,0,0,3,2,1,0,0,0,1,1,0,0,0,0
174756,20000,200,0,2,3,1,2,0,0,0,0,0,0,0,0,0,0,0,0,0,0,0,3,1,2,0,0,0,0,0,0,0,0,0
174783,20000,200,0,2,21,12,9,0,0,0,5,4,1,1,1,0,1,1,0,0,0,0,11,4,7,0,0,0,3,2,1,0,0,0
174792,20000,200,0,2,8,5,3,0,0,0,1,0,1,0,0,0,1,1,0,0,0,0,5,3,2,1,1,0,0,0,0,0,0,0
174817,20000,200,0,2,4,2,2,0,0,0,0,0,0,1,1,0,0,0,0,0,0,0,3,1,2,0,0,0,0,0,0,0,0,0
174844,20000,200,0,2,18,10,8,0,0,0,1,0,1,1,1,0,1,1,0,0,0,0,13,7,6,0,0,0,1,1,0,1,0,1
174862,20000,200,0,2,2,2,0,0,0,0,1,1,0,0,0,0,0,0,0,0,0,0,1,1,0,0,0,0,0,0,0,0,0,0
174899,20000,200,0,2,10,6,4,0,0,0,1,1,0,0,0,0,0,0,0,0,0,0,8,4,4,1,1,0,0,0,0,0,0,0
174914,20000,200,0,2,15,6,9,0,0,0,2,1,1,1,0,1,2,1,1,0,0,0,9,4,5,0,0,0,0,0,0,1,0,1
175005,20000,200,0,2,30,3,27,0,0,0,1,1,0,5,0,5,0,0,0,0,0,0,24,2,22,0,0,0,0,0,0,0,0,0
175014,20000,200,0,2,20,4,16,0,0,0,0,0,0,2,1,1,0,0,0,0,0,0,16,2,14,1,1,0,1,0,1,0,0,0
175041,20000,200,0,2,4,2,2,0,0,0,0,0,0,0,0,0,1,1,0,0,0,0,3,1,2,0,0,0,0,0,0,0,0,0
175078,20000,200,0,2,4,2,2,0,0,0,0,0,0,0,0,0,0,0,0,0,0,0,4,2,2,0,0,0,0,0,0,0,0,0
175227,20000,200,0,2,11,7,4,0,0,0,1,0,1,0,0,0,0,0,0,0,0,0,10,7,3,0,0,0,0,0,0,0,0,0
175236,20000,200,0,2,4,2,2,0,0,0,0,0,0,0,0,0,0,0,0,0,0,0,3,2,1,0,0,0,1,0,1,0,0,0
175263,20000,200,0,2,2,1,1,0,0,0,0,0,0,0,0,0,0,0,0,0,0,0,2,1,1,0,0,0,0,0,0,0,0,0
175272,20000,200,0,2,23,6,17,0,0,0,2,1,1,0,0,0,1,0,1,0,0,0,17,4,13,1,0,1,2,1,1,0,0,0
175281,20000,200,0,2,5,1,4,0,0,0,0,0,0,3,1,2,0,0,0,0,0,0,2,0,2,0,0,0,0,0,0,0,0,0
175315,20000,200,0,2,1,1,0,0,0,0,0,0,0,1,1,0,0,0,0,0,0,0,0,0,0,0,0,0,0,0,0,0,0,0
175342,20000,200,0,2,8,4,4,0,0,0,0,0,0,7,4,3,0,0,0,0,0,0,1,0,1,0,0,0,0,0,0,0,0,0
175421,20000,200,0,2,6,2,4,0,0,0,0,0,0,2,0,2,0,0,0,0,0,0,4,2,2,0,0,0,0,0,0,0,0,0
175430,20000,200,0,2,3,2,1,0,0,0,0,0,0,1,1,0,0,0,0,0,0,0,2,1,1,0,0,0,0,0,0,0,0,0
175519,20000,200,0,2,8,4,4,0,0,0,0,0,0,5,2,3,0,0,0,0,0,0,3,2,1,0,0,0,0,0,0,0,0,0
175573,20000,200,0,2,4,0,4,0,0,0,0,0,0,1,0,1,0,0,0,0,0,0,2,0,2,1,0,1,0,0,0,0,0,0
175616,20000,200,0,2,12,7,5,0,0,0,2,2,0,1,0,1,0,0,0,0,0,0,7,4,3,0,0,0,0,0,0,2,1,1
175643,20000,200,0,2,4,3,1,0,0,0,0,0,0,0,0,0,0,0,0,0,0,0,4,3,1,0,0,0,0,0,0,0,0,0
175652,20000,200,0,2,2,1,1,0,0,0,0,0,0,1,0,1,0,0,0,0,0,0,1,1,0,0,0,0,0,0,0,0,0,0
175786,20000,200,0,2,31,13,18,0,0,0,0,0,0,11,3,8,1,0,1,0,0,0,18,10,8,0,0,0,1,0,1,0,0,0
175810,20000,200,0,2,11,1,10,0,0,0,0,0,0,2,0,2,0,0,0,0,0,0,9,1,8,0,0,0,0,0,0,0,0,0
175829,20000,200,0,2,5,1,4,0,0,0,0,0,0,0,0,0,0,0,0,0,0,0,5,1,4,0,0,0,0,0,0,0,0,0
175856,20000,200,0,2,41,15,26,1,0,1,4,3,1,25,5,20,1,1,0,0,0,0,8,4,4,0,0,0,0,0,0,2,2,0
175883,20000,200,0,2,19,10,9,0,0,0,1,1,0,3,0,3,0,0,0,0,0,0,15,9,6,0,0,0,0,0,0,0,0,0
175935,20000,200,0,2,7,1,6,0,0,0,0,0,0,3,1,2,0,0,0,0,0,0,3,0,3,0,0,0,1,0,1,0,0,0
175980,20000,200,0,2,2,1,1,0,0,0,0,0,0,0,0,0,1,0,1,0,0,0,1,1,0,0,0,0,0,0,0,0,0,0
176008,20000,200,0,2,10,3,7,0,0,0,0,0,0,4,2,2,0,0,0,0,0,0,6,1,5,0,0,0,0,0,0,0,0,0
176017,20000,200,0,2,105,48,57,0,0,0,9,6,3,15,3,12,3,1,2,0,0,0,56,28,28,2,1,1,1,1,0,19,8,11
176035,20000,200,0,2,15,3,12,0,0,0,1,1,0,2,0,2,0,0,0,0,0,0,11,1,10,0,0,0,0,0,0,1,1,0
176044,20000,200,0,2,7,4,3,0,0,0,1,1,0,4,2,2,0,0,0,0,0,0,2,1,1,0,0,0,0,0,0,0,0,0
176053,20000,200,0,2,21,9,12,0,0,0,0,0,0,1,1,0,0,0,0,0,0,0,7,3,4,0,0,0,12,4,8,1,1,0
176071,20000,200,0,2,38,17,21,0,0,0,1,1,0,4,0,4,1,0,1,0,0,0,21,10,11,0,0,0,11,6,5,0,0,0
176080,20000,200,0,2,87,44,43,0,0,0,6,4,2,6,1,5,3,1,2,0,0,0,50,25,25,0,0,0,1,0,1,21,13,8
176169,20000,200,0,2,8,1,7,0,0,0,0,0,0,0,0,0,0,0,0,0,0,0,6,0,6,0,0,0,2,1,1,0,0,0
176178,20000,200,0,2,21,7,14,0,0,0,0,0,0,4,1,3,0,0,0,0,0,0,17,6,11,0,0,0,0,0,0,0,0,0
176239,20000,200,0,2,24,6,18,0,0,0,0,0,0,4,1,3,0,0,0,0,0,0,20,5,15,0,0,0,0,0,0,0,0,0
176318,20000,200,0,2,12,6,6,0,0,0,0,0,0,11,6,5,0,0,0,0,0,0,1,0,1,0,0,0,0,0,0,0,0,0
176354,20000,200,0,2,5,1,4,0,0,0,0,0,0,0,0,0,0,0,0,0,0,0,5,1,4,0,0,0,0,0,0,0,0,0
176406,20000,200,0,2,2,0,2,0,0,0,0,0,0,2,0,2,0,0,0,0,0,0,0,0,0,0,0,0,0,0,0,0,0,0
176600,20000,200,0,2,1,1,0,0,0,0,0,0,0,0,0,0,0,0,0,0,0,0,1,1,0,0,0,0,0,0,0,0,0,0
176628,20000,200,0,2,7,3,4,0,0,0,0,0,0,0,0,0,0,0,0,0,0,0,7,3,4,0,0,0,0,0,0,0,0,0
176664,20000,200,0,2,4,3,1,0,0,0,0,0,0,0,0,0,0,0,0,0,0,0,4,3,1,0,0,0,0,0,0,0,0,0
176789,20000,200,0,2,1,1,0,0,0,0,1,1,0,0,0,0,0,0,0,0,0,0,0,0,0,0,0,0,0,0,0,0,0,0
176910,20000,200,0,2,1,1,0,0,0,0,0,0,0,0,0,0,0,0,0,0,0,0,1,1,0,0,0,0,0,0,0,0,0,0
176947,20000,200,0,2,8,3,5,0,0,0,0,0,0,0,0,0,0,0,0,0,0,0,8,3,5,0,0,0,0,0,0,0,0,0
176965,20000,200,0,2,23,12,11,0,0,0,0,0,0,0,0,0,1,0,1,0,0,0,17,7,10,0,0,0,0,0,0,5,5,0
177038,20000,200,0,2,1,1,0,0,0,0,0,0,0,1,1,0,0,0,0,0,0,0,0,0,0,0,0,0,0,0,0,0,0,0
177065,20000,200,0,2,5,3,2,0,0,0,0,0,0,0,0,0,0,0,0,0,0,0,5,3,2,0,0,0,0,0,0,0,0,0
177092,20000,200,0,2,3,3,0,0,0,0,0,0,0,0,0,0,1,1,0,0,0,0,2,2,0,0,0,0,0,0,0,0,0,0
177117,20000,200,0,2,5,2,3,0,0,0,0,0,0,0,0,0,0,0,0,0,0,0,2,1,1,0,0,0,0,0,0,3,1,2
177126,20000,200,0,2,2,1,1,0,0,0,0,0,0,0,0,0,0,0,0,0,0,0,2,1,1,0,0,0,0,0,0,0,0,0
177135,20000,200,0,2,13,5,8,1,1,0,0,0,0,0,0,0,1,0,1,0,0,0,8,3,5,1,0,1,2,1,1,0,0,0
177144,20000,200,0,2,5,4,1,0,0,0,1,1,0,0,0,0,0,0,0,0,0,0,4,3,1,0,0,0,0,0,0,0,0,0
177214,20000,200,0,2,4,4,0,0,0,0,0,0,0,0,0,0,0,0,0,0,0,0,0,0,0,0,0,0,4,4,0,0,0,0
177250,20000,200,0,2,6,2,4,0,0,0,0,0,0,0,0,0,0,0,0,0,0,0,5,2,3,1,0,1,0,0,0,0,0,0
177302,20000,200,0,2,4,4,0,0,0,0,1,1,0,1,1,0,0,0,0,0,0,0,2,2,0,0,0,0,0,0,0,0,0,0
177339,20000,200,0,2,2,1,1,0,0,0,0,0,0,0,0,0,0,0,0,0,0,0,2,1,1,0,0,0,0,0,0,0,0,0
177418,20000,200,0,2,11,6,5,1,0,1,2,1,1,0,0,0,2,1,1,0,0,0,6,4,2,0,0,0,0,0,0,0,0,0
177472,20000,200,0,2,10,7,3,0,0,0,0,0,0,0,0,0,0,0,0,0,0,0,8,6,2,0,0,0,2,1,1,0,0,0
177542,20000,200,0,2,5,2,3,0,0,0,0,0,0,0,0,0,0,0,0,0,0,0,5,2,3,0,0,0,0,0,0,0,0,0
177551,20000,200,0,2,1,1,0,0,0,0,0,0,0,0,0,0,0,0,0,0,0,0,1,1,0,0,0,0,0,0,0,0,0,0
177676,20000,200,0,2,5,1,4,0,0,0,0,0,0,0,0,0,0,0,0,0,0,0,5,1,4,0,0,0,0,0,0,0,0,0
177719,20000,200,0,2,5,0,5,0,0,0,0,0,0,2,0,2,0,0,0,0,0,0,3,0,3,0,0,0,0,0,0,0,0,0
177746,20000,200,0,2,4,2,2,0,0,0,0,0,0,1,1,0,1,1,0,0,0,0,2,0,2,0,0,0,0,0,0,0,0,0
177940,20000,200,0,2,6,4,2,0,0,0,2,2,0,0,0,0,0,0,0,0,0,0,4,2,2,0,0,0,0,0,0,0,0,0
177968,20000,200,0,2,8,1,7,0,0,0,0,0,0,1,0,1,0,0,0,0,0,0,6,0,6,0,0,0,0,0,0,1,1,0
177977,20000,200,0,2,18,14,4,0,0,0,0,0,0,0,0,0,0,0,0,0,0,0,17,13,4,1,1,0,0,0,0,0,0,0
177986,20000,200,0,2,6,2,4,0,0,0,0,0,0,0,0,0,0,0,0,0,0,0,5,1,4,1,1,0,0,0,0,0,0,0
177995,20000,200,0,2,9,4,5,0,0,0,0,0,0,1,1,0,0,0,0,0,0,0,8,3,5,0,0,0,0,0,0,0,0,0
178059,20000,200,0,2,8,1,7,0,0,0,0,0,0,1,0,1,0,0,0,0,0,0,7,1,6,0,0,0,0,0,0,0,0,0
178183,20000,200,0,2,2,0,2,0,0,0,0,0,0,0,0,0,0,0,0,0,0,0,2,0,2,0,0,0,0,0,0,0,0,0
178208,20000,200,0,2,2,2,0,0,0,0,0,0,0,0,0,0,1,1,0,0,0,0,1,1,0,0,0,0,0,0,0,0,0,0
178217,20000,200,0,2,1,0,1,0,0,0,0,0,0,0,0,0,0,0,0,0,0,0,1,0,1,0,0,0,0,0,0,0,0,0
178244,20000,200,0,2,6,1,5,0,0,0,0,0,0,1,0,1,0,0,0,0,0,0,5,1,4,0,0,0,0,0,0,0,0,0
178341,20000,200,0,2,10,4,6,0,0,0,0,0,0,1,0,1,0,0,0,0,0,0,8,3,5,0,0,0,0,0,0,1,1,0
178369,20000,200,0,2,9,5,4,0,0,0,2,2,0,0,0,0,0,0,0,0,0,0,7,3,4,0,0,0,0,0,0,0,0,0
178387,20000,200,0,2,11,5,6,0,0,0,0,0,0,0,0,0,2,2,0,0,0,0,3,0,3,0,0,0,6,3,3,0,0,0
178396,20000,200,0,2,162,86,76,1,0,1,17,13,4,9,5,4,4,2,2,0,0,0,95,48,47,1,1,0,17,6,11,18,11,7
178402,20000,200,0,2,43,25,18,0,0,0,3,2,1,6,4,2,3,2,1,0,0,0,25,14,11,0,0,0,1,0,1,5,3,2
178411,20000,200,0,2,12,9,3,0,0,0,1,1,0,0,0,0,0,0,0,0,0,0,3,2,1,0,0,0,1,0,1,7,6,1
178420,20000,200,0,2,6,2,4,0,0,0,1,0,1,1,0,1,0,0,0,0,0,0,3,2,1,0,0,0,1,0,1,0,0,0
178448,20000,200,0,2,9,3,6,0,0,0,0,0,0,1,1,0,0,0,0,0,0,0,8,2,6,0,0,0,0,0,0,0,0,0
178615,20000,200,0,2,17,11,6,0,0,0,2,2,0,1,1,0,0,0,0,0,0,0,11,7,4,0,0,0,0,0,0,3,1,2
178624,20000,200,0,2,18,8,10,0,0,0,1,1,0,0,0,0,0,0,0,0,0,0,12,4,8,0,0,0,0,0,0,5,3,2
178679,20000,200,0,2,1,1,0,0,0,0,0,0,0,0,0,0,0,0,0,0,0,0,1,1,0,0,0,0,0,0,0,0,0,0
178697,20000,200,0,2,8,7,1,0,0,0,0,0,0,0,0,0,0,0,0,0,0,0,8,7,1,0,0,0,0,0,0,0,0,0
178721,20000,200,0,2,8,1,7,1,0,1,0,0,0,0,0,0,0,0,0,0,0,0,6,1,5,1,0,1,0,0,0,0,0,0
178891,20000,200,0,2,7,6,1,0,0,0,0,0,0,1,0,1,0,0,0,0,0,0,6,6,0,0,0,0,0,0,0,0,0,0
178989,20000,200,0,2,4,2,2,0,0,0,0,0,0,0,0,0,0,0,0,0,0,0,4,2,2,0,0,0,0,0,0,0,0,0
179043,20000,200,0,2,14,2,12,0,0,0,0,0,0,0,0,0,0,0,0,0,0,0,11,2,9,0,0,0,2,0,2,1,0,1
179159,20000,200,0,2,111,63,48,1,0,1,12,9,3,9,5,4,6,4,2,0,0,0,54,28,26,1,0,1,0,0,0,28,17,11
179308,20000,200,0,2,27,8,19,0,0,0,0,0,0,2,0,2,0,0,0,0,0,0,20,5,15,0,0,0,3,1,2,2,2,0
179317,20000,200,0,2,1,1,0,0,0,0,0,0,0,1,1,0,0,0,0,0,0,0,0,0,0,0,0,0,0,0,0,0,0,0
179326,20000,200,0,2,12,6,6,0,0,0,1,1,0,0,0,0,0,0,0,0,0,0,11,5,6,0,0,0,0,0,0,0,0,0
179344,20000,200,0,2,4,2,2,0,0,0,0,0,0,0,0,0,0,0,0,0,0,0,2,0,2,0,0,0,2,2,0,0,0,0
179539,20000,200,0,2,9,2,7,0,0,0,0,0,0,0,0,0,1,0,1,0,0,0,8,2,6,0,0,0,0,0,0,0,0,0
179548,20000,200,0,2,8,3,5,0,0,0,0,0,0,0,0,0,0,0,0,0,0,0,8,3,5,0,0,0,0,0,0,0,0,0
179557,20000,200,0,2,23,15,8,0,0,0,1,1,0,0,0,0,1,1,0,0,0,0,17,9,8,0,0,0,4,4,0,0,0,0
179566,20000,200,0,2,41,13,28,1,0,1,2,0,2,3,1,2,5,3,2,0,0,0,24,8,16,0,0,0,0,0,0,6,1,5
179645,20000,200,0,2,2,1,1,0,0,0,0,0,0,0,0,0,0,0,0,0,0,0,2,1,1,0,0,0,0,0,0,0,0,0
179715,20000,200,0,2,5,2,3,0,0,0,0,0,0,0,0,0,0,0,0,0,0,0,5,2,3,0,0,0,0,0,0,0,0,0
179812,20000,200,0,2,8,4,4,0,0,0,0,0,0,0,0,0,1,0,1,0,0,0,6,4,2,1,0,1,0,0,0,0,0,0
179867,20000,200,0,2,479,286,193,1,1,0,109,66,43,31,14,17,22,15,7,1,1,0,186,109,77,9,6,3,15,5,10,105,69,36
179894,20000,200,0,2,6,3,3,0,0,0,0,0,0,0,0,0,0,0,0,0,0,0,3,1,2,1,0,1,2,2,0,0,0,0
179946,20000,200,0,2,1,0,1,0,0,0,0,0,0,0,0,0,0,0,0,0,0,0,1,0,1,0,0,0,0,0,0,0,0,0
179955,20000,200,0,2,3,2,1,0,0,0,0,0,0,0,0,0,0,0,0,0,0,0,3,2,1,0,0,0,0,0,0,0,0,0
179964,20000,200,0,2,3,3,0,0,0,0,0,0,0,0,0,0,0,0,0,0,0,0,3,3,0,0,0,0,0,0,0,0,0,0
180054,20000,200,0,2,3,2,1,3,2,1,0,0,0,0,0,0,0,0,0,0,0,0,0,0,0,0,0,0,0,0,0,0,0,0
180106,20000,200,0,2,19,5,14,0,0,0,0,0,0,0,0,0,0,0,0,0,0,0,11,3,8,0,0,0,8,2,6,0,0,0
180151,20000,200,0,2,2,1,1,0,0,0,0,0,0,0,0,0,0,0,0,0,0,0,2,1,1,0,0,0,0,0,0,0,0,0
180179,20000,200,0,2,21,10,11,0,0,0,0,0,0,0,0,0,0,0,0,0,0,0,20,10,10,0,0,0,1,0,1,0,0,0
180197,20000,200,0,2,7,3,4,0,0,0,0,0,0,0,0,0,0,0,0,0,0,0,7,3,4,0,0,0,0,0,0,0,0,0
180203,20000,200,0,2,2,2,0,1,1,0,0,0,0,0,0,0,0,0,0,0,0,0,1,1,0,0,0,0,0,0,0,0,0,0
180212,20000,200,0,2,2,1,1,0,0,0,0,0,0,0,0,0,0,0,0,0,0,0,2,1,1,0,0,0,0,0,0,0,0,0
180249,20000,200,0,2,2,0,2,0,0,0,0,0,0,0,0,0,0,0,0,0,0,0,2,0,2,0,0,0,0,0,0,0,0,0
180258,20000,200,0,2,2,1,1,0,0,0,0,0,0,0,0,0,1,1,0,0,0,0,0,0,0,1,0,1,0,0,0,0,0,0
180276,20000,200,0,2,2,0,2,0,0,0,0,0,0,0,0,0,0,0,0,0,0,0,2,0,2,0,0,0,0,0,0,0,0,0
180328,20000,200,0,2,1,1,0,1,1,0,0,0,0,0,0,0,0,0,0,0,0,0,0,0,0,0,0,0,0,0,0,0,0,0
180373,20000,200,0,2,5,3,2,0,0,0,0,0,0,0,0,0,0,0,0,0,0,0,3,2,1,0,0,0,2,1,1,0,0,0
180416,20000,200,0,2,8,4,4,0,0,0,0,0,0,0,0,0,0,0,0,0,0,0,8,4,4,0,0,0,0,0,0,0,0,0
180461,20000,200,0,2,93,48,45,1,0,1,3,3,0,0,0,0,3,1,2,0,0,0,67,32,35,4,2,2,4,3,1,11,7,4
180489,20000,200,0,2,52,16,36,1,1,0,11,1,10,0,0,0,3,0,3,0,0,0,32,12,20,1,0,1,2,1,1,2,1,1
180522,20000,200,0,2,5,3,2,0,0,0,0,0,0,0,0,0,0,0,0,0,0,0,5,3,2,0,0,0,0,0,0,0,0,0
180595,20000,200,0,2,5,1,4,0,0,0,0,0,0,0,0,0,0,0,0,0,0,0,3,0,3,0,0,0,2,1,1,0,0,0
180647,20000,200,0,2,8,5,3,3,2,1,0,0,0,0,0,0,1,0,1,0,0,0,4,3,1,0,0,0,0,0,0,0,0,0
180692,20000,200,0,2,5,3,2,0,0,0,1,0,1,0,0,0,0,0,0,0,0,0,1,0,1,1,1,0,2,2,0,0,0,0
180814,20000,200,0,2,3,3,0,0,0,0,0,0,0,0,0,0,0,0,0,0,0,0,2,2,0,0,0,0,1,1,0,0,0,0
180832,20000,200,0,2,4,0,4,0,0,0,0,0,0,0,0,0,0,0,0,0,0,0,4,0,4,0,0,0,0,0,0,0,0,0
180878,20000,200,0,2,1,0,1,0,0,0,0,0,0,0,0,0,0,0,0,0,0,0,1,0,1,0,0,0,0,0,0,0,0,0
180902,20000,200,0,2,9,6,3,0,0,0,2,1,1,0,0,0,0,0,0,0,0,0,7,5,2,0,0,0,0,0,0,0,0,0
180948,20000,200,0,2,6,4,2,0,0,0,0,0,0,1,0,1,0,0,0,0,0,0,5,4,1,0,0,0,0,0,0,0,0,0
180984,20000,200,0,2,4,2,2,0,0,0,1,1,0,0,0,0,0,0,0,0,0,0,3,1,2,0,0,0,0,0,0,0,0,0
181002,20000,200,0,2,46,19,27,0,0,0,6,1,5,0,0,0,2,1,1,0,0,0,25,11,14,1,0,1,11,5,6,1,1,0
181020,20000,200,0,2,11,7,4,0,0,0,3,2,1,0,0,0,1,1,0,0,0,0,6,3,3,0,0,0,1,1,0,0,0,0
181127,20000,200,0,2,7,1,6,0,0,0,0,0,0,0,0,0,0,0,0,0,0,0,7,1,6,0,0,0,0,0,0,0,0,0
181215,20000,200,0,2,30,15,15,0,0,0,4,3,1,0,0,0,0,0,0,0,0,0,21,8,13,0,0,0,0,0,0,5,4,1
181303,20000,200,0,2,12,7,5,0,0,0,0,0,0,0,0,0,1,1,0,0,0,0,11,6,5,0,0,0,0,0,0,0,0,0
181312,20000,200,0,2,15,13,2,0,0,0,0,0,0,0,0,0,0,0,0,0,0,0,15,13,2,0,0,0,0,0,0,0,0,0
181330,20000,200,0,2,2,1,1,0,0,0,0,0,0,0,0,0,0,0,0,0,0,0,2,1,1,0,0,0,0,0,0,0,0,0
181394,20000,200,0,2,46,23,23,0,0,0,1,0,1,2,0,2,3,3,0,0,0,0,24,13,11,0,0,0,4,2,2,12,5,7
181419,20000,200,0,2,7,5,2,5,3,2,1,1,0,0,0,0,0,0,0,0,0,0,1,1,0,0,0,0,0,0,0,0,0,0
181428,20000,200,0,2,118,58,60,2,0,2,15,8,7,4,2,2,4,2,2,0,0,0,77,37,40,1,1,0,3,1,2,12,7,5
181446,20000,200,0,2,15,4,11,0,0,0,1,0,1,1,0,1,0,0,0,0,0,0,11,4,7,1,0,1,0,0,0,1,0,1
181464,20000,200,0,2,105,65,40,0,0,0,4,4,0,0,0,0,3,1,2,0,0,0,44,21,23,1,0,1,0,0,0,53,39,14
181491,20000,200,0,2,13,10,3,0,0,0,0,0,0,0,0,0,0,0,0,0,0,0,13,10,3,0,0,0,0,0,0,0,0,0
181534,20000,200,0,2,3,3,0,0,0,0,0,0,0,0,0,0,0,0,0,0,0,0,3,3,0,0,0,0,0,0,0,0,0,0
181604,20000,200,0,2,6,1,5,0,0,0,0,0,0,0,0,0,0,0,0,0,0,0,6,1,5,0,0,0,0,0,0,0,0,0
181640,20000,200,0,2,20,12,8,0,0,0,1,1,0,1,1,0,0,0,0,0,0,0,18,10,8,0,0,0,0,0,0,0,0,0
181738,20000,200,0,2,10,2,8,0,0,0,0,0,0,0,0,0,2,0,2,0,0,0,8,2,6,0,0,0,0,0,0,0,0,0
181765,20000,200,0,2,1,1,0,0,0,0,0,0,0,0,0,0,0,0,0,0,0,0,1,1,0,0,0,0,0,0,0,0,0,0
181783,20000,200,0,2,8,4,4,0,0,0,0,0,0,0,0,0,1,0,1,0,0,0,7,4,3,0,0,0,0,0,0,0,0,0
181817,20000,200,0,2,9,4,5,0,0,0,0,0,0,0,0,0,0,0,0,0,0,0,9,4,5,0,0,0,0,0,0,0,0,0
181853,20000,200,0,2,3,2,1,0,0,0,0,0,0,0,0,0,0,0,0,0,0,0,3,2,1,0,0,0,0,0,0,0,0,0
181941,20000,200,0,2,10,7,3,1,1,0,0,0,0,0,0,0,2,1,1,0,0,0,7,5,2,0,0,0,0,0,0,0,0,0
182005,20000,200,0,2,10,5,5,0,0,0,2,2,0,2,0,2,0,0,0,0,0,0,5,3,2,0,0,0,1,0,1,0,0,0
182148,20000,200,0,2,14,0,14,0,0,0,0,0,0,1,0,1,4,0,4,0,0,0,9,0,9,0,0,0,0,0,0,0,0,0
182281,20000,200,0,2,45,24,21,0,0,0,12,7,5,2,1,1,3,1,2,0,0,0,17,8,9,2,1,1,0,0,0,9,6,3
182290,20000,200,0,2,41,15,26,0,0,0,2,0,2,0,0,0,6,2,4,0,0,0,27,8,19,0,0,0,0,0,0,6,5,1
182306,20000,200,0,2,5,3,2,0,0,0,0,0,0,0,0,0,0,0,0,0,0,0,4,2,2,0,0,0,0,0,0,1,1,0
182458,20000,200,0,2,1,0,1,0,0,0,0,0,0,1,0,1,0,0,0,0,0,0,0,0,0,0,0,0,0,0,0,0,0,0
182500,20000,200,0,2,6,3,3,0,0,0,0,0,0,1,1,0,1,0,1,0,0,0,4,2,2,0,0,0,0,0,0,0,0,0
182564,20000,200,0,2,1,0,1,0,0,0,0,0,0,0,0,0,0,0,0,0,0,0,1,0,1,0,0,0,0,0,0,0,0,0
182634,20000,200,0,2,9,3,6,0,0,0,0,0,0,0,0,0,1,0,1,0,0,0,8,3,5,0,0,0,0,0,0,0,0,0
182670,20000,200,0,2,30,10,20,0,0,0,2,2,0,0,0,0,0,0,0,0,0,0,24,6,18,0,0,0,0,0,0,4,2,2
182795,20000,200,0,2,6,2,4,0,0,0,0,0,0,0,0,0,0,0,0,0,0,0,6,2,4,0,0,0,0,0,0,0,0,0
182829,20000,200,0,2,3,1,2,0,0,0,1,0,1,0,0,0,0,0,0,0,0,0,1,0,1,0,0,0,1,1,0,0,0,0
182980,20000,200,0,2,5,0,5,0,0,0,0,0,0,1,0,1,0,0,0,0,0,0,4,0,4,0,0,0,0,0,0,0,0,0
183026,20000,200,0,2,2,1,1,0,0,0,0,0,0,0,0,0,0,0,0,0,0,0,2,1,1,0,0,0,0,0,0,0,0,0
183044,20000,200,0,2,82,38,44,0,0,0,6,3,3,2,0,2,6,3,3,0,0,0,32,14,18,2,0,2,5,1,4,29,17,12
183062,20000,200,0,2,10,4,6,0,0,0,0,0,0,0,0,0,0,0,0,0,0,0,5,1,4,0,0,0,3,1,2,2,2,0
183071,20000,200,0,2,1,1,0,0,0,0,0,0,0,0,0,0,0,0,0,0,0,0,1,1,0,0,0,0,0,0,0,0,0,0
183080,20000,200,0,2,15,5,10,0,0,0,0,0,0,0,0,0,0,0,0,0,0,0,12,5,7,0,0,0,1,0,1,2,0,2
183105,20000,200,0,2,1,1,0,0,0,0,0,0,0,0,0,0,0,0,0,0,0,0,1,1,0,0,0,0,0,0,0,0,0,0
183114,20000,200,0,2,1,0,1,0,0,0,0,0,0,0,0,0,0,0,0,0,0,0,1,0,1,0,0,0,0,0,0,0,0,0
183123,20000,200,0,2,5,3,2,0,0,0,0,0,0,0,0,0,0,0,0,0,0,0,4,2,2,0,0,0,1,1,0,0,0,0
183132,20000,200,0,2,1,0,1,0,0,0,0,0,0,0,0,0,0,0,0,0,0,0,0,0,0,1,0,1,0,0,0,0,0,0
183141,20000,200,0,2,2,1,1,0,0,0,0,0,0,0,0,0,0,0,0,0,0,0,2,1,1,0,0,0,0,0,0,0,0,0
183150,20000,200,0,2,1,1,0,0,0,0,0,0,0,0,0,0,0,0,0,0,0,0,1,1,0,0,0,0,0,0,0,0,0,0
183211,20000,200,0,2,4,0,4,0,0,0,1,0,1,0,0,0,0,0,0,0,0,0,3,0,3,0,0,0,0,0,0,0,0,0
183239,20000,200,0,2,12,3,9,0,0,0,0,0,0,1,1,0,1,0,1,0,0,0,9,1,8,0,0,0,1,1,0,0,0,0
183248,20000,200,0,2,2,0,2,0,0,0,0,0,0,0,0,0,0,0,0,0,0,0,2,0,2,0,0,0,0,0,0,0,0,0
183257,20000,200,0,2,3,1,2,0,0,0,0,0,0,0,0,0,0,0,0,0,0,0,3,1,2,0,0,0,0,0,0,0,0,0
183655,20000,200,0,2,8,2,6,0,0,0,0,0,0,0,0,0,1,1,0,0,0,0,7,1,6,0,0,0,0,0,0,0,0,0
183822,20000,200,0,2,4,1,3,0,0,0,0,0,0,3,0,3,0,0,0,0,0,0,1,1,0,0,0,0,0,0,0,0,0,0
183859,20000,200,0,2,15,8,7,0,0,0,0,0,0,0,0,0,0,0,0,0,0,0,13,6,7,1,1,0,1,1,0,0,0,0
183910,20000,200,0,2,3,1,2,0,0,0,0,0,0,0,0,0,0,0,0,0,0,0,3,1,2,0,0,0,0,0,0,0,0,0
183938,20000,200,0,2,5,2,3,0,0,0,1,1,0,0,0,0,0,0,0,0,0,0,4,1,3,0,0,0,0,0,0,0,0,0
183974,20000,200,0,2,4,1,3,0,0,0,0,0,0,0,0,0,0,0,0,0,0,0,4,1,3,0,0,0,0,0,0,0,0,0
184180,20000,200,0,2,2,0,2,0,0,0,0,0,0,0,0,0,0,0,0,0,0,0,2,0,2,0,0,0,0,0,0,0,0,0
184205,20000,200,0,2,5,1,4,0,0,0,0,0,0,0,0,0,0,0,0,0,0,0,5,1,4,0,0,0,0,0,0,0,0,0
184348,20000,200,0,2,4,2,2,0,0,0,2,2,0,1,0,1,0,0,0,0,0,0,0,0,0,0,0,0,0,0,0,1,0,1
184481,20000,200,0,2,5,2,3,0,0,0,0,0,0,3,0,3,0,0,0,0,0,0,1,1,0,0,0,0,1,1,0,0,0,0
184603,20000,200,0,2,9,5,4,0,0,0,1,1,0,1,1,0,0,0,0,0,0,0,6,3,3,0,0,0,1,0,1,0,0,0
184612,20000,200,0,2,16,4,12,0,0,0,0,0,0,1,0,1,4,1,3,0,0,0,10,2,8,1,1,0,0,0,0,0,0,0
184694,20000,200,0,2,11,2,9,0,0,0,4,1,3,0,0,0,0,0,0,0,0,0,3,0,3,1,1,0,3,0,3,0,0,0
184773,20000,200,0,2,6,0,6,0,0,0,0,0,0,0,0,0,1,0,1,0,0,0,5,0,5,0,0,0,0,0,0,0,0,0
184782,20000,200,0,2,61,27,34,0,0,0,6,3,3,8,2,6,3,0,3,0,0,0,36,15,21,3,3,0,2,2,0,3,2,1
184791,20000,200,0,2,4,1,3,0,0,0,0,0,0,0,0,0,0,0,0,0,0,0,3,0,3,0,0,0,1,1,0,0,0,0
184959,20000,200,0,2,3,0,3,0,0,0,0,0,0,0,0,0,0,0,0,0,0,0,3,0,3,0,0,0,0,0,0,0,0,0
184995,20000,200,0,2,1,0,1,0,0,0,0,0,0,0,0,0,1,0,1,0,0,0,0,0,0,0,0,0,0,0,0,0,0,0
185129,20000,200,0,2,8,5,3,0,0,0,2,2,0,2,0,2,1,0,1,0,0,0,3,3,0,0,0,0,0,0,0,0,0,0
185262,20000,200,0,2,40,16,24,0,0,0,9,4,5,6,0,6,6,3,3,0,0,0,13,5,8,1,0,1,2,1,1,3,3,0
185509,20000,200,0,2,2,2,0,0,0,0,1,1,0,0,0,0,0,0,0,0,0,0,1,1,0,0,0,0,0,0,0,0,0,0
185536,20000,200,0,2,2,1,1,0,0,0,0,0,0,1,1,0,0,0,0,0,0,0,1,0,1,0,0,0,0,0,0,0,0,0
185572,20000,200,0,2,10,2,8,0,0,0,0,0,0,0,0,0,1,1,0,0,0,0,8,1,7,1,0,1,0,0,0,0,0,0
185590,20000,200,0,2,17,7,10,0,0,0,2,2,0,4,1,3,2,0,2,0,0,0,3,2,1,0,0,0,2,0,2,4,2,2
185721,20000,200,0,2,1,0,1,0,0,0,0,0,0,0,0,0,0,0,0,0,0,0,1,0,1,0,0,0,0,0,0,0,0,0
185828,20000,200,0,2,45,29,16,0,0,0,8,6,2,0,0,0,2,0,2,0,0,0,16,9,7,0,0,0,1,1,0,18,13,5
185873,20000,200,0,2,6,2,4,0,0,0,2,0,2,0,0,0,1,1,0,0,0,0,3,1,2,0,0,0,0,0,0,0,0,0
186034,20000,200,0,2,2,0,2,0,0,0,0,0,0,0,0,0,0,0,0,0,0,0,2,0,2,0,0,0,0,0,0,0,0,0
186122,20000,200,0,2,1,1,0,0,0,0,0,0,0,0,0,0,0,0,0,0,0,0,1,1,0,0,0,0,0,0,0,0,0,0
186131,20000,200,0,2,42,25,17,0,0,0,4,4,0,1,1,0,2,1,1,0,0,0,7,2,5,0,0,0,14,8,6,14,9,5
186201,20000,200,0,2,4,1,3,0,0,0,1,0,1,1,0,1,0,0,0,0,0,0,2,1,1,0,0,0,0,0,0,0,0,0
186283,20000,200,0,2,7,4,3,0,0,0,1,0,1,2,2,0,3,2,1,0,0,0,1,0,1,0,0,0,0,0,0,0,0,0
186371,20000,200,0,2,12,6,6,0,0,0,0,0,0,0,0,0,0,0,0,0,0,0,1,1,0,0,0,0,7,4,3,4,1,3
186380,20000,200,0,2,484,214,270,0,0,0,18,11,7,11,4,7,9,2,7,0,0,0,40,15,25,2,1,1,319,127,192,85,54,31
186399,20000,200,0,2,47,26,21,0,0,0,2,1,1,2,0,2,1,1,0,0,0,0,2,1,1,0,0,0,19,10,9,21,13,8
186432,20000,200,0,2,3,2,1,0,0,0,2,2,0,0,0,0,0,0,0,0,0,0,1,0,1,0,0,0,0,0,0,0,0,0
186584,20000,200,0,2,17,7,10,0,0,0,0,0,0,0,0,0,3,1,2,0,0,0,12,6,6,1,0,1,1,0,1,0,0,0
186618,20000,200,0,2,11,2,9,0,0,0,1,0,1,0,0,0,0,0,0,0,0,0,8,1,7,0,0,0,2,1,1,0,0,0
186645,20000,200,0,2,6,1,5,0,0,0,1,0,1,1,0,1,1,0,1,0,0,0,3,1,2,0,0,0,0,0,0,0,0,0
186867,20000,200,0,2,41,27,14,0,0,0,4,2,2,0,0,0,1,1,0,0,0,0,13,8,5,0,0,0,1,1,0,22,15,7
186876,20000,200,0,2,12,3,9,0,0,0,0,0,0,1,1,0,0,0,0,0,0,0,9,1,8,0,0,0,1,0,1,1,1,0
187134,20000,200,0,2,17,10,7,0,0,0,1,1,0,3,1,2,1,1,0,0,0,0,11,7,4,0,0,0,1,0,1,0,0,0
187444,20000,200,0,2,8,2,6,0,0,0,1,0,1,3,1,2,2,1,1,0,0,0,2,0,2,0,0,0,0,0,0,0,0,0
187532,20000,200,0,2,6,2,4,0,0,0,0,0,0,0,0,0,1,0,1,0,0,0,5,2,3,0,0,0,0,0,0,0,0,0
187596,20000,200,0,2,18,13,5,6,4,2,0,0,0,2,1,1,0,0,0,0,0,0,6,5,1,0,0,0,1,1,0,3,2,1
187639,20000,200,0,2,8,2,6,0,0,0,0,0,0,1,0,1,2,1,1,0,0,0,5,1,4,0,0,0,0,0,0,0,0,0
187648,20000,200,0,2,9,4,5,0,0,0,0,0,0,0,0,0,0,0,0,0,0,0,6,3,3,0,0,0,0,0,0,3,1,2
187666,20000,200,0,2,4,0,4,0,0,0,0,0,0,0,0,0,3,0,3,0,0,0,1,0,1,0,0,0,0,0,0,0,0,0
187897,20000,200,0,2,14,7,7,0,0,0,0,0,0,1,1,0,2,0,2,0,0,0,9,5,4,0,0,0,0,0,0,2,1,1
187903,20000,200,0,2,15,7,8,0,0,0,0,0,0,2,0,2,1,1,0,0,0,0,12,6,6,0,0,0,0,0,0,0,0,0
187912,20000,200,0,2,9,7,2,0,0,0,1,0,1,1,1,0,0,0,0,0,0,0,5,4,1,0,0,0,0,0,0,2,2,0
187958,20000,200,0,2,2,1,1,1,0,1,0,0,0,0,0,0,0,0,0,0,0,0,0,0,0,0,0,0,0,0,0,1,1,0
187967,20000,200,0,2,7,2,5,0,0,0,1,0,1,0,0,0,2,1,1,0,0,0,4,1,3,0,0,0,0,0,0,0,0,0
187985,20000,200,0,2,147,53,94,3,1,2,14,6,8,4,1,3,18,6,12,0,0,0,71,21,50,2,1,1,4,3,1,31,14,17
187994,20000,200,0,2,3,3,0,0,0,0,0,0,0,1,1,0,1,1,0,0,0,0,1,1,0,0,0,0,0,0,0,0,0,0
188030,20000,200,0,2,20,6,14,0,0,0,2,1,1,1,0,1,1,0,1,0,0,0,14,5,9,0,0,0,0,0,0,2,0,2
188058,20000,200,0,2,1,1,0,0,0,0,0,0,0,0,0,0,0,0,0,0,0,0,0,0,0,0,0,0,1,1,0,0,0,0
188100,20000,200,0,2,9,6,3,0,0,0,1,1,0,1,1,0,1,1,0,0,0,0,2,1,1,0,0,0,4,2,2,0,0,0
188137,20000,200,0,2,6,5,1,0,0,0,0,0,0,0,0,0,4,3,1,0,0,0,1,1,0,1,1,0,0,0,0,0,0,0
188182,20000,200,0,2,4,1,3,0,0,0,0,0,0,0,0,0,0,0,0,0,0,0,0,0,0,0,0,0,4,1,3,0,0,0
188225,20000,200,0,2,1,1,0,0,0,0,0,0,0,0,0,0,0,0,0,0,0,0,1,1,0,0,0,0,0,0,0,0,0,0
188261,20000,200,0,2,2,1,1,0,0,0,0,0,0,0,0,0,0,0,0,0,0,0,2,1,1,0,0,0,0,0,0,0,0,0
188304,20000,200,0,2,10,3,7,0,0,0,0,0,0,0,0,0,1,0,1,0,0,0,5,1,4,0,0,0,3,2,1,1,0,1
188340,20000,200,0,2,1,1,0,0,0,0,0,0,0,1,1,0,0,0,0,0,0,0,0,0,0,0,0,0,0,0,0,0,0,0
188429,20000,200,0,2,20,6,14,0,0,0,4,1,3,3,0,3,3,1,2,0,0,0,10,4,6,0,0,0,0,0,0,0,0,0
188438,20000,200,0,2,11,5,6,0,0,0,1,1,0,0,0,0,0,0,0,0,0,0,10,4,6,0,0,0,0,0,0,0,0,0
188517,20000,200,0,2,2,0,2,0,0,0,0,0,0,0,0,0,0,0,0,0,0,0,1,0,1,0,0,0,1,0,1,0,0,0
188526,20000,200,0,2,15,6,9,0,0,0,2,1,1,1,0,1,0,0,0,0,0,0,8,3,5,1,0,1,0,0,0,3,2,1
188535,20000,200,0,2,3,1,2,0,0,0,0,0,0,1,0,1,1,1,0,0,0,0,1,0,1,0,0,0,0,0,0,0,0,0
188580,20000,200,0,2,50,28,22,0,0,0,8,7,1,1,1,0,5,2,3,0,0,0,30,17,13,0,0,0,6,1,5,0,0,0
188641,20000,200,0,2,14,3,11,0,0,0,2,1,1,0,0,0,2,0,2,0,0,0,8,1,7,1,0,1,0,0,0,1,1,0
188854,20000,200,0,2,3,2,1,0,0,0,0,0,0,0,0,0,0,0,0,0,0,0,2,1,1,1,1,0,0,0,0,0,0,0
189015,20000,200,0,2,1,0,1,0,0,0,0,0,0,0,0,0,0,0,0,0,0,0,1,0,1,0,0,0,0,0,0,0,0,0
189088,20000,200,0,2,4,1,3,0,0,0,1,0,1,1,1,0,0,0,0,0,0,0,0,0,0,0,0,0,1,0,1,1,0,1
189097,20000,200,0,2,24,8,16,0,0,0,3,1,2,2,1,1,0,0,0,0,0,0,17,6,11,0,0,0,2,0,2,0,0,0
189413,20000,200,0,2,2,1,1,0,0,0,0,0,0,1,1,0,1,0,1,0,0,0,0,0,0,0,0,0,0,0,0,0,0,0
189547,20000,200,0,2,3,2,1,1,1,0,0,0,0,0,0,0,0,0,0,0,0,0,2,1,1,0,0,0,0,0,0,0,0,0
189565,20000,200,0,2,2,0,2,0,0,0,0,0,0,0,0,0,0,0,0,0,0,0,1,0,1,0,0,0,1,0,1,0,0,0
189705,20000,200,0,2,3,0,3,0,0,0,0,0,0,0,0,0,0,0,0,0,0,0,3,0,3,0,0,0,0,0,0,0,0,0
189811,20000,200,0,2,1,0,1,0,0,0,1,0,1,0,0,0,0,0,0,0,0,0,0,0,0,0,0,0,0,0,0,0,0,0
189839,20000,200,0,2,1,0,1,0,0,0,0,0,0,0,0,0,0,0,0,0,0,0,1,0,1,0,0,0,0,0,0,0,0,0
189848,20000,200,0,2,2,0,2,0,0,0,0,0,0,0,0,0,0,0,0,0,0,0,2,0,2,0,0,0,0,0,0,0,0,0
189857,20000,200,0,2,5,5,0,0,0,0,0,0,0,0,0,0,0,0,0,0,0,0,5,5,0,0,0,0,0,0,0,0,0,0
190044,20000,200,0,2,17,7,10,0,0,0,0,0,0,2,1,1,0,0,0,0,0,0,8,2,6,0,0,0,0,0,0,7,4,3
190071,20000,200,0,2,2,0,2,0,0,0,0,0,0,0,0,0,0,0,0,0,0,0,2,0,2,0,0,0,0,0,0,0,0,0
190080,20000,200,0,2,1,0,1,0,0,0,0,0,0,1,0,1,0,0,0,0,0,0,0,0,0,0,0,0,0,0,0,0,0,0
190099,20000,200,0,2,37,17,20,0,0,0,3,0,3,2,0,2,2,2,0,1,1,0,17,7,10,2,1,1,1,0,1,9,6,3
190150,20000,200,0,2,862,457,405,1,1,0,108,50,58,55,25,30,42,21,21,0,0,0,230,123,107,11,5,6,29,15,14,386,217,169
190169,20000,200,0,2,4,1,3,0,0,0,0,0,0,0,0,0,0,0,0,0,0,0,4,1,3,0,0,0,0,0,0,0,0,0
190372,20000,200,0,2,4,1,3,0,0,0,0,0,0,1,1,0,0,0,0,0,0,0,3,0,3,0,0,0,0,0,0,0,0,0
190415,20000,200,0,2,441,232,209,2,0,2,24,14,10,17,6,11,27,11,16,0,0,0,168,86,82,12,3,9,0,0,0,191,112,79
190424,20000,200,0,2,172,62,110,0,0,0,60,35,25,16,4,12,7,2,5,0,0,0,63,6,57,0,0,0,1,0,1,25,15,10
190442,20000,200,0,2,4,3,1,0,0,0,0,0,0,1,1,0,0,0,0,0,0,0,3,2,1,0,0,0,0,0,0,0,0,0
190451,20000,200,0,2,1,0,1,0,0,0,0,0,0,0,0,0,0,0,0,0,0,0,1,0,1,0,0,0,0,0,0,0,0,0
190503,20000,200,0,2,5,2,3,0,0,0,1,0,1,0,0,0,1,0,1,0,0,0,3,2,1,0,0,0,0,0,0,0,0,0
190512,20000,200,0,2,19,10,9,0,0,0,4,0,4,0,0,0,3,1,2,0,0,0,7,5,2,0,0,0,0,0,0,5,4,1
190521,20000,200,0,2,20,8,12,0,0,0,3,2,1,6,1,5,2,2,0,0,0,0,8,3,5,0,0,0,0,0,0,1,0,1
190530,20000,200,0,2,3,3,0,0,0,0,0,0,0,1,1,0,1,1,0,0,0,0,1,1,0,0,0,0,0,0,0,0,0,0
190549,20000,200,0,2,21,8,13,0,0,0,0,0,0,5,3,2,1,0,1,0,0,0,11,3,8,0,0,0,0,0,0,4,2,2
190558,20000,200,0,2,4,1,3,0,0,0,0,0,0,0,0,0,1,0,1,0,0,0,2,0,2,0,0,0,0,0,0,1,1,0
190567,20000,200,0,2,17,11,6,0,0,0,1,1,0,1,1,0,2,2,0,0,0,0,10,4,6,2,2,0,0,0,0,1,1,0
190576,20000,200,0,2,21,4,17,0,0,0,1,0,1,6,0,6,4,2,2,0,0,0,9,2,7,1,0,1,0,0,0,0,0,0
190585,20000,200,0,2,1,1,0,0,0,0,0,0,0,0,0,0,0,0,0,0,0,0,1,1,0,0,0,0,0,0,0,0,0,0
190594,20000,200,0,2,15,7,8,0,0,0,2,0,2,3,2,1,2,1,1,0,0,0,8,4,4,0,0,0,0,0,0,0,0,0
190600,20000,200,0,2,37,15,22,0,0,0,1,0,1,9,6,3,5,1,4,0,0,0,22,8,14,0,0,0,0,0,0,0,0,0
190619,20000,200,0,2,19,6,13,0,0,0,2,0,2,4,1,3,3,1,2,0,0,0,10,4,6,0,0,0,0,0,0,0,0,0
190628,20000,200,0,2,3,1,2,0,0,0,0,0,0,0,0,0,2,1,1,0,0,0,1,0,1,0,0,0,0,0,0,0,0,0
190637,20000,200,0,2,12,5,7,0,0,0,1,0,1,3,0,3,1,1,0,0,0,0,6,4,2,0,0,0,0,0,0,1,0,1
190646,20000,200,0,2,14,7,7,0,0,0,1,1,0,11,5,6,0,0,0,0,0,0,2,1,1,0,0,0,0,0,0,0,0,0
190655,20000,200,0,2,3,1,2,0,0,0,1,1,0,1,0,1,0,0,0,0,0,0,1,0,1,0,0,0,0,0,0,0,0,0
190664,20000,200,0,2,28,9,19,0,0,0,5,2,3,4,1,3,2,0,2,0,0,0,17,6,11,0,0,0,0,0,0,0,0,0
190673,20000,200,0,2,3,2,1,0,0,0,0,0,0,1,1,0,0,0,0,0,0,0,2,1,1,0,0,0,0,0,0,0,0,0
190682,20000,200,0,2,3,2,1,0,0,0,1,0,1,1,1,0,1,1,0,0,0,0,0,0,0,0,0,0,0,0,0,0,0,0
190691,20000,200,0,2,8,3,5,0,0,0,2,1,1,3,1,2,0,0,0,0,0,0,3,1,2,0,0,0,0,0,0,0,0,0
190716,20000,200,0,2,13,2,11,0,0,0,1,0,1,4,0,4,0,0,0,0,0,0,8,2,6,0,0,0,0,0,0,0,0,0
190725,20000,200,0,2,12,2,10,0,0,0,0,0,0,0,0,0,1,0,1,0,0,0,11,2,9,0,0,0,0,0,0,0,0,0
190761,20000,200,0,2,3,2,1,0,0,0,0,0,0,0,0,0,0,0,0,0,0,0,3,2,1,0,0,0,0,0,0,0,0,0
190840,20000,200,0,2,3,1,2,0,0,0,0,0,0,0,0,0,0,0,0,0,0,0,1,0,1,0,0,0,2,1,1,0,0,0
190956,20000,200,0,2,4,0,4,0,0,0,0,0,0,0,0,0,0,0,0,0,0,0,4,0,4,0,0,0,0,0,0,0,0,0
190983,20000,200,0,2,11,4,7,0,0,0,0,0,0,0,0,0,0,0,0,0,0,0,11,4,7,0,0,0,0,0,0,0,0,0
191083,20000,200,0,2,3,1,2,0,0,0,0,0,0,1,1,0,0,0,0,0,0,0,1,0,1,0,0,0,1,0,1,0,0,0
191126,20000,200,0,2,2,1,1,0,0,0,0,0,0,0,0,0,0,0,0,0,0,0,2,1,1,0,0,0,0,0,0,0,0,0
191199,20000,200,0,2,1,1,0,0,0,0,0,0,0,0,0,0,0,0,0,0,0,0,1,1,0,0,0,0,0,0,0,0,0,0
191205,20000,200,0,2,2,0,2,0,0,0,1,0,1,0,0,0,0,0,0,0,0,0,1,0,1,0,0,0,0,0,0,0,0,0
191241,20000,200,0,2,50,22,28,0,0,0,6,1,5,3,2,1,4,1,3,0,0,0,25,11,14,0,0,0,7,4,3,5,3,2
191320,20000,200,0,2,1,0,1,0,0,0,0,0,0,0,0,0,0,0,0,0,0,0,1,0,1,0,0,0,0,0,0,0,0,0
191515,20000,200,0,2,38,20,18,0,0,0,3,1,2,0,0,0,2,0,2,0,0,0,16,11,5,1,0,1,3,1,2,13,7,6
191533,20000,200,0,2,6,3,3,0,0,0,0,0,0,0,0,0,0,0,0,0,0,0,2,1,1,0,0,0,3,1,2,1,1,0
191597,20000,200,0,2,6,1,5,0,0,0,1,0,1,4,0,4,0,0,0,0,0,0,1,1,0,0,0,0,0,0,0,0,0,0
191621,20000,200,0,2,4,3,1,0,0,0,0,0,0,0,0,0,0,0,0,0,0,0,4,3,1,0,0,0,0,0,0,0,0,0
191630,20000,200,0,2,16,8,8,0,0,0,2,2,0,1,1,0,2,1,1,0,0,0,10,4,6,0,0,0,1,0,1,0,0,0
191649,20000,200,0,2,20,11,9,0,0,0,2,1,1,2,1,1,1,0,1,0,0,0,9,5,4,0,0,0,0,0,0,6,4,2
191676,20000,200,0,2,7,6,1,0,0,0,1,1,0,1,1,0,0,0,0,0,0,0,3,3,0,0,0,0,1,1,0,1,0,1
191719,20000,200,0,2,7,4,3,0,0,0,0,0,0,0,0,0,0,0,0,0,0,0,7,4,3,0,0,0,0,0,0,0,0,0
191931,20000,200,0,2,16,8,8,0,0,0,3,2,1,2,1,1,1,0,1,0,0,0,9,4,5,0,0,0,1,1,0,0,0,0
191968,20000,200,0,2,7,3,4,0,0,0,0,0,0,0,0,0,0,0,0,0,0,0,2,2,0,0,0,0,5,1,4,0,0,0
191986,20000,200,0,2,6,1,5,0,0,0,0,0,0,0,0,0,0,0,0,0,0,0,6,1,5,0,0,0,0,0,0,0,0,0
192022,20000,200,0,2,4,2,2,0,0,0,0,0,0,0,0,0,1,1,0,0,0,0,3,1,2,0,0,0,0,0,0,0,0,0
192110,20000,200,0,2,2,2,0,0,0,0,0,0,0,1,1,0,0,0,0,0,0,0,0,0,0,0,0,0,0,0,0,1,1,0
192192,20000,200,0,2,2,0,2,0,0,0,0,0,0,0,0,0,0,0,0,0,0,0,2,0,2,0,0,0,0,0,0,0,0,0
192323,20000,200,0,2,12,6,6,0,0,0,1,0,1,1,0,1,1,1,0,0,0,0,9,5,4,0,0,0,0,0,0,0,0,0
192448,20000,200,0,2,37,18,19,0,0,0,5,2,3,3,0,3,0,0,0,0,0,0,19,11,8,0,0,0,6,2,4,4,3,1
192688,20000,200,0,2,2,1,1,0,0,0,1,0,1,0,0,0,1,1,0,0,0,0,0,0,0,0,0,0,0,0,0,0,0,0
192703,20000,200,0,2,3,1,2,0,0,0,0,0,0,0,0,0,1,0,1,0,0,0,1,1,0,0,0,0,1,0,1,0,0,0
192749,20000,200,0,2,13,0,13,0,0,0,2,0,2,1,0,1,3,0,3,0,0,0,5,0,5,0,0,0,2,0,2,0,0,0
192785,20000,200,0,2,2,0,2,0,0,0,0,0,0,0,0,0,0,0,0,0,0,0,2,0,2,0,0,0,0,0,0,0,0,0
192819,20000,200,0,2,8,2,6,0,0,0,2,1,1,1,0,1,0,0,0,0,0,0,5,1,4,0,0,0,0,0,0,0,0,0
192864,20000,200,0,2,7,5,2,0,0,0,0,0,0,0,0,0,0,0,0,0,0,0,0,0,0,0,0,0,7,5,2,0,0,0
192925,20000,200,0,2,11,3,8,1,1,0,0,0,0,2,1,1,0,0,0,1,0,1,7,1,6,0,0,0,0,0,0,0,0,0
193016,20000,200,0,2,26,8,18,0,0,0,2,1,1,5,1,4,3,1,2,0,0,0,14,3,11,0,0,0,1,1,0,1,1,0
193201,20000,200,0,2,1,0,1,0,0,0,0,0,0,0,0,0,0,0,0,0,0,0,1,0,1,0,0,0,0,0,0,0,0,0
193247,20000,200,0,2,1,1,0,0,0,0,0,0,0,0,0,0,0,0,0,0,0,0,1,1,0,0,0,0,0,0,0,0,0,0
193283,20000,200,0,2,5,1,4,0,0,0,0,0,0,0,0,0,0,0,0,0,0,0,5,1,4,0,0,0,0,0,0,0,0,0
193292,20000,200,0,2,12,2,10,0,0,0,0,0,0,0,0,0,1,1,0,0,0,0,11,1,10,0,0,0,0,0,0,0,0,0
193308,20000,200,0,2,9,2,7,0,0,0,3,1,2,1,0,1,2,0,2,0,0,0,3,1,2,0,0,0,0,0,0,0,0,0
193326,20000,200,0,2,4,1,3,0,0,0,0,0,0,0,0,0,0,0,0,0,0,0,4,1,3,0,0,0,0,0,0,0,0,0
193353,20000,200,0,2,2,1,1,0,0,0,1,0,1,0,0,0,0,0,0,0,0,0,1,1,0,0,0,0,0,0,0,0,0,0
193399,20000,200,0,2,9,3,6,0,0,0,0,0,0,1,0,1,0,0,0,0,0,0,8,3,5,0,0,0,0,0,0,0,0,0
193405,20000,200,0,2,285,137,148,0,0,0,33,13,20,6,2,4,9,4,5,0,0,0,57,32,25,1,0,1,159,73,86,20,13,7
193478,20000,200,0,2,2,1,1,0,0,0,0,0,0,0,0,0,0,0,0,0,0,0,2,1,1,0,0,0,0,0,0,0,0,0
193584,20000,200,0,2,8,2,6,0,0,0,1,0,1,0,0,0,2,1,1,0,0,0,5,1,4,0,0,0,0,0,0,0,0,0
193654,20000,200,0,2,15,8,7,0,0,0,0,0,0,2,1,1,2,0,2,0,0,0,7,3,4,0,0,0,1,1,0,3,3,0
193751,20000,200,0,2,1,0,1,0,0,0,0,0,0,0,0,0,0,0,0,0,0,0,1,0,1,0,0,0,0,0,0,0,0,0
193821,20000,200,0,2,3,1,2,0,0,0,0,0,0,0,0,0,0,0,0,0,0,0,1,0,1,0,0,0,2,1,1,0,0,0
193830,20000,200,0,2,18,9,9,0,0,0,8,4,4,3,1,2,1,0,1,0,0,0,6,4,2,0,0,0,0,0,0,0,0,0
193900,20000,200,0,2,846,348,498,3,0,3,154,69,85,58,18,40,70,24,46,2,1,1,356,149,207,11,2,9,51,13,38,141,72,69
193946,20000,200,0,2,3,2,1,0,0,0,0,0,0,0,0,0,0,0,0,0,0,0,3,2,1,0,0,0,0,0,0,0,0,0
193973,20000,200,0,2,27,12,15,0,0,0,0,0,0,0,0,0,0,0,0,0,0,0,21,8,13,0,0,0,3,2,1,3,2,1
194028,20000,200,0,2,5,1,4,0,0,0,0,0,0,0,0,0,0,0,0,0,0,0,5,1,4,0,0,0,0,0,0,0,0,0
194073,20000,200,0,2,1,0,1,0,0,0,1,0,1,0,0,0,0,0,0,0,0,0,0,0,0,0,0,0,0,0,0,0,0,0
194091,20000,200,0,2,10,6,4,0,0,0,0,0,0,2,1,1,0,0,0,0,0,0,6,4,2,2,1,1,0,0,0,0,0,0
194222,20000,200,0,2,2,0,2,0,0,0,0,0,0,0,0,0,0,0,0,0,0,0,2,0,2,0,0,0,0,0,0,0,0,0
194310,20000,200,0,2,27,8,19,0,0,0,3,0,3,2,2,0,4,1,3,0,0,0,15,5,10,0,0,0,2,0,2,1,0,1
194392,20000,200,0,2,5,4,1,0,0,0,2,2,0,0,0,0,0,0,0,0,0,0,3,2,1,0,0,0,0,0,0,0,0,0
194499,20000,200,0,2,1,1,0,0,0,0,0,0,0,0,0,0,1,1,0,0,0,0,0,0,0,0,0,0,0,0,0,0,0,0
194578,20000,200,0,2,9,4,5,0,0,0,2,0,2,1,0,1,1,0,1,0,0,0,5,4,1,0,0,0,0,0,0,0,0,0
194824,20000,200,0,2,26,14,12,0,0,0,14,10,4,1,1,0,0,0,0,0,0,0,11,3,8,0,0,0,0,0,0,0,0,0
194958,20000,200,0,2,5,2,3,0,0,0,0,0,0,0,0,0,0,0,0,0,0,0,5,2,3,0,0,0,0,0,0,0,0,0
195003,20000,200,0,2,62,34,28,0,0,0,11,4,7,1,0,1,6,4,2,1,1,0,30,16,14,2,1,1,3,1,2,8,7,1
195030,20000,200,0,2,241,144,97,0,0,0,28,18,10,11,5,6,6,4,2,0,0,0,105,56,49,0,0,0,0,0,0,91,61,30
195049,20000,200,0,2,39,28,11,0,0,0,1,1,0,0,0,0,3,2,1,0,0,0,15,12,3,1,1,0,0,0,0,19,12,7
195058,20000,200,0,2,4,2,2,0,0,0,0,0,0,0,0,0,0,0,0,0,0,0,4,2,2,0,0,0,0,0,0,0,0,0
195128,20000,200,0,2,7,1,6,0,0,0,1,0,1,1,0,1,0,0,0,0,0,0,5,1,4,0,0,0,0,0,0,0,0,0
195164,20000,200,0,2,22,8,14,0,0,0,3,2,1,2,1,1,1,0,1,1,1,0,15,4,11,0,0,0,0,0,0,0,0,0
195173,20000,200,0,2,9,3,6,0,0,0,1,1,0,2,0,2,0,0,0,0,0,0,5,1,4,1,1,0,0,0,0,0,0,0
195191,20000,200,0,2,1,0,1,0,0,0,0,0,0,0,0,0,0,0,0,0,0,0,1,0,1,0,0,0,0,0,0,0,0,0
195216,20000,200,0,2,9,5,4,0,0,0,1,0,1,0,0,0,1,1,0,0,0,0,5,4,1,0,0,0,1,0,1,1,0,1
195234,20000,200,0,2,3,2,1,0,0,0,0,0,0,1,1,0,0,0,0,0,0,0,2,1,1,0,0,0,0,0,0,0,0,0
195243,20000,200,0,2,4,2,2,0,0,0,0,0,0,0,0,0,3,1,2,0,0,0,1,1,0,0,0,0,0,0,0,0,0,0
195304,20000,200,0,2,3,1,2,0,0,0,0,0,0,1,0,1,2,1,1,0,0,0,0,0,0,0,0,0,0,0,0,0,0,0
195322,20000,200,0,2,3,1,2,0,0,0,0,0,0,0,0,0,0,0,0,0,0,0,3,1,2,0,0,0,0,0,0,0,0,0
195438,20000,200,0,2,3,3,0,0,0,0,0,0,0,0,0,0,0,0,0,0,0,0,3,3,0,0,0,0,0,0,0,0,0,0
195474,20000,200,0,2,20,8,12,0,0,0,0,0,0,1,0,1,1,0,1,0,0,0,14,7,7,0,0,0,0,0,0,4,1,3
195526,20000,200,0,2,2,2,0,0,0,0,0,0,0,0,0,0,0,0,0,0,0,0,2,2,0,0,0,0,0,0,0,0,0,0
195544,20000,200,0,2,12,5,7,0,0,0,0,0,0,1,0,1,0,0,0,0,0,0,3,1,2,0,0,0,8,4,4,0,0,0
195720,20000,200,0,2,21,7,14,0,0,0,2,1,1,4,1,3,0,0,0,0,0,0,14,4,10,0,0,0,1,1,0,0,0,0
195784,20000,200,0,2,1,0,1,0,0,0,0,0,0,0,0,0,0,0,0,0,0,0,1,0,1,0,0,0,0,0,0,0,0,0
195809,20000,200,0,2,25,12,13,0,0,0,5,3,2,1,0,1,5,4,1,0,0,0,12,4,8,1,0,1,0,0,0,1,1,0
195988,20000,200,0,2,2,1,1,0,0,0,0,0,0,0,0,0,0,0,0,0,0,0,2,1,1,0,0,0,0,0,0,0,0,0
196006,20000,200,0,2,25,17,8,0,0,0,1,1,0,1,1,0,2,2,0,0,0,0,20,12,8,0,0,0,0,0,0,1,1,0
196015,20000,200,0,2,6,3,3,0,0,0,0,0,0,1,0,1,0,0,0,0,0,0,3,1,2,0,0,0,0,0,0,2,2,0
196024,20000,200,0,2,5,2,3,0,0,0,0,0,0,0,0,0,0,0,0,0,0,0,4,1,3,1,1,0,0,0,0,0,0,0
196033,20000,200,0,2,6,3,3,0,0,0,0,0,0,0,0,0,0,0,0,0,0,0,6,3,3,0,0,0,0,0,0,0,0,0
196042,20000,200,0,2,3,1,2,0,0,0,1,0,1,0,0,0,0,0,0,0,0,0,2,1,1,0,0,0,0,0,0,0,0,0
196051,20000,200,0,2,3,0,3,0,0,0,0,0,0,0,0,0,0,0,0,0,0,0,3,0,3,0,0,0,0,0,0,0,0,0
196060,20000,200,0,2,13,6,7,0,0,0,1,1,0,0,0,0,0,0,0,0,0,0,9,4,5,1,0,1,0,0,0,2,1,1
196079,20000,200,0,2,45,24,21,0,0,0,4,3,1,2,1,1,1,0,1,0,0,0,29,12,17,1,1,0,0,0,0,8,7,1
196088,20000,200,0,2,54,27,27,2,1,1,6,4,2,5,2,3,5,4,1,0,0,0,27,9,18,0,0,0,0,0,0,9,7,2
196097,20000,200,0,2,126,65,61,0,0,0,25,16,9,4,2,2,10,6,4,0,0,0,56,22,34,2,0,2,15,9,6,14,10,4
196103,20000,200,0,2,6,5,1,0,0,0,0,0,0,0,0,0,0,0,0,0,0,0,6,5,1,0,0,0,0,0,0,0,0,0
196112,20000,200,0,2,3,1,2,0,0,0,1,1,0,0,0,0,0,0,0,0,0,0,1,0,1,0,0,0,0,0,0,1,0,1
196121,20000,200,0,2,6,1,5,0,0,0,0,0,0,0,0,0,0,0,0,0,0,0,6,1,5,0,0,0,0,0,0,0,0,0
196130,20000,200,0,2,4,2,2,0,0,0,0,0,0,0,0,0,0,0,0,0,0,0,2,1,1,0,0,0,0,0,0,2,1,1
196149,20000,200,0,2,7,6,1,0,0,0,0,0,0,5,4,1,0,0,0,0,0,0,2,2,0,0,0,0,0,0,0,0,0,0
196158,20000,200,0,2,4,4,0,0,0,0,0,0,0,1,1,0,0,0,0,0,0,0,2,2,0,0,0,0,0,0,0,1,1,0
196167,20000,200,0,2,3,1,2,0,0,0,1,1,0,0,0,0,0,0,0,0,0,0,2,0,2,0,0,0,0,0,0,0,0,0
196176,20000,200,0,2,10,4,6,0,0,0,1,1,0,2,0,2,0,0,0,0,0,0,6,3,3,0,0,0,0,0,0,1,0,1
196185,20000,200,0,2,22,9,13,1,0,1,2,1,1,1,0,1,1,1,0,0,0,0,14,7,7,0,0,0,0,0,0,3,0,3
196194,20000,200,0,2,3,0,3,0,0,0,1,0,1,0,0,0,0,0,0,0,0,0,1,0,1,0,0,0,0,0,0,1,0,1
196200,20000,200,0,2,11,9,2,0,0,0,0,0,0,2,1,1,1,1,0,0,0,0,8,7,1,0,0,0,0,0,0,0,0,0
196219,20000,200,0,2,5,1,4,0,0,0,0,0,0,1,0,1,1,0,1,0,0,0,3,1,2,0,0,0,0,0,0,0,0,0
196228,20000,200,0,2,1,0,1,0,0,0,1,0,1,0,0,0,0,0,0,0,0,0,0,0,0,0,0,0,0,0,0,0,0,0
196237,20000,200,0,2,2,1,1,0,0,0,0,0,0,0,0,0,1,1,0,0,0,0,1,0,1,0,0,0,0,0,0,0,0,0
196246,20000,200,0,2,8,5,3,0,0,0,0,0,0,0,0,0,0,0,0,0,0,0,3,3,0,1,0,1,0,0,0,4,2,2
196255,20000,200,0,2,17,9,8,0,0,0,1,1,0,7,3,4,2,1,1,0,0,0,7,4,3,0,0,0,0,0,0,0,0,0
196264,20000,200,0,2,6,2,4,0,0,0,1,0,1,0,0,0,0,0,0,0,0,0,5,2,3,0,0,0,0,0,0,0,0,0
196291,20000,200,0,2,3,3,0,0,0,0,2,2,0,0,0,0,0,0,0,0,0,0,1,1,0,0,0,0,0,0,0,0,0,0
196307,20000,200,0,2,45,30,15,0,0,0,11,7,4,1,0,1,1,1,0,0,0,0,21,15,6,0,0,0,0,0,0,11,7,4
196389,20000,200,0,2,7,2,5,0,0,0,1,1,0,3,1,2,2,0,2,0,0,0,1,0,1,0,0,0,0,0,0,0,0,0
196413,20000,200,0,2,93,42,51,1,1,0,13,5,8,10,5,5,9,6,3,0,0,0,28,8,20,3,0,3,0,0,0,29,17,12
196431,20000,200,0,2,2,2,0,0,0,0,0,0,0,0,0,0,0,0,0,0,0,0,2,2,0,0,0,0,0,0,0,0,0,0
196468,20000,200,0,2,9,4,5,0,0,0,1,0,1,0,0,0,1,0,1,0,0,0,4,1,3,1,1,0,0,0,0,2,2,0
196565,20000,200,0,2,1,0,1,0,0,0,0,0,0,0,0,0,0,0,0,0,0,0,1,0,1,0,0,0,0,0,0,0,0,0
196592,20000,200,0,2,30,6,24,0,0,0,2,1,1,2,0,2,6,0,6,0,0,0,15,4,11,3,1,2,2,0,2,0,0,0
196653,20000,200,0,2,6,1,5,0,0,0,0,0,0,1,0,1,0,0,0,0,0,0,5,1,4,0,0,0,0,0,0,0,0,0
196680,20000,200,0,2,2,0,2,0,0,0,1,0,1,0,0,0,0,0,0,0,0,0,1,0,1,0,0,0,0,0,0,0,0,0
196699,20000,200,0,2,2,0,2,0,0,0,0,0,0,0,0,0,0,0,0,0,0,0,2,0,2,0,0,0,0,0,0,0,0,0
196866,20000,200,0,2,6,3,3,0,0,0,0,0,0,0,0,0,0,0,0,0,0,0,3,2,1,0,0,0,0,0,0,3,1,2
196884,20000,200,0,2,1,1,0,0,0,0,0,0,0,1,1,0,0,0,0,0,0,0,0,0,0,0,0,0,0,0,0,0,0,0
197027,20000,200,0,2,4,4,0,0,0,0,0,0,0,0,0,0,0,0,0,0,0,0,4,4,0,0,0,0,0,0,0,0,0,0
197036,20000,200,0,2,30,15,15,0,0,0,0,0,0,1,0,1,0,0,0,0,0,0,29,15,14,0,0,0,0,0,0,0,0,0
197045,20000,200,0,2,12,3,9,0,0,0,1,1,0,1,0,1,0,0,0,0,0,0,9,2,7,1,0,1,0,0,0,0,0,0
197133,20000,200,0,2,30,17,13,1,0,1,1,0,1,3,2,1,3,2,1,0,0,0,13,7,6,1,1,0,3,3,0,5,2,3
197142,20000,200,0,2,2,1,1,0,0,0,0,0,0,0,0,0,0,0,0,0,0,0,2,1,1,0,0,0,0,0,0,0,0,0
197151,20000,200,0,2,3,1,2,0,0,0,0,0,0,0,0,0,0,0,0,0,0,0,1,1,0,0,0,0,1,0,1,1,0,1
197230,20000,200,0,2,6,3,3,0,0,0,0,0,0,0,0,0,1,0,1,0,0,0,4,2,2,1,1,0,0,0,0,0,0,0
197294,20000,200,0,2,3,2,1,0,0,0,0,0,0,0,0,0,0,0,0,0,0,0,3,2,1,0,0,0,0,0,0,0,0,0
197708,20000,200,0,2,15,6,9,0,0,0,1,0,1,2,1,1,4,2,2,0,0,0,8,3,5,0,0,0,0,0,0,0,0,0
197735,20000,200,0,2,3,3,0,0,0,0,0,0,0,0,0,0,0,0,0,0,0,0,3,3,0,0,0,0,0,0,0,0,0,0
197814,20000,200,0,2,5,3,2,0,0,0,0,0,0,1,0,1,0,0,0,0,0,0,4,3,1,0,0,0,0,0,0,0,0,0
197850,20000,200,0,2,11,5,6,0,0,0,0,0,0,1,0,1,0,0,0,0,0,0,10,5,5,0,0,0,0,0,0,0,0,0
197869,20000,200,0,2,59,27,32,0,0,0,4,2,2,2,0,2,1,1,0,0,0,0,37,13,24,1,0,1,2,2,0,12,9,3
197887,20000,200,0,2,11,6,5,0,0,0,0,0,0,0,0,0,0,0,0,0,0,0,11,6,5,0,0,0,0,0,0,0,0,0
197911,20000,200,0,2,8,3,5,0,0,0,1,1,0,2,1,1,0,0,0,0,0,0,4,0,4,0,0,0,1,1,0,0,0,0
197966,20000,200,0,2,4,1,3,0,0,0,0,0,0,1,0,1,0,0,0,0,0,0,3,1,2,0,0,0,0,0,0,0,0,0
197984,20000,200,0,2,13,5,8,0,0,0,0,0,0,1,0,1,1,0,1,0,0,0,11,5,6,0,0,0,0,0,0,0,0,0
197993,20000,200,0,2,1,0,1,0,0,0,0,0,0,0,0,0,0,0,0,0,0,0,1,0,1,0,0,0,0,0,0,0,0,0
198011,20000,200,0,2,6,4,2,2,0,2,0,0,0,0,0,0,0,0,0,0,0,0,4,4,0,0,0,0,0,0,0,0,0,0
198039,20000,200,0,2,14,4,10,0,0,0,0,0,0,1,0,1,0,0,0,0,0,0,13,4,9,0,0,0,0,0,0,0,0,0
198066,20000,200,0,2,2,0,2,0,0,0,0,0,0,0,0,0,0,0,0,0,0,0,2,0,2,0,0,0,0,0,0,0,0,0
198084,20000,200,0,2,4,0,4,0,0,0,0,0,0,1,0,1,0,0,0,0,0,0,3,0,3,0,0,0,0,0,0,0,0,0
198109,20000,200,0,2,3,1,2,0,0,0,0,0,0,1,1,0,0,0,0,0,0,0,2,0,2,0,0,0,0,0,0,0,0,0
198118,20000,200,0,2,14,6,8,0,0,0,0,0,0,0,0,0,0,0,0,0,0,0,14,6,8,0,0,0,0,0,0,0,0,0
198136,20000,200,0,2,14,8,6,0,0,0,1,0,1,2,1,1,2,1,1,0,0,0,9,6,3,0,0,0,0,0,0,0,0,0
198154,20000,200,0,2,8,4,4,0,0,0,0,0,0,0,0,0,1,0,1,0,0,0,6,3,3,1,1,0,0,0,0,0,0,0
198206,20000,200,0,2,4,1,3,0,0,0,0,0,0,0,0,0,0,0,0,0,0,0,4,1,3,0,0,0,0,0,0,0,0,0
198215,20000,200,0,2,10,2,8,0,0,0,0,0,0,0,0,0,0,0,0,0,0,0,10,2,8,0,0,0,0,0,0,0,0,0
198233,20000,200,0,2,10,5,5,0,0,0,1,1,0,0,0,0,0,0,0,0,0,0,8,4,4,0,0,0,1,0,1,0,0,0
198251,20000,200,0,2,8,2,6,0,0,0,0,0,0,2,0,2,0,0,0,0,0,0,6,2,4,0,0,0,0,0,0,0,0,0
198260,20000,200,0,2,14,7,7,0,0,0,0,0,0,1,0,1,0,0,0,0,0,0,11,7,4,0,0,0,2,0,2,0,0,0
198303,20000,200,0,2,6,3,3,0,0,0,0,0,0,2,0,2,0,0,0,0,0,0,4,3,1,0,0,0,0,0,0,0,0,0
198321,20000,200,0,2,5,1,4,0,0,0,0,0,0,0,0,0,1,0,1,0,0,0,4,1,3,0,0,0,0,0,0,0,0,0
198330,20000,200,0,2,9,5,4,0,0,0,0,0,0,0,0,0,0,0,0,0,0,0,9,5,4,0,0,0,0,0,0,0,0,0
198367,20000,200,0,2,3,1,2,0,0,0,0,0,0,0,0,0,0,0,0,0,0,0,3,1,2,0,0,0,0,0,0,0,0,0
198376,20000,200,0,2,15,5,10,0,0,0,0,0,0,1,1,0,0,0,0,0,0,0,13,4,9,1,0,1,0,0,0,0,0,0
198385,20000,200,0,2,18,9,9,0,0,0,2,1,1,1,1,0,4,2,2,0,0,0,10,4,6,0,0,0,1,1,0,0,0,0
198419,20000,200,0,2,178,91,87,1,0,1,24,11,13,14,7,7,15,5,10,0,0,0,100,52,48,1,1,0,0,0,0,23,15,8
198455,20000,200,0,2,7,4,3,0,0,0,0,0,0,5,3,2,0,0,0,0,0,0,2,1,1,0,0,0,0,0,0,0,0,0
198464,20000,200,0,2,87,31,56,0,0,0,7,3,4,4,0,4,11,3,8,0,0,0,47,18,29,2,0,2,6,1,5,10,6,4
198491,20000,200,0,2,7,2,5,0,0,0,0,0,0,2,1,1,0,0,0,0,0,0,5,1,4,0,0,0,0,0,0,0,0,0
198507,20000,200,0,2,11,6,5,0,0,0,0,0,0,6,3,3,0,0,0,0,0,0,4,2,2,0,0,0,0,0,0,1,1,0
198516,20000,200,0,2,37,13,24,0,0,0,4,2,2,5,0,5,3,1,2,0,0,0,23,9,14,0,0,0,2,1,1,0,0,0
198534,20000,200,0,2,37,17,20,4,2,2,2,2,0,12,5,7,0,0,0,0,0,0,19,8,11,0,0,0,0,0,0,0,0,0
198543,20000,200,0,2,11,4,7,0,0,0,1,1,0,7,1,6,0,0,0,0,0,0,1,1,0,0,0,0,0,0,0,2,1,1
198552,20000,200,0,2,14,6,8,0,0,0,0,0,0,6,2,4,0,0,0,0,0,0,7,4,3,1,0,1,0,0,0,0,0,0
198561,20000,200,0,2,6,1,5,0,0,0,0,0,0,1,0,1,1,0,1,0,0,0,4,1,3,0,0,0,0,0,0,0,0,0
198570,20000,200,0,2,19,8,11,0,0,0,0,0,0,0,0,0,0,0,0,0,0,0,19,8,11,0,0,0,0,0,0,0,0,0
198598,20000,200,0,2,1,0,1,0,0,0,0,0,0,0,0,0,0,0,0,0,0,0,1,0,1,0,0,0,0,0,0,0,0,0
198613,20000,200,0,2,7,5,2,0,0,0,3,1,2,0,0,0,0,0,0,0,0,0,4,4,0,0,0,0,0,0,0,0,0,0
198622,20000,200,0,2,21,8,13,0,0,0,0,0,0,5,0,5,0,0,0,0,0,0,16,8,8,0,0,0,0,0,0,0,0,0
198640,20000,200,0,2,3,2,1,0,0,0,0,0,0,0,0,0,0,0,0,0,0,0,3,2,1,0,0,0,0,0,0,0,0,0
198668,20000,200,0,2,4,0,4,0,0,0,0,0,0,0,0,0,0,0,0,0,0,0,4,0,4,0,0,0,0,0,0,0,0,0
198695,20000,200,0,2,34,13,21,0,0,0,1,1,0,5,2,3,1,0,1,0,0,0,26,10,16,1,0,1,0,0,0,0,0,0
198710,20000,200,0,2,3,0,3,0,0,0,0,0,0,0,0,0,0,0,0,0,0,0,3,0,3,0,0,0,0,0,0,0,0,0
198729,20000,200,0,2,2,0,2,0,0,0,0,0,0,0,0,0,1,0,1,0,0,0,1,0,1,0,0,0,0,0,0,0,0,0
198756,20000,200,0,2,6,4,2,0,0,0,1,1,0,3,1,2,0,0,0,0,0,0,2,2,0,0,0,0,0,0,0,0,0,0
198774,20000,200,0,2,7,2,5,0,0,0,0,0,0,0,0,0,0,0,0,0,0,0,7,2,5,0,0,0,0,0,0,0,0,0
198808,20000,200,0,2,11,5,6,0,0,0,0,0,0,0,0,0,1,1,0,0,0,0,10,4,6,0,0,0,0,0,0,0,0,0
198817,20000,200,0,2,11,4,7,0,0,0,0,0,0,1,0,1,0,0,0,0,0,0,10,4,6,0,0,0,0,0,0,0,0,0
198835,20000,200,0,2,18,8,10,0,0,0,2,1,1,2,1,1,0,0,0,0,0,0,11,3,8,1,1,0,2,2,0,0,0,0
198862,20000,200,0,2,8,2,6,0,0,0,0,0,0,6,2,4,0,0,0,0,0,0,2,0,2,0,0,0,0,0,0,0,0,0
198871,20000,200,0,2,3,1,2,0,0,0,0,0,0,1,0,1,0,0,0,0,0,0,2,1,1,0,0,0,0,0,0,0,0,0
198899,20000,200,0,2,5,2,3,0,0,0,0,0,0,0,0,0,0,0,0,0,0,0,5,2,3,0,0,0,0,0,0,0,0,0
198905,20000,200,0,2,1,1,0,0,0,0,0,0,0,0,0,0,0,0,0,0,0,0,1,1,0,0,0,0,0,0,0,0,0,0
198923,20000,200,0,2,3,2,1,0,0,0,0,0,0,0,0,0,0,0,0,0,0,0,3,2,1,0,0,0,0,0,0,0,0,0
198950,20000,200,0,2,7,3,4,0,0,0,0,0,0,1,0,1,1,1,0,0,0,0,4,2,2,0,0,0,1,0,1,0,0,0
198969,20000,200,0,2,17,5,12,0,0,0,2,1,1,2,1,1,0,0,0,0,0,0,11,2,9,1,0,1,1,1,0,0,0,0
198987,20000,200,0,2,5,3,2,0,0,0,0,0,0,0,0,0,0,0,0,0,0,0,5,3,2,0,0,0,0,0,0,0,0,0
199023,20000,200,0,2,4,0,4,0,0,0,0,0,0,0,0,0,0,0,0,0,0,0,4,0,4,0,0,0,0,0,0,0,0,0
199032,20000,200,0,2,6,3,3,0,0,0,0,0,0,2,0,2,0,0,0,0,0,0,4,3,1,0,0,0,0,0,0,0,0,0
199069,20000,200,0,2,3,1,2,0,0,0,0,0,0,0,0,0,0,0,0,0,0,0,3,1,2,0,0,0,0,0,0,0,0,0
199087,20000,200,0,2,6,3,3,0,0,0,0,0,0,0,0,0,0,0,0,0,0,0,5,3,2,1,0,1,0,0,0,0,0,0
199102,20000,200,0,2,44,24,20,0,0,0,2,2,0,11,4,7,3,1,2,0,0,0,5,4,1,0,0,0,13,8,5,10,5,5
199111,20000,200,0,2,11,6,5,0,0,0,0,0,0,1,0,1,1,0,1,0,0,0,1,0,1,0,0,0,7,5,2,1,1,0
199120,20000,200,0,2,242,96,146,0,0,0,12,6,6,17,1,16,11,7,4,0,0,0,95,40,55,8,2,6,84,33,51,15,7,8
199139,20000,200,0,2,50,20,30,0,0,0,0,0,0,16,5,11,4,0,4,0,0,0,25,11,14,1,0,1,0,0,0,4,4,0
199148,20000,200,0,2,70,28,42,0,0,0,3,0,3,7,1,6,2,2,0,0,0,0,45,17,28,0,0,0,1,0,1,12,8,4
199157,20000,200,0,2,16,4,12,0,0,0,0,0,0,4,2,2,0,0,0,0,0,0,4,0,4,0,0,0,8,2,6,0,0,0
199184,20000,200,0,2,5,1,4,0,0,0,1,0,1,1,0,1,0,0,0,0,0,0,3,1,2,0,0,0,0,0,0,0,0,0
199193,20000,200,0,2,91,41,50,1,1,0,11,5,6,8,0,8,4,3,1,0,0,0,52,24,28,0,0,0,3,2,1,12,6,6
199209,20000,200,0,2,9,5,4,0,0,0,0,0,0,0,0,0,0,0,0,0,0,0,9,5,4,0,0,0,0,0,0,0,0,0
199218,20000,200,0,2,67,26,41,0,0,0,3,3,0,5,2,3,2,0,2,0,0,0,35,10,25,3,2,1,6,3,3,13,6,7
199263,20000,200,0,2,2,2,0,0,0,0,0,0,0,0,0,0,0,0,0,0,0,0,2,2,0,0,0,0,0,0,0,0,0,0
199272,20000,200,0,2,1,0,1,0,0,0,0,0,0,0,0,0,0,0,0,0,0,0,1,0,1,0,0,0,0,0,0,0,0,0
199281,20000,200,0,2,28,11,17,1,0,1,2,1,1,3,0,3,0,0,0,0,0,0,20,9,11,0,0,0,0,0,0,2,1,1
199306,20000,200,0,2,10,4,6,0,0,0,0,0,0,2,1,1,0,0,0,0,0,0,8,3,5,0,0,0,0,0,0,0,0,0
199324,20000,200,0,2,12,6,6,0,0,0,0,0,0,3,2,1,1,0,1,0,0,0,8,4,4,0,0,0,0,0,0,0,0,0
199333,20000,200,0,2,6,1,5,0,0,0,0,0,0,1,0,1,0,0,0,0,0,0,5,1,4,0,0,0,0,0,0,0,0,0
199412,20000,200,0,2,4,1,3,0,0,0,0,0,0,1,0,1,1,0,1,0,0,0,2,1,1,0,0,0,0,0,0,0,0,0
199421,20000,200,0,2,2,0,2,0,0,0,0,0,0,0,0,0,0,0,0,0,0,0,1,0,1,0,0,0,1,0,1,0,0,0
199449,20000,200,0,2,13,7,6,0,0,0,0,0,0,1,1,0,0,0,0,0,0,0,12,6,6,0,0,0,0,0,0,0,0,0
199458,20000,200,0,2,1,1,0,0,0,0,0,0,0,0,0,0,0,0,0,0,0,0,1,1,0,0,0,0,0,0,0,0,0,0
199467,20000,200,0,2,2,0,2,0,0,0,0,0,0,0,0,0,0,0,0,0,0,0,2,0,2,0,0,0,0,0,0,0,0,0
199476,20000,200,0,2,7,1,6,2,1,1,0,0,0,2,0,2,0,0,0,0,0,0,3,0,3,0,0,0,0,0,0,0,0,0
199485,20000,200,0,2,1,0,1,0,0,0,0,0,0,0,0,0,0,0,0,0,0,0,1,0,1,0,0,0,0,0,0,0,0,0
199494,20000,200,0,2,5,2,3,0,0,0,0,0,0,2,2,0,0,0,0,0,0,0,3,0,3,0,0,0,0,0,0,0,0,0
199582,20000,200,0,2,1,1,0,0,0,0,0,0,0,1,1,0,0,0,0,0,0,0,0,0,0,0,0,0,0,0,0,0,0,0
199607,20000,200,0,2,1,0,1,0,0,0,0,0,0,0,0,0,0,0,0,0,0,0,1,0,1,0,0,0,0,0,0,0,0,0
199625,20000,200,0,2,8,4,4,1,0,1,0,0,0,1,1,0,0,0,0,0,0,0,6,3,3,0,0,0,0,0,0,0,0,0
199634,20000,200,0,2,7,4,3,0,0,0,0,0,0,0,0,0,0,0,0,0,0,0,7,4,3,0,0,0,0,0,0,0,0,0
199643,20000,200,0,2,8,2,6,0,0,0,0,0,0,8,2,6,0,0,0,0,0,0,0,0,0,0,0,0,0,0,0,0,0,0
199698,20000,200,0,2,5,1,4,0,0,0,0,0,0,1,0,1,0,0,0,0,0,0,4,1,3,0,0,0,0,0,0,0,0,0
199722,20000,200,0,2,12,7,5,0,0,0,0,0,0,2,1,1,0,0,0,0,0,0,10,6,4,0,0,0,0,0,0,0,0,0
199731,20000,200,0,2,4,1,3,0,0,0,0,0,0,0,0,0,0,0,0,0,0,0,4,1,3,0,0,0,0,0,0,0,0,0
199740,20000,200,0,2,3,1,2,0,0,0,0,0,0,1,0,1,0,0,0,0,0,0,2,1,1,0,0,0,0,0,0,0,0,0
199759,20000,200,0,2,1,0,1,0,0,0,0,0,0,0,0,0,0,0,0,0,0,0,1,0,1,0,0,0,0,0,0,0,0,0
199768,20000,200,0,2,4,2,2,0,0,0,0,0,0,0,0,0,0,0,0,0,0,0,4,2,2,0,0,0,0,0,0,0,0,0
199786,20000,200,0,2,6,1,5,0,0,0,0,0,0,0,0,0,0,0,0,0,0,0,6,1,5,0,0,0,0,0,0,0,0,0
199795,20000,200,0,2,3,1,2,0,0,0,0,0,0,0,0,0,0,0,0,0,0,0,3,1,2,0,0,0,0,0,0,0,0,0
199838,20000,200,0,2,1,1,0,0,0,0,1,1,0,0,0,0,0,0,0,0,0,0,0,0,0,0,0,0,0,0,0,0,0,0
199847,20000,200,0,2,133,74,59,1,1,0,22,14,8,13,3,10,4,2,2,0,0,0,79,47,32,4,1,3,0,0,0,10,6,4
199856,20000,200,0,2,34,23,11,0,0,0,2,2,0,5,1,4,0,0,0,0,0,0,21,15,6,0,0,0,6,5,1,0,0,0
199865,20000,200,0,2,2,0,2,0,0,0,0,0,0,0,0,0,0,0,0,0,0,0,1,0,1,0,0,0,0,0,0,1,0,1
199883,20000,200,0,2,1,0,1,0,0,0,0,0,0,1,0,1,0,0,0,0,0,0,0,0,0,0,0,0,0,0,0,0,0,0
199892,20000,200,0,2,10,3,7,0,0,0,0,0,0,0,0,0,0,0,0,0,0,0,10,3,7,0,0,0,0,0,0,0,0,0
199908,20000,200,0,2,2,1,1,0,0,0,0,0,0,0,0,0,0,0,0,0,0,0,2,1,1,0,0,0,0,0,0,0,0,0
199926,20000,200,0,2,3,3,0,0,0,0,0,0,0,0,0,0,0,0,0,0,0,0,3,3,0,0,0,0,0,0,0,0,0,0
199953,20000,200,0,2,2,1,1,0,0,0,0,0,0,1,1,0,0,0,0,0,0,0,1,0,1,0,0,0,0,0,0,0,0,0
199962,20000,200,0,2,6,3,3,0,0,0,1,0,1,1,1,0,0,0,0,0,0,0,4,2,2,0,0,0,0,0,0,0,0,0
199999,20000,200,0,2,13,5,8,0,0,0,1,0,1,8,3,5,0,0,0,0,0,0,4,2,2,0,0,0,0,0,0,0,0,0
200004,20000,200,0,2,47,26,21,0,0,0,3,0,3,5,3,2,5,3,2,0,0,0,31,18,13,0,0,0,0,0,0,3,2,1
200022,20000,200,0,2,5,2,3,1,1,0,0,0,0,0,0,0,0,0,0,0,0,0,4,1,3,0,0,0,0,0,0,0,0,0
200059,20000,200,0,2,5,4,1,0,0,0,0,0,0,0,0,0,0,0,0,0,0,0,5,4,1,0,0,0,0,0,0,0,0,0
200156,20000,200,0,2,7,3,4,0,0,0,0,0,0,0,0,0,0,0,0,0,0,0,7,3,4,0,0,0,0,0,0,0,0,0
200192,20000,200,0,2,2,1,1,0,0,0,0,0,0,0,0,0,0,0,0,0,0,0,2,1,1,0,0,0,0,0,0,0,0,0
200208,20000,200,0,2,3,2,1,2,1,1,0,0,0,0,0,0,0,0,0,0,0,0,1,1,0,0,0,0,0,0,0,0,0,0
200217,20000,200,0,2,11,3,8,0,0,0,1,1,0,0,0,0,0,0,0,0,0,0,10,2,8,0,0,0,0,0,0,0,0,0
200226,20000,200,0,2,1,0,1,0,0,0,0,0,0,0,0,0,0,0,0,0,0,0,1,0,1,0,0,0,0,0,0,0,0,0
200253,20000,200,0,2,22,6,16,0,0,0,0,0,0,0,0,0,0,0,0,0,0,0,22,6,16,0,0,0,0,0,0,0,0,0
200280,20000,200,0,2,59,30,29,2,1,1,5,2,3,3,2,1,1,0,1,0,0,0,27,11,16,0,0,0,0,0,0,21,14,7
200305,20000,200,0,2,7,3,4,0,0,0,0,0,0,0,0,0,0,0,0,0,0,0,7,3,4,0,0,0,0,0,0,0,0,0
200314,20000,200,0,2,3,1,2,1,0,1,0,0,0,0,0,0,0,0,0,0,0,0,2,1,1,0,0,0,0,0,0,0,0,0
200332,20000,200,0,2,68,36,32,0,0,0,7,5,2,0,0,0,1,0,1,0,0,0,31,8,23,1,1,0,2,2,0,26,20,6
200341,20000,200,0,2,5,1,4,0,0,0,0,0,0,0,0,0,0,0,0,0,0,0,5,1,4,0,0,0,0,0,0,0,0,0
200466,20000,200,0,2,1,1,0,0,0,0,0,0,0,0,0,0,0,0,0,0,0,0,1,1,0,0,0,0,0,0,0,0,0,0
200527,20000,200,0,2,4,3,1,3,2,1,0,0,0,0,0,0,0,0,0,0,0,0,1,1,0,0,0,0,0,0,0,0,0,0
200554,20000,200,0,2,1,1,0,0,0,0,0,0,0,0,0,0,0,0,0,0,0,0,1,1,0,0,0,0,0,0,0,0,0,0
200572,20000,200,0,2,10,3,7,0,0,0,0,0,0,0,0,0,0,0,0,0,0,0,10,3,7,0,0,0,0,0,0,0,0,0
200590,20000,200,0,2,1,0,1,0,0,0,0,0,0,0,0,0,0,0,0,0,0,0,1,0,1,0,0,0,0,0,0,0,0,0
200800,20000,200,0,2,21,9,12,0,0,0,3,1,2,1,0,1,2,1,1,0,0,0,12,6,6,0,0,0,0,0,0,3,1,2
201104,20000,200,0,2,13,4,9,0,0,0,0,0,0,3,0,3,0,0,0,0,0,0,8,3,5,0,0,0,0,0,0,2,1,1
201140,20000,200,0,2,1,1,0,0,0,0,0,0,0,0,0,0,0,0,0,0,0,0,1,1,0,0,0,0,0,0,0,0,0,0
201177,20000,200,0,2,1,0,1,0,0,0,0,0,0,0,0,0,0,0,0,0,0,0,1,0,1,0,0,0,0,0,0,0,0,0
201195,20000,200,0,2,12,5,7,0,0,0,1,0,1,1,1,0,1,1,0,0,0,0,9,3,6,0,0,0,0,0,0,0,0,0
201283,20000,200,0,2,1,1,0,0,0,0,0,0,0,0,0,0,0,0,0,0,0,0,1,1,0,0,0,0,0,0,0,0,0,0
201371,20000,200,0,2,2,0,2,0,0,0,0,0,0,0,0,0,0,0,0,0,0,0,2,0,2,0,0,0,0,0,0,0,0,0
201432,20000,200,0,2,3,3,0,0,0,0,0,0,0,0,0,0,0,0,0,0,0,0,2,2,0,0,0,0,1,1,0,0,0,0
201441,20000,200,0,2,42,15,27,0,0,0,0,0,0,2,0,2,0,0,0,0,0,0,18,4,14,0,0,0,22,11,11,0,0,0
201469,20000,200,0,2,3,1,2,0,0,0,0,0,0,0,0,0,0,0,0,0,0,0,3,1,2,0,0,0,0,0,0,0,0,0
201548,20000,200,0,2,14,5,9,0,0,0,1,1,0,1,0,1,0,0,0,0,0,0,11,4,7,0,0,0,1,0,1,0,0,0
201645,20000,200,0,2,128,66,62,0,0,0,44,24,20,11,4,7,6,4,2,0,0,0,53,26,27,0,0,0,2,2,0,12,6,6
201654,20000,200,0,2,15,4,11,0,0,0,0,0,0,1,1,0,0,0,0,0,0,0,14,3,11,0,0,0,0,0,0,0,0,0
201672,20000,200,0,2,1,1,0,0,0,0,0,0,0,0,0,0,0,0,0,0,0,0,1,1,0,0,0,0,0,0,0,0,0,0
201690,20000,200,0,2,18,12,6,0,0,0,2,2,0,5,4,1,1,1,0,0,0,0,8,5,3,0,0,0,2,0,2,0,0,0
201751,20000,200,0,2,2,0,2,0,0,0,0,0,0,0,0,0,0,0,0,0,0,0,1,0,1,0,0,0,1,0,1,0,0,0
201821,20000,200,0,2,10,2,8,0,0,0,0,0,0,0,0,0,0,0,0,0,0,0,10,2,8,0,0,0,0,0,0,0,0,0
201885,20000,200,0,2,168,85,83,0,0,0,25,13,12,9,5,4,4,3,1,0,0,0,94,43,51,2,1,1,12,5,7,22,15,7
201928,20000,200,0,2,4,0,4,0,0,0,0,0,0,1,0,1,0,0,0,0,0,0,3,0,3,0,0,0,0,0,0,0,0,0
201946,20000,200,0,2,5,0,5,0,0,0,0,0,0,0,0,0,1,0,1,0,0,0,4,0,4,0,0,0,0,0,0,0,0,0
201955,20000,200,0,2,2,1,1,0,0,0,0,0,0,0,0,0,0,0,0,0,0,0,1,1,0,0,0,0,1,0,1,0,0,0
201964,20000,200,0,2,1,1,0,0,0,0,0,0,0,0,0,0,0,0,0,0,0,0,1,1,0,0,0,0,0,0,0,0,0,0
201973,20000,200,0,2,8,1,7,0,0,0,0,0,0,0,0,0,0,0,0,0,0,0,7,0,7,0,0,0,1,1,0,0,0,0
202046,20000,200,0,2,5,3,2,0,0,0,0,0,0,0,0,0,0,0,0,0,0,0,5,3,2,0,0,0,0,0,0,0,0,0
202073,20000,200,0,2,2,1,1,0,0,0,0,0,0,0,0,0,0,0,0,0,0,0,2,1,1,0,0,0,0,0,0,0,0,0
202134,20000,200,0,2,32,20,12,0,0,0,3,2,1,2,0,2,1,1,0,0,0,0,22,15,7,0,0,0,0,0,0,4,2,2
202222,20000,200,0,2,13,8,5,0,0,0,0,0,0,0,0,0,1,0,1,1,0,1,10,7,3,0,0,0,1,1,0,0,0,0
202356,20000,200,0,2,30,8,22,0,0,0,0,0,0,5,0,5,1,0,1,0,0,0,21,6,15,2,1,1,1,1,0,0,0,0
202480,20000,200,0,2,60,40,20,0,0,0,7,5,2,4,3,1,1,1,0,0,0,0,44,28,16,0,0,0,0,0,0,4,3,1
202514,20000,200,0,2,4,0,4,0,0,0,0,0,0,0,0,0,0,0,0,0,0,0,4,0,4,0,0,0,0,0,0,0,0,0
202523,20000,200,0,2,18,6,12,0,0,0,2,1,1,1,0,1,0,0,0,0,0,0,15,5,10,0,0,0,0,0,0,0,0,0
202648,20000,200,0,2,3,1,2,0,0,0,1,0,1,0,0,0,0,0,0,0,0,0,1,0,1,0,0,0,1,1,0,0,0,0
202763,20000,200,0,2,9,6,3,0,0,0,1,1,0,2,2,0,0,0,0,0,0,0,6,3,3,0,0,0,0,0,0,0,0,0
202806,20000,200,0,2,5,1,4,0,0,0,0,0,0,0,0,0,0,0,0,0,0,0,5,1,4,0,0,0,0,0,0,0,0,0
202912,20000,200,0,2,6,0,6,0,0,0,0,0,0,0,0,0,0,0,0,0,0,0,6,0,6,0,0,0,0,0,0,0,0,0
203085,20000,200,0,2,9,5,4,0,0,0,0,0,0,1,0,1,0,0,0,0,0,0,8,5,3,0,0,0,0,0,0,0,0,0
203128,20000,200,0,2,4,2,2,0,0,0,1,0,1,0,0,0,0,0,0,0,0,0,3,2,1,0,0,0,0,0,0,0,0,0
203155,20000,200,0,2,11,7,4,0,0,0,0,0,0,1,0,1,0,0,0,0,0,0,10,7,3,0,0,0,0,0,0,0,0,0
203368,20000,200,0,2,7,5,2,0,0,0,2,1,1,0,0,0,0,0,0,0,0,0,4,3,1,0,0,0,0,0,0,1,1,0
203386,20000,200,0,2,33,5,28,0,0,0,0,0,0,4,0,4,0,0,0,0,0,0,28,5,23,0,0,0,1,0,1,0,0,0
203483,20000,200,0,2,1,1,0,0,0,0,0,0,0,0,0,0,0,0,0,0,0,0,1,1,0,0,0,0,0,0,0,0,0,0
203492,20000,200,0,2,2,1,1,0,0,0,0,0,0,0,0,0,0,0,0,0,0,0,1,0,1,0,0,0,0,0,0,1,1,0
203517,20000,200,0,2,31,15,16,0,0,0,0,0,0,5,0,5,2,2,0,0,0,0,14,6,8,2,1,1,3,3,0,5,3,2
203535,20000,200,0,2,30,6,24,0,0,0,1,0,1,0,0,0,3,1,2,0,0,0,5,0,5,0,0,0,19,4,15,2,1,1
203544,20000,200,0,2,4,2,2,0,0,0,0,0,0,1,1,0,0,0,0,0,0,0,3,1,2,0,0,0,0,0,0,0,0,0
203599,20000,200,0,2,3,1,2,0,0,0,0,0,0,0,0,0,0,0,0,0,0,0,2,1,1,0,0,0,1,0,1,0,0,0
203678,20000,200,0,2,8,4,4,0,0,0,1,1,0,0,0,0,0,0,0,0,0,0,7,3,4,0,0,0,0,0,0,0,0,0
203720,20000,200,0,2,5,5,0,0,0,0,0,0,0,2,2,0,0,0,0,0,0,0,3,3,0,0,0,0,0,0,0,0,0,0
203748,20000,200,0,2,2,0,2,0,0,0,0,0,0,0,0,0,0,0,0,0,0,0,2,0,2,0,0,0,0,0,0,0,0,0
203757,20000,200,0,2,10,1,9,0,0,0,0,0,0,0,0,0,0,0,0,0,0,0,8,0,8,0,0,0,2,1,1,0,0,0
203775,20000,200,0,2,2,1,1,0,0,0,0,0,0,1,1,0,0,0,0,0,0,0,1,0,1,0,0,0,0,0,0,0,0,0
203845,20000,200,0,2,13,8,5,0,0,0,0,0,0,0,0,0,1,1,0,0,0,0,12,7,5,0,0,0,0,0,0,0,0,0
203881,20000,200,0,2,1,0,1,0,0,0,0,0,0,0,0,0,0,0,0,0,0,0,1,0,1,0,0,0,0,0,0,0,0,0
203960,20000,200,0,2,8,0,8,0,0,0,0,0,0,1,0,1,0,0,0,0,0,0,7,0,7,0,0,0,0,0,0,0,0,0
204006,20000,200,0,2,4,0,4,0,0,0,0,0,0,0,0,0,0,0,0,0,0,0,4,0,4,0,0,0,0,0,0,0,0,0
204015,20000,200,0,2,1,0,1,0,0,0,0,0,0,0,0,0,0,0,0,0,0,0,0,0,0,0,0,0,1,0,1,0,0,0
204024,20000,200,0,2,37,19,18,0,0,0,1,0,1,2,0,2,1,1,0,0,0,0,29,14,15,0,0,0,0,0,0,4,4,0
204176,20000,200,0,2,4,0,4,0,0,0,0,0,0,0,0,0,0,0,0,0,0,0,4,0,4,0,0,0,0,0,0,0,0,0
204185,20000,200,0,2,6,3,3,0,0,0,1,1,0,0,0,0,0,0,0,0,0,0,4,1,3,0,0,0,0,0,0,1,1,0
204194,20000,200,0,2,5,4,1,0,0,0,1,1,0,1,1,0,1,1,0,0,0,0,1,1,0,1,0,1,0,0,0,0,0,0
204200,20000,200,0,2,10,2,8,0,0,0,2,0,2,0,0,0,0,0,0,0,0,0,8,2,6,0,0,0,0,0,0,0,0,0
204255,20000,200,0,2,2,0,2,0,0,0,0,0,0,0,0,0,0,0,0,0,0,0,2,0,2,0,0,0,0,0,0,0,0,0
204264,20000,200,0,2,7,2,5,0,0,0,1,0,1,0,0,0,0,0,0,0,0,0,6,2,4,0,0,0,0,0,0,0,0,0
204422,20000,200,0,2,6,3,3,0,0,0,1,1,0,2,1,1,0,0,0,2,1,1,1,0,1,0,0,0,0,0,0,0,0,0
204440,20000,200,0,2,7,5,2,0,0,0,0,0,0,0,0,0,0,0,0,0,0,0,7,5,2,0,0,0,0,0,0,0,0,0
204477,20000,200,0,2,7,5,2,0,0,0,0,0,0,0,0,0,0,0,0,0,0,0,7,5,2,0,0,0,0,0,0,0,0,0
204501,20000,200,0,2,43,20,23,0,0,0,1,0,1,1,0,1,2,1,1,0,0,0,27,12,15,0,0,0,2,0,2,10,7,3
204608,20000,200,0,2,3,1,2,0,0,0,0,0,0,1,0,1,0,0,0,0,0,0,2,1,1,0,0,0,0,0,0,0,0,0
204617,20000,200,0,2,2,2,0,0,0,0,1,1,0,0,0,0,0,0,0,0,0,0,1,1,0,0,0,0,0,0,0,0,0,0
204635,20000,200,0,2,9,7,2,0,0,0,1,0,1,0,0,0,1,1,0,0,0,0,7,6,1,0,0,0,0,0,0,0,0,0
204796,20000,200,0,2,290,118,172,0,0,0,59,24,35,16,6,10,14,7,7,0,0,0,171,65,106,5,2,3,14,7,7,11,7,4
204820,20000,200,0,2,1,0,1,0,0,0,0,0,0,0,0,0,0,0,0,0,0,0,1,0,1,0,0,0,0,0,0,0,0,0
204839,20000,200,0,2,2,1,1,0,0,0,0,0,0,0,0,0,0,0,0,0,0,0,2,1,1,0,0,0,0,0,0,0,0,0
204848,20000,200,0,2,1,1,0,0,0,0,0,0,0,0,0,0,0,0,0,0,0,0,1,1,0,0,0,0,0,0,0,0,0,0
204857,20000,200,0,2,16,3,13,0,0,0,1,0,1,1,0,1,1,0,1,0,0,0,10,2,8,0,0,0,2,0,2,1,1,0
204866,20000,200,0,2,2,1,1,0,0,0,0,0,0,0,0,0,0,0,0,0,0,0,2,1,1,0,0,0,0,0,0,0,0,0
204909,20000,200,0,2,11,6,5,0,0,0,1,0,1,2,2,0,1,0,1,0,0,0,6,4,2,0,0,0,1,0,1,0,0,0
204945,20000,200,0,2,3,0,3,0,0,0,0,0,0,0,0,0,0,0,0,0,0,0,3,0,3,0,0,0,0,0,0,0,0,0
205054,20000,200,0,2,1,0,1,0,0,0,0,0,0,0,0,0,0,0,0,0,0,0,1,0,1,0,0,0,0,0,0,0,0,0
205179,20000,200,0,2,3,1,2,0,0,0,0,0,0,0,0,0,0,0,0,0,0,0,3,1,2,0,0,0,0,0,0,0,0,0
205203,20000,200,0,2,5,3,2,0,0,0,0,0,0,0,0,0,0,0,0,0,0,0,5,3,2,0,0,0,0,0,0,0,0,0
205391,20000,200,0,2,1,1,0,0,0,0,0,0,0,0,0,0,0,0,0,0,0,0,1,1,0,0,0,0,0,0,0,0,0,0
205443,20000,200,0,2,3,0,3,0,0,0,0,0,0,0,0,0,0,0,0,0,0,0,3,0,3,0,0,0,0,0,0,0,0,0
205470,20000,200,0,2,11,3,8,0,0,0,0,0,0,1,0,1,0,0,0,0,0,0,10,3,7,0,0,0,0,0,0,0,0,0
205841,20000,200,0,2,10,5,5,0,0,0,0,0,0,0,0,0,0,0,0,0,0,0,9,4,5,0,0,0,1,1,0,0,0,0
205887,20000,200,0,2,6,0,6,0,0,0,0,0,0,1,0,1,0,0,0,0,0,0,5,0,5,0,0,0,0,0,0,0,0,0
205957,20000,200,0,2,8,4,4,0,0,0,0,0,0,0,0,0,0,0,0,0,0,0,7,3,4,0,0,0,1,1,0,0,0,0
205966,20000,200,0,2,5,4,1,0,0,0,0,0,0,0,0,0,0,0,0,0,0,0,5,4,1,0,0,0,0,0,0,0,0,0
206011,20000,200,0,2,4,2,2,0,0,0,0,0,0,1,0,1,0,0,0,0,0,0,3,2,1,0,0,0,0,0,0,0,0,0
206048,20000,200,0,2,9,8,1,0,0,0,0,0,0,0,0,0,0,0,0,0,0,0,8,7,1,1,1,0,0,0,0,0,0,0
206084,20000,200,0,2,58,36,22,0,0,0,21,15,6,2,2,0,1,0,1,0,0,0,31,17,14,1,1,0,1,0,1,1,1,0
206279,20000,200,0,2,1,0,1,0,0,0,0,0,0,0,0,0,0,0,0,0,0,0,1,0,1,0,0,0,0,0,0,0,0,0
206349,20000,200,0,2,14,4,10,0,0,0,0,0,0,1,1,0,0,0,0,0,0,0,13,3,10,0,0,0,0,0,0,0,0,0
206437,20000,200,0,2,8,4,4,0,0,0,0,0,0,1,1,0,0,0,0,0,0,0,6,2,4,0,0,0,1,1,0,0,0,0
206446,20000,200,0,2,11,3,8,0,0,0,0,0,0,0,0,0,1,1,0,0,0,0,10,2,8,0,0,0,0,0,0,0,0,0
206491,20000,200,0,2,1,1,0,0,0,0,0,0,0,1,1,0,0,0,0,0,0,0,0,0,0,0,0,0,0,0,0,0,0,0
206507,20000,200,0,2,11,4,7,0,0,0,0,0,0,0,0,0,1,0,1,0,0,0,10,4,6,0,0,0,0,0,0,0,0,0
206525,20000,200,0,2,7,1,6,0,0,0,1,1,0,0,0,0,1,0,1,0,0,0,5,0,5,0,0,0,0,0,0,0,0,0
206589,20000,200,0,2,16,6,10,0,0,0,0,0,0,3,0,3,1,1,0,0,0,0,7,1,6,0,0,0,1,1,0,4,3,1
206604,20000,200,0,2,21,8,13,0,0,0,3,2,1,2,0,2,0,0,0,0,0,0,12,3,9,0,0,0,0,0,0,4,3,1
206622,20000,200,0,2,20,8,12,0,0,0,1,0,1,2,1,1,0,0,0,0,0,0,17,7,10,0,0,0,0,0,0,0,0,0
206695,20000,200,0,2,34,20,14,0,0,0,0,0,0,0,0,0,1,0,1,0,0,0,24,14,10,1,0,1,0,0,0,8,6,2
206862,20000,200,0,2,9,4,5,0,0,0,1,0,1,0,0,0,0,0,0,0,0,0,7,4,3,1,0,1,0,0,0,0,0,0
206914,20000,200,0,2,7,3,4,0,0,0,2,1,1,0,0,0,0,0,0,0,0,0,4,1,3,1,1,0,0,0,0,0,0,0
206923,20000,200,0,2,1,0,1,0,0,0,0,0,0,0,0,0,0,0,0,0,0,0,1,0,1,0,0,0,0,0,0,0,0,0
206932,20000,200,0,2,3,1,2,0,0,0,0,0,0,0,0,0,0,0,0,0,0,0,3,1,2,0,0,0,0,0,0,0,0,0
206941,20000,200,0,2,54,24,30,1,0,1,3,2,1,2,1,1,3,2,1,2,1,1,34,11,23,1,1,0,7,5,2,1,1,0
206996,20000,200,0,2,7,4,3,1,1,0,1,1,0,0,0,0,1,0,1,0,0,0,4,2,2,0,0,0,0,0,0,0,0,0
207041,20000,200,0,2,8,4,4,0,0,0,1,1,0,0,0,0,0,0,0,0,0,0,6,3,3,0,0,0,1,0,1,0,0,0
207069,20000,200,0,2,1,0,1,0,0,0,0,0,0,0,0,0,0,0,0,0,0,0,0,0,0,1,0,1,0,0,0,0,0,0
207157,20000,200,0,2,4,4,0,1,1,0,0,0,0,0,0,0,0,0,0,0,0,0,3,3,0,0,0,0,0,0,0,0,0,0
207209,20000,200,0,2,8,1,7,0,0,0,0,0,0,5,1,4,0,0,0,0,0,0,3,0,3,0,0,0,0,0,0,0,0,0
207236,20000,200,0,2,9,4,5,2,1,1,0,0,0,0,0,0,1,1,0,0,0,0,6,2,4,0,0,0,0,0,0,0,0,0
207254,20000,200,0,2,25,25,0,2,2,0,4,4,0,1,1,0,4,4,0,0,0,0,14,14,0,0,0,0,0,0,0,0,0,0
207263,20000,200,0,2,15,6,9,1,0,1,2,0,2,1,1,0,0,0,0,0,0,0,11,5,6,0,0,0,0,0,0,0,0,0
207281,20000,200,0,2,6,3,3,0,0,0,0,0,0,0,0,0,0,0,0,0,0,0,6,3,3,0,0,0,0,0,0,0,0,0
207290,20000,200,0,2,5,2,3,0,0,0,0,0,0,1,1,0,0,0,0,0,0,0,3,1,2,1,0,1,0,0,0,0,0,0
207306,20000,200,0,2,8,5,3,0,0,0,0,0,0,0,0,0,0,0,0,0,0,0,7,5,2,0,0,0,1,0,1,0,0,0
207315,20000,200,0,2,25,10,15,1,1,0,2,0,2,1,0,1,1,0,1,0,0,0,18,8,10,2,1,1,0,0,0,0,0,0
207324,20000,200,0,2,4,1,3,0,0,0,0,0,0,1,0,1,0,0,0,0,0,0,3,1,2,0,0,0,0,0,0,0,0,0
207342,20000,200,0,2,30,18,12,0,0,0,2,1,1,0,0,0,1,1,0,0,0,0,16,7,9,1,1,0,0,0,0,10,8,2
207351,20000,200,0,2,6,3,3,0,0,0,0,0,0,0,0,0,0,0,0,0,0,0,5,3,2,0,0,0,0,0,0,1,0,1
207388,20000,200,0,2,139,63,76,1,1,0,11,7,4,4,4,0,8,3,5,0,0,0,71,21,50,5,1,4,1,0,1,38,26,12
207397,20000,200,0,2,6,0,6,1,0,1,0,0,0,2,0,2,0,0,0,0,0,0,3,0,3,0,0,0,0,0,0,0,0,0
207403,20000,200,0,2,7,5,2,0,0,0,1,0,1,0,0,0,0,0,0,0,0,0,6,5,1,0,0,0,0,0,0,0,0,0
207449,20000,200,0,2,14,7,7,0,0,0,3,1,2,0,0,0,0,0,0,0,0,0,9,5,4,2,1,1,0,0,0,0,0,0
207458,20000,200,0,2,26,13,13,0,0,0,2,2,0,1,0,1,0,0,0,0,0,0,21,10,11,0,0,0,0,0,0,2,1,1
207500,20000,200,0,2,159,90,69,1,1,0,10,7,3,7,4,3,12,8,4,0,0,0,68,31,37,0,0,0,11,8,3,50,31,19
207564,20000,200,0,2,8,6,2,0,0,0,0,0,0,1,1,0,0,0,0,0,0,0,6,4,2,1,1,0,0,0,0,0,0,0
207582,20000,200,0,2,5,5,0,0,0,0,0,0,0,0,0,0,0,0,0,0,0,0,3,3,0,0,0,0,0,0,0,2,2,0
207661,20000,200,0,2,11,3,8,2,1,1,2,0,2,0,0,0,0,0,0,0,0,0,6,2,4,0,0,0,1,0,1,0,0,0
207670,20000,200,0,2,18,7,11,0,0,0,2,1,1,1,0,1,0,0,0,0,0,0,15,6,9,0,0,0,0,0,0,0,0,0
207722,20000,200,0,2,3,1,2,1,1,0,0,0,0,0,0,0,0,0,0,0,0,0,2,0,2,0,0,0,0,0,0,0,0,0
207740,20000,200,0,2,2,1,1,0,0,0,0,0,0,0,0,0,0,0,0,0,0,0,2,1,1,0,0,0,0,0,0,0,0,0
207847,20000,200,0,2,11,6,5,0,0,0,0,0,0,0,0,0,0,0,0,0,0,0,9,6,3,0,0,0,0,0,0,2,0,2
207856,20000,200,0,2,5,2,3,0,0,0,0,0,0,0,0,0,0,0,0,0,0,0,5,2,3,0,0,0,0,0,0,0,0,0
207865,20000,200,0,2,9,3,6,0,0,0,0,0,0,0,0,0,0,0,0,0,0,0,9,3,6,0,0,0,0,0,0,0,0,0
207935,20000,200,0,2,15,6,9,1,1,0,0,0,0,2,1,1,4,2,2,0,0,0,6,1,5,2,1,1,0,0,0,0,0,0
207962,20000,200,0,2,4,4,0,1,1,0,0,0,0,0,0,0,0,0,0,0,0,0,2,2,0,0,0,0,1,1,0,0,0,0
207971,20000,200,0,2,17,9,8,0,0,0,0,0,0,3,3,0,0,0,0,0,0,0,9,2,7,2,1,1,3,3,0,0,0,0
208035,20000,200,0,2,5,0,5,0,0,0,0,0,0,0,0,0,2,0,2,0,0,0,3,0,3,0,0,0,0,0,0,0,0,0
208318,20000,200,0,2,5,1,4,0,0,0,1,1,0,0,0,0,1,0,1,0,0,0,3,0,3,0,0,0,0,0,0,0,0,0
208390,20000,200,0,2,11,7,4,0,0,0,0,0,0,0,0,0,2,1,1,0,0,0,6,4,2,0,0,0,2,1,1,1,1,0
208406,20000,200,0,2,3,1,2,0,0,0,0,0,0,0,0,0,0,0,0,0,0,0,3,1,2,0,0,0,0,0,0,0,0,0
208415,20000,200,0,2,2,1,1,0,0,0,0,0,0,0,0,0,1,0,1,0,0,0,1,1,0,0,0,0,0,0,0,0,0,0
208479,20000,200,0,2,2,1,1,0,0,0,1,1,0,0,0,0,0,0,0,0,0,0,1,0,1,0,0,0,0,0,0,0,0,0
208512,20000,200,0,2,4,2,2,0,0,0,0,0,0,0,0,0,0,0,0,0,0,0,0,0,0,4,2,2,0,0,0,0,0,0
208646,20000,200,0,2,14,6,8,0,0,0,2,1,1,0,0,0,0,0,0,0,0,0,9,3,6,0,0,0,3,2,1,0,0,0
208822,20000,200,0,2,29,12,17,0,0,0,1,1,0,2,1,1,1,1,0,0,0,0,22,6,16,1,1,0,2,2,0,0,0,0
209038,20000,200,0,2,13,4,9,0,0,0,1,1,0,0,0,0,2,2,0,0,0,0,10,1,9,0,0,0,0,0,0,0,0,0
209056,20000,200,0,2,4,1,3,0,0,0,0,0,0,1,0,1,0,0,0,0,0,0,2,1,1,1,0,1,0,0,0,0,0,0
209065,20000,200,0,2,8,1,7,0,0,0,1,0,1,0,0,0,0,0,0,0,0,0,6,1,5,0,0,0,1,0,1,0,0,0
209074,20000,200,0,2,7,1,6,0,0,0,0,0,0,0,0,0,2,0,2,0,0,0,0,0,0,1,0,1,3,1,2,1,0,1
209241,20000,200,0,2,3,3,0,0,0,0,0,0,0,0,0,0,2,2,0,0,0,0,1,1,0,0,0,0,0,0,0,0,0,0
209250,20000,200,0,2,4,2,2,0,0,0,1,1,0,1,1,0,0,0,0,0,0,0,2,0,2,0,0,0,0,0,0,0,0,0
209287,20000,200,0,2,1,1,0,0,0,0,1,1,0,0,0,0,0,0,0,0,0,0,0,0,0,0,0,0,0,0,0,0,0,0
209409,20000,200,0,2,3,2,1,0,0,0,0,0,0,0,0,0,1,1,0,0,0,0,2,1,1,0,0,0,0,0,0,0,0,0
209490,20000,200,0,2,278,115,163,0,0,0,52,22,30,9,4,5,13,7,6,1,0,1,138,53,85,6,0,6,29,16,13,30,13,17
209506,20000,200,0,2,21,12,9,0,0,0,3,1,2,0,0,0,0,0,0,0,0,0,15,8,7,0,0,0,0,0,0,3,3,0
209542,20000,200,0,2,199,101,98,0,0,0,9,6,3,1,1,0,11,7,4,0,0,0,59,30,29,6,1,5,68,30,38,45,26,19
209551,20000,200,0,2,111,48,63,0,0,0,4,1,3,5,1,4,5,3,2,0,0,0,66,24,42,2,0,2,6,3,3,23,16,7
209612,20000,200,0,2,23,7,16,0,0,0,2,2,0,1,0,1,1,1,0,0,0,0,16,3,13,1,1,0,0,0,0,2,0,2
209746,20000,200,0,2,12,4,8,0,0,0,1,0,1,1,1,0,2,1,1,0,0,0,6,1,5,0,0,0,2,1,1,0,0,0
209807,20000,200,0,2,30,13,17,0,0,0,5,2,3,3,0,3,6,4,2,0,0,0,10,5,5,3,0,3,0,0,0,3,2,1
209825,20000,200,0,2,25,8,17,0,0,0,0,0,0,1,0,1,2,2,0,0,0,0,12,3,9,0,0,0,5,0,5,5,3,2
209922,20000,200,0,2,21,8,13,0,0,0,2,1,1,0,0,0,3,1,2,0,0,0,10,2,8,2,2,0,0,0,0,4,2,2
210146,20000,200,0,2,7,6,1,0,0,0,1,0,1,0,0,0,0,0,0,0,0,0,6,6,0,0,0,0,0,0,0,0,0,0
210155,20000,200,0,2,6,1,5,0,0,0,0,0,0,0,0,0,0,0,0,0,0,0,5,1,4,0,0,0,1,0,1,0,0,0
210234,20000,200,0,2,6,1,5,0,0,0,0,0,0,0,0,0,1,0,1,0,0,0,3,1,2,0,0,0,2,0,2,0,0,0
210270,20000,200,0,2,7,2,5,0,0,0,0,0,0,0,0,0,0,0,0,0,0,0,5,2,3,1,0,1,1,0,1,0,0,0
210304,20000,200,0,2,4,3,1,0,0,0,0,0,0,1,1,0,0,0,0,0,0,0,2,1,1,0,0,0,1,1,0,0,0,0
210331,20000,200,0,2,4,3,1,0,0,0,0,0,0,0,0,0,0,0,0,0,0,0,4,3,1,0,0,0,0,0,0,0,0,0
210368,20000,200,0,2,2,1,1,0,0,0,0,0,0,0,0,0,0,0,0,0,0,0,2,1,1,0,0,0,0,0,0,0,0,0
210401,20000,200,0,2,3,3,0,0,0,0,0,0,0,0,0,0,0,0,0,0,0,0,3,3,0,0,0,0,0,0,0,0,0,0
210429,20000,200,0,2,5,3,2,0,0,0,0,0,0,0,0,0,0,0,0,0,0,0,3,1,2,1,1,0,0,0,0,1,1,0
210438,20000,200,0,2,3,1,2,0,0,0,0,0,0,1,1,0,0,0,0,0,0,0,1,0,1,0,0,0,1,0,1,0,0,0
210492,20000,200,0,2,1,1,0,0,0,0,0,0,0,0,0,0,0,0,0,0,0,0,1,1,0,0,0,0,0,0,0,0,0,0
210571,20000,200,0,2,8,4,4,0,0,0,1,0,1,0,0,0,0,0,0,0,0,0,6,3,3,1,1,0,0,0,0,0,0,0
210599,20000,200,0,2,9,5,4,0,0,0,0,0,0,3,0,3,1,0,1,0,0,0,2,2,0,1,1,0,2,2,0,0,0,0
210605,20000,200,0,2,21,6,15,0,0,0,2,0,2,3,1,2,0,0,0,0,0,0,15,5,10,0,0,0,1,0,1,0,0,0
210669,20000,200,0,2,9,5,4,0,0,0,2,0,2,1,0,1,2,2,0,0,0,0,3,3,0,1,0,1,0,0,0,0,0,0
210739,20000,200,0,2,10,5,5,0,0,0,0,0,0,1,0,1,0,0,0,0,0,0,8,4,4,1,1,0,0,0,0,0,0,0
210775,20000,200,0,2,13,3,10,0,0,0,0,0,0,1,0,1,0,0,0,0,0,0,11,3,8,1,0,1,0,0,0,0,0,0
210809,20000,200,0,2,4,1,3,0,0,0,0,0,0,1,0,1,0,0,0,0,0,0,3,1,2,0,0,0,0,0,0,0,0,0
211079,20000,200,0,2,8,3,5,0,0,0,1,1,0,0,0,0,0,0,0,0,0,0,7,2,5,0,0,0,0,0,0,0,0,0
211088,20000,200,0,2,5,0,5,0,0,0,1,0,1,1,0,1,0,0,0,0,0,0,3,0,3,0,0,0,0,0,0,0,0,0
211158,20000,200,0,2,4,1,3,0,0,0,0,0,0,0,0,0,0,0,0,0,0,0,4,1,3,0,0,0,0,0,0,0,0,0
211273,20000,200,0,2,14,3,11,0,0,0,4,0,4,1,0,1,0,0,0,0,0,0,3,1,2,2,1,1,4,1,3,0,0,0
211291,20000,200,0,2,24,9,15,0,0,0,5,1,4,1,0,1,0,0,0,0,0,0,13,6,7,0,0,0,1,0,1,4,2,2
211352,20000,200,0,2,3,1,2,0,0,0,1,1,0,0,0,0,0,0,0,0,0,0,2,0,2,0,0,0,0,0,0,0,0,0
211361,20000,200,0,2,1,0,1,0,0,0,0,0,0,0,0,0,0,0,0,0,0,0,1,0,1,0,0,0,0,0,0,0,0,0
211431,20000,200,0,2,7,1,6,0,0,0,0,0,0,0,0,0,0,0,0,0,0,0,7,1,6,0,0,0,0,0,0,0,0,0
211440,20000,200,0,2,191,138,53,0,0,0,17,13,4,12,5,7,8,7,1,0,0,0,48,30,18,5,5,0,7,5,2,94,73,21
211468,20000,200,0,2,6,2,4,0,0,0,0,0,0,1,0,1,0,0,0,0,0,0,5,2,3,0,0,0,0,0,0,0,0,0
211477,20000,200,0,2,7,2,5,0,0,0,0,0,0,2,0,2,1,0,1,0,0,0,4,2,2,0,0,0,0,0,0,0,0,0
211556,20000,200,0,2,9,2,7,0,0,0,0,0,0,0,0,0,1,1,0,0,0,0,8,1,7,0,0,0,0,0,0,0,0,0
211583,20000,200,0,2,4,2,2,0,0,0,1,0,1,1,1,0,0,0,0,0,0,0,2,1,1,0,0,0,0,0,0,0,0,0
211608,20000,200,0,2,1,1,0,0,0,0,0,0,0,1,1,0,0,0,0,0,0,0,0,0,0,0,0,0,0,0,0,0,0,0
211927,20000,200,0,2,1,0,1,0,0,0,0,0,0,0,0,0,0,0,0,0,0,0,1,0,1,0,0,0,0,0,0,0,0,0
211981,20000,200,0,2,1,0,1,0,0,0,0,0,0,0,0,0,0,0,0,0,0,0,1,0,1,0,0,0,0,0,0,0,0,0
212009,20000,200,0,2,15,7,8,0,0,0,1,1,0,1,0,1,3,1,2,0,0,0,4,1,3,0,0,0,0,0,0,6,4,2
212045,20000,200,0,2,1,1,0,0,0,0,0,0,0,0,0,0,0,0,0,0,0,0,1,1,0,0,0,0,0,0,0,0,0,0
212054,20000,200,0,2,78,33,45,0,0,0,4,0,4,7,4,3,2,1,1,0,0,0,35,14,21,4,1,3,1,0,1,25,13,12
212106,20000,200,0,2,27,10,17,0,0,0,2,0,2,1,1,0,0,0,0,0,0,0,22,8,14,0,0,0,0,0,0,2,1,1
212115,20000,200,0,2,3,3,0,0,0,0,0,0,0,0,0,0,0,0,0,0,0,0,2,2,0,0,0,0,0,0,0,1,1,0
212133,20000,200,0,2,23,9,14,0,0,0,1,1,0,3,2,1,0,0,0,0,0,0,17,6,11,0,0,0,2,0,2,0,0,0
212160,20000,200,0,2,1,0,1,0,0,0,0,0,0,0,0,0,0,0,0,0,0,0,1,0,1,0,0,0,0,0,0,0,0,0
212197,20000,200,0,2,6,3,3,0,0,0,0,0,0,0,0,0,0,0,0,0,0,0,1,0,1,0,0,0,5,3,2,0,0,0
212434,20000,200,0,2,6,5,1,0,0,0,0,0,0,0,0,0,0,0,0,0,0,0,6,5,1,0,0,0,0,0,0,0,0,0
212577,20000,200,0,2,10,4,6,0,0,0,4,1,3,1,1,0,0,0,0,0,0,0,3,1,2,0,0,0,0,0,0,2,1,1
212601,20000,200,0,2,31,11,20,0,0,0,5,3,2,2,1,1,0,0,0,0,0,0,23,6,17,0,0,0,1,1,0,0,0,0
212656,20000,200,0,2,3,1,2,0,0,0,0,0,0,1,0,1,0,0,0,0,0,0,2,1,1,0,0,0,0,0,0,0,0,0
212674,20000,200,0,2,16,5,11,0,0,0,1,0,1,0,0,0,0,0,0,0,0,0,8,2,6,0,0,0,0,0,0,7,3,4
212832,20000,200,0,2,3,1,2,0,0,0,0,0,0,0,0,0,0,0,0,0,0,0,3,1,2,0,0,0,0,0,0,0,0,0
212869,20000,200,0,2,4,1,3,0,0,0,0,0,0,0,0,0,0,0,0,0,0,0,4,1,3,0,0,0,0,0,0,0,0,0
212878,20000,200,0,2,2,1,1,0,0,0,0,0,0,1,1,0,0,0,0,0,0,0,1,0,1,0,0,0,0,0,0,0,0,0
212911,20000,200,0,2,24,10,14,0,0,0,3,1,2,1,0,1,2,0,2,0,0,0,11,4,7,0,0,0,1,0,1,6,5,1
212975,20000,200,0,2,2,1,1,0,0,0,0,0,0,0,0,0,0,0,0,0,0,0,2,1,1,0,0,0,0,0,0,0,0,0
212984,20000,200,0,2,8,5,3,0,0,0,1,1,0,1,1,0,0,0,0,0,0,0,6,3,3,0,0,0,0,0,0,0,0,0
213011,20000,200,0,2,8,3,5,0,0,0,1,1,0,0,0,0,0,0,0,0,0,0,5,1,4,1,1,0,1,0,1,0,0,0
213181,20000,200,0,2,8,0,8,0,0,0,0,0,0,0,0,0,0,0,0,0,0,0,8,0,8,0,0,0,0,0,0,0,0,0
213233,20000,200,0,2,5,4,1,0,0,0,0,0,0,0,0,0,0,0,0,0,0,0,5,4,1,0,0,0,0,0,0,0,0,0
213251,20000,200,0,2,5,2,3,0,0,0,1,1,0,1,0,1,0,0,0,0,0,0,3,1,2,0,0,0,0,0,0,0,0,0
213303,20000,200,0,2,8,3,5,0,0,0,0,0,0,0,0,0,0,0,0,0,0,0,8,3,5,0,0,0,0,0,0,0,0,0
213321,20000,200,0,2,4,3,1,0,0,0,0,0,0,0,0,0,0,0,0,0,0,0,4,3,1,0,0,0,0,0,0,0,0,0
213358,20000,200,0,2,1,0,1,0,0,0,0,0,0,0,0,0,0,0,0,0,0,0,1,0,1,0,0,0,0,0,0,0,0,0
213367,20000,200,0,2,11,5,6,0,0,0,0,0,0,2,1,1,0,0,0,0,0,0,9,4,5,0,0,0,0,0,0,0,0,0
213385,20000,200,0,2,19,12,7,0,0,0,0,0,0,1,1,0,0,0,0,0,0,0,14,7,7,0,0,0,0,0,0,4,4,0
213400,20000,200,0,2,9,5,4,0,0,0,0,0,0,0,0,0,1,1,0,0,0,0,8,4,4,0,0,0,0,0,0,0,0,0
213507,20000,200,0,2,3,2,1,0,0,0,0,0,0,0,0,0,0,0,0,0,0,0,2,1,1,0,0,0,0,0,0,1,1,0
213525,20000,200,0,2,3,1,2,0,0,0,1,1,0,0,0,0,0,0,0,0,0,0,2,0,2,0,0,0,0,0,0,0,0,0
213534,20000,200,0,2,1,0,1,0,0,0,0,0,0,0,0,0,0,0,0,0,0,0,1,0,1,0,0,0,0,0,0,0,0,0
213543,20000,200,0,2,40,25,15,0,0,0,5,1,4,2,1,1,0,0,0,0,0,0,14,10,4,0,0,0,11,8,3,8,5,3
213570,20000,200,0,2,2,0,2,0,0,0,0,0,0,1,0,1,0,0,0,0,0,0,1,0,1,0,0,0,0,0,0,0,0,0
213589,20000,200,0,2,2,2,0,0,0,0,0,0,0,0,0,0,0,0,0,0,0,0,2,2,0,0,0,0,0,0,0,0,0,0
213598,20000,200,0,2,7,1,6,0,0,0,0,0,0,5,1,4,1,0,1,0,0,0,1,0,1,0,0,0,0,0,0,0,0,0
213631,20000,200,0,2,2,0,2,0,0,0,1,0,1,1,0,1,0,0,0,0,0,0,0,0,0,0,0,0,0,0,0,0,0,0
213659,20000,200,0,2,3,1,2,0,0,0,0,0,0,0,0,0,0,0,0,0,0,0,3,1,2,0,0,0,0,0,0,0,0,0
213668,20000,200,0,2,8,2,6,0,0,0,0,0,0,0,0,0,3,1,2,0,0,0,4,0,4,0,0,0,1,1,0,0,0,0
213826,20000,200,0,2,21,7,14,0,0,0,3,1,2,1,0,1,3,3,0,0,0,0,14,3,11,0,0,0,0,0,0,0,0,0
213987,20000,200,0,2,14,4,10,0,0,0,2,0,2,0,0,0,0,0,0,0,0,0,12,4,8,0,0,0,0,0,0,0,0,0
213996,20000,200,0,2,9,4,5,0,0,0,0,0,0,1,0,1,1,1,0,0,0,0,7,3,4,0,0,0,0,0,0,0,0,0
214041,20000,200,0,2,6,1,5,0,0,0,0,0,0,0,0,0,0,0,0,0,0,0,5,0,5,0,0,0,1,1,0,0,0,0
214069,20000,200,0,2,7,2,5,0,0,0,2,1,1,0,0,0,0,0,0,0,0,0,5,1,4,0,0,0,0,0,0,0,0,0
214111,20000,200,0,2,2,0,2,0,0,0,0,0,0,0,0,0,0,0,0,0,0,0,1,0,1,0,0,0,1,0,1,0,0,0
214148,20000,200,0,2,1,1,0,0,0,0,0,0,0,0,0,0,1,1,0,0,0,0,0,0,0,0,0,0,0,0,0,0,0,0
214157,20000,200,0,2,4,2,2,0,0,0,1,0,1,1,1,0,0,0,0,0,0,0,1,1,0,0,0,0,0,0,0,1,0,1
214166,20000,200,0,2,8,2,6,0,0,0,0,0,0,0,0,0,0,0,0,0,0,0,8,2,6,0,0,0,0,0,0,0,0,0
214175,20000,200,0,2,25,11,14,0,0,0,3,0,3,5,3,2,4,1,3,0,0,0,10,4,6,0,0,0,0,0,0,3,3,0
214272,20000,200,0,2,6,0,6,0,0,0,0,0,0,2,0,2,0,0,0,0,0,0,4,0,4,0,0,0,0,0,0,0,0,0
214290,20000,200,0,2,10,9,1,0,0,0,0,0,0,0,0,0,0,0,0,0,0,0,10,9,1,0,0,0,0,0,0,0,0,0
214379,20000,200,0,2,2,2,0,0,0,0,1,1,0,0,0,0,0,0,0,0,0,0,1,1,0,0,0,0,0,0,0,0,0,0
214564,20000,200,0,2,13,4,9,0,0,0,4,2,2,1,0,1,0,0,0,0,0,0,7,2,5,1,0,1,0,0,0,0,0,0
214582,20000,200,0,2,2,0,2,0,0,0,0,0,0,0,0,0,0,0,0,0,0,0,2,0,2,0,0,0,0,0,0,0,0,0
214892,20000,200,0,2,11,4,7,0,0,0,0,0,0,0,0,0,0,0,0,0,0,0,11,4,7,0,0,0,0,0,0,0,0,0
214944,20000,200,0,2,9,8,1,0,0,0,0,0,0,0,0,0,1,1,0,0,0,0,8,7,1,0,0,0,0,0,0,0,0,0
214971,20000,200,0,2,3,2,1,0,0,0,0,0,0,2,2,0,0,0,0,0,0,0,0,0,0,1,0,1,0,0,0,0,0,0
215053,20000,200,0,2,2,1,1,0,0,0,0,0,0,0,0,0,0,0,0,0,0,0,2,1,1,0,0,0,0,0,0,0,0,0
215062,20000,200,0,2,808,407,401,0,0,0,126,62,64,48,15,33,38,16,22,0,0,0,280,125,155,11,4,7,60,34,26,245,151,94
215105,20000,200,0,2,1,0,1,0,0,0,0,0,0,0,0,0,0,0,0,0,0,0,1,0,1,0,0,0,0,0,0,0,0,0
215114,20000,200,0,2,3,2,1,0,0,0,0,0,0,0,0,0,0,0,0,0,0,0,3,2,1,0,0,0,0,0,0,0,0,0
215123,20000,200,0,2,18,8,10,1,1,0,3,0,3,1,1,0,0,0,0,0,0,0,10,5,5,2,1,1,1,0,1,0,0,0
215132,20000,200,0,2,9,6,3,0,0,0,2,1,1,0,0,0,0,0,0,0,0,0,7,5,2,0,0,0,0,0,0,0,0,0
215239,20000,200,0,2,12,6,6,0,0,0,2,1,1,4,2,2,2,1,1,0,0,0,4,2,2,0,0,0,0,0,0,0,0,0
215266,20000,200,0,2,7,6,1,0,0,0,0,0,0,2,2,0,0,0,0,0,0,0,1,1,0,0,0,0,1,0,1,3,3,0
215275,20000,200,0,2,5,1,4,0,0,0,0,0,0,0,0,0,0,0,0,0,0,0,3,0,3,0,0,0,2,1,1,0,0,0
215284,20000,200,0,2,4,1,3,0,0,0,0,0,0,0,0,0,0,0,0,0,0,0,3,1,2,0,0,0,0,0,0,1,0,1
215293,20000,200,0,2,458,223,235,0,0,0,37,20,17,15,2,13,17,8,9,0,0,0,170,81,89,5,1,4,42,14,28,172,97,75
215381,20000,200,0,2,11,9,2,0,0,0,0,0,0,0,0,0,0,0,0,0,0,0,11,9,2,0,0,0,0,0,0,0,0,0
215415,20000,200,0,2,5,3,2,0,0,0,0,0,0,0,0,0,0,0,0,0,0,0,5,3,2,0,0,0,0,0,0,0,0,0
215424,20000,200,0,2,1,0,1,0,0,0,0,0,0,1,0,1,0,0,0,0,0,0,0,0,0,0,0,0,0,0,0,0,0,0
215442,20000,200,0,2,6,3,3,0,0,0,1,0,1,1,1,0,0,0,0,0,0,0,4,2,2,0,0,0,0,0,0,0,0,0
215585,20000,200,0,2,4,0,4,0,0,0,0,0,0,0,0,0,0,0,0,0,0,0,4,0,4,0,0,0,0,0,0,0,0,0
215655,20000,200,0,2,6,3,3,0,0,0,0,0,0,0,0,0,1,0,1,0,0,0,1,0,1,0,0,0,0,0,0,4,3,1
215682,20000,200,0,2,6,6,0,0,0,0,0,0,0,0,0,0,0,0,0,0,0,0,6,6,0,0,0,0,0,0,0,0,0,0
215691,20000,200,0,2,1,1,0,0,0,0,1,1,0,0,0,0,0,0,0,0,0,0,0,0,0,0,0,0,0,0,0,0,0,0
215743,20000,200,0,2,16,4,12,0,0,0,0,0,0,0,0,0,0,0,0,0,0,0,16,4,12,0,0,0,0,0,0,0,0,0
215770,20000,200,0,2,7,2,5,0,0,0,1,0,1,2,0,2,1,0,1,0,0,0,3,2,1,0,0,0,0,0,0,0,0,0
215798,20000,200,0,2,3,1,2,0,0,0,0,0,0,0,0,0,0,0,0,0,0,0,1,1,0,0,0,0,2,0,2,0,0,0
215929,20000,200,0,2,14,7,7,0,0,0,0,0,0,2,0,2,0,0,0,0,0,0,5,3,2,0,0,0,2,1,1,5,3,2
215947,20000,200,0,2,11,3,8,0,0,0,0,0,0,1,0,1,0,0,0,0,0,0,9,3,6,0,0,0,0,0,0,1,0,1
215992,20000,200,0,2,2,0,2,0,0,0,0,0,0,0,0,0,0,0,0,0,0,0,2,0,2,0,0,0,0,0,0,0,0,0
216010,20000,200,0,2,1,1,0,0,0,0,0,0,0,1,1,0,0,0,0,0,0,0,0,0,0,0,0,0,0,0,0,0,0,0
216038,20000,200,0,2,6,3,3,0,0,0,1,1,0,1,0,1,0,0,0,0,0,0,4,2,2,0,0,0,0,0,0,0,0,0
216278,20000,200,0,2,12,9,3,0,0,0,1,1,0,1,0,1,0,0,0,0,0,0,9,8,1,0,0,0,0,0,0,1,0,1
216287,20000,200,0,2,33,13,20,3,1,2,3,1,2,2,0,2,2,1,1,0,0,0,15,8,7,0,0,0,2,1,1,6,1,5
216296,20000,200,0,2,8,7,1,0,0,0,2,2,0,0,0,0,0,0,0,0,0,0,6,5,1,0,0,0,0,0,0,0,0,0
216339,20000,200,0,2,168,70,98,0,0,0,24,12,12,25,9,16,3,1,2,0,0,0,79,34,45,1,0,1,20,8,12,16,6,10
216357,20000,200,0,2,4,3,1,0,0,0,0,0,0,0,0,0,0,0,0,0,0,0,4,3,1,0,0,0,0,0,0,0,0,0
216366,20000,200,0,2,81,34,47,0,0,0,18,8,10,3,1,2,1,0,1,0,0,0,45,20,25,6,1,5,4,2,2,4,2,2
216436,20000,200,0,2,7,7,0,0,0,0,0,0,0,1,1,0,0,0,0,0,0,0,6,6,0,0,0,0,0,0,0,0,0,0
216445,20000,200,0,2,3,2,1,0,0,0,0,0,0,0,0,0,0,0,0,0,0,0,3,2,1,0,0,0,0,0,0,0,0,0
216454,20000,200,0,2,2,2,0,0,0,0,0,0,0,0,0,0,0,0,0,0,0,0,2,2,0,0,0,0,0,0,0,0,0,0
216463,20000,200,0,2,2,2,0,0,0,0,0,0,0,0,0,0,0,0,0,0,0,0,2,2,0,0,0,0,0,0,0,0,0,0
216524,20000,200,0,2,7,4,3,0,0,0,0,0,0,0,0,0,0,0,0,0,0,0,6,3,3,0,0,0,0,0,0,1,1,0
216542,20000,200,0,2,2,0,2,0,0,0,0,0,0,0,0,0,0,0,0,0,0,0,2,0,2,0,0,0,0,0,0,0,0,0
216597,20000,200,0,2,61,30,31,1,0,1,5,4,1,4,2,2,3,3,0,0,0,0,35,12,23,2,0,2,0,0,0,11,9,2
216667,20000,200,0,2,5,1,4,0,0,0,1,0,1,0,0,0,0,0,0,0,0,0,4,1,3,0,0,0,0,0,0,0,0,0
216694,20000,200,0,2,8,2,6,0,0,0,0,0,0,0,0,0,1,0,1,0,0,0,7,2,5,0,0,0,0,0,0,0,0,0
216764,20000,200,0,2,25,11,14,0,0,0,4,4,0,5,2,3,0,0,0,0,0,0,13,3,10,1,0,1,0,0,0,2,2,0
216782,20000,200,0,2,15,3,12,0,0,0,0,0,0,0,0,0,0,0,0,0,0,0,14,3,11,1,0,1,0,0,0,0,0,0
216807,20000,200,0,2,5,3,2,0,0,0,0,0,0,0,0,0,0,0,0,0,0,0,5,3,2,0,0,0,0,0,0,0,0,0
216816,20000,200,0,2,1,1,0,0,0,0,0,0,0,0,0,0,1,1,0,0,0,0,0,0,0,0,0,0,0,0,0,0,0,0
216825,20000,200,0,2,3,2,1,0,0,0,0,0,0,0,0,0,0,0,0,0,0,0,3,2,1,0,0,0,0,0,0,0,0,0
216852,20000,200,0,2,31,10,21,0,0,0,5,2,3,3,0,3,2,1,1,0,0,0,13,2,11,0,0,0,0,0,0,8,5,3
216931,20000,200,0,2,7,2,5,1,0,1,1,0,1,1,1,0,0,0,0,0,0,0,3,1,2,1,0,1,0,0,0,0,0,0
216940,20000,200,0,2,1,1,0,0,0,0,0,0,0,0,0,0,0,0,0,0,0,0,1,1,0,0,0,0,0,0,0,0,0,0
217013,20000,200,0,2,4,2,2,0,0,0,0,0,0,0,0,0,0,0,0,0,0,0,3,1,2,0,0,0,1,1,0,0,0,0
217059,20000,200,0,2,6,3,3,0,0,0,2,1,1,1,0,1,0,0,0,0,0,0,2,1,1,0,0,0,0,0,0,1,1,0
217077,20000,200,0,2,2,0,2,0,0,0,0,0,0,0,0,0,0,0,0,0,0,0,2,0,2,0,0,0,0,0,0,0,0,0
217156,20000,200,0,2,264,125,139,1,1,0,28,15,13,17,5,12,13,9,4,0,0,0,94,35,59,4,2,2,18,10,8,89,48,41
217165,20000,200,0,2,3,0,3,0,0,0,1,0,1,0,0,0,0,0,0,0,0,0,0,0,0,1,0,1,0,0,0,1,0,1
217235,20000,200,0,2,9,2,7,0,0,0,0,0,0,2,1,1,0,0,0,0,0,0,4,1,3,0,0,0,2,0,2,1,0,1
217402,20000,200,0,2,39,18,21,0,0,0,1,1,0,3,1,2,0,0,0,0,0,0,30,13,17,2,1,1,0,0,0,3,2,1
217420,20000,200,0,2,2,0,2,0,0,0,0,0,0,1,0,1,0,0,0,0,0,0,1,0,1,0,0,0,0,0,0,0,0,0
217475,20000,200,0,2,14,4,10,0,0,0,1,0,1,1,1,0,1,1,0,0,0,0,11,2,9,0,0,0,0,0,0,0,0,0
217484,20000,200,0,2,63,22,41,0,0,0,5,1,4,6,0,6,1,1,0,0,0,0,46,18,28,0,0,0,0,0,0,5,2,3
217493,20000,200,0,2,19,5,14,0,0,0,1,0,1,5,1,4,0,0,0,0,0,0,3,2,1,0,0,0,3,0,3,7,2,5
217518,20000,200,0,2,7,2,5,0,0,0,0,0,0,1,0,1,0,0,0,0,0,0,2,1,1,0,0,0,0,0,0,4,1,3
217536,20000,200,0,2,7,3,4,0,0,0,1,1,0,0,0,0,0,0,0,0,0,0,6,2,4,0,0,0,0,0,0,0,0,0
217615,20000,200,0,2,4,2,2,0,0,0,0,0,0,0,0,0,0,0,0,0,0,0,4,2,2,0,0,0,0,0,0,0,0,0
217624,20000,200,0,2,16,9,7,0,0,0,0,0,0,12,6,6,0,0,0,0,0,0,4,3,1,0,0,0,0,0,0,0,0,0
217633,20000,200,0,2,18,9,9,0,0,0,1,0,1,1,0,1,1,0,1,0,0,0,15,9,6,0,0,0,0,0,0,0,0,0
217688,20000,200,0,2,32,12,20,1,0,1,0,0,0,4,3,1,1,0,1,0,0,0,24,8,16,2,1,1,0,0,0,0,0,0
217712,20000,200,0,2,2,2,0,0,0,0,0,0,0,0,0,0,0,0,0,0,0,0,2,2,0,0,0,0,0,0,0,0,0,0
217721,20000,200,0,2,10,7,3,0,0,0,1,1,0,8,6,2,1,0,1,0,0,0,0,0,0,0,0,0,0,0,0,0,0,0
217749,20000,200,0,2,10,6,4,0,0,0,0,0,0,0,0,0,0,0,0,0,0,0,10,6,4,0,0,0,0,0,0,0,0,0
217776,20000,200,0,2,4,2,2,0,0,0,0,0,0,0,0,0,0,0,0,0,0,0,3,2,1,1,0,1,0,0,0,0,0,0
217819,20000,200,0,2,33,18,15,0,0,0,0,0,0,4,2,2,4,3,1,1,0,1,16,8,8,0,0,0,0,0,0,8,5,3
217837,20000,200,0,2,7,0,7,0,0,0,0,0,0,4,0,4,0,0,0,0,0,0,3,0,3,0,0,0,0,0,0,0,0,0
217864,20000,200,0,2,15,8,7,0,0,0,0,0,0,0,0,0,2,0,2,0,0,0,2,1,1,1,0,1,9,6,3,1,1,0
217873,20000,200,0,2,12,5,7,0,0,0,1,1,0,8,2,6,1,1,0,0,0,0,2,1,1,0,0,0,0,0,0,0,0,0
217882,20000,200,0,2,135,77,58,0,0,0,7,4,3,0,0,0,0,0,0,0,0,0,92,50,42,0,0,0,0,0,0,36,23,13
217907,20000,200,0,2,5,2,3,0,0,0,0,0,0,0,0,0,0,0,0,0,0,0,5,2,3,0,0,0,0,0,0,0,0,0
217925,20000,200,0,2,5,3,2,0,0,0,0,0,0,0,0,0,0,0,0,0,0,0,5,3,2,0,0,0,0,0,0,0,0,0
217934,20000,200,0,2,7,2,5,0,0,0,0,0,0,1,0,1,0,0,0,0,0,0,6,2,4,0,0,0,0,0,0,0,0,0
217961,20000,200,0,2,4,0,4,0,0,0,0,0,0,0,0,0,1,0,1,0,0,0,3,0,3,0,0,0,0,0,0,0,0,0
217998,20000,200,0,2,4,2,2,0,0,0,0,0,0,0,0,0,0,0,0,0,0,0,4,2,2,0,0,0,0,0,0,0,0,0
218025,20000,200,0,2,6,2,4,0,0,0,0,0,0,2,1,1,0,0,0,0,0,0,4,1,3,0,0,0,0,0,0,0,0,0
218061,20000,200,0,2,5,4,1,0,0,0,0,0,0,0,0,0,0,0,0,0,0,0,5,4,1,0,0,0,0,0,0,0,0,0
218070,20000,200,0,2,14,4,10,0,0,0,2,1,1,4,1,3,0,0,0,0,0,0,7,2,5,1,0,1,0,0,0,0,0,0
218113,20000,200,0,2,29,7,22,0,0,0,1,0,1,5,1,4,0,0,0,0,0,0,23,6,17,0,0,0,0,0,0,0,0,0
218140,20000,200,0,2,15,4,11,0,0,0,0,0,0,1,0,1,0,0,0,0,0,0,14,4,10,0,0,0,0,0,0,0,0,0
218229,20000,200,0,2,31,6,25,0,0,0,0,0,0,5,0,5,1,1,0,0,0,0,23,5,18,1,0,1,1,0,1,0,0,0
218238,20000,200,0,2,7,2,5,0,0,0,0,0,0,2,0,2,0,0,0,0,0,0,5,2,3,0,0,0,0,0,0,0,0,0
218335,20000,200,0,2,32,18,14,0,0,0,2,2,0,1,0,1,1,0,1,0,0,0,28,16,12,0,0,0,0,0,0,0,0,0
218353,20000,200,0,2,12,3,9,0,0,0,1,0,1,2,1,1,2,1,1,0,0,0,7,1,6,0,0,0,0,0,0,0,0,0
218399,20000,200,0,2,2,1,1,0,0,0,0,0,0,2,1,1,0,0,0,0,0,0,0,0,0,0,0,0,0,0,0,0,0,0
218414,20000,200,0,2,5,4,1,0,0,0,0,0,0,4,3,1,0,0,0,0,0,0,1,1,0,0,0,0,0,0,0,0,0,0
218441,20000,200,0,2,14,9,5,0,0,0,0,0,0,1,1,0,0,0,0,0,0,0,13,8,5,0,0,0,0,0,0,0,0,0
218487,20000,200,0,2,8,3,5,0,0,0,0,0,0,2,0,2,0,0,0,0,0,0,6,3,3,0,0,0,0,0,0,0,0,0
218520,20000,200,0,2,15,6,9,0,0,0,0,0,0,5,2,3,1,0,1,0,0,0,9,4,5,0,0,0,0,0,0,0,0,0
218539,20000,200,0,2,10,3,7,0,0,0,2,1,1,2,0,2,0,0,0,0,0,0,6,2,4,0,0,0,0,0,0,0,0,0
218645,20000,200,0,2,9,3,6,0,0,0,1,0,1,0,0,0,0,0,0,0,0,0,8,3,5,0,0,0,0,0,0,0,0,0
218654,20000,200,0,2,1,1,0,0,0,0,0,0,0,0,0,0,0,0,0,0,0,0,1,1,0,0,0,0,0,0,0,0,0,0
218663,20000,200,0,2,157,79,78,0,0,0,7,4,3,13,6,7,5,2,3,0,0,0,60,23,37,5,3,2,1,0,1,66,41,25
218681,20000,200,0,2,1,0,1,0,0,0,0,0,0,0,0,0,0,0,0,0,0,0,1,0,1,0,0,0,0,0,0,0,0,0
218690,20000,200,0,2,6,2,4,0,0,0,1,0,1,0,0,0,1,0,1,0,0,0,4,2,2,0,0,0,0,0,0,0,0,0
218706,20000,200,0,2,1,0,1,0,0,0,0,0,0,0,0,0,0,0,0,0,0,0,1,0,1,0,0,0,0,0,0,0,0,0
218724,20000,200,0,2,28,16,12,0,0,0,3,3,0,3,2,1,1,0,1,0,0,0,19,10,9,1,1,0,1,0,1,0,0,0
218733,20000,200,0,2,10,7,3,0,0,0,1,1,0,9,6,3,0,0,0,0,0,0,0,0,0,0,0,0,0,0,0,0,0,0
218742,20000,200,0,2,13,2,11,0,0,0,0,0,0,2,0,2,0,0,0,0,0,0,10,2,8,1,0,1,0,0,0,0,0,0
218751,20000,200,0,2,4,2,2,0,0,0,0,0,0,0,0,0,0,0,0,0,0,0,3,1,2,1,1,0,0,0,0,0,0,0
218821,20000,200,0,2,4,1,3,0,0,0,0,0,0,1,1,0,0,0,0,0,0,0,3,0,3,0,0,0,0,0,0,0,0,0
218830,20000,200,0,2,16,4,12,0,0,0,1,1,0,1,0,1,1,0,1,0,0,0,13,3,10,0,0,0,0,0,0,0,0,0
218858,20000,200,0,2,7,3,4,0,0,0,0,0,0,2,1,1,0,0,0,0,0,0,5,2,3,0,0,0,0,0,0,0,0,0
218885,20000,200,0,2,11,5,6,0,0,0,0,0,0,3,1,2,1,0,1,0,0,0,7,4,3,0,0,0,0,0,0,0,0,0
218894,20000,200,0,2,16,6,10,0,0,0,1,0,1,2,1,1,0,0,0,0,0,0,13,5,8,0,0,0,0,0,0,0,0,0
218919,20000,200,0,2,4,3,1,0,0,0,0,0,0,4,3,1,0,0,0,0,0,0,0,0,0,0,0,0,0,0,0,0,0,0
218955,20000,200,0,2,6,3,3,0,0,0,0,0,0,2,1,1,0,0,0,0,0,0,4,2,2,0,0,0,0,0,0,0,0,0
218964,20000,200,0,2,3,1,2,0,0,0,0,0,0,0,0,0,0,0,0,0,0,0,3,1,2,0,0,0,0,0,0,0,0,0
218973,20000,200,0,2,11,5,6,0,0,0,3,1,2,1,0,1,0,0,0,0,0,0,6,4,2,0,0,0,1,0,1,0,0,0
218991,20000,200,0,2,18,9,9,0,0,0,0,0,0,3,1,2,0,0,0,0,0,0,15,8,7,0,0,0,0,0,0,0,0,0
219000,20000,200,0,2,8,4,4,0,0,0,2,2,0,1,0,1,1,1,0,0,0,0,3,0,3,1,1,0,0,0,0,0,0,0
219046,20000,200,0,2,4,4,0,0,0,0,0,0,0,0,0,0,0,0,0,0,0,0,4,4,0,0,0,0,0,0,0,0,0,0
219082,20000,200,0,2,9,7,2,0,0,0,1,1,0,0,0,0,0,0,0,0,0,0,7,6,1,0,0,0,0,0,0,1,0,1
219091,20000,200,0,2,7,3,4,0,0,0,0,0,0,0,0,0,0,0,0,0,0,0,7,3,4,0,0,0,0,0,0,0,0,0
219143,20000,200,0,2,16,11,5,0,0,0,0,0,0,0,0,0,0,0,0,0,0,0,16,11,5,0,0,0,0,0,0,0,0,0
219189,20000,200,0,2,7,3,4,0,0,0,0,0,0,0,0,0,0,0,0,0,0,0,7,3,4,0,0,0,0,0,0,0,0,0
219198,20000,200,0,2,4,1,3,0,0,0,0,0,0,0,0,0,0,0,0,0,0,0,4,1,3,0,0,0,0,0,0,0,0,0
219259,20000,200,0,2,9,2,7,0,0,0,0,0,0,1,0,1,0,0,0,0,0,0,6,2,4,0,0,0,0,0,0,2,0,2
219277,20000,200,0,2,7,3,4,3,2,1,0,0,0,0,0,0,0,0,0,0,0,0,4,1,3,0,0,0,0,0,0,0,0,0
219295,20000,200,0,2,4,0,4,0,0,0,0,0,0,0,0,0,0,0,0,0,0,0,4,0,4,0,0,0,0,0,0,0,0,0
219347,20000,200,0,2,15,13,2,0,0,0,1,1,0,0,0,0,0,0,0,0,0,0,9,8,1,0,0,0,0,0,0,5,4,1
219356,20000,200,0,2,50,25,25,1,0,1,5,4,1,0,0,0,0,0,0,0,0,0,33,12,21,0,0,0,0,0,0,11,9,2
219374,20000,200,0,2,3,2,1,2,2,0,0,0,0,0,0,0,0,0,0,0,0,0,1,0,1,0,0,0,0,0,0,0,0,0
219383,20000,200,0,2,2,2,0,0,0,0,0,0,0,0,0,0,0,0,0,0,0,0,2,2,0,0,0,0,0,0,0,0,0,0
219408,20000,200,0,2,1,1,0,0,0,0,0,0,0,0,0,0,0,0,0,0,0,0,1,1,0,0,0,0,0,0,0,0,0,0
219426,20000,200,0,2,18,5,13,0,0,0,0,0,0,0,0,0,0,0,0,0,0,0,18,5,13,0,0,0,0,0,0,0,0,0
219471,20000,200,0,2,33,16,17,0,0,0,3,2,1,1,0,1,3,2,1,0,0,0,23,11,12,0,0,0,0,0,0,3,1,2
219480,20000,200,0,2,12,7,5,0,0,0,0,0,0,0,0,0,0,0,0,0,0,0,9,5,4,2,2,0,1,0,1,0,0,0
219505,20000,200,0,2,1,0,1,0,0,0,0,0,0,1,0,1,0,0,0,0,0,0,0,0,0,0,0,0,0,0,0,0,0,0
219602,20000,200,0,2,24,9,15,0,0,0,0,0,0,4,1,3,0,0,0,0,0,0,16,6,10,1,0,1,2,1,1,1,1,0
219639,20000,200,0,2,7,2,5,0,0,0,0,0,0,3,0,3,0,0,0,0,0,0,4,2,2,0,0,0,0,0,0,0,0,0
219709,20000,200,0,2,39,17,22,0,0,0,0,0,0,10,4,6,0,0,0,0,0,0,25,13,12,0,0,0,2,0,2,2,0,2
219718,20000,200,0,2,4,1,3,0,0,0,0,0,0,0,0,0,0,0,0,0,0,0,4,1,3,0,0,0,0,0,0,0,0,0
219790,20000,200,0,2,6,4,2,0,0,0,0,0,0,0,0,0,0,0,0,0,0,0,6,4,2,0,0,0,0,0,0,0,0,0
219806,20000,200,0,2,5,2,3,0,0,0,0,0,0,0,0,0,0,0,0,0,0,0,5,2,3,0,0,0,0,0,0,0,0,0
219824,20000,200,0,2,32,12,20,1,1,0,1,0,1,1,0,1,1,1,0,0,0,0,26,9,17,2,1,1,0,0,0,0,0,0
219833,20000,200,0,2,11,3,8,0,0,0,0,0,0,1,0,1,0,0,0,0,0,0,10,3,7,0,0,0,0,0,0,0,0,0
219879,20000,200,0,2,7,3,4,0,0,0,0,0,0,0,0,0,0,0,0,0,0,0,7,3,4,0,0,0,0,0,0,0,0,0
219888,20000,200,0,2,18,6,12,1,0,1,3,1,2,0,0,0,0,0,0,0,0,0,13,5,8,0,0,0,1,0,1,0,0,0
219903,20000,200,0,2,14,1,13,0,0,0,0,0,0,8,0,8,0,0,0,0,0,0,5,0,5,0,0,0,1,1,0,0,0,0
219949,20000,200,0,2,10,5,5,0,0,0,0,0,0,1,0,1,0,0,0,0,0,0,9,5,4,0,0,0,0,0,0,0,0,0
219976,20000,200,0,2,14,7,7,0,0,0,1,0,1,1,1,0,0,0,0,0,0,0,10,4,6,0,0,0,2,2,0,0,0,0
220057,20000,200,0,2,5,3,2,0,0,0,0,0,0,1,1,0,0,0,0,0,0,0,3,1,2,0,0,0,1,1,0,0,0,0
220075,20000,200,0,2,118,51,67,0,0,0,4,2,2,4,1,3,1,0,1,0,0,0,88,35,53,2,0,2,4,2,2,15,11,4
220118,20000,200,0,2,6,0,6,0,0,0,0,0,0,1,0,1,0,0,0,0,0,0,5,0,5,0,0,0,0,0,0,0,0,0
220181,20000,200,0,2,5,3,2,0,0,0,0,0,0,4,3,1,0,0,0,0,0,0,1,0,1,0,0,0,0,0,0,0,0,0
220206,20000,200,0,2,1,1,0,0,0,0,0,0,0,0,0,0,0,0,0,0,0,0,1,1,0,0,0,0,0,0,0,0,0,0
220215,20000,200,0,2,11,6,5,0,0,0,0,0,0,1,1,0,0,0,0,0,0,0,10,5,5,0,0,0,0,0,0,0,0,0
220400,20000,200,0,2,1,1,0,0,0,0,0,0,0,0,0,0,0,0,0,0,0,0,1,1,0,0,0,0,0,0,0,0,0,0
220473,20000,200,0,2,2,2,0,0,0,0,0,0,0,0,0,0,0,0,0,0,0,0,2,2,0,0,0,0,0,0,0,0,0,0
220516,20000,200,0,2,6,0,6,0,0,0,0,0,0,0,0,0,0,0,0,0,0,0,6,0,6,0,0,0,0,0,0,0,0,0
220552,20000,200,0,2,56,15,41,1,1,0,4,0,4,7,1,6,2,1,1,0,0,0,40,11,29,2,1,1,0,0,0,0,0,0
220598,20000,200,0,2,15,8,7,0,0,0,1,1,0,7,3,4,3,1,2,0,0,0,4,3,1,0,0,0,0,0,0,0,0,0
220604,20000,200,0,2,6,2,4,0,0,0,0,0,0,6,2,4,0,0,0,0,0,0,0,0,0,0,0,0,0,0,0,0,0,0
220613,20000,200,0,2,7,4,3,0,0,0,1,0,1,0,0,0,0,0,0,0,0,0,6,4,2,0,0,0,0,0,0,0,0,0
220631,20000,200,0,2,76,28,48,0,0,0,1,1,0,2,2,0,2,1,1,0,0,0,64,22,42,0,0,0,7,2,5,0,0,0
220710,20000,200,0,2,5,1,4,0,0,0,0,0,0,0,0,0,0,0,0,0,0,0,5,1,4,0,0,0,0,0,0,0,0,0
220792,20000,200,0,2,10,6,4,0,0,0,2,1,1,8,5,3,0,0,0,0,0,0,0,0,0,0,0,0,0,0,0,0,0,0
220862,20000,200,0,2,88,46,42,0,0,0,16,9,7,17,6,11,3,3,0,0,0,0,48,24,24,0,0,0,2,2,0,2,2,0
220978,20000,200,0,2,82,37,45,0,0,0,3,2,1,9,2,7,4,3,1,0,0,0,59,26,33,0,0,0,0,0,0,7,4,3
220996,20000,200,0,2,2,1,1,0,0,0,0,0,0,0,0,0,0,0,0,0,0,0,2,1,1,0,0,0,0,0,0,0,0,0
221096,20000,200,0,2,3,2,1,0,0,0,0,0,0,0,0,0,0,0,0,0,0,0,3,2,1,0,0,0,0,0,0,0,0,0
221148,20000,200,0,2,22,22,0,0,0,0,0,0,0,0,0,0,0,0,0,0,0,0,22,22,0,0,0,0,0,0,0,0,0,0
221184,20000,200,0,2,11,4,7,0,0,0,0,0,0,1,0,1,0,0,0,0,0,0,8,4,4,0,0,0,0,0,0,2,0,2
221351,20000,200,0,2,20,12,8,0,0,0,1,1,0,1,1,0,2,1,1,0,0,0,6,3,3,0,0,0,6,3,3,4,3,1
221397,20000,200,0,2,17,5,12,0,0,0,0,0,0,0,0,0,0,0,0,0,0,0,16,5,11,0,0,0,1,0,1,0,0,0
221485,20000,200,0,2,13,7,6,0,0,0,0,0,0,4,2,2,1,0,1,0,0,0,8,5,3,0,0,0,0,0,0,0,0,0
221519,20000,200,0,2,13,8,5,0,0,0,1,1,0,0,0,0,0,0,0,0,0,0,9,5,4,0,0,0,1,1,0,2,1,1
221643,20000,200,0,2,6,5,1,0,0,0,0,0,0,1,1,0,1,1,0,0,0,0,2,2,0,1,0,1,1,1,0,0,0,0
221661,20000,200,0,2,8,3,5,0,0,0,3,2,1,2,0,2,0,0,0,0,0,0,3,1,2,0,0,0,0,0,0,0,0,0
221670,20000,200,0,2,4,2,2,0,0,0,1,0,1,0,0,0,0,0,0,0,0,0,3,2,1,0,0,0,0,0,0,0,0,0
221731,20000,200,0,2,2,0,2,0,0,0,0,0,0,0,0,0,0,0,0,0,0,0,2,0,2,0,0,0,0,0,0,0,0,0
221740,20000,200,0,2,35,18,17,0,0,0,4,2,2,3,0,3,0,0,0,0,0,0,20,11,9,0,0,0,0,0,0,8,5,3
221759,20000,200,0,2,110,46,64,1,0,1,8,6,2,20,8,12,7,0,7,0,0,0,62,26,36,1,0,1,0,0,0,11,6,5
221768,20000,200,0,2,19,5,14,0,0,0,0,0,0,3,0,3,0,0,0,0,0,0,15,5,10,0,0,0,0,0,0,1,0,1
221838,20000,200,0,2,29,14,15,0,0,0,2,2,0,9,4,5,2,0,2,0,0,0,14,7,7,0,0,0,0,0,0,2,1,1
221847,20000,200,0,2,40,21,19,0,0,0,1,1,0,0,0,0,0,0,0,0,0,0,26,10,16,1,1,0,3,2,1,9,7,2
221892,20000,200,0,2,5,4,1,0,0,0,1,1,0,0,0,0,0,0,0,0,0,0,4,3,1,0,0,0,0,0,0,0,0,0
221908,20000,200,0,2,4,1,3,0,0,0,0,0,0,0,0,0,0,0,0,0,0,0,4,1,3,0,0,0,0,0,0,0,0,0
221953,20000,200,0,2,8,3,5,0,0,0,1,1,0,0,0,0,0,0,0,0,0,0,7,2,5,0,0,0,0,0,0,0,0,0
221971,20000,200,0,2,17,9,8,0,0,0,0,0,0,2,2,0,0,0,0,0,0,0,15,7,8,0,0,0,0,0,0,0,0,0
221999,20000,200,0,2,103,44,59,0,0,0,3,1,2,4,2,2,3,1,2,0,0,0,24,10,14,0,0,0,49,19,30,20,11,9
222053,20000,200,0,2,13,9,4,0,0,0,0,0,0,3,2,1,0,0,0,0,0,0,10,7,3,0,0,0,0,0,0,0,0,0
222062,20000,200,0,2,14,7,7,0,0,0,0,0,0,0,0,0,0,0,0,0,0,0,14,7,7,0,0,0,0,0,0,0,0,0
222105,20000,200,0,2,7,7,0,0,0,0,0,0,0,3,3,0,0,0,0,0,0,0,4,4,0,0,0,0,0,0,0,0,0,0
222178,20000,200,0,2,12,7,5,0,0,0,0,0,0,2,0,2,1,0,1,0,0,0,7,5,2,0,0,0,2,2,0,0,0,0
222567,20000,200,0,2,9,4,5,0,0,0,0,0,0,1,1,0,1,1,0,0,0,0,5,1,4,0,0,0,2,1,1,0,0,0
222576,20000,200,0,2,11,5,6,0,0,0,0,0,0,1,0,1,2,0,2,0,0,0,8,5,3,0,0,0,0,0,0,0,0,0
222628,20000,200,0,2,1,0,1,0,0,0,0,0,0,0,0,0,0,0,0,0,0,0,1,0,1,0,0,0,0,0,0,0,0,0
222822,20000,200,0,2,8,4,4,0,0,0,1,0,1,0,0,0,0,0,0,0,0,0,7,4,3,0,0,0,0,0,0,0,0,0
222831,20000,200,0,2,25,9,16,0,0,0,3,0,3,2,1,1,1,1,0,0,0,0,17,6,11,0,0,0,2,1,1,0,0,0
222877,20000,200,0,2,1,1,0,0,0,0,0,0,0,0,0,0,0,0,0,0,0,0,1,1,0,0,0,0,0,0,0,0,0,0
222983,20000,200,0,2,6,3,3,0,0,0,0,0,0,1,0,1,1,1,0,0,0,0,3,2,1,0,0,0,0,0,0,1,0,1
222992,20000,200,0,2,18,10,8,0,0,0,1,1,0,4,1,3,2,2,0,0,0,0,11,6,5,0,0,0,0,0,0,0,0,0
223083,20000,200,0,2,4,0,4,0,0,0,0,0,0,0,0,0,0,0,0,0,0,0,4,0,4,0,0,0,0,0,0,0,0,0
223223,20000,200,0,2,788,264,524,0,0,0,206,81,125,88,19,69,103,31,72,4,2,2,245,75,170,30,10,20,112,46,66,0,0,0
223232,20000,200,0,2,34,11,23,0,0,0,3,2,1,4,0,4,1,0,1,0,0,0,20,7,13,0,0,0,5,1,4,1,1,0
223320,20000,200,0,2,4,1,3,0,0,0,0,0,0,1,1,0,0,0,0,0,0,0,2,0,2,0,0,0,1,0,1,0,0,0
223427,20000,200,0,2,7,2,5,0,0,0,0,0,0,3,1,2,0,0,0,0,0,0,4,1,3,0,0,0,0,0,0,0,0,0
223463,20000,200,0,2,1,1,0,0,0,0,0,0,0,1,1,0,0,0,0,0,0,0,0,0,0,0,0,0,0,0,0,0,0,0
223506,20000,200,0,2,5,3,2,0,0,0,0,0,0,1,0,1,0,0,0,0,0,0,3,2,1,1,1,0,0,0,0,0,0,0
223816,20000,200,0,2,6,1,5,0,0,0,0,0,0,0,0,0,1,0,1,0,0,0,3,1,2,2,0,2,0,0,0,0,0,0
223898,20000,200,0,2,10,5,5,0,0,0,0,0,0,0,0,0,1,0,1,0,0,0,8,5,3,0,0,0,1,0,1,0,0,0
223922,20000,200,0,2,5,3,2,0,0,0,0,0,0,0,0,0,0,0,0,0,0,0,5,3,2,0,0,0,0,0,0,0,0,0
224004,20000,200,0,2,4,0,4,0,0,0,1,0,1,1,0,1,0,0,0,0,0,0,2,0,2,0,0,0,0,0,0,0,0,0
224110,20000,200,0,2,12,5,7,1,0,1,0,0,0,1,0,1,0,0,0,0,0,0,7,3,4,2,1,1,1,1,0,0,0,0
224147,20000,200,0,2,22,6,16,0,0,0,4,1,3,1,0,1,2,1,1,0,0,0,11,2,9,1,1,0,0,0,0,3,1,2
224226,20000,200,0,2,6,2,4,0,0,0,0,0,0,1,0,1,0,0,0,0,0,0,5,2,3,0,0,0,0,0,0,0,0,0
224244,20000,200,0,2,1,0,1,0,0,0,0,0,0,0,0,0,0,0,0,0,0,0,1,0,1,0,0,0,0,0,0,0,0,0
224305,20000,200,0,2,3,3,0,0,0,0,1,1,0,0,0,0,0,0,0,0,0,0,2,2,0,0,0,0,0,0,0,0,0,0
224323,20000,200,0,2,7,3,4,0,0,0,0,0,0,0,0,0,0,0,0,0,0,0,7,3,4,0,0,0,0,0,0,0,0,0
224350,20000,200,0,2,14,10,4,0,0,0,1,1,0,0,0,0,5,4,1,0,0,0,8,5,3,0,0,0,0,0,0,0,0,0
224527,20000,200,0,2,16,5,11,1,0,1,1,1,0,0,0,0,0,0,0,0,0,0,14,4,10,0,0,0,0,0,0,0,0,0
224545,20000,200,0,2,6,4,2,0,0,0,0,0,0,0,0,0,0,0,0,0,0,0,3,2,1,0,0,0,1,0,1,2,2,0
224554,20000,200,0,2,25,10,15,0,0,0,1,1,0,2,0,2,2,1,1,0,0,0,12,5,7,0,0,0,1,0,1,7,3,4
224615,20000,200,0,2,30,8,22,0,0,0,6,1,5,10,2,8,3,2,1,0,0,0,11,3,8,0,0,0,0,0,0,0,0,0
224642,20000,200,0,2,24,6,18,0,0,0,0,0,0,0,0,0,14,3,11,0,0,0,8,2,6,0,0,0,0,0,0,2,1,1
224660,20000,200,0,2,16,9,7,0,0,0,0,0,0,0,0,0,9,6,3,0,0,0,5,2,3,1,0,1,1,1,0,0,0,0
224679,20000,200,0,2,15,14,1,0,0,0,0,0,0,0,0,0,15,14,1,0,0,0,0,0,0,0,0,0,0,0,0,0,0,0
224712,20000,200,0,2,5,1,4,0,0,0,1,0,1,2,1,1,1,0,1,0,0,0,1,0,1,0,0,0,0,0,0,0,0,0
224891,20000,200,0,2,5,2,3,0,0,0,0,0,0,0,0,0,1,0,1,0,0,0,4,2,2,0,0,0,0,0,0,0,0,0
224961,20000,200,0,2,6,2,4,0,0,0,1,1,0,1,0,1,4,1,3,0,0,0,0,0,0,0,0,0,0,0,0,0,0,0
225070,20000,200,0,2,13,6,7,0,0,0,1,0,1,0,0,0,1,0,1,0,0,0,11,6,5,0,0,0,0,0,0,0,0,0
225201,20000,200,0,2,10,5,5,0,0,0,1,1,0,2,2,0,4,1,3,0,0,0,3,1,2,0,0,0,0,0,0,0,0,0
225247,20000,200,0,2,5,1,4,0,0,0,0,0,0,0,0,0,0,0,0,0,0,0,5,1,4,0,0,0,0,0,0,0,0,0
225308,20000,200,0,2,10,2,8,0,0,0,0,0,0,1,1,0,0,0,0,0,0,0,9,1,8,0,0,0,0,0,0,0,0,0
225371,20000,200,0,2,5,2,3,0,0,0,1,1,0,0,0,0,0,0,0,0,0,0,4,1,3,0,0,0,0,0,0,0,0,0
225399,20000,200,0,2,16,6,10,0,0,0,0,0,0,3,0,3,1,0,1,0,0,0,12,6,6,0,0,0,0,0,0,0,0,0
225414,20000,200,0,2,10,0,10,0,0,0,3,0,3,1,0,1,0,0,0,0,0,0,4,0,4,0,0,0,0,0,0,2,0,2
225423,20000,200,0,2,25,13,12,0,0,0,2,0,2,6,1,5,4,3,1,0,0,0,9,7,2,2,1,1,2,1,1,0,0,0
225432,20000,200,0,2,21,10,11,0,0,0,1,1,0,2,1,1,5,2,3,0,0,0,7,4,3,0,0,0,0,0,0,6,2,4
225502,20000,200,0,2,6,1,5,0,0,0,0,0,0,2,0,2,1,0,1,0,0,0,3,1,2,0,0,0,0,0,0,0,0,0
225511,20000,200,0,2,92,56,36,0,0,0,22,11,11,7,3,4,9,3,6,0,0,0,26,17,9,0,0,0,1,1,0,27,21,6
225520,20000,200,0,2,6,4,2,0,0,0,1,1,0,0,0,0,1,0,1,0,0,0,4,3,1,0,0,0,0,0,0,0,0,0
225548,20000,200,0,2,3,2,1,0,0,0,0,0,0,0,0,0,2,2,0,0,0,0,1,0,1,0,0,0,0,0,0,0,0,0
225627,20000,200,0,2,33,14,19,0,0,0,3,1,2,1,0,1,9,4,5,0,0,0,13,6,7,3,0,3,0,0,0,4,3,1
225885,20000,200,0,2,1,1,0,0,0,0,0,0,0,0,0,0,1,1,0,0,0,0,0,0,0,0,0,0,0,0,0,0,0,0
226019,20000,200,0,2,13,5,8,0,0,0,0,0,0,0,0,0,0,0,0,0,0,0,13,5,8,0,0,0,0,0,0,0,0,0
226091,20000,200,0,2,18,10,8,0,0,0,2,2,0,1,0,1,0,0,0,0,0,0,13,6,7,0,0,0,2,2,0,0,0,0
226116,20000,200,0,2,10,4,6,0,0,0,0,0,0,2,0,2,2,1,1,0,0,0,6,3,3,0,0,0,0,0,0,0,0,0
226134,20000,200,0,2,11,5,6,0,0,0,1,1,0,0,0,0,10,4,6,0,0,0,0,0,0,0,0,0,0,0,0,0,0,0
226152,20000,200,0,2,27,9,18,0,0,0,3,1,2,1,0,1,7,1,6,0,0,0,10,6,4,1,0,1,2,1,1,3,0,3
226204,20000,200,0,2,15,9,6,0,0,0,0,0,0,4,3,1,2,1,1,0,0,0,8,5,3,0,0,0,1,0,1,0,0,0
226231,20000,200,0,2,19,12,7,0,0,0,1,0,1,0,0,0,0,0,0,0,0,0,17,11,6,0,0,0,1,1,0,0,0,0
226277,20000,200,0,2,35,31,4,0,0,0,1,1,0,2,2,0,4,4,0,0,0,0,26,22,4,1,1,0,1,1,0,0,0,0
226383,20000,200,0,2,3,2,1,0,0,0,0,0,0,0,0,0,0,0,0,0,0,0,3,2,1,0,0,0,0,0,0,0,0,0
226408,20000,200,0,2,5,3,2,0,0,0,0,0,0,1,1,0,0,0,0,0,0,0,2,2,0,2,0,2,0,0,0,0,0,0
226471,20000,200,0,2,20,7,13,1,0,1,2,1,1,1,0,1,2,1,1,0,0,0,14,5,9,0,0,0,0,0,0,0,0,0
226578,20000,200,0,2,7,4,3,0,0,0,0,0,0,1,1,0,0,0,0,0,0,0,6,3,3,0,0,0,0,0,0,0,0,0
226587,20000,200,0,2,5,3,2,0,0,0,0,0,0,0,0,0,0,0,0,0,0,0,5,3,2,0,0,0,0,0,0,0,0,0
226806,20000,200,0,2,10,5,5,0,0,0,1,1,0,0,0,0,4,1,3,0,0,0,5,3,2,0,0,0,0,0,0,0,0,0
226833,20000,200,0,2,13,3,10,0,0,0,0,0,0,0,0,0,1,0,1,0,0,0,9,3,6,0,0,0,0,0,0,3,0,3
226903,20000,200,0,2,40,23,17,0,0,0,0,0,0,1,1,0,25,14,11,0,0,0,10,6,4,1,1,0,3,1,2,0,0,0
227146,20000,200,0,2,7,1,6,0,0,0,0,0,0,0,0,0,1,0,1,0,0,0,6,1,5,0,0,0,0,0,0,0,0,0
227182,20000,200,0,2,13,8,5,0,0,0,0,0,0,5,2,3,3,3,0,0,0,0,5,3,2,0,0,0,0,0,0,0,0,0
227216,20000,200,0,2,161,74,87,0,0,0,33,23,10,13,6,7,15,4,11,1,0,1,84,35,49,3,1,2,7,2,5,5,3,2
227225,20000,200,0,2,6,1,5,0,0,0,0,0,0,0,0,0,0,0,0,0,0,0,6,1,5,0,0,0,0,0,0,0,0,0
227304,20000,200,0,2,14,7,7,0,0,0,1,1,0,2,0,2,2,0,2,1,1,0,8,5,3,0,0,0,0,0,0,0,0,0
227331,20000,200,0,2,15,3,12,0,0,0,1,0,1,3,1,2,8,1,7,0,0,0,3,1,2,0,0,0,0,0,0,0,0,0
227368,20000,200,0,2,237,130,107,0,0,0,28,15,13,4,2,2,84,39,45,0,0,0,81,46,35,1,1,0,6,4,2,33,23,10
227377,20000,200,0,2,4,3,1,0,0,0,0,0,0,0,0,0,2,1,1,0,0,0,1,1,0,0,0,0,0,0,0,1,1,0
227386,20000,200,0,2,9,3,6,1,0,1,0,0,0,0,0,0,0,0,0,0,0,0,8,3,5,0,0,0,0,0,0,0,0,0
227401,20000,200,0,2,10,6,4,0,0,0,0,0,0,1,0,1,2,2,0,0,0,0,7,4,3,0,0,0,0,0,0,0,0,0
227526,20000,200,0,2,17,10,7,0,0,0,3,1,2,6,3,3,0,0,0,0,0,0,7,5,2,0,0,0,0,0,0,1,1,0
227687,20000,200,0,2,7,5,2,0,0,0,0,0,0,0,0,0,1,1,0,0,0,0,6,4,2,0,0,0,0,0,0,0,0,0
227757,20000,200,0,2,51,37,14,0,0,0,5,3,2,5,2,3,7,5,2,0,0,0,18,13,5,0,0,0,8,6,2,8,8,0
227845,20000,200,0,2,11,6,5,0,0,0,2,1,1,1,0,1,0,0,0,0,0,0,8,5,3,0,0,0,0,0,0,0,0,0
227854,20000,200,0,2,16,7,9,0,0,0,3,1,2,3,0,3,4,3,1,0,0,0,6,3,3,0,0,0,0,0,0,0,0,0
227863,20000,200,0,2,11,6,5,0,0,0,1,0,1,1,0,1,1,1,0,0,0,0,7,5,2,0,0,0,0,0,0,1,0,1
227881,20000,200,0,2,101,41,60,1,0,1,7,2,5,6,0,6,9,5,4,0,0,0,67,28,39,0,0,0,0,0,0,11,6,5
227924,20000,200,0,2,12,4,8,0,0,0,1,0,1,1,0,1,6,2,4,0,0,0,4,2,2,0,0,0,0,0,0,0,0,0
227979,20000,200,0,2,24,11,13,0,0,0,0,0,0,9,4,5,2,1,1,0,0,0,12,6,6,0,0,0,0,0,0,1,0,1
228042,20000,200,0,2,5,2,3,0,0,0,0,0,0,1,0,1,0,0,0,0,0,0,4,2,2,0,0,0,0,0,0,0,0,0
228149,20000,200,0,2,13,8,5,0,0,0,1,0,1,2,1,1,2,2,0,0,0,0,6,4,2,0,0,0,0,0,0,2,1,1
228158,20000,200,0,2,13,6,7,0,0,0,1,0,1,0,0,0,3,1,2,0,0,0,9,5,4,0,0,0,0,0,0,0,0,0
228194,20000,200,0,2,2,1,1,0,0,0,0,0,0,0,0,0,0,0,0,0,0,0,2,1,1,0,0,0,0,0,0,0,0,0
228246,20000,200,0,2,66,35,31,0,0,0,17,11,6,6,3,3,1,0,1,0,0,0,30,13,17,0,0,0,0,0,0,12,8,4
228316,20000,200,0,2,8,2,6,0,0,0,0,0,0,0,0,0,6,1,5,0,0,0,2,1,1,0,0,0,0,0,0,0,0,0
228325,20000,200,0,2,4,4,0,0,0,0,1,1,0,0,0,0,0,0,0,0,0,0,3,3,0,0,0,0,0,0,0,0,0,0
228343,20000,200,0,2,10,2,8,0,0,0,2,0,2,0,0,0,4,1,3,0,0,0,3,0,3,1,1,0,0,0,0,0,0,0
228431,20000,200,0,2,4,2,2,0,0,0,0,0,0,2,1,1,0,0,0,0,0,0,1,0,1,0,0,0,0,0,0,1,1,0
228459,20000,200,0,2,69,35,34,0,0,0,12,8,4,3,3,0,5,2,3,0,0,0,25,10,15,2,1,1,22,11,11,0,0,0
228468,20000,200,0,2,7,3,4,0,0,0,0,0,0,0,0,0,2,0,2,1,1,0,4,2,2,0,0,0,0,0,0,0,0,0
228501,20000,200,0,2,6,2,4,0,0,0,1,1,0,0,0,0,0,0,0,0,0,0,5,1,4,0,0,0,0,0,0,0,0,0
228529,20000,200,0,2,35,17,18,1,1,0,2,0,2,4,2,2,3,2,1,0,0,0,21,9,12,1,1,0,0,0,0,3,2,1
228547,20000,200,0,2,12,5,7,0,0,0,2,2,0,5,0,5,3,2,1,0,0,0,2,1,1,0,0,0,0,0,0,0,0,0
228608,20000,200,0,2,14,6,8,1,1,0,2,1,1,1,1,0,0,0,0,0,0,0,10,3,7,0,0,0,0,0,0,0,0,0
228635,20000,200,0,2,201,102,99,0,0,0,77,41,36,12,5,7,11,5,6,0,0,0,74,36,38,3,1,2,4,1,3,20,13,7
228644,20000,200,0,2,180,74,106,1,1,0,31,15,16,13,4,9,41,10,31,0,0,0,68,32,36,1,1,0,23,10,13,2,1,1
228653,20000,200,0,2,51,26,25,0,0,0,7,5,2,9,4,5,6,2,4,0,0,0,25,13,12,0,0,0,0,0,0,4,2,2
228699,20000,200,0,2,3,0,3,0,0,0,0,0,0,1,0,1,0,0,0,0,0,0,2,0,2,0,0,0,0,0,0,0,0,0
228705,20000,200,0,2,7,5,2,0,0,0,1,1,0,0,0,0,1,1,0,0,0,0,3,2,1,0,0,0,0,0,0,2,1,1
228723,20000,200,0,2,279,173,106,0,0,0,76,48,28,14,8,6,23,12,11,0,0,0,127,79,48,3,3,0,23,17,6,13,6,7
228769,20000,200,0,2,100,49,51,0,0,0,23,14,9,8,2,6,8,6,2,1,0,1,24,10,14,3,1,2,23,9,14,10,7,3
228778,20000,200,0,2,222,112,110,0,0,0,32,12,20,19,8,11,34,16,18,0,0,0,99,52,47,3,1,2,0,0,0,35,23,12
228787,20000,200,0,2,78,40,38,0,0,0,20,14,6,2,0,2,1,0,1,0,0,0,25,11,14,2,1,1,27,13,14,1,1,0
228796,20000,200,0,2,58,24,34,0,0,0,11,3,8,1,1,0,19,5,14,0,0,0,16,9,7,1,0,1,2,2,0,8,4,4
228802,20000,200,0,2,37,16,21,0,0,0,6,4,2,2,1,1,1,0,1,0,0,0,13,3,10,0,0,0,5,2,3,10,6,4
228875,20000,200,0,2,45,17,28,0,0,0,2,1,1,9,3,6,6,1,5,0,0,0,22,10,12,0,0,0,3,1,2,3,1,2
228884,20000,200,0,2,3,1,2,0,0,0,0,0,0,3,1,2,0,0,0,0,0,0,0,0,0,0,0,0,0,0,0,0,0,0
228909,20000,200,0,2,37,14,23,0,0,0,6,3,3,4,2,2,6,2,4,0,0,0,15,7,8,1,0,1,3,0,3,2,0,2
228981,20000,200,0,2,5,3,2,0,0,0,0,0,0,0,0,0,5,3,2,0,0,0,0,0,0,0,0,0,0,0,0,0,0,0
229018,20000,200,0,2,26,12,14,0,0,0,1,1,0,3,0,3,3,1,2,0,0,0,18,9,9,0,0,0,0,0,0,1,1,0
229027,20000,200,0,2,71,42,29,0,0,0,5,4,1,2,0,2,20,11,9,0,0,0,11,6,5,0,0,0,12,5,7,21,16,5
229063,20000,200,0,2,18,8,10,1,0,1,2,0,2,13,7,6,0,0,0,0,0,0,2,1,1,0,0,0,0,0,0,0,0,0
229115,20000,200,0,2,120,63,57,1,0,1,9,5,4,2,1,1,11,6,5,1,0,1,57,27,30,1,0,1,0,0,0,38,24,14
229179,20000,200,0,2,25,4,21,0,0,0,7,1,6,2,0,2,5,1,4,0,0,0,10,2,8,0,0,0,1,0,1,0,0,0
229267,20000,200,0,2,13,7,6,0,0,0,1,0,1,1,1,0,4,2,2,0,0,0,7,4,3,0,0,0,0,0,0,0,0,0
229300,20000,200,0,2,192,89,103,0,0,0,56,27,29,10,1,9,23,8,15,1,1,0,53,24,29,6,1,5,21,12,9,22,15,7
229337,20000,200,0,2,39,17,22,0,0,0,13,6,7,1,0,1,5,1,4,0,0,0,20,10,10,0,0,0,0,0,0,0,0,0
229355,20000,200,0,2,37,11,26,0,0,0,0,0,0,1,0,1,1,0,1,0,0,0,35,11,24,0,0,0,0,0,0,0,0,0
229504,20000,200,0,2,7,4,3,0,0,0,0,0,0,0,0,0,0,0,0,0,0,0,7,4,3,0,0,0,0,0,0,0,0,0
229540,20000,200,0,2,7,5,2,0,0,0,0,0,0,0,0,0,2,2,0,0,0,0,5,3,2,0,0,0,0,0,0,0,0,0
229780,20000,200,0,2,3,2,1,0,0,0,0,0,0,0,0,0,1,0,1,0,0,0,2,2,0,0,0,0,0,0,0,0,0,0
229799,20000,200,0,2,12,3,9,0,0,0,2,1,1,1,0,1,0,0,0,0,0,0,6,1,5,0,0,0,3,1,2,0,0,0
229814,20000,200,0,2,32,15,17,0,0,0,3,2,1,0,0,0,2,1,1,0,0,0,17,6,11,0,0,0,0,0,0,10,6,4
229832,20000,200,0,2,4,4,0,0,0,0,0,0,0,0,0,0,1,1,0,0,0,0,3,3,0,0,0,0,0,0,0,0,0,0
229841,20000,200,0,2,11,2,9,0,0,0,0,0,0,3,0,3,1,1,0,0,0,0,5,0,5,0,0,0,2,1,1,0,0,0
229887,20000,200,0,2,5,0,5,0,0,0,0,0,0,5,0,5,0,0,0,0,0,0,0,0,0,0,0,0,0,0,0,0,0,0
230038,20000,200,0,2,66,40,26,0,0,0,1,1,0,0,0,0,1,0,1,0,0,0,60,37,23,4,2,2,0,0,0,0,0,0
230047,20000,200,0,2,9,5,4,0,0,0,1,1,0,0,0,0,1,0,1,1,0,1,5,3,2,0,0,0,0,0,0,1,1,0
230171,20000,200,0,2,30,14,16,0,0,0,2,1,1,0,0,0,0,0,0,0,0,0,26,11,15,0,0,0,1,1,0,1,1,0
230366,20000,200,0,2,5,0,5,0,0,0,0,0,0,0,0,0,0,0,0,0,0,0,5,0,5,0,0,0,0,0,0,0,0,0
230418,20000,200,0,2,1,1,0,0,0,0,0,0,0,0,0,0,0,0,0,0,0,0,1,1,0,0,0,0,0,0,0,0,0,0
230597,20000,200,0,2,12,6,6,0,0,0,0,0,0,1,0,1,0,0,0,0,0,0,11,6,5,0,0,0,0,0,0,0,0,0
230603,20000,200,0,2,37,24,13,0,0,0,0,0,0,1,1,0,3,1,2,0,0,0,32,21,11,0,0,0,0,0,0,1,1,0
230728,20000,200,0,2,61,33,28,0,0,0,5,4,1,0,0,0,4,3,1,0,0,0,48,24,24,2,1,1,2,1,1,0,0,0
230737,20000,200,0,2,87,47,40,0,0,0,8,2,6,1,0,1,2,1,1,1,0,1,54,29,25,2,1,1,12,9,3,7,5,2
230746,20000,200,0,2,21,12,9,1,0,1,1,0,1,1,0,1,3,1,2,0,0,0,15,11,4,0,0,0,0,0,0,0,0,0
230764,20000,200,0,2,416,217,199,1,1,0,31,14,17,8,4,4,26,7,19,1,1,0,211,113,98,6,3,3,24,11,13,108,63,45
230782,20000,200,0,2,44,23,21,0,0,0,1,1,0,0,0,0,1,1,0,0,0,0,35,17,18,1,0,1,2,1,1,4,3,1
230807,20000,200,0,2,4,0,4,0,0,0,0,0,0,0,0,0,0,0,0,0,0,0,4,0,4,0,0,0,0,0,0,0,0,0
230816,20000,200,0,2,2,1,1,0,0,0,1,0,1,0,0,0,0,0,0,0,0,0,1,1,0,0,0,0,0,0,0,0,0,0
230834,20000,200,0,2,2,0,2,0,0,0,0,0,0,0,0,0,0,0,0,0,0,0,1,0,1,0,0,0,1,0,1,0,0,0
230852,20000,200,0,2,2,1,1,0,0,0,0,0,0,0,0,0,0,0,0,0,0,0,1,1,0,0,0,0,1,0,1,0,0,0
230913,20000,200,0,2,2,1,1,0,0,0,0,0,0,0,0,0,0,0,0,0,0,0,2,1,1,0,0,0,0,0,0,0,0,0
230959,20000,200,0,2,14,6,8,0,0,0,1,0,1,1,1,0,1,0,1,0,0,0,6,2,4,0,0,0,3,3,0,2,0,2
230995,20000,200,0,2,21,9,12,0,0,0,0,0,0,0,0,0,1,0,1,0,0,0,16,6,10,0,0,0,3,3,0,1,0,1
231059,20000,200,0,2,8,3,5,0,0,0,0,0,0,0,0,0,0,0,0,0,0,0,6,2,4,0,0,0,0,0,0,2,1,1
231068,20000,200,0,2,1,0,1,0,0,0,0,0,0,0,0,0,0,0,0,0,0,0,1,0,1,0,0,0,0,0,0,0,0,0
231147,20000,200,0,2,10,4,6,0,0,0,0,0,0,1,0,1,0,0,0,0,0,0,7,3,4,1,1,0,1,0,1,0,0,0
231165,20000,200,0,2,4,1,3,0,0,0,0,0,0,0,0,0,0,0,0,0,0,0,4,1,3,0,0,0,0,0,0,0,0,0
231174,20000,200,0,2,83,38,45,0,0,0,6,1,5,2,2,0,3,0,3,0,0,0,46,20,26,1,1,0,5,3,2,20,11,9
231411,20000,200,0,2,3,2,1,0,0,0,0,0,0,1,0,1,0,0,0,0,0,0,2,2,0,0,0,0,0,0,0,0,0,0
231420,20000,200,0,2,5,4,1,0,0,0,0,0,0,0,0,0,0,0,0,0,0,0,5,4,1,0,0,0,0,0,0,0,0,0
231536,20000,200,0,2,3,0,3,0,0,0,0,0,0,0,0,0,0,0,0,0,0,0,3,0,3,0,0,0,0,0,0,0,0,0
231554,20000,200,0,2,1,0,1,0,0,0,0,0,0,0,0,0,0,0,0,0,0,0,1,0,1,0,0,0,0,0,0,0,0,0
231581,20000,200,0,2,9,7,2,0,0,0,2,2,0,0,0,0,0,0,0,0,0,0,5,4,1,0,0,0,0,0,0,2,1,1
231624,20000,200,0,2,42,20,22,0,0,0,5,2,3,2,1,1,3,1,2,0,0,0,17,8,9,1,1,0,7,3,4,7,4,3
231651,20000,200,0,2,8,2,6,0,0,0,0,0,0,2,0,2,0,0,0,1,0,1,5,2,3,0,0,0,0,0,0,0,0,0
231697,20000,200,0,2,1,0,1,0,0,0,0,0,0,0,0,0,0,0,0,0,0,0,1,0,1,0,0,0,0,0,0,0,0,0
231712,20000,200,0,2,11,4,7,0,0,0,3,1,2,0,0,0,0,0,0,0,0,0,8,3,5,0,0,0,0,0,0,0,0,0
231785,20000,200,0,2,8,2,6,0,0,0,0,0,0,4,0,4,0,0,0,0,0,0,2,1,1,1,1,0,1,0,1,0,0,0
231873,20000,200,0,2,5,1,4,0,0,0,0,0,0,0,0,0,0,0,0,0,0,0,5,1,4,0,0,0,0,0,0,0,0,0
231882,20000,200,0,2,15,10,5,0,0,0,0,0,0,1,0,1,0,0,0,0,0,0,14,10,4,0,0,0,0,0,0,0,0,0
231970,20000,200,0,2,44,13,31,0,0,0,8,2,6,9,2,7,1,0,1,0,0,0,25,9,16,1,0,1,0,0,0,0,0,0
232016,20000,200,0,2,4,2,2,0,0,0,0,0,0,3,1,2,0,0,0,0,0,0,1,1,0,0,0,0,0,0,0,0,0,0
232025,20000,200,0,2,16,6,10,0,0,0,0,0,0,1,0,1,0,0,0,0,0,0,6,1,5,0,0,0,9,5,4,0,0,0
232043,20000,200,0,2,5,3,2,0,0,0,1,1,0,0,0,0,0,0,0,0,0,0,4,2,2,0,0,0,0,0,0,0,0,0
232052,20000,200,0,2,1,0,1,0,0,0,1,0,1,0,0,0,0,0,0,0,0,0,0,0,0,0,0,0,0,0,0,0,0,0
232089,20000,200,0,2,5,2,3,0,0,0,1,1,0,0,0,0,0,0,0,0,0,0,4,1,3,0,0,0,0,0,0,0,0,0
232186,20000,200,0,2,160,93,67,1,1,0,24,15,9,16,9,7,6,4,2,0,0,0,64,35,29,3,1,2,1,1,0,45,27,18
232195,20000,200,0,2,13,7,6,1,0,1,1,1,0,4,3,1,1,0,1,0,0,0,6,3,3,0,0,0,0,0,0,0,0,0
232256,20000,200,0,2,7,6,1,0,0,0,1,1,0,1,0,1,1,1,0,0,0,0,4,4,0,0,0,0,0,0,0,0,0,0
232265,20000,200,0,2,31,11,20,0,0,0,6,3,3,17,5,12,0,0,0,0,0,0,8,3,5,0,0,0,0,0,0,0,0,0
232308,20000,200,0,2,21,6,15,0,0,0,0,0,0,2,1,1,0,0,0,0,0,0,16,5,11,1,0,1,0,0,0,2,0,2
232414,20000,200,0,2,8,2,6,0,0,0,0,0,0,1,0,1,0,0,0,0,0,0,7,2,5,0,0,0,0,0,0,0,0,0
232423,20000,200,0,2,40,10,30,1,0,1,3,1,2,7,2,5,5,1,4,0,0,0,21,5,16,2,1,1,0,0,0,1,0,1
232450,20000,200,0,2,3,0,3,0,0,0,0,0,0,0,0,0,0,0,0,0,0,0,3,0,3,0,0,0,0,0,0,0,0,0
232557,20000,200,0,2,48,19,29,0,0,0,1,1,0,11,3,8,2,1,1,0,0,0,34,14,20,0,0,0,0,0,0,0,0,0
232566,20000,200,0,2,9,4,5,0,0,0,0,0,0,1,0,1,0,0,0,0,0,0,7,3,4,0,0,0,0,0,0,1,1,0
232575,20000,200,0,2,6,1,5,1,0,1,0,0,0,0,0,0,0,0,0,0,0,0,5,1,4,0,0,0,0,0,0,0,0,0
232609,20000,200,0,2,8,5,3,0,0,0,1,1,0,0,0,0,0,0,0,0,0,0,4,2,2,0,0,0,3,2,1,0,0,0
232618,20000,200,0,2,6,1,5,0,0,0,0,0,0,0,0,0,0,0,0,0,0,0,6,1,5,0,0,0,0,0,0,0,0,0
232672,20000,200,0,2,10,2,8,0,0,0,0,0,0,0,0,0,1,0,1,0,0,0,9,2,7,0,0,0,0,0,0,0,0,0
232681,20000,200,0,2,13,8,5,0,0,0,3,3,0,1,0,1,1,1,0,0,0,0,8,4,4,0,0,0,0,0,0,0,0,0
232706,20000,200,0,2,14,5,9,0,0,0,2,0,2,4,1,3,3,2,1,0,0,0,4,2,2,0,0,0,1,0,1,0,0,0
232788,20000,200,0,2,1,1,0,0,0,0,0,0,0,0,0,0,0,0,0,0,0,0,1,1,0,0,0,0,0,0,0,0,0,0
232797,20000,200,0,2,2,1,1,0,0,0,1,1,0,0,0,0,0,0,0,0,0,0,1,0,1,0,0,0,0,0,0,0,0,0
232867,20000,200,0,2,4,1,3,0,0,0,0,0,0,0,0,0,0,0,0,0,0,0,4,1,3,0,0,0,0,0,0,0,0,0
232885,20000,200,0,2,1,0,1,0,0,0,0,0,0,1,0,1,0,0,0,0,0,0,0,0,0,0,0,0,0,0,0,0,0,0
232937,20000,200,0,2,7,4,3,0,0,0,2,0,2,4,3,1,0,0,0,0,0,0,1,1,0,0,0,0,0,0,0,0,0,0
232946,20000,200,0,2,8,3,5,0,0,0,0,0,0,2,2,0,0,0,0,0,0,0,6,1,5,0,0,0,0,0,0,0,0,0
232982,20000,200,0,2,47,24,23,0,0,0,6,2,4,5,2,3,0,0,0,0,0,0,27,14,13,0,0,0,0,0,0,9,6,3
233019,20000,200,0,2,2,0,2,0,0,0,0,0,0,0,0,0,0,0,0,0,0,0,2,0,2,0,0,0,0,0,0,0,0,0
233082,20000,200,0,2,2,0,2,0,0,0,0,0,0,0,0,0,0,0,0,0,0,0,2,0,2,0,0,0,0,0,0,0,0,0
233116,20000,200,0,2,6,2,4,0,0,0,1,1,0,2,1,1,0,0,0,0,0,0,3,0,3,0,0,0,0,0,0,0,0,0
233277,20000,200,0,2,26,12,14,0,0,0,4,2,2,2,2,0,0,0,0,0,0,0,20,8,12,0,0,0,0,0,0,0,0,0
233295,20000,200,0,2,15,7,8,0,0,0,0,0,0,2,0,2,1,1,0,0,0,0,12,6,6,0,0,0,0,0,0,0,0,0
233301,20000,200,0,2,3,0,3,0,0,0,0,0,0,1,0,1,0,0,0,0,0,0,2,0,2,0,0,0,0,0,0,0,0,0
233310,20000,200,0,2,3,0,3,0,0,0,0,0,0,1,0,1,0,0,0,0,0,0,2,0,2,0,0,0,0,0,0,0,0,0
233329,20000,200,0,2,12,1,11,0,0,0,2,0,2,1,0,1,3,0,3,0,0,0,5,0,5,0,0,0,1,1,0,0,0,0
233356,20000,200,0,2,3,2,1,0,0,0,0,0,0,1,1,0,0,0,0,0,0,0,2,1,1,0,0,0,0,0,0,0,0,0
233374,20000,200,0,2,33,15,18,0,0,0,1,0,1,5,2,3,0,0,0,0,0,0,21,10,11,1,0,1,1,1,0,4,2,2
233408,20000,200,0,2,2,0,2,0,0,0,0,0,0,0,0,0,0,0,0,0,0,0,2,0,2,0,0,0,0,0,0,0,0,0
233426,20000,200,0,2,15,10,5,0,0,0,0,0,0,0,0,0,1,1,0,0,0,0,13,8,5,1,1,0,0,0,0,0,0,0
233541,20000,200,0,2,23,7,16,0,0,0,0,0,0,3,2,1,0,0,0,0,0,0,14,4,10,0,0,0,5,1,4,1,0,1
233611,20000,200,0,2,1,1,0,0,0,0,0,0,0,0,0,0,0,0,0,0,0,0,1,1,0,0,0,0,0,0,0,0,0,0
233639,20000,200,0,2,1,0,1,0,0,0,0,0,0,0,0,0,0,0,0,0,0,0,1,0,1,0,0,0,0,0,0,0,0,0
233718,20000,200,0,2,11,2,9,0,0,0,1,0,1,2,0,2,1,0,1,0,0,0,7,2,5,0,0,0,0,0,0,0,0,0
233754,20000,200,0,2,1,1,0,0,0,0,0,0,0,0,0,0,0,0,0,0,0,0,1,1,0,0,0,0,0,0,0,0,0,0
233772,20000,200,0,2,12,6,6,0,0,0,0,0,0,1,1,0,0,0,0,0,0,0,11,5,6,0,0,0,0,0,0,0,0,0
233842,20000,200,0,2,2,1,1,0,0,0,0,0,0,2,1,1,0,0,0,0,0,0,0,0,0,0,0,0,0,0,0,0,0,0
233897,20000,200,0,2,5,3,2,0,0,0,0,0,0,0,0,0,0,0,0,0,0,0,5,3,2,0,0,0,0,0,0,0,0,0
233903,20000,200,0,2,1,1,0,0,0,0,0,0,0,0,0,0,0,0,0,0,0,0,1,1,0,0,0,0,0,0,0,0,0,0
233921,20000,200,0,2,298,182,116,2,1,1,25,19,6,12,7,5,12,8,4,0,0,0,127,70,57,4,4,0,0,0,0,116,73,43
233949,20000,200,0,2,2,1,1,0,0,0,1,1,0,0,0,0,0,0,0,0,0,0,1,0,1,0,0,0,0,0,0,0,0,0
234030,20000,200,0,2,169,71,98,0,0,0,12,4,8,20,6,14,7,3,4,0,0,0,80,29,51,2,0,2,1,1,0,47,28,19
234076,20000,200,0,2,180,94,86,0,0,0,26,17,9,17,7,10,4,1,3,0,0,0,86,48,38,6,4,2,17,11,6,24,6,18
234085,20000,200,0,2,16,9,7,0,0,0,3,1,2,0,0,0,0,0,0,0,0,0,13,8,5,0,0,0,0,0,0,0,0,0
234155,20000,200,0,2,28,18,10,0,0,0,4,3,1,19,11,8,1,0,1,0,0,0,4,4,0,0,0,0,0,0,0,0,0,0
234164,20000,200,0,2,3,3,0,0,0,0,0,0,0,1,1,0,0,0,0,0,0,0,0,0,0,0,0,0,2,2,0,0,0,0
234173,20000,200,0,2,1,1,0,0,0,0,0,0,0,0,0,0,0,0,0,0,0,0,1,1,0,0,0,0,0,0,0,0,0,0
234207,20000,200,0,2,22,9,13,0,0,0,1,0,1,3,1,2,5,3,2,0,0,0,3,2,1,0,0,0,4,1,3,6,2,4
234377,20000,200,0,2,1,0,1,0,0,0,0,0,0,0,0,0,0,0,0,0,0,0,1,0,1,0,0,0,0,0,0,0,0,0
234669,20000,200,0,2,5,2,3,0,0,0,0,0,0,4,2,2,0,0,0,0,0,0,1,0,1,0,0,0,0,0,0,0,0,0
234696,20000,200,0,2,6,3,3,0,0,0,0,0,0,0,0,0,0,0,0,0,0,0,5,3,2,1,0,1,0,0,0,0,0,0
234711,20000,200,0,2,2,2,0,0,0,0,1,1,0,0,0,0,0,0,0,0,0,0,1,1,0,0,0,0,0,0,0,0,0,0
234827,20000,200,0,2,24,15,9,0,0,0,4,4,0,2,0,2,3,2,1,0,0,0,13,7,6,2,2,0,0,0,0,0,0,0
234845,20000,200,0,2,1,0,1,0,0,0,0,0,0,0,0,0,0,0,0,0,0,0,1,0,1,0,0,0,0,0,0,0,0,0
234915,20000,200,0,2,7,4,3,0,0,0,2,2,0,0,0,0,0,0,0,0,0,0,4,1,3,0,0,0,1,1,0,0,0,0
234933,20000,200,0,2,10,1,9,0,0,0,1,0,1,1,1,0,0,0,0,0,0,0,7,0,7,0,0,0,1,0,1,0,0,0
234951,20000,200,0,2,6,5,1,0,0,0,0,0,0,1,1,0,0,0,0,0,0,0,5,4,1,0,0,0,0,0,0,0,0,0
234979,20000,200,0,2,5,3,2,0,0,0,0,0,0,0,0,0,0,0,0,0,0,0,4,2,2,1,1,0,0,0,0,0,0,0
235024,20000,200,0,2,2,0,2,0,0,0,0,0,0,0,0,0,1,0,1,0,0,0,0,0,0,1,0,1,0,0,0,0,0,0
235097,20000,200,0,2,35,17,18,1,1,0,3,1,2,1,0,1,1,1,0,0,0,0,27,12,15,0,0,0,0,0,0,2,2,0
235103,20000,200,0,2,3,0,3,0,0,0,0,0,0,0,0,0,0,0,0,0,0,0,3,0,3,0,0,0,0,0,0,0,0,0
235149,20000,200,0,2,4,3,1,0,0,0,1,1,0,0,0,0,0,0,0,0,0,0,1,1,0,1,0,1,1,1,0,0,0,0
235167,20000,200,0,2,3,1,2,0,0,0,0,0,0,0,0,0,0,0,0,0,0,0,0,0,0,0,0,0,3,1,2,0,0,0
235237,20000,200,0,2,6,1,5,0,0,0,2,0,2,1,1,0,0,0,0,0,0,0,3,0,3,0,0,0,0,0,0,0,0,0
235316,20000,200,0,2,34,19,15,0,0,0,4,4,0,2,2,0,1,0,1,0,0,0,19,6,13,0,0,0,3,3,0,5,4,1
235334,20000,200,0,2,4,2,2,0,0,0,0,0,0,0,0,0,0,0,0,0,0,0,4,2,2,0,0,0,0,0,0,0,0,0
235343,20000,200,0,2,4,3,1,0,0,0,0,0,0,0,0,0,0,0,0,0,0,0,1,1,0,2,1,1,1,1,0,0,0,0
235422,20000,200,0,2,4,0,4,0,0,0,1,0,1,0,0,0,1,0,1,0,0,0,2,0,2,0,0,0,0,0,0,0,0,0
235431,20000,200,0,2,10,6,4,0,0,0,0,0,0,1,0,1,0,0,0,0,0,0,8,5,3,0,0,0,1,1,0,0,0,0
235671,20000,200,0,2,4,2,2,0,0,0,1,0,1,0,0,0,1,1,0,0,0,0,2,1,1,0,0,0,0,0,0,0,0,0
235699,20000,200,0,2,7,1,6,0,0,0,1,0,1,0,0,0,0,0,0,0,0,0,6,1,5,0,0,0,0,0,0,0,0,0
235750,20000,200,0,2,3,1,2,0,0,0,0,0,0,0,0,0,0,0,0,0,0,0,1,0,1,1,0,1,1,1,0,0,0,0
236072,20000,200,0,2,1,0,1,0,0,0,0,0,0,0,0,0,0,0,0,0,0,0,1,0,1,0,0,0,0,0,0,0,0,0
236133,20000,200,0,2,8,3,5,0,0,0,0,0,0,0,0,0,0,0,0,0,0,0,8,3,5,0,0,0,0,0,0,0,0,0
236188,20000,200,0,2,13,2,11,0,0,0,0,0,0,0,0,0,0,0,0,1,0,1,11,2,9,1,0,1,0,0,0,0,0,0
236212,20000,200,0,2,10,9,1,0,0,0,0,0,0,0,0,0,0,0,0,0,0,0,9,8,1,0,0,0,1,1,0,0,0,0
236230,20000,200,0,2,12,4,8,0,0,0,0,0,0,0,0,0,0,0,0,0,0,0,11,4,7,0,0,0,1,0,1,0,0,0
236258,20000,200,0,2,3,1,2,0,0,0,0,0,0,0,0,0,0,0,0,0,0,0,2,0,2,0,0,0,1,1,0,0,0,0
236328,20000,200,0,2,10,2,8,0,0,0,3,0,3,0,0,0,0,0,0,0,0,0,7,2,5,0,0,0,0,0,0,0,0,0
236382,20000,200,0,2,5,2,3,1,1,0,1,0,1,1,1,0,0,0,0,0,0,0,2,0,2,0,0,0,0,0,0,0,0,0
236452,20000,200,0,2,6,2,4,0,0,0,0,0,0,0,0,0,0,0,0,0,0,0,2,1,1,0,0,0,4,1,3,0,0,0
236513,20000,200,0,2,3,3,0,0,0,0,1,1,0,0,0,0,0,0,0,0,0,0,1,1,0,0,0,0,1,1,0,0,0,0
236577,20000,200,0,2,16,5,11,0,0,0,1,0,1,1,0,1,2,2,0,0,0,0,5,2,3,0,0,0,1,0,1,6,1,5
236595,20000,200,0,2,53,24,29,0,0,0,12,9,3,2,0,2,1,0,1,0,0,0,31,12,19,1,1,0,6,2,4,0,0,0
236610,20000,200,0,2,8,1,7,0,0,0,1,0,1,1,0,1,0,0,0,0,0,0,5,1,4,0,0,0,1,0,1,0,0,0
236638,20000,200,0,2,4,2,2,0,0,0,1,1,0,0,0,0,0,0,0,0,0,0,3,1,2,0,0,0,0,0,0,0,0,0
236656,20000,200,0,2,3,2,1,0,0,0,0,0,0,1,1,0,0,0,0,0,0,0,2,1,1,0,0,0,0,0,0,0,0,0
236692,20000,200,0,2,9,6,3,1,1,0,0,0,0,1,1,0,0,0,0,0,0,0,7,4,3,0,0,0,0,0,0,0,0,0
236708,20000,200,0,2,4,0,4,0,0,0,0,0,0,0,0,0,0,0,0,0,0,0,4,0,4,0,0,0,0,0,0,0,0,0
236753,20000,200,0,2,6,4,2,0,0,0,0,0,0,0,0,0,1,1,0,1,0,1,2,2,0,0,0,0,2,1,1,0,0,0
236887,20000,200,0,2,4,2,2,0,0,0,0,0,0,1,0,1,0,0,0,1,0,1,2,2,0,0,0,0,0,0,0,0,0,0
236896,20000,200,0,2,8,6,2,0,0,0,2,2,0,0,0,0,1,0,1,0,0,0,5,4,1,0,0,0,0,0,0,0,0,0
236939,20000,200,0,2,36,21,15,1,0,1,4,4,0,1,1,0,4,2,2,0,0,0,10,4,6,0,0,0,14,9,5,2,1,1
236948,20000,200,0,2,939,403,536,4,2,2,121,40,81,37,10,27,58,22,36,1,0,1,411,164,247,33,12,21,77,34,43,197,119,78
236975,20000,200,0,2,2,1,1,0,0,0,0,0,0,0,0,0,1,1,0,0,0,0,1,0,1,0,0,0,0,0,0,0,0,0
237011,20000,200,0,2,20,10,10,0,0,0,4,2,2,0,0,0,1,0,1,0,0,0,11,5,6,1,0,1,2,2,0,1,1,0
237039,20000,200,0,2,4,1,3,0,0,0,0,0,0,0,0,0,0,0,0,0,0,0,3,1,2,0,0,0,1,0,1,0,0,0
237057,20000,200,0,2,11,6,5,0,0,0,0,0,0,0,0,0,1,0,1,0,0,0,8,5,3,0,0,0,0,0,0,2,1,1
237066,20000,200,0,2,20,9,11,0,0,0,1,0,1,2,2,0,0,0,0,0,0,0,17,7,10,0,0,0,0,0,0,0,0,0
237109,20000,200,0,2,3,0,3,0,0,0,0,0,0,0,0,0,2,0,2,0,0,0,1,0,1,0,0,0,0,0,0,0,0,0
237118,20000,200,0,2,8,5,3,0,0,0,0,0,0,1,1,0,0,0,0,0,0,0,7,4,3,0,0,0,0,0,0,0,0,0
237181,20000,200,0,2,3,2,1,0,0,0,0,0,0,1,1,0,0,0,0,0,0,0,2,1,1,0,0,0,0,0,0,0,0,0
237215,20000,200,0,2,8,3,5,0,0,0,0,0,0,0,0,0,0,0,0,0,0,0,8,3,5,0,0,0,0,0,0,0,0,0
237312,20000,200,0,2,21,7,14,0,0,0,0,0,0,3,0,3,1,1,0,0,0,0,17,6,11,0,0,0,0,0,0,0,0,0
237330,20000,200,0,2,5,3,2,0,0,0,0,0,0,1,0,1,0,0,0,0,0,0,4,3,1,0,0,0,0,0,0,0,0,0
237358,20000,200,0,2,8,3,5,0,0,0,0,0,0,0,0,0,0,0,0,0,0,0,8,3,5,0,0,0,0,0,0,0,0,0
237367,20000,200,0,2,10,3,7,0,0,0,0,0,0,0,0,0,0,0,0,0,0,0,10,3,7,0,0,0,0,0,0,0,0,0
237525,20000,200,0,2,57,28,29,1,0,1,10,6,4,4,2,2,1,1,0,0,0,0,40,19,21,0,0,0,1,0,1,0,0,0
237686,20000,200,0,2,6,1,5,0,0,0,0,0,0,0,0,0,0,0,0,0,0,0,6,1,5,0,0,0,0,0,0,0,0,0
237701,20000,200,0,2,5,1,4,0,0,0,0,0,0,1,0,1,0,0,0,0,0,0,3,0,3,0,0,0,0,0,0,1,1,0
237792,20000,200,0,2,6,2,4,0,0,0,0,0,0,0,0,0,0,0,0,0,0,0,6,2,4,0,0,0,0,0,0,0,0,0
237817,20000,200,0,2,6,1,5,0,0,0,0,0,0,0,0,0,0,0,0,0,0,0,6,1,5,0,0,0,0,0,0,0,0,0
237880,20000,200,0,2,4,2,2,0,0,0,0,0,0,0,0,0,1,1,0,0,0,0,3,1,2,0,0,0,0,0,0,0,0,0
237899,20000,200,0,2,7,2,5,0,0,0,1,1,0,0,0,0,0,0,0,0,0,0,6,1,5,0,0,0,0,0,0,0,0,0
237932,20000,200,0,2,4,2,2,0,0,0,1,1,0,0,0,0,0,0,0,0,0,0,2,1,1,0,0,0,1,0,1,0,0,0
237950,20000,200,0,2,9,6,3,0,0,0,2,2,0,0,0,0,0,0,0,0,0,0,5,2,3,0,0,0,0,0,0,2,2,0
237969,20000,200,0,2,2,1,1,0,0,0,0,0,0,0,0,0,0,0,0,0,0,0,2,1,1,0,0,0,0,0,0,0,0,0
237996,20000,200,0,2,12,3,9,0,0,0,0,0,0,0,0,0,0,0,0,0,0,0,12,3,9,0,0,0,0,0,0,0,0,0
238014,20000,200,0,2,8,1,7,0,0,0,1,1,0,1,0,1,0,0,0,0,0,0,6,0,6,0,0,0,0,0,0,0,0,0
238032,20000,200,0,2,248,138,110,0,0,0,36,25,11,6,2,4,8,3,5,0,0,0,149,75,74,3,2,1,11,9,2,35,22,13
238078,20000,200,0,2,4,2,2,0,0,0,0,0,0,0,0,0,0,0,0,0,0,0,4,2,2,0,0,0,0,0,0,0,0,0
238193,20000,200,0,2,8,1,7,0,0,0,0,0,0,2,1,1,0,0,0,0,0,0,6,0,6,0,0,0,0,0,0,0,0,0
238263,20000,200,0,2,14,4,10,0,0,0,0,0,0,1,1,0,2,1,1,0,0,0,10,1,9,0,0,0,1,1,0,0,0,0
238324,20000,200,0,2,1,0,1,0,0,0,0,0,0,0,0,0,0,0,0,0,0,0,1,0,1,0,0,0,0,0,0,0,0,0
238333,20000,200,0,2,12,5,7,0,0,0,0,0,0,0,0,0,1,0,1,0,0,0,10,5,5,0,0,0,0,0,0,1,0,1
238397,20000,200,0,2,9,8,1,0,0,0,0,0,0,2,2,0,0,0,0,0,0,0,6,6,0,0,0,0,1,0,1,0,0,0
238430,20000,200,0,2,3,2,1,0,0,0,0,0,0,0,0,0,0,0,0,0,0,0,3,2,1,0,0,0,0,0,0,0,0,0
238458,20000,200,0,2,15,6,9,0,0,0,0,0,0,0,0,0,0,0,0,0,0,0,12,4,8,0,0,0,1,0,1,2,2,0
238476,20000,200,0,2,10,5,5,0,0,0,1,1,0,0,0,0,0,0,0,0,0,0,8,4,4,0,0,0,1,0,1,0,0,0
238616,20000,200,0,2,17,5,12,0,0,0,0,0,0,0,0,0,1,0,1,0,0,0,16,5,11,0,0,0,0,0,0,0,0,0
238661,20000,200,0,2,2,1,1,0,0,0,0,0,0,1,1,0,0,0,0,0,0,0,0,0,0,0,0,0,0,0,0,1,0,1
238722,20000,200,0,2,5,3,2,0,0,0,0,0,0,0,0,0,0,0,0,0,0,0,5,3,2,0,0,0,0,0,0,0,0,0
238759,20000,200,0,2,15,5,10,0,0,0,1,0,1,1,0,1,0,0,0,1,1,0,12,4,8,0,0,0,0,0,0,0,0,0
239008,20000,200,0,2,4,2,2,0,0,0,0,0,0,1,0,1,0,0,0,0,0,0,3,2,1,0,0,0,0,0,0,0,0,0
239017,20000,200,0,2,9,2,7,0,0,0,0,0,0,0,0,0,0,0,0,0,0,0,8,2,6,1,0,1,0,0,0,0,0,0
239071,20000,200,0,2,3,2,1,0,0,0,0,0,0,0,0,0,0,0,0,0,0,0,3,2,1,0,0,0,0,0,0,0,0,0
239080,20000,200,0,2,3,0,3,0,0,0,0,0,0,0,0,0,0,0,0,0,0,0,3,0,3,0,0,0,0,0,0,0,0,0
239105,20000,200,0,2,27,12,15,0,0,0,2,1,1,2,1,1,3,1,2,0,0,0,15,6,9,1,0,1,0,0,0,4,3,1
239169,20000,200,0,2,127,69,58,0,0,0,29,16,13,4,3,1,5,3,2,0,0,0,88,47,41,1,0,1,0,0,0,0,0,0
239220,20000,200,0,2,9,4,5,0,0,0,1,1,0,0,0,0,0,0,0,0,0,0,8,3,5,0,0,0,0,0,0,0,0,0
239248,20000,200,0,2,9,6,3,0,0,0,0,0,0,0,0,0,1,0,1,0,0,0,8,6,2,0,0,0,0,0,0,0,0,0
239309,20000,200,0,2,7,2,5,0,0,0,0,0,0,2,1,1,0,0,0,0,0,0,1,1,0,4,0,4,0,0,0,0,0,0
239318,20000,200,0,2,9,6,3,0,0,0,0,0,0,0,0,0,0,0,0,0,0,0,9,6,3,0,0,0,0,0,0,0,0,0
239372,20000,200,0,2,1,1,0,0,0,0,0,0,0,0,0,0,0,0,0,0,0,0,1,1,0,0,0,0,0,0,0,0,0,0
239390,20000,200,0,2,2,1,1,0,0,0,0,0,0,0,0,0,0,0,0,0,0,0,1,1,0,0,0,0,1,0,1,0,0,0
239442,20000,200,0,2,2,0,2,0,0,0,0,0,0,0,0,0,0,0,0,0,0,0,2,0,2,0,0,0,0,0,0,0,0,0
239460,20000,200,0,2,17,6,11,0,0,0,1,0,1,0,0,0,0,0,0,0,0,0,15,6,9,0,0,0,1,0,1,0,0,0
239488,20000,200,0,2,18,14,4,0,0,0,0,0,0,0,0,0,0,0,0,0,0,0,18,14,4,0,0,0,0,0,0,0,0,0
239512,20000,200,0,2,2,0,2,0,0,0,0,0,0,0,0,0,0,0,0,0,0,0,2,0,2,0,0,0,0,0,0,0,0,0
239628,20000,200,0,2,2,2,0,0,0,0,0,0,0,0,0,0,0,0,0,0,0,0,2,2,0,0,0,0,0,0,0,0,0,0
239716,20000,200,0,2,10,4,6,0,0,0,0,0,0,0,0,0,0,0,0,0,0,0,6,3,3,0,0,0,1,0,1,3,1,2
239910,20000,200,0,2,2,0,2,0,0,0,0,0,0,1,0,1,0,0,0,0,0,0,1,0,1,0,0,0,0,0,0,0,0,0
240107,20000,200,0,2,19,9,10,0,0,0,2,1,1,0,0,0,0,0,0,0,0,0,17,8,9,0,0,0,0,0,0,0,0,0
240116,20000,200,0,2,17,9,8,0,0,0,1,0,1,0,0,0,1,1,0,0,0,0,15,8,7,0,0,0,0,0,0,0,0,0
240125,20000,200,0,2,13,7,6,0,0,0,0,0,0,0,0,0,1,1,0,0,0,0,11,5,6,0,0,0,1,1,0,0,0,0
240189,20000,200,0,2,4,2,2,0,0,0,0,0,0,0,0,0,0,0,0,0,0,0,4,2,2,0,0,0,0,0,0,0,0,0
240198,20000,200,0,2,11,5,6,0,0,0,0,0,0,0,0,0,0,0,0,0,0,0,11,5,6,0,0,0,0,0,0,0,0,0
240268,20000,200,0,2,16,5,11,0,0,0,3,0,3,0,0,0,0,0,0,0,0,0,9,3,6,0,0,0,2,1,1,2,1,1
240277,20000,200,0,2,18,9,9,1,0,1,3,2,1,0,0,0,0,0,0,0,0,0,11,4,7,0,0,0,0,0,0,3,3,0
240329,20000,200,0,2,5,3,2,0,0,0,2,1,1,0,0,0,0,0,0,0,0,0,2,1,1,0,0,0,1,1,0,0,0,0
240338,20000,200,0,2,2,2,0,0,0,0,0,0,0,0,0,0,0,0,0,0,0,0,2,2,0,0,0,0,0,0,0,0,0,0
240365,20000,200,0,2,6,3,3,0,0,0,0,0,0,0,0,0,0,0,0,0,0,0,4,1,3,0,0,0,1,1,0,1,1,0
240374,20000,200,0,2,11,7,4,0,0,0,1,1,0,0,0,0,0,0,0,0,0,0,7,5,2,0,0,0,1,1,0,2,0,2
240392,20000,200,0,2,19,1,18,0,0,0,0,0,0,1,0,1,0,0,0,0,0,0,16,1,15,1,0,1,1,0,1,0,0,0
240417,20000,200,0,2,9,6,3,0,0,0,2,1,1,0,0,0,0,0,0,0,0,0,4,3,1,0,0,0,0,0,0,3,2,1
240426,20000,200,0,2,12,3,9,0,0,0,1,0,1,0,0,0,0,0,0,0,0,0,10,3,7,0,0,0,0,0,0,1,0,1
240444,20000,200,0,2,235,119,116,1,1,0,26,15,11,10,3,7,11,2,9,0,0,0,132,68,64,3,1,2,13,5,8,39,24,15
240453,20000,200,0,2,14,7,7,0,0,0,3,1,2,2,0,2,1,1,0,0,0,0,7,4,3,0,0,0,0,0,0,1,1,0
240462,20000,200,0,2,2,1,1,0,0,0,0,0,0,0,0,0,0,0,0,0,0,0,0,0,0,0,0,0,0,0,0,2,1,1
240471,20000,200,0,2,8,4,4,0,0,0,1,1,0,0,0,0,1,1,0,0,0,0,4,1,3,0,0,0,0,0,0,2,1,1
240480,20000,200,0,2,8,2,6,0,0,0,0,0,0,0,0,0,0,0,0,0,0,0,8,2,6,0,0,0,0,0,0,0,0,0
240505,20000,200,0,2,4,2,2,0,0,0,0,0,0,0,0,0,0,0,0,0,0,0,1,0,1,0,0,0,3,2,1,0,0,0
240514,20000,200,0,2,7,4,3,0,0,0,0,0,0,0,0,0,0,0,0,0,0,0,5,2,3,0,0,0,2,2,0,0,0,0
240596,20000,200,0,2,5,2,3,0,0,0,0,0,0,0,0,0,0,0,0,0,0,0,5,2,3,0,0,0,0,0,0,0,0,0
240620,20000,200,0,2,12,3,9,0,0,0,0,0,0,0,0,0,1,0,1,0,0,0,10,3,7,0,0,0,1,0,1,0,0,0
240657,20000,200,0,2,4,3,1,0,0,0,0,0,0,0,0,0,0,0,0,0,0,0,4,3,1,0,0,0,0,0,0,0,0,0
240666,20000,200,0,2,6,1,5,0,0,0,0,0,0,0,0,0,0,0,0,0,0,0,6,1,5,0,0,0,0,0,0,0,0,0
240693,20000,200,0,2,6,4,2,0,0,0,0,0,0,0,0,0,0,0,0,0,0,0,6,4,2,0,0,0,0,0,0,0,0,0
240718,20000,200,0,2,14,13,1,0,0,0,0,0,0,0,0,0,0,0,0,0,0,0,14,13,1,0,0,0,0,0,0,0,0,0
240727,20000,200,0,2,80,36,44,0,0,0,6,1,5,0,0,0,2,1,1,0,0,0,35,11,24,0,0,0,23,11,12,14,12,2
240736,20000,200,0,2,1,1,0,0,0,0,0,0,0,0,0,0,0,0,0,1,1,0,0,0,0,0,0,0,0,0,0,0,0,0
240745,20000,200,0,2,4,1,3,0,0,0,2,0,2,0,0,0,0,0,0,1,1,0,1,0,1,0,0,0,0,0,0,0,0,0
240754,20000,200,0,2,9,5,4,0,0,0,5,2,3,0,0,0,0,0,0,2,1,1,2,2,0,0,0,0,0,0,0,0,0,0
240790,20000,200,0,2,2,2,0,0,0,0,0,0,0,0,0,0,0,0,0,1,1,0,0,0,0,0,0,0,0,0,0,1,1,0
241191,20000,200,0,2,2,0,2,0,0,0,0,0,0,0,0,0,2,0,2,0,0,0,0,0,0,0,0,0,0,0,0,0,0,0
241225,20000,200,0,2,3,1,2,0,0,0,0,0,0,0,0,0,3,1,2,0,0,0,0,0,0,0,0,0,0,0,0,0,0,0
241304,20000,200,0,2,3,0,3,0,0,0,0,0,0,0,0,0,3,0,3,0,0,0,0,0,0,0,0,0,0,0,0,0,0,0
241331,20000,200,0,2,2,1,1,0,0,0,0,0,0,0,0,0,2,1,1,0,0,0,0,0,0,0,0,0,0,0,0,0,0,0
241395,20000,200,0,2,1,0,1,0,0,0,0,0,0,0,0,0,1,0,1,0,0,0,0,0,0,0,0,0,0,0,0,0,0,0
241410,20000,200,0,2,5,2,3,0,0,0,0,0,0,0,0,0,5,2,3,0,0,0,0,0,0,0,0,0,0,0,0,0,0,0
241739,20000,200,0,2,10,2,8,0,0,0,0,0,0,0,0,0,10,2,8,0,0,0,0,0,0,0,0,0,0,0,0,0,0,0
241766,20000,200,0,2,2,1,1,0,0,0,0,0,0,0,0,0,2,1,1,0,0,0,0,0,0,0,0,0,0,0,0,0,0,0
241836,20000,200,0,2,5,1,4,0,0,0,0,0,0,0,0,0,5,1,4,0,0,0,0,0,0,0,0,0,0,0,0,0,0,0
241951,20000,200,0,2,1,1,0,0,0,0,0,0,0,0,0,0,1,1,0,0,0,0,0,0,0,0,0,0,0,0,0,0,0,0
242112,20000,200,0,2,1,0,1,0,0,0,0,0,0,0,0,0,1,0,1,0,0,0,0,0,0,0,0,0,0,0,0,0,0,0
242130,20000,200,0,2,1,1,0,0,0,0,0,0,0,0,0,0,1,1,0,0,0,0,0,0,0,0,0,0,0,0,0,0,0,0
242617,20000,200,0,2,3,1,2,0,0,0,0,0,0,0,0,0,3,1,2,0,0,0,0,0,0,0,0,0,0,0,0,0,0,0
242635,20000,200,0,2,12,6,6,0,0,0,0,0,0,0,0,0,12,6,6,0,0,0,0,0,0,0,0,0,0,0,0,0,0,0
242644,20000,200,0,2,7,2,5,0,0,0,0,0,0,0,0,0,7,2,5,0,0,0,0,0,0,0,0,0,0,0,0,0,0,0
242653,20000,200,0,2,10,4,6,0,0,0,0,0,0,0,0,0,10,4,6,0,0,0,0,0,0,0,0,0,0,0,0,0,0,0
242662,20000,200,0,2,6,3,3,0,0,0,0,0,0,0,0,0,6,3,3,0,0,0,0,0,0,0,0,0,0,0,0,0,0,0
242671,20000,200,0,2,4,2,2,0,0,0,0,0,0,0,0,0,4,2,2,0,0,0,0,0,0,0,0,0,0,0,0,0,0,0
242680,20000,200,0,2,3,0,3,0,0,0,0,0,0,0,0,0,3,0,3,0,0,0,0,0,0,0,0,0,0,0,0,0,0,0
242699,20000,200,0,2,5,5,0,0,0,0,0,0,0,0,0,0,5,5,0,0,0,0,0,0,0,0,0,0,0,0,0,0,0,0
242705,20000,200,0,2,7,3,4,0,0,0,0,0,0,0,0,0,7,3,4,0,0,0,0,0,0,0,0,0,0,0,0,0,0,0
243081,20000,200,0,2,29,7,22,0,0,0,0,0,0,0,0,0,29,7,22,0,0,0,0,0,0,0,0,0,0,0,0,0,0,0
243151,20000,200,0,2,2,1,1,0,0,0,0,0,0,0,0,0,2,1,1,0,0,0,0,0,0,0,0,0,0,0,0,0,0,0
243160,20000,200,0,2,6,2,4,0,0,0,0,0,0,0,0,0,1,0,1,1,0,1,0,0,0,0,0,0,3,1,2,1,1,0
243179,20000,200,0,2,4,3,1,0,0,0,0,0,0,0,0,0,2,1,1,0,0,0,0,0,0,0,0,0,1,1,0,1,1,0
243197,20000,200,0,2,39,19,20,0,0,0,0,0,0,0,0,0,1,0,1,0,0,0,0,0,0,0,0,0,38,19,19,0,0,0
243346,20000,200,0,2,1,1,0,0,0,0,0,0,0,0,0,0,1,1,0,0,0,0,0,0,0,0,0,0,0,0,0,0,0,0
243443,20000,200,0,2,16,4,12,0,0,0,0,0,0,0,0,0,16,4,12,0,0,0,0,0,0,0,0,0,0,0,0,0,0,0
243568,20000,200,0,2,15,7,8,0,0,0,0,0,0,0,0,0,15,7,8,0,0,0,0,0,0,0,0,0,0,0,0,0,0,0
243586,20000,200,0,2,2,0,2,0,0,0,0,0,0,0,0,0,2,0,2,0,0,0,0,0,0,0,0,0,0,0,0,0,0,0
243601,20000,200,0,2,3,1,2,0,0,0,0,0,0,0,0,0,2,1,1,0,0,0,1,0,1,0,0,0,0,0,0,0,0,0
243638,20000,200,0,2,8,6,2,0,0,0,2,2,0,0,0,0,0,0,0,6,4,2,0,0,0,0,0,0,0,0,0,0,0,0
243647,20000,200,0,2,2,0,2,0,0,0,0,0,0,0,0,0,0,0,0,2,0,2,0,0,0,0,0,0,0,0,0,0,0,0
243744,20000,200,0,2,575,322,253,3,1,2,113,56,57,22,9,13,29,13,16,1,1,0,182,110,72,18,9,9,98,57,41,109,66,43
243780,20000,200,0,2,283,196,87,2,2,0,26,18,8,11,8,3,8,5,3,0,0,0,87,52,35,8,4,4,1,0,1,140,107,33
243823,20000,200,0,2,12,8,4,0,0,0,0,0,0,1,1,0,0,0,0,0,0,0,7,5,2,0,0,0,4,2,2,0,0,0
243832,20000,200,0,2,9,1,8,0,0,0,0,0,0,0,0,0,9,1,8,0,0,0,0,0,0,0,0,0,0,0,0,0,0,0
244437,20000,200,0,2,19,12,7,0,0,0,2,0,2,7,5,2,2,2,0,0,0,0,8,5,3,0,0,0,0,0,0,0,0,0
244446,20000,200,0,2,28,7,21,0,0,0,1,1,0,17,4,13,0,0,0,0,0,0,10,2,8,0,0,0,0,0,0,0,0,0
245652,20000,200,0,2,5,2,3,0,0,0,2,1,1,1,1,0,0,0,0,0,0,0,2,0,2,0,0,0,0,0,0,0,0,0
245953,20000,200,0,2,4,3,1,0,0,0,0,0,0,1,1,0,0,0,0,0,0,0,3,2,1,0,0,0,0,0,0,0,0,0
246354,20000,200,0,2,6,2,4,0,0,0,1,0,1,0,0,0,4,1,3,0,0,0,1,1,0,0,0,0,0,0,0,0,0,0
246813,20000,200,0,2,35,21,14,2,2,0,2,0,2,8,3,5,0,0,0,0,0,0,23,16,7,0,0,0,0,0,0,0,0,0
246974,20000,200,0,2,5,1,4,0,0,0,0,0,0,0,0,0,2,0,2,0,0,0,3,1,2,0,0,0,0,0,0,0,0,0
247649,20000,200,0,2,4,0,4,0,0,0,0,0,0,0,0,0,0,0,0,0,0,0,4,0,4,0,0,0,0,0,0,0,0,0
247834,20000,200,0,2,28,11,17,0,0,0,1,1,0,5,3,2,1,0,1,0,0,0,19,7,12,0,0,0,2,0,2,0,0,0
247940,20000,200,0,2,4,1,3,0,0,0,0,0,0,0,0,0,0,0,0,0,0,0,4,1,3,0,0,0,0,0,0,0,0,0
248934,20000,200,0,2,69,11,58,0,0,0,2,1,1,18,2,16,2,1,1,0,0,0,42,5,37,2,1,1,3,1,2,0,0,0
250027,20000,200,0,2,5,1,4,0,0,0,0,0,0,0,0,0,0,0,0,0,0,0,5,1,4,0,0,0,0,0,0,0,0,0
251260,20000,200,0,2,9,2,7,0,0,0,1,0,1,0,0,0,1,0,1,0,0,0,7,2,5,0,0,0,0,0,0,0,0,0
251312,20000,200,0,2,1,0,1,0,0,0,0,0,0,0,0,0,0,0,0,0,0,0,1,0,1,0,0,0,0,0,0,0,0,0
260372,20000,200,0,2,4,2,2,3,1,2,0,0,0,0,0,0,0,0,0,0,0,0,1,1,0,0,0,0,0,0,0,0,0,0
260691,20000,200,0,2,4,2,2,0,0,0,0,0,0,0,0,0,0,0,0,0,0,0,4,2,2,0,0,0,0,0,0,0,0,0
260789,20000,200,0,2,5,0,5,0,0,0,1,0,1,0,0,0,2,0,2,0,0,0,2,0,2,0,0,0,0,0,0,0,0,0
260992,20000,200,0,2,4,0,4,0,0,0,0,0,0,2,0,2,0,0,0,0,0,0,2,0,2,0,0,0,0,0,0,0,0,0
261861,20000,200,0,2,1,0,1,0,0,0,0,0,0,0,0,0,0,0,0,0,0,0,1,0,1,0,0,0,0,0,0,0,0,0
262031,20000,200,0,2,3,3,0,0,0,0,0,0,0,1,1,0,0,0,0,0,0,0,2,2,0,0,0,0,0,0,0,0,0,0
262086,20000,200,0,2,7,0,7,0,0,0,1,0,1,3,0,3,1,0,1,0,0,0,2,0,2,0,0,0,0,0,0,0,0,0
262129,20000,200,0,2,8,3,5,0,0,0,4,1,3,0,0,0,0,0,0,0,0,0,1,1,0,0,0,0,0,0,0,3,1,2
363633,20000,200,0,2,1,0,1,0,0,0,0,0,0,0,0,0,1,0,1,0,0,0,0,0,0,0,0,0,0,0,0,0,0,0
363934,20000,200,0,2,4,3,1,0,0,0,1,0,1,0,0,0,0,0,0,0,0,0,2,2,0,1,1,0,0,0,0,0,0,0
364016,20000,200,0,2,11,5,6,0,0,0,0,0,0,1,1,0,1,0,1,0,0,0,8,4,4,1,0,1,0,0,0,0,0,0
364025,20000,200,0,2,11,3,8,0,0,0,0,0,0,1,0,1,1,0,1,0,0,0,9,3,6,0,0,0,0,0,0,0,0,0
366252,20000,200,0,2,6,6,0,0,0,0,0,0,0,0,0,0,0,0,0,0,0,0,6,6,0,0,0,0,0,0,0,0,0,0
366270,20000,200,0,2,3,0,3,0,0,0,0,0,0,2,0,2,0,0,0,0,0,0,1,0,1,0,0,0,0,0,0,0,0,0
366340,20000,200,0,2,3,1,2,2,1,1,0,0,0,0,0,0,0,0,0,0,0,0,1,0,1,0,0,0,0,0,0,0,0,0
366465,20000,200,0,2,9,8,1,0,0,0,0,0,0,1,1,0,1,1,0,0,0,0,7,6,1,0,0,0,0,0,0,0,0,0
366553,20000,200,0,2,20,5,15,0,0,0,0,0,0,2,0,2,1,1,0,0,0,0,17,4,13,0,0,0,0,0,0,0,0,0
366711,20000,200,0,2,19,7,12,0,0,0,3,0,3,1,0,1,4,2,2,0,0,0,6,1,5,1,1,0,0,0,0,4,3,1
367459,20000,200,0,2,13,2,11,0,0,0,1,0,1,0,0,0,0,0,0,0,0,0,11,2,9,0,0,0,1,0,1,0,0,0
367954,20000,200,0,2,25,3,22,0,0,0,1,0,1,0,0,0,1,0,1,0,0,0,22,3,19,1,0,1,0,0,0,0,0,0
368629,20000,200,0,2,2,0,2,0,0,0,0,0,0,0,0,0,1,0,1,0,0,0,1,0,1,0,0,0,0,0,0,0,0,0
368911,20000,200,0,2,9,3,6,0,0,0,1,1,0,0,0,0,0,0,0,0,0,0,8,2,6,0,0,0,0,0,0,0,0,0
369400,20000,200,0,2,6,6,0,0,0,0,0,0,0,0,0,0,1,1,0,0,0,0,4,4,0,1,1,0,0,0,0,0,0,0
372329,20000,200,0,2,3,0,3,0,0,0,0,0,0,0,0,0,1,0,1,0,0,0,2,0,2,0,0,0,0,0,0,0,0,0
376695,20000,200,0,2,6,5,1,0,0,0,0,0,0,0,0,0,0,0,0,3,3,0,3,2,1,0,0,0,0,0,0,0,0,0
377111,20000,200,0,2,1,0,1,0,0,0,0,0,0,1,0,1,0,0,0,0,0,0,0,0,0,0,0,0,0,0,0,0,0,0
377458,20000,200,0,2,12,4,8,0,0,0,0,0,0,6,0,6,0,0,0,0,0,0,6,4,2,0,0,0,0,0,0,0,0,0
377555,20000,200,0,2,10,2,8,0,0,0,4,1,3,0,0,0,1,0,1,0,0,0,2,1,1,0,0,0,0,0,0,3,0,3
377564,20000,200,0,2,22,12,10,0,0,0,2,1,1,3,2,1,0,0,0,0,0,0,10,6,4,2,1,1,2,1,1,3,1,2
378105,20000,200,0,2,5,3,2,0,0,0,0,0,0,0,0,0,3,2,1,0,0,0,2,1,1,0,0,0,0,0,0,0,0,0
378576,20000,200,0,2,1,0,1,0,0,0,0,0,0,0,0,0,0,0,0,0,0,0,0,0,0,0,0,0,1,0,1,0,0,0
379746,20000,200,0,2,3,1,2,0,0,0,0,0,0,1,0,1,0,0,0,0,0,0,2,1,1,0,0,0,0,0,0,0,0,0
380359,20000,200,0,2,3,1,2,1,1,0,0,0,0,0,0,0,0,0,0,0,0,0,2,0,2,0,0,0,0,0,0,0,0,0
380368,20000,200,0,2,1,0,1,0,0,0,0,0,0,0,0,0,0,0,0,0,0,0,1,0,1,0,0,0,0,0,0,0,0,0
380377,20000,200,0,2,6,2,4,2,1,1,0,0,0,1,1,0,0,0,0,0,0,0,1,0,1,2,0,2,0,0,0,0,0,0
380438,20000,200,0,2,8,2,6,0,0,0,0,0,0,0,0,0,0,0,0,0,0,0,7,1,6,1,1,0,0,0,0,0,0,0
382957,20000,200,0,2,6,2,4,0,0,0,0,0,0,1,0,1,0,0,0,0,0,0,3,1,2,0,0,0,2,1,1,0,0,0
384254,20000,200,0,2,5,1,4,0,0,0,0,0,0,3,1,2,1,0,1,0,0,0,1,0,1,0,0,0,0,0,0,0,0,0
384333,20000,200,0,2,8,3,5,0,0,0,0,0,0,0,0,0,1,0,1,0,0,0,7,3,4,0,0,0,0,0,0,0,0,0
384342,20000,200,0,2,5,4,1,0,0,0,0,0,0,0,0,0,0,0,0,0,0,0,5,4,1,0,0,0,0,0,0,0,0,0
385415,20000,200,0,2,69,33,36,0,0,0,7,4,3,0,0,0,2,1,1,0,0,0,25,13,12,0,0,0,0,0,0,35,15,20
385503,20000,200,0,2,3,0,3,0,0,0,0,0,0,1,0,1,0,0,0,0,0,0,2,0,2,0,0,0,0,0,0,0,0,0
385619,20000,200,0,2,4,4,0,0,0,0,1,1,0,0,0,0,1,1,0,0,0,0,0,0,0,2,2,0,0,0,0,0,0,0
386472,20000,200,0,2,3,0,3,0,0,0,0,0,0,1,0,1,0,0,0,0,0,0,1,0,1,0,0,0,1,0,1,0,0,0
392257,20000,200,0,2,13,1,12,0,0,0,1,0,1,7,0,7,2,1,1,0,0,0,3,0,3,0,0,0,0,0,0,0,0,0
392415,20000,200,0,2,1,0,1,0,0,0,0,0,0,1,0,1,0,0,0,0,0,0,0,0,0,0,0,0,0,0,0,0,0,0
395362,20000,200,0,2,1,0,1,0,0,0,0,0,0,0,0,0,0,0,0,0,0,0,1,0,1,0,0,0,0,0,0,0,0,0
399869,20000,200,0,2,1,1,0,0,0,0,0,0,0,0,0,0,0,0,0,0,0,0,1,1,0,0,0,0,0,0,0,0,0,0
399911,20000,200,0,2,3,1,2,0,0,0,2,0,2,0,0,0,0,0,0,0,0,0,1,1,0,0,0,0,0,0,0,0,0,0
403469,20000,200,0,2,2,1,1,0,0,0,0,0,0,0,0,0,0,0,0,0,0,0,2,1,1,0,0,0,0,0,0,0,0,0
403478,20000,200,0,2,3,1,2,0,0,0,0,0,0,0,0,0,0,0,0,0,0,0,3,1,2,0,0,0,0,0,0,0,0,0
403487,20000,200,0,2,3,2,1,0,0,0,0,0,0,0,0,0,0,0,0,0,0,0,3,2,1,0,0,0,0,0,0,0,0,0
404055,20000,200,0,2,5,2,3,0,0,0,0,0,0,1,0,1,0,0,0,0,0,0,3,1,2,0,0,0,1,1,0,0,0,0
404222,20000,200,0,2,1,1,0,0,0,0,0,0,0,0,0,0,1,1,0,0,0,0,0,0,0,0,0,0,0,0,0,0,0,0
404426,20000,200,0,2,3,1,2,1,1,0,0,0,0,0,0,0,1,0,1,0,0,0,1,0,1,0,0,0,0,0,0,0,0,0
404912,20000,200,0,2,5,1,4,0,0,0,0,0,0,1,1,0,0,0,0,0,0,0,4,0,4,0,0,0,0,0,0,0,0,0
404994,20000,200,0,2,6,2,4,0,0,0,0,0,0,0,0,0,3,1,2,0,0,0,3,1,2,0,0,0,0,0,0,0,0,0
405872,20000,200,0,2,2,1,1,0,0,0,0,0,0,0,0,0,0,0,0,0,0,0,2,1,1,0,0,0,0,0,0,0,0,0
406024,20000,200,0,2,20,2,18,0,0,0,1,0,1,1,0,1,3,1,2,0,0,0,14,1,13,1,0,1,0,0,0,0,0,0
406033,20000,200,0,2,20,3,17,0,0,0,3,1,2,0,0,0,7,1,6,0,0,0,9,1,8,0,0,0,1,0,1,0,0,0
407629,20000,200,0,2,28,15,13,0,0,0,4,2,2,1,0,1,0,0,0,0,0,0,23,13,10,0,0,0,0,0,0,0,0,0
408729,20000,200,0,2,1,0,1,0,0,0,0,0,0,0,0,0,0,0,0,0,0,0,1,0,1,0,0,0,0,0,0,0,0,0
408844,20000,200,0,2,13,7,6,0,0,0,0,0,0,2,1,1,11,6,5,0,0,0,0,0,0,0,0,0,0,0,0,0,0,0
409254,20000,200,0,2,2,0,2,0,0,0,0,0,0,2,0,2,0,0,0,0,0,0,0,0,0,0,0,0,0,0,0,0,0,0
409315,20000,200,0,2,54,34,20,0,0,0,3,1,2,0,0,0,36,21,15,0,0,0,10,7,3,0,0,0,2,2,0,3,3,0
409698,20000,200,0,2,7,3,4,0,0,0,1,0,1,0,0,0,1,1,0,0,0,0,4,1,3,0,0,0,0,0,0,1,1,0
412173,20000,200,0,2,3,0,3,0,0,0,0,0,0,0,0,0,0,0,0,0,0,0,3,0,3,0,0,0,0,0,0,0,0,0
413413,20000,200,0,2,6,1,5,0,0,0,0,0,0,1,0,1,0,0,0,0,0,0,4,1,3,0,0,0,1,0,1,0,0,0
413626,20000,200,0,2,1,1,0,0,0,0,0,0,0,0,0,0,0,0,0,0,0,0,1,1,0,0,0,0,0,0,0,0,0,0
413680,20000,200,0,2,7,7,0,0,0,0,0,0,0,2,2,0,3,3,0,0,0,0,2,2,0,0,0,0,0,0,0,0,0,0
414911,20000,200,0,2,1,1,0,0,0,0,0,0,0,0,0,0,0,0,0,0,0,0,1,1,0,0,0,0,0,0,0,0,0,0
414966,20000,200,0,2,2,0,2,0,0,0,0,0,0,0,0,0,0,0,0,0,0,0,2,0,2,0,0,0,0,0,0,0,0,0
416458,20000,200,0,2,1,0,1,0,0,0,1,0,1,0,0,0,0,0,0,0,0,0,0,0,0,0,0,0,0,0,0,0,0,0
416801,20000,200,0,2,1,0,1,0,0,0,0,0,0,0,0,0,0,0,0,0,0,0,1,0,1,0,0,0,0,0,0,0,0,0
418126,20000,200,0,2,1,0,1,0,0,0,0,0,0,0,0,0,0,0,0,0,0,0,1,0,1,0,0,0,0,0,0,0,0,0
418533,20000,200,0,2,4,2,2,0,0,0,0,0,0,0,0,0,0,0,0,0,0,0,4,2,2,0,0,0,0,0,0,0,0,0
420024,20000,200,0,2,3,0,3,0,0,0,1,0,1,1,0,1,0,0,0,0,0,0,1,0,1,0,0,0,0,0,0,0,0,0
420246,20000,200,0,2,4,2,2,0,0,0,0,0,0,1,1,0,0,0,0,0,0,0,3,1,2,0,0,0,0,0,0,0,0,0
420398,20000,200,0,2,3,1,2,0,0,0,1,0,1,0,0,0,0,0,0,0,0,0,2,1,1,0,0,0,0,0,0,0,0,0
420431,20000,200,0,2,9,3,6,0,0,0,0,0,0,1,0,1,0,0,0,0,0,0,8,3,5,0,0,0,0,0,0,0,0,0
420440,20000,200,0,2,3,0,3,0,0,0,0,0,0,0,0,0,0,0,0,0,0,0,3,0,3,0,0,0,0,0,0,0,0,0
420538,20000,200,0,2,1,1,0,0,0,0,0,0,0,0,0,0,0,0,0,0,0,0,1,1,0,0,0,0,0,0,0,0,0,0
420556,20000,200,0,2,4,2,2,0,0,0,0,0,0,0,0,0,1,0,1,0,0,0,3,2,1,0,0,0,0,0,0,0,0,0
421708,20000,200,0,2,16,3,13,0,0,0,0,0,0,5,0,5,0,0,0,0,0,0,10,3,7,1,0,1,0,0,0,0,0,0
422020,20000,200,0,2,2,2,0,0,0,0,0,0,0,0,0,0,1,1,0,0,0,0,0,0,0,0,0,0,1,1,0,0,0,0
422695,20000,200,0,2,2,0,2,0,0,0,0,0,0,0,0,0,0,0,0,0,0,0,2,0,2,0,0,0,0,0,0,0,0,0
423643,20000,200,0,2,32,14,18,0,0,0,4,2,2,3,3,0,4,2,2,0,0,0,19,7,12,1,0,1,1,0,1,0,0,0
423652,20000,200,0,2,4,1,3,0,0,0,0,0,0,0,0,0,0,0,0,0,0,0,4,1,3,0,0,0,0,0,0,0,0,0
426314,20000,200,0,2,11,7,4,0,0,0,0,0,0,0,0,0,0,0,0,0,0,0,6,4,2,1,1,0,4,2,2,0,0,0
427982,20000,200,0,2,11,7,4,0,0,0,0,0,0,7,3,4,0,0,0,0,0,0,4,4,0,0,0,0,0,0,0,0,0,0
428170,20000,200,0,2,8,0,8,0,0,0,1,0,1,2,0,2,3,0,3,0,0,0,2,0,2,0,0,0,0,0,0,0,0,0
428392,20000,200,0,2,4,1,3,0,0,0,0,0,0,0,0,0,0,0,0,0,0,0,4,1,3,0,0,0,0,0,0,0,0,0
429094,20000,200,0,2,1,0,1,0,0,0,1,0,1,0,0,0,0,0,0,0,0,0,0,0,0,0,0,0,0,0,0,0,0,0
431141,20000,200,0,2,21,4,17,0,0,0,1,0,1,1,0,1,6,1,5,1,0,1,11,3,8,0,0,0,1,0,1,0,0,0
432348,20000,200,0,2,1,1,0,0,0,0,0,0,0,0,0,0,0,0,0,0,0,0,1,1,0,0,0,0,0,0,0,0,0,0
433004,20000,200,0,2,7,5,2,1,1,0,2,1,1,0,0,0,0,0,0,0,0,0,4,3,1,0,0,0,0,0,0,0,0,0
433013,20000,200,0,2,8,2,6,0,0,0,0,0,0,0,0,0,4,1,3,0,0,0,4,1,3,0,0,0,0,0,0,0,0,0
433174,20000,200,0,2,8,1,7,0,0,0,1,1,0,1,0,1,0,0,0,0,0,0,6,0,6,0,0,0,0,0,0,0,0,0
433387,20000,200,0,2,224,88,136,1,1,0,8,3,5,50,25,25,17,3,14,0,0,0,131,48,83,5,3,2,12,5,7,0,0,0
433420,20000,200,0,2,9,9,0,0,0,0,0,0,0,0,0,0,2,2,0,0,0,0,7,7,0,0,0,0,0,0,0,0,0,0
433536,20000,200,0,2,3,0,3,0,0,0,0,0,0,1,0,1,0,0,0,0,0,0,2,0,2,0,0,0,0,0,0,0,0,0
433660,20000,200,0,2,39,16,23,0,0,0,6,2,4,3,1,2,4,1,3,0,0,0,18,9,9,2,0,2,0,0,0,6,3,3
434016,20000,200,0,2,2,1,1,0,0,0,0,0,0,0,0,0,0,0,0,0,0,0,2,1,1,0,0,0,0,0,0,0,0,0
434061,20000,200,0,2,20,8,12,0,0,0,1,0,1,10,2,8,0,0,0,1,0,1,7,5,2,0,0,0,0,0,0,1,1,0
434140,20000,200,0,2,4,1,3,0,0,0,0,0,0,0,0,0,0,0,0,0,0,0,4,1,3,0,0,0,0,0,0,0,0,0
434584,20000,200,0,2,1,1,0,0,0,0,1,1,0,0,0,0,0,0,0,0,0,0,0,0,0,0,0,0,0,0,0,0,0,0
434672,20000,200,0,2,14,3,11,0,0,0,2,0,2,4,1,3,1,0,1,0,0,0,6,1,5,0,0,0,0,0,0,1,1,0
434751,20000,200,0,2,1,1,0,1,1,0,0,0,0,0,0,0,0,0,0,0,0,0,0,0,0,0,0,0,0,0,0,0,0,0
434821,20000,200,0,2,1,0,1,0,0,0,0,0,0,1,0,1,0,0,0,0,0,0,0,0,0,0,0,0,0,0,0,0,0,0
435000,20000,200,0,2,113,66,47,0,0,0,21,13,8,2,1,1,7,4,3,0,0,0,44,24,20,1,0,1,0,0,0,38,24,14
436304,20000,200,0,2,12,5,7,0,0,0,0,0,0,4,1,3,1,1,0,0,0,0,7,3,4,0,0,0,0,0,0,0,0,0
436429,20000,200,0,2,9,0,9,0,0,0,0,0,0,1,0,1,2,0,2,0,0,0,5,0,5,0,0,0,1,0,1,0,0,0
437103,20000,200,0,2,5,1,4,0,0,0,0,0,0,3,0,3,0,0,0,0,0,0,2,1,1,0,0,0,0,0,0,0,0,0
437635,20000,200,0,2,18,6,12,0,0,0,0,0,0,3,0,3,7,3,4,0,0,0,7,2,5,1,1,0,0,0,0,0,0,0
437936,20000,200,0,2,4,3,1,0,0,0,1,1,0,0,0,0,1,1,0,0,0,0,2,1,1,0,0,0,0,0,0,0,0,0
438179,20000,200,0,2,4,0,4,0,0,0,0,0,0,1,0,1,2,0,2,0,0,0,1,0,1,0,0,0,0,0,0,0,0,0
438258,20000,200,0,2,5,0,5,0,0,0,0,0,0,0,0,0,0,0,0,1,0,1,3,0,3,1,0,1,0,0,0,0,0,0
438498,20000,200,0,2,10,1,9,0,0,0,0,0,0,2,0,2,0,0,0,0,0,0,7,1,6,0,0,0,1,0,1,0,0,0
438504,20000,200,0,2,2,2,0,0,0,0,0,0,0,0,0,0,2,2,0,0,0,0,0,0,0,0,0,0,0,0,0,0,0,0
438586,20000,200,0,2,1,1,0,0,0,0,0,0,0,1,1,0,0,0,0,0,0,0,0,0,0,0,0,0,0,0,0,0,0,0
438708,20000,200,0,2,3,1,2,0,0,0,0,0,0,0,0,0,0,0,0,0,0,0,3,1,2,0,0,0,0,0,0,0,0,0
439118,20000,200,0,2,2,0,2,0,0,0,0,0,0,0,0,0,0,0,0,0,0,0,1,0,1,0,0,0,1,0,1,0,0,0
439367,20000,200,0,2,5,1,4,0,0,0,0,0,0,0,0,0,2,0,2,0,0,0,3,1,2,0,0,0,0,0,0,0,0,0
439446,20000,200,0,2,1,1,0,0,0,0,1,1,0,0,0,0,0,0,0,0,0,0,0,0,0,0,0,0,0,0,0,0,0,0
439570,20000,200,0,2,8,1,7,0,0,0,0,0,0,2,0,2,0,0,0,0,0,0,6,1,5,0,0,0,0,0,0,0,0,0
439701,20000,200,0,2,1,1,0,0,0,0,0,0,0,0,0,0,0,0,0,0,0,0,1,1,0,0,0,0,0,0,0,0,0,0
439738,20000,200,0,2,1,0,1,0,0,0,0,0,0,1,0,1,0,0,0,0,0,0,0,0,0,0,0,0,0,0,0,0,0,0
439792,20000,200,0,2,4,0,4,0,0,0,0,0,0,2,0,2,0,0,0,0,0,0,2,0,2,0,0,0,0,0,0,0,0,0
440031,20000,200,0,2,21,9,12,0,0,0,8,5,3,2,0,2,0,0,0,0,0,0,8,1,7,1,1,0,2,2,0,0,0,0
440059,20000,200,0,2,13,12,1,0,0,0,1,1,0,1,1,0,1,1,0,0,0,0,10,9,1,0,0,0,0,0,0,0,0,0
440262,20000,200,0,2,1,1,0,0,0,0,0,0,0,0,0,0,1,1,0,0,0,0,0,0,0,0,0,0,0,0,0,0,0,0
440396,20000,200,0,2,1,0,1,0,0,0,0,0,0,0,0,0,0,0,0,0,0,0,1,0,1,0,0,0,0,0,0,0,0,0
440402,20000,200,0,2,12,4,8,0,0,0,0,0,0,0,0,0,1,1,0,0,0,0,11,3,8,0,0,0,0,0,0,0,0,0
440651,20000,200,0,2,1,0,1,0,0,0,0,0,0,0,0,0,1,0,1,0,0,0,0,0,0,0,0,0,0,0,0,0,0,0
440794,20000,200,0,2,1,0,1,0,0,0,0,0,0,1,0,1,0,0,0,0,0,0,0,0,0,0,0,0,0,0,0,0,0,0
440916,20000,200,0,2,13,7,6,0,0,0,1,1,0,7,2,5,0,0,0,0,0,0,5,4,1,0,0,0,0,0,0,0,0,0
441025,20000,200,0,2,3,3,0,0,0,0,0,0,0,0,0,0,0,0,0,0,0,0,3,3,0,0,0,0,0,0,0,0,0,0
441052,20000,200,0,2,5,2,3,0,0,0,0,0,0,0,0,0,2,2,0,0,0,0,2,0,2,1,0,1,0,0,0,0,0,0
441070,20000,200,0,2,1,1,0,0,0,0,0,0,0,0,0,0,0,0,0,0,0,0,1,1,0,0,0,0,0,0,0,0,0,0
441131,20000,200,0,2,1,1,0,0,0,0,0,0,0,0,0,0,0,0,0,0,0,0,1,1,0,0,0,0,0,0,0,0,0,0
441229,20000,200,0,2,18,7,11,0,0,0,0,0,0,1,0,1,4,3,1,0,0,0,10,3,7,0,0,0,3,1,2,0,0,0
441371,20000,200,0,2,50,9,41,0,0,0,1,0,1,20,2,18,3,2,1,0,0,0,23,5,18,1,0,1,2,0,2,0,0,0
441423,20000,200,0,2,3,2,1,0,0,0,0,0,0,0,0,0,3,2,1,0,0,0,0,0,0,0,0,0,0,0,0,0,0,0
441609,20000,200,0,2,1,1,0,0,0,0,0,0,0,0,0,0,0,0,0,0,0,0,1,1,0,0,0,0,0,0,0,0,0,0
441636,20000,200,0,2,4,1,3,0,0,0,0,0,0,1,0,1,0,0,0,0,0,0,3,1,2,0,0,0,0,0,0,0,0,0
441742,20000,200,0,2,2,1,1,0,0,0,1,1,0,1,0,1,0,0,0,0,0,0,0,0,0,0,0,0,0,0,0,0,0,0
441760,20000,200,0,2,6,1,5,1,0,1,0,0,0,0,0,0,1,1,0,0,0,0,3,0,3,0,0,0,1,0,1,0,0,0
441900,20000,200,0,2,13,6,7,0,0,0,1,0,1,2,1,1,2,1,1,0,0,0,8,4,4,0,0,0,0,0,0,0,0,0
441937,20000,200,0,2,5,2,3,0,0,0,1,1,0,0,0,0,2,0,2,0,0,0,0,0,0,2,1,1,0,0,0,0,0,0
441982,20000,200,0,2,1,0,1,0,0,0,0,0,0,0,0,0,1,0,1,0,0,0,0,0,0,0,0,0,0,0,0,0,0,0
442134,20000,200,0,2,2,0,2,0,0,0,0,0,0,0,0,0,1,0,1,0,0,0,1,0,1,0,0,0,0,0,0,0,0,0
442295,20000,200,0,2,1,1,0,0,0,0,0,0,0,0,0,0,0,0,0,0,0,0,1,1,0,0,0,0,0,0,0,0,0,0
442356,20000,200,0,2,16,0,16,0,0,0,1,0,1,0,0,0,0,0,0,0,0,0,15,0,15,0,0,0,0,0,0,0,0,0
442383,20000,200,0,2,7,1,6,0,0,0,0,0,0,0,0,0,0,0,0,0,0,0,7,1,6,0,0,0,0,0,0,0,0,0
442426,20000,200,0,2,2,1,1,0,0,0,0,0,0,0,0,0,0,0,0,0,0,0,2,1,1,0,0,0,0,0,0,0,0,0
442444,20000,200,0,2,4,2,2,0,0,0,0,0,0,0,0,0,0,0,0,0,0,0,3,2,1,0,0,0,1,0,1,0,0,0
442602,20000,200,0,2,5,0,5,0,0,0,0,0,0,0,0,0,1,0,1,0,0,0,3,0,3,1,0,1,0,0,0,0,0,0
442781,20000,200,0,2,4,2,2,2,0,2,2,2,0,0,0,0,0,0,0,0,0,0,0,0,0,0,0,0,0,0,0,0,0,0
442806,20000,200,0,2,29,17,12,0,0,0,4,1,3,1,0,1,1,0,1,0,0,0,23,16,7,0,0,0,0,0,0,0,0,0
442930,20000,200,0,2,1,0,1,0,0,0,0,0,0,0,0,0,0,0,0,0,0,0,1,0,1,0,0,0,0,0,0,0,0,0
443128,20000,200,0,2,1,1,0,0,0,0,0,0,0,0,0,0,0,0,0,0,0,0,1,1,0,0,0,0,0,0,0,0,0,0
443261,20000,200,0,2,5,1,4,0,0,0,0,0,0,3,1,2,0,0,0,0,0,0,2,0,2,0,0,0,0,0,0,0,0,0
443331,20000,200,0,2,3,0,3,0,0,0,1,0,1,0,0,0,0,0,0,0,0,0,2,0,2,0,0,0,0,0,0,0,0,0
443377,20000,200,0,2,3,3,0,0,0,0,0,0,0,0,0,0,0,0,0,0,0,0,3,3,0,0,0,0,0,0,0,0,0,0
443410,20000,200,0,2,3,1,2,0,0,0,0,0,0,0,0,0,0,0,0,0,0,0,3,1,2,0,0,0,0,0,0,0,0,0
443492,20000,200,0,2,2,1,1,0,0,0,0,0,0,0,0,0,0,0,0,0,0,0,2,1,1,0,0,0,0,0,0,0,0,0
443599,20000,200,0,2,1,1,0,0,0,0,0,0,0,0,0,0,0,0,0,0,0,0,1,1,0,0,0,0,0,0,0,0,0,0
443650,20000,200,0,2,3,1,2,0,0,0,0,0,0,0,0,0,0,0,0,0,0,0,3,1,2,0,0,0,0,0,0,0,0,0
443748,20000,200,0,2,5,1,4,1,0,1,0,0,0,3,1,2,0,0,0,0,0,0,0,0,0,1,0,1,0,0,0,0,0,0
444088,20000,200,0,2,4,0,4,1,0,1,0,0,0,0,0,0,1,0,1,1,0,1,1,0,1,0,0,0,0,0,0,0,0,0
444130,20000,200,0,2,6,3,3,0,0,0,0,0,0,2,1,1,0,0,0,0,0,0,4,2,2,0,0,0,0,0,0,0,0,0
444556,20000,200,0,2,5,3,2,0,0,0,0,0,0,0,0,0,0,0,0,1,0,1,1,0,1,1,1,0,2,2,0,0,0,0
444565,20000,200,0,2,1,1,0,0,0,0,0,0,0,0,0,0,0,0,0,0,0,0,1,1,0,0,0,0,0,0,0,0,0,0
444787,20000,200,0,2,65,7,58,0,0,0,1,0,1,10,0,10,0,0,0,0,0,0,47,5,42,0,0,0,7,2,5,0,0,0
444811,20000,200,0,2,3,1,2,0,0,0,0,0,0,2,1,1,0,0,0,0,0,0,1,0,1,0,0,0,0,0,0,0,0,0
444866,20000,200,0,2,3,0,3,0,0,0,0,0,0,1,0,1,0,0,0,0,0,0,1,0,1,1,0,1,0,0,0,0,0,0
444954,20000,200,0,2,7,3,4,0,0,0,0,0,0,0,0,0,1,0,1,0,0,0,6,3,3,0,0,0,0,0,0,0,0,0
445027,20000,200,0,2,6,2,4,1,0,1,0,0,0,2,1,1,0,0,0,0,0,0,3,1,2,0,0,0,0,0,0,0,0,0
445188,20000,200,0,2,70,36,34,1,0,1,3,2,1,2,2,0,8,3,5,0,0,0,24,8,16,2,1,1,5,5,0,25,15,10
445203,20000,200,0,2,1,0,1,0,0,0,0,0,0,0,0,0,0,0,0,0,0,0,1,0,1,0,0,0,0,0,0,0,0,0
445230,20000,200,0,2,4,2,2,0,0,0,0,0,0,1,0,1,1,1,0,0,0,0,2,1,1,0,0,0,0,0,0,0,0,0
445461,20000,200,0,2,4,2,2,0,0,0,0,0,0,2,0,2,0,0,0,0,0,0,1,1,0,0,0,0,1,1,0,0,0,0
445692,20000,200,0,2,2,2,0,0,0,0,0,0,0,0,0,0,0,0,0,0,0,0,2,2,0,0,0,0,0,0,0,0,0,0
445735,20000,200,0,2,14,6,8,0,0,0,0,0,0,3,0,3,3,2,1,0,0,0,8,4,4,0,0,0,0,0,0,0,0,0
445744,20000,200,0,2,1,0,1,0,0,0,0,0,0,0,0,0,0,0,0,0,0,0,1,0,1,0,0,0,0,0,0,0,0,0
445869,20000,200,0,2,5,2,3,0,0,0,0,0,0,1,0,1,0,0,0,0,0,0,3,2,1,0,0,0,1,0,1,0,0,0
445948,20000,200,0,2,30,11,19,0,0,0,1,0,1,6,2,4,9,1,8,1,1,0,10,4,6,2,2,0,1,1,0,0,0,0
446048,20000,200,0,2,9,6,3,0,0,0,1,0,1,0,0,0,1,1,0,0,0,0,7,5,2,0,0,0,0,0,0,0,0,0
446118,20000,200,0,2,14,3,11,0,0,0,3,1,2,3,0,3,4,1,3,0,0,0,4,1,3,0,0,0,0,0,0,0,0,0
446127,20000,200,0,2,1,0,1,0,0,0,0,0,0,0,0,0,0,0,0,0,0,0,1,0,1,0,0,0,0,0,0,0,0,0
446385,20000,200,0,2,1,0,1,0,0,0,1,0,1,0,0,0,0,0,0,0,0,0,0,0,0,0,0,0,0,0,0,0,0,0
446552,20000,200,0,2,18,10,8,0,0,0,0,0,0,1,1,0,4,3,1,0,0,0,12,5,7,1,1,0,0,0,0,0,0,0
446561,20000,200,0,2,8,4,4,0,0,0,1,0,1,1,1,0,1,1,0,0,0,0,5,2,3,0,0,0,0,0,0,0,0,0
446604,20000,200,0,2,12,12,0,0,0,0,0,0,0,0,0,0,0,0,0,0,0,0,12,12,0,0,0,0,0,0,0,0,0,0
446640,20000,200,0,2,8,6,2,0,0,0,2,1,1,0,0,0,0,0,0,0,0,0,4,3,1,0,0,0,2,2,0,0,0,0
446774,20000,200,0,2,7,3,4,0,0,0,0,0,0,0,0,0,0,0,0,0,0,0,7,3,4,0,0,0,0,0,0,0,0,0
447014,20000,200,0,2,1,0,1,0,0,0,0,0,0,0,0,0,0,0,0,0,0,0,1,0,1,0,0,0,0,0,0,0,0,0
447263,20000,200,0,2,43,5,38,0,0,0,1,0,1,2,1,1,0,0,0,0,0,0,27,2,25,0,0,0,13,2,11,0,0,0
447351,20000,200,0,2,4,1,3,0,0,0,0,0,0,0,0,0,1,0,1,0,0,0,3,1,2,0,0,0,0,0,0,0,0,0
447421,20000,200,0,2,4,1,3,0,0,0,0,0,0,1,1,0,0,0,0,0,0,0,3,0,3,0,0,0,0,0,0,0,0,0
447582,20000,200,0,2,8,3,5,0,0,0,0,0,0,1,1,0,0,0,0,0,0,0,7,2,5,0,0,0,0,0,0,0,0,0
447591,20000,200,0,2,7,1,6,0,0,0,0,0,0,5,0,5,0,0,0,0,0,0,1,0,1,1,1,0,0,0,0,0,0,0
447689,20000,200,0,2,13,4,9,0,0,0,0,0,0,3,1,2,0,0,0,0,0,0,10,3,7,0,0,0,0,0,0,0,0,0
447768,20000,200,0,2,5,1,4,0,0,0,0,0,0,3,0,3,1,1,0,0,0,0,1,0,1,0,0,0,0,0,0,0,0,0
447777,20000,200,0,2,3,1,2,0,0,0,0,0,0,0,0,0,1,0,1,0,0,0,2,1,1,0,0,0,0,0,0,0,0,0
447953,20000,200,0,2,2,2,0,0,0,0,1,1,0,0,0,0,1,1,0,0,0,0,0,0,0,0,0,0,0,0,0,0,0,0
448354,20000,200,0,2,2,1,1,0,0,0,0,0,0,0,0,0,0,0,0,0,0,0,2,1,1,0,0,0,0,0,0,0,0,0
448594,20000,200,0,2,3,1,2,0,0,0,1,1,0,1,0,1,0,0,0,0,0,0,0,0,0,0,0,0,1,0,1,0,0,0
448600,20000,200,0,2,7,1,6,0,0,0,0,0,0,0,0,0,0,0,0,0,0,0,7,1,6,0,0,0,0,0,0,0,0,0
448673,20000,200,0,2,15,3,12,0,0,0,1,1,0,0,0,0,1,0,1,0,0,0,12,2,10,0,0,0,1,0,1,0,0,0
448859,20000,200,0,2,2,2,0,0,0,0,0,0,0,0,0,0,0,0,0,0,0,0,2,2,0,0,0,0,0,0,0,0,0,0
449074,20000,200,0,2,4,1,3,0,0,0,0,0,0,0,0,0,1,0,1,0,0,0,2,1,1,1,0,1,0,0,0,0,0,0
449250,20000,200,0,2,8,1,7,0,0,0,0,0,0,1,0,1,2,0,2,1,0,1,4,1,3,0,0,0,0,0,0,0,0,0
449339,20000,200,0,2,3,1,2,0,0,0,0,0,0,0,0,0,1,0,1,0,0,0,1,0,1,0,0,0,1,1,0,0,0,0
449524,20000,200,0,2,3,0,3,0,0,0,0,0,0,0,0,0,0,0,0,0,0,0,3,0,3,0,0,0,0,0,0,0,0,0
449728,20000,200,0,2,2,0,2,0,0,0,0,0,0,0,0,0,0,0,0,0,0,0,2,0,2,0,0,0,0,0,0,0,0,0
449764,20000,200,0,2,1,1,0,0,0,0,0,0,0,0,0,0,0,0,0,0,0,0,1,1,0,0,0,0,0,0,0,0,0,0
449870,20000,200,0,2,1,1,0,0,0,0,0,0,0,0,0,0,0,0,0,0,0,0,1,1,0,0,0,0,0,0,0,0,0,0
449889,20000,200,0,2,4,0,4,0,0,0,0,0,0,1,0,1,0,0,0,0,0,0,3,0,3,0,0,0,0,0,0,0,0,0
449898,20000,200,0,2,4,1,3,0,0,0,0,0,0,1,0,1,0,0,0,0,0,0,3,1,2,0,0,0,0,0,0,0,0,0
449922,20000,200,0,2,1,1,0,0,0,0,1,1,0,0,0,0,0,0,0,0,0,0,0,0,0,0,0,0,0,0,0,0,0,0
450058,20000,200,0,2,15,2,13,0,0,0,1,0,1,2,0,2,0,0,0,0,0,0,11,2,9,1,0,1,0,0,0,0,0,0
450067,20000,200,0,2,4,0,4,0,0,0,0,0,0,0,0,0,0,0,0,0,0,0,4,0,4,0,0,0,0,0,0,0,0,0
450128,20000,200,0,2,3,0,3,0,0,0,0,0,0,0,0,0,0,0,0,0,0,0,3,0,3,0,0,0,0,0,0,0,0,0
450304,20000,200,0,2,1,1,0,0,0,0,0,0,0,1,1,0,0,0,0,0,0,0,0,0,0,0,0,0,0,0,0,0,0,0
450571,20000,200,0,2,1,0,1,0,0,0,0,0,0,0,0,0,0,0,0,0,0,0,1,0,1,0,0,0,0,0,0,0,0,0
450696,20000,200,0,2,5,1,4,0,0,0,0,0,0,1,1,0,1,0,1,0,0,0,3,0,3,0,0,0,0,0,0,0,0,0
450702,20000,200,0,2,2,0,2,0,0,0,0,0,0,0,0,0,0,0,0,0,0,0,2,0,2,0,0,0,0,0,0,0,0,0
450933,20000,200,0,2,4,0,4,0,0,0,0,0,0,1,0,1,0,0,0,0,0,0,3,0,3,0,0,0,0,0,0,0,0,0
451103,20000,200,0,2,3,0,3,0,0,0,0,0,0,0,0,0,3,0,3,0,0,0,0,0,0,0,0,0,0,0,0,0,0,0
451228,20000,200,0,2,1,1,0,0,0,0,0,0,0,0,0,0,0,0,0,0,0,0,1,1,0,0,0,0,0,0,0,0,0,0
451404,20000,200,0,2,6,6,0,0,0,0,0,0,0,0,0,0,0,0,0,0,0,0,6,6,0,0,0,0,0,0,0,0,0,0
451477,20000,200,0,2,6,5,1,0,0,0,0,0,0,0,0,0,0,0,0,0,0,0,5,4,1,1,1,0,0,0,0,0,0,0
451510,20000,200,0,2,2,1,1,0,0,0,0,0,0,0,0,0,0,0,0,0,0,0,2,1,1,0,0,0,0,0,0,0,0,0
451556,20000,200,0,2,26,12,14,0,0,0,0,0,0,0,0,0,25,11,14,0,0,0,1,1,0,0,0,0,0,0,0,0,0,0
451750,20000,200,0,2,8,0,8,0,0,0,1,0,1,1,0,1,0,0,0,0,0,0,6,0,6,0,0,0,0,0,0,0,0,0
451927,20000,200,0,2,1,1,0,0,0,0,0,0,0,0,0,0,0,0,0,0,0,0,1,1,0,0,0,0,0,0,0,0,0,0
452124,20000,200,0,2,5,0,5,0,0,0,0,0,0,1,0,1,0,0,0,0,0,0,4,0,4,0,0,0,0,0,0,0,0,0
452373,20000,200,0,2,1,0,1,0,0,0,0,0,0,1,0,1,0,0,0,0,0,0,0,0,0,0,0,0,0,0,0,0,0,0
452948,20000,200,0,2,6,0,6,0,0,0,0,0,0,1,0,1,0,0,0,0,0,0,5,0,5,0,0,0,0,0,0,0,0,0
454218,20000,200,0,2,75,11,64,0,0,0,4,2,2,18,3,15,4,1,3,0,0,0,41,4,37,3,0,3,5,1,4,0,0,0
454698,20000,200,0,2,6,1,5,0,0,0,0,0,0,1,0,1,3,0,3,0,0,0,2,1,1,0,0,0,0,0,0,0,0,0
454786,20000,200,0,2,3,1,2,0,0,0,0,0,0,1,0,1,0,0,0,0,0,0,2,1,1,0,0,0,0,0,0,0,0,0
454810,20000,200,0,2,64,32,32,1,0,1,3,0,3,5,1,4,2,2,0,0,0,0,46,26,20,5,2,3,2,1,1,0,0,0
454829,20000,200,0,2,13,0,13,0,0,0,1,0,1,0,0,0,0,0,0,0,0,0,11,0,11,0,0,0,1,0,1,0,0,0
454856,20000,200,0,2,2,0,2,0,0,0,0,0,0,0,0,0,0,0,0,0,0,0,2,0,2,0,0,0,0,0,0,0,0,0
455114,20000,200,0,2,19,13,6,0,0,0,0,0,0,0,0,0,1,1,0,0,0,0,17,11,6,0,0,0,1,1,0,0,0,0
455196,20000,200,0,2,15,1,14,0,0,0,0,0,0,5,1,4,2,0,2,0,0,0,8,0,8,0,0,0,0,0,0,0,0,0
455257,20000,200,0,2,1,1,0,0,0,0,0,0,0,0,0,0,0,0,0,0,0,0,1,1,0,0,0,0,0,0,0,0,0,0
455406,20000,200,0,2,6,2,4,0,0,0,0,0,0,0,0,0,0,0,0,0,0,0,5,1,4,1,1,0,0,0,0,0,0,0
455433,20000,200,0,2,1,1,0,0,0,0,0,0,0,0,0,0,0,0,0,0,0,0,0,0,0,1,1,0,0,0,0,0,0,0
455479,20000,200,0,2,3,1,2,0,0,0,0,0,0,0,0,0,0,0,0,0,0,0,3,1,2,0,0,0,0,0,0,0,0,0
455512,20000,200,0,2,1,0,1,0,0,0,0,0,0,0,0,0,0,0,0,0,0,0,1,0,1,0,0,0,0,0,0,0,0,0
455628,20000,200,0,2,6,3,3,0,0,0,0,0,0,5,2,3,0,0,0,0,0,0,1,1,0,0,0,0,0,0,0,0,0,0
455664,20000,200,0,2,12,4,8,0,0,0,0,0,0,2,0,2,1,1,0,0,0,0,7,2,5,2,1,1,0,0,0,0,0,0
455804,20000,200,0,2,3,2,1,0,0,0,0,0,0,0,0,0,0,0,0,0,0,0,3,2,1,0,0,0,0,0,0,0,0,0
455813,20000,200,0,2,1,0,1,0,0,0,0,0,0,0,0,0,0,0,0,0,0,0,1,0,1,0,0,0,0,0,0,0,0,0
456038,20000,200,0,2,2,0,2,0,0,0,0,0,0,0,0,0,1,0,1,0,0,0,1,0,1,0,0,0,0,0,0,0,0,0
456205,20000,200,0,2,5,2,3,0,0,0,0,0,0,1,0,1,0,0,0,0,0,0,4,2,2,0,0,0,0,0,0,0,0,0
456214,20000,200,0,2,4,3,1,0,0,0,0,0,0,0,0,0,1,1,0,0,0,0,3,2,1,0,0,0,0,0,0,0,0,0
456454,20000,200,0,2,5,3,2,0,0,0,0,0,0,0,0,0,0,0,0,0,0,0,5,3,2,0,0,0,0,0,0,0,0,0
456490,20000,200,0,2,1,1,0,0,0,0,0,0,0,0,0,0,1,1,0,0,0,0,0,0,0,0,0,0,0,0,0,0,0,0
456542,20000,200,0,2,3,1,2,0,0,0,0,0,0,1,0,1,0,0,0,0,0,0,2,1,1,0,0,0,0,0,0,0,0,0
456579,20000,200,0,2,2,1,1,0,0,0,0,0,0,0,0,0,0,0,0,0,0,0,2,1,1,0,0,0,0,0,0,0,0,0
456852,20000,200,0,2,1,1,0,0,0,0,0,0,0,1,1,0,0,0,0,0,0,0,0,0,0,0,0,0,0,0,0,0,0,0
456959,20000,200,0,2,2,0,2,0,0,0,1,0,1,0,0,0,0,0,0,0,0,0,0,0,0,1,0,1,0,0,0,0,0,0
457086,20000,200,0,2,1,1,0,0,0,0,1,1,0,0,0,0,0,0,0,0,0,0,0,0,0,0,0,0,0,0,0,0,0,0
457101,20000,200,0,2,8,2,6,0,0,0,1,1,0,1,0,1,1,1,0,0,0,0,4,0,4,0,0,0,1,0,1,0,0,0
457110,20000,200,0,2,1,0,1,0,0,0,0,0,0,0,0,0,0,0,0,0,0,0,1,0,1,0,0,0,0,0,0,0,0,0
457299,20000,200,0,2,3,1,2,0,0,0,1,0,1,0,0,0,2,1,1,0,0,0,0,0,0,0,0,0,0,0,0,0,0,0
457527,20000,200,0,2,4,0,4,0,0,0,0,0,0,0,0,0,1,0,1,0,0,0,3,0,3,0,0,0,0,0,0,0,0,0
458210,20000,200,0,2,5,2,3,0,0,0,2,0,2,0,0,0,1,1,0,0,0,0,2,1,1,0,0,0,0,0,0,0,0,0
458229,20000,200,0,2,3,0,3,0,0,0,0,0,0,0,0,0,1,0,1,0,0,0,2,0,2,0,0,0,0,0,0,0,0,0
458405,20000,200,0,2,3,2,1,0,0,0,0,0,0,2,2,0,0,0,0,0,0,0,0,0,0,1,0,1,0,0,0,0,0,0
458441,20000,200,0,2,1,0,1,0,0,0,0,0,0,1,0,1,0,0,0,0,0,0,0,0,0,0,0,0,0,0,0,0,0,0
458681,20000,200,0,2,5,2,3,0,0,0,0,0,0,1,1,0,0,0,0,0,0,0,4,1,3,0,0,0,0,0,0,0,0,0
459204,20000,200,0,2,22,1,21,0,0,0,8,0,8,3,0,3,0,0,0,0,0,0,10,1,9,1,0,1,0,0,0,0,0,0
459213,20000,200,0,2,14,2,12,0,0,0,3,0,3,0,0,0,1,0,1,1,0,1,6,1,5,0,0,0,3,1,2,0,0,0
459259,20000,200,0,2,4,0,4,0,0,0,2,0,2,1,0,1,0,0,0,0,0,0,1,0,1,0,0,0,0,0,0,0,0,0
459268,20000,200,0,2,2,0,2,0,0,0,0,0,0,1,0,1,0,0,0,0,0,0,1,0,1,0,0,0,0,0,0,0,0,0
459727,20000,200,0,2,3,1,2,0,0,0,0,0,0,1,0,1,0,0,0,0,0,0,2,1,1,0,0,0,0,0,0,0,0,0
459736,20000,200,0,2,2,0,2,0,0,0,0,0,0,0,0,0,0,0,0,0,0,0,1,0,1,1,0,1,0,0,0,0,0,0
459745,20000,200,0,2,2,0,2,0,0,0,1,0,1,0,0,0,0,0,0,0,0,0,1,0,1,0,0,0,0,0,0,0,0,0
459824,20000,200,0,2,9,2,7,0,0,0,1,0,1,1,0,1,0,0,0,0,0,0,7,2,5,0,0,0,0,0,0,0,0,0
459842,20000,200,0,2,4,1,3,0,0,0,0,0,0,1,0,1,0,0,0,0,0,0,3,1,2,0,0,0,0,0,0,0,0,0
459851,20000,200,0,2,6,2,4,0,0,0,0,0,0,0,0,0,0,0,0,0,0,0,6,2,4,0,0,0,0,0,0,0,0,0
459949,20000,200,0,2,24,11,13,0,0,0,0,0,0,1,0,1,8,6,2,0,0,0,13,5,8,0,0,0,1,0,1,1,0,1
460020,20000,200,0,2,1,0,1,0,0,0,0,0,0,1,0,1,0,0,0,0,0,0,0,0,0,0,0,0,0,0,0,0,0,0
460136,20000,200,0,2,8,0,8,0,0,0,0,0,0,3,0,3,2,0,2,0,0,0,2,0,2,1,0,1,0,0,0,0,0,0
460181,20000,200,0,2,1,0,1,0,0,0,0,0,0,0,0,0,0,0,0,0,0,0,1,0,1,0,0,0,0,0,0,0,0,0
460206,20000,200,0,2,4,2,2,0,0,0,0,0,0,0,0,0,2,2,0,0,0,0,2,0,2,0,0,0,0,0,0,0,0,0
460376,20000,200,0,2,4,1,3,0,0,0,0,0,0,0,0,0,0,0,0,0,0,0,3,0,3,1,1,0,0,0,0,0,0,0
460394,20000,200,0,2,4,2,2,0,0,0,0,0,0,1,1,0,1,1,0,0,0,0,2,0,2,0,0,0,0,0,0,0,0,0
460464,20000,200,0,2,3,2,1,1,1,0,0,0,0,0,0,0,1,1,0,0,0,0,1,0,1,0,0,0,0,0,0,0,0,0
460543,20000,200,0,2,3,3,0,0,0,0,0,0,0,0,0,0,0,0,0,0,0,0,2,2,0,1,1,0,0,0,0,0,0,0
460677,20000,200,0,2,3,0,3,0,0,0,0,0,0,0,0,0,3,0,3,0,0,0,0,0,0,0,0,0,0,0,0,0,0,0
460738,20000,200,0,2,2,0,2,0,0,0,0,0,0,0,0,0,0,0,0,0,0,0,1,0,1,0,0,0,1,0,1,0,0,0
460756,20000,200,0,2,1,0,1,0,0,0,1,0,1,0,0,0,0,0,0,0,0,0,0,0,0,0,0,0,0,0,0,0,0,0
460826,20000,200,0,2,6,1,5,0,0,0,0,0,0,5,1,4,1,0,1,0,0,0,0,0,0,0,0,0,0,0,0,0,0,0
460835,20000,200,0,2,3,1,2,0,0,0,0,0,0,0,0,0,0,0,0,0,0,0,3,1,2,0,0,0,0,0,0,0,0,0
461148,20000,200,0,2,3,0,3,0,0,0,0,0,0,0,0,0,1,0,1,0,0,0,2,0,2,0,0,0,0,0,0,0,0,0
461218,20000,200,0,2,1,0,1,0,0,0,0,0,0,0,0,0,0,0,0,0,0,0,1,0,1,0,0,0,0,0,0,0,0,0
461689,20000,200,0,2,5,3,2,0,0,0,0,0,0,0,0,0,1,1,0,0,0,0,4,2,2,0,0,0,0,0,0,0,0,0
461795,20000,200,0,2,4,3,1,0,0,0,2,1,1,1,1,0,0,0,0,0,0,0,1,1,0,0,0,0,0,0,0,0,0,0
464226,20000,200,0,2,4,1,3,0,0,0,0,0,0,0,0,0,2,1,1,0,0,0,2,0,2,0,0,0,0,0,0,0,0,0
475033,20000,200,0,2,11,3,8,0,0,0,2,0,2,2,0,2,3,2,1,0,0,0,4,1,3,0,0,0,0,0,0,0,0,0
475121,20000,200,0,2,16,1,15,1,0,1,0,0,0,2,0,2,0,0,0,0,0,0,13,1,12,0,0,0,0,0,0,0,0,0
475176,20000,200,0,2,2,1,1,0,0,0,0,0,0,0,0,0,0,0,0,0,0,0,0,0,0,2,1,1,0,0,0,0,0,0
475398,20000,200,0,2,1,0,1,0,0,0,0,0,0,0,0,0,0,0,0,0,0,0,1,0,1,0,0,0,0,0,0,0,0,0
475495,20000,200,0,2,11,5,6,0,0,0,0,0,0,0,0,0,1,1,0,0,0,0,10,4,6,0,0,0,0,0,0,0,0,0
475608,20000,200,0,2,4,2,2,0,0,0,0,0,0,0,0,0,0,0,0,0,0,0,4,2,2,0,0,0,0,0,0,0,0,0
475714,20000,200,0,2,1,0,1,0,0,0,0,0,0,0,0,0,1,0,1,0,0,0,0,0,0,0,0,0,0,0,0,0,0,0
476717,20000,200,0,2,1,1,0,0,0,0,0,0,0,0,0,0,0,0,0,0,0,0,1,1,0,0,0,0,0,0,0,0,0,0
476726,20000,200,0,2,11,3,8,0,0,0,0,0,0,0,0,0,10,3,7,1,0,1,0,0,0,0,0,0,0,0,0,0,0,0
476975,20000,200,0,2,2,1,1,0,0,0,0,0,0,0,0,0,0,0,0,0,0,0,2,1,1,0,0,0,0,0,0,0,0,0
477039,20000,200,0,2,12,0,12,0,0,0,1,0,1,5,0,5,2,0,2,0,0,0,4,0,4,0,0,0,0,0,0,0,0,0
480073,20000,200,0,2,3,1,2,0,0,0,1,1,0,0,0,0,0,0,0,0,0,0,2,0,2,0,0,0,0,0,0,0,0,0
480657,20000,200,0,2,1,0,1,0,0,0,0,0,0,0,0,0,0,0,0,0,0,0,1,0,1,0,0,0,0,0,0,0,0,0
480790,20000,200,0,2,6,3,3,0,0,0,1,0,1,0,0,0,0,0,0,0,0,0,5,3,2,0,0,0,0,0,0,0,0,0
480824,20000,200,0,2,4,0,4,0,0,0,0,0,0,1,0,1,1,0,1,0,0,0,2,0,2,0,0,0,0,0,0,0,0,0
480833,20000,200,0,2,5,1,4,0,0,0,0,0,0,2,0,2,1,1,0,0,0,0,2,0,2,0,0,0,0,0,0,0,0,0
480967,20000,200,0,2,2,1,1,2,1,1,0,0,0,0,0,0,0,0,0,0,0,0,0,0,0,0,0,0,0,0,0,0,0,0
481030,20000,200,0,2,2,1,1,0,0,0,0,0,0,0,0,0,0,0,0,0,0,0,2,1,1,0,0,0,0,0,0,0,0,0
481535,20000,200,0,2,59,20,39,0,0,0,10,2,8,0,0,0,8,7,1,0,0,0,16,6,10,3,1,2,0,0,0,22,4,18
481775,20000,200,0,2,1,1,0,0,0,0,0,0,0,0,0,0,1,1,0,0,0,0,0,0,0,0,0,0,0,0,0,0,0,0
482149,20000,200,0,2,95,51,44,0,0,0,13,8,5,5,2,3,9,5,4,0,0,0,55,28,27,0,0,0,2,2,0,11,6,5
482158,20000,200,0,2,18,7,11,0,0,0,3,2,1,0,0,0,0,0,0,0,0,0,15,5,10,0,0,0,0,0,0,0,0,0
482477,20000,200,0,2,1,1,0,0,0,0,0,0,0,0,0,0,0,0,0,0,0,0,1,1,0,0,0,0,0,0,0,0,0,0
482635,20000,200,0,2,1,1,0,0,0,0,0,0,0,0,0,0,0,0,0,0,0,0,1,1,0,0,0,0,0,0,0,0,0,0
482680,20000,200,0,2,39,24,15,0,0,0,3,3,0,2,0,2,2,1,1,0,0,0,27,16,11,0,0,0,4,3,1,1,1,0
482699,20000,200,0,2,3,1,2,0,0,0,0,0,0,0,0,0,0,0,0,0,0,0,3,1,2,0,0,0,0,0,0,0,0,0
482705,20000,200,0,2,9,5,4,0,0,0,0,0,0,1,1,0,0,0,0,0,0,0,1,1,0,0,0,0,5,2,3,2,1,1
482936,20000,200,0,2,12,10,2,0,0,0,2,1,1,0,0,0,0,0,0,0,0,0,6,5,1,0,0,0,0,0,0,4,4,0
482990,20000,200,0,2,1,0,1,0,0,0,0,0,0,0,0,0,0,0,0,0,0,0,1,0,1,0,0,0,0,0,0,0,0,0
483018,20000,200,0,2,1,0,1,0,0,0,0,0,0,0,0,0,0,0,0,0,0,0,1,0,1,0,0,0,0,0,0,0,0,0
483036,20000,200,0,2,7,4,3,0,0,0,1,0,1,1,0,1,0,0,0,0,0,0,1,1,0,0,0,0,0,0,0,4,3,1
483045,20000,200,0,2,25,13,12,0,0,0,0,0,0,4,1,3,0,0,0,1,1,0,20,11,9,0,0,0,0,0,0,0,0,0
483124,20000,200,0,2,75,32,43,0,0,0,3,1,2,3,1,2,7,3,4,0,0,0,32,16,16,2,0,2,22,8,14,6,3,3
483212,20000,200,0,2,24,12,12,0,0,0,0,0,0,6,3,3,0,0,0,0,0,0,15,6,9,2,2,0,0,0,0,1,1,0
483595,20000,200,0,2,32,15,17,0,0,0,0,0,0,0,0,0,31,15,16,0,0,0,1,0,1,0,0,0,0,0,0,0,0,0
483647,20000,200,0,2,6,1,5,0,0,0,0,0,0,0,0,0,0,0,0,0,0,0,6,1,5,0,0,0,0,0,0,0,0,0
483975,20000,200,0,2,7,5,2,0,0,0,0,0,0,1,1,0,0,0,0,0,0,0,6,4,2,0,0,0,0,0,0,0,0,0
484002,20000,200,0,2,17,5,12,1,1,0,3,0,3,2,0,2,4,2,2,0,0,0,7,2,5,0,0,0,0,0,0,0,0,0
484066,20000,200,0,2,6,0,6,0,0,0,0,0,0,0,0,0,0,0,0,0,0,0,6,0,6,0,0,0,0,0,0,0,0,0
484613,20000,200,0,2,7,2,5,0,0,0,1,0,1,2,1,1,0,0,0,0,0,0,3,1,2,0,0,0,1,0,1,0,0,0
484844,20000,200,0,2,1,0,1,0,0,0,1,0,1,0,0,0,0,0,0,0,0,0,0,0,0,0,0,0,0,0,0,0,0,0
484905,20000,200,0,2,22,10,12,0,0,0,0,0,0,4,2,2,3,1,2,0,0,0,14,7,7,0,0,0,1,0,1,0,0,0
484932,20000,200,0,2,2,1,1,0,0,0,0,0,0,0,0,0,0,0,0,0,0,0,2,1,1,0,0,0,0,0,0,0,0,0
485111,20000,200,0,2,1,0,1,0,0,0,0,0,0,0,0,0,0,0,0,0,0,0,1,0,1,0,0,0,0,0,0,0,0,0
485272,20000,200,0,2,2,0,2,0,0,0,0,0,0,0,0,0,1,0,1,0,0,0,1,0,1,0,0,0,0,0,0,0,0,0
485458,20000,200,0,2,18,9,9,0,0,0,1,0,1,1,1,0,0,0,0,0,0,0,16,8,8,0,0,0,0,0,0,0,0,0
485519,20000,200,0,2,1,1,0,0,0,0,0,0,0,0,0,0,0,0,0,0,0,0,1,1,0,0,0,0,0,0,0,0,0,0
485546,20000,200,0,2,1,0,1,0,0,0,0,0,0,1,0,1,0,0,0,0,0,0,0,0,0,0,0,0,0,0,0,0,0,0
485698,20000,200,0,2,5,4,1,0,0,0,0,0,0,1,1,0,0,0,0,0,0,0,4,3,1,0,0,0,0,0,0,0,0,0
485768,20000,200,0,2,8,7,1,0,0,0,0,0,0,2,1,1,5,5,0,0,0,0,1,1,0,0,0,0,0,0,0,0,0,0
486053,20000,200,0,2,2,2,0,0,0,0,0,0,0,0,0,0,0,0,0,0,0,0,2,2,0,0,0,0,0,0,0,0,0,0
486424,20000,200,0,2,2,1,1,0,0,0,0,0,0,2,1,1,0,0,0,0,0,0,0,0,0,0,0,0,0,0,0,0,0,0
486813,20000,200,0,2,4,2,2,0,0,0,0,0,0,0,0,0,2,1,1,0,0,0,2,1,1,0,0,0,0,0,0,0,0,0
486822,20000,200,0,2,14,3,11,0,0,0,0,0,0,0,0,0,4,1,3,0,0,0,10,2,8,0,0,0,0,0,0,0,0,0
486840,20000,200,0,2,122,56,66,0,0,0,19,11,8,9,4,5,5,5,0,0,0,0,74,29,45,0,0,0,2,1,1,13,6,7
486901,20000,200,0,2,7,1,6,0,0,0,0,0,0,1,0,1,0,0,0,0,0,0,6,1,5,0,0,0,0,0,0,0,0,0
487010,20000,200,0,2,173,98,75,0,0,0,17,12,5,10,3,7,4,2,2,0,0,0,70,43,27,1,1,0,0,0,0,71,37,34
487092,20000,200,0,2,1,0,1,0,0,0,0,0,0,1,0,1,0,0,0,0,0,0,0,0,0,0,0,0,0,0,0,0,0,0
487162,20000,200,0,2,18,9,9,0,0,0,0,0,0,4,3,1,0,0,0,0,0,0,14,6,8,0,0,0,0,0,0,0,0,0
487302,20000,200,0,2,2,0,2,0,0,0,0,0,0,0,0,0,0,0,0,0,0,0,2,0,2,0,0,0,0,0,0,0,0,0
487320,20000,200,0,2,63,54,9,0,0,0,1,1,0,1,0,1,19,15,4,0,0,0,41,38,3,0,0,0,1,0,1,0,0,0
487375,20000,200,0,2,12,5,7,1,1,0,2,1,1,2,0,2,1,1,0,0,0,0,5,2,3,1,0,1,0,0,0,0,0,0
487384,20000,200,0,2,1,1,0,0,0,0,0,0,0,0,0,0,0,0,0,0,0,0,0,0,0,1,1,0,0,0,0,0,0,0
487393,20000,200,0,2,8,2,6,0,0,0,0,0,0,4,1,3,1,1,0,0,0,0,0,0,0,2,0,2,1,0,1,0,0,0
487409,20000,200,0,2,3,0,3,0,0,0,0,0,0,0,0,0,3,0,3,0,0,0,0,0,0,0,0,0,0,0,0,0,0,0
487418,20000,200,0,2,6,3,3,0,0,0,0,0,0,1,0,1,2,1,1,0,0,0,2,1,1,0,0,0,1,1,0,0,0,0
487427,20000,200,0,2,5,1,4,0,0,0,0,0,0,2,1,1,1,0,1,0,0,0,1,0,1,1,0,1,0,0,0,0,0,0
487445,20000,200,0,2,4,1,3,0,0,0,0,0,0,1,0,1,1,1,0,0,0,0,0,0,0,2,0,2,0,0,0,0,0,0
487472,20000,200,0,2,11,4,7,0,0,0,1,1,0,4,1,3,5,2,3,0,0,0,1,0,1,0,0,0,0,0,0,0,0,0
487490,20000,200,0,2,3,1,2,0,0,0,0,0,0,1,0,1,1,0,1,0,0,0,0,0,0,0,0,0,1,1,0,0,0,0
487524,20000,200,0,2,7,3,4,0,0,0,1,1,0,0,0,0,0,0,0,0,0,0,6,2,4,0,0,0,0,0,0,0,0,0
487588,20000,200,0,2,2,0,2,0,0,0,0,0,0,2,0,2,0,0,0,0,0,0,0,0,0,0,0,0,0,0,0,0,0,0
487597,20000,200,0,2,15,15,0,0,0,0,0,0,0,0,0,0,7,7,0,1,1,0,7,7,0,0,0,0,0,0,0,0,0,0
487861,20000,200,0,2,3,1,2,0,0,0,0,0,0,0,0,0,0,0,0,0,0,0,3,1,2,0,0,0,0,0,0,0,0,0
487977,20000,200,0,2,4,0,4,0,0,0,0,0,0,1,0,1,0,0,0,0,0,0,3,0,3,0,0,0,0,0,0,0,0,0
488077,20000,200,0,2,1,0,1,0,0,0,1,0,1,0,0,0,0,0,0,0,0,0,0,0,0,0,0,0,0,0,0,0,0,0
488305,20000,200,0,2,1,1,0,0,0,0,0,0,0,0,0,0,0,0,0,0,0,0,1,1,0,0,0,0,0,0,0,0,0,0
488527,20000,200,0,2,12,5,7,0,0,0,2,0,2,0,0,0,1,1,0,0,0,0,8,3,5,0,0,0,1,1,0,0,0,0
488554,20000,200,0,2,3,2,1,0,0,0,0,0,0,0,0,0,0,0,0,0,0,0,3,2,1,0,0,0,0,0,0,0,0,0
488572,20000,200,0,2,11,5,6,0,0,0,5,3,2,1,0,1,0,0,0,0,0,0,4,1,3,1,1,0,0,0,0,0,0,0
488730,20000,200,0,2,1,1,0,0,0,0,0,0,0,0,0,0,0,0,0,0,0,0,1,1,0,0,0,0,0,0,0,0,0,0
488846,20000,200,0,2,1,0,1,0,0,0,1,0,1,0,0,0,0,0,0,0,0,0,0,0,0,0,0,0,0,0,0,0,0,0
489201,20000,200,0,2,8,4,4,0,0,0,1,0,1,1,1,0,1,0,1,0,0,0,4,3,1,0,0,0,1,0,1,0,0,0
489283,20000,200,0,2,9,4,5,0,0,0,0,0,0,0,0,0,7,3,4,0,0,0,2,1,1,0,0,0,0,0,0,0,0,0
489779,20000,200,0,2,6,3,3,0,0,0,0,0,0,2,1,1,0,0,0,0,0,0,3,1,2,0,0,0,1,1,0,0,0,0
489858,20000,200,0,2,5,2,3,0,0,0,3,1,2,0,0,0,0,0,0,0,0,0,2,1,1,0,0,0,0,0,0,0,0,0
489937,20000,200,0,2,12,8,4,0,0,0,6,5,1,1,0,1,0,0,0,0,0,0,5,3,2,0,0,0,0,0,0,0,0,0
490106,20000,200,0,2,1,0,1,0,0,0,1,0,1,0,0,0,0,0,0,0,0,0,0,0,0,0,0,0,0,0,0,0,0,0
490133,20000,200,0,2,4,3,1,0,0,0,0,0,0,0,0,0,0,0,0,0,0,0,1,1,0,0,0,0,3,2,1,0,0,0
490373,20000,200,0,2,21,5,16,0,0,0,1,1,0,1,0,1,0,0,0,0,0,0,11,1,10,2,1,1,2,1,1,4,1,3
490559,20000,200,0,2,2,1,1,0,0,0,0,0,0,1,0,1,0,0,0,0,0,0,1,1,0,0,0,0,0,0,0,0,0,0
490805,20000,200,0,2,8,3,5,0,0,0,0,0,0,1,0,1,0,0,0,0,0,0,4,1,3,0,0,0,0,0,0,3,2,1
490878,20000,200,0,2,2,0,2,0,0,0,0,0,0,0,0,0,1,0,1,0,0,0,1,0,1,0,0,0,0,0,0,0,0,0
490975,20000,200,0,2,2,1,1,0,0,0,1,1,0,0,0,0,1,0,1,0,0,0,0,0,0,0,0,0,0,0,0,0,0,0
491057,20000,200,0,2,2,2,0,0,0,0,0,0,0,0,0,0,0,0,0,0,0,0,2,2,0,0,0,0,0,0,0,0,0,0
491181,20000,200,0,2,3,0,3,0,0,0,0,0,0,0,0,0,0,0,0,0,0,0,3,0,3,0,0,0,0,0,0,0,0,0
491525,20000,200,0,2,1,1,0,0,0,0,0,0,0,0,0,0,0,0,0,0,0,0,1,1,0,0,0,0,0,0,0,0,0,0
491844,20000,200,0,2,7,3,4,6,2,4,0,0,0,0,0,0,0,0,0,0,0,0,1,1,0,0,0,0,0,0,0,0,0,0
492449,20000,200,0,2,3,1,2,0,0,0,0,0,0,0,0,0,3,1,2,0,0,0,0,0,0,0,0,0,0,0,0,0,0,0
492476,20000,200,0,2,1,0,1,0,0,0,0,0,0,0,0,0,1,0,1,0,0,0,0,0,0,0,0,0,0,0,0,0,0,0
492607,20000,200,0,2,1,0,1,0,0,0,0,0,0,0,0,0,0,0,0,0,0,0,1,0,1,0,0,0,0,0,0,0,0,0
492689,20000,200,0,2,52,28,24,0,0,0,9,4,5,3,0,3,10,6,4,0,0,0,24,15,9,0,0,0,0,0,0,6,3,3
492722,20000,200,0,2,6,0,6,0,0,0,0,0,0,1,0,1,3,0,3,0,0,0,1,0,1,1,0,1,0,0,0,0,0,0
493080,20000,200,0,2,1,1,0,0,0,0,0,0,0,0,0,0,0,0,0,0,0,0,0,0,0,1,1,0,0,0,0,0,0,0
493646,20000,200,0,2,7,0,7,0,0,0,0,0,0,0,0,0,0,0,0,0,0,0,7,0,7,0,0,0,0,0,0,0,0,0
494010,20000,200,0,2,1,0,1,0,0,0,0,0,0,0,0,0,0,0,0,0,0,0,1,0,1,0,0,0,0,0,0,0,0,0
494162,20000,200,0,2,8,1,7,0,0,0,1,0,1,4,0,4,0,0,0,0,0,0,3,1,2,0,0,0,0,0,0,0,0,0
494250,20000,200,0,2,9,1,8,0,0,0,0,0,0,2,0,2,0,0,0,0,0,0,7,1,6,0,0,0,0,0,0,0,0,0
494278,20000,200,0,2,2,1,1,0,0,0,0,0,0,0,0,0,2,1,1,0,0,0,0,0,0,0,0,0,0,0,0,0,0,0
494287,20000,200,0,2,8,0,8,0,0,0,0,0,0,0,0,0,8,0,8,0,0,0,0,0,0,0,0,0,0,0,0,0,0,0
494436,20000,200,0,2,4,0,4,0,0,0,0,0,0,0,0,0,0,0,0,0,0,0,4,0,4,0,0,0,0,0,0,0,0,0
494588,20000,200,0,2,2,1,1,0,0,0,0,0,0,0,0,0,0,0,0,0,0,0,1,1,0,1,0,1,0,0,0,0,0,0
494603,20000,200,0,2,3,3,0,0,0,0,0,0,0,0,0,0,0,0,0,0,0,0,3,3,0,0,0,0,0,0,0,0,0,0
494746,20000,200,0,2,3,2,1,0,0,0,0,0,0,0,0,0,0,0,0,1,1,0,0,0,0,0,0,0,2,1,1,0,0,0
494755,20000,200,0,2,1,0,1,0,0,0,0,0,0,0,0,0,0,0,0,0,0,0,1,0,1,0,0,0,0,0,0,0,0,0
494843,20000,200,0,2,4,0,4,0,0,0,1,0,1,3,0,3,0,0,0,0,0,0,0,0,0,0,0,0,0,0,0,0,0,0
494852,20000,200,0,2,10,4,6,0,0,0,0,0,0,1,0,1,0,0,0,0,0,0,9,4,5,0,0,0,0,0,0,0,0,0
494959,20000,200,0,2,1,1,0,0,0,0,0,0,0,1,1,0,0,0,0,0,0,0,0,0,0,0,0,0,0,0,0,0,0,0
495314,20000,200,0,2,2,0,2,0,0,0,2,0,2,0,0,0,0,0,0,0,0,0,0,0,0,0,0,0,0,0,0,0,0,0
495420,20000,200,0,2,2,0,2,0,0,0,1,0,1,0,0,0,0,0,0,0,0,0,1,0,1,0,0,0,0,0,0,0,0,0
495439,20000,200,0,2,4,1,3,0,0,0,0,0,0,2,0,2,2,1,1,0,0,0,0,0,0,0,0,0,0,0,0,0,0,0
495448,20000,200,0,2,5,1,4,0,0,0,0,0,0,0,0,0,0,0,0,0,0,0,4,0,4,1,1,0,0,0,0,0,0,0
495457,20000,200,0,2,2,0,2,0,0,0,0,0,0,0,0,0,1,0,1,0,0,0,1,0,1,0,0,0,0,0,0,0,0,0
495767,20000,200,0,2,546,305,241,0,0,0,87,52,35,32,16,16,29,16,13,0,0,0,246,122,124,10,5,5,14,9,5,128,85,43
496043,20000,200,0,2,1,1,0,0,0,0,1,1,0,0,0,0,0,0,0,0,0,0,0,0,0,0,0,0,0,0,0,0,0,0
496283,20000,200,0,2,3,2,1,0,0,0,0,0,0,0,0,0,0,0,0,0,0,0,3,2,1,0,0,0,0,0,0,0,0,0
496326,20000,200,0,2,7,1,6,0,0,0,1,1,0,0,0,0,0,0,0,0,0,0,6,0,6,0,0,0,0,0,0,0,0,0
496627,20000,200,0,2,5,3,2,0,0,0,1,1,0,0,0,0,0,0,0,0,0,0,4,2,2,0,0,0,0,0,0,0,0,0
496991,20000,200,0,2,7,0,7,0,0,0,0,0,0,6,0,6,0,0,0,0,0,0,0,0,0,1,0,1,0,0,0,0,0,0
497046,20000,200,0,2,2,1,1,0,0,0,0,0,0,0,0,0,1,0,1,0,0,0,1,1,0,0,0,0,0,0,0,0,0,0
497277,20000,200,0,2,3,0,3,0,0,0,0,0,0,0,0,0,0,0,0,0,0,0,2,0,2,1,0,1,0,0,0,0,0,0
497286,20000,200,0,2,3,3,0,0,0,0,0,0,0,0,0,0,1,1,0,0,0,0,2,2,0,0,0,0,0,0,0,0,0,0
100654,21000,210,0,-2,19,10,9,0,0,0,1,1,0,6,3,3,0,0,0,0,0,0,10,5,5,0,0,0,1,1,0,1,0,1
100663,21000,210,0,-2,177,102,75,1,1,0,23,19,4,15,6,9,4,2,2,0,0,0,99,47,52,4,3,1,0,0,0,31,24,7
100690,21000,210,0,-2,3,3,0,0,0,0,0,0,0,0,0,0,0,0,0,0,0,0,3,3,0,0,0,0,0,0,0,0,0,0
100706,21000,210,0,-2,22,6,16,0,0,0,2,1,1,1,0,1,2,0,2,0,0,0,16,4,12,0,0,0,0,0,0,1,1,0
100724,21000,210,0,-2,10,6,4,0,0,0,2,1,1,7,4,3,0,0,0,0,0,0,1,1,0,0,0,0,0,0,0,0,0,0
100751,21000,210,0,-2,146,71,75,0,0,0,12,8,4,11,3,8,3,1,2,0,0,0,86,43,43,3,1,2,1,0,1,30,15,15
100760,21000,210,0,-2,5,2,3,0,0,0,0,0,0,1,1,0,0,0,0,0,0,0,4,1,3,0,0,0,0,0,0,0,0,0
100812,21000,210,0,-2,6,4,2,0,0,0,3,2,1,0,0,0,0,0,0,0,0,0,3,2,1,0,0,0,0,0,0,0,0,0
100830,21000,210,0,-2,18,8,10,0,0,0,1,0,1,0,0,0,0,0,0,0,0,0,6,4,2,0,0,0,7,0,7,4,4,0
100858,21000,210,0,-2,74,38,36,0,0,0,3,1,2,5,0,5,0,0,0,1,1,0,46,25,21,1,1,0,0,0,0,18,10,8
100937,21000,210,0,-2,10,4,6,0,0,0,2,1,1,2,2,0,0,0,0,0,0,0,6,1,5,0,0,0,0,0,0,0,0,0
101028,21000,210,0,-2,2,0,2,0,0,0,0,0,0,0,0,0,0,0,0,0,0,0,2,0,2,0,0,0,0,0,0,0,0,0
101116,21000,210,0,-2,1,1,0,0,0,0,0,0,0,0,0,0,0,0,0,0,0,0,1,1,0,0,0,0,0,0,0,0,0,0
101143,21000,210,0,-2,8,7,1,0,0,0,1,1,0,1,1,0,0,0,0,0,0,0,6,5,1,0,0,0,0,0,0,0,0,0
101161,21000,210,0,-2,15,8,7,1,1,0,0,0,0,2,1,1,0,0,0,0,0,0,12,6,6,0,0,0,0,0,0,0,0,0
101189,21000,210,0,-2,15,4,11,1,0,1,0,0,0,2,1,1,0,0,0,0,0,0,12,3,9,0,0,0,0,0,0,0,0,0
101240,21000,210,0,-2,8,6,2,0,0,0,0,0,0,1,1,0,1,0,1,0,0,0,6,5,1,0,0,0,0,0,0,0,0,0
101286,21000,210,0,-2,10,5,5,0,0,0,0,0,0,0,0,0,0,0,0,0,0,0,10,5,5,0,0,0,0,0,0,0,0,0
101295,21000,210,0,-2,13,9,4,0,0,0,0,0,0,1,0,1,1,1,0,0,0,0,11,8,3,0,0,0,0,0,0,0,0,0
101301,21000,210,0,-2,5,2,3,0,0,0,0,0,0,2,0,2,0,0,0,0,0,0,1,1,0,0,0,0,2,1,1,0,0,0
101435,21000,210,0,-2,5,4,1,0,0,0,0,0,0,2,1,1,0,0,0,0,0,0,0,0,0,0,0,0,3,3,0,0,0,0
101462,21000,210,0,-2,4,0,4,0,0,0,0,0,0,3,0,3,0,0,0,0,0,0,1,0,1,0,0,0,0,0,0,0,0,0
101471,21000,210,0,-2,6,4,2,0,0,0,0,0,0,3,1,2,0,0,0,0,0,0,3,3,0,0,0,0,0,0,0,0,0,0
101480,21000,210,0,-2,37,13,24,0,0,0,2,1,1,3,1,2,1,0,1,0,0,0,27,9,18,0,0,0,0,0,0,4,2,2
101505,21000,210,0,-2,9,3,6,0,0,0,0,0,0,2,1,1,0,0,0,0,0,0,7,2,5,0,0,0,0,0,0,0,0,0
101514,21000,210,0,-2,10,2,8,0,0,0,0,0,0,0,0,0,0,0,0,0,0,0,10,2,8,0,0,0,0,0,0,0,0,0
101569,21000,210,0,-2,7,5,2,0,0,0,0,0,0,4,2,2,0,0,0,0,0,0,3,3,0,0,0,0,0,0,0,0,0,0
101587,21000,210,0,-2,8,2,6,0,0,0,1,0,1,0,0,0,0,0,0,0,0,0,2,0,2,0,0,0,3,0,3,2,2,0
101602,21000,210,0,-2,6,4,2,0,0,0,0,0,0,0,0,0,0,0,0,0,0,0,6,4,2,0,0,0,0,0,0,0,0,0
101648,21000,210,0,-2,2,2,0,0,0,0,0,0,0,0,0,0,0,0,0,0,0,0,2,2,0,0,0,0,0,0,0,0,0,0
101675,21000,210,0,-2,12,3,9,0,0,0,0,0,0,7,2,5,0,0,0,0,0,0,5,1,4,0,0,0,0,0,0,0,0,0
101693,21000,210,0,-2,4,2,2,0,0,0,0,0,0,0,0,0,0,0,0,0,0,0,4,2,2,0,0,0,0,0,0,0,0,0
101709,21000,210,0,-2,13,4,9,1,0,1,1,1,0,3,0,3,0,0,0,0,0,0,7,2,5,0,0,0,0,0,0,1,1,0
101736,21000,210,0,-2,2,1,1,0,0,0,0,0,0,1,0,1,0,0,0,0,0,0,1,1,0,0,0,0,0,0,0,0,0,0
101879,21000,210,0,-2,25,16,9,0,0,0,2,2,0,4,1,3,1,1,0,0,0,0,18,12,6,0,0,0,0,0,0,0,0,0
101897,21000,210,0,-2,2,2,0,0,0,0,0,0,0,0,0,0,0,0,0,0,0,0,2,2,0,0,0,0,0,0,0,0,0,0
101912,21000,210,0,-2,4,2,2,0,0,0,0,0,0,4,2,2,0,0,0,0,0,0,0,0,0,0,0,0,0,0,0,0,0,0
102030,21000,210,0,-2,4,1,3,0,0,0,0,0,0,1,0,1,0,0,0,0,0,0,2,1,1,0,0,0,1,0,1,0,0,0
102049,21000,210,0,-2,24,8,16,0,0,0,0,0,0,2,0,2,1,0,1,0,0,0,21,8,13,0,0,0,0,0,0,0,0,0
102067,21000,210,0,-2,14,4,10,0,0,0,0,0,0,6,3,3,0,0,0,0,0,0,8,1,7,0,0,0,0,0,0,0,0,0
102076,21000,210,0,-2,9,7,2,0,0,0,0,0,0,0,0,0,0,0,0,0,0,0,9,7,2,0,0,0,0,0,0,0,0,0
102094,21000,210,0,-2,73,42,31,0,0,0,14,10,4,4,1,3,1,0,1,0,0,0,50,31,19,3,0,3,1,0,1,0,0,0
102234,21000,210,0,-2,12,1,11,0,0,0,0,0,0,1,0,1,0,0,0,0,0,0,11,1,10,0,0,0,0,0,0,0,0,0
102270,21000,210,0,-2,5,2,3,0,0,0,0,0,0,5,2,3,0,0,0,0,0,0,0,0,0,0,0,0,0,0,0,0,0,0
102298,21000,210,0,-2,3,1,2,0,0,0,0,0,0,3,1,2,0,0,0,0,0,0,0,0,0,0,0,0,0,0,0,0,0,0
102313,21000,210,0,-2,4,1,3,0,0,0,0,0,0,4,1,3,0,0,0,0,0,0,0,0,0,0,0,0,0,0,0,0,0,0
102368,21000,210,0,-2,24,11,13,0,0,0,0,0,0,0,0,0,0,0,0,0,0,0,17,6,11,1,0,1,0,0,0,6,5,1
102377,21000,210,0,-2,2,1,1,0,0,0,0,0,0,1,0,1,0,0,0,0,0,0,1,1,0,0,0,0,0,0,0,0,0,0
102429,21000,210,0,-2,9,6,3,0,0,0,0,0,0,0,0,0,0,0,0,0,0,0,9,6,3,0,0,0,0,0,0,0,0,0
102553,21000,210,0,-2,25,9,16,1,0,1,1,0,1,0,0,0,0,0,0,0,0,0,19,7,12,1,0,1,2,2,0,1,0,1
102614,21000,210,0,-2,7,2,5,0,0,0,0,0,0,0,0,0,0,0,0,0,0,0,5,2,3,1,0,1,1,0,1,0,0,0
102632,21000,210,0,-2,6,2,4,0,0,0,1,0,1,0,0,0,0,0,0,0,0,0,5,2,3,0,0,0,0,0,0,0,0,0
102669,21000,210,0,-2,5,0,5,0,0,0,0,0,0,0,0,0,0,0,0,0,0,0,5,0,5,0,0,0,0,0,0,0,0,0
102845,21000,210,0,-2,29,13,16,1,0,1,1,0,1,5,2,3,3,1,2,0,0,0,19,10,9,0,0,0,0,0,0,0,0,0
103893,21000,210,0,-2,15,2,13,0,0,0,0,0,0,0,0,0,1,1,0,0,0,0,12,1,11,1,0,1,1,0,1,0,0,0
103909,21000,210,0,-2,7,3,4,0,0,0,0,0,0,0,0,0,1,0,1,0,0,0,5,2,3,0,0,0,1,1,0,0,0,0
103927,21000,210,0,-2,6,0,6,0,0,0,0,0,0,1,0,1,0,0,0,0,0,0,5,0,5,0,0,0,0,0,0,0,0,0
104090,21000,210,0,-2,8,2,6,0,0,0,0,0,0,0,0,0,0,0,0,0,0,0,7,2,5,1,0,1,0,0,0,0,0,0
104151,21000,210,0,-2,275,123,152,1,0,1,14,10,4,16,4,12,27,13,14,0,0,0,96,43,53,4,1,3,88,38,50,29,14,15
104160,21000,210,0,-2,14,6,8,0,0,0,1,0,1,0,0,0,3,1,2,0,0,0,6,4,2,0,0,0,4,1,3,0,0,0
104179,21000,210,0,-2,79,44,35,1,1,0,9,6,3,5,3,2,7,3,4,0,0,0,47,24,23,1,0,1,3,2,1,6,5,1
104346,21000,210,0,-2,3,3,0,0,0,0,0,0,0,1,1,0,0,0,0,0,0,0,2,2,0,0,0,0,0,0,0,0,0,0
104425,21000,210,0,-2,17,8,9,0,0,0,0,0,0,1,0,1,3,2,1,0,0,0,12,6,6,0,0,0,1,0,1,0,0,0
104577,21000,210,0,-2,3,2,1,0,0,0,0,0,0,0,0,0,0,0,0,0,0,0,3,2,1,0,0,0,0,0,0,0,0,0
104586,21000,210,0,-2,27,21,6,0,0,0,5,5,0,1,1,0,1,0,1,0,0,0,17,14,3,0,0,0,2,1,1,1,0,1
104708,21000,210,0,-2,16,7,9,0,0,0,0,0,0,0,0,0,1,0,1,0,0,0,14,6,8,1,1,0,0,0,0,0,0,0
104717,21000,210,0,-2,55,13,42,0,0,0,3,3,0,13,2,11,2,0,2,0,0,0,34,8,26,2,0,2,1,0,1,0,0,0
105145,21000,210,0,-2,10,3,7,0,0,0,0,0,0,0,0,0,1,1,0,0,0,0,9,2,7,0,0,0,0,0,0,0,0,0
105154,21000,210,0,-2,28,13,15,0,0,0,1,1,0,2,1,1,3,0,3,0,0,0,20,10,10,2,1,1,0,0,0,0,0,0
105206,21000,210,0,-2,6,1,5,0,0,0,1,0,1,0,0,0,0,0,0,0,0,0,3,0,3,1,0,1,1,1,0,0,0,0
105215,21000,210,0,-2,1,1,0,0,0,0,0,0,0,0,0,0,0,0,0,0,0,0,1,1,0,0,0,0,0,0,0,0,0,0
105297,21000,210,0,-2,4,4,0,3,3,0,0,0,0,0,0,0,0,0,0,0,0,0,1,1,0,0,0,0,0,0,0,0,0,0
105330,21000,210,0,-2,81,35,46,0,0,0,5,0,5,2,1,1,2,0,2,0,0,0,66,30,36,0,0,0,3,2,1,3,2,1
105428,21000,210,0,-2,8,2,6,0,0,0,1,1,0,0,0,0,1,0,1,0,0,0,5,1,4,0,0,0,1,0,1,0,0,0
105525,21000,210,0,-2,5,2,3,1,1,0,0,0,0,1,0,1,0,0,0,0,0,0,3,1,2,0,0,0,0,0,0,0,0,0
105534,21000,210,0,-2,12,5,7,0,0,0,0,0,0,0,0,0,4,0,4,0,0,0,5,2,3,3,3,0,0,0,0,0,0,0
105543,21000,210,0,-2,10,1,9,0,0,0,0,0,0,0,0,0,3,0,3,0,0,0,7,1,6,0,0,0,0,0,0,0,0,0
105589,21000,210,0,-2,3,1,2,0,0,0,0,0,0,1,0,1,0,0,0,0,0,0,1,1,0,0,0,0,1,0,1,0,0,0
105659,21000,210,0,-2,7,6,1,1,0,1,0,0,0,2,2,0,2,2,0,0,0,0,2,2,0,0,0,0,0,0,0,0,0,0
105668,21000,210,0,-2,4,0,4,0,0,0,0,0,0,0,0,0,0,0,0,0,0,0,4,0,4,0,0,0,0,0,0,0,0,0
105747,21000,210,0,-2,6,3,3,0,0,0,0,0,0,0,0,0,0,0,0,0,0,0,6,3,3,0,0,0,0,0,0,0,0,0
105792,21000,210,0,-2,1,1,0,0,0,0,0,0,0,0,0,0,0,0,0,0,0,0,1,1,0,0,0,0,0,0,0,0,0,0
105899,21000,210,0,-2,1,1,0,0,0,0,0,0,0,0,0,0,0,0,0,0,0,0,1,1,0,0,0,0,0,0,0,0,0,0
106041,21000,210,0,-2,9,9,0,0,0,0,1,1,0,0,0,0,4,4,0,0,0,0,4,4,0,0,0,0,0,0,0,0,0,0
106148,21000,210,0,-2,12,8,4,0,0,0,0,0,0,0,0,0,0,0,0,0,0,0,12,8,4,0,0,0,0,0,0,0,0,0
106245,21000,210,0,-2,19,8,11,0,0,0,0,0,0,2,1,1,0,0,0,0,0,0,13,5,8,0,0,0,3,1,2,1,1,0
106263,21000,210,0,-2,8,1,7,0,0,0,1,0,1,1,0,1,1,0,1,0,0,0,4,1,3,0,0,0,0,0,0,1,0,1
106306,21000,210,0,-2,1,1,0,0,0,0,0,0,0,1,1,0,0,0,0,0,0,0,0,0,0,0,0,0,0,0,0,0,0,0
106342,21000,210,0,-2,1,1,0,0,0,0,0,0,0,0,0,0,0,0,0,0,0,0,1,1,0,0,0,0,0,0,0,0,0,0
106397,21000,210,0,-2,91,44,47,0,0,0,3,2,1,7,4,3,7,4,3,0,0,0,52,23,29,0,0,0,8,3,5,14,8,6
106412,21000,210,0,-2,8,4,4,0,0,0,1,1,0,4,1,3,0,0,0,0,0,0,3,2,1,0,0,0,0,0,0,0,0,0
106449,21000,210,0,-2,15,8,7,0,0,0,0,0,0,0,0,0,0,0,0,0,0,0,14,7,7,1,1,0,0,0,0,0,0,0
106458,21000,210,0,-2,27,14,13,0,0,0,1,1,0,1,1,0,0,0,0,0,0,0,18,6,12,0,0,0,2,2,0,5,4,1
106467,21000,210,0,-2,16,7,9,0,0,0,6,2,4,0,0,0,0,0,0,0,0,0,9,5,4,0,0,0,1,0,1,0,0,0
106485,21000,210,0,-2,19,13,6,0,0,0,1,1,0,0,0,0,0,0,0,0,0,0,14,9,5,0,0,0,1,0,1,3,3,0
106546,21000,210,0,-2,11,1,10,0,0,0,0,0,0,0,0,0,0,0,0,0,0,0,11,1,10,0,0,0,0,0,0,0,0,0
106625,21000,210,0,-2,6,3,3,0,0,0,0,0,0,0,0,0,0,0,0,0,0,0,6,3,3,0,0,0,0,0,0,0,0,0
106704,21000,210,0,-2,31,15,16,0,0,0,1,1,0,4,2,2,0,0,0,0,0,0,23,11,12,1,1,0,0,0,0,2,0,2
106713,21000,210,0,-2,3,0,3,0,0,0,0,0,0,0,0,0,0,0,0,0,0,0,3,0,3,0,0,0,0,0,0,0,0,0
106795,21000,210,0,-2,6,2,4,0,0,0,0,0,0,0,0,0,0,0,0,0,0,0,6,2,4,0,0,0,0,0,0,0,0,0
106810,21000,210,0,-2,5,2,3,0,0,0,0,0,0,0,0,0,0,0,0,0,0,0,5,2,3,0,0,0,0,0,0,0,0,0
106883,21000,210,0,-2,5,2,3,0,0,0,0,0,0,0,0,0,0,0,0,0,0,0,5,2,3,0,0,0,0,0,0,0,0,0
106980,21000,210,0,-2,13,7,6,0,0,0,0,0,0,0,0,0,0,0,0,0,0,0,13,7,6,0,0,0,0,0,0,0,0,0
106999,21000,210,0,-2,5,2,3,0,0,0,0,0,0,0,0,0,0,0,0,0,0,0,5,2,3,0,0,0,0,0,0,0,0,0
107044,21000,210,0,-2,14,4,10,0,0,0,0,0,0,0,0,0,1,0,1,0,0,0,12,4,8,0,0,0,0,0,0,1,0,1
107071,21000,210,0,-2,7,4,3,0,0,0,0,0,0,1,0,1,0,0,0,0,0,0,6,4,2,0,0,0,0,0,0,0,0,0
107080,21000,210,0,-2,5,2,3,0,0,0,0,0,0,0,0,0,0,0,0,0,0,0,4,2,2,0,0,0,0,0,0,1,0,1
107141,21000,210,0,-2,4,1,3,0,0,0,0,0,0,0,0,0,0,0,0,0,0,0,3,1,2,0,0,0,1,0,1,0,0,0
107318,21000,210,0,-2,2,2,0,0,0,0,0,0,0,1,1,0,0,0,0,0,0,0,1,1,0,0,0,0,0,0,0,0,0,0
107327,21000,210,0,-2,2,1,1,0,0,0,0,0,0,0,0,0,0,0,0,0,0,0,2,1,1,0,0,0,0,0,0,0,0,0
107460,21000,210,0,-2,4,1,3,0,0,0,0,0,0,0,0,0,0,0,0,0,0,0,4,1,3,0,0,0,0,0,0,0,0,0
107512,21000,210,0,-2,10,5,5,0,0,0,0,0,0,0,0,0,0,0,0,0,0,0,10,5,5,0,0,0,0,0,0,0,0,0
107521,21000,210,0,-2,14,8,6,0,0,0,0,0,0,4,2,2,0,0,0,0,0,0,10,6,4,0,0,0,0,0,0,0,0,0
107549,21000,210,0,-2,7,4,3,0,0,0,0,0,0,0,0,0,0,0,0,0,0,0,7,4,3,0,0,0,0,0,0,0,0,0
107558,21000,210,0,-2,8,6,2,1,1,0,0,0,0,0,0,0,2,2,0,1,1,0,4,2,2,0,0,0,0,0,0,0,0,0
107585,21000,210,0,-2,5,3,2,0,0,0,0,0,0,0,0,0,0,0,0,0,0,0,5,3,2,0,0,0,0,0,0,0,0,0
107600,21000,210,0,-2,3,0,3,0,0,0,1,0,1,2,0,2,0,0,0,0,0,0,0,0,0,0,0,0,0,0,0,0,0,0
107619,21000,210,0,-2,4,0,4,0,0,0,0,0,0,1,0,1,0,0,0,0,0,0,3,0,3,0,0,0,0,0,0,0,0,0
107637,21000,210,0,-2,12,4,8,0,0,0,0,0,0,5,3,2,1,1,0,0,0,0,5,0,5,1,0,1,0,0,0,0,0,0
107664,21000,210,0,-2,9,7,2,0,0,0,0,0,0,2,1,1,0,0,0,0,0,0,6,5,1,0,0,0,1,1,0,0,0,0
107725,21000,210,0,-2,4,2,2,0,0,0,0,0,0,0,0,0,0,0,0,0,0,0,4,2,2,0,0,0,0,0,0,0,0,0
107743,21000,210,0,-2,1,0,1,0,0,0,0,0,0,0,0,0,0,0,0,0,0,0,1,0,1,0,0,0,0,0,0,0,0,0
107840,21000,210,0,-2,2,1,1,0,0,0,0,0,0,2,1,1,0,0,0,0,0,0,0,0,0,0,0,0,0,0,0,0,0,0
107974,21000,210,0,-2,4,1,3,0,0,0,0,0,0,2,1,1,0,0,0,0,0,0,2,0,2,0,0,0,0,0,0,0,0,0
107983,21000,210,0,-2,12,9,3,0,0,0,2,2,0,2,1,1,1,1,0,0,0,0,7,5,2,0,0,0,0,0,0,0,0,0
107992,21000,210,0,-2,12,6,6,0,0,0,0,0,0,2,0,2,0,0,0,0,0,0,10,6,4,0,0,0,0,0,0,0,0,0
108092,21000,210,0,-2,10,4,6,0,0,0,3,3,0,0,0,0,0,0,0,0,0,0,7,1,6,0,0,0,0,0,0,0,0,0
108232,21000,210,0,-2,2,2,0,0,0,0,0,0,0,0,0,0,0,0,0,0,0,0,2,2,0,0,0,0,0,0,0,0,0,0
108870,21000,210,0,-2,1,1,0,0,0,0,0,0,0,0,0,0,0,0,0,0,0,0,1,1,0,0,0,0,0,0,0,0,0,0
109040,21000,210,0,-2,15,5,10,0,0,0,2,1,1,2,1,1,6,0,6,0,0,0,5,3,2,0,0,0,0,0,0,0,0,0
109208,21000,210,0,-2,5,2,3,0,0,0,1,0,1,1,1,0,3,1,2,0,0,0,0,0,0,0,0,0,0,0,0,0,0,0
109350,21000,210,0,-2,8,5,3,0,0,0,0,0,0,0,0,0,1,1,0,0,0,0,5,3,2,1,1,0,1,0,1,0,0,0
109785,21000,210,0,-2,12,3,9,0,0,0,4,1,3,3,1,2,1,1,0,0,0,0,4,0,4,0,0,0,0,0,0,0,0,0
109819,21000,210,0,-2,8,2,6,0,0,0,1,0,1,0,0,0,0,0,0,0,0,0,7,2,5,0,0,0,0,0,0,0,0,0
110097,21000,210,0,-2,6,5,1,0,0,0,0,0,0,0,0,0,1,1,0,0,0,0,2,2,0,0,0,0,3,2,1,0,0,0
110219,21000,210,0,-2,3,0,3,0,0,0,0,0,0,1,0,1,0,0,0,0,0,0,2,0,2,0,0,0,0,0,0,0,0,0
110316,21000,210,0,-2,3,1,2,0,0,0,0,0,0,2,1,1,0,0,0,0,0,0,1,0,1,0,0,0,0,0,0,0,0,0
110361,21000,210,0,-2,34,12,22,0,0,0,3,2,1,4,1,3,8,2,6,0,0,0,19,7,12,0,0,0,0,0,0,0,0,0
110370,21000,210,0,-2,1,0,1,0,0,0,0,0,0,0,0,0,0,0,0,0,0,0,0,0,0,0,0,0,0,0,0,1,0,1
110404,21000,210,0,-2,21,13,8,0,0,0,3,0,3,1,1,0,2,2,0,0,0,0,4,1,3,2,1,1,0,0,0,9,8,1
110413,21000,210,0,-2,14,6,8,0,0,0,1,0,1,1,1,0,5,3,2,0,0,0,6,2,4,1,0,1,0,0,0,0,0,0
110422,21000,210,0,-2,34,21,13,0,0,0,3,3,0,2,2,0,4,2,2,0,0,0,11,5,6,0,0,0,0,0,0,14,9,5
110468,21000,210,0,-2,9,3,6,0,0,0,1,0,1,1,0,1,1,0,1,0,0,0,6,3,3,0,0,0,0,0,0,0,0,0
110486,21000,210,0,-2,12,4,8,0,0,0,1,0,1,0,0,0,4,2,2,0,0,0,3,1,2,2,1,1,1,0,1,1,0,1
110495,21000,210,0,-2,27,8,19,1,1,0,4,0,4,2,1,1,4,3,1,0,0,0,11,2,9,1,0,1,1,1,0,3,0,3
110510,21000,210,0,-2,28,14,14,0,0,0,4,2,2,2,1,1,4,2,2,0,0,0,16,8,8,0,0,0,2,1,1,0,0,0
110529,21000,210,0,-2,1,1,0,0,0,0,0,0,0,0,0,0,0,0,0,0,0,0,0,0,0,0,0,0,1,1,0,0,0,0
110538,21000,210,0,-2,21,14,7,0,0,0,0,0,0,3,1,2,0,0,0,0,0,0,12,7,5,0,0,0,1,1,0,5,5,0
110547,21000,210,0,-2,12,3,9,0,0,0,0,0,0,1,0,1,2,0,2,0,0,0,3,1,2,3,2,1,1,0,1,2,0,2
110556,21000,210,0,-2,25,8,17,0,0,0,6,4,2,1,0,1,5,1,4,0,0,0,8,2,6,0,0,0,2,0,2,3,1,2
110565,21000,210,0,-2,82,43,39,0,0,0,19,10,9,7,2,5,10,4,6,0,0,0,38,22,16,1,0,1,0,0,0,7,5,2
110574,21000,210,0,-2,11,5,6,0,0,0,1,1,0,1,1,0,1,0,1,0,0,0,3,1,2,0,0,0,3,2,1,2,0,2
110583,21000,210,0,-2,38,9,29,2,0,2,6,1,5,4,1,3,4,1,3,0,0,0,14,1,13,1,1,0,1,0,1,6,4,2
110592,21000,210,0,-2,13,6,7,0,0,0,6,4,2,0,0,0,3,1,2,0,0,0,3,0,3,0,0,0,1,1,0,0,0,0
110608,21000,210,0,-2,22,11,11,0,0,0,3,2,1,1,1,0,2,1,1,0,0,0,8,0,8,0,0,0,1,1,0,7,6,1
110617,21000,210,0,-2,29,17,12,1,0,1,4,2,2,5,4,1,2,1,1,0,0,0,8,5,3,0,0,0,6,3,3,3,2,1
110635,21000,210,0,-2,127,68,59,1,1,0,12,7,5,8,3,5,9,4,5,0,0,0,56,32,24,6,3,3,8,5,3,27,13,14
110644,21000,210,0,-2,216,100,116,0,0,0,29,8,21,10,5,5,24,8,16,0,0,0,95,45,50,3,1,2,11,3,8,44,30,14
110653,21000,210,0,-2,175,89,86,0,0,0,39,23,16,11,2,9,14,5,9,2,1,1,75,35,40,5,3,2,12,9,3,17,11,6
110662,21000,210,0,-2,396,211,185,0,0,0,112,51,61,11,6,5,32,21,11,1,0,1,146,85,61,9,5,4,23,10,13,62,33,29
110671,21000,210,0,-2,48,27,21,0,0,0,5,4,1,1,1,0,6,2,4,0,0,0,22,10,12,1,1,0,1,1,0,12,8,4
110680,21000,210,0,-2,238,112,126,1,0,1,35,14,21,7,1,6,21,13,8,0,0,0,102,43,59,4,0,4,8,4,4,60,37,23
110699,21000,210,0,-2,217,91,126,0,0,0,65,25,40,15,6,9,15,10,5,0,0,0,85,35,50,8,3,5,13,5,8,16,7,9
110705,21000,210,0,-2,57,33,24,0,0,0,9,2,7,1,0,1,4,2,2,0,0,0,20,12,8,1,0,1,2,1,1,20,16,4
110714,21000,210,0,-2,55,22,33,0,0,0,4,1,3,1,1,0,6,1,5,0,0,0,22,10,12,4,1,3,2,1,1,16,7,9
111081,21000,210,0,-2,8,4,4,0,0,0,2,1,1,1,1,0,0,0,0,0,0,0,3,1,2,0,0,0,0,0,0,2,1,1
111188,21000,210,0,-2,7,6,1,0,0,0,0,0,0,0,0,0,0,0,0,0,0,0,5,4,1,0,0,0,2,2,0,0,0,0
111391,21000,210,0,-2,5,3,2,0,0,0,0,0,0,1,1,0,1,1,0,0,0,0,3,1,2,0,0,0,0,0,0,0,0,0
111434,21000,210,0,-2,4,4,0,0,0,0,0,0,0,1,1,0,2,2,0,0,0,0,0,0,0,0,0,0,1,1,0,0,0,0
111461,21000,210,0,-2,4,2,2,0,0,0,0,0,0,1,1,0,0,0,0,0,0,0,3,1,2,0,0,0,0,0,0,0,0,0
111887,21000,210,0,-2,2,2,0,0,0,0,0,0,0,0,0,0,0,0,0,0,0,0,2,2,0,0,0,0,0,0,0,0,0,0
111896,21000,210,0,-2,3,1,2,0,0,0,0,0,0,0,0,0,0,0,0,0,0,0,2,0,2,0,0,0,1,1,0,0,0,0
111920,21000,210,0,-2,3,1,2,0,0,0,1,0,1,0,0,0,0,0,0,0,0,0,2,1,1,0,0,0,0,0,0,0,0,0
111939,21000,210,0,-2,17,7,10,0,0,0,2,1,1,1,0,1,4,1,3,0,0,0,10,5,5,0,0,0,0,0,0,0,0,0
111948,21000,210,0,-2,40,17,23,0,0,0,3,0,3,2,1,1,7,1,6,0,0,0,12,7,5,1,0,1,10,7,3,5,1,4
111966,21000,210,0,-2,7,2,5,0,0,0,2,1,1,2,0,2,0,0,0,0,0,0,1,0,1,0,0,0,2,1,1,0,0,0
112075,21000,210,0,-2,9,4,5,0,0,0,0,0,0,1,0,1,0,0,0,0,0,0,4,2,2,0,0,0,4,2,2,0,0,0
112127,21000,210,0,-2,1,0,1,0,0,0,1,0,1,0,0,0,0,0,0,0,0,0,0,0,0,0,0,0,0,0,0,0,0,0
112172,21000,210,0,-2,2,1,1,0,0,0,0,0,0,0,0,0,1,0,1,0,0,0,1,1,0,0,0,0,0,0,0,0,0,0
112251,21000,210,0,-2,4,3,1,0,0,0,0,0,0,0,0,0,1,0,1,0,0,0,0,0,0,0,0,0,3,3,0,0,0,0
112260,21000,210,0,-2,14,6,8,0,0,0,4,2,2,1,1,0,1,0,1,0,0,0,4,2,2,0,0,0,1,1,0,3,0,3
112394,21000,210,0,-2,1,1,0,0,0,0,0,0,0,0,0,0,0,0,0,0,0,0,1,1,0,0,0,0,0,0,0,0,0,0
112525,21000,210,0,-2,24,9,15,0,0,0,8,4,4,2,0,2,1,1,0,0,0,0,8,2,6,1,0,1,3,2,1,1,0,1
112561,21000,210,0,-2,24,11,13,0,0,0,0,0,0,1,0,1,2,0,2,0,0,0,19,10,9,2,1,1,0,0,0,0,0,0
112570,21000,210,0,-2,1,1,0,0,0,0,0,0,0,1,1,0,0,0,0,0,0,0,0,0,0,0,0,0,0,0,0,0,0,0
112686,21000,210,0,-2,8,4,4,0,0,0,1,0,1,4,1,3,2,2,0,0,0,0,1,1,0,0,0,0,0,0,0,0,0,0
112826,21000,210,0,-2,6,1,5,0,0,0,0,0,0,1,0,1,1,0,1,0,0,0,3,1,2,1,0,1,0,0,0,0,0,0
113111,21000,210,0,-2,3,2,1,0,0,0,1,0,1,0,0,0,0,0,0,0,0,0,1,1,0,0,0,0,1,1,0,0,0,0
113193,21000,210,0,-2,4,0,4,0,0,0,0,0,0,0,0,0,1,0,1,0,0,0,3,0,3,0,0,0,0,0,0,0,0,0
113236,21000,210,0,-2,3,2,1,0,0,0,0,0,0,2,1,1,0,0,0,0,0,0,1,1,0,0,0,0,0,0,0,0,0,0
113333,21000,210,0,-2,5,3,2,0,0,0,1,0,1,0,0,0,1,1,0,0,0,0,2,2,0,0,0,0,0,0,0,1,0,1
113573,21000,210,0,-2,25,8,17,0,0,0,0,0,0,5,0,5,9,5,4,0,0,0,8,3,5,0,0,0,2,0,2,1,0,1
113634,21000,210,0,-2,1,0,1,0,0,0,1,0,1,0,0,0,0,0,0,0,0,0,0,0,0,0,0,0,0,0,0,0,0,0
113698,21000,210,0,-2,8,4,4,0,0,0,0,0,0,0,0,0,0,0,0,0,0,0,4,3,1,0,0,0,3,1,2,1,0,1
113856,21000,210,0,-2,26,13,13,0,0,0,2,1,1,2,0,2,3,1,2,0,0,0,6,4,2,0,0,0,12,6,6,1,1,0
113980,21000,210,0,-2,1,1,0,0,0,0,1,1,0,0,0,0,0,0,0,0,0,0,0,0,0,0,0,0,0,0,0,0,0,0
114266,21000,210,0,-2,8,3,5,0,0,0,3,0,3,0,0,0,2,1,1,0,0,0,2,2,0,0,0,0,1,0,1,0,0,0
114433,21000,210,0,-2,7,2,5,0,0,0,0,0,0,0,0,0,2,1,1,0,0,0,5,1,4,0,0,0,0,0,0,0,0,0
114549,21000,210,0,-2,2,2,0,0,0,0,0,0,0,0,0,0,0,0,0,0,0,0,2,2,0,0,0,0,0,0,0,0,0,0
114716,21000,210,0,-2,6,1,5,0,0,0,1,0,1,0,0,0,2,0,2,0,0,0,3,1,2,0,0,0,0,0,0,0,0,0
114789,21000,210,0,-2,13,6,7,1,1,0,0,0,0,1,0,1,3,1,2,0,0,0,7,4,3,1,0,1,0,0,0,0,0,0
114813,21000,210,0,-2,12,5,7,1,1,0,2,1,1,1,0,1,2,0,2,0,0,0,6,3,3,0,0,0,0,0,0,0,0,0
114840,21000,210,0,-2,2,1,1,0,0,0,0,0,0,2,1,1,0,0,0,0,0,0,0,0,0,0,0,0,0,0,0,0,0,0
114859,21000,210,0,-2,2,0,2,0,0,0,0,0,0,1,0,1,1,0,1,0,0,0,0,0,0,0,0,0,0,0,0,0,0,0
114938,21000,210,0,-2,1,0,1,0,0,0,0,0,0,0,0,0,1,0,1,0,0,0,0,0,0,0,0,0,0,0,0,0,0,0
115001,21000,210,0,-2,2,1,1,0,0,0,0,0,0,0,0,0,1,1,0,0,0,0,1,0,1,0,0,0,0,0,0,0,0,0
115010,21000,210,0,-2,12,2,10,0,0,0,4,1,3,1,1,0,4,0,4,0,0,0,2,0,2,1,0,1,0,0,0,0,0,0
115083,21000,210,0,-2,3,0,3,0,0,0,0,0,0,0,0,0,0,0,0,0,0,0,3,0,3,0,0,0,0,0,0,0,0,0
115296,21000,210,0,-2,1,1,0,0,0,0,0,0,0,0,0,0,0,0,0,0,0,0,0,0,0,0,0,0,1,1,0,0,0,0
115393,21000,210,0,-2,3,2,1,0,0,0,0,0,0,0,0,0,1,1,0,0,0,0,0,0,0,0,0,0,2,1,1,0,0,0
115409,21000,210,0,-2,4,1,3,0,0,0,0,0,0,0,0,0,0,0,0,0,0,0,3,1,2,0,0,0,1,0,1,0,0,0
115728,21000,210,0,-2,2,1,1,0,0,0,1,1,0,1,0,1,0,0,0,0,0,0,0,0,0,0,0,0,0,0,0,0,0,0
115746,21000,210,0,-2,6,2,4,0,0,0,0,0,0,0,0,0,0,0,0,0,0,0,6,2,4,0,0,0,0,0,0,0,0,0
115755,21000,210,0,-2,14,8,6,0,0,0,1,1,0,0,0,0,1,0,1,0,0,0,9,4,5,0,0,0,3,3,0,0,0,0
115861,21000,210,0,-2,108,58,50,0,0,0,9,6,3,5,3,2,43,20,23,0,0,0,48,26,22,2,2,0,1,1,0,0,0,0
115931,21000,210,0,-2,7,5,2,0,0,0,0,0,0,2,1,1,3,2,1,0,0,0,2,2,0,0,0,0,0,0,0,0,0,0
116439,21000,210,0,-2,5,1,4,0,0,0,1,0,1,0,0,0,0,0,0,0,0,0,3,1,2,0,0,0,1,0,1,0,0,0
117052,21000,210,0,-2,2,1,1,0,0,0,0,0,0,0,0,0,0,0,0,0,0,0,1,1,0,0,0,0,1,0,1,0,0,0
117140,21000,210,0,-2,3,2,1,0,0,0,0,0,0,0,0,0,0,0,0,0,0,0,2,1,1,0,0,0,1,1,0,0,0,0
117168,21000,210,0,-2,1,0,1,0,0,0,1,0,1,0,0,0,0,0,0,0,0,0,0,0,0,0,0,0,0,0,0,0,0,0
117195,21000,210,0,-2,3,2,1,0,0,0,0,0,0,0,0,0,2,1,1,0,0,0,1,1,0,0,0,0,0,0,0,0,0,0
117247,21000,210,0,-2,9,2,7,0,0,0,3,0,3,0,0,0,3,2,1,0,0,0,0,0,0,0,0,0,3,0,3,0,0,0
117274,21000,210,0,-2,2,1,1,0,0,0,0,0,0,0,0,0,0,0,0,0,0,0,1,0,1,0,0,0,1,1,0,0,0,0
117557,21000,210,0,-2,1,1,0,0,0,0,0,0,0,0,0,0,0,0,0,0,0,0,1,1,0,0,0,0,0,0,0,0,0,0
117627,21000,210,0,-2,6,2,4,0,0,0,1,1,0,0,0,0,1,0,1,2,1,1,2,0,2,0,0,0,0,0,0,0,0,0
117636,21000,210,0,-2,26,8,18,0,0,0,3,0,3,2,1,1,4,3,1,0,0,0,14,4,10,1,0,1,0,0,0,2,0,2
117672,21000,210,0,-2,1,0,1,0,0,0,0,0,0,0,0,0,0,0,0,0,0,0,0,0,0,1,0,1,0,0,0,0,0,0
117690,21000,210,0,-2,7,5,2,0,0,0,0,0,0,1,0,1,0,0,0,0,0,0,1,1,0,0,0,0,5,4,1,0,0,0
117706,21000,210,0,-2,32,17,15,0,0,0,6,4,2,3,2,1,1,0,1,0,0,0,18,7,11,0,0,0,4,4,0,0,0,0
117715,21000,210,0,-2,5,0,5,0,0,0,1,0,1,0,0,0,2,0,2,0,0,0,0,0,0,0,0,0,2,0,2,0,0,0
117724,21000,210,0,-2,17,12,5,0,0,0,1,1,0,1,1,0,4,3,1,0,0,0,4,3,1,0,0,0,7,4,3,0,0,0
117733,21000,210,0,-2,23,10,13,0,0,0,1,0,1,1,1,0,3,2,1,0,0,0,14,5,9,2,1,1,2,1,1,0,0,0
117751,21000,210,0,-2,3,1,2,0,0,0,0,0,0,1,0,1,0,0,0,0,0,0,2,1,1,0,0,0,0,0,0,0,0,0
117788,21000,210,0,-2,15,7,8,0,0,0,1,1,0,0,0,0,1,1,0,0,0,0,5,2,3,0,0,0,8,3,5,0,0,0
117867,21000,210,0,-2,13,7,6,0,0,0,2,1,1,0,0,0,3,3,0,0,0,0,7,2,5,0,0,0,1,1,0,0,0,0
117894,21000,210,0,-2,8,4,4,0,0,0,2,1,1,2,1,1,0,0,0,0,0,0,4,2,2,0,0,0,0,0,0,0,0,0
117946,21000,210,0,-2,26,9,17,0,0,0,2,1,1,5,3,2,1,0,1,0,0,0,9,1,8,0,0,0,9,4,5,0,0,0
118198,21000,210,0,-2,1,1,0,0,0,0,0,0,0,0,0,0,0,0,0,0,0,0,1,1,0,0,0,0,0,0,0,0,0,0
118347,21000,210,0,-2,3,2,1,0,0,0,0,0,0,0,0,0,0,0,0,0,0,0,1,1,0,0,0,0,2,1,1,0,0,0
118684,21000,210,0,-2,6,3,3,0,0,0,1,0,1,0,0,0,4,2,2,0,0,0,1,1,0,0,0,0,0,0,0,0,0,0
118693,21000,210,0,-2,4,2,2,0,0,0,0,0,0,0,0,0,0,0,0,0,0,0,3,2,1,0,0,0,1,0,1,0,0,0
118718,21000,210,0,-2,5,3,2,0,0,0,0,0,0,1,1,0,2,0,2,0,0,0,0,0,0,0,0,0,2,2,0,0,0,0
118912,21000,210,0,-2,3,2,1,0,0,0,1,1,0,0,0,0,0,0,0,0,0,0,1,1,0,0,0,0,0,0,0,1,0,1
118976,21000,210,0,-2,92,35,57,0,0,0,4,1,3,3,1,2,21,6,15,0,0,0,63,27,36,1,0,1,0,0,0,0,0,0
119058,21000,210,0,-2,1,0,1,0,0,0,0,0,0,0,0,0,0,0,0,0,0,0,1,0,1,0,0,0,0,0,0,0,0,0
119067,21000,210,0,-2,2,1,1,0,0,0,1,0,1,0,0,0,0,0,0,0,0,0,0,0,0,1,1,0,0,0,0,0,0,0
119137,21000,210,0,-2,8,5,3,0,0,0,1,1,0,0,0,0,0,0,0,0,0,0,4,1,3,0,0,0,0,0,0,3,3,0
119164,21000,210,0,-2,11,6,5,1,0,1,1,0,1,0,0,0,2,1,1,0,0,0,5,4,1,0,0,0,2,1,1,0,0,0
119173,21000,210,0,-2,8,2,6,0,0,0,2,0,2,0,0,0,2,1,1,0,0,0,4,1,3,0,0,0,0,0,0,0,0,0
119216,21000,210,0,-2,3,2,1,0,0,0,0,0,0,1,1,0,1,1,0,0,0,0,1,0,1,0,0,0,0,0,0,0,0,0
119270,21000,210,0,-2,1,0,1,0,0,0,0,0,0,0,0,0,0,0,0,1,0,1,0,0,0,0,0,0,0,0,0,0,0,0
119331,21000,210,0,-2,7,1,6,0,0,0,0,0,0,0,0,0,0,0,0,0,0,0,6,1,5,0,0,0,1,0,1,0,0,0
119605,21000,210,0,-2,7,3,4,0,0,0,0,0,0,1,1,0,0,0,0,0,0,0,4,2,2,0,0,0,2,0,2,0,0,0
119678,21000,210,0,-2,13,11,2,0,0,0,0,0,0,1,0,1,1,1,0,0,0,0,9,8,1,0,0,0,2,2,0,0,0,0
120078,21000,210,0,-2,16,3,13,0,0,0,2,1,1,2,0,2,8,0,8,0,0,0,2,2,0,1,0,1,1,0,1,0,0,0
120254,21000,210,0,-2,17,9,8,0,0,0,0,0,0,1,0,1,2,2,0,0,0,0,5,3,2,0,0,0,8,3,5,1,1,0
120290,21000,210,0,-2,7,2,5,0,0,0,1,0,1,2,0,2,2,1,1,0,0,0,2,1,1,0,0,0,0,0,0,0,0,0
120403,21000,210,0,-2,2,0,2,0,0,0,0,0,0,0,0,0,0,0,0,0,0,0,2,0,2,0,0,0,0,0,0,0,0,0
120421,21000,210,0,-2,10,4,6,0,0,0,2,1,1,0,0,0,3,1,2,0,0,0,4,2,2,0,0,0,1,0,1,0,0,0
120661,21000,210,0,-2,3,1,2,1,0,1,0,0,0,0,0,0,1,0,1,0,0,0,1,1,0,0,0,0,0,0,0,0,0,0
120698,21000,210,0,-2,2,1,1,0,0,0,0,0,0,0,0,0,0,0,0,0,0,0,2,1,1,0,0,0,0,0,0,0,0,0
120865,21000,210,0,-2,7,3,4,0,0,0,1,0,1,1,0,1,1,0,1,0,0,0,4,3,1,0,0,0,0,0,0,0,0,0
120883,21000,210,0,-2,35,15,20,0,0,0,6,1,5,4,0,4,4,1,3,0,0,0,18,11,7,1,1,0,2,1,1,0,0,0
120953,21000,210,0,-2,7,4,3,0,0,0,1,1,0,0,0,0,2,1,1,0,0,0,4,2,2,0,0,0,0,0,0,0,0,0
120971,21000,210,0,-2,2,1,1,0,0,0,0,0,0,0,0,0,1,0,1,0,0,0,1,1,0,0,0,0,0,0,0,0,0,0
121044,21000,210,0,-2,11,3,8,1,0,1,0,0,0,0,0,0,0,0,0,0,0,0,7,3,4,1,0,1,1,0,1,1,0,1
121150,21000,210,0,-2,40,16,24,0,0,0,3,3,0,4,2,2,6,3,3,0,0,0,26,7,19,0,0,0,0,0,0,1,1,0
121309,21000,210,0,-2,6,1,5,0,0,0,0,0,0,0,0,0,1,1,0,0,0,0,4,0,4,1,0,1,0,0,0,0,0,0
121345,21000,210,0,-2,18,8,10,0,0,0,2,1,1,5,3,2,4,2,2,0,0,0,5,2,3,0,0,0,2,0,2,0,0,0
121363,21000,210,0,-2,4,1,3,0,0,0,0,0,0,1,0,1,1,0,1,0,0,0,2,1,1,0,0,0,0,0,0,0,0,0
121619,21000,210,0,-2,1,0,1,0,0,0,0,0,0,0,0,0,0,0,0,0,0,0,0,0,0,0,0,0,1,0,1,0,0,0
121691,21000,210,0,-2,11,4,7,0,0,0,3,1,2,1,0,1,2,1,1,0,0,0,4,2,2,0,0,0,1,0,1,0,0,0
121707,21000,210,0,-2,4,2,2,0,0,0,0,0,0,0,0,0,0,0,0,0,0,0,4,2,2,0,0,0,0,0,0,0,0,0
121886,21000,210,0,-2,3,0,3,0,0,0,1,0,1,0,0,0,1,0,1,0,0,0,0,0,0,0,0,0,1,0,1,0,0,0
121901,21000,210,0,-2,8,2,6,0,0,0,1,0,1,0,0,0,5,2,3,0,0,0,2,0,2,0,0,0,0,0,0,0,0,0
122180,21000,210,0,-2,5,2,3,0,0,0,0,0,0,1,0,1,0,0,0,0,0,0,2,1,1,1,1,0,1,0,1,0,0,0
122205,21000,210,0,-2,5,2,3,0,0,0,2,1,1,0,0,0,0,0,0,0,0,0,3,1,2,0,0,0,0,0,0,0,0,0
122296,21000,210,0,-2,9,2,7,0,0,0,3,2,1,0,0,0,1,0,1,0,0,0,2,0,2,0,0,0,3,0,3,0,0,0
122384,21000,210,0,-2,1,0,1,0,0,0,0,0,0,0,0,0,1,0,1,0,0,0,0,0,0,0,0,0,0,0,0,0,0,0
122409,21000,210,0,-2,80,41,39,2,2,0,6,4,2,9,6,3,10,6,4,0,0,0,34,10,24,1,0,1,7,5,2,11,8,3
122436,21000,210,0,-2,3,0,3,0,0,0,0,0,0,0,0,0,0,0,0,0,0,0,2,0,2,0,0,0,0,0,0,1,0,1
122597,21000,210,0,-2,21,10,11,0,0,0,4,2,2,2,0,2,3,1,2,0,0,0,8,5,3,0,0,0,2,0,2,2,2,0
122612,21000,210,0,-2,15,4,11,0,0,0,1,0,1,3,1,2,2,0,2,0,0,0,8,2,6,0,0,0,1,1,0,0,0,0
122649,21000,210,0,-2,1,1,0,0,0,0,0,0,0,0,0,0,0,0,0,0,0,0,1,1,0,0,0,0,0,0,0,0,0,0
122685,21000,210,0,-2,7,2,5,0,0,0,0,0,0,1,0,1,2,2,0,0,0,0,3,0,3,1,0,1,0,0,0,0,0,0
122694,21000,210,0,-2,4,0,4,0,0,0,1,0,1,0,0,0,0,0,0,0,0,0,2,0,2,1,0,1,0,0,0,0,0,0
122728,21000,210,0,-2,2,2,0,0,0,0,1,1,0,0,0,0,0,0,0,0,0,0,1,1,0,0,0,0,0,0,0,0,0,0
122746,21000,210,0,-2,2,1,1,0,0,0,0,0,0,2,1,1,0,0,0,0,0,0,0,0,0,0,0,0,0,0,0,0,0,0
122755,21000,210,0,-2,68,32,36,1,1,0,13,7,6,7,2,5,8,6,2,0,0,0,22,6,16,1,0,1,2,1,1,14,9,5
122791,21000,210,0,-2,7,2,5,0,0,0,2,1,1,3,1,2,1,0,1,0,0,0,1,0,1,0,0,0,0,0,0,0,0,0
122931,21000,210,0,-2,49,25,24,0,0,0,6,4,2,8,2,6,3,1,2,0,0,0,22,14,8,0,0,0,0,0,0,10,4,6
122977,21000,210,0,-2,8,0,8,0,0,0,1,0,1,2,0,2,1,0,1,0,0,0,3,0,3,0,0,0,1,0,1,0,0,0
123013,21000,210,0,-2,11,5,6,0,0,0,0,0,0,2,2,0,2,1,1,0,0,0,6,1,5,0,0,0,1,1,0,0,0,0
123095,21000,210,0,-2,42,15,27,0,0,0,4,1,3,8,2,6,4,3,1,0,0,0,20,7,13,2,2,0,4,0,4,0,0,0
123217,21000,210,0,-2,1,1,0,0,0,0,0,0,0,0,0,0,0,0,0,0,0,0,0,0,0,1,1,0,0,0,0,0,0,0
123299,21000,210,0,-2,2,1,1,0,0,0,0,0,0,0,0,0,0,0,0,0,0,0,1,0,1,0,0,0,1,1,0,0,0,0
123341,21000,210,0,-2,4,1,3,0,0,0,0,0,0,0,0,0,2,0,2,0,0,0,2,1,1,0,0,0,0,0,0,0,0,0
123457,21000,210,0,-2,3,3,0,0,0,0,0,0,0,0,0,0,0,0,0,0,0,0,2,2,0,0,0,0,1,1,0,0,0,0
123484,21000,210,0,-2,4,2,2,0,0,0,0,0,0,1,0,1,0,0,0,0,0,0,3,2,1,0,0,0,0,0,0,0,0,0
123509,21000,210,0,-2,4,2,2,0,0,0,1,0,1,2,2,0,1,0,1,0,0,0,0,0,0,0,0,0,0,0,0,0,0,0
123527,21000,210,0,-2,6,3,3,0,0,0,0,0,0,1,0,1,4,3,1,0,0,0,1,0,1,0,0,0,0,0,0,0,0,0
123554,21000,210,0,-2,8,4,4,0,0,0,3,2,1,1,0,1,1,1,0,0,0,0,2,1,1,0,0,0,1,0,1,0,0,0
123563,21000,210,0,-2,1,0,1,0,0,0,0,0,0,1,0,1,0,0,0,0,0,0,0,0,0,0,0,0,0,0,0,0,0,0
123572,21000,210,0,-2,6,1,5,0,0,0,0,0,0,0,0,0,2,0,2,0,0,0,2,0,2,0,0,0,0,0,0,2,1,1
123633,21000,210,0,-2,2,1,1,0,0,0,0,0,0,0,0,0,0,0,0,0,0,0,2,1,1,0,0,0,0,0,0,0,0,0
123651,21000,210,0,-2,2,2,0,0,0,0,0,0,0,0,0,0,0,0,0,0,0,0,2,2,0,0,0,0,0,0,0,0,0,0
123679,21000,210,0,-2,10,2,8,0,0,0,2,0,2,0,0,0,3,1,2,0,0,0,3,0,3,1,0,1,1,1,0,0,0,0
123800,21000,210,0,-2,10,4,6,0,0,0,0,0,0,2,2,0,2,0,2,1,1,0,3,0,3,0,0,0,2,1,1,0,0,0
123943,21000,210,0,-2,3,1,2,0,0,0,2,0,2,0,0,0,0,0,0,0,0,0,1,1,0,0,0,0,0,0,0,0,0,0
123952,21000,210,0,-2,2,2,0,0,0,0,0,0,0,1,1,0,0,0,0,0,0,0,1,1,0,0,0,0,0,0,0,0,0,0
123961,21000,210,0,-2,84,50,34,1,0,1,16,8,8,10,4,6,2,1,1,0,0,0,34,24,10,3,1,2,3,2,1,15,10,5
123970,21000,210,0,-2,8,4,4,0,0,0,2,1,1,2,0,2,0,0,0,0,0,0,3,2,1,0,0,0,0,0,0,1,1,0
124113,21000,210,0,-2,1,0,1,0,0,0,0,0,0,0,0,0,0,0,0,0,0,0,1,0,1,0,0,0,0,0,0,0,0,0
124283,21000,210,0,-2,3,1,2,0,0,0,2,0,2,0,0,0,0,0,0,0,0,0,1,1,0,0,0,0,0,0,0,0,0,0
124292,21000,210,0,-2,1,1,0,0,0,0,0,0,0,0,0,0,0,0,0,0,0,0,1,1,0,0,0,0,0,0,0,0,0,0
124557,21000,210,0,-2,24,18,6,0,0,0,2,1,1,0,0,0,1,0,1,0,0,0,17,14,3,0,0,0,1,1,0,3,2,1
124706,21000,210,0,-2,4,1,3,0,0,0,0,0,0,0,0,0,1,0,1,0,0,0,1,0,1,1,0,1,1,1,0,0,0,0
124937,21000,210,0,-2,4,2,2,0,0,0,1,0,1,0,0,0,2,2,0,0,0,0,1,0,1,0,0,0,0,0,0,0,0,0
125028,21000,210,0,-2,8,4,4,0,0,0,1,0,1,0,0,0,1,1,0,0,0,0,4,2,2,0,0,0,2,1,1,0,0,0
125091,21000,210,0,-2,2,1,1,0,0,0,0,0,0,0,0,0,0,0,0,0,0,0,2,1,1,0,0,0,0,0,0,0,0,0
125231,21000,210,0,-2,14,5,9,0,0,0,0,0,0,9,3,6,1,0,1,0,0,0,2,1,1,1,0,1,1,1,0,0,0,0
125471,21000,210,0,-2,8,4,4,0,0,0,0,0,0,0,0,0,2,0,2,0,0,0,3,2,1,0,0,0,3,2,1,0,0,0
125532,21000,210,0,-2,8,0,8,1,0,1,1,0,1,2,0,2,0,0,0,1,0,1,3,0,3,0,0,0,0,0,0,0,0,0
125718,21000,210,0,-2,1,1,0,0,0,0,0,0,0,0,0,0,0,0,0,0,0,0,1,1,0,0,0,0,0,0,0,0,0,0
125727,21000,210,0,-2,8,6,2,0,0,0,1,1,0,2,1,1,0,0,0,0,0,0,1,1,0,0,0,0,4,3,1,0,0,0
125763,21000,210,0,-2,3,2,1,0,0,0,0,0,0,0,0,0,1,1,0,0,0,0,2,1,1,0,0,0,0,0,0,0,0,0
125897,21000,210,0,-2,2,2,0,0,0,0,0,0,0,0,0,0,0,0,0,0,0,0,2,2,0,0,0,0,0,0,0,0,0,0
126119,21000,210,0,-2,14,4,10,0,0,0,1,0,1,0,0,0,1,1,0,0,0,0,11,3,8,0,0,0,1,0,1,0,0,0
126182,21000,210,0,-2,5,4,1,0,0,0,0,0,0,0,0,0,0,0,0,0,0,0,4,3,1,0,0,0,0,0,0,1,1,0
126207,21000,210,0,-2,8,4,4,0,0,0,0,0,0,0,0,0,0,0,0,0,0,0,7,3,4,0,0,0,1,1,0,0,0,0
126289,21000,210,0,-2,9,5,4,0,0,0,0,0,0,0,0,0,0,0,0,0,0,0,8,4,4,0,0,0,1,1,0,0,0,0
126562,21000,210,0,-2,354,110,244,2,0,2,38,15,23,3,1,2,16,7,9,1,0,1,208,60,148,5,1,4,74,23,51,7,3,4
126580,21000,210,0,-2,25,10,15,0,0,0,4,4,0,0,0,0,1,0,1,0,0,0,16,4,12,0,0,0,1,0,1,3,2,1
126605,21000,210,0,-2,8,8,0,0,0,0,0,0,0,0,0,0,1,1,0,0,0,0,6,6,0,0,0,0,1,1,0,0,0,0
126614,21000,210,0,-2,45,23,22,0,0,0,6,3,3,6,3,3,5,3,2,0,0,0,11,4,7,0,0,0,4,3,1,13,7,6
126669,21000,210,0,-2,13,4,9,0,0,0,1,1,0,0,0,0,0,0,0,0,0,0,11,3,8,1,0,1,0,0,0,0,0,0
126678,21000,210,0,-2,10,5,5,0,0,0,1,0,1,0,0,0,3,2,1,0,0,0,2,0,2,2,1,1,0,0,0,2,2,0
126687,21000,210,0,-2,6,0,6,0,0,0,1,0,1,0,0,0,1,0,1,0,0,0,3,0,3,1,0,1,0,0,0,0,0,0
126711,21000,210,0,-2,8,2,6,0,0,0,0,0,0,0,0,0,1,1,0,0,0,0,7,1,6,0,0,0,0,0,0,0,0,0
126748,21000,210,0,-2,4,1,3,0,0,0,0,0,0,1,1,0,1,0,1,0,0,0,2,0,2,0,0,0,0,0,0,0,0,0
126775,21000,210,0,-2,27,15,12,0,0,0,2,2,0,0,0,0,2,2,0,0,0,0,13,7,6,0,0,0,7,1,6,3,3,0
126784,21000,210,0,-2,2,2,0,0,0,0,0,0,0,0,0,0,0,0,0,0,0,0,2,2,0,0,0,0,0,0,0,0,0,0
126818,21000,210,0,-2,47,27,20,0,0,0,1,0,1,0,0,0,1,1,0,0,0,0,28,13,15,1,1,0,15,11,4,1,1,0
126827,21000,210,0,-2,3,1,2,0,0,0,0,0,0,0,0,0,0,0,0,0,0,0,3,1,2,0,0,0,0,0,0,0,0,0
126863,21000,210,0,-2,9,4,5,1,1,0,2,0,2,0,0,0,0,0,0,0,0,0,5,2,3,0,0,0,0,0,0,1,1,0
126942,21000,210,0,-2,14,4,10,0,0,0,1,0,1,0,0,0,1,1,0,0,0,0,10,2,8,1,0,1,1,1,0,0,0,0
126951,21000,210,0,-2,17,15,2,0,0,0,0,0,0,1,1,0,0,0,0,0,0,0,16,14,2,0,0,0,0,0,0,0,0,0
126979,21000,210,0,-2,3,1,2,0,0,0,0,0,0,1,0,1,0,0,0,0,0,0,2,1,1,0,0,0,0,0,0,0,0,0
127060,21000,210,0,-2,57,22,35,6,0,6,2,1,1,6,2,4,5,1,4,0,0,0,21,9,12,10,5,5,3,3,0,4,1,3
127185,21000,210,0,-2,12,4,8,0,0,0,0,0,0,0,0,0,0,0,0,0,0,0,11,3,8,0,0,0,1,1,0,0,0,0
127200,21000,210,0,-2,12,3,9,0,0,0,2,1,1,1,0,1,1,0,1,0,0,0,8,2,6,0,0,0,0,0,0,0,0,0
127389,21000,210,0,-2,6,5,1,0,0,0,0,0,0,0,0,0,0,0,0,0,0,0,4,3,1,1,1,0,0,0,0,1,1,0
127556,21000,210,0,-2,32,12,20,0,0,0,0,0,0,0,0,0,1,0,1,0,0,0,27,9,18,0,0,0,1,0,1,3,3,0
127565,21000,210,0,-2,25,11,14,1,0,1,6,4,2,3,2,1,3,0,3,0,0,0,11,4,7,0,0,0,1,1,0,0,0,0
127617,21000,210,0,-2,3,3,0,0,0,0,0,0,0,0,0,0,1,1,0,0,0,0,2,2,0,0,0,0,0,0,0,0,0,0
127653,21000,210,0,-2,13,2,11,0,0,0,0,0,0,2,0,2,2,0,2,0,0,0,5,1,4,0,0,0,4,1,3,0,0,0
127732,21000,210,0,-2,8,3,5,0,0,0,0,0,0,0,0,0,0,0,0,0,0,0,8,3,5,0,0,0,0,0,0,0,0,0
127741,21000,210,0,-2,18,10,8,0,0,0,3,2,1,0,0,0,2,1,1,0,0,0,13,7,6,0,0,0,0,0,0,0,0,0
127778,21000,210,0,-2,3,0,3,1,0,1,0,0,0,0,0,0,1,0,1,0,0,0,1,0,1,0,0,0,0,0,0,0,0,0
127820,21000,210,0,-2,24,11,13,1,1,0,1,0,1,4,1,3,1,0,1,0,0,0,16,9,7,1,0,1,0,0,0,0,0,0
127884,21000,210,0,-2,8,2,6,1,0,1,1,1,0,0,0,0,1,0,1,0,0,0,5,1,4,0,0,0,0,0,0,0,0,0
127909,21000,210,0,-2,6,3,3,0,0,0,2,1,1,0,0,0,0,0,0,0,0,0,4,2,2,0,0,0,0,0,0,0,0,0
127918,21000,210,0,-2,19,6,13,0,0,0,0,0,0,2,0,2,2,0,2,0,0,0,12,5,7,1,1,0,2,0,2,0,0,0
127945,21000,210,0,-2,6,1,5,0,0,0,0,0,0,0,0,0,0,0,0,0,0,0,6,1,5,0,0,0,0,0,0,0,0,0
128106,21000,210,0,-2,18,9,9,0,0,0,5,2,3,0,0,0,2,1,1,0,0,0,10,5,5,0,0,0,1,1,0,0,0,0
128179,21000,210,0,-2,6,2,4,1,1,0,0,0,0,1,0,1,2,0,2,0,0,0,2,1,1,0,0,0,0,0,0,0,0,0
128188,21000,210,0,-2,15,5,10,0,0,0,0,0,0,0,0,0,3,1,2,0,0,0,8,3,5,0,0,0,4,1,3,0,0,0
128258,21000,210,0,-2,4,2,2,0,0,0,0,0,0,0,0,0,0,0,0,0,0,0,4,2,2,0,0,0,0,0,0,0,0,0
128328,21000,210,0,-2,53,31,22,0,0,0,1,0,1,0,0,0,0,0,0,0,0,0,43,26,17,0,0,0,9,5,4,0,0,0
128391,21000,210,0,-2,16,9,7,0,0,0,0,0,0,0,0,0,2,1,1,0,0,0,11,7,4,1,0,1,0,0,0,2,1,1
128498,21000,210,0,-2,5,1,4,0,0,0,1,0,1,1,1,0,2,0,2,0,0,0,1,0,1,0,0,0,0,0,0,0,0,0
128744,21000,210,0,-2,132,68,64,0,0,0,12,9,3,9,4,5,9,3,6,0,0,0,91,44,47,2,2,0,9,6,3,0,0,0
128771,21000,210,0,-2,14,9,5,0,0,0,2,2,0,0,0,0,1,1,0,0,0,0,7,4,3,1,0,1,0,0,0,3,2,1
128902,21000,210,0,-2,7,4,3,0,0,0,0,0,0,0,0,0,0,0,0,0,0,0,4,3,1,0,0,0,1,0,1,2,1,1
129020,21000,210,0,-2,145,54,91,0,0,0,21,8,13,10,2,8,8,3,5,0,0,0,67,22,45,6,2,4,8,3,5,25,14,11
129154,21000,210,0,-2,4,0,4,0,0,0,1,0,1,0,0,0,0,0,0,0,0,0,2,0,2,1,0,1,0,0,0,0,0,0
129215,21000,210,0,-2,3,1,2,0,0,0,1,0,1,0,0,0,0,0,0,0,0,0,2,1,1,0,0,0,0,0,0,0,0,0
129242,21000,210,0,-2,22,10,12,0,0,0,3,0,3,1,1,0,2,1,1,0,0,0,14,6,8,0,0,0,0,0,0,2,2,0
129525,21000,210,0,-2,35,17,18,0,0,0,0,0,0,2,2,0,3,2,1,0,0,0,17,7,10,1,0,1,2,1,1,10,5,5
129543,21000,210,0,-2,4,2,2,0,0,0,1,0,1,1,0,1,0,0,0,0,0,0,1,1,0,1,1,0,0,0,0,0,0,0
129695,21000,210,0,-2,3,0,3,0,0,0,0,0,0,0,0,0,0,0,0,1,0,1,2,0,2,0,0,0,0,0,0,0,0,0
129774,21000,210,0,-2,2,1,1,0,0,0,0,0,0,0,0,0,0,0,0,0,0,0,2,1,1,0,0,0,0,0,0,0,0,0
129941,21000,210,0,-2,26,11,15,0,0,0,9,4,5,1,0,1,1,0,1,0,0,0,15,7,8,0,0,0,0,0,0,0,0,0
130040,21000,210,0,-2,6,1,5,0,0,0,1,1,0,0,0,0,0,0,0,0,0,0,5,0,5,0,0,0,0,0,0,0,0,0
130110,21000,210,0,-2,6,2,4,0,0,0,1,0,1,0,0,0,0,0,0,0,0,0,5,2,3,0,0,0,0,0,0,0,0,0
130183,21000,210,0,-2,2,0,2,0,0,0,0,0,0,0,0,0,0,0,0,0,0,0,2,0,2,0,0,0,0,0,0,0,0,0
130217,21000,210,0,-2,2,2,0,0,0,0,0,0,0,1,1,0,0,0,0,0,0,0,1,1,0,0,0,0,0,0,0,0,0,0
130226,21000,210,0,-2,19,8,11,0,0,0,1,1,0,1,0,1,1,0,1,0,0,0,16,7,9,0,0,0,0,0,0,0,0,0
130253,21000,210,0,-2,40,12,28,0,0,0,4,2,2,3,0,3,4,0,4,0,0,0,22,8,14,1,0,1,4,1,3,2,1,1
130314,21000,210,0,-2,11,0,11,0,0,0,2,0,2,0,0,0,2,0,2,0,0,0,6,0,6,1,0,1,0,0,0,0,0,0
130396,21000,210,0,-2,1,0,1,0,0,0,0,0,0,0,0,0,1,0,1,0,0,0,0,0,0,0,0,0,0,0,0,0,0,0
130493,21000,210,0,-2,29,10,19,0,0,0,1,0,1,1,0,1,2,1,1,0,0,0,21,6,15,0,0,0,0,0,0,4,3,1
130590,21000,210,0,-2,24,10,14,0,0,0,4,1,3,6,2,4,3,1,2,0,0,0,9,6,3,1,0,1,0,0,0,1,0,1
130606,21000,210,0,-2,2,2,0,0,0,0,0,0,0,0,0,0,0,0,0,0,0,0,1,1,0,0,0,0,1,1,0,0,0,0
130624,21000,210,0,-2,42,28,14,0,0,0,0,0,0,3,2,1,1,1,0,0,0,0,38,25,13,0,0,0,0,0,0,0,0,0
130697,21000,210,0,-2,32,16,16,1,0,1,6,1,5,4,1,3,6,5,1,0,0,0,11,6,5,0,0,0,1,1,0,3,2,1
130776,21000,210,0,-2,1,0,1,0,0,0,0,0,0,0,0,0,0,0,0,0,0,0,0,0,0,1,0,1,0,0,0,0,0,0
130794,21000,210,0,-2,159,72,87,0,0,0,26,14,12,16,3,13,5,2,3,0,0,0,68,33,35,2,0,2,9,3,6,33,17,16
130907,21000,210,0,-2,21,6,15,1,0,1,0,0,0,6,3,3,0,0,0,0,0,0,14,3,11,0,0,0,0,0,0,0,0,0
130934,21000,210,0,-2,23,10,13,0,0,0,2,0,2,2,0,2,0,0,0,0,0,0,19,10,9,0,0,0,0,0,0,0,0,0
130943,21000,210,0,-2,35,22,13,0,0,0,3,2,1,3,2,1,3,3,0,0,0,0,19,10,9,1,1,0,0,0,0,6,4,2
131113,21000,210,0,-2,3,1,2,0,0,0,1,1,0,0,0,0,1,0,1,0,0,0,1,0,1,0,0,0,0,0,0,0,0,0
131159,21000,210,0,-2,56,19,37,0,0,0,9,4,5,13,5,8,1,1,0,0,0,0,28,7,21,0,0,0,2,2,0,3,0,3
131283,21000,210,0,-2,5,4,1,0,0,0,0,0,0,0,0,0,2,2,0,0,0,0,3,2,1,0,0,0,0,0,0,0,0,0
131399,21000,210,0,-2,6,3,3,0,0,0,2,1,1,1,0,1,0,0,0,0,0,0,2,1,1,0,0,0,1,1,0,0,0,0
131405,21000,210,0,-2,2,1,1,0,0,0,0,0,0,0,0,0,0,0,0,0,0,0,2,1,1,0,0,0,0,0,0,0,0,0
131450,21000,210,0,-2,11,6,5,0,0,0,4,2,2,1,1,0,2,2,0,0,0,0,3,1,2,1,0,1,0,0,0,0,0,0
131469,21000,210,0,-2,54,22,32,0,0,0,8,4,4,7,1,6,3,0,3,0,0,0,31,15,16,0,0,0,5,2,3,0,0,0
131496,21000,210,0,-2,56,29,27,0,0,0,3,1,2,6,3,3,2,0,2,0,0,0,26,13,13,0,0,0,5,2,3,14,10,4
131520,21000,210,0,-2,92,39,53,0,0,0,14,7,7,47,17,30,11,5,6,0,0,0,7,3,4,4,2,2,9,5,4,0,0,0
131803,21000,210,0,-2,11,8,3,0,0,0,3,2,1,2,1,1,0,0,0,0,0,0,3,3,0,0,0,0,3,2,1,0,0,0
131876,21000,210,0,-2,5,1,4,0,0,0,0,0,0,3,1,2,1,0,1,0,0,0,1,0,1,0,0,0,0,0,0,0,0,0
132408,21000,210,0,-2,1,0,1,0,0,0,0,0,0,0,0,0,0,0,0,0,0,0,1,0,1,0,0,0,0,0,0,0,0,0
132471,21000,210,0,-2,16,5,11,0,0,0,0,0,0,3,0,3,2,0,2,0,0,0,7,3,4,0,0,0,1,1,0,3,1,2
132602,21000,210,0,-2,8,5,3,0,0,0,1,1,0,5,3,2,0,0,0,0,0,0,2,1,1,0,0,0,0,0,0,0,0,0
132657,21000,210,0,-2,11,7,4,0,0,0,0,0,0,0,0,0,3,2,1,1,0,1,5,4,1,2,1,1,0,0,0,0,0,0
132693,21000,210,0,-2,14,2,12,0,0,0,0,0,0,3,1,2,2,0,2,0,0,0,9,1,8,0,0,0,0,0,0,0,0,0
132709,21000,210,0,-2,2,1,1,0,0,0,1,1,0,1,0,1,0,0,0,0,0,0,0,0,0,0,0,0,0,0,0,0,0,0
132842,21000,210,0,-2,4,2,2,0,0,0,0,0,0,0,0,0,4,2,2,0,0,0,0,0,0,0,0,0,0,0,0,0,0,0
132851,21000,210,0,-2,11,3,8,0,0,0,1,1,0,0,0,0,0,0,0,0,0,0,9,2,7,1,0,1,0,0,0,0,0,0
132879,21000,210,0,-2,1,0,1,0,0,0,0,0,0,0,0,0,0,0,0,0,0,0,1,0,1,0,0,0,0,0,0,0,0,0
132903,21000,210,0,-2,12,4,8,0,0,0,2,1,1,1,1,0,2,0,2,0,0,0,5,2,3,1,0,1,0,0,0,1,0,1
133021,21000,210,0,-2,1,0,1,0,0,0,0,0,0,0,0,0,0,0,0,0,0,0,1,0,1,0,0,0,0,0,0,0,0,0
133386,21000,210,0,-2,5,1,4,0,0,0,0,0,0,0,0,0,1,1,0,0,0,0,4,0,4,0,0,0,0,0,0,0,0,0
133465,21000,210,0,-2,8,2,6,0,0,0,0,0,0,4,0,4,1,0,1,0,0,0,2,1,1,0,0,0,1,1,0,0,0,0
133492,21000,210,0,-2,15,4,11,0,0,0,1,1,0,0,0,0,0,0,0,0,0,0,12,3,9,1,0,1,1,0,1,0,0,0
133508,21000,210,0,-2,7,2,5,0,0,0,0,0,0,1,1,0,0,0,0,0,0,0,5,1,4,0,0,0,1,0,1,0,0,0
133553,21000,210,0,-2,38,21,17,0,0,0,4,3,1,0,0,0,2,1,1,0,0,0,19,10,9,0,0,0,4,2,2,9,5,4
133650,21000,210,0,-2,45,24,21,0,0,0,4,3,1,30,14,16,1,1,0,0,0,0,7,4,3,0,0,0,0,0,0,3,2,1
133669,21000,210,0,-2,15,9,6,0,0,0,3,2,1,1,0,1,2,0,2,0,0,0,7,6,1,0,0,0,0,0,0,2,1,1
133702,21000,210,0,-2,13,6,7,0,0,0,1,1,0,3,1,2,0,0,0,0,0,0,9,4,5,0,0,0,0,0,0,0,0,0
133711,21000,210,0,-2,14,9,5,0,0,0,1,1,0,1,0,1,0,0,0,0,0,0,11,7,4,0,0,0,1,1,0,0,0,0
133809,21000,210,0,-2,9,3,6,0,0,0,0,0,0,0,0,0,0,0,0,0,0,0,9,3,6,0,0,0,0,0,0,0,0,0
133845,21000,210,0,-2,5,0,5,0,0,0,0,0,0,1,0,1,2,0,2,0,0,0,2,0,2,0,0,0,0,0,0,0,0,0
133854,21000,210,0,-2,1,1,0,0,0,0,0,0,0,1,1,0,0,0,0,0,0,0,0,0,0,0,0,0,0,0,0,0,0,0
133863,21000,210,0,-2,4,1,3,0,0,0,1,1,0,0,0,0,2,0,2,0,0,0,0,0,0,0,0,0,1,0,1,0,0,0
133872,21000,210,0,-2,6,0,6,0,0,0,0,0,0,1,0,1,3,0,3,0,0,0,2,0,2,0,0,0,0,0,0,0,0,0
133881,21000,210,0,-2,16,11,5,1,1,0,4,2,2,0,0,0,0,0,0,0,0,0,9,6,3,0,0,0,1,1,0,1,1,0
133951,21000,210,0,-2,168,87,81,1,1,0,16,11,5,16,5,11,36,16,20,0,0,0,82,42,40,0,0,0,0,0,0,17,12,5
133960,21000,210,0,-2,4,1,3,0,0,0,0,0,0,0,0,0,0,0,0,0,0,0,3,1,2,0,0,0,1,0,1,0,0,0
133979,21000,210,0,-2,5,1,4,0,0,0,0,0,0,4,1,3,0,0,0,0,0,0,1,0,1,0,0,0,0,0,0,0,0,0
134079,21000,210,0,-2,9,6,3,0,0,0,0,0,0,1,0,1,1,1,0,0,0,0,7,5,2,0,0,0,0,0,0,0,0,0
134097,21000,210,0,-2,87,44,43,0,0,0,2,1,1,6,5,1,5,3,2,0,0,0,59,29,30,2,1,1,1,0,1,12,5,7
134130,21000,210,0,-2,107,58,49,0,0,0,11,8,3,11,5,6,11,4,7,0,0,0,44,21,23,0,0,0,9,5,4,21,15,6
134237,21000,210,0,-2,24,19,5,0,0,0,1,1,0,2,1,1,5,3,2,0,0,0,15,13,2,1,1,0,0,0,0,0,0,0
134343,21000,210,0,-2,12,3,9,0,0,0,0,0,0,1,0,1,1,0,1,0,0,0,8,2,6,0,0,0,2,1,1,0,0,0
134495,21000,210,0,-2,5,2,3,0,0,0,0,0,0,0,0,0,0,0,0,0,0,0,5,2,3,0,0,0,0,0,0,0,0,0
134608,21000,210,0,-2,2,1,1,0,0,0,0,0,0,1,0,1,0,0,0,0,0,0,1,1,0,0,0,0,0,0,0,0,0,0
134945,21000,210,0,-2,16,3,13,0,0,0,2,1,1,5,1,4,0,0,0,0,0,0,9,1,8,0,0,0,0,0,0,0,0,0
135081,21000,210,0,-2,37,16,21,1,1,0,2,0,2,9,3,6,8,4,4,0,0,0,15,7,8,2,1,1,0,0,0,0,0,0
135160,21000,210,0,-2,10,2,8,0,0,0,0,0,0,1,0,1,0,0,0,0,0,0,9,2,7,0,0,0,0,0,0,0,0,0
135188,21000,210,0,-2,1,0,1,0,0,0,0,0,0,0,0,0,0,0,0,0,0,0,1,0,1,0,0,0,0,0,0,0,0,0
135391,21000,210,0,-2,8,2,6,0,0,0,0,0,0,1,1,0,0,0,0,0,0,0,7,1,6,0,0,0,0,0,0,0,0,0
135717,21000,210,0,-2,18,3,15,0,0,0,1,0,1,4,1,3,11,1,10,0,0,0,1,1,0,0,0,0,0,0,0,1,0,1
135726,21000,210,0,-2,57,36,21,0,0,0,3,3,0,8,4,4,9,6,3,0,0,0,23,13,10,2,1,1,4,2,2,8,7,1
136145,21000,210,0,-2,2,0,2,0,0,0,0,0,0,0,0,0,0,0,0,0,0,0,2,0,2,0,0,0,0,0,0,0,0,0
136172,21000,210,0,-2,39,16,23,0,0,0,5,3,2,5,1,4,1,0,1,1,0,1,20,8,12,1,0,1,0,0,0,6,4,2
136215,21000,210,0,-2,108,46,62,0,0,0,6,2,4,9,1,8,14,7,7,0,0,0,65,28,37,0,0,0,1,1,0,13,7,6
136233,21000,210,0,-2,15,7,8,0,0,0,0,0,0,1,0,1,3,2,1,0,0,0,9,4,5,1,1,0,0,0,0,1,0,1
136330,21000,210,0,-2,11,6,5,0,0,0,0,0,0,2,2,0,2,1,1,0,0,0,6,2,4,0,0,0,0,0,0,1,1,0
136358,21000,210,0,-2,3,1,2,1,0,1,0,0,0,1,0,1,0,0,0,0,0,0,1,1,0,0,0,0,0,0,0,0,0,0
136400,21000,210,0,-2,8,0,8,0,0,0,0,0,0,1,0,1,0,0,0,0,0,0,7,0,7,0,0,0,0,0,0,0,0,0
136473,21000,210,0,-2,15,9,6,0,0,0,0,0,0,0,0,0,0,0,0,0,0,0,14,9,5,1,0,1,0,0,0,0,0,0
136516,21000,210,0,-2,13,1,12,0,0,0,0,0,0,2,0,2,2,1,1,0,0,0,8,0,8,1,0,1,0,0,0,0,0,0
136701,21000,210,0,-2,4,4,0,0,0,0,1,1,0,0,0,0,1,1,0,0,0,0,1,1,0,0,0,0,0,0,0,1,1,0
136774,21000,210,0,-2,6,3,3,0,0,0,0,0,0,0,0,0,1,1,0,0,0,0,5,2,3,0,0,0,0,0,0,0,0,0
136950,21000,210,0,-2,32,12,20,0,0,0,1,0,1,2,1,1,2,1,1,0,0,0,20,8,12,0,0,0,1,0,1,6,2,4
137032,21000,210,0,-2,1,0,1,0,0,0,0,0,0,0,0,0,0,0,0,0,0,0,1,0,1,0,0,0,0,0,0,0,0,0
137078,21000,210,0,-2,15,0,15,0,0,0,0,0,0,2,0,2,1,0,1,0,0,0,10,0,10,0,0,0,2,0,2,0,0,0
137096,21000,210,0,-2,19,7,12,0,0,0,1,0,1,2,1,1,2,1,1,0,0,0,13,5,8,0,0,0,1,0,1,0,0,0
137209,21000,210,0,-2,6,3,3,0,0,0,2,2,0,0,0,0,0,0,0,0,0,0,4,1,3,0,0,0,0,0,0,0,0,0
137281,21000,210,0,-2,11,5,6,0,0,0,0,0,0,0,0,0,1,0,1,0,0,0,10,5,5,0,0,0,0,0,0,0,0,0
137315,21000,210,0,-2,9,3,6,0,0,0,0,0,0,1,0,1,0,0,0,0,0,0,7,3,4,0,0,0,1,0,1,0,0,0
137351,21000,210,0,-2,143,59,84,0,0,0,22,11,11,6,1,5,7,3,4,0,0,0,73,30,43,12,5,7,3,1,2,20,8,12
137476,21000,210,0,-2,16,9,7,0,0,0,0,0,0,1,1,0,5,2,3,0,0,0,10,6,4,0,0,0,0,0,0,0,0,0
137546,21000,210,0,-2,13,7,6,0,0,0,1,1,0,0,0,0,0,0,0,0,0,0,8,5,3,0,0,0,2,1,1,2,0,2
137564,21000,210,0,-2,6,3,3,0,0,0,0,0,0,0,0,0,0,0,0,0,0,0,6,3,3,0,0,0,0,0,0,0,0,0
137759,21000,210,0,-2,21,5,16,0,0,0,1,0,1,2,0,2,2,1,1,0,0,0,15,3,12,0,0,0,1,1,0,0,0,0
137801,21000,210,0,-2,3,0,3,0,0,0,0,0,0,0,0,0,0,0,0,0,0,0,2,0,2,1,0,1,0,0,0,0,0,0
137847,21000,210,0,-2,47,26,21,0,0,0,6,4,2,5,1,4,2,2,0,1,1,0,24,12,12,1,1,0,8,5,3,0,0,0
137962,21000,210,0,-2,1,1,0,0,0,0,0,0,0,0,0,0,0,0,0,0,0,0,1,1,0,0,0,0,0,0,0,0,0,0
138187,21000,210,0,-2,5,0,5,0,0,0,0,0,0,3,0,3,0,0,0,0,0,0,2,0,2,0,0,0,0,0,0,0,0,0
138275,21000,210,0,-2,4,2,2,0,0,0,0,0,0,2,0,2,0,0,0,0,0,0,2,2,0,0,0,0,0,0,0,0,0,0
138293,21000,210,0,-2,5,2,3,0,0,0,0,0,0,0,0,0,0,0,0,0,0,0,5,2,3,0,0,0,0,0,0,0,0,0
138309,21000,210,0,-2,35,5,30,0,0,0,0,0,0,8,0,8,0,0,0,0,0,0,26,5,21,1,0,1,0,0,0,0,0,0
138354,21000,210,0,-2,11,5,6,0,0,0,2,1,1,1,0,1,0,0,0,0,0,0,8,4,4,0,0,0,0,0,0,0,0,0
138558,21000,210,0,-2,9,3,6,0,0,0,0,0,0,1,0,1,0,0,0,0,0,0,8,3,5,0,0,0,0,0,0,0,0,0
138600,21000,210,0,-2,4,2,2,0,0,0,2,1,1,0,0,0,0,0,0,0,0,0,2,1,1,0,0,0,0,0,0,0,0,0
138682,21000,210,0,-2,18,8,10,0,0,0,2,1,1,12,4,8,0,0,0,0,0,0,3,2,1,0,0,0,1,1,0,0,0,0
138716,21000,210,0,-2,21,7,14,0,0,0,3,3,0,9,1,8,1,0,1,0,0,0,8,3,5,0,0,0,0,0,0,0,0,0
138761,21000,210,0,-2,4,2,2,0,0,0,0,0,0,1,1,0,0,0,0,0,0,0,3,1,2,0,0,0,0,0,0,0,0,0
138840,21000,210,0,-2,14,3,11,1,0,1,0,0,0,12,3,9,1,0,1,0,0,0,0,0,0,0,0,0,0,0,0,0,0,0
138868,21000,210,0,-2,4,3,1,0,0,0,0,0,0,0,0,0,0,0,0,0,0,0,4,3,1,0,0,0,0,0,0,0,0,0
138901,21000,210,0,-2,1,1,0,0,0,0,0,0,0,1,1,0,0,0,0,0,0,0,0,0,0,0,0,0,0,0,0,0,0,0
138929,21000,210,0,-2,3,1,2,0,0,0,0,0,0,0,0,0,0,0,0,0,0,0,3,1,2,0,0,0,0,0,0,0,0,0
138947,21000,210,0,-2,27,13,14,0,0,0,4,3,1,21,8,13,0,0,0,0,0,0,1,1,0,0,0,0,0,0,0,1,1,0
138956,21000,210,0,-2,16,7,9,0,0,0,0,0,0,7,2,5,2,1,1,0,0,0,7,4,3,0,0,0,0,0,0,0,0,0
139144,21000,210,0,-2,19,10,9,0,0,0,1,1,0,2,0,2,1,0,1,0,0,0,11,7,4,1,0,1,2,1,1,1,1,0
139199,21000,210,0,-2,20,4,16,0,0,0,3,2,1,2,0,2,1,0,1,0,0,0,14,2,12,0,0,0,0,0,0,0,0,0
139205,21000,210,0,-2,4,3,1,0,0,0,0,0,0,0,0,0,0,0,0,0,0,0,4,3,1,0,0,0,0,0,0,0,0,0
139250,21000,210,0,-2,10,6,4,0,0,0,0,0,0,2,2,0,2,2,0,0,0,0,6,2,4,0,0,0,0,0,0,0,0,0
139278,21000,210,0,-2,18,5,13,0,0,0,0,0,0,4,1,3,0,0,0,0,0,0,14,4,10,0,0,0,0,0,0,0,0,0
139311,21000,210,0,-2,13,4,9,0,0,0,1,0,1,4,0,4,0,0,0,0,0,0,8,4,4,0,0,0,0,0,0,0,0,0
139357,21000,210,0,-2,19,6,13,0,0,0,1,1,0,9,2,7,1,1,0,0,0,0,8,2,6,0,0,0,0,0,0,0,0,0
139366,21000,210,0,-2,17,10,7,0,0,0,2,1,1,4,2,2,0,0,0,0,0,0,10,6,4,0,0,0,1,1,0,0,0,0
139384,21000,210,0,-2,13,5,8,0,0,0,0,0,0,0,0,0,1,1,0,0,0,0,12,4,8,0,0,0,0,0,0,0,0,0
139393,21000,210,0,-2,2,1,1,0,0,0,0,0,0,0,0,0,1,0,1,0,0,0,1,1,0,0,0,0,0,0,0,0,0,0
139463,21000,210,0,-2,3,1,2,0,0,0,1,0,1,0,0,0,0,0,0,0,0,0,2,1,1,0,0,0,0,0,0,0,0,0
139579,21000,210,0,-2,5,2,3,0,0,0,0,0,0,2,1,1,0,0,0,0,0,0,3,1,2,0,0,0,0,0,0,0,0,0
139630,21000,210,0,-2,3,2,1,0,0,0,0,0,0,0,0,0,0,0,0,0,0,0,3,2,1,0,0,0,0,0,0,0,0,0
139658,21000,210,0,-2,62,19,43,1,0,1,17,4,13,10,4,6,3,1,2,0,0,0,24,8,16,0,0,0,0,0,0,7,2,5
139700,21000,210,0,-2,5,1,4,0,0,0,0,0,0,0,0,0,1,0,1,0,0,0,3,1,2,1,0,1,0,0,0,0,0,0
139719,21000,210,0,-2,11,3,8,0,0,0,0,0,0,8,1,7,1,1,0,0,0,0,2,1,1,0,0,0,0,0,0,0,0,0
139755,21000,210,0,-2,60,34,26,0,0,0,13,5,8,2,2,0,3,2,1,0,0,0,25,16,9,1,1,0,4,2,2,12,6,6
139764,21000,210,0,-2,6,1,5,0,0,0,0,0,0,0,0,0,0,0,0,0,0,0,6,1,5,0,0,0,0,0,0,0,0,0
139861,21000,210,0,-2,20,12,8,0,0,0,0,0,0,1,0,1,1,0,1,0,0,0,15,11,4,0,0,0,0,0,0,3,1,2
139931,21000,210,0,-2,65,25,40,0,0,0,10,4,6,6,0,6,5,2,3,0,0,0,40,16,24,1,1,0,3,2,1,0,0,0
139940,21000,210,0,-2,80,38,42,0,0,0,15,7,8,19,6,13,3,0,3,0,0,0,34,19,15,0,0,0,1,1,0,8,5,3
139959,21000,210,0,-2,83,45,38,0,0,0,13,9,4,7,5,2,6,2,4,0,0,0,32,19,13,2,1,1,5,1,4,18,8,10
139968,21000,210,0,-2,1,0,1,0,0,0,0,0,0,0,0,0,0,0,0,0,0,0,1,0,1,0,0,0,0,0,0,0,0,0
139986,21000,210,0,-2,11,5,6,0,0,0,1,1,0,2,0,2,1,1,0,0,0,0,7,3,4,0,0,0,0,0,0,0,0,0
140012,21000,210,0,-2,13,6,7,0,0,0,0,0,0,5,2,3,1,1,0,0,0,0,7,3,4,0,0,0,0,0,0,0,0,0
140146,21000,210,0,-2,2,1,1,0,0,0,0,0,0,1,0,1,1,1,0,0,0,0,0,0,0,0,0,0,0,0,0,0,0,0
140243,21000,210,0,-2,13,2,11,0,0,0,2,0,2,1,0,1,1,1,0,0,0,0,9,1,8,0,0,0,0,0,0,0,0,0
140252,21000,210,0,-2,7,4,3,0,0,0,0,0,0,0,0,0,0,0,0,0,0,0,7,4,3,0,0,0,0,0,0,0,0,0
140331,21000,210,0,-2,18,7,11,0,0,0,0,0,0,4,0,4,1,0,1,0,0,0,13,7,6,0,0,0,0,0,0,0,0,0
140447,21000,210,0,-2,56,27,29,0,0,0,8,5,3,11,0,11,1,0,1,0,0,0,33,20,13,0,0,0,0,0,0,3,2,1
140562,21000,210,0,-2,19,6,13,0,0,0,3,1,2,13,4,9,0,0,0,0,0,0,2,1,1,1,0,1,0,0,0,0,0,0
140678,21000,210,0,-2,11,6,5,0,0,0,0,0,0,0,0,0,0,0,0,0,0,0,11,6,5,0,0,0,0,0,0,0,0,0
140696,21000,210,0,-2,14,8,6,0,0,0,1,1,0,3,2,1,0,0,0,0,0,0,9,4,5,1,1,0,0,0,0,0,0,0
140720,21000,210,0,-2,2,1,1,0,0,0,0,0,0,2,1,1,0,0,0,0,0,0,0,0,0,0,0,0,0,0,0,0,0,0
140818,21000,210,0,-2,13,5,8,0,0,0,0,0,0,1,0,1,0,0,0,0,0,0,11,4,7,1,1,0,0,0,0,0,0,0
140872,21000,210,0,-2,6,4,2,0,0,0,1,1,0,1,0,1,0,0,0,0,0,0,4,3,1,0,0,0,0,0,0,0,0,0
140942,21000,210,0,-2,22,10,12,0,0,0,1,0,1,5,0,5,2,1,1,0,0,0,12,8,4,2,1,1,0,0,0,0,0,0
140951,21000,210,0,-2,78,39,39,0,0,0,4,2,2,10,2,8,2,2,0,0,0,0,47,24,23,4,2,2,6,3,3,5,4,1
140960,21000,210,0,-2,5,3,2,0,0,0,1,1,0,3,2,1,0,0,0,0,0,0,1,0,1,0,0,0,0,0,0,0,0,0
140988,21000,210,0,-2,8,4,4,0,0,0,0,0,0,0,0,0,0,0,0,0,0,0,8,4,4,0,0,0,0,0,0,0,0,0
141006,21000,210,0,-2,4,3,1,0,0,0,0,0,0,1,1,0,0,0,0,0,0,0,3,2,1,0,0,0,0,0,0,0,0,0
141060,21000,210,0,-2,25,10,15,0,0,0,4,1,3,12,3,9,3,2,1,0,0,0,6,4,2,0,0,0,0,0,0,0,0,0
141167,21000,210,0,-2,10,3,7,0,0,0,0,0,0,2,2,0,0,0,0,0,0,0,8,1,7,0,0,0,0,0,0,0,0,0
141185,21000,210,0,-2,2,2,0,0,0,0,0,0,0,0,0,0,0,0,0,0,0,0,2,2,0,0,0,0,0,0,0,0,0,0
141237,21000,210,0,-2,3,1,2,0,0,0,0,0,0,0,0,0,0,0,0,0,0,0,3,1,2,0,0,0,0,0,0,0,0,0
141255,21000,210,0,-2,24,7,17,0,0,0,0,0,0,3,1,2,0,0,0,0,0,0,21,6,15,0,0,0,0,0,0,0,0,0
141264,21000,210,0,-2,27,8,19,0,0,0,7,4,3,2,0,2,1,0,1,0,0,0,17,4,13,0,0,0,0,0,0,0,0,0
141325,21000,210,0,-2,2,1,1,0,0,0,0,0,0,2,1,1,0,0,0,0,0,0,0,0,0,0,0,0,0,0,0,0,0,0
141334,21000,210,0,-2,16,5,11,0,0,0,0,0,0,5,2,3,0,0,0,0,0,0,9,2,7,1,0,1,1,1,0,0,0,0
141361,21000,210,0,-2,3,2,1,0,0,0,0,0,0,0,0,0,0,0,0,0,0,0,1,1,0,0,0,0,2,1,1,0,0,0
141486,21000,210,0,-2,9,2,7,0,0,0,1,0,1,0,0,0,1,0,1,1,1,0,4,1,3,2,0,2,0,0,0,0,0,0
141565,21000,210,0,-2,1,0,1,0,0,0,0,0,0,1,0,1,0,0,0,0,0,0,0,0,0,0,0,0,0,0,0,0,0,0
141574,21000,210,0,-2,8,6,2,0,0,0,1,1,0,0,0,0,0,0,0,0,0,0,6,5,1,1,0,1,0,0,0,0,0,0
141644,21000,210,0,-2,17,3,14,0,0,0,3,0,3,1,0,1,2,0,2,2,1,1,9,2,7,0,0,0,0,0,0,0,0,0
141811,21000,210,0,-2,1,0,1,0,0,0,0,0,0,0,0,0,0,0,0,0,0,0,1,0,1,0,0,0,0,0,0,0,0,0
142054,21000,210,0,-2,10,0,10,0,0,0,0,0,0,0,0,0,1,0,1,0,0,0,7,0,7,1,0,1,1,0,1,0,0,0
142115,21000,210,0,-2,41,13,28,0,0,0,1,0,1,0,0,0,3,2,1,0,0,0,30,7,23,2,0,2,1,0,1,4,4,0
142179,21000,210,0,-2,4,2,2,0,0,0,0,0,0,0,0,0,0,0,0,0,0,0,4,2,2,0,0,0,0,0,0,0,0,0
142276,21000,210,0,-2,25,13,12,0,0,0,2,1,1,0,0,0,0,0,0,0,0,0,15,8,7,0,0,0,8,4,4,0,0,0
142285,21000,210,0,-2,14,6,8,0,0,0,1,0,1,1,0,1,0,0,0,0,0,0,7,5,2,0,0,0,3,0,3,2,1,1
142294,21000,210,0,-2,13,9,4,0,0,0,1,1,0,0,0,0,4,3,1,0,0,0,7,4,3,0,0,0,0,0,0,1,1,0
142328,21000,210,0,-2,6,0,6,0,0,0,0,0,0,0,0,0,0,0,0,0,0,0,5,0,5,1,0,1,0,0,0,0,0,0
142443,21000,210,0,-2,5,2,3,0,0,0,0,0,0,0,0,0,0,0,0,0,0,0,4,2,2,1,0,1,0,0,0,0,0,0
142461,21000,210,0,-2,11,3,8,0,0,0,1,0,1,0,0,0,0,0,0,0,0,0,7,2,5,0,0,0,3,1,2,0,0,0
142522,21000,210,0,-2,21,15,6,0,0,0,0,0,0,0,0,0,1,1,0,0,0,0,19,14,5,0,0,0,1,0,1,0,0,0
142559,21000,210,0,-2,17,6,11,0,0,0,0,0,0,0,0,0,1,0,1,0,0,0,13,4,9,1,1,0,2,1,1,0,0,0
142832,21000,210,0,-2,9,2,7,0,0,0,0,0,0,3,0,3,1,0,1,0,0,0,4,1,3,0,0,0,1,1,0,0,0,0
143048,21000,210,0,-2,3,0,3,0,0,0,0,0,0,1,0,1,0,0,0,0,0,0,0,0,0,1,0,1,0,0,0,1,0,1
143084,21000,210,0,-2,12,4,8,0,0,0,2,1,1,2,1,1,0,0,0,0,0,0,8,2,6,0,0,0,0,0,0,0,0,0
143118,21000,210,0,-2,19,4,15,0,0,0,1,1,0,3,0,3,1,0,1,0,0,0,14,3,11,0,0,0,0,0,0,0,0,0
143215,21000,210,0,-2,10,4,6,0,0,0,0,0,0,1,1,0,0,0,0,0,0,0,9,3,6,0,0,0,0,0,0,0,0,0
143279,21000,210,0,-2,6,3,3,0,0,0,0,0,0,0,0,0,0,0,0,0,0,0,3,1,2,0,0,0,3,2,1,0,0,0
143288,21000,210,0,-2,3,2,1,0,0,0,0,0,0,0,0,0,0,0,0,0,0,0,3,2,1,0,0,0,0,0,0,0,0,0
143297,21000,210,0,-2,1,0,1,0,0,0,0,0,0,0,0,0,0,0,0,0,0,0,1,0,1,0,0,0,0,0,0,0,0,0
143358,21000,210,0,-2,25,12,13,0,0,0,5,4,1,1,0,1,1,1,0,0,0,0,17,6,11,1,1,0,0,0,0,0,0,0
143613,21000,210,0,-2,1,0,1,0,0,0,0,0,0,0,0,0,0,0,0,0,0,0,1,0,1,0,0,0,0,0,0,0,0,0
143659,21000,210,0,-2,1,0,1,0,0,0,0,0,0,0,0,0,0,0,0,0,0,0,1,0,1,0,0,0,0,0,0,0,0,0
143853,21000,210,0,-2,11,5,6,0,0,0,3,1,2,0,0,0,0,0,0,0,0,0,6,3,3,0,0,0,2,1,1,0,0,0
143978,21000,210,0,-2,3,1,2,0,0,0,1,1,0,0,0,0,0,0,0,0,0,0,2,0,2,0,0,0,0,0,0,0,0,0
144005,21000,210,0,-2,9,8,1,0,0,0,0,0,0,3,3,0,0,0,0,0,0,0,2,2,0,0,0,0,4,3,1,0,0,0
144014,21000,210,0,-2,1,0,1,0,0,0,1,0,1,0,0,0,0,0,0,0,0,0,0,0,0,0,0,0,0,0,0,0,0,0
144050,21000,210,0,-2,209,113,96,0,0,0,30,12,18,9,5,4,6,2,4,0,0,0,98,55,43,4,1,3,16,10,6,46,28,18
144157,21000,210,0,-2,3,2,1,0,0,0,1,0,1,1,1,0,0,0,0,0,0,0,1,1,0,0,0,0,0,0,0,0,0,0
144166,21000,210,0,-2,9,2,7,0,0,0,0,0,0,7,1,6,2,1,1,0,0,0,0,0,0,0,0,0,0,0,0,0,0,0
144184,21000,210,0,-2,2,2,0,0,0,0,0,0,0,0,0,0,0,0,0,0,0,0,0,0,0,0,0,0,2,2,0,0,0,0
144193,21000,210,0,-2,2,1,1,0,0,0,1,0,1,0,0,0,0,0,0,0,0,0,0,0,0,1,1,0,0,0,0,0,0,0
144209,21000,210,0,-2,2,1,1,0,0,0,0,0,0,1,1,0,0,0,0,0,0,0,1,0,1,0,0,0,0,0,0,0,0,0
144218,21000,210,0,-2,1,1,0,0,0,0,0,0,0,0,0,0,0,0,0,0,0,0,1,1,0,0,0,0,0,0,0,0,0,0
144281,21000,210,0,-2,4,2,2,0,0,0,1,1,0,0,0,0,0,0,0,0,0,0,3,1,2,0,0,0,0,0,0,0,0,0
144351,21000,210,0,-2,5,2,3,0,0,0,0,0,0,0,0,0,0,0,0,0,0,0,5,2,3,0,0,0,0,0,0,0,0,0
144485,21000,210,0,-2,1,1,0,0,0,0,1,1,0,0,0,0,0,0,0,0,0,0,0,0,0,0,0,0,0,0,0,0,0,0
144564,21000,210,0,-2,2,0,2,0,0,0,0,0,0,0,0,0,0,0,0,0,0,0,2,0,2,0,0,0,0,0,0,0,0,0
144740,21000,210,0,-2,21,10,11,0,0,0,3,1,2,3,1,2,1,1,0,0,0,0,9,3,6,0,0,0,4,4,0,1,0,1
144865,21000,210,0,-2,7,2,5,0,0,0,0,0,0,0,0,0,1,1,0,0,0,0,6,1,5,0,0,0,0,0,0,0,0,0
144892,21000,210,0,-2,22,8,14,0,0,0,1,1,0,0,0,0,0,0,0,0,0,0,11,2,9,0,0,0,8,4,4,2,1,1
144944,21000,210,0,-2,12,6,6,0,0,0,1,0,1,1,1,0,1,1,0,0,0,0,8,3,5,1,1,0,0,0,0,0,0,0
144962,21000,210,0,-2,7,3,4,0,0,0,0,0,0,1,1,0,0,0,0,0,0,0,5,2,3,0,0,0,1,0,1,0,0,0
144971,21000,210,0,-2,3,2,1,0,0,0,0,0,0,0,0,0,0,0,0,0,0,0,3,2,1,0,0,0,0,0,0,0,0,0
145239,21000,210,0,-2,4,0,4,0,0,0,0,0,0,1,0,1,0,0,0,0,0,0,3,0,3,0,0,0,0,0,0,0,0,0
145275,21000,210,0,-2,4,1,3,0,0,0,0,0,0,1,0,1,2,1,1,0,0,0,1,0,1,0,0,0,0,0,0,0,0,0
145336,21000,210,0,-2,16,7,9,1,0,1,3,2,1,3,0,3,0,0,0,0,0,0,9,5,4,0,0,0,0,0,0,0,0,0
145372,21000,210,0,-2,5,0,5,0,0,0,1,0,1,2,0,2,0,0,0,0,0,0,2,0,2,0,0,0,0,0,0,0,0,0
145558,21000,210,0,-2,8,2,6,0,0,0,4,1,3,0,0,0,0,0,0,0,0,0,4,1,3,0,0,0,0,0,0,0,0,0
145600,21000,210,0,-2,98,42,56,0,0,0,24,12,12,12,6,6,7,1,6,0,0,0,42,15,27,2,0,2,1,1,0,10,7,3
145619,21000,210,0,-2,1,0,1,0,0,0,0,0,0,0,0,0,0,0,0,0,0,0,1,0,1,0,0,0,0,0,0,0,0,0
145628,21000,210,0,-2,1,1,0,0,0,0,0,0,0,1,1,0,0,0,0,0,0,0,0,0,0,0,0,0,0,0,0,0,0,0
145637,21000,210,0,-2,99,47,52,3,2,1,10,6,4,9,3,6,9,5,4,0,0,0,46,19,27,3,1,2,2,1,1,17,10,7
145646,21000,210,0,-2,5,2,3,0,0,0,0,0,0,1,0,1,0,0,0,0,0,0,3,1,2,0,0,0,0,0,0,1,1,0
145682,21000,210,0,-2,11,1,10,0,0,0,0,0,0,0,0,0,0,0,0,0,0,0,11,1,10,0,0,0,0,0,0,0,0,0
145691,21000,210,0,-2,4,0,4,0,0,0,1,0,1,0,0,0,0,0,0,0,0,0,3,0,3,0,0,0,0,0,0,0,0,0
145707,21000,210,0,-2,2,0,2,0,0,0,0,0,0,0,0,0,0,0,0,0,0,0,2,0,2,0,0,0,0,0,0,0,0,0
145725,21000,210,0,-2,17,12,5,0,0,0,2,2,0,1,1,0,0,0,0,0,0,0,3,2,1,0,0,0,8,4,4,3,3,0
145813,21000,210,0,-2,16,1,15,0,0,0,0,0,0,0,0,0,1,0,1,0,0,0,10,1,9,0,0,0,5,0,5,0,0,0
145831,21000,210,0,-2,6,0,6,0,0,0,0,0,0,0,0,0,0,0,0,0,0,0,6,0,6,0,0,0,0,0,0,0,0,0
146205,21000,210,0,-2,5,3,2,0,0,0,0,0,0,0,0,0,0,0,0,0,0,0,5,3,2,0,0,0,0,0,0,0,0,0
146278,21000,210,0,-2,2,1,1,0,0,0,0,0,0,0,0,0,0,0,0,0,0,0,2,1,1,0,0,0,0,0,0,0,0,0
146296,21000,210,0,-2,7,2,5,0,0,0,0,0,0,1,0,1,0,0,0,0,0,0,2,0,2,0,0,0,4,2,2,0,0,0
146339,21000,210,0,-2,4,3,1,0,0,0,0,0,0,0,0,0,1,1,0,0,0,0,1,1,0,0,0,0,0,0,0,2,1,1
146348,21000,210,0,-2,3,2,1,0,0,0,0,0,0,0,0,0,0,0,0,0,0,0,2,1,1,0,0,0,1,1,0,0,0,0
146366,21000,210,0,-2,3,1,2,0,0,0,0,0,0,0,0,0,0,0,0,0,0,0,3,1,2,0,0,0,0,0,0,0,0,0
146418,21000,210,0,-2,3,0,3,0,0,0,0,0,0,0,0,0,0,0,0,0,0,0,3,0,3,0,0,0,0,0,0,0,0,0
146427,21000,210,0,-2,3,1,2,0,0,0,0,0,0,0,0,0,0,0,0,0,0,0,1,0,1,0,0,0,1,0,1,1,1,0
146472,21000,210,0,-2,17,11,6,0,0,0,2,1,1,2,2,0,3,3,0,0,0,0,9,4,5,1,1,0,0,0,0,0,0,0
146481,21000,210,0,-2,4,2,2,0,0,0,0,0,0,1,1,0,0,0,0,0,0,0,2,1,1,0,0,0,0,0,0,1,0,1
146506,21000,210,0,-2,3,3,0,0,0,0,0,0,0,0,0,0,0,0,0,0,0,0,3,3,0,0,0,0,0,0,0,0,0,0
146533,21000,210,0,-2,2,0,2,0,0,0,0,0,0,0,0,0,0,0,0,0,0,0,2,0,2,0,0,0,0,0,0,0,0,0
146603,21000,210,0,-2,1,0,1,0,0,0,0,0,0,0,0,0,0,0,0,0,0,0,1,0,1,0,0,0,0,0,0,0,0,0
146612,21000,210,0,-2,15,3,12,0,0,0,0,0,0,0,0,0,0,0,0,0,0,0,13,3,10,0,0,0,2,0,2,0,0,0
146667,21000,210,0,-2,1,1,0,0,0,0,0,0,0,0,0,0,0,0,0,0,0,0,1,1,0,0,0,0,0,0,0,0,0,0
146676,21000,210,0,-2,5,4,1,0,0,0,0,0,0,0,0,0,0,0,0,0,0,0,5,4,1,0,0,0,0,0,0,0,0,0
146685,21000,210,0,-2,10,4,6,0,0,0,1,1,0,0,0,0,0,0,0,0,0,0,9,3,6,0,0,0,0,0,0,0,0,0
146700,21000,210,0,-2,8,7,1,0,0,0,0,0,0,2,1,1,1,1,0,0,0,0,5,5,0,0,0,0,0,0,0,0,0,0
146719,21000,210,0,-2,86,44,42,0,0,0,6,3,3,9,4,5,14,8,6,0,0,0,38,21,17,2,1,1,4,1,3,13,6,7
146728,21000,210,0,-2,1,1,0,0,0,0,0,0,0,0,0,0,1,1,0,0,0,0,0,0,0,0,0,0,0,0,0,0,0,0
146755,21000,210,0,-2,5,1,4,0,0,0,0,0,0,0,0,0,0,0,0,0,0,0,5,1,4,0,0,0,0,0,0,0,0,0
146816,21000,210,0,-2,1,1,0,0,0,0,0,0,0,0,0,0,0,0,0,0,0,0,1,1,0,0,0,0,0,0,0,0,0,0
147004,21000,210,0,-2,5,1,4,0,0,0,0,0,0,0,0,0,0,0,0,0,0,0,5,1,4,0,0,0,0,0,0,0,0,0
147013,21000,210,0,-2,7,2,5,1,0,1,0,0,0,0,0,0,0,0,0,0,0,0,6,2,4,0,0,0,0,0,0,0,0,0
147129,21000,210,0,-2,2,0,2,0,0,0,0,0,0,0,0,0,0,0,0,0,0,0,2,0,2,0,0,0,0,0,0,0,0,0
147244,21000,210,0,-2,15,5,10,0,0,0,1,1,0,1,0,1,0,0,0,0,0,0,12,4,8,0,0,0,0,0,0,1,0,1
147341,21000,210,0,-2,1,1,0,0,0,0,0,0,0,0,0,0,0,0,0,0,0,0,0,0,0,0,0,0,0,0,0,1,1,0
147369,21000,210,0,-2,2,1,1,0,0,0,0,0,0,0,0,0,0,0,0,0,0,0,2,1,1,0,0,0,0,0,0,0,0,0
147378,21000,210,0,-2,4,1,3,0,0,0,1,0,1,0,0,0,1,1,0,0,0,0,2,0,2,0,0,0,0,0,0,0,0,0
147411,21000,210,0,-2,2,0,2,0,0,0,0,0,0,0,0,0,1,0,1,0,0,0,1,0,1,0,0,0,0,0,0,0,0,0
147536,21000,210,0,-2,24,2,22,0,0,0,0,0,0,6,1,5,4,0,4,0,0,0,10,1,9,1,0,1,0,0,0,3,0,3
147660,21000,210,0,-2,10,5,5,0,0,0,1,1,0,0,0,0,0,0,0,0,0,0,6,3,3,0,0,0,1,0,1,2,1,1
147679,21000,210,0,-2,4,2,2,0,0,0,2,1,1,0,0,0,1,1,0,0,0,0,1,0,1,0,0,0,0,0,0,0,0,0
147697,21000,210,0,-2,2,0,2,0,0,0,0,0,0,0,0,0,0,0,0,0,0,0,2,0,2,0,0,0,0,0,0,0,0,0
147703,21000,210,0,-2,16,8,8,0,0,0,1,1,0,2,1,1,0,0,0,0,0,0,6,4,2,0,0,0,0,0,0,7,2,5
147767,21000,210,0,-2,94,52,42,0,0,0,18,10,8,11,5,6,9,6,3,0,0,0,33,19,14,1,0,1,1,0,1,21,12,9
147776,21000,210,0,-2,8,4,4,0,0,0,3,1,2,0,0,0,0,0,0,0,0,0,2,1,1,0,0,0,3,2,1,0,0,0
147800,21000,210,0,-2,5,3,2,0,0,0,0,0,0,0,0,0,1,1,0,0,0,0,1,1,0,0,0,0,3,1,2,0,0,0
147828,21000,210,0,-2,6,3,3,0,0,0,0,0,0,0,0,0,0,0,0,0,0,0,6,3,3,0,0,0,0,0,0,0,0,0
147916,21000,210,0,-2,4,3,1,0,0,0,0,0,0,1,1,0,0,0,0,0,0,0,2,1,1,0,0,0,1,1,0,0,0,0
148007,21000,210,0,-2,2,0,2,0,0,0,0,0,0,2,0,2,0,0,0,0,0,0,0,0,0,0,0,0,0,0,0,0,0,0
148016,21000,210,0,-2,4,2,2,0,0,0,0,0,0,0,0,0,0,0,0,0,0,0,2,0,2,0,0,0,2,2,0,0,0,0
148131,21000,210,0,-2,3,2,1,0,0,0,0,0,0,0,0,0,0,0,0,0,0,0,3,2,1,0,0,0,0,0,0,0,0,0
148292,21000,210,0,-2,5,3,2,0,0,0,0,0,0,0,0,0,0,0,0,0,0,0,5,3,2,0,0,0,0,0,0,0,0,0
148380,21000,210,0,-2,4,3,1,0,0,0,0,0,0,0,0,0,0,0,0,0,0,0,3,2,1,0,0,0,1,1,0,0,0,0
148405,21000,210,0,-2,3,0,3,0,0,0,0,0,0,0,0,0,0,0,0,0,0,0,3,0,3,0,0,0,0,0,0,0,0,0
148487,21000,210,0,-2,10,6,4,0,0,0,1,1,0,1,1,0,0,0,0,0,0,0,2,2,0,0,0,0,5,2,3,1,0,1
148496,21000,210,0,-2,7,2,5,0,0,0,1,1,0,3,1,2,0,0,0,0,0,0,2,0,2,0,0,0,1,0,1,0,0,0
148511,21000,210,0,-2,62,28,34,0,0,0,12,4,8,4,2,2,4,2,2,0,0,0,40,20,20,2,0,2,0,0,0,0,0,0
148575,21000,210,0,-2,1,1,0,0,0,0,0,0,0,0,0,0,0,0,0,0,0,0,1,1,0,0,0,0,0,0,0,0,0,0
148584,21000,210,0,-2,6,0,6,0,0,0,1,0,1,3,0,3,0,0,0,0,0,0,2,0,2,0,0,0,0,0,0,0,0,0
148593,21000,210,0,-2,2,0,2,0,0,0,0,0,0,0,0,0,0,0,0,0,0,0,2,0,2,0,0,0,0,0,0,0,0,0
148627,21000,210,0,-2,8,1,7,0,0,0,1,0,1,0,0,0,0,0,0,0,0,0,2,0,2,0,0,0,5,1,4,0,0,0
148654,21000,210,0,-2,4,2,2,0,0,0,0,0,0,0,0,0,0,0,0,0,0,0,4,2,2,0,0,0,0,0,0,0,0,0
148672,21000,210,0,-2,3,2,1,0,0,0,0,0,0,0,0,0,0,0,0,0,0,0,3,2,1,0,0,0,0,0,0,0,0,0
148821,21000,210,0,-2,2,0,2,0,0,0,0,0,0,0,0,0,0,0,0,0,0,0,2,0,2,0,0,0,0,0,0,0,0,0
148876,21000,210,0,-2,2,2,0,0,0,0,1,1,0,0,0,0,1,1,0,0,0,0,0,0,0,0,0,0,0,0,0,0,0,0
148982,21000,210,0,-2,1,1,0,0,0,0,0,0,0,0,0,0,0,0,0,0,0,0,1,1,0,0,0,0,0,0,0,0,0,0
149028,21000,210,0,-2,1,0,1,0,0,0,0,0,0,0,0,0,0,0,0,0,0,0,1,0,1,0,0,0,0,0,0,0,0,0
149222,21000,210,0,-2,103,64,39,0,0,0,12,7,5,7,2,5,3,3,0,0,0,0,71,45,26,1,0,1,0,0,0,9,7,2
149231,21000,210,0,-2,10,6,4,0,0,0,0,0,0,2,2,0,2,1,1,0,0,0,4,2,2,0,0,0,0,0,0,2,1,1
149329,21000,210,0,-2,1,1,0,0,0,0,0,0,0,0,0,0,0,0,0,0,0,0,1,1,0,0,0,0,0,0,0,0,0,0
149365,21000,210,0,-2,4,1,3,0,0,0,0,0,0,2,0,2,0,0,0,0,0,0,1,0,1,0,0,0,1,1,0,0,0,0
149505,21000,210,0,-2,5,2,3,0,0,0,0,0,0,0,0,0,1,1,0,0,0,0,4,1,3,0,0,0,0,0,0,0,0,0
149532,21000,210,0,-2,2,0,2,0,0,0,0,0,0,0,0,0,0,0,0,0,0,0,1,0,1,0,0,0,1,0,1,0,0,0
149639,21000,210,0,-2,1,0,1,0,0,0,0,0,0,0,0,0,1,0,1,0,0,0,0,0,0,0,0,0,0,0,0,0,0,0
149727,21000,210,0,-2,2,2,0,0,0,0,0,0,0,0,0,0,0,0,0,0,0,0,2,2,0,0,0,0,0,0,0,0,0,0
149772,21000,210,0,-2,7,2,5,0,0,0,0,0,0,0,0,0,0,0,0,0,0,0,6,2,4,0,0,0,1,0,1,0,0,0
149781,21000,210,0,-2,10,6,4,0,0,0,4,2,2,0,0,0,0,0,0,0,0,0,5,4,1,0,0,0,0,0,0,1,0,1
149842,21000,210,0,-2,8,1,7,0,0,0,0,0,0,2,0,2,0,0,0,0,0,0,5,1,4,0,0,0,1,0,1,0,0,0
150066,21000,210,0,-2,8,2,6,0,0,0,0,0,0,1,0,1,0,0,0,0,0,0,7,2,5,0,0,0,0,0,0,0,0,0
150136,21000,210,0,-2,1,0,1,0,0,0,0,0,0,0,0,0,0,0,0,0,0,0,1,0,1,0,0,0,0,0,0,0,0,0
150145,21000,210,0,-2,11,2,9,0,0,0,0,0,0,0,0,0,0,0,0,0,0,0,11,2,9,0,0,0,0,0,0,0,0,0
150163,21000,210,0,-2,36,16,20,0,0,0,4,1,3,2,1,1,2,1,1,0,0,0,28,13,15,0,0,0,0,0,0,0,0,0
150172,21000,210,0,-2,4,2,2,0,0,0,0,0,0,0,0,0,1,0,1,0,0,0,3,2,1,0,0,0,0,0,0,0,0,0
150215,21000,210,0,-2,1,0,1,0,0,0,0,0,0,1,0,1,0,0,0,0,0,0,0,0,0,0,0,0,0,0,0,0,0,0
150288,21000,210,0,-2,1,1,0,0,0,0,0,0,0,0,0,0,0,0,0,0,0,0,1,1,0,0,0,0,0,0,0,0,0,0
150400,21000,210,0,-2,10,5,5,0,0,0,3,1,2,0,0,0,3,2,1,0,0,0,4,2,2,0,0,0,0,0,0,0,0,0
150455,21000,210,0,-2,13,8,5,0,0,0,1,1,0,5,3,2,1,1,0,0,0,0,3,2,1,0,0,0,0,0,0,3,1,2
150534,21000,210,0,-2,18,8,10,0,0,0,0,0,0,0,0,0,0,0,0,0,0,0,5,2,3,0,0,0,13,6,7,0,0,0
150604,21000,210,0,-2,6,2,4,0,0,0,0,0,0,0,0,0,0,0,0,0,0,0,6,2,4,0,0,0,0,0,0,0,0,0
150668,21000,210,0,-2,4,1,3,0,0,0,0,0,0,1,0,1,0,0,0,0,0,0,3,1,2,0,0,0,0,0,0,0,0,0
150677,21000,210,0,-2,2,1,1,0,0,0,0,0,0,0,0,0,0,0,0,0,0,0,1,1,0,0,0,0,1,0,1,0,0,0
150756,21000,210,0,-2,11,9,2,0,0,0,0,0,0,2,2,0,1,1,0,0,0,0,8,6,2,0,0,0,0,0,0,0,0,0
150774,21000,210,0,-2,3,2,1,0,0,0,0,0,0,1,0,1,0,0,0,0,0,0,2,2,0,0,0,0,0,0,0,0,0,0
150941,21000,210,0,-2,10,2,8,0,0,0,1,1,0,0,0,0,0,0,0,0,0,0,9,1,8,0,0,0,0,0,0,0,0,0
150987,21000,210,0,-2,62,24,38,0,0,0,1,0,1,8,2,6,1,1,0,0,0,0,52,21,31,0,0,0,0,0,0,0,0,0
151102,21000,210,0,-2,11,6,5,0,0,0,1,1,0,0,0,0,0,0,0,0,0,0,6,3,3,1,0,1,1,1,0,2,1,1
151111,21000,210,0,-2,247,111,136,0,0,0,52,20,32,10,1,9,7,1,6,0,0,0,156,75,81,3,2,1,0,0,0,19,12,7
151263,21000,210,0,-2,19,7,12,0,0,0,1,0,1,1,1,0,0,0,0,0,0,0,16,6,10,1,0,1,0,0,0,0,0,0
151290,21000,210,0,-2,6,3,3,0,0,0,2,2,0,0,0,0,0,0,0,0,0,0,2,0,2,0,0,0,0,0,0,2,1,1
151306,21000,210,0,-2,15,5,10,0,0,0,1,1,0,0,0,0,0,0,0,0,0,0,10,1,9,0,0,0,0,0,0,4,3,1
151324,21000,210,0,-2,16,8,8,0,0,0,4,0,4,3,2,1,2,2,0,0,0,0,7,4,3,0,0,0,0,0,0,0,0,0
151333,21000,210,0,-2,7,1,6,0,0,0,0,0,0,0,0,0,0,0,0,0,0,0,4,0,4,0,0,0,0,0,0,3,1,2
151342,21000,210,0,-2,16,7,9,0,0,0,0,0,0,2,0,2,0,0,0,0,0,0,14,7,7,0,0,0,0,0,0,0,0,0
151351,21000,210,0,-2,121,53,68,1,1,0,11,3,8,8,3,5,14,5,9,0,0,0,61,27,34,1,0,1,0,0,0,25,14,11
151360,21000,210,0,-2,5,1,4,0,0,0,0,0,0,3,0,3,0,0,0,0,0,0,2,1,1,0,0,0,0,0,0,0,0,0
151379,21000,210,0,-2,6,0,6,0,0,0,0,0,0,0,0,0,0,0,0,0,0,0,5,0,5,0,0,0,0,0,0,1,0,1
151388,21000,210,0,-2,2,1,1,0,0,0,0,0,0,0,0,0,0,0,0,0,0,0,2,1,1,0,0,0,0,0,0,0,0,0
151467,21000,210,0,-2,1,0,1,0,0,0,0,0,0,0,0,0,0,0,0,0,0,0,1,0,1,0,0,0,0,0,0,0,0,0
151661,21000,210,0,-2,14,12,2,0,0,0,0,0,0,2,2,0,0,0,0,0,0,0,12,10,2,0,0,0,0,0,0,0,0,0
151777,21000,210,0,-2,9,2,7,0,0,0,0,0,0,0,0,0,1,0,1,0,0,0,7,1,6,0,0,0,1,1,0,0,0,0
151786,21000,210,0,-2,47,17,30,0,0,0,0,0,0,3,0,3,5,3,2,0,0,0,39,14,25,0,0,0,0,0,0,0,0,0
151801,21000,210,0,-2,11,5,6,0,0,0,1,1,0,2,1,1,0,0,0,0,0,0,7,2,5,0,0,0,1,1,0,0,0,0
151810,21000,210,0,-2,6,4,2,0,0,0,0,0,0,5,3,2,0,0,0,0,0,0,1,1,0,0,0,0,0,0,0,0,0,0
152080,21000,210,0,-2,96,54,42,0,0,0,5,2,3,5,2,3,7,4,3,0,0,0,47,31,16,2,0,2,7,2,5,23,13,10
152099,21000,210,0,-2,5,2,3,0,0,0,2,0,2,0,0,0,0,0,0,0,0,0,2,1,1,0,0,0,1,1,0,0,0,0
152318,21000,210,0,-2,10,5,5,0,0,0,1,0,1,0,0,0,0,0,0,0,0,0,5,3,2,0,0,0,0,0,0,4,2,2
152336,21000,210,0,-2,8,1,7,0,0,0,0,0,0,0,0,0,0,0,0,0,0,0,8,1,7,0,0,0,0,0,0,0,0,0
152381,21000,210,0,-2,7,2,5,0,0,0,0,0,0,0,0,0,1,0,1,0,0,0,6,2,4,0,0,0,0,0,0,0,0,0
152390,21000,210,0,-2,13,3,10,0,0,0,0,0,0,0,0,0,0,0,0,0,0,0,9,2,7,0,0,0,1,0,1,3,1,2
152530,21000,210,0,-2,7,3,4,0,0,0,0,0,0,0,0,0,0,0,0,0,0,0,5,2,3,0,0,0,0,0,0,2,1,1
152567,21000,210,0,-2,8,4,4,0,0,0,0,0,0,0,0,0,0,0,0,0,0,0,8,4,4,0,0,0,0,0,0,0,0,0
152600,21000,210,0,-2,7,1,6,0,0,0,0,0,0,0,0,0,1,0,1,0,0,0,6,1,5,0,0,0,0,0,0,0,0,0
152637,21000,210,0,-2,14,7,7,0,0,0,0,0,0,0,0,0,0,0,0,0,0,0,14,7,7,0,0,0,0,0,0,0,0,0
152673,21000,210,0,-2,2,0,2,0,0,0,0,0,0,0,0,0,0,0,0,0,0,0,2,0,2,0,0,0,0,0,0,0,0,0
152798,21000,210,0,-2,5,2,3,0,0,0,0,0,0,0,0,0,0,0,0,0,0,0,5,2,3,0,0,0,0,0,0,0,0,0
152992,21000,210,0,-2,6,4,2,0,0,0,0,0,0,0,0,0,0,0,0,0,0,0,6,4,2,0,0,0,0,0,0,0,0,0
153001,21000,210,0,-2,10,7,3,0,0,0,0,0,0,1,0,1,2,2,0,0,0,0,7,5,2,0,0,0,0,0,0,0,0,0
153108,21000,210,0,-2,1,1,0,0,0,0,0,0,0,0,0,0,0,0,0,0,0,0,0,0,0,0,0,0,0,0,0,1,1,0
153126,21000,210,0,-2,6,1,5,0,0,0,0,0,0,1,0,1,0,0,0,0,0,0,5,1,4,0,0,0,0,0,0,0,0,0
153144,21000,210,0,-2,5,2,3,0,0,0,0,0,0,1,1,0,0,0,0,0,0,0,4,1,3,0,0,0,0,0,0,0,0,0
153162,21000,210,0,-2,3,1,2,0,0,0,0,0,0,0,0,0,0,0,0,0,0,0,2,1,1,0,0,0,0,0,0,1,0,1
153214,21000,210,0,-2,22,10,12,0,0,0,3,2,1,0,0,0,1,1,0,0,0,0,18,7,11,0,0,0,0,0,0,0,0,0
153241,21000,210,0,-2,3,1,2,0,0,0,0,0,0,0,0,0,0,0,0,0,0,0,2,1,1,0,0,0,0,0,0,1,0,1
153250,21000,210,0,-2,5,4,1,0,0,0,0,0,0,0,0,0,0,0,0,0,0,0,5,4,1,0,0,0,0,0,0,0,0,0
153269,21000,210,0,-2,26,14,12,0,0,0,2,1,1,0,0,0,2,1,1,0,0,0,17,9,8,0,0,0,0,0,0,5,3,2
153278,21000,210,0,-2,5,3,2,0,0,0,0,0,0,0,0,0,1,1,0,0,0,0,4,2,2,0,0,0,0,0,0,0,0,0
153296,21000,210,0,-2,3,1,2,0,0,0,0,0,0,0,0,0,0,0,0,0,0,0,3,1,2,0,0,0,0,0,0,0,0,0
153311,21000,210,0,-2,6,2,4,0,0,0,0,0,0,1,0,1,1,0,1,0,0,0,4,2,2,0,0,0,0,0,0,0,0,0
153320,21000,210,0,-2,1,0,1,0,0,0,0,0,0,0,0,0,0,0,0,0,0,0,1,0,1,0,0,0,0,0,0,0,0,0
153366,21000,210,0,-2,17,8,9,0,0,0,3,2,1,1,0,1,2,1,1,0,0,0,11,5,6,0,0,0,0,0,0,0,0,0
153375,21000,210,0,-2,9,4,5,0,0,0,3,1,2,0,0,0,0,0,0,0,0,0,6,3,3,0,0,0,0,0,0,0,0,0
153384,21000,210,0,-2,19,7,12,0,0,0,2,0,2,1,1,0,2,1,1,0,0,0,12,4,8,1,0,1,1,1,0,0,0,0
153445,21000,210,0,-2,5,1,4,0,0,0,0,0,0,0,0,0,0,0,0,0,0,0,4,1,3,1,0,1,0,0,0,0,0,0
153472,21000,210,0,-2,4,2,2,0,0,0,0,0,0,0,0,0,0,0,0,0,0,0,4,2,2,0,0,0,0,0,0,0,0,0
153524,21000,210,0,-2,5,1,4,0,0,0,0,0,0,0,0,0,0,0,0,0,0,0,4,1,3,0,0,0,1,0,1,0,0,0
153533,21000,210,0,-2,7,4,3,0,0,0,0,0,0,1,1,0,0,0,0,0,0,0,6,3,3,0,0,0,0,0,0,0,0,0
153603,21000,210,0,-2,59,29,30,1,1,0,7,4,3,0,0,0,4,3,1,0,0,0,35,13,22,0,0,0,0,0,0,12,8,4
153621,21000,210,0,-2,5,3,2,0,0,0,0,0,0,0,0,0,0,0,0,0,0,0,5,3,2,0,0,0,0,0,0,0,0,0
153630,21000,210,0,-2,15,8,7,0,0,0,1,0,1,2,2,0,2,2,0,0,0,0,9,4,5,0,0,0,1,0,1,0,0,0
153658,21000,210,0,-2,113,54,59,0,0,0,15,13,2,7,3,4,4,2,2,0,0,0,48,18,30,0,0,0,15,6,9,24,12,12
153737,21000,210,0,-2,15,6,9,0,0,0,1,1,0,2,1,1,0,0,0,0,0,0,12,4,8,0,0,0,0,0,0,0,0,0
153825,21000,210,0,-2,7,3,4,0,0,0,3,1,2,0,0,0,0,0,0,0,0,0,4,2,2,0,0,0,0,0,0,0,0,0
153834,21000,210,0,-2,1,0,1,0,0,0,1,0,1,0,0,0,0,0,0,0,0,0,0,0,0,0,0,0,0,0,0,0,0,0
153861,21000,210,0,-2,19,13,6,0,0,0,6,5,1,1,0,1,0,0,0,0,0,0,10,6,4,0,0,0,2,2,0,0,0,0
153922,21000,210,0,-2,3,2,1,0,0,0,0,0,0,0,0,0,0,0,0,0,0,0,3,2,1,0,0,0,0,0,0,0,0,0
153977,21000,210,0,-2,4,0,4,0,0,0,0,0,0,0,0,0,0,0,0,0,0,0,3,0,3,1,0,1,0,0,0,0,0,0
154004,21000,210,0,-2,8,1,7,0,0,0,0,0,0,2,0,2,0,0,0,0,0,0,6,1,5,0,0,0,0,0,0,0,0,0
154013,21000,210,0,-2,10,4,6,0,0,0,0,0,0,0,0,0,1,1,0,0,0,0,9,3,6,0,0,0,0,0,0,0,0,0
154022,21000,210,0,-2,7,2,5,0,0,0,1,1,0,2,0,2,2,1,1,0,0,0,2,0,2,0,0,0,0,0,0,0,0,0
154059,21000,210,0,-2,9,5,4,0,0,0,0,0,0,0,0,0,0,0,0,0,0,0,9,5,4,0,0,0,0,0,0,0,0,0
154095,21000,210,0,-2,18,5,13,0,0,0,2,1,1,0,0,0,0,0,0,0,0,0,11,3,8,0,0,0,0,0,0,5,1,4
154101,21000,210,0,-2,4,2,2,0,0,0,0,0,0,0,0,0,0,0,0,0,0,0,3,1,2,0,0,0,0,0,0,1,1,0
154110,21000,210,0,-2,7,4,3,0,0,0,0,0,0,0,0,0,0,0,0,0,0,0,5,2,3,0,0,0,2,2,0,0,0,0
154129,21000,210,0,-2,2,1,1,0,0,0,1,0,1,1,1,0,0,0,0,0,0,0,0,0,0,0,0,0,0,0,0,0,0,0
154156,21000,210,0,-2,9,4,5,0,0,0,0,0,0,0,0,0,0,0,0,0,0,0,9,4,5,0,0,0,0,0,0,0,0,0
154174,21000,210,0,-2,10,5,5,0,0,0,2,2,0,0,0,0,0,0,0,0,0,0,8,3,5,0,0,0,0,0,0,0,0,0
154235,21000,210,0,-2,9,4,5,0,0,0,1,0,1,0,0,0,0,0,0,0,0,0,8,4,4,0,0,0,0,0,0,0,0,0
154350,21000,210,0,-2,8,4,4,0,0,0,2,2,0,1,1,0,1,0,1,0,0,0,4,1,3,0,0,0,0,0,0,0,0,0
154378,21000,210,0,-2,9,3,6,0,0,0,0,0,0,0,0,0,0,0,0,0,0,0,9,3,6,0,0,0,0,0,0,0,0,0
154396,21000,210,0,-2,5,3,2,0,0,0,0,0,0,1,1,0,0,0,0,0,0,0,4,2,2,0,0,0,0,0,0,0,0,0
154493,21000,210,0,-2,4,2,2,0,0,0,1,0,1,0,0,0,0,0,0,0,0,0,0,0,0,0,0,0,3,2,1,0,0,0
154518,21000,210,0,-2,2,2,0,0,0,0,1,1,0,0,0,0,0,0,0,0,0,0,1,1,0,0,0,0,0,0,0,0,0,0
154527,21000,210,0,-2,8,4,4,0,0,0,0,0,0,0,0,0,0,0,0,0,0,0,8,4,4,0,0,0,0,0,0,0,0,0
154572,21000,210,0,-2,3,1,2,0,0,0,0,0,0,0,0,0,0,0,0,0,0,0,3,1,2,0,0,0,0,0,0,0,0,0
154590,21000,210,0,-2,6,3,3,0,0,0,0,0,0,0,0,0,1,1,0,0,0,0,5,2,3,0,0,0,0,0,0,0,0,0
154642,21000,210,0,-2,2,1,1,0,0,0,0,0,0,0,0,0,1,1,0,0,0,0,1,0,1,0,0,0,0,0,0,0,0,0
154688,21000,210,0,-2,4,1,3,0,0,0,0,0,0,0,0,0,0,0,0,0,0,0,3,1,2,0,0,0,1,0,1,0,0,0
154697,21000,210,0,-2,5,3,2,0,0,0,0,0,0,0,0,0,0,0,0,0,0,0,5,3,2,0,0,0,0,0,0,0,0,0
154712,21000,210,0,-2,1,1,0,0,0,0,0,0,0,0,0,0,0,0,0,0,0,0,1,1,0,0,0,0,0,0,0,0,0,0
154721,21000,210,0,-2,5,0,5,0,0,0,0,0,0,1,0,1,0,0,0,0,0,0,4,0,4,0,0,0,0,0,0,0,0,0
154749,21000,210,0,-2,4,0,4,0,0,0,0,0,0,0,0,0,0,0,0,0,0,0,4,0,4,0,0,0,0,0,0,0,0,0
154800,21000,210,0,-2,11,9,2,0,0,0,0,0,0,0,0,0,1,1,0,0,0,0,10,8,2,0,0,0,0,0,0,0,0,0
154855,21000,210,0,-2,2,1,1,0,0,0,0,0,0,0,0,0,0,0,0,0,0,0,2,1,1,0,0,0,0,0,0,0,0,0
154907,21000,210,0,-2,8,6,2,0,0,0,0,0,0,0,0,0,0,0,0,0,0,0,8,6,2,0,0,0,0,0,0,0,0,0
154925,21000,210,0,-2,4,3,1,0,0,0,0,0,0,0,0,0,0,0,0,0,0,0,4,3,1,0,0,0,0,0,0,0,0,0
154934,21000,210,0,-2,4,2,2,0,0,0,0,0,0,0,0,0,0,0,0,0,0,0,4,2,2,0,0,0,0,0,0,0,0,0
154952,21000,210,0,-2,4,3,1,0,0,0,0,0,0,0,0,0,0,0,0,0,0,0,4,3,1,0,0,0,0,0,0,0,0,0
154998,21000,210,0,-2,7,2,5,0,0,0,0,0,0,0,0,0,0,0,0,0,0,0,7,2,5,0,0,0,0,0,0,0,0,0
155007,21000,210,0,-2,5,2,3,0,0,0,0,0,0,1,0,1,0,0,0,0,0,0,3,1,2,0,0,0,1,1,0,0,0,0
155025,21000,210,0,-2,17,5,12,0,0,0,4,2,2,1,0,1,0,0,0,0,0,0,12,3,9,0,0,0,0,0,0,0,0,0
155052,21000,210,0,-2,3,1,2,0,0,0,0,0,0,0,0,0,0,0,0,0,0,0,3,1,2,0,0,0,0,0,0,0,0,0
155061,21000,210,0,-2,25,15,10,0,0,0,3,1,2,1,1,0,1,1,0,0,0,0,14,10,4,4,1,3,1,1,0,1,0,1
155089,21000,210,0,-2,8,3,5,1,0,1,0,0,0,1,1,0,0,0,0,0,0,0,6,2,4,0,0,0,0,0,0,0,0,0
155098,21000,210,0,-2,10,5,5,0,0,0,0,0,0,0,0,0,1,1,0,0,0,0,9,4,5,0,0,0,0,0,0,0,0,0
155104,21000,210,0,-2,8,5,3,0,0,0,0,0,0,0,0,0,2,0,2,0,0,0,6,5,1,0,0,0,0,0,0,0,0,0
155177,21000,210,0,-2,4,3,1,0,0,0,0,0,0,0,0,0,0,0,0,0,0,0,3,2,1,1,1,0,0,0,0,0,0,0
155186,21000,210,0,-2,8,1,7,0,0,0,0,0,0,0,0,0,0,0,0,0,0,0,8,1,7,0,0,0,0,0,0,0,0,0
155195,21000,210,0,-2,15,7,8,0,0,0,0,0,0,0,0,0,0,0,0,0,0,0,15,7,8,0,0,0,0,0,0,0,0,0
155201,21000,210,0,-2,6,3,3,0,0,0,1,1,0,0,0,0,1,0,1,0,0,0,4,2,2,0,0,0,0,0,0,0,0,0
155210,21000,210,0,-2,15,7,8,0,0,0,0,0,0,0,0,0,0,0,0,0,0,0,12,5,7,1,0,1,2,2,0,0,0,0
155283,21000,210,0,-2,6,1,5,0,0,0,0,0,0,2,0,2,1,0,1,0,0,0,3,1,2,0,0,0,0,0,0,0,0,0
155292,21000,210,0,-2,6,2,4,0,0,0,0,0,0,1,0,1,3,0,3,0,0,0,2,2,0,0,0,0,0,0,0,0,0,0
155308,21000,210,0,-2,1,0,1,0,0,0,0,0,0,0,0,0,0,0,0,0,0,0,1,0,1,0,0,0,0,0,0,0,0,0
155317,21000,210,0,-2,140,71,69,0,0,0,13,11,2,8,4,4,5,1,4,0,0,0,89,40,49,5,0,5,2,0,2,18,15,3
155335,21000,210,0,-2,2,1,1,0,0,0,0,0,0,0,0,0,0,0,0,0,0,0,2,1,1,0,0,0,0,0,0,0,0,0
155399,21000,210,0,-2,36,16,20,0,0,0,4,2,2,2,0,2,3,2,1,0,0,0,23,11,12,0,0,0,0,0,0,4,1,3
155414,21000,210,0,-2,10,4,6,0,0,0,1,0,1,0,0,0,0,0,0,0,0,0,9,4,5,0,0,0,0,0,0,0,0,0
155450,21000,210,0,-2,2,0,2,0,0,0,0,0,0,0,0,0,0,0,0,0,0,0,2,0,2,0,0,0,0,0,0,0,0,0
155487,21000,210,0,-2,1,0,1,0,0,0,0,0,0,0,0,0,0,0,0,0,0,0,0,0,0,0,0,0,1,0,1,0,0,0
155511,21000,210,0,-2,4,3,1,0,0,0,1,1,0,0,0,0,0,0,0,0,0,0,2,2,0,1,0,1,0,0,0,0,0,0
155566,21000,210,0,-2,11,7,4,0,0,0,0,0,0,0,0,0,0,0,0,0,0,0,9,5,4,0,0,0,0,0,0,2,2,0
155593,21000,210,0,-2,7,5,2,0,0,0,0,0,0,0,0,0,0,0,0,0,0,0,7,5,2,0,0,0,0,0,0,0,0,0
155618,21000,210,0,-2,2,2,0,0,0,0,0,0,0,0,0,0,0,0,0,0,0,0,2,2,0,0,0,0,0,0,0,0,0,0
155627,21000,210,0,-2,1,1,0,0,0,0,0,0,0,0,0,0,0,0,0,0,0,0,1,1,0,0,0,0,0,0,0,0,0,0
155681,21000,210,0,-2,8,6,2,1,1,0,1,0,1,0,0,0,0,0,0,0,0,0,6,5,1,0,0,0,0,0,0,0,0,0
155715,21000,210,0,-2,7,5,2,0,0,0,0,0,0,0,0,0,1,0,1,0,0,0,6,5,1,0,0,0,0,0,0,0,0,0
155812,21000,210,0,-2,14,4,10,0,0,0,0,0,0,2,0,2,0,0,0,0,0,0,12,4,8,0,0,0,0,0,0,0,0,0
155830,21000,210,0,-2,3,0,3,0,0,0,0,0,0,0,0,0,0,0,0,0,0,0,3,0,3,0,0,0,0,0,0,0,0,0
155858,21000,210,0,-2,4,2,2,0,0,0,0,0,0,0,0,0,1,1,0,0,0,0,3,1,2,0,0,0,0,0,0,0,0,0
155900,21000,210,0,-2,3,2,1,0,0,0,1,1,0,1,0,1,0,0,0,0,0,0,1,1,0,0,0,0,0,0,0,0,0,0
155937,21000,210,0,-2,3,2,1,0,0,0,0,0,0,0,0,0,0,0,0,0,0,0,3,2,1,0,0,0,0,0,0,0,0,0
155973,21000,210,0,-2,4,3,1,0,0,0,0,0,0,0,0,0,0,0,0,0,0,0,4,3,1,0,0,0,0,0,0,0,0,0
156082,21000,210,0,-2,7,2,5,0,0,0,0,0,0,1,0,1,0,0,0,0,0,0,6,2,4,0,0,0,0,0,0,0,0,0
156107,21000,210,0,-2,12,8,4,0,0,0,0,0,0,0,0,0,1,0,1,0,0,0,11,8,3,0,0,0,0,0,0,0,0,0
156125,21000,210,0,-2,31,16,15,0,0,0,1,0,1,1,1,0,1,1,0,0,0,0,19,8,11,0,0,0,1,1,0,8,5,3
156134,21000,210,0,-2,7,3,4,1,1,0,0,0,0,1,1,0,0,0,0,0,0,0,5,1,4,0,0,0,0,0,0,0,0,0
156189,21000,210,0,-2,5,3,2,0,0,0,0,0,0,0,0,0,0,0,0,0,0,0,5,3,2,0,0,0,0,0,0,0,0,0
156213,21000,210,0,-2,8,2,6,0,0,0,1,0,1,1,0,1,0,0,0,0,0,0,6,2,4,0,0,0,0,0,0,0,0,0
156222,21000,210,0,-2,4,3,1,0,0,0,1,1,0,0,0,0,1,0,1,0,0,0,2,2,0,0,0,0,0,0,0,0,0,0
156231,21000,210,0,-2,3,1,2,0,0,0,0,0,0,0,0,0,0,0,0,0,0,0,2,0,2,0,0,0,1,1,0,0,0,0
156286,21000,210,0,-2,11,1,10,0,0,0,2,0,2,1,1,0,0,0,0,0,0,0,7,0,7,0,0,0,0,0,0,1,0,1
156295,21000,210,0,-2,14,4,10,0,0,0,2,1,1,2,0,2,1,0,1,0,0,0,7,2,5,0,0,0,0,0,0,2,1,1
156338,21000,210,0,-2,6,1,5,0,0,0,0,0,0,1,0,1,0,0,0,0,0,0,4,1,3,0,0,0,1,0,1,0,0,0
156356,21000,210,0,-2,4,2,2,0,0,0,0,0,0,0,0,0,0,0,0,0,0,0,3,2,1,0,0,0,1,0,1,0,0,0
156365,21000,210,0,-2,16,8,8,0,0,0,0,0,0,1,1,0,0,0,0,0,0,0,13,6,7,0,0,0,2,1,1,0,0,0
156392,21000,210,0,-2,12,3,9,0,0,0,0,0,0,0,0,0,0,0,0,0,0,0,11,3,8,0,0,0,1,0,1,0,0,0
156408,21000,210,0,-2,13,5,8,0,0,0,1,0,1,1,0,1,1,1,0,0,0,0,7,2,5,1,1,0,2,1,1,0,0,0
156471,21000,210,0,-2,18,1,17,0,0,0,0,0,0,3,0,3,0,0,0,0,0,0,15,1,14,0,0,0,0,0,0,0,0,0
156541,21000,210,0,-2,35,18,17,0,0,0,0,0,0,7,4,3,0,0,0,0,0,0,27,14,13,0,0,0,1,0,1,0,0,0
156620,21000,210,0,-2,63,28,35,0,0,0,0,0,0,1,0,1,1,1,0,0,0,0,47,22,25,3,1,2,1,0,1,10,4,6
156648,21000,210,0,-2,7,4,3,0,0,0,0,0,0,0,0,0,0,0,0,0,0,0,7,4,3,0,0,0,0,0,0,0,0,0
156727,21000,210,0,-2,18,5,13,0,0,0,0,0,0,2,0,2,1,0,1,0,0,0,14,5,9,1,0,1,0,0,0,0,0,0
156745,21000,210,0,-2,6,2,4,0,0,0,1,1,0,0,0,0,0,0,0,0,0,0,4,1,3,0,0,0,0,0,0,1,0,1
156790,21000,210,0,-2,4,0,4,0,0,0,0,0,0,0,0,0,0,0,0,0,0,0,4,0,4,0,0,0,0,0,0,0,0,0
156851,21000,210,0,-2,4,0,4,0,0,0,0,0,0,0,0,0,0,0,0,0,0,0,3,0,3,0,0,0,1,0,1,0,0,0
156860,21000,210,0,-2,10,2,8,0,0,0,0,0,0,0,0,0,0,0,0,0,0,0,10,2,8,0,0,0,0,0,0,0,0,0
156921,21000,210,0,-2,18,7,11,1,1,0,2,1,1,2,1,1,0,0,0,0,0,0,12,4,8,1,0,1,0,0,0,0,0,0
157021,21000,210,0,-2,3,1,2,0,0,0,0,0,0,1,0,1,0,0,0,0,0,0,2,1,1,0,0,0,0,0,0,0,0,0
157058,21000,210,0,-2,9,4,5,0,0,0,1,0,1,0,0,0,0,0,0,0,0,0,2,1,1,0,0,0,6,3,3,0,0,0
157076,21000,210,0,-2,5,2,3,0,0,0,0,0,0,0,0,0,0,0,0,0,0,0,5,2,3,0,0,0,0,0,0,0,0,0
157085,21000,210,0,-2,46,21,25,0,0,0,4,3,1,10,4,6,4,4,0,0,0,0,21,6,15,0,0,0,0,0,0,7,4,3
157100,21000,210,0,-2,4,1,3,0,0,0,0,0,0,0,0,0,0,0,0,0,0,0,4,1,3,0,0,0,0,0,0,0,0,0
157216,21000,210,0,-2,13,4,9,0,0,0,0,0,0,1,0,1,1,0,1,0,0,0,11,4,7,0,0,0,0,0,0,0,0,0
157289,21000,210,0,-2,78,39,39,0,0,0,5,4,1,4,1,3,4,3,1,0,0,0,58,26,32,0,0,0,0,0,0,7,5,2
157304,21000,210,0,-2,6,5,1,0,0,0,0,0,0,0,0,0,0,0,0,0,0,0,4,3,1,0,0,0,2,2,0,0,0,0
157331,21000,210,0,-2,5,1,4,0,0,0,0,0,0,0,0,0,0,0,0,0,0,0,5,1,4,0,0,0,0,0,0,0,0,0
157377,21000,210,0,-2,11,4,7,0,0,0,1,1,0,0,0,0,0,0,0,0,0,0,9,3,6,0,0,0,1,0,1,0,0,0
157386,21000,210,0,-2,22,10,12,0,0,0,2,2,0,0,0,0,1,0,1,0,0,0,17,7,10,1,0,1,1,1,0,0,0,0
157438,21000,210,0,-2,9,6,3,0,0,0,0,0,0,1,1,0,0,0,0,0,0,0,8,5,3,0,0,0,0,0,0,0,0,0
157447,21000,210,0,-2,28,10,18,1,0,1,0,0,0,4,2,2,0,0,0,0,0,0,19,5,14,0,0,0,0,0,0,4,3,1
157483,21000,210,0,-2,8,3,5,0,0,0,0,0,0,1,0,1,0,0,0,0,0,0,7,3,4,0,0,0,0,0,0,0,0,0
157535,21000,210,0,-2,21,8,13,0,0,0,4,1,3,1,1,0,0,0,0,0,0,0,15,5,10,0,0,0,1,1,0,0,0,0
157553,21000,210,0,-2,5,3,2,0,0,0,0,0,0,0,0,0,0,0,0,0,0,0,5,3,2,0,0,0,0,0,0,0,0,0
157711,21000,210,0,-2,6,4,2,0,0,0,0,0,0,0,0,0,1,1,0,0,0,0,5,3,2,0,0,0,0,0,0,0,0,0
157739,21000,210,0,-2,4,1,3,0,0,0,0,0,0,0,0,0,0,0,0,0,0,0,4,1,3,0,0,0,0,0,0,0,0,0
157748,21000,210,0,-2,1,1,0,0,0,0,0,0,0,0,0,0,0,0,0,0,0,0,0,0,0,0,0,0,1,1,0,0,0,0
157757,21000,210,0,-2,10,3,7,0,0,0,1,1,0,2,1,1,0,0,0,0,0,0,7,1,6,0,0,0,0,0,0,0,0,0
157809,21000,210,0,-2,8,4,4,0,0,0,1,1,0,0,0,0,0,0,0,0,0,0,7,3,4,0,0,0,0,0,0,0,0,0
157818,21000,210,0,-2,4,1,3,0,0,0,0,0,0,0,0,0,0,0,0,0,0,0,4,1,3,0,0,0,0,0,0,0,0,0
157863,21000,210,0,-2,4,1,3,0,0,0,0,0,0,0,0,0,0,0,0,0,0,0,3,1,2,0,0,0,0,0,0,1,0,1
157951,21000,210,0,-2,55,23,32,0,0,0,5,0,5,2,2,0,2,1,1,0,0,0,43,19,24,0,0,0,3,1,2,0,0,0
158088,21000,210,0,-2,17,5,12,0,0,0,0,0,0,4,1,3,0,0,0,0,0,0,7,2,5,0,0,0,6,2,4,0,0,0
158431,21000,210,0,-2,15,3,12,0,0,0,0,0,0,0,0,0,1,0,1,0,0,0,14,3,11,0,0,0,0,0,0,0,0,0
158477,21000,210,0,-2,1,1,0,0,0,0,1,1,0,0,0,0,0,0,0,0,0,0,0,0,0,0,0,0,0,0,0,0,0,0
158662,21000,210,0,-2,11,2,9,0,0,0,0,0,0,1,1,0,0,0,0,0,0,0,10,1,9,0,0,0,0,0,0,0,0,0
158802,21000,210,0,-2,9,5,4,0,0,0,0,0,0,6,2,4,0,0,0,0,0,0,3,3,0,0,0,0,0,0,0,0,0,0
158884,21000,210,0,-2,8,5,3,0,0,0,1,1,0,2,2,0,0,0,0,0,0,0,5,2,3,0,0,0,0,0,0,0,0,0
159009,21000,210,0,-2,15,6,9,0,0,0,2,1,1,10,3,7,0,0,0,0,0,0,2,1,1,0,0,0,0,0,0,1,1,0
159197,21000,210,0,-2,3,2,1,0,0,0,0,0,0,0,0,0,0,0,0,0,0,0,3,2,1,0,0,0,0,0,0,0,0,0
159373,21000,210,0,-2,42,20,22,0,0,0,6,4,2,4,0,4,1,1,0,0,0,0,28,14,14,0,0,0,1,0,1,2,1,1
159382,21000,210,0,-2,7,4,3,0,0,0,0,0,0,0,0,0,0,0,0,0,0,0,7,4,3,0,0,0,0,0,0,0,0,0
159391,21000,210,0,-2,101,49,52,0,0,0,6,2,4,11,5,6,9,5,4,0,0,0,56,26,30,2,1,1,2,2,0,15,8,7
159407,21000,210,0,-2,12,5,7,0,0,0,0,0,0,1,1,0,0,0,0,0,0,0,9,3,6,1,0,1,0,0,0,1,1,0
159416,21000,210,0,-2,20,10,10,0,0,0,3,3,0,2,0,2,2,0,2,0,0,0,13,7,6,0,0,0,0,0,0,0,0,0
159568,21000,210,0,-2,7,5,2,0,0,0,0,0,0,0,0,0,0,0,0,0,0,0,6,4,2,0,0,0,0,0,0,1,1,0
159647,21000,210,0,-2,18,13,5,0,0,0,2,1,1,0,0,0,0,0,0,0,0,0,16,12,4,0,0,0,0,0,0,0,0,0
159656,21000,210,0,-2,21,6,15,0,0,0,3,1,2,5,1,4,1,1,0,0,0,0,8,3,5,0,0,0,1,0,1,3,0,3
159717,21000,210,0,-2,13,2,11,1,0,1,0,0,0,0,0,0,0,0,0,0,0,0,11,2,9,0,0,0,1,0,1,0,0,0
159939,21000,210,0,-2,11,5,6,0,0,0,1,0,1,1,0,1,2,2,0,0,0,0,5,2,3,1,0,1,0,0,0,1,1,0
159948,21000,210,0,-2,2,2,0,0,0,0,0,0,0,0,0,0,0,0,0,0,0,0,2,2,0,0,0,0,0,0,0,0,0,0
159966,21000,210,0,-2,15,4,11,0,0,0,1,0,1,1,0,1,0,0,0,0,0,0,12,4,8,0,0,0,0,0,0,1,0,1
159993,21000,210,0,-2,32,15,17,0,0,0,7,5,2,6,4,2,2,1,1,0,0,0,17,5,12,0,0,0,0,0,0,0,0,0
160010,21000,210,0,-2,6,0,6,0,0,0,0,0,0,2,0,2,0,0,0,0,0,0,4,0,4,0,0,0,0,0,0,0,0,0
160038,21000,210,0,-2,38,13,25,0,0,0,0,0,0,0,0,0,2,2,0,0,0,0,20,3,17,0,0,0,14,6,8,2,2,0
160065,21000,210,0,-2,4,1,3,0,0,0,0,0,0,1,0,1,1,1,0,0,0,0,2,0,2,0,0,0,0,0,0,0,0,0
160074,21000,210,0,-2,3,1,2,0,0,0,0,0,0,0,0,0,0,0,0,0,0,0,3,1,2,0,0,0,0,0,0,0,0,0
160481,21000,210,0,-2,6,3,3,0,0,0,0,0,0,0,0,0,0,0,0,0,0,0,6,3,3,0,0,0,0,0,0,0,0,0
160579,21000,210,0,-2,9,0,9,0,0,0,0,0,0,3,0,3,1,0,1,0,0,0,5,0,5,0,0,0,0,0,0,0,0,0
160612,21000,210,0,-2,49,17,32,0,0,0,1,0,1,7,3,4,1,0,1,0,0,0,33,9,24,0,0,0,0,0,0,7,5,2
160621,21000,210,0,-2,31,9,22,0,0,0,1,1,0,24,7,17,0,0,0,0,0,0,6,1,5,0,0,0,0,0,0,0,0,0
160630,21000,210,0,-2,6,2,4,0,0,0,0,0,0,6,2,4,0,0,0,0,0,0,0,0,0,0,0,0,0,0,0,0,0,0
160649,21000,210,0,-2,5,2,3,0,0,0,0,0,0,5,2,3,0,0,0,0,0,0,0,0,0,0,0,0,0,0,0,0,0,0
160658,21000,210,0,-2,31,9,22,0,0,0,1,0,1,1,0,1,5,1,4,0,0,0,21,6,15,0,0,0,1,0,1,2,2,0
160667,21000,210,0,-2,12,6,6,0,0,0,0,0,0,0,0,0,0,0,0,0,0,0,12,6,6,0,0,0,0,0,0,0,0,0
160755,21000,210,0,-2,97,54,43,2,2,0,15,8,7,9,4,5,8,1,7,0,0,0,55,34,21,1,0,1,0,0,0,7,5,2
160904,21000,210,0,-2,17,7,10,0,0,0,0,0,0,8,2,6,0,0,0,1,1,0,4,1,3,0,0,0,0,0,0,4,3,1
160959,21000,210,0,-2,1,0,1,0,0,0,1,0,1,0,0,0,0,0,0,0,0,0,0,0,0,0,0,0,0,0,0,0,0,0
160977,21000,210,0,-2,9,4,5,0,0,0,3,0,3,1,1,0,0,0,0,0,0,0,3,1,2,2,2,0,0,0,0,0,0,0
160995,21000,210,0,-2,5,2,3,0,0,0,0,0,0,0,0,0,0,0,0,0,0,0,5,2,3,0,0,0,0,0,0,0,0,0
161004,21000,210,0,-2,22,12,10,0,0,0,5,2,3,1,1,0,2,2,0,0,0,0,8,5,3,0,0,0,3,1,2,3,1,2
161022,21000,210,0,-2,2,0,2,0,0,0,0,0,0,0,0,0,0,0,0,0,0,0,2,0,2,0,0,0,0,0,0,0,0,0
161077,21000,210,0,-2,8,5,3,0,0,0,0,0,0,0,0,0,0,0,0,0,0,0,7,4,3,0,0,0,1,1,0,0,0,0
161086,21000,210,0,-2,35,16,19,0,0,0,1,0,1,0,0,0,1,1,0,0,0,0,18,8,10,2,0,2,3,2,1,10,5,5
161138,21000,210,0,-2,6,4,2,0,0,0,0,0,0,0,0,0,0,0,0,0,0,0,6,4,2,0,0,0,0,0,0,0,0,0
161192,21000,210,0,-2,10,4,6,0,0,0,0,0,0,0,0,0,0,0,0,0,0,0,10,4,6,0,0,0,0,0,0,0,0,0
161208,21000,210,0,-2,1,1,0,0,0,0,0,0,0,0,0,0,0,0,0,0,0,0,1,1,0,0,0,0,0,0,0,0,0,0
161217,21000,210,0,-2,4,1,3,0,0,0,0,0,0,0,0,0,0,0,0,0,0,0,4,1,3,0,0,0,0,0,0,0,0,0
161226,21000,210,0,-2,4,1,3,0,0,0,0,0,0,0,0,0,0,0,0,0,0,0,4,1,3,0,0,0,0,0,0,0,0,0
161235,21000,210,0,-2,3,1,2,0,0,0,0,0,0,0,0,0,0,0,0,0,0,0,2,1,1,0,0,0,1,0,1,0,0,0
161253,21000,210,0,-2,27,15,12,0,0,0,3,3,0,1,0,1,0,0,0,0,0,0,18,8,10,2,1,1,1,1,0,2,2,0
161299,21000,210,0,-2,5,4,1,0,0,0,0,0,0,0,0,0,0,0,0,0,0,0,5,4,1,0,0,0,0,0,0,0,0,0
161457,21000,210,0,-2,24,11,13,0,0,0,0,0,0,0,0,0,0,0,0,0,0,0,21,10,11,0,0,0,1,0,1,2,1,1
161484,21000,210,0,-2,3,3,0,0,0,0,0,0,0,0,0,0,0,0,0,0,0,0,3,3,0,0,0,0,0,0,0,0,0,0
161509,21000,210,0,-2,2,2,0,0,0,0,0,0,0,0,0,0,0,0,0,0,0,0,2,2,0,0,0,0,0,0,0,0,0,0
161518,21000,210,0,-2,2,0,2,0,0,0,0,0,0,0,0,0,0,0,0,0,0,0,2,0,2,0,0,0,0,0,0,0,0,0
161545,21000,210,0,-2,8,5,3,0,0,0,0,0,0,0,0,0,0,0,0,0,0,0,8,5,3,0,0,0,0,0,0,0,0,0
161554,21000,210,0,-2,15,4,11,0,0,0,1,1,0,0,0,0,0,0,0,0,0,0,13,3,10,0,0,0,0,0,0,1,0,1
161563,21000,210,0,-2,2,1,1,0,0,0,0,0,0,0,0,0,0,0,0,0,0,0,2,1,1,0,0,0,0,0,0,0,0,0
161572,21000,210,0,-2,2,1,1,0,0,0,0,0,0,0,0,0,0,0,0,0,0,0,2,1,1,0,0,0,0,0,0,0,0,0
161688,21000,210,0,-2,6,1,5,0,0,0,0,0,0,0,0,0,0,0,0,0,0,0,6,1,5,0,0,0,0,0,0,0,0,0
161767,21000,210,0,-2,13,4,9,0,0,0,1,1,0,5,1,4,1,0,1,0,0,0,6,2,4,0,0,0,0,0,0,0,0,0
161864,21000,210,0,-2,7,3,4,0,0,0,1,1,0,3,0,3,0,0,0,0,0,0,3,2,1,0,0,0,0,0,0,0,0,0
161873,21000,210,0,-2,11,3,8,0,0,0,3,1,2,1,0,1,1,0,1,0,0,0,5,2,3,0,0,0,1,0,1,0,0,0
162007,21000,210,0,-2,13,5,8,0,0,0,0,0,0,10,5,5,1,0,1,0,0,0,1,0,1,0,0,0,1,0,1,0,0,0
162061,21000,210,0,-2,1,1,0,0,0,0,0,0,0,1,1,0,0,0,0,0,0,0,0,0,0,0,0,0,0,0,0,0,0,0
162122,21000,210,0,-2,4,3,1,0,0,0,0,0,0,0,0,0,0,0,0,0,0,0,4,3,1,0,0,0,0,0,0,0,0,0
162168,21000,210,0,-2,2,1,1,0,0,0,0,0,0,0,0,0,0,0,0,0,0,0,0,0,0,0,0,0,2,1,1,0,0,0
162210,21000,210,0,-2,1,0,1,0,0,0,0,0,0,0,0,0,0,0,0,0,0,0,1,0,1,0,0,0,0,0,0,0,0,0
162283,21000,210,0,-2,9,5,4,0,0,0,2,1,1,7,4,3,0,0,0,0,0,0,0,0,0,0,0,0,0,0,0,0,0,0
162557,21000,210,0,-2,8,1,7,0,0,0,0,0,0,0,0,0,1,0,1,0,0,0,7,1,6,0,0,0,0,0,0,0,0,0
162584,21000,210,0,-2,13,4,9,0,0,0,1,0,1,0,0,0,0,0,0,0,0,0,10,2,8,0,0,0,0,0,0,2,2,0
162654,21000,210,0,-2,6,3,3,0,0,0,1,1,0,1,1,0,0,0,0,0,0,0,4,1,3,0,0,0,0,0,0,0,0,0
162690,21000,210,0,-2,2,2,0,0,0,0,0,0,0,0,0,0,0,0,0,0,0,0,1,1,0,0,0,0,1,1,0,0,0,0
162706,21000,210,0,-2,2,1,1,0,0,0,0,0,0,0,0,0,0,0,0,0,0,0,2,1,1,0,0,0,0,0,0,0,0,0
162760,21000,210,0,-2,13,6,7,0,0,0,3,1,2,1,0,1,0,0,0,0,0,0,8,5,3,0,0,0,1,0,1,0,0,0
162779,21000,210,0,-2,8,4,4,0,0,0,1,1,0,2,1,1,0,0,0,0,0,0,4,2,2,1,0,1,0,0,0,0,0,0
162928,21000,210,0,-2,234,122,112,0,0,0,51,24,27,18,9,9,11,4,7,0,0,0,121,67,54,6,5,1,1,1,0,26,12,14
163028,21000,210,0,-2,21,21,0,0,0,0,1,1,0,10,10,0,0,0,0,0,0,0,7,7,0,1,1,0,2,2,0,0,0,0
163046,21000,210,0,-2,21,10,11,0,0,0,2,0,2,2,0,2,3,2,1,0,0,0,14,8,6,0,0,0,0,0,0,0,0,0
163204,21000,210,0,-2,10,4,6,0,0,0,1,0,1,0,0,0,0,0,0,0,0,0,4,2,2,0,0,0,5,2,3,0,0,0
163259,21000,210,0,-2,164,77,87,0,0,0,37,20,17,14,7,7,14,4,10,0,0,0,75,32,43,1,0,1,1,1,0,22,13,9
163268,21000,210,0,-2,13,7,6,0,0,0,1,0,1,0,0,0,0,0,0,0,0,0,7,4,3,0,0,0,2,0,2,3,3,0
163286,21000,210,0,-2,70,36,34,0,0,0,6,4,2,4,2,2,8,1,7,0,0,0,27,16,11,0,0,0,11,5,6,14,8,6
163295,21000,210,0,-2,12,6,6,0,0,0,2,1,1,2,1,1,1,0,1,0,0,0,2,1,1,0,0,0,1,1,0,4,2,2
163338,21000,210,0,-2,13,6,7,0,0,0,2,1,1,5,4,1,1,1,0,0,0,0,3,0,3,1,0,1,1,0,1,0,0,0
163426,21000,210,0,-2,27,10,17,0,0,0,2,1,1,12,4,8,2,2,0,0,0,0,7,3,4,0,0,0,1,0,1,3,0,3
163453,21000,210,0,-2,11,8,3,0,0,0,1,1,0,6,5,1,1,0,1,0,0,0,1,1,0,0,0,0,1,1,0,1,0,1
163462,21000,210,0,-2,9,5,4,0,0,0,1,0,1,2,2,0,1,1,0,0,0,0,4,2,2,1,0,1,0,0,0,0,0,0
163532,21000,210,0,-2,1,1,0,0,0,0,0,0,0,0,0,0,0,0,0,0,0,0,1,1,0,0,0,0,0,0,0,0,0,0
163578,21000,210,0,-2,15,5,10,0,0,0,3,1,2,3,1,2,0,0,0,0,0,0,8,2,6,1,1,0,0,0,0,0,0,0
163657,21000,210,0,-2,11,5,6,0,0,0,1,0,1,4,1,3,0,0,0,0,0,0,5,4,1,1,0,1,0,0,0,0,0,0
163851,21000,210,0,-2,27,11,16,0,0,0,3,1,2,1,0,1,2,2,0,0,0,0,13,5,8,0,0,0,0,0,0,8,3,5
163912,21000,210,0,-2,11,5,6,0,0,0,0,0,0,0,0,0,2,1,1,0,0,0,6,2,4,0,0,0,0,0,0,3,2,1
163976,21000,210,0,-2,4,2,2,0,0,0,0,0,0,0,0,0,0,0,0,0,0,0,4,2,2,0,0,0,0,0,0,0,0,0
164076,21000,210,0,-2,63,32,31,1,0,1,11,4,7,2,1,1,3,1,2,0,0,0,42,25,17,1,0,1,2,1,1,1,0,1
164155,21000,210,0,-2,24,16,8,0,0,0,3,1,2,2,2,0,1,0,1,0,0,0,16,12,4,0,0,0,2,1,1,0,0,0
164173,21000,210,0,-2,6,3,3,0,0,0,0,0,0,2,1,1,0,0,0,0,0,0,4,2,2,0,0,0,0,0,0,0,0,0
164216,21000,210,0,-2,7,2,5,0,0,0,3,2,1,1,0,1,1,0,1,0,0,0,2,0,2,0,0,0,0,0,0,0,0,0
164270,21000,210,0,-2,20,6,14,0,0,0,2,0,2,3,1,2,2,1,1,0,0,0,13,4,9,0,0,0,0,0,0,0,0,0
164313,21000,210,0,-2,4,1,3,0,0,0,2,1,1,0,0,0,0,0,0,0,0,0,2,0,2,0,0,0,0,0,0,0,0,0
164368,21000,210,0,-2,16,11,5,0,0,0,5,3,2,1,1,0,2,1,1,0,0,0,5,4,1,0,0,0,3,2,1,0,0,0
164447,21000,210,0,-2,3,0,3,0,0,0,0,0,0,0,0,0,0,0,0,0,0,0,3,0,3,0,0,0,0,0,0,0,0,0
164465,21000,210,0,-2,23,10,13,0,0,0,1,0,1,7,5,2,2,1,1,0,0,0,9,2,7,0,0,0,0,0,0,4,2,2
164492,21000,210,0,-2,5,0,5,0,0,0,0,0,0,0,0,0,0,0,0,0,0,0,5,0,5,0,0,0,0,0,0,0,0,0
164562,21000,210,0,-2,5,2,3,0,0,0,0,0,0,0,0,0,1,0,1,0,0,0,3,2,1,1,0,1,0,0,0,0,0,0
164580,21000,210,0,-2,1,1,0,0,0,0,0,0,0,0,0,0,0,0,0,0,0,0,1,1,0,0,0,0,0,0,0,0,0,0
164632,21000,210,0,-2,2,0,2,0,0,0,0,0,0,0,0,0,0,0,0,0,0,0,2,0,2,0,0,0,0,0,0,0,0,0
164739,21000,210,0,-2,20,11,9,0,0,0,5,3,2,2,2,0,0,0,0,0,0,0,10,5,5,0,0,0,1,0,1,2,1,1
164748,21000,210,0,-2,9,8,1,1,1,0,1,1,0,0,0,0,2,2,0,0,0,0,5,4,1,0,0,0,0,0,0,0,0,0
164775,21000,210,0,-2,1,0,1,0,0,0,0,0,0,0,0,0,1,0,1,0,0,0,0,0,0,0,0,0,0,0,0,0,0,0
164924,21000,210,0,-2,46,23,23,0,0,0,4,1,3,7,3,4,3,2,1,0,0,0,31,16,15,1,1,0,0,0,0,0,0,0
164988,21000,210,0,-2,234,106,128,0,0,0,32,13,19,14,3,11,20,9,11,0,0,0,107,49,58,5,4,1,25,6,19,31,22,9
165015,21000,210,0,-2,20,10,10,0,0,0,1,1,0,1,0,1,1,0,1,0,0,0,12,7,5,0,0,0,2,1,1,3,1,2
165024,21000,210,0,-2,8,1,7,0,0,0,1,1,0,1,0,1,0,0,0,0,0,0,5,0,5,0,0,0,1,0,1,0,0,0
165033,21000,210,0,-2,7,2,5,0,0,0,0,0,0,0,0,0,0,0,0,0,0,0,7,2,5,0,0,0,0,0,0,0,0,0
165112,21000,210,0,-2,9,1,8,0,0,0,1,0,1,0,0,0,2,1,1,0,0,0,6,0,6,0,0,0,0,0,0,0,0,0
165194,21000,210,0,-2,3,0,3,0,0,0,0,0,0,0,0,0,1,0,1,0,0,0,2,0,2,0,0,0,0,0,0,0,0,0
165264,21000,210,0,-2,1,0,1,0,0,0,0,0,0,0,0,0,0,0,0,0,0,0,1,0,1,0,0,0,0,0,0,0,0,0
165334,21000,210,0,-2,34,18,16,0,0,0,1,0,1,7,4,3,1,1,0,0,0,0,16,9,7,2,0,2,0,0,0,7,4,3
165529,21000,210,0,-2,5,2,3,0,0,0,0,0,0,2,0,2,0,0,0,0,0,0,2,1,1,0,0,0,1,1,0,0,0,0
165574,21000,210,0,-2,2,1,1,0,0,0,0,0,0,0,0,0,0,0,0,0,0,0,2,1,1,0,0,0,0,0,0,0,0,0
165644,21000,210,0,-2,4,3,1,0,0,0,1,1,0,0,0,0,0,0,0,0,0,0,1,0,1,0,0,0,2,2,0,0,0,0
165662,21000,210,0,-2,9,4,5,0,0,0,1,0,1,4,2,2,0,0,0,0,0,0,2,1,1,0,0,0,2,1,1,0,0,0
165671,21000,210,0,-2,4,1,3,0,0,0,0,0,0,0,0,0,1,0,1,0,0,0,3,1,2,0,0,0,0,0,0,0,0,0
165699,21000,210,0,-2,5,1,4,0,0,0,1,0,1,0,0,0,0,0,0,0,0,0,2,1,1,0,0,0,2,0,2,0,0,0
165802,21000,210,0,-2,3,1,2,0,0,0,1,0,1,0,0,0,0,0,0,0,0,0,2,1,1,0,0,0,0,0,0,0,0,0
165820,21000,210,0,-2,3,0,3,0,0,0,0,0,0,0,0,0,0,0,0,0,0,0,3,0,3,0,0,0,0,0,0,0,0,0
165866,21000,210,0,-2,3,0,3,0,0,0,0,0,0,0,0,0,0,0,0,0,0,0,3,0,3,0,0,0,0,0,0,0,0,0
165884,21000,210,0,-2,1,1,0,0,0,0,0,0,0,0,0,0,0,0,0,0,0,0,1,1,0,0,0,0,0,0,0,0,0,0
165936,21000,210,0,-2,8,2,6,0,0,0,2,0,2,0,0,0,0,0,0,0,0,0,4,2,2,0,0,0,2,0,2,0,0,0
165945,21000,210,0,-2,2,0,2,0,0,0,0,0,0,0,0,0,0,0,0,0,0,0,2,0,2,0,0,0,0,0,0,0,0,0
165981,21000,210,0,-2,2,1,1,0,0,0,0,0,0,0,0,0,0,0,0,0,0,0,2,1,1,0,0,0,0,0,0,0,0,0
166018,21000,210,0,-2,2,1,1,0,0,0,0,0,0,0,0,0,1,1,0,0,0,0,1,0,1,0,0,0,0,0,0,0,0,0
166027,21000,210,0,-2,132,59,73,0,0,0,9,3,6,9,5,4,16,5,11,0,0,0,74,31,43,3,2,1,1,1,0,20,12,8
166045,21000,210,0,-2,1,0,1,0,0,0,0,0,0,0,0,0,0,0,0,0,0,0,1,0,1,0,0,0,0,0,0,0,0,0
166124,21000,210,0,-2,20,11,9,0,0,0,2,1,1,0,0,0,3,1,2,0,0,0,10,6,4,1,0,1,2,1,1,2,2,0
166133,21000,210,0,-2,2,0,2,0,0,0,1,0,1,0,0,0,0,0,0,0,0,0,1,0,1,0,0,0,0,0,0,0,0,0
166391,21000,210,0,-2,2,1,1,0,0,0,0,0,0,0,0,0,0,0,0,0,0,0,0,0,0,1,1,0,1,0,1,0,0,0
166407,21000,210,0,-2,2,0,2,0,0,0,0,0,0,0,0,0,0,0,0,0,0,0,2,0,2,0,0,0,0,0,0,0,0,0
166452,21000,210,0,-2,9,5,4,0,0,0,2,1,1,2,0,2,0,0,0,0,0,0,5,4,1,0,0,0,0,0,0,0,0,0
166513,21000,210,0,-2,24,13,11,0,0,0,1,0,1,0,0,0,3,1,2,0,0,0,10,6,4,0,0,0,2,2,0,8,4,4
166629,21000,210,0,-2,49,20,29,1,1,0,2,0,2,4,1,3,3,0,3,0,0,0,23,10,13,0,0,0,0,0,0,16,8,8
166638,21000,210,0,-2,34,11,23,1,0,1,4,0,4,2,0,2,2,1,1,0,0,0,14,7,7,0,0,0,4,1,3,7,2,5
166647,21000,210,0,-2,6,0,6,0,0,0,1,0,1,2,0,2,0,0,0,0,0,0,2,0,2,0,0,0,1,0,1,0,0,0
166656,21000,210,0,-2,11,1,10,0,0,0,1,1,0,0,0,0,0,0,0,0,0,0,8,0,8,1,0,1,1,0,1,0,0,0
166674,21000,210,0,-2,17,5,12,0,0,0,2,1,1,1,1,0,3,1,2,0,0,0,8,2,6,0,0,0,3,0,3,0,0,0
166683,21000,210,0,-2,80,51,29,0,0,0,4,2,2,13,9,4,3,2,1,0,0,0,28,14,14,4,2,2,9,7,2,19,15,4
166692,21000,210,0,-2,1,1,0,0,0,0,0,0,0,0,0,0,0,0,0,0,0,0,1,1,0,0,0,0,0,0,0,0,0,0
166708,21000,210,0,-2,205,106,99,0,0,0,46,22,24,5,2,3,10,3,7,0,0,0,77,43,34,0,0,0,6,2,4,61,34,27
166717,21000,210,0,-2,11,3,8,0,0,0,0,0,0,2,0,2,1,0,1,0,0,0,8,3,5,0,0,0,0,0,0,0,0,0
166823,21000,210,0,-2,1,0,1,0,0,0,0,0,0,0,0,0,0,0,0,0,0,0,1,0,1,0,0,0,0,0,0,0,0,0
166850,21000,210,0,-2,15,3,12,0,0,0,1,0,1,2,1,1,0,0,0,0,0,0,9,1,8,2,0,2,1,1,0,0,0,0
166869,21000,210,0,-2,9,1,8,0,0,0,0,0,0,0,0,0,0,0,0,0,0,0,9,1,8,0,0,0,0,0,0,0,0,0
166911,21000,210,0,-2,4,1,3,0,0,0,1,0,1,0,0,0,0,0,0,0,0,0,1,0,1,0,0,0,2,1,1,0,0,0
166939,21000,210,0,-2,24,7,17,0,0,0,3,1,2,3,1,2,0,0,0,0,0,0,8,2,6,0,0,0,5,1,4,5,2,3
166957,21000,210,0,-2,5,2,3,0,0,0,0,0,0,0,0,0,1,0,1,0,0,0,4,2,2,0,0,0,0,0,0,0,0,0
167057,21000,210,0,-2,3,2,1,0,0,0,0,0,0,1,0,1,0,0,0,0,0,0,2,2,0,0,0,0,0,0,0,0,0,0
167093,21000,210,0,-2,2,0,2,0,0,0,0,0,0,0,0,0,0,0,0,0,0,0,1,0,1,0,0,0,1,0,1,0,0,0
167215,21000,210,0,-2,6,1,5,0,0,0,0,0,0,0,0,0,1,0,1,0,0,0,5,1,4,0,0,0,0,0,0,0,0,0
167260,21000,210,0,-2,4,4,0,0,0,0,0,0,0,1,1,0,0,0,0,0,0,0,3,3,0,0,0,0,0,0,0,0,0,0
167288,21000,210,0,-2,4,3,1,0,0,0,0,0,0,0,0,0,0,0,0,0,0,0,4,3,1,0,0,0,0,0,0,0,0,0
167312,21000,210,0,-2,6,0,6,0,0,0,0,0,0,0,0,0,1,0,1,0,0,0,5,0,5,0,0,0,0,0,0,0,0,0
167358,21000,210,0,-2,115,71,44,0,0,0,19,12,7,4,2,2,4,3,1,0,0,0,54,32,22,3,1,2,20,13,7,11,8,3
167376,21000,210,0,-2,8,2,6,0,0,0,0,0,0,1,0,1,0,0,0,0,0,0,7,2,5,0,0,0,0,0,0,0,0,0
167394,21000,210,0,-2,4,0,4,0,0,0,0,0,0,1,0,1,0,0,0,0,0,0,3,0,3,0,0,0,0,0,0,0,0,0
167525,21000,210,0,-2,5,2,3,0,0,0,0,0,0,0,0,0,1,1,0,0,0,0,4,1,3,0,0,0,0,0,0,0,0,0
167534,21000,210,0,-2,9,3,6,0,0,0,2,0,2,0,0,0,1,1,0,0,0,0,6,2,4,0,0,0,0,0,0,0,0,0
167598,21000,210,0,-2,9,1,8,0,0,0,0,0,0,5,1,4,2,0,2,0,0,0,2,0,2,0,0,0,0,0,0,0,0,0
167631,21000,210,0,-2,1,1,0,0,0,0,0,0,0,1,1,0,0,0,0,0,0,0,0,0,0,0,0,0,0,0,0,0,0,0
167677,21000,210,0,-2,1,1,0,0,0,0,0,0,0,0,0,0,0,0,0,0,0,0,1,1,0,0,0,0,0,0,0,0,0,0
167729,21000,210,0,-2,16,6,10,0,0,0,0,0,0,1,1,0,1,1,0,0,0,0,14,4,10,0,0,0,0,0,0,0,0,0
167783,21000,210,0,-2,27,9,18,0,0,0,1,0,1,6,1,5,2,1,1,0,0,0,16,6,10,0,0,0,0,0,0,2,1,1
167792,21000,210,0,-2,3,1,2,0,0,0,1,0,1,0,0,0,0,0,0,0,0,0,1,0,1,0,0,0,0,0,0,1,1,0
167835,21000,210,0,-2,19,3,16,0,0,0,1,0,1,6,1,5,0,0,0,0,0,0,5,1,4,2,0,2,0,0,0,5,1,4
167899,21000,210,0,-2,26,11,15,0,0,0,4,3,1,2,0,2,1,0,1,0,0,0,15,6,9,3,2,1,1,0,1,0,0,0
167905,21000,210,0,-2,3,0,3,0,0,0,0,0,0,0,0,0,1,0,1,0,0,0,2,0,2,0,0,0,0,0,0,0,0,0
167987,21000,210,0,-2,13,4,9,0,0,0,0,0,0,1,0,1,0,0,0,0,0,0,12,4,8,0,0,0,0,0,0,0,0,0
167996,21000,210,0,-2,12,6,6,0,0,0,1,1,0,0,0,0,0,0,0,0,0,0,1,0,1,0,0,0,10,5,5,0,0,0
168005,21000,210,0,-2,9,3,6,0,0,0,2,0,2,0,0,0,1,0,1,0,0,0,6,3,3,0,0,0,0,0,0,0,0,0
168148,21000,210,0,-2,66,31,35,0,0,0,8,3,5,8,4,4,7,3,4,0,0,0,31,16,15,2,1,1,2,0,2,8,4,4
168218,21000,210,0,-2,13,3,10,0,0,0,1,0,1,0,0,0,1,0,1,1,1,0,5,1,4,1,1,0,1,0,1,3,0,3
168227,21000,210,0,-2,8,4,4,0,0,0,1,1,0,0,0,0,0,0,0,0,0,0,5,2,3,0,0,0,2,1,1,0,0,0
168254,21000,210,0,-2,3,1,2,0,0,0,1,1,0,0,0,0,0,0,0,0,0,0,1,0,1,0,0,0,1,0,1,0,0,0
168263,21000,210,0,-2,3,0,3,0,0,0,1,0,1,0,0,0,0,0,0,0,0,0,2,0,2,0,0,0,0,0,0,0,0,0
168281,21000,210,0,-2,9,2,7,0,0,0,1,0,1,2,1,1,1,1,0,0,0,0,5,0,5,0,0,0,0,0,0,0,0,0
168342,21000,210,0,-2,20,8,12,0,0,0,2,0,2,4,0,4,4,2,2,0,0,0,4,2,2,0,0,0,0,0,0,6,4,2
168421,21000,210,0,-2,31,19,12,0,0,0,3,2,1,1,0,1,3,1,2,0,0,0,12,8,4,1,0,1,4,2,2,7,6,1
168430,21000,210,0,-2,30,5,25,1,1,0,0,0,0,0,0,0,0,0,0,0,0,0,28,4,24,1,0,1,0,0,0,0,0,0
168528,21000,210,0,-2,4,1,3,0,0,0,0,0,0,0,0,0,0,0,0,0,0,0,4,1,3,0,0,0,0,0,0,0,0,0
168546,21000,210,0,-2,17,8,9,0,0,0,3,1,2,1,1,0,3,1,2,0,0,0,9,4,5,0,0,0,0,0,0,1,1,0
168591,21000,210,0,-2,7,2,5,0,0,0,2,1,1,1,1,0,0,0,0,0,0,0,4,0,4,0,0,0,0,0,0,0,0,0
168607,21000,210,0,-2,4,2,2,0,0,0,0,0,0,0,0,0,0,0,0,0,0,0,4,2,2,0,0,0,0,0,0,0,0,0
168740,21000,210,0,-2,17,7,10,0,0,0,1,1,0,3,2,1,3,2,1,0,0,0,6,2,4,1,0,1,0,0,0,3,0,3
168847,21000,210,0,-2,12,4,8,0,0,0,0,0,0,1,0,1,0,0,0,0,0,0,11,4,7,0,0,0,0,0,0,0,0,0
168883,21000,210,0,-2,1,1,0,0,0,0,0,0,0,0,0,0,0,0,0,0,0,0,1,1,0,0,0,0,0,0,0,0,0,0
169080,21000,210,0,-2,4,1,3,0,0,0,1,0,1,0,0,0,0,0,0,0,0,0,3,1,2,0,0,0,0,0,0,0,0,0
169220,21000,210,0,-2,2,1,1,0,0,0,0,0,0,1,1,0,0,0,0,0,0,0,1,0,1,0,0,0,0,0,0,0,0,0
169248,21000,210,0,-2,20,10,10,0,0,0,2,0,2,0,0,0,0,0,0,0,0,0,17,9,8,0,0,0,0,0,0,1,1,0
169275,21000,210,0,-2,1,1,0,0,0,0,0,0,0,0,0,0,0,0,0,0,0,0,1,1,0,0,0,0,0,0,0,0,0,0
169327,21000,210,0,-2,2,1,1,0,0,0,0,0,0,0,0,0,0,0,0,0,0,0,2,1,1,0,0,0,0,0,0,0,0,0
169363,21000,210,0,-2,8,4,4,0,0,0,0,0,0,0,0,0,0,0,0,0,0,0,8,4,4,0,0,0,0,0,0,0,0,0
169424,21000,210,0,-2,1,1,0,0,0,0,0,0,0,0,0,0,0,0,0,0,0,0,1,1,0,0,0,0,0,0,0,0,0,0
169479,21000,210,0,-2,11,5,6,0,0,0,0,0,0,2,2,0,0,0,0,0,0,0,6,1,5,1,0,1,1,1,0,1,1,0
169521,21000,210,0,-2,2,0,2,0,0,0,0,0,0,0,0,0,0,0,0,0,0,0,2,0,2,0,0,0,0,0,0,0,0,0
169655,21000,210,0,-2,14,11,3,0,0,0,0,0,0,5,5,0,1,1,0,0,0,0,7,4,3,1,1,0,0,0,0,0,0,0
169716,21000,210,0,-2,24,7,17,0,0,0,1,0,1,0,0,0,1,0,1,0,0,0,5,1,4,0,0,0,2,0,2,15,6,9
169761,21000,210,0,-2,3,1,2,0,0,0,0,0,0,1,0,1,0,0,0,0,0,0,2,1,1,0,0,0,0,0,0,0,0,0
169798,21000,210,0,-2,19,9,10,1,1,0,2,0,2,2,1,1,1,1,0,0,0,0,12,6,6,0,0,0,1,0,1,0,0,0
169910,21000,210,0,-2,3,2,1,0,0,0,0,0,0,0,0,0,0,0,0,0,0,0,2,1,1,0,0,0,0,0,0,1,1,0
169983,21000,210,0,-2,12,5,7,0,0,0,3,1,2,1,0,1,0,0,0,0,0,0,7,4,3,1,0,1,0,0,0,0,0,0
169992,21000,210,0,-2,3,2,1,0,0,0,0,0,0,0,0,0,0,0,0,0,0,0,3,2,1,0,0,0,0,0,0,0,0,0
170037,21000,210,0,-2,4,3,1,0,0,0,0,0,0,0,0,0,1,0,1,0,0,0,3,3,0,0,0,0,0,0,0,0,0,0
170055,21000,210,0,-2,17,7,10,0,0,0,0,0,0,1,0,1,0,0,0,0,0,0,16,7,9,0,0,0,0,0,0,0,0,0
170082,21000,210,0,-2,49,27,22,0,0,0,2,1,1,1,0,1,2,1,1,0,0,0,39,21,18,0,0,0,2,2,0,3,2,1
170240,21000,210,0,-2,18,7,11,0,0,0,2,2,0,3,1,2,0,0,0,0,0,0,12,4,8,0,0,0,0,0,0,1,0,1
170286,21000,210,0,-2,22,19,3,0,0,0,0,0,0,0,0,0,0,0,0,0,0,0,0,0,0,0,0,0,22,19,3,0,0,0
170301,21000,210,0,-2,20,7,13,0,0,0,2,0,2,1,1,0,1,1,0,1,1,0,12,4,8,2,0,2,0,0,0,1,0,1
170532,21000,210,0,-2,9,6,3,0,0,0,2,1,1,4,2,2,0,0,0,0,0,0,3,3,0,0,0,0,0,0,0,0,0,0
170541,21000,210,0,-2,2,2,0,0,0,0,0,0,0,0,0,0,0,0,0,0,0,0,1,1,0,0,0,0,1,1,0,0,0,0
170550,21000,210,0,-2,9,5,4,0,0,0,1,1,0,0,0,0,0,0,0,0,0,0,8,4,4,0,0,0,0,0,0,0,0,0
170587,21000,210,0,-2,4,2,2,0,0,0,0,0,0,0,0,0,0,0,0,0,0,0,4,2,2,0,0,0,0,0,0,0,0,0
170620,21000,210,0,-2,4,2,2,0,0,0,0,0,0,2,1,1,0,0,0,0,0,0,2,1,1,0,0,0,0,0,0,0,0,0
170639,21000,210,0,-2,17,7,10,0,0,0,0,0,0,0,0,0,0,0,0,0,0,0,15,5,10,0,0,0,1,1,0,1,1,0
170657,21000,210,0,-2,8,4,4,0,0,0,0,0,0,2,1,1,0,0,0,0,0,0,6,3,3,0,0,0,0,0,0,0,0,0
170675,21000,210,0,-2,17,11,6,0,0,0,1,1,0,0,0,0,1,1,0,0,0,0,12,8,4,0,0,0,1,1,0,2,0,2
170806,21000,210,0,-2,4,2,2,0,0,0,0,0,0,0,0,0,0,0,0,0,0,0,4,2,2,0,0,0,0,0,0,0,0,0
170967,21000,210,0,-2,5,1,4,0,0,0,0,0,0,1,0,1,0,0,0,0,0,0,4,1,3,0,0,0,0,0,0,0,0,0
170976,21000,210,0,-2,667,379,288,2,2,0,49,19,30,24,12,12,14,9,5,0,0,0,255,116,139,12,7,5,18,11,7,293,203,90
171100,21000,210,0,-2,96,43,53,0,0,0,13,10,3,5,2,3,8,3,5,0,0,0,54,18,36,1,0,1,0,0,0,15,10,5
171128,21000,210,0,-2,12,7,5,0,0,0,1,1,0,0,0,0,0,0,0,0,0,0,3,2,1,0,0,0,2,1,1,6,3,3
171137,21000,210,0,-2,7,5,2,0,0,0,1,0,1,0,0,0,0,0,0,0,0,0,4,4,0,1,0,1,0,0,0,1,1,0
171146,21000,210,0,-2,8,2,6,0,0,0,0,0,0,1,0,1,0,0,0,0,0,0,6,2,4,0,0,0,0,0,0,1,0,1
171234,21000,210,0,-2,2,0,2,0,0,0,0,0,0,0,0,0,0,0,0,0,0,0,2,0,2,0,0,0,0,0,0,0,0,0
171304,21000,210,0,-2,1,1,0,0,0,0,0,0,0,0,0,0,0,0,0,0,0,0,1,1,0,0,0,0,0,0,0,0,0,0
171395,21000,210,0,-2,3,2,1,0,0,0,0,0,0,0,0,0,0,0,0,0,0,0,3,2,1,0,0,0,0,0,0,0,0,0
171456,21000,210,0,-2,16,8,8,0,0,0,0,0,0,0,0,0,0,0,0,0,0,0,14,7,7,0,0,0,1,0,1,1,1,0
171483,21000,210,0,-2,3,0,3,0,0,0,0,0,0,0,0,0,0,0,0,0,0,0,3,0,3,0,0,0,0,0,0,0,0,0
171535,21000,210,0,-2,11,4,7,0,0,0,0,0,0,2,1,1,0,0,0,0,0,0,9,3,6,0,0,0,0,0,0,0,0,0
171571,21000,210,0,-2,27,11,16,1,1,0,3,3,0,1,1,0,0,0,0,0,0,0,16,4,12,0,0,0,0,0,0,6,2,4
171599,21000,210,0,-2,3,0,3,0,0,0,0,0,0,1,0,1,1,0,1,0,0,0,1,0,1,0,0,0,0,0,0,0,0,0
171881,21000,210,0,-2,1,0,1,0,0,0,0,0,0,0,0,0,0,0,0,0,0,0,1,0,1,0,0,0,0,0,0,0,0,0
172033,21000,210,0,-2,4,3,1,0,0,0,0,0,0,0,0,0,0,0,0,0,0,0,4,3,1,0,0,0,0,0,0,0,0,0
172051,21000,210,0,-2,13,8,5,0,0,0,0,0,0,0,0,0,0,0,0,0,0,0,13,8,5,0,0,0,0,0,0,0,0,0
172200,21000,210,0,-2,5,3,2,0,0,0,0,0,0,1,1,0,0,0,0,0,0,0,3,2,1,0,0,0,1,0,1,0,0,0
172264,21000,210,0,-2,4,1,3,0,0,0,0,0,0,0,0,0,0,0,0,0,0,0,4,1,3,0,0,0,0,0,0,0,0,0
172291,21000,210,0,-2,5,2,3,0,0,0,0,0,0,0,0,0,0,0,0,0,0,0,5,2,3,0,0,0,0,0,0,0,0,0
172307,21000,210,0,-2,4,2,2,0,0,0,0,0,0,0,0,0,0,0,0,0,0,0,2,1,1,0,0,0,2,1,1,0,0,0
172334,21000,210,0,-2,8,3,5,0,0,0,0,0,0,0,0,0,0,0,0,0,0,0,7,2,5,0,0,0,1,1,0,0,0,0
172440,21000,210,0,-2,11,2,9,0,0,0,0,0,0,0,0,0,0,0,0,0,0,0,11,2,9,0,0,0,0,0,0,0,0,0
172617,21000,210,0,-2,1,1,0,1,1,0,0,0,0,0,0,0,0,0,0,0,0,0,0,0,0,0,0,0,0,0,0,0,0,0
172635,21000,210,0,-2,3,1,2,0,0,0,0,0,0,2,1,1,0,0,0,0,0,0,1,0,1,0,0,0,0,0,0,0,0,0
172644,21000,210,0,-2,69,37,32,0,0,0,5,2,3,6,2,4,1,1,0,0,0,0,41,26,15,1,0,1,0,0,0,15,6,9
172671,21000,210,0,-2,1,1,0,0,0,0,0,0,0,0,0,0,0,0,0,0,0,0,1,1,0,0,0,0,0,0,0,0,0,0
172699,21000,210,0,-2,16,5,11,0,0,0,2,0,2,4,1,3,0,0,0,0,0,0,10,4,6,0,0,0,0,0,0,0,0,0
172705,21000,210,0,-2,1,1,0,0,0,0,0,0,0,0,0,0,1,1,0,0,0,0,0,0,0,0,0,0,0,0,0,0,0,0
172918,21000,210,0,-2,2,2,0,0,0,0,0,0,0,0,0,0,0,0,0,0,0,0,2,2,0,0,0,0,0,0,0,0,0,0
172963,21000,210,0,-2,3,0,3,0,0,0,1,0,1,0,0,0,0,0,0,0,0,0,2,0,2,0,0,0,0,0,0,0,0,0
173045,21000,210,0,-2,11,1,10,0,0,0,2,0,2,0,0,0,1,0,1,1,0,1,4,1,3,1,0,1,2,0,2,0,0,0
173063,21000,210,0,-2,4,2,2,0,0,0,0,0,0,0,0,0,0,0,0,0,0,0,4,2,2,0,0,0,0,0,0,0,0,0
173115,21000,210,0,-2,1,1,0,0,0,0,0,0,0,0,0,0,0,0,0,0,0,0,1,1,0,0,0,0,0,0,0,0,0,0
173124,21000,210,0,-2,17,9,8,2,1,1,1,1,0,0,0,0,1,1,0,0,0,0,9,5,4,1,0,1,3,1,2,0,0,0
173142,21000,210,0,-2,3,1,2,0,0,0,0,0,0,0,0,0,0,0,0,0,0,0,3,1,2,0,0,0,0,0,0,0,0,0
173160,21000,210,0,-2,11,5,6,0,0,0,0,0,0,0,0,0,0,0,0,0,0,0,9,4,5,0,0,0,2,1,1,0,0,0
173203,21000,210,0,-2,3,1,2,0,0,0,0,0,0,0,0,0,0,0,0,0,0,0,2,0,2,0,0,0,1,1,0,0,0,0
173258,21000,210,0,-2,25,12,13,0,0,0,4,1,3,0,0,0,7,5,2,0,0,0,13,6,7,1,0,1,0,0,0,0,0,0
173300,21000,210,0,-2,6,2,4,0,0,0,0,0,0,0,0,0,1,0,1,0,0,0,5,2,3,0,0,0,0,0,0,0,0,0
173328,21000,210,0,-2,5,1,4,0,0,0,0,0,0,0,0,0,0,0,0,0,0,0,4,1,3,0,0,0,1,0,1,0,0,0
173416,21000,210,0,-2,5,4,1,0,0,0,1,0,1,0,0,0,0,0,0,0,0,0,4,4,0,0,0,0,0,0,0,0,0,0
173452,21000,210,0,-2,5,5,0,0,0,0,0,0,0,1,1,0,0,0,0,0,0,0,4,4,0,0,0,0,0,0,0,0,0,0
173461,21000,210,0,-2,2,1,1,0,0,0,0,0,0,0,0,0,0,0,0,0,0,0,1,1,0,0,0,0,1,0,1,0,0,0
173638,21000,210,0,-2,5,4,1,0,0,0,0,0,0,0,0,0,0,0,0,0,0,0,5,4,1,0,0,0,0,0,0,0,0,0
173647,21000,210,0,-2,4,0,4,0,0,0,0,0,0,1,0,1,0,0,0,0,0,0,3,0,3,0,0,0,0,0,0,0,0,0
173665,21000,210,0,-2,4,2,2,0,0,0,0,0,0,0,0,0,1,0,1,0,0,0,2,1,1,0,0,0,1,1,0,0,0,0
173708,21000,210,0,-2,1,1,0,0,0,0,0,0,0,0,0,0,0,0,0,0,0,0,1,1,0,0,0,0,0,0,0,0,0,0
173799,21000,210,0,-2,6,3,3,0,0,0,1,1,0,1,0,1,1,1,0,0,0,0,2,1,1,0,0,0,1,0,1,0,0,0
173805,21000,210,0,-2,2,2,0,0,0,0,0,0,0,0,0,0,0,0,0,0,0,0,2,2,0,0,0,0,0,0,0,0,0,0
173902,21000,210,0,-2,14,7,7,0,0,0,2,0,2,1,1,0,1,0,1,0,0,0,6,5,1,0,0,0,0,0,0,4,1,3
173911,21000,210,0,-2,9,6,3,0,0,0,0,0,0,1,1,0,0,0,0,0,0,0,8,5,3,0,0,0,0,0,0,0,0,0
173920,21000,210,0,-2,32,11,21,0,0,0,4,1,3,2,0,2,4,2,2,0,0,0,22,8,14,0,0,0,0,0,0,0,0,0
174020,21000,210,0,-2,11,3,8,0,0,0,2,0,2,1,0,1,1,0,1,0,0,0,5,2,3,0,0,0,2,1,1,0,0,0
174066,21000,210,0,-2,221,115,106,1,0,1,20,13,7,14,7,7,7,3,4,1,1,0,119,59,60,10,4,6,30,18,12,19,10,9
174075,21000,210,0,-2,6,3,3,0,0,0,0,0,0,0,0,0,0,0,0,0,0,0,5,2,3,0,0,0,0,0,0,1,1,0
174127,21000,210,0,-2,2,0,2,0,0,0,0,0,0,1,0,1,0,0,0,0,0,0,1,0,1,0,0,0,0,0,0,0,0,0
174136,21000,210,0,-2,3,2,1,0,0,0,0,0,0,0,0,0,0,0,0,0,0,0,3,2,1,0,0,0,0,0,0,0,0,0
174154,21000,210,0,-2,7,0,7,0,0,0,0,0,0,0,0,0,0,0,0,0,0,0,7,0,7,0,0,0,0,0,0,0,0,0
174233,21000,210,0,-2,30,17,13,0,0,0,2,1,1,0,0,0,1,1,0,0,0,0,20,9,11,0,0,0,2,2,0,5,4,1
174251,21000,210,0,-2,4,2,2,0,0,0,0,0,0,0,0,0,0,0,0,0,0,0,1,1,0,1,0,1,2,1,1,0,0,0
174358,21000,210,0,-2,13,4,9,0,0,0,0,0,0,0,0,0,0,0,0,0,0,0,11,3,8,0,0,0,1,1,0,1,0,1
174376,21000,210,0,-2,2,1,1,0,0,0,0,0,0,0,0,0,0,0,0,0,0,0,1,1,0,0,0,0,1,0,1,0,0,0
174428,21000,210,0,-2,5,1,4,0,0,0,2,1,1,0,0,0,0,0,0,0,0,0,3,0,3,0,0,0,0,0,0,0,0,0
174437,21000,210,0,-2,1,0,1,0,0,0,0,0,0,0,0,0,0,0,0,0,0,0,1,0,1,0,0,0,0,0,0,0,0,0
174473,21000,210,0,-2,3,2,1,0,0,0,0,0,0,0,0,0,0,0,0,0,0,0,3,2,1,0,0,0,0,0,0,0,0,0
174491,21000,210,0,-2,3,2,1,0,0,0,0,0,0,0,0,0,1,1,0,0,0,0,2,1,1,0,0,0,0,0,0,0,0,0
174507,21000,210,0,-2,2,0,2,0,0,0,0,0,0,0,0,0,0,0,0,0,0,0,2,0,2,0,0,0,0,0,0,0,0,0
174525,21000,210,0,-2,1,1,0,0,0,0,0,0,0,0,0,0,0,0,0,0,0,0,1,1,0,0,0,0,0,0,0,0,0,0
174570,21000,210,0,-2,1,0,1,0,0,0,0,0,0,0,0,0,0,0,0,0,0,0,1,0,1,0,0,0,0,0,0,0,0,0
174738,21000,210,0,-2,1,0,1,0,0,0,0,0,0,0,0,0,0,0,0,0,0,0,1,0,1,0,0,0,0,0,0,0,0,0
174747,21000,210,0,-2,6,3,3,0,0,0,1,0,1,1,0,1,0,0,0,0,0,0,3,2,1,0,0,0,1,1,0,0,0,0
174756,21000,210,0,-2,3,1,2,0,0,0,0,0,0,0,0,0,0,0,0,0,0,0,3,1,2,0,0,0,0,0,0,0,0,0
174783,21000,210,0,-2,21,12,9,0,0,0,5,4,1,1,1,0,1,1,0,0,0,0,11,4,7,0,0,0,3,2,1,0,0,0
174792,21000,210,0,-2,8,5,3,0,0,0,1,0,1,0,0,0,1,1,0,0,0,0,5,3,2,1,1,0,0,0,0,0,0,0
174817,21000,210,0,-2,4,2,2,0,0,0,0,0,0,1,1,0,0,0,0,0,0,0,3,1,2,0,0,0,0,0,0,0,0,0
174844,21000,210,0,-2,18,10,8,0,0,0,1,0,1,1,1,0,1,1,0,0,0,0,13,7,6,0,0,0,1,1,0,1,0,1
174862,21000,210,0,-2,2,2,0,0,0,0,1,1,0,0,0,0,0,0,0,0,0,0,1,1,0,0,0,0,0,0,0,0,0,0
174899,21000,210,0,-2,10,6,4,0,0,0,1,1,0,0,0,0,0,0,0,0,0,0,8,4,4,1,1,0,0,0,0,0,0,0
174914,21000,210,0,-2,15,6,9,0,0,0,2,1,1,1,0,1,2,1,1,0,0,0,9,4,5,0,0,0,0,0,0,1,0,1
175005,21000,210,0,-2,30,3,27,0,0,0,1,1,0,5,0,5,0,0,0,0,0,0,24,2,22,0,0,0,0,0,0,0,0,0
175014,21000,210,0,-2,20,4,16,0,0,0,0,0,0,2,1,1,0,0,0,0,0,0,16,2,14,1,1,0,1,0,1,0,0,0
175041,21000,210,0,-2,4,2,2,0,0,0,0,0,0,0,0,0,1,1,0,0,0,0,3,1,2,0,0,0,0,0,0,0,0,0
175078,21000,210,0,-2,4,2,2,0,0,0,0,0,0,0,0,0,0,0,0,0,0,0,4,2,2,0,0,0,0,0,0,0,0,0
175227,21000,210,0,-2,11,7,4,0,0,0,1,0,1,0,0,0,0,0,0,0,0,0,10,7,3,0,0,0,0,0,0,0,0,0
175236,21000,210,0,-2,4,2,2,0,0,0,0,0,0,0,0,0,0,0,0,0,0,0,3,2,1,0,0,0,1,0,1,0,0,0
175263,21000,210,0,-2,2,1,1,0,0,0,0,0,0,0,0,0,0,0,0,0,0,0,2,1,1,0,0,0,0,0,0,0,0,0
175272,21000,210,0,-2,23,6,17,0,0,0,2,1,1,0,0,0,1,0,1,0,0,0,17,4,13,1,0,1,2,1,1,0,0,0
175281,21000,210,0,-2,5,1,4,0,0,0,0,0,0,3,1,2,0,0,0,0,0,0,2,0,2,0,0,0,0,0,0,0,0,0
175315,21000,210,0,-2,1,1,0,0,0,0,0,0,0,1,1,0,0,0,0,0,0,0,0,0,0,0,0,0,0,0,0,0,0,0
175342,21000,210,0,-2,8,4,4,0,0,0,0,0,0,7,4,3,0,0,0,0,0,0,1,0,1,0,0,0,0,0,0,0,0,0
175421,21000,210,0,-2,6,2,4,0,0,0,0,0,0,2,0,2,0,0,0,0,0,0,4,2,2,0,0,0,0,0,0,0,0,0
175430,21000,210,0,-2,3,2,1,0,0,0,0,0,0,1,1,0,0,0,0,0,0,0,2,1,1,0,0,0,0,0,0,0,0,0
175519,21000,210,0,-2,8,4,4,0,0,0,0,0,0,5,2,3,0,0,0,0,0,0,3,2,1,0,0,0,0,0,0,0,0,0
175573,21000,210,0,-2,4,0,4,0,0,0,0,0,0,1,0,1,0,0,0,0,0,0,2,0,2,1,0,1,0,0,0,0,0,0
175616,21000,210,0,-2,12,7,5,0,0,0,2,2,0,1,0,1,0,0,0,0,0,0,7,4,3,0,0,0,0,0,0,2,1,1
175643,21000,210,0,-2,4,3,1,0,0,0,0,0,0,0,0,0,0,0,0,0,0,0,4,3,1,0,0,0,0,0,0,0,0,0
175652,21000,210,0,-2,2,1,1,0,0,0,0,0,0,1,0,1,0,0,0,0,0,0,1,1,0,0,0,0,0,0,0,0,0,0
175786,21000,210,0,-2,31,13,18,0,0,0,0,0,0,11,3,8,1,0,1,0,0,0,18,10,8,0,0,0,1,0,1,0,0,0
175810,21000,210,0,-2,11,1,10,0,0,0,0,0,0,2,0,2,0,0,0,0,0,0,9,1,8,0,0,0,0,0,0,0,0,0
175829,21000,210,0,-2,5,1,4,0,0,0,0,0,0,0,0,0,0,0,0,0,0,0,5,1,4,0,0,0,0,0,0,0,0,0
175856,21000,210,0,-2,29,10,19,0,0,0,3,3,0,20,4,16,0,0,0,0,0,0,5,2,3,0,0,0,0,0,0,1,1,0
175883,21000,210,0,-2,18,10,8,0,0,0,1,1,0,3,0,3,0,0,0,0,0,0,14,9,5,0,0,0,0,0,0,0,0,0
175935,21000,210,0,-2,7,1,6,0,0,0,0,0,0,3,1,2,0,0,0,0,0,0,3,0,3,0,0,0,1,0,1,0,0,0
175980,21000,210,0,-2,2,1,1,0,0,0,0,0,0,0,0,0,1,0,1,0,0,0,1,1,0,0,0,0,0,0,0,0,0,0
176008,21000,210,0,-2,10,3,7,0,0,0,0,0,0,4,2,2,0,0,0,0,0,0,6,1,5,0,0,0,0,0,0,0,0,0
176017,21000,210,0,-2,105,48,57,0,0,0,9,6,3,15,3,12,3,1,2,0,0,0,56,28,28,2,1,1,1,1,0,19,8,11
176035,21000,210,0,-2,15,3,12,0,0,0,1,1,0,2,0,2,0,0,0,0,0,0,11,1,10,0,0,0,0,0,0,1,1,0
176044,21000,210,0,-2,7,4,3,0,0,0,1,1,0,4,2,2,0,0,0,0,0,0,2,1,1,0,0,0,0,0,0,0,0,0
176053,21000,210,0,-2,21,9,12,0,0,0,0,0,0,1,1,0,0,0,0,0,0,0,7,3,4,0,0,0,12,4,8,1,1,0
176071,21000,210,0,-2,37,16,21,0,0,0,1,1,0,4,0,4,1,0,1,0,0,0,21,10,11,0,0,0,10,5,5,0,0,0
176080,21000,210,0,-2,68,36,32,0,0,0,4,4,0,5,0,5,2,1,1,0,0,0,39,20,19,0,0,0,0,0,0,18,11,7
176169,21000,210,0,-2,8,1,7,0,0,0,0,0,0,0,0,0,0,0,0,0,0,0,6,0,6,0,0,0,2,1,1,0,0,0
176178,21000,210,0,-2,21,7,14,0,0,0,0,0,0,4,1,3,0,0,0,0,0,0,17,6,11,0,0,0,0,0,0,0,0,0
176239,21000,210,0,-2,24,6,18,0,0,0,0,0,0,4,1,3,0,0,0,0,0,0,20,5,15,0,0,0,0,0,0,0,0,0
176318,21000,210,0,-2,12,6,6,0,0,0,0,0,0,11,6,5,0,0,0,0,0,0,1,0,1,0,0,0,0,0,0,0,0,0
176354,21000,210,0,-2,5,1,4,0,0,0,0,0,0,0,0,0,0,0,0,0,0,0,5,1,4,0,0,0,0,0,0,0,0,0
176406,21000,210,0,-2,2,0,2,0,0,0,0,0,0,2,0,2,0,0,0,0,0,0,0,0,0,0,0,0,0,0,0,0,0,0
176600,21000,210,0,-2,1,1,0,0,0,0,0,0,0,0,0,0,0,0,0,0,0,0,1,1,0,0,0,0,0,0,0,0,0,0
176628,21000,210,0,-2,6,2,4,0,0,0,0,0,0,0,0,0,0,0,0,0,0,0,6,2,4,0,0,0,0,0,0,0,0,0
176664,21000,210,0,-2,4,3,1,0,0,0,0,0,0,0,0,0,0,0,0,0,0,0,4,3,1,0,0,0,0,0,0,0,0,0
176789,21000,210,0,-2,1,1,0,0,0,0,1,1,0,0,0,0,0,0,0,0,0,0,0,0,0,0,0,0,0,0,0,0,0,0
176910,21000,210,0,-2,1,1,0,0,0,0,0,0,0,0,0,0,0,0,0,0,0,0,1,1,0,0,0,0,0,0,0,0,0,0
176947,21000,210,0,-2,8,3,5,0,0,0,0,0,0,0,0,0,0,0,0,0,0,0,8,3,5,0,0,0,0,0,0,0,0,0
176965,21000,210,0,-2,23,12,11,0,0,0,0,0,0,0,0,0,1,0,1,0,0,0,17,7,10,0,0,0,0,0,0,5,5,0
177038,21000,210,0,-2,1,1,0,0,0,0,0,0,0,1,1,0,0,0,0,0,0,0,0,0,0,0,0,0,0,0,0,0,0,0
177065,21000,210,0,-2,5,3,2,0,0,0,0,0,0,0,0,0,0,0,0,0,0,0,5,3,2,0,0,0,0,0,0,0,0,0
177092,21000,210,0,-2,3,3,0,0,0,0,0,0,0,0,0,0,1,1,0,0,0,0,2,2,0,0,0,0,0,0,0,0,0,0
177117,21000,210,0,-2,5,2,3,0,0,0,0,0,0,0,0,0,0,0,0,0,0,0,2,1,1,0,0,0,0,0,0,3,1,2
177126,21000,210,0,-2,2,1,1,0,0,0,0,0,0,0,0,0,0,0,0,0,0,0,2,1,1,0,0,0,0,0,0,0,0,0
177135,21000,210,0,-2,13,5,8,1,1,0,0,0,0,0,0,0,1,0,1,0,0,0,8,3,5,1,0,1,2,1,1,0,0,0
177144,21000,210,0,-2,5,4,1,0,0,0,1,1,0,0,0,0,0,0,0,0,0,0,4,3,1,0,0,0,0,0,0,0,0,0
177214,21000,210,0,-2,4,4,0,0,0,0,0,0,0,0,0,0,0,0,0,0,0,0,0,0,0,0,0,0,4,4,0,0,0,0
177250,21000,210,0,-2,6,2,4,0,0,0,0,0,0,0,0,0,0,0,0,0,0,0,5,2,3,1,0,1,0,0,0,0,0,0
177302,21000,210,0,-2,4,4,0,0,0,0,1,1,0,1,1,0,0,0,0,0,0,0,2,2,0,0,0,0,0,0,0,0,0,0
177339,21000,210,0,-2,2,1,1,0,0,0,0,0,0,0,0,0,0,0,0,0,0,0,2,1,1,0,0,0,0,0,0,0,0,0
177418,21000,210,0,-2,11,6,5,1,0,1,2,1,1,0,0,0,2,1,1,0,0,0,6,4,2,0,0,0,0,0,0,0,0,0
177472,21000,210,0,-2,10,7,3,0,0,0,0,0,0,0,0,0,0,0,0,0,0,0,8,6,2,0,0,0,2,1,1,0,0,0
177542,21000,210,0,-2,5,2,3,0,0,0,0,0,0,0,0,0,0,0,0,0,0,0,5,2,3,0,0,0,0,0,0,0,0,0
177551,21000,210,0,-2,1,1,0,0,0,0,0,0,0,0,0,0,0,0,0,0,0,0,1,1,0,0,0,0,0,0,0,0,0,0
177676,21000,210,0,-2,5,1,4,0,0,0,0,0,0,0,0,0,0,0,0,0,0,0,5,1,4,0,0,0,0,0,0,0,0,0
177719,21000,210,0,-2,5,0,5,0,0,0,0,0,0,2,0,2,0,0,0,0,0,0,3,0,3,0,0,0,0,0,0,0,0,0
177746,21000,210,0,-2,4,2,2,0,0,0,0,0,0,1,1,0,1,1,0,0,0,0,2,0,2,0,0,0,0,0,0,0,0,0
177940,21000,210,0,-2,3,1,2,0,0,0,0,0,0,0,0,0,0,0,0,0,0,0,3,1,2,0,0,0,0,0,0,0,0,0
177968,21000,210,0,-2,8,1,7,0,0,0,0,0,0,1,0,1,0,0,0,0,0,0,6,0,6,0,0,0,0,0,0,1,1,0
177977,21000,210,0,-2,18,14,4,0,0,0,0,0,0,0,0,0,0,0,0,0,0,0,17,13,4,1,1,0,0,0,0,0,0,0
177986,21000,210,0,-2,6,2,4,0,0,0,0,0,0,0,0,0,0,0,0,0,0,0,5,1,4,1,1,0,0,0,0,0,0,0
177995,21000,210,0,-2,9,4,5,0,0,0,0,0,0,1,1,0,0,0,0,0,0,0,8,3,5,0,0,0,0,0,0,0,0,0
178059,21000,210,0,-2,8,1,7,0,0,0,0,0,0,1,0,1,0,0,0,0,0,0,7,1,6,0,0,0,0,0,0,0,0,0
178183,21000,210,0,-2,2,0,2,0,0,0,0,0,0,0,0,0,0,0,0,0,0,0,2,0,2,0,0,0,0,0,0,0,0,0
178208,21000,210,0,-2,2,2,0,0,0,0,0,0,0,0,0,0,1,1,0,0,0,0,1,1,0,0,0,0,0,0,0,0,0,0
178217,21000,210,0,-2,1,0,1,0,0,0,0,0,0,0,0,0,0,0,0,0,0,0,1,0,1,0,0,0,0,0,0,0,0,0
178244,21000,210,0,-2,6,1,5,0,0,0,0,0,0,1,0,1,0,0,0,0,0,0,5,1,4,0,0,0,0,0,0,0,0,0
178341,21000,210,0,-2,10,4,6,0,0,0,0,0,0,1,0,1,0,0,0,0,0,0,8,3,5,0,0,0,0,0,0,1,1,0
178369,21000,210,0,-2,9,5,4,0,0,0,2,2,0,0,0,0,0,0,0,0,0,0,7,3,4,0,0,0,0,0,0,0,0,0
178387,21000,210,0,-2,11,5,6,0,0,0,0,0,0,0,0,0,2,2,0,0,0,0,3,0,3,0,0,0,6,3,3,0,0,0
178396,21000,210,0,-2,152,78,74,1,0,1,17,13,4,8,4,4,4,2,2,0,0,0,88,43,45,1,1,0,16,5,11,17,10,7
178402,21000,210,0,-2,39,22,17,0,0,0,2,1,1,6,4,2,2,1,1,0,0,0,23,13,10,0,0,0,1,0,1,5,3,2
178411,21000,210,0,-2,9,7,2,0,0,0,0,0,0,0,0,0,0,0,0,0,0,0,3,2,1,0,0,0,1,0,1,5,5,0
178420,21000,210,0,-2,5,1,4,0,0,0,1,0,1,1,0,1,0,0,0,0,0,0,2,1,1,0,0,0,1,0,1,0,0,0
178448,21000,210,0,-2,9,3,6,0,0,0,0,0,0,1,1,0,0,0,0,0,0,0,8,2,6,0,0,0,0,0,0,0,0,0
178615,21000,210,0,-2,17,11,6,0,0,0,2,2,0,1,1,0,0,0,0,0,0,0,11,7,4,0,0,0,0,0,0,3,1,2
178624,21000,210,0,-2,18,8,10,0,0,0,1,1,0,0,0,0,0,0,0,0,0,0,12,4,8,0,0,0,0,0,0,5,3,2
178679,21000,210,0,-2,1,1,0,0,0,0,0,0,0,0,0,0,0,0,0,0,0,0,1,1,0,0,0,0,0,0,0,0,0,0
178697,21000,210,0,-2,8,7,1,0,0,0,0,0,0,0,0,0,0,0,0,0,0,0,8,7,1,0,0,0,0,0,0,0,0,0
178721,21000,210,0,-2,8,1,7,1,0,1,0,0,0,0,0,0,0,0,0,0,0,0,6,1,5,1,0,1,0,0,0,0,0,0
178891,21000,210,0,-2,7,6,1,0,0,0,0,0,0,1,0,1,0,0,0,0,0,0,6,6,0,0,0,0,0,0,0,0,0,0
178989,21000,210,0,-2,4,2,2,0,0,0,0,0,0,0,0,0,0,0,0,0,0,0,4,2,2,0,0,0,0,0,0,0,0,0
179043,21000,210,0,-2,14,2,12,0,0,0,0,0,0,0,0,0,0,0,0,0,0,0,11,2,9,0,0,0,2,0,2,1,0,1
179159,21000,210,0,-2,40,20,20,0,0,0,2,0,2,7,4,3,4,3,1,0,0,0,17,8,9,1,0,1,0,0,0,9,5,4
179308,21000,210,0,-2,27,8,19,0,0,0,0,0,0,2,0,2,0,0,0,0,0,0,20,5,15,0,0,0,3,1,2,2,2,0
179317,21000,210,0,-2,1,1,0,0,0,0,0,0,0,1,1,0,0,0,0,0,0,0,0,0,0,0,0,0,0,0,0,0,0,0
179326,21000,210,0,-2,12,6,6,0,0,0,1,1,0,0,0,0,0,0,0,0,0,0,11,5,6,0,0,0,0,0,0,0,0,0
179344,21000,210,0,-2,4,2,2,0,0,0,0,0,0,0,0,0,0,0,0,0,0,0,2,0,2,0,0,0,2,2,0,0,0,0
179539,21000,210,0,-2,9,2,7,0,0,0,0,0,0,0,0,0,1,0,1,0,0,0,8,2,6,0,0,0,0,0,0,0,0,0
179548,21000,210,0,-2,8,3,5,0,0,0,0,0,0,0,0,0,0,0,0,0,0,0,8,3,5,0,0,0,0,0,0,0,0,0
179557,21000,210,0,-2,23,15,8,0,0,0,1,1,0,0,0,0,1,1,0,0,0,0,17,9,8,0,0,0,4,4,0,0,0,0
179566,21000,210,0,-2,41,13,28,1,0,1,2,0,2,3,1,2,5,3,2,0,0,0,24,8,16,0,0,0,0,0,0,6,1,5
179645,21000,210,0,-2,2,1,1,0,0,0,0,0,0,0,0,0,0,0,0,0,0,0,2,1,1,0,0,0,0,0,0,0,0,0
179715,21000,210,0,-2,5,2,3,0,0,0,0,0,0,0,0,0,0,0,0,0,0,0,5,2,3,0,0,0,0,0,0,0,0,0
179812,21000,210,0,-2,8,4,4,0,0,0,0,0,0,0,0,0,1,0,1,0,0,0,6,4,2,1,0,1,0,0,0,0,0,0
179867,21000,210,0,-2,89,48,41,1,1,0,18,11,7,11,6,5,4,3,1,0,0,0,41,20,21,4,2,2,2,0,2,8,5,3
179894,21000,210,0,-2,6,3,3,0,0,0,0,0,0,0,0,0,0,0,0,0,0,0,3,1,2,1,0,1,2,2,0,0,0,0
179946,21000,210,0,-2,1,0,1,0,0,0,0,0,0,0,0,0,0,0,0,0,0,0,1,0,1,0,0,0,0,0,0,0,0,0
179955,21000,210,0,-2,3,2,1,0,0,0,0,0,0,0,0,0,0,0,0,0,0,0,3,2,1,0,0,0,0,0,0,0,0,0
179964,21000,210,0,-2,3,3,0,0,0,0,0,0,0,0,0,0,0,0,0,0,0,0,3,3,0,0,0,0,0,0,0,0,0,0
180054,21000,210,0,-2,1,1,0,1,1,0,0,0,0,0,0,0,0,0,0,0,0,0,0,0,0,0,0,0,0,0,0,0,0,0
180106,21000,210,0,-2,19,5,14,0,0,0,0,0,0,0,0,0,0,0,0,0,0,0,11,3,8,0,0,0,8,2,6,0,0,0
180151,21000,210,0,-2,2,1,1,0,0,0,0,0,0,0,0,0,0,0,0,0,0,0,2,1,1,0,0,0,0,0,0,0,0,0
180179,21000,210,0,-2,21,10,11,0,0,0,0,0,0,0,0,0,0,0,0,0,0,0,20,10,10,0,0,0,1,0,1,0,0,0
180197,21000,210,0,-2,7,3,4,0,0,0,0,0,0,0,0,0,0,0,0,0,0,0,7,3,4,0,0,0,0,0,0,0,0,0
180203,21000,210,0,-2,2,2,0,1,1,0,0,0,0,0,0,0,0,0,0,0,0,0,1,1,0,0,0,0,0,0,0,0,0,0
180212,21000,210,0,-2,2,1,1,0,0,0,0,0,0,0,0,0,0,0,0,0,0,0,2,1,1,0,0,0,0,0,0,0,0,0
180249,21000,210,0,-2,2,0,2,0,0,0,0,0,0,0,0,0,0,0,0,0,0,0,2,0,2,0,0,0,0,0,0,0,0,0
180258,21000,210,0,-2,2,1,1,0,0,0,0,0,0,0,0,0,1,1,0,0,0,0,0,0,0,1,0,1,0,0,0,0,0,0
180276,21000,210,0,-2,2,0,2,0,0,0,0,0,0,0,0,0,0,0,0,0,0,0,2,0,2,0,0,0,0,0,0,0,0,0
180328,21000,210,0,-2,1,1,0,1,1,0,0,0,0,0,0,0,0,0,0,0,0,0,0,0,0,0,0,0,0,0,0,0,0,0
180373,21000,210,0,-2,5,3,2,0,0,0,0,0,0,0,0,0,0,0,0,0,0,0,3,2,1,0,0,0,2,1,1,0,0,0
180416,21000,210,0,-2,6,4,2,0,0,0,0,0,0,0,0,0,0,0,0,0,0,0,6,4,2,0,0,0,0,0,0,0,0,0
180461,21000,210,0,-2,17,6,11,0,0,0,0,0,0,0,0,0,0,0,0,0,0,0,14,5,9,0,0,0,1,0,1,2,1,1
180489,21000,210,0,-2,21,8,13,1,1,0,0,0,0,0,0,0,1,0,1,0,0,0,17,6,11,1,0,1,1,1,0,0,0,0
180522,21000,210,0,-2,5,3,2,0,0,0,0,0,0,0,0,0,0,0,0,0,0,0,5,3,2,0,0,0,0,0,0,0,0,0
180595,21000,210,0,-2,5,1,4,0,0,0,0,0,0,0,0,0,0,0,0,0,0,0,3,0,3,0,0,0,2,1,1,0,0,0
180647,21000,210,0,-2,8,5,3,3,2,1,0,0,0,0,0,0,1,0,1,0,0,0,4,3,1,0,0,0,0,0,0,0,0,0
180692,21000,210,0,-2,5,3,2,0,0,0,1,0,1,0,0,0,0,0,0,0,0,0,1,0,1,1,1,0,2,2,0,0,0,0
180814,21000,210,0,-2,3,3,0,0,0,0,0,0,0,0,0,0,0,0,0,0,0,0,2,2,0,0,0,0,1,1,0,0,0,0
180832,21000,210,0,-2,4,0,4,0,0,0,0,0,0,0,0,0,0,0,0,0,0,0,4,0,4,0,0,0,0,0,0,0,0,0
180878,21000,210,0,-2,1,0,1,0,0,0,0,0,0,0,0,0,0,0,0,0,0,0,1,0,1,0,0,0,0,0,0,0,0,0
180902,21000,210,0,-2,9,6,3,0,0,0,2,1,1,0,0,0,0,0,0,0,0,0,7,5,2,0,0,0,0,0,0,0,0,0
180948,21000,210,0,-2,6,4,2,0,0,0,0,0,0,1,0,1,0,0,0,0,0,0,5,4,1,0,0,0,0,0,0,0,0,0
180984,21000,210,0,-2,4,2,2,0,0,0,1,1,0,0,0,0,0,0,0,0,0,0,3,1,2,0,0,0,0,0,0,0,0,0
181002,21000,210,0,-2,46,19,27,0,0,0,6,1,5,0,0,0,2,1,1,0,0,0,25,11,14,1,0,1,11,5,6,1,1,0
181020,21000,210,0,-2,11,7,4,0,0,0,3,2,1,0,0,0,1,1,0,0,0,0,6,3,3,0,0,0,1,1,0,0,0,0
181127,21000,210,0,-2,7,1,6,0,0,0,0,0,0,0,0,0,0,0,0,0,0,0,7,1,6,0,0,0,0,0,0,0,0,0
181215,21000,210,0,-2,30,15,15,0,0,0,4,3,1,0,0,0,0,0,0,0,0,0,21,8,13,0,0,0,0,0,0,5,4,1
181303,21000,210,0,-2,12,7,5,0,0,0,0,0,0,0,0,0,1,1,0,0,0,0,11,6,5,0,0,0,0,0,0,0,0,0
181312,21000,210,0,-2,14,12,2,0,0,0,0,0,0,0,0,0,0,0,0,0,0,0,14,12,2,0,0,0,0,0,0,0,0,0
181330,21000,210,0,-2,2,1,1,0,0,0,0,0,0,0,0,0,0,0,0,0,0,0,2,1,1,0,0,0,0,0,0,0,0,0
181394,21000,210,0,-2,44,21,23,0,0,0,1,0,1,2,0,2,3,3,0,0,0,0,22,11,11,0,0,0,4,2,2,12,5,7
181419,21000,210,0,-2,3,3,0,2,2,0,1,1,0,0,0,0,0,0,0,0,0,0,0,0,0,0,0,0,0,0,0,0,0,0
181428,21000,210,0,-2,70,30,40,0,0,0,6,2,4,3,1,2,1,1,0,0,0,0,47,18,29,1,1,0,1,0,1,11,7,4
181446,21000,210,0,-2,15,4,11,0,0,0,1,0,1,1,0,1,0,0,0,0,0,0,11,4,7,1,0,1,0,0,0,1,0,1
181464,21000,210,0,-2,36,17,19,0,0,0,1,1,0,0,0,0,1,0,1,0,0,0,21,9,12,1,0,1,0,0,0,12,7,5
181491,21000,210,0,-2,13,10,3,0,0,0,0,0,0,0,0,0,0,0,0,0,0,0,13,10,3,0,0,0,0,0,0,0,0,0
181534,21000,210,0,-2,3,3,0,0,0,0,0,0,0,0,0,0,0,0,0,0,0,0,3,3,0,0,0,0,0,0,0,0,0,0
181604,21000,210,0,-2,6,1,5,0,0,0,0,0,0,0,0,0,0,0,0,0,0,0,6,1,5,0,0,0,0,0,0,0,0,0
181640,21000,210,0,-2,20,12,8,0,0,0,1,1,0,1,1,0,0,0,0,0,0,0,18,10,8,0,0,0,0,0,0,0,0,0
181738,21000,210,0,-2,10,2,8,0,0,0,0,0,0,0,0,0,2,0,2,0,0,0,8,2,6,0,0,0,0,0,0,0,0,0
181765,21000,210,0,-2,1,1,0,0,0,0,0,0,0,0,0,0,0,0,0,0,0,0,1,1,0,0,0,0,0,0,0,0,0,0
181783,21000,210,0,-2,8,4,4,0,0,0,0,0,0,0,0,0,1,0,1,0,0,0,7,4,3,0,0,0,0,0,0,0,0,0
181817,21000,210,0,-2,9,4,5,0,0,0,0,0,0,0,0,0,0,0,0,0,0,0,9,4,5,0,0,0,0,0,0,0,0,0
181853,21000,210,0,-2,3,2,1,0,0,0,0,0,0,0,0,0,0,0,0,0,0,0,3,2,1,0,0,0,0,0,0,0,0,0
181941,21000,210,0,-2,10,7,3,1,1,0,0,0,0,0,0,0,2,1,1,0,0,0,7,5,2,0,0,0,0,0,0,0,0,0
182005,21000,210,0,-2,10,5,5,0,0,0,2,2,0,2,0,2,0,0,0,0,0,0,5,3,2,0,0,0,1,0,1,0,0,0
182148,21000,210,0,-2,14,0,14,0,0,0,0,0,0,1,0,1,4,0,4,0,0,0,9,0,9,0,0,0,0,0,0,0,0,0
182281,21000,210,0,-2,38,20,18,0,0,0,12,7,5,2,1,1,3,1,2,0,0,0,11,5,6,2,1,1,0,0,0,8,5,3
182290,21000,210,0,-2,27,9,18,0,0,0,1,0,1,0,0,0,5,2,3,0,0,0,20,6,14,0,0,0,0,0,0,1,1,0
182306,21000,210,0,-2,5,3,2,0,0,0,0,0,0,0,0,0,0,0,0,0,0,0,4,2,2,0,0,0,0,0,0,1,1,0
182458,21000,210,0,-2,1,0,1,0,0,0,0,0,0,1,0,1,0,0,0,0,0,0,0,0,0,0,0,0,0,0,0,0,0,0
182500,21000,210,0,-2,6,3,3,0,0,0,0,0,0,1,1,0,1,0,1,0,0,0,4,2,2,0,0,0,0,0,0,0,0,0
182564,21000,210,0,-2,1,0,1,0,0,0,0,0,0,0,0,0,0,0,0,0,0,0,1,0,1,0,0,0,0,0,0,0,0,0
182634,21000,210,0,-2,9,3,6,0,0,0,0,0,0,0,0,0,1,0,1,0,0,0,8,3,5,0,0,0,0,0,0,0,0,0
182670,21000,210,0,-2,29,10,19,0,0,0,2,2,0,0,0,0,0,0,0,0,0,0,23,6,17,0,0,0,0,0,0,4,2,2
182795,21000,210,0,-2,6,2,4,0,0,0,0,0,0,0,0,0,0,0,0,0,0,0,6,2,4,0,0,0,0,0,0,0,0,0
182829,21000,210,0,-2,3,1,2,0,0,0,1,0,1,0,0,0,0,0,0,0,0,0,1,0,1,0,0,0,1,1,0,0,0,0
182980,21000,210,0,-2,5,0,5,0,0,0,0,0,0,1,0,1,0,0,0,0,0,0,4,0,4,0,0,0,0,0,0,0,0,0
183026,21000,210,0,-2,2,1,1,0,0,0,0,0,0,0,0,0,0,0,0,0,0,0,2,1,1,0,0,0,0,0,0,0,0,0
183044,21000,210,0,-2,43,18,25,0,0,0,3,2,1,2,0,2,2,0,2,0,0,0,21,10,11,1,0,1,5,1,4,9,5,4
183062,21000,210,0,-2,9,4,5,0,0,0,0,0,0,0,0,0,0,0,0,0,0,0,4,1,3,0,0,0,3,1,2,2,2,0
183071,21000,210,0,-2,1,1,0,0,0,0,0,0,0,0,0,0,0,0,0,0,0,0,1,1,0,0,0,0,0,0,0,0,0,0
183080,21000,210,0,-2,15,5,10,0,0,0,0,0,0,0,0,0,0,0,0,0,0,0,12,5,7,0,0,0,1,0,1,2,0,2
183105,21000,210,0,-2,1,1,0,0,0,0,0,0,0,0,0,0,0,0,0,0,0,0,1,1,0,0,0,0,0,0,0,0,0,0
183114,21000,210,0,-2,1,0,1,0,0,0,0,0,0,0,0,0,0,0,0,0,0,0,1,0,1,0,0,0,0,0,0,0,0,0
183123,21000,210,0,-2,5,3,2,0,0,0,0,0,0,0,0,0,0,0,0,0,0,0,4,2,2,0,0,0,1,1,0,0,0,0
183132,21000,210,0,-2,1,0,1,0,0,0,0,0,0,0,0,0,0,0,0,0,0,0,0,0,0,1,0,1,0,0,0,0,0,0
183141,21000,210,0,-2,2,1,1,0,0,0,0,0,0,0,0,0,0,0,0,0,0,0,2,1,1,0,0,0,0,0,0,0,0,0
183150,21000,210,0,-2,1,1,0,0,0,0,0,0,0,0,0,0,0,0,0,0,0,0,1,1,0,0,0,0,0,0,0,0,0,0
183211,21000,210,0,-2,4,0,4,0,0,0,1,0,1,0,0,0,0,0,0,0,0,0,3,0,3,0,0,0,0,0,0,0,0,0
183239,21000,210,0,-2,12,3,9,0,0,0,0,0,0,1,1,0,1,0,1,0,0,0,9,1,8,0,0,0,1,1,0,0,0,0
183248,21000,210,0,-2,2,0,2,0,0,0,0,0,0,0,0,0,0,0,0,0,0,0,2,0,2,0,0,0,0,0,0,0,0,0
183257,21000,210,0,-2,3,1,2,0,0,0,0,0,0,0,0,0,0,0,0,0,0,0,3,1,2,0,0,0,0,0,0,0,0,0
183655,21000,210,0,-2,8,2,6,0,0,0,0,0,0,0,0,0,1,1,0,0,0,0,7,1,6,0,0,0,0,0,0,0,0,0
183822,21000,210,0,-2,4,1,3,0,0,0,0,0,0,3,0,3,0,0,0,0,0,0,1,1,0,0,0,0,0,0,0,0,0,0
183859,21000,210,0,-2,12,8,4,0,0,0,0,0,0,0,0,0,0,0,0,0,0,0,10,6,4,1,1,0,1,1,0,0,0,0
183910,21000,210,0,-2,3,1,2,0,0,0,0,0,0,0,0,0,0,0,0,0,0,0,3,1,2,0,0,0,0,0,0,0,0,0
183938,21000,210,0,-2,5,2,3,0,0,0,1,1,0,0,0,0,0,0,0,0,0,0,4,1,3,0,0,0,0,0,0,0,0,0
183974,21000,210,0,-2,3,1,2,0,0,0,0,0,0,0,0,0,0,0,0,0,0,0,3,1,2,0,0,0,0,0,0,0,0,0
184180,21000,210,0,-2,2,0,2,0,0,0,0,0,0,0,0,0,0,0,0,0,0,0,2,0,2,0,0,0,0,0,0,0,0,0
184205,21000,210,0,-2,5,1,4,0,0,0,0,0,0,0,0,0,0,0,0,0,0,0,5,1,4,0,0,0,0,0,0,0,0,0
184348,21000,210,0,-2,4,2,2,0,0,0,2,2,0,1,0,1,0,0,0,0,0,0,0,0,0,0,0,0,0,0,0,1,0,1
184481,21000,210,0,-2,5,2,3,0,0,0,0,0,0,3,0,3,0,0,0,0,0,0,1,1,0,0,0,0,1,1,0,0,0,0
184603,21000,210,0,-2,9,5,4,0,0,0,1,1,0,1,1,0,0,0,0,0,0,0,6,3,3,0,0,0,1,0,1,0,0,0
184612,21000,210,0,-2,16,4,12,0,0,0,0,0,0,1,0,1,4,1,3,0,0,0,10,2,8,1,1,0,0,0,0,0,0,0
184694,21000,210,0,-2,11,2,9,0,0,0,4,1,3,0,0,0,0,0,0,0,0,0,3,0,3,1,1,0,3,0,3,0,0,0
184773,21000,210,0,-2,6,0,6,0,0,0,0,0,0,0,0,0,1,0,1,0,0,0,5,0,5,0,0,0,0,0,0,0,0,0
184782,21000,210,0,-2,61,27,34,0,0,0,6,3,3,8,2,6,3,0,3,0,0,0,36,15,21,3,3,0,2,2,0,3,2,1
184791,21000,210,0,-2,4,1,3,0,0,0,0,0,0,0,0,0,0,0,0,0,0,0,3,0,3,0,0,0,1,1,0,0,0,0
184959,21000,210,0,-2,3,0,3,0,0,0,0,0,0,0,0,0,0,0,0,0,0,0,3,0,3,0,0,0,0,0,0,0,0,0
184995,21000,210,0,-2,1,0,1,0,0,0,0,0,0,0,0,0,1,0,1,0,0,0,0,0,0,0,0,0,0,0,0,0,0,0
185129,21000,210,0,-2,8,5,3,0,0,0,2,2,0,2,0,2,1,0,1,0,0,0,3,3,0,0,0,0,0,0,0,0,0,0
185262,21000,210,0,-2,40,16,24,0,0,0,9,4,5,6,0,6,6,3,3,0,0,0,13,5,8,1,0,1,2,1,1,3,3,0
185509,21000,210,0,-2,2,2,0,0,0,0,1,1,0,0,0,0,0,0,0,0,0,0,1,1,0,0,0,0,0,0,0,0,0,0
185572,21000,210,0,-2,10,2,8,0,0,0,0,0,0,0,0,0,1,1,0,0,0,0,8,1,7,1,0,1,0,0,0,0,0,0
185590,21000,210,0,-2,17,7,10,0,0,0,2,2,0,4,1,3,2,0,2,0,0,0,3,2,1,0,0,0,2,0,2,4,2,2
185721,21000,210,0,-2,1,0,1,0,0,0,0,0,0,0,0,0,0,0,0,0,0,0,1,0,1,0,0,0,0,0,0,0,0,0
185828,21000,210,0,-2,33,21,12,0,0,0,7,5,2,0,0,0,1,0,1,0,0,0,13,8,5,0,0,0,0,0,0,12,8,4
185873,21000,210,0,-2,6,2,4,0,0,0,2,0,2,0,0,0,1,1,0,0,0,0,3,1,2,0,0,0,0,0,0,0,0,0
186034,21000,210,0,-2,2,0,2,0,0,0,0,0,0,0,0,0,0,0,0,0,0,0,2,0,2,0,0,0,0,0,0,0,0,0
186122,21000,210,0,-2,1,1,0,0,0,0,0,0,0,0,0,0,0,0,0,0,0,0,1,1,0,0,0,0,0,0,0,0,0,0
186131,21000,210,0,-2,42,25,17,0,0,0,4,4,0,1,1,0,2,1,1,0,0,0,7,2,5,0,0,0,14,8,6,14,9,5
186201,21000,210,0,-2,4,1,3,0,0,0,1,0,1,1,0,1,0,0,0,0,0,0,2,1,1,0,0,0,0,0,0,0,0,0
186283,21000,210,0,-2,7,4,3,0,0,0,1,0,1,2,2,0,3,2,1,0,0,0,1,0,1,0,0,0,0,0,0,0,0,0
186371,21000,210,0,-2,8,5,3,0,0,0,0,0,0,0,0,0,0,0,0,0,0,0,1,1,0,0,0,0,5,3,2,2,1,1
186380,21000,210,0,-2,193,84,109,0,0,0,11,9,2,5,2,3,5,1,4,0,0,0,25,9,16,0,0,0,126,49,77,21,14,7
186399,21000,210,0,-2,27,14,13,0,0,0,2,1,1,1,0,1,1,1,0,0,0,0,0,0,0,0,0,0,16,9,7,7,3,4
186432,21000,210,0,-2,3,2,1,0,0,0,2,2,0,0,0,0,0,0,0,0,0,0,1,0,1,0,0,0,0,0,0,0,0,0
186584,21000,210,0,-2,17,7,10,0,0,0,0,0,0,0,0,0,3,1,2,0,0,0,12,6,6,1,0,1,1,0,1,0,0,0
186618,21000,210,0,-2,11,2,9,0,0,0,1,0,1,0,0,0,0,0,0,0,0,0,8,1,7,0,0,0,2,1,1,0,0,0
186645,21000,210,0,-2,6,1,5,0,0,0,1,0,1,1,0,1,1,0,1,0,0,0,3,1,2,0,0,0,0,0,0,0,0,0
186867,21000,210,0,-2,30,19,11,0,0,0,3,2,1,0,0,0,0,0,0,0,0,0,11,6,5,0,0,0,1,1,0,15,10,5
186876,21000,210,0,-2,12,3,9,0,0,0,0,0,0,1,1,0,0,0,0,0,0,0,9,1,8,0,0,0,1,0,1,1,1,0
187134,21000,210,0,-2,17,10,7,0,0,0,1,1,0,3,1,2,1,1,0,0,0,0,11,7,4,0,0,0,1,0,1,0,0,0
187444,21000,210,0,-2,8,2,6,0,0,0,1,0,1,3,1,2,2,1,1,0,0,0,2,0,2,0,0,0,0,0,0,0,0,0
187532,21000,210,0,-2,6,2,4,0,0,0,0,0,0,0,0,0,1,0,1,0,0,0,5,2,3,0,0,0,0,0,0,0,0,0
187596,21000,210,0,-2,18,13,5,6,4,2,0,0,0,2,1,1,0,0,0,0,0,0,6,5,1,0,0,0,1,1,0,3,2,1
187639,21000,210,0,-2,8,2,6,0,0,0,0,0,0,1,0,1,2,1,1,0,0,0,5,1,4,0,0,0,0,0,0,0,0,0
187648,21000,210,0,-2,9,4,5,0,0,0,0,0,0,0,0,0,0,0,0,0,0,0,6,3,3,0,0,0,0,0,0,3,1,2
187666,21000,210,0,-2,4,0,4,0,0,0,0,0,0,0,0,0,3,0,3,0,0,0,1,0,1,0,0,0,0,0,0,0,0,0
187897,21000,210,0,-2,14,7,7,0,0,0,0,0,0,1,1,0,2,0,2,0,0,0,9,5,4,0,0,0,0,0,0,2,1,1
187903,21000,210,0,-2,15,7,8,0,0,0,0,0,0,2,0,2,1,1,0,0,0,0,12,6,6,0,0,0,0,0,0,0,0,0
187912,21000,210,0,-2,9,7,2,0,0,0,1,0,1,1,1,0,0,0,0,0,0,0,5,4,1,0,0,0,0,0,0,2,2,0
187958,21000,210,0,-2,2,1,1,1,0,1,0,0,0,0,0,0,0,0,0,0,0,0,0,0,0,0,0,0,0,0,0,1,1,0
187967,21000,210,0,-2,7,2,5,0,0,0,1,0,1,0,0,0,2,1,1,0,0,0,4,1,3,0,0,0,0,0,0,0,0,0
187985,21000,210,0,-2,103,33,70,3,1,2,10,4,6,4,1,3,14,5,9,0,0,0,55,14,41,2,1,1,4,3,1,11,4,7
187994,21000,210,0,-2,3,3,0,0,0,0,0,0,0,1,1,0,1,1,0,0,0,0,1,1,0,0,0,0,0,0,0,0,0,0
188030,21000,210,0,-2,19,5,14,0,0,0,1,0,1,1,0,1,1,0,1,0,0,0,14,5,9,0,0,0,0,0,0,2,0,2
188058,21000,210,0,-2,1,1,0,0,0,0,0,0,0,0,0,0,0,0,0,0,0,0,0,0,0,0,0,0,1,1,0,0,0,0
188100,21000,210,0,-2,9,6,3,0,0,0,1,1,0,1,1,0,1,1,0,0,0,0,2,1,1,0,0,0,4,2,2,0,0,0
188137,21000,210,0,-2,5,4,1,0,0,0,0,0,0,0,0,0,3,2,1,0,0,0,1,1,0,1,1,0,0,0,0,0,0,0
188182,21000,210,0,-2,4,1,3,0,0,0,0,0,0,0,0,0,0,0,0,0,0,0,0,0,0,0,0,0,4,1,3,0,0,0
188225,21000,210,0,-2,1,1,0,0,0,0,0,0,0,0,0,0,0,0,0,0,0,0,1,1,0,0,0,0,0,0,0,0,0,0
188261,21000,210,0,-2,2,1,1,0,0,0,0,0,0,0,0,0,0,0,0,0,0,0,2,1,1,0,0,0,0,0,0,0,0,0
188304,21000,210,0,-2,10,3,7,0,0,0,0,0,0,0,0,0,1,0,1,0,0,0,5,1,4,0,0,0,3,2,1,1,0,1
188340,21000,210,0,-2,1,1,0,0,0,0,0,0,0,1,1,0,0,0,0,0,0,0,0,0,0,0,0,0,0,0,0,0,0,0
188429,21000,210,0,-2,20,6,14,0,0,0,4,1,3,3,0,3,3,1,2,0,0,0,10,4,6,0,0,0,0,0,0,0,0,0
188438,21000,210,0,-2,11,5,6,0,0,0,1,1,0,0,0,0,0,0,0,0,0,0,10,4,6,0,0,0,0,0,0,0,0,0
188517,21000,210,0,-2,2,0,2,0,0,0,0,0,0,0,0,0,0,0,0,0,0,0,1,0,1,0,0,0,1,0,1,0,0,0
188526,21000,210,0,-2,2,1,1,0,0,0,1,1,0,0,0,0,0,0,0,0,0,0,1,0,1,0,0,0,0,0,0,0,0,0
188535,21000,210,0,-2,3,1,2,0,0,0,0,0,0,1,0,1,1,1,0,0,0,0,1,0,1,0,0,0,0,0,0,0,0,0
188580,21000,210,0,-2,50,28,22,0,0,0,8,7,1,1,1,0,5,2,3,0,0,0,30,17,13,0,0,0,6,1,5,0,0,0
188641,21000,210,0,-2,14,3,11,0,0,0,2,1,1,0,0,0,2,0,2,0,0,0,8,1,7,1,0,1,0,0,0,1,1,0
188854,21000,210,0,-2,3,2,1,0,0,0,0,0,0,0,0,0,0,0,0,0,0,0,2,1,1,1,1,0,0,0,0,0,0,0
189015,21000,210,0,-2,1,0,1,0,0,0,0,0,0,0,0,0,0,0,0,0,0,0,1,0,1,0,0,0,0,0,0,0,0,0
189088,21000,210,0,-2,4,1,3,0,0,0,1,0,1,1,1,0,0,0,0,0,0,0,0,0,0,0,0,0,1,0,1,1,0,1
189097,21000,210,0,-2,24,8,16,0,0,0,3,1,2,2,1,1,0,0,0,0,0,0,17,6,11,0,0,0,2,0,2,0,0,0
189413,21000,210,0,-2,2,1,1,0,0,0,0,0,0,1,1,0,1,0,1,0,0,0,0,0,0,0,0,0,0,0,0,0,0,0
189547,21000,210,0,-2,3,2,1,1,1,0,0,0,0,0,0,0,0,0,0,0,0,0,2,1,1,0,0,0,0,0,0,0,0,0
189565,21000,210,0,-2,2,0,2,0,0,0,0,0,0,0,0,0,0,0,0,0,0,0,1,0,1,0,0,0,1,0,1,0,0,0
189705,21000,210,0,-2,3,0,3,0,0,0,0,0,0,0,0,0,0,0,0,0,0,0,3,0,3,0,0,0,0,0,0,0,0,0
189811,21000,210,0,-2,1,0,1,0,0,0,1,0,1,0,0,0,0,0,0,0,0,0,0,0,0,0,0,0,0,0,0,0,0,0
189839,21000,210,0,-2,1,0,1,0,0,0,0,0,0,0,0,0,0,0,0,0,0,0,1,0,1,0,0,0,0,0,0,0,0,0
189848,21000,210,0,-2,2,0,2,0,0,0,0,0,0,0,0,0,0,0,0,0,0,0,2,0,2,0,0,0,0,0,0,0,0,0
189857,21000,210,0,-2,5,5,0,0,0,0,0,0,0,0,0,0,0,0,0,0,0,0,5,5,0,0,0,0,0,0,0,0,0,0
190044,21000,210,0,-2,17,7,10,0,0,0,0,0,0,2,1,1,0,0,0,0,0,0,8,2,6,0,0,0,0,0,0,7,4,3
190071,21000,210,0,-2,2,0,2,0,0,0,0,0,0,0,0,0,0,0,0,0,0,0,2,0,2,0,0,0,0,0,0,0,0,0
190080,21000,210,0,-2,1,0,1,0,0,0,0,0,0,1,0,1,0,0,0,0,0,0,0,0,0,0,0,0,0,0,0,0,0,0
190099,21000,210,0,-2,37,17,20,0,0,0,3,0,3,2,0,2,2,2,0,1,1,0,17,7,10,2,1,1,1,0,1,9,6,3
190150,21000,210,0,-2,339,179,160,1,1,0,74,36,38,34,16,18,21,12,9,0,0,0,130,67,63,7,3,4,23,13,10,49,31,18
190169,21000,210,0,-2,4,1,3,0,0,0,0,0,0,0,0,0,0,0,0,0,0,0,4,1,3,0,0,0,0,0,0,0,0,0
190372,21000,210,0,-2,4,1,3,0,0,0,0,0,0,1,1,0,0,0,0,0,0,0,3,0,3,0,0,0,0,0,0,0,0,0
190415,21000,210,0,-2,121,55,66,1,0,1,13,8,5,8,5,3,12,5,7,0,0,0,53,26,27,6,1,5,0,0,0,28,10,18
190424,21000,210,0,-2,172,62,110,0,0,0,60,35,25,16,4,12,7,2,5,0,0,0,63,6,57,0,0,0,1,0,1,25,15,10
190442,21000,210,0,-2,4,3,1,0,0,0,0,0,0,1,1,0,0,0,0,0,0,0,3,2,1,0,0,0,0,0,0,0,0,0
190451,21000,210,0,-2,1,0,1,0,0,0,0,0,0,0,0,0,0,0,0,0,0,0,1,0,1,0,0,0,0,0,0,0,0,0
190503,21000,210,0,-2,5,2,3,0,0,0,1,0,1,0,0,0,1,0,1,0,0,0,3,2,1,0,0,0,0,0,0,0,0,0
190512,21000,210,0,-2,18,9,9,0,0,0,4,0,4,0,0,0,3,1,2,0,0,0,6,4,2,0,0,0,0,0,0,5,4,1
190521,21000,210,0,-2,20,8,12,0,0,0,3,2,1,6,1,5,2,2,0,0,0,0,8,3,5,0,0,0,0,0,0,1,0,1
190530,21000,210,0,-2,3,3,0,0,0,0,0,0,0,1,1,0,1,1,0,0,0,0,1,1,0,0,0,0,0,0,0,0,0,0
190549,21000,210,0,-2,21,8,13,0,0,0,0,0,0,5,3,2,1,0,1,0,0,0,11,3,8,0,0,0,0,0,0,4,2,2
190558,21000,210,0,-2,4,1,3,0,0,0,0,0,0,0,0,0,1,0,1,0,0,0,2,0,2,0,0,0,0,0,0,1,1,0
190567,21000,210,0,-2,17,11,6,0,0,0,1,1,0,1,1,0,2,2,0,0,0,0,10,4,6,2,2,0,0,0,0,1,1,0
190576,21000,210,0,-2,21,4,17,0,0,0,1,0,1,6,0,6,4,2,2,0,0,0,9,2,7,1,0,1,0,0,0,0,0,0
190585,21000,210,0,-2,1,1,0,0,0,0,0,0,0,0,0,0,0,0,0,0,0,0,1,1,0,0,0,0,0,0,0,0,0,0
190594,21000,210,0,-2,15,7,8,0,0,0,2,0,2,3,2,1,2,1,1,0,0,0,8,4,4,0,0,0,0,0,0,0,0,0
190600,21000,210,0,-2,37,15,22,0,0,0,1,0,1,9,6,3,5,1,4,0,0,0,22,8,14,0,0,0,0,0,0,0,0,0
190619,21000,210,0,-2,19,6,13,0,0,0,2,0,2,4,1,3,3,1,2,0,0,0,10,4,6,0,0,0,0,0,0,0,0,0
190628,21000,210,0,-2,3,1,2,0,0,0,0,0,0,0,0,0,2,1,1,0,0,0,1,0,1,0,0,0,0,0,0,0,0,0
190637,21000,210,0,-2,12,5,7,0,0,0,1,0,1,3,0,3,1,1,0,0,0,0,6,4,2,0,0,0,0,0,0,1,0,1
190646,21000,210,0,-2,14,7,7,0,0,0,1,1,0,11,5,6,0,0,0,0,0,0,2,1,1,0,0,0,0,0,0,0,0,0
190655,21000,210,0,-2,3,1,2,0,0,0,1,1,0,1,0,1,0,0,0,0,0,0,1,0,1,0,0,0,0,0,0,0,0,0
190664,21000,210,0,-2,28,9,19,0,0,0,5,2,3,4,1,3,2,0,2,0,0,0,17,6,11,0,0,0,0,0,0,0,0,0
190673,21000,210,0,-2,3,2,1,0,0,0,0,0,0,1,1,0,0,0,0,0,0,0,2,1,1,0,0,0,0,0,0,0,0,0
190682,21000,210,0,-2,3,2,1,0,0,0,1,0,1,1,1,0,1,1,0,0,0,0,0,0,0,0,0,0,0,0,0,0,0,0
190691,21000,210,0,-2,8,3,5,0,0,0,2,1,1,3,1,2,0,0,0,0,0,0,3,1,2,0,0,0,0,0,0,0,0,0
190716,21000,210,0,-2,7,2,5,0,0,0,1,0,1,2,0,2,0,0,0,0,0,0,4,2,2,0,0,0,0,0,0,0,0,0
190725,21000,210,0,-2,12,2,10,0,0,0,0,0,0,0,0,0,1,0,1,0,0,0,11,2,9,0,0,0,0,0,0,0,0,0
190761,21000,210,0,-2,3,2,1,0,0,0,0,0,0,0,0,0,0,0,0,0,0,0,3,2,1,0,0,0,0,0,0,0,0,0
190840,21000,210,0,-2,3,1,2,0,0,0,0,0,0,0,0,0,0,0,0,0,0,0,1,0,1,0,0,0,2,1,1,0,0,0
190956,21000,210,0,-2,4,0,4,0,0,0,0,0,0,0,0,0,0,0,0,0,0,0,4,0,4,0,0,0,0,0,0,0,0,0
190983,21000,210,0,-2,11,4,7,0,0,0,0,0,0,0,0,0,0,0,0,0,0,0,11,4,7,0,0,0,0,0,0,0,0,0
191083,21000,210,0,-2,3,1,2,0,0,0,0,0,0,1,1,0,0,0,0,0,0,0,1,0,1,0,0,0,1,0,1,0,0,0
191126,21000,210,0,-2,2,1,1,0,0,0,0,0,0,0,0,0,0,0,0,0,0,0,2,1,1,0,0,0,0,0,0,0,0,0
191199,21000,210,0,-2,1,1,0,0,0,0,0,0,0,0,0,0,0,0,0,0,0,0,1,1,0,0,0,0,0,0,0,0,0,0
191205,21000,210,0,-2,2,0,2,0,0,0,1,0,1,0,0,0,0,0,0,0,0,0,1,0,1,0,0,0,0,0,0,0,0,0
191241,21000,210,0,-2,50,22,28,0,0,0,6,1,5,3,2,1,4,1,3,0,0,0,25,11,14,0,0,0,7,4,3,5,3,2
191320,21000,210,0,-2,1,0,1,0,0,0,0,0,0,0,0,0,0,0,0,0,0,0,1,0,1,0,0,0,0,0,0,0,0,0
191515,21000,210,0,-2,38,20,18,0,0,0,3,1,2,0,0,0,2,0,2,0,0,0,16,11,5,1,0,1,3,1,2,13,7,6
191533,21000,210,0,-2,6,3,3,0,0,0,0,0,0,0,0,0,0,0,0,0,0,0,2,1,1,0,0,0,3,1,2,1,1,0
191597,21000,210,0,-2,6,1,5,0,0,0,1,0,1,4,0,4,0,0,0,0,0,0,1,1,0,0,0,0,0,0,0,0,0,0
191621,21000,210,0,-2,4,3,1,0,0,0,0,0,0,0,0,0,0,0,0,0,0,0,4,3,1,0,0,0,0,0,0,0,0,0
191630,21000,210,0,-2,16,8,8,0,0,0,2,2,0,1,1,0,2,1,1,0,0,0,10,4,6,0,0,0,1,0,1,0,0,0
191649,21000,210,0,-2,20,11,9,0,0,0,2,1,1,2,1,1,1,0,1,0,0,0,9,5,4,0,0,0,0,0,0,6,4,2
191676,21000,210,0,-2,7,6,1,0,0,0,1,1,0,1,1,0,0,0,0,0,0,0,3,3,0,0,0,0,1,1,0,1,0,1
191719,21000,210,0,-2,7,4,3,0,0,0,0,0,0,0,0,0,0,0,0,0,0,0,7,4,3,0,0,0,0,0,0,0,0,0
191931,21000,210,0,-2,16,8,8,0,0,0,3,2,1,2,1,1,1,0,1,0,0,0,9,4,5,0,0,0,1,1,0,0,0,0
191968,21000,210,0,-2,7,3,4,0,0,0,0,0,0,0,0,0,0,0,0,0,0,0,2,2,0,0,0,0,5,1,4,0,0,0
191986,21000,210,0,-2,6,1,5,0,0,0,0,0,0,0,0,0,0,0,0,0,0,0,6,1,5,0,0,0,0,0,0,0,0,0
192022,21000,210,0,-2,4,2,2,0,0,0,0,0,0,0,0,0,1,1,0,0,0,0,3,1,2,0,0,0,0,0,0,0,0,0
192110,21000,210,0,-2,2,2,0,0,0,0,0,0,0,1,1,0,0,0,0,0,0,0,0,0,0,0,0,0,0,0,0,1,1,0
192192,21000,210,0,-2,2,0,2,0,0,0,0,0,0,0,0,0,0,0,0,0,0,0,2,0,2,0,0,0,0,0,0,0,0,0
192323,21000,210,0,-2,12,6,6,0,0,0,1,0,1,1,0,1,1,1,0,0,0,0,9,5,4,0,0,0,0,0,0,0,0,0
192448,21000,210,0,-2,37,18,19,0,0,0,5,2,3,3,0,3,0,0,0,0,0,0,19,11,8,0,0,0,6,2,4,4,3,1
192688,21000,210,0,-2,2,1,1,0,0,0,1,0,1,0,0,0,1,1,0,0,0,0,0,0,0,0,0,0,0,0,0,0,0,0
192703,21000,210,0,-2,3,1,2,0,0,0,0,0,0,0,0,0,1,0,1,0,0,0,1,1,0,0,0,0,1,0,1,0,0,0
192749,21000,210,0,-2,13,0,13,0,0,0,2,0,2,1,0,1,3,0,3,0,0,0,5,0,5,0,0,0,2,0,2,0,0,0
192785,21000,210,0,-2,1,0,1,0,0,0,0,0,0,0,0,0,0,0,0,0,0,0,1,0,1,0,0,0,0,0,0,0,0,0
192819,21000,210,0,-2,8,2,6,0,0,0,2,1,1,1,0,1,0,0,0,0,0,0,5,1,4,0,0,0,0,0,0,0,0,0
192864,21000,210,0,-2,7,5,2,0,0,0,0,0,0,0,0,0,0,0,0,0,0,0,0,0,0,0,0,0,7,5,2,0,0,0
192925,21000,210,0,-2,11,3,8,1,1,0,0,0,0,2,1,1,0,0,0,1,0,1,7,1,6,0,0,0,0,0,0,0,0,0
193016,21000,210,0,-2,26,8,18,0,0,0,2,1,1,5,1,4,3,1,2,0,0,0,14,3,11,0,0,0,1,1,0,1,1,0
193201,21000,210,0,-2,1,0,1,0,0,0,0,0,0,0,0,0,0,0,0,0,0,0,1,0,1,0,0,0,0,0,0,0,0,0
193247,21000,210,0,-2,1,1,0,0,0,0,0,0,0,0,0,0,0,0,0,0,0,0,1,1,0,0,0,0,0,0,0,0,0,0
193283,21000,210,0,-2,5,1,4,0,0,0,0,0,0,0,0,0,0,0,0,0,0,0,5,1,4,0,0,0,0,0,0,0,0,0
193292,21000,210,0,-2,12,2,10,0,0,0,0,0,0,0,0,0,1,1,0,0,0,0,11,1,10,0,0,0,0,0,0,0,0,0
193308,21000,210,0,-2,9,2,7,0,0,0,3,1,2,1,0,1,2,0,2,0,0,0,3,1,2,0,0,0,0,0,0,0,0,0
193326,21000,210,0,-2,4,1,3,0,0,0,0,0,0,0,0,0,0,0,0,0,0,0,4,1,3,0,0,0,0,0,0,0,0,0
193353,21000,210,0,-2,2,1,1,0,0,0,1,0,1,0,0,0,0,0,0,0,0,0,1,1,0,0,0,0,0,0,0,0,0,0
193399,21000,210,0,-2,9,3,6,0,0,0,0,0,0,1,0,1,0,0,0,0,0,0,8,3,5,0,0,0,0,0,0,0,0,0
193405,21000,210,0,-2,285,137,148,0,0,0,33,13,20,6,2,4,9,4,5,0,0,0,57,32,25,1,0,1,159,73,86,20,13,7
193478,21000,210,0,-2,2,1,1,0,0,0,0,0,0,0,0,0,0,0,0,0,0,0,2,1,1,0,0,0,0,0,0,0,0,0
193584,21000,210,0,-2,8,2,6,0,0,0,1,0,1,0,0,0,2,1,1,0,0,0,5,1,4,0,0,0,0,0,0,0,0,0
193654,21000,210,0,-2,15,8,7,0,0,0,0,0,0,2,1,1,2,0,2,0,0,0,7,3,4,0,0,0,1,1,0,3,3,0
193751,21000,210,0,-2,1,0,1,0,0,0,0,0,0,0,0,0,0,0,0,0,0,0,1,0,1,0,0,0,0,0,0,0,0,0
193821,21000,210,0,-2,3,1,2,0,0,0,0,0,0,0,0,0,0,0,0,0,0,0,1,0,1,0,0,0,2,1,1,0,0,0
193830,21000,210,0,-2,8,3,5,0,0,0,4,2,2,1,0,1,1,0,1,0,0,0,2,1,1,0,0,0,0,0,0,0,0,0
193900,21000,210,0,-2,474,215,259,2,0,2,107,55,52,30,9,21,35,13,22,1,1,0,249,114,135,3,1,2,9,3,6,38,19,19
193946,21000,210,0,-2,3,2,1,0,0,0,0,0,0,0,0,0,0,0,0,0,0,0,3,2,1,0,0,0,0,0,0,0,0,0
193973,21000,210,0,-2,27,12,15,0,0,0,0,0,0,0,0,0,0,0,0,0,0,0,21,8,13,0,0,0,3,2,1,3,2,1
194028,21000,210,0,-2,5,1,4,0,0,0,0,0,0,0,0,0,0,0,0,0,0,0,5,1,4,0,0,0,0,0,0,0,0,0
194073,21000,210,0,-2,1,0,1,0,0,0,1,0,1,0,0,0,0,0,0,0,0,0,0,0,0,0,0,0,0,0,0,0,0,0
194091,21000,210,0,-2,10,6,4,0,0,0,0,0,0,2,1,1,0,0,0,0,0,0,6,4,2,2,1,1,0,0,0,0,0,0
194222,21000,210,0,-2,2,0,2,0,0,0,0,0,0,0,0,0,0,0,0,0,0,0,2,0,2,0,0,0,0,0,0,0,0,0
194310,21000,210,0,-2,27,8,19,0,0,0,3,0,3,2,2,0,4,1,3,0,0,0,15,5,10,0,0,0,2,0,2,1,0,1
194392,21000,210,0,-2,5,4,1,0,0,0,2,2,0,0,0,0,0,0,0,0,0,0,3,2,1,0,0,0,0,0,0,0,0,0
194499,21000,210,0,-2,1,1,0,0,0,0,0,0,0,0,0,0,1,1,0,0,0,0,0,0,0,0,0,0,0,0,0,0,0,0
194578,21000,210,0,-2,9,4,5,0,0,0,2,0,2,1,0,1,1,0,1,0,0,0,5,4,1,0,0,0,0,0,0,0,0,0
194824,21000,210,0,-2,5,3,2,0,0,0,2,2,0,0,0,0,0,0,0,0,0,0,3,1,2,0,0,0,0,0,0,0,0,0
194958,21000,210,0,-2,5,2,3,0,0,0,0,0,0,0,0,0,0,0,0,0,0,0,5,2,3,0,0,0,0,0,0,0,0,0
195003,21000,210,0,-2,61,34,27,0,0,0,11,4,7,0,0,0,6,4,2,1,1,0,30,16,14,2,1,1,3,1,2,8,7,1
195030,21000,210,0,-2,132,69,63,0,0,0,21,14,7,7,3,4,6,4,2,0,0,0,71,33,38,0,0,0,0,0,0,27,15,12
195049,21000,210,0,-2,1,1,0,0,0,0,0,0,0,0,0,0,0,0,0,0,0,0,1,1,0,0,0,0,0,0,0,0,0,0
195058,21000,210,0,-2,4,2,2,0,0,0,0,0,0,0,0,0,0,0,0,0,0,0,4,2,2,0,0,0,0,0,0,0,0,0
195128,21000,210,0,-2,7,1,6,0,0,0,1,0,1,1,0,1,0,0,0,0,0,0,5,1,4,0,0,0,0,0,0,0,0,0
195164,21000,210,0,-2,22,8,14,0,0,0,3,2,1,2,1,1,1,0,1,1,1,0,15,4,11,0,0,0,0,0,0,0,0,0
195173,21000,210,0,-2,9,3,6,0,0,0,1,1,0,2,0,2,0,0,0,0,0,0,5,1,4,1,1,0,0,0,0,0,0,0
195191,21000,210,0,-2,1,0,1,0,0,0,0,0,0,0,0,0,0,0,0,0,0,0,1,0,1,0,0,0,0,0,0,0,0,0
195216,21000,210,0,-2,9,5,4,0,0,0,1,0,1,0,0,0,1,1,0,0,0,0,5,4,1,0,0,0,1,0,1,1,0,1
195234,21000,210,0,-2,3,2,1,0,0,0,0,0,0,1,1,0,0,0,0,0,0,0,2,1,1,0,0,0,0,0,0,0,0,0
195243,21000,210,0,-2,4,2,2,0,0,0,0,0,0,0,0,0,3,1,2,0,0,0,1,1,0,0,0,0,0,0,0,0,0,0
195304,21000,210,0,-2,3,1,2,0,0,0,0,0,0,1,0,1,2,1,1,0,0,0,0,0,0,0,0,0,0,0,0,0,0,0
195322,21000,210,0,-2,3,1,2,0,0,0,0,0,0,0,0,0,0,0,0,0,0,0,3,1,2,0,0,0,0,0,0,0,0,0
195438,21000,210,0,-2,3,3,0,0,0,0,0,0,0,0,0,0,0,0,0,0,0,0,3,3,0,0,0,0,0,0,0,0,0,0
195474,21000,210,0,-2,20,8,12,0,0,0,0,0,0,1,0,1,1,0,1,0,0,0,14,7,7,0,0,0,0,0,0,4,1,3
195544,21000,210,0,-2,12,5,7,0,0,0,0,0,0,1,0,1,0,0,0,0,0,0,3,1,2,0,0,0,8,4,4,0,0,0
195720,21000,210,0,-2,21,7,14,0,0,0,2,1,1,4,1,3,0,0,0,0,0,0,14,4,10,0,0,0,1,1,0,0,0,0
195784,21000,210,0,-2,1,0,1,0,0,0,0,0,0,0,0,0,0,0,0,0,0,0,1,0,1,0,0,0,0,0,0,0,0,0
195809,21000,210,0,-2,25,12,13,0,0,0,5,3,2,1,0,1,5,4,1,0,0,0,12,4,8,1,0,1,0,0,0,1,1,0
195988,21000,210,0,-2,2,1,1,0,0,0,0,0,0,0,0,0,0,0,0,0,0,0,2,1,1,0,0,0,0,0,0,0,0,0
196006,21000,210,0,-2,25,17,8,0,0,0,1,1,0,1,1,0,2,2,0,0,0,0,20,12,8,0,0,0,0,0,0,1,1,0
196015,21000,210,0,-2,6,3,3,0,0,0,0,0,0,1,0,1,0,0,0,0,0,0,3,1,2,0,0,0,0,0,0,2,2,0
196024,21000,210,0,-2,5,2,3,0,0,0,0,0,0,0,0,0,0,0,0,0,0,0,4,1,3,1,1,0,0,0,0,0,0,0
196033,21000,210,0,-2,6,3,3,0,0,0,0,0,0,0,0,0,0,0,0,0,0,0,6,3,3,0,0,0,0,0,0,0,0,0
196042,21000,210,0,-2,3,1,2,0,0,0,1,0,1,0,0,0,0,0,0,0,0,0,2,1,1,0,0,0,0,0,0,0,0,0
196051,21000,210,0,-2,3,0,3,0,0,0,0,0,0,0,0,0,0,0,0,0,0,0,3,0,3,0,0,0,0,0,0,0,0,0
196060,21000,210,0,-2,13,6,7,0,0,0,1,1,0,0,0,0,0,0,0,0,0,0,9,4,5,1,0,1,0,0,0,2,1,1
196079,21000,210,0,-2,31,17,14,0,0,0,3,3,0,2,1,1,1,0,1,0,0,0,18,7,11,0,0,0,0,0,0,7,6,1
196088,21000,210,0,-2,47,23,24,2,1,1,6,4,2,2,1,1,1,1,0,0,0,0,27,9,18,0,0,0,0,0,0,9,7,2
196097,21000,210,0,-2,111,54,57,0,0,0,22,13,9,3,2,1,10,6,4,0,0,0,51,19,32,2,0,2,14,8,6,9,6,3
196103,21000,210,0,-2,6,5,1,0,0,0,0,0,0,0,0,0,0,0,0,0,0,0,6,5,1,0,0,0,0,0,0,0,0,0
196112,21000,210,0,-2,3,1,2,0,0,0,1,1,0,0,0,0,0,0,0,0,0,0,1,0,1,0,0,0,0,0,0,1,0,1
196121,21000,210,0,-2,5,0,5,0,0,0,0,0,0,0,0,0,0,0,0,0,0,0,5,0,5,0,0,0,0,0,0,0,0,0
196130,21000,210,0,-2,4,2,2,0,0,0,0,0,0,0,0,0,0,0,0,0,0,0,2,1,1,0,0,0,0,0,0,2,1,1
196149,21000,210,0,-2,7,6,1,0,0,0,0,0,0,5,4,1,0,0,0,0,0,0,2,2,0,0,0,0,0,0,0,0,0,0
196158,21000,210,0,-2,4,4,0,0,0,0,0,0,0,1,1,0,0,0,0,0,0,0,2,2,0,0,0,0,0,0,0,1,1,0
196167,21000,210,0,-2,3,1,2,0,0,0,1,1,0,0,0,0,0,0,0,0,0,0,2,0,2,0,0,0,0,0,0,0,0,0
196176,21000,210,0,-2,10,4,6,0,0,0,1,1,0,2,0,2,0,0,0,0,0,0,6,3,3,0,0,0,0,0,0,1,0,1
196185,21000,210,0,-2,22,9,13,1,0,1,2,1,1,1,0,1,1,1,0,0,0,0,14,7,7,0,0,0,0,0,0,3,0,3
196194,21000,210,0,-2,3,0,3,0,0,0,1,0,1,0,0,0,0,0,0,0,0,0,1,0,1,0,0,0,0,0,0,1,0,1
196200,21000,210,0,-2,11,9,2,0,0,0,0,0,0,2,1,1,1,1,0,0,0,0,8,7,1,0,0,0,0,0,0,0,0,0
196219,21000,210,0,-2,5,1,4,0,0,0,0,0,0,1,0,1,1,0,1,0,0,0,3,1,2,0,0,0,0,0,0,0,0,0
196228,21000,210,0,-2,1,0,1,0,0,0,1,0,1,0,0,0,0,0,0,0,0,0,0,0,0,0,0,0,0,0,0,0,0,0
196237,21000,210,0,-2,2,1,1,0,0,0,0,0,0,0,0,0,1,1,0,0,0,0,1,0,1,0,0,0,0,0,0,0,0,0
196246,21000,210,0,-2,8,5,3,0,0,0,0,0,0,0,0,0,0,0,0,0,0,0,3,3,0,1,0,1,0,0,0,4,2,2
196255,21000,210,0,-2,17,9,8,0,0,0,1,1,0,7,3,4,2,1,1,0,0,0,7,4,3,0,0,0,0,0,0,0,0,0
196264,21000,210,0,-2,6,2,4,0,0,0,1,0,1,0,0,0,0,0,0,0,0,0,5,2,3,0,0,0,0,0,0,0,0,0
196291,21000,210,0,-2,3,3,0,0,0,0,2,2,0,0,0,0,0,0,0,0,0,0,1,1,0,0,0,0,0,0,0,0,0,0
196307,21000,210,0,-2,45,30,15,0,0,0,11,7,4,1,0,1,1,1,0,0,0,0,21,15,6,0,0,0,0,0,0,11,7,4
196389,21000,210,0,-2,7,2,5,0,0,0,1,1,0,3,1,2,2,0,2,0,0,0,1,0,1,0,0,0,0,0,0,0,0,0
196413,21000,210,0,-2,71,30,41,0,0,0,10,4,6,10,5,5,8,6,2,0,0,0,24,7,17,3,0,3,0,0,0,16,8,8
196431,21000,210,0,-2,2,2,0,0,0,0,0,0,0,0,0,0,0,0,0,0,0,0,2,2,0,0,0,0,0,0,0,0,0,0
196468,21000,210,0,-2,9,4,5,0,0,0,1,0,1,0,0,0,1,0,1,0,0,0,4,1,3,1,1,0,0,0,0,2,2,0
196565,21000,210,0,-2,1,0,1,0,0,0,0,0,0,0,0,0,0,0,0,0,0,0,1,0,1,0,0,0,0,0,0,0,0,0
196592,21000,210,0,-2,30,6,24,0,0,0,2,1,1,2,0,2,6,0,6,0,0,0,15,4,11,3,1,2,2,0,2,0,0,0
196653,21000,210,0,-2,6,1,5,0,0,0,0,0,0,1,0,1,0,0,0,0,0,0,5,1,4,0,0,0,0,0,0,0,0,0
196680,21000,210,0,-2,2,0,2,0,0,0,1,0,1,0,0,0,0,0,0,0,0,0,1,0,1,0,0,0,0,0,0,0,0,0
196699,21000,210,0,-2,1,0,1,0,0,0,0,0,0,0,0,0,0,0,0,0,0,0,1,0,1,0,0,0,0,0,0,0,0,0
196866,21000,210,0,-2,6,3,3,0,0,0,0,0,0,0,0,0,0,0,0,0,0,0,3,2,1,0,0,0,0,0,0,3,1,2
196884,21000,210,0,-2,1,1,0,0,0,0,0,0,0,1,1,0,0,0,0,0,0,0,0,0,0,0,0,0,0,0,0,0,0,0
197027,21000,210,0,-2,4,4,0,0,0,0,0,0,0,0,0,0,0,0,0,0,0,0,4,4,0,0,0,0,0,0,0,0,0,0
197036,21000,210,0,-2,30,15,15,0,0,0,0,0,0,1,0,1,0,0,0,0,0,0,29,15,14,0,0,0,0,0,0,0,0,0
197045,21000,210,0,-2,12,3,9,0,0,0,1,1,0,1,0,1,0,0,0,0,0,0,9,2,7,1,0,1,0,0,0,0,0,0
197133,21000,210,0,-2,30,17,13,1,0,1,1,0,1,3,2,1,3,2,1,0,0,0,13,7,6,1,1,0,3,3,0,5,2,3
197142,21000,210,0,-2,2,1,1,0,0,0,0,0,0,0,0,0,0,0,0,0,0,0,2,1,1,0,0,0,0,0,0,0,0,0
197151,21000,210,0,-2,3,1,2,0,0,0,0,0,0,0,0,0,0,0,0,0,0,0,1,1,0,0,0,0,1,0,1,1,0,1
197230,21000,210,0,-2,6,3,3,0,0,0,0,0,0,0,0,0,1,0,1,0,0,0,4,2,2,1,1,0,0,0,0,0,0,0
197294,21000,210,0,-2,3,2,1,0,0,0,0,0,0,0,0,0,0,0,0,0,0,0,3,2,1,0,0,0,0,0,0,0,0,0
197708,21000,210,0,-2,15,6,9,0,0,0,1,0,1,2,1,1,4,2,2,0,0,0,8,3,5,0,0,0,0,0,0,0,0,0
197735,21000,210,0,-2,3,3,0,0,0,0,0,0,0,0,0,0,0,0,0,0,0,0,3,3,0,0,0,0,0,0,0,0,0,0
197814,21000,210,0,-2,5,3,2,0,0,0,0,0,0,1,0,1,0,0,0,0,0,0,4,3,1,0,0,0,0,0,0,0,0,0
197850,21000,210,0,-2,11,5,6,0,0,0,0,0,0,1,0,1,0,0,0,0,0,0,10,5,5,0,0,0,0,0,0,0,0,0
197869,21000,210,0,-2,59,27,32,0,0,0,4,2,2,2,0,2,1,1,0,0,0,0,37,13,24,1,0,1,2,2,0,12,9,3
197887,21000,210,0,-2,11,6,5,0,0,0,0,0,0,0,0,0,0,0,0,0,0,0,11,6,5,0,0,0,0,0,0,0,0,0
197911,21000,210,0,-2,8,3,5,0,0,0,1,1,0,2,1,1,0,0,0,0,0,0,4,0,4,0,0,0,1,1,0,0,0,0
197966,21000,210,0,-2,4,1,3,0,0,0,0,0,0,1,0,1,0,0,0,0,0,0,3,1,2,0,0,0,0,0,0,0,0,0
197984,21000,210,0,-2,13,5,8,0,0,0,0,0,0,1,0,1,1,0,1,0,0,0,11,5,6,0,0,0,0,0,0,0,0,0
197993,21000,210,0,-2,1,0,1,0,0,0,0,0,0,0,0,0,0,0,0,0,0,0,1,0,1,0,0,0,0,0,0,0,0,0
198011,21000,210,0,-2,6,4,2,2,0,2,0,0,0,0,0,0,0,0,0,0,0,0,4,4,0,0,0,0,0,0,0,0,0,0
198039,21000,210,0,-2,14,4,10,0,0,0,0,0,0,1,0,1,0,0,0,0,0,0,13,4,9,0,0,0,0,0,0,0,0,0
198066,21000,210,0,-2,2,0,2,0,0,0,0,0,0,0,0,0,0,0,0,0,0,0,2,0,2,0,0,0,0,0,0,0,0,0
198084,21000,210,0,-2,4,0,4,0,0,0,0,0,0,1,0,1,0,0,0,0,0,0,3,0,3,0,0,0,0,0,0,0,0,0
198109,21000,210,0,-2,3,1,2,0,0,0,0,0,0,1,1,0,0,0,0,0,0,0,2,0,2,0,0,0,0,0,0,0,0,0
198118,21000,210,0,-2,14,6,8,0,0,0,0,0,0,0,0,0,0,0,0,0,0,0,14,6,8,0,0,0,0,0,0,0,0,0
198136,21000,210,0,-2,14,8,6,0,0,0,1,0,1,2,1,1,2,1,1,0,0,0,9,6,3,0,0,0,0,0,0,0,0,0
198154,21000,210,0,-2,8,4,4,0,0,0,0,0,0,0,0,0,1,0,1,0,0,0,6,3,3,1,1,0,0,0,0,0,0,0
198206,21000,210,0,-2,4,1,3,0,0,0,0,0,0,0,0,0,0,0,0,0,0,0,4,1,3,0,0,0,0,0,0,0,0,0
198215,21000,210,0,-2,10,2,8,0,0,0,0,0,0,0,0,0,0,0,0,0,0,0,10,2,8,0,0,0,0,0,0,0,0,0
198233,21000,210,0,-2,10,5,5,0,0,0,1,1,0,0,0,0,0,0,0,0,0,0,8,4,4,0,0,0,1,0,1,0,0,0
198251,21000,210,0,-2,8,2,6,0,0,0,0,0,0,2,0,2,0,0,0,0,0,0,6,2,4,0,0,0,0,0,0,0,0,0
198260,21000,210,0,-2,14,7,7,0,0,0,0,0,0,1,0,1,0,0,0,0,0,0,11,7,4,0,0,0,2,0,2,0,0,0
198303,21000,210,0,-2,6,3,3,0,0,0,0,0,0,2,0,2,0,0,0,0,0,0,4,3,1,0,0,0,0,0,0,0,0,0
198321,21000,210,0,-2,5,1,4,0,0,0,0,0,0,0,0,0,1,0,1,0,0,0,4,1,3,0,0,0,0,0,0,0,0,0
198330,21000,210,0,-2,9,5,4,0,0,0,0,0,0,0,0,0,0,0,0,0,0,0,9,5,4,0,0,0,0,0,0,0,0,0
198367,21000,210,0,-2,3,1,2,0,0,0,0,0,0,0,0,0,0,0,0,0,0,0,3,1,2,0,0,0,0,0,0,0,0,0
198376,21000,210,0,-2,15,5,10,0,0,0,0,0,0,1,1,0,0,0,0,0,0,0,13,4,9,1,0,1,0,0,0,0,0,0
198385,21000,210,0,-2,18,9,9,0,0,0,2,1,1,1,1,0,4,2,2,0,0,0,10,4,6,0,0,0,1,1,0,0,0,0
198419,21000,210,0,-2,178,91,87,1,0,1,24,11,13,14,7,7,15,5,10,0,0,0,100,52,48,1,1,0,0,0,0,23,15,8
198455,21000,210,0,-2,7,4,3,0,0,0,0,0,0,5,3,2,0,0,0,0,0,0,2,1,1,0,0,0,0,0,0,0,0,0
198464,21000,210,0,-2,46,15,31,0,0,0,3,2,1,4,0,4,6,2,4,0,0,0,24,7,17,2,0,2,3,0,3,4,4,0
198491,21000,210,0,-2,7,2,5,0,0,0,0,0,0,2,1,1,0,0,0,0,0,0,5,1,4,0,0,0,0,0,0,0,0,0
198507,21000,210,0,-2,11,6,5,0,0,0,0,0,0,6,3,3,0,0,0,0,0,0,4,2,2,0,0,0,0,0,0,1,1,0
198516,21000,210,0,-2,37,13,24,0,0,0,4,2,2,5,0,5,3,1,2,0,0,0,23,9,14,0,0,0,2,1,1,0,0,0
198534,21000,210,0,-2,37,17,20,4,2,2,2,2,0,12,5,7,0,0,0,0,0,0,19,8,11,0,0,0,0,0,0,0,0,0
198543,21000,210,0,-2,11,4,7,0,0,0,1,1,0,7,1,6,0,0,0,0,0,0,1,1,0,0,0,0,0,0,0,2,1,1
198552,21000,210,0,-2,14,6,8,0,0,0,0,0,0,6,2,4,0,0,0,0,0,0,7,4,3,1,0,1,0,0,0,0,0,0
198561,21000,210,0,-2,6,1,5,0,0,0,0,0,0,1,0,1,1,0,1,0,0,0,4,1,3,0,0,0,0,0,0,0,0,0
198570,21000,210,0,-2,19,8,11,0,0,0,0,0,0,0,0,0,0,0,0,0,0,0,19,8,11,0,0,0,0,0,0,0,0,0
198598,21000,210,0,-2,1,0,1,0,0,0,0,0,0,0,0,0,0,0,0,0,0,0,1,0,1,0,0,0,0,0,0,0,0,0
198613,21000,210,0,-2,7,5,2,0,0,0,3,1,2,0,0,0,0,0,0,0,0,0,4,4,0,0,0,0,0,0,0,0,0,0
198622,21000,210,0,-2,21,8,13,0,0,0,0,0,0,5,0,5,0,0,0,0,0,0,16,8,8,0,0,0,0,0,0,0,0,0
198640,21000,210,0,-2,3,2,1,0,0,0,0,0,0,0,0,0,0,0,0,0,0,0,3,2,1,0,0,0,0,0,0,0,0,0
198668,21000,210,0,-2,4,0,4,0,0,0,0,0,0,0,0,0,0,0,0,0,0,0,4,0,4,0,0,0,0,0,0,0,0,0
198695,21000,210,0,-2,34,13,21,0,0,0,1,1,0,5,2,3,1,0,1,0,0,0,26,10,16,1,0,1,0,0,0,0,0,0
198710,21000,210,0,-2,2,0,2,0,0,0,0,0,0,0,0,0,0,0,0,0,0,0,2,0,2,0,0,0,0,0,0,0,0,0
198729,21000,210,0,-2,2,0,2,0,0,0,0,0,0,0,0,0,1,0,1,0,0,0,1,0,1,0,0,0,0,0,0,0,0,0
198756,21000,210,0,-2,6,4,2,0,0,0,1,1,0,3,1,2,0,0,0,0,0,0,2,2,0,0,0,0,0,0,0,0,0,0
198774,21000,210,0,-2,7,2,5,0,0,0,0,0,0,0,0,0,0,0,0,0,0,0,7,2,5,0,0,0,0,0,0,0,0,0
198808,21000,210,0,-2,11,5,6,0,0,0,0,0,0,0,0,0,1,1,0,0,0,0,10,4,6,0,0,0,0,0,0,0,0,0
198817,21000,210,0,-2,9,3,6,0,0,0,0,0,0,0,0,0,0,0,0,0,0,0,9,3,6,0,0,0,0,0,0,0,0,0
198835,21000,210,0,-2,18,8,10,0,0,0,2,1,1,2,1,1,0,0,0,0,0,0,11,3,8,1,1,0,2,2,0,0,0,0
198862,21000,210,0,-2,8,2,6,0,0,0,0,0,0,6,2,4,0,0,0,0,0,0,2,0,2,0,0,0,0,0,0,0,0,0
198871,21000,210,0,-2,3,1,2,0,0,0,0,0,0,1,0,1,0,0,0,0,0,0,2,1,1,0,0,0,0,0,0,0,0,0
198899,21000,210,0,-2,5,2,3,0,0,0,0,0,0,0,0,0,0,0,0,0,0,0,5,2,3,0,0,0,0,0,0,0,0,0
198905,21000,210,0,-2,1,1,0,0,0,0,0,0,0,0,0,0,0,0,0,0,0,0,1,1,0,0,0,0,0,0,0,0,0,0
198923,21000,210,0,-2,3,2,1,0,0,0,0,0,0,0,0,0,0,0,0,0,0,0,3,2,1,0,0,0,0,0,0,0,0,0
198950,21000,210,0,-2,7,3,4,0,0,0,0,0,0,1,0,1,1,1,0,0,0,0,4,2,2,0,0,0,1,0,1,0,0,0
198969,21000,210,0,-2,17,5,12,0,0,0,2,1,1,2,1,1,0,0,0,0,0,0,11,2,9,1,0,1,1,1,0,0,0,0
198987,21000,210,0,-2,5,3,2,0,0,0,0,0,0,0,0,0,0,0,0,0,0,0,5,3,2,0,0,0,0,0,0,0,0,0
199023,21000,210,0,-2,4,0,4,0,0,0,0,0,0,0,0,0,0,0,0,0,0,0,4,0,4,0,0,0,0,0,0,0,0,0
199032,21000,210,0,-2,6,3,3,0,0,0,0,0,0,2,0,2,0,0,0,0,0,0,4,3,1,0,0,0,0,0,0,0,0,0
199069,21000,210,0,-2,3,1,2,0,0,0,0,0,0,0,0,0,0,0,0,0,0,0,3,1,2,0,0,0,0,0,0,0,0,0
199087,21000,210,0,-2,6,3,3,0,0,0,0,0,0,0,0,0,0,0,0,0,0,0,5,3,2,1,0,1,0,0,0,0,0,0
199102,21000,210,0,-2,34,18,16,0,0,0,2,2,0,10,3,7,3,1,2,0,0,0,5,4,1,0,0,0,13,8,5,1,0,1
199111,21000,210,0,-2,11,6,5,0,0,0,0,0,0,1,0,1,1,0,1,0,0,0,1,0,1,0,0,0,7,5,2,1,1,0
199120,21000,210,0,-2,93,37,56,0,0,0,3,1,2,9,0,9,7,4,3,0,0,0,31,15,16,3,0,3,28,13,15,12,4,8
199139,21000,210,0,-2,50,20,30,0,0,0,0,0,0,16,5,11,4,0,4,0,0,0,25,11,14,1,0,1,0,0,0,4,4,0
199148,21000,210,0,-2,63,21,42,0,0,0,3,0,3,7,1,6,2,2,0,0,0,0,41,13,28,0,0,0,1,0,1,9,5,4
199157,21000,210,0,-2,16,4,12,0,0,0,0,0,0,4,2,2,0,0,0,0,0,0,4,0,4,0,0,0,8,2,6,0,0,0
199184,21000,210,0,-2,5,1,4,0,0,0,1,0,1,1,0,1,0,0,0,0,0,0,3,1,2,0,0,0,0,0,0,0,0,0
199193,21000,210,0,-2,81,37,44,1,1,0,9,4,5,7,0,7,4,3,1,0,0,0,46,21,25,0,0,0,3,2,1,11,6,5
199209,21000,210,0,-2,9,5,4,0,0,0,0,0,0,0,0,0,0,0,0,0,0,0,9,5,4,0,0,0,0,0,0,0,0,0
199218,21000,210,0,-2,63,25,38,0,0,0,3,3,0,5,2,3,2,0,2,0,0,0,34,10,24,3,2,1,3,2,1,13,6,7
199263,21000,210,0,-2,2,2,0,0,0,0,0,0,0,0,0,0,0,0,0,0,0,0,2,2,0,0,0,0,0,0,0,0,0,0
199272,21000,210,0,-2,1,0,1,0,0,0,0,0,0,0,0,0,0,0,0,0,0,0,1,0,1,0,0,0,0,0,0,0,0,0
199281,21000,210,0,-2,28,11,17,1,0,1,2,1,1,3,0,3,0,0,0,0,0,0,20,9,11,0,0,0,0,0,0,2,1,1
199306,21000,210,0,-2,10,4,6,0,0,0,0,0,0,2,1,1,0,0,0,0,0,0,8,3,5,0,0,0,0,0,0,0,0,0
199324,21000,210,0,-2,9,6,3,0,0,0,0,0,0,2,2,0,1,0,1,0,0,0,6,4,2,0,0,0,0,0,0,0,0,0
199333,21000,210,0,-2,6,1,5,0,0,0,0,0,0,1,0,1,0,0,0,0,0,0,5,1,4,0,0,0,0,0,0,0,0,0
199412,21000,210,0,-2,4,1,3,0,0,0,0,0,0,1,0,1,1,0,1,0,0,0,2,1,1,0,0,0,0,0,0,0,0,0
199421,21000,210,0,-2,2,0,2,0,0,0,0,0,0,0,0,0,0,0,0,0,0,0,1,0,1,0,0,0,1,0,1,0,0,0
199449,21000,210,0,-2,13,7,6,0,0,0,0,0,0,1,1,0,0,0,0,0,0,0,12,6,6,0,0,0,0,0,0,0,0,0
199458,21000,210,0,-2,1,1,0,0,0,0,0,0,0,0,0,0,0,0,0,0,0,0,1,1,0,0,0,0,0,0,0,0,0,0
199467,21000,210,0,-2,2,0,2,0,0,0,0,0,0,0,0,0,0,0,0,0,0,0,2,0,2,0,0,0,0,0,0,0,0,0
199476,21000,210,0,-2,7,1,6,2,1,1,0,0,0,2,0,2,0,0,0,0,0,0,3,0,3,0,0,0,0,0,0,0,0,0
199485,21000,210,0,-2,1,0,1,0,0,0,0,0,0,0,0,0,0,0,0,0,0,0,1,0,1,0,0,0,0,0,0,0,0,0
199494,21000,210,0,-2,5,2,3,0,0,0,0,0,0,2,2,0,0,0,0,0,0,0,3,0,3,0,0,0,0,0,0,0,0,0
199582,21000,210,0,-2,1,1,0,0,0,0,0,0,0,1,1,0,0,0,0,0,0,0,0,0,0,0,0,0,0,0,0,0,0,0
199607,21000,210,0,-2,1,0,1,0,0,0,0,0,0,0,0,0,0,0,0,0,0,0,1,0,1,0,0,0,0,0,0,0,0,0
199625,21000,210,0,-2,8,4,4,1,0,1,0,0,0,1,1,0,0,0,0,0,0,0,6,3,3,0,0,0,0,0,0,0,0,0
199634,21000,210,0,-2,7,4,3,0,0,0,0,0,0,0,0,0,0,0,0,0,0,0,7,4,3,0,0,0,0,0,0,0,0,0
199643,21000,210,0,-2,8,2,6,0,0,0,0,0,0,8,2,6,0,0,0,0,0,0,0,0,0,0,0,0,0,0,0,0,0,0
199698,21000,210,0,-2,5,1,4,0,0,0,0,0,0,1,0,1,0,0,0,0,0,0,4,1,3,0,0,0,0,0,0,0,0,0
199722,21000,210,0,-2,12,7,5,0,0,0,0,0,0,2,1,1,0,0,0,0,0,0,10,6,4,0,0,0,0,0,0,0,0,0
199731,21000,210,0,-2,4,1,3,0,0,0,0,0,0,0,0,0,0,0,0,0,0,0,4,1,3,0,0,0,0,0,0,0,0,0
199740,21000,210,0,-2,3,1,2,0,0,0,0,0,0,1,0,1,0,0,0,0,0,0,2,1,1,0,0,0,0,0,0,0,0,0
199759,21000,210,0,-2,1,0,1,0,0,0,0,0,0,0,0,0,0,0,0,0,0,0,1,0,1,0,0,0,0,0,0,0,0,0
199768,21000,210,0,-2,4,2,2,0,0,0,0,0,0,0,0,0,0,0,0,0,0,0,4,2,2,0,0,0,0,0,0,0,0,0
199786,21000,210,0,-2,6,1,5,0,0,0,0,0,0,0,0,0,0,0,0,0,0,0,6,1,5,0,0,0,0,0,0,0,0,0
199795,21000,210,0,-2,3,1,2,0,0,0,0,0,0,0,0,0,0,0,0,0,0,0,3,1,2,0,0,0,0,0,0,0,0,0
199838,21000,210,0,-2,1,1,0,0,0,0,1,1,0,0,0,0,0,0,0,0,0,0,0,0,0,0,0,0,0,0,0,0,0,0
199847,21000,210,0,-2,126,71,55,1,1,0,22,14,8,13,3,10,4,2,2,0,0,0,76,46,30,4,1,3,0,0,0,6,4,2
199856,21000,210,0,-2,34,23,11,0,0,0,2,2,0,5,1,4,0,0,0,0,0,0,21,15,6,0,0,0,6,5,1,0,0,0
199865,21000,210,0,-2,2,0,2,0,0,0,0,0,0,0,0,0,0,0,0,0,0,0,1,0,1,0,0,0,0,0,0,1,0,1
199883,21000,210,0,-2,1,0,1,0,0,0,0,0,0,1,0,1,0,0,0,0,0,0,0,0,0,0,0,0,0,0,0,0,0,0
199892,21000,210,0,-2,10,3,7,0,0,0,0,0,0,0,0,0,0,0,0,0,0,0,10,3,7,0,0,0,0,0,0,0,0,0
199908,21000,210,0,-2,2,1,1,0,0,0,0,0,0,0,0,0,0,0,0,0,0,0,2,1,1,0,0,0,0,0,0,0,0,0
199926,21000,210,0,-2,3,3,0,0,0,0,0,0,0,0,0,0,0,0,0,0,0,0,3,3,0,0,0,0,0,0,0,0,0,0
199953,21000,210,0,-2,2,1,1,0,0,0,0,0,0,1,1,0,0,0,0,0,0,0,1,0,1,0,0,0,0,0,0,0,0,0
199962,21000,210,0,-2,6,3,3,0,0,0,1,0,1,1,1,0,0,0,0,0,0,0,4,2,2,0,0,0,0,0,0,0,0,0
199999,21000,210,0,-2,13,5,8,0,0,0,1,0,1,8,3,5,0,0,0,0,0,0,4,2,2,0,0,0,0,0,0,0,0,0
200004,21000,210,0,-2,47,26,21,0,0,0,3,0,3,5,3,2,5,3,2,0,0,0,31,18,13,0,0,0,0,0,0,3,2,1
200022,21000,210,0,-2,5,2,3,1,1,0,0,0,0,0,0,0,0,0,0,0,0,0,4,1,3,0,0,0,0,0,0,0,0,0
200059,21000,210,0,-2,5,4,1,0,0,0,0,0,0,0,0,0,0,0,0,0,0,0,5,4,1,0,0,0,0,0,0,0,0,0
200156,21000,210,0,-2,7,3,4,0,0,0,0,0,0,0,0,0,0,0,0,0,0,0,7,3,4,0,0,0,0,0,0,0,0,0
200192,21000,210,0,-2,2,1,1,0,0,0,0,0,0,0,0,0,0,0,0,0,0,0,2,1,1,0,0,0,0,0,0,0,0,0
200208,21000,210,0,-2,3,2,1,2,1,1,0,0,0,0,0,0,0,0,0,0,0,0,1,1,0,0,0,0,0,0,0,0,0,0
200217,21000,210,0,-2,11,3,8,0,0,0,1,1,0,0,0,0,0,0,0,0,0,0,10,2,8,0,0,0,0,0,0,0,0,0
200226,21000,210,0,-2,1,0,1,0,0,0,0,0,0,0,0,0,0,0,0,0,0,0,1,0,1,0,0,0,0,0,0,0,0,0
200253,21000,210,0,-2,13,5,8,0,0,0,0,0,0,0,0,0,0,0,0,0,0,0,13,5,8,0,0,0,0,0,0,0,0,0
200280,21000,210,0,-2,59,30,29,2,1,1,5,2,3,3,2,1,1,0,1,0,0,0,27,11,16,0,0,0,0,0,0,21,14,7
200305,21000,210,0,-2,7,3,4,0,0,0,0,0,0,0,0,0,0,0,0,0,0,0,7,3,4,0,0,0,0,0,0,0,0,0
200314,21000,210,0,-2,3,1,2,1,0,1,0,0,0,0,0,0,0,0,0,0,0,0,2,1,1,0,0,0,0,0,0,0,0,0
200332,21000,210,0,-2,31,14,17,0,0,0,4,3,1,0,0,0,0,0,0,0,0,0,18,5,13,1,1,0,0,0,0,8,5,3
200341,21000,210,0,-2,5,1,4,0,0,0,0,0,0,0,0,0,0,0,0,0,0,0,5,1,4,0,0,0,0,0,0,0,0,0
200466,21000,210,0,-2,1,1,0,0,0,0,0,0,0,0,0,0,0,0,0,0,0,0,1,1,0,0,0,0,0,0,0,0,0,0
200527,21000,210,0,-2,4,3,1,3,2,1,0,0,0,0,0,0,0,0,0,0,0,0,1,1,0,0,0,0,0,0,0,0,0,0
200554,21000,210,0,-2,1,1,0,0,0,0,0,0,0,0,0,0,0,0,0,0,0,0,1,1,0,0,0,0,0,0,0,0,0,0
200572,21000,210,0,-2,10,3,7,0,0,0,0,0,0,0,0,0,0,0,0,0,0,0,10,3,7,0,0,0,0,0,0,0,0,0
200590,21000,210,0,-2,1,0,1,0,0,0,0,0,0,0,0,0,0,0,0,0,0,0,1,0,1,0,0,0,0,0,0,0,0,0
200800,21000,210,0,-2,21,9,12,0,0,0,3,1,2,1,0,1,2,1,1,0,0,0,12,6,6,0,0,0,0,0,0,3,1,2
201104,21000,210,0,-2,13,4,9,0,0,0,0,0,0,3,0,3,0,0,0,0,0,0,8,3,5,0,0,0,0,0,0,2,1,1
201140,21000,210,0,-2,1,1,0,0,0,0,0,0,0,0,0,0,0,0,0,0,0,0,1,1,0,0,0,0,0,0,0,0,0,0
201177,21000,210,0,-2,1,0,1,0,0,0,0,0,0,0,0,0,0,0,0,0,0,0,1,0,1,0,0,0,0,0,0,0,0,0
201195,21000,210,0,-2,12,5,7,0,0,0,1,0,1,1,1,0,1,1,0,0,0,0,9,3,6,0,0,0,0,0,0,0,0,0
201283,21000,210,0,-2,1,1,0,0,0,0,0,0,0,0,0,0,0,0,0,0,0,0,1,1,0,0,0,0,0,0,0,0,0,0
201371,21000,210,0,-2,2,0,2,0,0,0,0,0,0,0,0,0,0,0,0,0,0,0,2,0,2,0,0,0,0,0,0,0,0,0
201432,21000,210,0,-2,3,3,0,0,0,0,0,0,0,0,0,0,0,0,0,0,0,0,2,2,0,0,0,0,1,1,0,0,0,0
201441,21000,210,0,-2,41,14,27,0,0,0,0,0,0,2,0,2,0,0,0,0,0,0,17,3,14,0,0,0,22,11,11,0,0,0
201469,21000,210,0,-2,3,1,2,0,0,0,0,0,0,0,0,0,0,0,0,0,0,0,3,1,2,0,0,0,0,0,0,0,0,0
201548,21000,210,0,-2,14,5,9,0,0,0,1,1,0,1,0,1,0,0,0,0,0,0,11,4,7,0,0,0,1,0,1,0,0,0
201645,21000,210,0,-2,42,25,17,0,0,0,6,4,2,3,2,1,3,2,1,0,0,0,24,13,11,0,0,0,1,1,0,5,3,2
201654,21000,210,0,-2,15,4,11,0,0,0,0,0,0,1,1,0,0,0,0,0,0,0,14,3,11,0,0,0,0,0,0,0,0,0
201672,21000,210,0,-2,1,1,0,0,0,0,0,0,0,0,0,0,0,0,0,0,0,0,1,1,0,0,0,0,0,0,0,0,0,0
201690,21000,210,0,-2,14,9,5,0,0,0,0,0,0,4,3,1,1,1,0,0,0,0,7,5,2,0,0,0,2,0,2,0,0,0
201751,21000,210,0,-2,2,0,2,0,0,0,0,0,0,0,0,0,0,0,0,0,0,0,1,0,1,0,0,0,1,0,1,0,0,0
201821,21000,210,0,-2,10,2,8,0,0,0,0,0,0,0,0,0,0,0,0,0,0,0,10,2,8,0,0,0,0,0,0,0,0,0
201885,21000,210,0,-2,150,77,73,0,0,0,21,10,11,8,4,4,4,3,1,0,0,0,88,42,46,2,1,1,9,4,5,18,13,5
201928,21000,210,0,-2,4,0,4,0,0,0,0,0,0,1,0,1,0,0,0,0,0,0,3,0,3,0,0,0,0,0,0,0,0,0
201946,21000,210,0,-2,5,0,5,0,0,0,0,0,0,0,0,0,1,0,1,0,0,0,4,0,4,0,0,0,0,0,0,0,0,0
201955,21000,210,0,-2,2,1,1,0,0,0,0,0,0,0,0,0,0,0,0,0,0,0,1,1,0,0,0,0,1,0,1,0,0,0
201964,21000,210,0,-2,1,1,0,0,0,0,0,0,0,0,0,0,0,0,0,0,0,0,1,1,0,0,0,0,0,0,0,0,0,0
201973,21000,210,0,-2,8,1,7,0,0,0,0,0,0,0,0,0,0,0,0,0,0,0,7,0,7,0,0,0,1,1,0,0,0,0
202046,21000,210,0,-2,5,3,2,0,0,0,0,0,0,0,0,0,0,0,0,0,0,0,5,3,2,0,0,0,0,0,0,0,0,0
202073,21000,210,0,-2,2,1,1,0,0,0,0,0,0,0,0,0,0,0,0,0,0,0,2,1,1,0,0,0,0,0,0,0,0,0
202134,21000,210,0,-2,32,20,12,0,0,0,3,2,1,2,0,2,1,1,0,0,0,0,22,15,7,0,0,0,0,0,0,4,2,2
202222,21000,210,0,-2,13,8,5,0,0,0,0,0,0,0,0,0,1,0,1,1,0,1,10,7,3,0,0,0,1,1,0,0,0,0
202356,21000,210,0,-2,30,8,22,0,0,0,0,0,0,5,0,5,1,0,1,0,0,0,21,6,15,2,1,1,1,1,0,0,0,0
202480,21000,210,0,-2,60,40,20,0,0,0,7,5,2,4,3,1,1,1,0,0,0,0,44,28,16,0,0,0,0,0,0,4,3,1
202514,21000,210,0,-2,4,0,4,0,0,0,0,0,0,0,0,0,0,0,0,0,0,0,4,0,4,0,0,0,0,0,0,0,0,0
202523,21000,210,0,-2,18,6,12,0,0,0,2,1,1,1,0,1,0,0,0,0,0,0,15,5,10,0,0,0,0,0,0,0,0,0
202648,21000,210,0,-2,3,1,2,0,0,0,1,0,1,0,0,0,0,0,0,0,0,0,1,0,1,0,0,0,1,1,0,0,0,0
202763,21000,210,0,-2,9,6,3,0,0,0,1,1,0,2,2,0,0,0,0,0,0,0,6,3,3,0,0,0,0,0,0,0,0,0
202806,21000,210,0,-2,5,1,4,0,0,0,0,0,0,0,0,0,0,0,0,0,0,0,5,1,4,0,0,0,0,0,0,0,0,0
202912,21000,210,0,-2,6,0,6,0,0,0,0,0,0,0,0,0,0,0,0,0,0,0,6,0,6,0,0,0,0,0,0,0,0,0
203085,21000,210,0,-2,9,5,4,0,0,0,0,0,0,1,0,1,0,0,0,0,0,0,8,5,3,0,0,0,0,0,0,0,0,0
203128,21000,210,0,-2,4,2,2,0,0,0,1,0,1,0,0,0,0,0,0,0,0,0,3,2,1,0,0,0,0,0,0,0,0,0
203155,21000,210,0,-2,11,7,4,0,0,0,0,0,0,1,0,1,0,0,0,0,0,0,10,7,3,0,0,0,0,0,0,0,0,0
203368,21000,210,0,-2,7,5,2,0,0,0,2,1,1,0,0,0,0,0,0,0,0,0,4,3,1,0,0,0,0,0,0,1,1,0
203386,21000,210,0,-2,33,5,28,0,0,0,0,0,0,4,0,4,0,0,0,0,0,0,28,5,23,0,0,0,1,0,1,0,0,0
203483,21000,210,0,-2,1,1,0,0,0,0,0,0,0,0,0,0,0,0,0,0,0,0,1,1,0,0,0,0,0,0,0,0,0,0
203492,21000,210,0,-2,2,1,1,0,0,0,0,0,0,0,0,0,0,0,0,0,0,0,1,0,1,0,0,0,0,0,0,1,1,0
203517,21000,210,0,-2,31,15,16,0,0,0,0,0,0,5,0,5,2,2,0,0,0,0,14,6,8,2,1,1,3,3,0,5,3,2
203535,21000,210,0,-2,30,6,24,0,0,0,1,0,1,0,0,0,3,1,2,0,0,0,5,0,5,0,0,0,19,4,15,2,1,1
203544,21000,210,0,-2,4,2,2,0,0,0,0,0,0,1,1,0,0,0,0,0,0,0,3,1,2,0,0,0,0,0,0,0,0,0
203599,21000,210,0,-2,3,1,2,0,0,0,0,0,0,0,0,0,0,0,0,0,0,0,2,1,1,0,0,0,1,0,1,0,0,0
203678,21000,210,0,-2,8,4,4,0,0,0,1,1,0,0,0,0,0,0,0,0,0,0,7,3,4,0,0,0,0,0,0,0,0,0
203720,21000,210,0,-2,5,5,0,0,0,0,0,0,0,2,2,0,0,0,0,0,0,0,3,3,0,0,0,0,0,0,0,0,0,0
203748,21000,210,0,-2,2,0,2,0,0,0,0,0,0,0,0,0,0,0,0,0,0,0,2,0,2,0,0,0,0,0,0,0,0,0
203757,21000,210,0,-2,10,1,9,0,0,0,0,0,0,0,0,0,0,0,0,0,0,0,8,0,8,0,0,0,2,1,1,0,0,0
203775,21000,210,0,-2,2,1,1,0,0,0,0,0,0,1,1,0,0,0,0,0,0,0,1,0,1,0,0,0,0,0,0,0,0,0
203845,21000,210,0,-2,13,8,5,0,0,0,0,0,0,0,0,0,1,1,0,0,0,0,12,7,5,0,0,0,0,0,0,0,0,0
203881,21000,210,0,-2,1,0,1,0,0,0,0,0,0,0,0,0,0,0,0,0,0,0,1,0,1,0,0,0,0,0,0,0,0,0
203960,21000,210,0,-2,8,0,8,0,0,0,0,0,0,1,0,1,0,0,0,0,0,0,7,0,7,0,0,0,0,0,0,0,0,0
204006,21000,210,0,-2,4,0,4,0,0,0,0,0,0,0,0,0,0,0,0,0,0,0,4,0,4,0,0,0,0,0,0,0,0,0
204015,21000,210,0,-2,1,0,1,0,0,0,0,0,0,0,0,0,0,0,0,0,0,0,0,0,0,0,0,0,1,0,1,0,0,0
204024,21000,210,0,-2,37,19,18,0,0,0,1,0,1,2,0,2,1,1,0,0,0,0,29,14,15,0,0,0,0,0,0,4,4,0
204176,21000,210,0,-2,4,0,4,0,0,0,0,0,0,0,0,0,0,0,0,0,0,0,4,0,4,0,0,0,0,0,0,0,0,0
204185,21000,210,0,-2,6,3,3,0,0,0,1,1,0,0,0,0,0,0,0,0,0,0,4,1,3,0,0,0,0,0,0,1,1,0
204194,21000,210,0,-2,5,4,1,0,0,0,1,1,0,1,1,0,1,1,0,0,0,0,1,1,0,1,0,1,0,0,0,0,0,0
204200,21000,210,0,-2,10,2,8,0,0,0,2,0,2,0,0,0,0,0,0,0,0,0,8,2,6,0,0,0,0,0,0,0,0,0
204255,21000,210,0,-2,2,0,2,0,0,0,0,0,0,0,0,0,0,0,0,0,0,0,2,0,2,0,0,0,0,0,0,0,0,0
204264,21000,210,0,-2,6,1,5,0,0,0,1,0,1,0,0,0,0,0,0,0,0,0,5,1,4,0,0,0,0,0,0,0,0,0
204422,21000,210,0,-2,6,3,3,0,0,0,1,1,0,2,1,1,0,0,0,2,1,1,1,0,1,0,0,0,0,0,0,0,0,0
204440,21000,210,0,-2,7,5,2,0,0,0,0,0,0,0,0,0,0,0,0,0,0,0,7,5,2,0,0,0,0,0,0,0,0,0
204477,21000,210,0,-2,7,5,2,0,0,0,0,0,0,0,0,0,0,0,0,0,0,0,7,5,2,0,0,0,0,0,0,0,0,0
204501,21000,210,0,-2,43,20,23,0,0,0,1,0,1,1,0,1,2,1,1,0,0,0,27,12,15,0,0,0,2,0,2,10,7,3
204608,21000,210,0,-2,3,1,2,0,0,0,0,0,0,1,0,1,0,0,0,0,0,0,2,1,1,0,0,0,0,0,0,0,0,0
204617,21000,210,0,-2,2,2,0,0,0,0,1,1,0,0,0,0,0,0,0,0,0,0,1,1,0,0,0,0,0,0,0,0,0,0
204635,21000,210,0,-2,9,7,2,0,0,0,1,0,1,0,0,0,1,1,0,0,0,0,7,6,1,0,0,0,0,0,0,0,0,0
204796,21000,210,0,-2,281,111,170,0,0,0,55,21,34,16,6,10,12,5,7,0,0,0,168,63,105,5,2,3,14,7,7,11,7,4
204820,21000,210,0,-2,1,0,1,0,0,0,0,0,0,0,0,0,0,0,0,0,0,0,1,0,1,0,0,0,0,0,0,0,0,0
204839,21000,210,0,-2,2,1,1,0,0,0,0,0,0,0,0,0,0,0,0,0,0,0,2,1,1,0,0,0,0,0,0,0,0,0
204848,21000,210,0,-2,1,1,0,0,0,0,0,0,0,0,0,0,0,0,0,0,0,0,1,1,0,0,0,0,0,0,0,0,0,0
204857,21000,210,0,-2,16,3,13,0,0,0,1,0,1,1,0,1,1,0,1,0,0,0,10,2,8,0,0,0,2,0,2,1,1,0
204866,21000,210,0,-2,2,1,1,0,0,0,0,0,0,0,0,0,0,0,0,0,0,0,2,1,1,0,0,0,0,0,0,0,0,0
204909,21000,210,0,-2,11,6,5,0,0,0,1,0,1,2,2,0,1,0,1,0,0,0,6,4,2,0,0,0,1,0,1,0,0,0
204945,21000,210,0,-2,3,0,3,0,0,0,0,0,0,0,0,0,0,0,0,0,0,0,3,0,3,0,0,0,0,0,0,0,0,0
205054,21000,210,0,-2,1,0,1,0,0,0,0,0,0,0,0,0,0,0,0,0,0,0,1,0,1,0,0,0,0,0,0,0,0,0
205179,21000,210,0,-2,3,1,2,0,0,0,0,0,0,0,0,0,0,0,0,0,0,0,3,1,2,0,0,0,0,0,0,0,0,0
205203,21000,210,0,-2,5,3,2,0,0,0,0,0,0,0,0,0,0,0,0,0,0,0,5,3,2,0,0,0,0,0,0,0,0,0
205391,21000,210,0,-2,1,1,0,0,0,0,0,0,0,0,0,0,0,0,0,0,0,0,1,1,0,0,0,0,0,0,0,0,0,0
205443,21000,210,0,-2,3,0,3,0,0,0,0,0,0,0,0,0,0,0,0,0,0,0,3,0,3,0,0,0,0,0,0,0,0,0
205470,21000,210,0,-2,11,3,8,0,0,0,0,0,0,1,0,1,0,0,0,0,0,0,10,3,7,0,0,0,0,0,0,0,0,0
205841,21000,210,0,-2,10,5,5,0,0,0,0,0,0,0,0,0,0,0,0,0,0,0,9,4,5,0,0,0,1,1,0,0,0,0
205887,21000,210,0,-2,6,0,6,0,0,0,0,0,0,1,0,1,0,0,0,0,0,0,5,0,5,0,0,0,0,0,0,0,0,0
205957,21000,210,0,-2,8,4,4,0,0,0,0,0,0,0,0,0,0,0,0,0,0,0,7,3,4,0,0,0,1,1,0,0,0,0
205966,21000,210,0,-2,5,4,1,0,0,0,0,0,0,0,0,0,0,0,0,0,0,0,5,4,1,0,0,0,0,0,0,0,0,0
206011,21000,210,0,-2,4,2,2,0,0,0,0,0,0,1,0,1,0,0,0,0,0,0,3,2,1,0,0,0,0,0,0,0,0,0
206048,21000,210,0,-2,9,8,1,0,0,0,0,0,0,0,0,0,0,0,0,0,0,0,8,7,1,1,1,0,0,0,0,0,0,0
206084,21000,210,0,-2,19,10,9,0,0,0,6,4,2,0,0,0,1,0,1,0,0,0,11,5,6,1,1,0,0,0,0,0,0,0
206279,21000,210,0,-2,1,0,1,0,0,0,0,0,0,0,0,0,0,0,0,0,0,0,1,0,1,0,0,0,0,0,0,0,0,0
206349,21000,210,0,-2,14,4,10,0,0,0,0,0,0,1,1,0,0,0,0,0,0,0,13,3,10,0,0,0,0,0,0,0,0,0
206437,21000,210,0,-2,8,4,4,0,0,0,0,0,0,1,1,0,0,0,0,0,0,0,6,2,4,0,0,0,1,1,0,0,0,0
206446,21000,210,0,-2,11,3,8,0,0,0,0,0,0,0,0,0,1,1,0,0,0,0,10,2,8,0,0,0,0,0,0,0,0,0
206491,21000,210,0,-2,1,1,0,0,0,0,0,0,0,1,1,0,0,0,0,0,0,0,0,0,0,0,0,0,0,0,0,0,0,0
206507,21000,210,0,-2,11,4,7,0,0,0,0,0,0,0,0,0,1,0,1,0,0,0,10,4,6,0,0,0,0,0,0,0,0,0
206525,21000,210,0,-2,7,1,6,0,0,0,1,1,0,0,0,0,1,0,1,0,0,0,5,0,5,0,0,0,0,0,0,0,0,0
206589,21000,210,0,-2,16,6,10,0,0,0,0,0,0,3,0,3,1,1,0,0,0,0,7,1,6,0,0,0,1,1,0,4,3,1
206604,21000,210,0,-2,19,7,12,0,0,0,3,2,1,2,0,2,0,0,0,0,0,0,12,3,9,0,0,0,0,0,0,2,2,0
206622,21000,210,0,-2,20,8,12,0,0,0,1,0,1,2,1,1,0,0,0,0,0,0,17,7,10,0,0,0,0,0,0,0,0,0
206695,21000,210,0,-2,34,20,14,0,0,0,0,0,0,0,0,0,1,0,1,0,0,0,24,14,10,1,0,1,0,0,0,8,6,2
206862,21000,210,0,-2,9,4,5,0,0,0,1,0,1,0,0,0,0,0,0,0,0,0,7,4,3,1,0,1,0,0,0,0,0,0
206914,21000,210,0,-2,7,3,4,0,0,0,2,1,1,0,0,0,0,0,0,0,0,0,4,1,3,1,1,0,0,0,0,0,0,0
206923,21000,210,0,-2,1,0,1,0,0,0,0,0,0,0,0,0,0,0,0,0,0,0,1,0,1,0,0,0,0,0,0,0,0,0
206932,21000,210,0,-2,3,1,2,0,0,0,0,0,0,0,0,0,0,0,0,0,0,0,3,1,2,0,0,0,0,0,0,0,0,0
206941,21000,210,0,-2,54,24,30,1,0,1,3,2,1,2,1,1,3,2,1,2,1,1,34,11,23,1,1,0,7,5,2,1,1,0
206996,21000,210,0,-2,7,4,3,1,1,0,1,1,0,0,0,0,1,0,1,0,0,0,4,2,2,0,0,0,0,0,0,0,0,0
207041,21000,210,0,-2,8,4,4,0,0,0,1,1,0,0,0,0,0,0,0,0,0,0,6,3,3,0,0,0,1,0,1,0,0,0
207069,21000,210,0,-2,1,0,1,0,0,0,0,0,0,0,0,0,0,0,0,0,0,0,0,0,0,1,0,1,0,0,0,0,0,0
207157,21000,210,0,-2,4,4,0,1,1,0,0,0,0,0,0,0,0,0,0,0,0,0,3,3,0,0,0,0,0,0,0,0,0,0
207209,21000,210,0,-2,8,1,7,0,0,0,0,0,0,5,1,4,0,0,0,0,0,0,3,0,3,0,0,0,0,0,0,0,0,0
207236,21000,210,0,-2,9,4,5,2,1,1,0,0,0,0,0,0,1,1,0,0,0,0,6,2,4,0,0,0,0,0,0,0,0,0
207254,21000,210,0,-2,25,25,0,2,2,0,4,4,0,1,1,0,4,4,0,0,0,0,14,14,0,0,0,0,0,0,0,0,0,0
207263,21000,210,0,-2,14,6,8,1,0,1,2,0,2,1,1,0,0,0,0,0,0,0,10,5,5,0,0,0,0,0,0,0,0,0
207281,21000,210,0,-2,6,3,3,0,0,0,0,0,0,0,0,0,0,0,0,0,0,0,6,3,3,0,0,0,0,0,0,0,0,0
207290,21000,210,0,-2,5,2,3,0,0,0,0,0,0,1,1,0,0,0,0,0,0,0,3,1,2,1,0,1,0,0,0,0,0,0
207306,21000,210,0,-2,8,5,3,0,0,0,0,0,0,0,0,0,0,0,0,0,0,0,7,5,2,0,0,0,1,0,1,0,0,0
207315,21000,210,0,-2,25,10,15,1,1,0,2,0,2,1,0,1,1,0,1,0,0,0,18,8,10,2,1,1,0,0,0,0,0,0
207324,21000,210,0,-2,4,1,3,0,0,0,0,0,0,1,0,1,0,0,0,0,0,0,3,1,2,0,0,0,0,0,0,0,0,0
207342,21000,210,0,-2,30,18,12,0,0,0,2,1,1,0,0,0,1,1,0,0,0,0,16,7,9,1,1,0,0,0,0,10,8,2
207351,21000,210,0,-2,6,3,3,0,0,0,0,0,0,0,0,0,0,0,0,0,0,0,5,3,2,0,0,0,0,0,0,1,0,1
207388,21000,210,0,-2,139,63,76,1,1,0,11,7,4,4,4,0,8,3,5,0,0,0,71,21,50,5,1,4,1,0,1,38,26,12
207397,21000,210,0,-2,6,0,6,1,0,1,0,0,0,2,0,2,0,0,0,0,0,0,3,0,3,0,0,0,0,0,0,0,0,0
207403,21000,210,0,-2,7,5,2,0,0,0,1,0,1,0,0,0,0,0,0,0,0,0,6,5,1,0,0,0,0,0,0,0,0,0
207449,21000,210,0,-2,14,7,7,0,0,0,3,1,2,0,0,0,0,0,0,0,0,0,9,5,4,2,1,1,0,0,0,0,0,0
207458,21000,210,0,-2,26,13,13,0,0,0,2,2,0,1,0,1,0,0,0,0,0,0,21,10,11,0,0,0,0,0,0,2,1,1
207500,21000,210,0,-2,116,63,53,1,1,0,9,6,3,7,4,3,7,4,3,0,0,0,52,23,29,0,0,0,11,8,3,29,17,12
207564,21000,210,0,-2,8,6,2,0,0,0,0,0,0,1,1,0,0,0,0,0,0,0,6,4,2,1,1,0,0,0,0,0,0,0
207582,21000,210,0,-2,5,5,0,0,0,0,0,0,0,0,0,0,0,0,0,0,0,0,3,3,0,0,0,0,0,0,0,2,2,0
207661,21000,210,0,-2,11,3,8,2,1,1,2,0,2,0,0,0,0,0,0,0,0,0,6,2,4,0,0,0,1,0,1,0,0,0
207670,21000,210,0,-2,18,7,11,0,0,0,2,1,1,1,0,1,0,0,0,0,0,0,15,6,9,0,0,0,0,0,0,0,0,0
207722,21000,210,0,-2,3,1,2,1,1,0,0,0,0,0,0,0,0,0,0,0,0,0,2,0,2,0,0,0,0,0,0,0,0,0
207740,21000,210,0,-2,2,1,1,0,0,0,0,0,0,0,0,0,0,0,0,0,0,0,2,1,1,0,0,0,0,0,0,0,0,0
207847,21000,210,0,-2,11,6,5,0,0,0,0,0,0,0,0,0,0,0,0,0,0,0,9,6,3,0,0,0,0,0,0,2,0,2
207856,21000,210,0,-2,5,2,3,0,0,0,0,0,0,0,0,0,0,0,0,0,0,0,5,2,3,0,0,0,0,0,0,0,0,0
207865,21000,210,0,-2,9,3,6,0,0,0,0,0,0,0,0,0,0,0,0,0,0,0,9,3,6,0,0,0,0,0,0,0,0,0
207935,21000,210,0,-2,15,6,9,1,1,0,0,0,0,2,1,1,4,2,2,0,0,0,6,1,5,2,1,1,0,0,0,0,0,0
207962,21000,210,0,-2,4,4,0,1,1,0,0,0,0,0,0,0,0,0,0,0,0,0,2,2,0,0,0,0,1,1,0,0,0,0
207971,21000,210,0,-2,15,8,7,0,0,0,0,0,0,3,3,0,0,0,0,0,0,0,8,2,6,1,0,1,3,3,0,0,0,0
208035,21000,210,0,-2,5,0,5,0,0,0,0,0,0,0,0,0,2,0,2,0,0,0,3,0,3,0,0,0,0,0,0,0,0,0
208318,21000,210,0,-2,5,1,4,0,0,0,1,1,0,0,0,0,1,0,1,0,0,0,3,0,3,0,0,0,0,0,0,0,0,0
208390,21000,210,0,-2,11,7,4,0,0,0,0,0,0,0,0,0,2,1,1,0,0,0,6,4,2,0,0,0,2,1,1,1,1,0
208406,21000,210,0,-2,3,1,2,0,0,0,0,0,0,0,0,0,0,0,0,0,0,0,3,1,2,0,0,0,0,0,0,0,0,0
208415,21000,210,0,-2,2,1,1,0,0,0,0,0,0,0,0,0,1,0,1,0,0,0,1,1,0,0,0,0,0,0,0,0,0,0
208479,21000,210,0,-2,2,1,1,0,0,0,1,1,0,0,0,0,0,0,0,0,0,0,1,0,1,0,0,0,0,0,0,0,0,0
208512,21000,210,0,-2,4,2,2,0,0,0,0,0,0,0,0,0,0,0,0,0,0,0,0,0,0,4,2,2,0,0,0,0,0,0
208646,21000,210,0,-2,14,6,8,0,0,0,2,1,1,0,0,0,0,0,0,0,0,0,9,3,6,0,0,0,3,2,1,0,0,0
208822,21000,210,0,-2,29,12,17,0,0,0,1,1,0,2,1,1,1,1,0,0,0,0,22,6,16,1,1,0,2,2,0,0,0,0
209038,21000,210,0,-2,12,3,9,0,0,0,1,1,0,0,0,0,2,2,0,0,0,0,9,0,9,0,0,0,0,0,0,0,0,0
209056,21000,210,0,-2,4,1,3,0,0,0,0,0,0,1,0,1,0,0,0,0,0,0,2,1,1,1,0,1,0,0,0,0,0,0
209065,21000,210,0,-2,8,1,7,0,0,0,1,0,1,0,0,0,0,0,0,0,0,0,6,1,5,0,0,0,1,0,1,0,0,0
209074,21000,210,0,-2,7,1,6,0,0,0,0,0,0,0,0,0,2,0,2,0,0,0,0,0,0,1,0,1,3,1,2,1,0,1
209241,21000,210,0,-2,3,3,0,0,0,0,0,0,0,0,0,0,2,2,0,0,0,0,1,1,0,0,0,0,0,0,0,0,0,0
209250,21000,210,0,-2,4,2,2,0,0,0,1,1,0,1,1,0,0,0,0,0,0,0,2,0,2,0,0,0,0,0,0,0,0,0
209287,21000,210,0,-2,1,1,0,0,0,0,1,1,0,0,0,0,0,0,0,0,0,0,0,0,0,0,0,0,0,0,0,0,0,0
209409,21000,210,0,-2,3,2,1,0,0,0,0,0,0,0,0,0,1,1,0,0,0,0,2,1,1,0,0,0,0,0,0,0,0,0
209490,21000,210,0,-2,222,96,126,0,0,0,46,21,25,8,3,5,8,5,3,1,0,1,119,47,72,4,0,4,24,14,10,12,6,6
209506,21000,210,0,-2,20,12,8,0,0,0,3,1,2,0,0,0,0,0,0,0,0,0,14,8,6,0,0,0,0,0,0,3,3,0
209542,21000,210,0,-2,59,27,32,0,0,0,4,2,2,1,1,0,7,5,2,0,0,0,13,7,6,0,0,0,24,7,17,10,5,5
209551,21000,210,0,-2,26,11,15,0,0,0,1,0,1,3,1,2,0,0,0,0,0,0,13,4,9,1,0,1,3,2,1,5,4,1
209612,21000,210,0,-2,21,7,14,0,0,0,2,2,0,1,0,1,1,1,0,0,0,0,15,3,12,1,1,0,0,0,0,1,0,1
209746,21000,210,0,-2,12,4,8,0,0,0,1,0,1,1,1,0,2,1,1,0,0,0,6,1,5,0,0,0,2,1,1,0,0,0
209807,21000,210,0,-2,23,11,12,0,0,0,2,1,1,3,0,3,5,3,2,0,0,0,9,5,4,1,0,1,0,0,0,3,2,1
209825,21000,210,0,-2,25,8,17,0,0,0,0,0,0,1,0,1,2,2,0,0,0,0,12,3,9,0,0,0,5,0,5,5,3,2
209922,21000,210,0,-2,21,8,13,0,0,0,2,1,1,0,0,0,3,1,2,0,0,0,10,2,8,2,2,0,0,0,0,4,2,2
210146,21000,210,0,-2,7,6,1,0,0,0,1,0,1,0,0,0,0,0,0,0,0,0,6,6,0,0,0,0,0,0,0,0,0,0
210155,21000,210,0,-2,5,1,4,0,0,0,0,0,0,0,0,0,0,0,0,0,0,0,4,1,3,0,0,0,1,0,1,0,0,0
210234,21000,210,0,-2,5,1,4,0,0,0,0,0,0,0,0,0,1,0,1,0,0,0,3,1,2,0,0,0,1,0,1,0,0,0
210270,21000,210,0,-2,7,2,5,0,0,0,0,0,0,0,0,0,0,0,0,0,0,0,5,2,3,1,0,1,1,0,1,0,0,0
210304,21000,210,0,-2,4,3,1,0,0,0,0,0,0,1,1,0,0,0,0,0,0,0,2,1,1,0,0,0,1,1,0,0,0,0
210331,21000,210,0,-2,4,3,1,0,0,0,0,0,0,0,0,0,0,0,0,0,0,0,4,3,1,0,0,0,0,0,0,0,0,0
210368,21000,210,0,-2,2,1,1,0,0,0,0,0,0,0,0,0,0,0,0,0,0,0,2,1,1,0,0,0,0,0,0,0,0,0
210401,21000,210,0,-2,3,3,0,0,0,0,0,0,0,0,0,0,0,0,0,0,0,0,3,3,0,0,0,0,0,0,0,0,0,0
210429,21000,210,0,-2,5,3,2,0,0,0,0,0,0,0,0,0,0,0,0,0,0,0,3,1,2,1,1,0,0,0,0,1,1,0
210438,21000,210,0,-2,3,1,2,0,0,0,0,0,0,1,1,0,0,0,0,0,0,0,1,0,1,0,0,0,1,0,1,0,0,0
210492,21000,210,0,-2,1,1,0,0,0,0,0,0,0,0,0,0,0,0,0,0,0,0,1,1,0,0,0,0,0,0,0,0,0,0
210571,21000,210,0,-2,8,4,4,0,0,0,1,0,1,0,0,0,0,0,0,0,0,0,6,3,3,1,1,0,0,0,0,0,0,0
210599,21000,210,0,-2,9,5,4,0,0,0,0,0,0,3,0,3,1,0,1,0,0,0,2,2,0,1,1,0,2,2,0,0,0,0
210605,21000,210,0,-2,21,6,15,0,0,0,2,0,2,3,1,2,0,0,0,0,0,0,15,5,10,0,0,0,1,0,1,0,0,0
210669,21000,210,0,-2,9,5,4,0,0,0,2,0,2,1,0,1,2,2,0,0,0,0,3,3,0,1,0,1,0,0,0,0,0,0
210739,21000,210,0,-2,10,5,5,0,0,0,0,0,0,1,0,1,0,0,0,0,0,0,8,4,4,1,1,0,0,0,0,0,0,0
210775,21000,210,0,-2,13,3,10,0,0,0,0,0,0,1,0,1,0,0,0,0,0,0,11,3,8,1,0,1,0,0,0,0,0,0
210809,21000,210,0,-2,2,1,1,0,0,0,0,0,0,1,0,1,0,0,0,0,0,0,1,1,0,0,0,0,0,0,0,0,0,0
211079,21000,210,0,-2,8,3,5,0,0,0,1,1,0,0,0,0,0,0,0,0,0,0,7,2,5,0,0,0,0,0,0,0,0,0
211088,21000,210,0,-2,5,0,5,0,0,0,1,0,1,1,0,1,0,0,0,0,0,0,3,0,3,0,0,0,0,0,0,0,0,0
211158,21000,210,0,-2,4,1,3,0,0,0,0,0,0,0,0,0,0,0,0,0,0,0,4,1,3,0,0,0,0,0,0,0,0,0
211273,21000,210,0,-2,14,3,11,0,0,0,4,0,4,1,0,1,0,0,0,0,0,0,3,1,2,2,1,1,4,1,3,0,0,0
211291,21000,210,0,-2,24,9,15,0,0,0,5,1,4,1,0,1,0,0,0,0,0,0,13,6,7,0,0,0,1,0,1,4,2,2
211352,21000,210,0,-2,3,1,2,0,0,0,1,1,0,0,0,0,0,0,0,0,0,0,2,0,2,0,0,0,0,0,0,0,0,0
211361,21000,210,0,-2,1,0,1,0,0,0,0,0,0,0,0,0,0,0,0,0,0,0,1,0,1,0,0,0,0,0,0,0,0,0
211431,21000,210,0,-2,7,1,6,0,0,0,0,0,0,0,0,0,0,0,0,0,0,0,7,1,6,0,0,0,0,0,0,0,0,0
211440,21000,210,0,-2,186,133,53,0,0,0,17,13,4,12,5,7,8,7,1,0,0,0,46,28,18,5,5,0,6,4,2,92,71,21
211468,21000,210,0,-2,6,2,4,0,0,0,0,0,0,1,0,1,0,0,0,0,0,0,5,2,3,0,0,0,0,0,0,0,0,0
211477,21000,210,0,-2,7,2,5,0,0,0,0,0,0,2,0,2,1,0,1,0,0,0,4,2,2,0,0,0,0,0,0,0,0,0
211556,21000,210,0,-2,9,2,7,0,0,0,0,0,0,0,0,0,1,1,0,0,0,0,8,1,7,0,0,0,0,0,0,0,0,0
211583,21000,210,0,-2,4,2,2,0,0,0,1,0,1,1,1,0,0,0,0,0,0,0,2,1,1,0,0,0,0,0,0,0,0,0
211608,21000,210,0,-2,1,1,0,0,0,0,0,0,0,1,1,0,0,0,0,0,0,0,0,0,0,0,0,0,0,0,0,0,0,0
211927,21000,210,0,-2,1,0,1,0,0,0,0,0,0,0,0,0,0,0,0,0,0,0,1,0,1,0,0,0,0,0,0,0,0,0
211981,21000,210,0,-2,1,0,1,0,0,0,0,0,0,0,0,0,0,0,0,0,0,0,1,0,1,0,0,0,0,0,0,0,0,0
212009,21000,210,0,-2,15,7,8,0,0,0,1,1,0,1,0,1,3,1,2,0,0,0,4,1,3,0,0,0,0,0,0,6,4,2
212045,21000,210,0,-2,1,1,0,0,0,0,0,0,0,0,0,0,0,0,0,0,0,0,1,1,0,0,0,0,0,0,0,0,0,0
212054,21000,210,0,-2,52,23,29,0,0,0,3,0,3,7,4,3,2,1,1,0,0,0,25,11,14,3,1,2,0,0,0,12,6,6
212106,21000,210,0,-2,27,10,17,0,0,0,2,0,2,1,1,0,0,0,0,0,0,0,22,8,14,0,0,0,0,0,0,2,1,1
212115,21000,210,0,-2,3,3,0,0,0,0,0,0,0,0,0,0,0,0,0,0,0,0,2,2,0,0,0,0,0,0,0,1,1,0
212133,21000,210,0,-2,23,9,14,0,0,0,1,1,0,3,2,1,0,0,0,0,0,0,17,6,11,0,0,0,2,0,2,0,0,0
212160,21000,210,0,-2,1,0,1,0,0,0,0,0,0,0,0,0,0,0,0,0,0,0,1,0,1,0,0,0,0,0,0,0,0,0
212197,21000,210,0,-2,6,3,3,0,0,0,0,0,0,0,0,0,0,0,0,0,0,0,1,0,1,0,0,0,5,3,2,0,0,0
212434,21000,210,0,-2,6,5,1,0,0,0,0,0,0,0,0,0,0,0,0,0,0,0,6,5,1,0,0,0,0,0,0,0,0,0
212577,21000,210,0,-2,10,4,6,0,0,0,4,1,3,1,1,0,0,0,0,0,0,0,3,1,2,0,0,0,0,0,0,2,1,1
212601,21000,210,0,-2,31,11,20,0,0,0,5,3,2,2,1,1,0,0,0,0,0,0,23,6,17,0,0,0,1,1,0,0,0,0
212656,21000,210,0,-2,3,1,2,0,0,0,0,0,0,1,0,1,0,0,0,0,0,0,2,1,1,0,0,0,0,0,0,0,0,0
212674,21000,210,0,-2,16,5,11,0,0,0,1,0,1,0,0,0,0,0,0,0,0,0,8,2,6,0,0,0,0,0,0,7,3,4
212832,21000,210,0,-2,3,1,2,0,0,0,0,0,0,0,0,0,0,0,0,0,0,0,3,1,2,0,0,0,0,0,0,0,0,0
212869,21000,210,0,-2,4,1,3,0,0,0,0,0,0,0,0,0,0,0,0,0,0,0,4,1,3,0,0,0,0,0,0,0,0,0
212878,21000,210,0,-2,2,1,1,0,0,0,0,0,0,1,1,0,0,0,0,0,0,0,1,0,1,0,0,0,0,0,0,0,0,0
212911,21000,210,0,-2,21,10,11,0,0,0,3,1,2,1,0,1,1,0,1,0,0,0,9,4,5,0,0,0,1,0,1,6,5,1
212975,21000,210,0,-2,2,1,1,0,0,0,0,0,0,0,0,0,0,0,0,0,0,0,2,1,1,0,0,0,0,0,0,0,0,0
212984,21000,210,0,-2,8,5,3,0,0,0,1,1,0,1,1,0,0,0,0,0,0,0,6,3,3,0,0,0,0,0,0,0,0,0
213011,21000,210,0,-2,8,3,5,0,0,0,1,1,0,0,0,0,0,0,0,0,0,0,5,1,4,1,1,0,1,0,1,0,0,0
213181,21000,210,0,-2,8,0,8,0,0,0,0,0,0,0,0,0,0,0,0,0,0,0,8,0,8,0,0,0,0,0,0,0,0,0
213233,21000,210,0,-2,4,4,0,0,0,0,0,0,0,0,0,0,0,0,0,0,0,0,4,4,0,0,0,0,0,0,0,0,0,0
213251,21000,210,0,-2,5,2,3,0,0,0,1,1,0,1,0,1,0,0,0,0,0,0,3,1,2,0,0,0,0,0,0,0,0,0
213303,21000,210,0,-2,8,3,5,0,0,0,0,0,0,0,0,0,0,0,0,0,0,0,8,3,5,0,0,0,0,0,0,0,0,0
213321,21000,210,0,-2,4,3,1,0,0,0,0,0,0,0,0,0,0,0,0,0,0,0,4,3,1,0,0,0,0,0,0,0,0,0
213358,21000,210,0,-2,1,0,1,0,0,0,0,0,0,0,0,0,0,0,0,0,0,0,1,0,1,0,0,0,0,0,0,0,0,0
213367,21000,210,0,-2,11,5,6,0,0,0,0,0,0,2,1,1,0,0,0,0,0,0,9,4,5,0,0,0,0,0,0,0,0,0
213385,21000,210,0,-2,19,12,7,0,0,0,0,0,0,1,1,0,0,0,0,0,0,0,14,7,7,0,0,0,0,0,0,4,4,0
213400,21000,210,0,-2,9,5,4,0,0,0,0,0,0,0,0,0,1,1,0,0,0,0,8,4,4,0,0,0,0,0,0,0,0,0
213507,21000,210,0,-2,3,2,1,0,0,0,0,0,0,0,0,0,0,0,0,0,0,0,2,1,1,0,0,0,0,0,0,1,1,0
213525,21000,210,0,-2,3,1,2,0,0,0,1,1,0,0,0,0,0,0,0,0,0,0,2,0,2,0,0,0,0,0,0,0,0,0
213534,21000,210,0,-2,1,0,1,0,0,0,0,0,0,0,0,0,0,0,0,0,0,0,1,0,1,0,0,0,0,0,0,0,0,0
213543,21000,210,0,-2,40,25,15,0,0,0,5,1,4,2,1,1,0,0,0,0,0,0,14,10,4,0,0,0,11,8,3,8,5,3
213570,21000,210,0,-2,2,0,2,0,0,0,0,0,0,1,0,1,0,0,0,0,0,0,1,0,1,0,0,0,0,0,0,0,0,0
213589,21000,210,0,-2,2,2,0,0,0,0,0,0,0,0,0,0,0,0,0,0,0,0,2,2,0,0,0,0,0,0,0,0,0,0
213598,21000,210,0,-2,7,1,6,0,0,0,0,0,0,5,1,4,1,0,1,0,0,0,1,0,1,0,0,0,0,0,0,0,0,0
213631,21000,210,0,-2,2,0,2,0,0,0,1,0,1,1,0,1,0,0,0,0,0,0,0,0,0,0,0,0,0,0,0,0,0,0
213659,21000,210,0,-2,3,1,2,0,0,0,0,0,0,0,0,0,0,0,0,0,0,0,3,1,2,0,0,0,0,0,0,0,0,0
213668,21000,210,0,-2,8,2,6,0,0,0,0,0,0,0,0,0,3,1,2,0,0,0,4,0,4,0,0,0,1,1,0,0,0,0
213826,21000,210,0,-2,21,7,14,0,0,0,3,1,2,1,0,1,3,3,0,0,0,0,14,3,11,0,0,0,0,0,0,0,0,0
213987,21000,210,0,-2,14,4,10,0,0,0,2,0,2,0,0,0,0,0,0,0,0,0,12,4,8,0,0,0,0,0,0,0,0,0
213996,21000,210,0,-2,9,4,5,0,0,0,0,0,0,1,0,1,1,1,0,0,0,0,7,3,4,0,0,0,0,0,0,0,0,0
214041,21000,210,0,-2,6,1,5,0,0,0,0,0,0,0,0,0,0,0,0,0,0,0,5,0,5,0,0,0,1,1,0,0,0,0
214069,21000,210,0,-2,7,2,5,0,0,0,2,1,1,0,0,0,0,0,0,0,0,0,5,1,4,0,0,0,0,0,0,0,0,0
214111,21000,210,0,-2,2,0,2,0,0,0,0,0,0,0,0,0,0,0,0,0,0,0,1,0,1,0,0,0,1,0,1,0,0,0
214148,21000,210,0,-2,1,1,0,0,0,0,0,0,0,0,0,0,1,1,0,0,0,0,0,0,0,0,0,0,0,0,0,0,0,0
214157,21000,210,0,-2,4,2,2,0,0,0,1,0,1,1,1,0,0,0,0,0,0,0,1,1,0,0,0,0,0,0,0,1,0,1
214166,21000,210,0,-2,8,2,6,0,0,0,0,0,0,0,0,0,0,0,0,0,0,0,8,2,6,0,0,0,0,0,0,0,0,0
214175,21000,210,0,-2,25,11,14,0,0,0,3,0,3,5,3,2,4,1,3,0,0,0,10,4,6,0,0,0,0,0,0,3,3,0
214272,21000,210,0,-2,6,0,6,0,0,0,0,0,0,2,0,2,0,0,0,0,0,0,4,0,4,0,0,0,0,0,0,0,0,0
214290,21000,210,0,-2,10,9,1,0,0,0,0,0,0,0,0,0,0,0,0,0,0,0,10,9,1,0,0,0,0,0,0,0,0,0
214379,21000,210,0,-2,2,2,0,0,0,0,1,1,0,0,0,0,0,0,0,0,0,0,1,1,0,0,0,0,0,0,0,0,0,0
214564,21000,210,0,-2,13,4,9,0,0,0,4,2,2,1,0,1,0,0,0,0,0,0,7,2,5,1,0,1,0,0,0,0,0,0
214582,21000,210,0,-2,2,0,2,0,0,0,0,0,0,0,0,0,0,0,0,0,0,0,2,0,2,0,0,0,0,0,0,0,0,0
214892,21000,210,0,-2,11,4,7,0,0,0,0,0,0,0,0,0,0,0,0,0,0,0,11,4,7,0,0,0,0,0,0,0,0,0
214944,21000,210,0,-2,9,8,1,0,0,0,0,0,0,0,0,0,1,1,0,0,0,0,8,7,1,0,0,0,0,0,0,0,0,0
214971,21000,210,0,-2,3,2,1,0,0,0,0,0,0,2,2,0,0,0,0,0,0,0,0,0,0,1,0,1,0,0,0,0,0,0
215053,21000,210,0,-2,2,1,1,0,0,0,0,0,0,0,0,0,0,0,0,0,0,0,2,1,1,0,0,0,0,0,0,0,0,0
215062,21000,210,0,-2,170,71,99,0,0,0,33,16,17,17,7,10,11,3,8,0,0,0,77,28,49,5,2,3,16,9,7,11,6,5
215105,21000,210,0,-2,1,0,1,0,0,0,0,0,0,0,0,0,0,0,0,0,0,0,1,0,1,0,0,0,0,0,0,0,0,0
215114,21000,210,0,-2,3,2,1,0,0,0,0,0,0,0,0,0,0,0,0,0,0,0,3,2,1,0,0,0,0,0,0,0,0,0
215123,21000,210,0,-2,14,7,7,1,1,0,3,0,3,1,1,0,0,0,0,0,0,0,8,5,3,1,0,1,0,0,0,0,0,0
215132,21000,210,0,-2,8,5,3,0,0,0,2,1,1,0,0,0,0,0,0,0,0,0,6,4,2,0,0,0,0,0,0,0,0,0
215239,21000,210,0,-2,12,6,6,0,0,0,2,1,1,4,2,2,2,1,1,0,0,0,4,2,2,0,0,0,0,0,0,0,0,0
215266,21000,210,0,-2,7,6,1,0,0,0,0,0,0,2,2,0,0,0,0,0,0,0,1,1,0,0,0,0,1,0,1,3,3,0
215275,21000,210,0,-2,5,1,4,0,0,0,0,0,0,0,0,0,0,0,0,0,0,0,3,0,3,0,0,0,2,1,1,0,0,0
215284,21000,210,0,-2,4,1,3,0,0,0,0,0,0,0,0,0,0,0,0,0,0,0,3,1,2,0,0,0,0,0,0,1,0,1
215293,21000,210,0,-2,233,107,126,0,0,0,32,16,16,13,2,11,11,5,6,0,0,0,113,55,58,4,1,3,32,11,21,28,17,11
215381,21000,210,0,-2,11,9,2,0,0,0,0,0,0,0,0,0,0,0,0,0,0,0,11,9,2,0,0,0,0,0,0,0,0,0
215415,21000,210,0,-2,5,3,2,0,0,0,0,0,0,0,0,0,0,0,0,0,0,0,5,3,2,0,0,0,0,0,0,0,0,0
215424,21000,210,0,-2,1,0,1,0,0,0,0,0,0,1,0,1,0,0,0,0,0,0,0,0,0,0,0,0,0,0,0,0,0,0
215442,21000,210,0,-2,6,3,3,0,0,0,1,0,1,1,1,0,0,0,0,0,0,0,4,2,2,0,0,0,0,0,0,0,0,0
215585,21000,210,0,-2,4,0,4,0,0,0,0,0,0,0,0,0,0,0,0,0,0,0,4,0,4,0,0,0,0,0,0,0,0,0
215655,21000,210,0,-2,6,3,3,0,0,0,0,0,0,0,0,0,1,0,1,0,0,0,1,0,1,0,0,0,0,0,0,4,3,1
215682,21000,210,0,-2,6,6,0,0,0,0,0,0,0,0,0,0,0,0,0,0,0,0,6,6,0,0,0,0,0,0,0,0,0,0
215691,21000,210,0,-2,1,1,0,0,0,0,1,1,0,0,0,0,0,0,0,0,0,0,0,0,0,0,0,0,0,0,0,0,0,0
215743,21000,210,0,-2,16,4,12,0,0,0,0,0,0,0,0,0,0,0,0,0,0,0,16,4,12,0,0,0,0,0,0,0,0,0
215770,21000,210,0,-2,7,2,5,0,0,0,1,0,1,2,0,2,1,0,1,0,0,0,3,2,1,0,0,0,0,0,0,0,0,0
215798,21000,210,0,-2,3,1,2,0,0,0,0,0,0,0,0,0,0,0,0,0,0,0,1,1,0,0,0,0,2,0,2,0,0,0
215929,21000,210,0,-2,14,7,7,0,0,0,0,0,0,2,0,2,0,0,0,0,0,0,5,3,2,0,0,0,2,1,1,5,3,2
215947,21000,210,0,-2,11,3,8,0,0,0,0,0,0,1,0,1,0,0,0,0,0,0,9,3,6,0,0,0,0,0,0,1,0,1
215992,21000,210,0,-2,2,0,2,0,0,0,0,0,0,0,0,0,0,0,0,0,0,0,2,0,2,0,0,0,0,0,0,0,0,0
216010,21000,210,0,-2,1,1,0,0,0,0,0,0,0,1,1,0,0,0,0,0,0,0,0,0,0,0,0,0,0,0,0,0,0,0
216038,21000,210,0,-2,6,3,3,0,0,0,1,1,0,1,0,1,0,0,0,0,0,0,4,2,2,0,0,0,0,0,0,0,0,0
216278,21000,210,0,-2,12,9,3,0,0,0,1,1,0,1,0,1,0,0,0,0,0,0,9,8,1,0,0,0,0,0,0,1,0,1
216287,21000,210,0,-2,33,13,20,3,1,2,3,1,2,2,0,2,2,1,1,0,0,0,15,8,7,0,0,0,2,1,1,6,1,5
216296,21000,210,0,-2,8,7,1,0,0,0,2,2,0,0,0,0,0,0,0,0,0,0,6,5,1,0,0,0,0,0,0,0,0,0
216339,21000,210,0,-2,168,70,98,0,0,0,24,12,12,25,9,16,3,1,2,0,0,0,79,34,45,1,0,1,20,8,12,16,6,10
216357,21000,210,0,-2,4,3,1,0,0,0,0,0,0,0,0,0,0,0,0,0,0,0,4,3,1,0,0,0,0,0,0,0,0,0
216366,21000,210,0,-2,20,5,15,0,0,0,1,0,1,1,0,1,0,0,0,0,0,0,18,5,13,0,0,0,0,0,0,0,0,0
216436,21000,210,0,-2,7,7,0,0,0,0,0,0,0,1,1,0,0,0,0,0,0,0,6,6,0,0,0,0,0,0,0,0,0,0
216445,21000,210,0,-2,3,2,1,0,0,0,0,0,0,0,0,0,0,0,0,0,0,0,3,2,1,0,0,0,0,0,0,0,0,0
216454,21000,210,0,-2,2,2,0,0,0,0,0,0,0,0,0,0,0,0,0,0,0,0,2,2,0,0,0,0,0,0,0,0,0,0
216463,21000,210,0,-2,2,2,0,0,0,0,0,0,0,0,0,0,0,0,0,0,0,0,2,2,0,0,0,0,0,0,0,0,0,0
216524,21000,210,0,-2,7,4,3,0,0,0,0,0,0,0,0,0,0,0,0,0,0,0,6,3,3,0,0,0,0,0,0,1,1,0
216542,21000,210,0,-2,2,0,2,0,0,0,0,0,0,0,0,0,0,0,0,0,0,0,2,0,2,0,0,0,0,0,0,0,0,0
216597,21000,210,0,-2,56,26,30,1,0,1,5,4,1,4,2,2,3,3,0,0,0,0,34,12,22,2,0,2,0,0,0,7,5,2
216667,21000,210,0,-2,5,1,4,0,0,0,1,0,1,0,0,0,0,0,0,0,0,0,4,1,3,0,0,0,0,0,0,0,0,0
216694,21000,210,0,-2,8,2,6,0,0,0,0,0,0,0,0,0,1,0,1,0,0,0,7,2,5,0,0,0,0,0,0,0,0,0
216764,21000,210,0,-2,25,11,14,0,0,0,4,4,0,5,2,3,0,0,0,0,0,0,13,3,10,1,0,1,0,0,0,2,2,0
216782,21000,210,0,-2,15,3,12,0,0,0,0,0,0,0,0,0,0,0,0,0,0,0,14,3,11,1,0,1,0,0,0,0,0,0
216807,21000,210,0,-2,5,3,2,0,0,0,0,0,0,0,0,0,0,0,0,0,0,0,5,3,2,0,0,0,0,0,0,0,0,0
216816,21000,210,0,-2,1,1,0,0,0,0,0,0,0,0,0,0,1,1,0,0,0,0,0,0,0,0,0,0,0,0,0,0,0,0
216825,21000,210,0,-2,3,2,1,0,0,0,0,0,0,0,0,0,0,0,0,0,0,0,3,2,1,0,0,0,0,0,0,0,0,0
216852,21000,210,0,-2,31,10,21,0,0,0,5,2,3,3,0,3,2,1,1,0,0,0,13,2,11,0,0,0,0,0,0,8,5,3
216931,21000,210,0,-2,7,2,5,1,0,1,1,0,1,1,1,0,0,0,0,0,0,0,3,1,2,1,0,1,0,0,0,0,0,0
216940,21000,210,0,-2,1,1,0,0,0,0,0,0,0,0,0,0,0,0,0,0,0,0,1,1,0,0,0,0,0,0,0,0,0,0
217013,21000,210,0,-2,4,2,2,0,0,0,0,0,0,0,0,0,0,0,0,0,0,0,3,1,2,0,0,0,1,1,0,0,0,0
217059,21000,210,0,-2,6,3,3,0,0,0,2,1,1,1,0,1,0,0,0,0,0,0,2,1,1,0,0,0,0,0,0,1,1,0
217077,21000,210,0,-2,2,0,2,0,0,0,0,0,0,0,0,0,0,0,0,0,0,0,2,0,2,0,0,0,0,0,0,0,0,0
217156,21000,210,0,-2,95,38,57,0,0,0,9,3,6,11,3,8,6,4,2,0,0,0,43,16,27,2,2,0,5,2,3,19,8,11
217165,21000,210,0,-2,2,0,2,0,0,0,1,0,1,0,0,0,0,0,0,0,0,0,0,0,0,0,0,0,0,0,0,1,0,1
217235,21000,210,0,-2,9,2,7,0,0,0,0,0,0,2,1,1,0,0,0,0,0,0,4,1,3,0,0,0,2,0,2,1,0,1
217402,21000,210,0,-2,39,18,21,0,0,0,1,1,0,3,1,2,0,0,0,0,0,0,30,13,17,2,1,1,0,0,0,3,2,1
217420,21000,210,0,-2,2,0,2,0,0,0,0,0,0,1,0,1,0,0,0,0,0,0,1,0,1,0,0,0,0,0,0,0,0,0
217475,21000,210,0,-2,14,4,10,0,0,0,1,0,1,1,1,0,1,1,0,0,0,0,11,2,9,0,0,0,0,0,0,0,0,0
217484,21000,210,0,-2,62,22,40,0,0,0,5,1,4,6,0,6,1,1,0,0,0,0,45,18,27,0,0,0,0,0,0,5,2,3
217493,21000,210,0,-2,19,5,14,0,0,0,1,0,1,5,1,4,0,0,0,0,0,0,3,2,1,0,0,0,3,0,3,7,2,5
217518,21000,210,0,-2,7,2,5,0,0,0,0,0,0,1,0,1,0,0,0,0,0,0,2,1,1,0,0,0,0,0,0,4,1,3
217536,21000,210,0,-2,7,3,4,0,0,0,1,1,0,0,0,0,0,0,0,0,0,0,6,2,4,0,0,0,0,0,0,0,0,0
217615,21000,210,0,-2,4,2,2,0,0,0,0,0,0,0,0,0,0,0,0,0,0,0,4,2,2,0,0,0,0,0,0,0,0,0
217624,21000,210,0,-2,16,9,7,0,0,0,0,0,0,12,6,6,0,0,0,0,0,0,4,3,1,0,0,0,0,0,0,0,0,0
217633,21000,210,0,-2,18,9,9,0,0,0,1,0,1,1,0,1,1,0,1,0,0,0,15,9,6,0,0,0,0,0,0,0,0,0
217688,21000,210,0,-2,32,12,20,1,0,1,0,0,0,4,3,1,1,0,1,0,0,0,24,8,16,2,1,1,0,0,0,0,0,0
217712,21000,210,0,-2,2,2,0,0,0,0,0,0,0,0,0,0,0,0,0,0,0,0,2,2,0,0,0,0,0,0,0,0,0,0
217721,21000,210,0,-2,10,7,3,0,0,0,1,1,0,8,6,2,1,0,1,0,0,0,0,0,0,0,0,0,0,0,0,0,0,0
217749,21000,210,0,-2,10,6,4,0,0,0,0,0,0,0,0,0,0,0,0,0,0,0,10,6,4,0,0,0,0,0,0,0,0,0
217776,21000,210,0,-2,4,2,2,0,0,0,0,0,0,0,0,0,0,0,0,0,0,0,3,2,1,1,0,1,0,0,0,0,0,0
217819,21000,210,0,-2,33,18,15,0,0,0,0,0,0,4,2,2,4,3,1,1,0,1,16,8,8,0,0,0,0,0,0,8,5,3
217837,21000,210,0,-2,7,0,7,0,0,0,0,0,0,4,0,4,0,0,0,0,0,0,3,0,3,0,0,0,0,0,0,0,0,0
217864,21000,210,0,-2,15,8,7,0,0,0,0,0,0,0,0,0,2,0,2,0,0,0,2,1,1,1,0,1,9,6,3,1,1,0
217873,21000,210,0,-2,12,5,7,0,0,0,1,1,0,8,2,6,1,1,0,0,0,0,2,1,1,0,0,0,0,0,0,0,0,0
217882,21000,210,0,-2,61,34,27,0,0,0,5,3,2,0,0,0,0,0,0,0,0,0,47,27,20,0,0,0,0,0,0,9,4,5
217907,21000,210,0,-2,5,2,3,0,0,0,0,0,0,0,0,0,0,0,0,0,0,0,5,2,3,0,0,0,0,0,0,0,0,0
217925,21000,210,0,-2,5,3,2,0,0,0,0,0,0,0,0,0,0,0,0,0,0,0,5,3,2,0,0,0,0,0,0,0,0,0
217934,21000,210,0,-2,7,2,5,0,0,0,0,0,0,1,0,1,0,0,0,0,0,0,6,2,4,0,0,0,0,0,0,0,0,0
217961,21000,210,0,-2,4,0,4,0,0,0,0,0,0,0,0,0,1,0,1,0,0,0,3,0,3,0,0,0,0,0,0,0,0,0
217998,21000,210,0,-2,4,2,2,0,0,0,0,0,0,0,0,0,0,0,0,0,0,0,4,2,2,0,0,0,0,0,0,0,0,0
218025,21000,210,0,-2,6,2,4,0,0,0,0,0,0,2,1,1,0,0,0,0,0,0,4,1,3,0,0,0,0,0,0,0,0,0
218061,21000,210,0,-2,5,4,1,0,0,0,0,0,0,0,0,0,0,0,0,0,0,0,5,4,1,0,0,0,0,0,0,0,0,0
218070,21000,210,0,-2,14,4,10,0,0,0,2,1,1,4,1,3,0,0,0,0,0,0,7,2,5,1,0,1,0,0,0,0,0,0
218113,21000,210,0,-2,29,7,22,0,0,0,1,0,1,5,1,4,0,0,0,0,0,0,23,6,17,0,0,0,0,0,0,0,0,0
218140,21000,210,0,-2,15,4,11,0,0,0,0,0,0,1,0,1,0,0,0,0,0,0,14,4,10,0,0,0,0,0,0,0,0,0
218229,21000,210,0,-2,31,6,25,0,0,0,0,0,0,5,0,5,1,1,0,0,0,0,23,5,18,1,0,1,1,0,1,0,0,0
218238,21000,210,0,-2,7,2,5,0,0,0,0,0,0,2,0,2,0,0,0,0,0,0,5,2,3,0,0,0,0,0,0,0,0,0
218335,21000,210,0,-2,4,1,3,0,0,0,0,0,0,0,0,0,0,0,0,0,0,0,4,1,3,0,0,0,0,0,0,0,0,0
218353,21000,210,0,-2,12,3,9,0,0,0,1,0,1,2,1,1,2,1,1,0,0,0,7,1,6,0,0,0,0,0,0,0,0,0
218399,21000,210,0,-2,2,1,1,0,0,0,0,0,0,2,1,1,0,0,0,0,0,0,0,0,0,0,0,0,0,0,0,0,0,0
218414,21000,210,0,-2,5,4,1,0,0,0,0,0,0,4,3,1,0,0,0,0,0,0,1,1,0,0,0,0,0,0,0,0,0,0
218441,21000,210,0,-2,14,9,5,0,0,0,0,0,0,1,1,0,0,0,0,0,0,0,13,8,5,0,0,0,0,0,0,0,0,0
218487,21000,210,0,-2,8,3,5,0,0,0,0,0,0,2,0,2,0,0,0,0,0,0,6,3,3,0,0,0,0,0,0,0,0,0
218520,21000,210,0,-2,15,6,9,0,0,0,0,0,0,5,2,3,1,0,1,0,0,0,9,4,5,0,0,0,0,0,0,0,0,0
218539,21000,210,0,-2,10,3,7,0,0,0,2,1,1,2,0,2,0,0,0,0,0,0,6,2,4,0,0,0,0,0,0,0,0,0
218645,21000,210,0,-2,9,3,6,0,0,0,1,0,1,0,0,0,0,0,0,0,0,0,8,3,5,0,0,0,0,0,0,0,0,0
218654,21000,210,0,-2,1,1,0,0,0,0,0,0,0,0,0,0,0,0,0,0,0,0,1,1,0,0,0,0,0,0,0,0,0,0
218663,21000,210,0,-2,70,29,41,0,0,0,4,3,1,11,5,6,2,0,2,0,0,0,41,14,27,5,3,2,1,0,1,6,4,2
218681,21000,210,0,-2,1,0,1,0,0,0,0,0,0,0,0,0,0,0,0,0,0,0,1,0,1,0,0,0,0,0,0,0,0,0
218690,21000,210,0,-2,6,2,4,0,0,0,1,0,1,0,0,0,1,0,1,0,0,0,4,2,2,0,0,0,0,0,0,0,0,0
218706,21000,210,0,-2,1,0,1,0,0,0,0,0,0,0,0,0,0,0,0,0,0,0,1,0,1,0,0,0,0,0,0,0,0,0
218724,21000,210,0,-2,28,16,12,0,0,0,3,3,0,3,2,1,1,0,1,0,0,0,19,10,9,1,1,0,1,0,1,0,0,0
218733,21000,210,0,-2,3,3,0,0,0,0,0,0,0,3,3,0,0,0,0,0,0,0,0,0,0,0,0,0,0,0,0,0,0,0
218742,21000,210,0,-2,13,2,11,0,0,0,0,0,0,2,0,2,0,0,0,0,0,0,10,2,8,1,0,1,0,0,0,0,0,0
218751,21000,210,0,-2,4,2,2,0,0,0,0,0,0,0,0,0,0,0,0,0,0,0,3,1,2,1,1,0,0,0,0,0,0,0
218821,21000,210,0,-2,4,1,3,0,0,0,0,0,0,1,1,0,0,0,0,0,0,0,3,0,3,0,0,0,0,0,0,0,0,0
218830,21000,210,0,-2,16,4,12,0,0,0,1,1,0,1,0,1,1,0,1,0,0,0,13,3,10,0,0,0,0,0,0,0,0,0
218858,21000,210,0,-2,7,3,4,0,0,0,0,0,0,2,1,1,0,0,0,0,0,0,5,2,3,0,0,0,0,0,0,0,0,0
218885,21000,210,0,-2,11,5,6,0,0,0,0,0,0,3,1,2,1,0,1,0,0,0,7,4,3,0,0,0,0,0,0,0,0,0
218894,21000,210,0,-2,16,6,10,0,0,0,1,0,1,2,1,1,0,0,0,0,0,0,13,5,8,0,0,0,0,0,0,0,0,0
218919,21000,210,0,-2,4,3,1,0,0,0,0,0,0,4,3,1,0,0,0,0,0,0,0,0,0,0,0,0,0,0,0,0,0,0
218955,21000,210,0,-2,6,3,3,0,0,0,0,0,0,2,1,1,0,0,0,0,0,0,4,2,2,0,0,0,0,0,0,0,0,0
218964,21000,210,0,-2,3,1,2,0,0,0,0,0,0,0,0,0,0,0,0,0,0,0,3,1,2,0,0,0,0,0,0,0,0,0
218973,21000,210,0,-2,11,5,6,0,0,0,3,1,2,1,0,1,0,0,0,0,0,0,6,4,2,0,0,0,1,0,1,0,0,0
218991,21000,210,0,-2,18,9,9,0,0,0,0,0,0,3,1,2,0,0,0,0,0,0,15,8,7,0,0,0,0,0,0,0,0,0
219000,21000,210,0,-2,8,4,4,0,0,0,2,2,0,1,0,1,1,1,0,0,0,0,3,0,3,1,1,0,0,0,0,0,0,0
219046,21000,210,0,-2,4,4,0,0,0,0,0,0,0,0,0,0,0,0,0,0,0,0,4,4,0,0,0,0,0,0,0,0,0,0
219082,21000,210,0,-2,9,7,2,0,0,0,1,1,0,0,0,0,0,0,0,0,0,0,7,6,1,0,0,0,0,0,0,1,0,1
219091,21000,210,0,-2,7,3,4,0,0,0,0,0,0,0,0,0,0,0,0,0,0,0,7,3,4,0,0,0,0,0,0,0,0,0
219143,21000,210,0,-2,16,11,5,0,0,0,0,0,0,0,0,0,0,0,0,0,0,0,16,11,5,0,0,0,0,0,0,0,0,0
219189,21000,210,0,-2,7,3,4,0,0,0,0,0,0,0,0,0,0,0,0,0,0,0,7,3,4,0,0,0,0,0,0,0,0,0
219198,21000,210,0,-2,4,1,3,0,0,0,0,0,0,0,0,0,0,0,0,0,0,0,4,1,3,0,0,0,0,0,0,0,0,0
219259,21000,210,0,-2,9,2,7,0,0,0,0,0,0,1,0,1,0,0,0,0,0,0,6,2,4,0,0,0,0,0,0,2,0,2
219277,21000,210,0,-2,7,3,4,3,2,1,0,0,0,0,0,0,0,0,0,0,0,0,4,1,3,0,0,0,0,0,0,0,0,0
219295,21000,210,0,-2,4,0,4,0,0,0,0,0,0,0,0,0,0,0,0,0,0,0,4,0,4,0,0,0,0,0,0,0,0,0
219347,21000,210,0,-2,15,13,2,0,0,0,1,1,0,0,0,0,0,0,0,0,0,0,9,8,1,0,0,0,0,0,0,5,4,1
219356,21000,210,0,-2,32,19,13,1,0,1,4,4,0,0,0,0,0,0,0,0,0,0,18,8,10,0,0,0,0,0,0,9,7,2
219374,21000,210,0,-2,3,2,1,2,2,0,0,0,0,0,0,0,0,0,0,0,0,0,1,0,1,0,0,0,0,0,0,0,0,0
219383,21000,210,0,-2,2,2,0,0,0,0,0,0,0,0,0,0,0,0,0,0,0,0,2,2,0,0,0,0,0,0,0,0,0,0
219408,21000,210,0,-2,1,1,0,0,0,0,0,0,0,0,0,0,0,0,0,0,0,0,1,1,0,0,0,0,0,0,0,0,0,0
219426,21000,210,0,-2,18,5,13,0,0,0,0,0,0,0,0,0,0,0,0,0,0,0,18,5,13,0,0,0,0,0,0,0,0,0
219471,21000,210,0,-2,33,16,17,0,0,0,3,2,1,1,0,1,3,2,1,0,0,0,23,11,12,0,0,0,0,0,0,3,1,2
219480,21000,210,0,-2,12,7,5,0,0,0,0,0,0,0,0,0,0,0,0,0,0,0,9,5,4,2,2,0,1,0,1,0,0,0
219505,21000,210,0,-2,1,0,1,0,0,0,0,0,0,1,0,1,0,0,0,0,0,0,0,0,0,0,0,0,0,0,0,0,0,0
219602,21000,210,0,-2,24,9,15,0,0,0,0,0,0,4,1,3,0,0,0,0,0,0,16,6,10,1,0,1,2,1,1,1,1,0
219639,21000,210,0,-2,7,2,5,0,0,0,0,0,0,3,0,3,0,0,0,0,0,0,4,2,2,0,0,0,0,0,0,0,0,0
219709,21000,210,0,-2,39,17,22,0,0,0,0,0,0,10,4,6,0,0,0,0,0,0,25,13,12,0,0,0,2,0,2,2,0,2
219718,21000,210,0,-2,4,1,3,0,0,0,0,0,0,0,0,0,0,0,0,0,0,0,4,1,3,0,0,0,0,0,0,0,0,0
219790,21000,210,0,-2,6,4,2,0,0,0,0,0,0,0,0,0,0,0,0,0,0,0,6,4,2,0,0,0,0,0,0,0,0,0
219806,21000,210,0,-2,5,2,3,0,0,0,0,0,0,0,0,0,0,0,0,0,0,0,5,2,3,0,0,0,0,0,0,0,0,0
219824,21000,210,0,-2,32,12,20,1,1,0,1,0,1,1,0,1,1,1,0,0,0,0,26,9,17,2,1,1,0,0,0,0,0,0
219833,21000,210,0,-2,11,3,8,0,0,0,0,0,0,1,0,1,0,0,0,0,0,0,10,3,7,0,0,0,0,0,0,0,0,0
219879,21000,210,0,-2,7,3,4,0,0,0,0,0,0,0,0,0,0,0,0,0,0,0,7,3,4,0,0,0,0,0,0,0,0,0
219888,21000,210,0,-2,18,6,12,1,0,1,3,1,2,0,0,0,0,0,0,0,0,0,13,5,8,0,0,0,1,0,1,0,0,0
219903,21000,210,0,-2,14,1,13,0,0,0,0,0,0,8,0,8,0,0,0,0,0,0,5,0,5,0,0,0,1,1,0,0,0,0
219949,21000,210,0,-2,10,5,5,0,0,0,0,0,0,1,0,1,0,0,0,0,0,0,9,5,4,0,0,0,0,0,0,0,0,0
219976,21000,210,0,-2,14,7,7,0,0,0,1,0,1,1,1,0,0,0,0,0,0,0,10,4,6,0,0,0,2,2,0,0,0,0
220057,21000,210,0,-2,5,3,2,0,0,0,0,0,0,1,1,0,0,0,0,0,0,0,3,1,2,0,0,0,1,1,0,0,0,0
220075,21000,210,0,-2,106,47,59,0,0,0,4,2,2,4,1,3,1,0,1,0,0,0,81,33,48,2,0,2,3,2,1,11,9,2
220118,21000,210,0,-2,6,0,6,0,0,0,0,0,0,1,0,1,0,0,0,0,0,0,5,0,5,0,0,0,0,0,0,0,0,0
220181,21000,210,0,-2,5,3,2,0,0,0,0,0,0,4,3,1,0,0,0,0,0,0,1,0,1,0,0,0,0,0,0,0,0,0
220206,21000,210,0,-2,1,1,0,0,0,0,0,0,0,0,0,0,0,0,0,0,0,0,1,1,0,0,0,0,0,0,0,0,0,0
220215,21000,210,0,-2,11,6,5,0,0,0,0,0,0,1,1,0,0,0,0,0,0,0,10,5,5,0,0,0,0,0,0,0,0,0
220400,21000,210,0,-2,1,1,0,0,0,0,0,0,0,0,0,0,0,0,0,0,0,0,1,1,0,0,0,0,0,0,0,0,0,0
220473,21000,210,0,-2,2,2,0,0,0,0,0,0,0,0,0,0,0,0,0,0,0,0,2,2,0,0,0,0,0,0,0,0,0,0
220516,21000,210,0,-2,6,0,6,0,0,0,0,0,0,0,0,0,0,0,0,0,0,0,6,0,6,0,0,0,0,0,0,0,0,0
220552,21000,210,0,-2,56,15,41,1,1,0,4,0,4,7,1,6,2,1,1,0,0,0,40,11,29,2,1,1,0,0,0,0,0,0
220598,21000,210,0,-2,15,8,7,0,0,0,1,1,0,7,3,4,3,1,2,0,0,0,4,3,1,0,0,0,0,0,0,0,0,0
220604,21000,210,0,-2,6,2,4,0,0,0,0,0,0,6,2,4,0,0,0,0,0,0,0,0,0,0,0,0,0,0,0,0,0,0
220613,21000,210,0,-2,7,4,3,0,0,0,1,0,1,0,0,0,0,0,0,0,0,0,6,4,2,0,0,0,0,0,0,0,0,0
220631,21000,210,0,-2,76,28,48,0,0,0,1,1,0,2,2,0,2,1,1,0,0,0,64,22,42,0,0,0,7,2,5,0,0,0
220710,21000,210,0,-2,5,1,4,0,0,0,0,0,0,0,0,0,0,0,0,0,0,0,5,1,4,0,0,0,0,0,0,0,0,0
220792,21000,210,0,-2,10,6,4,0,0,0,2,1,1,8,5,3,0,0,0,0,0,0,0,0,0,0,0,0,0,0,0,0,0,0
220862,21000,210,0,-2,74,34,40,0,0,0,9,4,5,17,6,11,3,3,0,0,0,0,42,18,24,0,0,0,2,2,0,1,1,0
220978,21000,210,0,-2,79,35,44,0,0,0,2,1,1,9,2,7,3,2,1,0,0,0,58,26,32,0,0,0,0,0,0,7,4,3
220996,21000,210,0,-2,2,1,1,0,0,0,0,0,0,0,0,0,0,0,0,0,0,0,2,1,1,0,0,0,0,0,0,0,0,0
221096,21000,210,0,-2,3,2,1,0,0,0,0,0,0,0,0,0,0,0,0,0,0,0,3,2,1,0,0,0,0,0,0,0,0,0
221148,21000,210,0,-2,22,22,0,0,0,0,0,0,0,0,0,0,0,0,0,0,0,0,22,22,0,0,0,0,0,0,0,0,0,0
221184,21000,210,0,-2,11,4,7,0,0,0,0,0,0,1,0,1,0,0,0,0,0,0,8,4,4,0,0,0,0,0,0,2,0,2
221351,21000,210,0,-2,20,12,8,0,0,0,1,1,0,1,1,0,2,1,1,0,0,0,6,3,3,0,0,0,6,3,3,4,3,1
221397,21000,210,0,-2,17,5,12,0,0,0,0,0,0,0,0,0,0,0,0,0,0,0,16,5,11,0,0,0,1,0,1,0,0,0
221485,21000,210,0,-2,13,7,6,0,0,0,0,0,0,4,2,2,1,0,1,0,0,0,8,5,3,0,0,0,0,0,0,0,0,0
221519,21000,210,0,-2,13,8,5,0,0,0,1,1,0,0,0,0,0,0,0,0,0,0,9,5,4,0,0,0,1,1,0,2,1,1
221643,21000,210,0,-2,6,5,1,0,0,0,0,0,0,1,1,0,1,1,0,0,0,0,2,2,0,1,0,1,1,1,0,0,0,0
221661,21000,210,0,-2,8,3,5,0,0,0,3,2,1,2,0,2,0,0,0,0,0,0,3,1,2,0,0,0,0,0,0,0,0,0
221670,21000,210,0,-2,4,2,2,0,0,0,1,0,1,0,0,0,0,0,0,0,0,0,3,2,1,0,0,0,0,0,0,0,0,0
221731,21000,210,0,-2,2,0,2,0,0,0,0,0,0,0,0,0,0,0,0,0,0,0,2,0,2,0,0,0,0,0,0,0,0,0
221740,21000,210,0,-2,35,18,17,0,0,0,4,2,2,3,0,3,0,0,0,0,0,0,20,11,9,0,0,0,0,0,0,8,5,3
221759,21000,210,0,-2,104,44,60,1,0,1,8,6,2,19,8,11,6,0,6,0,0,0,58,24,34,1,0,1,0,0,0,11,6,5
221768,21000,210,0,-2,17,5,12,0,0,0,0,0,0,3,0,3,0,0,0,0,0,0,13,5,8,0,0,0,0,0,0,1,0,1
221838,21000,210,0,-2,28,13,15,0,0,0,2,2,0,9,4,5,2,0,2,0,0,0,13,6,7,0,0,0,0,0,0,2,1,1
221847,21000,210,0,-2,35,16,19,0,0,0,1,1,0,0,0,0,0,0,0,0,0,0,23,7,16,1,1,0,3,2,1,7,5,2
221892,21000,210,0,-2,5,4,1,0,0,0,1,1,0,0,0,0,0,0,0,0,0,0,4,3,1,0,0,0,0,0,0,0,0,0
221908,21000,210,0,-2,4,1,3,0,0,0,0,0,0,0,0,0,0,0,0,0,0,0,4,1,3,0,0,0,0,0,0,0,0,0
221953,21000,210,0,-2,8,3,5,0,0,0,1,1,0,0,0,0,0,0,0,0,0,0,7,2,5,0,0,0,0,0,0,0,0,0
221971,21000,210,0,-2,17,9,8,0,0,0,0,0,0,2,2,0,0,0,0,0,0,0,15,7,8,0,0,0,0,0,0,0,0,0
221999,21000,210,0,-2,76,33,43,0,0,0,0,0,0,3,2,1,1,0,1,0,0,0,18,7,11,0,0,0,43,18,25,11,6,5
222053,21000,210,0,-2,13,9,4,0,0,0,0,0,0,3,2,1,0,0,0,0,0,0,10,7,3,0,0,0,0,0,0,0,0,0
222062,21000,210,0,-2,14,7,7,0,0,0,0,0,0,0,0,0,0,0,0,0,0,0,14,7,7,0,0,0,0,0,0,0,0,0
222105,21000,210,0,-2,7,7,0,0,0,0,0,0,0,3,3,0,0,0,0,0,0,0,4,4,0,0,0,0,0,0,0,0,0,0
222178,21000,210,0,-2,12,7,5,0,0,0,0,0,0,2,0,2,1,0,1,0,0,0,7,5,2,0,0,0,2,2,0,0,0,0
222567,21000,210,0,-2,9,4,5,0,0,0,0,0,0,1,1,0,1,1,0,0,0,0,5,1,4,0,0,0,2,1,1,0,0,0
222576,21000,210,0,-2,11,5,6,0,0,0,0,0,0,1,0,1,2,0,2,0,0,0,8,5,3,0,0,0,0,0,0,0,0,0
222628,21000,210,0,-2,1,0,1,0,0,0,0,0,0,0,0,0,0,0,0,0,0,0,1,0,1,0,0,0,0,0,0,0,0,0
222822,21000,210,0,-2,8,4,4,0,0,0,1,0,1,0,0,0,0,0,0,0,0,0,7,4,3,0,0,0,0,0,0,0,0,0
222831,21000,210,0,-2,25,9,16,0,0,0,3,0,3,2,1,1,1,1,0,0,0,0,17,6,11,0,0,0,2,1,1,0,0,0
222877,21000,210,0,-2,1,1,0,0,0,0,0,0,0,0,0,0,0,0,0,0,0,0,1,1,0,0,0,0,0,0,0,0,0,0
222983,21000,210,0,-2,6,3,3,0,0,0,0,0,0,1,0,1,1,1,0,0,0,0,3,2,1,0,0,0,0,0,0,1,0,1
222992,21000,210,0,-2,18,10,8,0,0,0,1,1,0,4,1,3,2,2,0,0,0,0,11,6,5,0,0,0,0,0,0,0,0,0
223083,21000,210,0,-2,4,0,4,0,0,0,0,0,0,0,0,0,0,0,0,0,0,0,4,0,4,0,0,0,0,0,0,0,0,0
223223,21000,210,0,-2,293,113,180,0,0,0,86,43,43,22,4,18,22,6,16,1,0,1,122,38,84,5,3,2,35,19,16,0,0,0
223232,21000,210,0,-2,34,11,23,0,0,0,3,2,1,4,0,4,1,0,1,0,0,0,20,7,13,0,0,0,5,1,4,1,1,0
223320,21000,210,0,-2,4,1,3,0,0,0,0,0,0,1,1,0,0,0,0,0,0,0,2,0,2,0,0,0,1,0,1,0,0,0
223427,21000,210,0,-2,7,2,5,0,0,0,0,0,0,3,1,2,0,0,0,0,0,0,4,1,3,0,0,0,0,0,0,0,0,0
223463,21000,210,0,-2,1,1,0,0,0,0,0,0,0,1,1,0,0,0,0,0,0,0,0,0,0,0,0,0,0,0,0,0,0,0
223506,21000,210,0,-2,5,3,2,0,0,0,0,0,0,1,0,1,0,0,0,0,0,0,3,2,1,1,1,0,0,0,0,0,0,0
223816,21000,210,0,-2,6,1,5,0,0,0,0,0,0,0,0,0,1,0,1,0,0,0,3,1,2,2,0,2,0,0,0,0,0,0
223898,21000,210,0,-2,10,5,5,0,0,0,0,0,0,0,0,0,1,0,1,0,0,0,8,5,3,0,0,0,1,0,1,0,0,0
223922,21000,210,0,-2,5,3,2,0,0,0,0,0,0,0,0,0,0,0,0,0,0,0,5,3,2,0,0,0,0,0,0,0,0,0
224004,21000,210,0,-2,4,0,4,0,0,0,1,0,1,1,0,1,0,0,0,0,0,0,2,0,2,0,0,0,0,0,0,0,0,0
224110,21000,210,0,-2,12,5,7,1,0,1,0,0,0,1,0,1,0,0,0,0,0,0,7,3,4,2,1,1,1,1,0,0,0,0
224147,21000,210,0,-2,22,6,16,0,0,0,4,1,3,1,0,1,2,1,1,0,0,0,11,2,9,1,1,0,0,0,0,3,1,2
224226,21000,210,0,-2,6,2,4,0,0,0,0,0,0,1,0,1,0,0,0,0,0,0,5,2,3,0,0,0,0,0,0,0,0,0
224244,21000,210,0,-2,1,0,1,0,0,0,0,0,0,0,0,0,0,0,0,0,0,0,1,0,1,0,0,0,0,0,0,0,0,0
224305,21000,210,0,-2,3,3,0,0,0,0,1,1,0,0,0,0,0,0,0,0,0,0,2,2,0,0,0,0,0,0,0,0,0,0
224323,21000,210,0,-2,7,3,4,0,0,0,0,0,0,0,0,0,0,0,0,0,0,0,7,3,4,0,0,0,0,0,0,0,0,0
224350,21000,210,0,-2,14,10,4,0,0,0,1,1,0,0,0,0,5,4,1,0,0,0,8,5,3,0,0,0,0,0,0,0,0,0
224527,21000,210,0,-2,16,5,11,1,0,1,1,1,0,0,0,0,0,0,0,0,0,0,14,4,10,0,0,0,0,0,0,0,0,0
224545,21000,210,0,-2,6,4,2,0,0,0,0,0,0,0,0,0,0,0,0,0,0,0,3,2,1,0,0,0,1,0,1,2,2,0
224554,21000,210,0,-2,25,10,15,0,0,0,1,1,0,2,0,2,2,1,1,0,0,0,12,5,7,0,0,0,1,0,1,7,3,4
224615,21000,210,0,-2,30,8,22,0,0,0,6,1,5,10,2,8,3,2,1,0,0,0,11,3,8,0,0,0,0,0,0,0,0,0
224642,21000,210,0,-2,24,6,18,0,0,0,0,0,0,0,0,0,14,3,11,0,0,0,8,2,6,0,0,0,0,0,0,2,1,1
224660,21000,210,0,-2,16,9,7,0,0,0,0,0,0,0,0,0,9,6,3,0,0,0,5,2,3,1,0,1,1,1,0,0,0,0
224679,21000,210,0,-2,15,14,1,0,0,0,0,0,0,0,0,0,15,14,1,0,0,0,0,0,0,0,0,0,0,0,0,0,0,0
224712,21000,210,0,-2,5,1,4,0,0,0,1,0,1,2,1,1,1,0,1,0,0,0,1,0,1,0,0,0,0,0,0,0,0,0
224891,21000,210,0,-2,3,1,2,0,0,0,0,0,0,0,0,0,1,0,1,0,0,0,2,1,1,0,0,0,0,0,0,0,0,0
224961,21000,210,0,-2,6,2,4,0,0,0,1,1,0,1,0,1,4,1,3,0,0,0,0,0,0,0,0,0,0,0,0,0,0,0
225070,21000,210,0,-2,13,6,7,0,0,0,1,0,1,0,0,0,1,0,1,0,0,0,11,6,5,0,0,0,0,0,0,0,0,0
225201,21000,210,0,-2,10,5,5,0,0,0,1,1,0,2,2,0,4,1,3,0,0,0,3,1,2,0,0,0,0,0,0,0,0,0
225247,21000,210,0,-2,5,1,4,0,0,0,0,0,0,0,0,0,0,0,0,0,0,0,5,1,4,0,0,0,0,0,0,0,0,0
225308,21000,210,0,-2,10,2,8,0,0,0,0,0,0,1,1,0,0,0,0,0,0,0,9,1,8,0,0,0,0,0,0,0,0,0
225371,21000,210,0,-2,5,2,3,0,0,0,1,1,0,0,0,0,0,0,0,0,0,0,4,1,3,0,0,0,0,0,0,0,0,0
225399,21000,210,0,-2,16,6,10,0,0,0,0,0,0,3,0,3,1,0,1,0,0,0,12,6,6,0,0,0,0,0,0,0,0,0
225414,21000,210,0,-2,8,0,8,0,0,0,2,0,2,1,0,1,0,0,0,0,0,0,3,0,3,0,0,0,0,0,0,2,0,2
225423,21000,210,0,-2,25,13,12,0,0,0,2,0,2,6,1,5,4,3,1,0,0,0,9,7,2,2,1,1,2,1,1,0,0,0
225432,21000,210,0,-2,21,10,11,0,0,0,1,1,0,2,1,1,5,2,3,0,0,0,7,4,3,0,0,0,0,0,0,6,2,4
225502,21000,210,0,-2,6,1,5,0,0,0,0,0,0,2,0,2,1,0,1,0,0,0,3,1,2,0,0,0,0,0,0,0,0,0
225511,21000,210,0,-2,84,53,31,0,0,0,19,9,10,5,3,2,9,3,6,0,0,0,25,17,8,0,0,0,1,1,0,25,20,5
225520,21000,210,0,-2,6,4,2,0,0,0,1,1,0,0,0,0,1,0,1,0,0,0,4,3,1,0,0,0,0,0,0,0,0,0
225548,21000,210,0,-2,3,2,1,0,0,0,0,0,0,0,0,0,2,2,0,0,0,0,1,0,1,0,0,0,0,0,0,0,0,0
225627,21000,210,0,-2,33,14,19,0,0,0,3,1,2,1,0,1,9,4,5,0,0,0,13,6,7,3,0,3,0,0,0,4,3,1
225885,21000,210,0,-2,1,1,0,0,0,0,0,0,0,0,0,0,1,1,0,0,0,0,0,0,0,0,0,0,0,0,0,0,0,0
226019,21000,210,0,-2,13,5,8,0,0,0,0,0,0,0,0,0,0,0,0,0,0,0,13,5,8,0,0,0,0,0,0,0,0,0
226091,21000,210,0,-2,18,10,8,0,0,0,2,2,0,1,0,1,0,0,0,0,0,0,13,6,7,0,0,0,2,2,0,0,0,0
226116,21000,210,0,-2,10,4,6,0,0,0,0,0,0,2,0,2,2,1,1,0,0,0,6,3,3,0,0,0,0,0,0,0,0,0
226134,21000,210,0,-2,11,5,6,0,0,0,1,1,0,0,0,0,10,4,6,0,0,0,0,0,0,0,0,0,0,0,0,0,0,0
226152,21000,210,0,-2,27,9,18,0,0,0,3,1,2,1,0,1,7,1,6,0,0,0,10,6,4,1,0,1,2,1,1,3,0,3
226204,21000,210,0,-2,15,9,6,0,0,0,0,0,0,4,3,1,2,1,1,0,0,0,8,5,3,0,0,0,1,0,1,0,0,0
226231,21000,210,0,-2,19,12,7,0,0,0,1,0,1,0,0,0,0,0,0,0,0,0,17,11,6,0,0,0,1,1,0,0,0,0
226277,21000,210,0,-2,35,31,4,0,0,0,1,1,0,2,2,0,4,4,0,0,0,0,26,22,4,1,1,0,1,1,0,0,0,0
226383,21000,210,0,-2,3,2,1,0,0,0,0,0,0,0,0,0,0,0,0,0,0,0,3,2,1,0,0,0,0,0,0,0,0,0
226408,21000,210,0,-2,5,3,2,0,0,0,0,0,0,1,1,0,0,0,0,0,0,0,2,2,0,2,0,2,0,0,0,0,0,0
226471,21000,210,0,-2,20,7,13,1,0,1,2,1,1,1,0,1,2,1,1,0,0,0,14,5,9,0,0,0,0,0,0,0,0,0
226578,21000,210,0,-2,7,4,3,0,0,0,0,0,0,1,1,0,0,0,0,0,0,0,6,3,3,0,0,0,0,0,0,0,0,0
226587,21000,210,0,-2,5,3,2,0,0,0,0,0,0,0,0,0,0,0,0,0,0,0,5,3,2,0,0,0,0,0,0,0,0,0
226806,21000,210,0,-2,10,5,5,0,0,0,1,1,0,0,0,0,4,1,3,0,0,0,5,3,2,0,0,0,0,0,0,0,0,0
226833,21000,210,0,-2,13,3,10,0,0,0,0,0,0,0,0,0,1,0,1,0,0,0,9,3,6,0,0,0,0,0,0,3,0,3
226903,21000,210,0,-2,40,23,17,0,0,0,0,0,0,1,1,0,25,14,11,0,0,0,10,6,4,1,1,0,3,1,2,0,0,0
227146,21000,210,0,-2,7,1,6,0,0,0,0,0,0,0,0,0,1,0,1,0,0,0,6,1,5,0,0,0,0,0,0,0,0,0
227182,21000,210,0,-2,13,8,5,0,0,0,0,0,0,5,2,3,3,3,0,0,0,0,5,3,2,0,0,0,0,0,0,0,0,0
227216,21000,210,0,-2,139,61,78,0,0,0,25,17,8,13,6,7,13,2,11,0,0,0,80,33,47,2,1,1,6,2,4,0,0,0
227225,21000,210,0,-2,6,1,5,0,0,0,0,0,0,0,0,0,0,0,0,0,0,0,6,1,5,0,0,0,0,0,0,0,0,0
227304,21000,210,0,-2,12,7,5,0,0,0,1,1,0,1,0,1,1,0,1,1,1,0,8,5,3,0,0,0,0,0,0,0,0,0
227331,21000,210,0,-2,15,3,12,0,0,0,1,0,1,3,1,2,8,1,7,0,0,0,3,1,2,0,0,0,0,0,0,0,0,0
227368,21000,210,0,-2,224,124,100,0,0,0,28,15,13,4,2,2,80,37,43,0,0,0,76,44,32,1,1,0,6,4,2,29,21,8
227377,21000,210,0,-2,4,3,1,0,0,0,0,0,0,0,0,0,2,1,1,0,0,0,1,1,0,0,0,0,0,0,0,1,1,0
227386,21000,210,0,-2,9,3,6,1,0,1,0,0,0,0,0,0,0,0,0,0,0,0,8,3,5,0,0,0,0,0,0,0,0,0
227401,21000,210,0,-2,10,6,4,0,0,0,0,0,0,1,0,1,2,2,0,0,0,0,7,4,3,0,0,0,0,0,0,0,0,0
227526,21000,210,0,-2,17,10,7,0,0,0,3,1,2,6,3,3,0,0,0,0,0,0,7,5,2,0,0,0,0,0,0,1,1,0
227687,21000,210,0,-2,7,5,2,0,0,0,0,0,0,0,0,0,1,1,0,0,0,0,6,4,2,0,0,0,0,0,0,0,0,0
227757,21000,210,0,-2,51,37,14,0,0,0,5,3,2,5,2,3,7,5,2,0,0,0,18,13,5,0,0,0,8,6,2,8,8,0
227845,21000,210,0,-2,11,6,5,0,0,0,2,1,1,1,0,1,0,0,0,0,0,0,8,5,3,0,0,0,0,0,0,0,0,0
227854,21000,210,0,-2,16,7,9,0,0,0,3,1,2,3,0,3,4,3,1,0,0,0,6,3,3,0,0,0,0,0,0,0,0,0
227863,21000,210,0,-2,11,6,5,0,0,0,1,0,1,1,0,1,1,1,0,0,0,0,7,5,2,0,0,0,0,0,0,1,0,1
227881,21000,210,0,-2,100,41,59,1,0,1,7,2,5,6,0,6,8,5,3,0,0,0,67,28,39,0,0,0,0,0,0,11,6,5
227924,21000,210,0,-2,12,4,8,0,0,0,1,0,1,1,0,1,6,2,4,0,0,0,4,2,2,0,0,0,0,0,0,0,0,0
227979,21000,210,0,-2,24,11,13,0,0,0,0,0,0,9,4,5,2,1,1,0,0,0,12,6,6,0,0,0,0,0,0,1,0,1
228042,21000,210,0,-2,5,2,3,0,0,0,0,0,0,1,0,1,0,0,0,0,0,0,4,2,2,0,0,0,0,0,0,0,0,0
228149,21000,210,0,-2,13,8,5,0,0,0,1,0,1,2,1,1,2,2,0,0,0,0,6,4,2,0,0,0,0,0,0,2,1,1
228158,21000,210,0,-2,13,6,7,0,0,0,1,0,1,0,0,0,3,1,2,0,0,0,9,5,4,0,0,0,0,0,0,0,0,0
228194,21000,210,0,-2,2,1,1,0,0,0,0,0,0,0,0,0,0,0,0,0,0,0,2,1,1,0,0,0,0,0,0,0,0,0
228246,21000,210,0,-2,28,11,17,0,0,0,7,3,4,5,2,3,1,0,1,0,0,0,13,4,9,0,0,0,0,0,0,2,2,0
228316,21000,210,0,-2,8,2,6,0,0,0,0,0,0,0,0,0,6,1,5,0,0,0,2,1,1,0,0,0,0,0,0,0,0,0
228325,21000,210,0,-2,4,4,0,0,0,0,1,1,0,0,0,0,0,0,0,0,0,0,3,3,0,0,0,0,0,0,0,0,0,0
228343,21000,210,0,-2,10,2,8,0,0,0,2,0,2,0,0,0,4,1,3,0,0,0,3,0,3,1,1,0,0,0,0,0,0,0
228431,21000,210,0,-2,4,2,2,0,0,0,0,0,0,2,1,1,0,0,0,0,0,0,1,0,1,0,0,0,0,0,0,1,1,0
228459,21000,210,0,-2,51,24,27,0,0,0,7,3,4,2,2,0,3,2,1,0,0,0,21,8,13,1,0,1,17,9,8,0,0,0
228468,21000,210,0,-2,7,3,4,0,0,0,0,0,0,0,0,0,2,0,2,1,1,0,4,2,2,0,0,0,0,0,0,0,0,0
228501,21000,210,0,-2,6,2,4,0,0,0,1,1,0,0,0,0,0,0,0,0,0,0,5,1,4,0,0,0,0,0,0,0,0,0
228529,21000,210,0,-2,35,17,18,1,1,0,2,0,2,4,2,2,3,2,1,0,0,0,21,9,12,1,1,0,0,0,0,3,2,1
228547,21000,210,0,-2,12,5,7,0,0,0,2,2,0,5,0,5,3,2,1,0,0,0,2,1,1,0,0,0,0,0,0,0,0,0
228608,21000,210,0,-2,14,6,8,1,1,0,2,1,1,1,1,0,0,0,0,0,0,0,10,3,7,0,0,0,0,0,0,0,0,0
228635,21000,210,0,-2,175,83,92,0,0,0,68,34,34,11,5,6,10,4,6,0,0,0,68,31,37,2,1,1,4,1,3,12,7,5
228644,21000,210,0,-2,64,32,32,0,0,0,12,6,6,4,3,1,11,4,7,0,0,0,29,17,12,0,0,0,8,2,6,0,0,0
228653,21000,210,0,-2,31,12,19,0,0,0,5,3,2,6,1,5,3,0,3,0,0,0,15,7,8,0,0,0,0,0,0,2,1,1
228699,21000,210,0,-2,3,0,3,0,0,0,0,0,0,1,0,1,0,0,0,0,0,0,2,0,2,0,0,0,0,0,0,0,0,0
228705,21000,210,0,-2,6,4,2,0,0,0,1,1,0,0,0,0,0,0,0,0,0,0,3,2,1,0,0,0,0,0,0,2,1,1
228723,21000,210,0,-2,180,110,70,0,0,0,33,16,17,9,5,4,15,7,8,0,0,0,99,63,36,3,3,0,14,12,2,7,4,3
228769,21000,210,0,-2,64,24,40,0,0,0,10,4,6,8,2,6,7,5,2,1,0,1,17,5,12,1,0,1,16,6,10,4,2,2
228778,21000,210,0,-2,222,112,110,0,0,0,32,12,20,19,8,11,34,16,18,0,0,0,99,52,47,3,1,2,0,0,0,35,23,12
228787,21000,210,0,-2,47,21,26,0,0,0,9,5,4,1,0,1,0,0,0,0,0,0,13,4,9,2,1,1,22,11,11,0,0,0
228796,21000,210,0,-2,54,22,32,0,0,0,11,3,8,1,1,0,17,4,13,0,0,0,15,9,6,1,0,1,2,2,0,7,3,4
228802,21000,210,0,-2,22,6,16,0,0,0,4,3,1,0,0,0,1,0,1,0,0,0,10,1,9,0,0,0,5,2,3,2,0,2
228875,21000,210,0,-2,33,14,19,0,0,0,2,1,1,4,1,3,5,1,4,0,0,0,16,9,7,0,0,0,3,1,2,3,1,2
228884,21000,210,0,-2,3,1,2,0,0,0,0,0,0,3,1,2,0,0,0,0,0,0,0,0,0,0,0,0,0,0,0,0,0,0
228909,21000,210,0,-2,19,9,10,0,0,0,3,1,2,2,1,1,2,2,0,0,0,0,10,5,5,0,0,0,2,0,2,0,0,0
228981,21000,210,0,-2,5,3,2,0,0,0,0,0,0,0,0,0,5,3,2,0,0,0,0,0,0,0,0,0,0,0,0,0,0,0
229018,21000,210,0,-2,26,12,14,0,0,0,1,1,0,3,0,3,3,1,2,0,0,0,18,9,9,0,0,0,0,0,0,1,1,0
229027,21000,210,0,-2,38,24,14,0,0,0,3,2,1,2,0,2,14,8,6,0,0,0,6,5,1,0,0,0,7,3,4,6,6,0
229063,21000,210,0,-2,18,8,10,1,0,1,2,0,2,13,7,6,0,0,0,0,0,0,2,1,1,0,0,0,0,0,0,0,0,0
229115,21000,210,0,-2,82,37,45,1,0,1,7,4,3,2,1,1,6,4,2,0,0,0,47,20,27,1,0,1,0,0,0,18,8,10
229179,21000,210,0,-2,25,4,21,0,0,0,7,1,6,2,0,2,5,1,4,0,0,0,10,2,8,0,0,0,1,0,1,0,0,0
229267,21000,210,0,-2,12,7,5,0,0,0,1,0,1,1,1,0,4,2,2,0,0,0,6,4,2,0,0,0,0,0,0,0,0,0
229300,21000,210,0,-2,192,89,103,0,0,0,56,27,29,10,1,9,23,8,15,1,1,0,53,24,29,6,1,5,21,12,9,22,15,7
229337,21000,210,0,-2,39,17,22,0,0,0,13,6,7,1,0,1,5,1,4,0,0,0,20,10,10,0,0,0,0,0,0,0,0,0
229355,21000,210,0,-2,37,11,26,0,0,0,0,0,0,1,0,1,1,0,1,0,0,0,35,11,24,0,0,0,0,0,0,0,0,0
229504,21000,210,0,-2,7,4,3,0,0,0,0,0,0,0,0,0,0,0,0,0,0,0,7,4,3,0,0,0,0,0,0,0,0,0
229540,21000,210,0,-2,7,5,2,0,0,0,0,0,0,0,0,0,2,2,0,0,0,0,5,3,2,0,0,0,0,0,0,0,0,0
229780,21000,210,0,-2,3,2,1,0,0,0,0,0,0,0,0,0,1,0,1,0,0,0,2,2,0,0,0,0,0,0,0,0,0,0
229799,21000,210,0,-2,12,3,9,0,0,0,2,1,1,1,0,1,0,0,0,0,0,0,6,1,5,0,0,0,3,1,2,0,0,0
229814,21000,210,0,-2,32,15,17,0,0,0,3,2,1,0,0,0,2,1,1,0,0,0,17,6,11,0,0,0,0,0,0,10,6,4
229832,21000,210,0,-2,4,4,0,0,0,0,0,0,0,0,0,0,1,1,0,0,0,0,3,3,0,0,0,0,0,0,0,0,0,0
229841,21000,210,0,-2,11,2,9,0,0,0,0,0,0,3,0,3,1,1,0,0,0,0,5,0,5,0,0,0,2,1,1,0,0,0
229887,21000,210,0,-2,5,0,5,0,0,0,0,0,0,5,0,5,0,0,0,0,0,0,0,0,0,0,0,0,0,0,0,0,0,0
230038,21000,210,0,-2,64,38,26,0,0,0,1,1,0,0,0,0,1,0,1,0,0,0,59,36,23,3,1,2,0,0,0,0,0,0
230047,21000,210,0,-2,9,5,4,0,0,0,1,1,0,0,0,0,1,0,1,1,0,1,5,3,2,0,0,0,0,0,0,1,1,0
230171,21000,210,0,-2,30,14,16,0,0,0,2,1,1,0,0,0,0,0,0,0,0,0,26,11,15,0,0,0,1,1,0,1,1,0
230366,21000,210,0,-2,5,0,5,0,0,0,0,0,0,0,0,0,0,0,0,0,0,0,5,0,5,0,0,0,0,0,0,0,0,0
230418,21000,210,0,-2,1,1,0,0,0,0,0,0,0,0,0,0,0,0,0,0,0,0,1,1,0,0,0,0,0,0,0,0,0,0
230597,21000,210,0,-2,12,6,6,0,0,0,0,0,0,1,0,1,0,0,0,0,0,0,11,6,5,0,0,0,0,0,0,0,0,0
230603,21000,210,0,-2,37,24,13,0,0,0,0,0,0,1,1,0,3,1,2,0,0,0,32,21,11,0,0,0,0,0,0,1,1,0
230728,21000,210,0,-2,54,31,23,0,0,0,4,4,0,0,0,0,4,3,1,0,0,0,42,22,20,2,1,1,2,1,1,0,0,0
230737,21000,210,0,-2,87,47,40,0,0,0,8,2,6,1,0,1,2,1,1,1,0,1,54,29,25,2,1,1,12,9,3,7,5,2
230746,21000,210,0,-2,21,12,9,1,0,1,1,0,1,1,0,1,3,1,2,0,0,0,15,11,4,0,0,0,0,0,0,0,0,0
230764,21000,210,0,-2,115,64,51,1,1,0,8,4,4,5,2,3,6,3,3,1,1,0,67,39,28,4,2,2,7,3,4,16,9,7
230782,21000,210,0,-2,44,23,21,0,0,0,1,1,0,0,0,0,1,1,0,0,0,0,35,17,18,1,0,1,2,1,1,4,3,1
230807,21000,210,0,-2,4,0,4,0,0,0,0,0,0,0,0,0,0,0,0,0,0,0,4,0,4,0,0,0,0,0,0,0,0,0
230816,21000,210,0,-2,2,1,1,0,0,0,1,0,1,0,0,0,0,0,0,0,0,0,1,1,0,0,0,0,0,0,0,0,0,0
230834,21000,210,0,-2,2,0,2,0,0,0,0,0,0,0,0,0,0,0,0,0,0,0,1,0,1,0,0,0,1,0,1,0,0,0
230852,21000,210,0,-2,2,1,1,0,0,0,0,0,0,0,0,0,0,0,0,0,0,0,1,1,0,0,0,0,1,0,1,0,0,0
230913,21000,210,0,-2,2,1,1,0,0,0,0,0,0,0,0,0,0,0,0,0,0,0,2,1,1,0,0,0,0,0,0,0,0,0
230959,21000,210,0,-2,14,6,8,0,0,0,1,0,1,1,1,0,1,0,1,0,0,0,6,2,4,0,0,0,3,3,0,2,0,2
230995,21000,210,0,-2,21,9,12,0,0,0,0,0,0,0,0,0,1,0,1,0,0,0,16,6,10,0,0,0,3,3,0,1,0,1
231059,21000,210,0,-2,7,2,5,0,0,0,0,0,0,0,0,0,0,0,0,0,0,0,5,1,4,0,0,0,0,0,0,2,1,1
231068,21000,210,0,-2,1,0,1,0,0,0,0,0,0,0,0,0,0,0,0,0,0,0,1,0,1,0,0,0,0,0,0,0,0,0
231147,21000,210,0,-2,8,2,6,0,0,0,0,0,0,1,0,1,0,0,0,0,0,0,6,2,4,0,0,0,1,0,1,0,0,0
231165,21000,210,0,-2,4,1,3,0,0,0,0,0,0,0,0,0,0,0,0,0,0,0,4,1,3,0,0,0,0,0,0,0,0,0
231174,21000,210,0,-2,26,12,14,0,0,0,2,0,2,2,2,0,1,0,1,0,0,0,16,7,9,0,0,0,2,1,1,3,2,1
231411,21000,210,0,-2,3,2,1,0,0,0,0,0,0,1,0,1,0,0,0,0,0,0,2,2,0,0,0,0,0,0,0,0,0,0
231420,21000,210,0,-2,5,4,1,0,0,0,0,0,0,0,0,0,0,0,0,0,0,0,5,4,1,0,0,0,0,0,0,0,0,0
231536,21000,210,0,-2,3,0,3,0,0,0,0,0,0,0,0,0,0,0,0,0,0,0,3,0,3,0,0,0,0,0,0,0,0,0
231554,21000,210,0,-2,1,0,1,0,0,0,0,0,0,0,0,0,0,0,0,0,0,0,1,0,1,0,0,0,0,0,0,0,0,0
231581,21000,210,0,-2,9,7,2,0,0,0,2,2,0,0,0,0,0,0,0,0,0,0,5,4,1,0,0,0,0,0,0,2,1,1
231624,21000,210,0,-2,32,14,18,0,0,0,5,2,3,2,1,1,2,1,1,0,0,0,14,7,7,1,1,0,6,2,4,2,0,2
231651,21000,210,0,-2,8,2,6,0,0,0,0,0,0,2,0,2,0,0,0,1,0,1,5,2,3,0,0,0,0,0,0,0,0,0
231697,21000,210,0,-2,1,0,1,0,0,0,0,0,0,0,0,0,0,0,0,0,0,0,1,0,1,0,0,0,0,0,0,0,0,0
231712,21000,210,0,-2,10,4,6,0,0,0,3,1,2,0,0,0,0,0,0,0,0,0,7,3,4,0,0,0,0,0,0,0,0,0
231785,21000,210,0,-2,8,2,6,0,0,0,0,0,0,4,0,4,0,0,0,0,0,0,2,1,1,1,1,0,1,0,1,0,0,0
231873,21000,210,0,-2,5,1,4,0,0,0,0,0,0,0,0,0,0,0,0,0,0,0,5,1,4,0,0,0,0,0,0,0,0,0
231882,21000,210,0,-2,15,10,5,0,0,0,0,0,0,1,0,1,0,0,0,0,0,0,14,10,4,0,0,0,0,0,0,0,0,0
231970,21000,210,0,-2,20,6,14,0,0,0,4,2,2,3,0,3,1,0,1,0,0,0,12,4,8,0,0,0,0,0,0,0,0,0
232016,21000,210,0,-2,4,2,2,0,0,0,0,0,0,3,1,2,0,0,0,0,0,0,1,1,0,0,0,0,0,0,0,0,0,0
232025,21000,210,0,-2,16,6,10,0,0,0,0,0,0,1,0,1,0,0,0,0,0,0,6,1,5,0,0,0,9,5,4,0,0,0
232043,21000,210,0,-2,5,3,2,0,0,0,1,1,0,0,0,0,0,0,0,0,0,0,4,2,2,0,0,0,0,0,0,0,0,0
232052,21000,210,0,-2,1,0,1,0,0,0,1,0,1,0,0,0,0,0,0,0,0,0,0,0,0,0,0,0,0,0,0,0,0,0
232089,21000,210,0,-2,5,2,3,0,0,0,1,1,0,0,0,0,0,0,0,0,0,0,4,1,3,0,0,0,0,0,0,0,0,0
232186,21000,210,0,-2,112,67,45,1,1,0,18,12,6,15,9,6,3,2,1,0,0,0,45,24,21,2,1,1,1,1,0,27,17,10
232195,21000,210,0,-2,13,7,6,1,0,1,1,1,0,4,3,1,1,0,1,0,0,0,6,3,3,0,0,0,0,0,0,0,0,0
232256,21000,210,0,-2,7,6,1,0,0,0,1,1,0,1,0,1,1,1,0,0,0,0,4,4,0,0,0,0,0,0,0,0,0,0
232265,21000,210,0,-2,31,11,20,0,0,0,6,3,3,17,5,12,0,0,0,0,0,0,8,3,5,0,0,0,0,0,0,0,0,0
232308,21000,210,0,-2,21,6,15,0,0,0,0,0,0,2,1,1,0,0,0,0,0,0,16,5,11,1,0,1,0,0,0,2,0,2
232414,21000,210,0,-2,8,2,6,0,0,0,0,0,0,1,0,1,0,0,0,0,0,0,7,2,5,0,0,0,0,0,0,0,0,0
232423,21000,210,0,-2,40,10,30,1,0,1,3,1,2,7,2,5,5,1,4,0,0,0,21,5,16,2,1,1,0,0,0,1,0,1
232450,21000,210,0,-2,3,0,3,0,0,0,0,0,0,0,0,0,0,0,0,0,0,0,3,0,3,0,0,0,0,0,0,0,0,0
232557,21000,210,0,-2,48,19,29,0,0,0,1,1,0,11,3,8,2,1,1,0,0,0,34,14,20,0,0,0,0,0,0,0,0,0
232566,21000,210,0,-2,9,4,5,0,0,0,0,0,0,1,0,1,0,0,0,0,0,0,7,3,4,0,0,0,0,0,0,1,1,0
232575,21000,210,0,-2,6,1,5,1,0,1,0,0,0,0,0,0,0,0,0,0,0,0,5,1,4,0,0,0,0,0,0,0,0,0
232609,21000,210,0,-2,8,5,3,0,0,0,1,1,0,0,0,0,0,0,0,0,0,0,4,2,2,0,0,0,3,2,1,0,0,0
232618,21000,210,0,-2,6,1,5,0,0,0,0,0,0,0,0,0,0,0,0,0,0,0,6,1,5,0,0,0,0,0,0,0,0,0
232672,21000,210,0,-2,10,2,8,0,0,0,0,0,0,0,0,0,1,0,1,0,0,0,9,2,7,0,0,0,0,0,0,0,0,0
232681,21000,210,0,-2,13,8,5,0,0,0,3,3,0,1,0,1,1,1,0,0,0,0,8,4,4,0,0,0,0,0,0,0,0,0
232706,21000,210,0,-2,14,5,9,0,0,0,2,0,2,4,1,3,3,2,1,0,0,0,4,2,2,0,0,0,1,0,1,0,0,0
232788,21000,210,0,-2,1,1,0,0,0,0,0,0,0,0,0,0,0,0,0,0,0,0,1,1,0,0,0,0,0,0,0,0,0,0
232797,21000,210,0,-2,2,1,1,0,0,0,1,1,0,0,0,0,0,0,0,0,0,0,1,0,1,0,0,0,0,0,0,0,0,0
232867,21000,210,0,-2,4,1,3,0,0,0,0,0,0,0,0,0,0,0,0,0,0,0,4,1,3,0,0,0,0,0,0,0,0,0
232885,21000,210,0,-2,1,0,1,0,0,0,0,0,0,1,0,1,0,0,0,0,0,0,0,0,0,0,0,0,0,0,0,0,0,0
232937,21000,210,0,-2,7,4,3,0,0,0,2,0,2,4,3,1,0,0,0,0,0,0,1,1,0,0,0,0,0,0,0,0,0,0
232946,21000,210,0,-2,8,3,5,0,0,0,0,0,0,2,2,0,0,0,0,0,0,0,6,1,5,0,0,0,0,0,0,0,0,0
232982,21000,210,0,-2,46,24,22,0,0,0,6,2,4,5,2,3,0,0,0,0,0,0,26,14,12,0,0,0,0,0,0,9,6,3
233019,21000,210,0,-2,2,0,2,0,0,0,0,0,0,0,0,0,0,0,0,0,0,0,2,0,2,0,0,0,0,0,0,0,0,0
233082,21000,210,0,-2,2,0,2,0,0,0,0,0,0,0,0,0,0,0,0,0,0,0,2,0,2,0,0,0,0,0,0,0,0,0
233116,21000,210,0,-2,6,2,4,0,0,0,1,1,0,2,1,1,0,0,0,0,0,0,3,0,3,0,0,0,0,0,0,0,0,0
233277,21000,210,0,-2,26,12,14,0,0,0,4,2,2,2,2,0,0,0,0,0,0,0,20,8,12,0,0,0,0,0,0,0,0,0
233295,21000,210,0,-2,15,7,8,0,0,0,0,0,0,2,0,2,1,1,0,0,0,0,12,6,6,0,0,0,0,0,0,0,0,0
233301,21000,210,0,-2,3,0,3,0,0,0,0,0,0,1,0,1,0,0,0,0,0,0,2,0,2,0,0,0,0,0,0,0,0,0
233310,21000,210,0,-2,3,0,3,0,0,0,0,0,0,1,0,1,0,0,0,0,0,0,2,0,2,0,0,0,0,0,0,0,0,0
233329,21000,210,0,-2,12,1,11,0,0,0,2,0,2,1,0,1,3,0,3,0,0,0,5,0,5,0,0,0,1,1,0,0,0,0
233356,21000,210,0,-2,3,2,1,0,0,0,0,0,0,1,1,0,0,0,0,0,0,0,2,1,1,0,0,0,0,0,0,0,0,0
233374,21000,210,0,-2,33,15,18,0,0,0,1,0,1,5,2,3,0,0,0,0,0,0,21,10,11,1,0,1,1,1,0,4,2,2
233408,21000,210,0,-2,2,0,2,0,0,0,0,0,0,0,0,0,0,0,0,0,0,0,2,0,2,0,0,0,0,0,0,0,0,0
233426,21000,210,0,-2,15,10,5,0,0,0,0,0,0,0,0,0,1,1,0,0,0,0,13,8,5,1,1,0,0,0,0,0,0,0
233541,21000,210,0,-2,23,7,16,0,0,0,0,0,0,3,2,1,0,0,0,0,0,0,14,4,10,0,0,0,5,1,4,1,0,1
233611,21000,210,0,-2,1,1,0,0,0,0,0,0,0,0,0,0,0,0,0,0,0,0,1,1,0,0,0,0,0,0,0,0,0,0
233639,21000,210,0,-2,1,0,1,0,0,0,0,0,0,0,0,0,0,0,0,0,0,0,1,0,1,0,0,0,0,0,0,0,0,0
233718,21000,210,0,-2,11,2,9,0,0,0,1,0,1,2,0,2,1,0,1,0,0,0,7,2,5,0,0,0,0,0,0,0,0,0
233754,21000,210,0,-2,1,1,0,0,0,0,0,0,0,0,0,0,0,0,0,0,0,0,1,1,0,0,0,0,0,0,0,0,0,0
233772,21000,210,0,-2,12,6,6,0,0,0,0,0,0,1,1,0,0,0,0,0,0,0,11,5,6,0,0,0,0,0,0,0,0,0
233842,21000,210,0,-2,2,1,1,0,0,0,0,0,0,2,1,1,0,0,0,0,0,0,0,0,0,0,0,0,0,0,0,0,0,0
233897,21000,210,0,-2,5,3,2,0,0,0,0,0,0,0,0,0,0,0,0,0,0,0,5,3,2,0,0,0,0,0,0,0,0,0
233903,21000,210,0,-2,1,1,0,0,0,0,0,0,0,0,0,0,0,0,0,0,0,0,1,1,0,0,0,0,0,0,0,0,0,0
233921,21000,210,0,-2,141,71,70,1,0,1,16,11,5,8,4,4,8,4,4,0,0,0,70,33,37,3,3,0,0,0,0,35,16,19
233949,21000,210,0,-2,2,1,1,0,0,0,1,1,0,0,0,0,0,0,0,0,0,0,1,0,1,0,0,0,0,0,0,0,0,0
234030,21000,210,0,-2,106,45,61,0,0,0,11,4,7,15,6,9,6,3,3,0,0,0,65,26,39,2,0,2,0,0,0,7,6,1
234076,21000,210,0,-2,163,87,76,0,0,0,24,17,7,16,7,9,4,1,3,0,0,0,80,43,37,6,4,2,15,11,4,18,4,14
234085,21000,210,0,-2,16,9,7,0,0,0,3,1,2,0,0,0,0,0,0,0,0,0,13,8,5,0,0,0,0,0,0,0,0,0
234155,21000,210,0,-2,22,13,9,0,0,0,4,3,1,13,6,7,1,0,1,0,0,0,4,4,0,0,0,0,0,0,0,0,0,0
234164,21000,210,0,-2,3,3,0,0,0,0,0,0,0,1,1,0,0,0,0,0,0,0,0,0,0,0,0,0,2,2,0,0,0,0
234173,21000,210,0,-2,1,1,0,0,0,0,0,0,0,0,0,0,0,0,0,0,0,0,1,1,0,0,0,0,0,0,0,0,0,0
234207,21000,210,0,-2,22,9,13,0,0,0,1,0,1,3,1,2,5,3,2,0,0,0,3,2,1,0,0,0,4,1,3,6,2,4
234377,21000,210,0,-2,1,0,1,0,0,0,0,0,0,0,0,0,0,0,0,0,0,0,1,0,1,0,0,0,0,0,0,0,0,0
234669,21000,210,0,-2,5,2,3,0,0,0,0,0,0,4,2,2,0,0,0,0,0,0,1,0,1,0,0,0,0,0,0,0,0,0
234696,21000,210,0,-2,6,3,3,0,0,0,0,0,0,0,0,0,0,0,0,0,0,0,5,3,2,1,0,1,0,0,0,0,0,0
234711,21000,210,0,-2,2,2,0,0,0,0,1,1,0,0,0,0,0,0,0,0,0,0,1,1,0,0,0,0,0,0,0,0,0,0
234827,21000,210,0,-2,24,15,9,0,0,0,4,4,0,2,0,2,3,2,1,0,0,0,13,7,6,2,2,0,0,0,0,0,0,0
234845,21000,210,0,-2,1,0,1,0,0,0,0,0,0,0,0,0,0,0,0,0,0,0,1,0,1,0,0,0,0,0,0,0,0,0
234915,21000,210,0,-2,7,4,3,0,0,0,2,2,0,0,0,0,0,0,0,0,0,0,4,1,3,0,0,0,1,1,0,0,0,0
234933,21000,210,0,-2,10,1,9,0,0,0,1,0,1,1,1,0,0,0,0,0,0,0,7,0,7,0,0,0,1,0,1,0,0,0
234951,21000,210,0,-2,6,5,1,0,0,0,0,0,0,1,1,0,0,0,0,0,0,0,5,4,1,0,0,0,0,0,0,0,0,0
234979,21000,210,0,-2,5,3,2,0,0,0,0,0,0,0,0,0,0,0,0,0,0,0,4,2,2,1,1,0,0,0,0,0,0,0
235024,21000,210,0,-2,2,0,2,0,0,0,0,0,0,0,0,0,1,0,1,0,0,0,0,0,0,1,0,1,0,0,0,0,0,0
235097,21000,210,0,-2,35,17,18,1,1,0,3,1,2,1,0,1,1,1,0,0,0,0,27,12,15,0,0,0,0,0,0,2,2,0
235103,21000,210,0,-2,3,0,3,0,0,0,0,0,0,0,0,0,0,0,0,0,0,0,3,0,3,0,0,0,0,0,0,0,0,0
235149,21000,210,0,-2,4,3,1,0,0,0,1,1,0,0,0,0,0,0,0,0,0,0,1,1,0,1,0,1,1,1,0,0,0,0
235167,21000,210,0,-2,3,1,2,0,0,0,0,0,0,0,0,0,0,0,0,0,0,0,0,0,0,0,0,0,3,1,2,0,0,0
235237,21000,210,0,-2,6,1,5,0,0,0,2,0,2,1,1,0,0,0,0,0,0,0,3,0,3,0,0,0,0,0,0,0,0,0
235316,21000,210,0,-2,34,19,15,0,0,0,4,4,0,2,2,0,1,0,1,0,0,0,19,6,13,0,0,0,3,3,0,5,4,1
235334,21000,210,0,-2,4,2,2,0,0,0,0,0,0,0,0,0,0,0,0,0,0,0,4,2,2,0,0,0,0,0,0,0,0,0
235343,21000,210,0,-2,4,3,1,0,0,0,0,0,0,0,0,0,0,0,0,0,0,0,1,1,0,2,1,1,1,1,0,0,0,0
235422,21000,210,0,-2,4,0,4,0,0,0,1,0,1,0,0,0,1,0,1,0,0,0,2,0,2,0,0,0,0,0,0,0,0,0
235431,21000,210,0,-2,10,6,4,0,0,0,0,0,0,1,0,1,0,0,0,0,0,0,8,5,3,0,0,0,1,1,0,0,0,0
235671,21000,210,0,-2,4,2,2,0,0,0,1,0,1,0,0,0,1,1,0,0,0,0,2,1,1,0,0,0,0,0,0,0,0,0
235699,21000,210,0,-2,7,1,6,0,0,0,1,0,1,0,0,0,0,0,0,0,0,0,6,1,5,0,0,0,0,0,0,0,0,0
235750,21000,210,0,-2,2,1,1,0,0,0,0,0,0,0,0,0,0,0,0,0,0,0,1,0,1,0,0,0,1,1,0,0,0,0
236072,21000,210,0,-2,1,0,1,0,0,0,0,0,0,0,0,0,0,0,0,0,0,0,1,0,1,0,0,0,0,0,0,0,0,0
236133,21000,210,0,-2,8,3,5,0,0,0,0,0,0,0,0,0,0,0,0,0,0,0,8,3,5,0,0,0,0,0,0,0,0,0
236188,21000,210,0,-2,13,2,11,0,0,0,0,0,0,0,0,0,0,0,0,1,0,1,11,2,9,1,0,1,0,0,0,0,0,0
236212,21000,210,0,-2,10,9,1,0,0,0,0,0,0,0,0,0,0,0,0,0,0,0,9,8,1,0,0,0,1,1,0,0,0,0
236230,21000,210,0,-2,12,4,8,0,0,0,0,0,0,0,0,0,0,0,0,0,0,0,11,4,7,0,0,0,1,0,1,0,0,0
236258,21000,210,0,-2,3,1,2,0,0,0,0,0,0,0,0,0,0,0,0,0,0,0,2,0,2,0,0,0,1,1,0,0,0,0
236328,21000,210,0,-2,10,2,8,0,0,0,3,0,3,0,0,0,0,0,0,0,0,0,7,2,5,0,0,0,0,0,0,0,0,0
236382,21000,210,0,-2,5,2,3,1,1,0,1,0,1,1,1,0,0,0,0,0,0,0,2,0,2,0,0,0,0,0,0,0,0,0
236452,21000,210,0,-2,6,2,4,0,0,0,0,0,0,0,0,0,0,0,0,0,0,0,2,1,1,0,0,0,4,1,3,0,0,0
236513,21000,210,0,-2,3,3,0,0,0,0,1,1,0,0,0,0,0,0,0,0,0,0,1,1,0,0,0,0,1,1,0,0,0,0
236577,21000,210,0,-2,16,5,11,0,0,0,1,0,1,1,0,1,2,2,0,0,0,0,5,2,3,0,0,0,1,0,1,6,1,5
236595,21000,210,0,-2,53,24,29,0,0,0,12,9,3,2,0,2,1,0,1,0,0,0,31,12,19,1,1,0,6,2,4,0,0,0
236610,21000,210,0,-2,8,1,7,0,0,0,1,0,1,1,0,1,0,0,0,0,0,0,5,1,4,0,0,0,1,0,1,0,0,0
236638,21000,210,0,-2,4,2,2,0,0,0,1,1,0,0,0,0,0,0,0,0,0,0,3,1,2,0,0,0,0,0,0,0,0,0
236656,21000,210,0,-2,3,2,1,0,0,0,0,0,0,1,1,0,0,0,0,0,0,0,2,1,1,0,0,0,0,0,0,0,0,0
236692,21000,210,0,-2,9,6,3,1,1,0,0,0,0,1,1,0,0,0,0,0,0,0,7,4,3,0,0,0,0,0,0,0,0,0
236708,21000,210,0,-2,4,0,4,0,0,0,0,0,0,0,0,0,0,0,0,0,0,0,4,0,4,0,0,0,0,0,0,0,0,0
236753,21000,210,0,-2,6,4,2,0,0,0,0,0,0,0,0,0,1,1,0,1,0,1,2,2,0,0,0,0,2,1,1,0,0,0
236887,21000,210,0,-2,4,2,2,0,0,0,0,0,0,1,0,1,0,0,0,1,0,1,2,2,0,0,0,0,0,0,0,0,0,0
236896,21000,210,0,-2,8,6,2,0,0,0,2,2,0,0,0,0,1,0,1,0,0,0,5,4,1,0,0,0,0,0,0,0,0,0
236939,21000,210,0,-2,32,18,14,1,0,1,3,3,0,1,1,0,3,2,1,0,0,0,9,3,6,0,0,0,13,8,5,2,1,1
236948,21000,210,0,-2,353,156,197,3,2,1,51,24,27,26,8,18,25,11,14,1,0,1,161,66,95,9,6,3,39,19,20,38,20,18
236975,21000,210,0,-2,2,1,1,0,0,0,0,0,0,0,0,0,1,1,0,0,0,0,1,0,1,0,0,0,0,0,0,0,0,0
237011,21000,210,0,-2,20,10,10,0,0,0,4,2,2,0,0,0,1,0,1,0,0,0,11,5,6,1,0,1,2,2,0,1,1,0
237039,21000,210,0,-2,4,1,3,0,0,0,0,0,0,0,0,0,0,0,0,0,0,0,3,1,2,0,0,0,1,0,1,0,0,0
237057,21000,210,0,-2,11,6,5,0,0,0,0,0,0,0,0,0,1,0,1,0,0,0,8,5,3,0,0,0,0,0,0,2,1,1
237066,21000,210,0,-2,20,9,11,0,0,0,1,0,1,2,2,0,0,0,0,0,0,0,17,7,10,0,0,0,0,0,0,0,0,0
237109,21000,210,0,-2,3,0,3,0,0,0,0,0,0,0,0,0,2,0,2,0,0,0,1,0,1,0,0,0,0,0,0,0,0,0
237118,21000,210,0,-2,8,5,3,0,0,0,0,0,0,1,1,0,0,0,0,0,0,0,7,4,3,0,0,0,0,0,0,0,0,0
237181,21000,210,0,-2,3,2,1,0,0,0,0,0,0,1,1,0,0,0,0,0,0,0,2,1,1,0,0,0,0,0,0,0,0,0
237215,21000,210,0,-2,8,3,5,0,0,0,0,0,0,0,0,0,0,0,0,0,0,0,8,3,5,0,0,0,0,0,0,0,0,0
237312,21000,210,0,-2,21,7,14,0,0,0,0,0,0,3,0,3,1,1,0,0,0,0,17,6,11,0,0,0,0,0,0,0,0,0
237330,21000,210,0,-2,5,3,2,0,0,0,0,0,0,1,0,1,0,0,0,0,0,0,4,3,1,0,0,0,0,0,0,0,0,0
237358,21000,210,0,-2,8,3,5,0,0,0,0,0,0,0,0,0,0,0,0,0,0,0,8,3,5,0,0,0,0,0,0,0,0,0
237367,21000,210,0,-2,10,3,7,0,0,0,0,0,0,0,0,0,0,0,0,0,0,0,10,3,7,0,0,0,0,0,0,0,0,0
237525,21000,210,0,-2,57,28,29,1,0,1,10,6,4,4,2,2,1,1,0,0,0,0,40,19,21,0,0,0,1,0,1,0,0,0
237686,21000,210,0,-2,6,1,5,0,0,0,0,0,0,0,0,0,0,0,0,0,0,0,6,1,5,0,0,0,0,0,0,0,0,0
237701,21000,210,0,-2,5,1,4,0,0,0,0,0,0,1,0,1,0,0,0,0,0,0,3,0,3,0,0,0,0,0,0,1,1,0
237792,21000,210,0,-2,6,2,4,0,0,0,0,0,0,0,0,0,0,0,0,0,0,0,6,2,4,0,0,0,0,0,0,0,0,0
237817,21000,210,0,-2,6,1,5,0,0,0,0,0,0,0,0,0,0,0,0,0,0,0,6,1,5,0,0,0,0,0,0,0,0,0
237880,21000,210,0,-2,2,1,1,0,0,0,0,0,0,0,0,0,0,0,0,0,0,0,2,1,1,0,0,0,0,0,0,0,0,0
237899,21000,210,0,-2,7,2,5,0,0,0,1,1,0,0,0,0,0,0,0,0,0,0,6,1,5,0,0,0,0,0,0,0,0,0
237932,21000,210,0,-2,4,2,2,0,0,0,1,1,0,0,0,0,0,0,0,0,0,0,2,1,1,0,0,0,1,0,1,0,0,0
237950,21000,210,0,-2,9,6,3,0,0,0,2,2,0,0,0,0,0,0,0,0,0,0,5,2,3,0,0,0,0,0,0,2,2,0
237969,21000,210,0,-2,2,1,1,0,0,0,0,0,0,0,0,0,0,0,0,0,0,0,2,1,1,0,0,0,0,0,0,0,0,0
237996,21000,210,0,-2,12,3,9,0,0,0,0,0,0,0,0,0,0,0,0,0,0,0,12,3,9,0,0,0,0,0,0,0,0,0
238014,21000,210,0,-2,8,1,7,0,0,0,1,1,0,1,0,1,0,0,0,0,0,0,6,0,6,0,0,0,0,0,0,0,0,0
238032,21000,210,0,-2,74,41,33,0,0,0,10,6,4,4,2,2,2,1,1,0,0,0,45,23,22,1,1,0,3,3,0,9,5,4
238078,21000,210,0,-2,4,2,2,0,0,0,0,0,0,0,0,0,0,0,0,0,0,0,4,2,2,0,0,0,0,0,0,0,0,0
238193,21000,210,0,-2,8,1,7,0,0,0,0,0,0,2,1,1,0,0,0,0,0,0,6,0,6,0,0,0,0,0,0,0,0,0
238263,21000,210,0,-2,14,4,10,0,0,0,0,0,0,1,1,0,2,1,1,0,0,0,10,1,9,0,0,0,1,1,0,0,0,0
238324,21000,210,0,-2,1,0,1,0,0,0,0,0,0,0,0,0,0,0,0,0,0,0,1,0,1,0,0,0,0,0,0,0,0,0
238333,21000,210,0,-2,12,5,7,0,0,0,0,0,0,0,0,0,1,0,1,0,0,0,10,5,5,0,0,0,0,0,0,1,0,1
238397,21000,210,0,-2,9,8,1,0,0,0,0,0,0,2,2,0,0,0,0,0,0,0,6,6,0,0,0,0,1,0,1,0,0,0
238430,21000,210,0,-2,3,2,1,0,0,0,0,0,0,0,0,0,0,0,0,0,0,0,3,2,1,0,0,0,0,0,0,0,0,0
238458,21000,210,0,-2,15,6,9,0,0,0,0,0,0,0,0,0,0,0,0,0,0,0,12,4,8,0,0,0,1,0,1,2,2,0
238476,21000,210,0,-2,10,5,5,0,0,0,1,1,0,0,0,0,0,0,0,0,0,0,8,4,4,0,0,0,1,0,1,0,0,0
238616,21000,210,0,-2,17,5,12,0,0,0,0,0,0,0,0,0,1,0,1,0,0,0,16,5,11,0,0,0,0,0,0,0,0,0
238661,21000,210,0,-2,2,1,1,0,0,0,0,0,0,1,1,0,0,0,0,0,0,0,0,0,0,0,0,0,0,0,0,1,0,1
238722,21000,210,0,-2,5,3,2,0,0,0,0,0,0,0,0,0,0,0,0,0,0,0,5,3,2,0,0,0,0,0,0,0,0,0
238759,21000,210,0,-2,15,5,10,0,0,0,1,0,1,1,0,1,0,0,0,1,1,0,12,4,8,0,0,0,0,0,0,0,0,0
239008,21000,210,0,-2,4,2,2,0,0,0,0,0,0,1,0,1,0,0,0,0,0,0,3,2,1,0,0,0,0,0,0,0,0,0
239017,21000,210,0,-2,9,2,7,0,0,0,0,0,0,0,0,0,0,0,0,0,0,0,8,2,6,1,0,1,0,0,0,0,0,0
239071,21000,210,0,-2,3,2,1,0,0,0,0,0,0,0,0,0,0,0,0,0,0,0,3,2,1,0,0,0,0,0,0,0,0,0
239080,21000,210,0,-2,3,0,3,0,0,0,0,0,0,0,0,0,0,0,0,0,0,0,3,0,3,0,0,0,0,0,0,0,0,0
239105,21000,210,0,-2,24,10,14,0,0,0,1,1,0,2,1,1,3,1,2,0,0,0,15,6,9,1,0,1,0,0,0,2,1,1
239169,21000,210,0,-2,127,69,58,0,0,0,29,16,13,4,3,1,5,3,2,0,0,0,88,47,41,1,0,1,0,0,0,0,0,0
239220,21000,210,0,-2,9,4,5,0,0,0,1,1,0,0,0,0,0,0,0,0,0,0,8,3,5,0,0,0,0,0,0,0,0,0
239248,21000,210,0,-2,9,6,3,0,0,0,0,0,0,0,0,0,1,0,1,0,0,0,8,6,2,0,0,0,0,0,0,0,0,0
239309,21000,210,0,-2,7,2,5,0,0,0,0,0,0,2,1,1,0,0,0,0,0,0,1,1,0,4,0,4,0,0,0,0,0,0
239318,21000,210,0,-2,9,6,3,0,0,0,0,0,0,0,0,0,0,0,0,0,0,0,9,6,3,0,0,0,0,0,0,0,0,0
239372,21000,210,0,-2,1,1,0,0,0,0,0,0,0,0,0,0,0,0,0,0,0,0,1,1,0,0,0,0,0,0,0,0,0,0
239390,21000,210,0,-2,2,1,1,0,0,0,0,0,0,0,0,0,0,0,0,0,0,0,1,1,0,0,0,0,1,0,1,0,0,0
239442,21000,210,0,-2,2,0,2,0,0,0,0,0,0,0,0,0,0,0,0,0,0,0,2,0,2,0,0,0,0,0,0,0,0,0
239460,21000,210,0,-2,17,6,11,0,0,0,1,0,1,0,0,0,0,0,0,0,0,0,15,6,9,0,0,0,1,0,1,0,0,0
239488,21000,210,0,-2,18,14,4,0,0,0,0,0,0,0,0,0,0,0,0,0,0,0,18,14,4,0,0,0,0,0,0,0,0,0
239512,21000,210,0,-2,2,0,2,0,0,0,0,0,0,0,0,0,0,0,0,0,0,0,2,0,2,0,0,0,0,0,0,0,0,0
239628,21000,210,0,-2,2,2,0,0,0,0,0,0,0,0,0,0,0,0,0,0,0,0,2,2,0,0,0,0,0,0,0,0,0,0
239716,21000,210,0,-2,10,4,6,0,0,0,0,0,0,0,0,0,0,0,0,0,0,0,6,3,3,0,0,0,1,0,1,3,1,2
239910,21000,210,0,-2,2,0,2,0,0,0,0,0,0,1,0,1,0,0,0,0,0,0,1,0,1,0,0,0,0,0,0,0,0,0
240107,21000,210,0,-2,19,9,10,0,0,0,2,1,1,0,0,0,0,0,0,0,0,0,17,8,9,0,0,0,0,0,0,0,0,0
240116,21000,210,0,-2,17,9,8,0,0,0,1,0,1,0,0,0,1,1,0,0,0,0,15,8,7,0,0,0,0,0,0,0,0,0
240125,21000,210,0,-2,13,7,6,0,0,0,0,0,0,0,0,0,1,1,0,0,0,0,11,5,6,0,0,0,1,1,0,0,0,0
240189,21000,210,0,-2,4,2,2,0,0,0,0,0,0,0,0,0,0,0,0,0,0,0,4,2,2,0,0,0,0,0,0,0,0,0
240198,21000,210,0,-2,11,5,6,0,0,0,0,0,0,0,0,0,0,0,0,0,0,0,11,5,6,0,0,0,0,0,0,0,0,0
240268,21000,210,0,-2,16,5,11,0,0,0,3,0,3,0,0,0,0,0,0,0,0,0,9,3,6,0,0,0,2,1,1,2,1,1
240277,21000,210,0,-2,18,9,9,1,0,1,3,2,1,0,0,0,0,0,0,0,0,0,11,4,7,0,0,0,0,0,0,3,3,0
240329,21000,210,0,-2,5,3,2,0,0,0,2,1,1,0,0,0,0,0,0,0,0,0,2,1,1,0,0,0,1,1,0,0,0,0
240338,21000,210,0,-2,2,2,0,0,0,0,0,0,0,0,0,0,0,0,0,0,0,0,2,2,0,0,0,0,0,0,0,0,0,0
240365,21000,210,0,-2,6,3,3,0,0,0,0,0,0,0,0,0,0,0,0,0,0,0,4,1,3,0,0,0,1,1,0,1,1,0
240374,21000,210,0,-2,11,7,4,0,0,0,1,1,0,0,0,0,0,0,0,0,0,0,7,5,2,0,0,0,1,1,0,2,0,2
240392,21000,210,0,-2,19,1,18,0,0,0,0,0,0,1,0,1,0,0,0,0,0,0,16,1,15,1,0,1,1,0,1,0,0,0
240417,21000,210,0,-2,9,6,3,0,0,0,2,1,1,0,0,0,0,0,0,0,0,0,4,3,1,0,0,0,0,0,0,3,2,1
240426,21000,210,0,-2,12,3,9,0,0,0,1,0,1,0,0,0,0,0,0,0,0,0,10,3,7,0,0,0,0,0,0,1,0,1
240444,21000,210,0,-2,215,104,111,1,1,0,23,13,10,10,3,7,9,1,8,0,0,0,124,61,63,3,1,2,10,3,7,35,21,14
240453,21000,210,0,-2,14,7,7,0,0,0,3,1,2,2,0,2,1,1,0,0,0,0,7,4,3,0,0,0,0,0,0,1,1,0
240462,21000,210,0,-2,2,1,1,0,0,0,0,0,0,0,0,0,0,0,0,0,0,0,0,0,0,0,0,0,0,0,0,2,1,1
240471,21000,210,0,-2,8,4,4,0,0,0,1,1,0,0,0,0,1,1,0,0,0,0,4,1,3,0,0,0,0,0,0,2,1,1
240480,21000,210,0,-2,8,2,6,0,0,0,0,0,0,0,0,0,0,0,0,0,0,0,8,2,6,0,0,0,0,0,0,0,0,0
240505,21000,210,0,-2,4,2,2,0,0,0,0,0,0,0,0,0,0,0,0,0,0,0,1,0,1,0,0,0,3,2,1,0,0,0
240514,21000,210,0,-2,7,4,3,0,0,0,0,0,0,0,0,0,0,0,0,0,0,0,5,2,3,0,0,0,2,2,0,0,0,0
240596,21000,210,0,-2,5,2,3,0,0,0,0,0,0,0,0,0,0,0,0,0,0,0,5,2,3,0,0,0,0,0,0,0,0,0
240620,21000,210,0,-2,12,3,9,0,0,0,0,0,0,0,0,0,1,0,1,0,0,0,10,3,7,0,0,0,1,0,1,0,0,0
240657,21000,210,0,-2,4,3,1,0,0,0,0,0,0,0,0,0,0,0,0,0,0,0,4,3,1,0,0,0,0,0,0,0,0,0
240666,21000,210,0,-2,6,1,5,0,0,0,0,0,0,0,0,0,0,0,0,0,0,0,6,1,5,0,0,0,0,0,0,0,0,0
240693,21000,210,0,-2,6,4,2,0,0,0,0,0,0,0,0,0,0,0,0,0,0,0,6,4,2,0,0,0,0,0,0,0,0,0
240718,21000,210,0,-2,14,13,1,0,0,0,0,0,0,0,0,0,0,0,0,0,0,0,14,13,1,0,0,0,0,0,0,0,0,0
240727,21000,210,0,-2,32,15,17,0,0,0,0,0,0,0,0,0,1,1,0,0,0,0,18,6,12,0,0,0,11,7,4,2,1,1
240736,21000,210,0,-2,1,1,0,0,0,0,0,0,0,0,0,0,0,0,0,1,1,0,0,0,0,0,0,0,0,0,0,0,0,0
240745,21000,210,0,-2,4,1,3,0,0,0,2,0,2,0,0,0,0,0,0,1,1,0,1,0,1,0,0,0,0,0,0,0,0,0
240754,21000,210,0,-2,7,3,4,0,0,0,4,1,3,0,0,0,0,0,0,1,0,1,2,2,0,0,0,0,0,0,0,0,0,0
240790,21000,210,0,-2,1,1,0,0,0,0,0,0,0,0,0,0,0,0,0,1,1,0,0,0,0,0,0,0,0,0,0,0,0,0
241191,21000,210,0,-2,2,0,2,0,0,0,0,0,0,0,0,0,2,0,2,0,0,0,0,0,0,0,0,0,0,0,0,0,0,0
241225,21000,210,0,-2,3,1,2,0,0,0,0,0,0,0,0,0,3,1,2,0,0,0,0,0,0,0,0,0,0,0,0,0,0,0
241304,21000,210,0,-2,3,0,3,0,0,0,0,0,0,0,0,0,3,0,3,0,0,0,0,0,0,0,0,0,0,0,0,0,0,0
241331,21000,210,0,-2,2,1,1,0,0,0,0,0,0,0,0,0,2,1,1,0,0,0,0,0,0,0,0,0,0,0,0,0,0,0
241395,21000,210,0,-2,1,0,1,0,0,0,0,0,0,0,0,0,1,0,1,0,0,0,0,0,0,0,0,0,0,0,0,0,0,0
241410,21000,210,0,-2,5,2,3,0,0,0,0,0,0,0,0,0,5,2,3,0,0,0,0,0,0,0,0,0,0,0,0,0,0,0
241739,21000,210,0,-2,10,2,8,0,0,0,0,0,0,0,0,0,10,2,8,0,0,0,0,0,0,0,0,0,0,0,0,0,0,0
241766,21000,210,0,-2,2,1,1,0,0,0,0,0,0,0,0,0,2,1,1,0,0,0,0,0,0,0,0,0,0,0,0,0,0,0
241836,21000,210,0,-2,5,1,4,0,0,0,0,0,0,0,0,0,5,1,4,0,0,0,0,0,0,0,0,0,0,0,0,0,0,0
241951,21000,210,0,-2,1,1,0,0,0,0,0,0,0,0,0,0,1,1,0,0,0,0,0,0,0,0,0,0,0,0,0,0,0,0
242112,21000,210,0,-2,1,0,1,0,0,0,0,0,0,0,0,0,1,0,1,0,0,0,0,0,0,0,0,0,0,0,0,0,0,0
242130,21000,210,0,-2,1,1,0,0,0,0,0,0,0,0,0,0,1,1,0,0,0,0,0,0,0,0,0,0,0,0,0,0,0,0
242617,21000,210,0,-2,2,0,2,0,0,0,0,0,0,0,0,0,2,0,2,0,0,0,0,0,0,0,0,0,0,0,0,0,0,0
242635,21000,210,0,-2,12,6,6,0,0,0,0,0,0,0,0,0,12,6,6,0,0,0,0,0,0,0,0,0,0,0,0,0,0,0
242644,21000,210,0,-2,5,2,3,0,0,0,0,0,0,0,0,0,5,2,3,0,0,0,0,0,0,0,0,0,0,0,0,0,0,0
242653,21000,210,0,-2,9,3,6,0,0,0,0,0,0,0,0,0,9,3,6,0,0,0,0,0,0,0,0,0,0,0,0,0,0,0
242662,21000,210,0,-2,5,2,3,0,0,0,0,0,0,0,0,0,5,2,3,0,0,0,0,0,0,0,0,0,0,0,0,0,0,0
242680,21000,210,0,-2,3,0,3,0,0,0,0,0,0,0,0,0,3,0,3,0,0,0,0,0,0,0,0,0,0,0,0,0,0,0
242699,21000,210,0,-2,5,5,0,0,0,0,0,0,0,0,0,0,5,5,0,0,0,0,0,0,0,0,0,0,0,0,0,0,0,0
242705,21000,210,0,-2,7,3,4,0,0,0,0,0,0,0,0,0,7,3,4,0,0,0,0,0,0,0,0,0,0,0,0,0,0,0
243081,21000,210,0,-2,5,2,3,0,0,0,0,0,0,0,0,0,5,2,3,0,0,0,0,0,0,0,0,0,0,0,0,0,0,0
243151,21000,210,0,-2,2,1,1,0,0,0,0,0,0,0,0,0,2,1,1,0,0,0,0,0,0,0,0,0,0,0,0,0,0,0
243179,21000,210,0,-2,4,3,1,0,0,0,0,0,0,0,0,0,2,1,1,0,0,0,0,0,0,0,0,0,1,1,0,1,1,0
243197,21000,210,0,-2,25,15,10,0,0,0,0,0,0,0,0,0,1,0,1,0,0,0,0,0,0,0,0,0,24,15,9,0,0,0
243346,21000,210,0,-2,1,1,0,0,0,0,0,0,0,0,0,0,1,1,0,0,0,0,0,0,0,0,0,0,0,0,0,0,0,0
243443,21000,210,0,-2,16,4,12,0,0,0,0,0,0,0,0,0,16,4,12,0,0,0,0,0,0,0,0,0,0,0,0,0,0,0
243568,21000,210,0,-2,7,3,4,0,0,0,0,0,0,0,0,0,7,3,4,0,0,0,0,0,0,0,0,0,0,0,0,0,0,0
243586,21000,210,0,-2,2,0,2,0,0,0,0,0,0,0,0,0,2,0,2,0,0,0,0,0,0,0,0,0,0,0,0,0,0,0
243601,21000,210,0,-2,3,1,2,0,0,0,0,0,0,0,0,0,2,1,1,0,0,0,1,0,1,0,0,0,0,0,0,0,0,0
243638,21000,210,0,-2,4,4,0,0,0,0,2,2,0,0,0,0,0,0,0,2,2,0,0,0,0,0,0,0,0,0,0,0,0,0
243647,21000,210,0,-2,1,0,1,0,0,0,0,0,0,0,0,0,0,0,0,1,0,1,0,0,0,0,0,0,0,0,0,0,0,0
243744,21000,210,0,-2,412,218,194,3,1,2,86,39,47,19,7,12,24,10,14,1,1,0,136,81,55,13,7,6,79,40,39,51,32,19
243780,21000,210,0,-2,121,80,41,0,0,0,21,13,8,3,3,0,8,5,3,0,0,0,53,35,18,4,3,1,1,0,1,31,21,10
243823,21000,210,0,-2,12,8,4,0,0,0,0,0,0,1,1,0,0,0,0,0,0,0,7,5,2,0,0,0,4,2,2,0,0,0
243832,21000,210,0,-2,9,1,8,0,0,0,0,0,0,0,0,0,9,1,8,0,0,0,0,0,0,0,0,0,0,0,0,0,0,0
244437,21000,210,0,-2,19,12,7,0,0,0,2,0,2,7,5,2,2,2,0,0,0,0,8,5,3,0,0,0,0,0,0,0,0,0
244446,21000,210,0,-2,27,7,20,0,0,0,1,1,0,17,4,13,0,0,0,0,0,0,9,2,7,0,0,0,0,0,0,0,0,0
245652,21000,210,0,-2,5,2,3,0,0,0,2,1,1,1,1,0,0,0,0,0,0,0,2,0,2,0,0,0,0,0,0,0,0,0
245953,21000,210,0,-2,4,3,1,0,0,0,0,0,0,1,1,0,0,0,0,0,0,0,3,2,1,0,0,0,0,0,0,0,0,0
246354,21000,210,0,-2,6,2,4,0,0,0,1,0,1,0,0,0,4,1,3,0,0,0,1,1,0,0,0,0,0,0,0,0,0,0
246813,21000,210,0,-2,35,21,14,2,2,0,2,0,2,8,3,5,0,0,0,0,0,0,23,16,7,0,0,0,0,0,0,0,0,0
246974,21000,210,0,-2,5,1,4,0,0,0,0,0,0,0,0,0,2,0,2,0,0,0,3,1,2,0,0,0,0,0,0,0,0,0
247649,21000,210,0,-2,4,0,4,0,0,0,0,0,0,0,0,0,0,0,0,0,0,0,4,0,4,0,0,0,0,0,0,0,0,0
247834,21000,210,0,-2,28,11,17,0,0,0,1,1,0,5,3,2,1,0,1,0,0,0,19,7,12,0,0,0,2,0,2,0,0,0
247940,21000,210,0,-2,4,1,3,0,0,0,0,0,0,0,0,0,0,0,0,0,0,0,4,1,3,0,0,0,0,0,0,0,0,0
248934,21000,210,0,-2,68,11,57,0,0,0,1,1,0,18,2,16,2,1,1,0,0,0,42,5,37,2,1,1,3,1,2,0,0,0
250027,21000,210,0,-2,5,1,4,0,0,0,0,0,0,0,0,0,0,0,0,0,0,0,5,1,4,0,0,0,0,0,0,0,0,0
251260,21000,210,0,-2,9,2,7,0,0,0,1,0,1,0,0,0,1,0,1,0,0,0,7,2,5,0,0,0,0,0,0,0,0,0
251312,21000,210,0,-2,1,0,1,0,0,0,0,0,0,0,0,0,0,0,0,0,0,0,1,0,1,0,0,0,0,0,0,0,0,0
260372,21000,210,0,-2,2,1,1,2,1,1,0,0,0,0,0,0,0,0,0,0,0,0,0,0,0,0,0,0,0,0,0,0,0,0
260691,21000,210,0,-2,4,2,2,0,0,0,0,0,0,0,0,0,0,0,0,0,0,0,4,2,2,0,0,0,0,0,0,0,0,0
260789,21000,210,0,-2,5,0,5,0,0,0,1,0,1,0,0,0,2,0,2,0,0,0,2,0,2,0,0,0,0,0,0,0,0,0
260992,21000,210,0,-2,4,0,4,0,0,0,0,0,0,2,0,2,0,0,0,0,0,0,2,0,2,0,0,0,0,0,0,0,0,0
261861,21000,210,0,-2,1,0,1,0,0,0,0,0,0,0,0,0,0,0,0,0,0,0,1,0,1,0,0,0,0,0,0,0,0,0
262031,21000,210,0,-2,3,3,0,0,0,0,0,0,0,1,1,0,0,0,0,0,0,0,2,2,0,0,0,0,0,0,0,0,0,0
262086,21000,210,0,-2,7,0,7,0,0,0,1,0,1,3,0,3,1,0,1,0,0,0,2,0,2,0,0,0,0,0,0,0,0,0
262129,21000,210,0,-2,8,3,5,0,0,0,4,1,3,0,0,0,0,0,0,0,0,0,1,1,0,0,0,0,0,0,0,3,1,2
363633,21000,210,0,-2,1,0,1,0,0,0,0,0,0,0,0,0,1,0,1,0,0,0,0,0,0,0,0,0,0,0,0,0,0,0
363934,21000,210,0,-2,4,3,1,0,0,0,1,0,1,0,0,0,0,0,0,0,0,0,2,2,0,1,1,0,0,0,0,0,0,0
364016,21000,210,0,-2,11,5,6,0,0,0,0,0,0,1,1,0,1,0,1,0,0,0,8,4,4,1,0,1,0,0,0,0,0,0
364025,21000,210,0,-2,11,3,8,0,0,0,0,0,0,1,0,1,1,0,1,0,0,0,9,3,6,0,0,0,0,0,0,0,0,0
366252,21000,210,0,-2,6,6,0,0,0,0,0,0,0,0,0,0,0,0,0,0,0,0,6,6,0,0,0,0,0,0,0,0,0,0
366270,21000,210,0,-2,3,0,3,0,0,0,0,0,0,2,0,2,0,0,0,0,0,0,1,0,1,0,0,0,0,0,0,0,0,0
366340,21000,210,0,-2,1,0,1,0,0,0,0,0,0,0,0,0,0,0,0,0,0,0,1,0,1,0,0,0,0,0,0,0,0,0
366465,21000,210,0,-2,9,8,1,0,0,0,0,0,0,1,1,0,1,1,0,0,0,0,7,6,1,0,0,0,0,0,0,0,0,0
366553,21000,210,0,-2,20,5,15,0,0,0,0,0,0,2,0,2,1,1,0,0,0,0,17,4,13,0,0,0,0,0,0,0,0,0
366711,21000,210,0,-2,19,7,12,0,0,0,3,0,3,1,0,1,4,2,2,0,0,0,6,1,5,1,1,0,0,0,0,4,3,1
367459,21000,210,0,-2,13,2,11,0,0,0,1,0,1,0,0,0,0,0,0,0,0,0,11,2,9,0,0,0,1,0,1,0,0,0
367954,21000,210,0,-2,25,3,22,0,0,0,1,0,1,0,0,0,1,0,1,0,0,0,22,3,19,1,0,1,0,0,0,0,0,0
368629,21000,210,0,-2,2,0,2,0,0,0,0,0,0,0,0,0,1,0,1,0,0,0,1,0,1,0,0,0,0,0,0,0,0,0
368911,21000,210,0,-2,9,3,6,0,0,0,1,1,0,0,0,0,0,0,0,0,0,0,8,2,6,0,0,0,0,0,0,0,0,0
369400,21000,210,0,-2,6,6,0,0,0,0,0,0,0,0,0,0,1,1,0,0,0,0,4,4,0,1,1,0,0,0,0,0,0,0
372329,21000,210,0,-2,3,0,3,0,0,0,0,0,0,0,0,0,1,0,1,0,0,0,2,0,2,0,0,0,0,0,0,0,0,0
376695,21000,210,0,-2,4,3,1,0,0,0,0,0,0,0,0,0,0,0,0,1,1,0,3,2,1,0,0,0,0,0,0,0,0,0
377111,21000,210,0,-2,1,0,1,0,0,0,0,0,0,1,0,1,0,0,0,0,0,0,0,0,0,0,0,0,0,0,0,0,0,0
377458,21000,210,0,-2,12,4,8,0,0,0,0,0,0,6,0,6,0,0,0,0,0,0,6,4,2,0,0,0,0,0,0,0,0,0
377555,21000,210,0,-2,7,2,5,0,0,0,4,1,3,0,0,0,1,0,1,0,0,0,2,1,1,0,0,0,0,0,0,0,0,0
377564,21000,210,0,-2,18,10,8,0,0,0,1,0,1,3,2,1,0,0,0,0,0,0,9,6,3,2,1,1,2,1,1,1,0,1
378105,21000,210,0,-2,5,3,2,0,0,0,0,0,0,0,0,0,3,2,1,0,0,0,2,1,1,0,0,0,0,0,0,0,0,0
378576,21000,210,0,-2,1,0,1,0,0,0,0,0,0,0,0,0,0,0,0,0,0,0,0,0,0,0,0,0,1,0,1,0,0,0
379746,21000,210,0,-2,3,1,2,0,0,0,0,0,0,1,0,1,0,0,0,0,0,0,2,1,1,0,0,0,0,0,0,0,0,0
380359,21000,210,0,-2,3,1,2,1,1,0,0,0,0,0,0,0,0,0,0,0,0,0,2,0,2,0,0,0,0,0,0,0,0,0
380368,21000,210,0,-2,1,0,1,0,0,0,0,0,0,0,0,0,0,0,0,0,0,0,1,0,1,0,0,0,0,0,0,0,0,0
380377,21000,210,0,-2,5,2,3,1,1,0,0,0,0,1,1,0,0,0,0,0,0,0,1,0,1,2,0,2,0,0,0,0,0,0
380438,21000,210,0,-2,8,2,6,0,0,0,0,0,0,0,0,0,0,0,0,0,0,0,7,1,6,1,1,0,0,0,0,0,0,0
382957,21000,210,0,-2,6,2,4,0,0,0,0,0,0,1,0,1,0,0,0,0,0,0,3,1,2,0,0,0,2,1,1,0,0,0
384254,21000,210,0,-2,5,1,4,0,0,0,0,0,0,3,1,2,1,0,1,0,0,0,1,0,1,0,0,0,0,0,0,0,0,0
384333,21000,210,0,-2,8,3,5,0,0,0,0,0,0,0,0,0,1,0,1,0,0,0,7,3,4,0,0,0,0,0,0,0,0,0
384342,21000,210,0,-2,5,4,1,0,0,0,0,0,0,0,0,0,0,0,0,0,0,0,5,4,1,0,0,0,0,0,0,0,0,0
385415,21000,210,0,-2,1,0,1,0,0,0,0,0,0,0,0,0,0,0,0,0,0,0,1,0,1,0,0,0,0,0,0,0,0,0
385503,21000,210,0,-2,3,0,3,0,0,0,0,0,0,1,0,1,0,0,0,0,0,0,2,0,2,0,0,0,0,0,0,0,0,0
385619,21000,210,0,-2,4,4,0,0,0,0,1,1,0,0,0,0,1,1,0,0,0,0,0,0,0,2,2,0,0,0,0,0,0,0
386472,21000,210,0,-2,3,0,3,0,0,0,0,0,0,1,0,1,0,0,0,0,0,0,1,0,1,0,0,0,1,0,1,0,0,0
392257,21000,210,0,-2,13,1,12,0,0,0,1,0,1,7,0,7,2,1,1,0,0,0,3,0,3,0,0,0,0,0,0,0,0,0
392415,21000,210,0,-2,1,0,1,0,0,0,0,0,0,1,0,1,0,0,0,0,0,0,0,0,0,0,0,0,0,0,0,0,0,0
395362,21000,210,0,-2,1,0,1,0,0,0,0,0,0,0,0,0,0,0,0,0,0,0,1,0,1,0,0,0,0,0,0,0,0,0
399869,21000,210,0,-2,1,1,0,0,0,0,0,0,0,0,0,0,0,0,0,0,0,0,1,1,0,0,0,0,0,0,0,0,0,0
399911,21000,210,0,-2,3,1,2,0,0,0,2,0,2,0,0,0,0,0,0,0,0,0,1,1,0,0,0,0,0,0,0,0,0,0
403469,21000,210,0,-2,2,1,1,0,0,0,0,0,0,0,0,0,0,0,0,0,0,0,2,1,1,0,0,0,0,0,0,0,0,0
403478,21000,210,0,-2,3,1,2,0,0,0,0,0,0,0,0,0,0,0,0,0,0,0,3,1,2,0,0,0,0,0,0,0,0,0
403487,21000,210,0,-2,3,2,1,0,0,0,0,0,0,0,0,0,0,0,0,0,0,0,3,2,1,0,0,0,0,0,0,0,0,0
404055,21000,210,0,-2,5,2,3,0,0,0,0,0,0,1,0,1,0,0,0,0,0,0,3,1,2,0,0,0,1,1,0,0,0,0
404222,21000,210,0,-2,1,1,0,0,0,0,0,0,0,0,0,0,1,1,0,0,0,0,0,0,0,0,0,0,0,0,0,0,0,0
404426,21000,210,0,-2,3,1,2,1,1,0,0,0,0,0,0,0,1,0,1,0,0,0,1,0,1,0,0,0,0,0,0,0,0,0
404912,21000,210,0,-2,5,1,4,0,0,0,0,0,0,1,1,0,0,0,0,0,0,0,4,0,4,0,0,0,0,0,0,0,0,0
404994,21000,210,0,-2,6,2,4,0,0,0,0,0,0,0,0,0,3,1,2,0,0,0,3,1,2,0,0,0,0,0,0,0,0,0
405872,21000,210,0,-2,2,1,1,0,0,0,0,0,0,0,0,0,0,0,0,0,0,0,2,1,1,0,0,0,0,0,0,0,0,0
406024,21000,210,0,-2,20,2,18,0,0,0,1,0,1,1,0,1,3,1,2,0,0,0,14,1,13,1,0,1,0,0,0,0,0,0
406033,21000,210,0,-2,20,3,17,0,0,0,3,1,2,0,0,0,7,1,6,0,0,0,9,1,8,0,0,0,1,0,1,0,0,0
407629,21000,210,0,-2,28,15,13,0,0,0,4,2,2,1,0,1,0,0,0,0,0,0,23,13,10,0,0,0,0,0,0,0,0,0
408729,21000,210,0,-2,1,0,1,0,0,0,0,0,0,0,0,0,0,0,0,0,0,0,1,0,1,0,0,0,0,0,0,0,0,0
408844,21000,210,0,-2,13,7,6,0,0,0,0,0,0,2,1,1,11,6,5,0,0,0,0,0,0,0,0,0,0,0,0,0,0,0
409254,21000,210,0,-2,2,0,2,0,0,0,0,0,0,2,0,2,0,0,0,0,0,0,0,0,0,0,0,0,0,0,0,0,0,0
409315,21000,210,0,-2,54,34,20,0,0,0,3,1,2,0,0,0,36,21,15,0,0,0,10,7,3,0,0,0,2,2,0,3,3,0
409698,21000,210,0,-2,7,3,4,0,0,0,1,0,1,0,0,0,1,1,0,0,0,0,4,1,3,0,0,0,0,0,0,1,1,0
412173,21000,210,0,-2,3,0,3,0,0,0,0,0,0,0,0,0,0,0,0,0,0,0,3,0,3,0,0,0,0,0,0,0,0,0
413413,21000,210,0,-2,6,1,5,0,0,0,0,0,0,1,0,1,0,0,0,0,0,0,4,1,3,0,0,0,1,0,1,0,0,0
413626,21000,210,0,-2,1,1,0,0,0,0,0,0,0,0,0,0,0,0,0,0,0,0,1,1,0,0,0,0,0,0,0,0,0,0
413680,21000,210,0,-2,7,7,0,0,0,0,0,0,0,2,2,0,3,3,0,0,0,0,2,2,0,0,0,0,0,0,0,0,0,0
414911,21000,210,0,-2,1,1,0,0,0,0,0,0,0,0,0,0,0,0,0,0,0,0,1,1,0,0,0,0,0,0,0,0,0,0
414966,21000,210,0,-2,2,0,2,0,0,0,0,0,0,0,0,0,0,0,0,0,0,0,2,0,2,0,0,0,0,0,0,0,0,0
416458,21000,210,0,-2,1,0,1,0,0,0,1,0,1,0,0,0,0,0,0,0,0,0,0,0,0,0,0,0,0,0,0,0,0,0
418126,21000,210,0,-2,1,0,1,0,0,0,0,0,0,0,0,0,0,0,0,0,0,0,1,0,1,0,0,0,0,0,0,0,0,0
418533,21000,210,0,-2,4,2,2,0,0,0,0,0,0,0,0,0,0,0,0,0,0,0,4,2,2,0,0,0,0,0,0,0,0,0
420024,21000,210,0,-2,3,0,3,0,0,0,1,0,1,1,0,1,0,0,0,0,0,0,1,0,1,0,0,0,0,0,0,0,0,0
420398,21000,210,0,-2,3,1,2,0,0,0,1,0,1,0,0,0,0,0,0,0,0,0,2,1,1,0,0,0,0,0,0,0,0,0
420431,21000,210,0,-2,9,3,6,0,0,0,0,0,0,1,0,1,0,0,0,0,0,0,8,3,5,0,0,0,0,0,0,0,0,0
420440,21000,210,0,-2,3,0,3,0,0,0,0,0,0,0,0,0,0,0,0,0,0,0,3,0,3,0,0,0,0,0,0,0,0,0
420538,21000,210,0,-2,1,1,0,0,0,0,0,0,0,0,0,0,0,0,0,0,0,0,1,1,0,0,0,0,0,0,0,0,0,0
420556,21000,210,0,-2,4,2,2,0,0,0,0,0,0,0,0,0,1,0,1,0,0,0,3,2,1,0,0,0,0,0,0,0,0,0
421708,21000,210,0,-2,16,3,13,0,0,0,0,0,0,5,0,5,0,0,0,0,0,0,10,3,7,1,0,1,0,0,0,0,0,0
422020,21000,210,0,-2,2,2,0,0,0,0,0,0,0,0,0,0,1,1,0,0,0,0,0,0,0,0,0,0,1,1,0,0,0,0
422695,21000,210,0,-2,2,0,2,0,0,0,0,0,0,0,0,0,0,0,0,0,0,0,2,0,2,0,0,0,0,0,0,0,0,0
423643,21000,210,0,-2,20,12,8,0,0,0,3,2,1,3,3,0,2,1,1,0,0,0,12,6,6,0,0,0,0,0,0,0,0,0
423652,21000,210,0,-2,4,1,3,0,0,0,0,0,0,0,0,0,0,0,0,0,0,0,4,1,3,0,0,0,0,0,0,0,0,0
426314,21000,210,0,-2,11,7,4,0,0,0,0,0,0,0,0,0,0,0,0,0,0,0,6,4,2,1,1,0,4,2,2,0,0,0
427982,21000,210,0,-2,11,7,4,0,0,0,0,0,0,7,3,4,0,0,0,0,0,0,4,4,0,0,0,0,0,0,0,0,0,0
428170,21000,210,0,-2,8,0,8,0,0,0,1,0,1,2,0,2,3,0,3,0,0,0,2,0,2,0,0,0,0,0,0,0,0,0
428392,21000,210,0,-2,4,1,3,0,0,0,0,0,0,0,0,0,0,0,0,0,0,0,4,1,3,0,0,0,0,0,0,0,0,0
429094,21000,210,0,-2,1,0,1,0,0,0,1,0,1,0,0,0,0,0,0,0,0,0,0,0,0,0,0,0,0,0,0,0,0,0
431141,21000,210,0,-2,21,4,17,0,0,0,1,0,1,1,0,1,6,1,5,1,0,1,11,3,8,0,0,0,1,0,1,0,0,0
432348,21000,210,0,-2,1,1,0,0,0,0,0,0,0,0,0,0,0,0,0,0,0,0,1,1,0,0,0,0,0,0,0,0,0,0
433004,21000,210,0,-2,7,5,2,1,1,0,2,1,1,0,0,0,0,0,0,0,0,0,4,3,1,0,0,0,0,0,0,0,0,0
433013,21000,210,0,-2,8,2,6,0,0,0,0,0,0,0,0,0,4,1,3,0,0,0,4,1,3,0,0,0,0,0,0,0,0,0
433174,21000,210,0,-2,8,1,7,0,0,0,1,1,0,1,0,1,0,0,0,0,0,0,6,0,6,0,0,0,0,0,0,0,0,0
433387,21000,210,0,-2,224,88,136,1,1,0,8,3,5,50,25,25,17,3,14,0,0,0,131,48,83,5,3,2,12,5,7,0,0,0
433420,21000,210,0,-2,9,9,0,0,0,0,0,0,0,0,0,0,2,2,0,0,0,0,7,7,0,0,0,0,0,0,0,0,0,0
433536,21000,210,0,-2,3,0,3,0,0,0,0,0,0,1,0,1,0,0,0,0,0,0,2,0,2,0,0,0,0,0,0,0,0,0
433660,21000,210,0,-2,39,16,23,0,0,0,6,2,4,3,1,2,4,1,3,0,0,0,18,9,9,2,0,2,0,0,0,6,3,3
434016,21000,210,0,-2,2,1,1,0,0,0,0,0,0,0,0,0,0,0,0,0,0,0,2,1,1,0,0,0,0,0,0,0,0,0
434061,21000,210,0,-2,20,8,12,0,0,0,1,0,1,10,2,8,0,0,0,1,0,1,7,5,2,0,0,0,0,0,0,1,1,0
434140,21000,210,0,-2,4,1,3,0,0,0,0,0,0,0,0,0,0,0,0,0,0,0,4,1,3,0,0,0,0,0,0,0,0,0
434584,21000,210,0,-2,1,1,0,0,0,0,1,1,0,0,0,0,0,0,0,0,0,0,0,0,0,0,0,0,0,0,0,0,0,0
434672,21000,210,0,-2,14,3,11,0,0,0,2,0,2,4,1,3,1,0,1,0,0,0,6,1,5,0,0,0,0,0,0,1,1,0
434751,21000,210,0,-2,1,1,0,1,1,0,0,0,0,0,0,0,0,0,0,0,0,0,0,0,0,0,0,0,0,0,0,0,0,0
434821,21000,210,0,-2,1,0,1,0,0,0,0,0,0,1,0,1,0,0,0,0,0,0,0,0,0,0,0,0,0,0,0,0,0,0
435000,21000,210,0,-2,112,66,46,0,0,0,21,13,8,2,1,1,7,4,3,0,0,0,43,24,19,1,0,1,0,0,0,38,24,14
436304,21000,210,0,-2,12,5,7,0,0,0,0,0,0,4,1,3,1,1,0,0,0,0,7,3,4,0,0,0,0,0,0,0,0,0
436429,21000,210,0,-2,9,0,9,0,0,0,0,0,0,1,0,1,2,0,2,0,0,0,5,0,5,0,0,0,1,0,1,0,0,0
437103,21000,210,0,-2,5,1,4,0,0,0,0,0,0,3,0,3,0,0,0,0,0,0,2,1,1,0,0,0,0,0,0,0,0,0
437635,21000,210,0,-2,18,6,12,0,0,0,0,0,0,3,0,3,7,3,4,0,0,0,7,2,5,1,1,0,0,0,0,0,0,0
437936,21000,210,0,-2,4,3,1,0,0,0,1,1,0,0,0,0,1,1,0,0,0,0,2,1,1,0,0,0,0,0,0,0,0,0
438179,21000,210,0,-2,4,0,4,0,0,0,0,0,0,1,0,1,2,0,2,0,0,0,1,0,1,0,0,0,0,0,0,0,0,0
438258,21000,210,0,-2,5,0,5,0,0,0,0,0,0,0,0,0,0,0,0,1,0,1,3,0,3,1,0,1,0,0,0,0,0,0
438498,21000,210,0,-2,10,1,9,0,0,0,0,0,0,2,0,2,0,0,0,0,0,0,7,1,6,0,0,0,1,0,1,0,0,0
438504,21000,210,0,-2,2,2,0,0,0,0,0,0,0,0,0,0,2,2,0,0,0,0,0,0,0,0,0,0,0,0,0,0,0,0
438586,21000,210,0,-2,1,1,0,0,0,0,0,0,0,1,1,0,0,0,0,0,0,0,0,0,0,0,0,0,0,0,0,0,0,0
438708,21000,210,0,-2,3,1,2,0,0,0,0,0,0,0,0,0,0,0,0,0,0,0,3,1,2,0,0,0,0,0,0,0,0,0
439118,21000,210,0,-2,2,0,2,0,0,0,0,0,0,0,0,0,0,0,0,0,0,0,1,0,1,0,0,0,1,0,1,0,0,0
439367,21000,210,0,-2,5,1,4,0,0,0,0,0,0,0,0,0,2,0,2,0,0,0,3,1,2,0,0,0,0,0,0,0,0,0
439446,21000,210,0,-2,1,1,0,0,0,0,1,1,0,0,0,0,0,0,0,0,0,0,0,0,0,0,0,0,0,0,0,0,0,0
439570,21000,210,0,-2,8,1,7,0,0,0,0,0,0,2,0,2,0,0,0,0,0,0,6,1,5,0,0,0,0,0,0,0,0,0
439701,21000,210,0,-2,1,1,0,0,0,0,0,0,0,0,0,0,0,0,0,0,0,0,1,1,0,0,0,0,0,0,0,0,0,0
439738,21000,210,0,-2,1,0,1,0,0,0,0,0,0,1,0,1,0,0,0,0,0,0,0,0,0,0,0,0,0,0,0,0,0,0
439792,21000,210,0,-2,4,0,4,0,0,0,0,0,0,2,0,2,0,0,0,0,0,0,2,0,2,0,0,0,0,0,0,0,0,0
440031,21000,210,0,-2,10,2,8,0,0,0,1,0,1,2,0,2,0,0,0,0,0,0,6,1,5,0,0,0,1,1,0,0,0,0
440059,21000,210,0,-2,13,12,1,0,0,0,1,1,0,1,1,0,1,1,0,0,0,0,10,9,1,0,0,0,0,0,0,0,0,0
440262,21000,210,0,-2,1,1,0,0,0,0,0,0,0,0,0,0,1,1,0,0,0,0,0,0,0,0,0,0,0,0,0,0,0,0
440396,21000,210,0,-2,1,0,1,0,0,0,0,0,0,0,0,0,0,0,0,0,0,0,1,0,1,0,0,0,0,0,0,0,0,0
440402,21000,210,0,-2,12,4,8,0,0,0,0,0,0,0,0,0,1,1,0,0,0,0,11,3,8,0,0,0,0,0,0,0,0,0
440651,21000,210,0,-2,1,0,1,0,0,0,0,0,0,0,0,0,1,0,1,0,0,0,0,0,0,0,0,0,0,0,0,0,0,0
440794,21000,210,0,-2,1,0,1,0,0,0,0,0,0,1,0,1,0,0,0,0,0,0,0,0,0,0,0,0,0,0,0,0,0,0
440916,21000,210,0,-2,13,7,6,0,0,0,1,1,0,7,2,5,0,0,0,0,0,0,5,4,1,0,0,0,0,0,0,0,0,0
441025,21000,210,0,-2,3,3,0,0,0,0,0,0,0,0,0,0,0,0,0,0,0,0,3,3,0,0,0,0,0,0,0,0,0,0
441052,21000,210,0,-2,5,2,3,0,0,0,0,0,0,0,0,0,2,2,0,0,0,0,2,0,2,1,0,1,0,0,0,0,0,0
441131,21000,210,0,-2,1,1,0,0,0,0,0,0,0,0,0,0,0,0,0,0,0,0,1,1,0,0,0,0,0,0,0,0,0,0
441229,21000,210,0,-2,18,7,11,0,0,0,0,0,0,1,0,1,4,3,1,0,0,0,10,3,7,0,0,0,3,1,2,0,0,0
441371,21000,210,0,-2,50,9,41,0,0,0,1,0,1,20,2,18,3,2,1,0,0,0,23,5,18,1,0,1,2,0,2,0,0,0
441423,21000,210,0,-2,3,2,1,0,0,0,0,0,0,0,0,0,3,2,1,0,0,0,0,0,0,0,0,0,0,0,0,0,0,0
441609,21000,210,0,-2,1,1,0,0,0,0,0,0,0,0,0,0,0,0,0,0,0,0,1,1,0,0,0,0,0,0,0,0,0,0
441636,21000,210,0,-2,4,1,3,0,0,0,0,0,0,1,0,1,0,0,0,0,0,0,3,1,2,0,0,0,0,0,0,0,0,0
441742,21000,210,0,-2,2,1,1,0,0,0,1,1,0,1,0,1,0,0,0,0,0,0,0,0,0,0,0,0,0,0,0,0,0,0
441760,21000,210,0,-2,6,1,5,1,0,1,0,0,0,0,0,0,1,1,0,0,0,0,3,0,3,0,0,0,1,0,1,0,0,0
441900,21000,210,0,-2,13,6,7,0,0,0,1,0,1,2,1,1,2,1,1,0,0,0,8,4,4,0,0,0,0,0,0,0,0,0
441937,21000,210,0,-2,5,2,3,0,0,0,1,1,0,0,0,0,2,0,2,0,0,0,0,0,0,2,1,1,0,0,0,0,0,0
441982,21000,210,0,-2,1,0,1,0,0,0,0,0,0,0,0,0,1,0,1,0,0,0,0,0,0,0,0,0,0,0,0,0,0,0
442134,21000,210,0,-2,2,0,2,0,0,0,0,0,0,0,0,0,1,0,1,0,0,0,1,0,1,0,0,0,0,0,0,0,0,0
442295,21000,210,0,-2,1,1,0,0,0,0,0,0,0,0,0,0,0,0,0,0,0,0,1,1,0,0,0,0,0,0,0,0,0,0
442356,21000,210,0,-2,16,0,16,0,0,0,1,0,1,0,0,0,0,0,0,0,0,0,15,0,15,0,0,0,0,0,0,0,0,0
442383,21000,210,0,-2,7,1,6,0,0,0,0,0,0,0,0,0,0,0,0,0,0,0,7,1,6,0,0,0,0,0,0,0,0,0
442426,21000,210,0,-2,2,1,1,0,0,0,0,0,0,0,0,0,0,0,0,0,0,0,2,1,1,0,0,0,0,0,0,0,0,0
442444,21000,210,0,-2,4,2,2,0,0,0,0,0,0,0,0,0,0,0,0,0,0,0,3,2,1,0,0,0,1,0,1,0,0,0
442602,21000,210,0,-2,5,0,5,0,0,0,0,0,0,0,0,0,1,0,1,0,0,0,3,0,3,1,0,1,0,0,0,0,0,0
442781,21000,210,0,-2,4,2,2,2,0,2,2,2,0,0,0,0,0,0,0,0,0,0,0,0,0,0,0,0,0,0,0,0,0,0
442806,21000,210,0,-2,29,17,12,0,0,0,4,1,3,1,0,1,1,0,1,0,0,0,23,16,7,0,0,0,0,0,0,0,0,0
442930,21000,210,0,-2,1,0,1,0,0,0,0,0,0,0,0,0,0,0,0,0,0,0,1,0,1,0,0,0,0,0,0,0,0,0
443128,21000,210,0,-2,1,1,0,0,0,0,0,0,0,0,0,0,0,0,0,0,0,0,1,1,0,0,0,0,0,0,0,0,0,0
443261,21000,210,0,-2,5,1,4,0,0,0,0,0,0,3,1,2,0,0,0,0,0,0,2,0,2,0,0,0,0,0,0,0,0,0
443331,21000,210,0,-2,3,0,3,0,0,0,1,0,1,0,0,0,0,0,0,0,0,0,2,0,2,0,0,0,0,0,0,0,0,0
443377,21000,210,0,-2,3,3,0,0,0,0,0,0,0,0,0,0,0,0,0,0,0,0,3,3,0,0,0,0,0,0,0,0,0,0
443410,21000,210,0,-2,3,1,2,0,0,0,0,0,0,0,0,0,0,0,0,0,0,0,3,1,2,0,0,0,0,0,0,0,0,0
443492,21000,210,0,-2,2,1,1,0,0,0,0,0,0,0,0,0,0,0,0,0,0,0,2,1,1,0,0,0,0,0,0,0,0,0
443599,21000,210,0,-2,1,1,0,0,0,0,0,0,0,0,0,0,0,0,0,0,0,0,1,1,0,0,0,0,0,0,0,0,0,0
443650,21000,210,0,-2,3,1,2,0,0,0,0,0,0,0,0,0,0,0,0,0,0,0,3,1,2,0,0,0,0,0,0,0,0,0
443748,21000,210,0,-2,5,1,4,1,0,1,0,0,0,3,1,2,0,0,0,0,0,0,0,0,0,1,0,1,0,0,0,0,0,0
444088,21000,210,0,-2,4,0,4,1,0,1,0,0,0,0,0,0,1,0,1,1,0,1,1,0,1,0,0,0,0,0,0,0,0,0
444130,21000,210,0,-2,6,3,3,0,0,0,0,0,0,2,1,1,0,0,0,0,0,0,4,2,2,0,0,0,0,0,0,0,0,0
444556,21000,210,0,-2,5,3,2,0,0,0,0,0,0,0,0,0,0,0,0,1,0,1,1,0,1,1,1,0,2,2,0,0,0,0
444565,21000,210,0,-2,1,1,0,0,0,0,0,0,0,0,0,0,0,0,0,0,0,0,1,1,0,0,0,0,0,0,0,0,0,0
444787,21000,210,0,-2,65,7,58,0,0,0,1,0,1,10,0,10,0,0,0,0,0,0,47,5,42,0,0,0,7,2,5,0,0,0
444811,21000,210,0,-2,3,1,2,0,0,0,0,0,0,2,1,1,0,0,0,0,0,0,1,0,1,0,0,0,0,0,0,0,0,0
444866,21000,210,0,-2,3,0,3,0,0,0,0,0,0,1,0,1,0,0,0,0,0,0,1,0,1,1,0,1,0,0,0,0,0,0
444954,21000,210,0,-2,7,3,4,0,0,0,0,0,0,0,0,0,1,0,1,0,0,0,6,3,3,0,0,0,0,0,0,0,0,0
445027,21000,210,0,-2,6,2,4,1,0,1,0,0,0,2,1,1,0,0,0,0,0,0,3,1,2,0,0,0,0,0,0,0,0,0
445188,21000,210,0,-2,32,18,14,1,0,1,1,1,0,2,2,0,2,1,1,0,0,0,14,5,9,1,0,1,4,4,0,7,5,2
445203,21000,210,0,-2,1,0,1,0,0,0,0,0,0,0,0,0,0,0,0,0,0,0,1,0,1,0,0,0,0,0,0,0,0,0
445230,21000,210,0,-2,4,2,2,0,0,0,0,0,0,1,0,1,1,1,0,0,0,0,2,1,1,0,0,0,0,0,0,0,0,0
445461,21000,210,0,-2,4,2,2,0,0,0,0,0,0,2,0,2,0,0,0,0,0,0,1,1,0,0,0,0,1,1,0,0,0,0
445692,21000,210,0,-2,2,2,0,0,0,0,0,0,0,0,0,0,0,0,0,0,0,0,2,2,0,0,0,0,0,0,0,0,0,0
445735,21000,210,0,-2,9,4,5,0,0,0,0,0,0,0,0,0,3,2,1,0,0,0,6,2,4,0,0,0,0,0,0,0,0,0
445744,21000,210,0,-2,1,0,1,0,0,0,0,0,0,0,0,0,0,0,0,0,0,0,1,0,1,0,0,0,0,0,0,0,0,0
445869,21000,210,0,-2,5,2,3,0,0,0,0,0,0,1,0,1,0,0,0,0,0,0,3,2,1,0,0,0,1,0,1,0,0,0
445948,21000,210,0,-2,30,11,19,0,0,0,1,0,1,6,2,4,9,1,8,1,1,0,10,4,6,2,2,0,1,1,0,0,0,0
446048,21000,210,0,-2,9,6,3,0,0,0,1,0,1,0,0,0,1,1,0,0,0,0,7,5,2,0,0,0,0,0,0,0,0,0
446118,21000,210,0,-2,14,3,11,0,0,0,3,1,2,3,0,3,4,1,3,0,0,0,4,1,3,0,0,0,0,0,0,0,0,0
446127,21000,210,0,-2,1,0,1,0,0,0,0,0,0,0,0,0,0,0,0,0,0,0,1,0,1,0,0,0,0,0,0,0,0,0
446385,21000,210,0,-2,1,0,1,0,0,0,1,0,1,0,0,0,0,0,0,0,0,0,0,0,0,0,0,0,0,0,0,0,0,0
446552,21000,210,0,-2,18,10,8,0,0,0,0,0,0,1,1,0,4,3,1,0,0,0,12,5,7,1,1,0,0,0,0,0,0,0
446561,21000,210,0,-2,8,4,4,0,0,0,1,0,1,1,1,0,1,1,0,0,0,0,5,2,3,0,0,0,0,0,0,0,0,0
446604,21000,210,0,-2,12,12,0,0,0,0,0,0,0,0,0,0,0,0,0,0,0,0,12,12,0,0,0,0,0,0,0,0,0,0
446640,21000,210,0,-2,6,6,0,0,0,0,1,1,0,0,0,0,0,0,0,0,0,0,3,3,0,0,0,0,2,2,0,0,0,0
446774,21000,210,0,-2,7,3,4,0,0,0,0,0,0,0,0,0,0,0,0,0,0,0,7,3,4,0,0,0,0,0,0,0,0,0
447014,21000,210,0,-2,1,0,1,0,0,0,0,0,0,0,0,0,0,0,0,0,0,0,1,0,1,0,0,0,0,0,0,0,0,0
447263,21000,210,0,-2,43,5,38,0,0,0,1,0,1,2,1,1,0,0,0,0,0,0,27,2,25,0,0,0,13,2,11,0,0,0
447351,21000,210,0,-2,4,1,3,0,0,0,0,0,0,0,0,0,1,0,1,0,0,0,3,1,2,0,0,0,0,0,0,0,0,0
447421,21000,210,0,-2,4,1,3,0,0,0,0,0,0,1,1,0,0,0,0,0,0,0,3,0,3,0,0,0,0,0,0,0,0,0
447582,21000,210,0,-2,8,3,5,0,0,0,0,0,0,1,1,0,0,0,0,0,0,0,7,2,5,0,0,0,0,0,0,0,0,0
447591,21000,210,0,-2,7,1,6,0,0,0,0,0,0,5,0,5,0,0,0,0,0,0,1,0,1,1,1,0,0,0,0,0,0,0
447689,21000,210,0,-2,13,4,9,0,0,0,0,0,0,3,1,2,0,0,0,0,0,0,10,3,7,0,0,0,0,0,0,0,0,0
447768,21000,210,0,-2,5,1,4,0,0,0,0,0,0,3,0,3,1,1,0,0,0,0,1,0,1,0,0,0,0,0,0,0,0,0
447777,21000,210,0,-2,3,1,2,0,0,0,0,0,0,0,0,0,1,0,1,0,0,0,2,1,1,0,0,0,0,0,0,0,0,0
447953,21000,210,0,-2,2,2,0,0,0,0,1,1,0,0,0,0,1,1,0,0,0,0,0,0,0,0,0,0,0,0,0,0,0,0
448354,21000,210,0,-2,2,1,1,0,0,0,0,0,0,0,0,0,0,0,0,0,0,0,2,1,1,0,0,0,0,0,0,0,0,0
448594,21000,210,0,-2,3,1,2,0,0,0,1,1,0,1,0,1,0,0,0,0,0,0,0,0,0,0,0,0,1,0,1,0,0,0
448600,21000,210,0,-2,7,1,6,0,0,0,0,0,0,0,0,0,0,0,0,0,0,0,7,1,6,0,0,0,0,0,0,0,0,0
448673,21000,210,0,-2,15,3,12,0,0,0,1,1,0,0,0,0,1,0,1,0,0,0,12,2,10,0,0,0,1,0,1,0,0,0
448859,21000,210,0,-2,2,2,0,0,0,0,0,0,0,0,0,0,0,0,0,0,0,0,2,2,0,0,0,0,0,0,0,0,0,0
449074,21000,210,0,-2,4,1,3,0,0,0,0,0,0,0,0,0,1,0,1,0,0,0,2,1,1,1,0,1,0,0,0,0,0,0
449250,21000,210,0,-2,8,1,7,0,0,0,0,0,0,1,0,1,2,0,2,1,0,1,4,1,3,0,0,0,0,0,0,0,0,0
449339,21000,210,0,-2,3,1,2,0,0,0,0,0,0,0,0,0,1,0,1,0,0,0,1,0,1,0,0,0,1,1,0,0,0,0
449524,21000,210,0,-2,3,0,3,0,0,0,0,0,0,0,0,0,0,0,0,0,0,0,3,0,3,0,0,0,0,0,0,0,0,0
449728,21000,210,0,-2,2,0,2,0,0,0,0,0,0,0,0,0,0,0,0,0,0,0,2,0,2,0,0,0,0,0,0,0,0,0
449764,21000,210,0,-2,1,1,0,0,0,0,0,0,0,0,0,0,0,0,0,0,0,0,1,1,0,0,0,0,0,0,0,0,0,0
449870,21000,210,0,-2,1,1,0,0,0,0,0,0,0,0,0,0,0,0,0,0,0,0,1,1,0,0,0,0,0,0,0,0,0,0
449889,21000,210,0,-2,4,0,4,0,0,0,0,0,0,1,0,1,0,0,0,0,0,0,3,0,3,0,0,0,0,0,0,0,0,0
449898,21000,210,0,-2,4,1,3,0,0,0,0,0,0,1,0,1,0,0,0,0,0,0,3,1,2,0,0,0,0,0,0,0,0,0
449922,21000,210,0,-2,1,1,0,0,0,0,1,1,0,0,0,0,0,0,0,0,0,0,0,0,0,0,0,0,0,0,0,0,0,0
450058,21000,210,0,-2,15,2,13,0,0,0,1,0,1,2,0,2,0,0,0,0,0,0,11,2,9,1,0,1,0,0,0,0,0,0
450067,21000,210,0,-2,4,0,4,0,0,0,0,0,0,0,0,0,0,0,0,0,0,0,4,0,4,0,0,0,0,0,0,0,0,0
450128,21000,210,0,-2,3,0,3,0,0,0,0,0,0,0,0,0,0,0,0,0,0,0,3,0,3,0,0,0,0,0,0,0,0,0
450304,21000,210,0,-2,1,1,0,0,0,0,0,0,0,1,1,0,0,0,0,0,0,0,0,0,0,0,0,0,0,0,0,0,0,0
450571,21000,210,0,-2,1,0,1,0,0,0,0,0,0,0,0,0,0,0,0,0,0,0,1,0,1,0,0,0,0,0,0,0,0,0
450696,21000,210,0,-2,5,1,4,0,0,0,0,0,0,1,1,0,1,0,1,0,0,0,3,0,3,0,0,0,0,0,0,0,0,0
450702,21000,210,0,-2,2,0,2,0,0,0,0,0,0,0,0,0,0,0,0,0,0,0,2,0,2,0,0,0,0,0,0,0,0,0
450933,21000,210,0,-2,4,0,4,0,0,0,0,0,0,1,0,1,0,0,0,0,0,0,3,0,3,0,0,0,0,0,0,0,0,0
451103,21000,210,0,-2,3,0,3,0,0,0,0,0,0,0,0,0,3,0,3,0,0,0,0,0,0,0,0,0,0,0,0,0,0,0
451228,21000,210,0,-2,1,1,0,0,0,0,0,0,0,0,0,0,0,0,0,0,0,0,1,1,0,0,0,0,0,0,0,0,0,0
451404,21000,210,0,-2,6,6,0,0,0,0,0,0,0,0,0,0,0,0,0,0,0,0,6,6,0,0,0,0,0,0,0,0,0,0
451477,21000,210,0,-2,6,5,1,0,0,0,0,0,0,0,0,0,0,0,0,0,0,0,5,4,1,1,1,0,0,0,0,0,0,0
451510,21000,210,0,-2,2,1,1,0,0,0,0,0,0,0,0,0,0,0,0,0,0,0,2,1,1,0,0,0,0,0,0,0,0,0
451556,21000,210,0,-2,26,12,14,0,0,0,0,0,0,0,0,0,25,11,14,0,0,0,1,1,0,0,0,0,0,0,0,0,0,0
451750,21000,210,0,-2,8,0,8,0,0,0,1,0,1,1,0,1,0,0,0,0,0,0,6,0,6,0,0,0,0,0,0,0,0,0
451927,21000,210,0,-2,1,1,0,0,0,0,0,0,0,0,0,0,0,0,0,0,0,0,1,1,0,0,0,0,0,0,0,0,0,0
452124,21000,210,0,-2,5,0,5,0,0,0,0,0,0,1,0,1,0,0,0,0,0,0,4,0,4,0,0,0,0,0,0,0,0,0
452373,21000,210,0,-2,1,0,1,0,0,0,0,0,0,1,0,1,0,0,0,0,0,0,0,0,0,0,0,0,0,0,0,0,0,0
452948,21000,210,0,-2,6,0,6,0,0,0,0,0,0,1,0,1,0,0,0,0,0,0,5,0,5,0,0,0,0,0,0,0,0,0
454218,21000,210,0,-2,75,11,64,0,0,0,4,2,2,18,3,15,4,1,3,0,0,0,41,4,37,3,0,3,5,1,4,0,0,0
454698,21000,210,0,-2,6,1,5,0,0,0,0,0,0,1,0,1,3,0,3,0,0,0,2,1,1,0,0,0,0,0,0,0,0,0
454786,21000,210,0,-2,3,1,2,0,0,0,0,0,0,1,0,1,0,0,0,0,0,0,2,1,1,0,0,0,0,0,0,0,0,0
454810,21000,210,0,-2,64,32,32,1,0,1,3,0,3,5,1,4,2,2,0,0,0,0,46,26,20,5,2,3,2,1,1,0,0,0
454829,21000,210,0,-2,13,0,13,0,0,0,1,0,1,0,0,0,0,0,0,0,0,0,11,0,11,0,0,0,1,0,1,0,0,0
454856,21000,210,0,-2,2,0,2,0,0,0,0,0,0,0,0,0,0,0,0,0,0,0,2,0,2,0,0,0,0,0,0,0,0,0
455114,21000,210,0,-2,19,13,6,0,0,0,0,0,0,0,0,0,1,1,0,0,0,0,17,11,6,0,0,0,1,1,0,0,0,0
455196,21000,210,0,-2,15,1,14,0,0,0,0,0,0,5,1,4,2,0,2,0,0,0,8,0,8,0,0,0,0,0,0,0,0,0
455257,21000,210,0,-2,1,1,0,0,0,0,0,0,0,0,0,0,0,0,0,0,0,0,1,1,0,0,0,0,0,0,0,0,0,0
455406,21000,210,0,-2,5,2,3,0,0,0,0,0,0,0,0,0,0,0,0,0,0,0,4,1,3,1,1,0,0,0,0,0,0,0
455433,21000,210,0,-2,1,1,0,0,0,0,0,0,0,0,0,0,0,0,0,0,0,0,0,0,0,1,1,0,0,0,0,0,0,0
455479,21000,210,0,-2,3,1,2,0,0,0,0,0,0,0,0,0,0,0,0,0,0,0,3,1,2,0,0,0,0,0,0,0,0,0
455512,21000,210,0,-2,1,0,1,0,0,0,0,0,0,0,0,0,0,0,0,0,0,0,1,0,1,0,0,0,0,0,0,0,0,0
455628,21000,210,0,-2,6,3,3,0,0,0,0,0,0,5,2,3,0,0,0,0,0,0,1,1,0,0,0,0,0,0,0,0,0,0
455664,21000,210,0,-2,12,4,8,0,0,0,0,0,0,2,0,2,1,1,0,0,0,0,7,2,5,2,1,1,0,0,0,0,0,0
455804,21000,210,0,-2,3,2,1,0,0,0,0,0,0,0,0,0,0,0,0,0,0,0,3,2,1,0,0,0,0,0,0,0,0,0
455813,21000,210,0,-2,1,0,1,0,0,0,0,0,0,0,0,0,0,0,0,0,0,0,1,0,1,0,0,0,0,0,0,0,0,0
456038,21000,210,0,-2,2,0,2,0,0,0,0,0,0,0,0,0,1,0,1,0,0,0,1,0,1,0,0,0,0,0,0,0,0,0
456205,21000,210,0,-2,5,2,3,0,0,0,0,0,0,1,0,1,0,0,0,0,0,0,4,2,2,0,0,0,0,0,0,0,0,0
456214,21000,210,0,-2,4,3,1,0,0,0,0,0,0,0,0,0,1,1,0,0,0,0,3,2,1,0,0,0,0,0,0,0,0,0
456454,21000,210,0,-2,5,3,2,0,0,0,0,0,0,0,0,0,0,0,0,0,0,0,5,3,2,0,0,0,0,0,0,0,0,0
456490,21000,210,0,-2,1,1,0,0,0,0,0,0,0,0,0,0,1,1,0,0,0,0,0,0,0,0,0,0,0,0,0,0,0,0
456542,21000,210,0,-2,3,1,2,0,0,0,0,0,0,1,0,1,0,0,0,0,0,0,2,1,1,0,0,0,0,0,0,0,0,0
456579,21000,210,0,-2,2,1,1,0,0,0,0,0,0,0,0,0,0,0,0,0,0,0,2,1,1,0,0,0,0,0,0,0,0,0
456852,21000,210,0,-2,1,1,0,0,0,0,0,0,0,1,1,0,0,0,0,0,0,0,0,0,0,0,0,0,0,0,0,0,0,0
456959,21000,210,0,-2,2,0,2,0,0,0,1,0,1,0,0,0,0,0,0,0,0,0,0,0,0,1,0,1,0,0,0,0,0,0
457086,21000,210,0,-2,1,1,0,0,0,0,1,1,0,0,0,0,0,0,0,0,0,0,0,0,0,0,0,0,0,0,0,0,0,0
457101,21000,210,0,-2,8,2,6,0,0,0,1,1,0,1,0,1,1,1,0,0,0,0,4,0,4,0,0,0,1,0,1,0,0,0
457110,21000,210,0,-2,1,0,1,0,0,0,0,0,0,0,0,0,0,0,0,0,0,0,1,0,1,0,0,0,0,0,0,0,0,0
457299,21000,210,0,-2,3,1,2,0,0,0,1,0,1,0,0,0,2,1,1,0,0,0,0,0,0,0,0,0,0,0,0,0,0,0
457527,21000,210,0,-2,4,0,4,0,0,0,0,0,0,0,0,0,1,0,1,0,0,0,3,0,3,0,0,0,0,0,0,0,0,0
458210,21000,210,0,-2,5,2,3,0,0,0,2,0,2,0,0,0,1,1,0,0,0,0,2,1,1,0,0,0,0,0,0,0,0,0
458229,21000,210,0,-2,3,0,3,0,0,0,0,0,0,0,0,0,1,0,1,0,0,0,2,0,2,0,0,0,0,0,0,0,0,0
458405,21000,210,0,-2,3,2,1,0,0,0,0,0,0,2,2,0,0,0,0,0,0,0,0,0,0,1,0,1,0,0,0,0,0,0
458441,21000,210,0,-2,1,0,1,0,0,0,0,0,0,1,0,1,0,0,0,0,0,0,0,0,0,0,0,0,0,0,0,0,0,0
458681,21000,210,0,-2,5,2,3,0,0,0,0,0,0,1,1,0,0,0,0,0,0,0,4,1,3,0,0,0,0,0,0,0,0,0
459204,21000,210,0,-2,22,1,21,0,0,0,8,0,8,3,0,3,0,0,0,0,0,0,10,1,9,1,0,1,0,0,0,0,0,0
459213,21000,210,0,-2,14,2,12,0,0,0,3,0,3,0,0,0,1,0,1,1,0,1,6,1,5,0,0,0,3,1,2,0,0,0
459259,21000,210,0,-2,4,0,4,0,0,0,2,0,2,1,0,1,0,0,0,0,0,0,1,0,1,0,0,0,0,0,0,0,0,0
459268,21000,210,0,-2,2,0,2,0,0,0,0,0,0,1,0,1,0,0,0,0,0,0,1,0,1,0,0,0,0,0,0,0,0,0
459727,21000,210,0,-2,3,1,2,0,0,0,0,0,0,1,0,1,0,0,0,0,0,0,2,1,1,0,0,0,0,0,0,0,0,0
459736,21000,210,0,-2,2,0,2,0,0,0,0,0,0,0,0,0,0,0,0,0,0,0,1,0,1,1,0,1,0,0,0,0,0,0
459745,21000,210,0,-2,2,0,2,0,0,0,1,0,1,0,0,0,0,0,0,0,0,0,1,0,1,0,0,0,0,0,0,0,0,0
459824,21000,210,0,-2,9,2,7,0,0,0,1,0,1,1,0,1,0,0,0,0,0,0,7,2,5,0,0,0,0,0,0,0,0,0
459842,21000,210,0,-2,4,1,3,0,0,0,0,0,0,1,0,1,0,0,0,0,0,0,3,1,2,0,0,0,0,0,0,0,0,0
459851,21000,210,0,-2,6,2,4,0,0,0,0,0,0,0,0,0,0,0,0,0,0,0,6,2,4,0,0,0,0,0,0,0,0,0
459949,21000,210,0,-2,24,11,13,0,0,0,0,0,0,1,0,1,8,6,2,0,0,0,13,5,8,0,0,0,1,0,1,1,0,1
460020,21000,210,0,-2,1,0,1,0,0,0,0,0,0,1,0,1,0,0,0,0,0,0,0,0,0,0,0,0,0,0,0,0,0,0
460136,21000,210,0,-2,8,0,8,0,0,0,0,0,0,3,0,3,2,0,2,0,0,0,2,0,2,1,0,1,0,0,0,0,0,0
460181,21000,210,0,-2,1,0,1,0,0,0,0,0,0,0,0,0,0,0,0,0,0,0,1,0,1,0,0,0,0,0,0,0,0,0
460206,21000,210,0,-2,4,2,2,0,0,0,0,0,0,0,0,0,2,2,0,0,0,0,2,0,2,0,0,0,0,0,0,0,0,0
460394,21000,210,0,-2,4,2,2,0,0,0,0,0,0,1,1,0,1,1,0,0,0,0,2,0,2,0,0,0,0,0,0,0,0,0
460464,21000,210,0,-2,3,2,1,1,1,0,0,0,0,0,0,0,1,1,0,0,0,0,1,0,1,0,0,0,0,0,0,0,0,0
460543,21000,210,0,-2,3,3,0,0,0,0,0,0,0,0,0,0,0,0,0,0,0,0,2,2,0,1,1,0,0,0,0,0,0,0
460677,21000,210,0,-2,3,0,3,0,0,0,0,0,0,0,0,0,3,0,3,0,0,0,0,0,0,0,0,0,0,0,0,0,0,0
460738,21000,210,0,-2,2,0,2,0,0,0,0,0,0,0,0,0,0,0,0,0,0,0,1,0,1,0,0,0,1,0,1,0,0,0
460756,21000,210,0,-2,1,0,1,0,0,0,1,0,1,0,0,0,0,0,0,0,0,0,0,0,0,0,0,0,0,0,0,0,0,0
460826,21000,210,0,-2,6,1,5,0,0,0,0,0,0,5,1,4,1,0,1,0,0,0,0,0,0,0,0,0,0,0,0,0,0,0
460835,21000,210,0,-2,3,1,2,0,0,0,0,0,0,0,0,0,0,0,0,0,0,0,3,1,2,0,0,0,0,0,0,0,0,0
461148,21000,210,0,-2,3,0,3,0,0,0,0,0,0,0,0,0,1,0,1,0,0,0,2,0,2,0,0,0,0,0,0,0,0,0
461218,21000,210,0,-2,1,0,1,0,0,0,0,0,0,0,0,0,0,0,0,0,0,0,1,0,1,0,0,0,0,0,0,0,0,0
461689,21000,210,0,-2,5,3,2,0,0,0,0,0,0,0,0,0,1,1,0,0,0,0,4,2,2,0,0,0,0,0,0,0,0,0
461795,21000,210,0,-2,4,3,1,0,0,0,2,1,1,1,1,0,0,0,0,0,0,0,1,1,0,0,0,0,0,0,0,0,0,0
464226,21000,210,0,-2,4,1,3,0,0,0,0,0,0,0,0,0,2,1,1,0,0,0,2,0,2,0,0,0,0,0,0,0,0,0
475033,21000,210,0,-2,9,2,7,0,0,0,1,0,1,2,0,2,3,2,1,0,0,0,3,0,3,0,0,0,0,0,0,0,0,0
475121,21000,210,0,-2,16,1,15,1,0,1,0,0,0,2,0,2,0,0,0,0,0,0,13,1,12,0,0,0,0,0,0,0,0,0
475176,21000,210,0,-2,2,1,1,0,0,0,0,0,0,0,0,0,0,0,0,0,0,0,0,0,0,2,1,1,0,0,0,0,0,0
475398,21000,210,0,-2,1,0,1,0,0,0,0,0,0,0,0,0,0,0,0,0,0,0,1,0,1,0,0,0,0,0,0,0,0,0
475495,21000,210,0,-2,11,5,6,0,0,0,0,0,0,0,0,0,1,1,0,0,0,0,10,4,6,0,0,0,0,0,0,0,0,0
475608,21000,210,0,-2,4,2,2,0,0,0,0,0,0,0,0,0,0,0,0,0,0,0,4,2,2,0,0,0,0,0,0,0,0,0
475714,21000,210,0,-2,1,0,1,0,0,0,0,0,0,0,0,0,1,0,1,0,0,0,0,0,0,0,0,0,0,0,0,0,0,0
476717,21000,210,0,-2,1,1,0,0,0,0,0,0,0,0,0,0,0,0,0,0,0,0,1,1,0,0,0,0,0,0,0,0,0,0
476726,21000,210,0,-2,11,3,8,0,0,0,0,0,0,0,0,0,10,3,7,1,0,1,0,0,0,0,0,0,0,0,0,0,0,0
476975,21000,210,0,-2,2,1,1,0,0,0,0,0,0,0,0,0,0,0,0,0,0,0,2,1,1,0,0,0,0,0,0,0,0,0
477039,21000,210,0,-2,12,0,12,0,0,0,1,0,1,5,0,5,2,0,2,0,0,0,4,0,4,0,0,0,0,0,0,0,0,0
480073,21000,210,0,-2,3,1,2,0,0,0,1,1,0,0,0,0,0,0,0,0,0,0,2,0,2,0,0,0,0,0,0,0,0,0
480657,21000,210,0,-2,1,0,1,0,0,0,0,0,0,0,0,0,0,0,0,0,0,0,1,0,1,0,0,0,0,0,0,0,0,0
480790,21000,210,0,-2,6,3,3,0,0,0,1,0,1,0,0,0,0,0,0,0,0,0,5,3,2,0,0,0,0,0,0,0,0,0
480824,21000,210,0,-2,4,0,4,0,0,0,0,0,0,1,0,1,1,0,1,0,0,0,2,0,2,0,0,0,0,0,0,0,0,0
480833,21000,210,0,-2,5,1,4,0,0,0,0,0,0,2,0,2,1,1,0,0,0,0,2,0,2,0,0,0,0,0,0,0,0,0
480967,21000,210,0,-2,2,1,1,2,1,1,0,0,0,0,0,0,0,0,0,0,0,0,0,0,0,0,0,0,0,0,0,0,0,0
481535,21000,210,0,-2,2,2,0,0,0,0,1,1,0,0,0,0,0,0,0,0,0,0,0,0,0,0,0,0,0,0,0,1,1,0
481775,21000,210,0,-2,1,1,0,0,0,0,0,0,0,0,0,0,1,1,0,0,0,0,0,0,0,0,0,0,0,0,0,0,0,0
482149,21000,210,0,-2,84,44,40,0,0,0,12,7,5,5,2,3,7,4,3,0,0,0,49,24,25,0,0,0,2,2,0,9,5,4
482158,21000,210,0,-2,18,7,11,0,0,0,3,2,1,0,0,0,0,0,0,0,0,0,15,5,10,0,0,0,0,0,0,0,0,0
482477,21000,210,0,-2,1,1,0,0,0,0,0,0,0,0,0,0,0,0,0,0,0,0,1,1,0,0,0,0,0,0,0,0,0,0
482635,21000,210,0,-2,1,1,0,0,0,0,0,0,0,0,0,0,0,0,0,0,0,0,1,1,0,0,0,0,0,0,0,0,0,0
482680,21000,210,0,-2,39,24,15,0,0,0,3,3,0,2,0,2,2,1,1,0,0,0,27,16,11,0,0,0,4,3,1,1,1,0
482699,21000,210,0,-2,3,1,2,0,0,0,0,0,0,0,0,0,0,0,0,0,0,0,3,1,2,0,0,0,0,0,0,0,0,0
482705,21000,210,0,-2,9,5,4,0,0,0,0,0,0,1,1,0,0,0,0,0,0,0,1,1,0,0,0,0,5,2,3,2,1,1
482936,21000,210,0,-2,12,10,2,0,0,0,2,1,1,0,0,0,0,0,0,0,0,0,6,5,1,0,0,0,0,0,0,4,4,0
482990,21000,210,0,-2,1,0,1,0,0,0,0,0,0,0,0,0,0,0,0,0,0,0,1,0,1,0,0,0,0,0,0,0,0,0
483018,21000,210,0,-2,1,0,1,0,0,0,0,0,0,0,0,0,0,0,0,0,0,0,1,0,1,0,0,0,0,0,0,0,0,0
483036,21000,210,0,-2,7,4,3,0,0,0,1,0,1,1,0,1,0,0,0,0,0,0,1,1,0,0,0,0,0,0,0,4,3,1
483045,21000,210,0,-2,25,13,12,0,0,0,0,0,0,4,1,3,0,0,0,1,1,0,20,11,9,0,0,0,0,0,0,0,0,0
483124,21000,210,0,-2,75,32,43,0,0,0,3,1,2,3,1,2,7,3,4,0,0,0,32,16,16,2,0,2,22,8,14,6,3,3
483212,21000,210,0,-2,24,12,12,0,0,0,0,0,0,6,3,3,0,0,0,0,0,0,15,6,9,2,2,0,0,0,0,1,1,0
483595,21000,210,0,-2,32,15,17,0,0,0,0,0,0,0,0,0,31,15,16,0,0,0,1,0,1,0,0,0,0,0,0,0,0,0
483647,21000,210,0,-2,6,1,5,0,0,0,0,0,0,0,0,0,0,0,0,0,0,0,6,1,5,0,0,0,0,0,0,0,0,0
483975,21000,210,0,-2,7,5,2,0,0,0,0,0,0,1,1,0,0,0,0,0,0,0,6,4,2,0,0,0,0,0,0,0,0,0
484002,21000,210,0,-2,17,5,12,1,1,0,3,0,3,2,0,2,4,2,2,0,0,0,7,2,5,0,0,0,0,0,0,0,0,0
484066,21000,210,0,-2,6,0,6,0,0,0,0,0,0,0,0,0,0,0,0,0,0,0,6,0,6,0,0,0,0,0,0,0,0,0
484613,21000,210,0,-2,7,2,5,0,0,0,1,0,1,2,1,1,0,0,0,0,0,0,3,1,2,0,0,0,1,0,1,0,0,0
484844,21000,210,0,-2,1,0,1,0,0,0,1,0,1,0,0,0,0,0,0,0,0,0,0,0,0,0,0,0,0,0,0,0,0,0
484905,21000,210,0,-2,20,9,11,0,0,0,0,0,0,2,1,1,3,1,2,0,0,0,14,7,7,0,0,0,1,0,1,0,0,0
484932,21000,210,0,-2,2,1,1,0,0,0,0,0,0,0,0,0,0,0,0,0,0,0,2,1,1,0,0,0,0,0,0,0,0,0
485111,21000,210,0,-2,1,0,1,0,0,0,0,0,0,0,0,0,0,0,0,0,0,0,1,0,1,0,0,0,0,0,0,0,0,0
485272,21000,210,0,-2,2,0,2,0,0,0,0,0,0,0,0,0,1,0,1,0,0,0,1,0,1,0,0,0,0,0,0,0,0,0
485458,21000,210,0,-2,18,9,9,0,0,0,1,0,1,1,1,0,0,0,0,0,0,0,16,8,8,0,0,0,0,0,0,0,0,0
485519,21000,210,0,-2,1,1,0,0,0,0,0,0,0,0,0,0,0,0,0,0,0,0,1,1,0,0,0,0,0,0,0,0,0,0
485546,21000,210,0,-2,1,0,1,0,0,0,0,0,0,1,0,1,0,0,0,0,0,0,0,0,0,0,0,0,0,0,0,0,0,0
485698,21000,210,0,-2,5,4,1,0,0,0,0,0,0,1,1,0,0,0,0,0,0,0,4,3,1,0,0,0,0,0,0,0,0,0
485768,21000,210,0,-2,8,7,1,0,0,0,0,0,0,2,1,1,5,5,0,0,0,0,1,1,0,0,0,0,0,0,0,0,0,0
486053,21000,210,0,-2,2,2,0,0,0,0,0,0,0,0,0,0,0,0,0,0,0,0,2,2,0,0,0,0,0,0,0,0,0,0
486424,21000,210,0,-2,2,1,1,0,0,0,0,0,0,2,1,1,0,0,0,0,0,0,0,0,0,0,0,0,0,0,0,0,0,0
486813,21000,210,0,-2,4,2,2,0,0,0,0,0,0,0,0,0,2,1,1,0,0,0,2,1,1,0,0,0,0,0,0,0,0,0
486822,21000,210,0,-2,14,3,11,0,0,0,0,0,0,0,0,0,4,1,3,0,0,0,10,2,8,0,0,0,0,0,0,0,0,0
486840,21000,210,0,-2,122,56,66,0,0,0,19,11,8,9,4,5,5,5,0,0,0,0,74,29,45,0,0,0,2,1,1,13,6,7
486901,21000,210,0,-2,7,1,6,0,0,0,0,0,0,1,0,1,0,0,0,0,0,0,6,1,5,0,0,0,0,0,0,0,0,0
487010,21000,210,0,-2,106,65,41,0,0,0,16,12,4,8,2,6,2,1,1,0,0,0,60,40,20,1,1,0,0,0,0,19,9,10
487162,21000,210,0,-2,16,9,7,0,0,0,0,0,0,4,3,1,0,0,0,0,0,0,12,6,6,0,0,0,0,0,0,0,0,0
487302,21000,210,0,-2,2,0,2,0,0,0,0,0,0,0,0,0,0,0,0,0,0,0,2,0,2,0,0,0,0,0,0,0,0,0
487320,21000,210,0,-2,63,54,9,0,0,0,1,1,0,1,0,1,19,15,4,0,0,0,41,38,3,0,0,0,1,0,1,0,0,0
487375,21000,210,0,-2,12,5,7,1,1,0,2,1,1,2,0,2,1,1,0,0,0,0,5,2,3,1,0,1,0,0,0,0,0,0
487384,21000,210,0,-2,1,1,0,0,0,0,0,0,0,0,0,0,0,0,0,0,0,0,0,0,0,1,1,0,0,0,0,0,0,0
487393,21000,210,0,-2,8,2,6,0,0,0,0,0,0,4,1,3,1,1,0,0,0,0,0,0,0,2,0,2,1,0,1,0,0,0
487409,21000,210,0,-2,3,0,3,0,0,0,0,0,0,0,0,0,3,0,3,0,0,0,0,0,0,0,0,0,0,0,0,0,0,0
487418,21000,210,0,-2,6,3,3,0,0,0,0,0,0,1,0,1,2,1,1,0,0,0,2,1,1,0,0,0,1,1,0,0,0,0
487427,21000,210,0,-2,5,1,4,0,0,0,0,0,0,2,1,1,1,0,1,0,0,0,1,0,1,1,0,1,0,0,0,0,0,0
487445,21000,210,0,-2,4,1,3,0,0,0,0,0,0,1,0,1,1,1,0,0,0,0,0,0,0,2,0,2,0,0,0,0,0,0
487472,21000,210,0,-2,11,4,7,0,0,0,1,1,0,4,1,3,5,2,3,0,0,0,1,0,1,0,0,0,0,0,0,0,0,0
487490,21000,210,0,-2,3,1,2,0,0,0,0,0,0,1,0,1,1,0,1,0,0,0,0,0,0,0,0,0,1,1,0,0,0,0
487524,21000,210,0,-2,7,3,4,0,0,0,1,1,0,0,0,0,0,0,0,0,0,0,6,2,4,0,0,0,0,0,0,0,0,0
487588,21000,210,0,-2,2,0,2,0,0,0,0,0,0,2,0,2,0,0,0,0,0,0,0,0,0,0,0,0,0,0,0,0,0,0
487597,21000,210,0,-2,15,15,0,0,0,0,0,0,0,0,0,0,7,7,0,1,1,0,7,7,0,0,0,0,0,0,0,0,0,0
487861,21000,210,0,-2,3,1,2,0,0,0,0,0,0,0,0,0,0,0,0,0,0,0,3,1,2,0,0,0,0,0,0,0,0,0
487977,21000,210,0,-2,4,0,4,0,0,0,0,0,0,1,0,1,0,0,0,0,0,0,3,0,3,0,0,0,0,0,0,0,0,0
488077,21000,210,0,-2,1,0,1,0,0,0,1,0,1,0,0,0,0,0,0,0,0,0,0,0,0,0,0,0,0,0,0,0,0,0
488305,21000,210,0,-2,1,1,0,0,0,0,0,0,0,0,0,0,0,0,0,0,0,0,1,1,0,0,0,0,0,0,0,0,0,0
488527,21000,210,0,-2,12,5,7,0,0,0,2,0,2,0,0,0,1,1,0,0,0,0,8,3,5,0,0,0,1,1,0,0,0,0
488554,21000,210,0,-2,3,2,1,0,0,0,0,0,0,0,0,0,0,0,0,0,0,0,3,2,1,0,0,0,0,0,0,0,0,0
488572,21000,210,0,-2,11,5,6,0,0,0,5,3,2,1,0,1,0,0,0,0,0,0,4,1,3,1,1,0,0,0,0,0,0,0
488730,21000,210,0,-2,1,1,0,0,0,0,0,0,0,0,0,0,0,0,0,0,0,0,1,1,0,0,0,0,0,0,0,0,0,0
489201,21000,210,0,-2,8,4,4,0,0,0,1,0,1,1,1,0,1,0,1,0,0,0,4,3,1,0,0,0,1,0,1,0,0,0
489283,21000,210,0,-2,9,4,5,0,0,0,0,0,0,0,0,0,7,3,4,0,0,0,2,1,1,0,0,0,0,0,0,0,0,0
489779,21000,210,0,-2,6,3,3,0,0,0,0,0,0,2,1,1,0,0,0,0,0,0,3,1,2,0,0,0,1,1,0,0,0,0
489858,21000,210,0,-2,5,2,3,0,0,0,3,1,2,0,0,0,0,0,0,0,0,0,2,1,1,0,0,0,0,0,0,0,0,0
489937,21000,210,0,-2,12,8,4,0,0,0,6,5,1,1,0,1,0,0,0,0,0,0,5,3,2,0,0,0,0,0,0,0,0,0
490106,21000,210,0,-2,1,0,1,0,0,0,1,0,1,0,0,0,0,0,0,0,0,0,0,0,0,0,0,0,0,0,0,0,0,0
490133,21000,210,0,-2,3,2,1,0,0,0,0,0,0,0,0,0,0,0,0,0,0,0,0,0,0,0,0,0,3,2,1,0,0,0
490373,21000,210,0,-2,11,2,9,0,0,0,1,1,0,1,0,1,0,0,0,0,0,0,7,1,6,1,0,1,1,0,1,0,0,0
490559,21000,210,0,-2,2,1,1,0,0,0,0,0,0,1,0,1,0,0,0,0,0,0,1,1,0,0,0,0,0,0,0,0,0,0
490805,21000,210,0,-2,6,2,4,0,0,0,0,0,0,1,0,1,0,0,0,0,0,0,3,1,2,0,0,0,0,0,0,2,1,1
490878,21000,210,0,-2,2,0,2,0,0,0,0,0,0,0,0,0,1,0,1,0,0,0,1,0,1,0,0,0,0,0,0,0,0,0
490975,21000,210,0,-2,2,1,1,0,0,0,1,1,0,0,0,0,1,0,1,0,0,0,0,0,0,0,0,0,0,0,0,0,0,0
491057,21000,210,0,-2,2,2,0,0,0,0,0,0,0,0,0,0,0,0,0,0,0,0,2,2,0,0,0,0,0,0,0,0,0,0
491181,21000,210,0,-2,3,0,3,0,0,0,0,0,0,0,0,0,0,0,0,0,0,0,3,0,3,0,0,0,0,0,0,0,0,0
491525,21000,210,0,-2,1,1,0,0,0,0,0,0,0,0,0,0,0,0,0,0,0,0,1,1,0,0,0,0,0,0,0,0,0,0
491844,21000,210,0,-2,6,3,3,5,2,3,0,0,0,0,0,0,0,0,0,0,0,0,1,1,0,0,0,0,0,0,0,0,0,0
492449,21000,210,0,-2,3,1,2,0,0,0,0,0,0,0,0,0,3,1,2,0,0,0,0,0,0,0,0,0,0,0,0,0,0,0
492476,21000,210,0,-2,1,0,1,0,0,0,0,0,0,0,0,0,1,0,1,0,0,0,0,0,0,0,0,0,0,0,0,0,0,0
492607,21000,210,0,-2,1,0,1,0,0,0,0,0,0,0,0,0,0,0,0,0,0,0,1,0,1,0,0,0,0,0,0,0,0,0
492689,21000,210,0,-2,51,28,23,0,0,0,8,4,4,3,0,3,10,6,4,0,0,0,24,15,9,0,0,0,0,0,0,6,3,3
492722,21000,210,0,-2,6,0,6,0,0,0,0,0,0,1,0,1,3,0,3,0,0,0,1,0,1,1,0,1,0,0,0,0,0,0
493080,21000,210,0,-2,1,1,0,0,0,0,0,0,0,0,0,0,0,0,0,0,0,0,0,0,0,1,1,0,0,0,0,0,0,0
493646,21000,210,0,-2,7,0,7,0,0,0,0,0,0,0,0,0,0,0,0,0,0,0,7,0,7,0,0,0,0,0,0,0,0,0
494010,21000,210,0,-2,1,0,1,0,0,0,0,0,0,0,0,0,0,0,0,0,0,0,1,0,1,0,0,0,0,0,0,0,0,0
494162,21000,210,0,-2,8,1,7,0,0,0,1,0,1,4,0,4,0,0,0,0,0,0,3,1,2,0,0,0,0,0,0,0,0,0
494250,21000,210,0,-2,9,1,8,0,0,0,0,0,0,2,0,2,0,0,0,0,0,0,7,1,6,0,0,0,0,0,0,0,0,0
494278,21000,210,0,-2,2,1,1,0,0,0,0,0,0,0,0,0,2,1,1,0,0,0,0,0,0,0,0,0,0,0,0,0,0,0
494287,21000,210,0,-2,8,0,8,0,0,0,0,0,0,0,0,0,8,0,8,0,0,0,0,0,0,0,0,0,0,0,0,0,0,0
494436,21000,210,0,-2,4,0,4,0,0,0,0,0,0,0,0,0,0,0,0,0,0,0,4,0,4,0,0,0,0,0,0,0,0,0
494588,21000,210,0,-2,2,1,1,0,0,0,0,0,0,0,0,0,0,0,0,0,0,0,1,1,0,1,0,1,0,0,0,0,0,0
494603,21000,210,0,-2,3,3,0,0,0,0,0,0,0,0,0,0,0,0,0,0,0,0,3,3,0,0,0,0,0,0,0,0,0,0
494746,21000,210,0,-2,3,2,1,0,0,0,0,0,0,0,0,0,0,0,0,1,1,0,0,0,0,0,0,0,2,1,1,0,0,0
494755,21000,210,0,-2,1,0,1,0,0,0,0,0,0,0,0,0,0,0,0,0,0,0,1,0,1,0,0,0,0,0,0,0,0,0
494843,21000,210,0,-2,4,0,4,0,0,0,1,0,1,3,0,3,0,0,0,0,0,0,0,0,0,0,0,0,0,0,0,0,0,0
494852,21000,210,0,-2,10,4,6,0,0,0,0,0,0,1,0,1,0,0,0,0,0,0,9,4,5,0,0,0,0,0,0,0,0,0
494959,21000,210,0,-2,1,1,0,0,0,0,0,0,0,1,1,0,0,0,0,0,0,0,0,0,0,0,0,0,0,0,0,0,0,0
495314,21000,210,0,-2,2,0,2,0,0,0,2,0,2,0,0,0,0,0,0,0,0,0,0,0,0,0,0,0,0,0,0,0,0,0
495420,21000,210,0,-2,2,0,2,0,0,0,1,0,1,0,0,0,0,0,0,0,0,0,1,0,1,0,0,0,0,0,0,0,0,0
495439,21000,210,0,-2,4,1,3,0,0,0,0,0,0,2,0,2,2,1,1,0,0,0,0,0,0,0,0,0,0,0,0,0,0,0
495448,21000,210,0,-2,5,1,4,0,0,0,0,0,0,0,0,0,0,0,0,0,0,0,4,0,4,1,1,0,0,0,0,0,0,0
495457,21000,210,0,-2,2,0,2,0,0,0,0,0,0,0,0,0,1,0,1,0,0,0,1,0,1,0,0,0,0,0,0,0,0,0
495767,21000,210,0,-2,319,163,156,0,0,0,47,28,19,23,10,13,19,11,8,0,0,0,162,80,82,8,5,3,11,6,5,49,23,26
496043,21000,210,0,-2,1,1,0,0,0,0,1,1,0,0,0,0,0,0,0,0,0,0,0,0,0,0,0,0,0,0,0,0,0,0
496283,21000,210,0,-2,3,2,1,0,0,0,0,0,0,0,0,0,0,0,0,0,0,0,3,2,1,0,0,0,0,0,0,0,0,0
496326,21000,210,0,-2,7,1,6,0,0,0,1,1,0,0,0,0,0,0,0,0,0,0,6,0,6,0,0,0,0,0,0,0,0,0
496627,21000,210,0,-2,5,3,2,0,0,0,1,1,0,0,0,0,0,0,0,0,0,0,4,2,2,0,0,0,0,0,0,0,0,0
496991,21000,210,0,-2,7,0,7,0,0,0,0,0,0,6,0,6,0,0,0,0,0,0,0,0,0,1,0,1,0,0,0,0,0,0
497046,21000,210,0,-2,2,1,1,0,0,0,0,0,0,0,0,0,1,0,1,0,0,0,1,1,0,0,0,0,0,0,0,0,0,0
497277,21000,210,0,-2,3,0,3,0,0,0,0,0,0,0,0,0,0,0,0,0,0,0,2,0,2,1,0,1,0,0,0,0,0,0
497286,21000,210,0,-2,3,3,0,0,0,0,0,0,0,0,0,0,1,1,0,0,0,0,2,2,0,0,0,0,0,0,0,0,0,0
100654,21010,210,10,-2,19,10,9,0,0,0,1,1,0,6,3,3,0,0,0,0,0,0,10,5,5,0,0,0,1,1,0,1,0,1
100663,21010,210,10,-2,177,102,75,1,1,0,23,19,4,15,6,9,4,2,2,0,0,0,99,47,52,4,3,1,0,0,0,31,24,7
100690,21010,210,10,-2,3,3,0,0,0,0,0,0,0,0,0,0,0,0,0,0,0,0,3,3,0,0,0,0,0,0,0,0,0,0
100706,21010,210,10,-2,22,6,16,0,0,0,2,1,1,1,0,1,2,0,2,0,0,0,16,4,12,0,0,0,0,0,0,1,1,0
100724,21010,210,10,-2,10,6,4,0,0,0,2,1,1,7,4,3,0,0,0,0,0,0,1,1,0,0,0,0,0,0,0,0,0,0
100751,21010,210,10,-2,146,71,75,0,0,0,12,8,4,11,3,8,3,1,2,0,0,0,86,43,43,3,1,2,1,0,1,30,15,15
100760,21010,210,10,-2,3,0,3,0,0,0,0,0,0,0,0,0,0,0,0,0,0,0,3,0,3,0,0,0,0,0,0,0,0,0
100812,21010,210,10,-2,6,4,2,0,0,0,3,2,1,0,0,0,0,0,0,0,0,0,3,2,1,0,0,0,0,0,0,0,0,0
100830,21010,210,10,-2,15,6,9,0,0,0,1,0,1,0,0,0,0,0,0,0,0,0,3,2,1,0,0,0,7,0,7,4,4,0
100858,21010,210,10,-2,74,38,36,0,0,0,3,1,2,5,0,5,0,0,0,1,1,0,46,25,21,1,1,0,0,0,0,18,10,8
100937,21010,210,10,-2,10,4,6,0,0,0,2,1,1,2,2,0,0,0,0,0,0,0,6,1,5,0,0,0,0,0,0,0,0,0
101028,21010,210,10,-2,2,0,2,0,0,0,0,0,0,0,0,0,0,0,0,0,0,0,2,0,2,0,0,0,0,0,0,0,0,0
101116,21010,210,10,-2,1,1,0,0,0,0,0,0,0,0,0,0,0,0,0,0,0,0,1,1,0,0,0,0,0,0,0,0,0,0
101143,21010,210,10,-2,8,7,1,0,0,0,1,1,0,1,1,0,0,0,0,0,0,0,6,5,1,0,0,0,0,0,0,0,0,0
101161,21010,210,10,-2,15,8,7,1,1,0,0,0,0,2,1,1,0,0,0,0,0,0,12,6,6,0,0,0,0,0,0,0,0,0
101189,21010,210,10,-2,15,4,11,1,0,1,0,0,0,2,1,1,0,0,0,0,0,0,12,3,9,0,0,0,0,0,0,0,0,0
101240,21010,210,10,-2,8,6,2,0,0,0,0,0,0,1,1,0,1,0,1,0,0,0,6,5,1,0,0,0,0,0,0,0,0,0
101286,21010,210,10,-2,10,5,5,0,0,0,0,0,0,0,0,0,0,0,0,0,0,0,10,5,5,0,0,0,0,0,0,0,0,0
101295,21010,210,10,-2,13,9,4,0,0,0,0,0,0,1,0,1,1,1,0,0,0,0,11,8,3,0,0,0,0,0,0,0,0,0
101301,21010,210,10,-2,5,2,3,0,0,0,0,0,0,2,0,2,0,0,0,0,0,0,1,1,0,0,0,0,2,1,1,0,0,0
101435,21010,210,10,-2,5,4,1,0,0,0,0,0,0,2,1,1,0,0,0,0,0,0,0,0,0,0,0,0,3,3,0,0,0,0
101462,21010,210,10,-2,4,0,4,0,0,0,0,0,0,3,0,3,0,0,0,0,0,0,1,0,1,0,0,0,0,0,0,0,0,0
101471,21010,210,10,-2,6,4,2,0,0,0,0,0,0,3,1,2,0,0,0,0,0,0,3,3,0,0,0,0,0,0,0,0,0,0
101480,21010,210,10,-2,37,13,24,0,0,0,2,1,1,3,1,2,1,0,1,0,0,0,27,9,18,0,0,0,0,0,0,4,2,2
101505,21010,210,10,-2,9,3,6,0,0,0,0,0,0,2,1,1,0,0,0,0,0,0,7,2,5,0,0,0,0,0,0,0,0,0
101514,21010,210,10,-2,10,2,8,0,0,0,0,0,0,0,0,0,0,0,0,0,0,0,10,2,8,0,0,0,0,0,0,0,0,0
101569,21010,210,10,-2,7,5,2,0,0,0,0,0,0,4,2,2,0,0,0,0,0,0,3,3,0,0,0,0,0,0,0,0,0,0
101587,21010,210,10,-2,8,2,6,0,0,0,1,0,1,0,0,0,0,0,0,0,0,0,2,0,2,0,0,0,3,0,3,2,2,0
101602,21010,210,10,-2,6,4,2,0,0,0,0,0,0,0,0,0,0,0,0,0,0,0,6,4,2,0,0,0,0,0,0,0,0,0
101648,21010,210,10,-2,2,2,0,0,0,0,0,0,0,0,0,0,0,0,0,0,0,0,2,2,0,0,0,0,0,0,0,0,0,0
101675,21010,210,10,-2,12,3,9,0,0,0,0,0,0,7,2,5,0,0,0,0,0,0,5,1,4,0,0,0,0,0,0,0,0,0
101693,21010,210,10,-2,4,2,2,0,0,0,0,0,0,0,0,0,0,0,0,0,0,0,4,2,2,0,0,0,0,0,0,0,0,0
101709,21010,210,10,-2,13,4,9,1,0,1,1,1,0,3,0,3,0,0,0,0,0,0,7,2,5,0,0,0,0,0,0,1,1,0
101736,21010,210,10,-2,2,1,1,0,0,0,0,0,0,1,0,1,0,0,0,0,0,0,1,1,0,0,0,0,0,0,0,0,0,0
101879,21010,210,10,-2,25,16,9,0,0,0,2,2,0,4,1,3,1,1,0,0,0,0,18,12,6,0,0,0,0,0,0,0,0,0
101897,21010,210,10,-2,2,2,0,0,0,0,0,0,0,0,0,0,0,0,0,0,0,0,2,2,0,0,0,0,0,0,0,0,0,0
101912,21010,210,10,-2,4,2,2,0,0,0,0,0,0,4,2,2,0,0,0,0,0,0,0,0,0,0,0,0,0,0,0,0,0,0
102030,21010,210,10,-2,4,1,3,0,0,0,0,0,0,1,0,1,0,0,0,0,0,0,2,1,1,0,0,0,1,0,1,0,0,0
102049,21010,210,10,-2,24,8,16,0,0,0,0,0,0,2,0,2,1,0,1,0,0,0,21,8,13,0,0,0,0,0,0,0,0,0
102067,21010,210,10,-2,14,4,10,0,0,0,0,0,0,6,3,3,0,0,0,0,0,0,8,1,7,0,0,0,0,0,0,0,0,0
102076,21010,210,10,-2,9,7,2,0,0,0,0,0,0,0,0,0,0,0,0,0,0,0,9,7,2,0,0,0,0,0,0,0,0,0
102094,21010,210,10,-2,73,42,31,0,0,0,14,10,4,4,1,3,1,0,1,0,0,0,50,31,19,3,0,3,1,0,1,0,0,0
102234,21010,210,10,-2,12,1,11,0,0,0,0,0,0,1,0,1,0,0,0,0,0,0,11,1,10,0,0,0,0,0,0,0,0,0
102270,21010,210,10,-2,4,1,3,0,0,0,0,0,0,4,1,3,0,0,0,0,0,0,0,0,0,0,0,0,0,0,0,0,0,0
102298,21010,210,10,-2,3,1,2,0,0,0,0,0,0,3,1,2,0,0,0,0,0,0,0,0,0,0,0,0,0,0,0,0,0,0
102313,21010,210,10,-2,4,1,3,0,0,0,0,0,0,4,1,3,0,0,0,0,0,0,0,0,0,0,0,0,0,0,0,0,0,0
102368,21010,210,10,-2,24,11,13,0,0,0,0,0,0,0,0,0,0,0,0,0,0,0,17,6,11,1,0,1,0,0,0,6,5,1
102377,21010,210,10,-2,2,1,1,0,0,0,0,0,0,1,0,1,0,0,0,0,0,0,1,1,0,0,0,0,0,0,0,0,0,0
102429,21010,210,10,-2,9,6,3,0,0,0,0,0,0,0,0,0,0,0,0,0,0,0,9,6,3,0,0,0,0,0,0,0,0,0
102553,21010,210,10,-2,25,9,16,1,0,1,1,0,1,0,0,0,0,0,0,0,0,0,19,7,12,1,0,1,2,2,0,1,0,1
102614,21010,210,10,-2,7,2,5,0,0,0,0,0,0,0,0,0,0,0,0,0,0,0,5,2,3,1,0,1,1,0,1,0,0,0
102632,21010,210,10,-2,6,2,4,0,0,0,1,0,1,0,0,0,0,0,0,0,0,0,5,2,3,0,0,0,0,0,0,0,0,0
102669,21010,210,10,-2,5,0,5,0,0,0,0,0,0,0,0,0,0,0,0,0,0,0,5,0,5,0,0,0,0,0,0,0,0,0
102845,21010,210,10,-2,29,13,16,1,0,1,1,0,1,5,2,3,3,1,2,0,0,0,19,10,9,0,0,0,0,0,0,0,0,0
103893,21010,210,10,-2,15,2,13,0,0,0,0,0,0,0,0,0,1,1,0,0,0,0,12,1,11,1,0,1,1,0,1,0,0,0
103909,21010,210,10,-2,7,3,4,0,0,0,0,0,0,0,0,0,1,0,1,0,0,0,5,2,3,0,0,0,1,1,0,0,0,0
103927,21010,210,10,-2,6,0,6,0,0,0,0,0,0,1,0,1,0,0,0,0,0,0,5,0,5,0,0,0,0,0,0,0,0,0
104090,21010,210,10,-2,8,2,6,0,0,0,0,0,0,0,0,0,0,0,0,0,0,0,7,2,5,1,0,1,0,0,0,0,0,0
104151,21010,210,10,-2,275,123,152,1,0,1,14,10,4,16,4,12,27,13,14,0,0,0,96,43,53,4,1,3,88,38,50,29,14,15
104160,21010,210,10,-2,14,6,8,0,0,0,1,0,1,0,0,0,3,1,2,0,0,0,6,4,2,0,0,0,4,1,3,0,0,0
104179,21010,210,10,-2,77,43,34,1,1,0,8,5,3,5,3,2,7,3,4,0,0,0,46,24,22,1,0,1,3,2,1,6,5,1
104346,21010,210,10,-2,3,3,0,0,0,0,0,0,0,1,1,0,0,0,0,0,0,0,2,2,0,0,0,0,0,0,0,0,0,0
104425,21010,210,10,-2,17,8,9,0,0,0,0,0,0,1,0,1,3,2,1,0,0,0,12,6,6,0,0,0,1,0,1,0,0,0
104577,21010,210,10,-2,3,2,1,0,0,0,0,0,0,0,0,0,0,0,0,0,0,0,3,2,1,0,0,0,0,0,0,0,0,0
104586,21010,210,10,-2,27,21,6,0,0,0,5,5,0,1,1,0,1,0,1,0,0,0,17,14,3,0,0,0,2,1,1,1,0,1
104708,21010,210,10,-2,16,7,9,0,0,0,0,0,0,0,0,0,1,0,1,0,0,0,14,6,8,1,1,0,0,0,0,0,0,0
104717,21010,210,10,-2,55,13,42,0,0,0,3,3,0,13,2,11,2,0,2,0,0,0,34,8,26,2,0,2,1,0,1,0,0,0
105145,21010,210,10,-2,6,2,4,0,0,0,0,0,0,0,0,0,1,1,0,0,0,0,5,1,4,0,0,0,0,0,0,0,0,0
105154,21010,210,10,-2,28,13,15,0,0,0,1,1,0,2,1,1,3,0,3,0,0,0,20,10,10,2,1,1,0,0,0,0,0,0
105206,21010,210,10,-2,6,1,5,0,0,0,1,0,1,0,0,0,0,0,0,0,0,0,3,0,3,1,0,1,1,1,0,0,0,0
105297,21010,210,10,-2,4,4,0,3,3,0,0,0,0,0,0,0,0,0,0,0,0,0,1,1,0,0,0,0,0,0,0,0,0,0
105330,21010,210,10,-2,81,35,46,0,0,0,5,0,5,2,1,1,2,0,2,0,0,0,66,30,36,0,0,0,3,2,1,3,2,1
105428,21010,210,10,-2,8,2,6,0,0,0,1,1,0,0,0,0,1,0,1,0,0,0,5,1,4,0,0,0,1,0,1,0,0,0
105525,21010,210,10,-2,5,2,3,1,1,0,0,0,0,1,0,1,0,0,0,0,0,0,3,1,2,0,0,0,0,0,0,0,0,0
105534,21010,210,10,-2,12,5,7,0,0,0,0,0,0,0,0,0,4,0,4,0,0,0,5,2,3,3,3,0,0,0,0,0,0,0
105543,21010,210,10,-2,10,1,9,0,0,0,0,0,0,0,0,0,3,0,3,0,0,0,7,1,6,0,0,0,0,0,0,0,0,0
105589,21010,210,10,-2,3,1,2,0,0,0,0,0,0,1,0,1,0,0,0,0,0,0,1,1,0,0,0,0,1,0,1,0,0,0
105659,21010,210,10,-2,7,6,1,1,0,1,0,0,0,2,2,0,2,2,0,0,0,0,2,2,0,0,0,0,0,0,0,0,0,0
105668,21010,210,10,-2,1,0,1,0,0,0,0,0,0,0,0,0,0,0,0,0,0,0,1,0,1,0,0,0,0,0,0,0,0,0
105747,21010,210,10,-2,6,3,3,0,0,0,0,0,0,0,0,0,0,0,0,0,0,0,6,3,3,0,0,0,0,0,0,0,0,0
105792,21010,210,10,-2,1,1,0,0,0,0,0,0,0,0,0,0,0,0,0,0,0,0,1,1,0,0,0,0,0,0,0,0,0,0
105899,21010,210,10,-2,1,1,0,0,0,0,0,0,0,0,0,0,0,0,0,0,0,0,1,1,0,0,0,0,0,0,0,0,0,0
106148,21010,210,10,-2,12,8,4,0,0,0,0,0,0,0,0,0,0,0,0,0,0,0,12,8,4,0,0,0,0,0,0,0,0,0
106245,21010,210,10,-2,19,8,11,0,0,0,0,0,0,2,1,1,0,0,0,0,0,0,13,5,8,0,0,0,3,1,2,1,1,0
106263,21010,210,10,-2,8,1,7,0,0,0,1,0,1,1,0,1,1,0,1,0,0,0,4,1,3,0,0,0,0,0,0,1,0,1
106306,21010,210,10,-2,1,1,0,0,0,0,0,0,0,1,1,0,0,0,0,0,0,0,0,0,0,0,0,0,0,0,0,0,0,0
106342,21010,210,10,-2,1,1,0,0,0,0,0,0,0,0,0,0,0,0,0,0,0,0,1,1,0,0,0,0,0,0,0,0,0,0
106397,21010,210,10,-2,91,44,47,0,0,0,3,2,1,7,4,3,7,4,3,0,0,0,52,23,29,0,0,0,8,3,5,14,8,6
106412,21010,210,10,-2,8,4,4,0,0,0,1,1,0,4,1,3,0,0,0,0,0,0,3,2,1,0,0,0,0,0,0,0,0,0
106449,21010,210,10,-2,15,8,7,0,0,0,0,0,0,0,0,0,0,0,0,0,0,0,14,7,7,1,1,0,0,0,0,0,0,0
106458,21010,210,10,-2,27,14,13,0,0,0,1,1,0,1,1,0,0,0,0,0,0,0,18,6,12,0,0,0,2,2,0,5,4,1
106467,21010,210,10,-2,16,7,9,0,0,0,6,2,4,0,0,0,0,0,0,0,0,0,9,5,4,0,0,0,1,0,1,0,0,0
106485,21010,210,10,-2,19,13,6,0,0,0,1,1,0,0,0,0,0,0,0,0,0,0,14,9,5,0,0,0,1,0,1,3,3,0
106546,21010,210,10,-2,11,1,10,0,0,0,0,0,0,0,0,0,0,0,0,0,0,0,11,1,10,0,0,0,0,0,0,0,0,0
106625,21010,210,10,-2,6,3,3,0,0,0,0,0,0,0,0,0,0,0,0,0,0,0,6,3,3,0,0,0,0,0,0,0,0,0
106704,21010,210,10,-2,31,15,16,0,0,0,1,1,0,4,2,2,0,0,0,0,0,0,23,11,12,1,1,0,0,0,0,2,0,2
106713,21010,210,10,-2,3,0,3,0,0,0,0,0,0,0,0,0,0,0,0,0,0,0,3,0,3,0,0,0,0,0,0,0,0,0
106795,21010,210,10,-2,6,2,4,0,0,0,0,0,0,0,0,0,0,0,0,0,0,0,6,2,4,0,0,0,0,0,0,0,0,0
106810,21010,210,10,-2,5,2,3,0,0,0,0,0,0,0,0,0,0,0,0,0,0,0,5,2,3,0,0,0,0,0,0,0,0,0
106883,21010,210,10,-2,5,2,3,0,0,0,0,0,0,0,0,0,0,0,0,0,0,0,5,2,3,0,0,0,0,0,0,0,0,0
106980,21010,210,10,-2,13,7,6,0,0,0,0,0,0,0,0,0,0,0,0,0,0,0,13,7,6,0,0,0,0,0,0,0,0,0
106999,21010,210,10,-2,5,2,3,0,0,0,0,0,0,0,0,0,0,0,0,0,0,0,5,2,3,0,0,0,0,0,0,0,0,0
107044,21010,210,10,-2,14,4,10,0,0,0,0,0,0,0,0,0,1,0,1,0,0,0,12,4,8,0,0,0,0,0,0,1,0,1
107071,21010,210,10,-2,7,4,3,0,0,0,0,0,0,1,0,1,0,0,0,0,0,0,6,4,2,0,0,0,0,0,0,0,0,0
107080,21010,210,10,-2,5,2,3,0,0,0,0,0,0,0,0,0,0,0,0,0,0,0,4,2,2,0,0,0,0,0,0,1,0,1
107141,21010,210,10,-2,4,1,3,0,0,0,0,0,0,0,0,0,0,0,0,0,0,0,3,1,2,0,0,0,1,0,1,0,0,0
107318,21010,210,10,-2,2,2,0,0,0,0,0,0,0,1,1,0,0,0,0,0,0,0,1,1,0,0,0,0,0,0,0,0,0,0
107327,21010,210,10,-2,2,1,1,0,0,0,0,0,0,0,0,0,0,0,0,0,0,0,2,1,1,0,0,0,0,0,0,0,0,0
107460,21010,210,10,-2,4,1,3,0,0,0,0,0,0,0,0,0,0,0,0,0,0,0,4,1,3,0,0,0,0,0,0,0,0,0
107512,21010,210,10,-2,10,5,5,0,0,0,0,0,0,0,0,0,0,0,0,0,0,0,10,5,5,0,0,0,0,0,0,0,0,0
107521,21010,210,10,-2,14,8,6,0,0,0,0,0,0,4,2,2,0,0,0,0,0,0,10,6,4,0,0,0,0,0,0,0,0,0
107549,21010,210,10,-2,7,4,3,0,0,0,0,0,0,0,0,0,0,0,0,0,0,0,7,4,3,0,0,0,0,0,0,0,0,0
107558,21010,210,10,-2,8,6,2,1,1,0,0,0,0,0,0,0,2,2,0,1,1,0,4,2,2,0,0,0,0,0,0,0,0,0
107585,21010,210,10,-2,5,3,2,0,0,0,0,0,0,0,0,0,0,0,0,0,0,0,5,3,2,0,0,0,0,0,0,0,0,0
107600,21010,210,10,-2,3,0,3,0,0,0,1,0,1,2,0,2,0,0,0,0,0,0,0,0,0,0,0,0,0,0,0,0,0,0
107619,21010,210,10,-2,4,0,4,0,0,0,0,0,0,1,0,1,0,0,0,0,0,0,3,0,3,0,0,0,0,0,0,0,0,0
107637,21010,210,10,-2,12,4,8,0,0,0,0,0,0,5,3,2,1,1,0,0,0,0,5,0,5,1,0,1,0,0,0,0,0,0
107664,21010,210,10,-2,9,7,2,0,0,0,0,0,0,2,1,1,0,0,0,0,0,0,6,5,1,0,0,0,1,1,0,0,0,0
107725,21010,210,10,-2,4,2,2,0,0,0,0,0,0,0,0,0,0,0,0,0,0,0,4,2,2,0,0,0,0,0,0,0,0,0
107743,21010,210,10,-2,1,0,1,0,0,0,0,0,0,0,0,0,0,0,0,0,0,0,1,0,1,0,0,0,0,0,0,0,0,0
107840,21010,210,10,-2,2,1,1,0,0,0,0,0,0,2,1,1,0,0,0,0,0,0,0,0,0,0,0,0,0,0,0,0,0,0
107974,21010,210,10,-2,3,0,3,0,0,0,0,0,0,1,0,1,0,0,0,0,0,0,2,0,2,0,0,0,0,0,0,0,0,0
107983,21010,210,10,-2,12,9,3,0,0,0,2,2,0,2,1,1,1,1,0,0,0,0,7,5,2,0,0,0,0,0,0,0,0,0
107992,21010,210,10,-2,12,6,6,0,0,0,0,0,0,2,0,2,0,0,0,0,0,0,10,6,4,0,0,0,0,0,0,0,0,0
108092,21010,210,10,-2,10,4,6,0,0,0,3,3,0,0,0,0,0,0,0,0,0,0,7,1,6,0,0,0,0,0,0,0,0,0
108232,21010,210,10,-2,2,2,0,0,0,0,0,0,0,0,0,0,0,0,0,0,0,0,2,2,0,0,0,0,0,0,0,0,0,0
108870,21010,210,10,-2,1,1,0,0,0,0,0,0,0,0,0,0,0,0,0,0,0,0,1,1,0,0,0,0,0,0,0,0,0,0
109208,21010,210,10,-2,5,2,3,0,0,0,1,0,1,1,1,0,3,1,2,0,0,0,0,0,0,0,0,0,0,0,0,0,0,0
109350,21010,210,10,-2,8,5,3,0,0,0,0,0,0,0,0,0,1,1,0,0,0,0,5,3,2,1,1,0,1,0,1,0,0,0
109785,21010,210,10,-2,12,3,9,0,0,0,4,1,3,3,1,2,1,1,0,0,0,0,4,0,4,0,0,0,0,0,0,0,0,0
109819,21010,210,10,-2,8,2,6,0,0,0,1,0,1,0,0,0,0,0,0,0,0,0,7,2,5,0,0,0,0,0,0,0,0,0
110097,21010,210,10,-2,6,5,1,0,0,0,0,0,0,0,0,0,1,1,0,0,0,0,2,2,0,0,0,0,3,2,1,0,0,0
110219,21010,210,10,-2,3,0,3,0,0,0,0,0,0,1,0,1,0,0,0,0,0,0,2,0,2,0,0,0,0,0,0,0,0,0
110316,21010,210,10,-2,3,1,2,0,0,0,0,0,0,2,1,1,0,0,0,0,0,0,1,0,1,0,0,0,0,0,0,0,0,0
110361,21010,210,10,-2,34,12,22,0,0,0,3,2,1,4,1,3,8,2,6,0,0,0,19,7,12,0,0,0,0,0,0,0,0,0
110370,21010,210,10,-2,1,0,1,0,0,0,0,0,0,0,0,0,0,0,0,0,0,0,0,0,0,0,0,0,0,0,0,1,0,1
110404,21010,210,10,-2,21,13,8,0,0,0,3,0,3,1,1,0,2,2,0,0,0,0,4,1,3,2,1,1,0,0,0,9,8,1
110413,21010,210,10,-2,14,6,8,0,0,0,1,0,1,1,1,0,5,3,2,0,0,0,6,2,4,1,0,1,0,0,0,0,0,0
110422,21010,210,10,-2,34,21,13,0,0,0,3,3,0,2,2,0,4,2,2,0,0,0,11,5,6,0,0,0,0,0,0,14,9,5
110468,21010,210,10,-2,9,3,6,0,0,0,1,0,1,1,0,1,1,0,1,0,0,0,6,3,3,0,0,0,0,0,0,0,0,0
110486,21010,210,10,-2,12,4,8,0,0,0,1,0,1,0,0,0,4,2,2,0,0,0,3,1,2,2,1,1,1,0,1,1,0,1
110495,21010,210,10,-2,27,8,19,1,1,0,4,0,4,2,1,1,4,3,1,0,0,0,11,2,9,1,0,1,1,1,0,3,0,3
110510,21010,210,10,-2,28,14,14,0,0,0,4,2,2,2,1,1,4,2,2,0,0,0,16,8,8,0,0,0,2,1,1,0,0,0
110529,21010,210,10,-2,1,1,0,0,0,0,0,0,0,0,0,0,0,0,0,0,0,0,0,0,0,0,0,0,1,1,0,0,0,0
110538,21010,210,10,-2,21,14,7,0,0,0,0,0,0,3,1,2,0,0,0,0,0,0,12,7,5,0,0,0,1,1,0,5,5,0
110547,21010,210,10,-2,12,3,9,0,0,0,0,0,0,1,0,1,2,0,2,0,0,0,3,1,2,3,2,1,1,0,1,2,0,2
110556,21010,210,10,-2,25,8,17,0,0,0,6,4,2,1,0,1,5,1,4,0,0,0,8,2,6,0,0,0,2,0,2,3,1,2
110565,21010,210,10,-2,82,43,39,0,0,0,19,10,9,7,2,5,10,4,6,0,0,0,38,22,16,1,0,1,0,0,0,7,5,2
110574,21010,210,10,-2,11,5,6,0,0,0,1,1,0,1,1,0,1,0,1,0,0,0,3,1,2,0,0,0,3,2,1,2,0,2
110583,21010,210,10,-2,38,9,29,2,0,2,6,1,5,4,1,3,4,1,3,0,0,0,14,1,13,1,1,0,1,0,1,6,4,2
110592,21010,210,10,-2,13,6,7,0,0,0,6,4,2,0,0,0,3,1,2,0,0,0,3,0,3,0,0,0,1,1,0,0,0,0
110608,21010,210,10,-2,22,11,11,0,0,0,3,2,1,1,1,0,2,1,1,0,0,0,8,0,8,0,0,0,1,1,0,7,6,1
110617,21010,210,10,-2,29,17,12,1,0,1,4,2,2,5,4,1,2,1,1,0,0,0,8,5,3,0,0,0,6,3,3,3,2,1
110635,21010,210,10,-2,127,68,59,1,1,0,12,7,5,8,3,5,9,4,5,0,0,0,56,32,24,6,3,3,8,5,3,27,13,14
110644,21010,210,10,-2,215,100,115,0,0,0,29,8,21,10,5,5,23,8,15,0,0,0,95,45,50,3,1,2,11,3,8,44,30,14
110653,21010,210,10,-2,175,89,86,0,0,0,39,23,16,11,2,9,14,5,9,2,1,1,75,35,40,5,3,2,12,9,3,17,11,6
110662,21010,210,10,-2,384,202,182,0,0,0,106,47,59,11,6,5,31,20,11,1,0,1,142,82,60,9,5,4,23,10,13,61,32,29
110671,21010,210,10,-2,48,27,21,0,0,0,5,4,1,1,1,0,6,2,4,0,0,0,22,10,12,1,1,0,1,1,0,12,8,4
110680,21010,210,10,-2,225,105,120,1,0,1,34,13,21,7,1,6,19,11,8,0,0,0,95,39,56,3,0,3,8,4,4,58,37,21
110699,21010,210,10,-2,217,91,126,0,0,0,65,25,40,15,6,9,15,10,5,0,0,0,85,35,50,8,3,5,13,5,8,16,7,9
110705,21010,210,10,-2,57,33,24,0,0,0,9,2,7,1,0,1,4,2,2,0,0,0,20,12,8,1,0,1,2,1,1,20,16,4
110714,21010,210,10,-2,53,22,31,0,0,0,4,1,3,1,1,0,6,1,5,0,0,0,21,10,11,4,1,3,2,1,1,15,7,8
111081,21010,210,10,-2,8,4,4,0,0,0,2,1,1,1,1,0,0,0,0,0,0,0,3,1,2,0,0,0,0,0,0,2,1,1
111188,21010,210,10,-2,7,6,1,0,0,0,0,0,0,0,0,0,0,0,0,0,0,0,5,4,1,0,0,0,2,2,0,0,0,0
111391,21010,210,10,-2,5,3,2,0,0,0,0,0,0,1,1,0,1,1,0,0,0,0,3,1,2,0,0,0,0,0,0,0,0,0
111434,21010,210,10,-2,4,4,0,0,0,0,0,0,0,1,1,0,2,2,0,0,0,0,0,0,0,0,0,0,1,1,0,0,0,0
111461,21010,210,10,-2,1,1,0,0,0,0,0,0,0,1,1,0,0,0,0,0,0,0,0,0,0,0,0,0,0,0,0,0,0,0
111887,21010,210,10,-2,2,2,0,0,0,0,0,0,0,0,0,0,0,0,0,0,0,0,2,2,0,0,0,0,0,0,0,0,0,0
111896,21010,210,10,-2,3,1,2,0,0,0,0,0,0,0,0,0,0,0,0,0,0,0,2,0,2,0,0,0,1,1,0,0,0,0
111920,21010,210,10,-2,3,1,2,0,0,0,1,0,1,0,0,0,0,0,0,0,0,0,2,1,1,0,0,0,0,0,0,0,0,0
111939,21010,210,10,-2,17,7,10,0,0,0,2,1,1,1,0,1,4,1,3,0,0,0,10,5,5,0,0,0,0,0,0,0,0,0
111948,21010,210,10,-2,40,17,23,0,0,0,3,0,3,2,1,1,7,1,6,0,0,0,12,7,5,1,0,1,10,7,3,5,1,4
111966,21010,210,10,-2,7,2,5,0,0,0,2,1,1,2,0,2,0,0,0,0,0,0,1,0,1,0,0,0,2,1,1,0,0,0
112075,21010,210,10,-2,9,4,5,0,0,0,0,0,0,1,0,1,0,0,0,0,0,0,4,2,2,0,0,0,4,2,2,0,0,0
112127,21010,210,10,-2,1,0,1,0,0,0,1,0,1,0,0,0,0,0,0,0,0,0,0,0,0,0,0,0,0,0,0,0,0,0
112172,21010,210,10,-2,2,1,1,0,0,0,0,0,0,0,0,0,1,0,1,0,0,0,1,1,0,0,0,0,0,0,0,0,0,0
112251,21010,210,10,-2,4,3,1,0,0,0,0,0,0,0,0,0,1,0,1,0,0,0,0,0,0,0,0,0,3,3,0,0,0,0
112260,21010,210,10,-2,14,6,8,0,0,0,4,2,2,1,1,0,1,0,1,0,0,0,4,2,2,0,0,0,1,1,0,3,0,3
112394,21010,210,10,-2,1,1,0,0,0,0,0,0,0,0,0,0,0,0,0,0,0,0,1,1,0,0,0,0,0,0,0,0,0,0
112525,21010,210,10,-2,24,9,15,0,0,0,8,4,4,2,0,2,1,1,0,0,0,0,8,2,6,1,0,1,3,2,1,1,0,1
112561,21010,210,10,-2,24,11,13,0,0,0,0,0,0,1,0,1,2,0,2,0,0,0,19,10,9,2,1,1,0,0,0,0,0,0
112570,21010,210,10,-2,1,1,0,0,0,0,0,0,0,1,1,0,0,0,0,0,0,0,0,0,0,0,0,0,0,0,0,0,0,0
112686,21010,210,10,-2,8,4,4,0,0,0,1,0,1,4,1,3,2,2,0,0,0,0,1,1,0,0,0,0,0,0,0,0,0,0
112826,21010,210,10,-2,6,1,5,0,0,0,0,0,0,1,0,1,1,0,1,0,0,0,3,1,2,1,0,1,0,0,0,0,0,0
113111,21010,210,10,-2,3,2,1,0,0,0,1,0,1,0,0,0,0,0,0,0,0,0,1,1,0,0,0,0,1,1,0,0,0,0
113193,21010,210,10,-2,4,0,4,0,0,0,0,0,0,0,0,0,1,0,1,0,0,0,3,0,3,0,0,0,0,0,0,0,0,0
113236,21010,210,10,-2,3,2,1,0,0,0,0,0,0,2,1,1,0,0,0,0,0,0,1,1,0,0,0,0,0,0,0,0,0,0
113333,21010,210,10,-2,5,3,2,0,0,0,1,0,1,0,0,0,1,1,0,0,0,0,2,2,0,0,0,0,0,0,0,1,0,1
113573,21010,210,10,-2,25,8,17,0,0,0,0,0,0,5,0,5,9,5,4,0,0,0,8,3,5,0,0,0,2,0,2,1,0,1
113634,21010,210,10,-2,1,0,1,0,0,0,1,0,1,0,0,0,0,0,0,0,0,0,0,0,0,0,0,0,0,0,0,0,0,0
113698,21010,210,10,-2,8,4,4,0,0,0,0,0,0,0,0,0,0,0,0,0,0,0,4,3,1,0,0,0,3,1,2,1,0,1
113856,21010,210,10,-2,26,13,13,0,0,0,2,1,1,2,0,2,3,1,2,0,0,0,6,4,2,0,0,0,12,6,6,1,1,0
113980,21010,210,10,-2,1,1,0,0,0,0,1,1,0,0,0,0,0,0,0,0,0,0,0,0,0,0,0,0,0,0,0,0,0,0
114266,21010,210,10,-2,8,3,5,0,0,0,3,0,3,0,0,0,2,1,1,0,0,0,2,2,0,0,0,0,1,0,1,0,0,0
114433,21010,210,10,-2,7,2,5,0,0,0,0,0,0,0,0,0,2,1,1,0,0,0,5,1,4,0,0,0,0,0,0,0,0,0
114549,21010,210,10,-2,2,2,0,0,0,0,0,0,0,0,0,0,0,0,0,0,0,0,2,2,0,0,0,0,0,0,0,0,0,0
114716,21010,210,10,-2,6,1,5,0,0,0,1,0,1,0,0,0,2,0,2,0,0,0,3,1,2,0,0,0,0,0,0,0,0,0
114789,21010,210,10,-2,13,6,7,1,1,0,0,0,0,1,0,1,3,1,2,0,0,0,7,4,3,1,0,1,0,0,0,0,0,0
114813,21010,210,10,-2,12,5,7,1,1,0,2,1,1,1,0,1,2,0,2,0,0,0,6,3,3,0,0,0,0,0,0,0,0,0
114840,21010,210,10,-2,2,1,1,0,0,0,0,0,0,2,1,1,0,0,0,0,0,0,0,0,0,0,0,0,0,0,0,0,0,0
114859,21010,210,10,-2,2,0,2,0,0,0,0,0,0,1,0,1,1,0,1,0,0,0,0,0,0,0,0,0,0,0,0,0,0,0
114938,21010,210,10,-2,1,0,1,0,0,0,0,0,0,0,0,0,1,0,1,0,0,0,0,0,0,0,0,0,0,0,0,0,0,0
115001,21010,210,10,-2,2,1,1,0,0,0,0,0,0,0,0,0,1,1,0,0,0,0,1,0,1,0,0,0,0,0,0,0,0,0
115083,21010,210,10,-2,3,0,3,0,0,0,0,0,0,0,0,0,0,0,0,0,0,0,3,0,3,0,0,0,0,0,0,0,0,0
115296,21010,210,10,-2,1,1,0,0,0,0,0,0,0,0,0,0,0,0,0,0,0,0,0,0,0,0,0,0,1,1,0,0,0,0
115393,21010,210,10,-2,3,2,1,0,0,0,0,0,0,0,0,0,1,1,0,0,0,0,0,0,0,0,0,0,2,1,1,0,0,0
115409,21010,210,10,-2,4,1,3,0,0,0,0,0,0,0,0,0,0,0,0,0,0,0,3,1,2,0,0,0,1,0,1,0,0,0
115728,21010,210,10,-2,2,1,1,0,0,0,1,1,0,1,0,1,0,0,0,0,0,0,0,0,0,0,0,0,0,0,0,0,0,0
115746,21010,210,10,-2,6,2,4,0,0,0,0,0,0,0,0,0,0,0,0,0,0,0,6,2,4,0,0,0,0,0,0,0,0,0
115755,21010,210,10,-2,14,8,6,0,0,0,1,1,0,0,0,0,1,0,1,0,0,0,9,4,5,0,0,0,3,3,0,0,0,0
115861,21010,210,10,-2,108,58,50,0,0,0,9,6,3,5,3,2,43,20,23,0,0,0,48,26,22,2,2,0,1,1,0,0,0,0
115931,21010,210,10,-2,7,5,2,0,0,0,0,0,0,2,1,1,3,2,1,0,0,0,2,2,0,0,0,0,0,0,0,0,0,0
116439,21010,210,10,-2,5,1,4,0,0,0,1,0,1,0,0,0,0,0,0,0,0,0,3,1,2,0,0,0,1,0,1,0,0,0
117052,21010,210,10,-2,2,1,1,0,0,0,0,0,0,0,0,0,0,0,0,0,0,0,1,1,0,0,0,0,1,0,1,0,0,0
117140,21010,210,10,-2,3,2,1,0,0,0,0,0,0,0,0,0,0,0,0,0,0,0,2,1,1,0,0,0,1,1,0,0,0,0
117168,21010,210,10,-2,1,0,1,0,0,0,1,0,1,0,0,0,0,0,0,0,0,0,0,0,0,0,0,0,0,0,0,0,0,0
117195,21010,210,10,-2,3,2,1,0,0,0,0,0,0,0,0,0,2,1,1,0,0,0,1,1,0,0,0,0,0,0,0,0,0,0
117247,21010,210,10,-2,9,2,7,0,0,0,3,0,3,0,0,0,3,2,1,0,0,0,0,0,0,0,0,0,3,0,3,0,0,0
117274,21010,210,10,-2,2,1,1,0,0,0,0,0,0,0,0,0,0,0,0,0,0,0,1,0,1,0,0,0,1,1,0,0,0,0
117557,21010,210,10,-2,1,1,0,0,0,0,0,0,0,0,0,0,0,0,0,0,0,0,1,1,0,0,0,0,0,0,0,0,0,0
117627,21010,210,10,-2,6,2,4,0,0,0,1,1,0,0,0,0,1,0,1,2,1,1,2,0,2,0,0,0,0,0,0,0,0,0
117636,21010,210,10,-2,26,8,18,0,0,0,3,0,3,2,1,1,4,3,1,0,0,0,14,4,10,1,0,1,0,0,0,2,0,2
117672,21010,210,10,-2,1,0,1,0,0,0,0,0,0,0,0,0,0,0,0,0,0,0,0,0,0,1,0,1,0,0,0,0,0,0
117690,21010,210,10,-2,7,5,2,0,0,0,0,0,0,1,0,1,0,0,0,0,0,0,1,1,0,0,0,0,5,4,1,0,0,0
117706,21010,210,10,-2,32,17,15,0,0,0,6,4,2,3,2,1,1,0,1,0,0,0,18,7,11,0,0,0,4,4,0,0,0,0
117715,21010,210,10,-2,5,0,5,0,0,0,1,0,1,0,0,0,2,0,2,0,0,0,0,0,0,0,0,0,2,0,2,0,0,0
117724,21010,210,10,-2,17,12,5,0,0,0,1,1,0,1,1,0,4,3,1,0,0,0,4,3,1,0,0,0,7,4,3,0,0,0
117733,21010,210,10,-2,23,10,13,0,0,0,1,0,1,1,1,0,3,2,1,0,0,0,14,5,9,2,1,1,2,1,1,0,0,0
117751,21010,210,10,-2,3,1,2,0,0,0,0,0,0,1,0,1,0,0,0,0,0,0,2,1,1,0,0,0,0,0,0,0,0,0
117788,21010,210,10,-2,15,7,8,0,0,0,1,1,0,0,0,0,1,1,0,0,0,0,5,2,3,0,0,0,8,3,5,0,0,0
117867,21010,210,10,-2,13,7,6,0,0,0,2,1,1,0,0,0,3,3,0,0,0,0,7,2,5,0,0,0,1,1,0,0,0,0
117894,21010,210,10,-2,8,4,4,0,0,0,2,1,1,2,1,1,0,0,0,0,0,0,4,2,2,0,0,0,0,0,0,0,0,0
117946,21010,210,10,-2,26,9,17,0,0,0,2,1,1,5,3,2,1,0,1,0,0,0,9,1,8,0,0,0,9,4,5,0,0,0
118198,21010,210,10,-2,1,1,0,0,0,0,0,0,0,0,0,0,0,0,0,0,0,0,1,1,0,0,0,0,0,0,0,0,0,0
118347,21010,210,10,-2,3,2,1,0,0,0,0,0,0,0,0,0,0,0,0,0,0,0,1,1,0,0,0,0,2,1,1,0,0,0
118684,21010,210,10,-2,6,3,3,0,0,0,1,0,1,0,0,0,4,2,2,0,0,0,1,1,0,0,0,0,0,0,0,0,0,0
118693,21010,210,10,-2,4,2,2,0,0,0,0,0,0,0,0,0,0,0,0,0,0,0,3,2,1,0,0,0,1,0,1,0,0,0
118718,21010,210,10,-2,5,3,2,0,0,0,0,0,0,1,1,0,2,0,2,0,0,0,0,0,0,0,0,0,2,2,0,0,0,0
118912,21010,210,10,-2,3,2,1,0,0,0,1,1,0,0,0,0,0,0,0,0,0,0,1,1,0,0,0,0,0,0,0,1,0,1
118976,21010,210,10,-2,92,35,57,0,0,0,4,1,3,3,1,2,21,6,15,0,0,0,63,27,36,1,0,1,0,0,0,0,0,0
119058,21010,210,10,-2,1,0,1,0,0,0,0,0,0,0,0,0,0,0,0,0,0,0,1,0,1,0,0,0,0,0,0,0,0,0
119067,21010,210,10,-2,2,1,1,0,0,0,1,0,1,0,0,0,0,0,0,0,0,0,0,0,0,1,1,0,0,0,0,0,0,0
119137,21010,210,10,-2,8,5,3,0,0,0,1,1,0,0,0,0,0,0,0,0,0,0,4,1,3,0,0,0,0,0,0,3,3,0
119164,21010,210,10,-2,11,6,5,1,0,1,1,0,1,0,0,0,2,1,1,0,0,0,5,4,1,0,0,0,2,1,1,0,0,0
119173,21010,210,10,-2,8,2,6,0,0,0,2,0,2,0,0,0,2,1,1,0,0,0,4,1,3,0,0,0,0,0,0,0,0,0
119216,21010,210,10,-2,3,2,1,0,0,0,0,0,0,1,1,0,1,1,0,0,0,0,1,0,1,0,0,0,0,0,0,0,0,0
119270,21010,210,10,-2,1,0,1,0,0,0,0,0,0,0,0,0,0,0,0,1,0,1,0,0,0,0,0,0,0,0,0,0,0,0
119331,21010,210,10,-2,7,1,6,0,0,0,0,0,0,0,0,0,0,0,0,0,0,0,6,1,5,0,0,0,1,0,1,0,0,0
119605,21010,210,10,-2,7,3,4,0,0,0,0,0,0,1,1,0,0,0,0,0,0,0,4,2,2,0,0,0,2,0,2,0,0,0
119678,21010,210,10,-2,13,11,2,0,0,0,0,0,0,1,0,1,1,1,0,0,0,0,9,8,1,0,0,0,2,2,0,0,0,0
120254,21010,210,10,-2,17,9,8,0,0,0,0,0,0,1,0,1,2,2,0,0,0,0,5,3,2,0,0,0,8,3,5,1,1,0
120290,21010,210,10,-2,7,2,5,0,0,0,1,0,1,2,0,2,2,1,1,0,0,0,2,1,1,0,0,0,0,0,0,0,0,0
120403,21010,210,10,-2,2,0,2,0,0,0,0,0,0,0,0,0,0,0,0,0,0,0,2,0,2,0,0,0,0,0,0,0,0,0
120421,21010,210,10,-2,10,4,6,0,0,0,2,1,1,0,0,0,3,1,2,0,0,0,4,2,2,0,0,0,1,0,1,0,0,0
120661,21010,210,10,-2,3,1,2,1,0,1,0,0,0,0,0,0,1,0,1,0,0,0,1,1,0,0,0,0,0,0,0,0,0,0
120698,21010,210,10,-2,2,1,1,0,0,0,0,0,0,0,0,0,0,0,0,0,0,0,2,1,1,0,0,0,0,0,0,0,0,0
120865,21010,210,10,-2,7,3,4,0,0,0,1,0,1,1,0,1,1,0,1,0,0,0,4,3,1,0,0,0,0,0,0,0,0,0
120883,21010,210,10,-2,35,15,20,0,0,0,6,1,5,4,0,4,4,1,3,0,0,0,18,11,7,1,1,0,2,1,1,0,0,0
120953,21010,210,10,-2,7,4,3,0,0,0,1,1,0,0,0,0,2,1,1,0,0,0,4,2,2,0,0,0,0,0,0,0,0,0
120971,21010,210,10,-2,2,1,1,0,0,0,0,0,0,0,0,0,1,0,1,0,0,0,1,1,0,0,0,0,0,0,0,0,0,0
121044,21010,210,10,-2,11,3,8,1,0,1,0,0,0,0,0,0,0,0,0,0,0,0,7,3,4,1,0,1,1,0,1,1,0,1
121150,21010,210,10,-2,40,16,24,0,0,0,3,3,0,4,2,2,6,3,3,0,0,0,26,7,19,0,0,0,0,0,0,1,1,0
121309,21010,210,10,-2,6,1,5,0,0,0,0,0,0,0,0,0,1,1,0,0,0,0,4,0,4,1,0,1,0,0,0,0,0,0
121345,21010,210,10,-2,5,4,1,0,0,0,0,0,0,4,3,1,1,1,0,0,0,0,0,0,0,0,0,0,0,0,0,0,0,0
121363,21010,210,10,-2,4,1,3,0,0,0,0,0,0,1,0,1,1,0,1,0,0,0,2,1,1,0,0,0,0,0,0,0,0,0
121619,21010,210,10,-2,1,0,1,0,0,0,0,0,0,0,0,0,0,0,0,0,0,0,0,0,0,0,0,0,1,0,1,0,0,0
121691,21010,210,10,-2,11,4,7,0,0,0,3,1,2,1,0,1,2,1,1,0,0,0,4,2,2,0,0,0,1,0,1,0,0,0
121707,21010,210,10,-2,4,2,2,0,0,0,0,0,0,0,0,0,0,0,0,0,0,0,4,2,2,0,0,0,0,0,0,0,0,0
121886,21010,210,10,-2,3,0,3,0,0,0,1,0,1,0,0,0,1,0,1,0,0,0,0,0,0,0,0,0,1,0,1,0,0,0
121901,21010,210,10,-2,8,2,6,0,0,0,1,0,1,0,0,0,5,2,3,0,0,0,2,0,2,0,0,0,0,0,0,0,0,0
122180,21010,210,10,-2,5,2,3,0,0,0,0,0,0,1,0,1,0,0,0,0,0,0,2,1,1,1,1,0,1,0,1,0,0,0
122205,21010,210,10,-2,5,2,3,0,0,0,2,1,1,0,0,0,0,0,0,0,0,0,3,1,2,0,0,0,0,0,0,0,0,0
122296,21010,210,10,-2,9,2,7,0,0,0,3,2,1,0,0,0,1,0,1,0,0,0,2,0,2,0,0,0,3,0,3,0,0,0
122384,21010,210,10,-2,1,0,1,0,0,0,0,0,0,0,0,0,1,0,1,0,0,0,0,0,0,0,0,0,0,0,0,0,0,0
122409,21010,210,10,-2,80,41,39,2,2,0,6,4,2,9,6,3,10,6,4,0,0,0,34,10,24,1,0,1,7,5,2,11,8,3
122436,21010,210,10,-2,3,0,3,0,0,0,0,0,0,0,0,0,0,0,0,0,0,0,2,0,2,0,0,0,0,0,0,1,0,1
122597,21010,210,10,-2,21,10,11,0,0,0,4,2,2,2,0,2,3,1,2,0,0,0,8,5,3,0,0,0,2,0,2,2,2,0
122612,21010,210,10,-2,15,4,11,0,0,0,1,0,1,3,1,2,2,0,2,0,0,0,8,2,6,0,0,0,1,1,0,0,0,0
122649,21010,210,10,-2,1,1,0,0,0,0,0,0,0,0,0,0,0,0,0,0,0,0,1,1,0,0,0,0,0,0,0,0,0,0
122685,21010,210,10,-2,7,2,5,0,0,0,0,0,0,1,0,1,2,2,0,0,0,0,3,0,3,1,0,1,0,0,0,0,0,0
122694,21010,210,10,-2,4,0,4,0,0,0,1,0,1,0,0,0,0,0,0,0,0,0,2,0,2,1,0,1,0,0,0,0,0,0
122728,21010,210,10,-2,2,2,0,0,0,0,1,1,0,0,0,0,0,0,0,0,0,0,1,1,0,0,0,0,0,0,0,0,0,0
122746,21010,210,10,-2,2,1,1,0,0,0,0,0,0,2,1,1,0,0,0,0,0,0,0,0,0,0,0,0,0,0,0,0,0,0
122755,21010,210,10,-2,68,32,36,1,1,0,13,7,6,7,2,5,8,6,2,0,0,0,22,6,16,1,0,1,2,1,1,14,9,5
122791,21010,210,10,-2,7,2,5,0,0,0,2,1,1,3,1,2,1,0,1,0,0,0,1,0,1,0,0,0,0,0,0,0,0,0
122931,21010,210,10,-2,49,25,24,0,0,0,6,4,2,8,2,6,3,1,2,0,0,0,22,14,8,0,0,0,0,0,0,10,4,6
122977,21010,210,10,-2,8,0,8,0,0,0,1,0,1,2,0,2,1,0,1,0,0,0,3,0,3,0,0,0,1,0,1,0,0,0
123013,21010,210,10,-2,11,5,6,0,0,0,0,0,0,2,2,0,2,1,1,0,0,0,6,1,5,0,0,0,1,1,0,0,0,0
123217,21010,210,10,-2,1,1,0,0,0,0,0,0,0,0,0,0,0,0,0,0,0,0,0,0,0,1,1,0,0,0,0,0,0,0
123299,21010,210,10,-2,2,1,1,0,0,0,0,0,0,0,0,0,0,0,0,0,0,0,1,0,1,0,0,0,1,1,0,0,0,0
123341,21010,210,10,-2,4,1,3,0,0,0,0,0,0,0,0,0,2,0,2,0,0,0,2,1,1,0,0,0,0,0,0,0,0,0
123457,21010,210,10,-2,3,3,0,0,0,0,0,0,0,0,0,0,0,0,0,0,0,0,2,2,0,0,0,0,1,1,0,0,0,0
123484,21010,210,10,-2,4,2,2,0,0,0,0,0,0,1,0,1,0,0,0,0,0,0,3,2,1,0,0,0,0,0,0,0,0,0
123509,21010,210,10,-2,4,2,2,0,0,0,1,0,1,2,2,0,1,0,1,0,0,0,0,0,0,0,0,0,0,0,0,0,0,0
123527,21010,210,10,-2,6,3,3,0,0,0,0,0,0,1,0,1,4,3,1,0,0,0,1,0,1,0,0,0,0,0,0,0,0,0
123554,21010,210,10,-2,8,4,4,0,0,0,3,2,1,1,0,1,1,1,0,0,0,0,2,1,1,0,0,0,1,0,1,0,0,0
123563,21010,210,10,-2,1,0,1,0,0,0,0,0,0,1,0,1,0,0,0,0,0,0,0,0,0,0,0,0,0,0,0,0,0,0
123572,21010,210,10,-2,6,1,5,0,0,0,0,0,0,0,0,0,2,0,2,0,0,0,2,0,2,0,0,0,0,0,0,2,1,1
123633,21010,210,10,-2,2,1,1,0,0,0,0,0,0,0,0,0,0,0,0,0,0,0,2,1,1,0,0,0,0,0,0,0,0,0
123651,21010,210,10,-2,2,2,0,0,0,0,0,0,0,0,0,0,0,0,0,0,0,0,2,2,0,0,0,0,0,0,0,0,0,0
123679,21010,210,10,-2,10,2,8,0,0,0,2,0,2,0,0,0,3,1,2,0,0,0,3,0,3,1,0,1,1,1,0,0,0,0
123800,21010,210,10,-2,10,4,6,0,0,0,0,0,0,2,2,0,2,0,2,1,1,0,3,0,3,0,0,0,2,1,1,0,0,0
123943,21010,210,10,-2,3,1,2,0,0,0,2,0,2,0,0,0,0,0,0,0,0,0,1,1,0,0,0,0,0,0,0,0,0,0
123952,21010,210,10,-2,2,2,0,0,0,0,0,0,0,1,1,0,0,0,0,0,0,0,1,1,0,0,0,0,0,0,0,0,0,0
123961,21010,210,10,-2,84,50,34,1,0,1,16,8,8,10,4,6,2,1,1,0,0,0,34,24,10,3,1,2,3,2,1,15,10,5
123970,21010,210,10,-2,8,4,4,0,0,0,2,1,1,2,0,2,0,0,0,0,0,0,3,2,1,0,0,0,0,0,0,1,1,0
124113,21010,210,10,-2,1,0,1,0,0,0,0,0,0,0,0,0,0,0,0,0,0,0,1,0,1,0,0,0,0,0,0,0,0,0
124283,21010,210,10,-2,3,1,2,0,0,0,2,0,2,0,0,0,0,0,0,0,0,0,1,1,0,0,0,0,0,0,0,0,0,0
124292,21010,210,10,-2,1,1,0,0,0,0,0,0,0,0,0,0,0,0,0,0,0,0,1,1,0,0,0,0,0,0,0,0,0,0
124706,21010,210,10,-2,4,1,3,0,0,0,0,0,0,0,0,0,1,0,1,0,0,0,1,0,1,1,0,1,1,1,0,0,0,0
124937,21010,210,10,-2,4,2,2,0,0,0,1,0,1,0,0,0,2,2,0,0,0,0,1,0,1,0,0,0,0,0,0,0,0,0
125028,21010,210,10,-2,8,4,4,0,0,0,1,0,1,0,0,0,1,1,0,0,0,0,4,2,2,0,0,0,2,1,1,0,0,0
125091,21010,210,10,-2,2,1,1,0,0,0,0,0,0,0,0,0,0,0,0,0,0,0,2,1,1,0,0,0,0,0,0,0,0,0
125231,21010,210,10,-2,14,5,9,0,0,0,0,0,0,9,3,6,1,0,1,0,0,0,2,1,1,1,0,1,1,1,0,0,0,0
125471,21010,210,10,-2,8,4,4,0,0,0,0,0,0,0,0,0,2,0,2,0,0,0,3,2,1,0,0,0,3,2,1,0,0,0
125532,21010,210,10,-2,8,0,8,1,0,1,1,0,1,2,0,2,0,0,0,1,0,1,3,0,3,0,0,0,0,0,0,0,0,0
125718,21010,210,10,-2,1,1,0,0,0,0,0,0,0,0,0,0,0,0,0,0,0,0,1,1,0,0,0,0,0,0,0,0,0,0
125727,21010,210,10,-2,8,6,2,0,0,0,1,1,0,2,1,1,0,0,0,0,0,0,1,1,0,0,0,0,4,3,1,0,0,0
125763,21010,210,10,-2,3,2,1,0,0,0,0,0,0,0,0,0,1,1,0,0,0,0,2,1,1,0,0,0,0,0,0,0,0,0
125897,21010,210,10,-2,2,2,0,0,0,0,0,0,0,0,0,0,0,0,0,0,0,0,2,2,0,0,0,0,0,0,0,0,0,0
126119,21010,210,10,-2,14,4,10,0,0,0,1,0,1,0,0,0,1,1,0,0,0,0,11,3,8,0,0,0,1,0,1,0,0,0
126182,21010,210,10,-2,5,4,1,0,0,0,0,0,0,0,0,0,0,0,0,0,0,0,4,3,1,0,0,0,0,0,0,1,1,0
126207,21010,210,10,-2,8,4,4,0,0,0,0,0,0,0,0,0,0,0,0,0,0,0,7,3,4,0,0,0,1,1,0,0,0,0
126289,21010,210,10,-2,9,5,4,0,0,0,0,0,0,0,0,0,0,0,0,0,0,0,8,4,4,0,0,0,1,1,0,0,0,0
126562,21010,210,10,-2,354,110,244,2,0,2,38,15,23,3,1,2,16,7,9,1,0,1,208,60,148,5,1,4,74,23,51,7,3,4
126580,21010,210,10,-2,25,10,15,0,0,0,4,4,0,0,0,0,1,0,1,0,0,0,16,4,12,0,0,0,1,0,1,3,2,1
126614,21010,210,10,-2,45,23,22,0,0,0,6,3,3,6,3,3,5,3,2,0,0,0,11,4,7,0,0,0,4,3,1,13,7,6
126669,21010,210,10,-2,13,4,9,0,0,0,1,1,0,0,0,0,0,0,0,0,0,0,11,3,8,1,0,1,0,0,0,0,0,0
126678,21010,210,10,-2,10,5,5,0,0,0,1,0,1,0,0,0,3,2,1,0,0,0,2,0,2,2,1,1,0,0,0,2,2,0
126687,21010,210,10,-2,6,0,6,0,0,0,1,0,1,0,0,0,1,0,1,0,0,0,3,0,3,1,0,1,0,0,0,0,0,0
126711,21010,210,10,-2,8,2,6,0,0,0,0,0,0,0,0,0,1,1,0,0,0,0,7,1,6,0,0,0,0,0,0,0,0,0
126748,21010,210,10,-2,4,1,3,0,0,0,0,0,0,1,1,0,1,0,1,0,0,0,2,0,2,0,0,0,0,0,0,0,0,0
126775,21010,210,10,-2,27,15,12,0,0,0,2,2,0,0,0,0,2,2,0,0,0,0,13,7,6,0,0,0,7,1,6,3,3,0
126818,21010,210,10,-2,39,22,17,0,0,0,0,0,0,0,0,0,1,1,0,0,0,0,24,11,13,1,1,0,13,9,4,0,0,0
126863,21010,210,10,-2,9,4,5,1,1,0,2,0,2,0,0,0,0,0,0,0,0,0,5,2,3,0,0,0,0,0,0,1,1,0
126942,21010,210,10,-2,14,4,10,0,0,0,1,0,1,0,0,0,1,1,0,0,0,0,10,2,8,1,0,1,1,1,0,0,0,0
126951,21010,210,10,-2,17,15,2,0,0,0,0,0,0,1,1,0,0,0,0,0,0,0,16,14,2,0,0,0,0,0,0,0,0,0
126979,21010,210,10,-2,3,1,2,0,0,0,0,0,0,1,0,1,0,0,0,0,0,0,2,1,1,0,0,0,0,0,0,0,0,0
127060,21010,210,10,-2,57,22,35,6,0,6,2,1,1,6,2,4,5,1,4,0,0,0,21,9,12,10,5,5,3,3,0,4,1,3
127185,21010,210,10,-2,12,4,8,0,0,0,0,0,0,0,0,0,0,0,0,0,0,0,11,3,8,0,0,0,1,1,0,0,0,0
127200,21010,210,10,-2,12,3,9,0,0,0,2,1,1,1,0,1,1,0,1,0,0,0,8,2,6,0,0,0,0,0,0,0,0,0
127389,21010,210,10,-2,6,5,1,0,0,0,0,0,0,0,0,0,0,0,0,0,0,0,4,3,1,1,1,0,0,0,0,1,1,0
127556,21010,210,10,-2,32,12,20,0,0,0,0,0,0,0,0,0,1,0,1,0,0,0,27,9,18,0,0,0,1,0,1,3,3,0
127565,21010,210,10,-2,25,11,14,1,0,1,6,4,2,3,2,1,3,0,3,0,0,0,11,4,7,0,0,0,1,1,0,0,0,0
127617,21010,210,10,-2,3,3,0,0,0,0,0,0,0,0,0,0,1,1,0,0,0,0,2,2,0,0,0,0,0,0,0,0,0,0
127653,21010,210,10,-2,13,2,11,0,0,0,0,0,0,2,0,2,2,0,2,0,0,0,5,1,4,0,0,0,4,1,3,0,0,0
127732,21010,210,10,-2,8,3,5,0,0,0,0,0,0,0,0,0,0,0,0,0,0,0,8,3,5,0,0,0,0,0,0,0,0,0
127741,21010,210,10,-2,18,10,8,0,0,0,3,2,1,0,0,0,2,1,1,0,0,0,13,7,6,0,0,0,0,0,0,0,0,0
127778,21010,210,10,-2,3,0,3,1,0,1,0,0,0,0,0,0,1,0,1,0,0,0,1,0,1,0,0,0,0,0,0,0,0,0
127820,21010,210,10,-2,24,11,13,1,1,0,1,0,1,4,1,3,1,0,1,0,0,0,16,9,7,1,0,1,0,0,0,0,0,0
127884,21010,210,10,-2,8,2,6,1,0,1,1,1,0,0,0,0,1,0,1,0,0,0,5,1,4,0,0,0,0,0,0,0,0,0
127909,21010,210,10,-2,6,3,3,0,0,0,2,1,1,0,0,0,0,0,0,0,0,0,4,2,2,0,0,0,0,0,0,0,0,0
127918,21010,210,10,-2,19,6,13,0,0,0,0,0,0,2,0,2,2,0,2,0,0,0,12,5,7,1,1,0,2,0,2,0,0,0
127945,21010,210,10,-2,6,1,5,0,0,0,0,0,0,0,0,0,0,0,0,0,0,0,6,1,5,0,0,0,0,0,0,0,0,0
128106,21010,210,10,-2,18,9,9,0,0,0,5,2,3,0,0,0,2,1,1,0,0,0,10,5,5,0,0,0,1,1,0,0,0,0
128179,21010,210,10,-2,6,2,4,1,1,0,0,0,0,1,0,1,2,0,2,0,0,0,2,1,1,0,0,0,0,0,0,0,0,0
128188,21010,210,10,-2,15,5,10,0,0,0,0,0,0,0,0,0,3,1,2,0,0,0,8,3,5,0,0,0,4,1,3,0,0,0
128258,21010,210,10,-2,4,2,2,0,0,0,0,0,0,0,0,0,0,0,0,0,0,0,4,2,2,0,0,0,0,0,0,0,0,0
128328,21010,210,10,-2,53,31,22,0,0,0,1,0,1,0,0,0,0,0,0,0,0,0,43,26,17,0,0,0,9,5,4,0,0,0
128391,21010,210,10,-2,16,9,7,0,0,0,0,0,0,0,0,0,2,1,1,0,0,0,11,7,4,1,0,1,0,0,0,2,1,1
128498,21010,210,10,-2,5,1,4,0,0,0,1,0,1,1,1,0,2,0,2,0,0,0,1,0,1,0,0,0,0,0,0,0,0,0
128744,21010,210,10,-2,132,68,64,0,0,0,12,9,3,9,4,5,9,3,6,0,0,0,91,44,47,2,2,0,9,6,3,0,0,0
128771,21010,210,10,-2,14,9,5,0,0,0,2,2,0,0,0,0,1,1,0,0,0,0,7,4,3,1,0,1,0,0,0,3,2,1
128902,21010,210,10,-2,7,4,3,0,0,0,0,0,0,0,0,0,0,0,0,0,0,0,4,3,1,0,0,0,1,0,1,2,1,1
129020,21010,210,10,-2,145,54,91,0,0,0,21,8,13,10,2,8,8,3,5,0,0,0,67,22,45,6,2,4,8,3,5,25,14,11
129154,21010,210,10,-2,4,0,4,0,0,0,1,0,1,0,0,0,0,0,0,0,0,0,2,0,2,1,0,1,0,0,0,0,0,0
129215,21010,210,10,-2,3,1,2,0,0,0,1,0,1,0,0,0,0,0,0,0,0,0,2,1,1,0,0,0,0,0,0,0,0,0
129242,21010,210,10,-2,22,10,12,0,0,0,3,0,3,1,1,0,2,1,1,0,0,0,14,6,8,0,0,0,0,0,0,2,2,0
129525,21010,210,10,-2,35,17,18,0,0,0,0,0,0,2,2,0,3,2,1,0,0,0,17,7,10,1,0,1,2,1,1,10,5,5
129543,21010,210,10,-2,4,2,2,0,0,0,1,0,1,1,0,1,0,0,0,0,0,0,1,1,0,1,1,0,0,0,0,0,0,0
129695,21010,210,10,-2,3,0,3,0,0,0,0,0,0,0,0,0,0,0,0,1,0,1,2,0,2,0,0,0,0,0,0,0,0,0
129774,21010,210,10,-2,2,1,1,0,0,0,0,0,0,0,0,0,0,0,0,0,0,0,2,1,1,0,0,0,0,0,0,0,0,0
129941,21010,210,10,-2,26,11,15,0,0,0,9,4,5,1,0,1,1,0,1,0,0,0,15,7,8,0,0,0,0,0,0,0,0,0
130040,21010,210,10,-2,6,1,5,0,0,0,1,1,0,0,0,0,0,0,0,0,0,0,5,0,5,0,0,0,0,0,0,0,0,0
130110,21010,210,10,-2,6,2,4,0,0,0,1,0,1,0,0,0,0,0,0,0,0,0,5,2,3,0,0,0,0,0,0,0,0,0
130183,21010,210,10,-2,2,0,2,0,0,0,0,0,0,0,0,0,0,0,0,0,0,0,2,0,2,0,0,0,0,0,0,0,0,0
130217,21010,210,10,-2,1,1,0,0,0,0,0,0,0,1,1,0,0,0,0,0,0,0,0,0,0,0,0,0,0,0,0,0,0,0
130226,21010,210,10,-2,19,8,11,0,0,0,1,1,0,1,0,1,1,0,1,0,0,0,16,7,9,0,0,0,0,0,0,0,0,0
130253,21010,210,10,-2,40,12,28,0,0,0,4,2,2,3,0,3,4,0,4,0,0,0,22,8,14,1,0,1,4,1,3,2,1,1
130314,21010,210,10,-2,11,0,11,0,0,0,2,0,2,0,0,0,2,0,2,0,0,0,6,0,6,1,0,1,0,0,0,0,0,0
130396,21010,210,10,-2,1,0,1,0,0,0,0,0,0,0,0,0,1,0,1,0,0,0,0,0,0,0,0,0,0,0,0,0,0,0
130493,21010,210,10,-2,29,10,19,0,0,0,1,0,1,1,0,1,2,1,1,0,0,0,21,6,15,0,0,0,0,0,0,4,3,1
130590,21010,210,10,-2,24,10,14,0,0,0,4,1,3,6,2,4,3,1,2,0,0,0,9,6,3,1,0,1,0,0,0,1,0,1
130606,21010,210,10,-2,2,2,0,0,0,0,0,0,0,0,0,0,0,0,0,0,0,0,1,1,0,0,0,0,1,1,0,0,0,0
130624,21010,210,10,-2,42,28,14,0,0,0,0,0,0,3,2,1,1,1,0,0,0,0,38,25,13,0,0,0,0,0,0,0,0,0
130697,21010,210,10,-2,32,16,16,1,0,1,6,1,5,4,1,3,6,5,1,0,0,0,11,6,5,0,0,0,1,1,0,3,2,1
130776,21010,210,10,-2,1,0,1,0,0,0,0,0,0,0,0,0,0,0,0,0,0,0,0,0,0,1,0,1,0,0,0,0,0,0
130794,21010,210,10,-2,159,72,87,0,0,0,26,14,12,16,3,13,5,2,3,0,0,0,68,33,35,2,0,2,9,3,6,33,17,16
130907,21010,210,10,-2,21,6,15,1,0,1,0,0,0,6,3,3,0,0,0,0,0,0,14,3,11,0,0,0,0,0,0,0,0,0
130934,21010,210,10,-2,23,10,13,0,0,0,2,0,2,2,0,2,0,0,0,0,0,0,19,10,9,0,0,0,0,0,0,0,0,0
130943,21010,210,10,-2,35,22,13,0,0,0,3,2,1,3,2,1,3,3,0,0,0,0,19,10,9,1,1,0,0,0,0,6,4,2
131113,21010,210,10,-2,3,1,2,0,0,0,1,1,0,0,0,0,1,0,1,0,0,0,1,0,1,0,0,0,0,0,0,0,0,0
131159,21010,210,10,-2,56,19,37,0,0,0,9,4,5,13,5,8,1,1,0,0,0,0,28,7,21,0,0,0,2,2,0,3,0,3
131283,21010,210,10,-2,5,4,1,0,0,0,0,0,0,0,0,0,2,2,0,0,0,0,3,2,1,0,0,0,0,0,0,0,0,0
131399,21010,210,10,-2,6,3,3,0,0,0,2,1,1,1,0,1,0,0,0,0,0,0,2,1,1,0,0,0,1,1,0,0,0,0
131450,21010,210,10,-2,9,5,4,0,0,0,3,1,2,1,1,0,2,2,0,0,0,0,3,1,2,0,0,0,0,0,0,0,0,0
131469,21010,210,10,-2,54,22,32,0,0,0,8,4,4,7,1,6,3,0,3,0,0,0,31,15,16,0,0,0,5,2,3,0,0,0
131496,21010,210,10,-2,56,29,27,0,0,0,3,1,2,6,3,3,2,0,2,0,0,0,26,13,13,0,0,0,5,2,3,14,10,4
131520,21010,210,10,-2,92,39,53,0,0,0,14,7,7,47,17,30,11,5,6,0,0,0,7,3,4,4,2,2,9,5,4,0,0,0
131803,21010,210,10,-2,11,8,3,0,0,0,3,2,1,2,1,1,0,0,0,0,0,0,3,3,0,0,0,0,3,2,1,0,0,0
131876,21010,210,10,-2,5,1,4,0,0,0,0,0,0,3,1,2,1,0,1,0,0,0,1,0,1,0,0,0,0,0,0,0,0,0
132408,21010,210,10,-2,1,0,1,0,0,0,0,0,0,0,0,0,0,0,0,0,0,0,1,0,1,0,0,0,0,0,0,0,0,0
132471,21010,210,10,-2,16,5,11,0,0,0,0,0,0,3,0,3,2,0,2,0,0,0,7,3,4,0,0,0,1,1,0,3,1,2
132602,21010,210,10,-2,8,5,3,0,0,0,1,1,0,5,3,2,0,0,0,0,0,0,2,1,1,0,0,0,0,0,0,0,0,0
132657,21010,210,10,-2,11,7,4,0,0,0,0,0,0,0,0,0,3,2,1,1,0,1,5,4,1,2,1,1,0,0,0,0,0,0
132693,21010,210,10,-2,14,2,12,0,0,0,0,0,0,3,1,2,2,0,2,0,0,0,9,1,8,0,0,0,0,0,0,0,0,0
132709,21010,210,10,-2,2,1,1,0,0,0,1,1,0,1,0,1,0,0,0,0,0,0,0,0,0,0,0,0,0,0,0,0,0,0
132842,21010,210,10,-2,4,2,2,0,0,0,0,0,0,0,0,0,4,2,2,0,0,0,0,0,0,0,0,0,0,0,0,0,0,0
132851,21010,210,10,-2,11,3,8,0,0,0,1,1,0,0,0,0,0,0,0,0,0,0,9,2,7,1,0,1,0,0,0,0,0,0
132879,21010,210,10,-2,1,0,1,0,0,0,0,0,0,0,0,0,0,0,0,0,0,0,1,0,1,0,0,0,0,0,0,0,0,0
132903,21010,210,10,-2,12,4,8,0,0,0,2,1,1,1,1,0,2,0,2,0,0,0,5,2,3,1,0,1,0,0,0,1,0,1
133021,21010,210,10,-2,1,0,1,0,0,0,0,0,0,0,0,0,0,0,0,0,0,0,1,0,1,0,0,0,0,0,0,0,0,0
133386,21010,210,10,-2,5,1,4,0,0,0,0,0,0,0,0,0,1,1,0,0,0,0,4,0,4,0,0,0,0,0,0,0,0,0
133465,21010,210,10,-2,8,2,6,0,0,0,0,0,0,4,0,4,1,0,1,0,0,0,2,1,1,0,0,0,1,1,0,0,0,0
133492,21010,210,10,-2,15,4,11,0,0,0,1,1,0,0,0,0,0,0,0,0,0,0,12,3,9,1,0,1,1,0,1,0,0,0
133508,21010,210,10,-2,7,2,5,0,0,0,0,0,0,1,1,0,0,0,0,0,0,0,5,1,4,0,0,0,1,0,1,0,0,0
133553,21010,210,10,-2,38,21,17,0,0,0,4,3,1,0,0,0,2,1,1,0,0,0,19,10,9,0,0,0,4,2,2,9,5,4
133650,21010,210,10,-2,40,22,18,0,0,0,4,3,1,25,12,13,1,1,0,0,0,0,7,4,3,0,0,0,0,0,0,3,2,1
133669,21010,210,10,-2,15,9,6,0,0,0,3,2,1,1,0,1,2,0,2,0,0,0,7,6,1,0,0,0,0,0,0,2,1,1
133702,21010,210,10,-2,13,6,7,0,0,0,1,1,0,3,1,2,0,0,0,0,0,0,9,4,5,0,0,0,0,0,0,0,0,0
133711,21010,210,10,-2,14,9,5,0,0,0,1,1,0,1,0,1,0,0,0,0,0,0,11,7,4,0,0,0,1,1,0,0,0,0
133809,21010,210,10,-2,9,3,6,0,0,0,0,0,0,0,0,0,0,0,0,0,0,0,9,3,6,0,0,0,0,0,0,0,0,0
133845,21010,210,10,-2,5,0,5,0,0,0,0,0,0,1,0,1,2,0,2,0,0,0,2,0,2,0,0,0,0,0,0,0,0,0
133854,21010,210,10,-2,1,1,0,0,0,0,0,0,0,1,1,0,0,0,0,0,0,0,0,0,0,0,0,0,0,0,0,0,0,0
133863,21010,210,10,-2,4,1,3,0,0,0,1,1,0,0,0,0,2,0,2,0,0,0,0,0,0,0,0,0,1,0,1,0,0,0
133872,21010,210,10,-2,6,0,6,0,0,0,0,0,0,1,0,1,3,0,3,0,0,0,2,0,2,0,0,0,0,0,0,0,0,0
133881,21010,210,10,-2,16,11,5,1,1,0,4,2,2,0,0,0,0,0,0,0,0,0,9,6,3,0,0,0,1,1,0,1,1,0
133951,21010,210,10,-2,159,85,74,1,1,0,16,11,5,15,5,10,32,15,17,0,0,0,78,41,37,0,0,0,0,0,0,17,12,5
133960,21010,210,10,-2,4,1,3,0,0,0,0,0,0,0,0,0,0,0,0,0,0,0,3,1,2,0,0,0,1,0,1,0,0,0
133979,21010,210,10,-2,5,1,4,0,0,0,0,0,0,4,1,3,0,0,0,0,0,0,1,0,1,0,0,0,0,0,0,0,0,0
134079,21010,210,10,-2,9,6,3,0,0,0,0,0,0,1,0,1,1,1,0,0,0,0,7,5,2,0,0,0,0,0,0,0,0,0
134097,21010,210,10,-2,81,41,40,0,0,0,1,0,1,6,5,1,5,3,2,0,0,0,57,28,29,2,1,1,1,0,1,9,4,5
134130,21010,210,10,-2,107,58,49,0,0,0,11,8,3,11,5,6,11,4,7,0,0,0,44,21,23,0,0,0,9,5,4,21,15,6
134237,21010,210,10,-2,24,19,5,0,0,0,1,1,0,2,1,1,5,3,2,0,0,0,15,13,2,1,1,0,0,0,0,0,0,0
134343,21010,210,10,-2,12,3,9,0,0,0,0,0,0,1,0,1,1,0,1,0,0,0,8,2,6,0,0,0,2,1,1,0,0,0
134495,21010,210,10,-2,5,2,3,0,0,0,0,0,0,0,0,0,0,0,0,0,0,0,5,2,3,0,0,0,0,0,0,0,0,0
134608,21010,210,10,-2,2,1,1,0,0,0,0,0,0,1,0,1,0,0,0,0,0,0,1,1,0,0,0,0,0,0,0,0,0,0
134945,21010,210,10,-2,16,3,13,0,0,0,2,1,1,5,1,4,0,0,0,0,0,0,9,1,8,0,0,0,0,0,0,0,0,0
135081,21010,210,10,-2,37,16,21,1,1,0,2,0,2,9,3,6,8,4,4,0,0,0,15,7,8,2,1,1,0,0,0,0,0,0
135160,21010,210,10,-2,10,2,8,0,0,0,0,0,0,1,0,1,0,0,0,0,0,0,9,2,7,0,0,0,0,0,0,0,0,0
135188,21010,210,10,-2,1,0,1,0,0,0,0,0,0,0,0,0,0,0,0,0,0,0,1,0,1,0,0,0,0,0,0,0,0,0
135391,21010,210,10,-2,8,2,6,0,0,0,0,0,0,1,1,0,0,0,0,0,0,0,7,1,6,0,0,0,0,0,0,0,0,0
135717,21010,210,10,-2,18,3,15,0,0,0,1,0,1,4,1,3,11,1,10,0,0,0,1,1,0,0,0,0,0,0,0,1,0,1
135726,21010,210,10,-2,57,36,21,0,0,0,3,3,0,8,4,4,9,6,3,0,0,0,23,13,10,2,1,1,4,2,2,8,7,1
136145,21010,210,10,-2,2,0,2,0,0,0,0,0,0,0,0,0,0,0,0,0,0,0,2,0,2,0,0,0,0,0,0,0,0,0
136172,21010,210,10,-2,39,16,23,0,0,0,5,3,2,5,1,4,1,0,1,1,0,1,20,8,12,1,0,1,0,0,0,6,4,2
136215,21010,210,10,-2,108,46,62,0,0,0,6,2,4,9,1,8,14,7,7,0,0,0,65,28,37,0,0,0,1,1,0,13,7,6
136233,21010,210,10,-2,15,7,8,0,0,0,0,0,0,1,0,1,3,2,1,0,0,0,9,4,5,1,1,0,0,0,0,1,0,1
136330,21010,210,10,-2,11,6,5,0,0,0,0,0,0,2,2,0,2,1,1,0,0,0,6,2,4,0,0,0,0,0,0,1,1,0
136358,21010,210,10,-2,3,1,2,1,0,1,0,0,0,1,0,1,0,0,0,0,0,0,1,1,0,0,0,0,0,0,0,0,0,0
136400,21010,210,10,-2,8,0,8,0,0,0,0,0,0,1,0,1,0,0,0,0,0,0,7,0,7,0,0,0,0,0,0,0,0,0
136473,21010,210,10,-2,15,9,6,0,0,0,0,0,0,0,0,0,0,0,0,0,0,0,14,9,5,1,0,1,0,0,0,0,0,0
136516,21010,210,10,-2,13,1,12,0,0,0,0,0,0,2,0,2,2,1,1,0,0,0,8,0,8,1,0,1,0,0,0,0,0,0
136701,21010,210,10,-2,4,4,0,0,0,0,1,1,0,0,0,0,1,1,0,0,0,0,1,1,0,0,0,0,0,0,0,1,1,0
136774,21010,210,10,-2,6,3,3,0,0,0,0,0,0,0,0,0,1,1,0,0,0,0,5,2,3,0,0,0,0,0,0,0,0,0
136950,21010,210,10,-2,32,12,20,0,0,0,1,0,1,2,1,1,2,1,1,0,0,0,20,8,12,0,0,0,1,0,1,6,2,4
137032,21010,210,10,-2,1,0,1,0,0,0,0,0,0,0,0,0,0,0,0,0,0,0,1,0,1,0,0,0,0,0,0,0,0,0
137078,21010,210,10,-2,15,0,15,0,0,0,0,0,0,2,0,2,1,0,1,0,0,0,10,0,10,0,0,0,2,0,2,0,0,0
137096,21010,210,10,-2,19,7,12,0,0,0,1,0,1,2,1,1,2,1,1,0,0,0,13,5,8,0,0,0,1,0,1,0,0,0
137209,21010,210,10,-2,6,3,3,0,0,0,2,2,0,0,0,0,0,0,0,0,0,0,4,1,3,0,0,0,0,0,0,0,0,0
137315,21010,210,10,-2,9,3,6,0,0,0,0,0,0,1,0,1,0,0,0,0,0,0,7,3,4,0,0,0,1,0,1,0,0,0
137351,21010,210,10,-2,143,59,84,0,0,0,22,11,11,6,1,5,7,3,4,0,0,0,73,30,43,12,5,7,3,1,2,20,8,12
137476,21010,210,10,-2,16,9,7,0,0,0,0,0,0,1,1,0,5,2,3,0,0,0,10,6,4,0,0,0,0,0,0,0,0,0
137546,21010,210,10,-2,13,7,6,0,0,0,1,1,0,0,0,0,0,0,0,0,0,0,8,5,3,0,0,0,2,1,1,2,0,2
137564,21010,210,10,-2,6,3,3,0,0,0,0,0,0,0,0,0,0,0,0,0,0,0,6,3,3,0,0,0,0,0,0,0,0,0
137759,21010,210,10,-2,9,3,6,0,0,0,0,0,0,0,0,0,0,0,0,0,0,0,8,2,6,0,0,0,1,1,0,0,0,0
137847,21010,210,10,-2,45,24,21,0,0,0,6,4,2,5,1,4,2,2,0,0,0,0,23,11,12,1,1,0,8,5,3,0,0,0
137962,21010,210,10,-2,1,1,0,0,0,0,0,0,0,0,0,0,0,0,0,0,0,0,1,1,0,0,0,0,0,0,0,0,0,0
138187,21010,210,10,-2,5,0,5,0,0,0,0,0,0,3,0,3,0,0,0,0,0,0,2,0,2,0,0,0,0,0,0,0,0,0
138275,21010,210,10,-2,4,2,2,0,0,0,0,0,0,2,0,2,0,0,0,0,0,0,2,2,0,0,0,0,0,0,0,0,0,0
138293,21010,210,10,-2,5,2,3,0,0,0,0,0,0,0,0,0,0,0,0,0,0,0,5,2,3,0,0,0,0,0,0,0,0,0
138309,21010,210,10,-2,35,5,30,0,0,0,0,0,0,8,0,8,0,0,0,0,0,0,26,5,21,1,0,1,0,0,0,0,0,0
138354,21010,210,10,-2,11,5,6,0,0,0,2,1,1,1,0,1,0,0,0,0,0,0,8,4,4,0,0,0,0,0,0,0,0,0
138558,21010,210,10,-2,9,3,6,0,0,0,0,0,0,1,0,1,0,0,0,0,0,0,8,3,5,0,0,0,0,0,0,0,0,0
138600,21010,210,10,-2,4,2,2,0,0,0,2,1,1,0,0,0,0,0,0,0,0,0,2,1,1,0,0,0,0,0,0,0,0,0
138682,21010,210,10,-2,15,6,9,0,0,0,2,1,1,10,3,7,0,0,0,0,0,0,2,1,1,0,0,0,1,1,0,0,0,0
138716,21010,210,10,-2,21,7,14,0,0,0,3,3,0,9,1,8,1,0,1,0,0,0,8,3,5,0,0,0,0,0,0,0,0,0
138761,21010,210,10,-2,4,2,2,0,0,0,0,0,0,1,1,0,0,0,0,0,0,0,3,1,2,0,0,0,0,0,0,0,0,0
138840,21010,210,10,-2,14,3,11,1,0,1,0,0,0,12,3,9,1,0,1,0,0,0,0,0,0,0,0,0,0,0,0,0,0,0
138868,21010,210,10,-2,4,3,1,0,0,0,0,0,0,0,0,0,0,0,0,0,0,0,4,3,1,0,0,0,0,0,0,0,0,0
138901,21010,210,10,-2,1,1,0,0,0,0,0,0,0,1,1,0,0,0,0,0,0,0,0,0,0,0,0,0,0,0,0,0,0,0
138947,21010,210,10,-2,27,13,14,0,0,0,4,3,1,21,8,13,0,0,0,0,0,0,1,1,0,0,0,0,0,0,0,1,1,0
138956,21010,210,10,-2,16,7,9,0,0,0,0,0,0,7,2,5,2,1,1,0,0,0,7,4,3,0,0,0,0,0,0,0,0,0
139144,21010,210,10,-2,19,10,9,0,0,0,1,1,0,2,0,2,1,0,1,0,0,0,11,7,4,1,0,1,2,1,1,1,1,0
139199,21010,210,10,-2,20,4,16,0,0,0,3,2,1,2,0,2,1,0,1,0,0,0,14,2,12,0,0,0,0,0,0,0,0,0
139205,21010,210,10,-2,4,3,1,0,0,0,0,0,0,0,0,0,0,0,0,0,0,0,4,3,1,0,0,0,0,0,0,0,0,0
139250,21010,210,10,-2,10,6,4,0,0,0,0,0,0,2,2,0,2,2,0,0,0,0,6,2,4,0,0,0,0,0,0,0,0,0
139278,21010,210,10,-2,18,5,13,0,0,0,0,0,0,4,1,3,0,0,0,0,0,0,14,4,10,0,0,0,0,0,0,0,0,0
139311,21010,210,10,-2,13,4,9,0,0,0,1,0,1,4,0,4,0,0,0,0,0,0,8,4,4,0,0,0,0,0,0,0,0,0
139357,21010,210,10,-2,19,6,13,0,0,0,1,1,0,9,2,7,1,1,0,0,0,0,8,2,6,0,0,0,0,0,0,0,0,0
139366,21010,210,10,-2,17,10,7,0,0,0,2,1,1,4,2,2,0,0,0,0,0,0,10,6,4,0,0,0,1,1,0,0,0,0
139393,21010,210,10,-2,2,1,1,0,0,0,0,0,0,0,0,0,1,0,1,0,0,0,1,1,0,0,0,0,0,0,0,0,0,0
139463,21010,210,10,-2,3,1,2,0,0,0,1,0,1,0,0,0,0,0,0,0,0,0,2,1,1,0,0,0,0,0,0,0,0,0
139579,21010,210,10,-2,5,2,3,0,0,0,0,0,0,2,1,1,0,0,0,0,0,0,3,1,2,0,0,0,0,0,0,0,0,0
139630,21010,210,10,-2,3,2,1,0,0,0,0,0,0,0,0,0,0,0,0,0,0,0,3,2,1,0,0,0,0,0,0,0,0,0
139658,21010,210,10,-2,62,19,43,1,0,1,17,4,13,10,4,6,3,1,2,0,0,0,24,8,16,0,0,0,0,0,0,7,2,5
139700,21010,210,10,-2,5,1,4,0,0,0,0,0,0,0,0,0,1,0,1,0,0,0,3,1,2,1,0,1,0,0,0,0,0,0
139719,21010,210,10,-2,11,3,8,0,0,0,0,0,0,8,1,7,1,1,0,0,0,0,2,1,1,0,0,0,0,0,0,0,0,0
139755,21010,210,10,-2,45,26,19,0,0,0,11,4,7,2,2,0,3,2,1,0,0,0,14,9,5,1,1,0,4,2,2,10,6,4
139764,21010,210,10,-2,6,1,5,0,0,0,0,0,0,0,0,0,0,0,0,0,0,0,6,1,5,0,0,0,0,0,0,0,0,0
139861,21010,210,10,-2,20,12,8,0,0,0,0,0,0,1,0,1,1,0,1,0,0,0,15,11,4,0,0,0,0,0,0,3,1,2
139931,21010,210,10,-2,65,25,40,0,0,0,10,4,6,6,0,6,5,2,3,0,0,0,40,16,24,1,1,0,3,2,1,0,0,0
139940,21010,210,10,-2,78,36,42,0,0,0,15,7,8,19,6,13,3,0,3,0,0,0,32,17,15,0,0,0,1,1,0,8,5,3
139959,21010,210,10,-2,83,45,38,0,0,0,13,9,4,7,5,2,6,2,4,0,0,0,32,19,13,2,1,1,5,1,4,18,8,10
139968,21010,210,10,-2,1,0,1,0,0,0,0,0,0,0,0,0,0,0,0,0,0,0,1,0,1,0,0,0,0,0,0,0,0,0
140012,21010,210,10,-2,13,6,7,0,0,0,0,0,0,5,2,3,1,1,0,0,0,0,7,3,4,0,0,0,0,0,0,0,0,0
140146,21010,210,10,-2,2,1,1,0,0,0,0,0,0,1,0,1,1,1,0,0,0,0,0,0,0,0,0,0,0,0,0,0,0,0
140243,21010,210,10,-2,13,2,11,0,0,0,2,0,2,1,0,1,1,1,0,0,0,0,9,1,8,0,0,0,0,0,0,0,0,0
140252,21010,210,10,-2,7,4,3,0,0,0,0,0,0,0,0,0,0,0,0,0,0,0,7,4,3,0,0,0,0,0,0,0,0,0
140331,21010,210,10,-2,18,7,11,0,0,0,0,0,0,4,0,4,1,0,1,0,0,0,13,7,6,0,0,0,0,0,0,0,0,0
140447,21010,210,10,-2,56,27,29,0,0,0,8,5,3,11,0,11,1,0,1,0,0,0,33,20,13,0,0,0,0,0,0,3,2,1
140562,21010,210,10,-2,19,6,13,0,0,0,3,1,2,13,4,9,0,0,0,0,0,0,2,1,1,1,0,1,0,0,0,0,0,0
140678,21010,210,10,-2,11,6,5,0,0,0,0,0,0,0,0,0,0,0,0,0,0,0,11,6,5,0,0,0,0,0,0,0,0,0
140696,21010,210,10,-2,14,8,6,0,0,0,1,1,0,3,2,1,0,0,0,0,0,0,9,4,5,1,1,0,0,0,0,0,0,0
140720,21010,210,10,-2,2,1,1,0,0,0,0,0,0,2,1,1,0,0,0,0,0,0,0,0,0,0,0,0,0,0,0,0,0,0
140818,21010,210,10,-2,13,5,8,0,0,0,0,0,0,1,0,1,0,0,0,0,0,0,11,4,7,1,1,0,0,0,0,0,0,0
140872,21010,210,10,-2,6,4,2,0,0,0,1,1,0,1,0,1,0,0,0,0,0,0,4,3,1,0,0,0,0,0,0,0,0,0
140942,21010,210,10,-2,22,10,12,0,0,0,1,0,1,5,0,5,2,1,1,0,0,0,12,8,4,2,1,1,0,0,0,0,0,0
140951,21010,210,10,-2,78,39,39,0,0,0,4,2,2,10,2,8,2,2,0,0,0,0,47,24,23,4,2,2,6,3,3,5,4,1
140960,21010,210,10,-2,5,3,2,0,0,0,1,1,0,3,2,1,0,0,0,0,0,0,1,0,1,0,0,0,0,0,0,0,0,0
140988,21010,210,10,-2,8,4,4,0,0,0,0,0,0,0,0,0,0,0,0,0,0,0,8,4,4,0,0,0,0,0,0,0,0,0
141006,21010,210,10,-2,4,3,1,0,0,0,0,0,0,1,1,0,0,0,0,0,0,0,3,2,1,0,0,0,0,0,0,0,0,0
141060,21010,210,10,-2,25,10,15,0,0,0,4,1,3,12,3,9,3,2,1,0,0,0,6,4,2,0,0,0,0,0,0,0,0,0
141167,21010,210,10,-2,10,3,7,0,0,0,0,0,0,2,2,0,0,0,0,0,0,0,8,1,7,0,0,0,0,0,0,0,0,0
141185,21010,210,10,-2,2,2,0,0,0,0,0,0,0,0,0,0,0,0,0,0,0,0,2,2,0,0,0,0,0,0,0,0,0,0
141237,21010,210,10,-2,3,1,2,0,0,0,0,0,0,0,0,0,0,0,0,0,0,0,3,1,2,0,0,0,0,0,0,0,0,0
141255,21010,210,10,-2,24,7,17,0,0,0,0,0,0,3,1,2,0,0,0,0,0,0,21,6,15,0,0,0,0,0,0,0,0,0
141264,21010,210,10,-2,27,8,19,0,0,0,7,4,3,2,0,2,1,0,1,0,0,0,17,4,13,0,0,0,0,0,0,0,0,0
141325,21010,210,10,-2,2,1,1,0,0,0,0,0,0,2,1,1,0,0,0,0,0,0,0,0,0,0,0,0,0,0,0,0,0,0
141334,21010,210,10,-2,16,5,11,0,0,0,0,0,0,5,2,3,0,0,0,0,0,0,9,2,7,1,0,1,1,1,0,0,0,0
141361,21010,210,10,-2,3,2,1,0,0,0,0,0,0,0,0,0,0,0,0,0,0,0,1,1,0,0,0,0,2,1,1,0,0,0
141486,21010,210,10,-2,9,2,7,0,0,0,1,0,1,0,0,0,1,0,1,1,1,0,4,1,3,2,0,2,0,0,0,0,0,0
141565,21010,210,10,-2,1,0,1,0,0,0,0,0,0,1,0,1,0,0,0,0,0,0,0,0,0,0,0,0,0,0,0,0,0,0
141574,21010,210,10,-2,8,6,2,0,0,0,1,1,0,0,0,0,0,0,0,0,0,0,6,5,1,1,0,1,0,0,0,0,0,0
141644,21010,210,10,-2,17,3,14,0,0,0,3,0,3,1,0,1,2,0,2,2,1,1,9,2,7,0,0,0,0,0,0,0,0,0
141811,21010,210,10,-2,1,0,1,0,0,0,0,0,0,0,0,0,0,0,0,0,0,0,1,0,1,0,0,0,0,0,0,0,0,0
142054,21010,210,10,-2,10,0,10,0,0,0,0,0,0,0,0,0,1,0,1,0,0,0,7,0,7,1,0,1,1,0,1,0,0,0
142115,21010,210,10,-2,41,13,28,0,0,0,1,0,1,0,0,0,3,2,1,0,0,0,30,7,23,2,0,2,1,0,1,4,4,0
142179,21010,210,10,-2,4,2,2,0,0,0,0,0,0,0,0,0,0,0,0,0,0,0,4,2,2,0,0,0,0,0,0,0,0,0
142276,21010,210,10,-2,24,12,12,0,0,0,2,1,1,0,0,0,0,0,0,0,0,0,14,7,7,0,0,0,8,4,4,0,0,0
142285,21010,210,10,-2,14,6,8,0,0,0,1,0,1,1,0,1,0,0,0,0,0,0,7,5,2,0,0,0,3,0,3,2,1,1
142294,21010,210,10,-2,13,9,4,0,0,0,1,1,0,0,0,0,4,3,1,0,0,0,7,4,3,0,0,0,0,0,0,1,1,0
142328,21010,210,10,-2,6,0,6,0,0,0,0,0,0,0,0,0,0,0,0,0,0,0,5,0,5,1,0,1,0,0,0,0,0,0
142443,21010,210,10,-2,5,2,3,0,0,0,0,0,0,0,0,0,0,0,0,0,0,0,4,2,2,1,0,1,0,0,0,0,0,0
142461,21010,210,10,-2,11,3,8,0,0,0,1,0,1,0,0,0,0,0,0,0,0,0,7,2,5,0,0,0,3,1,2,0,0,0
142559,21010,210,10,-2,17,6,11,0,0,0,0,0,0,0,0,0,1,0,1,0,0,0,13,4,9,1,1,0,2,1,1,0,0,0
142832,21010,210,10,-2,9,2,7,0,0,0,0,0,0,3,0,3,1,0,1,0,0,0,4,1,3,0,0,0,1,1,0,0,0,0
143048,21010,210,10,-2,3,0,3,0,0,0,0,0,0,1,0,1,0,0,0,0,0,0,0,0,0,1,0,1,0,0,0,1,0,1
143084,21010,210,10,-2,12,4,8,0,0,0,2,1,1,2,1,1,0,0,0,0,0,0,8,2,6,0,0,0,0,0,0,0,0,0
143118,21010,210,10,-2,19,4,15,0,0,0,1,1,0,3,0,3,1,0,1,0,0,0,14,3,11,0,0,0,0,0,0,0,0,0
143215,21010,210,10,-2,10,4,6,0,0,0,0,0,0,1,1,0,0,0,0,0,0,0,9,3,6,0,0,0,0,0,0,0,0,0
143279,21010,210,10,-2,6,3,3,0,0,0,0,0,0,0,0,0,0,0,0,0,0,0,3,1,2,0,0,0,3,2,1,0,0,0
143288,21010,210,10,-2,3,2,1,0,0,0,0,0,0,0,0,0,0,0,0,0,0,0,3,2,1,0,0,0,0,0,0,0,0,0
143297,21010,210,10,-2,1,0,1,0,0,0,0,0,0,0,0,0,0,0,0,0,0,0,1,0,1,0,0,0,0,0,0,0,0,0
143358,21010,210,10,-2,25,12,13,0,0,0,5,4,1,1,0,1,1,1,0,0,0,0,17,6,11,1,1,0,0,0,0,0,0,0
143613,21010,210,10,-2,1,0,1,0,0,0,0,0,0,0,0,0,0,0,0,0,0,0,1,0,1,0,0,0,0,0,0,0,0,0
143659,21010,210,10,-2,1,0,1,0,0,0,0,0,0,0,0,0,0,0,0,0,0,0,1,0,1,0,0,0,0,0,0,0,0,0
143853,21010,210,10,-2,9,5,4,0,0,0,3,1,2,0,0,0,0,0,0,0,0,0,4,3,1,0,0,0,2,1,1,0,0,0
143978,21010,210,10,-2,3,1,2,0,0,0,1,1,0,0,0,0,0,0,0,0,0,0,2,0,2,0,0,0,0,0,0,0,0,0
144005,21010,210,10,-2,9,8,1,0,0,0,0,0,0,3,3,0,0,0,0,0,0,0,2,2,0,0,0,0,4,3,1,0,0,0
144014,21010,210,10,-2,1,0,1,0,0,0,1,0,1,0,0,0,0,0,0,0,0,0,0,0,0,0,0,0,0,0,0,0,0,0
144050,21010,210,10,-2,209,113,96,0,0,0,30,12,18,9,5,4,6,2,4,0,0,0,98,55,43,4,1,3,16,10,6,46,28,18
144157,21010,210,10,-2,3,2,1,0,0,0,1,0,1,1,1,0,0,0,0,0,0,0,1,1,0,0,0,0,0,0,0,0,0,0
144166,21010,210,10,-2,9,2,7,0,0,0,0,0,0,7,1,6,2,1,1,0,0,0,0,0,0,0,0,0,0,0,0,0,0,0
144184,21010,210,10,-2,2,2,0,0,0,0,0,0,0,0,0,0,0,0,0,0,0,0,0,0,0,0,0,0,2,2,0,0,0,0
144193,21010,210,10,-2,2,1,1,0,0,0,1,0,1,0,0,0,0,0,0,0,0,0,0,0,0,1,1,0,0,0,0,0,0,0
144209,21010,210,10,-2,2,1,1,0,0,0,0,0,0,1,1,0,0,0,0,0,0,0,1,0,1,0,0,0,0,0,0,0,0,0
144218,21010,210,10,-2,1,1,0,0,0,0,0,0,0,0,0,0,0,0,0,0,0,0,1,1,0,0,0,0,0,0,0,0,0,0
144281,21010,210,10,-2,4,2,2,0,0,0,1,1,0,0,0,0,0,0,0,0,0,0,3,1,2,0,0,0,0,0,0,0,0,0
144351,21010,210,10,-2,5,2,3,0,0,0,0,0,0,0,0,0,0,0,0,0,0,0,5,2,3,0,0,0,0,0,0,0,0,0
144485,21010,210,10,-2,1,1,0,0,0,0,1,1,0,0,0,0,0,0,0,0,0,0,0,0,0,0,0,0,0,0,0,0,0,0
144564,21010,210,10,-2,2,0,2,0,0,0,0,0,0,0,0,0,0,0,0,0,0,0,2,0,2,0,0,0,0,0,0,0,0,0
144740,21010,210,10,-2,21,10,11,0,0,0,3,1,2,3,1,2,1,1,0,0,0,0,9,3,6,0,0,0,4,4,0,1,0,1
144865,21010,210,10,-2,7,2,5,0,0,0,0,0,0,0,0,0,1,1,0,0,0,0,6,1,5,0,0,0,0,0,0,0,0,0
144892,21010,210,10,-2,22,8,14,0,0,0,1,1,0,0,0,0,0,0,0,0,0,0,11,2,9,0,0,0,8,4,4,2,1,1
144944,21010,210,10,-2,12,6,6,0,0,0,1,0,1,1,1,0,1,1,0,0,0,0,8,3,5,1,1,0,0,0,0,0,0,0
144962,21010,210,10,-2,7,3,4,0,0,0,0,0,0,1,1,0,0,0,0,0,0,0,5,2,3,0,0,0,1,0,1,0,0,0
144971,21010,210,10,-2,3,2,1,0,0,0,0,0,0,0,0,0,0,0,0,0,0,0,3,2,1,0,0,0,0,0,0,0,0,0
145239,21010,210,10,-2,4,0,4,0,0,0,0,0,0,1,0,1,0,0,0,0,0,0,3,0,3,0,0,0,0,0,0,0,0,0
145275,21010,210,10,-2,4,1,3,0,0,0,0,0,0,1,0,1,2,1,1,0,0,0,1,0,1,0,0,0,0,0,0,0,0,0
145336,21010,210,10,-2,16,7,9,1,0,1,3,2,1,3,0,3,0,0,0,0,0,0,9,5,4,0,0,0,0,0,0,0,0,0
145372,21010,210,10,-2,5,0,5,0,0,0,1,0,1,2,0,2,0,0,0,0,0,0,2,0,2,0,0,0,0,0,0,0,0,0
145558,21010,210,10,-2,6,2,4,0,0,0,4,1,3,0,0,0,0,0,0,0,0,0,2,1,1,0,0,0,0,0,0,0,0,0
145600,21010,210,10,-2,98,42,56,0,0,0,24,12,12,12,6,6,7,1,6,0,0,0,42,15,27,2,0,2,1,1,0,10,7,3
145619,21010,210,10,-2,1,0,1,0,0,0,0,0,0,0,0,0,0,0,0,0,0,0,1,0,1,0,0,0,0,0,0,0,0,0
145628,21010,210,10,-2,1,1,0,0,0,0,0,0,0,1,1,0,0,0,0,0,0,0,0,0,0,0,0,0,0,0,0,0,0,0
145637,21010,210,10,-2,99,47,52,3,2,1,10,6,4,9,3,6,9,5,4,0,0,0,46,19,27,3,1,2,2,1,1,17,10,7
145646,21010,210,10,-2,5,2,3,0,0,0,0,0,0,1,0,1,0,0,0,0,0,0,3,1,2,0,0,0,0,0,0,1,1,0
145682,21010,210,10,-2,11,1,10,0,0,0,0,0,0,0,0,0,0,0,0,0,0,0,11,1,10,0,0,0,0,0,0,0,0,0
145691,21010,210,10,-2,4,0,4,0,0,0,1,0,1,0,0,0,0,0,0,0,0,0,3,0,3,0,0,0,0,0,0,0,0,0
145707,21010,210,10,-2,2,0,2,0,0,0,0,0,0,0,0,0,0,0,0,0,0,0,2,0,2,0,0,0,0,0,0,0,0,0
145725,21010,210,10,-2,17,12,5,0,0,0,2,2,0,1,1,0,0,0,0,0,0,0,3,2,1,0,0,0,8,4,4,3,3,0
145813,21010,210,10,-2,16,1,15,0,0,0,0,0,0,0,0,0,1,0,1,0,0,0,10,1,9,0,0,0,5,0,5,0,0,0
145831,21010,210,10,-2,6,0,6,0,0,0,0,0,0,0,0,0,0,0,0,0,0,0,6,0,6,0,0,0,0,0,0,0,0,0
146205,21010,210,10,-2,5,3,2,0,0,0,0,0,0,0,0,0,0,0,0,0,0,0,5,3,2,0,0,0,0,0,0,0,0,0
146278,21010,210,10,-2,2,1,1,0,0,0,0,0,0,0,0,0,0,0,0,0,0,0,2,1,1,0,0,0,0,0,0,0,0,0
146296,21010,210,10,-2,7,2,5,0,0,0,0,0,0,1,0,1,0,0,0,0,0,0,2,0,2,0,0,0,4,2,2,0,0,0
146339,21010,210,10,-2,4,3,1,0,0,0,0,0,0,0,0,0,1,1,0,0,0,0,1,1,0,0,0,0,0,0,0,2,1,1
146348,21010,210,10,-2,3,2,1,0,0,0,0,0,0,0,0,0,0,0,0,0,0,0,2,1,1,0,0,0,1,1,0,0,0,0
146366,21010,210,10,-2,3,1,2,0,0,0,0,0,0,0,0,0,0,0,0,0,0,0,3,1,2,0,0,0,0,0,0,0,0,0
146418,21010,210,10,-2,3,0,3,0,0,0,0,0,0,0,0,0,0,0,0,0,0,0,3,0,3,0,0,0,0,0,0,0,0,0
146427,21010,210,10,-2,3,1,2,0,0,0,0,0,0,0,0,0,0,0,0,0,0,0,1,0,1,0,0,0,1,0,1,1,1,0
146472,21010,210,10,-2,17,11,6,0,0,0,2,1,1,2,2,0,3,3,0,0,0,0,9,4,5,1,1,0,0,0,0,0,0,0
146481,21010,210,10,-2,4,2,2,0,0,0,0,0,0,1,1,0,0,0,0,0,0,0,2,1,1,0,0,0,0,0,0,1,0,1
146506,21010,210,10,-2,3,3,0,0,0,0,0,0,0,0,0,0,0,0,0,0,0,0,3,3,0,0,0,0,0,0,0,0,0,0
146533,21010,210,10,-2,2,0,2,0,0,0,0,0,0,0,0,0,0,0,0,0,0,0,2,0,2,0,0,0,0,0,0,0,0,0
146603,21010,210,10,-2,1,0,1,0,0,0,0,0,0,0,0,0,0,0,0,0,0,0,1,0,1,0,0,0,0,0,0,0,0,0
146612,21010,210,10,-2,15,3,12,0,0,0,0,0,0,0,0,0,0,0,0,0,0,0,13,3,10,0,0,0,2,0,2,0,0,0
146667,21010,210,10,-2,1,1,0,0,0,0,0,0,0,0,0,0,0,0,0,0,0,0,1,1,0,0,0,0,0,0,0,0,0,0
146676,21010,210,10,-2,5,4,1,0,0,0,0,0,0,0,0,0,0,0,0,0,0,0,5,4,1,0,0,0,0,0,0,0,0,0
146685,21010,210,10,-2,10,4,6,0,0,0,1,1,0,0,0,0,0,0,0,0,0,0,9,3,6,0,0,0,0,0,0,0,0,0
146700,21010,210,10,-2,8,7,1,0,0,0,0,0,0,2,1,1,1,1,0,0,0,0,5,5,0,0,0,0,0,0,0,0,0,0
146719,21010,210,10,-2,86,44,42,0,0,0,6,3,3,9,4,5,14,8,6,0,0,0,38,21,17,2,1,1,4,1,3,13,6,7
146728,21010,210,10,-2,1,1,0,0,0,0,0,0,0,0,0,0,1,1,0,0,0,0,0,0,0,0,0,0,0,0,0,0,0,0
146755,21010,210,10,-2,5,1,4,0,0,0,0,0,0,0,0,0,0,0,0,0,0,0,5,1,4,0,0,0,0,0,0,0,0,0
146816,21010,210,10,-2,1,1,0,0,0,0,0,0,0,0,0,0,0,0,0,0,0,0,1,1,0,0,0,0,0,0,0,0,0,0
147004,21010,210,10,-2,5,1,4,0,0,0,0,0,0,0,0,0,0,0,0,0,0,0,5,1,4,0,0,0,0,0,0,0,0,0
147013,21010,210,10,-2,7,2,5,1,0,1,0,0,0,0,0,0,0,0,0,0,0,0,6,2,4,0,0,0,0,0,0,0,0,0
147129,21010,210,10,-2,2,0,2,0,0,0,0,0,0,0,0,0,0,0,0,0,0,0,2,0,2,0,0,0,0,0,0,0,0,0
147244,21010,210,10,-2,15,5,10,0,0,0,1,1,0,1,0,1,0,0,0,0,0,0,12,4,8,0,0,0,0,0,0,1,0,1
147341,21010,210,10,-2,1,1,0,0,0,0,0,0,0,0,0,0,0,0,0,0,0,0,0,0,0,0,0,0,0,0,0,1,1,0
147369,21010,210,10,-2,2,1,1,0,0,0,0,0,0,0,0,0,0,0,0,0,0,0,2,1,1,0,0,0,0,0,0,0,0,0
147378,21010,210,10,-2,4,1,3,0,0,0,1,0,1,0,0,0,1,1,0,0,0,0,2,0,2,0,0,0,0,0,0,0,0,0
147411,21010,210,10,-2,2,0,2,0,0,0,0,0,0,0,0,0,1,0,1,0,0,0,1,0,1,0,0,0,0,0,0,0,0,0
147536,21010,210,10,-2,24,2,22,0,0,0,0,0,0,6,1,5,4,0,4,0,0,0,10,1,9,1,0,1,0,0,0,3,0,3
147660,21010,210,10,-2,10,5,5,0,0,0,1,1,0,0,0,0,0,0,0,0,0,0,6,3,3,0,0,0,1,0,1,2,1,1
147679,21010,210,10,-2,4,2,2,0,0,0,2,1,1,0,0,0,1,1,0,0,0,0,1,0,1,0,0,0,0,0,0,0,0,0
147697,21010,210,10,-2,2,0,2,0,0,0,0,0,0,0,0,0,0,0,0,0,0,0,2,0,2,0,0,0,0,0,0,0,0,0
147703,21010,210,10,-2,16,8,8,0,0,0,1,1,0,2,1,1,0,0,0,0,0,0,6,4,2,0,0,0,0,0,0,7,2,5
147767,21010,210,10,-2,94,52,42,0,0,0,18,10,8,11,5,6,9,6,3,0,0,0,33,19,14,1,0,1,1,0,1,21,12,9
147776,21010,210,10,-2,8,4,4,0,0,0,3,1,2,0,0,0,0,0,0,0,0,0,2,1,1,0,0,0,3,2,1,0,0,0
147800,21010,210,10,-2,5,3,2,0,0,0,0,0,0,0,0,0,1,1,0,0,0,0,1,1,0,0,0,0,3,1,2,0,0,0
147828,21010,210,10,-2,6,3,3,0,0,0,0,0,0,0,0,0,0,0,0,0,0,0,6,3,3,0,0,0,0,0,0,0,0,0
147916,21010,210,10,-2,4,3,1,0,0,0,0,0,0,1,1,0,0,0,0,0,0,0,2,1,1,0,0,0,1,1,0,0,0,0
148007,21010,210,10,-2,2,0,2,0,0,0,0,0,0,2,0,2,0,0,0,0,0,0,0,0,0,0,0,0,0,0,0,0,0,0
148016,21010,210,10,-2,4,2,2,0,0,0,0,0,0,0,0,0,0,0,0,0,0,0,2,0,2,0,0,0,2,2,0,0,0,0
148131,21010,210,10,-2,3,2,1,0,0,0,0,0,0,0,0,0,0,0,0,0,0,0,3,2,1,0,0,0,0,0,0,0,0,0
148292,21010,210,10,-2,5,3,2,0,0,0,0,0,0,0,0,0,0,0,0,0,0,0,5,3,2,0,0,0,0,0,0,0,0,0
148380,21010,210,10,-2,4,3,1,0,0,0,0,0,0,0,0,0,0,0,0,0,0,0,3,2,1,0,0,0,1,1,0,0,0,0
148405,21010,210,10,-2,3,0,3,0,0,0,0,0,0,0,0,0,0,0,0,0,0,0,3,0,3,0,0,0,0,0,0,0,0,0
148487,21010,210,10,-2,10,6,4,0,0,0,1,1,0,1,1,0,0,0,0,0,0,0,2,2,0,0,0,0,5,2,3,1,0,1
148496,21010,210,10,-2,7,2,5,0,0,0,1,1,0,3,1,2,0,0,0,0,0,0,2,0,2,0,0,0,1,0,1,0,0,0
148511,21010,210,10,-2,62,28,34,0,0,0,12,4,8,4,2,2,4,2,2,0,0,0,40,20,20,2,0,2,0,0,0,0,0,0
148575,21010,210,10,-2,1,1,0,0,0,0,0,0,0,0,0,0,0,0,0,0,0,0,1,1,0,0,0,0,0,0,0,0,0,0
148584,21010,210,10,-2,6,0,6,0,0,0,1,0,1,3,0,3,0,0,0,0,0,0,2,0,2,0,0,0,0,0,0,0,0,0
148593,21010,210,10,-2,2,0,2,0,0,0,0,0,0,0,0,0,0,0,0,0,0,0,2,0,2,0,0,0,0,0,0,0,0,0
148627,21010,210,10,-2,8,1,7,0,0,0,1,0,1,0,0,0,0,0,0,0,0,0,2,0,2,0,0,0,5,1,4,0,0,0
148654,21010,210,10,-2,4,2,2,0,0,0,0,0,0,0,0,0,0,0,0,0,0,0,4,2,2,0,0,0,0,0,0,0,0,0
148672,21010,210,10,-2,3,2,1,0,0,0,0,0,0,0,0,0,0,0,0,0,0,0,3,2,1,0,0,0,0,0,0,0,0,0
148821,21010,210,10,-2,2,0,2,0,0,0,0,0,0,0,0,0,0,0,0,0,0,0,2,0,2,0,0,0,0,0,0,0,0,0
148876,21010,210,10,-2,2,2,0,0,0,0,1,1,0,0,0,0,1,1,0,0,0,0,0,0,0,0,0,0,0,0,0,0,0,0
148982,21010,210,10,-2,1,1,0,0,0,0,0,0,0,0,0,0,0,0,0,0,0,0,1,1,0,0,0,0,0,0,0,0,0,0
149028,21010,210,10,-2,1,0,1,0,0,0,0,0,0,0,0,0,0,0,0,0,0,0,1,0,1,0,0,0,0,0,0,0,0,0
149222,21010,210,10,-2,103,64,39,0,0,0,12,7,5,7,2,5,3,3,0,0,0,0,71,45,26,1,0,1,0,0,0,9,7,2
149231,21010,210,10,-2,10,6,4,0,0,0,0,0,0,2,2,0,2,1,1,0,0,0,4,2,2,0,0,0,0,0,0,2,1,1
149329,21010,210,10,-2,1,1,0,0,0,0,0,0,0,0,0,0,0,0,0,0,0,0,1,1,0,0,0,0,0,0,0,0,0,0
149365,21010,210,10,-2,4,1,3,0,0,0,0,0,0,2,0,2,0,0,0,0,0,0,1,0,1,0,0,0,1,1,0,0,0,0
149505,21010,210,10,-2,5,2,3,0,0,0,0,0,0,0,0,0,1,1,0,0,0,0,4,1,3,0,0,0,0,0,0,0,0,0
149532,21010,210,10,-2,2,0,2,0,0,0,0,0,0,0,0,0,0,0,0,0,0,0,1,0,1,0,0,0,1,0,1,0,0,0
149639,21010,210,10,-2,1,0,1,0,0,0,0,0,0,0,0,0,1,0,1,0,0,0,0,0,0,0,0,0,0,0,0,0,0,0
149727,21010,210,10,-2,2,2,0,0,0,0,0,0,0,0,0,0,0,0,0,0,0,0,2,2,0,0,0,0,0,0,0,0,0,0
149772,21010,210,10,-2,7,2,5,0,0,0,0,0,0,0,0,0,0,0,0,0,0,0,6,2,4,0,0,0,1,0,1,0,0,0
149781,21010,210,10,-2,10,6,4,0,0,0,4,2,2,0,0,0,0,0,0,0,0,0,5,4,1,0,0,0,0,0,0,1,0,1
149842,21010,210,10,-2,8,1,7,0,0,0,0,0,0,2,0,2,0,0,0,0,0,0,5,1,4,0,0,0,1,0,1,0,0,0
150066,21010,210,10,-2,8,2,6,0,0,0,0,0,0,1,0,1,0,0,0,0,0,0,7,2,5,0,0,0,0,0,0,0,0,0
150136,21010,210,10,-2,1,0,1,0,0,0,0,0,0,0,0,0,0,0,0,0,0,0,1,0,1,0,0,0,0,0,0,0,0,0
150145,21010,210,10,-2,11,2,9,0,0,0,0,0,0,0,0,0,0,0,0,0,0,0,11,2,9,0,0,0,0,0,0,0,0,0
150163,21010,210,10,-2,36,16,20,0,0,0,4,1,3,2,1,1,2,1,1,0,0,0,28,13,15,0,0,0,0,0,0,0,0,0
150172,21010,210,10,-2,4,2,2,0,0,0,0,0,0,0,0,0,1,0,1,0,0,0,3,2,1,0,0,0,0,0,0,0,0,0
150288,21010,210,10,-2,1,1,0,0,0,0,0,0,0,0,0,0,0,0,0,0,0,0,1,1,0,0,0,0,0,0,0,0,0,0
150400,21010,210,10,-2,10,5,5,0,0,0,3,1,2,0,0,0,3,2,1,0,0,0,4,2,2,0,0,0,0,0,0,0,0,0
150455,21010,210,10,-2,12,7,5,0,0,0,1,1,0,5,3,2,1,1,0,0,0,0,3,2,1,0,0,0,0,0,0,2,0,2
150534,21010,210,10,-2,18,8,10,0,0,0,0,0,0,0,0,0,0,0,0,0,0,0,5,2,3,0,0,0,13,6,7,0,0,0
150604,21010,210,10,-2,6,2,4,0,0,0,0,0,0,0,0,0,0,0,0,0,0,0,6,2,4,0,0,0,0,0,0,0,0,0
150668,21010,210,10,-2,3,0,3,0,0,0,0,0,0,1,0,1,0,0,0,0,0,0,2,0,2,0,0,0,0,0,0,0,0,0
150677,21010,210,10,-2,2,1,1,0,0,0,0,0,0,0,0,0,0,0,0,0,0,0,1,1,0,0,0,0,1,0,1,0,0,0
150756,21010,210,10,-2,11,9,2,0,0,0,0,0,0,2,2,0,1,1,0,0,0,0,8,6,2,0,0,0,0,0,0,0,0,0
150774,21010,210,10,-2,3,2,1,0,0,0,0,0,0,1,0,1,0,0,0,0,0,0,2,2,0,0,0,0,0,0,0,0,0,0
150941,21010,210,10,-2,10,2,8,0,0,0,1,1,0,0,0,0,0,0,0,0,0,0,9,1,8,0,0,0,0,0,0,0,0,0
150987,21010,210,10,-2,62,24,38,0,0,0,1,0,1,8,2,6,1,1,0,0,0,0,52,21,31,0,0,0,0,0,0,0,0,0
151102,21010,210,10,-2,2,2,0,0,0,0,1,1,0,0,0,0,0,0,0,0,0,0,0,0,0,0,0,0,0,0,0,1,1,0
151111,21010,210,10,-2,247,111,136,0,0,0,52,20,32,10,1,9,7,1,6,0,0,0,156,75,81,3,2,1,0,0,0,19,12,7
151263,21010,210,10,-2,19,7,12,0,0,0,1,0,1,1,1,0,0,0,0,0,0,0,16,6,10,1,0,1,0,0,0,0,0,0
151290,21010,210,10,-2,6,3,3,0,0,0,2,2,0,0,0,0,0,0,0,0,0,0,2,0,2,0,0,0,0,0,0,2,1,1
151306,21010,210,10,-2,15,5,10,0,0,0,1,1,0,0,0,0,0,0,0,0,0,0,10,1,9,0,0,0,0,0,0,4,3,1
151324,21010,210,10,-2,16,8,8,0,0,0,4,0,4,3,2,1,2,2,0,0,0,0,7,4,3,0,0,0,0,0,0,0,0,0
151333,21010,210,10,-2,7,1,6,0,0,0,0,0,0,0,0,0,0,0,0,0,0,0,4,0,4,0,0,0,0,0,0,3,1,2
151342,21010,210,10,-2,16,7,9,0,0,0,0,0,0,2,0,2,0,0,0,0,0,0,14,7,7,0,0,0,0,0,0,0,0,0
151351,21010,210,10,-2,121,53,68,1,1,0,11,3,8,8,3,5,14,5,9,0,0,0,61,27,34,1,0,1,0,0,0,25,14,11
151360,21010,210,10,-2,5,1,4,0,0,0,0,0,0,3,0,3,0,0,0,0,0,0,2,1,1,0,0,0,0,0,0,0,0,0
151379,21010,210,10,-2,6,0,6,0,0,0,0,0,0,0,0,0,0,0,0,0,0,0,5,0,5,0,0,0,0,0,0,1,0,1
151388,21010,210,10,-2,2,1,1,0,0,0,0,0,0,0,0,0,0,0,0,0,0,0,2,1,1,0,0,0,0,0,0,0,0,0
151467,21010,210,10,-2,1,0,1,0,0,0,0,0,0,0,0,0,0,0,0,0,0,0,1,0,1,0,0,0,0,0,0,0,0,0
151661,21010,210,10,-2,14,12,2,0,0,0,0,0,0,2,2,0,0,0,0,0,0,0,12,10,2,0,0,0,0,0,0,0,0,0
151777,21010,210,10,-2,9,2,7,0,0,0,0,0,0,0,0,0,1,0,1,0,0,0,7,1,6,0,0,0,1,1,0,0,0,0
151786,21010,210,10,-2,47,17,30,0,0,0,0,0,0,3,0,3,5,3,2,0,0,0,39,14,25,0,0,0,0,0,0,0,0,0
151801,21010,210,10,-2,11,5,6,0,0,0,1,1,0,2,1,1,0,0,0,0,0,0,7,2,5,0,0,0,1,1,0,0,0,0
151810,21010,210,10,-2,6,4,2,0,0,0,0,0,0,5,3,2,0,0,0,0,0,0,1,1,0,0,0,0,0,0,0,0,0,0
152080,21010,210,10,-2,68,40,28,0,0,0,4,2,2,5,2,3,3,2,1,0,0,0,33,23,10,1,0,1,5,1,4,17,10,7
152099,21010,210,10,-2,5,2,3,0,0,0,2,0,2,0,0,0,0,0,0,0,0,0,2,1,1,0,0,0,1,1,0,0,0,0
152318,21010,210,10,-2,10,5,5,0,0,0,1,0,1,0,0,0,0,0,0,0,0,0,5,3,2,0,0,0,0,0,0,4,2,2
152336,21010,210,10,-2,8,1,7,0,0,0,0,0,0,0,0,0,0,0,0,0,0,0,8,1,7,0,0,0,0,0,0,0,0,0
152381,21010,210,10,-2,7,2,5,0,0,0,0,0,0,0,0,0,1,0,1,0,0,0,6,2,4,0,0,0,0,0,0,0,0,0
152390,21010,210,10,-2,13,3,10,0,0,0,0,0,0,0,0,0,0,0,0,0,0,0,9,2,7,0,0,0,1,0,1,3,1,2
152530,21010,210,10,-2,7,3,4,0,0,0,0,0,0,0,0,0,0,0,0,0,0,0,5,2,3,0,0,0,0,0,0,2,1,1
152567,21010,210,10,-2,8,4,4,0,0,0,0,0,0,0,0,0,0,0,0,0,0,0,8,4,4,0,0,0,0,0,0,0,0,0
152600,21010,210,10,-2,7,1,6,0,0,0,0,0,0,0,0,0,1,0,1,0,0,0,6,1,5,0,0,0,0,0,0,0,0,0
152637,21010,210,10,-2,14,7,7,0,0,0,0,0,0,0,0,0,0,0,0,0,0,0,14,7,7,0,0,0,0,0,0,0,0,0
152673,21010,210,10,-2,2,0,2,0,0,0,0,0,0,0,0,0,0,0,0,0,0,0,2,0,2,0,0,0,0,0,0,0,0,0
152798,21010,210,10,-2,5,2,3,0,0,0,0,0,0,0,0,0,0,0,0,0,0,0,5,2,3,0,0,0,0,0,0,0,0,0
152992,21010,210,10,-2,6,4,2,0,0,0,0,0,0,0,0,0,0,0,0,0,0,0,6,4,2,0,0,0,0,0,0,0,0,0
153001,21010,210,10,-2,10,7,3,0,0,0,0,0,0,1,0,1,2,2,0,0,0,0,7,5,2,0,0,0,0,0,0,0,0,0
153108,21010,210,10,-2,1,1,0,0,0,0,0,0,0,0,0,0,0,0,0,0,0,0,0,0,0,0,0,0,0,0,0,1,1,0
153126,21010,210,10,-2,6,1,5,0,0,0,0,0,0,1,0,1,0,0,0,0,0,0,5,1,4,0,0,0,0,0,0,0,0,0
153144,21010,210,10,-2,5,2,3,0,0,0,0,0,0,1,1,0,0,0,0,0,0,0,4,1,3,0,0,0,0,0,0,0,0,0
153214,21010,210,10,-2,22,10,12,0,0,0,3,2,1,0,0,0,1,1,0,0,0,0,18,7,11,0,0,0,0,0,0,0,0,0
153241,21010,210,10,-2,3,1,2,0,0,0,0,0,0,0,0,0,0,0,0,0,0,0,2,1,1,0,0,0,0,0,0,1,0,1
153250,21010,210,10,-2,5,4,1,0,0,0,0,0,0,0,0,0,0,0,0,0,0,0,5,4,1,0,0,0,0,0,0,0,0,0
153269,21010,210,10,-2,26,14,12,0,0,0,2,1,1,0,0,0,2,1,1,0,0,0,17,9,8,0,0,0,0,0,0,5,3,2
153278,21010,210,10,-2,5,3,2,0,0,0,0,0,0,0,0,0,1,1,0,0,0,0,4,2,2,0,0,0,0,0,0,0,0,0
153296,21010,210,10,-2,3,1,2,0,0,0,0,0,0,0,0,0,0,0,0,0,0,0,3,1,2,0,0,0,0,0,0,0,0,0
153311,21010,210,10,-2,6,2,4,0,0,0,0,0,0,1,0,1,1,0,1,0,0,0,4,2,2,0,0,0,0,0,0,0,0,0
153320,21010,210,10,-2,1,0,1,0,0,0,0,0,0,0,0,0,0,0,0,0,0,0,1,0,1,0,0,0,0,0,0,0,0,0
153366,21010,210,10,-2,17,8,9,0,0,0,3,2,1,1,0,1,2,1,1,0,0,0,11,5,6,0,0,0,0,0,0,0,0,0
153375,21010,210,10,-2,9,4,5,0,0,0,3,1,2,0,0,0,0,0,0,0,0,0,6,3,3,0,0,0,0,0,0,0,0,0
153384,21010,210,10,-2,19,7,12,0,0,0,2,0,2,1,1,0,2,1,1,0,0,0,12,4,8,1,0,1,1,1,0,0,0,0
153445,21010,210,10,-2,5,1,4,0,0,0,0,0,0,0,0,0,0,0,0,0,0,0,4,1,3,1,0,1,0,0,0,0,0,0
153472,21010,210,10,-2,4,2,2,0,0,0,0,0,0,0,0,0,0,0,0,0,0,0,4,2,2,0,0,0,0,0,0,0,0,0
153524,21010,210,10,-2,5,1,4,0,0,0,0,0,0,0,0,0,0,0,0,0,0,0,4,1,3,0,0,0,1,0,1,0,0,0
153533,21010,210,10,-2,7,4,3,0,0,0,0,0,0,1,1,0,0,0,0,0,0,0,6,3,3,0,0,0,0,0,0,0,0,0
153603,21010,210,10,-2,59,29,30,1,1,0,7,4,3,0,0,0,4,3,1,0,0,0,35,13,22,0,0,0,0,0,0,12,8,4
153621,21010,210,10,-2,5,3,2,0,0,0,0,0,0,0,0,0,0,0,0,0,0,0,5,3,2,0,0,0,0,0,0,0,0,0
153630,21010,210,10,-2,15,8,7,0,0,0,1,0,1,2,2,0,2,2,0,0,0,0,9,4,5,0,0,0,1,0,1,0,0,0
153658,21010,210,10,-2,113,54,59,0,0,0,15,13,2,7,3,4,4,2,2,0,0,0,48,18,30,0,0,0,15,6,9,24,12,12
153737,21010,210,10,-2,12,4,8,0,0,0,0,0,0,2,1,1,0,0,0,0,0,0,10,3,7,0,0,0,0,0,0,0,0,0
153825,21010,210,10,-2,7,3,4,0,0,0,3,1,2,0,0,0,0,0,0,0,0,0,4,2,2,0,0,0,0,0,0,0,0,0
153834,21010,210,10,-2,1,0,1,0,0,0,1,0,1,0,0,0,0,0,0,0,0,0,0,0,0,0,0,0,0,0,0,0,0,0
153861,21010,210,10,-2,19,13,6,0,0,0,6,5,1,1,0,1,0,0,0,0,0,0,10,6,4,0,0,0,2,2,0,0,0,0
153922,21010,210,10,-2,3,2,1,0,0,0,0,0,0,0,0,0,0,0,0,0,0,0,3,2,1,0,0,0,0,0,0,0,0,0
153977,21010,210,10,-2,4,0,4,0,0,0,0,0,0,0,0,0,0,0,0,0,0,0,3,0,3,1,0,1,0,0,0,0,0,0
154004,21010,210,10,-2,8,1,7,0,0,0,0,0,0,2,0,2,0,0,0,0,0,0,6,1,5,0,0,0,0,0,0,0,0,0
154013,21010,210,10,-2,10,4,6,0,0,0,0,0,0,0,0,0,1,1,0,0,0,0,9,3,6,0,0,0,0,0,0,0,0,0
154022,21010,210,10,-2,7,2,5,0,0,0,1,1,0,2,0,2,2,1,1,0,0,0,2,0,2,0,0,0,0,0,0,0,0,0
154059,21010,210,10,-2,9,5,4,0,0,0,0,0,0,0,0,0,0,0,0,0,0,0,9,5,4,0,0,0,0,0,0,0,0,0
154095,21010,210,10,-2,18,5,13,0,0,0,2,1,1,0,0,0,0,0,0,0,0,0,11,3,8,0,0,0,0,0,0,5,1,4
154101,21010,210,10,-2,4,2,2,0,0,0,0,0,0,0,0,0,0,0,0,0,0,0,3,1,2,0,0,0,0,0,0,1,1,0
154110,21010,210,10,-2,6,3,3,0,0,0,0,0,0,0,0,0,0,0,0,0,0,0,4,1,3,0,0,0,2,2,0,0,0,0
154129,21010,210,10,-2,2,1,1,0,0,0,1,0,1,1,1,0,0,0,0,0,0,0,0,0,0,0,0,0,0,0,0,0,0,0
154156,21010,210,10,-2,9,4,5,0,0,0,0,0,0,0,0,0,0,0,0,0,0,0,9,4,5,0,0,0,0,0,0,0,0,0
154174,21010,210,10,-2,10,5,5,0,0,0,2,2,0,0,0,0,0,0,0,0,0,0,8,3,5,0,0,0,0,0,0,0,0,0
154235,21010,210,10,-2,9,4,5,0,0,0,1,0,1,0,0,0,0,0,0,0,0,0,8,4,4,0,0,0,0,0,0,0,0,0
154350,21010,210,10,-2,8,4,4,0,0,0,2,2,0,1,1,0,1,0,1,0,0,0,4,1,3,0,0,0,0,0,0,0,0,0
154378,21010,210,10,-2,6,2,4,0,0,0,0,0,0,0,0,0,0,0,0,0,0,0,6,2,4,0,0,0,0,0,0,0,0,0
154396,21010,210,10,-2,5,3,2,0,0,0,0,0,0,1,1,0,0,0,0,0,0,0,4,2,2,0,0,0,0,0,0,0,0,0
154493,21010,210,10,-2,4,2,2,0,0,0,1,0,1,0,0,0,0,0,0,0,0,0,0,0,0,0,0,0,3,2,1,0,0,0
154518,21010,210,10,-2,2,2,0,0,0,0,1,1,0,0,0,0,0,0,0,0,0,0,1,1,0,0,0,0,0,0,0,0,0,0
154527,21010,210,10,-2,8,4,4,0,0,0,0,0,0,0,0,0,0,0,0,0,0,0,8,4,4,0,0,0,0,0,0,0,0,0
154572,21010,210,10,-2,3,1,2,0,0,0,0,0,0,0,0,0,0,0,0,0,0,0,3,1,2,0,0,0,0,0,0,0,0,0
154590,21010,210,10,-2,6,3,3,0,0,0,0,0,0,0,0,0,1,1,0,0,0,0,5,2,3,0,0,0,0,0,0,0,0,0
154642,21010,210,10,-2,2,1,1,0,0,0,0,0,0,0,0,0,1,1,0,0,0,0,1,0,1,0,0,0,0,0,0,0,0,0
154688,21010,210,10,-2,4,1,3,0,0,0,0,0,0,0,0,0,0,0,0,0,0,0,3,1,2,0,0,0,1,0,1,0,0,0
154697,21010,210,10,-2,5,3,2,0,0,0,0,0,0,0,0,0,0,0,0,0,0,0,5,3,2,0,0,0,0,0,0,0,0,0
154712,21010,210,10,-2,1,1,0,0,0,0,0,0,0,0,0,0,0,0,0,0,0,0,1,1,0,0,0,0,0,0,0,0,0,0
154721,21010,210,10,-2,5,0,5,0,0,0,0,0,0,1,0,1,0,0,0,0,0,0,4,0,4,0,0,0,0,0,0,0,0,0
154749,21010,210,10,-2,4,0,4,0,0,0,0,0,0,0,0,0,0,0,0,0,0,0,4,0,4,0,0,0,0,0,0,0,0,0
154800,21010,210,10,-2,11,9,2,0,0,0,0,0,0,0,0,0,1,1,0,0,0,0,10,8,2,0,0,0,0,0,0,0,0,0
154855,21010,210,10,-2,2,1,1,0,0,0,0,0,0,0,0,0,0,0,0,0,0,0,2,1,1,0,0,0,0,0,0,0,0,0
154907,21010,210,10,-2,8,6,2,0,0,0,0,0,0,0,0,0,0,0,0,0,0,0,8,6,2,0,0,0,0,0,0,0,0,0
154925,21010,210,10,-2,4,3,1,0,0,0,0,0,0,0,0,0,0,0,0,0,0,0,4,3,1,0,0,0,0,0,0,0,0,0
154934,21010,210,10,-2,4,2,2,0,0,0,0,0,0,0,0,0,0,0,0,0,0,0,4,2,2,0,0,0,0,0,0,0,0,0
154952,21010,210,10,-2,3,3,0,0,0,0,0,0,0,0,0,0,0,0,0,0,0,0,3,3,0,0,0,0,0,0,0,0,0,0
154998,21010,210,10,-2,7,2,5,0,0,0,0,0,0,0,0,0,0,0,0,0,0,0,7,2,5,0,0,0,0,0,0,0,0,0
155007,21010,210,10,-2,5,2,3,0,0,0,0,0,0,1,0,1,0,0,0,0,0,0,3,1,2,0,0,0,1,1,0,0,0,0
155025,21010,210,10,-2,17,5,12,0,0,0,4,2,2,1,0,1,0,0,0,0,0,0,12,3,9,0,0,0,0,0,0,0,0,0
155052,21010,210,10,-2,3,1,2,0,0,0,0,0,0,0,0,0,0,0,0,0,0,0,3,1,2,0,0,0,0,0,0,0,0,0
155061,21010,210,10,-2,25,15,10,0,0,0,3,1,2,1,1,0,1,1,0,0,0,0,14,10,4,4,1,3,1,1,0,1,0,1
155089,21010,210,10,-2,8,3,5,1,0,1,0,0,0,1,1,0,0,0,0,0,0,0,6,2,4,0,0,0,0,0,0,0,0,0
155098,21010,210,10,-2,10,5,5,0,0,0,0,0,0,0,0,0,1,1,0,0,0,0,9,4,5,0,0,0,0,0,0,0,0,0
155104,21010,210,10,-2,6,3,3,0,0,0,0,0,0,0,0,0,2,0,2,0,0,0,4,3,1,0,0,0,0,0,0,0,0,0
155177,21010,210,10,-2,4,3,1,0,0,0,0,0,0,0,0,0,0,0,0,0,0,0,3,2,1,1,1,0,0,0,0,0,0,0
155186,21010,210,10,-2,8,1,7,0,0,0,0,0,0,0,0,0,0,0,0,0,0,0,8,1,7,0,0,0,0,0,0,0,0,0
155195,21010,210,10,-2,11,5,6,0,0,0,0,0,0,0,0,0,0,0,0,0,0,0,11,5,6,0,0,0,0,0,0,0,0,0
155201,21010,210,10,-2,6,3,3,0,0,0,1,1,0,0,0,0,1,0,1,0,0,0,4,2,2,0,0,0,0,0,0,0,0,0
155210,21010,210,10,-2,15,7,8,0,0,0,0,0,0,0,0,0,0,0,0,0,0,0,12,5,7,1,0,1,2,2,0,0,0,0
155283,21010,210,10,-2,6,1,5,0,0,0,0,0,0,2,0,2,1,0,1,0,0,0,3,1,2,0,0,0,0,0,0,0,0,0
155292,21010,210,10,-2,6,2,4,0,0,0,0,0,0,1,0,1,3,0,3,0,0,0,2,2,0,0,0,0,0,0,0,0,0,0
155308,21010,210,10,-2,1,0,1,0,0,0,0,0,0,0,0,0,0,0,0,0,0,0,1,0,1,0,0,0,0,0,0,0,0,0
155317,21010,210,10,-2,140,71,69,0,0,0,13,11,2,8,4,4,5,1,4,0,0,0,89,40,49,5,0,5,2,0,2,18,15,3
155335,21010,210,10,-2,2,1,1,0,0,0,0,0,0,0,0,0,0,0,0,0,0,0,2,1,1,0,0,0,0,0,0,0,0,0
155399,21010,210,10,-2,36,16,20,0,0,0,4,2,2,2,0,2,3,2,1,0,0,0,23,11,12,0,0,0,0,0,0,4,1,3
155414,21010,210,10,-2,10,4,6,0,0,0,1,0,1,0,0,0,0,0,0,0,0,0,9,4,5,0,0,0,0,0,0,0,0,0
155450,21010,210,10,-2,2,0,2,0,0,0,0,0,0,0,0,0,0,0,0,0,0,0,2,0,2,0,0,0,0,0,0,0,0,0
155487,21010,210,10,-2,1,0,1,0,0,0,0,0,0,0,0,0,0,0,0,0,0,0,0,0,0,0,0,0,1,0,1,0,0,0
155511,21010,210,10,-2,4,3,1,0,0,0,1,1,0,0,0,0,0,0,0,0,0,0,2,2,0,1,0,1,0,0,0,0,0,0
155566,21010,210,10,-2,11,7,4,0,0,0,0,0,0,0,0,0,0,0,0,0,0,0,9,5,4,0,0,0,0,0,0,2,2,0
155593,21010,210,10,-2,6,4,2,0,0,0,0,0,0,0,0,0,0,0,0,0,0,0,6,4,2,0,0,0,0,0,0,0,0,0
155618,21010,210,10,-2,2,2,0,0,0,0,0,0,0,0,0,0,0,0,0,0,0,0,2,2,0,0,0,0,0,0,0,0,0,0
155627,21010,210,10,-2,1,1,0,0,0,0,0,0,0,0,0,0,0,0,0,0,0,0,1,1,0,0,0,0,0,0,0,0,0,0
155681,21010,210,10,-2,8,6,2,1,1,0,1,0,1,0,0,0,0,0,0,0,0,0,6,5,1,0,0,0,0,0,0,0,0,0
155715,21010,210,10,-2,7,5,2,0,0,0,0,0,0,0,0,0,1,0,1,0,0,0,6,5,1,0,0,0,0,0,0,0,0,0
155812,21010,210,10,-2,14,4,10,0,0,0,0,0,0,2,0,2,0,0,0,0,0,0,12,4,8,0,0,0,0,0,0,0,0,0
155830,21010,210,10,-2,3,0,3,0,0,0,0,0,0,0,0,0,0,0,0,0,0,0,3,0,3,0,0,0,0,0,0,0,0,0
155858,21010,210,10,-2,4,2,2,0,0,0,0,0,0,0,0,0,1,1,0,0,0,0,3,1,2,0,0,0,0,0,0,0,0,0
155900,21010,210,10,-2,3,2,1,0,0,0,1,1,0,1,0,1,0,0,0,0,0,0,1,1,0,0,0,0,0,0,0,0,0,0
155937,21010,210,10,-2,3,2,1,0,0,0,0,0,0,0,0,0,0,0,0,0,0,0,3,2,1,0,0,0,0,0,0,0,0,0
155973,21010,210,10,-2,4,3,1,0,0,0,0,0,0,0,0,0,0,0,0,0,0,0,4,3,1,0,0,0,0,0,0,0,0,0
156082,21010,210,10,-2,7,2,5,0,0,0,0,0,0,1,0,1,0,0,0,0,0,0,6,2,4,0,0,0,0,0,0,0,0,0
156107,21010,210,10,-2,12,8,4,0,0,0,0,0,0,0,0,0,1,0,1,0,0,0,11,8,3,0,0,0,0,0,0,0,0,0
156125,21010,210,10,-2,31,16,15,0,0,0,1,0,1,1,1,0,1,1,0,0,0,0,19,8,11,0,0,0,1,1,0,8,5,3
156134,21010,210,10,-2,6,2,4,1,1,0,0,0,0,0,0,0,0,0,0,0,0,0,5,1,4,0,0,0,0,0,0,0,0,0
156189,21010,210,10,-2,5,3,2,0,0,0,0,0,0,0,0,0,0,0,0,0,0,0,5,3,2,0,0,0,0,0,0,0,0,0
156213,21010,210,10,-2,8,2,6,0,0,0,1,0,1,1,0,1,0,0,0,0,0,0,6,2,4,0,0,0,0,0,0,0,0,0
156222,21010,210,10,-2,4,3,1,0,0,0,1,1,0,0,0,0,1,0,1,0,0,0,2,2,0,0,0,0,0,0,0,0,0,0
156231,21010,210,10,-2,3,1,2,0,0,0,0,0,0,0,0,0,0,0,0,0,0,0,2,0,2,0,0,0,1,1,0,0,0,0
156286,21010,210,10,-2,11,1,10,0,0,0,2,0,2,1,1,0,0,0,0,0,0,0,7,0,7,0,0,0,0,0,0,1,0,1
156295,21010,210,10,-2,14,4,10,0,0,0,2,1,1,2,0,2,1,0,1,0,0,0,7,2,5,0,0,0,0,0,0,2,1,1
156338,21010,210,10,-2,6,1,5,0,0,0,0,0,0,1,0,1,0,0,0,0,0,0,4,1,3,0,0,0,1,0,1,0,0,0
156356,21010,210,10,-2,4,2,2,0,0,0,0,0,0,0,0,0,0,0,0,0,0,0,3,2,1,0,0,0,1,0,1,0,0,0
156365,21010,210,10,-2,11,6,5,0,0,0,0,0,0,1,1,0,0,0,0,0,0,0,9,4,5,0,0,0,1,1,0,0,0,0
156392,21010,210,10,-2,12,3,9,0,0,0,0,0,0,0,0,0,0,0,0,0,0,0,11,3,8,0,0,0,1,0,1,0,0,0
156408,21010,210,10,-2,13,5,8,0,0,0,1,0,1,1,0,1,1,1,0,0,0,0,7,2,5,1,1,0,2,1,1,0,0,0
156471,21010,210,10,-2,18,1,17,0,0,0,0,0,0,3,0,3,0,0,0,0,0,0,15,1,14,0,0,0,0,0,0,0,0,0
156541,21010,210,10,-2,35,18,17,0,0,0,0,0,0,7,4,3,0,0,0,0,0,0,27,14,13,0,0,0,1,0,1,0,0,0
156620,21010,210,10,-2,63,28,35,0,0,0,0,0,0,1,0,1,1,1,0,0,0,0,47,22,25,3,1,2,1,0,1,10,4,6
156648,21010,210,10,-2,7,4,3,0,0,0,0,0,0,0,0,0,0,0,0,0,0,0,7,4,3,0,0,0,0,0,0,0,0,0
156727,21010,210,10,-2,18,5,13,0,0,0,0,0,0,2,0,2,1,0,1,0,0,0,14,5,9,1,0,1,0,0,0,0,0,0
156745,21010,210,10,-2,6,2,4,0,0,0,1,1,0,0,0,0,0,0,0,0,0,0,4,1,3,0,0,0,0,0,0,1,0,1
156790,21010,210,10,-2,4,0,4,0,0,0,0,0,0,0,0,0,0,0,0,0,0,0,4,0,4,0,0,0,0,0,0,0,0,0
156851,21010,210,10,-2,4,0,4,0,0,0,0,0,0,0,0,0,0,0,0,0,0,0,3,0,3,0,0,0,1,0,1,0,0,0
156860,21010,210,10,-2,10,2,8,0,0,0,0,0,0,0,0,0,0,0,0,0,0,0,10,2,8,0,0,0,0,0,0,0,0,0
156921,21010,210,10,-2,18,7,11,1,1,0,2,1,1,2,1,1,0,0,0,0,0,0,12,4,8,1,0,1,0,0,0,0,0,0
157058,21010,210,10,-2,9,4,5,0,0,0,1,0,1,0,0,0,0,0,0,0,0,0,2,1,1,0,0,0,6,3,3,0,0,0
157076,21010,210,10,-2,5,2,3,0,0,0,0,0,0,0,0,0,0,0,0,0,0,0,5,2,3,0,0,0,0,0,0,0,0,0
157085,21010,210,10,-2,46,21,25,0,0,0,4,3,1,10,4,6,4,4,0,0,0,0,21,6,15,0,0,0,0,0,0,7,4,3
157100,21010,210,10,-2,4,1,3,0,0,0,0,0,0,0,0,0,0,0,0,0,0,0,4,1,3,0,0,0,0,0,0,0,0,0
157216,21010,210,10,-2,13,4,9,0,0,0,0,0,0,1,0,1,1,0,1,0,0,0,11,4,7,0,0,0,0,0,0,0,0,0
157289,21010,210,10,-2,78,39,39,0,0,0,5,4,1,4,1,3,4,3,1,0,0,0,58,26,32,0,0,0,0,0,0,7,5,2
157304,21010,210,10,-2,6,5,1,0,0,0,0,0,0,0,0,0,0,0,0,0,0,0,4,3,1,0,0,0,2,2,0,0,0,0
157331,21010,210,10,-2,5,1,4,0,0,0,0,0,0,0,0,0,0,0,0,0,0,0,5,1,4,0,0,0,0,0,0,0,0,0
157377,21010,210,10,-2,11,4,7,0,0,0,1,1,0,0,0,0,0,0,0,0,0,0,9,3,6,0,0,0,1,0,1,0,0,0
157386,21010,210,10,-2,22,10,12,0,0,0,2,2,0,0,0,0,1,0,1,0,0,0,17,7,10,1,0,1,1,1,0,0,0,0
157438,21010,210,10,-2,9,6,3,0,0,0,0,0,0,1,1,0,0,0,0,0,0,0,8,5,3,0,0,0,0,0,0,0,0,0
157447,21010,210,10,-2,28,10,18,1,0,1,0,0,0,4,2,2,0,0,0,0,0,0,19,5,14,0,0,0,0,0,0,4,3,1
157483,21010,210,10,-2,8,3,5,0,0,0,0,0,0,1,0,1,0,0,0,0,0,0,7,3,4,0,0,0,0,0,0,0,0,0
157535,21010,210,10,-2,21,8,13,0,0,0,4,1,3,1,1,0,0,0,0,0,0,0,15,5,10,0,0,0,1,1,0,0,0,0
157553,21010,210,10,-2,5,3,2,0,0,0,0,0,0,0,0,0,0,0,0,0,0,0,5,3,2,0,0,0,0,0,0,0,0,0
157711,21010,210,10,-2,6,4,2,0,0,0,0,0,0,0,0,0,1,1,0,0,0,0,5,3,2,0,0,0,0,0,0,0,0,0
157739,21010,210,10,-2,4,1,3,0,0,0,0,0,0,0,0,0,0,0,0,0,0,0,4,1,3,0,0,0,0,0,0,0,0,0
157748,21010,210,10,-2,1,1,0,0,0,0,0,0,0,0,0,0,0,0,0,0,0,0,0,0,0,0,0,0,1,1,0,0,0,0
157757,21010,210,10,-2,10,3,7,0,0,0,1,1,0,2,1,1,0,0,0,0,0,0,7,1,6,0,0,0,0,0,0,0,0,0
157809,21010,210,10,-2,8,4,4,0,0,0,1,1,0,0,0,0,0,0,0,0,0,0,7,3,4,0,0,0,0,0,0,0,0,0
157818,21010,210,10,-2,4,1,3,0,0,0,0,0,0,0,0,0,0,0,0,0,0,0,4,1,3,0,0,0,0,0,0,0,0,0
157863,21010,210,10,-2,4,1,3,0,0,0,0,0,0,0,0,0,0,0,0,0,0,0,3,1,2,0,0,0,0,0,0,1,0,1
157951,21010,210,10,-2,55,23,32,0,0,0,5,0,5,2,2,0,2,1,1,0,0,0,43,19,24,0,0,0,3,1,2,0,0,0
158088,21010,210,10,-2,17,5,12,0,0,0,0,0,0,4,1,3,0,0,0,0,0,0,7,2,5,0,0,0,6,2,4,0,0,0
158431,21010,210,10,-2,15,3,12,0,0,0,0,0,0,0,0,0,1,0,1,0,0,0,14,3,11,0,0,0,0,0,0,0,0,0
158477,21010,210,10,-2,1,1,0,0,0,0,1,1,0,0,0,0,0,0,0,0,0,0,0,0,0,0,0,0,0,0,0,0,0,0
158662,21010,210,10,-2,11,2,9,0,0,0,0,0,0,1,1,0,0,0,0,0,0,0,10,1,9,0,0,0,0,0,0,0,0,0
158802,21010,210,10,-2,9,5,4,0,0,0,0,0,0,6,2,4,0,0,0,0,0,0,3,3,0,0,0,0,0,0,0,0,0,0
158884,21010,210,10,-2,8,5,3,0,0,0,1,1,0,2,2,0,0,0,0,0,0,0,5,2,3,0,0,0,0,0,0,0,0,0
159009,21010,210,10,-2,1,0,1,0,0,0,0,0,0,1,0,1,0,0,0,0,0,0,0,0,0,0,0,0,0,0,0,0,0,0
159197,21010,210,10,-2,3,2,1,0,0,0,0,0,0,0,0,0,0,0,0,0,0,0,3,2,1,0,0,0,0,0,0,0,0,0
159373,21010,210,10,-2,42,20,22,0,0,0,6,4,2,4,0,4,1,1,0,0,0,0,28,14,14,0,0,0,1,0,1,2,1,1
159382,21010,210,10,-2,7,4,3,0,0,0,0,0,0,0,0,0,0,0,0,0,0,0,7,4,3,0,0,0,0,0,0,0,0,0
159391,21010,210,10,-2,101,49,52,0,0,0,6,2,4,11,5,6,9,5,4,0,0,0,56,26,30,2,1,1,2,2,0,15,8,7
159407,21010,210,10,-2,12,5,7,0,0,0,0,0,0,1,1,0,0,0,0,0,0,0,9,3,6,1,0,1,0,0,0,1,1,0
159416,21010,210,10,-2,20,10,10,0,0,0,3,3,0,2,0,2,2,0,2,0,0,0,13,7,6,0,0,0,0,0,0,0,0,0
159568,21010,210,10,-2,7,5,2,0,0,0,0,0,0,0,0,0,0,0,0,0,0,0,6,4,2,0,0,0,0,0,0,1,1,0
159647,21010,210,10,-2,18,13,5,0,0,0,2,1,1,0,0,0,0,0,0,0,0,0,16,12,4,0,0,0,0,0,0,0,0,0
159656,21010,210,10,-2,21,6,15,0,0,0,3,1,2,5,1,4,1,1,0,0,0,0,8,3,5,0,0,0,1,0,1,3,0,3
159717,21010,210,10,-2,13,2,11,1,0,1,0,0,0,0,0,0,0,0,0,0,0,0,11,2,9,0,0,0,1,0,1,0,0,0
159939,21010,210,10,-2,11,5,6,0,0,0,1,0,1,1,0,1,2,2,0,0,0,0,5,2,3,1,0,1,0,0,0,1,1,0
159948,21010,210,10,-2,2,2,0,0,0,0,0,0,0,0,0,0,0,0,0,0,0,0,2,2,0,0,0,0,0,0,0,0,0,0
159966,21010,210,10,-2,15,4,11,0,0,0,1,0,1,1,0,1,0,0,0,0,0,0,12,4,8,0,0,0,0,0,0,1,0,1
159993,21010,210,10,-2,29,13,16,0,0,0,7,5,2,4,2,2,2,1,1,0,0,0,16,5,11,0,0,0,0,0,0,0,0,0
160010,21010,210,10,-2,6,0,6,0,0,0,0,0,0,2,0,2,0,0,0,0,0,0,4,0,4,0,0,0,0,0,0,0,0,0
160038,21010,210,10,-2,38,13,25,0,0,0,0,0,0,0,0,0,2,2,0,0,0,0,20,3,17,0,0,0,14,6,8,2,2,0
160065,21010,210,10,-2,4,1,3,0,0,0,0,0,0,1,0,1,1,1,0,0,0,0,2,0,2,0,0,0,0,0,0,0,0,0
160074,21010,210,10,-2,3,1,2,0,0,0,0,0,0,0,0,0,0,0,0,0,0,0,3,1,2,0,0,0,0,0,0,0,0,0
160481,21010,210,10,-2,6,3,3,0,0,0,0,0,0,0,0,0,0,0,0,0,0,0,6,3,3,0,0,0,0,0,0,0,0,0
160579,21010,210,10,-2,9,0,9,0,0,0,0,0,0,3,0,3,1,0,1,0,0,0,5,0,5,0,0,0,0,0,0,0,0,0
160612,21010,210,10,-2,49,17,32,0,0,0,1,0,1,7,3,4,1,0,1,0,0,0,33,9,24,0,0,0,0,0,0,7,5,2
160621,21010,210,10,-2,15,3,12,0,0,0,1,1,0,11,1,10,0,0,0,0,0,0,3,1,2,0,0,0,0,0,0,0,0,0
160630,21010,210,10,-2,6,2,4,0,0,0,0,0,0,6,2,4,0,0,0,0,0,0,0,0,0,0,0,0,0,0,0,0,0,0
160649,21010,210,10,-2,5,2,3,0,0,0,0,0,0,5,2,3,0,0,0,0,0,0,0,0,0,0,0,0,0,0,0,0,0,0
160658,21010,210,10,-2,11,4,7,0,0,0,0,0,0,0,0,0,1,1,0,0,0,0,10,3,7,0,0,0,0,0,0,0,0,0
160667,21010,210,10,-2,12,6,6,0,0,0,0,0,0,0,0,0,0,0,0,0,0,0,12,6,6,0,0,0,0,0,0,0,0,0
160755,21010,210,10,-2,97,54,43,2,2,0,15,8,7,9,4,5,8,1,7,0,0,0,55,34,21,1,0,1,0,0,0,7,5,2
160904,21010,210,10,-2,17,7,10,0,0,0,0,0,0,8,2,6,0,0,0,1,1,0,4,1,3,0,0,0,0,0,0,4,3,1
160959,21010,210,10,-2,1,0,1,0,0,0,1,0,1,0,0,0,0,0,0,0,0,0,0,0,0,0,0,0,0,0,0,0,0,0
160977,21010,210,10,-2,9,4,5,0,0,0,3,0,3,1,1,0,0,0,0,0,0,0,3,1,2,2,2,0,0,0,0,0,0,0
161004,21010,210,10,-2,22,12,10,0,0,0,5,2,3,1,1,0,2,2,0,0,0,0,8,5,3,0,0,0,3,1,2,3,1,2
161022,21010,210,10,-2,2,0,2,0,0,0,0,0,0,0,0,0,0,0,0,0,0,0,2,0,2,0,0,0,0,0,0,0,0,0
161077,21010,210,10,-2,8,5,3,0,0,0,0,0,0,0,0,0,0,0,0,0,0,0,7,4,3,0,0,0,1,1,0,0,0,0
161086,21010,210,10,-2,35,16,19,0,0,0,1,0,1,0,0,0,1,1,0,0,0,0,18,8,10,2,0,2,3,2,1,10,5,5
161138,21010,210,10,-2,6,4,2,0,0,0,0,0,0,0,0,0,0,0,0,0,0,0,6,4,2,0,0,0,0,0,0,0,0,0
161192,21010,210,10,-2,10,4,6,0,0,0,0,0,0,0,0,0,0,0,0,0,0,0,10,4,6,0,0,0,0,0,0,0,0,0
161208,21010,210,10,-2,1,1,0,0,0,0,0,0,0,0,0,0,0,0,0,0,0,0,1,1,0,0,0,0,0,0,0,0,0,0
161217,21010,210,10,-2,4,1,3,0,0,0,0,0,0,0,0,0,0,0,0,0,0,0,4,1,3,0,0,0,0,0,0,0,0,0
161226,21010,210,10,-2,4,1,3,0,0,0,0,0,0,0,0,0,0,0,0,0,0,0,4,1,3,0,0,0,0,0,0,0,0,0
161235,21010,210,10,-2,3,1,2,0,0,0,0,0,0,0,0,0,0,0,0,0,0,0,2,1,1,0,0,0,1,0,1,0,0,0
161253,21010,210,10,-2,27,15,12,0,0,0,3,3,0,1,0,1,0,0,0,0,0,0,18,8,10,2,1,1,1,1,0,2,2,0
161299,21010,210,10,-2,5,4,1,0,0,0,0,0,0,0,0,0,0,0,0,0,0,0,5,4,1,0,0,0,0,0,0,0,0,0
161457,21010,210,10,-2,24,11,13,0,0,0,0,0,0,0,0,0,0,0,0,0,0,0,21,10,11,0,0,0,1,0,1,2,1,1
161484,21010,210,10,-2,3,3,0,0,0,0,0,0,0,0,0,0,0,0,0,0,0,0,3,3,0,0,0,0,0,0,0,0,0,0
161509,21010,210,10,-2,2,2,0,0,0,0,0,0,0,0,0,0,0,0,0,0,0,0,2,2,0,0,0,0,0,0,0,0,0,0
161518,21010,210,10,-2,2,0,2,0,0,0,0,0,0,0,0,0,0,0,0,0,0,0,2,0,2,0,0,0,0,0,0,0,0,0
161545,21010,210,10,-2,8,5,3,0,0,0,0,0,0,0,0,0,0,0,0,0,0,0,8,5,3,0,0,0,0,0,0,0,0,0
161554,21010,210,10,-2,15,4,11,0,0,0,1,1,0,0,0,0,0,0,0,0,0,0,13,3,10,0,0,0,0,0,0,1,0,1
161563,21010,210,10,-2,2,1,1,0,0,0,0,0,0,0,0,0,0,0,0,0,0,0,2,1,1,0,0,0,0,0,0,0,0,0
161688,21010,210,10,-2,6,1,5,0,0,0,0,0,0,0,0,0,0,0,0,0,0,0,6,1,5,0,0,0,0,0,0,0,0,0
161767,21010,210,10,-2,13,4,9,0,0,0,1,1,0,5,1,4,1,0,1,0,0,0,6,2,4,0,0,0,0,0,0,0,0,0
161864,21010,210,10,-2,7,3,4,0,0,0,1,1,0,3,0,3,0,0,0,0,0,0,3,2,1,0,0,0,0,0,0,0,0,0
161873,21010,210,10,-2,11,3,8,0,0,0,3,1,2,1,0,1,1,0,1,0,0,0,5,2,3,0,0,0,1,0,1,0,0,0
162007,21010,210,10,-2,13,5,8,0,0,0,0,0,0,10,5,5,1,0,1,0,0,0,1,0,1,0,0,0,1,0,1,0,0,0
162061,21010,210,10,-2,1,1,0,0,0,0,0,0,0,1,1,0,0,0,0,0,0,0,0,0,0,0,0,0,0,0,0,0,0,0
162122,21010,210,10,-2,4,3,1,0,0,0,0,0,0,0,0,0,0,0,0,0,0,0,4,3,1,0,0,0,0,0,0,0,0,0
162168,21010,210,10,-2,2,1,1,0,0,0,0,0,0,0,0,0,0,0,0,0,0,0,0,0,0,0,0,0,2,1,1,0,0,0
162210,21010,210,10,-2,1,0,1,0,0,0,0,0,0,0,0,0,0,0,0,0,0,0,1,0,1,0,0,0,0,0,0,0,0,0
162283,21010,210,10,-2,9,5,4,0,0,0,2,1,1,7,4,3,0,0,0,0,0,0,0,0,0,0,0,0,0,0,0,0,0,0
162557,21010,210,10,-2,8,1,7,0,0,0,0,0,0,0,0,0,1,0,1,0,0,0,7,1,6,0,0,0,0,0,0,0,0,0
162584,21010,210,10,-2,13,4,9,0,0,0,1,0,1,0,0,0,0,0,0,0,0,0,10,2,8,0,0,0,0,0,0,2,2,0
162654,21010,210,10,-2,6,3,3,0,0,0,1,1,0,1,1,0,0,0,0,0,0,0,4,1,3,0,0,0,0,0,0,0,0,0
162690,21010,210,10,-2,2,2,0,0,0,0,0,0,0,0,0,0,0,0,0,0,0,0,1,1,0,0,0,0,1,1,0,0,0,0
162706,21010,210,10,-2,2,1,1,0,0,0,0,0,0,0,0,0,0,0,0,0,0,0,2,1,1,0,0,0,0,0,0,0,0,0
162760,21010,210,10,-2,13,6,7,0,0,0,3,1,2,1,0,1,0,0,0,0,0,0,8,5,3,0,0,0,1,0,1,0,0,0
162779,21010,210,10,-2,8,4,4,0,0,0,1,1,0,2,1,1,0,0,0,0,0,0,4,2,2,1,0,1,0,0,0,0,0,0
162928,21010,210,10,-2,234,122,112,0,0,0,51,24,27,18,9,9,11,4,7,0,0,0,121,67,54,6,5,1,1,1,0,26,12,14
163028,21010,210,10,-2,21,21,0,0,0,0,1,1,0,10,10,0,0,0,0,0,0,0,7,7,0,1,1,0,2,2,0,0,0,0
163046,21010,210,10,-2,21,10,11,0,0,0,2,0,2,2,0,2,3,2,1,0,0,0,14,8,6,0,0,0,0,0,0,0,0,0
163204,21010,210,10,-2,10,4,6,0,0,0,1,0,1,0,0,0,0,0,0,0,0,0,4,2,2,0,0,0,5,2,3,0,0,0
163259,21010,210,10,-2,164,77,87,0,0,0,37,20,17,14,7,7,14,4,10,0,0,0,75,32,43,1,0,1,1,1,0,22,13,9
163268,21010,210,10,-2,13,7,6,0,0,0,1,0,1,0,0,0,0,0,0,0,0,0,7,4,3,0,0,0,2,0,2,3,3,0
163286,21010,210,10,-2,70,36,34,0,0,0,6,4,2,4,2,2,8,1,7,0,0,0,27,16,11,0,0,0,11,5,6,14,8,6
163295,21010,210,10,-2,12,6,6,0,0,0,2,1,1,2,1,1,1,0,1,0,0,0,2,1,1,0,0,0,1,1,0,4,2,2
163338,21010,210,10,-2,13,6,7,0,0,0,2,1,1,5,4,1,1,1,0,0,0,0,3,0,3,1,0,1,1,0,1,0,0,0
163426,21010,210,10,-2,27,10,17,0,0,0,2,1,1,12,4,8,2,2,0,0,0,0,7,3,4,0,0,0,1,0,1,3,0,3
163453,21010,210,10,-2,11,8,3,0,0,0,1,1,0,6,5,1,1,0,1,0,0,0,1,1,0,0,0,0,1,1,0,1,0,1
163462,21010,210,10,-2,9,5,4,0,0,0,1,0,1,2,2,0,1,1,0,0,0,0,4,2,2,1,0,1,0,0,0,0,0,0
163532,21010,210,10,-2,1,1,0,0,0,0,0,0,0,0,0,0,0,0,0,0,0,0,1,1,0,0,0,0,0,0,0,0,0,0
163578,21010,210,10,-2,15,5,10,0,0,0,3,1,2,3,1,2,0,0,0,0,0,0,8,2,6,1,1,0,0,0,0,0,0,0
163657,21010,210,10,-2,11,5,6,0,0,0,1,0,1,4,1,3,0,0,0,0,0,0,5,4,1,1,0,1,0,0,0,0,0,0
163851,21010,210,10,-2,27,11,16,0,0,0,3,1,2,1,0,1,2,2,0,0,0,0,13,5,8,0,0,0,0,0,0,8,3,5
163912,21010,210,10,-2,11,5,6,0,0,0,0,0,0,0,0,0,2,1,1,0,0,0,6,2,4,0,0,0,0,0,0,3,2,1
163976,21010,210,10,-2,4,2,2,0,0,0,0,0,0,0,0,0,0,0,0,0,0,0,4,2,2,0,0,0,0,0,0,0,0,0
164076,21010,210,10,-2,63,32,31,1,0,1,11,4,7,2,1,1,3,1,2,0,0,0,42,25,17,1,0,1,2,1,1,1,0,1
164155,21010,210,10,-2,24,16,8,0,0,0,3,1,2,2,2,0,1,0,1,0,0,0,16,12,4,0,0,0,2,1,1,0,0,0
164173,21010,210,10,-2,6,3,3,0,0,0,0,0,0,2,1,1,0,0,0,0,0,0,4,2,2,0,0,0,0,0,0,0,0,0
164216,21010,210,10,-2,7,2,5,0,0,0,3,2,1,1,0,1,1,0,1,0,0,0,2,0,2,0,0,0,0,0,0,0,0,0
164270,21010,210,10,-2,20,6,14,0,0,0,2,0,2,3,1,2,2,1,1,0,0,0,13,4,9,0,0,0,0,0,0,0,0,0
164313,21010,210,10,-2,4,1,3,0,0,0,2,1,1,0,0,0,0,0,0,0,0,0,2,0,2,0,0,0,0,0,0,0,0,0
164368,21010,210,10,-2,16,11,5,0,0,0,5,3,2,1,1,0,2,1,1,0,0,0,5,4,1,0,0,0,3,2,1,0,0,0
164447,21010,210,10,-2,3,0,3,0,0,0,0,0,0,0,0,0,0,0,0,0,0,0,3,0,3,0,0,0,0,0,0,0,0,0
164465,21010,210,10,-2,23,10,13,0,0,0,1,0,1,7,5,2,2,1,1,0,0,0,9,2,7,0,0,0,0,0,0,4,2,2
164492,21010,210,10,-2,5,0,5,0,0,0,0,0,0,0,0,0,0,0,0,0,0,0,5,0,5,0,0,0,0,0,0,0,0,0
164562,21010,210,10,-2,5,2,3,0,0,0,0,0,0,0,0,0,1,0,1,0,0,0,3,2,1,1,0,1,0,0,0,0,0,0
164580,21010,210,10,-2,1,1,0,0,0,0,0,0,0,0,0,0,0,0,0,0,0,0,1,1,0,0,0,0,0,0,0,0,0,0
164632,21010,210,10,-2,2,0,2,0,0,0,0,0,0,0,0,0,0,0,0,0,0,0,2,0,2,0,0,0,0,0,0,0,0,0
164739,21010,210,10,-2,20,11,9,0,0,0,5,3,2,2,2,0,0,0,0,0,0,0,10,5,5,0,0,0,1,0,1,2,1,1
164748,21010,210,10,-2,9,8,1,1,1,0,1,1,0,0,0,0,2,2,0,0,0,0,5,4,1,0,0,0,0,0,0,0,0,0
164775,21010,210,10,-2,1,0,1,0,0,0,0,0,0,0,0,0,1,0,1,0,0,0,0,0,0,0,0,0,0,0,0,0,0,0
164924,21010,210,10,-2,46,23,23,0,0,0,4,1,3,7,3,4,3,2,1,0,0,0,31,16,15,1,1,0,0,0,0,0,0,0
164988,21010,210,10,-2,234,106,128,0,0,0,32,13,19,14,3,11,20,9,11,0,0,0,107,49,58,5,4,1,25,6,19,31,22,9
165015,21010,210,10,-2,20,10,10,0,0,0,1,1,0,1,0,1,1,0,1,0,0,0,12,7,5,0,0,0,2,1,1,3,1,2
165024,21010,210,10,-2,8,1,7,0,0,0,1,1,0,1,0,1,0,0,0,0,0,0,5,0,5,0,0,0,1,0,1,0,0,0
165033,21010,210,10,-2,7,2,5,0,0,0,0,0,0,0,0,0,0,0,0,0,0,0,7,2,5,0,0,0,0,0,0,0,0,0
165112,21010,210,10,-2,9,1,8,0,0,0,1,0,1,0,0,0,2,1,1,0,0,0,6,0,6,0,0,0,0,0,0,0,0,0
165194,21010,210,10,-2,3,0,3,0,0,0,0,0,0,0,0,0,1,0,1,0,0,0,2,0,2,0,0,0,0,0,0,0,0,0
165264,21010,210,10,-2,1,0,1,0,0,0,0,0,0,0,0,0,0,0,0,0,0,0,1,0,1,0,0,0,0,0,0,0,0,0
165334,21010,210,10,-2,34,18,16,0,0,0,1,0,1,7,4,3,1,1,0,0,0,0,16,9,7,2,0,2,0,0,0,7,4,3
165529,21010,210,10,-2,5,2,3,0,0,0,0,0,0,2,0,2,0,0,0,0,0,0,2,1,1,0,0,0,1,1,0,0,0,0
165574,21010,210,10,-2,2,1,1,0,0,0,0,0,0,0,0,0,0,0,0,0,0,0,2,1,1,0,0,0,0,0,0,0,0,0
165644,21010,210,10,-2,4,3,1,0,0,0,1,1,0,0,0,0,0,0,0,0,0,0,1,0,1,0,0,0,2,2,0,0,0,0
165662,21010,210,10,-2,9,4,5,0,0,0,1,0,1,4,2,2,0,0,0,0,0,0,2,1,1,0,0,0,2,1,1,0,0,0
165671,21010,210,10,-2,4,1,3,0,0,0,0,0,0,0,0,0,1,0,1,0,0,0,3,1,2,0,0,0,0,0,0,0,0,0
165699,21010,210,10,-2,5,1,4,0,0,0,1,0,1,0,0,0,0,0,0,0,0,0,2,1,1,0,0,0,2,0,2,0,0,0
165802,21010,210,10,-2,3,1,2,0,0,0,1,0,1,0,0,0,0,0,0,0,0,0,2,1,1,0,0,0,0,0,0,0,0,0
165820,21010,210,10,-2,3,0,3,0,0,0,0,0,0,0,0,0,0,0,0,0,0,0,3,0,3,0,0,0,0,0,0,0,0,0
165866,21010,210,10,-2,3,0,3,0,0,0,0,0,0,0,0,0,0,0,0,0,0,0,3,0,3,0,0,0,0,0,0,0,0,0
165884,21010,210,10,-2,1,1,0,0,0,0,0,0,0,0,0,0,0,0,0,0,0,0,1,1,0,0,0,0,0,0,0,0,0,0
165936,21010,210,10,-2,8,2,6,0,0,0,2,0,2,0,0,0,0,0,0,0,0,0,4,2,2,0,0,0,2,0,2,0,0,0
165945,21010,210,10,-2,2,0,2,0,0,0,0,0,0,0,0,0,0,0,0,0,0,0,2,0,2,0,0,0,0,0,0,0,0,0
165981,21010,210,10,-2,2,1,1,0,0,0,0,0,0,0,0,0,0,0,0,0,0,0,2,1,1,0,0,0,0,0,0,0,0,0
166018,21010,210,10,-2,2,1,1,0,0,0,0,0,0,0,0,0,1,1,0,0,0,0,1,0,1,0,0,0,0,0,0,0,0,0
166027,21010,210,10,-2,132,59,73,0,0,0,9,3,6,9,5,4,16,5,11,0,0,0,74,31,43,3,2,1,1,1,0,20,12,8
166045,21010,210,10,-2,1,0,1,0,0,0,0,0,0,0,0,0,0,0,0,0,0,0,1,0,1,0,0,0,0,0,0,0,0,0
166124,21010,210,10,-2,20,11,9,0,0,0,2,1,1,0,0,0,3,1,2,0,0,0,10,6,4,1,0,1,2,1,1,2,2,0
166133,21010,210,10,-2,2,0,2,0,0,0,1,0,1,0,0,0,0,0,0,0,0,0,1,0,1,0,0,0,0,0,0,0,0,0
166391,21010,210,10,-2,2,1,1,0,0,0,0,0,0,0,0,0,0,0,0,0,0,0,0,0,0,1,1,0,1,0,1,0,0,0
166407,21010,210,10,-2,2,0,2,0,0,0,0,0,0,0,0,0,0,0,0,0,0,0,2,0,2,0,0,0,0,0,0,0,0,0
166452,21010,210,10,-2,9,5,4,0,0,0,2,1,1,2,0,2,0,0,0,0,0,0,5,4,1,0,0,0,0,0,0,0,0,0
166513,21010,210,10,-2,24,13,11,0,0,0,1,0,1,0,0,0,3,1,2,0,0,0,10,6,4,0,0,0,2,2,0,8,4,4
166629,21010,210,10,-2,49,20,29,1,1,0,2,0,2,4,1,3,3,0,3,0,0,0,23,10,13,0,0,0,0,0,0,16,8,8
166638,21010,210,10,-2,34,11,23,1,0,1,4,0,4,2,0,2,2,1,1,0,0,0,14,7,7,0,0,0,4,1,3,7,2,5
166647,21010,210,10,-2,6,0,6,0,0,0,1,0,1,2,0,2,0,0,0,0,0,0,2,0,2,0,0,0,1,0,1,0,0,0
166656,21010,210,10,-2,11,1,10,0,0,0,1,1,0,0,0,0,0,0,0,0,0,0,8,0,8,1,0,1,1,0,1,0,0,0
166674,21010,210,10,-2,17,5,12,0,0,0,2,1,1,1,1,0,3,1,2,0,0,0,8,2,6,0,0,0,3,0,3,0,0,0
166683,21010,210,10,-2,26,12,14,0,0,0,2,1,1,1,0,1,0,0,0,0,0,0,14,5,9,0,0,0,3,1,2,6,5,1
166692,21010,210,10,-2,1,1,0,0,0,0,0,0,0,0,0,0,0,0,0,0,0,0,1,1,0,0,0,0,0,0,0,0,0,0
166708,21010,210,10,-2,124,65,59,0,0,0,40,20,20,3,1,2,7,3,4,0,0,0,64,37,27,0,0,0,6,2,4,4,2,2
166717,21010,210,10,-2,11,3,8,0,0,0,0,0,0,2,0,2,1,0,1,0,0,0,8,3,5,0,0,0,0,0,0,0,0,0
166823,21010,210,10,-2,1,0,1,0,0,0,0,0,0,0,0,0,0,0,0,0,0,0,1,0,1,0,0,0,0,0,0,0,0,0
166850,21010,210,10,-2,15,3,12,0,0,0,1,0,1,2,1,1,0,0,0,0,0,0,9,1,8,2,0,2,1,1,0,0,0,0
166869,21010,210,10,-2,9,1,8,0,0,0,0,0,0,0,0,0,0,0,0,0,0,0,9,1,8,0,0,0,0,0,0,0,0,0
166911,21010,210,10,-2,4,1,3,0,0,0,1,0,1,0,0,0,0,0,0,0,0,0,1,0,1,0,0,0,2,1,1,0,0,0
166939,21010,210,10,-2,24,7,17,0,0,0,3,1,2,3,1,2,0,0,0,0,0,0,8,2,6,0,0,0,5,1,4,5,2,3
166957,21010,210,10,-2,5,2,3,0,0,0,0,0,0,0,0,0,1,0,1,0,0,0,4,2,2,0,0,0,0,0,0,0,0,0
167057,21010,210,10,-2,3,2,1,0,0,0,0,0,0,1,0,1,0,0,0,0,0,0,2,2,0,0,0,0,0,0,0,0,0,0
167093,21010,210,10,-2,2,0,2,0,0,0,0,0,0,0,0,0,0,0,0,0,0,0,1,0,1,0,0,0,1,0,1,0,0,0
167215,21010,210,10,-2,6,1,5,0,0,0,0,0,0,0,0,0,1,0,1,0,0,0,5,1,4,0,0,0,0,0,0,0,0,0
167260,21010,210,10,-2,4,4,0,0,0,0,0,0,0,1,1,0,0,0,0,0,0,0,3,3,0,0,0,0,0,0,0,0,0,0
167288,21010,210,10,-2,4,3,1,0,0,0,0,0,0,0,0,0,0,0,0,0,0,0,4,3,1,0,0,0,0,0,0,0,0,0
167312,21010,210,10,-2,6,0,6,0,0,0,0,0,0,0,0,0,1,0,1,0,0,0,5,0,5,0,0,0,0,0,0,0,0,0
167358,21010,210,10,-2,115,71,44,0,0,0,19,12,7,4,2,2,4,3,1,0,0,0,54,32,22,3,1,2,20,13,7,11,8,3
167376,21010,210,10,-2,8,2,6,0,0,0,0,0,0,1,0,1,0,0,0,0,0,0,7,2,5,0,0,0,0,0,0,0,0,0
167394,21010,210,10,-2,4,0,4,0,0,0,0,0,0,1,0,1,0,0,0,0,0,0,3,0,3,0,0,0,0,0,0,0,0,0
167525,21010,210,10,-2,5,2,3,0,0,0,0,0,0,0,0,0,1,1,0,0,0,0,4,1,3,0,0,0,0,0,0,0,0,0
167534,21010,210,10,-2,9,3,6,0,0,0,2,0,2,0,0,0,1,1,0,0,0,0,6,2,4,0,0,0,0,0,0,0,0,0
167598,21010,210,10,-2,9,1,8,0,0,0,0,0,0,5,1,4,2,0,2,0,0,0,2,0,2,0,0,0,0,0,0,0,0,0
167631,21010,210,10,-2,1,1,0,0,0,0,0,0,0,1,1,0,0,0,0,0,0,0,0,0,0,0,0,0,0,0,0,0,0,0
167677,21010,210,10,-2,1,1,0,0,0,0,0,0,0,0,0,0,0,0,0,0,0,0,1,1,0,0,0,0,0,0,0,0,0,0
167729,21010,210,10,-2,16,6,10,0,0,0,0,0,0,1,1,0,1,1,0,0,0,0,14,4,10,0,0,0,0,0,0,0,0,0
167783,21010,210,10,-2,27,9,18,0,0,0,1,0,1,6,1,5,2,1,1,0,0,0,16,6,10,0,0,0,0,0,0,2,1,1
167792,21010,210,10,-2,3,1,2,0,0,0,1,0,1,0,0,0,0,0,0,0,0,0,1,0,1,0,0,0,0,0,0,1,1,0
167835,21010,210,10,-2,19,3,16,0,0,0,1,0,1,6,1,5,0,0,0,0,0,0,5,1,4,2,0,2,0,0,0,5,1,4
167899,21010,210,10,-2,26,11,15,0,0,0,4,3,1,2,0,2,1,0,1,0,0,0,15,6,9,3,2,1,1,0,1,0,0,0
167905,21010,210,10,-2,3,0,3,0,0,0,0,0,0,0,0,0,1,0,1,0,0,0,2,0,2,0,0,0,0,0,0,0,0,0
167987,21010,210,10,-2,13,4,9,0,0,0,0,0,0,1,0,1,0,0,0,0,0,0,12,4,8,0,0,0,0,0,0,0,0,0
167996,21010,210,10,-2,12,6,6,0,0,0,1,1,0,0,0,0,0,0,0,0,0,0,1,0,1,0,0,0,10,5,5,0,0,0
168005,21010,210,10,-2,9,3,6,0,0,0,2,0,2,0,0,0,1,0,1,0,0,0,6,3,3,0,0,0,0,0,0,0,0,0
168148,21010,210,10,-2,66,31,35,0,0,0,8,3,5,8,4,4,7,3,4,0,0,0,31,16,15,2,1,1,2,0,2,8,4,4
168218,21010,210,10,-2,13,3,10,0,0,0,1,0,1,0,0,0,1,0,1,1,1,0,5,1,4,1,1,0,1,0,1,3,0,3
168227,21010,210,10,-2,8,4,4,0,0,0,1,1,0,0,0,0,0,0,0,0,0,0,5,2,3,0,0,0,2,1,1,0,0,0
168254,21010,210,10,-2,3,1,2,0,0,0,1,1,0,0,0,0,0,0,0,0,0,0,1,0,1,0,0,0,1,0,1,0,0,0
168263,21010,210,10,-2,3,0,3,0,0,0,1,0,1,0,0,0,0,0,0,0,0,0,2,0,2,0,0,0,0,0,0,0,0,0
168281,21010,210,10,-2,9,2,7,0,0,0,1,0,1,2,1,1,1,1,0,0,0,0,5,0,5,0,0,0,0,0,0,0,0,0
168342,21010,210,10,-2,20,8,12,0,0,0,2,0,2,4,0,4,4,2,2,0,0,0,4,2,2,0,0,0,0,0,0,6,4,2
168421,21010,210,10,-2,30,19,11,0,0,0,3,2,1,1,0,1,3,1,2,0,0,0,11,8,3,1,0,1,4,2,2,7,6,1
168430,21010,210,10,-2,30,5,25,1,1,0,0,0,0,0,0,0,0,0,0,0,0,0,28,4,24,1,0,1,0,0,0,0,0,0
168528,21010,210,10,-2,4,1,3,0,0,0,0,0,0,0,0,0,0,0,0,0,0,0,4,1,3,0,0,0,0,0,0,0,0,0
168546,21010,210,10,-2,17,8,9,0,0,0,3,1,2,1,1,0,3,1,2,0,0,0,9,4,5,0,0,0,0,0,0,1,1,0
168591,21010,210,10,-2,7,2,5,0,0,0,2,1,1,1,1,0,0,0,0,0,0,0,4,0,4,0,0,0,0,0,0,0,0,0
168607,21010,210,10,-2,4,2,2,0,0,0,0,0,0,0,0,0,0,0,0,0,0,0,4,2,2,0,0,0,0,0,0,0,0,0
168740,21010,210,10,-2,17,7,10,0,0,0,1,1,0,3,2,1,3,2,1,0,0,0,6,2,4,1,0,1,0,0,0,3,0,3
168847,21010,210,10,-2,12,4,8,0,0,0,0,0,0,1,0,1,0,0,0,0,0,0,11,4,7,0,0,0,0,0,0,0,0,0
168883,21010,210,10,-2,1,1,0,0,0,0,0,0,0,0,0,0,0,0,0,0,0,0,1,1,0,0,0,0,0,0,0,0,0,0
169220,21010,210,10,-2,2,1,1,0,0,0,0,0,0,1,1,0,0,0,0,0,0,0,1,0,1,0,0,0,0,0,0,0,0,0
169248,21010,210,10,-2,20,10,10,0,0,0,2,0,2,0,0,0,0,0,0,0,0,0,17,9,8,0,0,0,0,0,0,1,1,0
169275,21010,210,10,-2,1,1,0,0,0,0,0,0,0,0,0,0,0,0,0,0,0,0,1,1,0,0,0,0,0,0,0,0,0,0
169327,21010,210,10,-2,2,1,1,0,0,0,0,0,0,0,0,0,0,0,0,0,0,0,2,1,1,0,0,0,0,0,0,0,0,0
169363,21010,210,10,-2,8,4,4,0,0,0,0,0,0,0,0,0,0,0,0,0,0,0,8,4,4,0,0,0,0,0,0,0,0,0
169424,21010,210,10,-2,1,1,0,0,0,0,0,0,0,0,0,0,0,0,0,0,0,0,1,1,0,0,0,0,0,0,0,0,0,0
169479,21010,210,10,-2,11,5,6,0,0,0,0,0,0,2,2,0,0,0,0,0,0,0,6,1,5,1,0,1,1,1,0,1,1,0
169521,21010,210,10,-2,2,0,2,0,0,0,0,0,0,0,0,0,0,0,0,0,0,0,2,0,2,0,0,0,0,0,0,0,0,0
169655,21010,210,10,-2,14,11,3,0,0,0,0,0,0,5,5,0,1,1,0,0,0,0,7,4,3,1,1,0,0,0,0,0,0,0
169716,21010,210,10,-2,24,7,17,0,0,0,1,0,1,0,0,0,1,0,1,0,0,0,5,1,4,0,0,0,2,0,2,15,6,9
169761,21010,210,10,-2,3,1,2,0,0,0,0,0,0,1,0,1,0,0,0,0,0,0,2,1,1,0,0,0,0,0,0,0,0,0
169798,21010,210,10,-2,19,9,10,1,1,0,2,0,2,2,1,1,1,1,0,0,0,0,12,6,6,0,0,0,1,0,1,0,0,0
169910,21010,210,10,-2,3,2,1,0,0,0,0,0,0,0,0,0,0,0,0,0,0,0,2,1,1,0,0,0,0,0,0,1,1,0
169983,21010,210,10,-2,12,5,7,0,0,0,3,1,2,1,0,1,0,0,0,0,0,0,7,4,3,1,0,1,0,0,0,0,0,0
169992,21010,210,10,-2,3,2,1,0,0,0,0,0,0,0,0,0,0,0,0,0,0,0,3,2,1,0,0,0,0,0,0,0,0,0
170037,21010,210,10,-2,4,3,1,0,0,0,0,0,0,0,0,0,1,0,1,0,0,0,3,3,0,0,0,0,0,0,0,0,0,0
170055,21010,210,10,-2,17,7,10,0,0,0,0,0,0,1,0,1,0,0,0,0,0,0,16,7,9,0,0,0,0,0,0,0,0,0
170082,21010,210,10,-2,49,27,22,0,0,0,2,1,1,1,0,1,2,1,1,0,0,0,39,21,18,0,0,0,2,2,0,3,2,1
170240,21010,210,10,-2,18,7,11,0,0,0,2,2,0,3,1,2,0,0,0,0,0,0,12,4,8,0,0,0,0,0,0,1,0,1
170286,21010,210,10,-2,12,10,2,0,0,0,0,0,0,0,0,0,0,0,0,0,0,0,0,0,0,0,0,0,12,10,2,0,0,0
170301,21010,210,10,-2,20,7,13,0,0,0,2,0,2,1,1,0,1,1,0,1,1,0,12,4,8,2,0,2,0,0,0,1,0,1
170532,21010,210,10,-2,9,6,3,0,0,0,2,1,1,4,2,2,0,0,0,0,0,0,3,3,0,0,0,0,0,0,0,0,0,0
170541,21010,210,10,-2,2,2,0,0,0,0,0,0,0,0,0,0,0,0,0,0,0,0,1,1,0,0,0,0,1,1,0,0,0,0
170550,21010,210,10,-2,9,5,4,0,0,0,1,1,0,0,0,0,0,0,0,0,0,0,8,4,4,0,0,0,0,0,0,0,0,0
170587,21010,210,10,-2,4,2,2,0,0,0,0,0,0,0,0,0,0,0,0,0,0,0,4,2,2,0,0,0,0,0,0,0,0,0
170620,21010,210,10,-2,4,2,2,0,0,0,0,0,0,2,1,1,0,0,0,0,0,0,2,1,1,0,0,0,0,0,0,0,0,0
170639,21010,210,10,-2,17,7,10,0,0,0,0,0,0,0,0,0,0,0,0,0,0,0,15,5,10,0,0,0,1,1,0,1,1,0
170657,21010,210,10,-2,8,4,4,0,0,0,0,0,0,2,1,1,0,0,0,0,0,0,6,3,3,0,0,0,0,0,0,0,0,0
170675,21010,210,10,-2,17,11,6,0,0,0,1,1,0,0,0,0,1,1,0,0,0,0,12,8,4,0,0,0,1,1,0,2,0,2
170806,21010,210,10,-2,4,2,2,0,0,0,0,0,0,0,0,0,0,0,0,0,0,0,4,2,2,0,0,0,0,0,0,0,0,0
170967,21010,210,10,-2,5,1,4,0,0,0,0,0,0,1,0,1,0,0,0,0,0,0,4,1,3,0,0,0,0,0,0,0,0,0
170976,21010,210,10,-2,667,379,288,2,2,0,49,19,30,24,12,12,14,9,5,0,0,0,255,116,139,12,7,5,18,11,7,293,203,90
171100,21010,210,10,-2,91,42,49,0,0,0,13,10,3,5,2,3,7,3,4,0,0,0,51,17,34,1,0,1,0,0,0,14,10,4
171128,21010,210,10,-2,12,7,5,0,0,0,1,1,0,0,0,0,0,0,0,0,0,0,3,2,1,0,0,0,2,1,1,6,3,3
171137,21010,210,10,-2,7,5,2,0,0,0,1,0,1,0,0,0,0,0,0,0,0,0,4,4,0,1,0,1,0,0,0,1,1,0
171146,21010,210,10,-2,8,2,6,0,0,0,0,0,0,1,0,1,0,0,0,0,0,0,6,2,4,0,0,0,0,0,0,1,0,1
171234,21010,210,10,-2,2,0,2,0,0,0,0,0,0,0,0,0,0,0,0,0,0,0,2,0,2,0,0,0,0,0,0,0,0,0
171304,21010,210,10,-2,1,1,0,0,0,0,0,0,0,0,0,0,0,0,0,0,0,0,1,1,0,0,0,0,0,0,0,0,0,0
171395,21010,210,10,-2,3,2,1,0,0,0,0,0,0,0,0,0,0,0,0,0,0,0,3,2,1,0,0,0,0,0,0,0,0,0
171456,21010,210,10,-2,16,8,8,0,0,0,0,0,0,0,0,0,0,0,0,0,0,0,14,7,7,0,0,0,1,0,1,1,1,0
171483,21010,210,10,-2,3,0,3,0,0,0,0,0,0,0,0,0,0,0,0,0,0,0,3,0,3,0,0,0,0,0,0,0,0,0
171535,21010,210,10,-2,11,4,7,0,0,0,0,0,0,2,1,1,0,0,0,0,0,0,9,3,6,0,0,0,0,0,0,0,0,0
171571,21010,210,10,-2,27,11,16,1,1,0,3,3,0,1,1,0,0,0,0,0,0,0,16,4,12,0,0,0,0,0,0,6,2,4
171599,21010,210,10,-2,3,0,3,0,0,0,0,0,0,1,0,1,1,0,1,0,0,0,1,0,1,0,0,0,0,0,0,0,0,0
171881,21010,210,10,-2,1,0,1,0,0,0,0,0,0,0,0,0,0,0,0,0,0,0,1,0,1,0,0,0,0,0,0,0,0,0
172033,21010,210,10,-2,4,3,1,0,0,0,0,0,0,0,0,0,0,0,0,0,0,0,4,3,1,0,0,0,0,0,0,0,0,0
172051,21010,210,10,-2,13,8,5,0,0,0,0,0,0,0,0,0,0,0,0,0,0,0,13,8,5,0,0,0,0,0,0,0,0,0
172200,21010,210,10,-2,5,3,2,0,0,0,0,0,0,1,1,0,0,0,0,0,0,0,3,2,1,0,0,0,1,0,1,0,0,0
172264,21010,210,10,-2,4,1,3,0,0,0,0,0,0,0,0,0,0,0,0,0,0,0,4,1,3,0,0,0,0,0,0,0,0,0
172291,21010,210,10,-2,5,2,3,0,0,0,0,0,0,0,0,0,0,0,0,0,0,0,5,2,3,0,0,0,0,0,0,0,0,0
172307,21010,210,10,-2,4,2,2,0,0,0,0,0,0,0,0,0,0,0,0,0,0,0,2,1,1,0,0,0,2,1,1,0,0,0
172334,21010,210,10,-2,8,3,5,0,0,0,0,0,0,0,0,0,0,0,0,0,0,0,7,2,5,0,0,0,1,1,0,0,0,0
172440,21010,210,10,-2,11,2,9,0,0,0,0,0,0,0,0,0,0,0,0,0,0,0,11,2,9,0,0,0,0,0,0,0,0,0
172617,21010,210,10,-2,1,1,0,1,1,0,0,0,0,0,0,0,0,0,0,0,0,0,0,0,0,0,0,0,0,0,0,0,0,0
172635,21010,210,10,-2,3,1,2,0,0,0,0,0,0,2,1,1,0,0,0,0,0,0,1,0,1,0,0,0,0,0,0,0,0,0
172644,21010,210,10,-2,69,37,32,0,0,0,5,2,3,6,2,4,1,1,0,0,0,0,41,26,15,1,0,1,0,0,0,15,6,9
172671,21010,210,10,-2,1,1,0,0,0,0,0,0,0,0,0,0,0,0,0,0,0,0,1,1,0,0,0,0,0,0,0,0,0,0
172699,21010,210,10,-2,16,5,11,0,0,0,2,0,2,4,1,3,0,0,0,0,0,0,10,4,6,0,0,0,0,0,0,0,0,0
172705,21010,210,10,-2,1,1,0,0,0,0,0,0,0,0,0,0,1,1,0,0,0,0,0,0,0,0,0,0,0,0,0,0,0,0
172918,21010,210,10,-2,2,2,0,0,0,0,0,0,0,0,0,0,0,0,0,0,0,0,2,2,0,0,0,0,0,0,0,0,0,0
172963,21010,210,10,-2,3,0,3,0,0,0,1,0,1,0,0,0,0,0,0,0,0,0,2,0,2,0,0,0,0,0,0,0,0,0
173045,21010,210,10,-2,11,1,10,0,0,0,2,0,2,0,0,0,1,0,1,1,0,1,4,1,3,1,0,1,2,0,2,0,0,0
173063,21010,210,10,-2,4,2,2,0,0,0,0,0,0,0,0,0,0,0,0,0,0,0,4,2,2,0,0,0,0,0,0,0,0,0
173115,21010,210,10,-2,1,1,0,0,0,0,0,0,0,0,0,0,0,0,0,0,0,0,1,1,0,0,0,0,0,0,0,0,0,0
173124,21010,210,10,-2,17,9,8,2,1,1,1,1,0,0,0,0,1,1,0,0,0,0,9,5,4,1,0,1,3,1,2,0,0,0
173142,21010,210,10,-2,3,1,2,0,0,0,0,0,0,0,0,0,0,0,0,0,0,0,3,1,2,0,0,0,0,0,0,0,0,0
173160,21010,210,10,-2,11,5,6,0,0,0,0,0,0,0,0,0,0,0,0,0,0,0,9,4,5,0,0,0,2,1,1,0,0,0
173203,21010,210,10,-2,3,1,2,0,0,0,0,0,0,0,0,0,0,0,0,0,0,0,2,0,2,0,0,0,1,1,0,0,0,0
173258,21010,210,10,-2,11,5,6,0,0,0,2,0,2,0,0,0,3,3,0,0,0,0,6,2,4,0,0,0,0,0,0,0,0,0
173300,21010,210,10,-2,6,2,4,0,0,0,0,0,0,0,0,0,1,0,1,0,0,0,5,2,3,0,0,0,0,0,0,0,0,0
173328,21010,210,10,-2,5,1,4,0,0,0,0,0,0,0,0,0,0,0,0,0,0,0,4,1,3,0,0,0,1,0,1,0,0,0
173416,21010,210,10,-2,5,4,1,0,0,0,1,0,1,0,0,0,0,0,0,0,0,0,4,4,0,0,0,0,0,0,0,0,0,0
173452,21010,210,10,-2,5,5,0,0,0,0,0,0,0,1,1,0,0,0,0,0,0,0,4,4,0,0,0,0,0,0,0,0,0,0
173461,21010,210,10,-2,2,1,1,0,0,0,0,0,0,0,0,0,0,0,0,0,0,0,1,1,0,0,0,0,1,0,1,0,0,0
173638,21010,210,10,-2,5,4,1,0,0,0,0,0,0,0,0,0,0,0,0,0,0,0,5,4,1,0,0,0,0,0,0,0,0,0
173647,21010,210,10,-2,4,0,4,0,0,0,0,0,0,1,0,1,0,0,0,0,0,0,3,0,3,0,0,0,0,0,0,0,0,0
173665,21010,210,10,-2,4,2,2,0,0,0,0,0,0,0,0,0,1,0,1,0,0,0,2,1,1,0,0,0,1,1,0,0,0,0
173708,21010,210,10,-2,1,1,0,0,0,0,0,0,0,0,0,0,0,0,0,0,0,0,1,1,0,0,0,0,0,0,0,0,0,0
173799,21010,210,10,-2,6,3,3,0,0,0,1,1,0,1,0,1,1,1,0,0,0,0,2,1,1,0,0,0,1,0,1,0,0,0
173805,21010,210,10,-2,2,2,0,0,0,0,0,0,0,0,0,0,0,0,0,0,0,0,2,2,0,0,0,0,0,0,0,0,0,0
173902,21010,210,10,-2,14,7,7,0,0,0,2,0,2,1,1,0,1,0,1,0,0,0,6,5,1,0,0,0,0,0,0,4,1,3
173911,21010,210,10,-2,9,6,3,0,0,0,0,0,0,1,1,0,0,0,0,0,0,0,8,5,3,0,0,0,0,0,0,0,0,0
173920,21010,210,10,-2,32,11,21,0,0,0,4,1,3,2,0,2,4,2,2,0,0,0,22,8,14,0,0,0,0,0,0,0,0,0
174020,21010,210,10,-2,11,3,8,0,0,0,2,0,2,1,0,1,1,0,1,0,0,0,5,2,3,0,0,0,2,1,1,0,0,0
174066,21010,210,10,-2,174,98,76,1,0,1,17,12,5,12,6,6,4,2,2,1,1,0,88,46,42,7,3,4,28,18,10,16,10,6
174075,21010,210,10,-2,2,2,0,0,0,0,0,0,0,0,0,0,0,0,0,0,0,0,1,1,0,0,0,0,0,0,0,1,1,0
174127,21010,210,10,-2,2,0,2,0,0,0,0,0,0,1,0,1,0,0,0,0,0,0,1,0,1,0,0,0,0,0,0,0,0,0
174136,21010,210,10,-2,3,2,1,0,0,0,0,0,0,0,0,0,0,0,0,0,0,0,3,2,1,0,0,0,0,0,0,0,0,0
174154,21010,210,10,-2,7,0,7,0,0,0,0,0,0,0,0,0,0,0,0,0,0,0,7,0,7,0,0,0,0,0,0,0,0,0
174233,21010,210,10,-2,30,17,13,0,0,0,2,1,1,0,0,0,1,1,0,0,0,0,20,9,11,0,0,0,2,2,0,5,4,1
174358,21010,210,10,-2,13,4,9,0,0,0,0,0,0,0,0,0,0,0,0,0,0,0,11,3,8,0,0,0,1,1,0,1,0,1
174376,21010,210,10,-2,2,1,1,0,0,0,0,0,0,0,0,0,0,0,0,0,0,0,1,1,0,0,0,0,1,0,1,0,0,0
174428,21010,210,10,-2,5,1,4,0,0,0,2,1,1,0,0,0,0,0,0,0,0,0,3,0,3,0,0,0,0,0,0,0,0,0
174437,21010,210,10,-2,1,0,1,0,0,0,0,0,0,0,0,0,0,0,0,0,0,0,1,0,1,0,0,0,0,0,0,0,0,0
174473,21010,210,10,-2,3,2,1,0,0,0,0,0,0,0,0,0,0,0,0,0,0,0,3,2,1,0,0,0,0,0,0,0,0,0
174491,21010,210,10,-2,3,2,1,0,0,0,0,0,0,0,0,0,1,1,0,0,0,0,2,1,1,0,0,0,0,0,0,0,0,0
174507,21010,210,10,-2,2,0,2,0,0,0,0,0,0,0,0,0,0,0,0,0,0,0,2,0,2,0,0,0,0,0,0,0,0,0
174525,21010,210,10,-2,1,1,0,0,0,0,0,0,0,0,0,0,0,0,0,0,0,0,1,1,0,0,0,0,0,0,0,0,0,0
174570,21010,210,10,-2,1,0,1,0,0,0,0,0,0,0,0,0,0,0,0,0,0,0,1,0,1,0,0,0,0,0,0,0,0,0
174738,21010,210,10,-2,1,0,1,0,0,0,0,0,0,0,0,0,0,0,0,0,0,0,1,0,1,0,0,0,0,0,0,0,0,0
174747,21010,210,10,-2,6,3,3,0,0,0,1,0,1,1,0,1,0,0,0,0,0,0,3,2,1,0,0,0,1,1,0,0,0,0
174756,21010,210,10,-2,3,1,2,0,0,0,0,0,0,0,0,0,0,0,0,0,0,0,3,1,2,0,0,0,0,0,0,0,0,0
174783,21010,210,10,-2,21,12,9,0,0,0,5,4,1,1,1,0,1,1,0,0,0,0,11,4,7,0,0,0,3,2,1,0,0,0
174792,21010,210,10,-2,8,5,3,0,0,0,1,0,1,0,0,0,1,1,0,0,0,0,5,3,2,1,1,0,0,0,0,0,0,0
174817,21010,210,10,-2,4,2,2,0,0,0,0,0,0,1,1,0,0,0,0,0,0,0,3,1,2,0,0,0,0,0,0,0,0,0
174844,21010,210,10,-2,18,10,8,0,0,0,1,0,1,1,1,0,1,1,0,0,0,0,13,7,6,0,0,0,1,1,0,1,0,1
174862,21010,210,10,-2,2,2,0,0,0,0,1,1,0,0,0,0,0,0,0,0,0,0,1,1,0,0,0,0,0,0,0,0,0,0
174899,21010,210,10,-2,10,6,4,0,0,0,1,1,0,0,0,0,0,0,0,0,0,0,8,4,4,1,1,0,0,0,0,0,0,0
174914,21010,210,10,-2,15,6,9,0,0,0,2,1,1,1,0,1,2,1,1,0,0,0,9,4,5,0,0,0,0,0,0,1,0,1
175005,21010,210,10,-2,30,3,27,0,0,0,1,1,0,5,0,5,0,0,0,0,0,0,24,2,22,0,0,0,0,0,0,0,0,0
175014,21010,210,10,-2,20,4,16,0,0,0,0,0,0,2,1,1,0,0,0,0,0,0,16,2,14,1,1,0,1,0,1,0,0,0
175041,21010,210,10,-2,4,2,2,0,0,0,0,0,0,0,0,0,1,1,0,0,0,0,3,1,2,0,0,0,0,0,0,0,0,0
175078,21010,210,10,-2,4,2,2,0,0,0,0,0,0,0,0,0,0,0,0,0,0,0,4,2,2,0,0,0,0,0,0,0,0,0
175227,21010,210,10,-2,11,7,4,0,0,0,1,0,1,0,0,0,0,0,0,0,0,0,10,7,3,0,0,0,0,0,0,0,0,0
175236,21010,210,10,-2,4,2,2,0,0,0,0,0,0,0,0,0,0,0,0,0,0,0,3,2,1,0,0,0,1,0,1,0,0,0
175263,21010,210,10,-2,2,1,1,0,0,0,0,0,0,0,0,0,0,0,0,0,0,0,2,1,1,0,0,0,0,0,0,0,0,0
175272,21010,210,10,-2,23,6,17,0,0,0,2,1,1,0,0,0,1,0,1,0,0,0,17,4,13,1,0,1,2,1,1,0,0,0
175281,21010,210,10,-2,5,1,4,0,0,0,0,0,0,3,1,2,0,0,0,0,0,0,2,0,2,0,0,0,0,0,0,0,0,0
175315,21010,210,10,-2,1,1,0,0,0,0,0,0,0,1,1,0,0,0,0,0,0,0,0,0,0,0,0,0,0,0,0,0,0,0
175342,21010,210,10,-2,8,4,4,0,0,0,0,0,0,7,4,3,0,0,0,0,0,0,1,0,1,0,0,0,0,0,0,0,0,0
175421,21010,210,10,-2,6,2,4,0,0,0,0,0,0,2,0,2,0,0,0,0,0,0,4,2,2,0,0,0,0,0,0,0,0,0
175430,21010,210,10,-2,3,2,1,0,0,0,0,0,0,1,1,0,0,0,0,0,0,0,2,1,1,0,0,0,0,0,0,0,0,0
175519,21010,210,10,-2,8,4,4,0,0,0,0,0,0,5,2,3,0,0,0,0,0,0,3,2,1,0,0,0,0,0,0,0,0,0
175573,21010,210,10,-2,4,0,4,0,0,0,0,0,0,1,0,1,0,0,0,0,0,0,2,0,2,1,0,1,0,0,0,0,0,0
175616,21010,210,10,-2,12,7,5,0,0,0,2,2,0,1,0,1,0,0,0,0,0,0,7,4,3,0,0,0,0,0,0,2,1,1
175643,21010,210,10,-2,4,3,1,0,0,0,0,0,0,0,0,0,0,0,0,0,0,0,4,3,1,0,0,0,0,0,0,0,0,0
175652,21010,210,10,-2,2,1,1,0,0,0,0,0,0,1,0,1,0,0,0,0,0,0,1,1,0,0,0,0,0,0,0,0,0,0
175786,21010,210,10,-2,30,12,18,0,0,0,0,0,0,10,2,8,1,0,1,0,0,0,18,10,8,0,0,0,1,0,1,0,0,0
175810,21010,210,10,-2,11,1,10,0,0,0,0,0,0,2,0,2,0,0,0,0,0,0,9,1,8,0,0,0,0,0,0,0,0,0
175829,21010,210,10,-2,5,1,4,0,0,0,0,0,0,0,0,0,0,0,0,0,0,0,5,1,4,0,0,0,0,0,0,0,0,0
175856,21010,210,10,-2,29,10,19,0,0,0,3,3,0,20,4,16,0,0,0,0,0,0,5,2,3,0,0,0,0,0,0,1,1,0
175883,21010,210,10,-2,18,10,8,0,0,0,1,1,0,3,0,3,0,0,0,0,0,0,14,9,5,0,0,0,0,0,0,0,0,0
175935,21010,210,10,-2,7,1,6,0,0,0,0,0,0,3,1,2,0,0,0,0,0,0,3,0,3,0,0,0,1,0,1,0,0,0
175980,21010,210,10,-2,2,1,1,0,0,0,0,0,0,0,0,0,1,0,1,0,0,0,1,1,0,0,0,0,0,0,0,0,0,0
176008,21010,210,10,-2,10,3,7,0,0,0,0,0,0,4,2,2,0,0,0,0,0,0,6,1,5,0,0,0,0,0,0,0,0,0
176017,21010,210,10,-2,105,48,57,0,0,0,9,6,3,15,3,12,3,1,2,0,0,0,56,28,28,2,1,1,1,1,0,19,8,11
176035,21010,210,10,-2,15,3,12,0,0,0,1,1,0,2,0,2,0,0,0,0,0,0,11,1,10,0,0,0,0,0,0,1,1,0
176044,21010,210,10,-2,7,4,3,0,0,0,1,1,0,4,2,2,0,0,0,0,0,0,2,1,1,0,0,0,0,0,0,0,0,0
176053,21010,210,10,-2,21,9,12,0,0,0,0,0,0,1,1,0,0,0,0,0,0,0,7,3,4,0,0,0,12,4,8,1,1,0
176071,21010,210,10,-2,37,16,21,0,0,0,1,1,0,4,0,4,1,0,1,0,0,0,21,10,11,0,0,0,10,5,5,0,0,0
176080,21010,210,10,-2,68,36,32,0,0,0,4,4,0,5,0,5,2,1,1,0,0,0,39,20,19,0,0,0,0,0,0,18,11,7
176169,21010,210,10,-2,8,1,7,0,0,0,0,0,0,0,0,0,0,0,0,0,0,0,6,0,6,0,0,0,2,1,1,0,0,0
176178,21010,210,10,-2,18,7,11,0,0,0,0,0,0,3,1,2,0,0,0,0,0,0,15,6,9,0,0,0,0,0,0,0,0,0
176239,21010,210,10,-2,24,6,18,0,0,0,0,0,0,4,1,3,0,0,0,0,0,0,20,5,15,0,0,0,0,0,0,0,0,0
176318,21010,210,10,-2,12,6,6,0,0,0,0,0,0,11,6,5,0,0,0,0,0,0,1,0,1,0,0,0,0,0,0,0,0,0
176354,21010,210,10,-2,5,1,4,0,0,0,0,0,0,0,0,0,0,0,0,0,0,0,5,1,4,0,0,0,0,0,0,0,0,0
176406,21010,210,10,-2,2,0,2,0,0,0,0,0,0,2,0,2,0,0,0,0,0,0,0,0,0,0,0,0,0,0,0,0,0,0
176600,21010,210,10,-2,1,1,0,0,0,0,0,0,0,0,0,0,0,0,0,0,0,0,1,1,0,0,0,0,0,0,0,0,0,0
176628,21010,210,10,-2,6,2,4,0,0,0,0,0,0,0,0,0,0,0,0,0,0,0,6,2,4,0,0,0,0,0,0,0,0,0
176664,21010,210,10,-2,4,3,1,0,0,0,0,0,0,0,0,0,0,0,0,0,0,0,4,3,1,0,0,0,0,0,0,0,0,0
176789,21010,210,10,-2,1,1,0,0,0,0,1,1,0,0,0,0,0,0,0,0,0,0,0,0,0,0,0,0,0,0,0,0,0,0
176910,21010,210,10,-2,1,1,0,0,0,0,0,0,0,0,0,0,0,0,0,0,0,0,1,1,0,0,0,0,0,0,0,0,0,0
176947,21010,210,10,-2,8,3,5,0,0,0,0,0,0,0,0,0,0,0,0,0,0,0,8,3,5,0,0,0,0,0,0,0,0,0
176965,21010,210,10,-2,21,11,10,0,0,0,0,0,0,0,0,0,1,0,1,0,0,0,15,6,9,0,0,0,0,0,0,5,5,0
177065,21010,210,10,-2,5,3,2,0,0,0,0,0,0,0,0,0,0,0,0,0,0,0,5,3,2,0,0,0,0,0,0,0,0,0
177092,21010,210,10,-2,3,3,0,0,0,0,0,0,0,0,0,0,1,1,0,0,0,0,2,2,0,0,0,0,0,0,0,0,0,0
177117,21010,210,10,-2,5,2,3,0,0,0,0,0,0,0,0,0,0,0,0,0,0,0,2,1,1,0,0,0,0,0,0,3,1,2
177126,21010,210,10,-2,2,1,1,0,0,0,0,0,0,0,0,0,0,0,0,0,0,0,2,1,1,0,0,0,0,0,0,0,0,0
177135,21010,210,10,-2,13,5,8,1,1,0,0,0,0,0,0,0,1,0,1,0,0,0,8,3,5,1,0,1,2,1,1,0,0,0
177144,21010,210,10,-2,5,4,1,0,0,0,1,1,0,0,0,0,0,0,0,0,0,0,4,3,1,0,0,0,0,0,0,0,0,0
177214,21010,210,10,-2,4,4,0,0,0,0,0,0,0,0,0,0,0,0,0,0,0,0,0,0,0,0,0,0,4,4,0,0,0,0
177250,21010,210,10,-2,6,2,4,0,0,0,0,0,0,0,0,0,0,0,0,0,0,0,5,2,3,1,0,1,0,0,0,0,0,0
177302,21010,210,10,-2,4,4,0,0,0,0,1,1,0,1,1,0,0,0,0,0,0,0,2,2,0,0,0,0,0,0,0,0,0,0
177339,21010,210,10,-2,2,1,1,0,0,0,0,0,0,0,0,0,0,0,0,0,0,0,2,1,1,0,0,0,0,0,0,0,0,0
177418,21010,210,10,-2,11,6,5,1,0,1,2,1,1,0,0,0,2,1,1,0,0,0,6,4,2,0,0,0,0,0,0,0,0,0
177472,21010,210,10,-2,10,7,3,0,0,0,0,0,0,0,0,0,0,0,0,0,0,0,8,6,2,0,0,0,2,1,1,0,0,0
177542,21010,210,10,-2,5,2,3,0,0,0,0,0,0,0,0,0,0,0,0,0,0,0,5,2,3,0,0,0,0,0,0,0,0,0
177551,21010,210,10,-2,1,1,0,0,0,0,0,0,0,0,0,0,0,0,0,0,0,0,1,1,0,0,0,0,0,0,0,0,0,0
177676,21010,210,10,-2,5,1,4,0,0,0,0,0,0,0,0,0,0,0,0,0,0,0,5,1,4,0,0,0,0,0,0,0,0,0
177719,21010,210,10,-2,5,0,5,0,0,0,0,0,0,2,0,2,0,0,0,0,0,0,3,0,3,0,0,0,0,0,0,0,0,0
177746,21010,210,10,-2,4,2,2,0,0,0,0,0,0,1,1,0,1,1,0,0,0,0,2,0,2,0,0,0,0,0,0,0,0,0
177940,21010,210,10,-2,3,1,2,0,0,0,0,0,0,0,0,0,0,0,0,0,0,0,3,1,2,0,0,0,0,0,0,0,0,0
177968,21010,210,10,-2,8,1,7,0,0,0,0,0,0,1,0,1,0,0,0,0,0,0,6,0,6,0,0,0,0,0,0,1,1,0
177977,21010,210,10,-2,18,14,4,0,0,0,0,0,0,0,0,0,0,0,0,0,0,0,17,13,4,1,1,0,0,0,0,0,0,0
177986,21010,210,10,-2,6,2,4,0,0,0,0,0,0,0,0,0,0,0,0,0,0,0,5,1,4,1,1,0,0,0,0,0,0,0
177995,21010,210,10,-2,9,4,5,0,0,0,0,0,0,1,1,0,0,0,0,0,0,0,8,3,5,0,0,0,0,0,0,0,0,0
178059,21010,210,10,-2,8,1,7,0,0,0,0,0,0,1,0,1,0,0,0,0,0,0,7,1,6,0,0,0,0,0,0,0,0,0
178183,21010,210,10,-2,2,0,2,0,0,0,0,0,0,0,0,0,0,0,0,0,0,0,2,0,2,0,0,0,0,0,0,0,0,0
178208,21010,210,10,-2,2,2,0,0,0,0,0,0,0,0,0,0,1,1,0,0,0,0,1,1,0,0,0,0,0,0,0,0,0,0
178217,21010,210,10,-2,1,0,1,0,0,0,0,0,0,0,0,0,0,0,0,0,0,0,1,0,1,0,0,0,0,0,0,0,0,0
178244,21010,210,10,-2,6,1,5,0,0,0,0,0,0,1,0,1,0,0,0,0,0,0,5,1,4,0,0,0,0,0,0,0,0,0
178341,21010,210,10,-2,10,4,6,0,0,0,0,0,0,1,0,1,0,0,0,0,0,0,8,3,5,0,0,0,0,0,0,1,1,0
178369,21010,210,10,-2,9,5,4,0,0,0,2,2,0,0,0,0,0,0,0,0,0,0,7,3,4,0,0,0,0,0,0,0,0,0
178387,21010,210,10,-2,11,5,6,0,0,0,0,0,0,0,0,0,2,2,0,0,0,0,3,0,3,0,0,0,6,3,3,0,0,0
178396,21010,210,10,-2,152,78,74,1,0,1,17,13,4,8,4,4,4,2,2,0,0,0,88,43,45,1,1,0,16,5,11,17,10,7
178402,21010,210,10,-2,39,22,17,0,0,0,2,1,1,6,4,2,2,1,1,0,0,0,23,13,10,0,0,0,1,0,1,5,3,2
178411,21010,210,10,-2,9,7,2,0,0,0,0,0,0,0,0,0,0,0,0,0,0,0,3,2,1,0,0,0,1,0,1,5,5,0
178420,21010,210,10,-2,5,1,4,0,0,0,1,0,1,1,0,1,0,0,0,0,0,0,2,1,1,0,0,0,1,0,1,0,0,0
178448,21010,210,10,-2,9,3,6,0,0,0,0,0,0,1,1,0,0,0,0,0,0,0,8,2,6,0,0,0,0,0,0,0,0,0
178615,21010,210,10,-2,17,11,6,0,0,0,2,2,0,1,1,0,0,0,0,0,0,0,11,7,4,0,0,0,0,0,0,3,1,2
178624,21010,210,10,-2,18,8,10,0,0,0,1,1,0,0,0,0,0,0,0,0,0,0,12,4,8,0,0,0,0,0,0,5,3,2
178679,21010,210,10,-2,1,1,0,0,0,0,0,0,0,0,0,0,0,0,0,0,0,0,1,1,0,0,0,0,0,0,0,0,0,0
178697,21010,210,10,-2,8,7,1,0,0,0,0,0,0,0,0,0,0,0,0,0,0,0,8,7,1,0,0,0,0,0,0,0,0,0
178721,21010,210,10,-2,8,1,7,1,0,1,0,0,0,0,0,0,0,0,0,0,0,0,6,1,5,1,0,1,0,0,0,0,0,0
178891,21010,210,10,-2,7,6,1,0,0,0,0,0,0,1,0,1,0,0,0,0,0,0,6,6,0,0,0,0,0,0,0,0,0,0
178989,21010,210,10,-2,4,2,2,0,0,0,0,0,0,0,0,0,0,0,0,0,0,0,4,2,2,0,0,0,0,0,0,0,0,0
179043,21010,210,10,-2,14,2,12,0,0,0,0,0,0,0,0,0,0,0,0,0,0,0,11,2,9,0,0,0,2,0,2,1,0,1
179159,21010,210,10,-2,40,20,20,0,0,0,2,0,2,7,4,3,4,3,1,0,0,0,17,8,9,1,0,1,0,0,0,9,5,4
179308,21010,210,10,-2,27,8,19,0,0,0,0,0,0,2,0,2,0,0,0,0,0,0,20,5,15,0,0,0,3,1,2,2,2,0
179317,21010,210,10,-2,1,1,0,0,0,0,0,0,0,1,1,0,0,0,0,0,0,0,0,0,0,0,0,0,0,0,0,0,0,0
179326,21010,210,10,-2,12,6,6,0,0,0,1,1,0,0,0,0,0,0,0,0,0,0,11,5,6,0,0,0,0,0,0,0,0,0
179344,21010,210,10,-2,4,2,2,0,0,0,0,0,0,0,0,0,0,0,0,0,0,0,2,0,2,0,0,0,2,2,0,0,0,0
179539,21010,210,10,-2,9,2,7,0,0,0,0,0,0,0,0,0,1,0,1,0,0,0,8,2,6,0,0,0,0,0,0,0,0,0
179548,21010,210,10,-2,8,3,5,0,0,0,0,0,0,0,0,0,0,0,0,0,0,0,8,3,5,0,0,0,0,0,0,0,0,0
179557,21010,210,10,-2,23,15,8,0,0,0,1,1,0,0,0,0,1,1,0,0,0,0,17,9,8,0,0,0,4,4,0,0,0,0
179566,21010,210,10,-2,41,13,28,1,0,1,2,0,2,3,1,2,5,3,2,0,0,0,24,8,16,0,0,0,0,0,0,6,1,5
179645,21010,210,10,-2,2,1,1,0,0,0,0,0,0,0,0,0,0,0,0,0,0,0,2,1,1,0,0,0,0,0,0,0,0,0
179715,21010,210,10,-2,5,2,3,0,0,0,0,0,0,0,0,0,0,0,0,0,0,0,5,2,3,0,0,0,0,0,0,0,0,0
179812,21010,210,10,-2,8,4,4,0,0,0,0,0,0,0,0,0,1,0,1,0,0,0,6,4,2,1,0,1,0,0,0,0,0,0
179867,21010,210,10,-2,89,48,41,1,1,0,18,11,7,11,6,5,4,3,1,0,0,0,41,20,21,4,2,2,2,0,2,8,5,3
179894,21010,210,10,-2,6,3,3,0,0,0,0,0,0,0,0,0,0,0,0,0,0,0,3,1,2,1,0,1,2,2,0,0,0,0
179946,21010,210,10,-2,1,0,1,0,0,0,0,0,0,0,0,0,0,0,0,0,0,0,1,0,1,0,0,0,0,0,0,0,0,0
179955,21010,210,10,-2,3,2,1,0,0,0,0,0,0,0,0,0,0,0,0,0,0,0,3,2,1,0,0,0,0,0,0,0,0,0
179964,21010,210,10,-2,3,3,0,0,0,0,0,0,0,0,0,0,0,0,0,0,0,0,3,3,0,0,0,0,0,0,0,0,0,0
180054,21010,210,10,-2,1,1,0,1,1,0,0,0,0,0,0,0,0,0,0,0,0,0,0,0,0,0,0,0,0,0,0,0,0,0
180106,21010,210,10,-2,19,5,14,0,0,0,0,0,0,0,0,0,0,0,0,0,0,0,11,3,8,0,0,0,8,2,6,0,0,0
180151,21010,210,10,-2,2,1,1,0,0,0,0,0,0,0,0,0,0,0,0,0,0,0,2,1,1,0,0,0,0,0,0,0,0,0
180179,21010,210,10,-2,21,10,11,0,0,0,0,0,0,0,0,0,0,0,0,0,0,0,20,10,10,0,0,0,1,0,1,0,0,0
180197,21010,210,10,-2,4,2,2,0,0,0,0,0,0,0,0,0,0,0,0,0,0,0,4,2,2,0,0,0,0,0,0,0,0,0
180203,21010,210,10,-2,2,2,0,1,1,0,0,0,0,0,0,0,0,0,0,0,0,0,1,1,0,0,0,0,0,0,0,0,0,0
180212,21010,210,10,-2,2,1,1,0,0,0,0,0,0,0,0,0,0,0,0,0,0,0,2,1,1,0,0,0,0,0,0,0,0,0
180249,21010,210,10,-2,2,0,2,0,0,0,0,0,0,0,0,0,0,0,0,0,0,0,2,0,2,0,0,0,0,0,0,0,0,0
180258,21010,210,10,-2,2,1,1,0,0,0,0,0,0,0,0,0,1,1,0,0,0,0,0,0,0,1,0,1,0,0,0,0,0,0
180276,21010,210,10,-2,2,0,2,0,0,0,0,0,0,0,0,0,0,0,0,0,0,0,2,0,2,0,0,0,0,0,0,0,0,0
180328,21010,210,10,-2,1,1,0,1,1,0,0,0,0,0,0,0,0,0,0,0,0,0,0,0,0,0,0,0,0,0,0,0,0,0
180373,21010,210,10,-2,5,3,2,0,0,0,0,0,0,0,0,0,0,0,0,0,0,0,3,2,1,0,0,0,2,1,1,0,0,0
180416,21010,210,10,-2,6,4,2,0,0,0,0,0,0,0,0,0,0,0,0,0,0,0,6,4,2,0,0,0,0,0,0,0,0,0
180461,21010,210,10,-2,17,6,11,0,0,0,0,0,0,0,0,0,0,0,0,0,0,0,14,5,9,0,0,0,1,0,1,2,1,1
180489,21010,210,10,-2,21,8,13,1,1,0,0,0,0,0,0,0,1,0,1,0,0,0,17,6,11,1,0,1,1,1,0,0,0,0
180522,21010,210,10,-2,5,3,2,0,0,0,0,0,0,0,0,0,0,0,0,0,0,0,5,3,2,0,0,0,0,0,0,0,0,0
180595,21010,210,10,-2,5,1,4,0,0,0,0,0,0,0,0,0,0,0,0,0,0,0,3,0,3,0,0,0,2,1,1,0,0,0
180647,21010,210,10,-2,8,5,3,3,2,1,0,0,0,0,0,0,1,0,1,0,0,0,4,3,1,0,0,0,0,0,0,0,0,0
180692,21010,210,10,-2,5,3,2,0,0,0,1,0,1,0,0,0,0,0,0,0,0,0,1,0,1,1,1,0,2,2,0,0,0,0
180814,21010,210,10,-2,3,3,0,0,0,0,0,0,0,0,0,0,0,0,0,0,0,0,2,2,0,0,0,0,1,1,0,0,0,0
180832,21010,210,10,-2,4,0,4,0,0,0,0,0,0,0,0,0,0,0,0,0,0,0,4,0,4,0,0,0,0,0,0,0,0,0
180878,21010,210,10,-2,1,0,1,0,0,0,0,0,0,0,0,0,0,0,0,0,0,0,1,0,1,0,0,0,0,0,0,0,0,0
180902,21010,210,10,-2,9,6,3,0,0,0,2,1,1,0,0,0,0,0,0,0,0,0,7,5,2,0,0,0,0,0,0,0,0,0
180948,21010,210,10,-2,6,4,2,0,0,0,0,0,0,1,0,1,0,0,0,0,0,0,5,4,1,0,0,0,0,0,0,0,0,0
180984,21010,210,10,-2,4,2,2,0,0,0,1,1,0,0,0,0,0,0,0,0,0,0,3,1,2,0,0,0,0,0,0,0,0,0
181002,21010,210,10,-2,46,19,27,0,0,0,6,1,5,0,0,0,2,1,1,0,0,0,25,11,14,1,0,1,11,5,6,1,1,0
181020,21010,210,10,-2,11,7,4,0,0,0,3,2,1,0,0,0,1,1,0,0,0,0,6,3,3,0,0,0,1,1,0,0,0,0
181127,21010,210,10,-2,7,1,6,0,0,0,0,0,0,0,0,0,0,0,0,0,0,0,7,1,6,0,0,0,0,0,0,0,0,0
181215,21010,210,10,-2,30,15,15,0,0,0,4,3,1,0,0,0,0,0,0,0,0,0,21,8,13,0,0,0,0,0,0,5,4,1
181303,21010,210,10,-2,12,7,5,0,0,0,0,0,0,0,0,0,1,1,0,0,0,0,11,6,5,0,0,0,0,0,0,0,0,0
181312,21010,210,10,-2,14,12,2,0,0,0,0,0,0,0,0,0,0,0,0,0,0,0,14,12,2,0,0,0,0,0,0,0,0,0
181330,21010,210,10,-2,2,1,1,0,0,0,0,0,0,0,0,0,0,0,0,0,0,0,2,1,1,0,0,0,0,0,0,0,0,0
181394,21010,210,10,-2,44,21,23,0,0,0,1,0,1,2,0,2,3,3,0,0,0,0,22,11,11,0,0,0,4,2,2,12,5,7
181419,21010,210,10,-2,3,3,0,2,2,0,1,1,0,0,0,0,0,0,0,0,0,0,0,0,0,0,0,0,0,0,0,0,0,0
181428,21010,210,10,-2,68,29,39,0,0,0,6,2,4,3,1,2,1,1,0,0,0,0,47,18,29,1,1,0,0,0,0,10,6,4
181446,21010,210,10,-2,15,4,11,0,0,0,1,0,1,1,0,1,0,0,0,0,0,0,11,4,7,1,0,1,0,0,0,1,0,1
181464,21010,210,10,-2,36,17,19,0,0,0,1,1,0,0,0,0,1,0,1,0,0,0,21,9,12,1,0,1,0,0,0,12,7,5
181491,21010,210,10,-2,13,10,3,0,0,0,0,0,0,0,0,0,0,0,0,0,0,0,13,10,3,0,0,0,0,0,0,0,0,0
181534,21010,210,10,-2,3,3,0,0,0,0,0,0,0,0,0,0,0,0,0,0,0,0,3,3,0,0,0,0,0,0,0,0,0,0
181604,21010,210,10,-2,6,1,5,0,0,0,0,0,0,0,0,0,0,0,0,0,0,0,6,1,5,0,0,0,0,0,0,0,0,0
181640,21010,210,10,-2,20,12,8,0,0,0,1,1,0,1,1,0,0,0,0,0,0,0,18,10,8,0,0,0,0,0,0,0,0,0
181738,21010,210,10,-2,10,2,8,0,0,0,0,0,0,0,0,0,2,0,2,0,0,0,8,2,6,0,0,0,0,0,0,0,0,0
181765,21010,210,10,-2,1,1,0,0,0,0,0,0,0,0,0,0,0,0,0,0,0,0,1,1,0,0,0,0,0,0,0,0,0,0
181783,21010,210,10,-2,8,4,4,0,0,0,0,0,0,0,0,0,1,0,1,0,0,0,7,4,3,0,0,0,0,0,0,0,0,0
181817,21010,210,10,-2,9,4,5,0,0,0,0,0,0,0,0,0,0,0,0,0,0,0,9,4,5,0,0,0,0,0,0,0,0,0
181853,21010,210,10,-2,3,2,1,0,0,0,0,0,0,0,0,0,0,0,0,0,0,0,3,2,1,0,0,0,0,0,0,0,0,0
181941,21010,210,10,-2,10,7,3,1,1,0,0,0,0,0,0,0,2,1,1,0,0,0,7,5,2,0,0,0,0,0,0,0,0,0
182005,21010,210,10,-2,10,5,5,0,0,0,2,2,0,2,0,2,0,0,0,0,0,0,5,3,2,0,0,0,1,0,1,0,0,0
182148,21010,210,10,-2,14,0,14,0,0,0,0,0,0,1,0,1,4,0,4,0,0,0,9,0,9,0,0,0,0,0,0,0,0,0
182281,21010,210,10,-2,38,20,18,0,0,0,12,7,5,2,1,1,3,1,2,0,0,0,11,5,6,2,1,1,0,0,0,8,5,3
182290,21010,210,10,-2,27,9,18,0,0,0,1,0,1,0,0,0,5,2,3,0,0,0,20,6,14,0,0,0,0,0,0,1,1,0
182306,21010,210,10,-2,5,3,2,0,0,0,0,0,0,0,0,0,0,0,0,0,0,0,4,2,2,0,0,0,0,0,0,1,1,0
182458,21010,210,10,-2,1,0,1,0,0,0,0,0,0,1,0,1,0,0,0,0,0,0,0,0,0,0,0,0,0,0,0,0,0,0
182500,21010,210,10,-2,6,3,3,0,0,0,0,0,0,1,1,0,1,0,1,0,0,0,4,2,2,0,0,0,0,0,0,0,0,0
182564,21010,210,10,-2,1,0,1,0,0,0,0,0,0,0,0,0,0,0,0,0,0,0,1,0,1,0,0,0,0,0,0,0,0,0
182634,21010,210,10,-2,9,3,6,0,0,0,0,0,0,0,0,0,1,0,1,0,0,0,8,3,5,0,0,0,0,0,0,0,0,0
182670,21010,210,10,-2,29,10,19,0,0,0,2,2,0,0,0,0,0,0,0,0,0,0,23,6,17,0,0,0,0,0,0,4,2,2
182795,21010,210,10,-2,6,2,4,0,0,0,0,0,0,0,0,0,0,0,0,0,0,0,6,2,4,0,0,0,0,0,0,0,0,0
182829,21010,210,10,-2,3,1,2,0,0,0,1,0,1,0,0,0,0,0,0,0,0,0,1,0,1,0,0,0,1,1,0,0,0,0
182980,21010,210,10,-2,5,0,5,0,0,0,0,0,0,1,0,1,0,0,0,0,0,0,4,0,4,0,0,0,0,0,0,0,0,0
183026,21010,210,10,-2,2,1,1,0,0,0,0,0,0,0,0,0,0,0,0,0,0,0,2,1,1,0,0,0,0,0,0,0,0,0
183044,21010,210,10,-2,43,18,25,0,0,0,3,2,1,2,0,2,2,0,2,0,0,0,21,10,11,1,0,1,5,1,4,9,5,4
183062,21010,210,10,-2,9,4,5,0,0,0,0,0,0,0,0,0,0,0,0,0,0,0,4,1,3,0,0,0,3,1,2,2,2,0
183071,21010,210,10,-2,1,1,0,0,0,0,0,0,0,0,0,0,0,0,0,0,0,0,1,1,0,0,0,0,0,0,0,0,0,0
183080,21010,210,10,-2,15,5,10,0,0,0,0,0,0,0,0,0,0,0,0,0,0,0,12,5,7,0,0,0,1,0,1,2,0,2
183105,21010,210,10,-2,1,1,0,0,0,0,0,0,0,0,0,0,0,0,0,0,0,0,1,1,0,0,0,0,0,0,0,0,0,0
183114,21010,210,10,-2,1,0,1,0,0,0,0,0,0,0,0,0,0,0,0,0,0,0,1,0,1,0,0,0,0,0,0,0,0,0
183123,21010,210,10,-2,5,3,2,0,0,0,0,0,0,0,0,0,0,0,0,0,0,0,4,2,2,0,0,0,1,1,0,0,0,0
183132,21010,210,10,-2,1,0,1,0,0,0,0,0,0,0,0,0,0,0,0,0,0,0,0,0,0,1,0,1,0,0,0,0,0,0
183141,21010,210,10,-2,2,1,1,0,0,0,0,0,0,0,0,0,0,0,0,0,0,0,2,1,1,0,0,0,0,0,0,0,0,0
183150,21010,210,10,-2,1,1,0,0,0,0,0,0,0,0,0,0,0,0,0,0,0,0,1,1,0,0,0,0,0,0,0,0,0,0
183211,21010,210,10,-2,4,0,4,0,0,0,1,0,1,0,0,0,0,0,0,0,0,0,3,0,3,0,0,0,0,0,0,0,0,0
183239,21010,210,10,-2,12,3,9,0,0,0,0,0,0,1,1,0,1,0,1,0,0,0,9,1,8,0,0,0,1,1,0,0,0,0
183248,21010,210,10,-2,2,0,2,0,0,0,0,0,0,0,0,0,0,0,0,0,0,0,2,0,2,0,0,0,0,0,0,0,0,0
183257,21010,210,10,-2,3,1,2,0,0,0,0,0,0,0,0,0,0,0,0,0,0,0,3,1,2,0,0,0,0,0,0,0,0,0
183655,21010,210,10,-2,7,2,5,0,0,0,0,0,0,0,0,0,1,1,0,0,0,0,6,1,5,0,0,0,0,0,0,0,0,0
183822,21010,210,10,-2,4,1,3,0,0,0,0,0,0,3,0,3,0,0,0,0,0,0,1,1,0,0,0,0,0,0,0,0,0,0
183859,21010,210,10,-2,12,8,4,0,0,0,0,0,0,0,0,0,0,0,0,0,0,0,10,6,4,1,1,0,1,1,0,0,0,0
183910,21010,210,10,-2,3,1,2,0,0,0,0,0,0,0,0,0,0,0,0,0,0,0,3,1,2,0,0,0,0,0,0,0,0,0
183938,21010,210,10,-2,2,0,2,0,0,0,0,0,0,0,0,0,0,0,0,0,0,0,2,0,2,0,0,0,0,0,0,0,0,0
183974,21010,210,10,-2,3,1,2,0,0,0,0,0,0,0,0,0,0,0,0,0,0,0,3,1,2,0,0,0,0,0,0,0,0,0
184180,21010,210,10,-2,2,0,2,0,0,0,0,0,0,0,0,0,0,0,0,0,0,0,2,0,2,0,0,0,0,0,0,0,0,0
184205,21010,210,10,-2,5,1,4,0,0,0,0,0,0,0,0,0,0,0,0,0,0,0,5,1,4,0,0,0,0,0,0,0,0,0
184348,21010,210,10,-2,4,2,2,0,0,0,2,2,0,1,0,1,0,0,0,0,0,0,0,0,0,0,0,0,0,0,0,1,0,1
184481,21010,210,10,-2,5,2,3,0,0,0,0,0,0,3,0,3,0,0,0,0,0,0,1,1,0,0,0,0,1,1,0,0,0,0
184603,21010,210,10,-2,9,5,4,0,0,0,1,1,0,1,1,0,0,0,0,0,0,0,6,3,3,0,0,0,1,0,1,0,0,0
184612,21010,210,10,-2,16,4,12,0,0,0,0,0,0,1,0,1,4,1,3,0,0,0,10,2,8,1,1,0,0,0,0,0,0,0
184694,21010,210,10,-2,11,2,9,0,0,0,4,1,3,0,0,0,0,0,0,0,0,0,3,0,3,1,1,0,3,0,3,0,0,0
184773,21010,210,10,-2,6,0,6,0,0,0,0,0,0,0,0,0,1,0,1,0,0,0,5,0,5,0,0,0,0,0,0,0,0,0
184782,21010,210,10,-2,61,27,34,0,0,0,6,3,3,8,2,6,3,0,3,0,0,0,36,15,21,3,3,0,2,2,0,3,2,1
184791,21010,210,10,-2,4,1,3,0,0,0,0,0,0,0,0,0,0,0,0,0,0,0,3,0,3,0,0,0,1,1,0,0,0,0
184959,21010,210,10,-2,3,0,3,0,0,0,0,0,0,0,0,0,0,0,0,0,0,0,3,0,3,0,0,0,0,0,0,0,0,0
184995,21010,210,10,-2,1,0,1,0,0,0,0,0,0,0,0,0,1,0,1,0,0,0,0,0,0,0,0,0,0,0,0,0,0,0
185129,21010,210,10,-2,8,5,3,0,0,0,2,2,0,2,0,2,1,0,1,0,0,0,3,3,0,0,0,0,0,0,0,0,0,0
185262,21010,210,10,-2,40,16,24,0,0,0,9,4,5,6,0,6,6,3,3,0,0,0,13,5,8,1,0,1,2,1,1,3,3,0
185509,21010,210,10,-2,2,2,0,0,0,0,1,1,0,0,0,0,0,0,0,0,0,0,1,1,0,0,0,0,0,0,0,0,0,0
185572,21010,210,10,-2,10,2,8,0,0,0,0,0,0,0,0,0,1,1,0,0,0,0,8,1,7,1,0,1,0,0,0,0,0,0
185590,21010,210,10,-2,17,7,10,0,0,0,2,2,0,4,1,3,2,0,2,0,0,0,3,2,1,0,0,0,2,0,2,4,2,2
185721,21010,210,10,-2,1,0,1,0,0,0,0,0,0,0,0,0,0,0,0,0,0,0,1,0,1,0,0,0,0,0,0,0,0,0
185828,21010,210,10,-2,31,20,11,0,0,0,7,5,2,0,0,0,1,0,1,0,0,0,11,7,4,0,0,0,0,0,0,12,8,4
186034,21010,210,10,-2,2,0,2,0,0,0,0,0,0,0,0,0,0,0,0,0,0,0,2,0,2,0,0,0,0,0,0,0,0,0
186122,21010,210,10,-2,1,1,0,0,0,0,0,0,0,0,0,0,0,0,0,0,0,0,1,1,0,0,0,0,0,0,0,0,0,0
186131,21010,210,10,-2,42,25,17,0,0,0,4,4,0,1,1,0,2,1,1,0,0,0,7,2,5,0,0,0,14,8,6,14,9,5
186201,21010,210,10,-2,4,1,3,0,0,0,1,0,1,1,0,1,0,0,0,0,0,0,2,1,1,0,0,0,0,0,0,0,0,0
186283,21010,210,10,-2,7,4,3,0,0,0,1,0,1,2,2,0,3,2,1,0,0,0,1,0,1,0,0,0,0,0,0,0,0,0
186371,21010,210,10,-2,8,5,3,0,0,0,0,0,0,0,0,0,0,0,0,0,0,0,1,1,0,0,0,0,5,3,2,2,1,1
186380,21010,210,10,-2,193,84,109,0,0,0,11,9,2,5,2,3,5,1,4,0,0,0,25,9,16,0,0,0,126,49,77,21,14,7
186399,21010,210,10,-2,27,14,13,0,0,0,2,1,1,1,0,1,1,1,0,0,0,0,0,0,0,0,0,0,16,9,7,7,3,4
186432,21010,210,10,-2,3,2,1,0,0,0,2,2,0,0,0,0,0,0,0,0,0,0,1,0,1,0,0,0,0,0,0,0,0,0
186584,21010,210,10,-2,17,7,10,0,0,0,0,0,0,0,0,0,3,1,2,0,0,0,12,6,6,1,0,1,1,0,1,0,0,0
186618,21010,210,10,-2,11,2,9,0,0,0,1,0,1,0,0,0,0,0,0,0,0,0,8,1,7,0,0,0,2,1,1,0,0,0
186645,21010,210,10,-2,6,1,5,0,0,0,1,0,1,1,0,1,1,0,1,0,0,0,3,1,2,0,0,0,0,0,0,0,0,0
186867,21010,210,10,-2,30,19,11,0,0,0,3,2,1,0,0,0,0,0,0,0,0,0,11,6,5,0,0,0,1,1,0,15,10,5
186876,21010,210,10,-2,12,3,9,0,0,0,0,0,0,1,1,0,0,0,0,0,0,0,9,1,8,0,0,0,1,0,1,1,1,0
187134,21010,210,10,-2,17,10,7,0,0,0,1,1,0,3,1,2,1,1,0,0,0,0,11,7,4,0,0,0,1,0,1,0,0,0
187444,21010,210,10,-2,8,2,6,0,0,0,1,0,1,3,1,2,2,1,1,0,0,0,2,0,2,0,0,0,0,0,0,0,0,0
187532,21010,210,10,-2,6,2,4,0,0,0,0,0,0,0,0,0,1,0,1,0,0,0,5,2,3,0,0,0,0,0,0,0,0,0
187596,21010,210,10,-2,17,12,5,5,3,2,0,0,0,2,1,1,0,0,0,0,0,0,6,5,1,0,0,0,1,1,0,3,2,1
187639,21010,210,10,-2,8,2,6,0,0,0,0,0,0,1,0,1,2,1,1,0,0,0,5,1,4,0,0,0,0,0,0,0,0,0
187648,21010,210,10,-2,9,4,5,0,0,0,0,0,0,0,0,0,0,0,0,0,0,0,6,3,3,0,0,0,0,0,0,3,1,2
187666,21010,210,10,-2,4,0,4,0,0,0,0,0,0,0,0,0,3,0,3,0,0,0,1,0,1,0,0,0,0,0,0,0,0,0
187897,21010,210,10,-2,14,7,7,0,0,0,0,0,0,1,1,0,2,0,2,0,0,0,9,5,4,0,0,0,0,0,0,2,1,1
187903,21010,210,10,-2,15,7,8,0,0,0,0,0,0,2,0,2,1,1,0,0,0,0,12,6,6,0,0,0,0,0,0,0,0,0
187912,21010,210,10,-2,8,6,2,0,0,0,1,0,1,0,0,0,0,0,0,0,0,0,5,4,1,0,0,0,0,0,0,2,2,0
187958,21010,210,10,-2,2,1,1,1,0,1,0,0,0,0,0,0,0,0,0,0,0,0,0,0,0,0,0,0,0,0,0,1,1,0
187967,21010,210,10,-2,7,2,5,0,0,0,1,0,1,0,0,0,2,1,1,0,0,0,4,1,3,0,0,0,0,0,0,0,0,0
187985,21010,210,10,-2,103,33,70,3,1,2,10,4,6,4,1,3,14,5,9,0,0,0,55,14,41,2,1,1,4,3,1,11,4,7
187994,21010,210,10,-2,3,3,0,0,0,0,0,0,0,1,1,0,1,1,0,0,0,0,1,1,0,0,0,0,0,0,0,0,0,0
188030,21010,210,10,-2,19,5,14,0,0,0,1,0,1,1,0,1,1,0,1,0,0,0,14,5,9,0,0,0,0,0,0,2,0,2
188058,21010,210,10,-2,1,1,0,0,0,0,0,0,0,0,0,0,0,0,0,0,0,0,0,0,0,0,0,0,1,1,0,0,0,0
188100,21010,210,10,-2,9,6,3,0,0,0,1,1,0,1,1,0,1,1,0,0,0,0,2,1,1,0,0,0,4,2,2,0,0,0
188137,21010,210,10,-2,5,4,1,0,0,0,0,0,0,0,0,0,3,2,1,0,0,0,1,1,0,1,1,0,0,0,0,0,0,0
188182,21010,210,10,-2,4,1,3,0,0,0,0,0,0,0,0,0,0,0,0,0,0,0,0,0,0,0,0,0,4,1,3,0,0,0
188225,21010,210,10,-2,1,1,0,0,0,0,0,0,0,0,0,0,0,0,0,0,0,0,1,1,0,0,0,0,0,0,0,0,0,0
188261,21010,210,10,-2,2,1,1,0,0,0,0,0,0,0,0,0,0,0,0,0,0,0,2,1,1,0,0,0,0,0,0,0,0,0
188304,21010,210,10,-2,10,3,7,0,0,0,0,0,0,0,0,0,1,0,1,0,0,0,5,1,4,0,0,0,3,2,1,1,0,1
188340,21010,210,10,-2,1,1,0,0,0,0,0,0,0,1,1,0,0,0,0,0,0,0,0,0,0,0,0,0,0,0,0,0,0,0
188429,21010,210,10,-2,20,6,14,0,0,0,4,1,3,3,0,3,3,1,2,0,0,0,10,4,6,0,0,0,0,0,0,0,0,0
188438,21010,210,10,-2,11,5,6,0,0,0,1,1,0,0,0,0,0,0,0,0,0,0,10,4,6,0,0,0,0,0,0,0,0,0
188517,21010,210,10,-2,2,0,2,0,0,0,0,0,0,0,0,0,0,0,0,0,0,0,1,0,1,0,0,0,1,0,1,0,0,0
188526,21010,210,10,-2,2,1,1,0,0,0,1,1,0,0,0,0,0,0,0,0,0,0,1,0,1,0,0,0,0,0,0,0,0,0
188535,21010,210,10,-2,3,1,2,0,0,0,0,0,0,1,0,1,1,1,0,0,0,0,1,0,1,0,0,0,0,0,0,0,0,0
188580,21010,210,10,-2,27,12,15,0,0,0,4,4,0,1,1,0,2,0,2,0,0,0,16,6,10,0,0,0,4,1,3,0,0,0
188641,21010,210,10,-2,14,3,11,0,0,0,2,1,1,0,0,0,2,0,2,0,0,0,8,1,7,1,0,1,0,0,0,1,1,0
188854,21010,210,10,-2,3,2,1,0,0,0,0,0,0,0,0,0,0,0,0,0,0,0,2,1,1,1,1,0,0,0,0,0,0,0
189015,21010,210,10,-2,1,0,1,0,0,0,0,0,0,0,0,0,0,0,0,0,0,0,1,0,1,0,0,0,0,0,0,0,0,0
189088,21010,210,10,-2,4,1,3,0,0,0,1,0,1,1,1,0,0,0,0,0,0,0,0,0,0,0,0,0,1,0,1,1,0,1
189097,21010,210,10,-2,24,8,16,0,0,0,3,1,2,2,1,1,0,0,0,0,0,0,17,6,11,0,0,0,2,0,2,0,0,0
189413,21010,210,10,-2,2,1,1,0,0,0,0,0,0,1,1,0,1,0,1,0,0,0,0,0,0,0,0,0,0,0,0,0,0,0
189547,21010,210,10,-2,3,2,1,1,1,0,0,0,0,0,0,0,0,0,0,0,0,0,2,1,1,0,0,0,0,0,0,0,0,0
189565,21010,210,10,-2,2,0,2,0,0,0,0,0,0,0,0,0,0,0,0,0,0,0,1,0,1,0,0,0,1,0,1,0,0,0
189705,21010,210,10,-2,3,0,3,0,0,0,0,0,0,0,0,0,0,0,0,0,0,0,3,0,3,0,0,0,0,0,0,0,0,0
189811,21010,210,10,-2,1,0,1,0,0,0,1,0,1,0,0,0,0,0,0,0,0,0,0,0,0,0,0,0,0,0,0,0,0,0
189839,21010,210,10,-2,1,0,1,0,0,0,0,0,0,0,0,0,0,0,0,0,0,0,1,0,1,0,0,0,0,0,0,0,0,0
189848,21010,210,10,-2,2,0,2,0,0,0,0,0,0,0,0,0,0,0,0,0,0,0,2,0,2,0,0,0,0,0,0,0,0,0
189857,21010,210,10,-2,5,5,0,0,0,0,0,0,0,0,0,0,0,0,0,0,0,0,5,5,0,0,0,0,0,0,0,0,0,0
190044,21010,210,10,-2,17,7,10,0,0,0,0,0,0,2,1,1,0,0,0,0,0,0,8,2,6,0,0,0,0,0,0,7,4,3
190071,21010,210,10,-2,2,0,2,0,0,0,0,0,0,0,0,0,0,0,0,0,0,0,2,0,2,0,0,0,0,0,0,0,0,0
190080,21010,210,10,-2,1,0,1,0,0,0,0,0,0,1,0,1,0,0,0,0,0,0,0,0,0,0,0,0,0,0,0,0,0,0
190099,21010,210,10,-2,32,15,17,0,0,0,1,0,1,2,0,2,1,1,0,1,1,0,15,6,9,2,1,1,1,0,1,9,6,3
190150,21010,210,10,-2,339,179,160,1,1,0,74,36,38,34,16,18,21,12,9,0,0,0,130,67,63,7,3,4,23,13,10,49,31,18
190169,21010,210,10,-2,4,1,3,0,0,0,0,0,0,0,0,0,0,0,0,0,0,0,4,1,3,0,0,0,0,0,0,0,0,0
190372,21010,210,10,-2,4,1,3,0,0,0,0,0,0,1,1,0,0,0,0,0,0,0,3,0,3,0,0,0,0,0,0,0,0,0
190415,21010,210,10,-2,121,55,66,1,0,1,13,8,5,8,5,3,12,5,7,0,0,0,53,26,27,6,1,5,0,0,0,28,10,18
190424,21010,210,10,-2,172,62,110,0,0,0,60,35,25,16,4,12,7,2,5,0,0,0,63,6,57,0,0,0,1,0,1,25,15,10
190442,21010,210,10,-2,4,3,1,0,0,0,0,0,0,1,1,0,0,0,0,0,0,0,3,2,1,0,0,0,0,0,0,0,0,0
190451,21010,210,10,-2,1,0,1,0,0,0,0,0,0,0,0,0,0,0,0,0,0,0,1,0,1,0,0,0,0,0,0,0,0,0
190503,21010,210,10,-2,5,2,3,0,0,0,1,0,1,0,0,0,1,0,1,0,0,0,3,2,1,0,0,0,0,0,0,0,0,0
190512,21010,210,10,-2,18,9,9,0,0,0,4,0,4,0,0,0,3,1,2,0,0,0,6,4,2,0,0,0,0,0,0,5,4,1
190521,21010,210,10,-2,20,8,12,0,0,0,3,2,1,6,1,5,2,2,0,0,0,0,8,3,5,0,0,0,0,0,0,1,0,1
190530,21010,210,10,-2,3,3,0,0,0,0,0,0,0,1,1,0,1,1,0,0,0,0,1,1,0,0,0,0,0,0,0,0,0,0
190549,21010,210,10,-2,21,8,13,0,0,0,0,0,0,5,3,2,1,0,1,0,0,0,11,3,8,0,0,0,0,0,0,4,2,2
190558,21010,210,10,-2,4,1,3,0,0,0,0,0,0,0,0,0,1,0,1,0,0,0,2,0,2,0,0,0,0,0,0,1,1,0
190567,21010,210,10,-2,17,11,6,0,0,0,1,1,0,1,1,0,2,2,0,0,0,0,10,4,6,2,2,0,0,0,0,1,1,0
190576,21010,210,10,-2,21,4,17,0,0,0,1,0,1,6,0,6,4,2,2,0,0,0,9,2,7,1,0,1,0,0,0,0,0,0
190585,21010,210,10,-2,1,1,0,0,0,0,0,0,0,0,0,0,0,0,0,0,0,0,1,1,0,0,0,0,0,0,0,0,0,0
190594,21010,210,10,-2,15,7,8,0,0,0,2,0,2,3,2,1,2,1,1,0,0,0,8,4,4,0,0,0,0,0,0,0,0,0
190600,21010,210,10,-2,37,15,22,0,0,0,1,0,1,9,6,3,5,1,4,0,0,0,22,8,14,0,0,0,0,0,0,0,0,0
190619,21010,210,10,-2,19,6,13,0,0,0,2,0,2,4,1,3,3,1,2,0,0,0,10,4,6,0,0,0,0,0,0,0,0,0
190628,21010,210,10,-2,3,1,2,0,0,0,0,0,0,0,0,0,2,1,1,0,0,0,1,0,1,0,0,0,0,0,0,0,0,0
190637,21010,210,10,-2,12,5,7,0,0,0,1,0,1,3,0,3,1,1,0,0,0,0,6,4,2,0,0,0,0,0,0,1,0,1
190646,21010,210,10,-2,14,7,7,0,0,0,1,1,0,11,5,6,0,0,0,0,0,0,2,1,1,0,0,0,0,0,0,0,0,0
190655,21010,210,10,-2,3,1,2,0,0,0,1,1,0,1,0,1,0,0,0,0,0,0,1,0,1,0,0,0,0,0,0,0,0,0
190664,21010,210,10,-2,28,9,19,0,0,0,5,2,3,4,1,3,2,0,2,0,0,0,17,6,11,0,0,0,0,0,0,0,0,0
190673,21010,210,10,-2,3,2,1,0,0,0,0,0,0,1,1,0,0,0,0,0,0,0,2,1,1,0,0,0,0,0,0,0,0,0
190682,21010,210,10,-2,3,2,1,0,0,0,1,0,1,1,1,0,1,1,0,0,0,0,0,0,0,0,0,0,0,0,0,0,0,0
190691,21010,210,10,-2,8,3,5,0,0,0,2,1,1,3,1,2,0,0,0,0,0,0,3,1,2,0,0,0,0,0,0,0,0,0
190716,21010,210,10,-2,7,2,5,0,0,0,1,0,1,2,0,2,0,0,0,0,0,0,4,2,2,0,0,0,0,0,0,0,0,0
190725,21010,210,10,-2,12,2,10,0,0,0,0,0,0,0,0,0,1,0,1,0,0,0,11,2,9,0,0,0,0,0,0,0,0,0
190761,21010,210,10,-2,3,2,1,0,0,0,0,0,0,0,0,0,0,0,0,0,0,0,3,2,1,0,0,0,0,0,0,0,0,0
190840,21010,210,10,-2,3,1,2,0,0,0,0,0,0,0,0,0,0,0,0,0,0,0,1,0,1,0,0,0,2,1,1,0,0,0
190956,21010,210,10,-2,4,0,4,0,0,0,0,0,0,0,0,0,0,0,0,0,0,0,4,0,4,0,0,0,0,0,0,0,0,0
190983,21010,210,10,-2,11,4,7,0,0,0,0,0,0,0,0,0,0,0,0,0,0,0,11,4,7,0,0,0,0,0,0,0,0,0
191083,21010,210,10,-2,3,1,2,0,0,0,0,0,0,1,1,0,0,0,0,0,0,0,1,0,1,0,0,0,1,0,1,0,0,0
191126,21010,210,10,-2,2,1,1,0,0,0,0,0,0,0,0,0,0,0,0,0,0,0,2,1,1,0,0,0,0,0,0,0,0,0
191199,21010,210,10,-2,1,1,0,0,0,0,0,0,0,0,0,0,0,0,0,0,0,0,1,1,0,0,0,0,0,0,0,0,0,0
191205,21010,210,10,-2,2,0,2,0,0,0,1,0,1,0,0,0,0,0,0,0,0,0,1,0,1,0,0,0,0,0,0,0,0,0
191241,21010,210,10,-2,11,7,4,0,0,0,2,1,1,2,1,1,0,0,0,0,0,0,4,2,2,0,0,0,1,1,0,2,2,0
191320,21010,210,10,-2,1,0,1,0,0,0,0,0,0,0,0,0,0,0,0,0,0,0,1,0,1,0,0,0,0,0,0,0,0,0
191515,21010,210,10,-2,35,18,17,0,0,0,2,0,2,0,0,0,1,0,1,0,0,0,16,11,5,1,0,1,3,1,2,12,6,6
191533,21010,210,10,-2,6,3,3,0,0,0,0,0,0,0,0,0,0,0,0,0,0,0,2,1,1,0,0,0,3,1,2,1,1,0
191597,21010,210,10,-2,6,1,5,0,0,0,1,0,1,4,0,4,0,0,0,0,0,0,1,1,0,0,0,0,0,0,0,0,0,0
191621,21010,210,10,-2,4,3,1,0,0,0,0,0,0,0,0,0,0,0,0,0,0,0,4,3,1,0,0,0,0,0,0,0,0,0
191630,21010,210,10,-2,16,8,8,0,0,0,2,2,0,1,1,0,2,1,1,0,0,0,10,4,6,0,0,0,1,0,1,0,0,0
191649,21010,210,10,-2,20,11,9,0,0,0,2,1,1,2,1,1,1,0,1,0,0,0,9,5,4,0,0,0,0,0,0,6,4,2
191676,21010,210,10,-2,7,6,1,0,0,0,1,1,0,1,1,0,0,0,0,0,0,0,3,3,0,0,0,0,1,1,0,1,0,1
191719,21010,210,10,-2,7,4,3,0,0,0,0,0,0,0,0,0,0,0,0,0,0,0,7,4,3,0,0,0,0,0,0,0,0,0
191931,21010,210,10,-2,16,8,8,0,0,0,3,2,1,2,1,1,1,0,1,0,0,0,9,4,5,0,0,0,1,1,0,0,0,0
191968,21010,210,10,-2,7,3,4,0,0,0,0,0,0,0,0,0,0,0,0,0,0,0,2,2,0,0,0,0,5,1,4,0,0,0
191986,21010,210,10,-2,6,1,5,0,0,0,0,0,0,0,0,0,0,0,0,0,0,0,6,1,5,0,0,0,0,0,0,0,0,0
192022,21010,210,10,-2,4,2,2,0,0,0,0,0,0,0,0,0,1,1,0,0,0,0,3,1,2,0,0,0,0,0,0,0,0,0
192110,21010,210,10,-2,2,2,0,0,0,0,0,0,0,1,1,0,0,0,0,0,0,0,0,0,0,0,0,0,0,0,0,1,1,0
192192,21010,210,10,-2,2,0,2,0,0,0,0,0,0,0,0,0,0,0,0,0,0,0,2,0,2,0,0,0,0,0,0,0,0,0
192323,21010,210,10,-2,12,6,6,0,0,0,1,0,1,1,0,1,1,1,0,0,0,0,9,5,4,0,0,0,0,0,0,0,0,0
192448,21010,210,10,-2,37,18,19,0,0,0,5,2,3,3,0,3,0,0,0,0,0,0,19,11,8,0,0,0,6,2,4,4,3,1
192688,21010,210,10,-2,2,1,1,0,0,0,1,0,1,0,0,0,1,1,0,0,0,0,0,0,0,0,0,0,0,0,0,0,0,0
192703,21010,210,10,-2,3,1,2,0,0,0,0,0,0,0,0,0,1,0,1,0,0,0,1,1,0,0,0,0,1,0,1,0,0,0
192749,21010,210,10,-2,13,0,13,0,0,0,2,0,2,1,0,1,3,0,3,0,0,0,5,0,5,0,0,0,2,0,2,0,0,0
192785,21010,210,10,-2,1,0,1,0,0,0,0,0,0,0,0,0,0,0,0,0,0,0,1,0,1,0,0,0,0,0,0,0,0,0
192819,21010,210,10,-2,8,2,6,0,0,0,2,1,1,1,0,1,0,0,0,0,0,0,5,1,4,0,0,0,0,0,0,0,0,0
192864,21010,210,10,-2,7,5,2,0,0,0,0,0,0,0,0,0,0,0,0,0,0,0,0,0,0,0,0,0,7,5,2,0,0,0
192925,21010,210,10,-2,11,3,8,1,1,0,0,0,0,2,1,1,0,0,0,1,0,1,7,1,6,0,0,0,0,0,0,0,0,0
193016,21010,210,10,-2,26,8,18,0,0,0,2,1,1,5,1,4,3,1,2,0,0,0,14,3,11,0,0,0,1,1,0,1,1,0
193283,21010,210,10,-2,5,1,4,0,0,0,0,0,0,0,0,0,0,0,0,0,0,0,5,1,4,0,0,0,0,0,0,0,0,0
193292,21010,210,10,-2,12,2,10,0,0,0,0,0,0,0,0,0,1,1,0,0,0,0,11,1,10,0,0,0,0,0,0,0,0,0
193308,21010,210,10,-2,9,2,7,0,0,0,3,1,2,1,0,1,2,0,2,0,0,0,3,1,2,0,0,0,0,0,0,0,0,0
193326,21010,210,10,-2,4,1,3,0,0,0,0,0,0,0,0,0,0,0,0,0,0,0,4,1,3,0,0,0,0,0,0,0,0,0
193353,21010,210,10,-2,2,1,1,0,0,0,1,0,1,0,0,0,0,0,0,0,0,0,1,1,0,0,0,0,0,0,0,0,0,0
193399,21010,210,10,-2,9,3,6,0,0,0,0,0,0,1,0,1,0,0,0,0,0,0,8,3,5,0,0,0,0,0,0,0,0,0
193405,21010,210,10,-2,285,137,148,0,0,0,33,13,20,6,2,4,9,4,5,0,0,0,57,32,25,1,0,1,159,73,86,20,13,7
193478,21010,210,10,-2,2,1,1,0,0,0,0,0,0,0,0,0,0,0,0,0,0,0,2,1,1,0,0,0,0,0,0,0,0,0
193584,21010,210,10,-2,8,2,6,0,0,0,1,0,1,0,0,0,2,1,1,0,0,0,5,1,4,0,0,0,0,0,0,0,0,0
193654,21010,210,10,-2,15,8,7,0,0,0,0,0,0,2,1,1,2,0,2,0,0,0,7,3,4,0,0,0,1,1,0,3,3,0
193821,21010,210,10,-2,3,1,2,0,0,0,0,0,0,0,0,0,0,0,0,0,0,0,1,0,1,0,0,0,2,1,1,0,0,0
193830,21010,210,10,-2,8,3,5,0,0,0,4,2,2,1,0,1,1,0,1,0,0,0,2,1,1,0,0,0,0,0,0,0,0,0
193900,21010,210,10,-2,474,215,259,2,0,2,107,55,52,30,9,21,35,13,22,1,1,0,249,114,135,3,1,2,9,3,6,38,19,19
193946,21010,210,10,-2,3,2,1,0,0,0,0,0,0,0,0,0,0,0,0,0,0,0,3,2,1,0,0,0,0,0,0,0,0,0
193973,21010,210,10,-2,27,12,15,0,0,0,0,0,0,0,0,0,0,0,0,0,0,0,21,8,13,0,0,0,3,2,1,3,2,1
194028,21010,210,10,-2,5,1,4,0,0,0,0,0,0,0,0,0,0,0,0,0,0,0,5,1,4,0,0,0,0,0,0,0,0,0
194073,21010,210,10,-2,1,0,1,0,0,0,1,0,1,0,0,0,0,0,0,0,0,0,0,0,0,0,0,0,0,0,0,0,0,0
194091,21010,210,10,-2,4,4,0,0,0,0,0,0,0,0,0,0,0,0,0,0,0,0,3,3,0,1,1,0,0,0,0,0,0,0
194222,21010,210,10,-2,2,0,2,0,0,0,0,0,0,0,0,0,0,0,0,0,0,0,2,0,2,0,0,0,0,0,0,0,0,0
194310,21010,210,10,-2,27,8,19,0,0,0,3,0,3,2,2,0,4,1,3,0,0,0,15,5,10,0,0,0,2,0,2,1,0,1
194392,21010,210,10,-2,5,4,1,0,0,0,2,2,0,0,0,0,0,0,0,0,0,0,3,2,1,0,0,0,0,0,0,0,0,0
194499,21010,210,10,-2,1,1,0,0,0,0,0,0,0,0,0,0,1,1,0,0,0,0,0,0,0,0,0,0,0,0,0,0,0,0
194578,21010,210,10,-2,9,4,5,0,0,0,2,0,2,1,0,1,1,0,1,0,0,0,5,4,1,0,0,0,0,0,0,0,0,0
194824,21010,210,10,-2,5,3,2,0,0,0,2,2,0,0,0,0,0,0,0,0,0,0,3,1,2,0,0,0,0,0,0,0,0,0
194958,21010,210,10,-2,5,2,3,0,0,0,0,0,0,0,0,0,0,0,0,0,0,0,5,2,3,0,0,0,0,0,0,0,0,0
195003,21010,210,10,-2,61,34,27,0,0,0,11,4,7,0,0,0,6,4,2,1,1,0,30,16,14,2,1,1,3,1,2,8,7,1
195030,21010,210,10,-2,132,69,63,0,0,0,21,14,7,7,3,4,6,4,2,0,0,0,71,33,38,0,0,0,0,0,0,27,15,12
195049,21010,210,10,-2,1,1,0,0,0,0,0,0,0,0,0,0,0,0,0,0,0,0,1,1,0,0,0,0,0,0,0,0,0,0
195058,21010,210,10,-2,4,2,2,0,0,0,0,0,0,0,0,0,0,0,0,0,0,0,4,2,2,0,0,0,0,0,0,0,0,0
195128,21010,210,10,-2,7,1,6,0,0,0,1,0,1,1,0,1,0,0,0,0,0,0,5,1,4,0,0,0,0,0,0,0,0,0
195164,21010,210,10,-2,22,8,14,0,0,0,3,2,1,2,1,1,1,0,1,1,1,0,15,4,11,0,0,0,0,0,0,0,0,0
195173,21010,210,10,-2,9,3,6,0,0,0,1,1,0,2,0,2,0,0,0,0,0,0,5,1,4,1,1,0,0,0,0,0,0,0
195191,21010,210,10,-2,1,0,1,0,0,0,0,0,0,0,0,0,0,0,0,0,0,0,1,0,1,0,0,0,0,0,0,0,0,0
195216,21010,210,10,-2,9,5,4,0,0,0,1,0,1,0,0,0,1,1,0,0,0,0,5,4,1,0,0,0,1,0,1,1,0,1
195234,21010,210,10,-2,3,2,1,0,0,0,0,0,0,1,1,0,0,0,0,0,0,0,2,1,1,0,0,0,0,0,0,0,0,0
195243,21010,210,10,-2,4,2,2,0,0,0,0,0,0,0,0,0,3,1,2,0,0,0,1,1,0,0,0,0,0,0,0,0,0,0
195304,21010,210,10,-2,3,1,2,0,0,0,0,0,0,1,0,1,2,1,1,0,0,0,0,0,0,0,0,0,0,0,0,0,0,0
195322,21010,210,10,-2,3,1,2,0,0,0,0,0,0,0,0,0,0,0,0,0,0,0,3,1,2,0,0,0,0,0,0,0,0,0
195438,21010,210,10,-2,3,3,0,0,0,0,0,0,0,0,0,0,0,0,0,0,0,0,3,3,0,0,0,0,0,0,0,0,0,0
195474,21010,210,10,-2,20,8,12,0,0,0,0,0,0,1,0,1,1,0,1,0,0,0,14,7,7,0,0,0,0,0,0,4,1,3
195544,21010,210,10,-2,12,5,7,0,0,0,0,0,0,1,0,1,0,0,0,0,0,0,3,1,2,0,0,0,8,4,4,0,0,0
195720,21010,210,10,-2,20,7,13,0,0,0,2,1,1,4,1,3,0,0,0,0,0,0,13,4,9,0,0,0,1,1,0,0,0,0
195784,21010,210,10,-2,1,0,1,0,0,0,0,0,0,0,0,0,0,0,0,0,0,0,1,0,1,0,0,0,0,0,0,0,0,0
195809,21010,210,10,-2,25,12,13,0,0,0,5,3,2,1,0,1,5,4,1,0,0,0,12,4,8,1,0,1,0,0,0,1,1,0
195988,21010,210,10,-2,2,1,1,0,0,0,0,0,0,0,0,0,0,0,0,0,0,0,2,1,1,0,0,0,0,0,0,0,0,0
196006,21010,210,10,-2,25,17,8,0,0,0,1,1,0,1,1,0,2,2,0,0,0,0,20,12,8,0,0,0,0,0,0,1,1,0
196015,21010,210,10,-2,6,3,3,0,0,0,0,0,0,1,0,1,0,0,0,0,0,0,3,1,2,0,0,0,0,0,0,2,2,0
196024,21010,210,10,-2,5,2,3,0,0,0,0,0,0,0,0,0,0,0,0,0,0,0,4,1,3,1,1,0,0,0,0,0,0,0
196033,21010,210,10,-2,6,3,3,0,0,0,0,0,0,0,0,0,0,0,0,0,0,0,6,3,3,0,0,0,0,0,0,0,0,0
196042,21010,210,10,-2,3,1,2,0,0,0,1,0,1,0,0,0,0,0,0,0,0,0,2,1,1,0,0,0,0,0,0,0,0,0
196051,21010,210,10,-2,3,0,3,0,0,0,0,0,0,0,0,0,0,0,0,0,0,0,3,0,3,0,0,0,0,0,0,0,0,0
196060,21010,210,10,-2,13,6,7,0,0,0,1,1,0,0,0,0,0,0,0,0,0,0,9,4,5,1,0,1,0,0,0,2,1,1
196079,21010,210,10,-2,31,17,14,0,0,0,3,3,0,2,1,1,1,0,1,0,0,0,18,7,11,0,0,0,0,0,0,7,6,1
196088,21010,210,10,-2,47,23,24,2,1,1,6,4,2,2,1,1,1,1,0,0,0,0,27,9,18,0,0,0,0,0,0,9,7,2
196097,21010,210,10,-2,111,54,57,0,0,0,22,13,9,3,2,1,10,6,4,0,0,0,51,19,32,2,0,2,14,8,6,9,6,3
196103,21010,210,10,-2,6,5,1,0,0,0,0,0,0,0,0,0,0,0,0,0,0,0,6,5,1,0,0,0,0,0,0,0,0,0
196112,21010,210,10,-2,3,1,2,0,0,0,1,1,0,0,0,0,0,0,0,0,0,0,1,0,1,0,0,0,0,0,0,1,0,1
196121,21010,210,10,-2,5,0,5,0,0,0,0,0,0,0,0,0,0,0,0,0,0,0,5,0,5,0,0,0,0,0,0,0,0,0
196130,21010,210,10,-2,4,2,2,0,0,0,0,0,0,0,0,0,0,0,0,0,0,0,2,1,1,0,0,0,0,0,0,2,1,1
196149,21010,210,10,-2,7,6,1,0,0,0,0,0,0,5,4,1,0,0,0,0,0,0,2,2,0,0,0,0,0,0,0,0,0,0
196158,21010,210,10,-2,4,4,0,0,0,0,0,0,0,1,1,0,0,0,0,0,0,0,2,2,0,0,0,0,0,0,0,1,1,0
196167,21010,210,10,-2,3,1,2,0,0,0,1,1,0,0,0,0,0,0,0,0,0,0,2,0,2,0,0,0,0,0,0,0,0,0
196176,21010,210,10,-2,10,4,6,0,0,0,1,1,0,2,0,2,0,0,0,0,0,0,6,3,3,0,0,0,0,0,0,1,0,1
196185,21010,210,10,-2,22,9,13,1,0,1,2,1,1,1,0,1,1,1,0,0,0,0,14,7,7,0,0,0,0,0,0,3,0,3
196194,21010,210,10,-2,3,0,3,0,0,0,1,0,1,0,0,0,0,0,0,0,0,0,1,0,1,0,0,0,0,0,0,1,0,1
196200,21010,210,10,-2,11,9,2,0,0,0,0,0,0,2,1,1,1,1,0,0,0,0,8,7,1,0,0,0,0,0,0,0,0,0
196219,21010,210,10,-2,5,1,4,0,0,0,0,0,0,1,0,1,1,0,1,0,0,0,3,1,2,0,0,0,0,0,0,0,0,0
196228,21010,210,10,-2,1,0,1,0,0,0,1,0,1,0,0,0,0,0,0,0,0,0,0,0,0,0,0,0,0,0,0,0,0,0
196237,21010,210,10,-2,2,1,1,0,0,0,0,0,0,0,0,0,1,1,0,0,0,0,1,0,1,0,0,0,0,0,0,0,0,0
196246,21010,210,10,-2,8,5,3,0,0,0,0,0,0,0,0,0,0,0,0,0,0,0,3,3,0,1,0,1,0,0,0,4,2,2
196255,21010,210,10,-2,17,9,8,0,0,0,1,1,0,7,3,4,2,1,1,0,0,0,7,4,3,0,0,0,0,0,0,0,0,0
196264,21010,210,10,-2,6,2,4,0,0,0,1,0,1,0,0,0,0,0,0,0,0,0,5,2,3,0,0,0,0,0,0,0,0,0
196291,21010,210,10,-2,3,3,0,0,0,0,2,2,0,0,0,0,0,0,0,0,0,0,1,1,0,0,0,0,0,0,0,0,0,0
196307,21010,210,10,-2,45,30,15,0,0,0,11,7,4,1,0,1,1,1,0,0,0,0,21,15,6,0,0,0,0,0,0,11,7,4
196389,21010,210,10,-2,7,2,5,0,0,0,1,1,0,3,1,2,2,0,2,0,0,0,1,0,1,0,0,0,0,0,0,0,0,0
196413,21010,210,10,-2,71,30,41,0,0,0,10,4,6,10,5,5,8,6,2,0,0,0,24,7,17,3,0,3,0,0,0,16,8,8
196431,21010,210,10,-2,2,2,0,0,0,0,0,0,0,0,0,0,0,0,0,0,0,0,2,2,0,0,0,0,0,0,0,0,0,0
196468,21010,210,10,-2,9,4,5,0,0,0,1,0,1,0,0,0,1,0,1,0,0,0,4,1,3,1,1,0,0,0,0,2,2,0
196565,21010,210,10,-2,1,0,1,0,0,0,0,0,0,0,0,0,0,0,0,0,0,0,1,0,1,0,0,0,0,0,0,0,0,0
196592,21010,210,10,-2,30,6,24,0,0,0,2,1,1,2,0,2,6,0,6,0,0,0,15,4,11,3,1,2,2,0,2,0,0,0
196653,21010,210,10,-2,6,1,5,0,0,0,0,0,0,1,0,1,0,0,0,0,0,0,5,1,4,0,0,0,0,0,0,0,0,0
196680,21010,210,10,-2,2,0,2,0,0,0,1,0,1,0,0,0,0,0,0,0,0,0,1,0,1,0,0,0,0,0,0,0,0,0
196699,21010,210,10,-2,1,0,1,0,0,0,0,0,0,0,0,0,0,0,0,0,0,0,1,0,1,0,0,0,0,0,0,0,0,0
196866,21010,210,10,-2,6,3,3,0,0,0,0,0,0,0,0,0,0,0,0,0,0,0,3,2,1,0,0,0,0,0,0,3,1,2
196884,21010,210,10,-2,1,1,0,0,0,0,0,0,0,1,1,0,0,0,0,0,0,0,0,0,0,0,0,0,0,0,0,0,0,0
197027,21010,210,10,-2,4,4,0,0,0,0,0,0,0,0,0,0,0,0,0,0,0,0,4,4,0,0,0,0,0,0,0,0,0,0
197036,21010,210,10,-2,30,15,15,0,0,0,0,0,0,1,0,1,0,0,0,0,0,0,29,15,14,0,0,0,0,0,0,0,0,0
197045,21010,210,10,-2,12,3,9,0,0,0,1,1,0,1,0,1,0,0,0,0,0,0,9,2,7,1,0,1,0,0,0,0,0,0
197133,21010,210,10,-2,30,17,13,1,0,1,1,0,1,3,2,1,3,2,1,0,0,0,13,7,6,1,1,0,3,3,0,5,2,3
197142,21010,210,10,-2,2,1,1,0,0,0,0,0,0,0,0,0,0,0,0,0,0,0,2,1,1,0,0,0,0,0,0,0,0,0
197151,21010,210,10,-2,3,1,2,0,0,0,0,0,0,0,0,0,0,0,0,0,0,0,1,1,0,0,0,0,1,0,1,1,0,1
197230,21010,210,10,-2,6,3,3,0,0,0,0,0,0,0,0,0,1,0,1,0,0,0,4,2,2,1,1,0,0,0,0,0,0,0
197294,21010,210,10,-2,3,2,1,0,0,0,0,0,0,0,0,0,0,0,0,0,0,0,3,2,1,0,0,0,0,0,0,0,0,0
197708,21010,210,10,-2,15,6,9,0,0,0,1,0,1,2,1,1,4,2,2,0,0,0,8,3,5,0,0,0,0,0,0,0,0,0
197735,21010,210,10,-2,3,3,0,0,0,0,0,0,0,0,0,0,0,0,0,0,0,0,3,3,0,0,0,0,0,0,0,0,0,0
197814,21010,210,10,-2,5,3,2,0,0,0,0,0,0,1,0,1,0,0,0,0,0,0,4,3,1,0,0,0,0,0,0,0,0,0
197850,21010,210,10,-2,10,4,6,0,0,0,0,0,0,1,0,1,0,0,0,0,0,0,9,4,5,0,0,0,0,0,0,0,0,0
197869,21010,210,10,-2,59,27,32,0,0,0,4,2,2,2,0,2,1,1,0,0,0,0,37,13,24,1,0,1,2,2,0,12,9,3
197887,21010,210,10,-2,11,6,5,0,0,0,0,0,0,0,0,0,0,0,0,0,0,0,11,6,5,0,0,0,0,0,0,0,0,0
197911,21010,210,10,-2,7,2,5,0,0,0,0,0,0,2,1,1,0,0,0,0,0,0,4,0,4,0,0,0,1,1,0,0,0,0
197966,21010,210,10,-2,4,1,3,0,0,0,0,0,0,1,0,1,0,0,0,0,0,0,3,1,2,0,0,0,0,0,0,0,0,0
197984,21010,210,10,-2,13,5,8,0,0,0,0,0,0,1,0,1,1,0,1,0,0,0,11,5,6,0,0,0,0,0,0,0,0,0
197993,21010,210,10,-2,1,0,1,0,0,0,0,0,0,0,0,0,0,0,0,0,0,0,1,0,1,0,0,0,0,0,0,0,0,0
198011,21010,210,10,-2,6,4,2,2,0,2,0,0,0,0,0,0,0,0,0,0,0,0,4,4,0,0,0,0,0,0,0,0,0,0
198039,21010,210,10,-2,14,4,10,0,0,0,0,0,0,1,0,1,0,0,0,0,0,0,13,4,9,0,0,0,0,0,0,0,0,0
198066,21010,210,10,-2,2,0,2,0,0,0,0,0,0,0,0,0,0,0,0,0,0,0,2,0,2,0,0,0,0,0,0,0,0,0
198084,21010,210,10,-2,4,0,4,0,0,0,0,0,0,1,0,1,0,0,0,0,0,0,3,0,3,0,0,0,0,0,0,0,0,0
198109,21010,210,10,-2,3,1,2,0,0,0,0,0,0,1,1,0,0,0,0,0,0,0,2,0,2,0,0,0,0,0,0,0,0,0
198118,21010,210,10,-2,14,6,8,0,0,0,0,0,0,0,0,0,0,0,0,0,0,0,14,6,8,0,0,0,0,0,0,0,0,0
198136,21010,210,10,-2,14,8,6,0,0,0,1,0,1,2,1,1,2,1,1,0,0,0,9,6,3,0,0,0,0,0,0,0,0,0
198154,21010,210,10,-2,8,4,4,0,0,0,0,0,0,0,0,0,1,0,1,0,0,0,6,3,3,1,1,0,0,0,0,0,0,0
198206,21010,210,10,-2,4,1,3,0,0,0,0,0,0,0,0,0,0,0,0,0,0,0,4,1,3,0,0,0,0,0,0,0,0,0
198215,21010,210,10,-2,10,2,8,0,0,0,0,0,0,0,0,0,0,0,0,0,0,0,10,2,8,0,0,0,0,0,0,0,0,0
198233,21010,210,10,-2,10,5,5,0,0,0,1,1,0,0,0,0,0,0,0,0,0,0,8,4,4,0,0,0,1,0,1,0,0,0
198251,21010,210,10,-2,8,2,6,0,0,0,0,0,0,2,0,2,0,0,0,0,0,0,6,2,4,0,0,0,0,0,0,0,0,0
198260,21010,210,10,-2,14,7,7,0,0,0,0,0,0,1,0,1,0,0,0,0,0,0,11,7,4,0,0,0,2,0,2,0,0,0
198303,21010,210,10,-2,6,3,3,0,0,0,0,0,0,2,0,2,0,0,0,0,0,0,4,3,1,0,0,0,0,0,0,0,0,0
198321,21010,210,10,-2,5,1,4,0,0,0,0,0,0,0,0,0,1,0,1,0,0,0,4,1,3,0,0,0,0,0,0,0,0,0
198330,21010,210,10,-2,9,5,4,0,0,0,0,0,0,0,0,0,0,0,0,0,0,0,9,5,4,0,0,0,0,0,0,0,0,0
198367,21010,210,10,-2,3,1,2,0,0,0,0,0,0,0,0,0,0,0,0,0,0,0,3,1,2,0,0,0,0,0,0,0,0,0
198376,21010,210,10,-2,15,5,10,0,0,0,0,0,0,1,1,0,0,0,0,0,0,0,13,4,9,1,0,1,0,0,0,0,0,0
198385,21010,210,10,-2,18,9,9,0,0,0,2,1,1,1,1,0,4,2,2,0,0,0,10,4,6,0,0,0,1,1,0,0,0,0
198419,21010,210,10,-2,178,91,87,1,0,1,24,11,13,14,7,7,15,5,10,0,0,0,100,52,48,1,1,0,0,0,0,23,15,8
198455,21010,210,10,-2,7,4,3,0,0,0,0,0,0,5,3,2,0,0,0,0,0,0,2,1,1,0,0,0,0,0,0,0,0,0
198464,21010,210,10,-2,46,15,31,0,0,0,3,2,1,4,0,4,6,2,4,0,0,0,24,7,17,2,0,2,3,0,3,4,4,0
198491,21010,210,10,-2,7,2,5,0,0,0,0,0,0,2,1,1,0,0,0,0,0,0,5,1,4,0,0,0,0,0,0,0,0,0
198507,21010,210,10,-2,11,6,5,0,0,0,0,0,0,6,3,3,0,0,0,0,0,0,4,2,2,0,0,0,0,0,0,1,1,0
198516,21010,210,10,-2,37,13,24,0,0,0,4,2,2,5,0,5,3,1,2,0,0,0,23,9,14,0,0,0,2,1,1,0,0,0
198534,21010,210,10,-2,37,17,20,4,2,2,2,2,0,12,5,7,0,0,0,0,0,0,19,8,11,0,0,0,0,0,0,0,0,0
198543,21010,210,10,-2,9,3,6,0,0,0,1,1,0,7,1,6,0,0,0,0,0,0,1,1,0,0,0,0,0,0,0,0,0,0
198552,21010,210,10,-2,14,6,8,0,0,0,0,0,0,6,2,4,0,0,0,0,0,0,7,4,3,1,0,1,0,0,0,0,0,0
198561,21010,210,10,-2,6,1,5,0,0,0,0,0,0,1,0,1,1,0,1,0,0,0,4,1,3,0,0,0,0,0,0,0,0,0
198570,21010,210,10,-2,19,8,11,0,0,0,0,0,0,0,0,0,0,0,0,0,0,0,19,8,11,0,0,0,0,0,0,0,0,0
198598,21010,210,10,-2,1,0,1,0,0,0,0,0,0,0,0,0,0,0,0,0,0,0,1,0,1,0,0,0,0,0,0,0,0,0
198613,21010,210,10,-2,7,5,2,0,0,0,3,1,2,0,0,0,0,0,0,0,0,0,4,4,0,0,0,0,0,0,0,0,0,0
198622,21010,210,10,-2,21,8,13,0,0,0,0,0,0,5,0,5,0,0,0,0,0,0,16,8,8,0,0,0,0,0,0,0,0,0
198640,21010,210,10,-2,3,2,1,0,0,0,0,0,0,0,0,0,0,0,0,0,0,0,3,2,1,0,0,0,0,0,0,0,0,0
198668,21010,210,10,-2,4,0,4,0,0,0,0,0,0,0,0,0,0,0,0,0,0,0,4,0,4,0,0,0,0,0,0,0,0,0
198695,21010,210,10,-2,34,13,21,0,0,0,1,1,0,5,2,3,1,0,1,0,0,0,26,10,16,1,0,1,0,0,0,0,0,0
198710,21010,210,10,-2,2,0,2,0,0,0,0,0,0,0,0,0,0,0,0,0,0,0,2,0,2,0,0,0,0,0,0,0,0,0
198729,21010,210,10,-2,2,0,2,0,0,0,0,0,0,0,0,0,1,0,1,0,0,0,1,0,1,0,0,0,0,0,0,0,0,0
198756,21010,210,10,-2,6,4,2,0,0,0,1,1,0,3,1,2,0,0,0,0,0,0,2,2,0,0,0,0,0,0,0,0,0,0
198774,21010,210,10,-2,7,2,5,0,0,0,0,0,0,0,0,0,0,0,0,0,0,0,7,2,5,0,0,0,0,0,0,0,0,0
198808,21010,210,10,-2,11,5,6,0,0,0,0,0,0,0,0,0,1,1,0,0,0,0,10,4,6,0,0,0,0,0,0,0,0,0
198817,21010,210,10,-2,9,3,6,0,0,0,0,0,0,0,0,0,0,0,0,0,0,0,9,3,6,0,0,0,0,0,0,0,0,0
198835,21010,210,10,-2,18,8,10,0,0,0,2,1,1,2,1,1,0,0,0,0,0,0,11,3,8,1,1,0,2,2,0,0,0,0
198862,21010,210,10,-2,8,2,6,0,0,0,0,0,0,6,2,4,0,0,0,0,0,0,2,0,2,0,0,0,0,0,0,0,0,0
198871,21010,210,10,-2,3,1,2,0,0,0,0,0,0,1,0,1,0,0,0,0,0,0,2,1,1,0,0,0,0,0,0,0,0,0
198899,21010,210,10,-2,5,2,3,0,0,0,0,0,0,0,0,0,0,0,0,0,0,0,5,2,3,0,0,0,0,0,0,0,0,0
198905,21010,210,10,-2,1,1,0,0,0,0,0,0,0,0,0,0,0,0,0,0,0,0,1,1,0,0,0,0,0,0,0,0,0,0
198923,21010,210,10,-2,3,2,1,0,0,0,0,0,0,0,0,0,0,0,0,0,0,0,3,2,1,0,0,0,0,0,0,0,0,0
198950,21010,210,10,-2,7,3,4,0,0,0,0,0,0,1,0,1,1,1,0,0,0,0,4,2,2,0,0,0,1,0,1,0,0,0
198969,21010,210,10,-2,17,5,12,0,0,0,2,1,1,2,1,1,0,0,0,0,0,0,11,2,9,1,0,1,1,1,0,0,0,0
198987,21010,210,10,-2,5,3,2,0,0,0,0,0,0,0,0,0,0,0,0,0,0,0,5,3,2,0,0,0,0,0,0,0,0,0
199023,21010,210,10,-2,4,0,4,0,0,0,0,0,0,0,0,0,0,0,0,0,0,0,4,0,4,0,0,0,0,0,0,0,0,0
199032,21010,210,10,-2,6,3,3,0,0,0,0,0,0,2,0,2,0,0,0,0,0,0,4,3,1,0,0,0,0,0,0,0,0,0
199069,21010,210,10,-2,3,1,2,0,0,0,0,0,0,0,0,0,0,0,0,0,0,0,3,1,2,0,0,0,0,0,0,0,0,0
199087,21010,210,10,-2,6,3,3,0,0,0,0,0,0,0,0,0,0,0,0,0,0,0,5,3,2,1,0,1,0,0,0,0,0,0
199102,21010,210,10,-2,34,18,16,0,0,0,2,2,0,10,3,7,3,1,2,0,0,0,5,4,1,0,0,0,13,8,5,1,0,1
199111,21010,210,10,-2,11,6,5,0,0,0,0,0,0,1,0,1,1,0,1,0,0,0,1,0,1,0,0,0,7,5,2,1,1,0
199120,21010,210,10,-2,93,37,56,0,0,0,3,1,2,9,0,9,7,4,3,0,0,0,31,15,16,3,0,3,28,13,15,12,4,8
199139,21010,210,10,-2,50,20,30,0,0,0,0,0,0,16,5,11,4,0,4,0,0,0,25,11,14,1,0,1,0,0,0,4,4,0
199148,21010,210,10,-2,62,21,41,0,0,0,3,0,3,7,1,6,2,2,0,0,0,0,40,13,27,0,0,0,1,0,1,9,5,4
199157,21010,210,10,-2,16,4,12,0,0,0,0,0,0,4,2,2,0,0,0,0,0,0,4,0,4,0,0,0,8,2,6,0,0,0
199184,21010,210,10,-2,5,1,4,0,0,0,1,0,1,1,0,1,0,0,0,0,0,0,3,1,2,0,0,0,0,0,0,0,0,0
199193,21010,210,10,-2,81,37,44,1,1,0,9,4,5,7,0,7,4,3,1,0,0,0,46,21,25,0,0,0,3,2,1,11,6,5
199209,21010,210,10,-2,9,5,4,0,0,0,0,0,0,0,0,0,0,0,0,0,0,0,9,5,4,0,0,0,0,0,0,0,0,0
199218,21010,210,10,-2,63,25,38,0,0,0,3,3,0,5,2,3,2,0,2,0,0,0,34,10,24,3,2,1,3,2,1,13,6,7
199263,21010,210,10,-2,2,2,0,0,0,0,0,0,0,0,0,0,0,0,0,0,0,0,2,2,0,0,0,0,0,0,0,0,0,0
199272,21010,210,10,-2,1,0,1,0,0,0,0,0,0,0,0,0,0,0,0,0,0,0,1,0,1,0,0,0,0,0,0,0,0,0
199281,21010,210,10,-2,28,11,17,1,0,1,2,1,1,3,0,3,0,0,0,0,0,0,20,9,11,0,0,0,0,0,0,2,1,1
199306,21010,210,10,-2,10,4,6,0,0,0,0,0,0,2,1,1,0,0,0,0,0,0,8,3,5,0,0,0,0,0,0,0,0,0
199324,21010,210,10,-2,9,6,3,0,0,0,0,0,0,2,2,0,1,0,1,0,0,0,6,4,2,0,0,0,0,0,0,0,0,0
199333,21010,210,10,-2,6,1,5,0,0,0,0,0,0,1,0,1,0,0,0,0,0,0,5,1,4,0,0,0,0,0,0,0,0,0
199412,21010,210,10,-2,4,1,3,0,0,0,0,0,0,1,0,1,1,0,1,0,0,0,2,1,1,0,0,0,0,0,0,0,0,0
199421,21010,210,10,-2,2,0,2,0,0,0,0,0,0,0,0,0,0,0,0,0,0,0,1,0,1,0,0,0,1,0,1,0,0,0
199449,21010,210,10,-2,13,7,6,0,0,0,0,0,0,1,1,0,0,0,0,0,0,0,12,6,6,0,0,0,0,0,0,0,0,0
199458,21010,210,10,-2,1,1,0,0,0,0,0,0,0,0,0,0,0,0,0,0,0,0,1,1,0,0,0,0,0,0,0,0,0,0
199467,21010,210,10,-2,2,0,2,0,0,0,0,0,0,0,0,0,0,0,0,0,0,0,2,0,2,0,0,0,0,0,0,0,0,0
199476,21010,210,10,-2,7,1,6,2,1,1,0,0,0,2,0,2,0,0,0,0,0,0,3,0,3,0,0,0,0,0,0,0,0,0
199485,21010,210,10,-2,1,0,1,0,0,0,0,0,0,0,0,0,0,0,0,0,0,0,1,0,1,0,0,0,0,0,0,0,0,0
199494,21010,210,10,-2,5,2,3,0,0,0,0,0,0,2,2,0,0,0,0,0,0,0,3,0,3,0,0,0,0,0,0,0,0,0
199582,21010,210,10,-2,1,1,0,0,0,0,0,0,0,1,1,0,0,0,0,0,0,0,0,0,0,0,0,0,0,0,0,0,0,0
199607,21010,210,10,-2,1,0,1,0,0,0,0,0,0,0,0,0,0,0,0,0,0,0,1,0,1,0,0,0,0,0,0,0,0,0
199625,21010,210,10,-2,8,4,4,1,0,1,0,0,0,1,1,0,0,0,0,0,0,0,6,3,3,0,0,0,0,0,0,0,0,0
199634,21010,210,10,-2,7,4,3,0,0,0,0,0,0,0,0,0,0,0,0,0,0,0,7,4,3,0,0,0,0,0,0,0,0,0
199643,21010,210,10,-2,8,2,6,0,0,0,0,0,0,8,2,6,0,0,0,0,0,0,0,0,0,0,0,0,0,0,0,0,0,0
199698,21010,210,10,-2,5,1,4,0,0,0,0,0,0,1,0,1,0,0,0,0,0,0,4,1,3,0,0,0,0,0,0,0,0,0
199722,21010,210,10,-2,12,7,5,0,0,0,0,0,0,2,1,1,0,0,0,0,0,0,10,6,4,0,0,0,0,0,0,0,0,0
199731,21010,210,10,-2,4,1,3,0,0,0,0,0,0,0,0,0,0,0,0,0,0,0,4,1,3,0,0,0,0,0,0,0,0,0
199740,21010,210,10,-2,3,1,2,0,0,0,0,0,0,1,0,1,0,0,0,0,0,0,2,1,1,0,0,0,0,0,0,0,0,0
199759,21010,210,10,-2,1,0,1,0,0,0,0,0,0,0,0,0,0,0,0,0,0,0,1,0,1,0,0,0,0,0,0,0,0,0
199768,21010,210,10,-2,4,2,2,0,0,0,0,0,0,0,0,0,0,0,0,0,0,0,4,2,2,0,0,0,0,0,0,0,0,0
199786,21010,210,10,-2,6,1,5,0,0,0,0,0,0,0,0,0,0,0,0,0,0,0,6,1,5,0,0,0,0,0,0,0,0,0
199795,21010,210,10,-2,3,1,2,0,0,0,0,0,0,0,0,0,0,0,0,0,0,0,3,1,2,0,0,0,0,0,0,0,0,0
199838,21010,210,10,-2,1,1,0,0,0,0,1,1,0,0,0,0,0,0,0,0,0,0,0,0,0,0,0,0,0,0,0,0,0,0
199847,21010,210,10,-2,126,71,55,1,1,0,22,14,8,13,3,10,4,2,2,0,0,0,76,46,30,4,1,3,0,0,0,6,4,2
199856,21010,210,10,-2,34,23,11,0,0,0,2,2,0,5,1,4,0,0,0,0,0,0,21,15,6,0,0,0,6,5,1,0,0,0
199865,21010,210,10,-2,2,0,2,0,0,0,0,0,0,0,0,0,0,0,0,0,0,0,1,0,1,0,0,0,0,0,0,1,0,1
199883,21010,210,10,-2,1,0,1,0,0,0,0,0,0,1,0,1,0,0,0,0,0,0,0,0,0,0,0,0,0,0,0,0,0,0
199892,21010,210,10,-2,10,3,7,0,0,0,0,0,0,0,0,0,0,0,0,0,0,0,10,3,7,0,0,0,0,0,0,0,0,0
199908,21010,210,10,-2,2,1,1,0,0,0,0,0,0,0,0,0,0,0,0,0,0,0,2,1,1,0,0,0,0,0,0,0,0,0
199926,21010,210,10,-2,3,3,0,0,0,0,0,0,0,0,0,0,0,0,0,0,0,0,3,3,0,0,0,0,0,0,0,0,0,0
199953,21010,210,10,-2,2,1,1,0,0,0,0,0,0,1,1,0,0,0,0,0,0,0,1,0,1,0,0,0,0,0,0,0,0,0
199962,21010,210,10,-2,6,3,3,0,0,0,1,0,1,1,1,0,0,0,0,0,0,0,4,2,2,0,0,0,0,0,0,0,0,0
199999,21010,210,10,-2,13,5,8,0,0,0,1,0,1,8,3,5,0,0,0,0,0,0,4,2,2,0,0,0,0,0,0,0,0,0
200004,21010,210,10,-2,47,26,21,0,0,0,3,0,3,5,3,2,5,3,2,0,0,0,31,18,13,0,0,0,0,0,0,3,2,1
200022,21010,210,10,-2,3,1,2,1,1,0,0,0,0,0,0,0,0,0,0,0,0,0,2,0,2,0,0,0,0,0,0,0,0,0
200059,21010,210,10,-2,5,4,1,0,0,0,0,0,0,0,0,0,0,0,0,0,0,0,5,4,1,0,0,0,0,0,0,0,0,0
200156,21010,210,10,-2,7,3,4,0,0,0,0,0,0,0,0,0,0,0,0,0,0,0,7,3,4,0,0,0,0,0,0,0,0,0
200192,21010,210,10,-2,2,1,1,0,0,0,0,0,0,0,0,0,0,0,0,0,0,0,2,1,1,0,0,0,0,0,0,0,0,0
200208,21010,210,10,-2,3,2,1,2,1,1,0,0,0,0,0,0,0,0,0,0,0,0,1,1,0,0,0,0,0,0,0,0,0,0
200217,21010,210,10,-2,11,3,8,0,0,0,1,1,0,0,0,0,0,0,0,0,0,0,10,2,8,0,0,0,0,0,0,0,0,0
200253,21010,210,10,-2,13,5,8,0,0,0,0,0,0,0,0,0,0,0,0,0,0,0,13,5,8,0,0,0,0,0,0,0,0,0
200280,21010,210,10,-2,21,12,9,1,1,0,3,1,2,2,1,1,0,0,0,0,0,0,9,3,6,0,0,0,0,0,0,6,6,0
200314,21010,210,10,-2,3,1,2,1,0,1,0,0,0,0,0,0,0,0,0,0,0,0,2,1,1,0,0,0,0,0,0,0,0,0
200332,21010,210,10,-2,31,14,17,0,0,0,4,3,1,0,0,0,0,0,0,0,0,0,18,5,13,1,1,0,0,0,0,8,5,3
200466,21010,210,10,-2,1,1,0,0,0,0,0,0,0,0,0,0,0,0,0,0,0,0,1,1,0,0,0,0,0,0,0,0,0,0
200527,21010,210,10,-2,4,3,1,3,2,1,0,0,0,0,0,0,0,0,0,0,0,0,1,1,0,0,0,0,0,0,0,0,0,0
200554,21010,210,10,-2,1,1,0,0,0,0,0,0,0,0,0,0,0,0,0,0,0,0,1,1,0,0,0,0,0,0,0,0,0,0
200572,21010,210,10,-2,10,3,7,0,0,0,0,0,0,0,0,0,0,0,0,0,0,0,10,3,7,0,0,0,0,0,0,0,0,0
200590,21010,210,10,-2,1,0,1,0,0,0,0,0,0,0,0,0,0,0,0,0,0,0,1,0,1,0,0,0,0,0,0,0,0,0
200800,21010,210,10,-2,21,9,12,0,0,0,3,1,2,1,0,1,2,1,1,0,0,0,12,6,6,0,0,0,0,0,0,3,1,2
201104,21010,210,10,-2,13,4,9,0,0,0,0,0,0,3,0,3,0,0,0,0,0,0,8,3,5,0,0,0,0,0,0,2,1,1
201140,21010,210,10,-2,1,1,0,0,0,0,0,0,0,0,0,0,0,0,0,0,0,0,1,1,0,0,0,0,0,0,0,0,0,0
201177,21010,210,10,-2,1,0,1,0,0,0,0,0,0,0,0,0,0,0,0,0,0,0,1,0,1,0,0,0,0,0,0,0,0,0
201195,21010,210,10,-2,12,5,7,0,0,0,1,0,1,1,1,0,1,1,0,0,0,0,9,3,6,0,0,0,0,0,0,0,0,0
201283,21010,210,10,-2,1,1,0,0,0,0,0,0,0,0,0,0,0,0,0,0,0,0,1,1,0,0,0,0,0,0,0,0,0,0
201371,21010,210,10,-2,2,0,2,0,0,0,0,0,0,0,0,0,0,0,0,0,0,0,2,0,2,0,0,0,0,0,0,0,0,0
201432,21010,210,10,-2,3,3,0,0,0,0,0,0,0,0,0,0,0,0,0,0,0,0,2,2,0,0,0,0,1,1,0,0,0,0
201441,21010,210,10,-2,41,14,27,0,0,0,0,0,0,2,0,2,0,0,0,0,0,0,17,3,14,0,0,0,22,11,11,0,0,0
201469,21010,210,10,-2,3,1,2,0,0,0,0,0,0,0,0,0,0,0,0,0,0,0,3,1,2,0,0,0,0,0,0,0,0,0
201548,21010,210,10,-2,14,5,9,0,0,0,1,1,0,1,0,1,0,0,0,0,0,0,11,4,7,0,0,0,1,0,1,0,0,0
201645,21010,210,10,-2,42,25,17,0,0,0,6,4,2,3,2,1,3,2,1,0,0,0,24,13,11,0,0,0,1,1,0,5,3,2
201654,21010,210,10,-2,15,4,11,0,0,0,0,0,0,1,1,0,0,0,0,0,0,0,14,3,11,0,0,0,0,0,0,0,0,0
201672,21010,210,10,-2,1,1,0,0,0,0,0,0,0,0,0,0,0,0,0,0,0,0,1,1,0,0,0,0,0,0,0,0,0,0
201690,21010,210,10,-2,14,9,5,0,0,0,0,0,0,4,3,1,1,1,0,0,0,0,7,5,2,0,0,0,2,0,2,0,0,0
201751,21010,210,10,-2,2,0,2,0,0,0,0,0,0,0,0,0,0,0,0,0,0,0,1,0,1,0,0,0,1,0,1,0,0,0
201821,21010,210,10,-2,9,2,7,0,0,0,0,0,0,0,0,0,0,0,0,0,0,0,9,2,7,0,0,0,0,0,0,0,0,0
201885,21010,210,10,-2,150,77,73,0,0,0,21,10,11,8,4,4,4,3,1,0,0,0,88,42,46,2,1,1,9,4,5,18,13,5
201928,21010,210,10,-2,4,0,4,0,0,0,0,0,0,1,0,1,0,0,0,0,0,0,3,0,3,0,0,0,0,0,0,0,0,0
201946,21010,210,10,-2,5,0,5,0,0,0,0,0,0,0,0,0,1,0,1,0,0,0,4,0,4,0,0,0,0,0,0,0,0,0
201955,21010,210,10,-2,2,1,1,0,0,0,0,0,0,0,0,0,0,0,0,0,0,0,1,1,0,0,0,0,1,0,1,0,0,0
201964,21010,210,10,-2,1,1,0,0,0,0,0,0,0,0,0,0,0,0,0,0,0,0,1,1,0,0,0,0,0,0,0,0,0,0
201973,21010,210,10,-2,8,1,7,0,0,0,0,0,0,0,0,0,0,0,0,0,0,0,7,0,7,0,0,0,1,1,0,0,0,0
202046,21010,210,10,-2,5,3,2,0,0,0,0,0,0,0,0,0,0,0,0,0,0,0,5,3,2,0,0,0,0,0,0,0,0,0
202073,21010,210,10,-2,2,1,1,0,0,0,0,0,0,0,0,0,0,0,0,0,0,0,2,1,1,0,0,0,0,0,0,0,0,0
202134,21010,210,10,-2,32,20,12,0,0,0,3,2,1,2,0,2,1,1,0,0,0,0,22,15,7,0,0,0,0,0,0,4,2,2
202222,21010,210,10,-2,13,8,5,0,0,0,0,0,0,0,0,0,1,0,1,1,0,1,10,7,3,0,0,0,1,1,0,0,0,0
202356,21010,210,10,-2,30,8,22,0,0,0,0,0,0,5,0,5,1,0,1,0,0,0,21,6,15,2,1,1,1,1,0,0,0,0
202480,21010,210,10,-2,60,40,20,0,0,0,7,5,2,4,3,1,1,1,0,0,0,0,44,28,16,0,0,0,0,0,0,4,3,1
202514,21010,210,10,-2,4,0,4,0,0,0,0,0,0,0,0,0,0,0,0,0,0,0,4,0,4,0,0,0,0,0,0,0,0,0
202523,21010,210,10,-2,18,6,12,0,0,0,2,1,1,1,0,1,0,0,0,0,0,0,15,5,10,0,0,0,0,0,0,0,0,0
202648,21010,210,10,-2,3,1,2,0,0,0,1,0,1,0,0,0,0,0,0,0,0,0,1,0,1,0,0,0,1,1,0,0,0,0
202763,21010,210,10,-2,9,6,3,0,0,0,1,1,0,2,2,0,0,0,0,0,0,0,6,3,3,0,0,0,0,0,0,0,0,0
202806,21010,210,10,-2,5,1,4,0,0,0,0,0,0,0,0,0,0,0,0,0,0,0,5,1,4,0,0,0,0,0,0,0,0,0
202912,21010,210,10,-2,6,0,6,0,0,0,0,0,0,0,0,0,0,0,0,0,0,0,6,0,6,0,0,0,0,0,0,0,0,0
203085,21010,210,10,-2,9,5,4,0,0,0,0,0,0,1,0,1,0,0,0,0,0,0,8,5,3,0,0,0,0,0,0,0,0,0
203128,21010,210,10,-2,4,2,2,0,0,0,1,0,1,0,0,0,0,0,0,0,0,0,3,2,1,0,0,0,0,0,0,0,0,0
203155,21010,210,10,-2,11,7,4,0,0,0,0,0,0,1,0,1,0,0,0,0,0,0,10,7,3,0,0,0,0,0,0,0,0,0
203368,21010,210,10,-2,7,5,2,0,0,0,2,1,1,0,0,0,0,0,0,0,0,0,4,3,1,0,0,0,0,0,0,1,1,0
203386,21010,210,10,-2,33,5,28,0,0,0,0,0,0,4,0,4,0,0,0,0,0,0,28,5,23,0,0,0,1,0,1,0,0,0
203483,21010,210,10,-2,1,1,0,0,0,0,0,0,0,0,0,0,0,0,0,0,0,0,1,1,0,0,0,0,0,0,0,0,0,0
203492,21010,210,10,-2,2,1,1,0,0,0,0,0,0,0,0,0,0,0,0,0,0,0,1,0,1,0,0,0,0,0,0,1,1,0
203517,21010,210,10,-2,31,15,16,0,0,0,0,0,0,5,0,5,2,2,0,0,0,0,14,6,8,2,1,1,3,3,0,5,3,2
203535,21010,210,10,-2,30,6,24,0,0,0,1,0,1,0,0,0,3,1,2,0,0,0,5,0,5,0,0,0,19,4,15,2,1,1
203544,21010,210,10,-2,4,2,2,0,0,0,0,0,0,1,1,0,0,0,0,0,0,0,3,1,2,0,0,0,0,0,0,0,0,0
203599,21010,210,10,-2,3,1,2,0,0,0,0,0,0,0,0,0,0,0,0,0,0,0,2,1,1,0,0,0,1,0,1,0,0,0
203678,21010,210,10,-2,8,4,4,0,0,0,1,1,0,0,0,0,0,0,0,0,0,0,7,3,4,0,0,0,0,0,0,0,0,0
203720,21010,210,10,-2,5,5,0,0,0,0,0,0,0,2,2,0,0,0,0,0,0,0,3,3,0,0,0,0,0,0,0,0,0,0
203748,21010,210,10,-2,2,0,2,0,0,0,0,0,0,0,0,0,0,0,0,0,0,0,2,0,2,0,0,0,0,0,0,0,0,0
203757,21010,210,10,-2,10,1,9,0,0,0,0,0,0,0,0,0,0,0,0,0,0,0,8,0,8,0,0,0,2,1,1,0,0,0
203775,21010,210,10,-2,2,1,1,0,0,0,0,0,0,1,1,0,0,0,0,0,0,0,1,0,1,0,0,0,0,0,0,0,0,0
203845,21010,210,10,-2,13,8,5,0,0,0,0,0,0,0,0,0,1,1,0,0,0,0,12,7,5,0,0,0,0,0,0,0,0,0
203881,21010,210,10,-2,1,0,1,0,0,0,0,0,0,0,0,0,0,0,0,0,0,0,1,0,1,0,0,0,0,0,0,0,0,0
203960,21010,210,10,-2,8,0,8,0,0,0,0,0,0,1,0,1,0,0,0,0,0,0,7,0,7,0,0,0,0,0,0,0,0,0
204006,21010,210,10,-2,4,0,4,0,0,0,0,0,0,0,0,0,0,0,0,0,0,0,4,0,4,0,0,0,0,0,0,0,0,0
204015,21010,210,10,-2,1,0,1,0,0,0,0,0,0,0,0,0,0,0,0,0,0,0,0,0,0,0,0,0,1,0,1,0,0,0
204024,21010,210,10,-2,37,19,18,0,0,0,1,0,1,2,0,2,1,1,0,0,0,0,29,14,15,0,0,0,0,0,0,4,4,0
204176,21010,210,10,-2,4,0,4,0,0,0,0,0,0,0,0,0,0,0,0,0,0,0,4,0,4,0,0,0,0,0,0,0,0,0
204185,21010,210,10,-2,6,3,3,0,0,0,1,1,0,0,0,0,0,0,0,0,0,0,4,1,3,0,0,0,0,0,0,1,1,0
204194,21010,210,10,-2,5,4,1,0,0,0,1,1,0,1,1,0,1,1,0,0,0,0,1,1,0,1,0,1,0,0,0,0,0,0
204200,21010,210,10,-2,10,2,8,0,0,0,2,0,2,0,0,0,0,0,0,0,0,0,8,2,6,0,0,0,0,0,0,0,0,0
204255,21010,210,10,-2,2,0,2,0,0,0,0,0,0,0,0,0,0,0,0,0,0,0,2,0,2,0,0,0,0,0,0,0,0,0
204264,21010,210,10,-2,6,1,5,0,0,0,1,0,1,0,0,0,0,0,0,0,0,0,5,1,4,0,0,0,0,0,0,0,0,0
204422,21010,210,10,-2,6,3,3,0,0,0,1,1,0,2,1,1,0,0,0,2,1,1,1,0,1,0,0,0,0,0,0,0,0,0
204477,21010,210,10,-2,7,5,2,0,0,0,0,0,0,0,0,0,0,0,0,0,0,0,7,5,2,0,0,0,0,0,0,0,0,0
204501,21010,210,10,-2,43,20,23,0,0,0,1,0,1,1,0,1,2,1,1,0,0,0,27,12,15,0,0,0,2,0,2,10,7,3
204617,21010,210,10,-2,2,2,0,0,0,0,1,1,0,0,0,0,0,0,0,0,0,0,1,1,0,0,0,0,0,0,0,0,0,0
204635,21010,210,10,-2,9,7,2,0,0,0,1,0,1,0,0,0,1,1,0,0,0,0,7,6,1,0,0,0,0,0,0,0,0,0
204796,21010,210,10,-2,261,105,156,0,0,0,50,20,30,16,6,10,12,5,7,0,0,0,153,58,95,5,2,3,14,7,7,11,7,4
204820,21010,210,10,-2,1,0,1,0,0,0,0,0,0,0,0,0,0,0,0,0,0,0,1,0,1,0,0,0,0,0,0,0,0,0
204839,21010,210,10,-2,2,1,1,0,0,0,0,0,0,0,0,0,0,0,0,0,0,0,2,1,1,0,0,0,0,0,0,0,0,0
204848,21010,210,10,-2,1,1,0,0,0,0,0,0,0,0,0,0,0,0,0,0,0,0,1,1,0,0,0,0,0,0,0,0,0,0
204857,21010,210,10,-2,16,3,13,0,0,0,1,0,1,1,0,1,1,0,1,0,0,0,10,2,8,0,0,0,2,0,2,1,1,0
204866,21010,210,10,-2,2,1,1,0,0,0,0,0,0,0,0,0,0,0,0,0,0,0,2,1,1,0,0,0,0,0,0,0,0,0
204909,21010,210,10,-2,11,6,5,0,0,0,1,0,1,2,2,0,1,0,1,0,0,0,6,4,2,0,0,0,1,0,1,0,0,0
204945,21010,210,10,-2,3,0,3,0,0,0,0,0,0,0,0,0,0,0,0,0,0,0,3,0,3,0,0,0,0,0,0,0,0,0
205054,21010,210,10,-2,1,0,1,0,0,0,0,0,0,0,0,0,0,0,0,0,0,0,1,0,1,0,0,0,0,0,0,0,0,0
205179,21010,210,10,-2,3,1,2,0,0,0,0,0,0,0,0,0,0,0,0,0,0,0,3,1,2,0,0,0,0,0,0,0,0,0
205203,21010,210,10,-2,5,3,2,0,0,0,0,0,0,0,0,0,0,0,0,0,0,0,5,3,2,0,0,0,0,0,0,0,0,0
205391,21010,210,10,-2,1,1,0,0,0,0,0,0,0,0,0,0,0,0,0,0,0,0,1,1,0,0,0,0,0,0,0,0,0,0
205443,21010,210,10,-2,3,0,3,0,0,0,0,0,0,0,0,0,0,0,0,0,0,0,3,0,3,0,0,0,0,0,0,0,0,0
205470,21010,210,10,-2,11,3,8,0,0,0,0,0,0,1,0,1,0,0,0,0,0,0,10,3,7,0,0,0,0,0,0,0,0,0
205841,21010,210,10,-2,10,5,5,0,0,0,0,0,0,0,0,0,0,0,0,0,0,0,9,4,5,0,0,0,1,1,0,0,0,0
205887,21010,210,10,-2,6,0,6,0,0,0,0,0,0,1,0,1,0,0,0,0,0,0,5,0,5,0,0,0,0,0,0,0,0,0
205957,21010,210,10,-2,8,4,4,0,0,0,0,0,0,0,0,0,0,0,0,0,0,0,7,3,4,0,0,0,1,1,0,0,0,0
205966,21010,210,10,-2,4,3,1,0,0,0,0,0,0,0,0,0,0,0,0,0,0,0,4,3,1,0,0,0,0,0,0,0,0,0
206011,21010,210,10,-2,4,2,2,0,0,0,0,0,0,1,0,1,0,0,0,0,0,0,3,2,1,0,0,0,0,0,0,0,0,0
206048,21010,210,10,-2,9,8,1,0,0,0,0,0,0,0,0,0,0,0,0,0,0,0,8,7,1,1,1,0,0,0,0,0,0,0
206084,21010,210,10,-2,19,10,9,0,0,0,6,4,2,0,0,0,1,0,1,0,0,0,11,5,6,1,1,0,0,0,0,0,0,0
206279,21010,210,10,-2,1,0,1,0,0,0,0,0,0,0,0,0,0,0,0,0,0,0,1,0,1,0,0,0,0,0,0,0,0,0
206349,21010,210,10,-2,14,4,10,0,0,0,0,0,0,1,1,0,0,0,0,0,0,0,13,3,10,0,0,0,0,0,0,0,0,0
206437,21010,210,10,-2,8,4,4,0,0,0,0,0,0,1,1,0,0,0,0,0,0,0,6,2,4,0,0,0,1,1,0,0,0,0
206446,21010,210,10,-2,11,3,8,0,0,0,0,0,0,0,0,0,1,1,0,0,0,0,10,2,8,0,0,0,0,0,0,0,0,0
206491,21010,210,10,-2,1,1,0,0,0,0,0,0,0,1,1,0,0,0,0,0,0,0,0,0,0,0,0,0,0,0,0,0,0,0
206507,21010,210,10,-2,11,4,7,0,0,0,0,0,0,0,0,0,1,0,1,0,0,0,10,4,6,0,0,0,0,0,0,0,0,0
206525,21010,210,10,-2,7,1,6,0,0,0,1,1,0,0,0,0,1,0,1,0,0,0,5,0,5,0,0,0,0,0,0,0,0,0
206589,21010,210,10,-2,16,6,10,0,0,0,0,0,0,3,0,3,1,1,0,0,0,0,7,1,6,0,0,0,1,1,0,4,3,1
206604,21010,210,10,-2,19,7,12,0,0,0,3,2,1,2,0,2,0,0,0,0,0,0,12,3,9,0,0,0,0,0,0,2,2,0
206622,21010,210,10,-2,20,8,12,0,0,0,1,0,1,2,1,1,0,0,0,0,0,0,17,7,10,0,0,0,0,0,0,0,0,0
206695,21010,210,10,-2,34,20,14,0,0,0,0,0,0,0,0,0,1,0,1,0,0,0,24,14,10,1,0,1,0,0,0,8,6,2
206862,21010,210,10,-2,9,4,5,0,0,0,1,0,1,0,0,0,0,0,0,0,0,0,7,4,3,1,0,1,0,0,0,0,0,0
206914,21010,210,10,-2,7,3,4,0,0,0,2,1,1,0,0,0,0,0,0,0,0,0,4,1,3,1,1,0,0,0,0,0,0,0
206923,21010,210,10,-2,1,0,1,0,0,0,0,0,0,0,0,0,0,0,0,0,0,0,1,0,1,0,0,0,0,0,0,0,0,0
206932,21010,210,10,-2,3,1,2,0,0,0,0,0,0,0,0,0,0,0,0,0,0,0,3,1,2,0,0,0,0,0,0,0,0,0
206941,21010,210,10,-2,54,24,30,1,0,1,3,2,1,2,1,1,3,2,1,2,1,1,34,11,23,1,1,0,7,5,2,1,1,0
206996,21010,210,10,-2,7,4,3,1,1,0,1,1,0,0,0,0,1,0,1,0,0,0,4,2,2,0,0,0,0,0,0,0,0,0
207041,21010,210,10,-2,8,4,4,0,0,0,1,1,0,0,0,0,0,0,0,0,0,0,6,3,3,0,0,0,1,0,1,0,0,0
207069,21010,210,10,-2,1,0,1,0,0,0,0,0,0,0,0,0,0,0,0,0,0,0,0,0,0,1,0,1,0,0,0,0,0,0
207157,21010,210,10,-2,4,4,0,1,1,0,0,0,0,0,0,0,0,0,0,0,0,0,3,3,0,0,0,0,0,0,0,0,0,0
207209,21010,210,10,-2,8,1,7,0,0,0,0,0,0,5,1,4,0,0,0,0,0,0,3,0,3,0,0,0,0,0,0,0,0,0
207236,21010,210,10,-2,9,4,5,2,1,1,0,0,0,0,0,0,1,1,0,0,0,0,6,2,4,0,0,0,0,0,0,0,0,0
207263,21010,210,10,-2,14,6,8,1,0,1,2,0,2,1,1,0,0,0,0,0,0,0,10,5,5,0,0,0,0,0,0,0,0,0
207281,21010,210,10,-2,6,3,3,0,0,0,0,0,0,0,0,0,0,0,0,0,0,0,6,3,3,0,0,0,0,0,0,0,0,0
207290,21010,210,10,-2,5,2,3,0,0,0,0,0,0,1,1,0,0,0,0,0,0,0,3,1,2,1,0,1,0,0,0,0,0,0
207306,21010,210,10,-2,8,5,3,0,0,0,0,0,0,0,0,0,0,0,0,0,0,0,7,5,2,0,0,0,1,0,1,0,0,0
207315,21010,210,10,-2,25,10,15,1,1,0,2,0,2,1,0,1,1,0,1,0,0,0,18,8,10,2,1,1,0,0,0,0,0,0
207324,21010,210,10,-2,4,1,3,0,0,0,0,0,0,1,0,1,0,0,0,0,0,0,3,1,2,0,0,0,0,0,0,0,0,0
207342,21010,210,10,-2,30,18,12,0,0,0,2,1,1,0,0,0,1,1,0,0,0,0,16,7,9,1,1,0,0,0,0,10,8,2
207351,21010,210,10,-2,6,3,3,0,0,0,0,0,0,0,0,0,0,0,0,0,0,0,5,3,2,0,0,0,0,0,0,1,0,1
207388,21010,210,10,-2,138,62,76,1,1,0,10,6,4,4,4,0,8,3,5,0,0,0,71,21,50,5,1,4,1,0,1,38,26,12
207397,21010,210,10,-2,6,0,6,1,0,1,0,0,0,2,0,2,0,0,0,0,0,0,3,0,3,0,0,0,0,0,0,0,0,0
207403,21010,210,10,-2,7,5,2,0,0,0,1,0,1,0,0,0,0,0,0,0,0,0,6,5,1,0,0,0,0,0,0,0,0,0
207449,21010,210,10,-2,14,7,7,0,0,0,3,1,2,0,0,0,0,0,0,0,0,0,9,5,4,2,1,1,0,0,0,0,0,0
207458,21010,210,10,-2,26,13,13,0,0,0,2,2,0,1,0,1,0,0,0,0,0,0,21,10,11,0,0,0,0,0,0,2,1,1
207500,21010,210,10,-2,116,63,53,1,1,0,9,6,3,7,4,3,7,4,3,0,0,0,52,23,29,0,0,0,11,8,3,29,17,12
207564,21010,210,10,-2,8,6,2,0,0,0,0,0,0,1,1,0,0,0,0,0,0,0,6,4,2,1,1,0,0,0,0,0,0,0
207582,21010,210,10,-2,5,5,0,0,0,0,0,0,0,0,0,0,0,0,0,0,0,0,3,3,0,0,0,0,0,0,0,2,2,0
207661,21010,210,10,-2,11,3,8,2,1,1,2,0,2,0,0,0,0,0,0,0,0,0,6,2,4,0,0,0,1,0,1,0,0,0
207670,21010,210,10,-2,18,7,11,0,0,0,2,1,1,1,0,1,0,0,0,0,0,0,15,6,9,0,0,0,0,0,0,0,0,0
207722,21010,210,10,-2,3,1,2,1,1,0,0,0,0,0,0,0,0,0,0,0,0,0,2,0,2,0,0,0,0,0,0,0,0,0
207740,21010,210,10,-2,2,1,1,0,0,0,0,0,0,0,0,0,0,0,0,0,0,0,2,1,1,0,0,0,0,0,0,0,0,0
207847,21010,210,10,-2,11,6,5,0,0,0,0,0,0,0,0,0,0,0,0,0,0,0,9,6,3,0,0,0,0,0,0,2,0,2
207856,21010,210,10,-2,5,2,3,0,0,0,0,0,0,0,0,0,0,0,0,0,0,0,5,2,3,0,0,0,0,0,0,0,0,0
207865,21010,210,10,-2,9,3,6,0,0,0,0,0,0,0,0,0,0,0,0,0,0,0,9,3,6,0,0,0,0,0,0,0,0,0
207935,21010,210,10,-2,15,6,9,1,1,0,0,0,0,2,1,1,4,2,2,0,0,0,6,1,5,2,1,1,0,0,0,0,0,0
207962,21010,210,10,-2,4,4,0,1,1,0,0,0,0,0,0,0,0,0,0,0,0,0,2,2,0,0,0,0,1,1,0,0,0,0
207971,21010,210,10,-2,15,8,7,0,0,0,0,0,0,3,3,0,0,0,0,0,0,0,8,2,6,1,0,1,3,3,0,0,0,0
208035,21010,210,10,-2,5,0,5,0,0,0,0,0,0,0,0,0,2,0,2,0,0,0,3,0,3,0,0,0,0,0,0,0,0,0
208318,21010,210,10,-2,5,1,4,0,0,0,1,1,0,0,0,0,1,0,1,0,0,0,3,0,3,0,0,0,0,0,0,0,0,0
208390,21010,210,10,-2,11,7,4,0,0,0,0,0,0,0,0,0,2,1,1,0,0,0,6,4,2,0,0,0,2,1,1,1,1,0
208406,21010,210,10,-2,3,1,2,0,0,0,0,0,0,0,0,0,0,0,0,0,0,0,3,1,2,0,0,0,0,0,0,0,0,0
208415,21010,210,10,-2,2,1,1,0,0,0,0,0,0,0,0,0,1,0,1,0,0,0,1,1,0,0,0,0,0,0,0,0,0,0
208479,21010,210,10,-2,2,1,1,0,0,0,1,1,0,0,0,0,0,0,0,0,0,0,1,0,1,0,0,0,0,0,0,0,0,0
208512,21010,210,10,-2,4,2,2,0,0,0,0,0,0,0,0,0,0,0,0,0,0,0,0,0,0,4,2,2,0,0,0,0,0,0
208646,21010,210,10,-2,14,6,8,0,0,0,2,1,1,0,0,0,0,0,0,0,0,0,9,3,6,0,0,0,3,2,1,0,0,0
208822,21010,210,10,-2,29,12,17,0,0,0,1,1,0,2,1,1,1,1,0,0,0,0,22,6,16,1,1,0,2,2,0,0,0,0
209038,21010,210,10,-2,12,3,9,0,0,0,1,1,0,0,0,0,2,2,0,0,0,0,9,0,9,0,0,0,0,0,0,0,0,0
209056,21010,210,10,-2,2,1,1,0,0,0,0,0,0,1,0,1,0,0,0,0,0,0,1,1,0,0,0,0,0,0,0,0,0,0
209065,21010,210,10,-2,8,1,7,0,0,0,1,0,1,0,0,0,0,0,0,0,0,0,6,1,5,0,0,0,1,0,1,0,0,0
209074,21010,210,10,-2,7,1,6,0,0,0,0,0,0,0,0,0,2,0,2,0,0,0,0,0,0,1,0,1,3,1,2,1,0,1
209241,21010,210,10,-2,3,3,0,0,0,0,0,0,0,0,0,0,2,2,0,0,0,0,1,1,0,0,0,0,0,0,0,0,0,0
209250,21010,210,10,-2,4,2,2,0,0,0,1,1,0,1,1,0,0,0,0,0,0,0,2,0,2,0,0,0,0,0,0,0,0,0
209287,21010,210,10,-2,1,1,0,0,0,0,1,1,0,0,0,0,0,0,0,0,0,0,0,0,0,0,0,0,0,0,0,0,0,0
209409,21010,210,10,-2,3,2,1,0,0,0,0,0,0,0,0,0,1,1,0,0,0,0,2,1,1,0,0,0,0,0,0,0,0,0
209490,21010,210,10,-2,222,96,126,0,0,0,46,21,25,8,3,5,8,5,3,1,0,1,119,47,72,4,0,4,24,14,10,12,6,6
209506,21010,210,10,-2,11,5,6,0,0,0,3,1,2,0,0,0,0,0,0,0,0,0,5,1,4,0,0,0,0,0,0,3,3,0
209542,21010,210,10,-2,59,27,32,0,0,0,4,2,2,1,1,0,7,5,2,0,0,0,13,7,6,0,0,0,24,7,17,10,5,5
209551,21010,210,10,-2,26,11,15,0,0,0,1,0,1,3,1,2,0,0,0,0,0,0,13,4,9,1,0,1,3,2,1,5,4,1
209612,21010,210,10,-2,19,7,12,0,0,0,2,2,0,1,0,1,1,1,0,0,0,0,14,3,11,1,1,0,0,0,0,0,0,0
209746,21010,210,10,-2,12,4,8,0,0,0,1,0,1,1,1,0,2,1,1,0,0,0,6,1,5,0,0,0,2,1,1,0,0,0
209807,21010,210,10,-2,23,11,12,0,0,0,2,1,1,3,0,3,5,3,2,0,0,0,9,5,4,1,0,1,0,0,0,3,2,1
209825,21010,210,10,-2,25,8,17,0,0,0,0,0,0,1,0,1,2,2,0,0,0,0,12,3,9,0,0,0,5,0,5,5,3,2
209922,21010,210,10,-2,21,8,13,0,0,0,2,1,1,0,0,0,3,1,2,0,0,0,10,2,8,2,2,0,0,0,0,4,2,2
210146,21010,210,10,-2,7,6,1,0,0,0,1,0,1,0,0,0,0,0,0,0,0,0,6,6,0,0,0,0,0,0,0,0,0,0
210155,21010,210,10,-2,5,1,4,0,0,0,0,0,0,0,0,0,0,0,0,0,0,0,4,1,3,0,0,0,1,0,1,0,0,0
210234,21010,210,10,-2,5,1,4,0,0,0,0,0,0,0,0,0,1,0,1,0,0,0,3,1,2,0,0,0,1,0,1,0,0,0
210270,21010,210,10,-2,7,2,5,0,0,0,0,0,0,0,0,0,0,0,0,0,0,0,5,2,3,1,0,1,1,0,1,0,0,0
210304,21010,210,10,-2,4,3,1,0,0,0,0,0,0,1,1,0,0,0,0,0,0,0,2,1,1,0,0,0,1,1,0,0,0,0
210331,21010,210,10,-2,4,3,1,0,0,0,0,0,0,0,0,0,0,0,0,0,0,0,4,3,1,0,0,0,0,0,0,0,0,0
210368,21010,210,10,-2,2,1,1,0,0,0,0,0,0,0,0,0,0,0,0,0,0,0,2,1,1,0,0,0,0,0,0,0,0,0
210401,21010,210,10,-2,3,3,0,0,0,0,0,0,0,0,0,0,0,0,0,0,0,0,3,3,0,0,0,0,0,0,0,0,0,0
210429,21010,210,10,-2,5,3,2,0,0,0,0,0,0,0,0,0,0,0,0,0,0,0,3,1,2,1,1,0,0,0,0,1,1,0
210438,21010,210,10,-2,3,1,2,0,0,0,0,0,0,1,1,0,0,0,0,0,0,0,1,0,1,0,0,0,1,0,1,0,0,0
210492,21010,210,10,-2,1,1,0,0,0,0,0,0,0,0,0,0,0,0,0,0,0,0,1,1,0,0,0,0,0,0,0,0,0,0
210571,21010,210,10,-2,8,4,4,0,0,0,1,0,1,0,0,0,0,0,0,0,0,0,6,3,3,1,1,0,0,0,0,0,0,0
210599,21010,210,10,-2,9,5,4,0,0,0,0,0,0,3,0,3,1,0,1,0,0,0,2,2,0,1,1,0,2,2,0,0,0,0
210605,21010,210,10,-2,21,6,15,0,0,0,2,0,2,3,1,2,0,0,0,0,0,0,15,5,10,0,0,0,1,0,1,0,0,0
210669,21010,210,10,-2,9,5,4,0,0,0,2,0,2,1,0,1,2,2,0,0,0,0,3,3,0,1,0,1,0,0,0,0,0,0
210739,21010,210,10,-2,10,5,5,0,0,0,0,0,0,1,0,1,0,0,0,0,0,0,8,4,4,1,1,0,0,0,0,0,0,0
210775,21010,210,10,-2,13,3,10,0,0,0,0,0,0,1,0,1,0,0,0,0,0,0,11,3,8,1,0,1,0,0,0,0,0,0
210809,21010,210,10,-2,2,1,1,0,0,0,0,0,0,1,0,1,0,0,0,0,0,0,1,1,0,0,0,0,0,0,0,0,0,0
211079,21010,210,10,-2,7,3,4,0,0,0,1,1,0,0,0,0,0,0,0,0,0,0,6,2,4,0,0,0,0,0,0,0,0,0
211088,21010,210,10,-2,5,0,5,0,0,0,1,0,1,1,0,1,0,0,0,0,0,0,3,0,3,0,0,0,0,0,0,0,0,0
211158,21010,210,10,-2,4,1,3,0,0,0,0,0,0,0,0,0,0,0,0,0,0,0,4,1,3,0,0,0,0,0,0,0,0,0
211273,21010,210,10,-2,14,3,11,0,0,0,4,0,4,1,0,1,0,0,0,0,0,0,3,1,2,2,1,1,4,1,3,0,0,0
211291,21010,210,10,-2,24,9,15,0,0,0,5,1,4,1,0,1,0,0,0,0,0,0,13,6,7,0,0,0,1,0,1,4,2,2
211352,21010,210,10,-2,3,1,2,0,0,0,1,1,0,0,0,0,0,0,0,0,0,0,2,0,2,0,0,0,0,0,0,0,0,0
211361,21010,210,10,-2,1,0,1,0,0,0,0,0,0,0,0,0,0,0,0,0,0,0,1,0,1,0,0,0,0,0,0,0,0,0
211431,21010,210,10,-2,7,1,6,0,0,0,0,0,0,0,0,0,0,0,0,0,0,0,7,1,6,0,0,0,0,0,0,0,0,0
211440,21010,210,10,-2,114,82,32,0,0,0,12,8,4,10,5,5,6,6,0,0,0,0,30,20,10,1,1,0,3,2,1,52,40,12
211468,21010,210,10,-2,6,2,4,0,0,0,0,0,0,1,0,1,0,0,0,0,0,0,5,2,3,0,0,0,0,0,0,0,0,0
211477,21010,210,10,-2,7,2,5,0,0,0,0,0,0,2,0,2,1,0,1,0,0,0,4,2,2,0,0,0,0,0,0,0,0,0
211556,21010,210,10,-2,9,2,7,0,0,0,0,0,0,0,0,0,1,1,0,0,0,0,8,1,7,0,0,0,0,0,0,0,0,0
211583,21010,210,10,-2,4,2,2,0,0,0,1,0,1,1,1,0,0,0,0,0,0,0,2,1,1,0,0,0,0,0,0,0,0,0
211608,21010,210,10,-2,1,1,0,0,0,0,0,0,0,1,1,0,0,0,0,0,0,0,0,0,0,0,0,0,0,0,0,0,0,0
211927,21010,210,10,-2,1,0,1,0,0,0,0,0,0,0,0,0,0,0,0,0,0,0,1,0,1,0,0,0,0,0,0,0,0,0
211981,21010,210,10,-2,1,0,1,0,0,0,0,0,0,0,0,0,0,0,0,0,0,0,1,0,1,0,0,0,0,0,0,0,0,0
212009,21010,210,10,-2,15,7,8,0,0,0,1,1,0,1,0,1,3,1,2,0,0,0,4,1,3,0,0,0,0,0,0,6,4,2
212045,21010,210,10,-2,1,1,0,0,0,0,0,0,0,0,0,0,0,0,0,0,0,0,1,1,0,0,0,0,0,0,0,0,0,0
212054,21010,210,10,-2,52,23,29,0,0,0,3,0,3,7,4,3,2,1,1,0,0,0,25,11,14,3,1,2,0,0,0,12,6,6
212106,21010,210,10,-2,27,10,17,0,0,0,2,0,2,1,1,0,0,0,0,0,0,0,22,8,14,0,0,0,0,0,0,2,1,1
212115,21010,210,10,-2,3,3,0,0,0,0,0,0,0,0,0,0,0,0,0,0,0,0,2,2,0,0,0,0,0,0,0,1,1,0
212133,21010,210,10,-2,23,9,14,0,0,0,1,1,0,3,2,1,0,0,0,0,0,0,17,6,11,0,0,0,2,0,2,0,0,0
212160,21010,210,10,-2,1,0,1,0,0,0,0,0,0,0,0,0,0,0,0,0,0,0,1,0,1,0,0,0,0,0,0,0,0,0
212197,21010,210,10,-2,6,3,3,0,0,0,0,0,0,0,0,0,0,0,0,0,0,0,1,0,1,0,0,0,5,3,2,0,0,0
212577,21010,210,10,-2,10,4,6,0,0,0,4,1,3,1,1,0,0,0,0,0,0,0,3,1,2,0,0,0,0,0,0,2,1,1
212601,21010,210,10,-2,31,11,20,0,0,0,5,3,2,2,1,1,0,0,0,0,0,0,23,6,17,0,0,0,1,1,0,0,0,0
212656,21010,210,10,-2,3,1,2,0,0,0,0,0,0,1,0,1,0,0,0,0,0,0,2,1,1,0,0,0,0,0,0,0,0,0
212674,21010,210,10,-2,16,5,11,0,0,0,1,0,1,0,0,0,0,0,0,0,0,0,8,2,6,0,0,0,0,0,0,7,3,4
212832,21010,210,10,-2,3,1,2,0,0,0,0,0,0,0,0,0,0,0,0,0,0,0,3,1,2,0,0,0,0,0,0,0,0,0
212869,21010,210,10,-2,4,1,3,0,0,0,0,0,0,0,0,0,0,0,0,0,0,0,4,1,3,0,0,0,0,0,0,0,0,0
212878,21010,210,10,-2,2,1,1,0,0,0,0,0,0,1,1,0,0,0,0,0,0,0,1,0,1,0,0,0,0,0,0,0,0,0
212911,21010,210,10,-2,21,10,11,0,0,0,3,1,2,1,0,1,1,0,1,0,0,0,9,4,5,0,0,0,1,0,1,6,5,1
212984,21010,210,10,-2,8,5,3,0,0,0,1,1,0,1,1,0,0,0,0,0,0,0,6,3,3,0,0,0,0,0,0,0,0,0
213011,21010,210,10,-2,8,3,5,0,0,0,1,1,0,0,0,0,0,0,0,0,0,0,5,1,4,1,1,0,1,0,1,0,0,0
213233,21010,210,10,-2,4,4,0,0,0,0,0,0,0,0,0,0,0,0,0,0,0,0,4,4,0,0,0,0,0,0,0,0,0,0
213251,21010,210,10,-2,5,2,3,0,0,0,1,1,0,1,0,1,0,0,0,0,0,0,3,1,2,0,0,0,0,0,0,0,0,0
213303,21010,210,10,-2,8,3,5,0,0,0,0,0,0,0,0,0,0,0,0,0,0,0,8,3,5,0,0,0,0,0,0,0,0,0
213321,21010,210,10,-2,4,3,1,0,0,0,0,0,0,0,0,0,0,0,0,0,0,0,4,3,1,0,0,0,0,0,0,0,0,0
213358,21010,210,10,-2,1,0,1,0,0,0,0,0,0,0,0,0,0,0,0,0,0,0,1,0,1,0,0,0,0,0,0,0,0,0
213367,21010,210,10,-2,11,5,6,0,0,0,0,0,0,2,1,1,0,0,0,0,0,0,9,4,5,0,0,0,0,0,0,0,0,0
213385,21010,210,10,-2,19,12,7,0,0,0,0,0,0,1,1,0,0,0,0,0,0,0,14,7,7,0,0,0,0,0,0,4,4,0
213400,21010,210,10,-2,9,5,4,0,0,0,0,0,0,0,0,0,1,1,0,0,0,0,8,4,4,0,0,0,0,0,0,0,0,0
213507,21010,210,10,-2,3,2,1,0,0,0,0,0,0,0,0,0,0,0,0,0,0,0,2,1,1,0,0,0,0,0,0,1,1,0
213525,21010,210,10,-2,3,1,2,0,0,0,1,1,0,0,0,0,0,0,0,0,0,0,2,0,2,0,0,0,0,0,0,0,0,0
213534,21010,210,10,-2,1,0,1,0,0,0,0,0,0,0,0,0,0,0,0,0,0,0,1,0,1,0,0,0,0,0,0,0,0,0
213543,21010,210,10,-2,40,25,15,0,0,0,5,1,4,2,1,1,0,0,0,0,0,0,14,10,4,0,0,0,11,8,3,8,5,3
213570,21010,210,10,-2,2,0,2,0,0,0,0,0,0,1,0,1,0,0,0,0,0,0,1,0,1,0,0,0,0,0,0,0,0,0
213589,21010,210,10,-2,2,2,0,0,0,0,0,0,0,0,0,0,0,0,0,0,0,0,2,2,0,0,0,0,0,0,0,0,0,0
213598,21010,210,10,-2,7,1,6,0,0,0,0,0,0,5,1,4,1,0,1,0,0,0,1,0,1,0,0,0,0,0,0,0,0,0
213631,21010,210,10,-2,2,0,2,0,0,0,1,0,1,1,0,1,0,0,0,0,0,0,0,0,0,0,0,0,0,0,0,0,0,0
213659,21010,210,10,-2,3,1,2,0,0,0,0,0,0,0,0,0,0,0,0,0,0,0,3,1,2,0,0,0,0,0,0,0,0,0
213668,21010,210,10,-2,8,2,6,0,0,0,0,0,0,0,0,0,3,1,2,0,0,0,4,0,4,0,0,0,1,1,0,0,0,0
213826,21010,210,10,-2,21,7,14,0,0,0,3,1,2,1,0,1,3,3,0,0,0,0,14,3,11,0,0,0,0,0,0,0,0,0
213987,21010,210,10,-2,14,4,10,0,0,0,2,0,2,0,0,0,0,0,0,0,0,0,12,4,8,0,0,0,0,0,0,0,0,0
213996,21010,210,10,-2,9,4,5,0,0,0,0,0,0,1,0,1,1,1,0,0,0,0,7,3,4,0,0,0,0,0,0,0,0,0
214041,21010,210,10,-2,6,1,5,0,0,0,0,0,0,0,0,0,0,0,0,0,0,0,5,0,5,0,0,0,1,1,0,0,0,0
214069,21010,210,10,-2,7,2,5,0,0,0,2,1,1,0,0,0,0,0,0,0,0,0,5,1,4,0,0,0,0,0,0,0,0,0
214111,21010,210,10,-2,2,0,2,0,0,0,0,0,0,0,0,0,0,0,0,0,0,0,1,0,1,0,0,0,1,0,1,0,0,0
214148,21010,210,10,-2,1,1,0,0,0,0,0,0,0,0,0,0,1,1,0,0,0,0,0,0,0,0,0,0,0,0,0,0,0,0
214157,21010,210,10,-2,4,2,2,0,0,0,1,0,1,1,1,0,0,0,0,0,0,0,1,1,0,0,0,0,0,0,0,1,0,1
214166,21010,210,10,-2,8,2,6,0,0,0,0,0,0,0,0,0,0,0,0,0,0,0,8,2,6,0,0,0,0,0,0,0,0,0
214175,21010,210,10,-2,25,11,14,0,0,0,3,0,3,5,3,2,4,1,3,0,0,0,10,4,6,0,0,0,0,0,0,3,3,0
214272,21010,210,10,-2,6,0,6,0,0,0,0,0,0,2,0,2,0,0,0,0,0,0,4,0,4,0,0,0,0,0,0,0,0,0
214290,21010,210,10,-2,10,9,1,0,0,0,0,0,0,0,0,0,0,0,0,0,0,0,10,9,1,0,0,0,0,0,0,0,0,0
214379,21010,210,10,-2,2,2,0,0,0,0,1,1,0,0,0,0,0,0,0,0,0,0,1,1,0,0,0,0,0,0,0,0,0,0
214564,21010,210,10,-2,2,1,1,0,0,0,0,0,0,0,0,0,0,0,0,0,0,0,1,1,0,1,0,1,0,0,0,0,0,0
214582,21010,210,10,-2,2,0,2,0,0,0,0,0,0,0,0,0,0,0,0,0,0,0,2,0,2,0,0,0,0,0,0,0,0,0
214892,21010,210,10,-2,11,4,7,0,0,0,0,0,0,0,0,0,0,0,0,0,0,0,11,4,7,0,0,0,0,0,0,0,0,0
214944,21010,210,10,-2,9,8,1,0,0,0,0,0,0,0,0,0,1,1,0,0,0,0,8,7,1,0,0,0,0,0,0,0,0,0
214971,21010,210,10,-2,3,2,1,0,0,0,0,0,0,2,2,0,0,0,0,0,0,0,0,0,0,1,0,1,0,0,0,0,0,0
215053,21010,210,10,-2,2,1,1,0,0,0,0,0,0,0,0,0,0,0,0,0,0,0,2,1,1,0,0,0,0,0,0,0,0,0
215062,21010,210,10,-2,170,71,99,0,0,0,33,16,17,17,7,10,11,3,8,0,0,0,77,28,49,5,2,3,16,9,7,11,6,5
215105,21010,210,10,-2,1,0,1,0,0,0,0,0,0,0,0,0,0,0,0,0,0,0,1,0,1,0,0,0,0,0,0,0,0,0
215114,21010,210,10,-2,3,2,1,0,0,0,0,0,0,0,0,0,0,0,0,0,0,0,3,2,1,0,0,0,0,0,0,0,0,0
215123,21010,210,10,-2,14,7,7,1,1,0,3,0,3,1,1,0,0,0,0,0,0,0,8,5,3,1,0,1,0,0,0,0,0,0
215132,21010,210,10,-2,8,5,3,0,0,0,2,1,1,0,0,0,0,0,0,0,0,0,6,4,2,0,0,0,0,0,0,0,0,0
215239,21010,210,10,-2,12,6,6,0,0,0,2,1,1,4,2,2,2,1,1,0,0,0,4,2,2,0,0,0,0,0,0,0,0,0
215266,21010,210,10,-2,7,6,1,0,0,0,0,0,0,2,2,0,0,0,0,0,0,0,1,1,0,0,0,0,1,0,1,3,3,0
215275,21010,210,10,-2,5,1,4,0,0,0,0,0,0,0,0,0,0,0,0,0,0,0,3,0,3,0,0,0,2,1,1,0,0,0
215284,21010,210,10,-2,4,1,3,0,0,0,0,0,0,0,0,0,0,0,0,0,0,0,3,1,2,0,0,0,0,0,0,1,0,1
215293,21010,210,10,-2,233,107,126,0,0,0,32,16,16,13,2,11,11,5,6,0,0,0,113,55,58,4,1,3,32,11,21,28,17,11
215415,21010,210,10,-2,5,3,2,0,0,0,0,0,0,0,0,0,0,0,0,0,0,0,5,3,2,0,0,0,0,0,0,0,0,0
215424,21010,210,10,-2,1,0,1,0,0,0,0,0,0,1,0,1,0,0,0,0,0,0,0,0,0,0,0,0,0,0,0,0,0,0
215442,21010,210,10,-2,6,3,3,0,0,0,1,0,1,1,1,0,0,0,0,0,0,0,4,2,2,0,0,0,0,0,0,0,0,0
215585,21010,210,10,-2,4,0,4,0,0,0,0,0,0,0,0,0,0,0,0,0,0,0,4,0,4,0,0,0,0,0,0,0,0,0
215655,21010,210,10,-2,6,3,3,0,0,0,0,0,0,0,0,0,1,0,1,0,0,0,1,0,1,0,0,0,0,0,0,4,3,1
215682,21010,210,10,-2,6,6,0,0,0,0,0,0,0,0,0,0,0,0,0,0,0,0,6,6,0,0,0,0,0,0,0,0,0,0
215691,21010,210,10,-2,1,1,0,0,0,0,1,1,0,0,0,0,0,0,0,0,0,0,0,0,0,0,0,0,0,0,0,0,0,0
215743,21010,210,10,-2,15,3,12,0,0,0,0,0,0,0,0,0,0,0,0,0,0,0,15,3,12,0,0,0,0,0,0,0,0,0
215770,21010,210,10,-2,7,2,5,0,0,0,1,0,1,2,0,2,1,0,1,0,0,0,3,2,1,0,0,0,0,0,0,0,0,0
215798,21010,210,10,-2,3,1,2,0,0,0,0,0,0,0,0,0,0,0,0,0,0,0,1,1,0,0,0,0,2,0,2,0,0,0
215929,21010,210,10,-2,14,7,7,0,0,0,0,0,0,2,0,2,0,0,0,0,0,0,5,3,2,0,0,0,2,1,1,5,3,2
215947,21010,210,10,-2,11,3,8,0,0,0,0,0,0,1,0,1,0,0,0,0,0,0,9,3,6,0,0,0,0,0,0,1,0,1
215992,21010,210,10,-2,2,0,2,0,0,0,0,0,0,0,0,0,0,0,0,0,0,0,2,0,2,0,0,0,0,0,0,0,0,0
216010,21010,210,10,-2,1,1,0,0,0,0,0,0,0,1,1,0,0,0,0,0,0,0,0,0,0,0,0,0,0,0,0,0,0,0
216038,21010,210,10,-2,6,3,3,0,0,0,1,1,0,1,0,1,0,0,0,0,0,0,4,2,2,0,0,0,0,0,0,0,0,0
216278,21010,210,10,-2,12,9,3,0,0,0,1,1,0,1,0,1,0,0,0,0,0,0,9,8,1,0,0,0,0,0,0,1,0,1
216287,21010,210,10,-2,32,13,19,3,1,2,3,1,2,2,0,2,2,1,1,0,0,0,15,8,7,0,0,0,2,1,1,5,1,4
216296,21010,210,10,-2,8,7,1,0,0,0,2,2,0,0,0,0,0,0,0,0,0,0,6,5,1,0,0,0,0,0,0,0,0,0
216339,21010,210,10,-2,168,70,98,0,0,0,24,12,12,25,9,16,3,1,2,0,0,0,79,34,45,1,0,1,20,8,12,16,6,10
216357,21010,210,10,-2,4,3,1,0,0,0,0,0,0,0,0,0,0,0,0,0,0,0,4,3,1,0,0,0,0,0,0,0,0,0
216366,21010,210,10,-2,20,5,15,0,0,0,1,0,1,1,0,1,0,0,0,0,0,0,18,5,13,0,0,0,0,0,0,0,0,0
216436,21010,210,10,-2,7,7,0,0,0,0,0,0,0,1,1,0,0,0,0,0,0,0,6,6,0,0,0,0,0,0,0,0,0,0
216445,21010,210,10,-2,3,2,1,0,0,0,0,0,0,0,0,0,0,0,0,0,0,0,3,2,1,0,0,0,0,0,0,0,0,0
216454,21010,210,10,-2,2,2,0,0,0,0,0,0,0,0,0,0,0,0,0,0,0,0,2,2,0,0,0,0,0,0,0,0,0,0
216463,21010,210,10,-2,2,2,0,0,0,0,0,0,0,0,0,0,0,0,0,0,0,0,2,2,0,0,0,0,0,0,0,0,0,0
216524,21010,210,10,-2,7,4,3,0,0,0,0,0,0,0,0,0,0,0,0,0,0,0,6,3,3,0,0,0,0,0,0,1,1,0
216542,21010,210,10,-2,2,0,2,0,0,0,0,0,0,0,0,0,0,0,0,0,0,0,2,0,2,0,0,0,0,0,0,0,0,0
216597,21010,210,10,-2,56,26,30,1,0,1,5,4,1,4,2,2,3,3,0,0,0,0,34,12,22,2,0,2,0,0,0,7,5,2
216667,21010,210,10,-2,5,1,4,0,0,0,1,0,1,0,0,0,0,0,0,0,0,0,4,1,3,0,0,0,0,0,0,0,0,0
216694,21010,210,10,-2,8,2,6,0,0,0,0,0,0,0,0,0,1,0,1,0,0,0,7,2,5,0,0,0,0,0,0,0,0,0
216764,21010,210,10,-2,25,11,14,0,0,0,4,4,0,5,2,3,0,0,0,0,0,0,13,3,10,1,0,1,0,0,0,2,2,0
216807,21010,210,10,-2,5,3,2,0,0,0,0,0,0,0,0,0,0,0,0,0,0,0,5,3,2,0,0,0,0,0,0,0,0,0
216816,21010,210,10,-2,1,1,0,0,0,0,0,0,0,0,0,0,1,1,0,0,0,0,0,0,0,0,0,0,0,0,0,0,0,0
216825,21010,210,10,-2,3,2,1,0,0,0,0,0,0,0,0,0,0,0,0,0,0,0,3,2,1,0,0,0,0,0,0,0,0,0
216852,21010,210,10,-2,31,10,21,0,0,0,5,2,3,3,0,3,2,1,1,0,0,0,13,2,11,0,0,0,0,0,0,8,5,3
216931,21010,210,10,-2,7,2,5,1,0,1,1,0,1,1,1,0,0,0,0,0,0,0,3,1,2,1,0,1,0,0,0,0,0,0
216940,21010,210,10,-2,1,1,0,0,0,0,0,0,0,0,0,0,0,0,0,0,0,0,1,1,0,0,0,0,0,0,0,0,0,0
217013,21010,210,10,-2,4,2,2,0,0,0,0,0,0,0,0,0,0,0,0,0,0,0,3,1,2,0,0,0,1,1,0,0,0,0
217059,21010,210,10,-2,6,3,3,0,0,0,2,1,1,1,0,1,0,0,0,0,0,0,2,1,1,0,0,0,0,0,0,1,1,0
217156,21010,210,10,-2,90,36,54,0,0,0,8,3,5,11,3,8,6,4,2,0,0,0,40,15,25,2,2,0,5,2,3,18,7,11
217165,21010,210,10,-2,2,0,2,0,0,0,1,0,1,0,0,0,0,0,0,0,0,0,0,0,0,0,0,0,0,0,0,1,0,1
217235,21010,210,10,-2,9,2,7,0,0,0,0,0,0,2,1,1,0,0,0,0,0,0,4,1,3,0,0,0,2,0,2,1,0,1
217402,21010,210,10,-2,39,18,21,0,0,0,1,1,0,3,1,2,0,0,0,0,0,0,30,13,17,2,1,1,0,0,0,3,2,1
217420,21010,210,10,-2,2,0,2,0,0,0,0,0,0,1,0,1,0,0,0,0,0,0,1,0,1,0,0,0,0,0,0,0,0,0
217475,21010,210,10,-2,14,4,10,0,0,0,1,0,1,1,1,0,1,1,0,0,0,0,11,2,9,0,0,0,0,0,0,0,0,0
217484,21010,210,10,-2,62,22,40,0,0,0,5,1,4,6,0,6,1,1,0,0,0,0,45,18,27,0,0,0,0,0,0,5,2,3
217493,21010,210,10,-2,19,5,14,0,0,0,1,0,1,5,1,4,0,0,0,0,0,0,3,2,1,0,0,0,3,0,3,7,2,5
217518,21010,210,10,-2,7,2,5,0,0,0,0,0,0,1,0,1,0,0,0,0,0,0,2,1,1,0,0,0,0,0,0,4,1,3
217536,21010,210,10,-2,7,3,4,0,0,0,1,1,0,0,0,0,0,0,0,0,0,0,6,2,4,0,0,0,0,0,0,0,0,0
217615,21010,210,10,-2,4,2,2,0,0,0,0,0,0,0,0,0,0,0,0,0,0,0,4,2,2,0,0,0,0,0,0,0,0,0
217624,21010,210,10,-2,16,9,7,0,0,0,0,0,0,12,6,6,0,0,0,0,0,0,4,3,1,0,0,0,0,0,0,0,0,0
217633,21010,210,10,-2,18,9,9,0,0,0,1,0,1,1,0,1,1,0,1,0,0,0,15,9,6,0,0,0,0,0,0,0,0,0
217688,21010,210,10,-2,20,6,14,0,0,0,0,0,0,0,0,0,0,0,0,0,0,0,19,6,13,1,0,1,0,0,0,0,0,0
217712,21010,210,10,-2,2,2,0,0,0,0,0,0,0,0,0,0,0,0,0,0,0,0,2,2,0,0,0,0,0,0,0,0,0,0
217721,21010,210,10,-2,10,7,3,0,0,0,1,1,0,8,6,2,1,0,1,0,0,0,0,0,0,0,0,0,0,0,0,0,0,0
217749,21010,210,10,-2,10,6,4,0,0,0,0,0,0,0,0,0,0,0,0,0,0,0,10,6,4,0,0,0,0,0,0,0,0,0
217776,21010,210,10,-2,4,2,2,0,0,0,0,0,0,0,0,0,0,0,0,0,0,0,3,2,1,1,0,1,0,0,0,0,0,0
217819,21010,210,10,-2,33,18,15,0,0,0,0,0,0,4,2,2,4,3,1,1,0,1,16,8,8,0,0,0,0,0,0,8,5,3
217837,21010,210,10,-2,7,0,7,0,0,0,0,0,0,4,0,4,0,0,0,0,0,0,3,0,3,0,0,0,0,0,0,0,0,0
217864,21010,210,10,-2,15,8,7,0,0,0,0,0,0,0,0,0,2,0,2,0,0,0,2,1,1,1,0,1,9,6,3,1,1,0
217873,21010,210,10,-2,12,5,7,0,0,0,1,1,0,8,2,6,1,1,0,0,0,0,2,1,1,0,0,0,0,0,0,0,0,0
217882,21010,210,10,-2,61,34,27,0,0,0,5,3,2,0,0,0,0,0,0,0,0,0,47,27,20,0,0,0,0,0,0,9,4,5
217907,21010,210,10,-2,5,2,3,0,0,0,0,0,0,0,0,0,0,0,0,0,0,0,5,2,3,0,0,0,0,0,0,0,0,0
217925,21010,210,10,-2,5,3,2,0,0,0,0,0,0,0,0,0,0,0,0,0,0,0,5,3,2,0,0,0,0,0,0,0,0,0
217934,21010,210,10,-2,7,2,5,0,0,0,0,0,0,1,0,1,0,0,0,0,0,0,6,2,4,0,0,0,0,0,0,0,0,0
217961,21010,210,10,-2,4,0,4,0,0,0,0,0,0,0,0,0,1,0,1,0,0,0,3,0,3,0,0,0,0,0,0,0,0,0
217998,21010,210,10,-2,4,2,2,0,0,0,0,0,0,0,0,0,0,0,0,0,0,0,4,2,2,0,0,0,0,0,0,0,0,0
218025,21010,210,10,-2,6,2,4,0,0,0,0,0,0,2,1,1,0,0,0,0,0,0,4,1,3,0,0,0,0,0,0,0,0,0
218061,21010,210,10,-2,5,4,1,0,0,0,0,0,0,0,0,0,0,0,0,0,0,0,5,4,1,0,0,0,0,0,0,0,0,0
218070,21010,210,10,-2,14,4,10,0,0,0,2,1,1,4,1,3,0,0,0,0,0,0,7,2,5,1,0,1,0,0,0,0,0,0
218113,21010,210,10,-2,29,7,22,0,0,0,1,0,1,5,1,4,0,0,0,0,0,0,23,6,17,0,0,0,0,0,0,0,0,0
218140,21010,210,10,-2,15,4,11,0,0,0,0,0,0,1,0,1,0,0,0,0,0,0,14,4,10,0,0,0,0,0,0,0,0,0
218229,21010,210,10,-2,26,6,20,0,0,0,0,0,0,2,0,2,1,1,0,0,0,0,23,5,18,0,0,0,0,0,0,0,0,0
218238,21010,210,10,-2,7,2,5,0,0,0,0,0,0,2,0,2,0,0,0,0,0,0,5,2,3,0,0,0,0,0,0,0,0,0
218335,21010,210,10,-2,4,1,3,0,0,0,0,0,0,0,0,0,0,0,0,0,0,0,4,1,3,0,0,0,0,0,0,0,0,0
218353,21010,210,10,-2,12,3,9,0,0,0,1,0,1,2,1,1,2,1,1,0,0,0,7,1,6,0,0,0,0,0,0,0,0,0
218399,21010,210,10,-2,2,1,1,0,0,0,0,0,0,2,1,1,0,0,0,0,0,0,0,0,0,0,0,0,0,0,0,0,0,0
218414,21010,210,10,-2,5,4,1,0,0,0,0,0,0,4,3,1,0,0,0,0,0,0,1,1,0,0,0,0,0,0,0,0,0,0
218441,21010,210,10,-2,14,9,5,0,0,0,0,0,0,1,1,0,0,0,0,0,0,0,13,8,5,0,0,0,0,0,0,0,0,0
218487,21010,210,10,-2,8,3,5,0,0,0,0,0,0,2,0,2,0,0,0,0,0,0,6,3,3,0,0,0,0,0,0,0,0,0
218520,21010,210,10,-2,15,6,9,0,0,0,0,0,0,5,2,3,1,0,1,0,0,0,9,4,5,0,0,0,0,0,0,0,0,0
218539,21010,210,10,-2,10,3,7,0,0,0,2,1,1,2,0,2,0,0,0,0,0,0,6,2,4,0,0,0,0,0,0,0,0,0
218645,21010,210,10,-2,9,3,6,0,0,0,1,0,1,0,0,0,0,0,0,0,0,0,8,3,5,0,0,0,0,0,0,0,0,0
218654,21010,210,10,-2,1,1,0,0,0,0,0,0,0,0,0,0,0,0,0,0,0,0,1,1,0,0,0,0,0,0,0,0,0,0
218663,21010,210,10,-2,70,29,41,0,0,0,4,3,1,11,5,6,2,0,2,0,0,0,41,14,27,5,3,2,1,0,1,6,4,2
218681,21010,210,10,-2,1,0,1,0,0,0,0,0,0,0,0,0,0,0,0,0,0,0,1,0,1,0,0,0,0,0,0,0,0,0
218690,21010,210,10,-2,6,2,4,0,0,0,1,0,1,0,0,0,1,0,1,0,0,0,4,2,2,0,0,0,0,0,0,0,0,0
218706,21010,210,10,-2,1,0,1,0,0,0,0,0,0,0,0,0,0,0,0,0,0,0,1,0,1,0,0,0,0,0,0,0,0,0
218724,21010,210,10,-2,28,16,12,0,0,0,3,3,0,3,2,1,1,0,1,0,0,0,19,10,9,1,1,0,1,0,1,0,0,0
218733,21010,210,10,-2,3,3,0,0,0,0,0,0,0,3,3,0,0,0,0,0,0,0,0,0,0,0,0,0,0,0,0,0,0,0
218742,21010,210,10,-2,13,2,11,0,0,0,0,0,0,2,0,2,0,0,0,0,0,0,10,2,8,1,0,1,0,0,0,0,0,0
218751,21010,210,10,-2,4,2,2,0,0,0,0,0,0,0,0,0,0,0,0,0,0,0,3,1,2,1,1,0,0,0,0,0,0,0
218821,21010,210,10,-2,4,1,3,0,0,0,0,0,0,1,1,0,0,0,0,0,0,0,3,0,3,0,0,0,0,0,0,0,0,0
218830,21010,210,10,-2,16,4,12,0,0,0,1,1,0,1,0,1,1,0,1,0,0,0,13,3,10,0,0,0,0,0,0,0,0,0
218858,21010,210,10,-2,7,3,4,0,0,0,0,0,0,2,1,1,0,0,0,0,0,0,5,2,3,0,0,0,0,0,0,0,0,0
218885,21010,210,10,-2,11,5,6,0,0,0,0,0,0,3,1,2,1,0,1,0,0,0,7,4,3,0,0,0,0,0,0,0,0,0
218894,21010,210,10,-2,16,6,10,0,0,0,1,0,1,2,1,1,0,0,0,0,0,0,13,5,8,0,0,0,0,0,0,0,0,0
218919,21010,210,10,-2,4,3,1,0,0,0,0,0,0,4,3,1,0,0,0,0,0,0,0,0,0,0,0,0,0,0,0,0,0,0
218955,21010,210,10,-2,6,3,3,0,0,0,0,0,0,2,1,1,0,0,0,0,0,0,4,2,2,0,0,0,0,0,0,0,0,0
218964,21010,210,10,-2,3,1,2,0,0,0,0,0,0,0,0,0,0,0,0,0,0,0,3,1,2,0,0,0,0,0,0,0,0,0
218973,21010,210,10,-2,11,5,6,0,0,0,3,1,2,1,0,1,0,0,0,0,0,0,6,4,2,0,0,0,1,0,1,0,0,0
218991,21010,210,10,-2,18,9,9,0,0,0,0,0,0,3,1,2,0,0,0,0,0,0,15,8,7,0,0,0,0,0,0,0,0,0
219000,21010,210,10,-2,8,4,4,0,0,0,2,2,0,1,0,1,1,1,0,0,0,0,3,0,3,1,1,0,0,0,0,0,0,0
219046,21010,210,10,-2,4,4,0,0,0,0,0,0,0,0,0,0,0,0,0,0,0,0,4,4,0,0,0,0,0,0,0,0,0,0
219082,21010,210,10,-2,9,7,2,0,0,0,1,1,0,0,0,0,0,0,0,0,0,0,7,6,1,0,0,0,0,0,0,1,0,1
219091,21010,210,10,-2,7,3,4,0,0,0,0,0,0,0,0,0,0,0,0,0,0,0,7,3,4,0,0,0,0,0,0,0,0,0
219143,21010,210,10,-2,15,10,5,0,0,0,0,0,0,0,0,0,0,0,0,0,0,0,15,10,5,0,0,0,0,0,0,0,0,0
219189,21010,210,10,-2,7,3,4,0,0,0,0,0,0,0,0,0,0,0,0,0,0,0,7,3,4,0,0,0,0,0,0,0,0,0
219198,21010,210,10,-2,4,1,3,0,0,0,0,0,0,0,0,0,0,0,0,0,0,0,4,1,3,0,0,0,0,0,0,0,0,0
219259,21010,210,10,-2,9,2,7,0,0,0,0,0,0,1,0,1,0,0,0,0,0,0,6,2,4,0,0,0,0,0,0,2,0,2
219277,21010,210,10,-2,7,3,4,3,2,1,0,0,0,0,0,0,0,0,0,0,0,0,4,1,3,0,0,0,0,0,0,0,0,0
219295,21010,210,10,-2,4,0,4,0,0,0,0,0,0,0,0,0,0,0,0,0,0,0,4,0,4,0,0,0,0,0,0,0,0,0
219347,21010,210,10,-2,15,13,2,0,0,0,1,1,0,0,0,0,0,0,0,0,0,0,9,8,1,0,0,0,0,0,0,5,4,1
219356,21010,210,10,-2,32,19,13,1,0,1,4,4,0,0,0,0,0,0,0,0,0,0,18,8,10,0,0,0,0,0,0,9,7,2
219374,21010,210,10,-2,3,2,1,2,2,0,0,0,0,0,0,0,0,0,0,0,0,0,1,0,1,0,0,0,0,0,0,0,0,0
219383,21010,210,10,-2,2,2,0,0,0,0,0,0,0,0,0,0,0,0,0,0,0,0,2,2,0,0,0,0,0,0,0,0,0,0
219408,21010,210,10,-2,1,1,0,0,0,0,0,0,0,0,0,0,0,0,0,0,0,0,1,1,0,0,0,0,0,0,0,0,0,0
219426,21010,210,10,-2,15,4,11,0,0,0,0,0,0,0,0,0,0,0,0,0,0,0,15,4,11,0,0,0,0,0,0,0,0,0
219471,21010,210,10,-2,32,16,16,0,0,0,3,2,1,1,0,1,3,2,1,0,0,0,22,11,11,0,0,0,0,0,0,3,1,2
219480,21010,210,10,-2,12,7,5,0,0,0,0,0,0,0,0,0,0,0,0,0,0,0,9,5,4,2,2,0,1,0,1,0,0,0
219505,21010,210,10,-2,1,0,1,0,0,0,0,0,0,1,0,1,0,0,0,0,0,0,0,0,0,0,0,0,0,0,0,0,0,0
219602,21010,210,10,-2,24,9,15,0,0,0,0,0,0,4,1,3,0,0,0,0,0,0,16,6,10,1,0,1,2,1,1,1,1,0
219639,21010,210,10,-2,7,2,5,0,0,0,0,0,0,3,0,3,0,0,0,0,0,0,4,2,2,0,0,0,0,0,0,0,0,0
219709,21010,210,10,-2,39,17,22,0,0,0,0,0,0,10,4,6,0,0,0,0,0,0,25,13,12,0,0,0,2,0,2,2,0,2
219718,21010,210,10,-2,4,1,3,0,0,0,0,0,0,0,0,0,0,0,0,0,0,0,4,1,3,0,0,0,0,0,0,0,0,0
219790,21010,210,10,-2,6,4,2,0,0,0,0,0,0,0,0,0,0,0,0,0,0,0,6,4,2,0,0,0,0,0,0,0,0,0
219806,21010,210,10,-2,5,2,3,0,0,0,0,0,0,0,0,0,0,0,0,0,0,0,5,2,3,0,0,0,0,0,0,0,0,0
219824,21010,210,10,-2,32,12,20,1,1,0,1,0,1,1,0,1,1,1,0,0,0,0,26,9,17,2,1,1,0,0,0,0,0,0
219833,21010,210,10,-2,11,3,8,0,0,0,0,0,0,1,0,1,0,0,0,0,0,0,10,3,7,0,0,0,0,0,0,0,0,0
219879,21010,210,10,-2,7,3,4,0,0,0,0,0,0,0,0,0,0,0,0,0,0,0,7,3,4,0,0,0,0,0,0,0,0,0
219888,21010,210,10,-2,17,5,12,1,0,1,3,1,2,0,0,0,0,0,0,0,0,0,12,4,8,0,0,0,1,0,1,0,0,0
219903,21010,210,10,-2,14,1,13,0,0,0,0,0,0,8,0,8,0,0,0,0,0,0,5,0,5,0,0,0,1,1,0,0,0,0
219949,21010,210,10,-2,10,5,5,0,0,0,0,0,0,1,0,1,0,0,0,0,0,0,9,5,4,0,0,0,0,0,0,0,0,0
219976,21010,210,10,-2,14,7,7,0,0,0,1,0,1,1,1,0,0,0,0,0,0,0,10,4,6,0,0,0,2,2,0,0,0,0
220057,21010,210,10,-2,5,3,2,0,0,0,0,0,0,1,1,0,0,0,0,0,0,0,3,1,2,0,0,0,1,1,0,0,0,0
220075,21010,210,10,-2,106,47,59,0,0,0,4,2,2,4,1,3,1,0,1,0,0,0,81,33,48,2,0,2,3,2,1,11,9,2
220118,21010,210,10,-2,6,0,6,0,0,0,0,0,0,1,0,1,0,0,0,0,0,0,5,0,5,0,0,0,0,0,0,0,0,0
220181,21010,210,10,-2,3,2,1,0,0,0,0,0,0,2,2,0,0,0,0,0,0,0,1,0,1,0,0,0,0,0,0,0,0,0
220206,21010,210,10,-2,1,1,0,0,0,0,0,0,0,0,0,0,0,0,0,0,0,0,1,1,0,0,0,0,0,0,0,0,0,0
220215,21010,210,10,-2,11,6,5,0,0,0,0,0,0,1,1,0,0,0,0,0,0,0,10,5,5,0,0,0,0,0,0,0,0,0
220400,21010,210,10,-2,1,1,0,0,0,0,0,0,0,0,0,0,0,0,0,0,0,0,1,1,0,0,0,0,0,0,0,0,0,0
220473,21010,210,10,-2,2,2,0,0,0,0,0,0,0,0,0,0,0,0,0,0,0,0,2,2,0,0,0,0,0,0,0,0,0,0
220516,21010,210,10,-2,6,0,6,0,0,0,0,0,0,0,0,0,0,0,0,0,0,0,6,0,6,0,0,0,0,0,0,0,0,0
220552,21010,210,10,-2,56,15,41,1,1,0,4,0,4,7,1,6,2,1,1,0,0,0,40,11,29,2,1,1,0,0,0,0,0,0
220598,21010,210,10,-2,15,8,7,0,0,0,1,1,0,7,3,4,3,1,2,0,0,0,4,3,1,0,0,0,0,0,0,0,0,0
220604,21010,210,10,-2,6,2,4,0,0,0,0,0,0,6,2,4,0,0,0,0,0,0,0,0,0,0,0,0,0,0,0,0,0,0
220613,21010,210,10,-2,7,4,3,0,0,0,1,0,1,0,0,0,0,0,0,0,0,0,6,4,2,0,0,0,0,0,0,0,0,0
220631,21010,210,10,-2,75,28,47,0,0,0,1,1,0,2,2,0,2,1,1,0,0,0,63,22,41,0,0,0,7,2,5,0,0,0
220710,21010,210,10,-2,5,1,4,0,0,0,0,0,0,0,0,0,0,0,0,0,0,0,5,1,4,0,0,0,0,0,0,0,0,0
220792,21010,210,10,-2,10,6,4,0,0,0,2,1,1,8,5,3,0,0,0,0,0,0,0,0,0,0,0,0,0,0,0,0,0,0
220862,21010,210,10,-2,74,34,40,0,0,0,9,4,5,17,6,11,3,3,0,0,0,0,42,18,24,0,0,0,2,2,0,1,1,0
220978,21010,210,10,-2,79,35,44,0,0,0,2,1,1,9,2,7,3,2,1,0,0,0,58,26,32,0,0,0,0,0,0,7,4,3
220996,21010,210,10,-2,2,1,1,0,0,0,0,0,0,0,0,0,0,0,0,0,0,0,2,1,1,0,0,0,0,0,0,0,0,0
221096,21010,210,10,-2,3,2,1,0,0,0,0,0,0,0,0,0,0,0,0,0,0,0,3,2,1,0,0,0,0,0,0,0,0,0
221148,21010,210,10,-2,22,22,0,0,0,0,0,0,0,0,0,0,0,0,0,0,0,0,22,22,0,0,0,0,0,0,0,0,0,0
221184,21010,210,10,-2,11,4,7,0,0,0,0,0,0,1,0,1,0,0,0,0,0,0,8,4,4,0,0,0,0,0,0,2,0,2
221351,21010,210,10,-2,20,12,8,0,0,0,1,1,0,1,1,0,2,1,1,0,0,0,6,3,3,0,0,0,6,3,3,4,3,1
221397,21010,210,10,-2,17,5,12,0,0,0,0,0,0,0,0,0,0,0,0,0,0,0,16,5,11,0,0,0,1,0,1,0,0,0
221485,21010,210,10,-2,13,7,6,0,0,0,0,0,0,4,2,2,1,0,1,0,0,0,8,5,3,0,0,0,0,0,0,0,0,0
221519,21010,210,10,-2,13,8,5,0,0,0,1,1,0,0,0,0,0,0,0,0,0,0,9,5,4,0,0,0,1,1,0,2,1,1
221643,21010,210,10,-2,6,5,1,0,0,0,0,0,0,1,1,0,1,1,0,0,0,0,2,2,0,1,0,1,1,1,0,0,0,0
221661,21010,210,10,-2,8,3,5,0,0,0,3,2,1,2,0,2,0,0,0,0,0,0,3,1,2,0,0,0,0,0,0,0,0,0
221670,21010,210,10,-2,4,2,2,0,0,0,1,0,1,0,0,0,0,0,0,0,0,0,3,2,1,0,0,0,0,0,0,0,0,0
221731,21010,210,10,-2,2,0,2,0,0,0,0,0,0,0,0,0,0,0,0,0,0,0,2,0,2,0,0,0,0,0,0,0,0,0
221740,21010,210,10,-2,35,18,17,0,0,0,4,2,2,3,0,3,0,0,0,0,0,0,20,11,9,0,0,0,0,0,0,8,5,3
221759,21010,210,10,-2,104,44,60,1,0,1,8,6,2,19,8,11,6,0,6,0,0,0,58,24,34,1,0,1,0,0,0,11,6,5
221768,21010,210,10,-2,17,5,12,0,0,0,0,0,0,3,0,3,0,0,0,0,0,0,13,5,8,0,0,0,0,0,0,1,0,1
221838,21010,210,10,-2,28,13,15,0,0,0,2,2,0,9,4,5,2,0,2,0,0,0,13,6,7,0,0,0,0,0,0,2,1,1
221847,21010,210,10,-2,35,16,19,0,0,0,1,1,0,0,0,0,0,0,0,0,0,0,23,7,16,1,1,0,3,2,1,7,5,2
221892,21010,210,10,-2,5,4,1,0,0,0,1,1,0,0,0,0,0,0,0,0,0,0,4,3,1,0,0,0,0,0,0,0,0,0
221908,21010,210,10,-2,4,1,3,0,0,0,0,0,0,0,0,0,0,0,0,0,0,0,4,1,3,0,0,0,0,0,0,0,0,0
221953,21010,210,10,-2,8,3,5,0,0,0,1,1,0,0,0,0,0,0,0,0,0,0,7,2,5,0,0,0,0,0,0,0,0,0
221971,21010,210,10,-2,17,9,8,0,0,0,0,0,0,2,2,0,0,0,0,0,0,0,15,7,8,0,0,0,0,0,0,0,0,0
221999,21010,210,10,-2,76,33,43,0,0,0,0,0,0,3,2,1,1,0,1,0,0,0,18,7,11,0,0,0,43,18,25,11,6,5
222053,21010,210,10,-2,13,9,4,0,0,0,0,0,0,3,2,1,0,0,0,0,0,0,10,7,3,0,0,0,0,0,0,0,0,0
222062,21010,210,10,-2,14,7,7,0,0,0,0,0,0,0,0,0,0,0,0,0,0,0,14,7,7,0,0,0,0,0,0,0,0,0
222105,21010,210,10,-2,7,7,0,0,0,0,0,0,0,3,3,0,0,0,0,0,0,0,4,4,0,0,0,0,0,0,0,0,0,0
222178,21010,210,10,-2,12,7,5,0,0,0,0,0,0,2,0,2,1,0,1,0,0,0,7,5,2,0,0,0,2,2,0,0,0,0
222567,21010,210,10,-2,9,4,5,0,0,0,0,0,0,1,1,0,1,1,0,0,0,0,5,1,4,0,0,0,2,1,1,0,0,0
222576,21010,210,10,-2,11,5,6,0,0,0,0,0,0,1,0,1,2,0,2,0,0,0,8,5,3,0,0,0,0,0,0,0,0,0
222628,21010,210,10,-2,1,0,1,0,0,0,0,0,0,0,0,0,0,0,0,0,0,0,1,0,1,0,0,0,0,0,0,0,0,0
222822,21010,210,10,-2,8,4,4,0,0,0,1,0,1,0,0,0,0,0,0,0,0,0,7,4,3,0,0,0,0,0,0,0,0,0
222831,21010,210,10,-2,25,9,16,0,0,0,3,0,3,2,1,1,1,1,0,0,0,0,17,6,11,0,0,0,2,1,1,0,0,0
222877,21010,210,10,-2,1,1,0,0,0,0,0,0,0,0,0,0,0,0,0,0,0,0,1,1,0,0,0,0,0,0,0,0,0,0
222983,21010,210,10,-2,6,3,3,0,0,0,0,0,0,1,0,1,1,1,0,0,0,0,3,2,1,0,0,0,0,0,0,1,0,1
222992,21010,210,10,-2,18,10,8,0,0,0,1,1,0,4,1,3,2,2,0,0,0,0,11,6,5,0,0,0,0,0,0,0,0,0
223083,21010,210,10,-2,4,0,4,0,0,0,0,0,0,0,0,0,0,0,0,0,0,0,4,0,4,0,0,0,0,0,0,0,0,0
223223,21010,210,10,-2,293,113,180,0,0,0,86,43,43,22,4,18,22,6,16,1,0,1,122,38,84,5,3,2,35,19,16,0,0,0
223232,21010,210,10,-2,34,11,23,0,0,0,3,2,1,4,0,4,1,0,1,0,0,0,20,7,13,0,0,0,5,1,4,1,1,0
223320,21010,210,10,-2,4,1,3,0,0,0,0,0,0,1,1,0,0,0,0,0,0,0,2,0,2,0,0,0,1,0,1,0,0,0
223427,21010,210,10,-2,7,2,5,0,0,0,0,0,0,3,1,2,0,0,0,0,0,0,4,1,3,0,0,0,0,0,0,0,0,0
223506,21010,210,10,-2,5,3,2,0,0,0,0,0,0,1,0,1,0,0,0,0,0,0,3,2,1,1,1,0,0,0,0,0,0,0
223816,21010,210,10,-2,6,1,5,0,0,0,0,0,0,0,0,0,1,0,1,0,0,0,3,1,2,2,0,2,0,0,0,0,0,0
223898,21010,210,10,-2,10,5,5,0,0,0,0,0,0,0,0,0,1,0,1,0,0,0,8,5,3,0,0,0,1,0,1,0,0,0
223922,21010,210,10,-2,5,3,2,0,0,0,0,0,0,0,0,0,0,0,0,0,0,0,5,3,2,0,0,0,0,0,0,0,0,0
224004,21010,210,10,-2,4,0,4,0,0,0,1,0,1,1,0,1,0,0,0,0,0,0,2,0,2,0,0,0,0,0,0,0,0,0
224110,21010,210,10,-2,12,5,7,1,0,1,0,0,0,1,0,1,0,0,0,0,0,0,7,3,4,2,1,1,1,1,0,0,0,0
224147,21010,210,10,-2,22,6,16,0,0,0,4,1,3,1,0,1,2,1,1,0,0,0,11,2,9,1,1,0,0,0,0,3,1,2
224226,21010,210,10,-2,6,2,4,0,0,0,0,0,0,1,0,1,0,0,0,0,0,0,5,2,3,0,0,0,0,0,0,0,0,0
224244,21010,210,10,-2,1,0,1,0,0,0,0,0,0,0,0,0,0,0,0,0,0,0,1,0,1,0,0,0,0,0,0,0,0,0
224305,21010,210,10,-2,3,3,0,0,0,0,1,1,0,0,0,0,0,0,0,0,0,0,2,2,0,0,0,0,0,0,0,0,0,0
224323,21010,210,10,-2,7,3,4,0,0,0,0,0,0,0,0,0,0,0,0,0,0,0,7,3,4,0,0,0,0,0,0,0,0,0
224350,21010,210,10,-2,14,10,4,0,0,0,1,1,0,0,0,0,5,4,1,0,0,0,8,5,3,0,0,0,0,0,0,0,0,0
224527,21010,210,10,-2,16,5,11,1,0,1,1,1,0,0,0,0,0,0,0,0,0,0,14,4,10,0,0,0,0,0,0,0,0,0
224545,21010,210,10,-2,6,4,2,0,0,0,0,0,0,0,0,0,0,0,0,0,0,0,3,2,1,0,0,0,1,0,1,2,2,0
224554,21010,210,10,-2,25,10,15,0,0,0,1,1,0,2,0,2,2,1,1,0,0,0,12,5,7,0,0,0,1,0,1,7,3,4
224615,21010,210,10,-2,30,8,22,0,0,0,6,1,5,10,2,8,3,2,1,0,0,0,11,3,8,0,0,0,0,0,0,0,0,0
224642,21010,210,10,-2,24,6,18,0,0,0,0,0,0,0,0,0,14,3,11,0,0,0,8,2,6,0,0,0,0,0,0,2,1,1
224660,21010,210,10,-2,16,9,7,0,0,0,0,0,0,0,0,0,9,6,3,0,0,0,5,2,3,1,0,1,1,1,0,0,0,0
224679,21010,210,10,-2,15,14,1,0,0,0,0,0,0,0,0,0,15,14,1,0,0,0,0,0,0,0,0,0,0,0,0,0,0,0
224712,21010,210,10,-2,4,1,3,0,0,0,1,0,1,2,1,1,1,0,1,0,0,0,0,0,0,0,0,0,0,0,0,0,0,0
224891,21010,210,10,-2,1,0,1,0,0,0,0,0,0,0,0,0,0,0,0,0,0,0,1,0,1,0,0,0,0,0,0,0,0,0
224961,21010,210,10,-2,6,2,4,0,0,0,1,1,0,1,0,1,4,1,3,0,0,0,0,0,0,0,0,0,0,0,0,0,0,0
225070,21010,210,10,-2,13,6,7,0,0,0,1,0,1,0,0,0,1,0,1,0,0,0,11,6,5,0,0,0,0,0,0,0,0,0
225201,21010,210,10,-2,10,5,5,0,0,0,1,1,0,2,2,0,4,1,3,0,0,0,3,1,2,0,0,0,0,0,0,0,0,0
225247,21010,210,10,-2,5,1,4,0,0,0,0,0,0,0,0,0,0,0,0,0,0,0,5,1,4,0,0,0,0,0,0,0,0,0
225308,21010,210,10,-2,10,2,8,0,0,0,0,0,0,1,1,0,0,0,0,0,0,0,9,1,8,0,0,0,0,0,0,0,0,0
225371,21010,210,10,-2,5,2,3,0,0,0,1,1,0,0,0,0,0,0,0,0,0,0,4,1,3,0,0,0,0,0,0,0,0,0
225399,21010,210,10,-2,16,6,10,0,0,0,0,0,0,3,0,3,1,0,1,0,0,0,12,6,6,0,0,0,0,0,0,0,0,0
225414,21010,210,10,-2,1,0,1,0,0,0,0,0,0,1,0,1,0,0,0,0,0,0,0,0,0,0,0,0,0,0,0,0,0,0
225423,21010,210,10,-2,25,13,12,0,0,0,2,0,2,6,1,5,4,3,1,0,0,0,9,7,2,2,1,1,2,1,1,0,0,0
225432,21010,210,10,-2,21,10,11,0,0,0,1,1,0,2,1,1,5,2,3,0,0,0,7,4,3,0,0,0,0,0,0,6,2,4
225502,21010,210,10,-2,5,1,4,0,0,0,0,0,0,2,0,2,1,0,1,0,0,0,2,1,1,0,0,0,0,0,0,0,0,0
225511,21010,210,10,-2,75,51,24,0,0,0,16,9,7,4,3,1,7,2,5,0,0,0,22,16,6,0,0,0,1,1,0,25,20,5
225520,21010,210,10,-2,6,4,2,0,0,0,1,1,0,0,0,0,1,0,1,0,0,0,4,3,1,0,0,0,0,0,0,0,0,0
225548,21010,210,10,-2,3,2,1,0,0,0,0,0,0,0,0,0,2,2,0,0,0,0,1,0,1,0,0,0,0,0,0,0,0,0
225627,21010,210,10,-2,33,14,19,0,0,0,3,1,2,1,0,1,9,4,5,0,0,0,13,6,7,3,0,3,0,0,0,4,3,1
225885,21010,210,10,-2,1,1,0,0,0,0,0,0,0,0,0,0,1,1,0,0,0,0,0,0,0,0,0,0,0,0,0,0,0,0
226019,21010,210,10,-2,13,5,8,0,0,0,0,0,0,0,0,0,0,0,0,0,0,0,13,5,8,0,0,0,0,0,0,0,0,0
226091,21010,210,10,-2,18,10,8,0,0,0,2,2,0,1,0,1,0,0,0,0,0,0,13,6,7,0,0,0,2,2,0,0,0,0
226116,21010,210,10,-2,10,4,6,0,0,0,0,0,0,2,0,2,2,1,1,0,0,0,6,3,3,0,0,0,0,0,0,0,0,0
226134,21010,210,10,-2,11,5,6,0,0,0,1,1,0,0,0,0,10,4,6,0,0,0,0,0,0,0,0,0,0,0,0,0,0,0
226152,21010,210,10,-2,27,9,18,0,0,0,3,1,2,1,0,1,7,1,6,0,0,0,10,6,4,1,0,1,2,1,1,3,0,3
226204,21010,210,10,-2,15,9,6,0,0,0,0,0,0,4,3,1,2,1,1,0,0,0,8,5,3,0,0,0,1,0,1,0,0,0
226231,21010,210,10,-2,12,6,6,0,0,0,1,0,1,0,0,0,0,0,0,0,0,0,11,6,5,0,0,0,0,0,0,0,0,0
226277,21010,210,10,-2,35,31,4,0,0,0,1,1,0,2,2,0,4,4,0,0,0,0,26,22,4,1,1,0,1,1,0,0,0,0
226383,21010,210,10,-2,3,2,1,0,0,0,0,0,0,0,0,0,0,0,0,0,0,0,3,2,1,0,0,0,0,0,0,0,0,0
226408,21010,210,10,-2,5,3,2,0,0,0,0,0,0,1,1,0,0,0,0,0,0,0,2,2,0,2,0,2,0,0,0,0,0,0
226471,21010,210,10,-2,20,7,13,1,0,1,2,1,1,1,0,1,2,1,1,0,0,0,14,5,9,0,0,0,0,0,0,0,0,0
226578,21010,210,10,-2,7,4,3,0,0,0,0,0,0,1,1,0,0,0,0,0,0,0,6,3,3,0,0,0,0,0,0,0,0,0
226587,21010,210,10,-2,5,3,2,0,0,0,0,0,0,0,0,0,0,0,0,0,0,0,5,3,2,0,0,0,0,0,0,0,0,0
226806,21010,210,10,-2,8,3,5,0,0,0,1,1,0,0,0,0,4,1,3,0,0,0,3,1,2,0,0,0,0,0,0,0,0,0
226833,21010,210,10,-2,13,3,10,0,0,0,0,0,0,0,0,0,1,0,1,0,0,0,9,3,6,0,0,0,0,0,0,3,0,3
226903,21010,210,10,-2,40,23,17,0,0,0,0,0,0,1,1,0,25,14,11,0,0,0,10,6,4,1,1,0,3,1,2,0,0,0
227146,21010,210,10,-2,7,1,6,0,0,0,0,0,0,0,0,0,1,0,1,0,0,0,6,1,5,0,0,0,0,0,0,0,0,0
227182,21010,210,10,-2,13,8,5,0,0,0,0,0,0,5,2,3,3,3,0,0,0,0,5,3,2,0,0,0,0,0,0,0,0,0
227216,21010,210,10,-2,123,56,67,0,0,0,25,17,8,11,5,6,11,2,9,0,0,0,69,30,39,2,1,1,5,1,4,0,0,0
227225,21010,210,10,-2,6,1,5,0,0,0,0,0,0,0,0,0,0,0,0,0,0,0,6,1,5,0,0,0,0,0,0,0,0,0
227304,21010,210,10,-2,12,7,5,0,0,0,1,1,0,1,0,1,1,0,1,1,1,0,8,5,3,0,0,0,0,0,0,0,0,0
227331,21010,210,10,-2,15,3,12,0,0,0,1,0,1,3,1,2,8,1,7,0,0,0,3,1,2,0,0,0,0,0,0,0,0,0
227368,21010,210,10,-2,224,124,100,0,0,0,28,15,13,4,2,2,80,37,43,0,0,0,76,44,32,1,1,0,6,4,2,29,21,8
227377,21010,210,10,-2,4,3,1,0,0,0,0,0,0,0,0,0,2,1,1,0,0,0,1,1,0,0,0,0,0,0,0,1,1,0
227386,21010,210,10,-2,9,3,6,1,0,1,0,0,0,0,0,0,0,0,0,0,0,0,8,3,5,0,0,0,0,0,0,0,0,0
227401,21010,210,10,-2,10,6,4,0,0,0,0,0,0,1,0,1,2,2,0,0,0,0,7,4,3,0,0,0,0,0,0,0,0,0
227526,21010,210,10,-2,17,10,7,0,0,0,3,1,2,6,3,3,0,0,0,0,0,0,7,5,2,0,0,0,0,0,0,1,1,0
227687,21010,210,10,-2,7,5,2,0,0,0,0,0,0,0,0,0,1,1,0,0,0,0,6,4,2,0,0,0,0,0,0,0,0,0
227757,21010,210,10,-2,51,37,14,0,0,0,5,3,2,5,2,3,7,5,2,0,0,0,18,13,5,0,0,0,8,6,2,8,8,0
227845,21010,210,10,-2,11,6,5,0,0,0,2,1,1,1,0,1,0,0,0,0,0,0,8,5,3,0,0,0,0,0,0,0,0,0
227854,21010,210,10,-2,12,5,7,0,0,0,2,1,1,3,0,3,4,3,1,0,0,0,3,1,2,0,0,0,0,0,0,0,0,0
227863,21010,210,10,-2,11,6,5,0,0,0,1,0,1,1,0,1,1,1,0,0,0,0,7,5,2,0,0,0,0,0,0,1,0,1
227881,21010,210,10,-2,100,41,59,1,0,1,7,2,5,6,0,6,8,5,3,0,0,0,67,28,39,0,0,0,0,0,0,11,6,5
227924,21010,210,10,-2,7,4,3,0,0,0,1,0,1,0,0,0,4,2,2,0,0,0,2,2,0,0,0,0,0,0,0,0,0,0
227979,21010,210,10,-2,24,11,13,0,0,0,0,0,0,9,4,5,2,1,1,0,0,0,12,6,6,0,0,0,0,0,0,1,0,1
228042,21010,210,10,-2,5,2,3,0,0,0,0,0,0,1,0,1,0,0,0,0,0,0,4,2,2,0,0,0,0,0,0,0,0,0
228149,21010,210,10,-2,13,8,5,0,0,0,1,0,1,2,1,1,2,2,0,0,0,0,6,4,2,0,0,0,0,0,0,2,1,1
228158,21010,210,10,-2,13,6,7,0,0,0,1,0,1,0,0,0,3,1,2,0,0,0,9,5,4,0,0,0,0,0,0,0,0,0
228194,21010,210,10,-2,2,1,1,0,0,0,0,0,0,0,0,0,0,0,0,0,0,0,2,1,1,0,0,0,0,0,0,0,0,0
228246,21010,210,10,-2,28,11,17,0,0,0,7,3,4,5,2,3,1,0,1,0,0,0,13,4,9,0,0,0,0,0,0,2,2,0
228316,21010,210,10,-2,7,1,6,0,0,0,0,0,0,0,0,0,5,0,5,0,0,0,2,1,1,0,0,0,0,0,0,0,0,0
228325,21010,210,10,-2,4,4,0,0,0,0,1,1,0,0,0,0,0,0,0,0,0,0,3,3,0,0,0,0,0,0,0,0,0,0
228343,21010,210,10,-2,10,2,8,0,0,0,2,0,2,0,0,0,4,1,3,0,0,0,3,0,3,1,1,0,0,0,0,0,0,0
228431,21010,210,10,-2,4,2,2,0,0,0,0,0,0,2,1,1,0,0,0,0,0,0,1,0,1,0,0,0,0,0,0,1,1,0
228459,21010,210,10,-2,48,22,26,0,0,0,7,3,4,1,1,0,2,1,1,0,0,0,20,8,12,1,0,1,17,9,8,0,0,0
228468,21010,210,10,-2,7,3,4,0,0,0,0,0,0,0,0,0,2,0,2,1,1,0,4,2,2,0,0,0,0,0,0,0,0,0
228501,21010,210,10,-2,6,2,4,0,0,0,1,1,0,0,0,0,0,0,0,0,0,0,5,1,4,0,0,0,0,0,0,0,0,0
228529,21010,210,10,-2,35,17,18,1,1,0,2,0,2,4,2,2,3,2,1,0,0,0,21,9,12,1,1,0,0,0,0,3,2,1
228547,21010,210,10,-2,12,5,7,0,0,0,2,2,0,5,0,5,3,2,1,0,0,0,2,1,1,0,0,0,0,0,0,0,0,0
228608,21010,210,10,-2,14,6,8,1,1,0,2,1,1,1,1,0,0,0,0,0,0,0,10,3,7,0,0,0,0,0,0,0,0,0
228635,21010,210,10,-2,175,83,92,0,0,0,68,34,34,11,5,6,10,4,6,0,0,0,68,31,37,2,1,1,4,1,3,12,7,5
228644,21010,210,10,-2,64,32,32,0,0,0,12,6,6,4,3,1,11,4,7,0,0,0,29,17,12,0,0,0,8,2,6,0,0,0
228653,21010,210,10,-2,31,12,19,0,0,0,5,3,2,6,1,5,3,0,3,0,0,0,15,7,8,0,0,0,0,0,0,2,1,1
228699,21010,210,10,-2,3,0,3,0,0,0,0,0,0,1,0,1,0,0,0,0,0,0,2,0,2,0,0,0,0,0,0,0,0,0
228705,21010,210,10,-2,5,4,1,0,0,0,1,1,0,0,0,0,0,0,0,0,0,0,2,2,0,0,0,0,0,0,0,2,1,1
228723,21010,210,10,-2,180,110,70,0,0,0,33,16,17,9,5,4,15,7,8,0,0,0,99,63,36,3,3,0,14,12,2,7,4,3
228769,21010,210,10,-2,64,24,40,0,0,0,10,4,6,8,2,6,7,5,2,1,0,1,17,5,12,1,0,1,16,6,10,4,2,2
228778,21010,210,10,-2,222,112,110,0,0,0,32,12,20,19,8,11,34,16,18,0,0,0,99,52,47,3,1,2,0,0,0,35,23,12
228787,21010,210,10,-2,47,21,26,0,0,0,9,5,4,1,0,1,0,0,0,0,0,0,13,4,9,2,1,1,22,11,11,0,0,0
228796,21010,210,10,-2,54,22,32,0,0,0,11,3,8,1,1,0,17,4,13,0,0,0,15,9,6,1,0,1,2,2,0,7,3,4
228802,21010,210,10,-2,22,6,16,0,0,0,4,3,1,0,0,0,1,0,1,0,0,0,10,1,9,0,0,0,5,2,3,2,0,2
228875,21010,210,10,-2,33,14,19,0,0,0,2,1,1,4,1,3,5,1,4,0,0,0,16,9,7,0,0,0,3,1,2,3,1,2
228884,21010,210,10,-2,3,1,2,0,0,0,0,0,0,3,1,2,0,0,0,0,0,0,0,0,0,0,0,0,0,0,0,0,0,0
228909,21010,210,10,-2,19,9,10,0,0,0,3,1,2,2,1,1,2,2,0,0,0,0,10,5,5,0,0,0,2,0,2,0,0,0
228981,21010,210,10,-2,5,3,2,0,0,0,0,0,0,0,0,0,5,3,2,0,0,0,0,0,0,0,0,0,0,0,0,0,0,0
229018,21010,210,10,-2,12,4,8,0,0,0,0,0,0,3,0,3,1,0,1,0,0,0,8,4,4,0,0,0,0,0,0,0,0,0
229027,21010,210,10,-2,38,24,14,0,0,0,3,2,1,2,0,2,14,8,6,0,0,0,6,5,1,0,0,0,7,3,4,6,6,0
229063,21010,210,10,-2,18,8,10,1,0,1,2,0,2,13,7,6,0,0,0,0,0,0,2,1,1,0,0,0,0,0,0,0,0,0
229115,21010,210,10,-2,82,37,45,1,0,1,7,4,3,2,1,1,6,4,2,0,0,0,47,20,27,1,0,1,0,0,0,18,8,10
229179,21010,210,10,-2,25,4,21,0,0,0,7,1,6,2,0,2,5,1,4,0,0,0,10,2,8,0,0,0,1,0,1,0,0,0
229267,21010,210,10,-2,12,7,5,0,0,0,1,0,1,1,1,0,4,2,2,0,0,0,6,4,2,0,0,0,0,0,0,0,0,0
229300,21010,210,10,-2,192,89,103,0,0,0,56,27,29,10,1,9,23,8,15,1,1,0,53,24,29,6,1,5,21,12,9,22,15,7
229337,21010,210,10,-2,39,17,22,0,0,0,13,6,7,1,0,1,5,1,4,0,0,0,20,10,10,0,0,0,0,0,0,0,0,0
229355,21010,210,10,-2,37,11,26,0,0,0,0,0,0,1,0,1,1,0,1,0,0,0,35,11,24,0,0,0,0,0,0,0,0,0
229504,21010,210,10,-2,7,4,3,0,0,0,0,0,0,0,0,0,0,0,0,0,0,0,7,4,3,0,0,0,0,0,0,0,0,0
229540,21010,210,10,-2,7,5,2,0,0,0,0,0,0,0,0,0,2,2,0,0,0,0,5,3,2,0,0,0,0,0,0,0,0,0
229780,21010,210,10,-2,3,2,1,0,0,0,0,0,0,0,0,0,1,0,1,0,0,0,2,2,0,0,0,0,0,0,0,0,0,0
229799,21010,210,10,-2,12,3,9,0,0,0,2,1,1,1,0,1,0,0,0,0,0,0,6,1,5,0,0,0,3,1,2,0,0,0
229814,21010,210,10,-2,32,15,17,0,0,0,3,2,1,0,0,0,2,1,1,0,0,0,17,6,11,0,0,0,0,0,0,10,6,4
229832,21010,210,10,-2,4,4,0,0,0,0,0,0,0,0,0,0,1,1,0,0,0,0,3,3,0,0,0,0,0,0,0,0,0,0
229841,21010,210,10,-2,11,2,9,0,0,0,0,0,0,3,0,3,1,1,0,0,0,0,5,0,5,0,0,0,2,1,1,0,0,0
229887,21010,210,10,-2,5,0,5,0,0,0,0,0,0,5,0,5,0,0,0,0,0,0,0,0,0,0,0,0,0,0,0,0,0,0
230038,21010,210,10,-2,61,38,23,0,0,0,1,1,0,0,0,0,1,0,1,0,0,0,56,36,20,3,1,2,0,0,0,0,0,0
230047,21010,210,10,-2,9,5,4,0,0,0,1,1,0,0,0,0,1,0,1,1,0,1,5,3,2,0,0,0,0,0,0,1,1,0
230171,21010,210,10,-2,30,14,16,0,0,0,2,1,1,0,0,0,0,0,0,0,0,0,26,11,15,0,0,0,1,1,0,1,1,0
230366,21010,210,10,-2,5,0,5,0,0,0,0,0,0,0,0,0,0,0,0,0,0,0,5,0,5,0,0,0,0,0,0,0,0,0
230418,21010,210,10,-2,1,1,0,0,0,0,0,0,0,0,0,0,0,0,0,0,0,0,1,1,0,0,0,0,0,0,0,0,0,0
230597,21010,210,10,-2,12,6,6,0,0,0,0,0,0,1,0,1,0,0,0,0,0,0,11,6,5,0,0,0,0,0,0,0,0,0
230603,21010,210,10,-2,37,24,13,0,0,0,0,0,0,1,1,0,3,1,2,0,0,0,32,21,11,0,0,0,0,0,0,1,1,0
230728,21010,210,10,-2,54,31,23,0,0,0,4,4,0,0,0,0,4,3,1,0,0,0,42,22,20,2,1,1,2,1,1,0,0,0
230737,21010,210,10,-2,87,47,40,0,0,0,8,2,6,1,0,1,2,1,1,1,0,1,54,29,25,2,1,1,12,9,3,7,5,2
230746,21010,210,10,-2,21,12,9,1,0,1,1,0,1,1,0,1,3,1,2,0,0,0,15,11,4,0,0,0,0,0,0,0,0,0
230764,21010,210,10,-2,106,59,47,1,1,0,8,4,4,4,2,2,6,3,3,1,1,0,63,37,26,3,1,2,6,2,4,14,8,6
230782,21010,210,10,-2,44,23,21,0,0,0,1,1,0,0,0,0,1,1,0,0,0,0,35,17,18,1,0,1,2,1,1,4,3,1
230807,21010,210,10,-2,4,0,4,0,0,0,0,0,0,0,0,0,0,0,0,0,0,0,4,0,4,0,0,0,0,0,0,0,0,0
230816,21010,210,10,-2,2,1,1,0,0,0,1,0,1,0,0,0,0,0,0,0,0,0,1,1,0,0,0,0,0,0,0,0,0,0
230834,21010,210,10,-2,2,0,2,0,0,0,0,0,0,0,0,0,0,0,0,0,0,0,1,0,1,0,0,0,1,0,1,0,0,0
230852,21010,210,10,-2,2,1,1,0,0,0,0,0,0,0,0,0,0,0,0,0,0,0,1,1,0,0,0,0,1,0,1,0,0,0
230913,21010,210,10,-2,2,1,1,0,0,0,0,0,0,0,0,0,0,0,0,0,0,0,2,1,1,0,0,0,0,0,0,0,0,0
230959,21010,210,10,-2,14,6,8,0,0,0,1,0,1,1,1,0,1,0,1,0,0,0,6,2,4,0,0,0,3,3,0,2,0,2
230995,21010,210,10,-2,21,9,12,0,0,0,0,0,0,0,0,0,1,0,1,0,0,0,16,6,10,0,0,0,3,3,0,1,0,1
231059,21010,210,10,-2,7,2,5,0,0,0,0,0,0,0,0,0,0,0,0,0,0,0,5,1,4,0,0,0,0,0,0,2,1,1
231068,21010,210,10,-2,1,0,1,0,0,0,0,0,0,0,0,0,0,0,0,0,0,0,1,0,1,0,0,0,0,0,0,0,0,0
231147,21010,210,10,-2,8,2,6,0,0,0,0,0,0,1,0,1,0,0,0,0,0,0,6,2,4,0,0,0,1,0,1,0,0,0
231165,21010,210,10,-2,4,1,3,0,0,0,0,0,0,0,0,0,0,0,0,0,0,0,4,1,3,0,0,0,0,0,0,0,0,0
231174,21010,210,10,-2,26,12,14,0,0,0,2,0,2,2,2,0,1,0,1,0,0,0,16,7,9,0,0,0,2,1,1,3,2,1
231411,21010,210,10,-2,3,2,1,0,0,0,0,0,0,1,0,1,0,0,0,0,0,0,2,2,0,0,0,0,0,0,0,0,0,0
231420,21010,210,10,-2,5,4,1,0,0,0,0,0,0,0,0,0,0,0,0,0,0,0,5,4,1,0,0,0,0,0,0,0,0,0
231536,21010,210,10,-2,3,0,3,0,0,0,0,0,0,0,0,0,0,0,0,0,0,0,3,0,3,0,0,0,0,0,0,0,0,0
231554,21010,210,10,-2,1,0,1,0,0,0,0,0,0,0,0,0,0,0,0,0,0,0,1,0,1,0,0,0,0,0,0,0,0,0
231581,21010,210,10,-2,9,7,2,0,0,0,2,2,0,0,0,0,0,0,0,0,0,0,5,4,1,0,0,0,0,0,0,2,1,1
231624,21010,210,10,-2,32,14,18,0,0,0,5,2,3,2,1,1,2,1,1,0,0,0,14,7,7,1,1,0,6,2,4,2,0,2
231651,21010,210,10,-2,8,2,6,0,0,0,0,0,0,2,0,2,0,0,0,1,0,1,5,2,3,0,0,0,0,0,0,0,0,0
231697,21010,210,10,-2,1,0,1,0,0,0,0,0,0,0,0,0,0,0,0,0,0,0,1,0,1,0,0,0,0,0,0,0,0,0
231712,21010,210,10,-2,10,4,6,0,0,0,3,1,2,0,0,0,0,0,0,0,0,0,7,3,4,0,0,0,0,0,0,0,0,0
231785,21010,210,10,-2,8,2,6,0,0,0,0,0,0,4,0,4,0,0,0,0,0,0,2,1,1,1,1,0,1,0,1,0,0,0
231873,21010,210,10,-2,5,1,4,0,0,0,0,0,0,0,0,0,0,0,0,0,0,0,5,1,4,0,0,0,0,0,0,0,0,0
231882,21010,210,10,-2,15,10,5,0,0,0,0,0,0,1,0,1,0,0,0,0,0,0,14,10,4,0,0,0,0,0,0,0,0,0
231970,21010,210,10,-2,20,6,14,0,0,0,4,2,2,3,0,3,1,0,1,0,0,0,12,4,8,0,0,0,0,0,0,0,0,0
232025,21010,210,10,-2,16,6,10,0,0,0,0,0,0,1,0,1,0,0,0,0,0,0,6,1,5,0,0,0,9,5,4,0,0,0
232043,21010,210,10,-2,5,3,2,0,0,0,1,1,0,0,0,0,0,0,0,0,0,0,4,2,2,0,0,0,0,0,0,0,0,0
232052,21010,210,10,-2,1,0,1,0,0,0,1,0,1,0,0,0,0,0,0,0,0,0,0,0,0,0,0,0,0,0,0,0,0,0
232089,21010,210,10,-2,5,2,3,0,0,0,1,1,0,0,0,0,0,0,0,0,0,0,4,1,3,0,0,0,0,0,0,0,0,0
232186,21010,210,10,-2,112,67,45,1,1,0,18,12,6,15,9,6,3,2,1,0,0,0,45,24,21,2,1,1,1,1,0,27,17,10
232195,21010,210,10,-2,13,7,6,1,0,1,1,1,0,4,3,1,1,0,1,0,0,0,6,3,3,0,0,0,0,0,0,0,0,0
232256,21010,210,10,-2,7,6,1,0,0,0,1,1,0,1,0,1,1,1,0,0,0,0,4,4,0,0,0,0,0,0,0,0,0,0
232265,21010,210,10,-2,30,11,19,0,0,0,6,3,3,16,5,11,0,0,0,0,0,0,8,3,5,0,0,0,0,0,0,0,0,0
232308,21010,210,10,-2,21,6,15,0,0,0,0,0,0,2,1,1,0,0,0,0,0,0,16,5,11,1,0,1,0,0,0,2,0,2
232414,21010,210,10,-2,8,2,6,0,0,0,0,0,0,1,0,1,0,0,0,0,0,0,7,2,5,0,0,0,0,0,0,0,0,0
232423,21010,210,10,-2,40,10,30,1,0,1,3,1,2,7,2,5,5,1,4,0,0,0,21,5,16,2,1,1,0,0,0,1,0,1
232450,21010,210,10,-2,3,0,3,0,0,0,0,0,0,0,0,0,0,0,0,0,0,0,3,0,3,0,0,0,0,0,0,0,0,0
232557,21010,210,10,-2,48,19,29,0,0,0,1,1,0,11,3,8,2,1,1,0,0,0,34,14,20,0,0,0,0,0,0,0,0,0
232566,21010,210,10,-2,9,4,5,0,0,0,0,0,0,1,0,1,0,0,0,0,0,0,7,3,4,0,0,0,0,0,0,1,1,0
232575,21010,210,10,-2,6,1,5,1,0,1,0,0,0,0,0,0,0,0,0,0,0,0,5,1,4,0,0,0,0,0,0,0,0,0
232609,21010,210,10,-2,8,5,3,0,0,0,1,1,0,0,0,0,0,0,0,0,0,0,4,2,2,0,0,0,3,2,1,0,0,0
232618,21010,210,10,-2,6,1,5,0,0,0,0,0,0,0,0,0,0,0,0,0,0,0,6,1,5,0,0,0,0,0,0,0,0,0
232672,21010,210,10,-2,10,2,8,0,0,0,0,0,0,0,0,0,1,0,1,0,0,0,9,2,7,0,0,0,0,0,0,0,0,0
232681,21010,210,10,-2,13,8,5,0,0,0,3,3,0,1,0,1,1,1,0,0,0,0,8,4,4,0,0,0,0,0,0,0,0,0
232706,21010,210,10,-2,14,5,9,0,0,0,2,0,2,4,1,3,3,2,1,0,0,0,4,2,2,0,0,0,1,0,1,0,0,0
232788,21010,210,10,-2,1,1,0,0,0,0,0,0,0,0,0,0,0,0,0,0,0,0,1,1,0,0,0,0,0,0,0,0,0,0
232867,21010,210,10,-2,4,1,3,0,0,0,0,0,0,0,0,0,0,0,0,0,0,0,4,1,3,0,0,0,0,0,0,0,0,0
232885,21010,210,10,-2,1,0,1,0,0,0,0,0,0,1,0,1,0,0,0,0,0,0,0,0,0,0,0,0,0,0,0,0,0,0
232937,21010,210,10,-2,7,4,3,0,0,0,2,0,2,4,3,1,0,0,0,0,0,0,1,1,0,0,0,0,0,0,0,0,0,0
232946,21010,210,10,-2,8,3,5,0,0,0,0,0,0,2,2,0,0,0,0,0,0,0,6,1,5,0,0,0,0,0,0,0,0,0
232982,21010,210,10,-2,45,24,21,0,0,0,6,2,4,5,2,3,0,0,0,0,0,0,25,14,11,0,0,0,0,0,0,9,6,3
233019,21010,210,10,-2,2,0,2,0,0,0,0,0,0,0,0,0,0,0,0,0,0,0,2,0,2,0,0,0,0,0,0,0,0,0
233082,21010,210,10,-2,2,0,2,0,0,0,0,0,0,0,0,0,0,0,0,0,0,0,2,0,2,0,0,0,0,0,0,0,0,0
233116,21010,210,10,-2,6,2,4,0,0,0,1,1,0,2,1,1,0,0,0,0,0,0,3,0,3,0,0,0,0,0,0,0,0,0
233277,21010,210,10,-2,26,12,14,0,0,0,4,2,2,2,2,0,0,0,0,0,0,0,20,8,12,0,0,0,0,0,0,0,0,0
233295,21010,210,10,-2,15,7,8,0,0,0,0,0,0,2,0,2,1,1,0,0,0,0,12,6,6,0,0,0,0,0,0,0,0,0
233301,21010,210,10,-2,3,0,3,0,0,0,0,0,0,1,0,1,0,0,0,0,0,0,2,0,2,0,0,0,0,0,0,0,0,0
233310,21010,210,10,-2,3,0,3,0,0,0,0,0,0,1,0,1,0,0,0,0,0,0,2,0,2,0,0,0,0,0,0,0,0,0
233329,21010,210,10,-2,12,1,11,0,0,0,2,0,2,1,0,1,3,0,3,0,0,0,5,0,5,0,0,0,1,1,0,0,0,0
233356,21010,210,10,-2,3,2,1,0,0,0,0,0,0,1,1,0,0,0,0,0,0,0,2,1,1,0,0,0,0,0,0,0,0,0
233374,21010,210,10,-2,33,15,18,0,0,0,1,0,1,5,2,3,0,0,0,0,0,0,21,10,11,1,0,1,1,1,0,4,2,2
233408,21010,210,10,-2,2,0,2,0,0,0,0,0,0,0,0,0,0,0,0,0,0,0,2,0,2,0,0,0,0,0,0,0,0,0
233426,21010,210,10,-2,15,10,5,0,0,0,0,0,0,0,0,0,1,1,0,0,0,0,13,8,5,1,1,0,0,0,0,0,0,0
233541,21010,210,10,-2,23,7,16,0,0,0,0,0,0,3,2,1,0,0,0,0,0,0,14,4,10,0,0,0,5,1,4,1,0,1
233611,21010,210,10,-2,1,1,0,0,0,0,0,0,0,0,0,0,0,0,0,0,0,0,1,1,0,0,0,0,0,0,0,0,0,0
233639,21010,210,10,-2,1,0,1,0,0,0,0,0,0,0,0,0,0,0,0,0,0,0,1,0,1,0,0,0,0,0,0,0,0,0
233718,21010,210,10,-2,11,2,9,0,0,0,1,0,1,2,0,2,1,0,1,0,0,0,7,2,5,0,0,0,0,0,0,0,0,0
233754,21010,210,10,-2,1,1,0,0,0,0,0,0,0,0,0,0,0,0,0,0,0,0,1,1,0,0,0,0,0,0,0,0,0,0
233772,21010,210,10,-2,12,6,6,0,0,0,0,0,0,1,1,0,0,0,0,0,0,0,11,5,6,0,0,0,0,0,0,0,0,0
233842,21010,210,10,-2,2,1,1,0,0,0,0,0,0,2,1,1,0,0,0,0,0,0,0,0,0,0,0,0,0,0,0,0,0,0
233897,21010,210,10,-2,5,3,2,0,0,0,0,0,0,0,0,0,0,0,0,0,0,0,5,3,2,0,0,0,0,0,0,0,0,0
233903,21010,210,10,-2,1,1,0,0,0,0,0,0,0,0,0,0,0,0,0,0,0,0,1,1,0,0,0,0,0,0,0,0,0,0
233921,21010,210,10,-2,141,71,70,1,0,1,16,11,5,8,4,4,8,4,4,0,0,0,70,33,37,3,3,0,0,0,0,35,16,19
233949,21010,210,10,-2,2,1,1,0,0,0,1,1,0,0,0,0,0,0,0,0,0,0,1,0,1,0,0,0,0,0,0,0,0,0
234030,21010,210,10,-2,106,45,61,0,0,0,11,4,7,15,6,9,6,3,3,0,0,0,65,26,39,2,0,2,0,0,0,7,6,1
234076,21010,210,10,-2,163,87,76,0,0,0,24,17,7,16,7,9,4,1,3,0,0,0,80,43,37,6,4,2,15,11,4,18,4,14
234085,21010,210,10,-2,15,8,7,0,0,0,3,1,2,0,0,0,0,0,0,0,0,0,12,7,5,0,0,0,0,0,0,0,0,0
234155,21010,210,10,-2,22,13,9,0,0,0,4,3,1,13,6,7,1,0,1,0,0,0,4,4,0,0,0,0,0,0,0,0,0,0
234164,21010,210,10,-2,3,3,0,0,0,0,0,0,0,1,1,0,0,0,0,0,0,0,0,0,0,0,0,0,2,2,0,0,0,0
234173,21010,210,10,-2,1,1,0,0,0,0,0,0,0,0,0,0,0,0,0,0,0,0,1,1,0,0,0,0,0,0,0,0,0,0
234207,21010,210,10,-2,22,9,13,0,0,0,1,0,1,3,1,2,5,3,2,0,0,0,3,2,1,0,0,0,4,1,3,6,2,4
234377,21010,210,10,-2,1,0,1,0,0,0,0,0,0,0,0,0,0,0,0,0,0,0,1,0,1,0,0,0,0,0,0,0,0,0
234669,21010,210,10,-2,5,2,3,0,0,0,0,0,0,4,2,2,0,0,0,0,0,0,1,0,1,0,0,0,0,0,0,0,0,0
234696,21010,210,10,-2,6,3,3,0,0,0,0,0,0,0,0,0,0,0,0,0,0,0,5,3,2,1,0,1,0,0,0,0,0,0
234711,21010,210,10,-2,2,2,0,0,0,0,1,1,0,0,0,0,0,0,0,0,0,0,1,1,0,0,0,0,0,0,0,0,0,0
234827,21010,210,10,-2,14,5,9,0,0,0,3,3,0,2,0,2,1,0,1,0,0,0,8,2,6,0,0,0,0,0,0,0,0,0
234845,21010,210,10,-2,1,0,1,0,0,0,0,0,0,0,0,0,0,0,0,0,0,0,1,0,1,0,0,0,0,0,0,0,0,0
234915,21010,210,10,-2,7,4,3,0,0,0,2,2,0,0,0,0,0,0,0,0,0,0,4,1,3,0,0,0,1,1,0,0,0,0
234933,21010,210,10,-2,10,1,9,0,0,0,1,0,1,1,1,0,0,0,0,0,0,0,7,0,7,0,0,0,1,0,1,0,0,0
234951,21010,210,10,-2,6,5,1,0,0,0,0,0,0,1,1,0,0,0,0,0,0,0,5,4,1,0,0,0,0,0,0,0,0,0
234979,21010,210,10,-2,5,3,2,0,0,0,0,0,0,0,0,0,0,0,0,0,0,0,4,2,2,1,1,0,0,0,0,0,0,0
235024,21010,210,10,-2,2,0,2,0,0,0,0,0,0,0,0,0,1,0,1,0,0,0,0,0,0,1,0,1,0,0,0,0,0,0
235097,21010,210,10,-2,35,17,18,1,1,0,3,1,2,1,0,1,1,1,0,0,0,0,27,12,15,0,0,0,0,0,0,2,2,0
235103,21010,210,10,-2,3,0,3,0,0,0,0,0,0,0,0,0,0,0,0,0,0,0,3,0,3,0,0,0,0,0,0,0,0,0
235149,21010,210,10,-2,4,3,1,0,0,0,1,1,0,0,0,0,0,0,0,0,0,0,1,1,0,1,0,1,1,1,0,0,0,0
235167,21010,210,10,-2,3,1,2,0,0,0,0,0,0,0,0,0,0,0,0,0,0,0,0,0,0,0,0,0,3,1,2,0,0,0
235237,21010,210,10,-2,6,1,5,0,0,0,2,0,2,1,1,0,0,0,0,0,0,0,3,0,3,0,0,0,0,0,0,0,0,0
235316,21010,210,10,-2,34,19,15,0,0,0,4,4,0,2,2,0,1,0,1,0,0,0,19,6,13,0,0,0,3,3,0,5,4,1
235334,21010,210,10,-2,4,2,2,0,0,0,0,0,0,0,0,0,0,0,0,0,0,0,4,2,2,0,0,0,0,0,0,0,0,0
235343,21010,210,10,-2,4,3,1,0,0,0,0,0,0,0,0,0,0,0,0,0,0,0,1,1,0,2,1,1,1,1,0,0,0,0
235422,21010,210,10,-2,4,0,4,0,0,0,1,0,1,0,0,0,1,0,1,0,0,0,2,0,2,0,0,0,0,0,0,0,0,0
235431,21010,210,10,-2,10,6,4,0,0,0,0,0,0,1,0,1,0,0,0,0,0,0,8,5,3,0,0,0,1,1,0,0,0,0
235671,21010,210,10,-2,4,2,2,0,0,0,1,0,1,0,0,0,1,1,0,0,0,0,2,1,1,0,0,0,0,0,0,0,0,0
235699,21010,210,10,-2,7,1,6,0,0,0,1,0,1,0,0,0,0,0,0,0,0,0,6,1,5,0,0,0,0,0,0,0,0,0
235750,21010,210,10,-2,2,1,1,0,0,0,0,0,0,0,0,0,0,0,0,0,0,0,1,0,1,0,0,0,1,1,0,0,0,0
236072,21010,210,10,-2,1,0,1,0,0,0,0,0,0,0,0,0,0,0,0,0,0,0,1,0,1,0,0,0,0,0,0,0,0,0
236133,21010,210,10,-2,8,3,5,0,0,0,0,0,0,0,0,0,0,0,0,0,0,0,8,3,5,0,0,0,0,0,0,0,0,0
236188,21010,210,10,-2,13,2,11,0,0,0,0,0,0,0,0,0,0,0,0,1,0,1,11,2,9,1,0,1,0,0,0,0,0,0
236212,21010,210,10,-2,10,9,1,0,0,0,0,0,0,0,0,0,0,0,0,0,0,0,9,8,1,0,0,0,1,1,0,0,0,0
236230,21010,210,10,-2,12,4,8,0,0,0,0,0,0,0,0,0,0,0,0,0,0,0,11,4,7,0,0,0,1,0,1,0,0,0
236258,21010,210,10,-2,3,1,2,0,0,0,0,0,0,0,0,0,0,0,0,0,0,0,2,0,2,0,0,0,1,1,0,0,0,0
236328,21010,210,10,-2,10,2,8,0,0,0,3,0,3,0,0,0,0,0,0,0,0,0,7,2,5,0,0,0,0,0,0,0,0,0
236382,21010,210,10,-2,5,2,3,1,1,0,1,0,1,1,1,0,0,0,0,0,0,0,2,0,2,0,0,0,0,0,0,0,0,0
236452,21010,210,10,-2,6,2,4,0,0,0,0,0,0,0,0,0,0,0,0,0,0,0,2,1,1,0,0,0,4,1,3,0,0,0
236513,21010,210,10,-2,3,3,0,0,0,0,1,1,0,0,0,0,0,0,0,0,0,0,1,1,0,0,0,0,1,1,0,0,0,0
236577,21010,210,10,-2,16,5,11,0,0,0,1,0,1,1,0,1,2,2,0,0,0,0,5,2,3,0,0,0,1,0,1,6,1,5
236595,21010,210,10,-2,53,24,29,0,0,0,12,9,3,2,0,2,1,0,1,0,0,0,31,12,19,1,1,0,6,2,4,0,0,0
236610,21010,210,10,-2,8,1,7,0,0,0,1,0,1,1,0,1,0,0,0,0,0,0,5,1,4,0,0,0,1,0,1,0,0,0
236638,21010,210,10,-2,4,2,2,0,0,0,1,1,0,0,0,0,0,0,0,0,0,0,3,1,2,0,0,0,0,0,0,0,0,0
236656,21010,210,10,-2,3,2,1,0,0,0,0,0,0,1,1,0,0,0,0,0,0,0,2,1,1,0,0,0,0,0,0,0,0,0
236692,21010,210,10,-2,9,6,3,1,1,0,0,0,0,1,1,0,0,0,0,0,0,0,7,4,3,0,0,0,0,0,0,0,0,0
236708,21010,210,10,-2,4,0,4,0,0,0,0,0,0,0,0,0,0,0,0,0,0,0,4,0,4,0,0,0,0,0,0,0,0,0
236753,21010,210,10,-2,6,4,2,0,0,0,0,0,0,0,0,0,1,1,0,1,0,1,2,2,0,0,0,0,2,1,1,0,0,0
236887,21010,210,10,-2,4,2,2,0,0,0,0,0,0,1,0,1,0,0,0,1,0,1,2,2,0,0,0,0,0,0,0,0,0,0
236896,21010,210,10,-2,8,6,2,0,0,0,2,2,0,0,0,0,1,0,1,0,0,0,5,4,1,0,0,0,0,0,0,0,0,0
236939,21010,210,10,-2,32,18,14,1,0,1,3,3,0,1,1,0,3,2,1,0,0,0,9,3,6,0,0,0,13,8,5,2,1,1
236948,21010,210,10,-2,352,155,197,3,2,1,51,24,27,26,8,18,25,11,14,1,0,1,160,65,95,9,6,3,39,19,20,38,20,18
236975,21010,210,10,-2,2,1,1,0,0,0,0,0,0,0,0,0,1,1,0,0,0,0,1,0,1,0,0,0,0,0,0,0,0,0
237011,21010,210,10,-2,20,10,10,0,0,0,4,2,2,0,0,0,1,0,1,0,0,0,11,5,6,1,0,1,2,2,0,1,1,0
237039,21010,210,10,-2,4,1,3,0,0,0,0,0,0,0,0,0,0,0,0,0,0,0,3,1,2,0,0,0,1,0,1,0,0,0
237057,21010,210,10,-2,11,6,5,0,0,0,0,0,0,0,0,0,1,0,1,0,0,0,8,5,3,0,0,0,0,0,0,2,1,1
237066,21010,210,10,-2,20,9,11,0,0,0,1,0,1,2,2,0,0,0,0,0,0,0,17,7,10,0,0,0,0,0,0,0,0,0
237109,21010,210,10,-2,3,0,3,0,0,0,0,0,0,0,0,0,2,0,2,0,0,0,1,0,1,0,0,0,0,0,0,0,0,0
237118,21010,210,10,-2,8,5,3,0,0,0,0,0,0,1,1,0,0,0,0,0,0,0,7,4,3,0,0,0,0,0,0,0,0,0
237181,21010,210,10,-2,3,2,1,0,0,0,0,0,0,1,1,0,0,0,0,0,0,0,2,1,1,0,0,0,0,0,0,0,0,0
237215,21010,210,10,-2,8,3,5,0,0,0,0,0,0,0,0,0,0,0,0,0,0,0,8,3,5,0,0,0,0,0,0,0,0,0
237312,21010,210,10,-2,21,7,14,0,0,0,0,0,0,3,0,3,1,1,0,0,0,0,17,6,11,0,0,0,0,0,0,0,0,0
237330,21010,210,10,-2,5,3,2,0,0,0,0,0,0,1,0,1,0,0,0,0,0,0,4,3,1,0,0,0,0,0,0,0,0,0
237358,21010,210,10,-2,8,3,5,0,0,0,0,0,0,0,0,0,0,0,0,0,0,0,8,3,5,0,0,0,0,0,0,0,0,0
237367,21010,210,10,-2,9,2,7,0,0,0,0,0,0,0,0,0,0,0,0,0,0,0,9,2,7,0,0,0,0,0,0,0,0,0
237525,21010,210,10,-2,57,28,29,1,0,1,10,6,4,4,2,2,1,1,0,0,0,0,40,19,21,0,0,0,1,0,1,0,0,0
237686,21010,210,10,-2,6,1,5,0,0,0,0,0,0,0,0,0,0,0,0,0,0,0,6,1,5,0,0,0,0,0,0,0,0,0
237701,21010,210,10,-2,5,1,4,0,0,0,0,0,0,1,0,1,0,0,0,0,0,0,3,0,3,0,0,0,0,0,0,1,1,0
237792,21010,210,10,-2,6,2,4,0,0,0,0,0,0,0,0,0,0,0,0,0,0,0,6,2,4,0,0,0,0,0,0,0,0,0
237817,21010,210,10,-2,6,1,5,0,0,0,0,0,0,0,0,0,0,0,0,0,0,0,6,1,5,0,0,0,0,0,0,0,0,0
237880,21010,210,10,-2,2,1,1,0,0,0,0,0,0,0,0,0,0,0,0,0,0,0,2,1,1,0,0,0,0,0,0,0,0,0
237899,21010,210,10,-2,7,2,5,0,0,0,1,1,0,0,0,0,0,0,0,0,0,0,6,1,5,0,0,0,0,0,0,0,0,0
237932,21010,210,10,-2,4,2,2,0,0,0,1,1,0,0,0,0,0,0,0,0,0,0,2,1,1,0,0,0,1,0,1,0,0,0
237950,21010,210,10,-2,9,6,3,0,0,0,2,2,0,0,0,0,0,0,0,0,0,0,5,2,3,0,0,0,0,0,0,2,2,0
237969,21010,210,10,-2,2,1,1,0,0,0,0,0,0,0,0,0,0,0,0,0,0,0,2,1,1,0,0,0,0,0,0,0,0,0
238014,21010,210,10,-2,8,1,7,0,0,0,1,1,0,1,0,1,0,0,0,0,0,0,6,0,6,0,0,0,0,0,0,0,0,0
238032,21010,210,10,-2,74,41,33,0,0,0,10,6,4,4,2,2,2,1,1,0,0,0,45,23,22,1,1,0,3,3,0,9,5,4
238078,21010,210,10,-2,4,2,2,0,0,0,0,0,0,0,0,0,0,0,0,0,0,0,4,2,2,0,0,0,0,0,0,0,0,0
238193,21010,210,10,-2,8,1,7,0,0,0,0,0,0,2,1,1,0,0,0,0,0,0,6,0,6,0,0,0,0,0,0,0,0,0
238263,21010,210,10,-2,14,4,10,0,0,0,0,0,0,1,1,0,2,1,1,0,0,0,10,1,9,0,0,0,1,1,0,0,0,0
238324,21010,210,10,-2,1,0,1,0,0,0,0,0,0,0,0,0,0,0,0,0,0,0,1,0,1,0,0,0,0,0,0,0,0,0
238333,21010,210,10,-2,12,5,7,0,0,0,0,0,0,0,0,0,1,0,1,0,0,0,10,5,5,0,0,0,0,0,0,1,0,1
238397,21010,210,10,-2,9,8,1,0,0,0,0,0,0,2,2,0,0,0,0,0,0,0,6,6,0,0,0,0,1,0,1,0,0,0
238430,21010,210,10,-2,3,2,1,0,0,0,0,0,0,0,0,0,0,0,0,0,0,0,3,2,1,0,0,0,0,0,0,0,0,0
238458,21010,210,10,-2,15,6,9,0,0,0,0,0,0,0,0,0,0,0,0,0,0,0,12,4,8,0,0,0,1,0,1,2,2,0
238476,21010,210,10,-2,10,5,5,0,0,0,1,1,0,0,0,0,0,0,0,0,0,0,8,4,4,0,0,0,1,0,1,0,0,0
238616,21010,210,10,-2,17,5,12,0,0,0,0,0,0,0,0,0,1,0,1,0,0,0,16,5,11,0,0,0,0,0,0,0,0,0
238661,21010,210,10,-2,2,1,1,0,0,0,0,0,0,1,1,0,0,0,0,0,0,0,0,0,0,0,0,0,0,0,0,1,0,1
238722,21010,210,10,-2,5,3,2,0,0,0,0,0,0,0,0,0,0,0,0,0,0,0,5,3,2,0,0,0,0,0,0,0,0,0
238759,21010,210,10,-2,15,5,10,0,0,0,1,0,1,1,0,1,0,0,0,1,1,0,12,4,8,0,0,0,0,0,0,0,0,0
239008,21010,210,10,-2,4,2,2,0,0,0,0,0,0,1,0,1,0,0,0,0,0,0,3,2,1,0,0,0,0,0,0,0,0,0
239017,21010,210,10,-2,9,2,7,0,0,0,0,0,0,0,0,0,0,0,0,0,0,0,8,2,6,1,0,1,0,0,0,0,0,0
239071,21010,210,10,-2,3,2,1,0,0,0,0,0,0,0,0,0,0,0,0,0,0,0,3,2,1,0,0,0,0,0,0,0,0,0
239080,21010,210,10,-2,3,0,3,0,0,0,0,0,0,0,0,0,0,0,0,0,0,0,3,0,3,0,0,0,0,0,0,0,0,0
239105,21010,210,10,-2,24,10,14,0,0,0,1,1,0,2,1,1,3,1,2,0,0,0,15,6,9,1,0,1,0,0,0,2,1,1
239169,21010,210,10,-2,127,69,58,0,0,0,29,16,13,4,3,1,5,3,2,0,0,0,88,47,41,1,0,1,0,0,0,0,0,0
239220,21010,210,10,-2,9,4,5,0,0,0,1,1,0,0,0,0,0,0,0,0,0,0,8,3,5,0,0,0,0,0,0,0,0,0
239248,21010,210,10,-2,9,6,3,0,0,0,0,0,0,0,0,0,1,0,1,0,0,0,8,6,2,0,0,0,0,0,0,0,0,0
239309,21010,210,10,-2,7,2,5,0,0,0,0,0,0,2,1,1,0,0,0,0,0,0,1,1,0,4,0,4,0,0,0,0,0,0
239318,21010,210,10,-2,9,6,3,0,0,0,0,0,0,0,0,0,0,0,0,0,0,0,9,6,3,0,0,0,0,0,0,0,0,0
239372,21010,210,10,-2,1,1,0,0,0,0,0,0,0,0,0,0,0,0,0,0,0,0,1,1,0,0,0,0,0,0,0,0,0,0
239390,21010,210,10,-2,2,1,1,0,0,0,0,0,0,0,0,0,0,0,0,0,0,0,1,1,0,0,0,0,1,0,1,0,0,0
239442,21010,210,10,-2,2,0,2,0,0,0,0,0,0,0,0,0,0,0,0,0,0,0,2,0,2,0,0,0,0,0,0,0,0,0
239460,21010,210,10,-2,17,6,11,0,0,0,1,0,1,0,0,0,0,0,0,0,0,0,15,6,9,0,0,0,1,0,1,0,0,0
239488,21010,210,10,-2,18,14,4,0,0,0,0,0,0,0,0,0,0,0,0,0,0,0,18,14,4,0,0,0,0,0,0,0,0,0
239512,21010,210,10,-2,2,0,2,0,0,0,0,0,0,0,0,0,0,0,0,0,0,0,2,0,2,0,0,0,0,0,0,0,0,0
239628,21010,210,10,-2,2,2,0,0,0,0,0,0,0,0,0,0,0,0,0,0,0,0,2,2,0,0,0,0,0,0,0,0,0,0
239716,21010,210,10,-2,10,4,6,0,0,0,0,0,0,0,0,0,0,0,0,0,0,0,6,3,3,0,0,0,1,0,1,3,1,2
239910,21010,210,10,-2,2,0,2,0,0,0,0,0,0,1,0,1,0,0,0,0,0,0,1,0,1,0,0,0,0,0,0,0,0,0
240107,21010,210,10,-2,19,9,10,0,0,0,2,1,1,0,0,0,0,0,0,0,0,0,17,8,9,0,0,0,0,0,0,0,0,0
240116,21010,210,10,-2,17,9,8,0,0,0,1,0,1,0,0,0,1,1,0,0,0,0,15,8,7,0,0,0,0,0,0,0,0,0
240125,21010,210,10,-2,13,7,6,0,0,0,0,0,0,0,0,0,1,1,0,0,0,0,11,5,6,0,0,0,1,1,0,0,0,0
240189,21010,210,10,-2,4,2,2,0,0,0,0,0,0,0,0,0,0,0,0,0,0,0,4,2,2,0,0,0,0,0,0,0,0,0
240198,21010,210,10,-2,11,5,6,0,0,0,0,0,0,0,0,0,0,0,0,0,0,0,11,5,6,0,0,0,0,0,0,0,0,0
240268,21010,210,10,-2,16,5,11,0,0,0,3,0,3,0,0,0,0,0,0,0,0,0,9,3,6,0,0,0,2,1,1,2,1,1
240277,21010,210,10,-2,18,9,9,1,0,1,3,2,1,0,0,0,0,0,0,0,0,0,11,4,7,0,0,0,0,0,0,3,3,0
240329,21010,210,10,-2,5,3,2,0,0,0,2,1,1,0,0,0,0,0,0,0,0,0,2,1,1,0,0,0,1,1,0,0,0,0
240338,21010,210,10,-2,2,2,0,0,0,0,0,0,0,0,0,0,0,0,0,0,0,0,2,2,0,0,0,0,0,0,0,0,0,0
240365,21010,210,10,-2,6,3,3,0,0,0,0,0,0,0,0,0,0,0,0,0,0,0,4,1,3,0,0,0,1,1,0,1,1,0
240374,21010,210,10,-2,11,7,4,0,0,0,1,1,0,0,0,0,0,0,0,0,0,0,7,5,2,0,0,0,1,1,0,2,0,2
240392,21010,210,10,-2,19,1,18,0,0,0,0,0,0,1,0,1,0,0,0,0,0,0,16,1,15,1,0,1,1,0,1,0,0,0
240417,21010,210,10,-2,9,6,3,0,0,0,2,1,1,0,0,0,0,0,0,0,0,0,4,3,1,0,0,0,0,0,0,3,2,1
240426,21010,210,10,-2,12,3,9,0,0,0,1,0,1,0,0,0,0,0,0,0,0,0,10,3,7,0,0,0,0,0,0,1,0,1
240444,21010,210,10,-2,215,104,111,1,1,0,23,13,10,10,3,7,9,1,8,0,0,0,124,61,63,3,1,2,10,3,7,35,21,14
240453,21010,210,10,-2,14,7,7,0,0,0,3,1,2,2,0,2,1,1,0,0,0,0,7,4,3,0,0,0,0,0,0,1,1,0
240462,21010,210,10,-2,2,1,1,0,0,0,0,0,0,0,0,0,0,0,0,0,0,0,0,0,0,0,0,0,0,0,0,2,1,1
240471,21010,210,10,-2,8,4,4,0,0,0,1,1,0,0,0,0,1,1,0,0,0,0,4,1,3,0,0,0,0,0,0,2,1,1
240480,21010,210,10,-2,8,2,6,0,0,0,0,0,0,0,0,0,0,0,0,0,0,0,8,2,6,0,0,0,0,0,0,0,0,0
240505,21010,210,10,-2,4,2,2,0,0,0,0,0,0,0,0,0,0,0,0,0,0,0,1,0,1,0,0,0,3,2,1,0,0,0
240514,21010,210,10,-2,7,4,3,0,0,0,0,0,0,0,0,0,0,0,0,0,0,0,5,2,3,0,0,0,2,2,0,0,0,0
240596,21010,210,10,-2,5,2,3,0,0,0,0,0,0,0,0,0,0,0,0,0,0,0,5,2,3,0,0,0,0,0,0,0,0,0
240620,21010,210,10,-2,12,3,9,0,0,0,0,0,0,0,0,0,1,0,1,0,0,0,10,3,7,0,0,0,1,0,1,0,0,0
240657,21010,210,10,-2,4,3,1,0,0,0,0,0,0,0,0,0,0,0,0,0,0,0,4,3,1,0,0,0,0,0,0,0,0,0
240666,21010,210,10,-2,6,1,5,0,0,0,0,0,0,0,0,0,0,0,0,0,0,0,6,1,5,0,0,0,0,0,0,0,0,0
240693,21010,210,10,-2,6,4,2,0,0,0,0,0,0,0,0,0,0,0,0,0,0,0,6,4,2,0,0,0,0,0,0,0,0,0
240718,21010,210,10,-2,14,13,1,0,0,0,0,0,0,0,0,0,0,0,0,0,0,0,14,13,1,0,0,0,0,0,0,0,0,0
240727,21010,210,10,-2,32,15,17,0,0,0,0,0,0,0,0,0,1,1,0,0,0,0,18,6,12,0,0,0,11,7,4,2,1,1
240736,21010,210,10,-2,1,1,0,0,0,0,0,0,0,0,0,0,0,0,0,1,1,0,0,0,0,0,0,0,0,0,0,0,0,0
240745,21010,210,10,-2,4,1,3,0,0,0,2,0,2,0,0,0,0,0,0,1,1,0,1,0,1,0,0,0,0,0,0,0,0,0
240754,21010,210,10,-2,7,3,4,0,0,0,4,1,3,0,0,0,0,0,0,1,0,1,2,2,0,0,0,0,0,0,0,0,0,0
240790,21010,210,10,-2,1,1,0,0,0,0,0,0,0,0,0,0,0,0,0,1,1,0,0,0,0,0,0,0,0,0,0,0,0,0
241191,21010,210,10,-2,2,0,2,0,0,0,0,0,0,0,0,0,2,0,2,0,0,0,0,0,0,0,0,0,0,0,0,0,0,0
241225,21010,210,10,-2,3,1,2,0,0,0,0,0,0,0,0,0,3,1,2,0,0,0,0,0,0,0,0,0,0,0,0,0,0,0
241331,21010,210,10,-2,2,1,1,0,0,0,0,0,0,0,0,0,2,1,1,0,0,0,0,0,0,0,0,0,0,0,0,0,0,0
241395,21010,210,10,-2,1,0,1,0,0,0,0,0,0,0,0,0,1,0,1,0,0,0,0,0,0,0,0,0,0,0,0,0,0,0
241410,21010,210,10,-2,5,2,3,0,0,0,0,0,0,0,0,0,5,2,3,0,0,0,0,0,0,0,0,0,0,0,0,0,0,0
241739,21010,210,10,-2,10,2,8,0,0,0,0,0,0,0,0,0,10,2,8,0,0,0,0,0,0,0,0,0,0,0,0,0,0,0
241766,21010,210,10,-2,2,1,1,0,0,0,0,0,0,0,0,0,2,1,1,0,0,0,0,0,0,0,0,0,0,0,0,0,0,0
241836,21010,210,10,-2,5,1,4,0,0,0,0,0,0,0,0,0,5,1,4,0,0,0,0,0,0,0,0,0,0,0,0,0,0,0
241951,21010,210,10,-2,1,1,0,0,0,0,0,0,0,0,0,0,1,1,0,0,0,0,0,0,0,0,0,0,0,0,0,0,0,0
242112,21010,210,10,-2,1,0,1,0,0,0,0,0,0,0,0,0,1,0,1,0,0,0,0,0,0,0,0,0,0,0,0,0,0,0
242130,21010,210,10,-2,1,1,0,0,0,0,0,0,0,0,0,0,1,1,0,0,0,0,0,0,0,0,0,0,0,0,0,0,0,0
242617,21010,210,10,-2,2,0,2,0,0,0,0,0,0,0,0,0,2,0,2,0,0,0,0,0,0,0,0,0,0,0,0,0,0,0
242635,21010,210,10,-2,12,6,6,0,0,0,0,0,0,0,0,0,12,6,6,0,0,0,0,0,0,0,0,0,0,0,0,0,0,0
242644,21010,210,10,-2,5,2,3,0,0,0,0,0,0,0,0,0,5,2,3,0,0,0,0,0,0,0,0,0,0,0,0,0,0,0
242653,21010,210,10,-2,9,3,6,0,0,0,0,0,0,0,0,0,9,3,6,0,0,0,0,0,0,0,0,0,0,0,0,0,0,0
242662,21010,210,10,-2,5,2,3,0,0,0,0,0,0,0,0,0,5,2,3,0,0,0,0,0,0,0,0,0,0,0,0,0,0,0
242680,21010,210,10,-2,3,0,3,0,0,0,0,0,0,0,0,0,3,0,3,0,0,0,0,0,0,0,0,0,0,0,0,0,0,0
242699,21010,210,10,-2,5,5,0,0,0,0,0,0,0,0,0,0,5,5,0,0,0,0,0,0,0,0,0,0,0,0,0,0,0,0
242705,21010,210,10,-2,7,3,4,0,0,0,0,0,0,0,0,0,7,3,4,0,0,0,0,0,0,0,0,0,0,0,0,0,0,0
243081,21010,210,10,-2,5,2,3,0,0,0,0,0,0,0,0,0,5,2,3,0,0,0,0,0,0,0,0,0,0,0,0,0,0,0
243151,21010,210,10,-2,2,1,1,0,0,0,0,0,0,0,0,0,2,1,1,0,0,0,0,0,0,0,0,0,0,0,0,0,0,0
243179,21010,210,10,-2,4,3,1,0,0,0,0,0,0,0,0,0,2,1,1,0,0,0,0,0,0,0,0,0,1,1,0,1,1,0
243197,21010,210,10,-2,25,15,10,0,0,0,0,0,0,0,0,0,1,0,1,0,0,0,0,0,0,0,0,0,24,15,9,0,0,0
243346,21010,210,10,-2,1,1,0,0,0,0,0,0,0,0,0,0,1,1,0,0,0,0,0,0,0,0,0,0,0,0,0,0,0,0
243443,21010,210,10,-2,15,4,11,0,0,0,0,0,0,0,0,0,15,4,11,0,0,0,0,0,0,0,0,0,0,0,0,0,0,0
243568,21010,210,10,-2,7,3,4,0,0,0,0,0,0,0,0,0,7,3,4,0,0,0,0,0,0,0,0,0,0,0,0,0,0,0
243586,21010,210,10,-2,2,0,2,0,0,0,0,0,0,0,0,0,2,0,2,0,0,0,0,0,0,0,0,0,0,0,0,0,0,0
243601,21010,210,10,-2,3,1,2,0,0,0,0,0,0,0,0,0,2,1,1,0,0,0,1,0,1,0,0,0,0,0,0,0,0,0
243638,21010,210,10,-2,4,4,0,0,0,0,2,2,0,0,0,0,0,0,0,2,2,0,0,0,0,0,0,0,0,0,0,0,0,0
243647,21010,210,10,-2,1,0,1,0,0,0,0,0,0,0,0,0,0,0,0,1,0,1,0,0,0,0,0,0,0,0,0,0,0,0
243744,21010,210,10,-2,90,51,39,1,0,1,22,10,12,8,5,3,2,1,1,0,0,0,36,23,13,4,2,2,12,7,5,5,3,2
243780,21010,210,10,-2,97,68,29,0,0,0,20,13,7,3,3,0,5,4,1,0,0,0,35,25,10,3,2,1,0,0,0,31,21,10
243823,21010,210,10,-2,12,8,4,0,0,0,0,0,0,1,1,0,0,0,0,0,0,0,7,5,2,0,0,0,4,2,2,0,0,0
243832,21010,210,10,-2,9,1,8,0,0,0,0,0,0,0,0,0,9,1,8,0,0,0,0,0,0,0,0,0,0,0,0,0,0,0
244437,21010,210,10,-2,19,12,7,0,0,0,2,0,2,7,5,2,2,2,0,0,0,0,8,5,3,0,0,0,0,0,0,0,0,0
244446,21010,210,10,-2,27,7,20,0,0,0,1,1,0,17,4,13,0,0,0,0,0,0,9,2,7,0,0,0,0,0,0,0,0,0
245652,21010,210,10,-2,5,2,3,0,0,0,2,1,1,1,1,0,0,0,0,0,0,0,2,0,2,0,0,0,0,0,0,0,0,0
245953,21010,210,10,-2,4,3,1,0,0,0,0,0,0,1,1,0,0,0,0,0,0,0,3,2,1,0,0,0,0,0,0,0,0,0
246354,21010,210,10,-2,5,2,3,0,0,0,1,0,1,0,0,0,3,1,2,0,0,0,1,1,0,0,0,0,0,0,0,0,0,0
246813,21010,210,10,-2,35,21,14,2,2,0,2,0,2,8,3,5,0,0,0,0,0,0,23,16,7,0,0,0,0,0,0,0,0,0
246974,21010,210,10,-2,5,1,4,0,0,0,0,0,0,0,0,0,2,0,2,0,0,0,3,1,2,0,0,0,0,0,0,0,0,0
247649,21010,210,10,-2,4,0,4,0,0,0,0,0,0,0,0,0,0,0,0,0,0,0,4,0,4,0,0,0,0,0,0,0,0,0
247834,21010,210,10,-2,28,11,17,0,0,0,1,1,0,5,3,2,1,0,1,0,0,0,19,7,12,0,0,0,2,0,2,0,0,0
247940,21010,210,10,-2,4,1,3,0,0,0,0,0,0,0,0,0,0,0,0,0,0,0,4,1,3,0,0,0,0,0,0,0,0,0
248934,21010,210,10,-2,68,11,57,0,0,0,1,1,0,18,2,16,2,1,1,0,0,0,42,5,37,2,1,1,3,1,2,0,0,0
250027,21010,210,10,-2,5,1,4,0,0,0,0,0,0,0,0,0,0,0,0,0,0,0,5,1,4,0,0,0,0,0,0,0,0,0
251260,21010,210,10,-2,9,2,7,0,0,0,1,0,1,0,0,0,1,0,1,0,0,0,7,2,5,0,0,0,0,0,0,0,0,0
251312,21010,210,10,-2,1,0,1,0,0,0,0,0,0,0,0,0,0,0,0,0,0,0,1,0,1,0,0,0,0,0,0,0,0,0
260372,21010,210,10,-2,2,1,1,2,1,1,0,0,0,0,0,0,0,0,0,0,0,0,0,0,0,0,0,0,0,0,0,0,0,0
260691,21010,210,10,-2,4,2,2,0,0,0,0,0,0,0,0,0,0,0,0,0,0,0,4,2,2,0,0,0,0,0,0,0,0,0
260789,21010,210,10,-2,5,0,5,0,0,0,1,0,1,0,0,0,2,0,2,0,0,0,2,0,2,0,0,0,0,0,0,0,0,0
260992,21010,210,10,-2,4,0,4,0,0,0,0,0,0,2,0,2,0,0,0,0,0,0,2,0,2,0,0,0,0,0,0,0,0,0
262031,21010,210,10,-2,3,3,0,0,0,0,0,0,0,1,1,0,0,0,0,0,0,0,2,2,0,0,0,0,0,0,0,0,0,0
262086,21010,210,10,-2,7,0,7,0,0,0,1,0,1,3,0,3,1,0,1,0,0,0,2,0,2,0,0,0,0,0,0,0,0,0
262129,21010,210,10,-2,3,1,2,0,0,0,1,0,1,0,0,0,0,0,0,0,0,0,0,0,0,0,0,0,0,0,0,2,1,1
363633,21010,210,10,-2,1,0,1,0,0,0,0,0,0,0,0,0,1,0,1,0,0,0,0,0,0,0,0,0,0,0,0,0,0,0
363934,21010,210,10,-2,3,2,1,0,0,0,1,0,1,0,0,0,0,0,0,0,0,0,2,2,0,0,0,0,0,0,0,0,0,0
364016,21010,210,10,-2,11,5,6,0,0,0,0,0,0,1,1,0,1,0,1,0,0,0,8,4,4,1,0,1,0,0,0,0,0,0
364025,21010,210,10,-2,11,3,8,0,0,0,0,0,0,1,0,1,1,0,1,0,0,0,9,3,6,0,0,0,0,0,0,0,0,0
366252,21010,210,10,-2,6,6,0,0,0,0,0,0,0,0,0,0,0,0,0,0,0,0,6,6,0,0,0,0,0,0,0,0,0,0
366270,21010,210,10,-2,3,0,3,0,0,0,0,0,0,2,0,2,0,0,0,0,0,0,1,0,1,0,0,0,0,0,0,0,0,0
366340,21010,210,10,-2,1,0,1,0,0,0,0,0,0,0,0,0,0,0,0,0,0,0,1,0,1,0,0,0,0,0,0,0,0,0
366553,21010,210,10,-2,20,5,15,0,0,0,0,0,0,2,0,2,1,1,0,0,0,0,17,4,13,0,0,0,0,0,0,0,0,0
366711,21010,210,10,-2,19,7,12,0,0,0,3,0,3,1,0,1,4,2,2,0,0,0,6,1,5,1,1,0,0,0,0,4,3,1
367459,21010,210,10,-2,13,2,11,0,0,0,1,0,1,0,0,0,0,0,0,0,0,0,11,2,9,0,0,0,1,0,1,0,0,0
367954,21010,210,10,-2,25,3,22,0,0,0,1,0,1,0,0,0,1,0,1,0,0,0,22,3,19,1,0,1,0,0,0,0,0,0
368629,21010,210,10,-2,2,0,2,0,0,0,0,0,0,0,0,0,1,0,1,0,0,0,1,0,1,0,0,0,0,0,0,0,0,0
368911,21010,210,10,-2,9,3,6,0,0,0,1,1,0,0,0,0,0,0,0,0,0,0,8,2,6,0,0,0,0,0,0,0,0,0
372329,21010,210,10,-2,3,0,3,0,0,0,0,0,0,0,0,0,1,0,1,0,0,0,2,0,2,0,0,0,0,0,0,0,0,0
376695,21010,210,10,-2,4,3,1,0,0,0,0,0,0,0,0,0,0,0,0,1,1,0,3,2,1,0,0,0,0,0,0,0,0,0
377555,21010,210,10,-2,7,2,5,0,0,0,4,1,3,0,0,0,1,0,1,0,0,0,2,1,1,0,0,0,0,0,0,0,0,0
377564,21010,210,10,-2,18,10,8,0,0,0,1,0,1,3,2,1,0,0,0,0,0,0,9,6,3,2,1,1,2,1,1,1,0,1
378105,21010,210,10,-2,5,3,2,0,0,0,0,0,0,0,0,0,3,2,1,0,0,0,2,1,1,0,0,0,0,0,0,0,0,0
378576,21010,210,10,-2,1,0,1,0,0,0,0,0,0,0,0,0,0,0,0,0,0,0,0,0,0,0,0,0,1,0,1,0,0,0
379746,21010,210,10,-2,3,1,2,0,0,0,0,0,0,1,0,1,0,0,0,0,0,0,2,1,1,0,0,0,0,0,0,0,0,0
380359,21010,210,10,-2,3,1,2,1,1,0,0,0,0,0,0,0,0,0,0,0,0,0,2,0,2,0,0,0,0,0,0,0,0,0
380368,21010,210,10,-2,1,0,1,0,0,0,0,0,0,0,0,0,0,0,0,0,0,0,1,0,1,0,0,0,0,0,0,0,0,0
380377,21010,210,10,-2,5,2,3,1,1,0,0,0,0,1,1,0,0,0,0,0,0,0,1,0,1,2,0,2,0,0,0,0,0,0
380438,21010,210,10,-2,8,2,6,0,0,0,0,0,0,0,0,0,0,0,0,0,0,0,7,1,6,1,1,0,0,0,0,0,0,0
382957,21010,210,10,-2,6,2,4,0,0,0,0,0,0,1,0,1,0,0,0,0,0,0,3,1,2,0,0,0,2,1,1,0,0,0
384254,21010,210,10,-2,5,1,4,0,0,0,0,0,0,3,1,2,1,0,1,0,0,0,1,0,1,0,0,0,0,0,0,0,0,0
384333,21010,210,10,-2,8,3,5,0,0,0,0,0,0,0,0,0,1,0,1,0,0,0,7,3,4,0,0,0,0,0,0,0,0,0
384342,21010,210,10,-2,5,4,1,0,0,0,0,0,0,0,0,0,0,0,0,0,0,0,5,4,1,0,0,0,0,0,0,0,0,0
385415,21010,210,10,-2,1,0,1,0,0,0,0,0,0,0,0,0,0,0,0,0,0,0,1,0,1,0,0,0,0,0,0,0,0,0
385503,21010,210,10,-2,3,0,3,0,0,0,0,0,0,1,0,1,0,0,0,0,0,0,2,0,2,0,0,0,0,0,0,0,0,0
385619,21010,210,10,-2,4,4,0,0,0,0,1,1,0,0,0,0,1,1,0,0,0,0,0,0,0,2,2,0,0,0,0,0,0,0
386472,21010,210,10,-2,3,0,3,0,0,0,0,0,0,1,0,1,0,0,0,0,0,0,1,0,1,0,0,0,1,0,1,0,0,0
392257,21010,210,10,-2,13,1,12,0,0,0,1,0,1,7,0,7,2,1,1,0,0,0,3,0,3,0,0,0,0,0,0,0,0,0
392415,21010,210,10,-2,1,0,1,0,0,0,0,0,0,1,0,1,0,0,0,0,0,0,0,0,0,0,0,0,0,0,0,0,0,0
395362,21010,210,10,-2,1,0,1,0,0,0,0,0,0,0,0,0,0,0,0,0,0,0,1,0,1,0,0,0,0,0,0,0,0,0
399869,21010,210,10,-2,1,1,0,0,0,0,0,0,0,0,0,0,0,0,0,0,0,0,1,1,0,0,0,0,0,0,0,0,0,0
399911,21010,210,10,-2,3,1,2,0,0,0,2,0,2,0,0,0,0,0,0,0,0,0,1,1,0,0,0,0,0,0,0,0,0,0
403469,21010,210,10,-2,2,1,1,0,0,0,0,0,0,0,0,0,0,0,0,0,0,0,2,1,1,0,0,0,0,0,0,0,0,0
403478,21010,210,10,-2,3,1,2,0,0,0,0,0,0,0,0,0,0,0,0,0,0,0,3,1,2,0,0,0,0,0,0,0,0,0
403487,21010,210,10,-2,3,2,1,0,0,0,0,0,0,0,0,0,0,0,0,0,0,0,3,2,1,0,0,0,0,0,0,0,0,0
404222,21010,210,10,-2,1,1,0,0,0,0,0,0,0,0,0,0,1,1,0,0,0,0,0,0,0,0,0,0,0,0,0,0,0,0
404426,21010,210,10,-2,3,1,2,1,1,0,0,0,0,0,0,0,1,0,1,0,0,0,1,0,1,0,0,0,0,0,0,0,0,0
404912,21010,210,10,-2,5,1,4,0,0,0,0,0,0,1,1,0,0,0,0,0,0,0,4,0,4,0,0,0,0,0,0,0,0,0
404994,21010,210,10,-2,6,2,4,0,0,0,0,0,0,0,0,0,3,1,2,0,0,0,3,1,2,0,0,0,0,0,0,0,0,0
405872,21010,210,10,-2,2,1,1,0,0,0,0,0,0,0,0,0,0,0,0,0,0,0,2,1,1,0,0,0,0,0,0,0,0,0
406024,21010,210,10,-2,20,2,18,0,0,0,1,0,1,1,0,1,3,1,2,0,0,0,14,1,13,1,0,1,0,0,0,0,0,0
406033,21010,210,10,-2,20,3,17,0,0,0,3,1,2,0,0,0,7,1,6,0,0,0,9,1,8,0,0,0,1,0,1,0,0,0
407629,21010,210,10,-2,28,15,13,0,0,0,4,2,2,1,0,1,0,0,0,0,0,0,23,13,10,0,0,0,0,0,0,0,0,0
408729,21010,210,10,-2,1,0,1,0,0,0,0,0,0,0,0,0,0,0,0,0,0,0,1,0,1,0,0,0,0,0,0,0,0,0
408844,21010,210,10,-2,13,7,6,0,0,0,0,0,0,2,1,1,11,6,5,0,0,0,0,0,0,0,0,0,0,0,0,0,0,0
409254,21010,210,10,-2,2,0,2,0,0,0,0,0,0,2,0,2,0,0,0,0,0,0,0,0,0,0,0,0,0,0,0,0,0,0
409315,21010,210,10,-2,54,34,20,0,0,0,3,1,2,0,0,0,36,21,15,0,0,0,10,7,3,0,0,0,2,2,0,3,3,0
409698,21010,210,10,-2,7,3,4,0,0,0,1,0,1,0,0,0,1,1,0,0,0,0,4,1,3,0,0,0,0,0,0,1,1,0
412173,21010,210,10,-2,3,0,3,0,0,0,0,0,0,0,0,0,0,0,0,0,0,0,3,0,3,0,0,0,0,0,0,0,0,0
413413,21010,210,10,-2,6,1,5,0,0,0,0,0,0,1,0,1,0,0,0,0,0,0,4,1,3,0,0,0,1,0,1,0,0,0
413626,21010,210,10,-2,1,1,0,0,0,0,0,0,0,0,0,0,0,0,0,0,0,0,1,1,0,0,0,0,0,0,0,0,0,0
414911,21010,210,10,-2,1,1,0,0,0,0,0,0,0,0,0,0,0,0,0,0,0,0,1,1,0,0,0,0,0,0,0,0,0,0
414966,21010,210,10,-2,2,0,2,0,0,0,0,0,0,0,0,0,0,0,0,0,0,0,2,0,2,0,0,0,0,0,0,0,0,0
416458,21010,210,10,-2,1,0,1,0,0,0,1,0,1,0,0,0,0,0,0,0,0,0,0,0,0,0,0,0,0,0,0,0,0,0
420398,21010,210,10,-2,2,0,2,0,0,0,1,0,1,0,0,0,0,0,0,0,0,0,1,0,1,0,0,0,0,0,0,0,0,0
420440,21010,210,10,-2,3,0,3,0,0,0,0,0,0,0,0,0,0,0,0,0,0,0,3,0,3,0,0,0,0,0,0,0,0,0
420538,21010,210,10,-2,1,1,0,0,0,0,0,0,0,0,0,0,0,0,0,0,0,0,1,1,0,0,0,0,0,0,0,0,0,0
420556,21010,210,10,-2,4,2,2,0,0,0,0,0,0,0,0,0,1,0,1,0,0,0,3,2,1,0,0,0,0,0,0,0,0,0
422020,21010,210,10,-2,2,2,0,0,0,0,0,0,0,0,0,0,1,1,0,0,0,0,0,0,0,0,0,0,1,1,0,0,0,0
422695,21010,210,10,-2,2,0,2,0,0,0,0,0,0,0,0,0,0,0,0,0,0,0,2,0,2,0,0,0,0,0,0,0,0,0
423643,21010,210,10,-2,11,11,0,0,0,0,2,2,0,3,3,0,1,1,0,0,0,0,5,5,0,0,0,0,0,0,0,0,0,0
423652,21010,210,10,-2,4,1,3,0,0,0,0,0,0,0,0,0,0,0,0,0,0,0,4,1,3,0,0,0,0,0,0,0,0,0
426314,21010,210,10,-2,11,7,4,0,0,0,0,0,0,0,0,0,0,0,0,0,0,0,6,4,2,1,1,0,4,2,2,0,0,0
428170,21010,210,10,-2,8,0,8,0,0,0,1,0,1,2,0,2,3,0,3,0,0,0,2,0,2,0,0,0,0,0,0,0,0,0
428392,21010,210,10,-2,4,1,3,0,0,0,0,0,0,0,0,0,0,0,0,0,0,0,4,1,3,0,0,0,0,0,0,0,0,0
429094,21010,210,10,-2,1,0,1,0,0,0,1,0,1,0,0,0,0,0,0,0,0,0,0,0,0,0,0,0,0,0,0,0,0,0
431141,21010,210,10,-2,21,4,17,0,0,0,1,0,1,1,0,1,6,1,5,1,0,1,11,3,8,0,0,0,1,0,1,0,0,0
432348,21010,210,10,-2,1,1,0,0,0,0,0,0,0,0,0,0,0,0,0,0,0,0,1,1,0,0,0,0,0,0,0,0,0,0
433004,21010,210,10,-2,7,5,2,1,1,0,2,1,1,0,0,0,0,0,0,0,0,0,4,3,1,0,0,0,0,0,0,0,0,0
433013,21010,210,10,-2,8,2,6,0,0,0,0,0,0,0,0,0,4,1,3,0,0,0,4,1,3,0,0,0,0,0,0,0,0,0
433174,21010,210,10,-2,8,1,7,0,0,0,1,1,0,1,0,1,0,0,0,0,0,0,6,0,6,0,0,0,0,0,0,0,0,0
433387,21010,210,10,-2,224,88,136,1,1,0,8,3,5,50,25,25,17,3,14,0,0,0,131,48,83,5,3,2,12,5,7,0,0,0
433420,21010,210,10,-2,9,9,0,0,0,0,0,0,0,0,0,0,2,2,0,0,0,0,7,7,0,0,0,0,0,0,0,0,0,0
433536,21010,210,10,-2,3,0,3,0,0,0,0,0,0,1,0,1,0,0,0,0,0,0,2,0,2,0,0,0,0,0,0,0,0,0
433660,21010,210,10,-2,39,16,23,0,0,0,6,2,4,3,1,2,4,1,3,0,0,0,18,9,9,2,0,2,0,0,0,6,3,3
434016,21010,210,10,-2,2,1,1,0,0,0,0,0,0,0,0,0,0,0,0,0,0,0,2,1,1,0,0,0,0,0,0,0,0,0
434061,21010,210,10,-2,20,8,12,0,0,0,1,0,1,10,2,8,0,0,0,1,0,1,7,5,2,0,0,0,0,0,0,1,1,0
434140,21010,210,10,-2,4,1,3,0,0,0,0,0,0,0,0,0,0,0,0,0,0,0,4,1,3,0,0,0,0,0,0,0,0,0
434584,21010,210,10,-2,1,1,0,0,0,0,1,1,0,0,0,0,0,0,0,0,0,0,0,0,0,0,0,0,0,0,0,0,0,0
434672,21010,210,10,-2,14,3,11,0,0,0,2,0,2,4,1,3,1,0,1,0,0,0,6,1,5,0,0,0,0,0,0,1,1,0
434751,21010,210,10,-2,1,1,0,1,1,0,0,0,0,0,0,0,0,0,0,0,0,0,0,0,0,0,0,0,0,0,0,0,0,0
435000,21010,210,10,-2,112,66,46,0,0,0,21,13,8,2,1,1,7,4,3,0,0,0,43,24,19,1,0,1,0,0,0,38,24,14
436304,21010,210,10,-2,12,5,7,0,0,0,0,0,0,4,1,3,1,1,0,0,0,0,7,3,4,0,0,0,0,0,0,0,0,0
436429,21010,210,10,-2,9,0,9,0,0,0,0,0,0,1,0,1,2,0,2,0,0,0,5,0,5,0,0,0,1,0,1,0,0,0
437103,21010,210,10,-2,5,1,4,0,0,0,0,0,0,3,0,3,0,0,0,0,0,0,2,1,1,0,0,0,0,0,0,0,0,0
437635,21010,210,10,-2,18,6,12,0,0,0,0,0,0,3,0,3,7,3,4,0,0,0,7,2,5,1,1,0,0,0,0,0,0,0
437936,21010,210,10,-2,4,3,1,0,0,0,1,1,0,0,0,0,1,1,0,0,0,0,2,1,1,0,0,0,0,0,0,0,0,0
438258,21010,210,10,-2,5,0,5,0,0,0,0,0,0,0,0,0,0,0,0,1,0,1,3,0,3,1,0,1,0,0,0,0,0,0
438708,21010,210,10,-2,3,1,2,0,0,0,0,0,0,0,0,0,0,0,0,0,0,0,3,1,2,0,0,0,0,0,0,0,0,0
439118,21010,210,10,-2,2,0,2,0,0,0,0,0,0,0,0,0,0,0,0,0,0,0,1,0,1,0,0,0,1,0,1,0,0,0
439367,21010,210,10,-2,5,1,4,0,0,0,0,0,0,0,0,0,2,0,2,0,0,0,3,1,2,0,0,0,0,0,0,0,0,0
439446,21010,210,10,-2,1,1,0,0,0,0,1,1,0,0,0,0,0,0,0,0,0,0,0,0,0,0,0,0,0,0,0,0,0,0
439570,21010,210,10,-2,8,1,7,0,0,0,0,0,0,2,0,2,0,0,0,0,0,0,6,1,5,0,0,0,0,0,0,0,0,0
439701,21010,210,10,-2,1,1,0,0,0,0,0,0,0,0,0,0,0,0,0,0,0,0,1,1,0,0,0,0,0,0,0,0,0,0
439738,21010,210,10,-2,1,0,1,0,0,0,0,0,0,1,0,1,0,0,0,0,0,0,0,0,0,0,0,0,0,0,0,0,0,0
439792,21010,210,10,-2,4,0,4,0,0,0,0,0,0,2,0,2,0,0,0,0,0,0,2,0,2,0,0,0,0,0,0,0,0,0
440031,21010,210,10,-2,10,2,8,0,0,0,1,0,1,2,0,2,0,0,0,0,0,0,6,1,5,0,0,0,1,1,0,0,0,0
440262,21010,210,10,-2,1,1,0,0,0,0,0,0,0,0,0,0,1,1,0,0,0,0,0,0,0,0,0,0,0,0,0,0,0,0
440396,21010,210,10,-2,1,0,1,0,0,0,0,0,0,0,0,0,0,0,0,0,0,0,1,0,1,0,0,0,0,0,0,0,0,0
440402,21010,210,10,-2,12,4,8,0,0,0,0,0,0,0,0,0,1,1,0,0,0,0,11,3,8,0,0,0,0,0,0,0,0,0
440651,21010,210,10,-2,1,0,1,0,0,0,0,0,0,0,0,0,1,0,1,0,0,0,0,0,0,0,0,0,0,0,0,0,0,0
440794,21010,210,10,-2,1,0,1,0,0,0,0,0,0,1,0,1,0,0,0,0,0,0,0,0,0,0,0,0,0,0,0,0,0,0
440916,21010,210,10,-2,13,7,6,0,0,0,1,1,0,7,2,5,0,0,0,0,0,0,5,4,1,0,0,0,0,0,0,0,0,0
441025,21010,210,10,-2,3,3,0,0,0,0,0,0,0,0,0,0,0,0,0,0,0,0,3,3,0,0,0,0,0,0,0,0,0,0
441131,21010,210,10,-2,1,1,0,0,0,0,0,0,0,0,0,0,0,0,0,0,0,0,1,1,0,0,0,0,0,0,0,0,0,0
441371,21010,210,10,-2,50,9,41,0,0,0,1,0,1,20,2,18,3,2,1,0,0,0,23,5,18,1,0,1,2,0,2,0,0,0
441423,21010,210,10,-2,3,2,1,0,0,0,0,0,0,0,0,0,3,2,1,0,0,0,0,0,0,0,0,0,0,0,0,0,0,0
441609,21010,210,10,-2,1,1,0,0,0,0,0,0,0,0,0,0,0,0,0,0,0,0,1,1,0,0,0,0,0,0,0,0,0,0
441636,21010,210,10,-2,4,1,3,0,0,0,0,0,0,1,0,1,0,0,0,0,0,0,3,1,2,0,0,0,0,0,0,0,0,0
441742,21010,210,10,-2,2,1,1,0,0,0,1,1,0,1,0,1,0,0,0,0,0,0,0,0,0,0,0,0,0,0,0,0,0,0
441760,21010,210,10,-2,6,1,5,1,0,1,0,0,0,0,0,0,1,1,0,0,0,0,3,0,3,0,0,0,1,0,1,0,0,0
441900,21010,210,10,-2,13,6,7,0,0,0,1,0,1,2,1,1,2,1,1,0,0,0,8,4,4,0,0,0,0,0,0,0,0,0
441937,21010,210,10,-2,5,2,3,0,0,0,1,1,0,0,0,0,2,0,2,0,0,0,0,0,0,2,1,1,0,0,0,0,0,0
441982,21010,210,10,-2,1,0,1,0,0,0,0,0,0,0,0,0,1,0,1,0,0,0,0,0,0,0,0,0,0,0,0,0,0,0
442134,21010,210,10,-2,2,0,2,0,0,0,0,0,0,0,0,0,1,0,1,0,0,0,1,0,1,0,0,0,0,0,0,0,0,0
442295,21010,210,10,-2,1,1,0,0,0,0,0,0,0,0,0,0,0,0,0,0,0,0,1,1,0,0,0,0,0,0,0,0,0,0
442356,21010,210,10,-2,16,0,16,0,0,0,1,0,1,0,0,0,0,0,0,0,0,0,15,0,15,0,0,0,0,0,0,0,0,0
442426,21010,210,10,-2,2,1,1,0,0,0,0,0,0,0,0,0,0,0,0,0,0,0,2,1,1,0,0,0,0,0,0,0,0,0
442444,21010,210,10,-2,4,2,2,0,0,0,0,0,0,0,0,0,0,0,0,0,0,0,3,2,1,0,0,0,1,0,1,0,0,0
442602,21010,210,10,-2,5,0,5,0,0,0,0,0,0,0,0,0,1,0,1,0,0,0,3,0,3,1,0,1,0,0,0,0,0,0
442781,21010,210,10,-2,4,2,2,2,0,2,2,2,0,0,0,0,0,0,0,0,0,0,0,0,0,0,0,0,0,0,0,0,0,0
442806,21010,210,10,-2,29,17,12,0,0,0,4,1,3,1,0,1,1,0,1,0,0,0,23,16,7,0,0,0,0,0,0,0,0,0
442930,21010,210,10,-2,1,0,1,0,0,0,0,0,0,0,0,0,0,0,0,0,0,0,1,0,1,0,0,0,0,0,0,0,0,0
443128,21010,210,10,-2,1,1,0,0,0,0,0,0,0,0,0,0,0,0,0,0,0,0,1,1,0,0,0,0,0,0,0,0,0,0
443261,21010,210,10,-2,5,1,4,0,0,0,0,0,0,3,1,2,0,0,0,0,0,0,2,0,2,0,0,0,0,0,0,0,0,0
443377,21010,210,10,-2,3,3,0,0,0,0,0,0,0,0,0,0,0,0,0,0,0,0,3,3,0,0,0,0,0,0,0,0,0,0
443410,21010,210,10,-2,3,1,2,0,0,0,0,0,0,0,0,0,0,0,0,0,0,0,3,1,2,0,0,0,0,0,0,0,0,0
443492,21010,210,10,-2,2,1,1,0,0,0,0,0,0,0,0,0,0,0,0,0,0,0,2,1,1,0,0,0,0,0,0,0,0,0
443599,21010,210,10,-2,1,1,0,0,0,0,0,0,0,0,0,0,0,0,0,0,0,0,1,1,0,0,0,0,0,0,0,0,0,0
443650,21010,210,10,-2,3,1,2,0,0,0,0,0,0,0,0,0,0,0,0,0,0,0,3,1,2,0,0,0,0,0,0,0,0,0
443748,21010,210,10,-2,1,0,1,0,0,0,0,0,0,1,0,1,0,0,0,0,0,0,0,0,0,0,0,0,0,0,0,0,0,0
444088,21010,210,10,-2,4,0,4,1,0,1,0,0,0,0,0,0,1,0,1,1,0,1,1,0,1,0,0,0,0,0,0,0,0,0
444130,21010,210,10,-2,6,3,3,0,0,0,0,0,0,2,1,1,0,0,0,0,0,0,4,2,2,0,0,0,0,0,0,0,0,0
444556,21010,210,10,-2,5,3,2,0,0,0,0,0,0,0,0,0,0,0,0,1,0,1,1,0,1,1,1,0,2,2,0,0,0,0
444787,21010,210,10,-2,65,7,58,0,0,0,1,0,1,10,0,10,0,0,0,0,0,0,47,5,42,0,0,0,7,2,5,0,0,0
444811,21010,210,10,-2,3,1,2,0,0,0,0,0,0,2,1,1,0,0,0,0,0,0,1,0,1,0,0,0,0,0,0,0,0,0
444866,21010,210,10,-2,3,0,3,0,0,0,0,0,0,1,0,1,0,0,0,0,0,0,1,0,1,1,0,1,0,0,0,0,0,0
444954,21010,210,10,-2,7,3,4,0,0,0,0,0,0,0,0,0,1,0,1,0,0,0,6,3,3,0,0,0,0,0,0,0,0,0
445188,21010,210,10,-2,32,18,14,1,0,1,1,1,0,2,2,0,2,1,1,0,0,0,14,5,9,1,0,1,4,4,0,7,5,2
445230,21010,210,10,-2,4,2,2,0,0,0,0,0,0,1,0,1,1,1,0,0,0,0,2,1,1,0,0,0,0,0,0,0,0,0
445692,21010,210,10,-2,2,2,0,0,0,0,0,0,0,0,0,0,0,0,0,0,0,0,2,2,0,0,0,0,0,0,0,0,0,0
445735,21010,210,10,-2,9,4,5,0,0,0,0,0,0,0,0,0,3,2,1,0,0,0,6,2,4,0,0,0,0,0,0,0,0,0
445744,21010,210,10,-2,1,0,1,0,0,0,0,0,0,0,0,0,0,0,0,0,0,0,1,0,1,0,0,0,0,0,0,0,0,0
445869,21010,210,10,-2,5,2,3,0,0,0,0,0,0,1,0,1,0,0,0,0,0,0,3,2,1,0,0,0,1,0,1,0,0,0
445948,21010,210,10,-2,30,11,19,0,0,0,1,0,1,6,2,4,9,1,8,1,1,0,10,4,6,2,2,0,1,1,0,0,0,0
446048,21010,210,10,-2,9,6,3,0,0,0,1,0,1,0,0,0,1,1,0,0,0,0,7,5,2,0,0,0,0,0,0,0,0,0
446118,21010,210,10,-2,14,3,11,0,0,0,3,1,2,3,0,3,4,1,3,0,0,0,4,1,3,0,0,0,0,0,0,0,0,0
446127,21010,210,10,-2,1,0,1,0,0,0,0,0,0,0,0,0,0,0,0,0,0,0,1,0,1,0,0,0,0,0,0,0,0,0
446385,21010,210,10,-2,1,0,1,0,0,0,1,0,1,0,0,0,0,0,0,0,0,0,0,0,0,0,0,0,0,0,0,0,0,0
446552,21010,210,10,-2,18,10,8,0,0,0,0,0,0,1,1,0,4,3,1,0,0,0,12,5,7,1,1,0,0,0,0,0,0,0
446561,21010,210,10,-2,8,4,4,0,0,0,1,0,1,1,1,0,1,1,0,0,0,0,5,2,3,0,0,0,0,0,0,0,0,0
446604,21010,210,10,-2,12,12,0,0,0,0,0,0,0,0,0,0,0,0,0,0,0,0,12,12,0,0,0,0,0,0,0,0,0,0
446640,21010,210,10,-2,6,6,0,0,0,0,1,1,0,0,0,0,0,0,0,0,0,0,3,3,0,0,0,0,2,2,0,0,0,0
446774,21010,210,10,-2,7,3,4,0,0,0,0,0,0,0,0,0,0,0,0,0,0,0,7,3,4,0,0,0,0,0,0,0,0,0
447014,21010,210,10,-2,1,0,1,0,0,0,0,0,0,0,0,0,0,0,0,0,0,0,1,0,1,0,0,0,0,0,0,0,0,0
447263,21010,210,10,-2,43,5,38,0,0,0,1,0,1,2,1,1,0,0,0,0,0,0,27,2,25,0,0,0,13,2,11,0,0,0
447351,21010,210,10,-2,4,1,3,0,0,0,0,0,0,0,0,0,1,0,1,0,0,0,3,1,2,0,0,0,0,0,0,0,0,0
447582,21010,210,10,-2,8,3,5,0,0,0,0,0,0,1,1,0,0,0,0,0,0,0,7,2,5,0,0,0,0,0,0,0,0,0
447591,21010,210,10,-2,7,1,6,0,0,0,0,0,0,5,0,5,0,0,0,0,0,0,1,0,1,1,1,0,0,0,0,0,0,0
447689,21010,210,10,-2,13,4,9,0,0,0,0,0,0,3,1,2,0,0,0,0,0,0,10,3,7,0,0,0,0,0,0,0,0,0
447953,21010,210,10,-2,2,2,0,0,0,0,1,1,0,0,0,0,1,1,0,0,0,0,0,0,0,0,0,0,0,0,0,0,0,0
448354,21010,210,10,-2,2,1,1,0,0,0,0,0,0,0,0,0,0,0,0,0,0,0,2,1,1,0,0,0,0,0,0,0,0,0
448594,21010,210,10,-2,3,1,2,0,0,0,1,1,0,1,0,1,0,0,0,0,0,0,0,0,0,0,0,0,1,0,1,0,0,0
448600,21010,210,10,-2,7,1,6,0,0,0,0,0,0,0,0,0,0,0,0,0,0,0,7,1,6,0,0,0,0,0,0,0,0,0
448673,21010,210,10,-2,15,3,12,0,0,0,1,1,0,0,0,0,1,0,1,0,0,0,12,2,10,0,0,0,1,0,1,0,0,0
448859,21010,210,10,-2,2,2,0,0,0,0,0,0,0,0,0,0,0,0,0,0,0,0,2,2,0,0,0,0,0,0,0,0,0,0
449074,21010,210,10,-2,4,1,3,0,0,0,0,0,0,0,0,0,1,0,1,0,0,0,2,1,1,1,0,1,0,0,0,0,0,0
449250,21010,210,10,-2,8,1,7,0,0,0,0,0,0,1,0,1,2,0,2,1,0,1,4,1,3,0,0,0,0,0,0,0,0,0
449339,21010,210,10,-2,3,1,2,0,0,0,0,0,0,0,0,0,1,0,1,0,0,0,1,0,1,0,0,0,1,1,0,0,0,0
449524,21010,210,10,-2,3,0,3,0,0,0,0,0,0,0,0,0,0,0,0,0,0,0,3,0,3,0,0,0,0,0,0,0,0,0
449728,21010,210,10,-2,2,0,2,0,0,0,0,0,0,0,0,0,0,0,0,0,0,0,2,0,2,0,0,0,0,0,0,0,0,0
449764,21010,210,10,-2,1,1,0,0,0,0,0,0,0,0,0,0,0,0,0,0,0,0,1,1,0,0,0,0,0,0,0,0,0,0
449870,21010,210,10,-2,1,1,0,0,0,0,0,0,0,0,0,0,0,0,0,0,0,0,1,1,0,0,0,0,0,0,0,0,0,0
449889,21010,210,10,-2,4,0,4,0,0,0,0,0,0,1,0,1,0,0,0,0,0,0,3,0,3,0,0,0,0,0,0,0,0,0
449898,21010,210,10,-2,4,1,3,0,0,0,0,0,0,1,0,1,0,0,0,0,0,0,3,1,2,0,0,0,0,0,0,0,0,0
449922,21010,210,10,-2,1,1,0,0,0,0,1,1,0,0,0,0,0,0,0,0,0,0,0,0,0,0,0,0,0,0,0,0,0,0
450058,21010,210,10,-2,15,2,13,0,0,0,1,0,1,2,0,2,0,0,0,0,0,0,11,2,9,1,0,1,0,0,0,0,0,0
450067,21010,210,10,-2,4,0,4,0,0,0,0,0,0,0,0,0,0,0,0,0,0,0,4,0,4,0,0,0,0,0,0,0,0,0
450304,21010,210,10,-2,1,1,0,0,0,0,0,0,0,1,1,0,0,0,0,0,0,0,0,0,0,0,0,0,0,0,0,0,0,0
450571,21010,210,10,-2,1,0,1,0,0,0,0,0,0,0,0,0,0,0,0,0,0,0,1,0,1,0,0,0,0,0,0,0,0,0
450696,21010,210,10,-2,5,1,4,0,0,0,0,0,0,1,1,0,1,0,1,0,0,0,3,0,3,0,0,0,0,0,0,0,0,0
450702,21010,210,10,-2,2,0,2,0,0,0,0,0,0,0,0,0,0,0,0,0,0,0,2,0,2,0,0,0,0,0,0,0,0,0
450933,21010,210,10,-2,4,0,4,0,0,0,0,0,0,1,0,1,0,0,0,0,0,0,3,0,3,0,0,0,0,0,0,0,0,0
451103,21010,210,10,-2,3,0,3,0,0,0,0,0,0,0,0,0,3,0,3,0,0,0,0,0,0,0,0,0,0,0,0,0,0,0
451404,21010,210,10,-2,6,6,0,0,0,0,0,0,0,0,0,0,0,0,0,0,0,0,6,6,0,0,0,0,0,0,0,0,0,0
451510,21010,210,10,-2,2,1,1,0,0,0,0,0,0,0,0,0,0,0,0,0,0,0,2,1,1,0,0,0,0,0,0,0,0,0
451750,21010,210,10,-2,8,0,8,0,0,0,1,0,1,1,0,1,0,0,0,0,0,0,6,0,6,0,0,0,0,0,0,0,0,0
451927,21010,210,10,-2,1,1,0,0,0,0,0,0,0,0,0,0,0,0,0,0,0,0,1,1,0,0,0,0,0,0,0,0,0,0
452124,21010,210,10,-2,5,0,5,0,0,0,0,0,0,1,0,1,0,0,0,0,0,0,4,0,4,0,0,0,0,0,0,0,0,0
452373,21010,210,10,-2,1,0,1,0,0,0,0,0,0,1,0,1,0,0,0,0,0,0,0,0,0,0,0,0,0,0,0,0,0,0
452948,21010,210,10,-2,6,0,6,0,0,0,0,0,0,1,0,1,0,0,0,0,0,0,5,0,5,0,0,0,0,0,0,0,0,0
454218,21010,210,10,-2,75,11,64,0,0,0,4,2,2,18,3,15,4,1,3,0,0,0,41,4,37,3,0,3,5,1,4,0,0,0
454786,21010,210,10,-2,3,1,2,0,0,0,0,0,0,1,0,1,0,0,0,0,0,0,2,1,1,0,0,0,0,0,0,0,0,0
454810,21010,210,10,-2,64,32,32,1,0,1,3,0,3,5,1,4,2,2,0,0,0,0,46,26,20,5,2,3,2,1,1,0,0,0
454829,21010,210,10,-2,13,0,13,0,0,0,1,0,1,0,0,0,0,0,0,0,0,0,11,0,11,0,0,0,1,0,1,0,0,0
454856,21010,210,10,-2,2,0,2,0,0,0,0,0,0,0,0,0,0,0,0,0,0,0,2,0,2,0,0,0,0,0,0,0,0,0
455114,21010,210,10,-2,19,13,6,0,0,0,0,0,0,0,0,0,1,1,0,0,0,0,17,11,6,0,0,0,1,1,0,0,0,0
455196,21010,210,10,-2,15,1,14,0,0,0,0,0,0,5,1,4,2,0,2,0,0,0,8,0,8,0,0,0,0,0,0,0,0,0
455257,21010,210,10,-2,1,1,0,0,0,0,0,0,0,0,0,0,0,0,0,0,0,0,1,1,0,0,0,0,0,0,0,0,0,0
455406,21010,210,10,-2,5,2,3,0,0,0,0,0,0,0,0,0,0,0,0,0,0,0,4,1,3,1,1,0,0,0,0,0,0,0
455433,21010,210,10,-2,1,1,0,0,0,0,0,0,0,0,0,0,0,0,0,0,0,0,0,0,0,1,1,0,0,0,0,0,0,0
455479,21010,210,10,-2,3,1,2,0,0,0,0,0,0,0,0,0,0,0,0,0,0,0,3,1,2,0,0,0,0,0,0,0,0,0
455512,21010,210,10,-2,1,0,1,0,0,0,0,0,0,0,0,0,0,0,0,0,0,0,1,0,1,0,0,0,0,0,0,0,0,0
455628,21010,210,10,-2,6,3,3,0,0,0,0,0,0,5,2,3,0,0,0,0,0,0,1,1,0,0,0,0,0,0,0,0,0,0
455664,21010,210,10,-2,12,4,8,0,0,0,0,0,0,2,0,2,1,1,0,0,0,0,7,2,5,2,1,1,0,0,0,0,0,0
455804,21010,210,10,-2,3,2,1,0,0,0,0,0,0,0,0,0,0,0,0,0,0,0,3,2,1,0,0,0,0,0,0,0,0,0
455813,21010,210,10,-2,1,0,1,0,0,0,0,0,0,0,0,0,0,0,0,0,0,0,1,0,1,0,0,0,0,0,0,0,0,0
456038,21010,210,10,-2,2,0,2,0,0,0,0,0,0,0,0,0,1,0,1,0,0,0,1,0,1,0,0,0,0,0,0,0,0,0
456205,21010,210,10,-2,5,2,3,0,0,0,0,0,0,1,0,1,0,0,0,0,0,0,4,2,2,0,0,0,0,0,0,0,0,0
456214,21010,210,10,-2,4,3,1,0,0,0,0,0,0,0,0,0,1,1,0,0,0,0,3,2,1,0,0,0,0,0,0,0,0,0
456454,21010,210,10,-2,5,3,2,0,0,0,0,0,0,0,0,0,0,0,0,0,0,0,5,3,2,0,0,0,0,0,0,0,0,0
456490,21010,210,10,-2,1,1,0,0,0,0,0,0,0,0,0,0,1,1,0,0,0,0,0,0,0,0,0,0,0,0,0,0,0,0
456542,21010,210,10,-2,3,1,2,0,0,0,0,0,0,1,0,1,0,0,0,0,0,0,2,1,1,0,0,0,0,0,0,0,0,0
456579,21010,210,10,-2,2,1,1,0,0,0,0,0,0,0,0,0,0,0,0,0,0,0,2,1,1,0,0,0,0,0,0,0,0,0
456852,21010,210,10,-2,1,1,0,0,0,0,0,0,0,1,1,0,0,0,0,0,0,0,0,0,0,0,0,0,0,0,0,0,0,0
457086,21010,210,10,-2,1,1,0,0,0,0,1,1,0,0,0,0,0,0,0,0,0,0,0,0,0,0,0,0,0,0,0,0,0,0
457101,21010,210,10,-2,8,2,6,0,0,0,1,1,0,1,0,1,1,1,0,0,0,0,4,0,4,0,0,0,1,0,1,0,0,0
457110,21010,210,10,-2,1,0,1,0,0,0,0,0,0,0,0,0,0,0,0,0,0,0,1,0,1,0,0,0,0,0,0,0,0,0
457299,21010,210,10,-2,3,1,2,0,0,0,1,0,1,0,0,0,2,1,1,0,0,0,0,0,0,0,0,0,0,0,0,0,0,0
457527,21010,210,10,-2,4,0,4,0,0,0,0,0,0,0,0,0,1,0,1,0,0,0,3,0,3,0,0,0,0,0,0,0,0,0
458210,21010,210,10,-2,5,2,3,0,0,0,2,0,2,0,0,0,1,1,0,0,0,0,2,1,1,0,0,0,0,0,0,0,0,0
458229,21010,210,10,-2,3,0,3,0,0,0,0,0,0,0,0,0,1,0,1,0,0,0,2,0,2,0,0,0,0,0,0,0,0,0
458405,21010,210,10,-2,3,2,1,0,0,0,0,0,0,2,2,0,0,0,0,0,0,0,0,0,0,1,0,1,0,0,0,0,0,0
458441,21010,210,10,-2,1,0,1,0,0,0,0,0,0,1,0,1,0,0,0,0,0,0,0,0,0,0,0,0,0,0,0,0,0,0
458681,21010,210,10,-2,5,2,3,0,0,0,0,0,0,1,1,0,0,0,0,0,0,0,4,1,3,0,0,0,0,0,0,0,0,0
459204,21010,210,10,-2,22,1,21,0,0,0,8,0,8,3,0,3,0,0,0,0,0,0,10,1,9,1,0,1,0,0,0,0,0,0
459213,21010,210,10,-2,14,2,12,0,0,0,3,0,3,0,0,0,1,0,1,1,0,1,6,1,5,0,0,0,3,1,2,0,0,0
459259,21010,210,10,-2,4,0,4,0,0,0,2,0,2,1,0,1,0,0,0,0,0,0,1,0,1,0,0,0,0,0,0,0,0,0
459268,21010,210,10,-2,2,0,2,0,0,0,0,0,0,1,0,1,0,0,0,0,0,0,1,0,1,0,0,0,0,0,0,0,0,0
459727,21010,210,10,-2,3,1,2,0,0,0,0,0,0,1,0,1,0,0,0,0,0,0,2,1,1,0,0,0,0,0,0,0,0,0
459736,21010,210,10,-2,2,0,2,0,0,0,0,0,0,0,0,0,0,0,0,0,0,0,1,0,1,1,0,1,0,0,0,0,0,0
459745,21010,210,10,-2,2,0,2,0,0,0,1,0,1,0,0,0,0,0,0,0,0,0,1,0,1,0,0,0,0,0,0,0,0,0
459824,21010,210,10,-2,9,2,7,0,0,0,1,0,1,1,0,1,0,0,0,0,0,0,7,2,5,0,0,0,0,0,0,0,0,0
459842,21010,210,10,-2,4,1,3,0,0,0,0,0,0,1,0,1,0,0,0,0,0,0,3,1,2,0,0,0,0,0,0,0,0,0
459851,21010,210,10,-2,6,2,4,0,0,0,0,0,0,0,0,0,0,0,0,0,0,0,6,2,4,0,0,0,0,0,0,0,0,0
459949,21010,210,10,-2,24,11,13,0,0,0,0,0,0,1,0,1,8,6,2,0,0,0,13,5,8,0,0,0,1,0,1,1,0,1
460020,21010,210,10,-2,1,0,1,0,0,0,0,0,0,1,0,1,0,0,0,0,0,0,0,0,0,0,0,0,0,0,0,0,0,0
460136,21010,210,10,-2,8,0,8,0,0,0,0,0,0,3,0,3,2,0,2,0,0,0,2,0,2,1,0,1,0,0,0,0,0,0
460181,21010,210,10,-2,1,0,1,0,0,0,0,0,0,0,0,0,0,0,0,0,0,0,1,0,1,0,0,0,0,0,0,0,0,0
460206,21010,210,10,-2,4,2,2,0,0,0,0,0,0,0,0,0,2,2,0,0,0,0,2,0,2,0,0,0,0,0,0,0,0,0
460394,21010,210,10,-2,4,2,2,0,0,0,0,0,0,1,1,0,1,1,0,0,0,0,2,0,2,0,0,0,0,0,0,0,0,0
460464,21010,210,10,-2,3,2,1,1,1,0,0,0,0,0,0,0,1,1,0,0,0,0,1,0,1,0,0,0,0,0,0,0,0,0
460677,21010,210,10,-2,3,0,3,0,0,0,0,0,0,0,0,0,3,0,3,0,0,0,0,0,0,0,0,0,0,0,0,0,0,0
460738,21010,210,10,-2,2,0,2,0,0,0,0,0,0,0,0,0,0,0,0,0,0,0,1,0,1,0,0,0,1,0,1,0,0,0
460756,21010,210,10,-2,1,0,1,0,0,0,1,0,1,0,0,0,0,0,0,0,0,0,0,0,0,0,0,0,0,0,0,0,0,0
460826,21010,210,10,-2,6,1,5,0,0,0,0,0,0,5,1,4,1,0,1,0,0,0,0,0,0,0,0,0,0,0,0,0,0,0
460835,21010,210,10,-2,3,1,2,0,0,0,0,0,0,0,0,0,0,0,0,0,0,0,3,1,2,0,0,0,0,0,0,0,0,0
461148,21010,210,10,-2,3,0,3,0,0,0,0,0,0,0,0,0,1,0,1,0,0,0,2,0,2,0,0,0,0,0,0,0,0,0
461218,21010,210,10,-2,1,0,1,0,0,0,0,0,0,0,0,0,0,0,0,0,0,0,1,0,1,0,0,0,0,0,0,0,0,0
461689,21010,210,10,-2,5,3,2,0,0,0,0,0,0,0,0,0,1,1,0,0,0,0,4,2,2,0,0,0,0,0,0,0,0,0
461795,21010,210,10,-2,4,3,1,0,0,0,2,1,1,1,1,0,0,0,0,0,0,0,1,1,0,0,0,0,0,0,0,0,0,0
464226,21010,210,10,-2,4,1,3,0,0,0,0,0,0,0,0,0,2,1,1,0,0,0,2,0,2,0,0,0,0,0,0,0,0,0
475033,21010,210,10,-2,9,2,7,0,0,0,1,0,1,2,0,2,3,2,1,0,0,0,3,0,3,0,0,0,0,0,0,0,0,0
475121,21010,210,10,-2,16,1,15,1,0,1,0,0,0,2,0,2,0,0,0,0,0,0,13,1,12,0,0,0,0,0,0,0,0,0
475176,21010,210,10,-2,2,1,1,0,0,0,0,0,0,0,0,0,0,0,0,0,0,0,0,0,0,2,1,1,0,0,0,0,0,0
475398,21010,210,10,-2,1,0,1,0,0,0,0,0,0,0,0,0,0,0,0,0,0,0,1,0,1,0,0,0,0,0,0,0,0,0
475495,21010,210,10,-2,11,5,6,0,0,0,0,0,0,0,0,0,1,1,0,0,0,0,10,4,6,0,0,0,0,0,0,0,0,0
475608,21010,210,10,-2,4,2,2,0,0,0,0,0,0,0,0,0,0,0,0,0,0,0,4,2,2,0,0,0,0,0,0,0,0,0
475714,21010,210,10,-2,1,0,1,0,0,0,0,0,0,0,0,0,1,0,1,0,0,0,0,0,0,0,0,0,0,0,0,0,0,0
476717,21010,210,10,-2,1,1,0,0,0,0,0,0,0,0,0,0,0,0,0,0,0,0,1,1,0,0,0,0,0,0,0,0,0,0
476726,21010,210,10,-2,11,3,8,0,0,0,0,0,0,0,0,0,10,3,7,1,0,1,0,0,0,0,0,0,0,0,0,0,0,0
476975,21010,210,10,-2,2,1,1,0,0,0,0,0,0,0,0,0,0,0,0,0,0,0,2,1,1,0,0,0,0,0,0,0,0,0
477039,21010,210,10,-2,12,0,12,0,0,0,1,0,1,5,0,5,2,0,2,0,0,0,4,0,4,0,0,0,0,0,0,0,0,0
480073,21010,210,10,-2,3,1,2,0,0,0,1,1,0,0,0,0,0,0,0,0,0,0,2,0,2,0,0,0,0,0,0,0,0,0
480657,21010,210,10,-2,1,0,1,0,0,0,0,0,0,0,0,0,0,0,0,0,0,0,1,0,1,0,0,0,0,0,0,0,0,0
480790,21010,210,10,-2,6,3,3,0,0,0,1,0,1,0,0,0,0,0,0,0,0,0,5,3,2,0,0,0,0,0,0,0,0,0
480824,21010,210,10,-2,4,0,4,0,0,0,0,0,0,1,0,1,1,0,1,0,0,0,2,0,2,0,0,0,0,0,0,0,0,0
480833,21010,210,10,-2,5,1,4,0,0,0,0,0,0,2,0,2,1,1,0,0,0,0,2,0,2,0,0,0,0,0,0,0,0,0
480967,21010,210,10,-2,2,1,1,2,1,1,0,0,0,0,0,0,0,0,0,0,0,0,0,0,0,0,0,0,0,0,0,0,0,0
481535,21010,210,10,-2,2,2,0,0,0,0,1,1,0,0,0,0,0,0,0,0,0,0,0,0,0,0,0,0,0,0,0,1,1,0
481775,21010,210,10,-2,1,1,0,0,0,0,0,0,0,0,0,0,1,1,0,0,0,0,0,0,0,0,0,0,0,0,0,0,0,0
482149,21010,210,10,-2,84,44,40,0,0,0,12,7,5,5,2,3,7,4,3,0,0,0,49,24,25,0,0,0,2,2,0,9,5,4
482158,21010,210,10,-2,18,7,11,0,0,0,3,2,1,0,0,0,0,0,0,0,0,0,15,5,10,0,0,0,0,0,0,0,0,0
482477,21010,210,10,-2,1,1,0,0,0,0,0,0,0,0,0,0,0,0,0,0,0,0,1,1,0,0,0,0,0,0,0,0,0,0
482635,21010,210,10,-2,1,1,0,0,0,0,0,0,0,0,0,0,0,0,0,0,0,0,1,1,0,0,0,0,0,0,0,0,0,0
482680,21010,210,10,-2,39,24,15,0,0,0,3,3,0,2,0,2,2,1,1,0,0,0,27,16,11,0,0,0,4,3,1,1,1,0
482699,21010,210,10,-2,3,1,2,0,0,0,0,0,0,0,0,0,0,0,0,0,0,0,3,1,2,0,0,0,0,0,0,0,0,0
482705,21010,210,10,-2,9,5,4,0,0,0,0,0,0,1,1,0,0,0,0,0,0,0,1,1,0,0,0,0,5,2,3,2,1,1
482936,21010,210,10,-2,12,10,2,0,0,0,2,1,1,0,0,0,0,0,0,0,0,0,6,5,1,0,0,0,0,0,0,4,4,0
483018,21010,210,10,-2,1,0,1,0,0,0,0,0,0,0,0,0,0,0,0,0,0,0,1,0,1,0,0,0,0,0,0,0,0,0
483036,21010,210,10,-2,7,4,3,0,0,0,1,0,1,1,0,1,0,0,0,0,0,0,1,1,0,0,0,0,0,0,0,4,3,1
483045,21010,210,10,-2,25,13,12,0,0,0,0,0,0,4,1,3,0,0,0,1,1,0,20,11,9,0,0,0,0,0,0,0,0,0
483124,21010,210,10,-2,75,32,43,0,0,0,3,1,2,3,1,2,7,3,4,0,0,0,32,16,16,2,0,2,22,8,14,6,3,3
483212,21010,210,10,-2,24,12,12,0,0,0,0,0,0,6,3,3,0,0,0,0,0,0,15,6,9,2,2,0,0,0,0,1,1,0
483595,21010,210,10,-2,32,15,17,0,0,0,0,0,0,0,0,0,31,15,16,0,0,0,1,0,1,0,0,0,0,0,0,0,0,0
483975,21010,210,10,-2,7,5,2,0,0,0,0,0,0,1,1,0,0,0,0,0,0,0,6,4,2,0,0,0,0,0,0,0,0,0
484002,21010,210,10,-2,17,5,12,1,1,0,3,0,3,2,0,2,4,2,2,0,0,0,7,2,5,0,0,0,0,0,0,0,0,0
484066,21010,210,10,-2,6,0,6,0,0,0,0,0,0,0,0,0,0,0,0,0,0,0,6,0,6,0,0,0,0,0,0,0,0,0
484613,21010,210,10,-2,7,2,5,0,0,0,1,0,1,2,1,1,0,0,0,0,0,0,3,1,2,0,0,0,1,0,1,0,0,0
484844,21010,210,10,-2,1,0,1,0,0,0,1,0,1,0,0,0,0,0,0,0,0,0,0,0,0,0,0,0,0,0,0,0,0,0
484905,21010,210,10,-2,5,2,3,0,0,0,0,0,0,1,0,1,0,0,0,0,0,0,4,2,2,0,0,0,0,0,0,0,0,0
484932,21010,210,10,-2,2,1,1,0,0,0,0,0,0,0,0,0,0,0,0,0,0,0,2,1,1,0,0,0,0,0,0,0,0,0
485111,21010,210,10,-2,1,0,1,0,0,0,0,0,0,0,0,0,0,0,0,0,0,0,1,0,1,0,0,0,0,0,0,0,0,0
485272,21010,210,10,-2,2,0,2,0,0,0,0,0,0,0,0,0,1,0,1,0,0,0,1,0,1,0,0,0,0,0,0,0,0,0
485458,21010,210,10,-2,18,9,9,0,0,0,1,0,1,1,1,0,0,0,0,0,0,0,16,8,8,0,0,0,0,0,0,0,0,0
485698,21010,210,10,-2,5,4,1,0,0,0,0,0,0,1,1,0,0,0,0,0,0,0,4,3,1,0,0,0,0,0,0,0,0,0
485768,21010,210,10,-2,8,7,1,0,0,0,0,0,0,2,1,1,5,5,0,0,0,0,1,1,0,0,0,0,0,0,0,0,0,0
486053,21010,210,10,-2,2,2,0,0,0,0,0,0,0,0,0,0,0,0,0,0,0,0,2,2,0,0,0,0,0,0,0,0,0,0
486813,21010,210,10,-2,4,2,2,0,0,0,0,0,0,0,0,0,2,1,1,0,0,0,2,1,1,0,0,0,0,0,0,0,0,0
486822,21010,210,10,-2,14,3,11,0,0,0,0,0,0,0,0,0,4,1,3,0,0,0,10,2,8,0,0,0,0,0,0,0,0,0
486840,21010,210,10,-2,122,56,66,0,0,0,19,11,8,9,4,5,5,5,0,0,0,0,74,29,45,0,0,0,2,1,1,13,6,7
486901,21010,210,10,-2,7,1,6,0,0,0,0,0,0,1,0,1,0,0,0,0,0,0,6,1,5,0,0,0,0,0,0,0,0,0
487010,21010,210,10,-2,106,65,41,0,0,0,16,12,4,8,2,6,2,1,1,0,0,0,60,40,20,1,1,0,0,0,0,19,9,10
487162,21010,210,10,-2,16,9,7,0,0,0,0,0,0,4,3,1,0,0,0,0,0,0,12,6,6,0,0,0,0,0,0,0,0,0
487302,21010,210,10,-2,2,0,2,0,0,0,0,0,0,0,0,0,0,0,0,0,0,0,2,0,2,0,0,0,0,0,0,0,0,0
487320,21010,210,10,-2,63,54,9,0,0,0,1,1,0,1,0,1,19,15,4,0,0,0,41,38,3,0,0,0,1,0,1,0,0,0
487524,21010,210,10,-2,7,3,4,0,0,0,1,1,0,0,0,0,0,0,0,0,0,0,6,2,4,0,0,0,0,0,0,0,0,0
487588,21010,210,10,-2,2,0,2,0,0,0,0,0,0,2,0,2,0,0,0,0,0,0,0,0,0,0,0,0,0,0,0,0,0,0
487861,21010,210,10,-2,3,1,2,0,0,0,0,0,0,0,0,0,0,0,0,0,0,0,3,1,2,0,0,0,0,0,0,0,0,0
487977,21010,210,10,-2,4,0,4,0,0,0,0,0,0,1,0,1,0,0,0,0,0,0,3,0,3,0,0,0,0,0,0,0,0,0
488077,21010,210,10,-2,1,0,1,0,0,0,1,0,1,0,0,0,0,0,0,0,0,0,0,0,0,0,0,0,0,0,0,0,0,0
488305,21010,210,10,-2,1,1,0,0,0,0,0,0,0,0,0,0,0,0,0,0,0,0,1,1,0,0,0,0,0,0,0,0,0,0
488527,21010,210,10,-2,12,5,7,0,0,0,2,0,2,0,0,0,1,1,0,0,0,0,8,3,5,0,0,0,1,1,0,0,0,0
488554,21010,210,10,-2,3,2,1,0,0,0,0,0,0,0,0,0,0,0,0,0,0,0,3,2,1,0,0,0,0,0,0,0,0,0
488572,21010,210,10,-2,11,5,6,0,0,0,5,3,2,1,0,1,0,0,0,0,0,0,4,1,3,1,1,0,0,0,0,0,0,0
489201,21010,210,10,-2,8,4,4,0,0,0,1,0,1,1,1,0,1,0,1,0,0,0,4,3,1,0,0,0,1,0,1,0,0,0
489283,21010,210,10,-2,9,4,5,0,0,0,0,0,0,0,0,0,7,3,4,0,0,0,2,1,1,0,0,0,0,0,0,0,0,0
489779,21010,210,10,-2,6,3,3,0,0,0,0,0,0,2,1,1,0,0,0,0,0,0,3,1,2,0,0,0,1,1,0,0,0,0
489858,21010,210,10,-2,5,2,3,0,0,0,3,1,2,0,0,0,0,0,0,0,0,0,2,1,1,0,0,0,0,0,0,0,0,0
489937,21010,210,10,-2,12,8,4,0,0,0,6,5,1,1,0,1,0,0,0,0,0,0,5,3,2,0,0,0,0,0,0,0,0,0
490106,21010,210,10,-2,1,0,1,0,0,0,1,0,1,0,0,0,0,0,0,0,0,0,0,0,0,0,0,0,0,0,0,0,0,0
490133,21010,210,10,-2,3,2,1,0,0,0,0,0,0,0,0,0,0,0,0,0,0,0,0,0,0,0,0,0,3,2,1,0,0,0
490373,21010,210,10,-2,11,2,9,0,0,0,1,1,0,1,0,1,0,0,0,0,0,0,7,1,6,1,0,1,1,0,1,0,0,0
490805,21010,210,10,-2,4,1,3,0,0,0,0,0,0,0,0,0,0,0,0,0,0,0,3,1,2,0,0,0,0,0,0,1,0,1
490878,21010,210,10,-2,2,0,2,0,0,0,0,0,0,0,0,0,1,0,1,0,0,0,1,0,1,0,0,0,0,0,0,0,0,0
490975,21010,210,10,-2,2,1,1,0,0,0,1,1,0,0,0,0,1,0,1,0,0,0,0,0,0,0,0,0,0,0,0,0,0,0
491057,21010,210,10,-2,2,2,0,0,0,0,0,0,0,0,0,0,0,0,0,0,0,0,2,2,0,0,0,0,0,0,0,0,0,0
491181,21010,210,10,-2,3,0,3,0,0,0,0,0,0,0,0,0,0,0,0,0,0,0,3,0,3,0,0,0,0,0,0,0,0,0
491525,21010,210,10,-2,1,1,0,0,0,0,0,0,0,0,0,0,0,0,0,0,0,0,1,1,0,0,0,0,0,0,0,0,0,0
491844,21010,210,10,-2,6,3,3,5,2,3,0,0,0,0,0,0,0,0,0,0,0,0,1,1,0,0,0,0,0,0,0,0,0,0
492449,21010,210,10,-2,3,1,2,0,0,0,0,0,0,0,0,0,3,1,2,0,0,0,0,0,0,0,0,0,0,0,0,0,0,0
492476,21010,210,10,-2,1,0,1,0,0,0,0,0,0,0,0,0,1,0,1,0,0,0,0,0,0,0,0,0,0,0,0,0,0,0
492607,21010,210,10,-2,1,0,1,0,0,0,0,0,0,0,0,0,0,0,0,0,0,0,1,0,1,0,0,0,0,0,0,0,0,0
492689,21010,210,10,-2,51,28,23,0,0,0,8,4,4,3,0,3,10,6,4,0,0,0,24,15,9,0,0,0,0,0,0,6,3,3
492722,21010,210,10,-2,6,0,6,0,0,0,0,0,0,1,0,1,3,0,3,0,0,0,1,0,1,1,0,1,0,0,0,0,0,0
493080,21010,210,10,-2,1,1,0,0,0,0,0,0,0,0,0,0,0,0,0,0,0,0,0,0,0,1,1,0,0,0,0,0,0,0
493646,21010,210,10,-2,7,0,7,0,0,0,0,0,0,0,0,0,0,0,0,0,0,0,7,0,7,0,0,0,0,0,0,0,0,0
494010,21010,210,10,-2,1,0,1,0,0,0,0,0,0,0,0,0,0,0,0,0,0,0,1,0,1,0,0,0,0,0,0,0,0,0
494278,21010,210,10,-2,2,1,1,0,0,0,0,0,0,0,0,0,2,1,1,0,0,0,0,0,0,0,0,0,0,0,0,0,0,0
494287,21010,210,10,-2,8,0,8,0,0,0,0,0,0,0,0,0,8,0,8,0,0,0,0,0,0,0,0,0,0,0,0,0,0,0
494436,21010,210,10,-2,4,0,4,0,0,0,0,0,0,0,0,0,0,0,0,0,0,0,4,0,4,0,0,0,0,0,0,0,0,0
494588,21010,210,10,-2,2,1,1,0,0,0,0,0,0,0,0,0,0,0,0,0,0,0,1,1,0,1,0,1,0,0,0,0,0,0
494603,21010,210,10,-2,3,3,0,0,0,0,0,0,0,0,0,0,0,0,0,0,0,0,3,3,0,0,0,0,0,0,0,0,0,0
494843,21010,210,10,-2,4,0,4,0,0,0,1,0,1,3,0,3,0,0,0,0,0,0,0,0,0,0,0,0,0,0,0,0,0,0
494852,21010,210,10,-2,10,4,6,0,0,0,0,0,0,1,0,1,0,0,0,0,0,0,9,4,5,0,0,0,0,0,0,0,0,0
494959,21010,210,10,-2,1,1,0,0,0,0,0,0,0,1,1,0,0,0,0,0,0,0,0,0,0,0,0,0,0,0,0,0,0,0
495314,21010,210,10,-2,2,0,2,0,0,0,2,0,2,0,0,0,0,0,0,0,0,0,0,0,0,0,0,0,0,0,0,0,0,0
495767,21010,210,10,-2,306,155,151,0,0,0,47,28,19,23,10,13,19,11,8,0,0,0,157,77,80,8,5,3,11,6,5,41,18,23
496043,21010,210,10,-2,1,1,0,0,0,0,1,1,0,0,0,0,0,0,0,0,0,0,0,0,0,0,0,0,0,0,0,0,0,0
496627,21010,210,10,-2,5,3,2,0,0,0,1,1,0,0,0,0,0,0,0,0,0,0,4,2,2,0,0,0,0,0,0,0,0,0
496991,21010,210,10,-2,7,0,7,0,0,0,0,0,0,6,0,6,0,0,0,0,0,0,0,0,0,1,0,1,0,0,0,0,0,0
497046,21010,210,10,-2,2,1,1,0,0,0,0,0,0,0,0,0,1,0,1,0,0,0,1,1,0,0,0,0,0,0,0,0,0,0
100663,21020,210,20,-2,12,8,4,0,0,0,2,2,0,1,1,0,0,0,0,0,0,0,9,5,4,0,0,0,0,0,0,0,0,0
100724,21020,210,20,-2,1,1,0,0,0,0,0,0,0,1,1,0,0,0,0,0,0,0,0,0,0,0,0,0,0,0,0,0,0,0
100751,21020,210,20,-2,5,5,0,0,0,0,2,2,0,0,0,0,0,0,0,0,0,0,3,3,0,0,0,0,0,0,0,0,0,0
100858,21020,210,20,-2,2,1,1,0,0,0,0,0,0,0,0,0,0,0,0,0,0,0,2,1,1,0,0,0,0,0,0,0,0,0
101471,21020,210,20,-2,1,1,0,0,0,0,0,0,0,1,1,0,0,0,0,0,0,0,0,0,0,0,0,0,0,0,0,0,0,0
102094,21020,210,20,-2,1,1,0,0,0,0,0,0,0,0,0,0,0,0,0,0,0,0,1,1,0,0,0,0,0,0,0,0,0,0
102614,21020,210,20,-2,1,0,1,0,0,0,0,0,0,0,0,0,0,0,0,0,0,0,1,0,1,0,0,0,0,0,0,0,0,0
104151,21020,210,20,-2,39,15,24,0,0,0,1,1,0,4,1,3,2,2,0,0,0,0,9,1,8,1,0,1,22,10,12,0,0,0
104179,21020,210,20,-2,7,4,3,0,0,0,0,0,0,0,0,0,2,1,1,0,0,0,4,2,2,0,0,0,1,1,0,0,0,0
105330,21020,210,20,-2,5,5,0,0,0,0,0,0,0,0,0,0,0,0,0,0,0,0,3,3,0,0,0,0,1,1,0,1,1,0
106245,21020,210,20,-2,1,1,0,0,0,0,0,0,0,1,1,0,0,0,0,0,0,0,0,0,0,0,0,0,0,0,0,0,0,0
106263,21020,210,20,-2,2,1,1,0,0,0,0,0,0,1,0,1,0,0,0,0,0,0,1,1,0,0,0,0,0,0,0,0,0,0
106342,21020,210,20,-2,1,1,0,0,0,0,0,0,0,0,0,0,0,0,0,0,0,0,1,1,0,0,0,0,0,0,0,0,0,0
106397,21020,210,20,-2,10,8,2,0,0,0,0,0,0,2,1,1,0,0,0,0,0,0,6,5,1,0,0,0,1,1,0,1,1,0
106458,21020,210,20,-2,1,1,0,0,0,0,0,0,0,0,0,0,0,0,0,0,0,0,0,0,0,0,0,0,0,0,0,1,1,0
106485,21020,210,20,-2,1,1,0,0,0,0,0,0,0,0,0,0,0,0,0,0,0,0,1,1,0,0,0,0,0,0,0,0,0,0
106704,21020,210,20,-2,1,0,1,0,0,0,0,0,0,0,0,0,0,0,0,0,0,0,1,0,1,0,0,0,0,0,0,0,0,0
107071,21020,210,20,-2,2,1,1,0,0,0,0,0,0,0,0,0,0,0,0,0,0,0,2,1,1,0,0,0,0,0,0,0,0,0
107512,21020,210,20,-2,1,0,1,0,0,0,0,0,0,0,0,0,0,0,0,0,0,0,1,0,1,0,0,0,0,0,0,0,0,0
107983,21020,210,20,-2,1,1,0,0,0,0,0,0,0,0,0,0,0,0,0,0,0,0,1,1,0,0,0,0,0,0,0,0,0,0
109819,21020,210,20,-2,2,1,1,0,0,0,0,0,0,0,0,0,0,0,0,0,0,0,2,1,1,0,0,0,0,0,0,0,0,0
110404,21020,210,20,-2,3,3,0,0,0,0,0,0,0,1,1,0,0,0,0,0,0,0,0,0,0,0,0,0,0,0,0,2,2,0
110413,21020,210,20,-2,2,0,2,0,0,0,1,0,1,0,0,0,1,0,1,0,0,0,0,0,0,0,0,0,0,0,0,0,0,0
110495,21020,210,20,-2,7,3,4,0,0,0,1,0,1,0,0,0,1,1,0,0,0,0,5,2,3,0,0,0,0,0,0,0,0,0
110510,21020,210,20,-2,7,5,2,0,0,0,0,0,0,0,0,0,1,1,0,0,0,0,5,3,2,0,0,0,1,1,0,0,0,0
110538,21020,210,20,-2,4,2,2,0,0,0,0,0,0,0,0,0,0,0,0,0,0,0,4,2,2,0,0,0,0,0,0,0,0,0
110547,21020,210,20,-2,1,1,0,0,0,0,0,0,0,0,0,0,0,0,0,0,0,0,0,0,0,1,1,0,0,0,0,0,0,0
110556,21020,210,20,-2,3,2,1,0,0,0,1,1,0,0,0,0,0,0,0,0,0,0,1,1,0,0,0,0,1,0,1,0,0,0
110565,21020,210,20,-2,48,25,23,0,0,0,16,9,7,1,0,1,3,2,1,0,0,0,28,14,14,0,0,0,0,0,0,0,0,0
110583,21020,210,20,-2,9,2,7,1,0,1,2,1,1,0,0,0,2,0,2,0,0,0,4,1,3,0,0,0,0,0,0,0,0,0
110592,21020,210,20,-2,6,5,1,0,0,0,4,4,0,0,0,0,2,1,1,0,0,0,0,0,0,0,0,0,0,0,0,0,0,0
110608,21020,210,20,-2,1,0,1,0,0,0,0,0,0,0,0,0,0,0,0,0,0,0,1,0,1,0,0,0,0,0,0,0,0,0
110617,21020,210,20,-2,7,4,3,0,0,0,2,1,1,0,0,0,0,0,0,0,0,0,5,3,2,0,0,0,0,0,0,0,0,0
110635,21020,210,20,-2,14,11,3,0,0,0,2,2,0,1,1,0,2,1,1,0,0,0,7,5,2,1,1,0,1,1,0,0,0,0
110644,21020,210,20,-2,20,13,7,0,0,0,3,2,1,1,1,0,3,3,0,0,0,0,10,5,5,0,0,0,1,1,0,2,1,1
110653,21020,210,20,-2,16,10,6,0,0,0,5,3,2,1,0,1,0,0,0,0,0,0,8,5,3,1,1,0,1,1,0,0,0,0
110662,21020,210,20,-2,23,14,9,0,0,0,3,2,1,1,1,0,4,1,3,0,0,0,10,6,4,0,0,0,2,1,1,3,3,0
110671,21020,210,20,-2,4,1,3,0,0,0,0,0,0,0,0,0,0,0,0,0,0,0,4,1,3,0,0,0,0,0,0,0,0,0
110680,21020,210,20,-2,29,14,15,0,0,0,2,1,1,1,0,1,3,2,1,0,0,0,14,4,10,0,0,0,0,0,0,9,7,2
110699,21020,210,20,-2,1,0,1,0,0,0,0,0,0,0,0,0,0,0,0,0,0,0,1,0,1,0,0,0,0,0,0,0,0,0
110705,21020,210,20,-2,14,8,6,0,0,0,2,0,2,0,0,0,0,0,0,0,0,0,6,4,2,0,0,0,0,0,0,6,4,2
110714,21020,210,20,-2,10,5,5,0,0,0,1,1,0,0,0,0,2,0,2,0,0,0,5,2,3,0,0,0,1,1,0,1,1,0
111188,21020,210,20,-2,1,1,0,0,0,0,0,0,0,0,0,0,0,0,0,0,0,0,1,1,0,0,0,0,0,0,0,0,0,0
111948,21020,210,20,-2,4,4,0,0,0,0,0,0,0,0,0,0,0,0,0,0,0,0,2,2,0,0,0,0,2,2,0,0,0,0
112251,21020,210,20,-2,1,1,0,0,0,0,0,0,0,0,0,0,0,0,0,0,0,0,0,0,0,0,0,0,1,1,0,0,0,0
112260,21020,210,20,-2,1,1,0,0,0,0,0,0,0,1,1,0,0,0,0,0,0,0,0,0,0,0,0,0,0,0,0,0,0,0
112561,21020,210,20,-2,1,0,1,0,0,0,0,0,0,0,0,0,0,0,0,0,0,0,1,0,1,0,0,0,0,0,0,0,0,0
113193,21020,210,20,-2,4,0,4,0,0,0,0,0,0,0,0,0,1,0,1,0,0,0,3,0,3,0,0,0,0,0,0,0,0,0
113573,21020,210,20,-2,2,1,1,0,0,0,0,0,0,0,0,0,1,1,0,0,0,0,1,0,1,0,0,0,0,0,0,0,0,0
113698,21020,210,20,-2,2,1,1,0,0,0,0,0,0,0,0,0,0,0,0,0,0,0,0,0,0,0,0,0,2,1,1,0,0,0
113856,21020,210,20,-2,25,12,13,0,0,0,2,1,1,2,0,2,2,0,2,0,0,0,6,4,2,0,0,0,12,6,6,1,1,0
113980,21020,210,20,-2,1,1,0,0,0,0,1,1,0,0,0,0,0,0,0,0,0,0,0,0,0,0,0,0,0,0,0,0,0,0
114266,21020,210,20,-2,1,1,0,0,0,0,0,0,0,0,0,0,0,0,0,0,0,0,1,1,0,0,0,0,0,0,0,0,0,0
115755,21020,210,20,-2,6,4,2,0,0,0,0,0,0,0,0,0,0,0,0,0,0,0,6,4,2,0,0,0,0,0,0,0,0,0
115861,21020,210,20,-2,79,46,33,0,0,0,6,5,1,4,3,1,29,16,13,0,0,0,39,21,18,1,1,0,0,0,0,0,0,0
117627,21020,210,20,-2,5,2,3,0,0,0,1,1,0,0,0,0,1,0,1,1,1,0,2,0,2,0,0,0,0,0,0,0,0,0
117690,21020,210,20,-2,5,4,1,0,0,0,0,0,0,0,0,0,0,0,0,0,0,0,1,1,0,0,0,0,4,3,1,0,0,0
117706,21020,210,20,-2,30,15,15,0,0,0,6,4,2,2,1,1,1,0,1,0,0,0,17,6,11,0,0,0,4,4,0,0,0,0
117715,21020,210,20,-2,3,0,3,0,0,0,1,0,1,0,0,0,1,0,1,0,0,0,0,0,0,0,0,0,1,0,1,0,0,0
117724,21020,210,20,-2,14,10,4,0,0,0,0,0,0,1,1,0,2,2,0,0,0,0,4,3,1,0,0,0,7,4,3,0,0,0
117733,21020,210,20,-2,17,9,8,0,0,0,0,0,0,0,0,0,2,2,0,0,0,0,11,5,6,2,1,1,2,1,1,0,0,0
117788,21020,210,20,-2,5,4,1,0,0,0,1,1,0,0,0,0,1,1,0,0,0,0,2,1,1,0,0,0,1,1,0,0,0,0
117867,21020,210,20,-2,8,5,3,0,0,0,2,1,1,0,0,0,2,2,0,0,0,0,3,1,2,0,0,0,1,1,0,0,0,0
118347,21020,210,20,-2,2,1,1,0,0,0,0,0,0,0,0,0,0,0,0,0,0,0,0,0,0,0,0,0,2,1,1,0,0,0
118976,21020,210,20,-2,10,2,8,0,0,0,0,0,0,1,0,1,2,0,2,0,0,0,7,2,5,0,0,0,0,0,0,0,0,0
119164,21020,210,20,-2,8,5,3,1,0,1,0,0,0,0,0,0,2,1,1,0,0,0,3,3,0,0,0,0,2,1,1,0,0,0
120421,21020,210,20,-2,2,1,1,0,0,0,0,0,0,0,0,0,1,1,0,0,0,0,1,0,1,0,0,0,0,0,0,0,0,0
120883,21020,210,20,-2,1,1,0,0,0,0,0,0,0,0,0,0,0,0,0,0,0,0,1,1,0,0,0,0,0,0,0,0,0,0
121044,21020,210,20,-2,1,1,0,0,0,0,0,0,0,0,0,0,0,0,0,0,0,0,1,1,0,0,0,0,0,0,0,0,0,0
121345,21020,210,20,-2,2,1,1,0,0,0,0,0,0,2,1,1,0,0,0,0,0,0,0,0,0,0,0,0,0,0,0,0,0,0
121363,21020,210,20,-2,4,1,3,0,0,0,0,0,0,1,0,1,1,0,1,0,0,0,2,1,1,0,0,0,0,0,0,0,0,0
121691,21020,210,20,-2,1,0,1,0,0,0,0,0,0,0,0,0,0,0,0,0,0,0,1,0,1,0,0,0,0,0,0,0,0,0
122409,21020,210,20,-2,7,4,3,0,0,0,1,1,0,1,1,0,0,0,0,0,0,0,5,2,3,0,0,0,0,0,0,0,0,0
122436,21020,210,20,-2,1,0,1,0,0,0,0,0,0,0,0,0,0,0,0,0,0,0,0,0,0,0,0,0,0,0,0,1,0,1
122597,21020,210,20,-2,4,2,2,0,0,0,0,0,0,0,0,0,1,1,0,0,0,0,1,1,0,0,0,0,2,0,2,0,0,0
122755,21020,210,20,-2,16,8,8,0,0,0,5,4,1,2,0,2,2,1,1,0,0,0,7,3,4,0,0,0,0,0,0,0,0,0
122931,21020,210,20,-2,2,1,1,0,0,0,0,0,0,1,0,1,0,0,0,0,0,0,0,0,0,0,0,0,0,0,0,1,1,0
123572,21020,210,20,-2,4,0,4,0,0,0,0,0,0,0,0,0,2,0,2,0,0,0,2,0,2,0,0,0,0,0,0,0,0,0
123961,21020,210,20,-2,9,8,1,0,0,0,1,1,0,0,0,0,1,1,0,0,0,0,5,4,1,0,0,0,1,1,0,1,1,0
123970,21020,210,20,-2,2,1,1,0,0,0,1,0,1,0,0,0,0,0,0,0,0,0,1,1,0,0,0,0,0,0,0,0,0,0
124283,21020,210,20,-2,3,1,2,0,0,0,2,0,2,0,0,0,0,0,0,0,0,0,1,1,0,0,0,0,0,0,0,0,0,0
125471,21020,210,20,-2,5,2,3,0,0,0,0,0,0,0,0,0,2,0,2,0,0,0,1,0,1,0,0,0,2,2,0,0,0,0
126580,21020,210,20,-2,3,2,1,0,0,0,2,2,0,0,0,0,0,0,0,0,0,0,1,0,1,0,0,0,0,0,0,0,0,0
126614,21020,210,20,-2,6,3,3,0,0,0,1,1,0,1,0,1,2,1,1,0,0,0,0,0,0,0,0,0,1,1,0,1,0,1
126775,21020,210,20,-2,1,1,0,0,0,0,1,1,0,0,0,0,0,0,0,0,0,0,0,0,0,0,0,0,0,0,0,0,0,0
127060,21020,210,20,-2,3,1,2,0,0,0,0,0,0,2,1,1,0,0,0,0,0,0,1,0,1,0,0,0,0,0,0,0,0,0
127389,21020,210,20,-2,6,5,1,0,0,0,0,0,0,0,0,0,0,0,0,0,0,0,4,3,1,1,1,0,0,0,0,1,1,0
127565,21020,210,20,-2,1,0,1,0,0,0,0,0,0,0,0,0,0,0,0,0,0,0,1,0,1,0,0,0,0,0,0,0,0,0
129020,21020,210,20,-2,9,4,5,0,0,0,0,0,0,1,0,1,2,1,1,0,0,0,5,2,3,0,0,0,1,1,0,0,0,0
129941,21020,210,20,-2,1,1,0,0,0,0,0,0,0,0,0,0,0,0,0,0,0,0,1,1,0,0,0,0,0,0,0,0,0,0
130253,21020,210,20,-2,2,1,1,0,0,0,1,1,0,0,0,0,0,0,0,0,0,0,1,0,1,0,0,0,0,0,0,0,0,0
130493,21020,210,20,-2,1,1,0,0,0,0,0,0,0,0,0,0,0,0,0,0,0,0,1,1,0,0,0,0,0,0,0,0,0,0
130624,21020,210,20,-2,31,23,8,0,0,0,0,0,0,2,2,0,0,0,0,0,0,0,29,21,8,0,0,0,0,0,0,0,0,0
130794,21020,210,20,-2,14,7,7,0,0,0,2,1,1,3,0,3,0,0,0,0,0,0,8,5,3,0,0,0,0,0,0,1,1,0
130943,21020,210,20,-2,2,2,0,0,0,0,0,0,0,0,0,0,0,0,0,0,0,0,1,1,0,1,1,0,0,0,0,0,0,0
131159,21020,210,20,-2,7,2,5,0,0,0,0,0,0,3,1,2,1,1,0,0,0,0,3,0,3,0,0,0,0,0,0,0,0,0
131469,21020,210,20,-2,4,2,2,0,0,0,1,0,1,0,0,0,0,0,0,0,0,0,2,2,0,0,0,0,1,0,1,0,0,0
131496,21020,210,20,-2,6,3,3,0,0,0,0,0,0,2,1,1,1,0,1,0,0,0,2,1,1,0,0,0,0,0,0,1,1,0
131520,21020,210,20,-2,12,6,6,0,0,0,4,4,0,7,1,6,0,0,0,0,0,0,0,0,0,0,0,0,1,1,0,0,0,0
133553,21020,210,20,-2,2,2,0,0,0,0,0,0,0,0,0,0,0,0,0,0,0,0,1,1,0,0,0,0,0,0,0,1,1,0
133650,21020,210,20,-2,10,8,2,0,0,0,2,2,0,3,2,1,0,0,0,0,0,0,2,2,0,0,0,0,0,0,0,3,2,1
133669,21020,210,20,-2,1,1,0,0,0,0,0,0,0,0,0,0,0,0,0,0,0,0,1,1,0,0,0,0,0,0,0,0,0,0
133809,21020,210,20,-2,2,1,1,0,0,0,0,0,0,0,0,0,0,0,0,0,0,0,2,1,1,0,0,0,0,0,0,0,0,0
133951,21020,210,20,-2,38,22,16,0,0,0,6,4,2,2,0,2,5,3,2,0,0,0,22,13,9,0,0,0,0,0,0,3,2,1
134097,21020,210,20,-2,2,1,1,0,0,0,0,0,0,0,0,0,0,0,0,0,0,0,2,1,1,0,0,0,0,0,0,0,0,0
134130,21020,210,20,-2,8,6,2,0,0,0,1,1,0,1,1,0,0,0,0,0,0,0,5,3,2,0,0,0,1,1,0,0,0,0
135188,21020,210,20,-2,1,0,1,0,0,0,0,0,0,0,0,0,0,0,0,0,0,0,1,0,1,0,0,0,0,0,0,0,0,0
135726,21020,210,20,-2,7,5,2,0,0,0,0,0,0,2,1,1,0,0,0,0,0,0,2,1,1,1,1,0,1,1,0,1,1,0
136400,21020,210,20,-2,6,0,6,0,0,0,0,0,0,1,0,1,0,0,0,0,0,0,5,0,5,0,0,0,0,0,0,0,0,0
137351,21020,210,20,-2,2,1,1,0,0,0,1,0,1,0,0,0,0,0,0,0,0,0,1,1,0,0,0,0,0,0,0,0,0,0
138354,21020,210,20,-2,1,1,0,0,0,0,0,0,0,0,0,0,0,0,0,0,0,0,1,1,0,0,0,0,0,0,0,0,0,0
138947,21020,210,20,-2,3,2,1,0,0,0,1,1,0,2,1,1,0,0,0,0,0,0,0,0,0,0,0,0,0,0,0,0,0,0
139366,21020,210,20,-2,1,1,0,0,0,0,0,0,0,0,0,0,0,0,0,0,0,0,1,1,0,0,0,0,0,0,0,0,0,0
139658,21020,210,20,-2,2,1,1,0,0,0,0,0,0,2,1,1,0,0,0,0,0,0,0,0,0,0,0,0,0,0,0,0,0,0
139755,21020,210,20,-2,2,2,0,0,0,0,0,0,0,0,0,0,0,0,0,0,0,0,1,1,0,0,0,0,1,1,0,0,0,0
139861,21020,210,20,-2,2,2,0,0,0,0,0,0,0,0,0,0,0,0,0,0,0,0,2,2,0,0,0,0,0,0,0,0,0,0
139940,21020,210,20,-2,3,1,2,0,0,0,3,1,2,0,0,0,0,0,0,0,0,0,0,0,0,0,0,0,0,0,0,0,0,0
139959,21020,210,20,-2,7,2,5,0,0,0,1,1,0,0,0,0,0,0,0,0,0,0,4,1,3,0,0,0,2,0,2,0,0,0
140447,21020,210,20,-2,1,1,0,0,0,0,1,1,0,0,0,0,0,0,0,0,0,0,0,0,0,0,0,0,0,0,0,0,0,0
142115,21020,210,20,-2,1,0,1,0,0,0,0,0,0,0,0,0,0,0,0,0,0,0,1,0,1,0,0,0,0,0,0,0,0,0
142285,21020,210,20,-2,2,1,1,0,0,0,1,0,1,0,0,0,0,0,0,0,0,0,1,1,0,0,0,0,0,0,0,0,0,0
143118,21020,210,20,-2,1,1,0,0,0,0,1,1,0,0,0,0,0,0,0,0,0,0,0,0,0,0,0,0,0,0,0,0,0,0
143613,21020,210,20,-2,1,0,1,0,0,0,0,0,0,0,0,0,0,0,0,0,0,0,1,0,1,0,0,0,0,0,0,0,0,0
143853,21020,210,20,-2,1,1,0,0,0,0,1,1,0,0,0,0,0,0,0,0,0,0,0,0,0,0,0,0,0,0,0,0,0,0
144050,21020,210,20,-2,9,6,3,0,0,0,0,0,0,2,2,0,0,0,0,0,0,0,7,4,3,0,0,0,0,0,0,0,0,0
144740,21020,210,20,-2,1,1,0,0,0,0,0,0,0,0,0,0,0,0,0,0,0,0,0,0,0,0,0,0,1,1,0,0,0,0
144865,21020,210,20,-2,2,0,2,0,0,0,0,0,0,0,0,0,0,0,0,0,0,0,2,0,2,0,0,0,0,0,0,0,0,0
145600,21020,210,20,-2,9,4,5,0,0,0,1,1,0,4,2,2,0,0,0,0,0,0,4,1,3,0,0,0,0,0,0,0,0,0
145637,21020,210,20,-2,11,6,5,1,0,1,4,2,2,0,0,0,2,1,1,0,0,0,4,3,1,0,0,0,0,0,0,0,0,0
145725,21020,210,20,-2,1,0,1,0,0,0,0,0,0,0,0,0,0,0,0,0,0,0,0,0,0,0,0,0,1,0,1,0,0,0
146719,21020,210,20,-2,3,2,1,0,0,0,0,0,0,0,0,0,0,0,0,0,0,0,0,0,0,1,1,0,1,0,1,1,1,0
147244,21020,210,20,-2,1,0,1,0,0,0,0,0,0,0,0,0,0,0,0,0,0,0,1,0,1,0,0,0,0,0,0,0,0,0
147703,21020,210,20,-2,1,1,0,0,0,0,0,0,0,0,0,0,0,0,0,0,0,0,0,0,0,0,0,0,0,0,0,1,1,0
147767,21020,210,20,-2,12,6,6,0,0,0,3,3,0,3,1,2,1,0,1,0,0,0,4,1,3,0,0,0,0,0,0,1,1,0
148487,21020,210,20,-2,1,1,0,0,0,0,0,0,0,0,0,0,0,0,0,0,0,0,1,1,0,0,0,0,0,0,0,0,0,0
148511,21020,210,20,-2,7,5,2,0,0,0,4,3,1,0,0,0,0,0,0,0,0,0,3,2,1,0,0,0,0,0,0,0,0,0
149222,21020,210,20,-2,3,2,1,0,0,0,0,0,0,1,0,1,0,0,0,0,0,0,2,2,0,0,0,0,0,0,0,0,0,0
149365,21020,210,20,-2,2,0,2,0,0,0,0,0,0,1,0,1,0,0,0,0,0,0,1,0,1,0,0,0,0,0,0,0,0,0
149772,21020,210,20,-2,1,1,0,0,0,0,0,0,0,0,0,0,0,0,0,0,0,0,1,1,0,0,0,0,0,0,0,0,0,0
150163,21020,210,20,-2,2,1,1,0,0,0,0,0,0,0,0,0,0,0,0,0,0,0,2,1,1,0,0,0,0,0,0,0,0,0
151111,21020,210,20,-2,3,2,1,0,0,0,1,1,0,0,0,0,0,0,0,0,0,0,2,1,1,0,0,0,0,0,0,0,0,0
151351,21020,210,20,-2,6,4,2,0,0,0,0,0,0,2,1,1,1,1,0,0,0,0,3,2,1,0,0,0,0,0,0,0,0,0
152080,21020,210,20,-2,13,10,3,0,0,0,1,0,1,2,1,1,0,0,0,0,0,0,8,7,1,0,0,0,1,1,0,1,1,0
152390,21020,210,20,-2,1,0,1,0,0,0,0,0,0,0,0,0,0,0,0,0,0,0,1,0,1,0,0,0,0,0,0,0,0,0
152637,21020,210,20,-2,2,0,2,0,0,0,0,0,0,0,0,0,0,0,0,0,0,0,2,0,2,0,0,0,0,0,0,0,0,0
153603,21020,210,20,-2,7,7,0,1,1,0,2,2,0,0,0,0,0,0,0,0,0,0,4,4,0,0,0,0,0,0,0,0,0,0
153621,21020,210,20,-2,1,0,1,0,0,0,0,0,0,0,0,0,0,0,0,0,0,0,1,0,1,0,0,0,0,0,0,0,0,0
153658,21020,210,20,-2,10,7,3,0,0,0,1,1,0,0,0,0,0,0,0,0,0,0,7,5,2,0,0,0,2,1,1,0,0,0
155104,21020,210,20,-2,6,3,3,0,0,0,0,0,0,0,0,0,2,0,2,0,0,0,4,3,1,0,0,0,0,0,0,0,0,0
155317,21020,210,20,-2,2,2,0,0,0,0,0,0,0,0,0,0,1,1,0,0,0,0,1,1,0,0,0,0,0,0,0,0,0,0
155399,21020,210,20,-2,1,1,0,0,0,0,0,0,0,0,0,0,0,0,0,0,0,0,1,1,0,0,0,0,0,0,0,0,0,0
156222,21020,210,20,-2,1,1,0,0,0,0,0,0,0,0,0,0,0,0,0,0,0,0,1,1,0,0,0,0,0,0,0,0,0,0
156620,21020,210,20,-2,12,8,4,0,0,0,0,0,0,0,0,0,0,0,0,0,0,0,12,8,4,0,0,0,0,0,0,0,0,0
157085,21020,210,20,-2,7,3,4,0,0,0,0,0,0,3,0,3,1,1,0,0,0,0,1,1,0,0,0,0,0,0,0,2,1,1
157447,21020,210,20,-2,1,0,1,0,0,0,0,0,0,0,0,0,0,0,0,0,0,0,1,0,1,0,0,0,0,0,0,0,0,0
159373,21020,210,20,-2,1,1,0,0,0,0,1,1,0,0,0,0,0,0,0,0,0,0,0,0,0,0,0,0,0,0,0,0,0,0
159391,21020,210,20,-2,1,1,0,0,0,0,0,0,0,0,0,0,0,0,0,0,0,0,1,1,0,0,0,0,0,0,0,0,0,0
159416,21020,210,20,-2,2,1,1,0,0,0,1,1,0,0,0,0,0,0,0,0,0,0,1,0,1,0,0,0,0,0,0,0,0,0
159568,21020,210,20,-2,1,1,0,0,0,0,0,0,0,0,0,0,0,0,0,0,0,0,0,0,0,0,0,0,0,0,0,1,1,0
159656,21020,210,20,-2,1,0,1,0,0,0,0,0,0,1,0,1,0,0,0,0,0,0,0,0,0,0,0,0,0,0,0,0,0,0
159939,21020,210,20,-2,2,2,0,0,0,0,0,0,0,0,0,0,2,2,0,0,0,0,0,0,0,0,0,0,0,0,0,0,0,0
159966,21020,210,20,-2,4,4,0,0,0,0,0,0,0,0,0,0,0,0,0,0,0,0,4,4,0,0,0,0,0,0,0,0,0,0
159993,21020,210,20,-2,1,0,1,0,0,0,1,0,1,0,0,0,0,0,0,0,0,0,0,0,0,0,0,0,0,0,0,0,0,0
160621,21020,210,20,-2,1,0,1,0,0,0,0,0,0,1,0,1,0,0,0,0,0,0,0,0,0,0,0,0,0,0,0,0,0,0
160630,21020,210,20,-2,2,0,2,0,0,0,0,0,0,2,0,2,0,0,0,0,0,0,0,0,0,0,0,0,0,0,0,0,0,0
160658,21020,210,20,-2,2,1,1,0,0,0,0,0,0,0,0,0,0,0,0,0,0,0,2,1,1,0,0,0,0,0,0,0,0,0
160755,21020,210,20,-2,4,2,2,0,0,0,3,2,1,0,0,0,0,0,0,0,0,0,1,0,1,0,0,0,0,0,0,0,0,0
161253,21020,210,20,-2,1,1,0,0,0,0,1,1,0,0,0,0,0,0,0,0,0,0,0,0,0,0,0,0,0,0,0,0,0,0
162706,21020,210,20,-2,1,1,0,0,0,0,0,0,0,0,0,0,0,0,0,0,0,0,1,1,0,0,0,0,0,0,0,0,0,0
162928,21020,210,20,-2,21,11,10,0,0,0,1,0,1,2,1,1,0,0,0,0,0,0,16,9,7,0,0,0,0,0,0,2,1,1
163259,21020,210,20,-2,2,1,1,0,0,0,0,0,0,0,0,0,1,0,1,0,0,0,1,1,0,0,0,0,0,0,0,0,0,0
163268,21020,210,20,-2,1,0,1,0,0,0,0,0,0,0,0,0,0,0,0,0,0,0,1,0,1,0,0,0,0,0,0,0,0,0
163286,21020,210,20,-2,6,3,3,0,0,0,1,1,0,1,1,0,2,0,2,0,0,0,1,1,0,0,0,0,1,0,1,0,0,0
163532,21020,210,20,-2,1,1,0,0,0,0,0,0,0,0,0,0,0,0,0,0,0,0,1,1,0,0,0,0,0,0,0,0,0,0
164076,21020,210,20,-2,1,1,0,0,0,0,0,0,0,0,0,0,0,0,0,0,0,0,1,1,0,0,0,0,0,0,0,0,0,0
164465,21020,210,20,-2,3,1,2,0,0,0,0,0,0,2,1,1,0,0,0,0,0,0,1,0,1,0,0,0,0,0,0,0,0,0
164580,21020,210,20,-2,1,1,0,0,0,0,0,0,0,0,0,0,0,0,0,0,0,0,1,1,0,0,0,0,0,0,0,0,0,0
164924,21020,210,20,-2,2,1,1,0,0,0,0,0,0,0,0,0,0,0,0,0,0,0,2,1,1,0,0,0,0,0,0,0,0,0
164988,21020,210,20,-2,6,4,2,0,0,0,2,2,0,0,0,0,0,0,0,0,0,0,3,2,1,0,0,0,1,0,1,0,0,0
165334,21020,210,20,-2,1,1,0,0,0,0,0,0,0,1,1,0,0,0,0,0,0,0,0,0,0,0,0,0,0,0,0,0,0,0
166027,21020,210,20,-2,5,2,3,0,0,0,1,1,0,1,1,0,0,0,0,0,0,0,3,0,3,0,0,0,0,0,0,0,0,0
166629,21020,210,20,-2,4,2,2,0,0,0,1,0,1,0,0,0,0,0,0,0,0,0,2,1,1,0,0,0,0,0,0,1,1,0
166683,21020,210,20,-2,5,0,5,0,0,0,1,0,1,1,0,1,0,0,0,0,0,0,3,0,3,0,0,0,0,0,0,0,0,0
167358,21020,210,20,-2,6,5,1,0,0,0,1,1,0,0,0,0,0,0,0,0,0,0,3,3,0,0,0,0,1,0,1,1,1,0
167835,21020,210,20,-2,4,2,2,0,0,0,0,0,0,2,1,1,0,0,0,0,0,0,2,1,1,0,0,0,0,0,0,0,0,0
168148,21020,210,20,-2,3,2,1,0,0,0,1,1,0,0,0,0,1,0,1,0,0,0,1,1,0,0,0,0,0,0,0,0,0,0
168421,21020,210,20,-2,3,2,1,0,0,0,2,2,0,0,0,0,1,0,1,0,0,0,0,0,0,0,0,0,0,0,0,0,0,0
168740,21020,210,20,-2,1,1,0,0,0,0,1,1,0,0,0,0,0,0,0,0,0,0,0,0,0,0,0,0,0,0,0,0,0,0
169248,21020,210,20,-2,1,1,0,0,0,0,0,0,0,0,0,0,0,0,0,0,0,0,1,1,0,0,0,0,0,0,0,0,0,0
170286,21020,210,20,-2,1,1,0,0,0,0,0,0,0,0,0,0,0,0,0,0,0,0,0,0,0,0,0,0,1,1,0,0,0,0
170541,21020,210,20,-2,1,1,0,0,0,0,0,0,0,0,0,0,0,0,0,0,0,0,1,1,0,0,0,0,0,0,0,0,0,0
170639,21020,210,20,-2,5,1,4,0,0,0,0,0,0,0,0,0,0,0,0,0,0,0,4,0,4,0,0,0,0,0,0,1,1,0
170976,21020,210,20,-2,11,4,7,0,0,0,0,0,0,3,1,2,0,0,0,0,0,0,6,1,5,0,0,0,1,1,0,1,1,0
171100,21020,210,20,-2,9,3,6,0,0,0,2,2,0,2,0,2,1,1,0,0,0,0,4,0,4,0,0,0,0,0,0,0,0,0
171128,21020,210,20,-2,1,1,0,0,0,0,1,1,0,0,0,0,0,0,0,0,0,0,0,0,0,0,0,0,0,0,0,0,0,0
171571,21020,210,20,-2,1,1,0,0,0,0,0,0,0,0,0,0,0,0,0,0,0,0,1,1,0,0,0,0,0,0,0,0,0,0
172644,21020,210,20,-2,6,5,1,0,0,0,1,1,0,1,0,1,0,0,0,0,0,0,4,4,0,0,0,0,0,0,0,0,0,0
173063,21020,210,20,-2,1,1,0,0,0,0,0,0,0,0,0,0,0,0,0,0,0,0,1,1,0,0,0,0,0,0,0,0,0,0
173124,21020,210,20,-2,1,1,0,0,0,0,0,0,0,0,0,0,0,0,0,0,0,0,1,1,0,0,0,0,0,0,0,0,0,0
173638,21020,210,20,-2,5,4,1,0,0,0,0,0,0,0,0,0,0,0,0,0,0,0,5,4,1,0,0,0,0,0,0,0,0,0
173799,21020,210,20,-2,1,1,0,0,0,0,0,0,0,0,0,0,0,0,0,0,0,0,1,1,0,0,0,0,0,0,0,0,0,0
173902,21020,210,20,-2,1,1,0,0,0,0,0,0,0,1,1,0,0,0,0,0,0,0,0,0,0,0,0,0,0,0,0,0,0,0
174066,21020,210,20,-2,10,7,3,0,0,0,2,2,0,0,0,0,0,0,0,1,1,0,4,2,2,0,0,0,2,1,1,1,1,0
174233,21020,210,20,-2,2,1,1,0,0,0,0,0,0,0,0,0,1,1,0,0,0,0,1,0,1,0,0,0,0,0,0,0,0,0
175005,21020,210,20,-2,3,0,3,0,0,0,0,0,0,1,0,1,0,0,0,0,0,0,2,0,2,0,0,0,0,0,0,0,0,0
175263,21020,210,20,-2,1,0,1,0,0,0,0,0,0,0,0,0,0,0,0,0,0,0,1,0,1,0,0,0,0,0,0,0,0,0
175342,21020,210,20,-2,3,3,0,0,0,0,0,0,0,3,3,0,0,0,0,0,0,0,0,0,0,0,0,0,0,0,0,0,0,0
175856,21020,210,20,-2,1,1,0,0,0,0,0,0,0,0,0,0,0,0,0,0,0,0,1,1,0,0,0,0,0,0,0,0,0,0
176053,21020,210,20,-2,1,0,1,0,0,0,0,0,0,0,0,0,0,0,0,0,0,0,0,0,0,0,0,0,1,0,1,0,0,0
176080,21020,210,20,-2,4,3,1,0,0,0,0,0,0,0,0,0,0,0,0,0,0,0,4,3,1,0,0,0,0,0,0,0,0,0
178396,21020,210,20,-2,8,2,6,0,0,0,2,1,1,1,0,1,0,0,0,0,0,0,4,1,3,0,0,0,1,0,1,0,0,0
178402,21020,210,20,-2,2,2,0,0,0,0,1,1,0,0,0,0,0,0,0,0,0,0,1,1,0,0,0,0,0,0,0,0,0,0
178411,21020,210,20,-2,2,1,1,0,0,0,0,0,0,0,0,0,0,0,0,0,0,0,2,1,1,0,0,0,0,0,0,0,0,0
178420,21020,210,20,-2,1,1,0,0,0,0,0,0,0,0,0,0,0,0,0,0,0,0,1,1,0,0,0,0,0,0,0,0,0,0
178624,21020,210,20,-2,1,0,1,0,0,0,0,0,0,0,0,0,0,0,0,0,0,0,1,0,1,0,0,0,0,0,0,0,0,0
179159,21020,210,20,-2,7,4,3,0,0,0,0,0,0,2,0,2,1,1,0,0,0,0,4,3,1,0,0,0,0,0,0,0,0,0
179557,21020,210,20,-2,2,1,1,0,0,0,0,0,0,0,0,0,0,0,0,0,0,0,1,0,1,0,0,0,1,1,0,0,0,0
179566,21020,210,20,-2,2,1,1,0,0,0,0,0,0,1,0,1,1,1,0,0,0,0,0,0,0,0,0,0,0,0,0,0,0,0
179867,21020,210,20,-2,16,12,4,1,1,0,2,2,0,4,2,2,0,0,0,0,0,0,8,6,2,0,0,0,0,0,0,1,1,0
180106,21020,210,20,-2,2,0,2,0,0,0,0,0,0,0,0,0,0,0,0,0,0,0,2,0,2,0,0,0,0,0,0,0,0,0
180461,21020,210,20,-2,1,0,1,0,0,0,0,0,0,0,0,0,0,0,0,0,0,0,1,0,1,0,0,0,0,0,0,0,0,0
181215,21020,210,20,-2,1,0,1,0,0,0,0,0,0,0,0,0,0,0,0,0,0,0,1,0,1,0,0,0,0,0,0,0,0,0
181394,21020,210,20,-2,8,4,4,0,0,0,0,0,0,0,0,0,0,0,0,0,0,0,4,2,2,0,0,0,2,1,1,2,1,1
181428,21020,210,20,-2,3,2,1,0,0,0,0,0,0,0,0,0,1,1,0,0,0,0,2,1,1,0,0,0,0,0,0,0,0,0
182290,21020,210,20,-2,1,0,1,0,0,0,0,0,0,0,0,0,1,0,1,0,0,0,0,0,0,0,0,0,0,0,0,0,0,0
182670,21020,210,20,-2,3,3,0,0,0,0,0,0,0,0,0,0,0,0,0,0,0,0,3,3,0,0,0,0,0,0,0,0,0,0
183044,21020,210,20,-2,1,1,0,0,0,0,0,0,0,0,0,0,0,0,0,0,0,0,0,0,0,0,0,0,1,1,0,0,0,0
184782,21020,210,20,-2,2,1,1,0,0,0,1,0,1,0,0,0,0,0,0,0,0,0,0,0,0,1,1,0,0,0,0,0,0,0
185590,21020,210,20,-2,1,0,1,0,0,0,0,0,0,0,0,0,0,0,0,0,0,0,0,0,0,0,0,0,0,0,0,1,0,1
185828,21020,210,20,-2,1,0,1,0,0,0,0,0,0,0,0,0,0,0,0,0,0,0,1,0,1,0,0,0,0,0,0,0,0,0
186131,21020,210,20,-2,6,5,1,0,0,0,1,1,0,0,0,0,0,0,0,0,0,0,1,0,1,0,0,0,3,3,0,1,1,0
186380,21020,210,20,-2,9,6,3,0,0,0,1,1,0,0,0,0,1,0,1,0,0,0,1,0,1,0,0,0,6,5,1,0,0,0
186584,21020,210,20,-2,1,0,1,0,0,0,0,0,0,0,0,0,0,0,0,0,0,0,1,0,1,0,0,0,0,0,0,0,0,0
186867,21020,210,20,-2,3,3,0,0,0,0,2,2,0,0,0,0,0,0,0,0,0,0,1,1,0,0,0,0,0,0,0,0,0,0
187985,21020,210,20,-2,6,2,4,0,0,0,1,0,1,0,0,0,1,0,1,0,0,0,4,2,2,0,0,0,0,0,0,0,0,0
188438,21020,210,20,-2,7,4,3,0,0,0,0,0,0,0,0,0,0,0,0,0,0,0,7,4,3,0,0,0,0,0,0,0,0,0
189848,21020,210,20,-2,2,0,2,0,0,0,0,0,0,0,0,0,0,0,0,0,0,0,2,0,2,0,0,0,0,0,0,0,0,0
190044,21020,210,20,-2,3,2,1,0,0,0,0,0,0,0,0,0,0,0,0,0,0,0,2,1,1,0,0,0,0,0,0,1,1,0
190150,21020,210,20,-2,15,9,6,1,1,0,4,3,1,3,0,3,1,1,0,0,0,0,6,4,2,0,0,0,0,0,0,0,0,0
190415,21020,210,20,-2,8,3,5,1,0,1,0,0,0,0,0,0,0,0,0,0,0,0,6,3,3,0,0,0,0,0,0,1,0,1
190521,21020,210,20,-2,1,1,0,0,0,0,1,1,0,0,0,0,0,0,0,0,0,0,0,0,0,0,0,0,0,0,0,0,0,0
190567,21020,210,20,-2,2,1,1,0,0,0,0,0,0,0,0,0,1,1,0,0,0,0,1,0,1,0,0,0,0,0,0,0,0,0
190576,21020,210,20,-2,6,1,5,0,0,0,0,0,0,2,0,2,0,0,0,0,0,0,3,1,2,1,0,1,0,0,0,0,0,0
190594,21020,210,20,-2,2,1,1,0,0,0,0,0,0,2,1,1,0,0,0,0,0,0,0,0,0,0,0,0,0,0,0,0,0,0
190628,21020,210,20,-2,1,0,1,0,0,0,0,0,0,0,0,0,1,0,1,0,0,0,0,0,0,0,0,0,0,0,0,0,0,0
190637,21020,210,20,-2,1,0,1,0,0,0,0,0,0,0,0,0,0,0,0,0,0,0,1,0,1,0,0,0,0,0,0,0,0,0
190664,21020,210,20,-2,1,1,0,0,0,0,0,0,0,1,1,0,0,0,0,0,0,0,0,0,0,0,0,0,0,0,0,0,0,0
190673,21020,210,20,-2,2,2,0,0,0,0,0,0,0,1,1,0,0,0,0,0,0,0,1,1,0,0,0,0,0,0,0,0,0,0
191241,21020,210,20,-2,3,2,1,0,0,0,2,1,1,0,0,0,0,0,0,0,0,0,0,0,0,0,0,0,0,0,0,1,1,0
191621,21020,210,20,-2,1,1,0,0,0,0,0,0,0,0,0,0,0,0,0,0,0,0,1,1,0,0,0,0,0,0,0,0,0,0
192448,21020,210,20,-2,2,1,1,0,0,0,1,1,0,0,0,0,0,0,0,0,0,0,1,0,1,0,0,0,0,0,0,0,0,0
193405,21020,210,20,-2,7,6,1,0,0,0,0,0,0,0,0,0,1,1,0,0,0,0,2,2,0,0,0,0,4,3,1,0,0,0
193900,21020,210,20,-2,11,4,7,1,0,1,3,2,1,2,0,2,0,0,0,0,0,0,5,2,3,0,0,0,0,0,0,0,0,0
194578,21020,210,20,-2,1,0,1,0,0,0,0,0,0,1,0,1,0,0,0,0,0,0,0,0,0,0,0,0,0,0,0,0,0,0
195003,21020,210,20,-2,3,0,3,0,0,0,1,0,1,0,0,0,0,0,0,0,0,0,1,0,1,1,0,1,0,0,0,0,0,0
195030,21020,210,20,-2,4,1,3,0,0,0,0,0,0,0,0,0,0,0,0,0,0,0,1,0,1,0,0,0,0,0,0,3,1,2
195164,21020,210,20,-2,2,1,1,0,0,0,1,0,1,0,0,0,0,0,0,0,0,0,1,1,0,0,0,0,0,0,0,0,0,0
196060,21020,210,20,-2,1,1,0,0,0,0,0,0,0,0,0,0,0,0,0,0,0,0,1,1,0,0,0,0,0,0,0,0,0,0
196079,21020,210,20,-2,3,2,1,0,0,0,0,0,0,0,0,0,0,0,0,0,0,0,3,2,1,0,0,0,0,0,0,0,0,0
196097,21020,210,20,-2,4,2,2,0,0,0,1,0,1,0,0,0,0,0,0,0,0,0,1,1,0,0,0,0,2,1,1,0,0,0
196237,21020,210,20,-2,1,0,1,0,0,0,0,0,0,0,0,0,0,0,0,0,0,0,1,0,1,0,0,0,0,0,0,0,0,0
196413,21020,210,20,-2,3,2,1,0,0,0,0,0,0,2,2,0,0,0,0,0,0,0,1,0,1,0,0,0,0,0,0,0,0,0
196468,21020,210,20,-2,1,0,1,0,0,0,0,0,0,0,0,0,1,0,1,0,0,0,0,0,0,0,0,0,0,0,0,0,0,0
196884,21020,210,20,-2,1,1,0,0,0,0,0,0,0,1,1,0,0,0,0,0,0,0,0,0,0,0,0,0,0,0,0,0,0,0
197045,21020,210,20,-2,1,0,1,0,0,0,0,0,0,0,0,0,0,0,0,0,0,0,1,0,1,0,0,0,0,0,0,0,0,0
197708,21020,210,20,-2,2,1,1,0,0,0,0,0,0,0,0,0,1,1,0,0,0,0,1,0,1,0,0,0,0,0,0,0,0,0
197869,21020,210,20,-2,3,1,2,0,0,0,0,0,0,0,0,0,0,0,0,0,0,0,2,0,2,0,0,0,0,0,0,1,1,0
197984,21020,210,20,-2,1,0,1,0,0,0,0,0,0,1,0,1,0,0,0,0,0,0,0,0,0,0,0,0,0,0,0,0,0,0
198419,21020,210,20,-2,2,1,1,0,0,0,0,0,0,0,0,0,0,0,0,0,0,0,1,0,1,0,0,0,0,0,0,1,1,0
198464,21020,210,20,-2,2,1,1,0,0,0,0,0,0,0,0,0,0,0,0,0,0,0,2,1,1,0,0,0,0,0,0,0,0,0
198695,21020,210,20,-2,1,0,1,0,0,0,0,0,0,0,0,0,0,0,0,0,0,0,1,0,1,0,0,0,0,0,0,0,0,0
199120,21020,210,20,-2,4,1,3,0,0,0,0,0,0,2,0,2,0,0,0,0,0,0,1,1,0,0,0,0,1,0,1,0,0,0
199139,21020,210,20,-2,1,1,0,0,0,0,0,0,0,1,1,0,0,0,0,0,0,0,0,0,0,0,0,0,0,0,0,0,0,0
199148,21020,210,20,-2,1,0,1,0,0,0,0,0,0,0,0,0,0,0,0,0,0,0,1,0,1,0,0,0,0,0,0,0,0,0
199157,21020,210,20,-2,1,0,1,0,0,0,0,0,0,0,0,0,0,0,0,0,0,0,0,0,0,0,0,0,1,0,1,0,0,0
199193,21020,210,20,-2,9,4,5,0,0,0,1,0,1,1,0,1,0,0,0,0,0,0,6,3,3,0,0,0,0,0,0,1,1,0
199218,21020,210,20,-2,2,2,0,0,0,0,0,0,0,0,0,0,0,0,0,0,0,0,2,2,0,0,0,0,0,0,0,0,0,0
199281,21020,210,20,-2,1,1,0,0,0,0,0,0,0,0,0,0,0,0,0,0,0,0,1,1,0,0,0,0,0,0,0,0,0,0
199847,21020,210,20,-2,6,2,4,0,0,0,0,0,0,2,1,1,0,0,0,0,0,0,3,1,2,1,0,1,0,0,0,0,0,0
200004,21020,210,20,-2,1,0,1,0,0,0,0,0,0,0,0,0,0,0,0,0,0,0,1,0,1,0,0,0,0,0,0,0,0,0
200280,21020,210,20,-2,1,1,0,0,0,0,1,1,0,0,0,0,0,0,0,0,0,0,0,0,0,0,0,0,0,0,0,0,0,0
201645,21020,210,20,-2,3,3,0,0,0,0,1,1,0,0,0,0,0,0,0,0,0,0,2,2,0,0,0,0,0,0,0,0,0,0
201690,21020,210,20,-2,2,0,2,0,0,0,0,0,0,0,0,0,0,0,0,0,0,0,0,0,0,0,0,0,2,0,2,0,0,0
201885,21020,210,20,-2,5,2,3,0,0,0,2,1,1,1,0,1,0,0,0,0,0,0,2,1,1,0,0,0,0,0,0,0,0,0
202356,21020,210,20,-2,4,0,4,0,0,0,0,0,0,2,0,2,0,0,0,0,0,0,2,0,2,0,0,0,0,0,0,0,0,0
203085,21020,210,20,-2,1,0,1,0,0,0,0,0,0,0,0,0,0,0,0,0,0,0,1,0,1,0,0,0,0,0,0,0,0,0
203368,21020,210,20,-2,6,4,2,0,0,0,2,1,1,0,0,0,0,0,0,0,0,0,3,2,1,0,0,0,0,0,0,1,1,0
204024,21020,210,20,-2,1,1,0,0,0,0,0,0,0,0,0,0,0,0,0,0,0,0,1,1,0,0,0,0,0,0,0,0,0,0
204501,21020,210,20,-2,1,0,1,0,0,0,0,0,0,0,0,0,0,0,0,0,0,0,1,0,1,0,0,0,0,0,0,0,0,0
204796,21020,210,20,-2,15,10,5,0,0,0,4,2,2,1,0,1,2,1,1,0,0,0,8,7,1,0,0,0,0,0,0,0,0,0
206084,21020,210,20,-2,2,1,1,0,0,0,2,1,1,0,0,0,0,0,0,0,0,0,0,0,0,0,0,0,0,0,0,0,0,0
206695,21020,210,20,-2,1,1,0,0,0,0,0,0,0,0,0,0,0,0,0,0,0,0,1,1,0,0,0,0,0,0,0,0,0,0
206941,21020,210,20,-2,2,0,2,0,0,0,1,0,1,0,0,0,0,0,0,0,0,0,1,0,1,0,0,0,0,0,0,0,0,0
207388,21020,210,20,-2,2,1,1,0,0,0,0,0,0,0,0,0,1,0,1,0,0,0,1,1,0,0,0,0,0,0,0,0,0,0
207458,21020,210,20,-2,1,0,1,0,0,0,0,0,0,1,0,1,0,0,0,0,0,0,0,0,0,0,0,0,0,0,0,0,0,0
207500,21020,210,20,-2,11,7,4,0,0,0,2,1,1,1,0,1,0,0,0,0,0,0,4,2,2,0,0,0,4,4,0,0,0,0
208822,21020,210,20,-2,1,0,1,0,0,0,0,0,0,0,0,0,0,0,0,0,0,0,1,0,1,0,0,0,0,0,0,0,0,0
209250,21020,210,20,-2,3,2,1,0,0,0,1,1,0,1,1,0,0,0,0,0,0,0,1,0,1,0,0,0,0,0,0,0,0,0
209506,21020,210,20,-2,1,1,0,0,0,0,0,0,0,0,0,0,0,0,0,0,0,0,0,0,0,0,0,0,0,0,0,1,1,0
209542,21020,210,20,-2,1,1,0,0,0,0,0,0,0,0,0,0,1,1,0,0,0,0,0,0,0,0,0,0,0,0,0,0,0,0
209551,21020,210,20,-2,2,2,0,0,0,0,0,0,0,0,0,0,0,0,0,0,0,0,1,1,0,0,0,0,0,0,0,1,1,0
209612,21020,210,20,-2,2,1,1,0,0,0,1,1,0,0,0,0,0,0,0,0,0,0,1,0,1,0,0,0,0,0,0,0,0,0
209825,21020,210,20,-2,2,1,1,0,0,0,0,0,0,1,0,1,1,1,0,0,0,0,0,0,0,0,0,0,0,0,0,0,0,0
211440,21020,210,20,-2,2,1,1,0,0,0,0,0,0,0,0,0,0,0,0,0,0,0,2,1,1,0,0,0,0,0,0,0,0,0
212054,21020,210,20,-2,1,0,1,0,0,0,1,0,1,0,0,0,0,0,0,0,0,0,0,0,0,0,0,0,0,0,0,0,0,0
212133,21020,210,20,-2,2,2,0,0,0,0,0,0,0,0,0,0,0,0,0,0,0,0,2,2,0,0,0,0,0,0,0,0,0,0
213543,21020,210,20,-2,2,2,0,0,0,0,1,1,0,0,0,0,0,0,0,0,0,0,1,1,0,0,0,0,0,0,0,0,0,0
213826,21020,210,20,-2,1,0,1,0,0,0,0,0,0,0,0,0,0,0,0,0,0,0,1,0,1,0,0,0,0,0,0,0,0,0
215062,21020,210,20,-2,27,11,16,0,0,0,3,0,3,8,4,4,4,2,2,0,0,0,8,3,5,1,1,0,1,0,1,2,1,1
215293,21020,210,20,-2,4,3,1,0,0,0,0,0,0,1,1,0,0,0,0,0,0,0,1,1,0,1,1,0,0,0,0,1,0,1
216597,21020,210,20,-2,3,1,2,0,0,0,1,1,0,1,0,1,0,0,0,0,0,0,1,0,1,0,0,0,0,0,0,0,0,0
217156,21020,210,20,-2,8,1,7,0,0,0,0,0,0,2,0,2,0,0,0,0,0,0,4,0,4,0,0,0,0,0,0,2,1,1
217402,21020,210,20,-2,2,0,2,0,0,0,0,0,0,0,0,0,0,0,0,0,0,0,2,0,2,0,0,0,0,0,0,0,0,0
217475,21020,210,20,-2,14,4,10,0,0,0,1,0,1,1,1,0,1,1,0,0,0,0,11,2,9,0,0,0,0,0,0,0,0,0
217484,21020,210,20,-2,4,1,3,0,0,0,1,0,1,1,0,1,0,0,0,0,0,0,2,1,1,0,0,0,0,0,0,0,0,0
217518,21020,210,20,-2,1,0,1,0,0,0,0,0,0,1,0,1,0,0,0,0,0,0,0,0,0,0,0,0,0,0,0,0,0,0
217864,21020,210,20,-2,1,0,1,0,0,0,0,0,0,0,0,0,0,0,0,0,0,0,1,0,1,0,0,0,0,0,0,0,0,0
217882,21020,210,20,-2,7,5,2,0,0,0,1,0,1,0,0,0,0,0,0,0,0,0,6,5,1,0,0,0,0,0,0,0,0,0
218070,21020,210,20,-2,1,1,0,0,0,0,0,0,0,0,0,0,0,0,0,0,0,0,1,1,0,0,0,0,0,0,0,0,0,0
218663,21020,210,20,-2,6,3,3,0,0,0,1,0,1,1,0,1,0,0,0,0,0,0,4,3,1,0,0,0,0,0,0,0,0,0
219356,21020,210,20,-2,3,2,1,0,0,0,1,1,0,0,0,0,0,0,0,0,0,0,2,1,1,0,0,0,0,0,0,0,0,0
219471,21020,210,20,-2,1,1,0,0,0,0,0,0,0,0,0,0,0,0,0,0,0,0,1,1,0,0,0,0,0,0,0,0,0,0
219602,21020,210,20,-2,1,0,1,0,0,0,0,0,0,0,0,0,0,0,0,0,0,0,1,0,1,0,0,0,0,0,0,0,0,0
219824,21020,210,20,-2,1,0,1,0,0,0,0,0,0,0,0,0,0,0,0,0,0,0,1,0,1,0,0,0,0,0,0,0,0,0
220075,21020,210,20,-2,13,9,4,0,0,0,0,0,0,1,1,0,0,0,0,0,0,0,10,7,3,0,0,0,1,1,0,1,0,1
220400,21020,210,20,-2,1,1,0,0,0,0,0,0,0,0,0,0,0,0,0,0,0,0,1,1,0,0,0,0,0,0,0,0,0,0
220862,21020,210,20,-2,2,0,2,0,0,0,0,0,0,1,0,1,0,0,0,0,0,0,1,0,1,0,0,0,0,0,0,0,0,0
220978,21020,210,20,-2,3,2,1,0,0,0,1,1,0,1,0,1,0,0,0,0,0,0,1,1,0,0,0,0,0,0,0,0,0,0
221351,21020,210,20,-2,1,0,1,0,0,0,0,0,0,0,0,0,0,0,0,0,0,0,1,0,1,0,0,0,0,0,0,0,0,0
221485,21020,210,20,-2,2,0,2,0,0,0,0,0,0,1,0,1,0,0,0,0,0,0,1,0,1,0,0,0,0,0,0,0,0,0
221740,21020,210,20,-2,6,3,3,0,0,0,2,1,1,0,0,0,0,0,0,0,0,0,4,2,2,0,0,0,0,0,0,0,0,0
221759,21020,210,20,-2,11,7,4,0,0,0,2,1,1,5,3,2,1,0,1,0,0,0,2,2,0,0,0,0,0,0,0,1,1,0
221999,21020,210,20,-2,8,6,2,0,0,0,0,0,0,1,1,0,0,0,0,0,0,0,1,1,0,0,0,0,6,4,2,0,0,0
222831,21020,210,20,-2,1,0,1,0,0,0,0,0,0,0,0,0,0,0,0,0,0,0,0,0,0,0,0,0,1,0,1,0,0,0
223223,21020,210,20,-2,6,3,3,0,0,0,1,0,1,0,0,0,0,0,0,0,0,0,5,3,2,0,0,0,0,0,0,0,0,0
223232,21020,210,20,-2,5,4,1,0,0,0,2,1,1,0,0,0,0,0,0,0,0,0,2,2,0,0,0,0,1,1,0,0,0,0
224323,21020,210,20,-2,1,0,1,0,0,0,0,0,0,0,0,0,0,0,0,0,0,0,1,0,1,0,0,0,0,0,0,0,0,0
224554,21020,210,20,-2,2,2,0,0,0,0,1,1,0,0,0,0,0,0,0,0,0,0,1,1,0,0,0,0,0,0,0,0,0,0
224642,21020,210,20,-2,1,0,1,0,0,0,0,0,0,0,0,0,0,0,0,0,0,0,1,0,1,0,0,0,0,0,0,0,0,0
225511,21020,210,20,-2,15,12,3,0,0,0,6,5,1,3,2,1,1,1,0,0,0,0,5,4,1,0,0,0,0,0,0,0,0,0
225627,21020,210,20,-2,1,0,1,0,0,0,0,0,0,0,0,0,0,0,0,0,0,0,0,0,0,1,0,1,0,0,0,0,0,0
226091,21020,210,20,-2,1,1,0,0,0,0,0,0,0,0,0,0,0,0,0,0,0,0,1,1,0,0,0,0,0,0,0,0,0,0
227216,21020,210,20,-2,12,7,5,0,0,0,5,4,1,0,0,0,0,0,0,0,0,0,6,2,4,0,0,0,1,1,0,0,0,0
227368,21020,210,20,-2,55,36,19,0,0,0,11,8,3,1,1,0,21,10,11,0,0,0,21,16,5,0,0,0,1,1,0,0,0,0
227757,21020,210,20,-2,7,7,0,0,0,0,1,1,0,0,0,0,2,2,0,0,0,0,2,2,0,0,0,0,2,2,0,0,0,0
227863,21020,210,20,-2,1,1,0,0,0,0,0,0,0,0,0,0,0,0,0,0,0,0,1,1,0,0,0,0,0,0,0,0,0,0
227881,21020,210,20,-2,2,1,1,0,0,0,1,1,0,0,0,0,0,0,0,0,0,0,1,0,1,0,0,0,0,0,0,0,0,0
228246,21020,210,20,-2,1,0,1,0,0,0,0,0,0,0,0,0,1,0,1,0,0,0,0,0,0,0,0,0,0,0,0,0,0,0
228431,21020,210,20,-2,1,0,1,0,0,0,0,0,0,0,0,0,0,0,0,0,0,0,1,0,1,0,0,0,0,0,0,0,0,0
228459,21020,210,20,-2,4,1,3,0,0,0,1,0,1,0,0,0,0,0,0,0,0,0,2,1,1,0,0,0,1,0,1,0,0,0
228501,21020,210,20,-2,1,0,1,0,0,0,0,0,0,0,0,0,0,0,0,0,0,0,1,0,1,0,0,0,0,0,0,0,0,0
228635,21020,210,20,-2,6,5,1,0,0,0,5,4,1,0,0,0,0,0,0,0,0,0,1,1,0,0,0,0,0,0,0,0,0,0
228644,21020,210,20,-2,2,0,2,0,0,0,0,0,0,0,0,0,0,0,0,0,0,0,2,0,2,0,0,0,0,0,0,0,0,0
228723,21020,210,20,-2,8,7,1,0,0,0,3,3,0,2,1,1,0,0,0,0,0,0,2,2,0,0,0,0,1,1,0,0,0,0
228769,21020,210,20,-2,6,2,4,0,0,0,0,0,0,0,0,0,1,1,0,0,0,0,4,1,3,0,0,0,1,0,1,0,0,0
228778,21020,210,20,-2,42,25,17,0,0,0,9,4,5,5,1,4,10,6,4,0,0,0,16,12,4,0,0,0,0,0,0,2,2,0
228787,21020,210,20,-2,2,2,0,0,0,0,1,1,0,0,0,0,0,0,0,0,0,0,1,1,0,0,0,0,0,0,0,0,0,0
228796,21020,210,20,-2,2,1,1,0,0,0,0,0,0,0,0,0,1,0,1,0,0,0,0,0,0,0,0,0,1,1,0,0,0,0
228909,21020,210,20,-2,1,1,0,0,0,0,0,0,0,0,0,0,0,0,0,0,0,0,1,1,0,0,0,0,0,0,0,0,0,0
229018,21020,210,20,-2,1,1,0,0,0,0,0,0,0,0,0,0,0,0,0,0,0,0,1,1,0,0,0,0,0,0,0,0,0,0
229027,21020,210,20,-2,5,3,2,0,0,0,1,1,0,1,0,1,2,1,1,0,0,0,1,1,0,0,0,0,0,0,0,0,0,0
229115,21020,210,20,-2,2,2,0,0,0,0,0,0,0,0,0,0,0,0,0,0,0,0,1,1,0,0,0,0,0,0,0,1,1,0
229267,21020,210,20,-2,1,1,0,0,0,0,0,0,0,0,0,0,1,1,0,0,0,0,0,0,0,0,0,0,0,0,0,0,0,0
229300,21020,210,20,-2,4,3,1,0,0,0,4,3,1,0,0,0,0,0,0,0,0,0,0,0,0,0,0,0,0,0,0,0,0,0
229337,21020,210,20,-2,1,0,1,0,0,0,0,0,0,0,0,0,0,0,0,0,0,0,1,0,1,0,0,0,0,0,0,0,0,0
229540,21020,210,20,-2,1,1,0,0,0,0,0,0,0,0,0,0,0,0,0,0,0,0,1,1,0,0,0,0,0,0,0,0,0,0
230728,21020,210,20,-2,2,2,0,0,0,0,0,0,0,0,0,0,0,0,0,0,0,0,2,2,0,0,0,0,0,0,0,0,0,0
230737,21020,210,20,-2,3,3,0,0,0,0,0,0,0,0,0,0,0,0,0,0,0,0,3,3,0,0,0,0,0,0,0,0,0,0
230764,21020,210,20,-2,7,5,2,0,0,0,2,1,1,0,0,0,0,0,0,0,0,0,3,2,1,0,0,0,1,1,0,1,1,0
230913,21020,210,20,-2,1,1,0,0,0,0,0,0,0,0,0,0,0,0,0,0,0,0,1,1,0,0,0,0,0,0,0,0,0,0
230995,21020,210,20,-2,1,1,0,0,0,0,0,0,0,0,0,0,0,0,0,0,0,0,1,1,0,0,0,0,0,0,0,0,0,0
231059,21020,210,20,-2,1,0,1,0,0,0,0,0,0,0,0,0,0,0,0,0,0,0,1,0,1,0,0,0,0,0,0,0,0,0
231174,21020,210,20,-2,2,0,2,0,0,0,0,0,0,0,0,0,0,0,0,0,0,0,2,0,2,0,0,0,0,0,0,0,0,0
231624,21020,210,20,-2,2,1,1,0,0,0,0,0,0,0,0,0,0,0,0,0,0,0,2,1,1,0,0,0,0,0,0,0,0,0
232025,21020,210,20,-2,2,1,1,0,0,0,0,0,0,0,0,0,0,0,0,0,0,0,1,0,1,0,0,0,1,1,0,0,0,0
232186,21020,210,20,-2,12,5,7,0,0,0,4,1,3,5,2,3,0,0,0,0,0,0,3,2,1,0,0,0,0,0,0,0,0,0
232423,21020,210,20,-2,2,0,2,1,0,1,0,0,0,0,0,0,0,0,0,0,0,0,1,0,1,0,0,0,0,0,0,0,0,0
232982,21020,210,20,-2,6,3,3,0,0,0,2,0,2,1,1,0,0,0,0,0,0,0,2,1,1,0,0,0,0,0,0,1,1,0
233277,21020,210,20,-2,2,1,1,0,0,0,0,0,0,0,0,0,0,0,0,0,0,0,2,1,1,0,0,0,0,0,0,0,0,0
233374,21020,210,20,-2,1,0,1,0,0,0,0,0,0,0,0,0,0,0,0,0,0,0,1,0,1,0,0,0,0,0,0,0,0,0
233921,21020,210,20,-2,7,5,2,0,0,0,1,1,0,0,0,0,0,0,0,0,0,0,5,3,2,1,1,0,0,0,0,0,0,0
234030,21020,210,20,-2,5,2,3,0,0,0,0,0,0,0,0,0,0,0,0,0,0,0,5,2,3,0,0,0,0,0,0,0,0,0
234076,21020,210,20,-2,29,14,15,0,0,0,7,4,3,8,5,3,0,0,0,0,0,0,12,3,9,0,0,0,2,2,0,0,0,0
234155,21020,210,20,-2,3,1,2,0,0,0,1,0,1,2,1,1,0,0,0,0,0,0,0,0,0,0,0,0,0,0,0,0,0,0
234173,21020,210,20,-2,1,1,0,0,0,0,0,0,0,0,0,0,0,0,0,0,0,0,1,1,0,0,0,0,0,0,0,0,0,0
235316,21020,210,20,-2,1,0,1,0,0,0,0,0,0,0,0,0,0,0,0,0,0,0,1,0,1,0,0,0,0,0,0,0,0,0
235431,21020,210,20,-2,3,2,1,0,0,0,0,0,0,0,0,0,0,0,0,0,0,0,3,2,1,0,0,0,0,0,0,0,0,0
236452,21020,210,20,-2,1,1,0,0,0,0,0,0,0,0,0,0,0,0,0,0,0,0,0,0,0,0,0,0,1,1,0,0,0,0
236595,21020,210,20,-2,2,1,1,0,0,0,1,0,1,0,0,0,0,0,0,0,0,0,0,0,0,0,0,0,1,1,0,0,0,0
236939,21020,210,20,-2,3,1,2,0,0,0,0,0,0,0,0,0,0,0,0,0,0,0,3,1,2,0,0,0,0,0,0,0,0,0
236948,21020,210,20,-2,22,9,13,1,0,1,2,2,0,5,1,4,2,1,1,0,0,0,10,4,6,0,0,0,1,0,1,1,1,0
237880,21020,210,20,-2,1,0,1,0,0,0,0,0,0,0,0,0,0,0,0,0,0,0,1,0,1,0,0,0,0,0,0,0,0,0
237899,21020,210,20,-2,1,0,1,0,0,0,0,0,0,0,0,0,0,0,0,0,0,0,1,0,1,0,0,0,0,0,0,0,0,0
238032,21020,210,20,-2,3,2,1,0,0,0,1,1,0,0,0,0,0,0,0,0,0,0,2,1,1,0,0,0,0,0,0,0,0,0
238476,21020,210,20,-2,1,1,0,0,0,0,1,1,0,0,0,0,0,0,0,0,0,0,0,0,0,0,0,0,0,0,0,0,0,0
240268,21020,210,20,-2,1,0,1,0,0,0,0,0,0,0,0,0,0,0,0,0,0,0,1,0,1,0,0,0,0,0,0,0,0,0
240444,21020,210,20,-2,8,4,4,0,0,0,2,1,1,0,0,0,1,0,1,0,0,0,4,2,2,0,0,0,0,0,0,1,1,0
240453,21020,210,20,-2,2,2,0,0,0,0,0,0,0,0,0,0,1,1,0,0,0,0,1,1,0,0,0,0,0,0,0,0,0,0
240727,21020,210,20,-2,2,2,0,0,0,0,0,0,0,0,0,0,0,0,0,0,0,0,1,1,0,0,0,0,1,1,0,0,0,0
241766,21020,210,20,-2,2,1,1,0,0,0,0,0,0,0,0,0,2,1,1,0,0,0,0,0,0,0,0,0,0,0,0,0,0,0
241951,21020,210,20,-2,1,1,0,0,0,0,0,0,0,0,0,0,1,1,0,0,0,0,0,0,0,0,0,0,0,0,0,0,0,0
242112,21020,210,20,-2,1,0,1,0,0,0,0,0,0,0,0,0,1,0,1,0,0,0,0,0,0,0,0,0,0,0,0,0,0,0
242653,21020,210,20,-2,1,0,1,0,0,0,0,0,0,0,0,0,1,0,1,0,0,0,0,0,0,0,0,0,0,0,0,0,0,0
243744,21020,210,20,-2,12,7,5,0,0,0,3,2,1,3,1,2,0,0,0,0,0,0,5,3,2,0,0,0,0,0,0,1,1,0
243780,21020,210,20,-2,10,7,3,0,0,0,2,1,1,0,0,0,0,0,0,0,0,0,7,6,1,0,0,0,0,0,0,1,0,1
366711,21020,210,20,-2,1,1,0,0,0,0,0,0,0,0,0,0,1,1,0,0,0,0,0,0,0,0,0,0,0,0,0,0,0,0
377555,21020,210,20,-2,1,0,1,0,0,0,1,0,1,0,0,0,0,0,0,0,0,0,0,0,0,0,0,0,0,0,0,0,0,0
377564,21020,210,20,-2,2,0,2,0,0,0,0,0,0,1,0,1,0,0,0,0,0,0,1,0,1,0,0,0,0,0,0,0,0,0
432348,21020,210,20,-2,1,1,0,0,0,0,0,0,0,0,0,0,0,0,0,0,0,0,1,1,0,0,0,0,0,0,0,0,0,0
435000,21020,210,20,-2,3,3,0,0,0,0,3,3,0,0,0,0,0,0,0,0,0,0,0,0,0,0,0,0,0,0,0,0,0,0
440651,21020,210,20,-2,1,0,1,0,0,0,0,0,0,0,0,0,1,0,1,0,0,0,0,0,0,0,0,0,0,0,0,0,0,0
441760,21020,210,20,-2,2,1,1,0,0,0,0,0,0,0,0,0,1,1,0,0,0,0,0,0,0,0,0,0,1,0,1,0,0,0
445188,21020,210,20,-2,3,3,0,0,0,0,0,0,0,0,0,0,0,0,0,0,0,0,1,1,0,0,0,0,1,1,0,1,1,0
459949,21020,210,20,-2,2,1,1,0,0,0,0,0,0,0,0,0,0,0,0,0,0,0,2,1,1,0,0,0,0,0,0,0,0,0
482149,21020,210,20,-2,3,1,2,0,0,0,0,0,0,0,0,0,0,0,0,0,0,0,3,1,2,0,0,0,0,0,0,0,0,0
483124,21020,210,20,-2,3,1,2,0,0,0,0,0,0,0,0,0,0,0,0,0,0,0,1,0,1,1,0,1,1,1,0,0,0,0
490805,21020,210,20,-2,1,0,1,0,0,0,0,0,0,0,0,0,0,0,0,0,0,0,1,0,1,0,0,0,0,0,0,0,0,0
492689,21020,210,20,-2,3,1,2,0,0,0,1,0,1,0,0,0,0,0,0,0,0,0,2,1,1,0,0,0,0,0,0,0,0,0
495767,21020,210,20,-2,9,4,5,0,0,0,2,1,1,1,1,0,1,0,1,0,0,0,3,1,2,0,0,0,0,0,0,2,1,1
100654,21030,210,30,-2,14,7,7,0,0,0,0,0,0,3,2,1,0,0,0,0,0,0,10,5,5,0,0,0,0,0,0,1,0,1
100663,21030,210,30,-2,60,41,19,1,1,0,9,8,1,8,4,4,3,2,1,0,0,0,26,15,11,1,1,0,0,0,0,12,10,2
100706,21030,210,30,-2,6,5,1,0,0,0,1,1,0,0,0,0,0,0,0,0,0,0,5,4,1,0,0,0,0,0,0,0,0,0
100724,21030,210,30,-2,8,5,3,0,0,0,2,1,1,5,3,2,0,0,0,0,0,0,1,1,0,0,0,0,0,0,0,0,0,0
100751,21030,210,30,-2,43,22,21,0,0,0,6,4,2,3,0,3,0,0,0,0,0,0,15,8,7,1,0,1,0,0,0,18,10,8
100760,21030,210,30,-2,3,0,3,0,0,0,0,0,0,0,0,0,0,0,0,0,0,0,3,0,3,0,0,0,0,0,0,0,0,0
100812,21030,210,30,-2,6,4,2,0,0,0,3,2,1,0,0,0,0,0,0,0,0,0,3,2,1,0,0,0,0,0,0,0,0,0
100830,21030,210,30,-2,10,5,5,0,0,0,0,0,0,0,0,0,0,0,0,0,0,0,2,1,1,0,0,0,4,0,4,4,4,0
100858,21030,210,30,-2,46,25,21,0,0,0,2,0,2,3,0,3,0,0,0,0,0,0,29,16,13,1,1,0,0,0,0,11,8,3
100937,21030,210,30,-2,5,2,3,0,0,0,1,1,0,1,1,0,0,0,0,0,0,0,3,0,3,0,0,0,0,0,0,0,0,0
101028,21030,210,30,-2,2,0,2,0,0,0,0,0,0,0,0,0,0,0,0,0,0,0,2,0,2,0,0,0,0,0,0,0,0,0
101143,21030,210,30,-2,8,7,1,0,0,0,1,1,0,1,1,0,0,0,0,0,0,0,6,5,1,0,0,0,0,0,0,0,0,0
101161,21030,210,30,-2,13,7,6,1,1,0,0,0,0,2,1,1,0,0,0,0,0,0,10,5,5,0,0,0,0,0,0,0,0,0
101189,21030,210,30,-2,15,4,11,1,0,1,0,0,0,2,1,1,0,0,0,0,0,0,12,3,9,0,0,0,0,0,0,0,0,0
101240,21030,210,30,-2,7,5,2,0,0,0,0,0,0,1,1,0,1,0,1,0,0,0,5,4,1,0,0,0,0,0,0,0,0,0
101286,21030,210,30,-2,9,4,5,0,0,0,0,0,0,0,0,0,0,0,0,0,0,0,9,4,5,0,0,0,0,0,0,0,0,0
101295,21030,210,30,-2,12,9,3,0,0,0,0,0,0,0,0,0,1,1,0,0,0,0,11,8,3,0,0,0,0,0,0,0,0,0
101435,21030,210,30,-2,2,2,0,0,0,0,0,0,0,1,1,0,0,0,0,0,0,0,0,0,0,0,0,0,1,1,0,0,0,0
101462,21030,210,30,-2,4,0,4,0,0,0,0,0,0,3,0,3,0,0,0,0,0,0,1,0,1,0,0,0,0,0,0,0,0,0
101471,21030,210,30,-2,5,3,2,0,0,0,0,0,0,2,0,2,0,0,0,0,0,0,3,3,0,0,0,0,0,0,0,0,0,0
101480,21030,210,30,-2,33,12,21,0,0,0,2,1,1,2,1,1,1,0,1,0,0,0,24,8,16,0,0,0,0,0,0,4,2,2
101514,21030,210,30,-2,5,2,3,0,0,0,0,0,0,0,0,0,0,0,0,0,0,0,5,2,3,0,0,0,0,0,0,0,0,0
101569,21030,210,30,-2,7,5,2,0,0,0,0,0,0,4,2,2,0,0,0,0,0,0,3,3,0,0,0,0,0,0,0,0,0,0
101587,21030,210,30,-2,5,2,3,0,0,0,0,0,0,0,0,0,0,0,0,0,0,0,1,0,1,0,0,0,2,0,2,2,2,0
101602,21030,210,30,-2,6,4,2,0,0,0,0,0,0,0,0,0,0,0,0,0,0,0,6,4,2,0,0,0,0,0,0,0,0,0
101648,21030,210,30,-2,2,2,0,0,0,0,0,0,0,0,0,0,0,0,0,0,0,0,2,2,0,0,0,0,0,0,0,0,0,0
101693,21030,210,30,-2,2,2,0,0,0,0,0,0,0,0,0,0,0,0,0,0,0,0,2,2,0,0,0,0,0,0,0,0,0,0
101709,21030,210,30,-2,5,3,2,0,0,0,1,1,0,1,0,1,0,0,0,0,0,0,2,1,1,0,0,0,0,0,0,1,1,0
101736,21030,210,30,-2,2,1,1,0,0,0,0,0,0,1,0,1,0,0,0,0,0,0,1,1,0,0,0,0,0,0,0,0,0,0
101879,21030,210,30,-2,12,12,0,0,0,0,2,2,0,1,1,0,1,1,0,0,0,0,8,8,0,0,0,0,0,0,0,0,0,0
101912,21030,210,30,-2,4,2,2,0,0,0,0,0,0,4,2,2,0,0,0,0,0,0,0,0,0,0,0,0,0,0,0,0,0,0
102030,21030,210,30,-2,4,1,3,0,0,0,0,0,0,1,0,1,0,0,0,0,0,0,2,1,1,0,0,0,1,0,1,0,0,0
102049,21030,210,30,-2,14,6,8,0,0,0,0,0,0,1,0,1,0,0,0,0,0,0,13,6,7,0,0,0,0,0,0,0,0,0
102067,21030,210,30,-2,12,3,9,0,0,0,0,0,0,5,2,3,0,0,0,0,0,0,7,1,6,0,0,0,0,0,0,0,0,0
102076,21030,210,30,-2,9,7,2,0,0,0,0,0,0,0,0,0,0,0,0,0,0,0,9,7,2,0,0,0,0,0,0,0,0,0
102094,21030,210,30,-2,24,16,8,0,0,0,8,6,2,1,0,1,0,0,0,0,0,0,15,10,5,0,0,0,0,0,0,0,0,0
102234,21030,210,30,-2,9,1,8,0,0,0,0,0,0,1,0,1,0,0,0,0,0,0,8,1,7,0,0,0,0,0,0,0,0,0
102270,21030,210,30,-2,4,1,3,0,0,0,0,0,0,4,1,3,0,0,0,0,0,0,0,0,0,0,0,0,0,0,0,0,0,0
102298,21030,210,30,-2,3,1,2,0,0,0,0,0,0,3,1,2,0,0,0,0,0,0,0,0,0,0,0,0,0,0,0,0,0,0
102313,21030,210,30,-2,4,1,3,0,0,0,0,0,0,4,1,3,0,0,0,0,0,0,0,0,0,0,0,0,0,0,0,0,0,0
102368,21030,210,30,-2,2,1,1,0,0,0,0,0,0,0,0,0,0,0,0,0,0,0,2,1,1,0,0,0,0,0,0,0,0,0
102429,21030,210,30,-2,9,6,3,0,0,0,0,0,0,0,0,0,0,0,0,0,0,0,9,6,3,0,0,0,0,0,0,0,0,0
102553,21030,210,30,-2,9,3,6,0,0,0,0,0,0,0,0,0,0,0,0,0,0,0,7,2,5,0,0,0,1,1,0,1,0,1
102614,21030,210,30,-2,2,0,2,0,0,0,0,0,0,0,0,0,0,0,0,0,0,0,2,0,2,0,0,0,0,0,0,0,0,0
102632,21030,210,30,-2,2,0,2,0,0,0,0,0,0,0,0,0,0,0,0,0,0,0,2,0,2,0,0,0,0,0,0,0,0,0
104151,21030,210,30,-2,77,41,36,0,0,0,6,6,0,7,0,7,8,7,1,0,0,0,8,4,4,0,0,0,28,13,15,20,11,9
104179,21030,210,30,-2,14,8,6,0,0,0,3,1,2,0,0,0,0,0,0,0,0,0,9,6,3,1,0,1,0,0,0,1,1,0
104586,21030,210,30,-2,17,12,5,0,0,0,4,4,0,0,0,0,1,0,1,0,0,0,9,7,2,0,0,0,2,1,1,1,0,1
104708,21030,210,30,-2,5,3,2,0,0,0,0,0,0,0,0,0,1,0,1,0,0,0,3,2,1,1,1,0,0,0,0,0,0,0
105145,21030,210,30,-2,5,2,3,0,0,0,0,0,0,0,0,0,1,1,0,0,0,0,4,1,3,0,0,0,0,0,0,0,0,0
105154,21030,210,30,-2,9,3,6,0,0,0,0,0,0,1,1,0,0,0,0,0,0,0,8,2,6,0,0,0,0,0,0,0,0,0
105330,21030,210,30,-2,10,3,7,0,0,0,2,0,2,1,0,1,0,0,0,0,0,0,5,2,3,0,0,0,0,0,0,2,1,1
105428,21030,210,30,-2,3,2,1,0,0,0,1,1,0,0,0,0,0,0,0,0,0,0,1,1,0,0,0,0,1,0,1,0,0,0
105668,21030,210,30,-2,1,0,1,0,0,0,0,0,0,0,0,0,0,0,0,0,0,0,1,0,1,0,0,0,0,0,0,0,0,0
105747,21030,210,30,-2,4,2,2,0,0,0,0,0,0,0,0,0,0,0,0,0,0,0,4,2,2,0,0,0,0,0,0,0,0,0
105792,21030,210,30,-2,1,1,0,0,0,0,0,0,0,0,0,0,0,0,0,0,0,0,1,1,0,0,0,0,0,0,0,0,0,0
106245,21030,210,30,-2,12,5,7,0,0,0,0,0,0,0,0,0,0,0,0,0,0,0,8,3,5,0,0,0,3,1,2,1,1,0
106263,21030,210,30,-2,4,0,4,0,0,0,1,0,1,0,0,0,1,0,1,0,0,0,1,0,1,0,0,0,0,0,0,1,0,1
106397,21030,210,30,-2,20,12,8,0,0,0,2,1,1,0,0,0,3,1,2,0,0,0,6,4,2,0,0,0,0,0,0,9,6,3
106412,21030,210,30,-2,6,4,2,0,0,0,1,1,0,3,1,2,0,0,0,0,0,0,2,2,0,0,0,0,0,0,0,0,0,0
106458,21030,210,30,-2,11,8,3,0,0,0,1,1,0,1,1,0,0,0,0,0,0,0,6,3,3,0,0,0,1,1,0,2,2,0
106467,21030,210,30,-2,8,4,4,0,0,0,5,2,3,0,0,0,0,0,0,0,0,0,3,2,1,0,0,0,0,0,0,0,0,0
106485,21030,210,30,-2,7,6,1,0,0,0,1,1,0,0,0,0,0,0,0,0,0,0,3,2,1,0,0,0,0,0,0,3,3,0
106704,21030,210,30,-2,14,7,7,0,0,0,1,1,0,1,1,0,0,0,0,0,0,0,10,5,5,0,0,0,0,0,0,2,0,2
107071,21030,210,30,-2,2,0,2,0,0,0,0,0,0,1,0,1,0,0,0,0,0,0,1,0,1,0,0,0,0,0,0,0,0,0
107512,21030,210,30,-2,4,2,2,0,0,0,0,0,0,0,0,0,0,0,0,0,0,0,4,2,2,0,0,0,0,0,0,0,0,0
107558,21030,210,30,-2,6,6,0,1,1,0,0,0,0,0,0,0,2,2,0,1,1,0,2,2,0,0,0,0,0,0,0,0,0,0
107600,21030,210,30,-2,1,0,1,0,0,0,0,0,0,1,0,1,0,0,0,0,0,0,0,0,0,0,0,0,0,0,0,0,0,0
107983,21030,210,30,-2,8,6,2,0,0,0,2,2,0,2,1,1,1,1,0,0,0,0,3,2,1,0,0,0,0,0,0,0,0,0
109208,21030,210,30,-2,4,1,3,0,0,0,1,0,1,1,1,0,2,0,2,0,0,0,0,0,0,0,0,0,0,0,0,0,0,0
109350,21030,210,30,-2,8,5,3,0,0,0,0,0,0,0,0,0,1,1,0,0,0,0,5,3,2,1,1,0,1,0,1,0,0,0
109819,21030,210,30,-2,6,1,5,0,0,0,1,0,1,0,0,0,0,0,0,0,0,0,5,1,4,0,0,0,0,0,0,0,0,0
110097,21030,210,30,-2,6,5,1,0,0,0,0,0,0,0,0,0,1,1,0,0,0,0,2,2,0,0,0,0,3,2,1,0,0,0
110361,21030,210,30,-2,24,10,14,0,0,0,3,2,1,3,1,2,8,2,6,0,0,0,10,5,5,0,0,0,0,0,0,0,0,0
110404,21030,210,30,-2,5,1,4,0,0,0,2,0,2,0,0,0,0,0,0,0,0,0,0,0,0,2,1,1,0,0,0,1,0,1
110413,21030,210,30,-2,2,2,0,0,0,0,0,0,0,0,0,0,2,2,0,0,0,0,0,0,0,0,0,0,0,0,0,0,0,0
110422,21030,210,30,-2,19,12,7,0,0,0,1,1,0,2,2,0,1,0,1,0,0,0,5,1,4,0,0,0,0,0,0,10,8,2
110486,21030,210,30,-2,4,0,4,0,0,0,0,0,0,0,0,0,1,0,1,0,0,0,2,0,2,0,0,0,0,0,0,1,0,1
110495,21030,210,30,-2,11,2,9,0,0,0,2,0,2,0,0,0,3,2,1,0,0,0,3,0,3,0,0,0,0,0,0,3,0,3
110510,21030,210,30,-2,11,5,6,0,0,0,4,2,2,1,1,0,3,1,2,0,0,0,3,1,2,0,0,0,0,0,0,0,0,0
110529,21030,210,30,-2,1,1,0,0,0,0,0,0,0,0,0,0,0,0,0,0,0,0,0,0,0,0,0,0,1,1,0,0,0,0
110538,21030,210,30,-2,14,9,5,0,0,0,0,0,0,3,1,2,0,0,0,0,0,0,6,3,3,0,0,0,1,1,0,4,4,0
110547,21030,210,30,-2,8,2,6,0,0,0,0,0,0,1,0,1,1,0,1,0,0,0,2,1,1,2,1,1,0,0,0,2,0,2
110556,21030,210,30,-2,17,5,12,0,0,0,3,2,1,1,0,1,3,1,2,0,0,0,6,1,5,0,0,0,1,0,1,3,1,2
110565,21030,210,30,-2,30,16,14,0,0,0,2,1,1,5,1,4,7,2,5,0,0,0,8,7,1,1,0,1,0,0,0,7,5,2
110574,21030,210,30,-2,9,3,6,0,0,0,1,1,0,0,0,0,1,0,1,0,0,0,2,0,2,0,0,0,3,2,1,2,0,2
110583,21030,210,30,-2,25,7,18,1,0,1,3,0,3,4,1,3,2,1,1,0,0,0,7,0,7,1,1,0,1,0,1,6,4,2
110592,21030,210,30,-2,2,0,2,0,0,0,0,0,0,0,0,0,0,0,0,0,0,0,2,0,2,0,0,0,0,0,0,0,0,0
110608,21030,210,30,-2,19,10,9,0,0,0,3,2,1,1,1,0,2,1,1,0,0,0,6,0,6,0,0,0,0,0,0,7,6,1
110617,21030,210,30,-2,21,12,9,1,0,1,2,1,1,5,4,1,2,1,1,0,0,0,3,2,1,0,0,0,5,2,3,3,2,1
110635,21030,210,30,-2,52,25,27,1,1,0,3,3,0,4,1,3,5,1,4,0,0,0,16,8,8,4,2,2,0,0,0,19,9,10
110644,21030,210,30,-2,37,19,18,0,0,0,6,2,4,2,1,1,4,2,2,0,0,0,8,3,5,1,0,1,2,1,1,14,10,4
110653,21030,210,30,-2,43,15,28,0,0,0,7,2,5,7,2,5,8,2,6,1,0,1,12,4,8,1,0,1,0,0,0,7,5,2
110662,21030,210,30,-2,39,16,23,0,0,0,7,3,4,4,2,2,5,4,1,0,0,0,8,3,5,0,0,0,2,0,2,13,4,9
110671,21030,210,30,-2,15,9,6,0,0,0,0,0,0,0,0,0,1,1,0,0,0,0,7,4,3,0,0,0,0,0,0,7,4,3
110680,21030,210,30,-2,44,25,19,0,0,0,0,0,0,4,1,3,2,2,0,0,0,0,9,3,6,1,0,1,1,1,0,27,18,9
110705,21030,210,30,-2,16,9,7,0,0,0,2,0,2,1,0,1,2,0,2,0,0,0,4,2,2,0,0,0,1,1,0,6,6,0
110714,21030,210,30,-2,31,13,18,0,0,0,2,0,2,0,0,0,3,0,3,0,0,0,11,6,5,2,1,1,1,0,1,12,6,6
111188,21030,210,30,-2,4,3,1,0,0,0,0,0,0,0,0,0,0,0,0,0,0,0,2,1,1,0,0,0,2,2,0,0,0,0
111391,21030,210,30,-2,2,2,0,0,0,0,0,0,0,1,1,0,1,1,0,0,0,0,0,0,0,0,0,0,0,0,0,0,0,0
111434,21030,210,30,-2,4,4,0,0,0,0,0,0,0,1,1,0,2,2,0,0,0,0,0,0,0,0,0,0,1,1,0,0,0,0
111461,21030,210,30,-2,1,1,0,0,0,0,0,0,0,1,1,0,0,0,0,0,0,0,0,0,0,0,0,0,0,0,0,0,0,0
111887,21030,210,30,-2,1,1,0,0,0,0,0,0,0,0,0,0,0,0,0,0,0,0,1,1,0,0,0,0,0,0,0,0,0,0
111896,21030,210,30,-2,3,1,2,0,0,0,0,0,0,0,0,0,0,0,0,0,0,0,2,0,2,0,0,0,1,1,0,0,0,0
111920,21030,210,30,-2,2,0,2,0,0,0,1,0,1,0,0,0,0,0,0,0,0,0,1,0,1,0,0,0,0,0,0,0,0,0
111939,21030,210,30,-2,13,5,8,0,0,0,2,1,1,1,0,1,2,0,2,0,0,0,8,4,4,0,0,0,0,0,0,0,0,0
111948,21030,210,30,-2,13,3,10,0,0,0,1,0,1,1,0,1,3,0,3,0,0,0,0,0,0,1,0,1,2,2,0,5,1,4
112172,21030,210,30,-2,2,1,1,0,0,0,0,0,0,0,0,0,1,0,1,0,0,0,1,1,0,0,0,0,0,0,0,0,0,0
112251,21030,210,30,-2,2,2,0,0,0,0,0,0,0,0,0,0,0,0,0,0,0,0,0,0,0,0,0,0,2,2,0,0,0,0
112260,21030,210,30,-2,1,1,0,0,0,0,1,1,0,0,0,0,0,0,0,0,0,0,0,0,0,0,0,0,0,0,0,0,0,0
112525,21030,210,30,-2,6,2,4,0,0,0,2,1,1,0,0,0,0,0,0,0,0,0,3,1,2,0,0,0,0,0,0,1,0,1
112561,21030,210,30,-2,5,2,3,0,0,0,0,0,0,0,0,0,0,0,0,0,0,0,5,2,3,0,0,0,0,0,0,0,0,0
112686,21030,210,30,-2,8,4,4,0,0,0,1,0,1,4,1,3,2,2,0,0,0,0,1,1,0,0,0,0,0,0,0,0,0,0
113111,21030,210,30,-2,3,2,1,0,0,0,1,0,1,0,0,0,0,0,0,0,0,0,1,1,0,0,0,0,1,1,0,0,0,0
113236,21030,210,30,-2,3,2,1,0,0,0,0,0,0,2,1,1,0,0,0,0,0,0,1,1,0,0,0,0,0,0,0,0,0,0
113333,21030,210,30,-2,3,2,1,0,0,0,1,0,1,0,0,0,1,1,0,0,0,0,1,1,0,0,0,0,0,0,0,0,0,0
113573,21030,210,30,-2,18,3,15,0,0,0,0,0,0,5,0,5,6,2,4,0,0,0,4,1,3,0,0,0,2,0,2,1,0,1
113634,21030,210,30,-2,1,0,1,0,0,0,1,0,1,0,0,0,0,0,0,0,0,0,0,0,0,0,0,0,0,0,0,0,0,0
113698,21030,210,30,-2,1,0,1,0,0,0,0,0,0,0,0,0,0,0,0,0,0,0,0,0,0,0,0,0,0,0,0,1,0,1
113856,21030,210,30,-2,1,1,0,0,0,0,0,0,0,0,0,0,1,1,0,0,0,0,0,0,0,0,0,0,0,0,0,0,0,0
114266,21030,210,30,-2,2,2,0,0,0,0,0,0,0,0,0,0,1,1,0,0,0,0,1,1,0,0,0,0,0,0,0,0,0,0
114433,21030,210,30,-2,5,1,4,0,0,0,0,0,0,0,0,0,0,0,0,0,0,0,5,1,4,0,0,0,0,0,0,0,0,0
114716,21030,210,30,-2,2,0,2,0,0,0,1,0,1,0,0,0,0,0,0,0,0,0,1,0,1,0,0,0,0,0,0,0,0,0
114789,21030,210,30,-2,6,3,3,0,0,0,0,0,0,0,0,0,2,0,2,0,0,0,4,3,1,0,0,0,0,0,0,0,0,0
114813,21030,210,30,-2,11,5,6,1,1,0,2,1,1,1,0,1,1,0,1,0,0,0,6,3,3,0,0,0,0,0,0,0,0,0
114840,21030,210,30,-2,1,1,0,0,0,0,0,0,0,1,1,0,0,0,0,0,0,0,0,0,0,0,0,0,0,0,0,0,0,0
114859,21030,210,30,-2,2,0,2,0,0,0,0,0,0,1,0,1,1,0,1,0,0,0,0,0,0,0,0,0,0,0,0,0,0,0
115001,21030,210,30,-2,2,1,1,0,0,0,0,0,0,0,0,0,1,1,0,0,0,0,1,0,1,0,0,0,0,0,0,0,0,0
115393,21030,210,30,-2,3,2,1,0,0,0,0,0,0,0,0,0,1,1,0,0,0,0,0,0,0,0,0,0,2,1,1,0,0,0
115409,21030,210,30,-2,1,0,1,0,0,0,0,0,0,0,0,0,0,0,0,0,0,0,1,0,1,0,0,0,0,0,0,0,0,0
115755,21030,210,30,-2,3,0,3,0,0,0,0,0,0,0,0,0,0,0,0,0,0,0,3,0,3,0,0,0,0,0,0,0,0,0
115861,21030,210,30,-2,19,11,8,0,0,0,2,1,1,0,0,0,7,3,4,0,0,0,8,5,3,1,1,0,1,1,0,0,0,0
116439,21030,210,30,-2,5,1,4,0,0,0,1,0,1,0,0,0,0,0,0,0,0,0,3,1,2,0,0,0,1,0,1,0,0,0
117052,21030,210,30,-2,2,1,1,0,0,0,0,0,0,0,0,0,0,0,0,0,0,0,1,1,0,0,0,0,1,0,1,0,0,0
117195,21030,210,30,-2,3,2,1,0,0,0,0,0,0,0,0,0,2,1,1,0,0,0,1,1,0,0,0,0,0,0,0,0,0,0
117247,21030,210,30,-2,9,2,7,0,0,0,3,0,3,0,0,0,3,2,1,0,0,0,0,0,0,0,0,0,3,0,3,0,0,0
117274,21030,210,30,-2,2,1,1,0,0,0,0,0,0,0,0,0,0,0,0,0,0,0,1,0,1,0,0,0,1,1,0,0,0,0
117627,21030,210,30,-2,1,0,1,0,0,0,0,0,0,0,0,0,0,0,0,1,0,1,0,0,0,0,0,0,0,0,0,0,0,0
117636,21030,210,30,-2,4,3,1,0,0,0,0,0,0,0,0,0,1,1,0,0,0,0,2,2,0,0,0,0,0,0,0,1,0,1
117690,21030,210,30,-2,2,1,1,0,0,0,0,0,0,1,0,1,0,0,0,0,0,0,0,0,0,0,0,0,1,1,0,0,0,0
117706,21030,210,30,-2,2,2,0,0,0,0,0,0,0,1,1,0,0,0,0,0,0,0,1,1,0,0,0,0,0,0,0,0,0,0
117715,21030,210,30,-2,1,0,1,0,0,0,0,0,0,0,0,0,1,0,1,0,0,0,0,0,0,0,0,0,0,0,0,0,0,0
117724,21030,210,30,-2,3,2,1,0,0,0,1,1,0,0,0,0,2,1,1,0,0,0,0,0,0,0,0,0,0,0,0,0,0,0
117733,21030,210,30,-2,6,1,5,0,0,0,1,0,1,1,1,0,1,0,1,0,0,0,3,0,3,0,0,0,0,0,0,0,0,0
117788,21030,210,30,-2,10,3,7,0,0,0,0,0,0,0,0,0,0,0,0,0,0,0,3,1,2,0,0,0,7,2,5,0,0,0
117867,21030,210,30,-2,5,2,3,0,0,0,0,0,0,0,0,0,1,1,0,0,0,0,4,1,3,0,0,0,0,0,0,0,0,0
117894,21030,210,30,-2,1,0,1,0,0,0,0,0,0,0,0,0,0,0,0,0,0,0,1,0,1,0,0,0,0,0,0,0,0,0
117946,21030,210,30,-2,6,4,2,0,0,0,0,0,0,2,2,0,0,0,0,0,0,0,2,0,2,0,0,0,2,2,0,0,0,0
118684,21030,210,30,-2,3,2,1,0,0,0,0,0,0,0,0,0,2,1,1,0,0,0,1,1,0,0,0,0,0,0,0,0,0,0
118718,21030,210,30,-2,4,3,1,0,0,0,0,0,0,1,1,0,1,0,1,0,0,0,0,0,0,0,0,0,2,2,0,0,0,0
118912,21030,210,30,-2,3,2,1,0,0,0,1,1,0,0,0,0,0,0,0,0,0,0,1,1,0,0,0,0,0,0,0,1,0,1
118976,21030,210,30,-2,13,8,5,0,0,0,1,1,0,2,1,1,2,1,1,0,0,0,8,5,3,0,0,0,0,0,0,0,0,0
119067,21030,210,30,-2,2,1,1,0,0,0,1,0,1,0,0,0,0,0,0,0,0,0,0,0,0,1,1,0,0,0,0,0,0,0
119137,21030,210,30,-2,5,4,1,0,0,0,1,1,0,0,0,0,0,0,0,0,0,0,2,1,1,0,0,0,0,0,0,2,2,0
119164,21030,210,30,-2,3,1,2,0,0,0,1,0,1,0,0,0,0,0,0,0,0,0,2,1,1,0,0,0,0,0,0,0,0,0
119173,21030,210,30,-2,1,0,1,0,0,0,0,0,0,0,0,0,1,0,1,0,0,0,0,0,0,0,0,0,0,0,0,0,0,0
119216,21030,210,30,-2,3,2,1,0,0,0,0,0,0,1,1,0,1,1,0,0,0,0,1,0,1,0,0,0,0,0,0,0,0,0
119331,21030,210,30,-2,6,1,5,0,0,0,0,0,0,0,0,0,0,0,0,0,0,0,5,1,4,0,0,0,1,0,1,0,0,0
119678,21030,210,30,-2,3,3,0,0,0,0,0,0,0,0,0,0,1,1,0,0,0,0,2,2,0,0,0,0,0,0,0,0,0,0
120254,21030,210,30,-2,2,0,2,0,0,0,0,0,0,1,0,1,0,0,0,0,0,0,0,0,0,0,0,0,1,0,1,0,0,0
120290,21030,210,30,-2,3,2,1,0,0,0,0,0,0,0,0,0,1,1,0,0,0,0,2,1,1,0,0,0,0,0,0,0,0,0
120421,21030,210,30,-2,5,1,4,0,0,0,1,0,1,0,0,0,1,0,1,0,0,0,2,1,1,0,0,0,1,0,1,0,0,0
120883,21030,210,30,-2,7,4,3,0,0,0,1,0,1,1,0,1,2,1,1,0,0,0,3,3,0,0,0,0,0,0,0,0,0,0
120953,21030,210,30,-2,7,4,3,0,0,0,1,1,0,0,0,0,2,1,1,0,0,0,4,2,2,0,0,0,0,0,0,0,0,0
120971,21030,210,30,-2,2,1,1,0,0,0,0,0,0,0,0,0,1,0,1,0,0,0,1,1,0,0,0,0,0,0,0,0,0,0
121044,21030,210,30,-2,7,1,6,1,0,1,0,0,0,0,0,0,0,0,0,0,0,0,5,1,4,1,0,1,0,0,0,0,0,0
121150,21030,210,30,-2,13,7,6,0,0,0,3,3,0,4,2,2,2,0,2,0,0,0,3,1,2,0,0,0,0,0,0,1,1,0
121309,21030,210,30,-2,5,1,4,0,0,0,0,0,0,0,0,0,1,1,0,0,0,0,4,0,4,0,0,0,0,0,0,0,0,0
121345,21030,210,30,-2,3,3,0,0,0,0,0,0,0,2,2,0,1,1,0,0,0,0,0,0,0,0,0,0,0,0,0,0,0,0
121707,21030,210,30,-2,3,2,1,0,0,0,0,0,0,0,0,0,0,0,0,0,0,0,3,2,1,0,0,0,0,0,0,0,0,0
121886,21030,210,30,-2,3,0,3,0,0,0,1,0,1,0,0,0,1,0,1,0,0,0,0,0,0,0,0,0,1,0,1,0,0,0
121901,21030,210,30,-2,8,2,6,0,0,0,1,0,1,0,0,0,5,2,3,0,0,0,2,0,2,0,0,0,0,0,0,0,0,0
122180,21030,210,30,-2,4,1,3,0,0,0,0,0,0,1,0,1,0,0,0,0,0,0,1,0,1,1,1,0,1,0,1,0,0,0
122205,21030,210,30,-2,5,2,3,0,0,0,2,1,1,0,0,0,0,0,0,0,0,0,3,1,2,0,0,0,0,0,0,0,0,0
122384,21030,210,30,-2,1,0,1,0,0,0,0,0,0,0,0,0,1,0,1,0,0,0,0,0,0,0,0,0,0,0,0,0,0,0
122409,21030,210,30,-2,47,23,24,0,0,0,2,1,1,7,4,3,4,3,1,0,0,0,17,4,13,1,0,1,6,4,2,10,7,3
122436,21030,210,30,-2,1,0,1,0,0,0,0,0,0,0,0,0,0,0,0,0,0,0,1,0,1,0,0,0,0,0,0,0,0,0
122597,21030,210,30,-2,5,3,2,0,0,0,1,1,0,1,0,1,0,0,0,0,0,0,1,0,1,0,0,0,0,0,0,2,2,0
122612,21030,210,30,-2,3,1,2,0,0,0,0,0,0,0,0,0,0,0,0,0,0,0,3,1,2,0,0,0,0,0,0,0,0,0
122728,21030,210,30,-2,1,1,0,0,0,0,0,0,0,0,0,0,0,0,0,0,0,0,1,1,0,0,0,0,0,0,0,0,0,0
122746,21030,210,30,-2,1,1,0,0,0,0,0,0,0,1,1,0,0,0,0,0,0,0,0,0,0,0,0,0,0,0,0,0,0,0
122755,21030,210,30,-2,44,22,22,1,1,0,6,3,3,4,2,2,5,4,1,0,0,0,12,2,10,1,0,1,1,1,0,14,9,5
122791,21030,210,30,-2,7,2,5,0,0,0,2,1,1,3,1,2,1,0,1,0,0,0,1,0,1,0,0,0,0,0,0,0,0,0
122931,21030,210,30,-2,24,8,16,0,0,0,2,1,1,5,0,5,2,1,1,0,0,0,7,3,4,0,0,0,0,0,0,8,3,5
122977,21030,210,30,-2,8,0,8,0,0,0,1,0,1,2,0,2,1,0,1,0,0,0,3,0,3,0,0,0,1,0,1,0,0,0
123013,21030,210,30,-2,11,5,6,0,0,0,0,0,0,2,2,0,2,1,1,0,0,0,6,1,5,0,0,0,1,1,0,0,0,0
123299,21030,210,30,-2,1,0,1,0,0,0,0,0,0,0,0,0,0,0,0,0,0,0,1,0,1,0,0,0,0,0,0,0,0,0
123341,21030,210,30,-2,4,1,3,0,0,0,0,0,0,0,0,0,2,0,2,0,0,0,2,1,1,0,0,0,0,0,0,0,0,0
123484,21030,210,30,-2,4,2,2,0,0,0,0,0,0,1,0,1,0,0,0,0,0,0,3,2,1,0,0,0,0,0,0,0,0,0
123509,21030,210,30,-2,4,2,2,0,0,0,1,0,1,2,2,0,1,0,1,0,0,0,0,0,0,0,0,0,0,0,0,0,0,0
123527,21030,210,30,-2,6,3,3,0,0,0,0,0,0,1,0,1,4,3,1,0,0,0,1,0,1,0,0,0,0,0,0,0,0,0
123554,21030,210,30,-2,6,3,3,0,0,0,3,2,1,1,0,1,0,0,0,0,0,0,1,1,0,0,0,0,1,0,1,0,0,0
123563,21030,210,30,-2,1,0,1,0,0,0,0,0,0,1,0,1,0,0,0,0,0,0,0,0,0,0,0,0,0,0,0,0,0,0
123800,21030,210,30,-2,10,4,6,0,0,0,0,0,0,2,2,0,2,0,2,1,1,0,3,0,3,0,0,0,2,1,1,0,0,0
123943,21030,210,30,-2,3,1,2,0,0,0,2,0,2,0,0,0,0,0,0,0,0,0,1,1,0,0,0,0,0,0,0,0,0,0
123961,21030,210,30,-2,39,22,17,1,0,1,8,4,4,7,4,3,1,0,1,0,0,0,10,6,4,1,0,1,2,1,1,9,7,2
123970,21030,210,30,-2,1,1,0,0,0,0,0,0,0,0,0,0,0,0,0,0,0,0,1,1,0,0,0,0,0,0,0,0,0,0
124113,21030,210,30,-2,1,0,1,0,0,0,0,0,0,0,0,0,0,0,0,0,0,0,1,0,1,0,0,0,0,0,0,0,0,0
125028,21030,210,30,-2,6,3,3,0,0,0,1,0,1,0,0,0,1,1,0,0,0,0,2,1,1,0,0,0,2,1,1,0,0,0
125091,21030,210,30,-2,2,1,1,0,0,0,0,0,0,0,0,0,0,0,0,0,0,0,2,1,1,0,0,0,0,0,0,0,0,0
125471,21030,210,30,-2,3,2,1,0,0,0,0,0,0,0,0,0,0,0,0,0,0,0,2,2,0,0,0,0,1,0,1,0,0,0
125718,21030,210,30,-2,1,1,0,0,0,0,0,0,0,0,0,0,0,0,0,0,0,0,1,1,0,0,0,0,0,0,0,0,0,0
125727,21030,210,30,-2,3,2,1,0,0,0,0,0,0,0,0,0,0,0,0,0,0,0,0,0,0,0,0,0,3,2,1,0,0,0
126119,21030,210,30,-2,2,0,2,0,0,0,0,0,0,0,0,0,0,0,0,0,0,0,1,0,1,0,0,0,1,0,1,0,0,0
126207,21030,210,30,-2,7,4,3,0,0,0,0,0,0,0,0,0,0,0,0,0,0,0,6,3,3,0,0,0,1,1,0,0,0,0
126289,21030,210,30,-2,9,5,4,0,0,0,0,0,0,0,0,0,0,0,0,0,0,0,8,4,4,0,0,0,1,1,0,0,0,0
126562,21030,210,30,-2,115,55,60,1,0,1,26,15,11,1,0,1,5,3,2,1,0,1,52,23,29,2,1,1,23,10,13,4,3,1
126580,21030,210,30,-2,14,6,8,0,0,0,1,1,0,0,0,0,0,0,0,0,0,0,9,3,6,0,0,0,1,0,1,3,2,1
126614,21030,210,30,-2,18,9,9,0,0,0,2,0,2,4,2,2,2,2,0,0,0,0,2,0,2,0,0,0,2,1,1,6,4,2
126678,21030,210,30,-2,10,5,5,0,0,0,1,0,1,0,0,0,3,2,1,0,0,0,2,0,2,2,1,1,0,0,0,2,2,0
126775,21030,210,30,-2,8,5,3,0,0,0,1,1,0,0,0,0,1,1,0,0,0,0,3,1,2,0,0,0,1,0,1,2,2,0
126818,21030,210,30,-2,24,12,12,0,0,0,0,0,0,0,0,0,0,0,0,0,0,0,14,5,9,1,1,0,9,6,3,0,0,0
127060,21030,210,30,-2,18,5,13,3,0,3,2,1,1,2,0,2,2,0,2,0,0,0,5,2,3,1,0,1,1,1,0,2,1,1
127185,21030,210,30,-2,7,3,4,0,0,0,0,0,0,0,0,0,0,0,0,0,0,0,7,3,4,0,0,0,0,0,0,0,0,0
127200,21030,210,30,-2,11,2,9,0,0,0,1,0,1,1,0,1,1,0,1,0,0,0,8,2,6,0,0,0,0,0,0,0,0,0
127556,21030,210,30,-2,12,4,8,0,0,0,0,0,0,0,0,0,0,0,0,0,0,0,8,1,7,0,0,0,1,0,1,3,3,0
127565,21030,210,30,-2,9,5,4,1,0,1,1,1,0,1,1,0,1,0,1,0,0,0,5,3,2,0,0,0,0,0,0,0,0,0
127741,21030,210,30,-2,7,5,2,0,0,0,1,1,0,0,0,0,0,0,0,0,0,0,6,4,2,0,0,0,0,0,0,0,0,0
127918,21030,210,30,-2,1,0,1,0,0,0,0,0,0,0,0,0,1,0,1,0,0,0,0,0,0,0,0,0,0,0,0,0,0,0
128391,21030,210,30,-2,4,1,3,0,0,0,0,0,0,0,0,0,0,0,0,0,0,0,2,0,2,1,0,1,0,0,0,1,1,0
128771,21030,210,30,-2,7,5,2,0,0,0,2,2,0,0,0,0,0,0,0,0,0,0,1,1,0,1,0,1,0,0,0,3,2,1
128902,21030,210,30,-2,2,0,2,0,0,0,0,0,0,0,0,0,0,0,0,0,0,0,0,0,0,0,0,0,1,0,1,1,0,1
129020,21030,210,30,-2,60,18,42,0,0,0,8,2,6,6,1,5,5,1,4,0,0,0,21,6,15,4,1,3,5,2,3,11,5,6
129215,21030,210,30,-2,1,0,1,0,0,0,0,0,0,0,0,0,0,0,0,0,0,0,1,0,1,0,0,0,0,0,0,0,0,0
129242,21030,210,30,-2,7,4,3,0,0,0,2,0,2,0,0,0,0,0,0,0,0,0,3,2,1,0,0,0,0,0,0,2,2,0
129525,21030,210,30,-2,13,5,8,0,0,0,0,0,0,0,0,0,2,1,1,0,0,0,2,0,2,0,0,0,1,0,1,8,4,4
129543,21030,210,30,-2,3,1,2,0,0,0,1,0,1,1,0,1,0,0,0,0,0,0,0,0,0,1,1,0,0,0,0,0,0,0
129695,21030,210,30,-2,3,0,3,0,0,0,0,0,0,0,0,0,0,0,0,1,0,1,2,0,2,0,0,0,0,0,0,0,0,0
129941,21030,210,30,-2,16,7,9,0,0,0,9,4,5,1,0,1,1,0,1,0,0,0,5,3,2,0,0,0,0,0,0,0,0,0
130040,21030,210,30,-2,6,1,5,0,0,0,1,1,0,0,0,0,0,0,0,0,0,0,5,0,5,0,0,0,0,0,0,0,0,0
130217,21030,210,30,-2,1,1,0,0,0,0,0,0,0,1,1,0,0,0,0,0,0,0,0,0,0,0,0,0,0,0,0,0,0,0
130226,21030,210,30,-2,7,2,5,0,0,0,0,0,0,1,0,1,1,0,1,0,0,0,5,2,3,0,0,0,0,0,0,0,0,0
130253,21030,210,30,-2,13,6,7,0,0,0,2,1,1,0,0,0,1,0,1,0,0,0,6,4,2,1,0,1,1,0,1,2,1,1
130314,21030,210,30,-2,6,0,6,0,0,0,2,0,2,0,0,0,0,0,0,0,0,0,3,0,3,1,0,1,0,0,0,0,0,0
130396,21030,210,30,-2,1,0,1,0,0,0,0,0,0,0,0,0,1,0,1,0,0,0,0,0,0,0,0,0,0,0,0,0,0,0
130493,21030,210,30,-2,26,9,17,0,0,0,0,0,0,1,0,1,2,1,1,0,0,0,19,5,14,0,0,0,0,0,0,4,3,1
130590,21030,210,30,-2,7,1,6,0,0,0,2,0,2,2,0,2,1,0,1,0,0,0,2,1,1,0,0,0,0,0,0,0,0,0
130606,21030,210,30,-2,1,1,0,0,0,0,0,0,0,0,0,0,0,0,0,0,0,0,0,0,0,0,0,0,1,1,0,0,0,0
130624,21030,210,30,-2,4,2,2,0,0,0,0,0,0,1,0,1,0,0,0,0,0,0,3,2,1,0,0,0,0,0,0,0,0,0
130697,21030,210,30,-2,10,6,4,0,0,0,4,1,3,1,1,0,3,2,1,0,0,0,1,1,0,0,0,0,1,1,0,0,0,0
130794,21030,210,30,-2,61,29,32,0,0,0,12,8,4,5,1,4,2,1,1,0,0,0,24,11,13,0,0,0,6,2,4,12,6,6
130934,21030,210,30,-2,2,2,0,0,0,0,0,0,0,0,0,0,0,0,0,0,0,0,2,2,0,0,0,0,0,0,0,0,0,0
130943,21030,210,30,-2,13,9,4,0,0,0,3,2,1,1,1,0,0,0,0,0,0,0,6,4,2,0,0,0,0,0,0,3,2,1
131159,21030,210,30,-2,14,5,9,0,0,0,5,2,3,2,0,2,0,0,0,0,0,0,4,3,1,0,0,0,0,0,0,3,0,3
131283,21030,210,30,-2,1,1,0,0,0,0,0,0,0,0,0,0,0,0,0,0,0,0,1,1,0,0,0,0,0,0,0,0,0,0
131399,21030,210,30,-2,6,3,3,0,0,0,2,1,1,1,0,1,0,0,0,0,0,0,2,1,1,0,0,0,1,1,0,0,0,0
131450,21030,210,30,-2,7,4,3,0,0,0,3,1,2,0,0,0,2,2,0,0,0,0,2,1,1,0,0,0,0,0,0,0,0,0
131469,21030,210,30,-2,10,8,2,0,0,0,2,2,0,2,1,1,0,0,0,0,0,0,5,5,0,0,0,0,1,0,1,0,0,0
131496,21030,210,30,-2,8,6,2,0,0,0,0,0,0,0,0,0,0,0,0,0,0,0,6,5,1,0,0,0,0,0,0,2,1,1
131520,21030,210,30,-2,18,6,12,0,0,0,2,1,1,9,1,8,4,1,3,0,0,0,1,1,0,1,1,0,1,1,0,0,0,0
131876,21030,210,30,-2,1,0,1,0,0,0,0,0,0,0,0,0,1,0,1,0,0,0,0,0,0,0,0,0,0,0,0,0,0,0
132602,21030,210,30,-2,6,5,1,0,0,0,1,1,0,4,3,1,0,0,0,0,0,0,1,1,0,0,0,0,0,0,0,0,0,0
132693,21030,210,30,-2,11,1,10,0,0,0,0,0,0,1,0,1,2,0,2,0,0,0,8,1,7,0,0,0,0,0,0,0,0,0
132709,21030,210,30,-2,2,1,1,0,0,0,1,1,0,1,0,1,0,0,0,0,0,0,0,0,0,0,0,0,0,0,0,0,0,0
132851,21030,210,30,-2,9,3,6,0,0,0,1,1,0,0,0,0,0,0,0,0,0,0,8,2,6,0,0,0,0,0,0,0,0,0
132903,21030,210,30,-2,2,1,1,0,0,0,1,1,0,0,0,0,0,0,0,0,0,0,0,0,0,0,0,0,0,0,0,1,0,1
133021,21030,210,30,-2,1,0,1,0,0,0,0,0,0,0,0,0,0,0,0,0,0,0,1,0,1,0,0,0,0,0,0,0,0,0
133386,21030,210,30,-2,5,1,4,0,0,0,0,0,0,0,0,0,1,1,0,0,0,0,4,0,4,0,0,0,0,0,0,0,0,0
133492,21030,210,30,-2,4,0,4,0,0,0,0,0,0,0,0,0,0,0,0,0,0,0,3,0,3,1,0,1,0,0,0,0,0,0
133508,21030,210,30,-2,6,1,5,0,0,0,0,0,0,0,0,0,0,0,0,0,0,0,5,1,4,0,0,0,1,0,1,0,0,0
133553,21030,210,30,-2,13,8,5,0,0,0,1,1,0,0,0,0,1,0,1,0,0,0,4,2,2,0,0,0,2,1,1,5,4,1
133650,21030,210,30,-2,30,14,16,0,0,0,2,1,1,22,10,12,1,1,0,0,0,0,5,2,3,0,0,0,0,0,0,0,0,0
133669,21030,210,30,-2,7,4,3,0,0,0,3,2,1,0,0,0,1,0,1,0,0,0,2,2,0,0,0,0,0,0,0,1,0,1
133702,21030,210,30,-2,11,4,7,0,0,0,1,1,0,3,1,2,0,0,0,0,0,0,7,2,5,0,0,0,0,0,0,0,0,0
133809,21030,210,30,-2,5,1,4,0,0,0,0,0,0,0,0,0,0,0,0,0,0,0,5,1,4,0,0,0,0,0,0,0,0,0
133881,21030,210,30,-2,4,2,2,0,0,0,3,2,1,0,0,0,0,0,0,0,0,0,1,0,1,0,0,0,0,0,0,0,0,0
133951,21030,210,30,-2,32,18,14,1,1,0,5,4,1,5,3,2,0,0,0,0,0,0,14,7,7,0,0,0,0,0,0,7,3,4
133960,21030,210,30,-2,4,1,3,0,0,0,0,0,0,0,0,0,0,0,0,0,0,0,3,1,2,0,0,0,1,0,1,0,0,0
133979,21030,210,30,-2,5,1,4,0,0,0,0,0,0,4,1,3,0,0,0,0,0,0,1,0,1,0,0,0,0,0,0,0,0,0
134079,21030,210,30,-2,4,3,1,0,0,0,0,0,0,0,0,0,1,1,0,0,0,0,3,2,1,0,0,0,0,0,0,0,0,0
134097,21030,210,30,-2,19,11,8,0,0,0,0,0,0,1,1,0,1,1,0,0,0,0,10,5,5,2,1,1,0,0,0,5,3,2
134130,21030,210,30,-2,60,33,27,0,0,0,8,6,2,7,3,4,7,1,6,0,0,0,15,9,6,0,0,0,7,3,4,16,11,5
134495,21030,210,30,-2,4,1,3,0,0,0,0,0,0,0,0,0,0,0,0,0,0,0,4,1,3,0,0,0,0,0,0,0,0,0
134945,21030,210,30,-2,6,1,5,0,0,0,1,1,0,2,0,2,0,0,0,0,0,0,3,0,3,0,0,0,0,0,0,0,0,0
135160,21030,210,30,-2,9,2,7,0,0,0,0,0,0,1,0,1,0,0,0,0,0,0,8,2,6,0,0,0,0,0,0,0,0,0
135391,21030,210,30,-2,4,0,4,0,0,0,0,0,0,0,0,0,0,0,0,0,0,0,4,0,4,0,0,0,0,0,0,0,0,0
135717,21030,210,30,-2,18,3,15,0,0,0,1,0,1,4,1,3,11,1,10,0,0,0,1,1,0,0,0,0,0,0,0,1,0,1
135726,21030,210,30,-2,19,15,4,0,0,0,1,1,0,4,2,2,2,2,0,0,0,0,7,7,0,1,0,1,0,0,0,4,3,1
136172,21030,210,30,-2,16,7,9,0,0,0,1,1,0,3,1,2,1,0,1,0,0,0,5,2,3,1,0,1,0,0,0,5,3,2
136233,21030,210,30,-2,3,1,2,0,0,0,0,0,0,0,0,0,0,0,0,0,0,0,3,1,2,0,0,0,0,0,0,0,0,0
136358,21030,210,30,-2,3,1,2,1,0,1,0,0,0,1,0,1,0,0,0,0,0,0,1,1,0,0,0,0,0,0,0,0,0,0
136400,21030,210,30,-2,2,0,2,0,0,0,0,0,0,0,0,0,0,0,0,0,0,0,2,0,2,0,0,0,0,0,0,0,0,0
136473,21030,210,30,-2,7,5,2,0,0,0,0,0,0,0,0,0,0,0,0,0,0,0,7,5,2,0,0,0,0,0,0,0,0,0
136516,21030,210,30,-2,8,1,7,0,0,0,0,0,0,1,0,1,2,1,1,0,0,0,4,0,4,1,0,1,0,0,0,0,0,0
136950,21030,210,30,-2,9,3,6,0,0,0,0,0,0,1,1,0,0,0,0,0,0,0,4,0,4,0,0,0,0,0,0,4,2,2
137032,21030,210,30,-2,1,0,1,0,0,0,0,0,0,0,0,0,0,0,0,0,0,0,1,0,1,0,0,0,0,0,0,0,0,0
137078,21030,210,30,-2,6,0,6,0,0,0,0,0,0,2,0,2,0,0,0,0,0,0,4,0,4,0,0,0,0,0,0,0,0,0
137096,21030,210,30,-2,19,7,12,0,0,0,1,0,1,2,1,1,2,1,1,0,0,0,13,5,8,0,0,0,1,0,1,0,0,0
137209,21030,210,30,-2,6,3,3,0,0,0,2,2,0,0,0,0,0,0,0,0,0,0,4,1,3,0,0,0,0,0,0,0,0,0
137315,21030,210,30,-2,6,0,6,0,0,0,0,0,0,1,0,1,0,0,0,0,0,0,4,0,4,0,0,0,1,0,1,0,0,0
137351,21030,210,30,-2,10,3,7,0,0,0,3,1,2,1,0,1,0,0,0,0,0,0,2,0,2,0,0,0,1,0,1,3,2,1
137476,21030,210,30,-2,1,1,0,0,0,0,0,0,0,0,0,0,0,0,0,0,0,0,1,1,0,0,0,0,0,0,0,0,0,0
137546,21030,210,30,-2,5,2,3,0,0,0,1,1,0,0,0,0,0,0,0,0,0,0,1,0,1,0,0,0,2,1,1,1,0,1
137759,21030,210,30,-2,2,1,1,0,0,0,0,0,0,0,0,0,0,0,0,0,0,0,2,1,1,0,0,0,0,0,0,0,0,0
137847,21030,210,30,-2,17,7,10,0,0,0,1,0,1,1,0,1,1,1,0,0,0,0,13,5,8,0,0,0,1,1,0,0,0,0
138354,21030,210,30,-2,3,1,2,0,0,0,1,0,1,0,0,0,0,0,0,0,0,0,2,1,1,0,0,0,0,0,0,0,0,0
138558,21030,210,30,-2,7,3,4,0,0,0,0,0,0,1,0,1,0,0,0,0,0,0,6,3,3,0,0,0,0,0,0,0,0,0
138600,21030,210,30,-2,1,0,1,0,0,0,1,0,1,0,0,0,0,0,0,0,0,0,0,0,0,0,0,0,0,0,0,0,0,0
138716,21030,210,30,-2,10,4,6,0,0,0,1,1,0,3,0,3,0,0,0,0,0,0,6,3,3,0,0,0,0,0,0,0,0,0
138947,21030,210,30,-2,2,0,2,0,0,0,0,0,0,2,0,2,0,0,0,0,0,0,0,0,0,0,0,0,0,0,0,0,0,0
139144,21030,210,30,-2,5,2,3,0,0,0,0,0,0,0,0,0,0,0,0,0,0,0,3,1,2,0,0,0,2,1,1,0,0,0
139250,21030,210,30,-2,3,2,1,0,0,0,0,0,0,1,1,0,1,1,0,0,0,0,1,0,1,0,0,0,0,0,0,0,0,0
139311,21030,210,30,-2,10,2,8,0,0,0,1,0,1,4,0,4,0,0,0,0,0,0,5,2,3,0,0,0,0,0,0,0,0,0
139366,21030,210,30,-2,16,9,7,0,0,0,2,1,1,4,2,2,0,0,0,0,0,0,9,5,4,0,0,0,1,1,0,0,0,0
139393,21030,210,30,-2,1,0,1,0,0,0,0,0,0,0,0,0,1,0,1,0,0,0,0,0,0,0,0,0,0,0,0,0,0,0
139658,21030,210,30,-2,32,12,20,1,0,1,6,3,3,4,2,2,3,1,2,0,0,0,12,4,8,0,0,0,0,0,0,6,2,4
139700,21030,210,30,-2,1,1,0,0,0,0,0,0,0,0,0,0,0,0,0,0,0,0,1,1,0,0,0,0,0,0,0,0,0,0
139719,21030,210,30,-2,7,2,5,0,0,0,0,0,0,5,1,4,1,1,0,0,0,0,1,0,1,0,0,0,0,0,0,0,0,0
139755,21030,210,30,-2,33,19,14,0,0,0,10,4,6,1,1,0,2,1,1,0,0,0,8,7,1,0,0,0,3,1,2,9,5,4
139764,21030,210,30,-2,5,1,4,0,0,0,0,0,0,0,0,0,0,0,0,0,0,0,5,1,4,0,0,0,0,0,0,0,0,0
139861,21030,210,30,-2,9,6,3,0,0,0,0,0,0,0,0,0,0,0,0,0,0,0,7,5,2,0,0,0,0,0,0,2,1,1
139931,21030,210,30,-2,32,11,21,0,0,0,5,2,3,4,0,4,4,2,2,0,0,0,17,6,11,1,1,0,1,0,1,0,0,0
139940,21030,210,30,-2,23,12,11,0,0,0,6,4,2,5,2,3,1,0,1,0,0,0,8,5,3,0,0,0,0,0,0,3,1,2
139959,21030,210,30,-2,41,23,18,0,0,0,9,5,4,4,3,1,4,1,3,0,0,0,11,9,2,1,0,1,2,1,1,10,4,6
140146,21030,210,30,-2,1,1,0,0,0,0,0,0,0,0,0,0,1,1,0,0,0,0,0,0,0,0,0,0,0,0,0,0,0,0
140447,21030,210,30,-2,30,17,13,0,0,0,3,2,1,4,0,4,0,0,0,0,0,0,21,14,7,0,0,0,0,0,0,2,1,1
140696,21030,210,30,-2,1,0,1,0,0,0,0,0,0,0,0,0,0,0,0,0,0,0,1,0,1,0,0,0,0,0,0,0,0,0
140872,21030,210,30,-2,1,1,0,0,0,0,1,1,0,0,0,0,0,0,0,0,0,0,0,0,0,0,0,0,0,0,0,0,0,0
140960,21030,210,30,-2,4,3,1,0,0,0,1,1,0,3,2,1,0,0,0,0,0,0,0,0,0,0,0,0,0,0,0,0,0,0
140988,21030,210,30,-2,8,4,4,0,0,0,0,0,0,0,0,0,0,0,0,0,0,0,8,4,4,0,0,0,0,0,0,0,0,0
141060,21030,210,30,-2,12,3,9,0,0,0,1,0,1,5,0,5,2,1,1,0,0,0,4,2,2,0,0,0,0,0,0,0,0,0
141264,21030,210,30,-2,16,6,10,0,0,0,7,4,3,0,0,0,1,0,1,0,0,0,8,2,6,0,0,0,0,0,0,0,0,0
141325,21030,210,30,-2,1,0,1,0,0,0,0,0,0,1,0,1,0,0,0,0,0,0,0,0,0,0,0,0,0,0,0,0,0,0
141334,21030,210,30,-2,3,1,2,0,0,0,0,0,0,1,1,0,0,0,0,0,0,0,1,0,1,1,0,1,0,0,0,0,0,0
141486,21030,210,30,-2,1,1,0,0,0,0,0,0,0,0,0,0,0,0,0,0,0,0,1,1,0,0,0,0,0,0,0,0,0,0
141565,21030,210,30,-2,1,0,1,0,0,0,0,0,0,1,0,1,0,0,0,0,0,0,0,0,0,0,0,0,0,0,0,0,0,0
141574,21030,210,30,-2,2,2,0,0,0,0,0,0,0,0,0,0,0,0,0,0,0,0,2,2,0,0,0,0,0,0,0,0,0,0
142276,21030,210,30,-2,13,6,7,0,0,0,1,0,1,0,0,0,0,0,0,0,0,0,5,3,2,0,0,0,7,3,4,0,0,0
142285,21030,210,30,-2,7,2,5,0,0,0,0,0,0,1,0,1,0,0,0,0,0,0,2,1,1,0,0,0,3,0,3,1,1,0
142294,21030,210,30,-2,7,4,3,0,0,0,0,0,0,0,0,0,3,2,1,0,0,0,4,2,2,0,0,0,0,0,0,0,0,0
142328,21030,210,30,-2,2,0,2,0,0,0,0,0,0,0,0,0,0,0,0,0,0,0,1,0,1,1,0,1,0,0,0,0,0,0
142443,21030,210,30,-2,1,0,1,0,0,0,0,0,0,0,0,0,0,0,0,0,0,0,1,0,1,0,0,0,0,0,0,0,0,0
142461,21030,210,30,-2,11,3,8,0,0,0,1,0,1,0,0,0,0,0,0,0,0,0,7,2,5,0,0,0,3,1,2,0,0,0
143048,21030,210,30,-2,3,0,3,0,0,0,0,0,0,1,0,1,0,0,0,0,0,0,0,0,0,1,0,1,0,0,0,1,0,1
143084,21030,210,30,-2,5,2,3,0,0,0,2,1,1,0,0,0,0,0,0,0,0,0,3,1,2,0,0,0,0,0,0,0,0,0
143118,21030,210,30,-2,2,0,2,0,0,0,0,0,0,1,0,1,0,0,0,0,0,0,1,0,1,0,0,0,0,0,0,0,0,0
143215,21030,210,30,-2,10,4,6,0,0,0,0,0,0,1,1,0,0,0,0,0,0,0,9,3,6,0,0,0,0,0,0,0,0,0
143279,21030,210,30,-2,4,2,2,0,0,0,0,0,0,0,0,0,0,0,0,0,0,0,2,1,1,0,0,0,2,1,1,0,0,0
143288,21030,210,30,-2,3,2,1,0,0,0,0,0,0,0,0,0,0,0,0,0,0,0,3,2,1,0,0,0,0,0,0,0,0,0
143358,21030,210,30,-2,7,5,2,0,0,0,3,3,0,0,0,0,1,1,0,0,0,0,3,1,2,0,0,0,0,0,0,0,0,0
143659,21030,210,30,-2,1,0,1,0,0,0,0,0,0,0,0,0,0,0,0,0,0,0,1,0,1,0,0,0,0,0,0,0,0,0
143853,21030,210,30,-2,5,2,3,0,0,0,1,0,1,0,0,0,0,0,0,0,0,0,2,1,1,0,0,0,2,1,1,0,0,0
144005,21030,210,30,-2,6,6,0,0,0,0,0,0,0,2,2,0,0,0,0,0,0,0,2,2,0,0,0,0,2,2,0,0,0,0
144050,21030,210,30,-2,27,13,14,0,0,0,4,3,1,1,0,1,0,0,0,0,0,0,11,5,6,1,0,1,2,1,1,8,4,4
144157,21030,210,30,-2,3,2,1,0,0,0,1,0,1,1,1,0,0,0,0,0,0,0,1,1,0,0,0,0,0,0,0,0,0,0
144166,21030,210,30,-2,9,2,7,0,0,0,0,0,0,7,1,6,2,1,1,0,0,0,0,0,0,0,0,0,0,0,0,0,0,0
144184,21030,210,30,-2,2,2,0,0,0,0,0,0,0,0,0,0,0,0,0,0,0,0,0,0,0,0,0,0,2,2,0,0,0,0
144193,21030,210,30,-2,2,1,1,0,0,0,1,0,1,0,0,0,0,0,0,0,0,0,0,0,0,1,1,0,0,0,0,0,0,0
144209,21030,210,30,-2,2,1,1,0,0,0,0,0,0,1,1,0,0,0,0,0,0,0,1,0,1,0,0,0,0,0,0,0,0,0
144218,21030,210,30,-2,1,1,0,0,0,0,0,0,0,0,0,0,0,0,0,0,0,0,1,1,0,0,0,0,0,0,0,0,0,0
144281,21030,210,30,-2,1,1,0,0,0,0,1,1,0,0,0,0,0,0,0,0,0,0,0,0,0,0,0,0,0,0,0,0,0,0
144351,21030,210,30,-2,1,1,0,0,0,0,0,0,0,0,0,0,0,0,0,0,0,0,1,1,0,0,0,0,0,0,0,0,0,0
144564,21030,210,30,-2,2,0,2,0,0,0,0,0,0,0,0,0,0,0,0,0,0,0,2,0,2,0,0,0,0,0,0,0,0,0
144740,21030,210,30,-2,3,0,3,0,0,0,1,0,1,0,0,0,0,0,0,0,0,0,2,0,2,0,0,0,0,0,0,0,0,0
144892,21030,210,30,-2,8,3,5,0,0,0,1,1,0,0,0,0,0,0,0,0,0,0,5,1,4,0,0,0,1,1,0,1,0,1
144944,21030,210,30,-2,12,6,6,0,0,0,1,0,1,1,1,0,1,1,0,0,0,0,8,3,5,1,1,0,0,0,0,0,0,0
144962,21030,210,30,-2,3,2,1,0,0,0,0,0,0,0,0,0,0,0,0,0,0,0,3,2,1,0,0,0,0,0,0,0,0,0
144971,21030,210,30,-2,3,2,1,0,0,0,0,0,0,0,0,0,0,0,0,0,0,0,3,2,1,0,0,0,0,0,0,0,0,0
145336,21030,210,30,-2,8,2,6,1,0,1,1,0,1,2,0,2,0,0,0,0,0,0,4,2,2,0,0,0,0,0,0,0,0,0
145372,21030,210,30,-2,5,0,5,0,0,0,1,0,1,2,0,2,0,0,0,0,0,0,2,0,2,0,0,0,0,0,0,0,0,0
145558,21030,210,30,-2,2,1,1,0,0,0,1,1,0,0,0,0,0,0,0,0,0,0,1,0,1,0,0,0,0,0,0,0,0,0
145600,21030,210,30,-2,22,12,10,0,0,0,7,4,3,2,1,1,2,0,2,0,0,0,8,4,4,0,0,0,0,0,0,3,3,0
145628,21030,210,30,-2,1,1,0,0,0,0,0,0,0,1,1,0,0,0,0,0,0,0,0,0,0,0,0,0,0,0,0,0,0,0
145637,21030,210,30,-2,41,20,21,0,0,0,3,2,1,5,2,3,2,0,2,0,0,0,16,6,10,2,1,1,0,0,0,13,9,4
145646,21030,210,30,-2,5,2,3,0,0,0,0,0,0,1,0,1,0,0,0,0,0,0,3,1,2,0,0,0,0,0,0,1,1,0
145682,21030,210,30,-2,10,1,9,0,0,0,0,0,0,0,0,0,0,0,0,0,0,0,10,1,9,0,0,0,0,0,0,0,0,0
145691,21030,210,30,-2,3,0,3,0,0,0,1,0,1,0,0,0,0,0,0,0,0,0,2,0,2,0,0,0,0,0,0,0,0,0
145707,21030,210,30,-2,1,0,1,0,0,0,0,0,0,0,0,0,0,0,0,0,0,0,1,0,1,0,0,0,0,0,0,0,0,0
145725,21030,210,30,-2,5,3,2,0,0,0,1,1,0,0,0,0,0,0,0,0,0,0,1,0,1,0,0,0,1,0,1,2,2,0
145813,21030,210,30,-2,1,0,1,0,0,0,0,0,0,0,0,0,0,0,0,0,0,0,1,0,1,0,0,0,0,0,0,0,0,0
145831,21030,210,30,-2,6,0,6,0,0,0,0,0,0,0,0,0,0,0,0,0,0,0,6,0,6,0,0,0,0,0,0,0,0,0
146205,21030,210,30,-2,5,3,2,0,0,0,0,0,0,0,0,0,0,0,0,0,0,0,5,3,2,0,0,0,0,0,0,0,0,0
146278,21030,210,30,-2,2,1,1,0,0,0,0,0,0,0,0,0,0,0,0,0,0,0,2,1,1,0,0,0,0,0,0,0,0,0
146296,21030,210,30,-2,7,2,5,0,0,0,0,0,0,1,0,1,0,0,0,0,0,0,2,0,2,0,0,0,4,2,2,0,0,0
146348,21030,210,30,-2,3,2,1,0,0,0,0,0,0,0,0,0,0,0,0,0,0,0,2,1,1,0,0,0,1,1,0,0,0,0
146366,21030,210,30,-2,2,0,2,0,0,0,0,0,0,0,0,0,0,0,0,0,0,0,2,0,2,0,0,0,0,0,0,0,0,0
146418,21030,210,30,-2,3,0,3,0,0,0,0,0,0,0,0,0,0,0,0,0,0,0,3,0,3,0,0,0,0,0,0,0,0,0
146427,21030,210,30,-2,1,0,1,0,0,0,0,0,0,0,0,0,0,0,0,0,0,0,0,0,0,0,0,0,1,0,1,0,0,0
146472,21030,210,30,-2,16,11,5,0,0,0,2,1,1,2,2,0,3,3,0,0,0,0,8,4,4,1,1,0,0,0,0,0,0,0
146481,21030,210,30,-2,2,1,1,0,0,0,0,0,0,1,1,0,0,0,0,0,0,0,0,0,0,0,0,0,0,0,0,1,0,1
146506,21030,210,30,-2,3,3,0,0,0,0,0,0,0,0,0,0,0,0,0,0,0,0,3,3,0,0,0,0,0,0,0,0,0,0
146603,21030,210,30,-2,1,0,1,0,0,0,0,0,0,0,0,0,0,0,0,0,0,0,1,0,1,0,0,0,0,0,0,0,0,0
146612,21030,210,30,-2,6,1,5,0,0,0,0,0,0,0,0,0,0,0,0,0,0,0,4,1,3,0,0,0,2,0,2,0,0,0
146676,21030,210,30,-2,3,2,1,0,0,0,0,0,0,0,0,0,0,0,0,0,0,0,3,2,1,0,0,0,0,0,0,0,0,0
146685,21030,210,30,-2,10,4,6,0,0,0,1,1,0,0,0,0,0,0,0,0,0,0,9,3,6,0,0,0,0,0,0,0,0,0
146719,21030,210,30,-2,31,14,17,0,0,0,3,1,2,4,2,2,7,4,3,0,0,0,5,3,2,1,0,1,1,0,1,10,4,6
146728,21030,210,30,-2,1,1,0,0,0,0,0,0,0,0,0,0,1,1,0,0,0,0,0,0,0,0,0,0,0,0,0,0,0,0
147004,21030,210,30,-2,4,1,3,0,0,0,0,0,0,0,0,0,0,0,0,0,0,0,4,1,3,0,0,0,0,0,0,0,0,0
147013,21030,210,30,-2,5,1,4,1,0,1,0,0,0,0,0,0,0,0,0,0,0,0,4,1,3,0,0,0,0,0,0,0,0,0
147244,21030,210,30,-2,11,3,8,0,0,0,1,1,0,1,0,1,0,0,0,0,0,0,8,2,6,0,0,0,0,0,0,1,0,1
147341,21030,210,30,-2,1,1,0,0,0,0,0,0,0,0,0,0,0,0,0,0,0,0,0,0,0,0,0,0,0,0,0,1,1,0
147378,21030,210,30,-2,4,1,3,0,0,0,1,0,1,0,0,0,1,1,0,0,0,0,2,0,2,0,0,0,0,0,0,0,0,0
147411,21030,210,30,-2,1,0,1,0,0,0,0,0,0,0,0,0,1,0,1,0,0,0,0,0,0,0,0,0,0,0,0,0,0,0
147660,21030,210,30,-2,1,1,0,0,0,0,0,0,0,0,0,0,0,0,0,0,0,0,0,0,0,0,0,0,0,0,0,1,1,0
147679,21030,210,30,-2,1,1,0,0,0,0,0,0,0,0,0,0,1,1,0,0,0,0,0,0,0,0,0,0,0,0,0,0,0,0
147703,21030,210,30,-2,7,4,3,0,0,0,0,0,0,1,1,0,0,0,0,0,0,0,5,3,2,0,0,0,0,0,0,1,0,1
147767,21030,210,30,-2,22,11,11,0,0,0,3,0,3,3,1,2,2,2,0,0,0,0,9,5,4,0,0,0,0,0,0,5,3,2
147776,21030,210,30,-2,8,4,4,0,0,0,3,1,2,0,0,0,0,0,0,0,0,0,2,1,1,0,0,0,3,2,1,0,0,0
147800,21030,210,30,-2,5,3,2,0,0,0,0,0,0,0,0,0,1,1,0,0,0,0,1,1,0,0,0,0,3,1,2,0,0,0
148007,21030,210,30,-2,2,0,2,0,0,0,0,0,0,2,0,2,0,0,0,0,0,0,0,0,0,0,0,0,0,0,0,0,0,0
148131,21030,210,30,-2,2,1,1,0,0,0,0,0,0,0,0,0,0,0,0,0,0,0,2,1,1,0,0,0,0,0,0,0,0,0
148292,21030,210,30,-2,5,3,2,0,0,0,0,0,0,0,0,0,0,0,0,0,0,0,5,3,2,0,0,0,0,0,0,0,0,0
148380,21030,210,30,-2,1,0,1,0,0,0,0,0,0,0,0,0,0,0,0,0,0,0,1,0,1,0,0,0,0,0,0,0,0,0
148405,21030,210,30,-2,3,0,3,0,0,0,0,0,0,0,0,0,0,0,0,0,0,0,3,0,3,0,0,0,0,0,0,0,0,0
148487,21030,210,30,-2,1,0,1,0,0,0,0,0,0,0,0,0,0,0,0,0,0,0,0,0,0,0,0,0,0,0,0,1,0,1
148496,21030,210,30,-2,3,1,2,0,0,0,0,0,0,1,1,0,0,0,0,0,0,0,1,0,1,0,0,0,1,0,1,0,0,0
148511,21030,210,30,-2,48,21,27,0,0,0,8,1,7,4,2,2,3,2,1,0,0,0,32,16,16,1,0,1,0,0,0,0,0,0
148584,21030,210,30,-2,5,0,5,0,0,0,1,0,1,3,0,3,0,0,0,0,0,0,1,0,1,0,0,0,0,0,0,0,0,0
148654,21030,210,30,-2,2,1,1,0,0,0,0,0,0,0,0,0,0,0,0,0,0,0,2,1,1,0,0,0,0,0,0,0,0,0
148672,21030,210,30,-2,3,2,1,0,0,0,0,0,0,0,0,0,0,0,0,0,0,0,3,2,1,0,0,0,0,0,0,0,0,0
148821,21030,210,30,-2,2,0,2,0,0,0,0,0,0,0,0,0,0,0,0,0,0,0,2,0,2,0,0,0,0,0,0,0,0,0
149222,21030,210,30,-2,70,44,26,0,0,0,5,3,2,5,2,3,1,1,0,0,0,0,50,31,19,0,0,0,0,0,0,9,7,2
149231,21030,210,30,-2,10,6,4,0,0,0,0,0,0,2,2,0,2,1,1,0,0,0,4,2,2,0,0,0,0,0,0,2,1,1
149505,21030,210,30,-2,3,2,1,0,0,0,0,0,0,0,0,0,1,1,0,0,0,0,2,1,1,0,0,0,0,0,0,0,0,0
149532,21030,210,30,-2,2,0,2,0,0,0,0,0,0,0,0,0,0,0,0,0,0,0,1,0,1,0,0,0,1,0,1,0,0,0
149727,21030,210,30,-2,2,2,0,0,0,0,0,0,0,0,0,0,0,0,0,0,0,0,2,2,0,0,0,0,0,0,0,0,0,0
149772,21030,210,30,-2,6,1,5,0,0,0,0,0,0,0,0,0,0,0,0,0,0,0,5,1,4,0,0,0,1,0,1,0,0,0
149781,21030,210,30,-2,3,2,1,0,0,0,3,2,1,0,0,0,0,0,0,0,0,0,0,0,0,0,0,0,0,0,0,0,0,0
149842,21030,210,30,-2,8,1,7,0,0,0,0,0,0,2,0,2,0,0,0,0,0,0,5,1,4,0,0,0,1,0,1,0,0,0
150066,21030,210,30,-2,3,1,2,0,0,0,0,0,0,1,0,1,0,0,0,0,0,0,2,1,1,0,0,0,0,0,0,0,0,0
150145,21030,210,30,-2,11,2,9,0,0,0,0,0,0,0,0,0,0,0,0,0,0,0,11,2,9,0,0,0,0,0,0,0,0,0
150163,21030,210,30,-2,11,4,7,0,0,0,4,1,3,0,0,0,1,1,0,0,0,0,6,2,4,0,0,0,0,0,0,0,0,0
150288,21030,210,30,-2,1,1,0,0,0,0,0,0,0,0,0,0,0,0,0,0,0,0,1,1,0,0,0,0,0,0,0,0,0,0
150455,21030,210,30,-2,1,0,1,0,0,0,0,0,0,1,0,1,0,0,0,0,0,0,0,0,0,0,0,0,0,0,0,0,0,0
150534,21030,210,30,-2,4,2,2,0,0,0,0,0,0,0,0,0,0,0,0,0,0,0,1,0,1,0,0,0,3,2,1,0,0,0
150604,21030,210,30,-2,2,0,2,0,0,0,0,0,0,0,0,0,0,0,0,0,0,0,2,0,2,0,0,0,0,0,0,0,0,0
150756,21030,210,30,-2,4,4,0,0,0,0,0,0,0,0,0,0,1,1,0,0,0,0,3,3,0,0,0,0,0,0,0,0,0,0
150774,21030,210,30,-2,1,1,0,0,0,0,0,0,0,0,0,0,0,0,0,0,0,0,1,1,0,0,0,0,0,0,0,0,0,0
150941,21030,210,30,-2,10,2,8,0,0,0,1,1,0,0,0,0,0,0,0,0,0,0,9,1,8,0,0,0,0,0,0,0,0,0
151111,21030,210,30,-2,23,13,10,0,0,0,4,3,1,1,0,1,1,0,1,0,0,0,14,8,6,0,0,0,0,0,0,3,2,1
151263,21030,210,30,-2,10,3,7,0,0,0,1,0,1,0,0,0,0,0,0,0,0,0,8,3,5,1,0,1,0,0,0,0,0,0
151290,21030,210,30,-2,6,3,3,0,0,0,2,2,0,0,0,0,0,0,0,0,0,0,2,0,2,0,0,0,0,0,0,2,1,1
151306,21030,210,30,-2,9,5,4,0,0,0,1,1,0,0,0,0,0,0,0,0,0,0,5,1,4,0,0,0,0,0,0,3,3,0
151324,21030,210,30,-2,6,3,3,0,0,0,3,0,3,1,1,0,1,1,0,0,0,0,1,1,0,0,0,0,0,0,0,0,0,0
151333,21030,210,30,-2,3,1,2,0,0,0,0,0,0,0,0,0,0,0,0,0,0,0,0,0,0,0,0,0,0,0,0,3,1,2
151342,21030,210,30,-2,1,1,0,0,0,0,0,0,0,0,0,0,0,0,0,0,0,0,1,1,0,0,0,0,0,0,0,0,0,0
151351,21030,210,30,-2,27,9,18,1,1,0,3,0,3,2,0,2,5,1,4,0,0,0,9,2,7,0,0,0,0,0,0,7,5,2
151379,21030,210,30,-2,5,0,5,0,0,0,0,0,0,0,0,0,0,0,0,0,0,0,4,0,4,0,0,0,0,0,0,1,0,1
151388,21030,210,30,-2,1,1,0,0,0,0,0,0,0,0,0,0,0,0,0,0,0,0,1,1,0,0,0,0,0,0,0,0,0,0
151777,21030,210,30,-2,1,0,1,0,0,0,0,0,0,0,0,0,1,0,1,0,0,0,0,0,0,0,0,0,0,0,0,0,0,0
152080,21030,210,30,-2,39,22,17,0,0,0,3,2,1,2,1,1,3,2,1,0,0,0,16,11,5,0,0,0,2,0,2,13,6,7
152318,21030,210,30,-2,4,1,3,0,0,0,1,0,1,0,0,0,0,0,0,0,0,0,2,0,2,0,0,0,0,0,0,1,1,0
152381,21030,210,30,-2,5,1,4,0,0,0,0,0,0,0,0,0,1,0,1,0,0,0,4,1,3,0,0,0,0,0,0,0,0,0
152390,21030,210,30,-2,3,1,2,0,0,0,0,0,0,0,0,0,0,0,0,0,0,0,0,0,0,0,0,0,1,0,1,2,1,1
152530,21030,210,30,-2,5,2,3,0,0,0,0,0,0,0,0,0,0,0,0,0,0,0,4,2,2,0,0,0,0,0,0,1,0,1
152600,21030,210,30,-2,3,0,3,0,0,0,0,0,0,0,0,0,1,0,1,0,0,0,2,0,2,0,0,0,0,0,0,0,0,0
152637,21030,210,30,-2,1,1,0,0,0,0,0,0,0,0,0,0,0,0,0,0,0,0,1,1,0,0,0,0,0,0,0,0,0,0
152992,21030,210,30,-2,4,2,2,0,0,0,0,0,0,0,0,0,0,0,0,0,0,0,4,2,2,0,0,0,0,0,0,0,0,0
153001,21030,210,30,-2,7,4,3,0,0,0,0,0,0,1,0,1,1,1,0,0,0,0,5,3,2,0,0,0,0,0,0,0,0,0
153108,21030,210,30,-2,1,1,0,0,0,0,0,0,0,0,0,0,0,0,0,0,0,0,0,0,0,0,0,0,0,0,0,1,1,0
153126,21030,210,30,-2,1,0,1,0,0,0,0,0,0,0,0,0,0,0,0,0,0,0,1,0,1,0,0,0,0,0,0,0,0,0
153269,21030,210,30,-2,16,8,8,0,0,0,1,0,1,0,0,0,2,1,1,0,0,0,10,5,5,0,0,0,0,0,0,3,2,1
153366,21030,210,30,-2,9,4,5,0,0,0,2,1,1,1,0,1,1,0,1,0,0,0,5,3,2,0,0,0,0,0,0,0,0,0
153375,21030,210,30,-2,3,1,2,0,0,0,2,0,2,0,0,0,0,0,0,0,0,0,1,1,0,0,0,0,0,0,0,0,0,0
153603,21030,210,30,-2,22,10,12,0,0,0,4,1,3,0,0,0,3,3,0,0,0,0,8,1,7,0,0,0,0,0,0,7,5,2
153621,21030,210,30,-2,3,2,1,0,0,0,0,0,0,0,0,0,0,0,0,0,0,0,3,2,1,0,0,0,0,0,0,0,0,0
153658,21030,210,30,-2,40,20,20,0,0,0,5,5,0,2,0,2,3,2,1,0,0,0,17,7,10,0,0,0,4,0,4,9,6,3
153825,21030,210,30,-2,5,2,3,0,0,0,1,0,1,0,0,0,0,0,0,0,0,0,4,2,2,0,0,0,0,0,0,0,0,0
154004,21030,210,30,-2,7,0,7,0,0,0,0,0,0,2,0,2,0,0,0,0,0,0,5,0,5,0,0,0,0,0,0,0,0,0
154013,21030,210,30,-2,5,3,2,0,0,0,0,0,0,0,0,0,1,1,0,0,0,0,4,2,2,0,0,0,0,0,0,0,0,0
154095,21030,210,30,-2,13,3,10,0,0,0,1,0,1,0,0,0,0,0,0,0,0,0,7,2,5,0,0,0,0,0,0,5,1,4
154101,21030,210,30,-2,4,2,2,0,0,0,0,0,0,0,0,0,0,0,0,0,0,0,3,1,2,0,0,0,0,0,0,1,1,0
154235,21030,210,30,-2,2,2,0,0,0,0,0,0,0,0,0,0,0,0,0,0,0,0,2,2,0,0,0,0,0,0,0,0,0,0
154350,21030,210,30,-2,4,2,2,0,0,0,1,1,0,1,1,0,1,0,1,0,0,0,1,0,1,0,0,0,0,0,0,0,0,0
154493,21030,210,30,-2,2,0,2,0,0,0,1,0,1,0,0,0,0,0,0,0,0,0,0,0,0,0,0,0,1,0,1,0,0,0
154518,21030,210,30,-2,2,2,0,0,0,0,1,1,0,0,0,0,0,0,0,0,0,0,1,1,0,0,0,0,0,0,0,0,0,0
154527,21030,210,30,-2,6,4,2,0,0,0,0,0,0,0,0,0,0,0,0,0,0,0,6,4,2,0,0,0,0,0,0,0,0,0
154590,21030,210,30,-2,2,2,0,0,0,0,0,0,0,0,0,0,1,1,0,0,0,0,1,1,0,0,0,0,0,0,0,0,0,0
154642,21030,210,30,-2,2,1,1,0,0,0,0,0,0,0,0,0,1,1,0,0,0,0,1,0,1,0,0,0,0,0,0,0,0,0
154688,21030,210,30,-2,3,1,2,0,0,0,0,0,0,0,0,0,0,0,0,0,0,0,3,1,2,0,0,0,0,0,0,0,0,0
154697,21030,210,30,-2,5,3,2,0,0,0,0,0,0,0,0,0,0,0,0,0,0,0,5,3,2,0,0,0,0,0,0,0,0,0
154721,21030,210,30,-2,5,0,5,0,0,0,0,0,0,1,0,1,0,0,0,0,0,0,4,0,4,0,0,0,0,0,0,0,0,0
154749,21030,210,30,-2,1,0,1,0,0,0,0,0,0,0,0,0,0,0,0,0,0,0,1,0,1,0,0,0,0,0,0,0,0,0
154907,21030,210,30,-2,8,6,2,0,0,0,0,0,0,0,0,0,0,0,0,0,0,0,8,6,2,0,0,0,0,0,0,0,0,0
154925,21030,210,30,-2,4,3,1,0,0,0,0,0,0,0,0,0,0,0,0,0,0,0,4,3,1,0,0,0,0,0,0,0,0,0
154952,21030,210,30,-2,3,3,0,0,0,0,0,0,0,0,0,0,0,0,0,0,0,0,3,3,0,0,0,0,0,0,0,0,0,0
154998,21030,210,30,-2,7,2,5,0,0,0,0,0,0,0,0,0,0,0,0,0,0,0,7,2,5,0,0,0,0,0,0,0,0,0
155025,21030,210,30,-2,10,3,7,0,0,0,3,1,2,0,0,0,0,0,0,0,0,0,7,2,5,0,0,0,0,0,0,0,0,0
155061,21030,210,30,-2,5,3,2,0,0,0,0,0,0,0,0,0,1,1,0,0,0,0,2,2,0,2,0,2,0,0,0,0,0,0
155089,21030,210,30,-2,6,2,4,0,0,0,0,0,0,0,0,0,0,0,0,0,0,0,6,2,4,0,0,0,0,0,0,0,0,0
155098,21030,210,30,-2,10,5,5,0,0,0,0,0,0,0,0,0,1,1,0,0,0,0,9,4,5,0,0,0,0,0,0,0,0,0
155195,21030,210,30,-2,11,5,6,0,0,0,0,0,0,0,0,0,0,0,0,0,0,0,11,5,6,0,0,0,0,0,0,0,0,0
155201,21030,210,30,-2,6,3,3,0,0,0,1,1,0,0,0,0,1,0,1,0,0,0,4,2,2,0,0,0,0,0,0,0,0,0
155292,21030,210,30,-2,6,2,4,0,0,0,0,0,0,1,0,1,3,0,3,0,0,0,2,2,0,0,0,0,0,0,0,0,0,0
155317,21030,210,30,-2,32,18,14,0,0,0,4,4,0,3,1,2,1,0,1,0,0,0,18,8,10,0,0,0,0,0,0,6,5,1
155335,21030,210,30,-2,2,1,1,0,0,0,0,0,0,0,0,0,0,0,0,0,0,0,2,1,1,0,0,0,0,0,0,0,0,0
155399,21030,210,30,-2,8,3,5,0,0,0,1,1,0,1,0,1,2,1,1,0,0,0,2,1,1,0,0,0,0,0,0,2,0,2
155414,21030,210,30,-2,4,3,1,0,0,0,0,0,0,0,0,0,0,0,0,0,0,0,4,3,1,0,0,0,0,0,0,0,0,0
155450,21030,210,30,-2,2,0,2,0,0,0,0,0,0,0,0,0,0,0,0,0,0,0,2,0,2,0,0,0,0,0,0,0,0,0
155511,21030,210,30,-2,4,3,1,0,0,0,1,1,0,0,0,0,0,0,0,0,0,0,2,2,0,1,0,1,0,0,0,0,0,0
155566,21030,210,30,-2,7,3,4,0,0,0,0,0,0,0,0,0,0,0,0,0,0,0,7,3,4,0,0,0,0,0,0,0,0,0
155593,21030,210,30,-2,6,4,2,0,0,0,0,0,0,0,0,0,0,0,0,0,0,0,6,4,2,0,0,0,0,0,0,0,0,0
155618,21030,210,30,-2,2,2,0,0,0,0,0,0,0,0,0,0,0,0,0,0,0,0,2,2,0,0,0,0,0,0,0,0,0,0
155681,21030,210,30,-2,6,5,1,0,0,0,0,0,0,0,0,0,0,0,0,0,0,0,6,5,1,0,0,0,0,0,0,0,0,0
155715,21030,210,30,-2,7,5,2,0,0,0,0,0,0,0,0,0,1,0,1,0,0,0,6,5,1,0,0,0,0,0,0,0,0,0
155812,21030,210,30,-2,8,3,5,0,0,0,0,0,0,1,0,1,0,0,0,0,0,0,7,3,4,0,0,0,0,0,0,0,0,0
155830,21030,210,30,-2,3,0,3,0,0,0,0,0,0,0,0,0,0,0,0,0,0,0,3,0,3,0,0,0,0,0,0,0,0,0
155900,21030,210,30,-2,3,2,1,0,0,0,1,1,0,1,0,1,0,0,0,0,0,0,1,1,0,0,0,0,0,0,0,0,0,0
155937,21030,210,30,-2,3,2,1,0,0,0,0,0,0,0,0,0,0,0,0,0,0,0,3,2,1,0,0,0,0,0,0,0,0,0
156107,21030,210,30,-2,12,8,4,0,0,0,0,0,0,0,0,0,1,0,1,0,0,0,11,8,3,0,0,0,0,0,0,0,0,0
156125,21030,210,30,-2,14,7,7,0,0,0,0,0,0,1,1,0,0,0,0,0,0,0,8,4,4,0,0,0,0,0,0,5,2,3
156213,21030,210,30,-2,6,2,4,0,0,0,1,0,1,1,0,1,0,0,0,0,0,0,4,2,2,0,0,0,0,0,0,0,0,0
156222,21030,210,30,-2,1,1,0,0,0,0,1,1,0,0,0,0,0,0,0,0,0,0,0,0,0,0,0,0,0,0,0,0,0,0
156286,21030,210,30,-2,8,1,7,0,0,0,2,0,2,1,1,0,0,0,0,0,0,0,4,0,4,0,0,0,0,0,0,1,0,1
156295,21030,210,30,-2,8,3,5,0,0,0,1,1,0,1,0,1,1,0,1,0,0,0,3,1,2,0,0,0,0,0,0,2,1,1
156356,21030,210,30,-2,3,2,1,0,0,0,0,0,0,0,0,0,0,0,0,0,0,0,2,2,0,0,0,0,1,0,1,0,0,0
156365,21030,210,30,-2,8,5,3,0,0,0,0,0,0,1,1,0,0,0,0,0,0,0,6,3,3,0,0,0,1,1,0,0,0,0
156408,21030,210,30,-2,1,1,0,0,0,0,0,0,0,0,0,0,0,0,0,0,0,0,0,0,0,1,1,0,0,0,0,0,0,0
156541,21030,210,30,-2,13,5,8,0,0,0,0,0,0,1,0,1,0,0,0,0,0,0,11,5,6,0,0,0,1,0,1,0,0,0
156620,21030,210,30,-2,29,11,18,0,0,0,0,0,0,0,0,0,1,1,0,0,0,0,21,6,15,2,1,1,0,0,0,5,3,2
156745,21030,210,30,-2,2,0,2,0,0,0,0,0,0,0,0,0,0,0,0,0,0,0,1,0,1,0,0,0,0,0,0,1,0,1
157058,21030,210,30,-2,2,1,1,0,0,0,1,0,1,0,0,0,0,0,0,0,0,0,1,1,0,0,0,0,0,0,0,0,0,0
157076,21030,210,30,-2,4,2,2,0,0,0,0,0,0,0,0,0,0,0,0,0,0,0,4,2,2,0,0,0,0,0,0,0,0,0
157085,21030,210,30,-2,26,10,16,0,0,0,4,3,1,5,2,3,1,1,0,0,0,0,12,2,10,0,0,0,0,0,0,4,2,2
157289,21030,210,30,-2,14,5,9,0,0,0,1,1,0,0,0,0,0,0,0,0,0,0,12,3,9,0,0,0,0,0,0,1,1,0
157304,21030,210,30,-2,1,1,0,0,0,0,0,0,0,0,0,0,0,0,0,0,0,0,0,0,0,0,0,0,1,1,0,0,0,0
157386,21030,210,30,-2,13,7,6,0,0,0,2,2,0,0,0,0,1,0,1,0,0,0,10,5,5,0,0,0,0,0,0,0,0,0
157447,21030,210,30,-2,6,2,4,1,0,1,0,0,0,1,1,0,0,0,0,0,0,0,3,0,3,0,0,0,0,0,0,1,1,0
157757,21030,210,30,-2,5,3,2,0,0,0,1,1,0,1,1,0,0,0,0,0,0,0,3,1,2,0,0,0,0,0,0,0,0,0
157809,21030,210,30,-2,1,1,0,0,0,0,0,0,0,0,0,0,0,0,0,0,0,0,1,1,0,0,0,0,0,0,0,0,0,0
157818,21030,210,30,-2,1,0,1,0,0,0,0,0,0,0,0,0,0,0,0,0,0,0,1,0,1,0,0,0,0,0,0,0,0,0
157863,21030,210,30,-2,1,0,1,0,0,0,0,0,0,0,0,0,0,0,0,0,0,0,0,0,0,0,0,0,0,0,0,1,0,1
157951,21030,210,30,-2,25,9,16,0,0,0,4,0,4,1,1,0,1,1,0,0,0,0,17,6,11,0,0,0,2,1,1,0,0,0
159373,21030,210,30,-2,1,1,0,0,0,0,0,0,0,0,0,0,0,0,0,0,0,0,1,1,0,0,0,0,0,0,0,0,0,0
159382,21030,210,30,-2,7,4,3,0,0,0,0,0,0,0,0,0,0,0,0,0,0,0,7,4,3,0,0,0,0,0,0,0,0,0
159391,21030,210,30,-2,44,26,18,0,0,0,5,2,3,4,1,3,3,2,1,0,0,0,19,13,6,0,0,0,1,1,0,12,7,5
159407,21030,210,30,-2,3,2,1,0,0,0,0,0,0,0,0,0,0,0,0,0,0,0,2,1,1,0,0,0,0,0,0,1,1,0
159416,21030,210,30,-2,10,5,5,0,0,0,1,1,0,0,0,0,1,0,1,0,0,0,8,4,4,0,0,0,0,0,0,0,0,0
159568,21030,210,30,-2,6,4,2,0,0,0,0,0,0,0,0,0,0,0,0,0,0,0,6,4,2,0,0,0,0,0,0,0,0,0
159647,21030,210,30,-2,8,6,2,0,0,0,0,0,0,0,0,0,0,0,0,0,0,0,8,6,2,0,0,0,0,0,0,0,0,0
159656,21030,210,30,-2,5,1,4,0,0,0,3,1,2,2,0,2,0,0,0,0,0,0,0,0,0,0,0,0,0,0,0,0,0,0
159717,21030,210,30,-2,7,1,6,1,0,1,0,0,0,0,0,0,0,0,0,0,0,0,5,1,4,0,0,0,1,0,1,0,0,0
159939,21030,210,30,-2,1,1,0,0,0,0,0,0,0,0,0,0,0,0,0,0,0,0,0,0,0,0,0,0,0,0,0,1,1,0
159948,21030,210,30,-2,2,2,0,0,0,0,0,0,0,0,0,0,0,0,0,0,0,0,2,2,0,0,0,0,0,0,0,0,0,0
159966,21030,210,30,-2,4,0,4,0,0,0,0,0,0,1,0,1,0,0,0,0,0,0,2,0,2,0,0,0,0,0,0,1,0,1
159993,21030,210,30,-2,16,9,7,0,0,0,4,3,1,3,1,2,2,1,1,0,0,0,7,4,3,0,0,0,0,0,0,0,0,0
160038,21030,210,30,-2,22,7,15,0,0,0,0,0,0,0,0,0,1,1,0,0,0,0,10,1,9,0,0,0,9,3,6,2,2,0
160612,21030,210,30,-2,13,4,9,0,0,0,1,0,1,3,1,2,0,0,0,0,0,0,5,1,4,0,0,0,0,0,0,4,2,2
160621,21030,210,30,-2,8,2,6,0,0,0,1,1,0,6,1,5,0,0,0,0,0,0,1,0,1,0,0,0,0,0,0,0,0,0
160630,21030,210,30,-2,4,2,2,0,0,0,0,0,0,4,2,2,0,0,0,0,0,0,0,0,0,0,0,0,0,0,0,0,0,0
160649,21030,210,30,-2,4,2,2,0,0,0,0,0,0,4,2,2,0,0,0,0,0,0,0,0,0,0,0,0,0,0,0,0,0,0
160658,21030,210,30,-2,3,2,1,0,0,0,0,0,0,0,0,0,0,0,0,0,0,0,3,2,1,0,0,0,0,0,0,0,0,0
160755,21030,210,30,-2,27,16,11,1,1,0,7,4,3,3,2,1,4,0,4,0,0,0,10,8,2,1,0,1,0,0,0,1,1,0
160904,21030,210,30,-2,12,5,7,0,0,0,0,0,0,4,1,3,0,0,0,1,1,0,4,1,3,0,0,0,0,0,0,3,2,1
160977,21030,210,30,-2,9,4,5,0,0,0,3,0,3,1,1,0,0,0,0,0,0,0,3,1,2,2,2,0,0,0,0,0,0,0
161004,21030,210,30,-2,4,2,2,0,0,0,1,0,1,0,0,0,1,1,0,0,0,0,1,1,0,0,0,0,0,0,0,1,0,1
161086,21030,210,30,-2,9,4,5,0,0,0,0,0,0,0,0,0,0,0,0,0,0,0,4,1,3,1,0,1,0,0,0,4,3,1
161217,21030,210,30,-2,4,1,3,0,0,0,0,0,0,0,0,0,0,0,0,0,0,0,4,1,3,0,0,0,0,0,0,0,0,0
161226,21030,210,30,-2,2,1,1,0,0,0,0,0,0,0,0,0,0,0,0,0,0,0,2,1,1,0,0,0,0,0,0,0,0,0
161235,21030,210,30,-2,1,0,1,0,0,0,0,0,0,0,0,0,0,0,0,0,0,0,0,0,0,0,0,0,1,0,1,0,0,0
161253,21030,210,30,-2,18,10,8,0,0,0,0,0,0,1,0,1,0,0,0,0,0,0,13,6,7,1,1,0,1,1,0,2,2,0
161457,21030,210,30,-2,1,1,0,0,0,0,0,0,0,0,0,0,0,0,0,0,0,0,1,1,0,0,0,0,0,0,0,0,0,0
161554,21030,210,30,-2,8,2,6,0,0,0,0,0,0,0,0,0,0,0,0,0,0,0,7,2,5,0,0,0,0,0,0,1,0,1
161688,21030,210,30,-2,6,1,5,0,0,0,0,0,0,0,0,0,0,0,0,0,0,0,6,1,5,0,0,0,0,0,0,0,0,0
161873,21030,210,30,-2,2,1,1,0,0,0,0,0,0,0,0,0,0,0,0,0,0,0,1,1,0,0,0,0,1,0,1,0,0,0
162007,21030,210,30,-2,7,3,4,0,0,0,0,0,0,5,3,2,0,0,0,0,0,0,1,0,1,0,0,0,1,0,1,0,0,0
162283,21030,210,30,-2,6,4,2,0,0,0,2,1,1,4,3,1,0,0,0,0,0,0,0,0,0,0,0,0,0,0,0,0,0,0
162584,21030,210,30,-2,13,4,9,0,0,0,1,0,1,0,0,0,0,0,0,0,0,0,10,2,8,0,0,0,0,0,0,2,2,0
162654,21030,210,30,-2,6,3,3,0,0,0,1,1,0,1,1,0,0,0,0,0,0,0,4,1,3,0,0,0,0,0,0,0,0,0
162690,21030,210,30,-2,2,2,0,0,0,0,0,0,0,0,0,0,0,0,0,0,0,0,1,1,0,0,0,0,1,1,0,0,0,0
162760,21030,210,30,-2,11,5,6,0,0,0,2,1,1,1,0,1,0,0,0,0,0,0,7,4,3,0,0,0,1,0,1,0,0,0
162928,21030,210,30,-2,86,40,46,0,0,0,24,11,13,5,1,4,5,1,4,0,0,0,37,18,19,4,4,0,0,0,0,11,5,6
163046,21030,210,30,-2,3,1,2,0,0,0,0,0,0,1,0,1,1,1,0,0,0,0,1,0,1,0,0,0,0,0,0,0,0,0
163259,21030,210,30,-2,6,5,1,0,0,0,1,0,1,1,1,0,1,1,0,0,0,0,1,1,0,0,0,0,0,0,0,2,2,0
163268,21030,210,30,-2,5,3,2,0,0,0,0,0,0,0,0,0,0,0,0,0,0,0,1,0,1,0,0,0,1,0,1,3,3,0
163286,21030,210,30,-2,21,15,6,0,0,0,1,0,1,1,1,0,0,0,0,0,0,0,8,6,2,0,0,0,2,2,0,9,6,3
163338,21030,210,30,-2,8,2,6,0,0,0,1,0,1,2,1,1,1,1,0,0,0,0,2,0,2,1,0,1,1,0,1,0,0,0
163453,21030,210,30,-2,8,5,3,0,0,0,0,0,0,4,3,1,1,0,1,0,0,0,1,1,0,0,0,0,1,1,0,1,0,1
163462,21030,210,30,-2,5,1,4,0,0,0,1,0,1,1,1,0,0,0,0,0,0,0,2,0,2,1,0,1,0,0,0,0,0,0
163578,21030,210,30,-2,8,3,5,0,0,0,3,1,2,2,1,1,0,0,0,0,0,0,2,0,2,1,1,0,0,0,0,0,0,0
163657,21030,210,30,-2,7,3,4,0,0,0,1,0,1,3,1,2,0,0,0,0,0,0,2,2,0,1,0,1,0,0,0,0,0,0
163851,21030,210,30,-2,20,9,11,0,0,0,3,1,2,1,0,1,1,1,0,0,0,0,7,4,3,0,0,0,0,0,0,8,3,5
163912,21030,210,30,-2,7,3,4,0,0,0,0,0,0,0,0,0,2,1,1,0,0,0,3,1,2,0,0,0,0,0,0,2,1,1
163976,21030,210,30,-2,4,2,2,0,0,0,0,0,0,0,0,0,0,0,0,0,0,0,4,2,2,0,0,0,0,0,0,0,0,0
164076,21030,210,30,-2,18,6,12,0,0,0,6,1,5,1,1,0,1,0,1,0,0,0,9,4,5,0,0,0,0,0,0,1,0,1
164155,21030,210,30,-2,11,5,6,0,0,0,2,1,1,1,1,0,1,0,1,0,0,0,6,3,3,0,0,0,1,0,1,0,0,0
164216,21030,210,30,-2,7,2,5,0,0,0,3,2,1,1,0,1,1,0,1,0,0,0,2,0,2,0,0,0,0,0,0,0,0,0
164270,21030,210,30,-2,6,1,5,0,0,0,1,0,1,2,1,1,0,0,0,0,0,0,3,0,3,0,0,0,0,0,0,0,0,0
164447,21030,210,30,-2,1,0,1,0,0,0,0,0,0,0,0,0,0,0,0,0,0,0,1,0,1,0,0,0,0,0,0,0,0,0
164465,21030,210,30,-2,4,0,4,0,0,0,0,0,0,0,0,0,1,0,1,0,0,0,2,0,2,0,0,0,0,0,0,1,0,1
164492,21030,210,30,-2,2,0,2,0,0,0,0,0,0,0,0,0,0,0,0,0,0,0,2,0,2,0,0,0,0,0,0,0,0,0
164739,21030,210,30,-2,7,4,3,0,0,0,1,1,0,2,2,0,0,0,0,0,0,0,1,0,1,0,0,0,1,0,1,2,1,1
164775,21030,210,30,-2,1,0,1,0,0,0,0,0,0,0,0,0,1,0,1,0,0,0,0,0,0,0,0,0,0,0,0,0,0,0
164924,21030,210,30,-2,11,5,6,0,0,0,1,0,1,3,1,2,0,0,0,0,0,0,6,3,3,1,1,0,0,0,0,0,0,0
164988,21030,210,30,-2,23,13,10,0,0,0,0,0,0,0,0,0,1,1,0,0,0,0,9,2,7,1,1,0,2,1,1,10,8,2
165015,21030,210,30,-2,6,3,3,0,0,0,0,0,0,0,0,0,0,0,0,0,0,0,4,2,2,0,0,0,0,0,0,2,1,1
165033,21030,210,30,-2,7,2,5,0,0,0,0,0,0,0,0,0,0,0,0,0,0,0,7,2,5,0,0,0,0,0,0,0,0,0
165112,21030,210,30,-2,9,1,8,0,0,0,1,0,1,0,0,0,2,1,1,0,0,0,6,0,6,0,0,0,0,0,0,0,0,0
165194,21030,210,30,-2,3,0,3,0,0,0,0,0,0,0,0,0,1,0,1,0,0,0,2,0,2,0,0,0,0,0,0,0,0,0
165334,21030,210,30,-2,5,2,3,0,0,0,0,0,0,3,2,1,0,0,0,0,0,0,1,0,1,0,0,0,0,0,0,1,0,1
165662,21030,210,30,-2,6,3,3,0,0,0,0,0,0,3,1,2,0,0,0,0,0,0,1,1,0,0,0,0,2,1,1,0,0,0
165671,21030,210,30,-2,1,0,1,0,0,0,0,0,0,0,0,0,1,0,1,0,0,0,0,0,0,0,0,0,0,0,0,0,0,0
165820,21030,210,30,-2,2,0,2,0,0,0,0,0,0,0,0,0,0,0,0,0,0,0,2,0,2,0,0,0,0,0,0,0,0,0
165866,21030,210,30,-2,1,0,1,0,0,0,0,0,0,0,0,0,0,0,0,0,0,0,1,0,1,0,0,0,0,0,0,0,0,0
165945,21030,210,30,-2,1,0,1,0,0,0,0,0,0,0,0,0,0,0,0,0,0,0,1,0,1,0,0,0,0,0,0,0,0,0
165981,21030,210,30,-2,2,1,1,0,0,0,0,0,0,0,0,0,0,0,0,0,0,0,2,1,1,0,0,0,0,0,0,0,0,0
166027,21030,210,30,-2,26,9,17,0,0,0,2,2,0,6,2,4,2,0,2,0,0,0,12,4,8,1,0,1,0,0,0,3,1,2
166133,21030,210,30,-2,1,0,1,0,0,0,0,0,0,0,0,0,0,0,0,0,0,0,1,0,1,0,0,0,0,0,0,0,0,0
166513,21030,210,30,-2,12,7,5,0,0,0,1,0,1,0,0,0,2,1,1,0,0,0,4,3,1,0,0,0,1,1,0,4,2,2
166629,21030,210,30,-2,20,8,12,0,0,0,1,0,1,1,1,0,3,0,3,0,0,0,6,3,3,0,0,0,0,0,0,9,4,5
166638,21030,210,30,-2,21,6,15,1,0,1,3,0,3,1,0,1,1,1,0,0,0,0,6,2,4,0,0,0,2,1,1,7,2,5
166647,21030,210,30,-2,6,0,6,0,0,0,1,0,1,2,0,2,0,0,0,0,0,0,2,0,2,0,0,0,1,0,1,0,0,0
166683,21030,210,30,-2,21,12,9,0,0,0,1,1,0,0,0,0,0,0,0,0,0,0,11,5,6,0,0,0,3,1,2,6,5,1
166692,21030,210,30,-2,1,1,0,0,0,0,0,0,0,0,0,0,0,0,0,0,0,0,1,1,0,0,0,0,0,0,0,0,0,0
166708,21030,210,30,-2,16,10,6,0,0,0,7,5,2,0,0,0,2,1,1,0,0,0,5,3,2,0,0,0,1,0,1,1,1,0
166823,21030,210,30,-2,1,0,1,0,0,0,0,0,0,0,0,0,0,0,0,0,0,0,1,0,1,0,0,0,0,0,0,0,0,0
166850,21030,210,30,-2,2,0,2,0,0,0,1,0,1,0,0,0,0,0,0,0,0,0,1,0,1,0,0,0,0,0,0,0,0,0
166939,21030,210,30,-2,1,0,1,0,0,0,0,0,0,0,0,0,0,0,0,0,0,0,1,0,1,0,0,0,0,0,0,0,0,0
166957,21030,210,30,-2,5,2,3,0,0,0,0,0,0,0,0,0,1,0,1,0,0,0,4,2,2,0,0,0,0,0,0,0,0,0
167288,21030,210,30,-2,1,1,0,0,0,0,0,0,0,0,0,0,0,0,0,0,0,0,1,1,0,0,0,0,0,0,0,0,0,0
167312,21030,210,30,-2,6,0,6,0,0,0,0,0,0,0,0,0,1,0,1,0,0,0,5,0,5,0,0,0,0,0,0,0,0,0
167358,21030,210,30,-2,41,23,18,0,0,0,11,7,4,0,0,0,1,1,0,0,0,0,15,7,8,2,0,2,6,5,1,6,3,3
167376,21030,210,30,-2,8,2,6,0,0,0,0,0,0,1,0,1,0,0,0,0,0,0,7,2,5,0,0,0,0,0,0,0,0,0
167394,21030,210,30,-2,1,0,1,0,0,0,0,0,0,0,0,0,0,0,0,0,0,0,1,0,1,0,0,0,0,0,0,0,0,0
167525,21030,210,30,-2,5,2,3,0,0,0,0,0,0,0,0,0,1,1,0,0,0,0,4,1,3,0,0,0,0,0,0,0,0,0
167534,21030,210,30,-2,9,3,6,0,0,0,2,0,2,0,0,0,1,1,0,0,0,0,6,2,4,0,0,0,0,0,0,0,0,0
167631,21030,210,30,-2,1,1,0,0,0,0,0,0,0,1,1,0,0,0,0,0,0,0,0,0,0,0,0,0,0,0,0,0,0,0
167783,21030,210,30,-2,8,2,6,0,0,0,0,0,0,1,0,1,2,1,1,0,0,0,5,1,4,0,0,0,0,0,0,0,0,0
167835,21030,210,30,-2,15,1,14,0,0,0,1,0,1,4,0,4,0,0,0,0,0,0,3,0,3,2,0,2,0,0,0,5,1,4
167899,21030,210,30,-2,12,5,7,0,0,0,1,1,0,1,0,1,1,0,1,0,0,0,6,2,4,2,2,0,1,0,1,0,0,0
167905,21030,210,30,-2,3,0,3,0,0,0,0,0,0,0,0,0,1,0,1,0,0,0,2,0,2,0,0,0,0,0,0,0,0,0
167996,21030,210,30,-2,6,3,3,0,0,0,1,1,0,0,0,0,0,0,0,0,0,0,0,0,0,0,0,0,5,2,3,0,0,0
168005,21030,210,30,-2,7,1,6,0,0,0,2,0,2,0,0,0,1,0,1,0,0,0,4,1,3,0,0,0,0,0,0,0,0,0
168148,21030,210,30,-2,14,7,7,0,0,0,2,0,2,1,1,0,1,0,1,0,0,0,6,4,2,0,0,0,1,0,1,3,2,1
168218,21030,210,30,-2,3,1,2,0,0,0,0,0,0,0,0,0,0,0,0,1,1,0,1,0,1,0,0,0,0,0,0,1,0,1
168254,21030,210,30,-2,2,1,1,0,0,0,1,1,0,0,0,0,0,0,0,0,0,0,0,0,0,0,0,0,1,0,1,0,0,0
168263,21030,210,30,-2,3,0,3,0,0,0,1,0,1,0,0,0,0,0,0,0,0,0,2,0,2,0,0,0,0,0,0,0,0,0
168281,21030,210,30,-2,4,1,3,0,0,0,0,0,0,1,0,1,1,1,0,0,0,0,2,0,2,0,0,0,0,0,0,0,0,0
168342,21030,210,30,-2,2,1,1,0,0,0,0,0,0,1,0,1,0,0,0,0,0,0,0,0,0,0,0,0,0,0,0,1,1,0
168421,21030,210,30,-2,4,3,1,0,0,0,0,0,0,0,0,0,0,0,0,0,0,0,1,1,0,0,0,0,1,0,1,2,2,0
168528,21030,210,30,-2,1,1,0,0,0,0,0,0,0,0,0,0,0,0,0,0,0,0,1,1,0,0,0,0,0,0,0,0,0,0
168546,21030,210,30,-2,2,2,0,0,0,0,1,1,0,0,0,0,0,0,0,0,0,0,1,1,0,0,0,0,0,0,0,0,0,0
168591,21030,210,30,-2,3,1,2,0,0,0,1,0,1,1,1,0,0,0,0,0,0,0,1,0,1,0,0,0,0,0,0,0,0,0
168740,21030,210,30,-2,10,3,7,0,0,0,0,0,0,1,0,1,2,1,1,0,0,0,4,2,2,1,0,1,0,0,0,2,0,2
168883,21030,210,30,-2,1,1,0,0,0,0,0,0,0,0,0,0,0,0,0,0,0,0,1,1,0,0,0,0,0,0,0,0,0,0
169248,21030,210,30,-2,7,3,4,0,0,0,1,0,1,0,0,0,0,0,0,0,0,0,6,3,3,0,0,0,0,0,0,0,0,0
169716,21030,210,30,-2,6,1,5,0,0,0,0,0,0,0,0,0,0,0,0,0,0,0,1,0,1,0,0,0,0,0,0,5,1,4
169798,21030,210,30,-2,17,8,9,1,1,0,2,0,2,2,1,1,1,1,0,0,0,0,10,5,5,0,0,0,1,0,1,0,0,0
169910,21030,210,30,-2,3,2,1,0,0,0,0,0,0,0,0,0,0,0,0,0,0,0,2,1,1,0,0,0,0,0,0,1,1,0
169983,21030,210,30,-2,7,3,4,0,0,0,1,1,0,1,0,1,0,0,0,0,0,0,5,2,3,0,0,0,0,0,0,0,0,0
170037,21030,210,30,-2,3,2,1,0,0,0,0,0,0,0,0,0,1,0,1,0,0,0,2,2,0,0,0,0,0,0,0,0,0,0
170055,21030,210,30,-2,14,7,7,0,0,0,0,0,0,0,0,0,0,0,0,0,0,0,14,7,7,0,0,0,0,0,0,0,0,0
170082,21030,210,30,-2,11,5,6,0,0,0,0,0,0,1,0,1,0,0,0,0,0,0,8,3,5,0,0,0,0,0,0,2,2,0
170240,21030,210,30,-2,18,7,11,0,0,0,2,2,0,3,1,2,0,0,0,0,0,0,12,4,8,0,0,0,0,0,0,1,0,1
170286,21030,210,30,-2,8,7,1,0,0,0,0,0,0,0,0,0,0,0,0,0,0,0,0,0,0,0,0,0,8,7,1,0,0,0
170301,21030,210,30,-2,9,4,5,0,0,0,1,0,1,1,1,0,1,1,0,1,1,0,4,1,3,1,0,1,0,0,0,0,0,0
170532,21030,210,30,-2,4,2,2,0,0,0,1,0,1,2,1,1,0,0,0,0,0,0,1,1,0,0,0,0,0,0,0,0,0,0
170541,21030,210,30,-2,1,1,0,0,0,0,0,0,0,0,0,0,0,0,0,0,0,0,0,0,0,0,0,0,1,1,0,0,0,0
170550,21030,210,30,-2,4,2,2,0,0,0,0,0,0,0,0,0,0,0,0,0,0,0,4,2,2,0,0,0,0,0,0,0,0,0
170639,21030,210,30,-2,8,3,5,0,0,0,0,0,0,0,0,0,0,0,0,0,0,0,8,3,5,0,0,0,0,0,0,0,0,0
170675,21030,210,30,-2,8,4,4,0,0,0,1,1,0,0,0,0,0,0,0,0,0,0,4,2,2,0,0,0,1,1,0,2,0,2
170967,21030,210,30,-2,5,1,4,0,0,0,0,0,0,1,0,1,0,0,0,0,0,0,4,1,3,0,0,0,0,0,0,0,0,0
170976,21030,210,30,-2,33,20,13,0,0,0,5,2,3,2,1,1,2,1,1,0,0,0,13,9,4,1,0,1,1,1,0,9,6,3
171100,21030,210,30,-2,19,11,8,0,0,0,3,1,2,2,2,0,2,1,1,0,0,0,8,4,4,0,0,0,0,0,0,4,3,1
171128,21030,210,30,-2,9,4,5,0,0,0,0,0,0,0,0,0,0,0,0,0,0,0,2,1,1,0,0,0,1,0,1,6,3,3
171137,21030,210,30,-2,1,1,0,0,0,0,0,0,0,0,0,0,0,0,0,0,0,0,0,0,0,0,0,0,0,0,0,1,1,0
171146,21030,210,30,-2,4,1,3,0,0,0,0,0,0,1,0,1,0,0,0,0,0,0,2,1,1,0,0,0,0,0,0,1,0,1
171234,21030,210,30,-2,2,0,2,0,0,0,0,0,0,0,0,0,0,0,0,0,0,0,2,0,2,0,0,0,0,0,0,0,0,0
171456,21030,210,30,-2,9,5,4,0,0,0,0,0,0,0,0,0,0,0,0,0,0,0,8,4,4,0,0,0,0,0,0,1,1,0
171571,21030,210,30,-2,25,10,15,1,1,0,3,3,0,1,1,0,0,0,0,0,0,0,14,3,11,0,0,0,0,0,0,6,2,4
171599,21030,210,30,-2,3,0,3,0,0,0,0,0,0,1,0,1,1,0,1,0,0,0,1,0,1,0,0,0,0,0,0,0,0,0
171881,21030,210,30,-2,1,0,1,0,0,0,0,0,0,0,0,0,0,0,0,0,0,0,1,0,1,0,0,0,0,0,0,0,0,0
172051,21030,210,30,-2,13,8,5,0,0,0,0,0,0,0,0,0,0,0,0,0,0,0,13,8,5,0,0,0,0,0,0,0,0,0
172291,21030,210,30,-2,5,2,3,0,0,0,0,0,0,0,0,0,0,0,0,0,0,0,5,2,3,0,0,0,0,0,0,0,0,0
172334,21030,210,30,-2,3,2,1,0,0,0,0,0,0,0,0,0,0,0,0,0,0,0,2,1,1,0,0,0,1,1,0,0,0,0
172440,21030,210,30,-2,5,1,4,0,0,0,0,0,0,0,0,0,0,0,0,0,0,0,5,1,4,0,0,0,0,0,0,0,0,0
172644,21030,210,30,-2,23,13,10,0,0,0,2,1,1,0,0,0,0,0,0,0,0,0,12,8,4,1,0,1,0,0,0,8,4,4
172671,21030,210,30,-2,1,1,0,0,0,0,0,0,0,0,0,0,0,0,0,0,0,0,1,1,0,0,0,0,0,0,0,0,0,0
172699,21030,210,30,-2,16,5,11,0,0,0,2,0,2,4,1,3,0,0,0,0,0,0,10,4,6,0,0,0,0,0,0,0,0,0
172705,21030,210,30,-2,1,1,0,0,0,0,0,0,0,0,0,0,1,1,0,0,0,0,0,0,0,0,0,0,0,0,0,0,0,0
172918,21030,210,30,-2,2,2,0,0,0,0,0,0,0,0,0,0,0,0,0,0,0,0,2,2,0,0,0,0,0,0,0,0,0,0
172963,21030,210,30,-2,3,0,3,0,0,0,1,0,1,0,0,0,0,0,0,0,0,0,2,0,2,0,0,0,0,0,0,0,0,0
173045,21030,210,30,-2,5,0,5,0,0,0,2,0,2,0,0,0,1,0,1,1,0,1,1,0,1,0,0,0,0,0,0,0,0,0
173063,21030,210,30,-2,2,0,2,0,0,0,0,0,0,0,0,0,0,0,0,0,0,0,2,0,2,0,0,0,0,0,0,0,0,0
173115,21030,210,30,-2,1,1,0,0,0,0,0,0,0,0,0,0,0,0,0,0,0,0,1,1,0,0,0,0,0,0,0,0,0,0
173124,21030,210,30,-2,9,4,5,1,1,0,0,0,0,0,0,0,1,1,0,0,0,0,5,2,3,1,0,1,1,0,1,0,0,0
173160,21030,210,30,-2,9,4,5,0,0,0,0,0,0,0,0,0,0,0,0,0,0,0,7,3,4,0,0,0,2,1,1,0,0,0
173203,21030,210,30,-2,3,1,2,0,0,0,0,0,0,0,0,0,0,0,0,0,0,0,2,0,2,0,0,0,1,1,0,0,0,0
173258,21030,210,30,-2,11,5,6,0,0,0,2,0,2,0,0,0,3,3,0,0,0,0,6,2,4,0,0,0,0,0,0,0,0,0
173300,21030,210,30,-2,2,0,2,0,0,0,0,0,0,0,0,0,0,0,0,0,0,0,2,0,2,0,0,0,0,0,0,0,0,0
173416,21030,210,30,-2,4,3,1,0,0,0,1,0,1,0,0,0,0,0,0,0,0,0,3,3,0,0,0,0,0,0,0,0,0,0
173461,21030,210,30,-2,2,1,1,0,0,0,0,0,0,0,0,0,0,0,0,0,0,0,1,1,0,0,0,0,1,0,1,0,0,0
173647,21030,210,30,-2,4,0,4,0,0,0,0,0,0,1,0,1,0,0,0,0,0,0,3,0,3,0,0,0,0,0,0,0,0,0
173665,21030,210,30,-2,2,1,1,0,0,0,0,0,0,0,0,0,1,0,1,0,0,0,0,0,0,0,0,0,1,1,0,0,0,0
173708,21030,210,30,-2,1,1,0,0,0,0,0,0,0,0,0,0,0,0,0,0,0,0,1,1,0,0,0,0,0,0,0,0,0,0
173799,21030,210,30,-2,4,1,3,0,0,0,0,0,0,1,0,1,1,1,0,0,0,0,1,0,1,0,0,0,1,0,1,0,0,0
173805,21030,210,30,-2,2,2,0,0,0,0,0,0,0,0,0,0,0,0,0,0,0,0,2,2,0,0,0,0,0,0,0,0,0,0
173902,21030,210,30,-2,1,0,1,0,0,0,1,0,1,0,0,0,0,0,0,0,0,0,0,0,0,0,0,0,0,0,0,0,0,0
173911,21030,210,30,-2,9,6,3,0,0,0,0,0,0,1,1,0,0,0,0,0,0,0,8,5,3,0,0,0,0,0,0,0,0,0
173920,21030,210,30,-2,19,6,13,0,0,0,1,0,1,1,0,1,3,1,2,0,0,0,14,5,9,0,0,0,0,0,0,0,0,0
174020,21030,210,30,-2,10,3,7,0,0,0,2,0,2,1,0,1,1,0,1,0,0,0,4,2,2,0,0,0,2,1,1,0,0,0
174066,21030,210,30,-2,39,19,20,0,0,0,3,2,1,4,1,3,3,2,1,0,0,0,17,5,12,2,1,1,1,1,0,9,7,2
174075,21030,210,30,-2,1,1,0,0,0,0,0,0,0,0,0,0,0,0,0,0,0,0,0,0,0,0,0,0,0,0,0,1,1,0
174136,21030,210,30,-2,3,2,1,0,0,0,0,0,0,0,0,0,0,0,0,0,0,0,3,2,1,0,0,0,0,0,0,0,0,0
174233,21030,210,30,-2,1,1,0,0,0,0,0,0,0,0,0,0,0,0,0,0,0,0,0,0,0,0,0,0,0,0,0,1,1,0
174358,21030,210,30,-2,2,1,1,0,0,0,0,0,0,0,0,0,0,0,0,0,0,0,2,1,1,0,0,0,0,0,0,0,0,0
174376,21030,210,30,-2,2,1,1,0,0,0,0,0,0,0,0,0,0,0,0,0,0,0,1,1,0,0,0,0,1,0,1,0,0,0
174428,21030,210,30,-2,5,1,4,0,0,0,2,1,1,0,0,0,0,0,0,0,0,0,3,0,3,0,0,0,0,0,0,0,0,0
174473,21030,210,30,-2,3,2,1,0,0,0,0,0,0,0,0,0,0,0,0,0,0,0,3,2,1,0,0,0,0,0,0,0,0,0
174738,21030,210,30,-2,1,0,1,0,0,0,0,0,0,0,0,0,0,0,0,0,0,0,1,0,1,0,0,0,0,0,0,0,0,0
174756,21030,210,30,-2,3,1,2,0,0,0,0,0,0,0,0,0,0,0,0,0,0,0,3,1,2,0,0,0,0,0,0,0,0,0
174783,21030,210,30,-2,11,8,3,0,0,0,3,2,1,1,1,0,1,1,0,0,0,0,3,2,1,0,0,0,3,2,1,0,0,0
174792,21030,210,30,-2,2,1,1,0,0,0,1,0,1,0,0,0,0,0,0,0,0,0,1,1,0,0,0,0,0,0,0,0,0,0
174817,21030,210,30,-2,1,1,0,0,0,0,0,0,0,0,0,0,0,0,0,0,0,0,1,1,0,0,0,0,0,0,0,0,0,0
174844,21030,210,30,-2,3,1,2,0,0,0,1,0,1,1,1,0,0,0,0,0,0,0,0,0,0,0,0,0,0,0,0,1,0,1
174862,21030,210,30,-2,2,2,0,0,0,0,1,1,0,0,0,0,0,0,0,0,0,0,1,1,0,0,0,0,0,0,0,0,0,0
174899,21030,210,30,-2,6,4,2,0,0,0,1,1,0,0,0,0,0,0,0,0,0,0,5,3,2,0,0,0,0,0,0,0,0,0
174914,21030,210,30,-2,1,1,0,0,0,0,0,0,0,0,0,0,0,0,0,0,0,0,1,1,0,0,0,0,0,0,0,0,0,0
175005,21030,210,30,-2,6,1,5,0,0,0,0,0,0,0,0,0,0,0,0,0,0,0,6,1,5,0,0,0,0,0,0,0,0,0
175041,21030,210,30,-2,3,1,2,0,0,0,0,0,0,0,0,0,1,1,0,0,0,0,2,0,2,0,0,0,0,0,0,0,0,0
175078,21030,210,30,-2,1,1,0,0,0,0,0,0,0,0,0,0,0,0,0,0,0,0,1,1,0,0,0,0,0,0,0,0,0,0
175236,21030,210,30,-2,4,2,2,0,0,0,0,0,0,0,0,0,0,0,0,0,0,0,3,2,1,0,0,0,1,0,1,0,0,0
175263,21030,210,30,-2,1,1,0,0,0,0,0,0,0,0,0,0,0,0,0,0,0,0,1,1,0,0,0,0,0,0,0,0,0,0
175272,21030,210,30,-2,11,4,7,0,0,0,2,1,1,0,0,0,0,0,0,0,0,0,7,3,4,1,0,1,1,0,1,0,0,0
175281,21030,210,30,-2,1,1,0,0,0,0,0,0,0,1,1,0,0,0,0,0,0,0,0,0,0,0,0,0,0,0,0,0,0,0
175315,21030,210,30,-2,1,1,0,0,0,0,0,0,0,1,1,0,0,0,0,0,0,0,0,0,0,0,0,0,0,0,0,0,0,0
175342,21030,210,30,-2,3,1,2,0,0,0,0,0,0,3,1,2,0,0,0,0,0,0,0,0,0,0,0,0,0,0,0,0,0,0
175421,21030,210,30,-2,5,2,3,0,0,0,0,0,0,1,0,1,0,0,0,0,0,0,4,2,2,0,0,0,0,0,0,0,0,0
175616,21030,210,30,-2,6,4,2,0,0,0,1,1,0,1,0,1,0,0,0,0,0,0,2,2,0,0,0,0,0,0,0,2,1,1
175856,21030,210,30,-2,14,7,7,0,0,0,2,2,0,9,3,6,0,0,0,0,0,0,2,1,1,0,0,0,0,0,0,1,1,0
176017,21030,210,30,-2,21,13,8,0,0,0,4,3,1,2,1,1,0,0,0,0,0,0,11,7,4,0,0,0,0,0,0,4,2,2
176035,21030,210,30,-2,4,2,2,0,0,0,0,0,0,1,0,1,0,0,0,0,0,0,2,1,1,0,0,0,0,0,0,1,1,0
176044,21030,210,30,-2,4,2,2,0,0,0,0,0,0,3,2,1,0,0,0,0,0,0,1,0,1,0,0,0,0,0,0,0,0,0
176053,21030,210,30,-2,11,6,5,0,0,0,0,0,0,1,1,0,0,0,0,0,0,0,3,1,2,0,0,0,6,3,3,1,1,0
176080,21030,210,30,-2,39,26,13,0,0,0,4,4,0,1,0,1,1,1,0,0,0,0,18,12,6,0,0,0,0,0,0,15,9,6
176406,21030,210,30,-2,2,0,2,0,0,0,0,0,0,2,0,2,0,0,0,0,0,0,0,0,0,0,0,0,0,0,0,0,0,0
176628,21030,210,30,-2,3,0,3,0,0,0,0,0,0,0,0,0,0,0,0,0,0,0,3,0,3,0,0,0,0,0,0,0,0,0
176947,21030,210,30,-2,1,1,0,0,0,0,0,0,0,0,0,0,0,0,0,0,0,0,1,1,0,0,0,0,0,0,0,0,0,0
176965,21030,210,30,-2,7,4,3,0,0,0,0,0,0,0,0,0,1,0,1,0,0,0,4,2,2,0,0,0,0,0,0,2,2,0
177065,21030,210,30,-2,1,0,1,0,0,0,0,0,0,0,0,0,0,0,0,0,0,0,1,0,1,0,0,0,0,0,0,0,0,0
177117,21030,210,30,-2,4,2,2,0,0,0,0,0,0,0,0,0,0,0,0,0,0,0,2,1,1,0,0,0,0,0,0,2,1,1
177144,21030,210,30,-2,4,3,1,0,0,0,1,1,0,0,0,0,0,0,0,0,0,0,3,2,1,0,0,0,0,0,0,0,0,0
177214,21030,210,30,-2,2,2,0,0,0,0,0,0,0,0,0,0,0,0,0,0,0,0,0,0,0,0,0,0,2,2,0,0,0,0
177250,21030,210,30,-2,6,2,4,0,0,0,0,0,0,0,0,0,0,0,0,0,0,0,5,2,3,1,0,1,0,0,0,0,0,0
177339,21030,210,30,-2,2,1,1,0,0,0,0,0,0,0,0,0,0,0,0,0,0,0,2,1,1,0,0,0,0,0,0,0,0,0
177418,21030,210,30,-2,4,1,3,1,0,1,0,0,0,0,0,0,2,1,1,0,0,0,1,0,1,0,0,0,0,0,0,0,0,0
177551,21030,210,30,-2,1,1,0,0,0,0,0,0,0,0,0,0,0,0,0,0,0,0,1,1,0,0,0,0,0,0,0,0,0,0
177676,21030,210,30,-2,5,1,4,0,0,0,0,0,0,0,0,0,0,0,0,0,0,0,5,1,4,0,0,0,0,0,0,0,0,0
177940,21030,210,30,-2,3,1,2,0,0,0,0,0,0,0,0,0,0,0,0,0,0,0,3,1,2,0,0,0,0,0,0,0,0,0
178059,21030,210,30,-2,5,1,4,0,0,0,0,0,0,0,0,0,0,0,0,0,0,0,5,1,4,0,0,0,0,0,0,0,0,0
178341,21030,210,30,-2,3,1,2,0,0,0,0,0,0,0,0,0,0,0,0,0,0,0,2,0,2,0,0,0,0,0,0,1,1,0
178387,21030,210,30,-2,5,2,3,0,0,0,0,0,0,0,0,0,1,1,0,0,0,0,0,0,0,0,0,0,4,1,3,0,0,0
178396,21030,210,30,-2,19,13,6,0,0,0,3,2,1,1,1,0,1,1,0,0,0,0,9,6,3,0,0,0,1,1,0,4,2,2
178402,21030,210,30,-2,6,2,4,0,0,0,1,0,1,2,1,1,2,1,1,0,0,0,1,0,1,0,0,0,0,0,0,0,0,0
178411,21030,210,30,-2,4,4,0,0,0,0,0,0,0,0,0,0,0,0,0,0,0,0,0,0,0,0,0,0,0,0,0,4,4,0
178615,21030,210,30,-2,7,5,2,0,0,0,1,1,0,0,0,0,0,0,0,0,0,0,5,3,2,0,0,0,0,0,0,1,1,0
178624,21030,210,30,-2,13,7,6,0,0,0,1,1,0,0,0,0,0,0,0,0,0,0,8,4,4,0,0,0,0,0,0,4,2,2
178721,21030,210,30,-2,6,1,5,1,0,1,0,0,0,0,0,0,0,0,0,0,0,0,4,1,3,1,0,1,0,0,0,0,0,0
179043,21030,210,30,-2,5,0,5,0,0,0,0,0,0,0,0,0,0,0,0,0,0,0,5,0,5,0,0,0,0,0,0,0,0,0
179159,21030,210,30,-2,10,5,5,0,0,0,0,0,0,2,1,1,1,1,0,0,0,0,6,2,4,0,0,0,0,0,0,1,1,0
179326,21030,210,30,-2,6,4,2,0,0,0,1,1,0,0,0,0,0,0,0,0,0,0,5,3,2,0,0,0,0,0,0,0,0,0
179548,21030,210,30,-2,1,0,1,0,0,0,0,0,0,0,0,0,0,0,0,0,0,0,1,0,1,0,0,0,0,0,0,0,0,0
179557,21030,210,30,-2,8,6,2,0,0,0,0,0,0,0,0,0,1,1,0,0,0,0,5,3,2,0,0,0,2,2,0,0,0,0
179566,21030,210,30,-2,20,7,13,1,0,1,2,0,2,1,0,1,2,2,0,0,0,0,9,4,5,0,0,0,0,0,0,5,1,4
179715,21030,210,30,-2,5,2,3,0,0,0,0,0,0,0,0,0,0,0,0,0,0,0,5,2,3,0,0,0,0,0,0,0,0,0
179867,21030,210,30,-2,38,18,20,0,0,0,11,8,3,3,2,1,2,2,0,0,0,0,17,5,12,2,1,1,2,0,2,1,0,1
179894,21030,210,30,-2,1,0,1,0,0,0,0,0,0,0,0,0,0,0,0,0,0,0,1,0,1,0,0,0,0,0,0,0,0,0
179964,21030,210,30,-2,3,3,0,0,0,0,0,0,0,0,0,0,0,0,0,0,0,0,3,3,0,0,0,0,0,0,0,0,0,0
180106,21030,210,30,-2,5,2,3,0,0,0,0,0,0,0,0,0,0,0,0,0,0,0,3,1,2,0,0,0,2,1,1,0,0,0
180151,21030,210,30,-2,2,1,1,0,0,0,0,0,0,0,0,0,0,0,0,0,0,0,2,1,1,0,0,0,0,0,0,0,0,0
180179,21030,210,30,-2,8,5,3,0,0,0,0,0,0,0,0,0,0,0,0,0,0,0,7,5,2,0,0,0,1,0,1,0,0,0
180197,21030,210,30,-2,4,2,2,0,0,0,0,0,0,0,0,0,0,0,0,0,0,0,4,2,2,0,0,0,0,0,0,0,0,0
180249,21030,210,30,-2,2,0,2,0,0,0,0,0,0,0,0,0,0,0,0,0,0,0,2,0,2,0,0,0,0,0,0,0,0,0
180258,21030,210,30,-2,2,1,1,0,0,0,0,0,0,0,0,0,1,1,0,0,0,0,0,0,0,1,0,1,0,0,0,0,0,0
180276,21030,210,30,-2,2,0,2,0,0,0,0,0,0,0,0,0,0,0,0,0,0,0,2,0,2,0,0,0,0,0,0,0,0,0
180416,21030,210,30,-2,4,2,2,0,0,0,0,0,0,0,0,0,0,0,0,0,0,0,4,2,2,0,0,0,0,0,0,0,0,0
180461,21030,210,30,-2,4,2,2,0,0,0,0,0,0,0,0,0,0,0,0,0,0,0,2,1,1,0,0,0,0,0,0,2,1,1
180489,21030,210,30,-2,12,3,9,0,0,0,0,0,0,0,0,0,1,0,1,0,0,0,9,2,7,1,0,1,1,1,0,0,0,0
180522,21030,210,30,-2,5,3,2,0,0,0,0,0,0,0,0,0,0,0,0,0,0,0,5,3,2,0,0,0,0,0,0,0,0,0
180595,21030,210,30,-2,1,0,1,0,0,0,0,0,0,0,0,0,0,0,0,0,0,0,1,0,1,0,0,0,0,0,0,0,0,0
180692,21030,210,30,-2,5,3,2,0,0,0,1,0,1,0,0,0,0,0,0,0,0,0,1,0,1,1,1,0,2,2,0,0,0,0
180948,21030,210,30,-2,5,3,2,0,0,0,0,0,0,1,0,1,0,0,0,0,0,0,4,3,1,0,0,0,0,0,0,0,0,0
181002,21030,210,30,-2,15,4,11,0,0,0,5,1,4,0,0,0,0,0,0,0,0,0,7,3,4,1,0,1,2,0,2,0,0,0
181020,21030,210,30,-2,4,4,0,0,0,0,1,1,0,0,0,0,1,1,0,0,0,0,1,1,0,0,0,0,1,1,0,0,0,0
181127,21030,210,30,-2,1,0,1,0,0,0,0,0,0,0,0,0,0,0,0,0,0,0,1,0,1,0,0,0,0,0,0,0,0,0
181215,21030,210,30,-2,19,10,9,0,0,0,4,3,1,0,0,0,0,0,0,0,0,0,11,4,7,0,0,0,0,0,0,4,3,1
181330,21030,210,30,-2,2,1,1,0,0,0,0,0,0,0,0,0,0,0,0,0,0,0,2,1,1,0,0,0,0,0,0,0,0,0
181394,21030,210,30,-2,25,11,14,0,0,0,1,0,1,2,0,2,2,2,0,0,0,0,10,5,5,0,0,0,1,0,1,9,4,5
181428,21030,210,30,-2,34,12,22,0,0,0,5,2,3,2,1,1,0,0,0,0,0,0,23,7,16,0,0,0,0,0,0,4,2,2
181446,21030,210,30,-2,10,3,7,0,0,0,0,0,0,1,0,1,0,0,0,0,0,0,8,3,5,1,0,1,0,0,0,0,0,0
181464,21030,210,30,-2,24,11,13,0,0,0,0,0,0,0,0,0,0,0,0,0,0,0,15,5,10,0,0,0,0,0,0,9,6,3
181534,21030,210,30,-2,3,3,0,0,0,0,0,0,0,0,0,0,0,0,0,0,0,0,3,3,0,0,0,0,0,0,0,0,0,0
181738,21030,210,30,-2,5,1,4,0,0,0,0,0,0,0,0,0,0,0,0,0,0,0,5,1,4,0,0,0,0,0,0,0,0,0
181783,21030,210,30,-2,7,4,3,0,0,0,0,0,0,0,0,0,1,0,1,0,0,0,6,4,2,0,0,0,0,0,0,0,0,0
181817,21030,210,30,-2,9,4,5,0,0,0,0,0,0,0,0,0,0,0,0,0,0,0,9,4,5,0,0,0,0,0,0,0,0,0
182005,21030,210,30,-2,10,5,5,0,0,0,2,2,0,2,0,2,0,0,0,0,0,0,5,3,2,0,0,0,1,0,1,0,0,0
182281,21030,210,30,-2,14,7,7,0,0,0,2,1,1,1,1,0,1,1,0,0,0,0,5,2,3,0,0,0,0,0,0,5,2,3
182290,21030,210,30,-2,13,5,8,0,0,0,1,0,1,0,0,0,3,1,2,0,0,0,8,3,5,0,0,0,0,0,0,1,1,0
182306,21030,210,30,-2,2,1,1,0,0,0,0,0,0,0,0,0,0,0,0,0,0,0,1,0,1,0,0,0,0,0,0,1,1,0
182500,21030,210,30,-2,3,2,1,0,0,0,0,0,0,1,1,0,0,0,0,0,0,0,2,1,1,0,0,0,0,0,0,0,0,0
182564,21030,210,30,-2,1,0,1,0,0,0,0,0,0,0,0,0,0,0,0,0,0,0,1,0,1,0,0,0,0,0,0,0,0,0
182634,21030,210,30,-2,4,3,1,0,0,0,0,0,0,0,0,0,1,0,1,0,0,0,3,3,0,0,0,0,0,0,0,0,0,0
182670,21030,210,30,-2,19,6,13,0,0,0,2,2,0,0,0,0,0,0,0,0,0,0,14,3,11,0,0,0,0,0,0,3,1,2
182829,21030,210,30,-2,2,1,1,0,0,0,1,0,1,0,0,0,0,0,0,0,0,0,0,0,0,0,0,0,1,1,0,0,0,0
183044,21030,210,30,-2,19,10,9,0,0,0,2,1,1,2,0,2,1,0,1,0,0,0,8,5,3,0,0,0,1,0,1,5,4,1
183062,21030,210,30,-2,7,2,5,0,0,0,0,0,0,0,0,0,0,0,0,0,0,0,3,0,3,0,0,0,2,0,2,2,2,0
183080,21030,210,30,-2,3,0,3,0,0,0,0,0,0,0,0,0,0,0,0,0,0,0,2,0,2,0,0,0,0,0,0,1,0,1
183239,21030,210,30,-2,2,0,2,0,0,0,0,0,0,0,0,0,0,0,0,0,0,0,2,0,2,0,0,0,0,0,0,0,0,0
183655,21030,210,30,-2,7,2,5,0,0,0,0,0,0,0,0,0,1,1,0,0,0,0,6,1,5,0,0,0,0,0,0,0,0,0
183822,21030,210,30,-2,1,1,0,0,0,0,0,0,0,0,0,0,0,0,0,0,0,0,1,1,0,0,0,0,0,0,0,0,0,0
183859,21030,210,30,-2,8,5,3,0,0,0,0,0,0,0,0,0,0,0,0,0,0,0,7,4,3,1,1,0,0,0,0,0,0,0
183910,21030,210,30,-2,3,1,2,0,0,0,0,0,0,0,0,0,0,0,0,0,0,0,3,1,2,0,0,0,0,0,0,0,0,0
183938,21030,210,30,-2,2,0,2,0,0,0,0,0,0,0,0,0,0,0,0,0,0,0,2,0,2,0,0,0,0,0,0,0,0,0
183974,21030,210,30,-2,1,0,1,0,0,0,0,0,0,0,0,0,0,0,0,0,0,0,1,0,1,0,0,0,0,0,0,0,0,0
184180,21030,210,30,-2,2,0,2,0,0,0,0,0,0,0,0,0,0,0,0,0,0,0,2,0,2,0,0,0,0,0,0,0,0,0
184205,21030,210,30,-2,4,0,4,0,0,0,0,0,0,0,0,0,0,0,0,0,0,0,4,0,4,0,0,0,0,0,0,0,0,0
184348,21030,210,30,-2,3,1,2,0,0,0,1,1,0,1,0,1,0,0,0,0,0,0,0,0,0,0,0,0,0,0,0,1,0,1
184481,21030,210,30,-2,4,2,2,0,0,0,0,0,0,2,0,2,0,0,0,0,0,0,1,1,0,0,0,0,1,1,0,0,0,0
184603,21030,210,30,-2,6,4,2,0,0,0,1,1,0,0,0,0,0,0,0,0,0,0,4,3,1,0,0,0,1,0,1,0,0,0
184694,21030,210,30,-2,4,0,4,0,0,0,1,0,1,0,0,0,0,0,0,0,0,0,1,0,1,0,0,0,2,0,2,0,0,0
184773,21030,210,30,-2,5,0,5,0,0,0,0,0,0,0,0,0,1,0,1,0,0,0,4,0,4,0,0,0,0,0,0,0,0,0
184782,21030,210,30,-2,3,1,2,0,0,0,0,0,0,0,0,0,1,0,1,0,0,0,2,1,1,0,0,0,0,0,0,0,0,0
184791,21030,210,30,-2,4,1,3,0,0,0,0,0,0,0,0,0,0,0,0,0,0,0,3,0,3,0,0,0,1,1,0,0,0,0
184995,21030,210,30,-2,1,0,1,0,0,0,0,0,0,0,0,0,1,0,1,0,0,0,0,0,0,0,0,0,0,0,0,0,0,0
185129,21030,210,30,-2,8,5,3,0,0,0,2,2,0,2,0,2,1,0,1,0,0,0,3,3,0,0,0,0,0,0,0,0,0,0
185262,21030,210,30,-2,35,16,19,0,0,0,9,4,5,3,0,3,5,3,2,0,0,0,12,5,7,1,0,1,2,1,1,3,3,0
185509,21030,210,30,-2,2,2,0,0,0,0,1,1,0,0,0,0,0,0,0,0,0,0,1,1,0,0,0,0,0,0,0,0,0,0
185572,21030,210,30,-2,1,0,1,0,0,0,0,0,0,0,0,0,0,0,0,0,0,0,1,0,1,0,0,0,0,0,0,0,0,0
185590,21030,210,30,-2,7,4,3,0,0,0,2,2,0,1,0,1,1,0,1,0,0,0,1,0,1,0,0,0,0,0,0,2,2,0
185828,21030,210,30,-2,18,14,4,0,0,0,2,2,0,0,0,0,0,0,0,0,0,0,7,6,1,0,0,0,0,0,0,9,6,3
186034,21030,210,30,-2,2,0,2,0,0,0,0,0,0,0,0,0,0,0,0,0,0,0,2,0,2,0,0,0,0,0,0,0,0,0
186131,21030,210,30,-2,13,9,4,0,0,0,1,1,0,0,0,0,1,1,0,0,0,0,2,1,1,0,0,0,4,1,3,5,5,0
186201,21030,210,30,-2,3,1,2,0,0,0,1,0,1,0,0,0,0,0,0,0,0,0,2,1,1,0,0,0,0,0,0,0,0,0
186283,21030,210,30,-2,5,4,1,0,0,0,0,0,0,2,2,0,3,2,1,0,0,0,0,0,0,0,0,0,0,0,0,0,0,0
186371,21030,210,30,-2,4,2,2,0,0,0,0,0,0,0,0,0,0,0,0,0,0,0,0,0,0,0,0,0,2,1,1,2,1,1
186380,21030,210,30,-2,37,19,18,0,0,0,3,3,0,0,0,0,0,0,0,0,0,0,2,1,1,0,0,0,21,9,12,11,6,5
186399,21030,210,30,-2,10,6,4,0,0,0,1,1,0,0,0,0,0,0,0,0,0,0,0,0,0,0,0,0,5,3,2,4,2,2
186584,21030,210,30,-2,3,1,2,0,0,0,0,0,0,0,0,0,2,1,1,0,0,0,1,0,1,0,0,0,0,0,0,0,0,0
186618,21030,210,30,-2,3,1,2,0,0,0,1,0,1,0,0,0,0,0,0,0,0,0,2,1,1,0,0,0,0,0,0,0,0,0
186645,21030,210,30,-2,6,1,5,0,0,0,1,0,1,1,0,1,1,0,1,0,0,0,3,1,2,0,0,0,0,0,0,0,0,0
186867,21030,210,30,-2,15,8,7,0,0,0,1,0,1,0,0,0,0,0,0,0,0,0,5,3,2,0,0,0,1,1,0,8,4,4
186876,21030,210,30,-2,5,3,2,0,0,0,0,0,0,1,1,0,0,0,0,0,0,0,2,1,1,0,0,0,1,0,1,1,1,0
187134,21030,210,30,-2,7,3,4,0,0,0,1,1,0,2,0,2,1,1,0,0,0,0,3,1,2,0,0,0,0,0,0,0,0,0
187444,21030,210,30,-2,1,0,1,0,0,0,0,0,0,0,0,0,1,0,1,0,0,0,0,0,0,0,0,0,0,0,0,0,0,0
187648,21030,210,30,-2,5,2,3,0,0,0,0,0,0,0,0,0,0,0,0,0,0,0,3,1,2,0,0,0,0,0,0,2,1,1
187666,21030,210,30,-2,4,0,4,0,0,0,0,0,0,0,0,0,3,0,3,0,0,0,1,0,1,0,0,0,0,0,0,0,0,0
187897,21030,210,30,-2,11,7,4,0,0,0,0,0,0,1,1,0,2,0,2,0,0,0,6,5,1,0,0,0,0,0,0,2,1,1
187912,21030,210,30,-2,8,6,2,0,0,0,1,0,1,0,0,0,0,0,0,0,0,0,5,4,1,0,0,0,0,0,0,2,2,0
187967,21030,210,30,-2,2,1,1,0,0,0,0,0,0,0,0,0,0,0,0,0,0,0,2,1,1,0,0,0,0,0,0,0,0,0
187985,21030,210,30,-2,13,6,7,0,0,0,3,0,3,1,0,1,1,1,0,0,0,0,4,1,3,0,0,0,2,2,0,2,2,0
187994,21030,210,30,-2,3,3,0,0,0,0,0,0,0,1,1,0,1,1,0,0,0,0,1,1,0,0,0,0,0,0,0,0,0,0
188030,21030,210,30,-2,8,1,7,0,0,0,1,0,1,1,0,1,0,0,0,0,0,0,4,1,3,0,0,0,0,0,0,2,0,2
188304,21030,210,30,-2,10,3,7,0,0,0,0,0,0,0,0,0,1,0,1,0,0,0,5,1,4,0,0,0,3,2,1,1,0,1
188340,21030,210,30,-2,1,1,0,0,0,0,0,0,0,1,1,0,0,0,0,0,0,0,0,0,0,0,0,0,0,0,0,0,0,0
188429,21030,210,30,-2,15,4,11,0,0,0,3,1,2,2,0,2,3,1,2,0,0,0,7,2,5,0,0,0,0,0,0,0,0,0
188438,21030,210,30,-2,3,1,2,0,0,0,1,1,0,0,0,0,0,0,0,0,0,0,2,0,2,0,0,0,0,0,0,0,0,0
188535,21030,210,30,-2,1,1,0,0,0,0,0,0,0,0,0,0,1,1,0,0,0,0,0,0,0,0,0,0,0,0,0,0,0,0
188580,21030,210,30,-2,12,6,6,0,0,0,2,2,0,0,0,0,1,0,1,0,0,0,6,3,3,0,0,0,3,1,2,0,0,0
188641,21030,210,30,-2,4,1,3,0,0,0,0,0,0,0,0,0,1,0,1,0,0,0,3,1,2,0,0,0,0,0,0,0,0,0
189088,21030,210,30,-2,2,0,2,0,0,0,1,0,1,0,0,0,0,0,0,0,0,0,0,0,0,0,0,0,0,0,0,1,0,1
189097,21030,210,30,-2,6,3,3,0,0,0,1,1,0,1,1,0,0,0,0,0,0,0,4,1,3,0,0,0,0,0,0,0,0,0
189547,21030,210,30,-2,3,2,1,1,1,0,0,0,0,0,0,0,0,0,0,0,0,0,2,1,1,0,0,0,0,0,0,0,0,0
189839,21030,210,30,-2,1,0,1,0,0,0,0,0,0,0,0,0,0,0,0,0,0,0,1,0,1,0,0,0,0,0,0,0,0,0
190044,21030,210,30,-2,9,4,5,0,0,0,0,0,0,2,1,1,0,0,0,0,0,0,1,0,1,0,0,0,0,0,0,6,3,3
190080,21030,210,30,-2,1,0,1,0,0,0,0,0,0,1,0,1,0,0,0,0,0,0,0,0,0,0,0,0,0,0,0,0,0,0
190099,21030,210,30,-2,5,1,4,0,0,0,1,0,1,2,0,2,0,0,0,0,0,0,2,1,1,0,0,0,0,0,0,0,0,0
190150,21030,210,30,-2,72,39,33,0,0,0,14,4,10,7,5,2,8,5,3,0,0,0,17,8,9,0,0,0,3,1,2,23,16,7
190169,21030,210,30,-2,3,1,2,0,0,0,0,0,0,0,0,0,0,0,0,0,0,0,3,1,2,0,0,0,0,0,0,0,0,0
190372,21030,210,30,-2,4,1,3,0,0,0,0,0,0,1,1,0,0,0,0,0,0,0,3,0,3,0,0,0,0,0,0,0,0,0
190415,21030,210,30,-2,39,15,24,0,0,0,3,3,0,5,3,2,5,1,4,0,0,0,12,3,9,4,1,3,0,0,0,10,4,6
190424,21030,210,30,-2,12,7,5,0,0,0,1,0,1,0,0,0,0,0,0,0,0,0,9,6,3,0,0,0,0,0,0,2,1,1
190442,21030,210,30,-2,3,2,1,0,0,0,0,0,0,0,0,0,0,0,0,0,0,0,3,2,1,0,0,0,0,0,0,0,0,0
190512,21030,210,30,-2,13,7,6,0,0,0,4,0,4,0,0,0,2,1,1,0,0,0,3,2,1,0,0,0,0,0,0,4,4,0
190521,21030,210,30,-2,1,0,1,0,0,0,0,0,0,1,0,1,0,0,0,0,0,0,0,0,0,0,0,0,0,0,0,0,0,0
190530,21030,210,30,-2,3,3,0,0,0,0,0,0,0,1,1,0,1,1,0,0,0,0,1,1,0,0,0,0,0,0,0,0,0,0
190549,21030,210,30,-2,2,1,1,0,0,0,0,0,0,1,1,0,0,0,0,0,0,0,0,0,0,0,0,0,0,0,0,1,0,1
190558,21030,210,30,-2,4,1,3,0,0,0,0,0,0,0,0,0,1,0,1,0,0,0,2,0,2,0,0,0,0,0,0,1,1,0
190567,21030,210,30,-2,3,3,0,0,0,0,0,0,0,1,1,0,0,0,0,0,0,0,1,1,0,0,0,0,0,0,0,1,1,0
190576,21030,210,30,-2,5,3,2,0,0,0,0,0,0,2,0,2,2,2,0,0,0,0,1,1,0,0,0,0,0,0,0,0,0,0
190594,21030,210,30,-2,6,3,3,0,0,0,1,0,1,0,0,0,0,0,0,0,0,0,5,3,2,0,0,0,0,0,0,0,0,0
190600,21030,210,30,-2,3,2,1,0,0,0,0,0,0,2,2,0,1,0,1,0,0,0,0,0,0,0,0,0,0,0,0,0,0,0
190619,21030,210,30,-2,5,1,4,0,0,0,0,0,0,0,0,0,3,1,2,0,0,0,2,0,2,0,0,0,0,0,0,0,0,0
190628,21030,210,30,-2,1,0,1,0,0,0,0,0,0,0,0,0,0,0,0,0,0,0,1,0,1,0,0,0,0,0,0,0,0,0
190637,21030,210,30,-2,2,1,1,0,0,0,0,0,0,1,0,1,0,0,0,0,0,0,1,1,0,0,0,0,0,0,0,0,0,0
190664,21030,210,30,-2,6,0,6,0,0,0,0,0,0,1,0,1,1,0,1,0,0,0,4,0,4,0,0,0,0,0,0,0,0,0
190673,21030,210,30,-2,1,0,1,0,0,0,0,0,0,0,0,0,0,0,0,0,0,0,1,0,1,0,0,0,0,0,0,0,0,0
190691,21030,210,30,-2,7,3,4,0,0,0,2,1,1,2,1,1,0,0,0,0,0,0,3,1,2,0,0,0,0,0,0,0,0,0
190725,21030,210,30,-2,6,1,5,0,0,0,0,0,0,0,0,0,0,0,0,0,0,0,6,1,5,0,0,0,0,0,0,0,0,0
190761,21030,210,30,-2,2,1,1,0,0,0,0,0,0,0,0,0,0,0,0,0,0,0,2,1,1,0,0,0,0,0,0,0,0,0
190840,21030,210,30,-2,3,1,2,0,0,0,0,0,0,0,0,0,0,0,0,0,0,0,1,0,1,0,0,0,2,1,1,0,0,0
190983,21030,210,30,-2,10,4,6,0,0,0,0,0,0,0,0,0,0,0,0,0,0,0,10,4,6,0,0,0,0,0,0,0,0,0
191083,21030,210,30,-2,3,1,2,0,0,0,0,0,0,1,1,0,0,0,0,0,0,0,1,0,1,0,0,0,1,0,1,0,0,0
191126,21030,210,30,-2,2,1,1,0,0,0,0,0,0,0,0,0,0,0,0,0,0,0,2,1,1,0,0,0,0,0,0,0,0,0
191199,21030,210,30,-2,1,1,0,0,0,0,0,0,0,0,0,0,0,0,0,0,0,0,1,1,0,0,0,0,0,0,0,0,0,0
191241,21030,210,30,-2,4,2,2,0,0,0,0,0,0,1,0,1,0,0,0,0,0,0,1,0,1,0,0,0,1,1,0,1,1,0
191515,21030,210,30,-2,11,5,6,0,0,0,0,0,0,0,0,0,0,0,0,0,0,0,7,4,3,0,0,0,1,0,1,3,1,2
191533,21030,210,30,-2,6,3,3,0,0,0,0,0,0,0,0,0,0,0,0,0,0,0,2,1,1,0,0,0,3,1,2,1,1,0
191621,21030,210,30,-2,2,1,1,0,0,0,0,0,0,0,0,0,0,0,0,0,0,0,2,1,1,0,0,0,0,0,0,0,0,0
191630,21030,210,30,-2,3,2,1,0,0,0,1,1,0,0,0,0,0,0,0,0,0,0,2,1,1,0,0,0,0,0,0,0,0,0
191649,21030,210,30,-2,10,6,4,0,0,0,0,0,0,1,1,0,1,0,1,0,0,0,4,2,2,0,0,0,0,0,0,4,3,1
191676,21030,210,30,-2,7,6,1,0,0,0,1,1,0,1,1,0,0,0,0,0,0,0,3,3,0,0,0,0,1,1,0,1,0,1
191719,21030,210,30,-2,7,4,3,0,0,0,0,0,0,0,0,0,0,0,0,0,0,0,7,4,3,0,0,0,0,0,0,0,0,0
191931,21030,210,30,-2,3,1,2,0,0,0,1,1,0,0,0,0,0,0,0,0,0,0,2,0,2,0,0,0,0,0,0,0,0,0
191968,21030,210,30,-2,1,0,1,0,0,0,0,0,0,0,0,0,0,0,0,0,0,0,0,0,0,0,0,0,1,0,1,0,0,0
191986,21030,210,30,-2,6,1,5,0,0,0,0,0,0,0,0,0,0,0,0,0,0,0,6,1,5,0,0,0,0,0,0,0,0,0
192022,21030,210,30,-2,3,1,2,0,0,0,0,0,0,0,0,0,1,1,0,0,0,0,2,0,2,0,0,0,0,0,0,0,0,0
192323,21030,210,30,-2,4,1,3,0,0,0,1,0,1,1,0,1,0,0,0,0,0,0,2,1,1,0,0,0,0,0,0,0,0,0
192448,21030,210,30,-2,13,5,8,0,0,0,3,0,3,0,0,0,0,0,0,0,0,0,5,2,3,0,0,0,1,0,1,4,3,1
192749,21030,210,30,-2,5,0,5,0,0,0,1,0,1,1,0,1,1,0,1,0,0,0,2,0,2,0,0,0,0,0,0,0,0,0
193016,21030,210,30,-2,5,2,3,0,0,0,0,0,0,1,0,1,2,1,1,0,0,0,1,0,1,0,0,0,0,0,0,1,1,0
193283,21030,210,30,-2,3,1,2,0,0,0,0,0,0,0,0,0,0,0,0,0,0,0,3,1,2,0,0,0,0,0,0,0,0,0
193292,21030,210,30,-2,12,2,10,0,0,0,0,0,0,0,0,0,1,1,0,0,0,0,11,1,10,0,0,0,0,0,0,0,0,0
193326,21030,210,30,-2,4,1,3,0,0,0,0,0,0,0,0,0,0,0,0,0,0,0,4,1,3,0,0,0,0,0,0,0,0,0
193353,21030,210,30,-2,2,1,1,0,0,0,1,0,1,0,0,0,0,0,0,0,0,0,1,1,0,0,0,0,0,0,0,0,0,0
193399,21030,210,30,-2,8,2,6,0,0,0,0,0,0,1,0,1,0,0,0,0,0,0,7,2,5,0,0,0,0,0,0,0,0,0
193405,21030,210,30,-2,123,65,58,0,0,0,16,6,10,3,2,1,4,2,2,0,0,0,26,13,13,0,0,0,65,35,30,9,7,2
193654,21030,210,30,-2,2,2,0,0,0,0,0,0,0,0,0,0,0,0,0,0,0,0,1,1,0,0,0,0,0,0,0,1,1,0
193821,21030,210,30,-2,1,0,1,0,0,0,0,0,0,0,0,0,0,0,0,0,0,0,0,0,0,0,0,0,1,0,1,0,0,0
193830,21030,210,30,-2,8,3,5,0,0,0,4,2,2,1,0,1,1,0,1,0,0,0,2,1,1,0,0,0,0,0,0,0,0,0
193900,21030,210,30,-2,24,11,13,0,0,0,6,3,3,3,1,2,4,1,3,0,0,0,5,3,2,0,0,0,0,0,0,6,3,3
193946,21030,210,30,-2,3,2,1,0,0,0,0,0,0,0,0,0,0,0,0,0,0,0,3,2,1,0,0,0,0,0,0,0,0,0
193973,21030,210,30,-2,14,7,7,0,0,0,0,0,0,0,0,0,0,0,0,0,0,0,8,3,5,0,0,0,3,2,1,3,2,1
194028,21030,210,30,-2,1,1,0,0,0,0,0,0,0,0,0,0,0,0,0,0,0,0,1,1,0,0,0,0,0,0,0,0,0,0
194091,21030,210,30,-2,2,2,0,0,0,0,0,0,0,0,0,0,0,0,0,0,0,0,2,2,0,0,0,0,0,0,0,0,0,0
194222,21030,210,30,-2,2,0,2,0,0,0,0,0,0,0,0,0,0,0,0,0,0,0,2,0,2,0,0,0,0,0,0,0,0,0
194310,21030,210,30,-2,5,1,4,0,0,0,1,0,1,0,0,0,0,0,0,0,0,0,4,1,3,0,0,0,0,0,0,0,0,0
194578,21030,210,30,-2,3,1,2,0,0,0,0,0,0,0,0,0,1,0,1,0,0,0,2,1,1,0,0,0,0,0,0,0,0,0
194958,21030,210,30,-2,5,2,3,0,0,0,0,0,0,0,0,0,0,0,0,0,0,0,5,2,3,0,0,0,0,0,0,0,0,0
195003,21030,210,30,-2,27,18,9,0,0,0,5,3,2,0,0,0,2,1,1,0,0,0,11,7,4,1,1,0,1,0,1,7,6,1
195030,21030,210,30,-2,66,32,34,0,0,0,13,9,4,3,1,2,3,2,1,0,0,0,34,15,19,0,0,0,0,0,0,13,5,8
195058,21030,210,30,-2,1,0,1,0,0,0,0,0,0,0,0,0,0,0,0,0,0,0,1,0,1,0,0,0,0,0,0,0,0,0
195128,21030,210,30,-2,3,1,2,0,0,0,0,0,0,0,0,0,0,0,0,0,0,0,3,1,2,0,0,0,0,0,0,0,0,0
195164,21030,210,30,-2,15,6,9,0,0,0,2,2,0,2,1,1,1,0,1,1,1,0,9,2,7,0,0,0,0,0,0,0,0,0
195173,21030,210,30,-2,9,3,6,0,0,0,1,1,0,2,0,2,0,0,0,0,0,0,5,1,4,1,1,0,0,0,0,0,0,0
195216,21030,210,30,-2,1,0,1,0,0,0,0,0,0,0,0,0,0,0,0,0,0,0,0,0,0,0,0,0,0,0,0,1,0,1
195234,21030,210,30,-2,1,1,0,0,0,0,0,0,0,1,1,0,0,0,0,0,0,0,0,0,0,0,0,0,0,0,0,0,0,0
195243,21030,210,30,-2,3,2,1,0,0,0,0,0,0,0,0,0,2,1,1,0,0,0,1,1,0,0,0,0,0,0,0,0,0,0
195304,21030,210,30,-2,3,1,2,0,0,0,0,0,0,1,0,1,2,1,1,0,0,0,0,0,0,0,0,0,0,0,0,0,0,0
195322,21030,210,30,-2,3,1,2,0,0,0,0,0,0,0,0,0,0,0,0,0,0,0,3,1,2,0,0,0,0,0,0,0,0,0
195474,21030,210,30,-2,6,1,5,0,0,0,0,0,0,0,0,0,1,0,1,0,0,0,3,1,2,0,0,0,0,0,0,2,0,2
195544,21030,210,30,-2,6,3,3,0,0,0,0,0,0,0,0,0,0,0,0,0,0,0,0,0,0,0,0,0,6,3,3,0,0,0
195720,21030,210,30,-2,7,3,4,0,0,0,2,1,1,2,1,1,0,0,0,0,0,0,3,1,2,0,0,0,0,0,0,0,0,0
195809,21030,210,30,-2,14,8,6,0,0,0,1,1,0,0,0,0,5,4,1,0,0,0,7,3,4,1,0,1,0,0,0,0,0,0
195988,21030,210,30,-2,2,1,1,0,0,0,0,0,0,0,0,0,0,0,0,0,0,0,2,1,1,0,0,0,0,0,0,0,0,0
196006,21030,210,30,-2,12,7,5,0,0,0,0,0,0,0,0,0,1,1,0,0,0,0,11,6,5,0,0,0,0,0,0,0,0,0
196015,21030,210,30,-2,4,2,2,0,0,0,0,0,0,1,0,1,0,0,0,0,0,0,2,1,1,0,0,0,0,0,0,1,1,0
196024,21030,210,30,-2,5,2,3,0,0,0,0,0,0,0,0,0,0,0,0,0,0,0,4,1,3,1,1,0,0,0,0,0,0,0
196033,21030,210,30,-2,4,1,3,0,0,0,0,0,0,0,0,0,0,0,0,0,0,0,4,1,3,0,0,0,0,0,0,0,0,0
196042,21030,210,30,-2,3,1,2,0,0,0,1,0,1,0,0,0,0,0,0,0,0,0,2,1,1,0,0,0,0,0,0,0,0,0
196051,21030,210,30,-2,3,0,3,0,0,0,0,0,0,0,0,0,0,0,0,0,0,0,3,0,3,0,0,0,0,0,0,0,0,0
196060,21030,210,30,-2,5,3,2,0,0,0,1,1,0,0,0,0,0,0,0,0,0,0,2,1,1,1,0,1,0,0,0,1,1,0
196079,21030,210,30,-2,4,4,0,0,0,0,2,2,0,1,1,0,0,0,0,0,0,0,0,0,0,0,0,0,0,0,0,1,1,0
196088,21030,210,30,-2,16,10,6,0,0,0,3,3,0,0,0,0,1,1,0,0,0,0,9,4,5,0,0,0,0,0,0,3,2,1
196097,21030,210,30,-2,18,12,6,0,0,0,3,2,1,1,1,0,1,1,0,0,0,0,3,3,0,1,0,1,3,2,1,6,3,3
196103,21030,210,30,-2,5,4,1,0,0,0,0,0,0,0,0,0,0,0,0,0,0,0,5,4,1,0,0,0,0,0,0,0,0,0
196112,21030,210,30,-2,2,1,1,0,0,0,1,1,0,0,0,0,0,0,0,0,0,0,0,0,0,0,0,0,0,0,0,1,0,1
196121,21030,210,30,-2,3,0,3,0,0,0,0,0,0,0,0,0,0,0,0,0,0,0,3,0,3,0,0,0,0,0,0,0,0,0
196130,21030,210,30,-2,2,2,0,0,0,0,0,0,0,0,0,0,0,0,0,0,0,0,1,1,0,0,0,0,0,0,0,1,1,0
196149,21030,210,30,-2,6,5,1,0,0,0,0,0,0,5,4,1,0,0,0,0,0,0,1,1,0,0,0,0,0,0,0,0,0,0
196158,21030,210,30,-2,1,1,0,0,0,0,0,0,0,0,0,0,0,0,0,0,0,0,0,0,0,0,0,0,0,0,0,1,1,0
196176,21030,210,30,-2,2,1,1,0,0,0,0,0,0,0,0,0,0,0,0,0,0,0,1,1,0,0,0,0,0,0,0,1,0,1
196185,21030,210,30,-2,11,2,9,0,0,0,1,0,1,1,0,1,1,1,0,0,0,0,5,1,4,0,0,0,0,0,0,3,0,3
196194,21030,210,30,-2,1,0,1,0,0,0,0,0,0,0,0,0,0,0,0,0,0,0,0,0,0,0,0,0,0,0,0,1,0,1
196200,21030,210,30,-2,1,0,1,0,0,0,0,0,0,0,0,0,0,0,0,0,0,0,1,0,1,0,0,0,0,0,0,0,0,0
196219,21030,210,30,-2,2,0,2,0,0,0,0,0,0,0,0,0,0,0,0,0,0,0,2,0,2,0,0,0,0,0,0,0,0,0
196228,21030,210,30,-2,1,0,1,0,0,0,1,0,1,0,0,0,0,0,0,0,0,0,0,0,0,0,0,0,0,0,0,0,0,0
196246,21030,210,30,-2,4,3,1,0,0,0,0,0,0,0,0,0,0,0,0,0,0,0,1,1,0,1,0,1,0,0,0,2,2,0
196255,21030,210,30,-2,6,3,3,0,0,0,0,0,0,4,2,2,0,0,0,0,0,0,2,1,1,0,0,0,0,0,0,0,0,0
196264,21030,210,30,-2,5,2,3,0,0,0,1,0,1,0,0,0,0,0,0,0,0,0,4,2,2,0,0,0,0,0,0,0,0,0
196291,21030,210,30,-2,2,2,0,0,0,0,2,2,0,0,0,0,0,0,0,0,0,0,0,0,0,0,0,0,0,0,0,0,0,0
196307,21030,210,30,-2,3,3,0,0,0,0,0,0,0,0,0,0,0,0,0,0,0,0,2,2,0,0,0,0,0,0,0,1,1,0
196413,21030,210,30,-2,34,13,21,0,0,0,5,1,4,6,3,3,6,4,2,0,0,0,6,2,4,1,0,1,0,0,0,10,3,7
196468,21030,210,30,-2,1,1,0,0,0,0,0,0,0,0,0,0,0,0,0,0,0,0,1,1,0,0,0,0,0,0,0,0,0,0
196565,21030,210,30,-2,1,0,1,0,0,0,0,0,0,0,0,0,0,0,0,0,0,0,1,0,1,0,0,0,0,0,0,0,0,0
196592,21030,210,30,-2,1,0,1,0,0,0,0,0,0,0,0,0,0,0,0,0,0,0,1,0,1,0,0,0,0,0,0,0,0,0
196699,21030,210,30,-2,1,0,1,0,0,0,0,0,0,0,0,0,0,0,0,0,0,0,1,0,1,0,0,0,0,0,0,0,0,0
196866,21030,210,30,-2,2,0,2,0,0,0,0,0,0,0,0,0,0,0,0,0,0,0,0,0,0,0,0,0,0,0,0,2,0,2
197027,21030,210,30,-2,3,3,0,0,0,0,0,0,0,0,0,0,0,0,0,0,0,0,3,3,0,0,0,0,0,0,0,0,0,0
197036,21030,210,30,-2,3,0,3,0,0,0,0,0,0,0,0,0,0,0,0,0,0,0,3,0,3,0,0,0,0,0,0,0,0,0
197045,21030,210,30,-2,10,2,8,0,0,0,1,1,0,1,0,1,0,0,0,0,0,0,7,1,6,1,0,1,0,0,0,0,0,0
197133,21030,210,30,-2,5,2,3,1,0,1,1,0,1,0,0,0,1,1,0,0,0,0,1,1,0,0,0,0,0,0,0,1,0,1
197230,21030,210,30,-2,3,2,1,0,0,0,0,0,0,0,0,0,0,0,0,0,0,0,3,2,1,0,0,0,0,0,0,0,0,0
197294,21030,210,30,-2,3,2,1,0,0,0,0,0,0,0,0,0,0,0,0,0,0,0,3,2,1,0,0,0,0,0,0,0,0,0
197708,21030,210,30,-2,1,0,1,0,0,0,0,0,0,0,0,0,1,0,1,0,0,0,0,0,0,0,0,0,0,0,0,0,0,0
197869,21030,210,30,-2,24,11,13,0,0,0,2,1,1,1,0,1,1,1,0,0,0,0,13,4,9,0,0,0,0,0,0,7,5,2
197911,21030,210,30,-2,6,2,4,0,0,0,0,0,0,2,1,1,0,0,0,0,0,0,3,0,3,0,0,0,1,1,0,0,0,0
197984,21030,210,30,-2,11,5,6,0,0,0,0,0,0,0,0,0,0,0,0,0,0,0,11,5,6,0,0,0,0,0,0,0,0,0
198066,21030,210,30,-2,2,0,2,0,0,0,0,0,0,0,0,0,0,0,0,0,0,0,2,0,2,0,0,0,0,0,0,0,0,0
198136,21030,210,30,-2,11,5,6,0,0,0,1,0,1,1,0,1,2,1,1,0,0,0,7,4,3,0,0,0,0,0,0,0,0,0
198215,21030,210,30,-2,7,1,6,0,0,0,0,0,0,0,0,0,0,0,0,0,0,0,7,1,6,0,0,0,0,0,0,0,0,0
198303,21030,210,30,-2,6,3,3,0,0,0,0,0,0,2,0,2,0,0,0,0,0,0,4,3,1,0,0,0,0,0,0,0,0,0
198385,21030,210,30,-2,5,3,2,0,0,0,0,0,0,1,1,0,2,1,1,0,0,0,1,0,1,0,0,0,1,1,0,0,0,0
198419,21030,210,30,-2,11,6,5,0,0,0,1,0,1,3,2,1,2,0,2,0,0,0,1,1,0,0,0,0,0,0,0,4,3,1
198464,21030,210,30,-2,13,3,10,0,0,0,2,2,0,1,0,1,1,0,1,0,0,0,7,1,6,0,0,0,2,0,2,0,0,0
198507,21030,210,30,-2,3,2,1,0,0,0,0,0,0,1,1,0,0,0,0,0,0,0,2,1,1,0,0,0,0,0,0,0,0,0
198516,21030,210,30,-2,14,6,8,0,0,0,2,1,1,2,0,2,2,1,1,0,0,0,6,3,3,0,0,0,2,1,1,0,0,0
198543,21030,210,30,-2,1,1,0,0,0,0,0,0,0,1,1,0,0,0,0,0,0,0,0,0,0,0,0,0,0,0,0,0,0,0
198561,21030,210,30,-2,1,1,0,0,0,0,0,0,0,0,0,0,0,0,0,0,0,0,1,1,0,0,0,0,0,0,0,0,0,0
198613,21030,210,30,-2,2,1,1,0,0,0,1,0,1,0,0,0,0,0,0,0,0,0,1,1,0,0,0,0,0,0,0,0,0,0
198695,21030,210,30,-2,6,1,5,0,0,0,0,0,0,2,1,1,0,0,0,0,0,0,4,0,4,0,0,0,0,0,0,0,0,0
198835,21030,210,30,-2,7,2,5,0,0,0,1,0,1,1,0,1,0,0,0,0,0,0,3,0,3,1,1,0,1,1,0,0,0,0
198899,21030,210,30,-2,4,2,2,0,0,0,0,0,0,0,0,0,0,0,0,0,0,0,4,2,2,0,0,0,0,0,0,0,0,0
198950,21030,210,30,-2,2,0,2,0,0,0,0,0,0,1,0,1,0,0,0,0,0,0,1,0,1,0,0,0,0,0,0,0,0,0
198969,21030,210,30,-2,15,5,10,0,0,0,2,1,1,1,1,0,0,0,0,0,0,0,10,2,8,1,0,1,1,1,0,0,0,0
199102,21030,210,30,-2,30,16,14,0,0,0,2,2,0,9,2,7,2,1,1,0,0,0,3,3,0,0,0,0,13,8,5,1,0,1
199120,21030,210,30,-2,31,15,16,0,0,0,1,1,0,2,0,2,3,2,1,0,0,0,9,6,3,1,0,1,7,4,3,8,2,6
199139,21030,210,30,-2,15,4,11,0,0,0,0,0,0,5,1,4,2,0,2,0,0,0,7,2,5,0,0,0,0,0,0,1,1,0
199148,21030,210,30,-2,19,7,12,0,0,0,1,0,1,2,1,1,1,1,0,0,0,0,10,2,8,0,0,0,0,0,0,5,3,2
199157,21030,210,30,-2,4,1,3,0,0,0,0,0,0,0,0,0,0,0,0,0,0,0,0,0,0,0,0,0,4,1,3,0,0,0
199193,21030,210,30,-2,39,16,23,1,1,0,7,3,4,2,0,2,2,2,0,0,0,0,15,4,11,0,0,0,2,1,1,10,5,5
199209,21030,210,30,-2,6,4,2,0,0,0,0,0,0,0,0,0,0,0,0,0,0,0,6,4,2,0,0,0,0,0,0,0,0,0
199218,21030,210,30,-2,36,16,20,0,0,0,3,3,0,4,1,3,0,0,0,0,0,0,14,4,10,1,1,0,1,1,0,13,6,7
199281,21030,210,30,-2,15,6,9,0,0,0,1,1,0,1,0,1,0,0,0,0,0,0,11,4,7,0,0,0,0,0,0,2,1,1
199412,21030,210,30,-2,2,1,1,0,0,0,0,0,0,0,0,0,0,0,0,0,0,0,2,1,1,0,0,0,0,0,0,0,0,0
199607,21030,210,30,-2,1,0,1,0,0,0,0,0,0,0,0,0,0,0,0,0,0,0,1,0,1,0,0,0,0,0,0,0,0,0
199847,21030,210,30,-2,13,7,6,0,0,0,2,1,1,1,0,1,2,1,1,0,0,0,6,3,3,1,1,0,0,0,0,1,1,0
199999,21030,210,30,-2,8,4,4,0,0,0,1,0,1,4,2,2,0,0,0,0,0,0,3,2,1,0,0,0,0,0,0,0,0,0
200004,21030,210,30,-2,23,13,10,0,0,0,3,0,3,2,1,1,3,2,1,0,0,0,13,9,4,0,0,0,0,0,0,2,1,1
200022,21030,210,30,-2,2,1,1,1,1,0,0,0,0,0,0,0,0,0,0,0,0,0,1,0,1,0,0,0,0,0,0,0,0,0
200059,21030,210,30,-2,3,3,0,0,0,0,0,0,0,0,0,0,0,0,0,0,0,0,3,3,0,0,0,0,0,0,0,0,0,0
200192,21030,210,30,-2,1,1,0,0,0,0,0,0,0,0,0,0,0,0,0,0,0,0,1,1,0,0,0,0,0,0,0,0,0,0
200253,21030,210,30,-2,8,2,6,0,0,0,0,0,0,0,0,0,0,0,0,0,0,0,8,2,6,0,0,0,0,0,0,0,0,0
200280,21030,210,30,-2,7,5,2,1,1,0,1,0,1,0,0,0,0,0,0,0,0,0,2,1,1,0,0,0,0,0,0,3,3,0
200332,21030,210,30,-2,15,9,6,0,0,0,2,2,0,0,0,0,0,0,0,0,0,0,4,1,3,1,1,0,0,0,0,8,5,3
200572,21030,210,30,-2,4,0,4,0,0,0,0,0,0,0,0,0,0,0,0,0,0,0,4,0,4,0,0,0,0,0,0,0,0,0
200800,21030,210,30,-2,6,3,3,0,0,0,1,0,1,0,0,0,1,1,0,0,0,0,4,2,2,0,0,0,0,0,0,0,0,0
201104,21030,210,30,-2,5,2,3,0,0,0,0,0,0,1,0,1,0,0,0,0,0,0,2,1,1,0,0,0,0,0,0,2,1,1
201195,21030,210,30,-2,9,4,5,0,0,0,0,0,0,1,1,0,0,0,0,0,0,0,8,3,5,0,0,0,0,0,0,0,0,0
201441,21030,210,30,-2,16,9,7,0,0,0,0,0,0,1,0,1,0,0,0,0,0,0,5,1,4,0,0,0,10,8,2,0,0,0
201548,21030,210,30,-2,7,3,4,0,0,0,1,1,0,1,0,1,0,0,0,0,0,0,4,2,2,0,0,0,1,0,1,0,0,0
201645,21030,210,30,-2,7,3,4,0,0,0,1,0,1,0,0,0,0,0,0,0,0,0,4,2,2,0,0,0,0,0,0,2,1,1
201654,21030,210,30,-2,4,1,3,0,0,0,0,0,0,0,0,0,0,0,0,0,0,0,4,1,3,0,0,0,0,0,0,0,0,0
201690,21030,210,30,-2,8,6,2,0,0,0,0,0,0,3,2,1,1,1,0,0,0,0,4,3,1,0,0,0,0,0,0,0,0,0
201885,21030,210,30,-2,24,12,12,0,0,0,2,0,2,2,2,0,0,0,0,0,0,0,12,5,7,0,0,0,0,0,0,8,5,3
201928,21030,210,30,-2,4,0,4,0,0,0,0,0,0,1,0,1,0,0,0,0,0,0,3,0,3,0,0,0,0,0,0,0,0,0
201946,21030,210,30,-2,2,0,2,0,0,0,0,0,0,0,0,0,1,0,1,0,0,0,1,0,1,0,0,0,0,0,0,0,0,0
201955,21030,210,30,-2,2,1,1,0,0,0,0,0,0,0,0,0,0,0,0,0,0,0,1,1,0,0,0,0,1,0,1,0,0,0
202134,21030,210,30,-2,18,10,8,0,0,0,2,1,1,2,0,2,1,1,0,0,0,0,11,7,4,0,0,0,0,0,0,2,1,1
202222,21030,210,30,-2,10,7,3,0,0,0,0,0,0,0,0,0,1,0,1,1,0,1,8,7,1,0,0,0,0,0,0,0,0,0
202480,21030,210,30,-2,18,14,4,0,0,0,4,3,1,2,1,1,0,0,0,0,0,0,8,7,1,0,0,0,0,0,0,4,3,1
202514,21030,210,30,-2,3,0,3,0,0,0,0,0,0,0,0,0,0,0,0,0,0,0,3,0,3,0,0,0,0,0,0,0,0,0
202523,21030,210,30,-2,5,1,4,0,0,0,1,0,1,0,0,0,0,0,0,0,0,0,4,1,3,0,0,0,0,0,0,0,0,0
202763,21030,210,30,-2,4,3,1,0,0,0,1,1,0,1,1,0,0,0,0,0,0,0,2,1,1,0,0,0,0,0,0,0,0,0
203085,21030,210,30,-2,1,1,0,0,0,0,0,0,0,0,0,0,0,0,0,0,0,0,1,1,0,0,0,0,0,0,0,0,0,0
203128,21030,210,30,-2,2,1,1,0,0,0,0,0,0,0,0,0,0,0,0,0,0,0,2,1,1,0,0,0,0,0,0,0,0,0
203368,21030,210,30,-2,1,1,0,0,0,0,0,0,0,0,0,0,0,0,0,0,0,0,1,1,0,0,0,0,0,0,0,0,0,0
203517,21030,210,30,-2,15,7,8,0,0,0,0,0,0,4,0,4,2,2,0,0,0,0,3,1,2,2,1,1,2,2,0,2,1,1
203535,21030,210,30,-2,4,2,2,0,0,0,0,0,0,0,0,0,1,1,0,0,0,0,1,0,1,0,0,0,1,0,1,1,1,0
203599,21030,210,30,-2,3,1,2,0,0,0,0,0,0,0,0,0,0,0,0,0,0,0,2,1,1,0,0,0,1,0,1,0,0,0
203845,21030,210,30,-2,1,1,0,0,0,0,0,0,0,0,0,0,0,0,0,0,0,0,1,1,0,0,0,0,0,0,0,0,0,0
204006,21030,210,30,-2,3,0,3,0,0,0,0,0,0,0,0,0,0,0,0,0,0,0,3,0,3,0,0,0,0,0,0,0,0,0
204015,21030,210,30,-2,1,0,1,0,0,0,0,0,0,0,0,0,0,0,0,0,0,0,0,0,0,0,0,0,1,0,1,0,0,0
204024,21030,210,30,-2,10,7,3,0,0,0,0,0,0,1,0,1,1,1,0,0,0,0,4,2,2,0,0,0,0,0,0,4,4,0
204185,21030,210,30,-2,2,1,1,0,0,0,0,0,0,0,0,0,0,0,0,0,0,0,1,0,1,0,0,0,0,0,0,1,1,0
204200,21030,210,30,-2,6,2,4,0,0,0,2,0,2,0,0,0,0,0,0,0,0,0,4,2,2,0,0,0,0,0,0,0,0,0
204264,21030,210,30,-2,6,1,5,0,0,0,1,0,1,0,0,0,0,0,0,0,0,0,5,1,4,0,0,0,0,0,0,0,0,0
204477,21030,210,30,-2,2,1,1,0,0,0,0,0,0,0,0,0,0,0,0,0,0,0,2,1,1,0,0,0,0,0,0,0,0,0
204501,21030,210,30,-2,7,1,6,0,0,0,1,0,1,1,0,1,1,0,1,0,0,0,3,1,2,0,0,0,1,0,1,0,0,0
204617,21030,210,30,-2,1,1,0,0,0,0,0,0,0,0,0,0,0,0,0,0,0,0,1,1,0,0,0,0,0,0,0,0,0,0
204635,21030,210,30,-2,2,2,0,0,0,0,0,0,0,0,0,0,1,1,0,0,0,0,1,1,0,0,0,0,0,0,0,0,0,0
204796,21030,210,30,-2,50,26,24,0,0,0,13,7,6,3,1,2,2,1,1,0,0,0,25,13,12,2,2,0,1,0,1,4,2,2
204857,21030,210,30,-2,4,1,3,0,0,0,0,0,0,0,0,0,1,0,1,0,0,0,3,1,2,0,0,0,0,0,0,0,0,0
204866,21030,210,30,-2,1,1,0,0,0,0,0,0,0,0,0,0,0,0,0,0,0,0,1,1,0,0,0,0,0,0,0,0,0,0
204909,21030,210,30,-2,6,3,3,0,0,0,1,0,1,2,2,0,1,0,1,0,0,0,2,1,1,0,0,0,0,0,0,0,0,0
205203,21030,210,30,-2,4,2,2,0,0,0,0,0,0,0,0,0,0,0,0,0,0,0,4,2,2,0,0,0,0,0,0,0,0,0
205443,21030,210,30,-2,3,0,3,0,0,0,0,0,0,0,0,0,0,0,0,0,0,0,3,0,3,0,0,0,0,0,0,0,0,0
205470,21030,210,30,-2,11,3,8,0,0,0,0,0,0,1,0,1,0,0,0,0,0,0,10,3,7,0,0,0,0,0,0,0,0,0
205957,21030,210,30,-2,6,4,2,0,0,0,0,0,0,0,0,0,0,0,0,0,0,0,5,3,2,0,0,0,1,1,0,0,0,0
206011,21030,210,30,-2,4,2,2,0,0,0,0,0,0,1,0,1,0,0,0,0,0,0,3,2,1,0,0,0,0,0,0,0,0,0
206084,21030,210,30,-2,8,4,4,0,0,0,1,1,0,0,0,0,1,0,1,0,0,0,6,3,3,0,0,0,0,0,0,0,0,0
206349,21030,210,30,-2,5,4,1,0,0,0,0,0,0,1,1,0,0,0,0,0,0,0,4,3,1,0,0,0,0,0,0,0,0,0
206437,21030,210,30,-2,4,1,3,0,0,0,0,0,0,0,0,0,0,0,0,0,0,0,4,1,3,0,0,0,0,0,0,0,0,0
206491,21030,210,30,-2,1,1,0,0,0,0,0,0,0,1,1,0,0,0,0,0,0,0,0,0,0,0,0,0,0,0,0,0,0,0
206507,21030,210,30,-2,7,2,5,0,0,0,0,0,0,0,0,0,1,0,1,0,0,0,6,2,4,0,0,0,0,0,0,0,0,0
206525,21030,210,30,-2,2,1,1,0,0,0,1,1,0,0,0,0,1,0,1,0,0,0,0,0,0,0,0,0,0,0,0,0,0,0
206589,21030,210,30,-2,5,2,3,0,0,0,0,0,0,2,0,2,0,0,0,0,0,0,0,0,0,0,0,0,1,1,0,2,1,1
206604,21030,210,30,-2,1,1,0,0,0,0,0,0,0,0,0,0,0,0,0,0,0,0,0,0,0,0,0,0,0,0,0,1,1,0
206622,21030,210,30,-2,5,3,2,0,0,0,0,0,0,2,1,1,0,0,0,0,0,0,3,2,1,0,0,0,0,0,0,0,0,0
206695,21030,210,30,-2,12,8,4,0,0,0,0,0,0,0,0,0,1,0,1,0,0,0,8,5,3,0,0,0,0,0,0,3,3,0
206914,21030,210,30,-2,6,2,4,0,0,0,2,1,1,0,0,0,0,0,0,0,0,0,4,1,3,0,0,0,0,0,0,0,0,0
206941,21030,210,30,-2,19,11,8,1,0,1,2,2,0,1,1,0,1,1,0,1,0,1,12,6,6,1,1,0,0,0,0,0,0,0
207041,21030,210,30,-2,5,2,3,0,0,0,1,1,0,0,0,0,0,0,0,0,0,0,3,1,2,0,0,0,1,0,1,0,0,0
207069,21030,210,30,-2,1,0,1,0,0,0,0,0,0,0,0,0,0,0,0,0,0,0,0,0,0,1,0,1,0,0,0,0,0,0
207209,21030,210,30,-2,2,0,2,0,0,0,0,0,0,1,0,1,0,0,0,0,0,0,1,0,1,0,0,0,0,0,0,0,0,0
207236,21030,210,30,-2,9,4,5,2,1,1,0,0,0,0,0,0,1,1,0,0,0,0,6,2,4,0,0,0,0,0,0,0,0,0
207263,21030,210,30,-2,9,5,4,0,0,0,2,0,2,1,1,0,0,0,0,0,0,0,6,4,2,0,0,0,0,0,0,0,0,0
207281,21030,210,30,-2,6,3,3,0,0,0,0,0,0,0,0,0,0,0,0,0,0,0,6,3,3,0,0,0,0,0,0,0,0,0
207306,21030,210,30,-2,3,3,0,0,0,0,0,0,0,0,0,0,0,0,0,0,0,0,3,3,0,0,0,0,0,0,0,0,0,0
207315,21030,210,30,-2,3,2,1,0,0,0,1,0,1,0,0,0,0,0,0,0,0,0,1,1,0,1,1,0,0,0,0,0,0,0
207324,21030,210,30,-2,4,1,3,0,0,0,0,0,0,1,0,1,0,0,0,0,0,0,3,1,2,0,0,0,0,0,0,0,0,0
207342,21030,210,30,-2,5,1,4,0,0,0,1,0,1,0,0,0,1,1,0,0,0,0,2,0,2,0,0,0,0,0,0,1,0,1
207351,21030,210,30,-2,3,1,2,0,0,0,0,0,0,0,0,0,0,0,0,0,0,0,2,1,1,0,0,0,0,0,0,1,0,1
207388,21030,210,30,-2,34,13,21,0,0,0,3,3,0,0,0,0,0,0,0,0,0,0,21,5,16,0,0,0,0,0,0,10,5,5
207397,21030,210,30,-2,6,0,6,1,0,1,0,0,0,2,0,2,0,0,0,0,0,0,3,0,3,0,0,0,0,0,0,0,0,0
207403,21030,210,30,-2,2,1,1,0,0,0,1,0,1,0,0,0,0,0,0,0,0,0,1,1,0,0,0,0,0,0,0,0,0,0
207458,21030,210,30,-2,6,2,4,0,0,0,1,1,0,0,0,0,0,0,0,0,0,0,4,1,3,0,0,0,0,0,0,1,0,1
207500,21030,210,30,-2,52,29,23,0,0,0,3,3,0,0,0,0,2,2,0,0,0,0,23,9,14,0,0,0,6,4,2,18,11,7
207661,21030,210,30,-2,3,0,3,1,0,1,0,0,0,0,0,0,0,0,0,0,0,0,2,0,2,0,0,0,0,0,0,0,0,0
207670,21030,210,30,-2,17,7,10,0,0,0,2,1,1,0,0,0,0,0,0,0,0,0,15,6,9,0,0,0,0,0,0,0,0,0
207740,21030,210,30,-2,1,1,0,0,0,0,0,0,0,0,0,0,0,0,0,0,0,0,1,1,0,0,0,0,0,0,0,0,0,0
207847,21030,210,30,-2,7,4,3,0,0,0,0,0,0,0,0,0,0,0,0,0,0,0,5,4,1,0,0,0,0,0,0,2,0,2
207865,21030,210,30,-2,2,2,0,0,0,0,0,0,0,0,0,0,0,0,0,0,0,0,2,2,0,0,0,0,0,0,0,0,0,0
207971,21030,210,30,-2,2,1,1,0,0,0,0,0,0,1,1,0,0,0,0,0,0,0,0,0,0,1,0,1,0,0,0,0,0,0
208035,21030,210,30,-2,5,0,5,0,0,0,0,0,0,0,0,0,2,0,2,0,0,0,3,0,3,0,0,0,0,0,0,0,0,0
208318,21030,210,30,-2,5,1,4,0,0,0,1,1,0,0,0,0,1,0,1,0,0,0,3,0,3,0,0,0,0,0,0,0,0,0
208646,21030,210,30,-2,7,3,4,0,0,0,2,1,1,0,0,0,0,0,0,0,0,0,4,1,3,0,0,0,1,1,0,0,0,0
208822,21030,210,30,-2,18,9,9,0,0,0,1,1,0,1,1,0,1,1,0,0,0,0,13,4,9,1,1,0,1,1,0,0,0,0
209065,21030,210,30,-2,6,0,6,0,0,0,1,0,1,0,0,0,0,0,0,0,0,0,4,0,4,0,0,0,1,0,1,0,0,0
209506,21030,210,30,-2,4,2,2,0,0,0,2,1,1,0,0,0,0,0,0,0,0,0,1,0,1,0,0,0,0,0,0,1,1,0
209542,21030,210,30,-2,23,12,11,0,0,0,2,1,1,1,1,0,2,2,0,0,0,0,2,2,0,0,0,0,8,3,5,8,3,5
209551,21030,210,30,-2,7,4,3,0,0,0,0,0,0,2,1,1,0,0,0,0,0,0,3,1,2,0,0,0,0,0,0,2,2,0
209612,21030,210,30,-2,5,2,3,0,0,0,0,0,0,0,0,0,1,1,0,0,0,0,4,1,3,0,0,0,0,0,0,0,0,0
209746,21030,210,30,-2,7,2,5,0,0,0,1,0,1,1,1,0,0,0,0,0,0,0,4,1,3,0,0,0,1,0,1,0,0,0
209807,21030,210,30,-2,15,6,9,0,0,0,2,1,1,2,0,2,3,2,1,0,0,0,6,2,4,0,0,0,0,0,0,2,1,1
209825,21030,210,30,-2,4,2,2,0,0,0,0,0,0,0,0,0,0,0,0,0,0,0,0,0,0,0,0,0,1,0,1,3,2,1
209922,21030,210,30,-2,2,1,1,0,0,0,0,0,0,0,0,0,0,0,0,0,0,0,2,1,1,0,0,0,0,0,0,0,0,0
210146,21030,210,30,-2,5,4,1,0,0,0,1,0,1,0,0,0,0,0,0,0,0,0,4,4,0,0,0,0,0,0,0,0,0,0
210155,21030,210,30,-2,4,1,3,0,0,0,0,0,0,0,0,0,0,0,0,0,0,0,3,1,2,0,0,0,1,0,1,0,0,0
210234,21030,210,30,-2,4,1,3,0,0,0,0,0,0,0,0,0,0,0,0,0,0,0,3,1,2,0,0,0,1,0,1,0,0,0
210401,21030,210,30,-2,3,3,0,0,0,0,0,0,0,0,0,0,0,0,0,0,0,0,3,3,0,0,0,0,0,0,0,0,0,0
210429,21030,210,30,-2,1,0,1,0,0,0,0,0,0,0,0,0,0,0,0,0,0,0,1,0,1,0,0,0,0,0,0,0,0,0
210438,21030,210,30,-2,1,0,1,0,0,0,0,0,0,0,0,0,0,0,0,0,0,0,1,0,1,0,0,0,0,0,0,0,0,0
210571,21030,210,30,-2,2,1,1,0,0,0,0,0,0,0,0,0,0,0,0,0,0,0,1,0,1,1,1,0,0,0,0,0,0,0
210605,21030,210,30,-2,11,3,8,0,0,0,1,0,1,1,0,1,0,0,0,0,0,0,9,3,6,0,0,0,0,0,0,0,0,0
210669,21030,210,30,-2,2,0,2,0,0,0,1,0,1,1,0,1,0,0,0,0,0,0,0,0,0,0,0,0,0,0,0,0,0,0
210739,21030,210,30,-2,5,3,2,0,0,0,0,0,0,1,0,1,0,0,0,0,0,0,4,3,1,0,0,0,0,0,0,0,0,0
210775,21030,210,30,-2,7,3,4,0,0,0,0,0,0,0,0,0,0,0,0,0,0,0,6,3,3,1,0,1,0,0,0,0,0,0
211079,21030,210,30,-2,3,2,1,0,0,0,0,0,0,0,0,0,0,0,0,0,0,0,3,2,1,0,0,0,0,0,0,0,0,0
211158,21030,210,30,-2,4,1,3,0,0,0,0,0,0,0,0,0,0,0,0,0,0,0,4,1,3,0,0,0,0,0,0,0,0,0
211273,21030,210,30,-2,7,1,6,0,0,0,2,0,2,1,0,1,0,0,0,0,0,0,1,0,1,1,0,1,2,1,1,0,0,0
211291,21030,210,30,-2,8,3,5,0,0,0,2,0,2,0,0,0,0,0,0,0,0,0,3,1,2,0,0,0,1,0,1,2,2,0
211352,21030,210,30,-2,2,1,1,0,0,0,1,1,0,0,0,0,0,0,0,0,0,0,1,0,1,0,0,0,0,0,0,0,0,0
211361,21030,210,30,-2,1,0,1,0,0,0,0,0,0,0,0,0,0,0,0,0,0,0,1,0,1,0,0,0,0,0,0,0,0,0
211431,21030,210,30,-2,4,0,4,0,0,0,0,0,0,0,0,0,0,0,0,0,0,0,4,0,4,0,0,0,0,0,0,0,0,0
211440,21030,210,30,-2,30,20,10,0,0,0,7,4,3,4,2,2,2,2,0,0,0,0,6,4,2,0,0,0,0,0,0,11,8,3
211468,21030,210,30,-2,1,0,1,0,0,0,0,0,0,1,0,1,0,0,0,0,0,0,0,0,0,0,0,0,0,0,0,0,0,0
211608,21030,210,30,-2,1,1,0,0,0,0,0,0,0,1,1,0,0,0,0,0,0,0,0,0,0,0,0,0,0,0,0,0,0,0
211927,21030,210,30,-2,1,0,1,0,0,0,0,0,0,0,0,0,0,0,0,0,0,0,1,0,1,0,0,0,0,0,0,0,0,0
212009,21030,210,30,-2,5,3,2,0,0,0,1,1,0,1,0,1,1,1,0,0,0,0,1,0,1,0,0,0,0,0,0,1,1,0
212054,21030,210,30,-2,9,4,5,0,0,0,0,0,0,2,1,1,0,0,0,0,0,0,2,1,1,0,0,0,0,0,0,5,2,3
212106,21030,210,30,-2,6,3,3,0,0,0,0,0,0,0,0,0,0,0,0,0,0,0,5,2,3,0,0,0,0,0,0,1,1,0
212115,21030,210,30,-2,1,1,0,0,0,0,0,0,0,0,0,0,0,0,0,0,0,0,0,0,0,0,0,0,0,0,0,1,1,0
212133,21030,210,30,-2,13,3,10,0,0,0,1,1,0,3,2,1,0,0,0,0,0,0,9,0,9,0,0,0,0,0,0,0,0,0
212160,21030,210,30,-2,1,0,1,0,0,0,0,0,0,0,0,0,0,0,0,0,0,0,1,0,1,0,0,0,0,0,0,0,0,0
212197,21030,210,30,-2,1,0,1,0,0,0,0,0,0,0,0,0,0,0,0,0,0,0,0,0,0,0,0,0,1,0,1,0,0,0
212577,21030,210,30,-2,1,1,0,0,0,0,1,1,0,0,0,0,0,0,0,0,0,0,0,0,0,0,0,0,0,0,0,0,0,0
212601,21030,210,30,-2,20,6,14,0,0,0,4,2,2,1,1,0,0,0,0,0,0,0,15,3,12,0,0,0,0,0,0,0,0,0
212656,21030,210,30,-2,1,0,1,0,0,0,0,0,0,1,0,1,0,0,0,0,0,0,0,0,0,0,0,0,0,0,0,0,0,0
212674,21030,210,30,-2,3,1,2,0,0,0,1,0,1,0,0,0,0,0,0,0,0,0,1,1,0,0,0,0,0,0,0,1,0,1
212878,21030,210,30,-2,2,1,1,0,0,0,0,0,0,1,1,0,0,0,0,0,0,0,1,0,1,0,0,0,0,0,0,0,0,0
212911,21030,210,30,-2,2,1,1,0,0,0,0,0,0,1,0,1,0,0,0,0,0,0,0,0,0,0,0,0,0,0,0,1,1,0
213011,21030,210,30,-2,6,2,4,0,0,0,0,0,0,0,0,0,0,0,0,0,0,0,4,1,3,1,1,0,1,0,1,0,0,0
213303,21030,210,30,-2,3,1,2,0,0,0,0,0,0,0,0,0,0,0,0,0,0,0,3,1,2,0,0,0,0,0,0,0,0,0
213321,21030,210,30,-2,2,2,0,0,0,0,0,0,0,0,0,0,0,0,0,0,0,0,2,2,0,0,0,0,0,0,0,0,0,0
213367,21030,210,30,-2,2,1,1,0,0,0,0,0,0,0,0,0,0,0,0,0,0,0,2,1,1,0,0,0,0,0,0,0,0,0
213385,21030,210,30,-2,8,5,3,0,0,0,0,0,0,1,1,0,0,0,0,0,0,0,5,2,3,0,0,0,0,0,0,2,2,0
213507,21030,210,30,-2,1,1,0,0,0,0,0,0,0,0,0,0,0,0,0,0,0,0,1,1,0,0,0,0,0,0,0,0,0,0
213543,21030,210,30,-2,16,10,6,0,0,0,2,0,2,0,0,0,0,0,0,0,0,0,5,4,1,0,0,0,1,1,0,8,5,3
213598,21030,210,30,-2,5,1,4,0,0,0,0,0,0,4,1,3,1,0,1,0,0,0,0,0,0,0,0,0,0,0,0,0,0,0
213631,21030,210,30,-2,1,0,1,0,0,0,0,0,0,1,0,1,0,0,0,0,0,0,0,0,0,0,0,0,0,0,0,0,0,0
213668,21030,210,30,-2,6,2,4,0,0,0,0,0,0,0,0,0,3,1,2,0,0,0,2,0,2,0,0,0,1,1,0,0,0,0
213826,21030,210,30,-2,6,2,4,0,0,0,2,1,1,1,0,1,1,1,0,0,0,0,2,0,2,0,0,0,0,0,0,0,0,0
213987,21030,210,30,-2,8,2,6,0,0,0,1,0,1,0,0,0,0,0,0,0,0,0,7,2,5,0,0,0,0,0,0,0,0,0
213996,21030,210,30,-2,5,3,2,0,0,0,0,0,0,1,0,1,1,1,0,0,0,0,3,2,1,0,0,0,0,0,0,0,0,0
214041,21030,210,30,-2,6,1,5,0,0,0,0,0,0,0,0,0,0,0,0,0,0,0,5,0,5,0,0,0,1,1,0,0,0,0
214111,21030,210,30,-2,2,0,2,0,0,0,0,0,0,0,0,0,0,0,0,0,0,0,1,0,1,0,0,0,1,0,1,0,0,0
214157,21030,210,30,-2,2,1,1,0,0,0,0,0,0,1,1,0,0,0,0,0,0,0,0,0,0,0,0,0,0,0,0,1,0,1
214175,21030,210,30,-2,5,3,2,0,0,0,1,0,1,0,0,0,0,0,0,0,0,0,3,2,1,0,0,0,0,0,0,1,1,0
214379,21030,210,30,-2,2,2,0,0,0,0,1,1,0,0,0,0,0,0,0,0,0,0,1,1,0,0,0,0,0,0,0,0,0,0
215062,21030,210,30,-2,33,17,16,0,0,0,6,2,4,2,2,0,2,0,2,0,0,0,17,9,8,0,0,0,1,1,0,5,3,2
215123,21030,210,30,-2,4,2,2,0,0,0,0,0,0,1,1,0,0,0,0,0,0,0,3,1,2,0,0,0,0,0,0,0,0,0
215132,21030,210,30,-2,3,2,1,0,0,0,2,1,1,0,0,0,0,0,0,0,0,0,1,1,0,0,0,0,0,0,0,0,0,0
215239,21030,210,30,-2,11,6,5,0,0,0,2,1,1,3,2,1,2,1,1,0,0,0,4,2,2,0,0,0,0,0,0,0,0,0
215266,21030,210,30,-2,4,3,1,0,0,0,0,0,0,1,1,0,0,0,0,0,0,0,0,0,0,0,0,0,1,0,1,2,2,0
215293,21030,210,30,-2,44,24,20,0,0,0,8,6,2,3,0,3,2,0,2,0,0,0,16,10,6,2,0,2,4,2,2,9,6,3
215424,21030,210,30,-2,1,0,1,0,0,0,0,0,0,1,0,1,0,0,0,0,0,0,0,0,0,0,0,0,0,0,0,0,0,0
215442,21030,210,30,-2,1,0,1,0,0,0,0,0,0,0,0,0,0,0,0,0,0,0,1,0,1,0,0,0,0,0,0,0,0,0
215655,21030,210,30,-2,6,3,3,0,0,0,0,0,0,0,0,0,1,0,1,0,0,0,1,0,1,0,0,0,0,0,0,4,3,1
215743,21030,210,30,-2,2,2,0,0,0,0,0,0,0,0,0,0,0,0,0,0,0,0,2,2,0,0,0,0,0,0,0,0,0,0
215770,21030,210,30,-2,2,0,2,0,0,0,1,0,1,0,0,0,0,0,0,0,0,0,1,0,1,0,0,0,0,0,0,0,0,0
215798,21030,210,30,-2,1,1,0,0,0,0,0,0,0,0,0,0,0,0,0,0,0,0,1,1,0,0,0,0,0,0,0,0,0,0
215929,21030,210,30,-2,6,2,4,0,0,0,0,0,0,2,0,2,0,0,0,0,0,0,1,0,1,0,0,0,0,0,0,3,2,1
215947,21030,210,30,-2,5,0,5,0,0,0,0,0,0,0,0,0,0,0,0,0,0,0,4,0,4,0,0,0,0,0,0,1,0,1
216010,21030,210,30,-2,1,1,0,0,0,0,0,0,0,1,1,0,0,0,0,0,0,0,0,0,0,0,0,0,0,0,0,0,0,0
216038,21030,210,30,-2,6,3,3,0,0,0,1,1,0,1,0,1,0,0,0,0,0,0,4,2,2,0,0,0,0,0,0,0,0,0
216278,21030,210,30,-2,7,4,3,0,0,0,1,1,0,1,0,1,0,0,0,0,0,0,4,3,1,0,0,0,0,0,0,1,0,1
216287,21030,210,30,-2,6,0,6,1,0,1,1,0,1,1,0,1,0,0,0,0,0,0,2,0,2,0,0,0,0,0,0,1,0,1
216296,21030,210,30,-2,8,7,1,0,0,0,2,2,0,0,0,0,0,0,0,0,0,0,6,5,1,0,0,0,0,0,0,0,0,0
216339,21030,210,30,-2,20,10,10,0,0,0,3,3,0,4,2,2,1,0,1,0,0,0,8,4,4,1,0,1,2,0,2,1,1,0
216357,21030,210,30,-2,3,2,1,0,0,0,0,0,0,0,0,0,0,0,0,0,0,0,3,2,1,0,0,0,0,0,0,0,0,0
216524,21030,210,30,-2,3,2,1,0,0,0,0,0,0,0,0,0,0,0,0,0,0,0,2,1,1,0,0,0,0,0,0,1,1,0
216597,21030,210,30,-2,13,6,7,0,0,0,2,1,1,2,2,0,1,1,0,0,0,0,5,2,3,2,0,2,0,0,0,1,0,1
216667,21030,210,30,-2,1,0,1,0,0,0,0,0,0,0,0,0,0,0,0,0,0,0,1,0,1,0,0,0,0,0,0,0,0,0
216694,21030,210,30,-2,4,2,2,0,0,0,0,0,0,0,0,0,1,0,1,0,0,0,3,2,1,0,0,0,0,0,0,0,0,0
216764,21030,210,30,-2,23,10,13,0,0,0,4,4,0,5,2,3,0,0,0,0,0,0,12,3,9,1,0,1,0,0,0,1,1,0
216807,21030,210,30,-2,4,2,2,0,0,0,0,0,0,0,0,0,0,0,0,0,0,0,4,2,2,0,0,0,0,0,0,0,0,0
216852,21030,210,30,-2,22,6,16,0,0,0,3,1,2,3,0,3,1,1,0,0,0,0,9,1,8,0,0,0,0,0,0,6,3,3
216931,21030,210,30,-2,3,1,2,1,0,1,0,0,0,1,1,0,0,0,0,0,0,0,1,0,1,0,0,0,0,0,0,0,0,0
217059,21030,210,30,-2,4,2,2,0,0,0,2,1,1,0,0,0,0,0,0,0,0,0,1,0,1,0,0,0,0,0,0,1,1,0
217156,21030,210,30,-2,29,16,13,0,0,0,4,2,2,5,2,3,4,2,2,0,0,0,11,7,4,1,1,0,2,1,1,2,1,1
217165,21030,210,30,-2,2,0,2,0,0,0,1,0,1,0,0,0,0,0,0,0,0,0,0,0,0,0,0,0,0,0,0,1,0,1
217402,21030,210,30,-2,10,2,8,0,0,0,0,0,0,3,1,2,0,0,0,0,0,0,5,0,5,1,1,0,0,0,0,1,0,1
217484,21030,210,30,-2,13,5,8,0,0,0,1,0,1,2,0,2,1,1,0,0,0,0,6,2,4,0,0,0,0,0,0,3,2,1
217518,21030,210,30,-2,3,1,2,0,0,0,0,0,0,0,0,0,0,0,0,0,0,0,2,1,1,0,0,0,0,0,0,1,0,1
217536,21030,210,30,-2,5,2,3,0,0,0,1,1,0,0,0,0,0,0,0,0,0,0,4,1,3,0,0,0,0,0,0,0,0,0
217633,21030,210,30,-2,8,5,3,0,0,0,0,0,0,1,0,1,1,0,1,0,0,0,6,5,1,0,0,0,0,0,0,0,0,0
217688,21030,210,30,-2,3,2,1,0,0,0,0,0,0,0,0,0,0,0,0,0,0,0,3,2,1,0,0,0,0,0,0,0,0,0
217721,21030,210,30,-2,7,5,2,0,0,0,1,1,0,5,4,1,1,0,1,0,0,0,0,0,0,0,0,0,0,0,0,0,0,0
217776,21030,210,30,-2,3,2,1,0,0,0,0,0,0,0,0,0,0,0,0,0,0,0,3,2,1,0,0,0,0,0,0,0,0,0
217819,21030,210,30,-2,18,7,11,0,0,0,0,0,0,2,1,1,2,1,1,1,0,1,7,2,5,0,0,0,0,0,0,6,3,3
217864,21030,210,30,-2,10,6,4,0,0,0,0,0,0,0,0,0,1,0,1,0,0,0,1,1,0,1,0,1,6,4,2,1,1,0
217873,21030,210,30,-2,10,5,5,0,0,0,1,1,0,6,2,4,1,1,0,0,0,0,2,1,1,0,0,0,0,0,0,0,0,0
217882,21030,210,30,-2,19,11,8,0,0,0,4,3,1,0,0,0,0,0,0,0,0,0,7,4,3,0,0,0,0,0,0,8,4,4
217934,21030,210,30,-2,1,1,0,0,0,0,0,0,0,0,0,0,0,0,0,0,0,0,1,1,0,0,0,0,0,0,0,0,0,0
217961,21030,210,30,-2,4,0,4,0,0,0,0,0,0,0,0,0,1,0,1,0,0,0,3,0,3,0,0,0,0,0,0,0,0,0
217998,21030,210,30,-2,4,2,2,0,0,0,0,0,0,0,0,0,0,0,0,0,0,0,4,2,2,0,0,0,0,0,0,0,0,0
218061,21030,210,30,-2,4,4,0,0,0,0,0,0,0,0,0,0,0,0,0,0,0,0,4,4,0,0,0,0,0,0,0,0,0,0
218070,21030,210,30,-2,8,2,6,0,0,0,2,1,1,3,1,2,0,0,0,0,0,0,3,0,3,0,0,0,0,0,0,0,0,0
218238,21030,210,30,-2,6,1,5,0,0,0,0,0,0,2,0,2,0,0,0,0,0,0,4,1,3,0,0,0,0,0,0,0,0,0
218335,21030,210,30,-2,3,0,3,0,0,0,0,0,0,0,0,0,0,0,0,0,0,0,3,0,3,0,0,0,0,0,0,0,0,0
218414,21030,210,30,-2,5,4,1,0,0,0,0,0,0,4,3,1,0,0,0,0,0,0,1,1,0,0,0,0,0,0,0,0,0,0
218539,21030,210,30,-2,8,3,5,0,0,0,2,1,1,2,0,2,0,0,0,0,0,0,4,2,2,0,0,0,0,0,0,0,0,0
218645,21030,210,30,-2,7,3,4,0,0,0,1,0,1,0,0,0,0,0,0,0,0,0,6,3,3,0,0,0,0,0,0,0,0,0
218654,21030,210,30,-2,1,1,0,0,0,0,0,0,0,0,0,0,0,0,0,0,0,0,1,1,0,0,0,0,0,0,0,0,0,0
218663,21030,210,30,-2,27,15,12,0,0,0,3,3,0,5,3,2,2,0,2,0,0,0,9,4,5,1,1,0,1,0,1,6,4,2
218690,21030,210,30,-2,1,0,1,0,0,0,0,0,0,0,0,0,1,0,1,0,0,0,0,0,0,0,0,0,0,0,0,0,0,0
218724,21030,210,30,-2,23,13,10,0,0,0,3,3,0,2,1,1,1,0,1,0,0,0,15,8,7,1,1,0,1,0,1,0,0,0
218733,21030,210,30,-2,3,3,0,0,0,0,0,0,0,3,3,0,0,0,0,0,0,0,0,0,0,0,0,0,0,0,0,0,0,0
218919,21030,210,30,-2,4,3,1,0,0,0,0,0,0,4,3,1,0,0,0,0,0,0,0,0,0,0,0,0,0,0,0,0,0,0
218964,21030,210,30,-2,1,0,1,0,0,0,0,0,0,0,0,0,0,0,0,0,0,0,1,0,1,0,0,0,0,0,0,0,0,0
218973,21030,210,30,-2,5,1,4,0,0,0,1,0,1,1,0,1,0,0,0,0,0,0,3,1,2,0,0,0,0,0,0,0,0,0
219000,21030,210,30,-2,4,2,2,0,0,0,1,1,0,1,0,1,0,0,0,0,0,0,1,0,1,1,1,0,0,0,0,0,0,0
219046,21030,210,30,-2,4,4,0,0,0,0,0,0,0,0,0,0,0,0,0,0,0,0,4,4,0,0,0,0,0,0,0,0,0,0
219082,21030,210,30,-2,5,4,1,0,0,0,1,1,0,0,0,0,0,0,0,0,0,0,4,3,1,0,0,0,0,0,0,0,0,0
219091,21030,210,30,-2,2,1,1,0,0,0,0,0,0,0,0,0,0,0,0,0,0,0,2,1,1,0,0,0,0,0,0,0,0,0
219198,21030,210,30,-2,2,1,1,0,0,0,0,0,0,0,0,0,0,0,0,0,0,0,2,1,1,0,0,0,0,0,0,0,0,0
219259,21030,210,30,-2,8,2,6,0,0,0,0,0,0,1,0,1,0,0,0,0,0,0,5,2,3,0,0,0,0,0,0,2,0,2
219347,21030,210,30,-2,11,10,1,0,0,0,1,1,0,0,0,0,0,0,0,0,0,0,5,5,0,0,0,0,0,0,0,5,4,1
219356,21030,210,30,-2,15,9,6,1,0,1,2,2,0,0,0,0,0,0,0,0,0,0,5,2,3,0,0,0,0,0,0,7,5,2
219383,21030,210,30,-2,1,1,0,0,0,0,0,0,0,0,0,0,0,0,0,0,0,0,1,1,0,0,0,0,0,0,0,0,0,0
219471,21030,210,30,-2,12,7,5,0,0,0,3,2,1,0,0,0,2,1,1,0,0,0,4,3,1,0,0,0,0,0,0,3,1,2
219602,21030,210,30,-2,14,6,8,0,0,0,0,0,0,3,1,2,0,0,0,0,0,0,9,4,5,0,0,0,1,0,1,1,1,0
219709,21030,210,30,-2,14,9,5,0,0,0,0,0,0,3,2,1,0,0,0,0,0,0,9,7,2,0,0,0,0,0,0,2,0,2
219806,21030,210,30,-2,5,2,3,0,0,0,0,0,0,0,0,0,0,0,0,0,0,0,5,2,3,0,0,0,0,0,0,0,0,0
219824,21030,210,30,-2,7,3,4,1,1,0,1,0,1,0,0,0,0,0,0,0,0,0,5,2,3,0,0,0,0,0,0,0,0,0
219833,21030,210,30,-2,3,1,2,0,0,0,0,0,0,1,0,1,0,0,0,0,0,0,2,1,1,0,0,0,0,0,0,0,0,0
219879,21030,210,30,-2,5,2,3,0,0,0,0,0,0,0,0,0,0,0,0,0,0,0,5,2,3,0,0,0,0,0,0,0,0,0
219976,21030,210,30,-2,12,6,6,0,0,0,1,0,1,1,1,0,0,0,0,0,0,0,9,4,5,0,0,0,1,1,0,0,0,0
220057,21030,210,30,-2,3,2,1,0,0,0,0,0,0,1,1,0,0,0,0,0,0,0,1,0,1,0,0,0,1,1,0,0,0,0
220075,21030,210,30,-2,24,11,13,0,0,0,0,0,0,2,0,2,0,0,0,0,0,0,16,6,10,0,0,0,0,0,0,6,5,1
220215,21030,210,30,-2,5,2,3,0,0,0,0,0,0,1,1,0,0,0,0,0,0,0,4,1,3,0,0,0,0,0,0,0,0,0
220604,21030,210,30,-2,4,0,4,0,0,0,0,0,0,4,0,4,0,0,0,0,0,0,0,0,0,0,0,0,0,0,0,0,0,0
220613,21030,210,30,-2,5,3,2,0,0,0,1,0,1,0,0,0,0,0,0,0,0,0,4,3,1,0,0,0,0,0,0,0,0,0
220710,21030,210,30,-2,2,0,2,0,0,0,0,0,0,0,0,0,0,0,0,0,0,0,2,0,2,0,0,0,0,0,0,0,0,0
220862,21030,210,30,-2,20,8,12,0,0,0,4,2,2,3,0,3,1,1,0,0,0,0,10,3,7,0,0,0,1,1,0,1,1,0
220978,21030,210,30,-2,18,6,12,0,0,0,0,0,0,2,0,2,1,1,0,0,0,0,10,2,8,0,0,0,0,0,0,5,3,2
221096,21030,210,30,-2,3,2,1,0,0,0,0,0,0,0,0,0,0,0,0,0,0,0,3,2,1,0,0,0,0,0,0,0,0,0
221351,21030,210,30,-2,3,2,1,0,0,0,0,0,0,0,0,0,0,0,0,0,0,0,1,1,0,0,0,0,0,0,0,2,1,1
221397,21030,210,30,-2,13,4,9,0,0,0,0,0,0,0,0,0,0,0,0,0,0,0,12,4,8,0,0,0,1,0,1,0,0,0
221485,21030,210,30,-2,4,3,1,0,0,0,0,0,0,1,1,0,1,0,1,0,0,0,2,2,0,0,0,0,0,0,0,0,0,0
221519,21030,210,30,-2,1,0,1,0,0,0,0,0,0,0,0,0,0,0,0,0,0,0,1,0,1,0,0,0,0,0,0,0,0,0
221643,21030,210,30,-2,3,2,1,0,0,0,0,0,0,1,1,0,0,0,0,0,0,0,0,0,0,1,0,1,1,1,0,0,0,0
221731,21030,210,30,-2,2,0,2,0,0,0,0,0,0,0,0,0,0,0,0,0,0,0,2,0,2,0,0,0,0,0,0,0,0,0
221740,21030,210,30,-2,10,3,7,0,0,0,1,1,0,1,0,1,0,0,0,0,0,0,4,1,3,0,0,0,0,0,0,4,1,3
221759,21030,210,30,-2,37,16,21,1,0,1,3,3,0,10,4,6,3,0,3,0,0,0,14,6,8,0,0,0,0,0,0,6,3,3
221768,21030,210,30,-2,6,1,5,0,0,0,0,0,0,1,0,1,0,0,0,0,0,0,4,1,3,0,0,0,0,0,0,1,0,1
221838,21030,210,30,-2,25,11,14,0,0,0,2,2,0,8,3,5,2,0,2,0,0,0,11,5,6,0,0,0,0,0,0,2,1,1
221847,21030,210,30,-2,15,4,11,0,0,0,0,0,0,0,0,0,0,0,0,0,0,0,11,1,10,0,0,0,0,0,0,4,3,1
221892,21030,210,30,-2,5,4,1,0,0,0,1,1,0,0,0,0,0,0,0,0,0,0,4,3,1,0,0,0,0,0,0,0,0,0
221971,21030,210,30,-2,17,9,8,0,0,0,0,0,0,2,2,0,0,0,0,0,0,0,15,7,8,0,0,0,0,0,0,0,0,0
221999,21030,210,30,-2,24,10,14,0,0,0,0,0,0,1,1,0,0,0,0,0,0,0,5,3,2,0,0,0,13,4,9,5,2,3
222053,21030,210,30,-2,7,6,1,0,0,0,0,0,0,3,2,1,0,0,0,0,0,0,4,4,0,0,0,0,0,0,0,0,0,0
222062,21030,210,30,-2,14,7,7,0,0,0,0,0,0,0,0,0,0,0,0,0,0,0,14,7,7,0,0,0,0,0,0,0,0,0
222178,21030,210,30,-2,7,5,2,0,0,0,0,0,0,0,0,0,1,0,1,0,0,0,5,4,1,0,0,0,1,1,0,0,0,0
222567,21030,210,30,-2,9,4,5,0,0,0,0,0,0,1,1,0,1,1,0,0,0,0,5,1,4,0,0,0,2,1,1,0,0,0
222576,21030,210,30,-2,10,5,5,0,0,0,0,0,0,0,0,0,2,0,2,0,0,0,8,5,3,0,0,0,0,0,0,0,0,0
222831,21030,210,30,-2,16,5,11,0,0,0,3,0,3,1,1,0,1,1,0,0,0,0,11,3,8,0,0,0,0,0,0,0,0,0
222983,21030,210,30,-2,3,2,1,0,0,0,0,0,0,1,0,1,0,0,0,0,0,0,2,2,0,0,0,0,0,0,0,0,0,0
223223,21030,210,30,-2,54,24,30,0,0,0,21,13,8,2,0,2,2,1,1,0,0,0,20,7,13,2,1,1,7,2,5,0,0,0
223232,21030,210,30,-2,4,3,1,0,0,0,1,1,0,0,0,0,0,0,0,0,0,0,2,1,1,0,0,0,0,0,0,1,1,0
224147,21030,210,30,-2,16,5,11,0,0,0,3,1,2,1,0,1,2,1,1,0,0,0,8,2,6,1,1,0,0,0,0,1,0,1
224305,21030,210,30,-2,3,3,0,0,0,0,1,1,0,0,0,0,0,0,0,0,0,0,2,2,0,0,0,0,0,0,0,0,0,0
224350,21030,210,30,-2,8,6,2,0,0,0,1,1,0,0,0,0,2,2,0,0,0,0,5,3,2,0,0,0,0,0,0,0,0,0
224545,21030,210,30,-2,2,1,1,0,0,0,0,0,0,0,0,0,0,0,0,0,0,0,1,0,1,0,0,0,0,0,0,1,1,0
224554,21030,210,30,-2,23,8,15,0,0,0,0,0,0,2,0,2,2,1,1,0,0,0,11,4,7,0,0,0,1,0,1,7,3,4
224642,21030,210,30,-2,12,2,10,0,0,0,0,0,0,0,0,0,9,1,8,0,0,0,1,0,1,0,0,0,0,0,0,2,1,1
224712,21030,210,30,-2,2,0,2,0,0,0,1,0,1,1,0,1,0,0,0,0,0,0,0,0,0,0,0,0,0,0,0,0,0,0
224961,21030,210,30,-2,6,2,4,0,0,0,1,1,0,1,0,1,4,1,3,0,0,0,0,0,0,0,0,0,0,0,0,0,0,0
225432,21030,210,30,-2,17,8,9,0,0,0,0,0,0,1,1,0,5,2,3,0,0,0,5,3,2,0,0,0,0,0,0,6,2,4
225502,21030,210,30,-2,4,0,4,0,0,0,0,0,0,2,0,2,1,0,1,0,0,0,1,0,1,0,0,0,0,0,0,0,0,0
225511,21030,210,30,-2,37,25,12,0,0,0,6,2,4,0,0,0,4,1,3,0,0,0,7,5,2,0,0,0,1,1,0,19,16,3
225627,21030,210,30,-2,11,8,3,0,0,0,1,1,0,0,0,0,3,2,1,0,0,0,6,5,1,0,0,0,0,0,0,1,0,1
226091,21030,210,30,-2,4,3,1,0,0,0,1,1,0,0,0,0,0,0,0,0,0,0,3,2,1,0,0,0,0,0,0,0,0,0
226116,21030,210,30,-2,10,4,6,0,0,0,0,0,0,2,0,2,2,1,1,0,0,0,6,3,3,0,0,0,0,0,0,0,0,0
226134,21030,210,30,-2,6,2,4,0,0,0,1,1,0,0,0,0,5,1,4,0,0,0,0,0,0,0,0,0,0,0,0,0,0,0
226152,21030,210,30,-2,8,1,7,0,0,0,0,0,0,1,0,1,1,0,1,0,0,0,2,1,1,1,0,1,0,0,0,3,0,3
226231,21030,210,30,-2,12,6,6,0,0,0,1,0,1,0,0,0,0,0,0,0,0,0,11,6,5,0,0,0,0,0,0,0,0,0
226471,21030,210,30,-2,14,6,8,0,0,0,2,1,1,1,0,1,2,1,1,0,0,0,9,4,5,0,0,0,0,0,0,0,0,0
226587,21030,210,30,-2,3,2,1,0,0,0,0,0,0,0,0,0,0,0,0,0,0,0,3,2,1,0,0,0,0,0,0,0,0,0
226833,21030,210,30,-2,3,2,1,0,0,0,0,0,0,0,0,0,0,0,0,0,0,0,2,2,0,0,0,0,0,0,0,1,0,1
227216,21030,210,30,-2,36,16,20,0,0,0,13,8,5,3,2,1,4,1,3,0,0,0,15,5,10,0,0,0,1,0,1,0,0,0
227331,21030,210,30,-2,3,1,2,0,0,0,1,0,1,1,0,1,1,1,0,0,0,0,0,0,0,0,0,0,0,0,0,0,0,0
227368,21030,210,30,-2,55,29,26,0,0,0,10,5,5,0,0,0,9,5,4,0,0,0,15,6,9,0,0,0,2,1,1,19,12,7
227526,21030,210,30,-2,10,5,5,0,0,0,3,1,2,4,2,2,0,0,0,0,0,0,3,2,1,0,0,0,0,0,0,0,0,0
227757,21030,210,30,-2,21,13,8,0,0,0,3,2,1,3,0,3,2,0,2,0,0,0,5,3,2,0,0,0,0,0,0,8,8,0
227845,21030,210,30,-2,2,1,1,0,0,0,1,1,0,0,0,0,0,0,0,0,0,0,1,0,1,0,0,0,0,0,0,0,0,0
227863,21030,210,30,-2,1,1,0,0,0,0,0,0,0,0,0,0,0,0,0,0,0,0,1,1,0,0,0,0,0,0,0,0,0,0
227881,21030,210,30,-2,28,14,14,0,0,0,4,1,3,1,0,1,1,0,1,0,0,0,18,9,9,0,0,0,0,0,0,4,4,0
228042,21030,210,30,-2,5,2,3,0,0,0,0,0,0,1,0,1,0,0,0,0,0,0,4,2,2,0,0,0,0,0,0,0,0,0
228149,21030,210,30,-2,3,2,1,0,0,0,0,0,0,0,0,0,1,1,0,0,0,0,1,1,0,0,0,0,0,0,0,1,0,1
228158,21030,210,30,-2,13,6,7,0,0,0,1,0,1,0,0,0,3,1,2,0,0,0,9,5,4,0,0,0,0,0,0,0,0,0
228194,21030,210,30,-2,2,1,1,0,0,0,0,0,0,0,0,0,0,0,0,0,0,0,2,1,1,0,0,0,0,0,0,0,0,0
228246,21030,210,30,-2,1,0,1,0,0,0,0,0,0,1,0,1,0,0,0,0,0,0,0,0,0,0,0,0,0,0,0,0,0,0
228343,21030,210,30,-2,5,0,5,0,0,0,1,0,1,0,0,0,3,0,3,0,0,0,1,0,1,0,0,0,0,0,0,0,0,0
228431,21030,210,30,-2,2,1,1,0,0,0,0,0,0,2,1,1,0,0,0,0,0,0,0,0,0,0,0,0,0,0,0,0,0,0
228459,21030,210,30,-2,13,7,6,0,0,0,2,0,2,0,0,0,0,0,0,0,0,0,3,2,1,0,0,0,8,5,3,0,0,0
228468,21030,210,30,-2,7,3,4,0,0,0,0,0,0,0,0,0,2,0,2,1,1,0,4,2,2,0,0,0,0,0,0,0,0,0
228501,21030,210,30,-2,3,1,2,0,0,0,1,1,0,0,0,0,0,0,0,0,0,0,2,0,2,0,0,0,0,0,0,0,0,0
228529,21030,210,30,-2,14,7,7,0,0,0,1,0,1,3,2,1,1,1,0,0,0,0,7,2,5,1,1,0,0,0,0,1,1,0
228547,21030,210,30,-2,12,5,7,0,0,0,2,2,0,5,0,5,3,2,1,0,0,0,2,1,1,0,0,0,0,0,0,0,0,0
228608,21030,210,30,-2,14,6,8,1,1,0,2,1,1,1,1,0,0,0,0,0,0,0,10,3,7,0,0,0,0,0,0,0,0,0
228635,21030,210,30,-2,4,3,1,0,0,0,2,2,0,0,0,0,0,0,0,0,0,0,0,0,0,0,0,0,0,0,0,2,1,1
228644,21030,210,30,-2,7,3,4,0,0,0,3,1,2,1,1,0,0,0,0,0,0,0,2,1,1,0,0,0,1,0,1,0,0,0
228653,21030,210,30,-2,12,7,5,0,0,0,3,2,1,1,0,1,0,0,0,0,0,0,6,4,2,0,0,0,0,0,0,2,1,1
228705,21030,210,30,-2,2,2,0,0,0,0,1,1,0,0,0,0,0,0,0,0,0,0,1,1,0,0,0,0,0,0,0,0,0,0
228723,21030,210,30,-2,69,47,22,0,0,0,18,11,7,3,2,1,7,3,4,0,0,0,34,26,8,1,1,0,3,3,0,3,1,2
228769,21030,210,30,-2,21,11,10,0,0,0,4,1,3,4,2,2,4,3,1,0,0,0,2,2,0,0,0,0,6,3,3,1,0,1
228778,21030,210,30,-2,67,35,32,0,0,0,12,6,6,7,3,4,9,3,6,0,0,0,22,13,9,1,0,1,0,0,0,16,10,6
228787,21030,210,30,-2,23,10,13,0,0,0,7,3,4,1,0,1,0,0,0,0,0,0,4,1,3,0,0,0,11,6,5,0,0,0
228796,21030,210,30,-2,30,15,15,0,0,0,7,1,6,0,0,0,7,3,4,0,0,0,10,7,3,0,0,0,1,1,0,5,3,2
228802,21030,210,30,-2,7,4,3,0,0,0,3,3,0,0,0,0,1,0,1,0,0,0,0,0,0,0,0,0,2,1,1,1,0,1
228875,21030,210,30,-2,3,1,2,0,0,0,0,0,0,0,0,0,1,0,1,0,0,0,1,1,0,0,0,0,0,0,0,1,0,1
228884,21030,210,30,-2,3,1,2,0,0,0,0,0,0,3,1,2,0,0,0,0,0,0,0,0,0,0,0,0,0,0,0,0,0,0
228909,21030,210,30,-2,6,5,1,0,0,0,1,0,1,1,1,0,1,1,0,0,0,0,3,3,0,0,0,0,0,0,0,0,0,0
228981,21030,210,30,-2,4,2,2,0,0,0,0,0,0,0,0,0,4,2,2,0,0,0,0,0,0,0,0,0,0,0,0,0,0,0
229018,21030,210,30,-2,5,2,3,0,0,0,0,0,0,3,0,3,0,0,0,0,0,0,2,2,0,0,0,0,0,0,0,0,0,0
229027,21030,210,30,-2,16,11,5,0,0,0,1,1,0,1,0,1,5,2,3,0,0,0,3,3,0,0,0,0,1,0,1,5,5,0
229063,21030,210,30,-2,3,2,1,0,0,0,0,0,0,2,2,0,0,0,0,0,0,0,1,0,1,0,0,0,0,0,0,0,0,0
229115,21030,210,30,-2,50,22,28,1,0,1,6,4,2,1,0,1,2,2,0,0,0,0,26,10,16,1,0,1,0,0,0,13,6,7
229179,21030,210,30,-2,14,4,10,0,0,0,4,1,3,0,0,0,2,1,1,0,0,0,7,2,5,0,0,0,1,0,1,0,0,0
229300,21030,210,30,-2,10,4,6,0,0,0,1,1,0,0,0,0,2,0,2,0,0,0,2,1,1,2,0,2,1,0,1,2,2,0
229337,21030,210,30,-2,2,2,0,0,0,0,0,0,0,0,0,0,0,0,0,0,0,0,2,2,0,0,0,0,0,0,0,0,0,0
229540,21030,210,30,-2,5,4,1,0,0,0,0,0,0,0,0,0,2,2,0,0,0,0,3,2,1,0,0,0,0,0,0,0,0,0
230038,21030,210,30,-2,60,37,23,0,0,0,1,1,0,0,0,0,1,0,1,0,0,0,55,35,20,3,1,2,0,0,0,0,0,0
230171,21030,210,30,-2,12,6,6,0,0,0,2,1,1,0,0,0,0,0,0,0,0,0,10,5,5,0,0,0,0,0,0,0,0,0
230597,21030,210,30,-2,10,5,5,0,0,0,0,0,0,1,0,1,0,0,0,0,0,0,9,5,4,0,0,0,0,0,0,0,0,0
230603,21030,210,30,-2,15,9,6,0,0,0,0,0,0,1,1,0,3,1,2,0,0,0,11,7,4,0,0,0,0,0,0,0,0,0
230728,21030,210,30,-2,20,11,9,0,0,0,4,4,0,0,0,0,1,0,1,0,0,0,14,7,7,1,0,1,0,0,0,0,0,0
230737,21030,210,30,-2,51,28,23,0,0,0,4,1,3,0,0,0,0,0,0,0,0,0,34,17,17,0,0,0,9,7,2,4,3,1
230746,21030,210,30,-2,18,10,8,1,0,1,1,0,1,0,0,0,3,1,2,0,0,0,13,9,4,0,0,0,0,0,0,0,0,0
230764,21030,210,30,-2,61,32,29,0,0,0,5,2,3,2,1,1,3,1,2,1,1,0,36,20,16,1,0,1,4,1,3,9,6,3
230782,21030,210,30,-2,19,12,7,0,0,0,1,1,0,0,0,0,0,0,0,0,0,0,12,7,5,0,0,0,2,1,1,4,3,1
230834,21030,210,30,-2,2,0,2,0,0,0,0,0,0,0,0,0,0,0,0,0,0,0,1,0,1,0,0,0,1,0,1,0,0,0
230913,21030,210,30,-2,1,0,1,0,0,0,0,0,0,0,0,0,0,0,0,0,0,0,1,0,1,0,0,0,0,0,0,0,0,0
230959,21030,210,30,-2,9,5,4,0,0,0,0,0,0,1,1,0,1,0,1,0,0,0,3,1,2,0,0,0,3,3,0,1,0,1
230995,21030,210,30,-2,9,4,5,0,0,0,0,0,0,0,0,0,1,0,1,0,0,0,5,2,3,0,0,0,2,2,0,1,0,1
231059,21030,210,30,-2,4,1,3,0,0,0,0,0,0,0,0,0,0,0,0,0,0,0,3,1,2,0,0,0,0,0,0,1,0,1
231165,21030,210,30,-2,3,1,2,0,0,0,0,0,0,0,0,0,0,0,0,0,0,0,3,1,2,0,0,0,0,0,0,0,0,0
231174,21030,210,30,-2,6,4,2,0,0,0,0,0,0,0,0,0,1,0,1,0,0,0,4,3,1,0,0,0,0,0,0,1,1,0
231420,21030,210,30,-2,3,3,0,0,0,0,0,0,0,0,0,0,0,0,0,0,0,0,3,3,0,0,0,0,0,0,0,0,0,0
231581,21030,210,30,-2,2,2,0,0,0,0,0,0,0,0,0,0,0,0,0,0,0,0,1,1,0,0,0,0,0,0,0,1,1,0
231624,21030,210,30,-2,9,5,4,0,0,0,3,1,2,1,1,0,1,0,1,0,0,0,1,0,1,1,1,0,2,2,0,0,0,0
231651,21030,210,30,-2,4,2,2,0,0,0,0,0,0,1,0,1,0,0,0,1,0,1,2,2,0,0,0,0,0,0,0,0,0,0
231712,21030,210,30,-2,7,2,5,0,0,0,3,1,2,0,0,0,0,0,0,0,0,0,4,1,3,0,0,0,0,0,0,0,0,0
232025,21030,210,30,-2,5,2,3,0,0,0,0,0,0,1,0,1,0,0,0,0,0,0,2,0,2,0,0,0,2,2,0,0,0,0
232043,21030,210,30,-2,2,1,1,0,0,0,0,0,0,0,0,0,0,0,0,0,0,0,2,1,1,0,0,0,0,0,0,0,0,0
232089,21030,210,30,-2,5,2,3,0,0,0,1,1,0,0,0,0,0,0,0,0,0,0,4,1,3,0,0,0,0,0,0,0,0,0
232186,21030,210,30,-2,41,25,16,0,0,0,8,7,1,1,0,1,2,1,1,0,0,0,11,6,5,1,0,1,0,0,0,18,11,7
232256,21030,210,30,-2,4,3,1,0,0,0,0,0,0,1,0,1,1,1,0,0,0,0,2,2,0,0,0,0,0,0,0,0,0,0
232265,21030,210,30,-2,3,1,2,0,0,0,1,1,0,2,0,2,0,0,0,0,0,0,0,0,0,0,0,0,0,0,0,0,0,0
232423,21030,210,30,-2,20,3,17,0,0,0,2,0,2,6,1,5,4,0,4,0,0,0,7,1,6,1,1,0,0,0,0,0,0,0
232566,21030,210,30,-2,4,2,2,0,0,0,0,0,0,1,0,1,0,0,0,0,0,0,3,2,1,0,0,0,0,0,0,0,0,0
232609,21030,210,30,-2,3,2,1,0,0,0,0,0,0,0,0,0,0,0,0,0,0,0,2,1,1,0,0,0,1,1,0,0,0,0
232681,21030,210,30,-2,6,3,3,0,0,0,2,2,0,1,0,1,1,1,0,0,0,0,2,0,2,0,0,0,0,0,0,0,0,0
232706,21030,210,30,-2,12,4,8,0,0,0,2,0,2,4,1,3,3,2,1,0,0,0,2,1,1,0,0,0,1,0,1,0,0,0
232937,21030,210,30,-2,5,3,2,0,0,0,2,0,2,2,2,0,0,0,0,0,0,0,1,1,0,0,0,0,0,0,0,0,0,0
232982,21030,210,30,-2,16,9,7,0,0,0,0,0,0,2,0,2,0,0,0,0,0,0,8,5,3,0,0,0,0,0,0,6,4,2
233277,21030,210,30,-2,14,6,8,0,0,0,3,2,1,2,2,0,0,0,0,0,0,0,9,2,7,0,0,0,0,0,0,0,0,0
233295,21030,210,30,-2,3,1,2,0,0,0,0,0,0,0,0,0,0,0,0,0,0,0,3,1,2,0,0,0,0,0,0,0,0,0
233374,21030,210,30,-2,9,3,6,0,0,0,0,0,0,4,1,3,0,0,0,0,0,0,5,2,3,0,0,0,0,0,0,0,0,0
233426,21030,210,30,-2,2,2,0,0,0,0,0,0,0,0,0,0,0,0,0,0,0,0,2,2,0,0,0,0,0,0,0,0,0,0
233718,21030,210,30,-2,2,0,2,0,0,0,1,0,1,1,0,1,0,0,0,0,0,0,0,0,0,0,0,0,0,0,0,0,0,0
233842,21030,210,30,-2,2,1,1,0,0,0,0,0,0,2,1,1,0,0,0,0,0,0,0,0,0,0,0,0,0,0,0,0,0,0
233897,21030,210,30,-2,3,2,1,0,0,0,0,0,0,0,0,0,0,0,0,0,0,0,3,2,1,0,0,0,0,0,0,0,0,0
233921,21030,210,30,-2,55,34,21,1,0,1,8,7,1,5,2,3,0,0,0,0,0,0,20,13,7,1,1,0,0,0,0,20,11,9
234030,21030,210,30,-2,17,6,11,0,0,0,4,1,3,3,2,1,2,1,1,0,0,0,8,2,6,0,0,0,0,0,0,0,0,0
234076,21030,210,30,-2,32,14,18,0,0,0,5,3,2,5,0,5,2,1,1,0,0,0,9,6,3,3,1,2,2,0,2,6,3,3
234085,21030,210,30,-2,9,6,3,0,0,0,2,1,1,0,0,0,0,0,0,0,0,0,7,5,2,0,0,0,0,0,0,0,0,0
234164,21030,210,30,-2,3,3,0,0,0,0,0,0,0,1,1,0,0,0,0,0,0,0,0,0,0,0,0,0,2,2,0,0,0,0
234207,21030,210,30,-2,8,4,4,0,0,0,1,0,1,2,1,1,1,1,0,0,0,0,0,0,0,0,0,0,0,0,0,4,2,2
234669,21030,210,30,-2,5,2,3,0,0,0,0,0,0,4,2,2,0,0,0,0,0,0,1,0,1,0,0,0,0,0,0,0,0,0
234696,21030,210,30,-2,4,2,2,0,0,0,0,0,0,0,0,0,0,0,0,0,0,0,3,2,1,1,0,1,0,0,0,0,0,0
234711,21030,210,30,-2,2,2,0,0,0,0,1,1,0,0,0,0,0,0,0,0,0,0,1,1,0,0,0,0,0,0,0,0,0,0
234827,21030,210,30,-2,5,1,4,0,0,0,1,1,0,0,0,0,1,0,1,0,0,0,3,0,3,0,0,0,0,0,0,0,0,0
234845,21030,210,30,-2,1,0,1,0,0,0,0,0,0,0,0,0,0,0,0,0,0,0,1,0,1,0,0,0,0,0,0,0,0,0
234951,21030,210,30,-2,3,3,0,0,0,0,0,0,0,0,0,0,0,0,0,0,0,0,3,3,0,0,0,0,0,0,0,0,0,0
234979,21030,210,30,-2,3,2,1,0,0,0,0,0,0,0,0,0,0,0,0,0,0,0,2,1,1,1,1,0,0,0,0,0,0,0
235097,21030,210,30,-2,3,2,1,0,0,0,0,0,0,0,0,0,0,0,0,0,0,0,2,1,1,0,0,0,0,0,0,1,1,0
235149,21030,210,30,-2,1,1,0,0,0,0,0,0,0,0,0,0,0,0,0,0,0,0,0,0,0,0,0,0,1,1,0,0,0,0
235237,21030,210,30,-2,5,1,4,0,0,0,2,0,2,1,1,0,0,0,0,0,0,0,2,0,2,0,0,0,0,0,0,0,0,0
235316,21030,210,30,-2,8,4,4,0,0,0,0,0,0,1,1,0,0,0,0,0,0,0,4,1,3,0,0,0,0,0,0,3,2,1
235334,21030,210,30,-2,4,2,2,0,0,0,0,0,0,0,0,0,0,0,0,0,0,0,4,2,2,0,0,0,0,0,0,0,0,0
235343,21030,210,30,-2,4,3,1,0,0,0,0,0,0,0,0,0,0,0,0,0,0,0,1,1,0,2,1,1,1,1,0,0,0,0
235671,21030,210,30,-2,1,1,0,0,0,0,0,0,0,0,0,0,1,1,0,0,0,0,0,0,0,0,0,0,0,0,0,0,0,0
235750,21030,210,30,-2,2,1,1,0,0,0,0,0,0,0,0,0,0,0,0,0,0,0,1,0,1,0,0,0,1,1,0,0,0,0
236072,21030,210,30,-2,1,0,1,0,0,0,0,0,0,0,0,0,0,0,0,0,0,0,1,0,1,0,0,0,0,0,0,0,0,0
236133,21030,210,30,-2,8,3,5,0,0,0,0,0,0,0,0,0,0,0,0,0,0,0,8,3,5,0,0,0,0,0,0,0,0,0
236188,21030,210,30,-2,4,1,3,0,0,0,0,0,0,0,0,0,0,0,0,0,0,0,4,1,3,0,0,0,0,0,0,0,0,0
236328,21030,210,30,-2,3,0,3,0,0,0,2,0,2,0,0,0,0,0,0,0,0,0,1,0,1,0,0,0,0,0,0,0,0,0
236382,21030,210,30,-2,4,1,3,1,1,0,1,0,1,0,0,0,0,0,0,0,0,0,2,0,2,0,0,0,0,0,0,0,0,0
236452,21030,210,30,-2,3,0,3,0,0,0,0,0,0,0,0,0,0,0,0,0,0,0,0,0,0,0,0,0,3,0,3,0,0,0
236577,21030,210,30,-2,8,2,6,0,0,0,1,0,1,1,0,1,1,1,0,0,0,0,1,0,1,0,0,0,0,0,0,4,1,3
236595,21030,210,30,-2,7,5,2,0,0,0,3,3,0,1,0,1,1,0,1,0,0,0,2,2,0,0,0,0,0,0,0,0,0,0
236638,21030,210,30,-2,3,1,2,0,0,0,1,1,0,0,0,0,0,0,0,0,0,0,2,0,2,0,0,0,0,0,0,0,0,0
236656,21030,210,30,-2,3,2,1,0,0,0,0,0,0,1,1,0,0,0,0,0,0,0,2,1,1,0,0,0,0,0,0,0,0,0
236692,21030,210,30,-2,7,5,2,1,1,0,0,0,0,1,1,0,0,0,0,0,0,0,5,3,2,0,0,0,0,0,0,0,0,0
236708,21030,210,30,-2,1,0,1,0,0,0,0,0,0,0,0,0,0,0,0,0,0,0,1,0,1,0,0,0,0,0,0,0,0,0
236887,21030,210,30,-2,2,0,2,0,0,0,0,0,0,1,0,1,0,0,0,1,0,1,0,0,0,0,0,0,0,0,0,0,0,0
236896,21030,210,30,-2,2,1,1,0,0,0,1,1,0,0,0,0,0,0,0,0,0,0,1,0,1,0,0,0,0,0,0,0,0,0
236939,21030,210,30,-2,22,15,7,0,0,0,2,2,0,1,1,0,3,2,1,0,0,0,5,2,3,0,0,0,10,7,3,1,1,0
236948,21030,210,30,-2,82,33,49,2,2,0,9,5,4,9,4,5,8,2,6,0,0,0,26,10,16,6,3,3,9,2,7,13,5,8
237011,21030,210,30,-2,11,5,6,0,0,0,3,2,1,0,0,0,1,0,1,0,0,0,5,2,3,1,0,1,1,1,0,0,0,0
237039,21030,210,30,-2,3,1,2,0,0,0,0,0,0,0,0,0,0,0,0,0,0,0,2,1,1,0,0,0,1,0,1,0,0,0
237066,21030,210,30,-2,9,4,5,0,0,0,1,0,1,2,2,0,0,0,0,0,0,0,6,2,4,0,0,0,0,0,0,0,0,0
237118,21030,210,30,-2,8,5,3,0,0,0,0,0,0,1,1,0,0,0,0,0,0,0,7,4,3,0,0,0,0,0,0,0,0,0
237181,21030,210,30,-2,3,2,1,0,0,0,0,0,0,1,1,0,0,0,0,0,0,0,2,1,1,0,0,0,0,0,0,0,0,0
237330,21030,210,30,-2,3,2,1,0,0,0,0,0,0,1,0,1,0,0,0,0,0,0,2,2,0,0,0,0,0,0,0,0,0,0
237367,21030,210,30,-2,9,2,7,0,0,0,0,0,0,0,0,0,0,0,0,0,0,0,9,2,7,0,0,0,0,0,0,0,0,0
237525,21030,210,30,-2,19,8,11,0,0,0,3,1,2,2,1,1,0,0,0,0,0,0,14,6,8,0,0,0,0,0,0,0,0,0
237701,21030,210,30,-2,1,1,0,0,0,0,0,0,0,0,0,0,0,0,0,0,0,0,0,0,0,0,0,0,0,0,0,1,1,0
237792,21030,210,30,-2,4,1,3,0,0,0,0,0,0,0,0,0,0,0,0,0,0,0,4,1,3,0,0,0,0,0,0,0,0,0
237880,21030,210,30,-2,1,1,0,0,0,0,0,0,0,0,0,0,0,0,0,0,0,0,1,1,0,0,0,0,0,0,0,0,0,0
237899,21030,210,30,-2,1,1,0,0,0,0,1,1,0,0,0,0,0,0,0,0,0,0,0,0,0,0,0,0,0,0,0,0,0,0
237950,21030,210,30,-2,6,4,2,0,0,0,1,1,0,0,0,0,0,0,0,0,0,0,4,2,2,0,0,0,0,0,0,1,1,0
238032,21030,210,30,-2,39,27,12,0,0,0,8,5,3,3,1,2,1,1,0,0,0,0,17,13,4,0,0,0,2,2,0,8,5,3
238193,21030,210,30,-2,4,0,4,0,0,0,0,0,0,1,0,1,0,0,0,0,0,0,3,0,3,0,0,0,0,0,0,0,0,0
238333,21030,210,30,-2,4,1,3,0,0,0,0,0,0,0,0,0,1,0,1,0,0,0,2,1,1,0,0,0,0,0,0,1,0,1
238430,21030,210,30,-2,1,1,0,0,0,0,0,0,0,0,0,0,0,0,0,0,0,0,1,1,0,0,0,0,0,0,0,0,0,0
238458,21030,210,30,-2,5,4,1,0,0,0,0,0,0,0,0,0,0,0,0,0,0,0,3,2,1,0,0,0,0,0,0,2,2,0
239017,21030,210,30,-2,7,2,5,0,0,0,0,0,0,0,0,0,0,0,0,0,0,0,6,2,4,1,0,1,0,0,0,0,0,0
239080,21030,210,30,-2,3,0,3,0,0,0,0,0,0,0,0,0,0,0,0,0,0,0,3,0,3,0,0,0,0,0,0,0,0,0
239105,21030,210,30,-2,3,1,2,0,0,0,0,0,0,0,0,0,1,0,1,0,0,0,2,1,1,0,0,0,0,0,0,0,0,0
239169,21030,210,30,-2,62,31,31,0,0,0,17,9,8,1,0,1,1,0,1,0,0,0,42,22,20,1,0,1,0,0,0,0,0,0
239390,21030,210,30,-2,2,1,1,0,0,0,0,0,0,0,0,0,0,0,0,0,0,0,1,1,0,0,0,0,1,0,1,0,0,0
239628,21030,210,30,-2,2,2,0,0,0,0,0,0,0,0,0,0,0,0,0,0,0,0,2,2,0,0,0,0,0,0,0,0,0,0
239716,21030,210,30,-2,6,3,3,0,0,0,0,0,0,0,0,0,0,0,0,0,0,0,3,2,1,0,0,0,0,0,0,3,1,2
240107,21030,210,30,-2,11,6,5,0,0,0,2,1,1,0,0,0,0,0,0,0,0,0,9,5,4,0,0,0,0,0,0,0,0,0
240189,21030,210,30,-2,4,2,2,0,0,0,0,0,0,0,0,0,0,0,0,0,0,0,4,2,2,0,0,0,0,0,0,0,0,0
240268,21030,210,30,-2,10,4,6,0,0,0,3,0,3,0,0,0,0,0,0,0,0,0,4,2,2,0,0,0,1,1,0,2,1,1
240277,21030,210,30,-2,11,7,4,0,0,0,2,1,1,0,0,0,0,0,0,0,0,0,6,3,3,0,0,0,0,0,0,3,3,0
240329,21030,210,30,-2,4,3,1,0,0,0,1,1,0,0,0,0,0,0,0,0,0,0,2,1,1,0,0,0,1,1,0,0,0,0
240365,21030,210,30,-2,1,0,1,0,0,0,0,0,0,0,0,0,0,0,0,0,0,0,1,0,1,0,0,0,0,0,0,0,0,0
240417,21030,210,30,-2,9,6,3,0,0,0,2,1,1,0,0,0,0,0,0,0,0,0,4,3,1,0,0,0,0,0,0,3,2,1
240426,21030,210,30,-2,5,2,3,0,0,0,0,0,0,0,0,0,0,0,0,0,0,0,4,2,2,0,0,0,0,0,0,1,0,1
240444,21030,210,30,-2,66,37,29,1,1,0,5,4,1,3,2,1,2,1,1,0,0,0,25,13,12,0,0,0,4,2,2,26,14,12
240453,21030,210,30,-2,4,3,1,0,0,0,2,1,1,0,0,0,0,0,0,0,0,0,2,2,0,0,0,0,0,0,0,0,0,0
240462,21030,210,30,-2,2,1,1,0,0,0,0,0,0,0,0,0,0,0,0,0,0,0,0,0,0,0,0,0,0,0,0,2,1,1
240471,21030,210,30,-2,7,4,3,0,0,0,1,1,0,0,0,0,1,1,0,0,0,0,3,1,2,0,0,0,0,0,0,2,1,1
240505,21030,210,30,-2,4,2,2,0,0,0,0,0,0,0,0,0,0,0,0,0,0,0,1,0,1,0,0,0,3,2,1,0,0,0
240596,21030,210,30,-2,5,2,3,0,0,0,0,0,0,0,0,0,0,0,0,0,0,0,5,2,3,0,0,0,0,0,0,0,0,0
240657,21030,210,30,-2,1,1,0,0,0,0,0,0,0,0,0,0,0,0,0,0,0,0,1,1,0,0,0,0,0,0,0,0,0,0
240666,21030,210,30,-2,4,0,4,0,0,0,0,0,0,0,0,0,0,0,0,0,0,0,4,0,4,0,0,0,0,0,0,0,0,0
240727,21030,210,30,-2,9,5,4,0,0,0,0,0,0,0,0,0,1,1,0,0,0,0,5,2,3,0,0,0,3,2,1,0,0,0
240736,21030,210,30,-2,1,1,0,0,0,0,0,0,0,0,0,0,0,0,0,1,1,0,0,0,0,0,0,0,0,0,0,0,0,0
240745,21030,210,30,-2,1,1,0,0,0,0,0,0,0,0,0,0,0,0,0,1,1,0,0,0,0,0,0,0,0,0,0,0,0,0
240754,21030,210,30,-2,4,3,1,0,0,0,2,1,1,0,0,0,0,0,0,0,0,0,2,2,0,0,0,0,0,0,0,0,0,0
241191,21030,210,30,-2,1,0,1,0,0,0,0,0,0,0,0,0,1,0,1,0,0,0,0,0,0,0,0,0,0,0,0,0,0,0
242705,21030,210,30,-2,1,0,1,0,0,0,0,0,0,0,0,0,1,0,1,0,0,0,0,0,0,0,0,0,0,0,0,0,0,0
243151,21030,210,30,-2,2,1,1,0,0,0,0,0,0,0,0,0,2,1,1,0,0,0,0,0,0,0,0,0,0,0,0,0,0,0
243179,21030,210,30,-2,4,3,1,0,0,0,0,0,0,0,0,0,2,1,1,0,0,0,0,0,0,0,0,0,1,1,0,1,1,0
243197,21030,210,30,-2,16,10,6,0,0,0,0,0,0,0,0,0,1,0,1,0,0,0,0,0,0,0,0,0,15,10,5,0,0,0
243744,21030,210,30,-2,34,14,20,1,0,1,3,0,3,3,3,0,1,0,1,0,0,0,14,6,8,2,0,2,6,3,3,4,2,2
243780,21030,210,30,-2,75,51,24,0,0,0,17,12,5,3,3,0,5,4,1,0,0,0,27,18,9,2,1,1,0,0,0,21,13,8
244437,21030,210,30,-2,14,8,6,0,0,0,2,0,2,6,4,2,2,2,0,0,0,0,4,2,2,0,0,0,0,0,0,0,0,0
245652,21030,210,30,-2,5,2,3,0,0,0,2,1,1,1,1,0,0,0,0,0,0,0,2,0,2,0,0,0,0,0,0,0,0,0
251260,21030,210,30,-2,9,2,7,0,0,0,1,0,1,0,0,0,1,0,1,0,0,0,7,2,5,0,0,0,0,0,0,0,0,0
262031,21030,210,30,-2,3,3,0,0,0,0,0,0,0,1,1,0,0,0,0,0,0,0,2,2,0,0,0,0,0,0,0,0,0,0
262129,21030,210,30,-2,1,1,0,0,0,0,0,0,0,0,0,0,0,0,0,0,0,0,0,0,0,0,0,0,0,0,0,1,1,0
364016,21030,210,30,-2,4,3,1,0,0,0,0,0,0,0,0,0,0,0,0,0,0,0,4,3,1,0,0,0,0,0,0,0,0,0
364025,21030,210,30,-2,6,1,5,0,0,0,0,0,0,0,0,0,1,0,1,0,0,0,5,1,4,0,0,0,0,0,0,0,0,0
366711,21030,210,30,-2,15,6,9,0,0,0,3,0,3,1,0,1,2,1,1,0,0,0,4,1,3,1,1,0,0,0,0,4,3,1
377555,21030,210,30,-2,1,0,1,0,0,0,1,0,1,0,0,0,0,0,0,0,0,0,0,0,0,0,0,0,0,0,0,0,0,0
377564,21030,210,30,-2,7,5,2,0,0,0,0,0,0,2,2,0,0,0,0,0,0,0,2,2,0,1,1,0,1,0,1,1,0,1
380368,21030,210,30,-2,1,0,1,0,0,0,0,0,0,0,0,0,0,0,0,0,0,0,1,0,1,0,0,0,0,0,0,0,0,0
384333,21030,210,30,-2,2,2,0,0,0,0,0,0,0,0,0,0,0,0,0,0,0,0,2,2,0,0,0,0,0,0,0,0,0,0
384342,21030,210,30,-2,5,4,1,0,0,0,0,0,0,0,0,0,0,0,0,0,0,0,5,4,1,0,0,0,0,0,0,0,0,0
395362,21030,210,30,-2,1,0,1,0,0,0,0,0,0,0,0,0,0,0,0,0,0,0,1,0,1,0,0,0,0,0,0,0,0,0
403469,21030,210,30,-2,1,1,0,0,0,0,0,0,0,0,0,0,0,0,0,0,0,0,1,1,0,0,0,0,0,0,0,0,0,0
403478,21030,210,30,-2,3,1,2,0,0,0,0,0,0,0,0,0,0,0,0,0,0,0,3,1,2,0,0,0,0,0,0,0,0,0
403487,21030,210,30,-2,3,2,1,0,0,0,0,0,0,0,0,0,0,0,0,0,0,0,3,2,1,0,0,0,0,0,0,0,0,0
409254,21030,210,30,-2,1,0,1,0,0,0,0,0,0,1,0,1,0,0,0,0,0,0,0,0,0,0,0,0,0,0,0,0,0,0
409698,21030,210,30,-2,5,2,3,0,0,0,1,0,1,0,0,0,0,0,0,0,0,0,3,1,2,0,0,0,0,0,0,1,1,0
414911,21030,210,30,-2,1,1,0,0,0,0,0,0,0,0,0,0,0,0,0,0,0,0,1,1,0,0,0,0,0,0,0,0,0,0
414966,21030,210,30,-2,1,0,1,0,0,0,0,0,0,0,0,0,0,0,0,0,0,0,1,0,1,0,0,0,0,0,0,0,0,0
423643,21030,210,30,-2,7,7,0,0,0,0,2,2,0,1,1,0,1,1,0,0,0,0,3,3,0,0,0,0,0,0,0,0,0,0
426314,21030,210,30,-2,5,4,1,0,0,0,0,0,0,0,0,0,0,0,0,0,0,0,4,3,1,0,0,0,1,1,0,0,0,0
435000,21030,210,30,-2,18,13,5,0,0,0,6,4,2,0,0,0,3,2,1,0,0,0,7,5,2,0,0,0,0,0,0,2,2,0
441900,21030,210,30,-2,7,5,2,0,0,0,1,0,1,2,1,1,1,1,0,0,0,0,3,3,0,0,0,0,0,0,0,0,0,0
441937,21030,210,30,-2,4,1,3,0,0,0,1,1,0,0,0,0,2,0,2,0,0,0,0,0,0,1,0,1,0,0,0,0,0,0
442295,21030,210,30,-2,1,1,0,0,0,0,0,0,0,0,0,0,0,0,0,0,0,0,1,1,0,0,0,0,0,0,0,0,0,0
442806,21030,210,30,-2,22,13,9,0,0,0,3,1,2,0,0,0,1,0,1,0,0,0,18,12,6,0,0,0,0,0,0,0,0,0
445188,21030,210,30,-2,17,9,8,1,0,1,1,1,0,1,1,0,1,1,0,0,0,0,7,2,5,0,0,0,1,1,0,5,3,2
448594,21030,210,30,-2,2,1,1,0,0,0,1,1,0,1,0,1,0,0,0,0,0,0,0,0,0,0,0,0,0,0,0,0,0,0
449870,21030,210,30,-2,1,1,0,0,0,0,0,0,0,0,0,0,0,0,0,0,0,0,1,1,0,0,0,0,0,0,0,0,0,0
450304,21030,210,30,-2,1,1,0,0,0,0,0,0,0,1,1,0,0,0,0,0,0,0,0,0,0,0,0,0,0,0,0,0,0,0
455512,21030,210,30,-2,1,0,1,0,0,0,0,0,0,0,0,0,0,0,0,0,0,0,1,0,1,0,0,0,0,0,0,0,0,0
456542,21030,210,30,-2,3,1,2,0,0,0,0,0,0,1,0,1,0,0,0,0,0,0,2,1,1,0,0,0,0,0,0,0,0,0
459949,21030,210,30,-2,3,0,3,0,0,0,0,0,0,1,0,1,0,0,0,0,0,0,2,0,2,0,0,0,0,0,0,0,0,0
460394,21030,210,30,-2,4,2,2,0,0,0,0,0,0,1,1,0,1,1,0,0,0,0,2,0,2,0,0,0,0,0,0,0,0,0
460464,21030,210,30,-2,3,2,1,1,1,0,0,0,0,0,0,0,1,1,0,0,0,0,1,0,1,0,0,0,0,0,0,0,0,0
482149,21030,210,30,-2,18,10,8,0,0,0,3,3,0,1,1,0,1,1,0,0,0,0,13,5,8,0,0,0,0,0,0,0,0,0
482158,21030,210,30,-2,15,6,9,0,0,0,3,2,1,0,0,0,0,0,0,0,0,0,12,4,8,0,0,0,0,0,0,0,0,0
482680,21030,210,30,-2,17,10,7,0,0,0,3,3,0,1,0,1,1,1,0,0,0,0,10,4,6,0,0,0,1,1,0,1,1,0
482699,21030,210,30,-2,2,0,2,0,0,0,0,0,0,0,0,0,0,0,0,0,0,0,2,0,2,0,0,0,0,0,0,0,0,0
483018,21030,210,30,-2,1,0,1,0,0,0,0,0,0,0,0,0,0,0,0,0,0,0,1,0,1,0,0,0,0,0,0,0,0,0
483036,21030,210,30,-2,4,2,2,0,0,0,0,0,0,1,0,1,0,0,0,0,0,0,1,1,0,0,0,0,0,0,0,2,1,1
483124,21030,210,30,-2,11,5,6,0,0,0,1,1,0,1,0,1,2,2,0,0,0,0,0,0,0,0,0,0,4,1,3,3,1,2
486840,21030,210,30,-2,40,22,18,0,0,0,10,7,3,2,0,2,2,2,0,0,0,0,17,8,9,0,0,0,1,0,1,8,5,3
486901,21030,210,30,-2,5,1,4,0,0,0,0,0,0,0,0,0,0,0,0,0,0,0,5,1,4,0,0,0,0,0,0,0,0,0
487010,21030,210,30,-2,14,10,4,0,0,0,1,1,0,2,1,1,0,0,0,0,0,0,8,7,1,1,1,0,0,0,0,2,0,2
489201,21030,210,30,-2,4,2,2,0,0,0,0,0,0,1,1,0,0,0,0,0,0,0,2,1,1,0,0,0,1,0,1,0,0,0
492689,21030,210,30,-2,1,0,1,0,0,0,0,0,0,0,0,0,0,0,0,0,0,0,1,0,1,0,0,0,0,0,0,0,0,0
495767,21030,210,30,-2,114,59,55,0,0,0,15,11,4,10,4,6,7,2,5,0,0,0,48,24,24,4,2,2,3,3,0,27,13,14
497046,21030,210,30,-2,2,1,1,0,0,0,0,0,0,0,0,0,1,0,1,0,0,0,1,1,0,0,0,0,0,0,0,0,0,0
100654,21040,210,40,-2,5,3,2,0,0,0,1,1,0,3,1,2,0,0,0,0,0,0,0,0,0,0,0,0,1,1,0,0,0,0
100663,21040,210,40,-2,105,53,52,0,0,0,12,9,3,6,1,5,1,0,1,0,0,0,64,27,37,3,2,1,0,0,0,19,14,5
100690,21040,210,40,-2,3,3,0,0,0,0,0,0,0,0,0,0,0,0,0,0,0,0,3,3,0,0,0,0,0,0,0,0,0,0
100706,21040,210,40,-2,16,1,15,0,0,0,1,0,1,1,0,1,2,0,2,0,0,0,11,0,11,0,0,0,0,0,0,1,1,0
100724,21040,210,40,-2,1,0,1,0,0,0,0,0,0,1,0,1,0,0,0,0,0,0,0,0,0,0,0,0,0,0,0,0,0,0
100751,21040,210,40,-2,98,44,54,0,0,0,4,2,2,8,3,5,3,1,2,0,0,0,68,32,36,2,1,1,1,0,1,12,5,7
100830,21040,210,40,-2,5,1,4,0,0,0,1,0,1,0,0,0,0,0,0,0,0,0,1,1,0,0,0,0,3,0,3,0,0,0
100858,21040,210,40,-2,26,12,14,0,0,0,1,1,0,2,0,2,0,0,0,1,1,0,15,8,7,0,0,0,0,0,0,7,2,5
100937,21040,210,40,-2,5,2,3,0,0,0,1,0,1,1,1,0,0,0,0,0,0,0,3,1,2,0,0,0,0,0,0,0,0,0
101116,21040,210,40,-2,1,1,0,0,0,0,0,0,0,0,0,0,0,0,0,0,0,0,1,1,0,0,0,0,0,0,0,0,0,0
101161,21040,210,40,-2,2,1,1,0,0,0,0,0,0,0,0,0,0,0,0,0,0,0,2,1,1,0,0,0,0,0,0,0,0,0
101240,21040,210,40,-2,1,1,0,0,0,0,0,0,0,0,0,0,0,0,0,0,0,0,1,1,0,0,0,0,0,0,0,0,0,0
101286,21040,210,40,-2,1,1,0,0,0,0,0,0,0,0,0,0,0,0,0,0,0,0,1,1,0,0,0,0,0,0,0,0,0,0
101295,21040,210,40,-2,1,0,1,0,0,0,0,0,0,1,0,1,0,0,0,0,0,0,0,0,0,0,0,0,0,0,0,0,0,0
101301,21040,210,40,-2,5,2,3,0,0,0,0,0,0,2,0,2,0,0,0,0,0,0,1,1,0,0,0,0,2,1,1,0,0,0
101435,21040,210,40,-2,3,2,1,0,0,0,0,0,0,1,0,1,0,0,0,0,0,0,0,0,0,0,0,0,2,2,0,0,0,0
101480,21040,210,40,-2,4,1,3,0,0,0,0,0,0,1,0,1,0,0,0,0,0,0,3,1,2,0,0,0,0,0,0,0,0,0
101505,21040,210,40,-2,9,3,6,0,0,0,0,0,0,2,1,1,0,0,0,0,0,0,7,2,5,0,0,0,0,0,0,0,0,0
101514,21040,210,40,-2,5,0,5,0,0,0,0,0,0,0,0,0,0,0,0,0,0,0,5,0,5,0,0,0,0,0,0,0,0,0
101587,21040,210,40,-2,3,0,3,0,0,0,1,0,1,0,0,0,0,0,0,0,0,0,1,0,1,0,0,0,1,0,1,0,0,0
101675,21040,210,40,-2,12,3,9,0,0,0,0,0,0,7,2,5,0,0,0,0,0,0,5,1,4,0,0,0,0,0,0,0,0,0
101693,21040,210,40,-2,2,0,2,0,0,0,0,0,0,0,0,0,0,0,0,0,0,0,2,0,2,0,0,0,0,0,0,0,0,0
101709,21040,210,40,-2,8,1,7,1,0,1,0,0,0,2,0,2,0,0,0,0,0,0,5,1,4,0,0,0,0,0,0,0,0,0
101879,21040,210,40,-2,13,4,9,0,0,0,0,0,0,3,0,3,0,0,0,0,0,0,10,4,6,0,0,0,0,0,0,0,0,0
101897,21040,210,40,-2,2,2,0,0,0,0,0,0,0,0,0,0,0,0,0,0,0,0,2,2,0,0,0,0,0,0,0,0,0,0
102049,21040,210,40,-2,10,2,8,0,0,0,0,0,0,1,0,1,1,0,1,0,0,0,8,2,6,0,0,0,0,0,0,0,0,0
102067,21040,210,40,-2,2,1,1,0,0,0,0,0,0,1,1,0,0,0,0,0,0,0,1,0,1,0,0,0,0,0,0,0,0,0
102094,21040,210,40,-2,48,25,23,0,0,0,6,4,2,3,1,2,1,0,1,0,0,0,34,20,14,3,0,3,1,0,1,0,0,0
102234,21040,210,40,-2,3,0,3,0,0,0,0,0,0,0,0,0,0,0,0,0,0,0,3,0,3,0,0,0,0,0,0,0,0,0
102368,21040,210,40,-2,22,10,12,0,0,0,0,0,0,0,0,0,0,0,0,0,0,0,15,5,10,1,0,1,0,0,0,6,5,1
102377,21040,210,40,-2,2,1,1,0,0,0,0,0,0,1,0,1,0,0,0,0,0,0,1,1,0,0,0,0,0,0,0,0,0,0
102553,21040,210,40,-2,16,6,10,1,0,1,1,0,1,0,0,0,0,0,0,0,0,0,12,5,7,1,0,1,1,1,0,0,0,0
102614,21040,210,40,-2,4,2,2,0,0,0,0,0,0,0,0,0,0,0,0,0,0,0,2,2,0,1,0,1,1,0,1,0,0,0
102632,21040,210,40,-2,4,2,2,0,0,0,1,0,1,0,0,0,0,0,0,0,0,0,3,2,1,0,0,0,0,0,0,0,0,0
102669,21040,210,40,-2,5,0,5,0,0,0,0,0,0,0,0,0,0,0,0,0,0,0,5,0,5,0,0,0,0,0,0,0,0,0
102845,21040,210,40,-2,29,13,16,1,0,1,1,0,1,5,2,3,3,1,2,0,0,0,19,10,9,0,0,0,0,0,0,0,0,0
103893,21040,210,40,-2,15,2,13,0,0,0,0,0,0,0,0,0,1,1,0,0,0,0,12,1,11,1,0,1,1,0,1,0,0,0
103909,21040,210,40,-2,7,3,4,0,0,0,0,0,0,0,0,0,1,0,1,0,0,0,5,2,3,0,0,0,1,1,0,0,0,0
103927,21040,210,40,-2,6,0,6,0,0,0,0,0,0,1,0,1,0,0,0,0,0,0,5,0,5,0,0,0,0,0,0,0,0,0
104090,21040,210,40,-2,8,2,6,0,0,0,0,0,0,0,0,0,0,0,0,0,0,0,7,2,5,1,0,1,0,0,0,0,0,0
104151,21040,210,40,-2,159,67,92,1,0,1,7,3,4,5,3,2,17,4,13,0,0,0,79,38,41,3,1,2,38,15,23,9,3,6
104160,21040,210,40,-2,14,6,8,0,0,0,1,0,1,0,0,0,3,1,2,0,0,0,6,4,2,0,0,0,4,1,3,0,0,0
104179,21040,210,40,-2,56,31,25,1,1,0,5,4,1,5,3,2,5,2,3,0,0,0,33,16,17,0,0,0,2,1,1,5,4,1
104346,21040,210,40,-2,3,3,0,0,0,0,0,0,0,1,1,0,0,0,0,0,0,0,2,2,0,0,0,0,0,0,0,0,0,0
104425,21040,210,40,-2,17,8,9,0,0,0,0,0,0,1,0,1,3,2,1,0,0,0,12,6,6,0,0,0,1,0,1,0,0,0
104577,21040,210,40,-2,3,2,1,0,0,0,0,0,0,0,0,0,0,0,0,0,0,0,3,2,1,0,0,0,0,0,0,0,0,0
104586,21040,210,40,-2,10,9,1,0,0,0,1,1,0,1,1,0,0,0,0,0,0,0,8,7,1,0,0,0,0,0,0,0,0,0
104708,21040,210,40,-2,11,4,7,0,0,0,0,0,0,0,0,0,0,0,0,0,0,0,11,4,7,0,0,0,0,0,0,0,0,0
104717,21040,210,40,-2,55,13,42,0,0,0,3,3,0,13,2,11,2,0,2,0,0,0,34,8,26,2,0,2,1,0,1,0,0,0
105145,21040,210,40,-2,1,0,1,0,0,0,0,0,0,0,0,0,0,0,0,0,0,0,1,0,1,0,0,0,0,0,0,0,0,0
105154,21040,210,40,-2,19,10,9,0,0,0,1,1,0,1,0,1,3,0,3,0,0,0,12,8,4,2,1,1,0,0,0,0,0,0
105206,21040,210,40,-2,6,1,5,0,0,0,1,0,1,0,0,0,0,0,0,0,0,0,3,0,3,1,0,1,1,1,0,0,0,0
105297,21040,210,40,-2,4,4,0,3,3,0,0,0,0,0,0,0,0,0,0,0,0,0,1,1,0,0,0,0,0,0,0,0,0,0
105330,21040,210,40,-2,66,27,39,0,0,0,3,0,3,1,1,0,2,0,2,0,0,0,58,25,33,0,0,0,2,1,1,0,0,0
105428,21040,210,40,-2,5,0,5,0,0,0,0,0,0,0,0,0,1,0,1,0,0,0,4,0,4,0,0,0,0,0,0,0,0,0
105525,21040,210,40,-2,5,2,3,1,1,0,0,0,0,1,0,1,0,0,0,0,0,0,3,1,2,0,0,0,0,0,0,0,0,0
105534,21040,210,40,-2,12,5,7,0,0,0,0,0,0,0,0,0,4,0,4,0,0,0,5,2,3,3,3,0,0,0,0,0,0,0
105543,21040,210,40,-2,10,1,9,0,0,0,0,0,0,0,0,0,3,0,3,0,0,0,7,1,6,0,0,0,0,0,0,0,0,0
105589,21040,210,40,-2,3,1,2,0,0,0,0,0,0,1,0,1,0,0,0,0,0,0,1,1,0,0,0,0,1,0,1,0,0,0
105659,21040,210,40,-2,7,6,1,1,0,1,0,0,0,2,2,0,2,2,0,0,0,0,2,2,0,0,0,0,0,0,0,0,0,0
105747,21040,210,40,-2,2,1,1,0,0,0,0,0,0,0,0,0,0,0,0,0,0,0,2,1,1,0,0,0,0,0,0,0,0,0
105899,21040,210,40,-2,1,1,0,0,0,0,0,0,0,0,0,0,0,0,0,0,0,0,1,1,0,0,0,0,0,0,0,0,0,0
106148,21040,210,40,-2,12,8,4,0,0,0,0,0,0,0,0,0,0,0,0,0,0,0,12,8,4,0,0,0,0,0,0,0,0,0
106245,21040,210,40,-2,6,2,4,0,0,0,0,0,0,1,0,1,0,0,0,0,0,0,5,2,3,0,0,0,0,0,0,0,0,0
106263,21040,210,40,-2,2,0,2,0,0,0,0,0,0,0,0,0,0,0,0,0,0,0,2,0,2,0,0,0,0,0,0,0,0,0
106306,21040,210,40,-2,1,1,0,0,0,0,0,0,0,1,1,0,0,0,0,0,0,0,0,0,0,0,0,0,0,0,0,0,0,0
106397,21040,210,40,-2,61,24,37,0,0,0,1,1,0,5,3,2,4,3,1,0,0,0,40,14,26,0,0,0,7,2,5,4,1,3
106412,21040,210,40,-2,2,0,2,0,0,0,0,0,0,1,0,1,0,0,0,0,0,0,1,0,1,0,0,0,0,0,0,0,0,0
106449,21040,210,40,-2,15,8,7,0,0,0,0,0,0,0,0,0,0,0,0,0,0,0,14,7,7,1,1,0,0,0,0,0,0,0
106458,21040,210,40,-2,15,5,10,0,0,0,0,0,0,0,0,0,0,0,0,0,0,0,12,3,9,0,0,0,1,1,0,2,1,1
106467,21040,210,40,-2,8,3,5,0,0,0,1,0,1,0,0,0,0,0,0,0,0,0,6,3,3,0,0,0,1,0,1,0,0,0
106485,21040,210,40,-2,11,6,5,0,0,0,0,0,0,0,0,0,0,0,0,0,0,0,10,6,4,0,0,0,1,0,1,0,0,0
106546,21040,210,40,-2,11,1,10,0,0,0,0,0,0,0,0,0,0,0,0,0,0,0,11,1,10,0,0,0,0,0,0,0,0,0
106625,21040,210,40,-2,6,3,3,0,0,0,0,0,0,0,0,0,0,0,0,0,0,0,6,3,3,0,0,0,0,0,0,0,0,0
106704,21040,210,40,-2,16,8,8,0,0,0,0,0,0,3,1,2,0,0,0,0,0,0,12,6,6,1,1,0,0,0,0,0,0,0
106713,21040,210,40,-2,3,0,3,0,0,0,0,0,0,0,0,0,0,0,0,0,0,0,3,0,3,0,0,0,0,0,0,0,0,0
106795,21040,210,40,-2,6,2,4,0,0,0,0,0,0,0,0,0,0,0,0,0,0,0,6,2,4,0,0,0,0,0,0,0,0,0
106810,21040,210,40,-2,5,2,3,0,0,0,0,0,0,0,0,0,0,0,0,0,0,0,5,2,3,0,0,0,0,0,0,0,0,0
106883,21040,210,40,-2,5,2,3,0,0,0,0,0,0,0,0,0,0,0,0,0,0,0,5,2,3,0,0,0,0,0,0,0,0,0
106980,21040,210,40,-2,13,7,6,0,0,0,0,0,0,0,0,0,0,0,0,0,0,0,13,7,6,0,0,0,0,0,0,0,0,0
106999,21040,210,40,-2,5,2,3,0,0,0,0,0,0,0,0,0,0,0,0,0,0,0,5,2,3,0,0,0,0,0,0,0,0,0
107044,21040,210,40,-2,14,4,10,0,0,0,0,0,0,0,0,0,1,0,1,0,0,0,12,4,8,0,0,0,0,0,0,1,0,1
107071,21040,210,40,-2,3,3,0,0,0,0,0,0,0,0,0,0,0,0,0,0,0,0,3,3,0,0,0,0,0,0,0,0,0,0
107080,21040,210,40,-2,5,2,3,0,0,0,0,0,0,0,0,0,0,0,0,0,0,0,4,2,2,0,0,0,0,0,0,1,0,1
107141,21040,210,40,-2,4,1,3,0,0,0,0,0,0,0,0,0,0,0,0,0,0,0,3,1,2,0,0,0,1,0,1,0,0,0
107318,21040,210,40,-2,2,2,0,0,0,0,0,0,0,1,1,0,0,0,0,0,0,0,1,1,0,0,0,0,0,0,0,0,0,0
107327,21040,210,40,-2,2,1,1,0,0,0,0,0,0,0,0,0,0,0,0,0,0,0,2,1,1,0,0,0,0,0,0,0,0,0
107460,21040,210,40,-2,4,1,3,0,0,0,0,0,0,0,0,0,0,0,0,0,0,0,4,1,3,0,0,0,0,0,0,0,0,0
107512,21040,210,40,-2,5,3,2,0,0,0,0,0,0,0,0,0,0,0,0,0,0,0,5,3,2,0,0,0,0,0,0,0,0,0
107521,21040,210,40,-2,14,8,6,0,0,0,0,0,0,4,2,2,0,0,0,0,0,0,10,6,4,0,0,0,0,0,0,0,0,0
107549,21040,210,40,-2,7,4,3,0,0,0,0,0,0,0,0,0,0,0,0,0,0,0,7,4,3,0,0,0,0,0,0,0,0,0
107558,21040,210,40,-2,2,0,2,0,0,0,0,0,0,0,0,0,0,0,0,0,0,0,2,0,2,0,0,0,0,0,0,0,0,0
107585,21040,210,40,-2,5,3,2,0,0,0,0,0,0,0,0,0,0,0,0,0,0,0,5,3,2,0,0,0,0,0,0,0,0,0
107600,21040,210,40,-2,2,0,2,0,0,0,1,0,1,1,0,1,0,0,0,0,0,0,0,0,0,0,0,0,0,0,0,0,0,0
107619,21040,210,40,-2,4,0,4,0,0,0,0,0,0,1,0,1,0,0,0,0,0,0,3,0,3,0,0,0,0,0,0,0,0,0
107637,21040,210,40,-2,12,4,8,0,0,0,0,0,0,5,3,2,1,1,0,0,0,0,5,0,5,1,0,1,0,0,0,0,0,0
107664,21040,210,40,-2,9,7,2,0,0,0,0,0,0,2,1,1,0,0,0,0,0,0,6,5,1,0,0,0,1,1,0,0,0,0
107725,21040,210,40,-2,4,2,2,0,0,0,0,0,0,0,0,0,0,0,0,0,0,0,4,2,2,0,0,0,0,0,0,0,0,0
107743,21040,210,40,-2,1,0,1,0,0,0,0,0,0,0,0,0,0,0,0,0,0,0,1,0,1,0,0,0,0,0,0,0,0,0
107840,21040,210,40,-2,2,1,1,0,0,0,0,0,0,2,1,1,0,0,0,0,0,0,0,0,0,0,0,0,0,0,0,0,0,0
107974,21040,210,40,-2,3,0,3,0,0,0,0,0,0,1,0,1,0,0,0,0,0,0,2,0,2,0,0,0,0,0,0,0,0,0
107983,21040,210,40,-2,3,2,1,0,0,0,0,0,0,0,0,0,0,0,0,0,0,0,3,2,1,0,0,0,0,0,0,0,0,0
107992,21040,210,40,-2,12,6,6,0,0,0,0,0,0,2,0,2,0,0,0,0,0,0,10,6,4,0,0,0,0,0,0,0,0,0
108092,21040,210,40,-2,10,4,6,0,0,0,3,3,0,0,0,0,0,0,0,0,0,0,7,1,6,0,0,0,0,0,0,0,0,0
108232,21040,210,40,-2,2,2,0,0,0,0,0,0,0,0,0,0,0,0,0,0,0,0,2,2,0,0,0,0,0,0,0,0,0,0
108870,21040,210,40,-2,1,1,0,0,0,0,0,0,0,0,0,0,0,0,0,0,0,0,1,1,0,0,0,0,0,0,0,0,0,0
109208,21040,210,40,-2,1,1,0,0,0,0,0,0,0,0,0,0,1,1,0,0,0,0,0,0,0,0,0,0,0,0,0,0,0,0
109785,21040,210,40,-2,12,3,9,0,0,0,4,1,3,3,1,2,1,1,0,0,0,0,4,0,4,0,0,0,0,0,0,0,0,0
110219,21040,210,40,-2,3,0,3,0,0,0,0,0,0,1,0,1,0,0,0,0,0,0,2,0,2,0,0,0,0,0,0,0,0,0
110316,21040,210,40,-2,3,1,2,0,0,0,0,0,0,2,1,1,0,0,0,0,0,0,1,0,1,0,0,0,0,0,0,0,0,0
110361,21040,210,40,-2,10,2,8,0,0,0,0,0,0,1,0,1,0,0,0,0,0,0,9,2,7,0,0,0,0,0,0,0,0,0
110370,21040,210,40,-2,1,0,1,0,0,0,0,0,0,0,0,0,0,0,0,0,0,0,0,0,0,0,0,0,0,0,0,1,0,1
110404,21040,210,40,-2,13,9,4,0,0,0,1,0,1,0,0,0,2,2,0,0,0,0,4,1,3,0,0,0,0,0,0,6,6,0
110413,21040,210,40,-2,10,4,6,0,0,0,0,0,0,1,1,0,2,1,1,0,0,0,6,2,4,1,0,1,0,0,0,0,0,0
110422,21040,210,40,-2,15,9,6,0,0,0,2,2,0,0,0,0,3,2,1,0,0,0,6,4,2,0,0,0,0,0,0,4,1,3
110468,21040,210,40,-2,9,3,6,0,0,0,1,0,1,1,0,1,1,0,1,0,0,0,6,3,3,0,0,0,0,0,0,0,0,0
110486,21040,210,40,-2,8,4,4,0,0,0,1,0,1,0,0,0,3,2,1,0,0,0,1,1,0,2,1,1,1,0,1,0,0,0
110495,21040,210,40,-2,9,3,6,1,1,0,1,0,1,2,1,1,0,0,0,0,0,0,3,0,3,1,0,1,1,1,0,0,0,0
110510,21040,210,40,-2,10,4,6,0,0,0,0,0,0,1,0,1,0,0,0,0,0,0,8,4,4,0,0,0,1,0,1,0,0,0
110538,21040,210,40,-2,3,3,0,0,0,0,0,0,0,0,0,0,0,0,0,0,0,0,2,2,0,0,0,0,0,0,0,1,1,0
110547,21040,210,40,-2,3,0,3,0,0,0,0,0,0,0,0,0,1,0,1,0,0,0,1,0,1,0,0,0,1,0,1,0,0,0
110556,21040,210,40,-2,5,1,4,0,0,0,2,1,1,0,0,0,2,0,2,0,0,0,1,0,1,0,0,0,0,0,0,0,0,0
110565,21040,210,40,-2,4,2,2,0,0,0,1,0,1,1,1,0,0,0,0,0,0,0,2,1,1,0,0,0,0,0,0,0,0,0
110574,21040,210,40,-2,2,2,0,0,0,0,0,0,0,1,1,0,0,0,0,0,0,0,1,1,0,0,0,0,0,0,0,0,0,0
110583,21040,210,40,-2,4,0,4,0,0,0,1,0,1,0,0,0,0,0,0,0,0,0,3,0,3,0,0,0,0,0,0,0,0,0
110592,21040,210,40,-2,5,1,4,0,0,0,2,0,2,0,0,0,1,0,1,0,0,0,1,0,1,0,0,0,1,1,0,0,0,0
110608,21040,210,40,-2,2,1,1,0,0,0,0,0,0,0,0,0,0,0,0,0,0,0,1,0,1,0,0,0,1,1,0,0,0,0
110617,21040,210,40,-2,1,1,0,0,0,0,0,0,0,0,0,0,0,0,0,0,0,0,0,0,0,0,0,0,1,1,0,0,0,0
110635,21040,210,40,-2,61,32,29,0,0,0,7,2,5,3,1,2,2,2,0,0,0,0,33,19,14,1,0,1,7,4,3,8,4,4
110644,21040,210,40,-2,158,68,90,0,0,0,20,4,16,7,3,4,16,3,13,0,0,0,77,37,40,2,1,1,8,1,7,28,19,9
110653,21040,210,40,-2,116,64,52,0,0,0,27,18,9,3,0,3,6,3,3,1,1,0,55,26,29,3,2,1,11,8,3,10,6,4
110662,21040,210,40,-2,322,172,150,0,0,0,96,42,54,6,3,3,22,15,7,1,0,1,124,73,51,9,5,4,19,9,10,45,25,20
110671,21040,210,40,-2,29,17,12,0,0,0,5,4,1,1,1,0,5,1,4,0,0,0,11,5,6,1,1,0,1,1,0,5,4,1
110680,21040,210,40,-2,152,66,86,1,0,1,32,12,20,2,0,2,14,7,7,0,0,0,72,32,40,2,0,2,7,3,4,22,12,10
110699,21040,210,40,-2,216,91,125,0,0,0,65,25,40,15,6,9,15,10,5,0,0,0,84,35,49,8,3,5,13,5,8,16,7,9
110705,21040,210,40,-2,27,16,11,0,0,0,5,2,3,0,0,0,2,2,0,0,0,0,10,6,4,1,0,1,1,0,1,8,6,2
110714,21040,210,40,-2,12,4,8,0,0,0,1,0,1,1,1,0,1,1,0,0,0,0,5,2,3,2,0,2,0,0,0,2,0,2
111081,21040,210,40,-2,8,4,4,0,0,0,2,1,1,1,1,0,0,0,0,0,0,0,3,1,2,0,0,0,0,0,0,2,1,1
111188,21040,210,40,-2,2,2,0,0,0,0,0,0,0,0,0,0,0,0,0,0,0,0,2,2,0,0,0,0,0,0,0,0,0,0
111391,21040,210,40,-2,3,1,2,0,0,0,0,0,0,0,0,0,0,0,0,0,0,0,3,1,2,0,0,0,0,0,0,0,0,0
111887,21040,210,40,-2,1,1,0,0,0,0,0,0,0,0,0,0,0,0,0,0,0,0,1,1,0,0,0,0,0,0,0,0,0,0
111920,21040,210,40,-2,1,1,0,0,0,0,0,0,0,0,0,0,0,0,0,0,0,0,1,1,0,0,0,0,0,0,0,0,0,0
111939,21040,210,40,-2,4,2,2,0,0,0,0,0,0,0,0,0,2,1,1,0,0,0,2,1,1,0,0,0,0,0,0,0,0,0
111948,21040,210,40,-2,23,10,13,0,0,0,2,0,2,1,1,0,4,1,3,0,0,0,10,5,5,0,0,0,6,3,3,0,0,0
111966,21040,210,40,-2,7,2,5,0,0,0,2,1,1,2,0,2,0,0,0,0,0,0,1,0,1,0,0,0,2,1,1,0,0,0
112075,21040,210,40,-2,9,4,5,0,0,0,0,0,0,1,0,1,0,0,0,0,0,0,4,2,2,0,0,0,4,2,2,0,0,0
112127,21040,210,40,-2,1,0,1,0,0,0,1,0,1,0,0,0,0,0,0,0,0,0,0,0,0,0,0,0,0,0,0,0,0,0
112251,21040,210,40,-2,1,0,1,0,0,0,0,0,0,0,0,0,1,0,1,0,0,0,0,0,0,0,0,0,0,0,0,0,0,0
112260,21040,210,40,-2,12,4,8,0,0,0,3,1,2,0,0,0,1,0,1,0,0,0,4,2,2,0,0,0,1,1,0,3,0,3
112394,21040,210,40,-2,1,1,0,0,0,0,0,0,0,0,0,0,0,0,0,0,0,0,1,1,0,0,0,0,0,0,0,0,0,0
112525,21040,210,40,-2,18,7,11,0,0,0,6,3,3,2,0,2,1,1,0,0,0,0,5,1,4,1,0,1,3,2,1,0,0,0
112561,21040,210,40,-2,18,9,9,0,0,0,0,0,0,1,0,1,2,0,2,0,0,0,13,8,5,2,1,1,0,0,0,0,0,0
112570,21040,210,40,-2,1,1,0,0,0,0,0,0,0,1,1,0,0,0,0,0,0,0,0,0,0,0,0,0,0,0,0,0,0,0
112826,21040,210,40,-2,6,1,5,0,0,0,0,0,0,1,0,1,1,0,1,0,0,0,3,1,2,1,0,1,0,0,0,0,0,0
113333,21040,210,40,-2,2,1,1,0,0,0,0,0,0,0,0,0,0,0,0,0,0,0,1,1,0,0,0,0,0,0,0,1,0,1
113573,21040,210,40,-2,5,4,1,0,0,0,0,0,0,0,0,0,2,2,0,0,0,0,3,2,1,0,0,0,0,0,0,0,0,0
113698,21040,210,40,-2,5,3,2,0,0,0,0,0,0,0,0,0,0,0,0,0,0,0,4,3,1,0,0,0,1,0,1,0,0,0
114266,21040,210,40,-2,5,0,5,0,0,0,3,0,3,0,0,0,1,0,1,0,0,0,0,0,0,0,0,0,1,0,1,0,0,0
114433,21040,210,40,-2,2,1,1,0,0,0,0,0,0,0,0,0,2,1,1,0,0,0,0,0,0,0,0,0,0,0,0,0,0,0
114549,21040,210,40,-2,2,2,0,0,0,0,0,0,0,0,0,0,0,0,0,0,0,0,2,2,0,0,0,0,0,0,0,0,0,0
114716,21040,210,40,-2,4,1,3,0,0,0,0,0,0,0,0,0,2,0,2,0,0,0,2,1,1,0,0,0,0,0,0,0,0,0
114789,21040,210,40,-2,7,3,4,1,1,0,0,0,0,1,0,1,1,1,0,0,0,0,3,1,2,1,0,1,0,0,0,0,0,0
114813,21040,210,40,-2,1,0,1,0,0,0,0,0,0,0,0,0,1,0,1,0,0,0,0,0,0,0,0,0,0,0,0,0,0,0
114840,21040,210,40,-2,1,0,1,0,0,0,0,0,0,1,0,1,0,0,0,0,0,0,0,0,0,0,0,0,0,0,0,0,0,0
114938,21040,210,40,-2,1,0,1,0,0,0,0,0,0,0,0,0,1,0,1,0,0,0,0,0,0,0,0,0,0,0,0,0,0,0
115083,21040,210,40,-2,3,0,3,0,0,0,0,0,0,0,0,0,0,0,0,0,0,0,3,0,3,0,0,0,0,0,0,0,0,0
115296,21040,210,40,-2,1,1,0,0,0,0,0,0,0,0,0,0,0,0,0,0,0,0,0,0,0,0,0,0,1,1,0,0,0,0
115409,21040,210,40,-2,3,1,2,0,0,0,0,0,0,0,0,0,0,0,0,0,0,0,2,1,1,0,0,0,1,0,1,0,0,0
115728,21040,210,40,-2,2,1,1,0,0,0,1,1,0,1,0,1,0,0,0,0,0,0,0,0,0,0,0,0,0,0,0,0,0,0
115746,21040,210,40,-2,6,2,4,0,0,0,0,0,0,0,0,0,0,0,0,0,0,0,6,2,4,0,0,0,0,0,0,0,0,0
115755,21040,210,40,-2,5,4,1,0,0,0,1,1,0,0,0,0,1,0,1,0,0,0,0,0,0,0,0,0,3,3,0,0,0,0
115861,21040,210,40,-2,10,1,9,0,0,0,1,0,1,1,0,1,7,1,6,0,0,0,1,0,1,0,0,0,0,0,0,0,0,0
115931,21040,210,40,-2,7,5,2,0,0,0,0,0,0,2,1,1,3,2,1,0,0,0,2,2,0,0,0,0,0,0,0,0,0,0
117140,21040,210,40,-2,3,2,1,0,0,0,0,0,0,0,0,0,0,0,0,0,0,0,2,1,1,0,0,0,1,1,0,0,0,0
117168,21040,210,40,-2,1,0,1,0,0,0,1,0,1,0,0,0,0,0,0,0,0,0,0,0,0,0,0,0,0,0,0,0,0,0
117557,21040,210,40,-2,1,1,0,0,0,0,0,0,0,0,0,0,0,0,0,0,0,0,1,1,0,0,0,0,0,0,0,0,0,0
117636,21040,210,40,-2,22,5,17,0,0,0,3,0,3,2,1,1,3,2,1,0,0,0,12,2,10,1,0,1,0,0,0,1,0,1
117672,21040,210,40,-2,1,0,1,0,0,0,0,0,0,0,0,0,0,0,0,0,0,0,0,0,0,1,0,1,0,0,0,0,0,0
117715,21040,210,40,-2,1,0,1,0,0,0,0,0,0,0,0,0,0,0,0,0,0,0,0,0,0,0,0,0,1,0,1,0,0,0
117751,21040,210,40,-2,3,1,2,0,0,0,0,0,0,1,0,1,0,0,0,0,0,0,2,1,1,0,0,0,0,0,0,0,0,0
117894,21040,210,40,-2,7,4,3,0,0,0,2,1,1,2,1,1,0,0,0,0,0,0,3,2,1,0,0,0,0,0,0,0,0,0
117946,21040,210,40,-2,20,5,15,0,0,0,2,1,1,3,1,2,1,0,1,0,0,0,7,1,6,0,0,0,7,2,5,0,0,0
118198,21040,210,40,-2,1,1,0,0,0,0,0,0,0,0,0,0,0,0,0,0,0,0,1,1,0,0,0,0,0,0,0,0,0,0
118347,21040,210,40,-2,1,1,0,0,0,0,0,0,0,0,0,0,0,0,0,0,0,0,1,1,0,0,0,0,0,0,0,0,0,0
118684,21040,210,40,-2,3,1,2,0,0,0,1,0,1,0,0,0,2,1,1,0,0,0,0,0,0,0,0,0,0,0,0,0,0,0
118693,21040,210,40,-2,4,2,2,0,0,0,0,0,0,0,0,0,0,0,0,0,0,0,3,2,1,0,0,0,1,0,1,0,0,0
118718,21040,210,40,-2,1,0,1,0,0,0,0,0,0,0,0,0,1,0,1,0,0,0,0,0,0,0,0,0,0,0,0,0,0,0
118976,21040,210,40,-2,69,25,44,0,0,0,3,0,3,0,0,0,17,5,12,0,0,0,48,20,28,1,0,1,0,0,0,0,0,0
119058,21040,210,40,-2,1,0,1,0,0,0,0,0,0,0,0,0,0,0,0,0,0,0,1,0,1,0,0,0,0,0,0,0,0,0
119137,21040,210,40,-2,3,1,2,0,0,0,0,0,0,0,0,0,0,0,0,0,0,0,2,0,2,0,0,0,0,0,0,1,1,0
119173,21040,210,40,-2,7,2,5,0,0,0,2,0,2,0,0,0,1,1,0,0,0,0,4,1,3,0,0,0,0,0,0,0,0,0
119270,21040,210,40,-2,1,0,1,0,0,0,0,0,0,0,0,0,0,0,0,1,0,1,0,0,0,0,0,0,0,0,0,0,0,0
119331,21040,210,40,-2,1,0,1,0,0,0,0,0,0,0,0,0,0,0,0,0,0,0,1,0,1,0,0,0,0,0,0,0,0,0
119605,21040,210,40,-2,7,3,4,0,0,0,0,0,0,1,1,0,0,0,0,0,0,0,4,2,2,0,0,0,2,0,2,0,0,0
119678,21040,210,40,-2,10,8,2,0,0,0,0,0,0,1,0,1,0,0,0,0,0,0,7,6,1,0,0,0,2,2,0,0,0,0
120254,21040,210,40,-2,15,9,6,0,0,0,0,0,0,0,0,0,2,2,0,0,0,0,5,3,2,0,0,0,7,3,4,1,1,0
120290,21040,210,40,-2,4,0,4,0,0,0,1,0,1,2,0,2,1,0,1,0,0,0,0,0,0,0,0,0,0,0,0,0,0,0
120403,21040,210,40,-2,2,0,2,0,0,0,0,0,0,0,0,0,0,0,0,0,0,0,2,0,2,0,0,0,0,0,0,0,0,0
120421,21040,210,40,-2,3,2,1,0,0,0,1,1,0,0,0,0,1,0,1,0,0,0,1,1,0,0,0,0,0,0,0,0,0,0
120661,21040,210,40,-2,3,1,2,1,0,1,0,0,0,0,0,0,1,0,1,0,0,0,1,1,0,0,0,0,0,0,0,0,0,0
120698,21040,210,40,-2,2,1,1,0,0,0,0,0,0,0,0,0,0,0,0,0,0,0,2,1,1,0,0,0,0,0,0,0,0,0
120865,21040,210,40,-2,7,3,4,0,0,0,1,0,1,1,0,1,1,0,1,0,0,0,4,3,1,0,0,0,0,0,0,0,0,0
120883,21040,210,40,-2,27,10,17,0,0,0,5,1,4,3,0,3,2,0,2,0,0,0,14,7,7,1,1,0,2,1,1,0,0,0
121044,21040,210,40,-2,3,1,2,0,0,0,0,0,0,0,0,0,0,0,0,0,0,0,1,1,0,0,0,0,1,0,1,1,0,1
121150,21040,210,40,-2,27,9,18,0,0,0,0,0,0,0,0,0,4,3,1,0,0,0,23,6,17,0,0,0,0,0,0,0,0,0
121309,21040,210,40,-2,1,0,1,0,0,0,0,0,0,0,0,0,0,0,0,0,0,0,0,0,0,1,0,1,0,0,0,0,0,0
121619,21040,210,40,-2,1,0,1,0,0,0,0,0,0,0,0,0,0,0,0,0,0,0,0,0,0,0,0,0,1,0,1,0,0,0
121691,21040,210,40,-2,10,4,6,0,0,0,3,1,2,1,0,1,2,1,1,0,0,0,3,2,1,0,0,0,1,0,1,0,0,0
121707,21040,210,40,-2,1,0,1,0,0,0,0,0,0,0,0,0,0,0,0,0,0,0,1,0,1,0,0,0,0,0,0,0,0,0
122180,21040,210,40,-2,1,1,0,0,0,0,0,0,0,0,0,0,0,0,0,0,0,0,1,1,0,0,0,0,0,0,0,0,0,0
122296,21040,210,40,-2,9,2,7,0,0,0,3,2,1,0,0,0,1,0,1,0,0,0,2,0,2,0,0,0,3,0,3,0,0,0
122409,21040,210,40,-2,26,14,12,2,2,0,3,2,1,1,1,0,6,3,3,0,0,0,12,4,8,0,0,0,1,1,0,1,1,0
122436,21040,210,40,-2,1,0,1,0,0,0,0,0,0,0,0,0,0,0,0,0,0,0,1,0,1,0,0,0,0,0,0,0,0,0
122597,21040,210,40,-2,12,5,7,0,0,0,3,1,2,1,0,1,2,0,2,0,0,0,6,4,2,0,0,0,0,0,0,0,0,0
122612,21040,210,40,-2,12,3,9,0,0,0,1,0,1,3,1,2,2,0,2,0,0,0,5,1,4,0,0,0,1,1,0,0,0,0
122649,21040,210,40,-2,1,1,0,0,0,0,0,0,0,0,0,0,0,0,0,0,0,0,1,1,0,0,0,0,0,0,0,0,0,0
122685,21040,210,40,-2,7,2,5,0,0,0,0,0,0,1,0,1,2,2,0,0,0,0,3,0,3,1,0,1,0,0,0,0,0,0
122694,21040,210,40,-2,4,0,4,0,0,0,1,0,1,0,0,0,0,0,0,0,0,0,2,0,2,1,0,1,0,0,0,0,0,0
122728,21040,210,40,-2,1,1,0,0,0,0,1,1,0,0,0,0,0,0,0,0,0,0,0,0,0,0,0,0,0,0,0,0,0,0
122746,21040,210,40,-2,1,0,1,0,0,0,0,0,0,1,0,1,0,0,0,0,0,0,0,0,0,0,0,0,0,0,0,0,0,0
122755,21040,210,40,-2,8,2,6,0,0,0,2,0,2,1,0,1,1,1,0,0,0,0,3,1,2,0,0,0,1,0,1,0,0,0
122931,21040,210,40,-2,23,16,7,0,0,0,4,3,1,2,2,0,1,0,1,0,0,0,15,11,4,0,0,0,0,0,0,1,0,1
123217,21040,210,40,-2,1,1,0,0,0,0,0,0,0,0,0,0,0,0,0,0,0,0,0,0,0,1,1,0,0,0,0,0,0,0
123299,21040,210,40,-2,1,1,0,0,0,0,0,0,0,0,0,0,0,0,0,0,0,0,0,0,0,0,0,0,1,1,0,0,0,0
123457,21040,210,40,-2,3,3,0,0,0,0,0,0,0,0,0,0,0,0,0,0,0,0,2,2,0,0,0,0,1,1,0,0,0,0
123554,21040,210,40,-2,2,1,1,0,0,0,0,0,0,0,0,0,1,1,0,0,0,0,1,0,1,0,0,0,0,0,0,0,0,0
123572,21040,210,40,-2,2,1,1,0,0,0,0,0,0,0,0,0,0,0,0,0,0,0,0,0,0,0,0,0,0,0,0,2,1,1
123633,21040,210,40,-2,2,1,1,0,0,0,0,0,0,0,0,0,0,0,0,0,0,0,2,1,1,0,0,0,0,0,0,0,0,0
123651,21040,210,40,-2,2,2,0,0,0,0,0,0,0,0,0,0,0,0,0,0,0,0,2,2,0,0,0,0,0,0,0,0,0,0
123679,21040,210,40,-2,10,2,8,0,0,0,2,0,2,0,0,0,3,1,2,0,0,0,3,0,3,1,0,1,1,1,0,0,0,0
123952,21040,210,40,-2,2,2,0,0,0,0,0,0,0,1,1,0,0,0,0,0,0,0,1,1,0,0,0,0,0,0,0,0,0,0
123961,21040,210,40,-2,36,20,16,0,0,0,7,3,4,3,0,3,0,0,0,0,0,0,19,14,5,2,1,1,0,0,0,5,2,3
123970,21040,210,40,-2,5,2,3,0,0,0,1,1,0,2,0,2,0,0,0,0,0,0,1,0,1,0,0,0,0,0,0,1,1,0
124292,21040,210,40,-2,1,1,0,0,0,0,0,0,0,0,0,0,0,0,0,0,0,0,1,1,0,0,0,0,0,0,0,0,0,0
124706,21040,210,40,-2,4,1,3,0,0,0,0,0,0,0,0,0,1,0,1,0,0,0,1,0,1,1,0,1,1,1,0,0,0,0
124937,21040,210,40,-2,4,2,2,0,0,0,1,0,1,0,0,0,2,2,0,0,0,0,1,0,1,0,0,0,0,0,0,0,0,0
125028,21040,210,40,-2,2,1,1,0,0,0,0,0,0,0,0,0,0,0,0,0,0,0,2,1,1,0,0,0,0,0,0,0,0,0
125231,21040,210,40,-2,14,5,9,0,0,0,0,0,0,9,3,6,1,0,1,0,0,0,2,1,1,1,0,1,1,1,0,0,0,0
125532,21040,210,40,-2,8,0,8,1,0,1,1,0,1,2,0,2,0,0,0,1,0,1,3,0,3,0,0,0,0,0,0,0,0,0
125727,21040,210,40,-2,5,4,1,0,0,0,1,1,0,2,1,1,0,0,0,0,0,0,1,1,0,0,0,0,1,1,0,0,0,0
125763,21040,210,40,-2,3,2,1,0,0,0,0,0,0,0,0,0,1,1,0,0,0,0,2,1,1,0,0,0,0,0,0,0,0,0
125897,21040,210,40,-2,2,2,0,0,0,0,0,0,0,0,0,0,0,0,0,0,0,0,2,2,0,0,0,0,0,0,0,0,0,0
126119,21040,210,40,-2,12,4,8,0,0,0,1,0,1,0,0,0,1,1,0,0,0,0,10,3,7,0,0,0,0,0,0,0,0,0
126182,21040,210,40,-2,5,4,1,0,0,0,0,0,0,0,0,0,0,0,0,0,0,0,4,3,1,0,0,0,0,0,0,1,1,0
126207,21040,210,40,-2,1,0,1,0,0,0,0,0,0,0,0,0,0,0,0,0,0,0,1,0,1,0,0,0,0,0,0,0,0,0
126562,21040,210,40,-2,239,55,184,1,0,1,12,0,12,2,1,1,11,4,7,0,0,0,156,37,119,3,0,3,51,13,38,3,0,3
126580,21040,210,40,-2,8,2,6,0,0,0,1,1,0,0,0,0,1,0,1,0,0,0,6,1,5,0,0,0,0,0,0,0,0,0
126614,21040,210,40,-2,21,11,10,0,0,0,3,2,1,1,1,0,1,0,1,0,0,0,9,4,5,0,0,0,1,1,0,6,3,3
126669,21040,210,40,-2,13,4,9,0,0,0,1,1,0,0,0,0,0,0,0,0,0,0,11,3,8,1,0,1,0,0,0,0,0,0
126687,21040,210,40,-2,6,0,6,0,0,0,1,0,1,0,0,0,1,0,1,0,0,0,3,0,3,1,0,1,0,0,0,0,0,0
126711,21040,210,40,-2,8,2,6,0,0,0,0,0,0,0,0,0,1,1,0,0,0,0,7,1,6,0,0,0,0,0,0,0,0,0
126748,21040,210,40,-2,4,1,3,0,0,0,0,0,0,1,1,0,1,0,1,0,0,0,2,0,2,0,0,0,0,0,0,0,0,0
126775,21040,210,40,-2,18,9,9,0,0,0,0,0,0,0,0,0,1,1,0,0,0,0,10,6,4,0,0,0,6,1,5,1,1,0
126818,21040,210,40,-2,15,10,5,0,0,0,0,0,0,0,0,0,1,1,0,0,0,0,10,6,4,0,0,0,4,3,1,0,0,0
126863,21040,210,40,-2,9,4,5,1,1,0,2,0,2,0,0,0,0,0,0,0,0,0,5,2,3,0,0,0,0,0,0,1,1,0
126942,21040,210,40,-2,14,4,10,0,0,0,1,0,1,0,0,0,1,1,0,0,0,0,10,2,8,1,0,1,1,1,0,0,0,0
126951,21040,210,40,-2,17,15,2,0,0,0,0,0,0,1,1,0,0,0,0,0,0,0,16,14,2,0,0,0,0,0,0,0,0,0
126979,21040,210,40,-2,3,1,2,0,0,0,0,0,0,1,0,1,0,0,0,0,0,0,2,1,1,0,0,0,0,0,0,0,0,0
127060,21040,210,40,-2,36,16,20,3,0,3,0,0,0,2,1,1,3,1,2,0,0,0,15,7,8,9,5,4,2,2,0,2,0,2
127185,21040,210,40,-2,5,1,4,0,0,0,0,0,0,0,0,0,0,0,0,0,0,0,4,0,4,0,0,0,1,1,0,0,0,0
127200,21040,210,40,-2,1,1,0,0,0,0,1,1,0,0,0,0,0,0,0,0,0,0,0,0,0,0,0,0,0,0,0,0,0,0
127556,21040,210,40,-2,20,8,12,0,0,0,0,0,0,0,0,0,1,0,1,0,0,0,19,8,11,0,0,0,0,0,0,0,0,0
127565,21040,210,40,-2,15,6,9,0,0,0,5,3,2,2,1,1,2,0,2,0,0,0,5,1,4,0,0,0,1,1,0,0,0,0
127617,21040,210,40,-2,3,3,0,0,0,0,0,0,0,0,0,0,1,1,0,0,0,0,2,2,0,0,0,0,0,0,0,0,0,0
127653,21040,210,40,-2,13,2,11,0,0,0,0,0,0,2,0,2,2,0,2,0,0,0,5,1,4,0,0,0,4,1,3,0,0,0
127732,21040,210,40,-2,8,3,5,0,0,0,0,0,0,0,0,0,0,0,0,0,0,0,8,3,5,0,0,0,0,0,0,0,0,0
127741,21040,210,40,-2,11,5,6,0,0,0,2,1,1,0,0,0,2,1,1,0,0,0,7,3,4,0,0,0,0,0,0,0,0,0
127778,21040,210,40,-2,3,0,3,1,0,1,0,0,0,0,0,0,1,0,1,0,0,0,1,0,1,0,0,0,0,0,0,0,0,0
127820,21040,210,40,-2,24,11,13,1,1,0,1,0,1,4,1,3,1,0,1,0,0,0,16,9,7,1,0,1,0,0,0,0,0,0
127884,21040,210,40,-2,8,2,6,1,0,1,1,1,0,0,0,0,1,0,1,0,0,0,5,1,4,0,0,0,0,0,0,0,0,0
127909,21040,210,40,-2,6,3,3,0,0,0,2,1,1,0,0,0,0,0,0,0,0,0,4,2,2,0,0,0,0,0,0,0,0,0
127918,21040,210,40,-2,18,6,12,0,0,0,0,0,0,2,0,2,1,0,1,0,0,0,12,5,7,1,1,0,2,0,2,0,0,0
127945,21040,210,40,-2,6,1,5,0,0,0,0,0,0,0,0,0,0,0,0,0,0,0,6,1,5,0,0,0,0,0,0,0,0,0
128106,21040,210,40,-2,18,9,9,0,0,0,5,2,3,0,0,0,2,1,1,0,0,0,10,5,5,0,0,0,1,1,0,0,0,0
128179,21040,210,40,-2,6,2,4,1,1,0,0,0,0,1,0,1,2,0,2,0,0,0,2,1,1,0,0,0,0,0,0,0,0,0
128188,21040,210,40,-2,15,5,10,0,0,0,0,0,0,0,0,0,3,1,2,0,0,0,8,3,5,0,0,0,4,1,3,0,0,0
128258,21040,210,40,-2,4,2,2,0,0,0,0,0,0,0,0,0,0,0,0,0,0,0,4,2,2,0,0,0,0,0,0,0,0,0
128328,21040,210,40,-2,53,31,22,0,0,0,1,0,1,0,0,0,0,0,0,0,0,0,43,26,17,0,0,0,9,5,4,0,0,0
128391,21040,210,40,-2,12,8,4,0,0,0,0,0,0,0,0,0,2,1,1,0,0,0,9,7,2,0,0,0,0,0,0,1,0,1
128498,21040,210,40,-2,5,1,4,0,0,0,1,0,1,1,1,0,2,0,2,0,0,0,1,0,1,0,0,0,0,0,0,0,0,0
128744,21040,210,40,-2,132,68,64,0,0,0,12,9,3,9,4,5,9,3,6,0,0,0,91,44,47,2,2,0,9,6,3,0,0,0
128771,21040,210,40,-2,7,4,3,0,0,0,0,0,0,0,0,0,1,1,0,0,0,0,6,3,3,0,0,0,0,0,0,0,0,0
128902,21040,210,40,-2,5,4,1,0,0,0,0,0,0,0,0,0,0,0,0,0,0,0,4,3,1,0,0,0,0,0,0,1,1,0
129020,21040,210,40,-2,76,32,44,0,0,0,13,6,7,3,1,2,1,1,0,0,0,0,41,14,27,2,1,1,2,0,2,14,9,5
129154,21040,210,40,-2,4,0,4,0,0,0,1,0,1,0,0,0,0,0,0,0,0,0,2,0,2,1,0,1,0,0,0,0,0,0
129215,21040,210,40,-2,2,1,1,0,0,0,1,0,1,0,0,0,0,0,0,0,0,0,1,1,0,0,0,0,0,0,0,0,0,0
129242,21040,210,40,-2,15,6,9,0,0,0,1,0,1,1,1,0,2,1,1,0,0,0,11,4,7,0,0,0,0,0,0,0,0,0
129525,21040,210,40,-2,22,12,10,0,0,0,0,0,0,2,2,0,1,1,0,0,0,0,15,7,8,1,0,1,1,1,0,2,1,1
129543,21040,210,40,-2,1,1,0,0,0,0,0,0,0,0,0,0,0,0,0,0,0,0,1,1,0,0,0,0,0,0,0,0,0,0
129774,21040,210,40,-2,2,1,1,0,0,0,0,0,0,0,0,0,0,0,0,0,0,0,2,1,1,0,0,0,0,0,0,0,0,0
129941,21040,210,40,-2,9,3,6,0,0,0,0,0,0,0,0,0,0,0,0,0,0,0,9,3,6,0,0,0,0,0,0,0,0,0
130110,21040,210,40,-2,6,2,4,0,0,0,1,0,1,0,0,0,0,0,0,0,0,0,5,2,3,0,0,0,0,0,0,0,0,0
130183,21040,210,40,-2,2,0,2,0,0,0,0,0,0,0,0,0,0,0,0,0,0,0,2,0,2,0,0,0,0,0,0,0,0,0
130226,21040,210,40,-2,12,6,6,0,0,0,1,1,0,0,0,0,0,0,0,0,0,0,11,5,6,0,0,0,0,0,0,0,0,0
130253,21040,210,40,-2,25,5,20,0,0,0,1,0,1,3,0,3,3,0,3,0,0,0,15,4,11,0,0,0,3,1,2,0,0,0
130314,21040,210,40,-2,5,0,5,0,0,0,0,0,0,0,0,0,2,0,2,0,0,0,3,0,3,0,0,0,0,0,0,0,0,0
130493,21040,210,40,-2,2,0,2,0,0,0,1,0,1,0,0,0,0,0,0,0,0,0,1,0,1,0,0,0,0,0,0,0,0,0
130590,21040,210,40,-2,17,9,8,0,0,0,2,1,1,4,2,2,2,1,1,0,0,0,7,5,2,1,0,1,0,0,0,1,0,1
130606,21040,210,40,-2,1,1,0,0,0,0,0,0,0,0,0,0,0,0,0,0,0,0,1,1,0,0,0,0,0,0,0,0,0,0
130624,21040,210,40,-2,7,3,4,0,0,0,0,0,0,0,0,0,1,1,0,0,0,0,6,2,4,0,0,0,0,0,0,0,0,0
130697,21040,210,40,-2,22,10,12,1,0,1,2,0,2,3,0,3,3,3,0,0,0,0,10,5,5,0,0,0,0,0,0,3,2,1
130776,21040,210,40,-2,1,0,1,0,0,0,0,0,0,0,0,0,0,0,0,0,0,0,0,0,0,1,0,1,0,0,0,0,0,0
130794,21040,210,40,-2,84,36,48,0,0,0,12,5,7,8,2,6,3,1,2,0,0,0,36,17,19,2,0,2,3,1,2,20,10,10
130907,21040,210,40,-2,21,6,15,1,0,1,0,0,0,6,3,3,0,0,0,0,0,0,14,3,11,0,0,0,0,0,0,0,0,0
130934,21040,210,40,-2,21,8,13,0,0,0,2,0,2,2,0,2,0,0,0,0,0,0,17,8,9,0,0,0,0,0,0,0,0,0
130943,21040,210,40,-2,20,11,9,0,0,0,0,0,0,2,1,1,3,3,0,0,0,0,12,5,7,0,0,0,0,0,0,3,2,1
131113,21040,210,40,-2,3,1,2,0,0,0,1,1,0,0,0,0,1,0,1,0,0,0,1,0,1,0,0,0,0,0,0,0,0,0
131159,21040,210,40,-2,35,12,23,0,0,0,4,2,2,8,4,4,0,0,0,0,0,0,21,4,17,0,0,0,2,2,0,0,0,0
131283,21040,210,40,-2,4,3,1,0,0,0,0,0,0,0,0,0,2,2,0,0,0,0,2,1,1,0,0,0,0,0,0,0,0,0
131450,21040,210,40,-2,2,1,1,0,0,0,0,0,0,1,1,0,0,0,0,0,0,0,1,0,1,0,0,0,0,0,0,0,0,0
131469,21040,210,40,-2,40,12,28,0,0,0,5,2,3,5,0,5,3,0,3,0,0,0,24,8,16,0,0,0,3,2,1,0,0,0
131496,21040,210,40,-2,42,20,22,0,0,0,3,1,2,4,2,2,1,0,1,0,0,0,18,7,11,0,0,0,5,2,3,11,8,3
131520,21040,210,40,-2,62,27,35,0,0,0,8,2,6,31,15,16,7,4,3,0,0,0,6,2,4,3,1,2,7,3,4,0,0,0
131803,21040,210,40,-2,11,8,3,0,0,0,3,2,1,2,1,1,0,0,0,0,0,0,3,3,0,0,0,0,3,2,1,0,0,0
131876,21040,210,40,-2,4,1,3,0,0,0,0,0,0,3,1,2,0,0,0,0,0,0,1,0,1,0,0,0,0,0,0,0,0,0
132408,21040,210,40,-2,1,0,1,0,0,0,0,0,0,0,0,0,0,0,0,0,0,0,1,0,1,0,0,0,0,0,0,0,0,0
132471,21040,210,40,-2,16,5,11,0,0,0,0,0,0,3,0,3,2,0,2,0,0,0,7,3,4,0,0,0,1,1,0,3,1,2
132602,21040,210,40,-2,2,0,2,0,0,0,0,0,0,1,0,1,0,0,0,0,0,0,1,0,1,0,0,0,0,0,0,0,0,0
132657,21040,210,40,-2,11,7,4,0,0,0,0,0,0,0,0,0,3,2,1,1,0,1,5,4,1,2,1,1,0,0,0,0,0,0
132693,21040,210,40,-2,3,1,2,0,0,0,0,0,0,2,1,1,0,0,0,0,0,0,1,0,1,0,0,0,0,0,0,0,0,0
132842,21040,210,40,-2,4,2,2,0,0,0,0,0,0,0,0,0,4,2,2,0,0,0,0,0,0,0,0,0,0,0,0,0,0,0
132851,21040,210,40,-2,2,0,2,0,0,0,0,0,0,0,0,0,0,0,0,0,0,0,1,0,1,1,0,1,0,0,0,0,0,0
132879,21040,210,40,-2,1,0,1,0,0,0,0,0,0,0,0,0,0,0,0,0,0,0,1,0,1,0,0,0,0,0,0,0,0,0
132903,21040,210,40,-2,10,3,7,0,0,0,1,0,1,1,1,0,2,0,2,0,0,0,5,2,3,1,0,1,0,0,0,0,0,0
133465,21040,210,40,-2,8,2,6,0,0,0,0,0,0,4,0,4,1,0,1,0,0,0,2,1,1,0,0,0,1,1,0,0,0,0
133492,21040,210,40,-2,11,4,7,0,0,0,1,1,0,0,0,0,0,0,0,0,0,0,9,3,6,0,0,0,1,0,1,0,0,0
133508,21040,210,40,-2,1,1,0,0,0,0,0,0,0,1,1,0,0,0,0,0,0,0,0,0,0,0,0,0,0,0,0,0,0,0
133553,21040,210,40,-2,23,11,12,0,0,0,3,2,1,0,0,0,1,1,0,0,0,0,14,7,7,0,0,0,2,1,1,3,0,3
133669,21040,210,40,-2,7,4,3,0,0,0,0,0,0,1,0,1,1,0,1,0,0,0,4,3,1,0,0,0,0,0,0,1,1,0
133702,21040,210,40,-2,2,2,0,0,0,0,0,0,0,0,0,0,0,0,0,0,0,0,2,2,0,0,0,0,0,0,0,0,0,0
133711,21040,210,40,-2,14,9,5,0,0,0,1,1,0,1,0,1,0,0,0,0,0,0,11,7,4,0,0,0,1,1,0,0,0,0
133809,21040,210,40,-2,2,1,1,0,0,0,0,0,0,0,0,0,0,0,0,0,0,0,2,1,1,0,0,0,0,0,0,0,0,0
133845,21040,210,40,-2,5,0,5,0,0,0,0,0,0,1,0,1,2,0,2,0,0,0,2,0,2,0,0,0,0,0,0,0,0,0
133854,21040,210,40,-2,1,1,0,0,0,0,0,0,0,1,1,0,0,0,0,0,0,0,0,0,0,0,0,0,0,0,0,0,0,0
133863,21040,210,40,-2,4,1,3,0,0,0,1,1,0,0,0,0,2,0,2,0,0,0,0,0,0,0,0,0,1,0,1,0,0,0
133872,21040,210,40,-2,6,0,6,0,0,0,0,0,0,1,0,1,3,0,3,0,0,0,2,0,2,0,0,0,0,0,0,0,0,0
133881,21040,210,40,-2,12,9,3,1,1,0,1,0,1,0,0,0,0,0,0,0,0,0,8,6,2,0,0,0,1,1,0,1,1,0
133951,21040,210,40,-2,89,45,44,0,0,0,5,3,2,8,2,6,27,12,15,0,0,0,42,21,21,0,0,0,0,0,0,7,7,0
134079,21040,210,40,-2,5,3,2,0,0,0,0,0,0,1,0,1,0,0,0,0,0,0,4,3,1,0,0,0,0,0,0,0,0,0
134097,21040,210,40,-2,60,29,31,0,0,0,1,0,1,5,4,1,4,2,2,0,0,0,45,22,23,0,0,0,1,0,1,4,1,3
134130,21040,210,40,-2,39,19,20,0,0,0,2,1,1,3,1,2,4,3,1,0,0,0,24,9,15,0,0,0,1,1,0,5,4,1
134237,21040,210,40,-2,24,19,5,0,0,0,1,1,0,2,1,1,5,3,2,0,0,0,15,13,2,1,1,0,0,0,0,0,0,0
134343,21040,210,40,-2,12,3,9,0,0,0,0,0,0,1,0,1,1,0,1,0,0,0,8,2,6,0,0,0,2,1,1,0,0,0
134495,21040,210,40,-2,1,1,0,0,0,0,0,0,0,0,0,0,0,0,0,0,0,0,1,1,0,0,0,0,0,0,0,0,0,0
134608,21040,210,40,-2,2,1,1,0,0,0,0,0,0,1,0,1,0,0,0,0,0,0,1,1,0,0,0,0,0,0,0,0,0,0
134945,21040,210,40,-2,10,2,8,0,0,0,1,0,1,3,1,2,0,0,0,0,0,0,6,1,5,0,0,0,0,0,0,0,0,0
135081,21040,210,40,-2,37,16,21,1,1,0,2,0,2,9,3,6,8,4,4,0,0,0,15,7,8,2,1,1,0,0,0,0,0,0
135160,21040,210,40,-2,1,0,1,0,0,0,0,0,0,0,0,0,0,0,0,0,0,0,1,0,1,0,0,0,0,0,0,0,0,0
135391,21040,210,40,-2,4,2,2,0,0,0,0,0,0,1,1,0,0,0,0,0,0,0,3,1,2,0,0,0,0,0,0,0,0,0
135726,21040,210,40,-2,31,16,15,0,0,0,2,2,0,2,1,1,7,4,3,0,0,0,14,5,9,0,0,0,3,1,2,3,3,0
136145,21040,210,40,-2,2,0,2,0,0,0,0,0,0,0,0,0,0,0,0,0,0,0,2,0,2,0,0,0,0,0,0,0,0,0
136172,21040,210,40,-2,23,9,14,0,0,0,4,2,2,2,0,2,0,0,0,1,0,1,15,6,9,0,0,0,0,0,0,1,1,0
136215,21040,210,40,-2,108,46,62,0,0,0,6,2,4,9,1,8,14,7,7,0,0,0,65,28,37,0,0,0,1,1,0,13,7,6
136233,21040,210,40,-2,12,6,6,0,0,0,0,0,0,1,0,1,3,2,1,0,0,0,6,3,3,1,1,0,0,0,0,1,0,1
136330,21040,210,40,-2,11,6,5,0,0,0,0,0,0,2,2,0,2,1,1,0,0,0,6,2,4,0,0,0,0,0,0,1,1,0
136473,21040,210,40,-2,8,4,4,0,0,0,0,0,0,0,0,0,0,0,0,0,0,0,7,4,3,1,0,1,0,0,0,0,0,0
136516,21040,210,40,-2,5,0,5,0,0,0,0,0,0,1,0,1,0,0,0,0,0,0,4,0,4,0,0,0,0,0,0,0,0,0
136701,21040,210,40,-2,4,4,0,0,0,0,1,1,0,0,0,0,1,1,0,0,0,0,1,1,0,0,0,0,0,0,0,1,1,0
136774,21040,210,40,-2,6,3,3,0,0,0,0,0,0,0,0,0,1,1,0,0,0,0,5,2,3,0,0,0,0,0,0,0,0,0
136950,21040,210,40,-2,23,9,14,0,0,0,1,0,1,1,0,1,2,1,1,0,0,0,16,8,8,0,0,0,1,0,1,2,0,2
137078,21040,210,40,-2,9,0,9,0,0,0,0,0,0,0,0,0,1,0,1,0,0,0,6,0,6,0,0,0,2,0,2,0,0,0
137315,21040,210,40,-2,3,3,0,0,0,0,0,0,0,0,0,0,0,0,0,0,0,0,3,3,0,0,0,0,0,0,0,0,0,0
137351,21040,210,40,-2,131,55,76,0,0,0,18,10,8,5,1,4,7,3,4,0,0,0,70,29,41,12,5,7,2,1,1,17,6,11
137476,21040,210,40,-2,15,8,7,0,0,0,0,0,0,1,1,0,5,2,3,0,0,0,9,5,4,0,0,0,0,0,0,0,0,0
137546,21040,210,40,-2,8,5,3,0,0,0,0,0,0,0,0,0,0,0,0,0,0,0,7,5,2,0,0,0,0,0,0,1,0,1
137564,21040,210,40,-2,6,3,3,0,0,0,0,0,0,0,0,0,0,0,0,0,0,0,6,3,3,0,0,0,0,0,0,0,0,0
137759,21040,210,40,-2,7,2,5,0,0,0,0,0,0,0,0,0,0,0,0,0,0,0,6,1,5,0,0,0,1,1,0,0,0,0
137847,21040,210,40,-2,28,17,11,0,0,0,5,4,1,4,1,3,1,1,0,0,0,0,10,6,4,1,1,0,7,4,3,0,0,0
137962,21040,210,40,-2,1,1,0,0,0,0,0,0,0,0,0,0,0,0,0,0,0,0,1,1,0,0,0,0,0,0,0,0,0,0
138187,21040,210,40,-2,5,0,5,0,0,0,0,0,0,3,0,3,0,0,0,0,0,0,2,0,2,0,0,0,0,0,0,0,0,0
138275,21040,210,40,-2,4,2,2,0,0,0,0,0,0,2,0,2,0,0,0,0,0,0,2,2,0,0,0,0,0,0,0,0,0,0
138293,21040,210,40,-2,5,2,3,0,0,0,0,0,0,0,0,0,0,0,0,0,0,0,5,2,3,0,0,0,0,0,0,0,0,0
138309,21040,210,40,-2,35,5,30,0,0,0,0,0,0,8,0,8,0,0,0,0,0,0,26,5,21,1,0,1,0,0,0,0,0,0
138354,21040,210,40,-2,7,3,4,0,0,0,1,1,0,1,0,1,0,0,0,0,0,0,5,2,3,0,0,0,0,0,0,0,0,0
138558,21040,210,40,-2,2,0,2,0,0,0,0,0,0,0,0,0,0,0,0,0,0,0,2,0,2,0,0,0,0,0,0,0,0,0
138600,21040,210,40,-2,3,2,1,0,0,0,1,1,0,0,0,0,0,0,0,0,0,0,2,1,1,0,0,0,0,0,0,0,0,0
138682,21040,210,40,-2,15,6,9,0,0,0,2,1,1,10,3,7,0,0,0,0,0,0,2,1,1,0,0,0,1,1,0,0,0,0
138716,21040,210,40,-2,11,3,8,0,0,0,2,2,0,6,1,5,1,0,1,0,0,0,2,0,2,0,0,0,0,0,0,0,0,0
138761,21040,210,40,-2,4,2,2,0,0,0,0,0,0,1,1,0,0,0,0,0,0,0,3,1,2,0,0,0,0,0,0,0,0,0
138840,21040,210,40,-2,14,3,11,1,0,1,0,0,0,12,3,9,1,0,1,0,0,0,0,0,0,0,0,0,0,0,0,0,0,0
138868,21040,210,40,-2,4,3,1,0,0,0,0,0,0,0,0,0,0,0,0,0,0,0,4,3,1,0,0,0,0,0,0,0,0,0
138901,21040,210,40,-2,1,1,0,0,0,0,0,0,0,1,1,0,0,0,0,0,0,0,0,0,0,0,0,0,0,0,0,0,0,0
138947,21040,210,40,-2,22,11,11,0,0,0,3,2,1,17,7,10,0,0,0,0,0,0,1,1,0,0,0,0,0,0,0,1,1,0
138956,21040,210,40,-2,16,7,9,0,0,0,0,0,0,7,2,5,2,1,1,0,0,0,7,4,3,0,0,0,0,0,0,0,0,0
139144,21040,210,40,-2,14,8,6,0,0,0,1,1,0,2,0,2,1,0,1,0,0,0,8,6,2,1,0,1,0,0,0,1,1,0
139199,21040,210,40,-2,20,4,16,0,0,0,3,2,1,2,0,2,1,0,1,0,0,0,14,2,12,0,0,0,0,0,0,0,0,0
139205,21040,210,40,-2,4,3,1,0,0,0,0,0,0,0,0,0,0,0,0,0,0,0,4,3,1,0,0,0,0,0,0,0,0,0
139250,21040,210,40,-2,7,4,3,0,0,0,0,0,0,1,1,0,1,1,0,0,0,0,5,2,3,0,0,0,0,0,0,0,0,0
139278,21040,210,40,-2,18,5,13,0,0,0,0,0,0,4,1,3,0,0,0,0,0,0,14,4,10,0,0,0,0,0,0,0,0,0
139311,21040,210,40,-2,3,2,1,0,0,0,0,0,0,0,0,0,0,0,0,0,0,0,3,2,1,0,0,0,0,0,0,0,0,0
139357,21040,210,40,-2,19,6,13,0,0,0,1,1,0,9,2,7,1,1,0,0,0,0,8,2,6,0,0,0,0,0,0,0,0,0
139393,21040,210,40,-2,1,1,0,0,0,0,0,0,0,0,0,0,0,0,0,0,0,0,1,1,0,0,0,0,0,0,0,0,0,0
139463,21040,210,40,-2,3,1,2,0,0,0,1,0,1,0,0,0,0,0,0,0,0,0,2,1,1,0,0,0,0,0,0,0,0,0
139579,21040,210,40,-2,5,2,3,0,0,0,0,0,0,2,1,1,0,0,0,0,0,0,3,1,2,0,0,0,0,0,0,0,0,0
139630,21040,210,40,-2,3,2,1,0,0,0,0,0,0,0,0,0,0,0,0,0,0,0,3,2,1,0,0,0,0,0,0,0,0,0
139658,21040,210,40,-2,28,6,22,0,0,0,11,1,10,4,1,3,0,0,0,0,0,0,12,4,8,0,0,0,0,0,0,1,0,1
139700,21040,210,40,-2,4,0,4,0,0,0,0,0,0,0,0,0,1,0,1,0,0,0,2,0,2,1,0,1,0,0,0,0,0,0
139719,21040,210,40,-2,4,1,3,0,0,0,0,0,0,3,0,3,0,0,0,0,0,0,1,1,0,0,0,0,0,0,0,0,0,0
139755,21040,210,40,-2,10,5,5,0,0,0,1,0,1,1,1,0,1,1,0,0,0,0,5,1,4,1,1,0,0,0,0,1,1,0
139764,21040,210,40,-2,1,0,1,0,0,0,0,0,0,0,0,0,0,0,0,0,0,0,1,0,1,0,0,0,0,0,0,0,0,0
139861,21040,210,40,-2,9,4,5,0,0,0,0,0,0,1,0,1,1,0,1,0,0,0,6,4,2,0,0,0,0,0,0,1,0,1
139931,21040,210,40,-2,33,14,19,0,0,0,5,2,3,2,0,2,1,0,1,0,0,0,23,10,13,0,0,0,2,2,0,0,0,0
139940,21040,210,40,-2,52,23,29,0,0,0,6,2,4,14,4,10,2,0,2,0,0,0,24,12,12,0,0,0,1,1,0,5,4,1
139959,21040,210,40,-2,35,20,15,0,0,0,3,3,0,3,2,1,2,1,1,0,0,0,17,9,8,1,1,0,1,0,1,8,4,4
139968,21040,210,40,-2,1,0,1,0,0,0,0,0,0,0,0,0,0,0,0,0,0,0,1,0,1,0,0,0,0,0,0,0,0,0
140012,21040,210,40,-2,13,6,7,0,0,0,0,0,0,5,2,3,1,1,0,0,0,0,7,3,4,0,0,0,0,0,0,0,0,0
140146,21040,210,40,-2,1,0,1,0,0,0,0,0,0,1,0,1,0,0,0,0,0,0,0,0,0,0,0,0,0,0,0,0,0,0
140243,21040,210,40,-2,13,2,11,0,0,0,2,0,2,1,0,1,1,1,0,0,0,0,9,1,8,0,0,0,0,0,0,0,0,0
140252,21040,210,40,-2,7,4,3,0,0,0,0,0,0,0,0,0,0,0,0,0,0,0,7,4,3,0,0,0,0,0,0,0,0,0
140331,21040,210,40,-2,18,7,11,0,0,0,0,0,0,4,0,4,1,0,1,0,0,0,13,7,6,0,0,0,0,0,0,0,0,0
140447,21040,210,40,-2,25,9,16,0,0,0,4,2,2,7,0,7,1,0,1,0,0,0,12,6,6,0,0,0,0,0,0,1,1,0
140562,21040,210,40,-2,19,6,13,0,0,0,3,1,2,13,4,9,0,0,0,0,0,0,2,1,1,1,0,1,0,0,0,0,0,0
140678,21040,210,40,-2,11,6,5,0,0,0,0,0,0,0,0,0,0,0,0,0,0,0,11,6,5,0,0,0,0,0,0,0,0,0
140696,21040,210,40,-2,13,8,5,0,0,0,1,1,0,3,2,1,0,0,0,0,0,0,8,4,4,1,1,0,0,0,0,0,0,0
140720,21040,210,40,-2,2,1,1,0,0,0,0,0,0,2,1,1,0,0,0,0,0,0,0,0,0,0,0,0,0,0,0,0,0,0
140818,21040,210,40,-2,13,5,8,0,0,0,0,0,0,1,0,1,0,0,0,0,0,0,11,4,7,1,1,0,0,0,0,0,0,0
140872,21040,210,40,-2,5,3,2,0,0,0,0,0,0,1,0,1,0,0,0,0,0,0,4,3,1,0,0,0,0,0,0,0,0,0
140942,21040,210,40,-2,22,10,12,0,0,0,1,0,1,5,0,5,2,1,1,0,0,0,12,8,4,2,1,1,0,0,0,0,0,0
140951,21040,210,40,-2,78,39,39,0,0,0,4,2,2,10,2,8,2,2,0,0,0,0,47,24,23,4,2,2,6,3,3,5,4,1
140960,21040,210,40,-2,1,0,1,0,0,0,0,0,0,0,0,0,0,0,0,0,0,0,1,0,1,0,0,0,0,0,0,0,0,0
141006,21040,210,40,-2,4,3,1,0,0,0,0,0,0,1,1,0,0,0,0,0,0,0,3,2,1,0,0,0,0,0,0,0,0,0
141060,21040,210,40,-2,13,7,6,0,0,0,3,1,2,7,3,4,1,1,0,0,0,0,2,2,0,0,0,0,0,0,0,0,0,0
141167,21040,210,40,-2,10,3,7,0,0,0,0,0,0,2,2,0,0,0,0,0,0,0,8,1,7,0,0,0,0,0,0,0,0,0
141185,21040,210,40,-2,2,2,0,0,0,0,0,0,0,0,0,0,0,0,0,0,0,0,2,2,0,0,0,0,0,0,0,0,0,0
141237,21040,210,40,-2,3,1,2,0,0,0,0,0,0,0,0,0,0,0,0,0,0,0,3,1,2,0,0,0,0,0,0,0,0,0
141255,21040,210,40,-2,24,7,17,0,0,0,0,0,0,3,1,2,0,0,0,0,0,0,21,6,15,0,0,0,0,0,0,0,0,0
141264,21040,210,40,-2,11,2,9,0,0,0,0,0,0,2,0,2,0,0,0,0,0,0,9,2,7,0,0,0,0,0,0,0,0,0
141325,21040,210,40,-2,1,1,0,0,0,0,0,0,0,1,1,0,0,0,0,0,0,0,0,0,0,0,0,0,0,0,0,0,0,0
141334,21040,210,40,-2,13,4,9,0,0,0,0,0,0,4,1,3,0,0,0,0,0,0,8,2,6,0,0,0,1,1,0,0,0,0
141361,21040,210,40,-2,3,2,1,0,0,0,0,0,0,0,0,0,0,0,0,0,0,0,1,1,0,0,0,0,2,1,1,0,0,0
141486,21040,210,40,-2,8,1,7,0,0,0,1,0,1,0,0,0,1,0,1,1,1,0,3,0,3,2,0,2,0,0,0,0,0,0
141574,21040,210,40,-2,6,4,2,0,0,0,1,1,0,0,0,0,0,0,0,0,0,0,4,3,1,1,0,1,0,0,0,0,0,0
141644,21040,210,40,-2,17,3,14,0,0,0,3,0,3,1,0,1,2,0,2,2,1,1,9,2,7,0,0,0,0,0,0,0,0,0
141811,21040,210,40,-2,1,0,1,0,0,0,0,0,0,0,0,0,0,0,0,0,0,0,1,0,1,0,0,0,0,0,0,0,0,0
142054,21040,210,40,-2,10,0,10,0,0,0,0,0,0,0,0,0,1,0,1,0,0,0,7,0,7,1,0,1,1,0,1,0,0,0
142115,21040,210,40,-2,40,13,27,0,0,0,1,0,1,0,0,0,3,2,1,0,0,0,29,7,22,2,0,2,1,0,1,4,4,0
142179,21040,210,40,-2,4,2,2,0,0,0,0,0,0,0,0,0,0,0,0,0,0,0,4,2,2,0,0,0,0,0,0,0,0,0
142276,21040,210,40,-2,11,6,5,0,0,0,1,1,0,0,0,0,0,0,0,0,0,0,9,4,5,0,0,0,1,1,0,0,0,0
142285,21040,210,40,-2,5,3,2,0,0,0,0,0,0,0,0,0,0,0,0,0,0,0,4,3,1,0,0,0,0,0,0,1,0,1
142294,21040,210,40,-2,6,5,1,0,0,0,1,1,0,0,0,0,1,1,0,0,0,0,3,2,1,0,0,0,0,0,0,1,1,0
142328,21040,210,40,-2,4,0,4,0,0,0,0,0,0,0,0,0,0,0,0,0,0,0,4,0,4,0,0,0,0,0,0,0,0,0
142443,21040,210,40,-2,4,2,2,0,0,0,0,0,0,0,0,0,0,0,0,0,0,0,3,2,1,1,0,1,0,0,0,0,0,0
142559,21040,210,40,-2,17,6,11,0,0,0,0,0,0,0,0,0,1,0,1,0,0,0,13,4,9,1,1,0,2,1,1,0,0,0
142832,21040,210,40,-2,9,2,7,0,0,0,0,0,0,3,0,3,1,0,1,0,0,0,4,1,3,0,0,0,1,1,0,0,0,0
143084,21040,210,40,-2,7,2,5,0,0,0,0,0,0,2,1,1,0,0,0,0,0,0,5,1,4,0,0,0,0,0,0,0,0,0
143118,21040,210,40,-2,16,3,13,0,0,0,0,0,0,2,0,2,1,0,1,0,0,0,13,3,10,0,0,0,0,0,0,0,0,0
143279,21040,210,40,-2,2,1,1,0,0,0,0,0,0,0,0,0,0,0,0,0,0,0,1,0,1,0,0,0,1,1,0,0,0,0
143297,21040,210,40,-2,1,0,1,0,0,0,0,0,0,0,0,0,0,0,0,0,0,0,1,0,1,0,0,0,0,0,0,0,0,0
143358,21040,210,40,-2,18,7,11,0,0,0,2,1,1,1,0,1,0,0,0,0,0,0,14,5,9,1,1,0,0,0,0,0,0,0
143853,21040,210,40,-2,3,2,1,0,0,0,1,0,1,0,0,0,0,0,0,0,0,0,2,2,0,0,0,0,0,0,0,0,0,0
143978,21040,210,40,-2,3,1,2,0,0,0,1,1,0,0,0,0,0,0,0,0,0,0,2,0,2,0,0,0,0,0,0,0,0,0
144005,21040,210,40,-2,3,2,1,0,0,0,0,0,0,1,1,0,0,0,0,0,0,0,0,0,0,0,0,0,2,1,1,0,0,0
144014,21040,210,40,-2,1,0,1,0,0,0,1,0,1,0,0,0,0,0,0,0,0,0,0,0,0,0,0,0,0,0,0,0,0,0
144050,21040,210,40,-2,173,94,79,0,0,0,26,9,17,6,3,3,6,2,4,0,0,0,80,46,34,3,1,2,14,9,5,38,24,14
144281,21040,210,40,-2,3,1,2,0,0,0,0,0,0,0,0,0,0,0,0,0,0,0,3,1,2,0,0,0,0,0,0,0,0,0
144351,21040,210,40,-2,4,1,3,0,0,0,0,0,0,0,0,0,0,0,0,0,0,0,4,1,3,0,0,0,0,0,0,0,0,0
144485,21040,210,40,-2,1,1,0,0,0,0,1,1,0,0,0,0,0,0,0,0,0,0,0,0,0,0,0,0,0,0,0,0,0,0
144740,21040,210,40,-2,17,9,8,0,0,0,2,1,1,3,1,2,1,1,0,0,0,0,7,3,4,0,0,0,3,3,0,1,0,1
144865,21040,210,40,-2,5,2,3,0,0,0,0,0,0,0,0,0,1,1,0,0,0,0,4,1,3,0,0,0,0,0,0,0,0,0
144892,21040,210,40,-2,14,5,9,0,0,0,0,0,0,0,0,0,0,0,0,0,0,0,6,1,5,0,0,0,7,3,4,1,1,0
144962,21040,210,40,-2,4,1,3,0,0,0,0,0,0,1,1,0,0,0,0,0,0,0,2,0,2,0,0,0,1,0,1,0,0,0
145239,21040,210,40,-2,4,0,4,0,0,0,0,0,0,1,0,1,0,0,0,0,0,0,3,0,3,0,0,0,0,0,0,0,0,0
145275,21040,210,40,-2,4,1,3,0,0,0,0,0,0,1,0,1,2,1,1,0,0,0,1,0,1,0,0,0,0,0,0,0,0,0
145336,21040,210,40,-2,8,5,3,0,0,0,2,2,0,1,0,1,0,0,0,0,0,0,5,3,2,0,0,0,0,0,0,0,0,0
145558,21040,210,40,-2,4,1,3,0,0,0,3,0,3,0,0,0,0,0,0,0,0,0,1,1,0,0,0,0,0,0,0,0,0,0
145600,21040,210,40,-2,67,26,41,0,0,0,16,7,9,6,3,3,5,1,4,0,0,0,30,10,20,2,0,2,1,1,0,7,4,3
145619,21040,210,40,-2,1,0,1,0,0,0,0,0,0,0,0,0,0,0,0,0,0,0,1,0,1,0,0,0,0,0,0,0,0,0
145637,21040,210,40,-2,47,21,26,2,2,0,3,2,1,4,1,3,5,4,1,0,0,0,26,10,16,1,0,1,2,1,1,4,1,3
145682,21040,210,40,-2,1,0,1,0,0,0,0,0,0,0,0,0,0,0,0,0,0,0,1,0,1,0,0,0,0,0,0,0,0,0
145691,21040,210,40,-2,1,0,1,0,0,0,0,0,0,0,0,0,0,0,0,0,0,0,1,0,1,0,0,0,0,0,0,0,0,0
145707,21040,210,40,-2,1,0,1,0,0,0,0,0,0,0,0,0,0,0,0,0,0,0,1,0,1,0,0,0,0,0,0,0,0,0
145725,21040,210,40,-2,11,9,2,0,0,0,1,1,0,1,1,0,0,0,0,0,0,0,2,2,0,0,0,0,6,4,2,1,1,0
145813,21040,210,40,-2,15,1,14,0,0,0,0,0,0,0,0,0,1,0,1,0,0,0,9,1,8,0,0,0,5,0,5,0,0,0
146339,21040,210,40,-2,4,3,1,0,0,0,0,0,0,0,0,0,1,1,0,0,0,0,1,1,0,0,0,0,0,0,0,2,1,1
146366,21040,210,40,-2,1,1,0,0,0,0,0,0,0,0,0,0,0,0,0,0,0,0,1,1,0,0,0,0,0,0,0,0,0,0
146427,21040,210,40,-2,2,1,1,0,0,0,0,0,0,0,0,0,0,0,0,0,0,0,1,0,1,0,0,0,0,0,0,1,1,0
146472,21040,210,40,-2,1,0,1,0,0,0,0,0,0,0,0,0,0,0,0,0,0,0,1,0,1,0,0,0,0,0,0,0,0,0
146481,21040,210,40,-2,2,1,1,0,0,0,0,0,0,0,0,0,0,0,0,0,0,0,2,1,1,0,0,0,0,0,0,0,0,0
146533,21040,210,40,-2,2,0,2,0,0,0,0,0,0,0,0,0,0,0,0,0,0,0,2,0,2,0,0,0,0,0,0,0,0,0
146612,21040,210,40,-2,9,2,7,0,0,0,0,0,0,0,0,0,0,0,0,0,0,0,9,2,7,0,0,0,0,0,0,0,0,0
146667,21040,210,40,-2,1,1,0,0,0,0,0,0,0,0,0,0,0,0,0,0,0,0,1,1,0,0,0,0,0,0,0,0,0,0
146676,21040,210,40,-2,2,2,0,0,0,0,0,0,0,0,0,0,0,0,0,0,0,0,2,2,0,0,0,0,0,0,0,0,0,0
146700,21040,210,40,-2,8,7,1,0,0,0,0,0,0,2,1,1,1,1,0,0,0,0,5,5,0,0,0,0,0,0,0,0,0,0
146719,21040,210,40,-2,52,28,24,0,0,0,3,2,1,5,2,3,7,4,3,0,0,0,33,18,15,0,0,0,2,1,1,2,1,1
146755,21040,210,40,-2,5,1,4,0,0,0,0,0,0,0,0,0,0,0,0,0,0,0,5,1,4,0,0,0,0,0,0,0,0,0
146816,21040,210,40,-2,1,1,0,0,0,0,0,0,0,0,0,0,0,0,0,0,0,0,1,1,0,0,0,0,0,0,0,0,0,0
147004,21040,210,40,-2,1,0,1,0,0,0,0,0,0,0,0,0,0,0,0,0,0,0,1,0,1,0,0,0,0,0,0,0,0,0
147013,21040,210,40,-2,2,1,1,0,0,0,0,0,0,0,0,0,0,0,0,0,0,0,2,1,1,0,0,0,0,0,0,0,0,0
147129,21040,210,40,-2,2,0,2,0,0,0,0,0,0,0,0,0,0,0,0,0,0,0,2,0,2,0,0,0,0,0,0,0,0,0
147244,21040,210,40,-2,3,2,1,0,0,0,0,0,0,0,0,0,0,0,0,0,0,0,3,2,1,0,0,0,0,0,0,0,0,0
147369,21040,210,40,-2,2,1,1,0,0,0,0,0,0,0,0,0,0,0,0,0,0,0,2,1,1,0,0,0,0,0,0,0,0,0
147411,21040,210,40,-2,1,0,1,0,0,0,0,0,0,0,0,0,0,0,0,0,0,0,1,0,1,0,0,0,0,0,0,0,0,0
147536,21040,210,40,-2,24,2,22,0,0,0,0,0,0,6,1,5,4,0,4,0,0,0,10,1,9,1,0,1,0,0,0,3,0,3
147660,21040,210,40,-2,9,4,5,0,0,0,1,1,0,0,0,0,0,0,0,0,0,0,6,3,3,0,0,0,1,0,1,1,0,1
147679,21040,210,40,-2,3,1,2,0,0,0,2,1,1,0,0,0,0,0,0,0,0,0,1,0,1,0,0,0,0,0,0,0,0,0
147697,21040,210,40,-2,2,0,2,0,0,0,0,0,0,0,0,0,0,0,0,0,0,0,2,0,2,0,0,0,0,0,0,0,0,0
147703,21040,210,40,-2,8,3,5,0,0,0,1,1,0,1,0,1,0,0,0,0,0,0,1,1,0,0,0,0,0,0,0,5,1,4
147767,21040,210,40,-2,60,35,25,0,0,0,12,7,5,5,3,2,6,4,2,0,0,0,20,13,7,1,0,1,1,0,1,15,8,7
147828,21040,210,40,-2,6,3,3,0,0,0,0,0,0,0,0,0,0,0,0,0,0,0,6,3,3,0,0,0,0,0,0,0,0,0
147916,21040,210,40,-2,4,3,1,0,0,0,0,0,0,1,1,0,0,0,0,0,0,0,2,1,1,0,0,0,1,1,0,0,0,0
148016,21040,210,40,-2,4,2,2,0,0,0,0,0,0,0,0,0,0,0,0,0,0,0,2,0,2,0,0,0,2,2,0,0,0,0
148131,21040,210,40,-2,1,1,0,0,0,0,0,0,0,0,0,0,0,0,0,0,0,0,1,1,0,0,0,0,0,0,0,0,0,0
148380,21040,210,40,-2,3,3,0,0,0,0,0,0,0,0,0,0,0,0,0,0,0,0,2,2,0,0,0,0,1,1,0,0,0,0
148487,21040,210,40,-2,8,5,3,0,0,0,1,1,0,1,1,0,0,0,0,0,0,0,1,1,0,0,0,0,5,2,3,0,0,0
148496,21040,210,40,-2,4,1,3,0,0,0,1,1,0,2,0,2,0,0,0,0,0,0,1,0,1,0,0,0,0,0,0,0,0,0
148511,21040,210,40,-2,7,2,5,0,0,0,0,0,0,0,0,0,1,0,1,0,0,0,5,2,3,1,0,1,0,0,0,0,0,0
148575,21040,210,40,-2,1,1,0,0,0,0,0,0,0,0,0,0,0,0,0,0,0,0,1,1,0,0,0,0,0,0,0,0,0,0
148584,21040,210,40,-2,1,0,1,0,0,0,0,0,0,0,0,0,0,0,0,0,0,0,1,0,1,0,0,0,0,0,0,0,0,0
148593,21040,210,40,-2,2,0,2,0,0,0,0,0,0,0,0,0,0,0,0,0,0,0,2,0,2,0,0,0,0,0,0,0,0,0
148627,21040,210,40,-2,8,1,7,0,0,0,1,0,1,0,0,0,0,0,0,0,0,0,2,0,2,0,0,0,5,1,4,0,0,0
148654,21040,210,40,-2,2,1,1,0,0,0,0,0,0,0,0,0,0,0,0,0,0,0,2,1,1,0,0,0,0,0,0,0,0,0
148876,21040,210,40,-2,2,2,0,0,0,0,1,1,0,0,0,0,1,1,0,0,0,0,0,0,0,0,0,0,0,0,0,0,0,0
148982,21040,210,40,-2,1,1,0,0,0,0,0,0,0,0,0,0,0,0,0,0,0,0,1,1,0,0,0,0,0,0,0,0,0,0
149028,21040,210,40,-2,1,0,1,0,0,0,0,0,0,0,0,0,0,0,0,0,0,0,1,0,1,0,0,0,0,0,0,0,0,0
149222,21040,210,40,-2,30,18,12,0,0,0,7,4,3,1,0,1,2,2,0,0,0,0,19,12,7,1,0,1,0,0,0,0,0,0
149329,21040,210,40,-2,1,1,0,0,0,0,0,0,0,0,0,0,0,0,0,0,0,0,1,1,0,0,0,0,0,0,0,0,0,0
149365,21040,210,40,-2,2,1,1,0,0,0,0,0,0,1,0,1,0,0,0,0,0,0,0,0,0,0,0,0,1,1,0,0,0,0
149505,21040,210,40,-2,2,0,2,0,0,0,0,0,0,0,0,0,0,0,0,0,0,0,2,0,2,0,0,0,0,0,0,0,0,0
149639,21040,210,40,-2,1,0,1,0,0,0,0,0,0,0,0,0,1,0,1,0,0,0,0,0,0,0,0,0,0,0,0,0,0,0
149781,21040,210,40,-2,7,4,3,0,0,0,1,0,1,0,0,0,0,0,0,0,0,0,5,4,1,0,0,0,0,0,0,1,0,1
150066,21040,210,40,-2,5,1,4,0,0,0,0,0,0,0,0,0,0,0,0,0,0,0,5,1,4,0,0,0,0,0,0,0,0,0
150136,21040,210,40,-2,1,0,1,0,0,0,0,0,0,0,0,0,0,0,0,0,0,0,1,0,1,0,0,0,0,0,0,0,0,0
150163,21040,210,40,-2,23,11,12,0,0,0,0,0,0,2,1,1,1,0,1,0,0,0,20,10,10,0,0,0,0,0,0,0,0,0
150172,21040,210,40,-2,4,2,2,0,0,0,0,0,0,0,0,0,1,0,1,0,0,0,3,2,1,0,0,0,0,0,0,0,0,0
150400,21040,210,40,-2,10,5,5,0,0,0,3,1,2,0,0,0,3,2,1,0,0,0,4,2,2,0,0,0,0,0,0,0,0,0
150455,21040,210,40,-2,11,7,4,0,0,0,1,1,0,4,3,1,1,1,0,0,0,0,3,2,1,0,0,0,0,0,0,2,0,2
150534,21040,210,40,-2,14,6,8,0,0,0,0,0,0,0,0,0,0,0,0,0,0,0,4,2,2,0,0,0,10,4,6,0,0,0
150604,21040,210,40,-2,4,2,2,0,0,0,0,0,0,0,0,0,0,0,0,0,0,0,4,2,2,0,0,0,0,0,0,0,0,0
150668,21040,210,40,-2,3,0,3,0,0,0,0,0,0,1,0,1,0,0,0,0,0,0,2,0,2,0,0,0,0,0,0,0,0,0
150677,21040,210,40,-2,2,1,1,0,0,0,0,0,0,0,0,0,0,0,0,0,0,0,1,1,0,0,0,0,1,0,1,0,0,0
150756,21040,210,40,-2,7,5,2,0,0,0,0,0,0,2,2,0,0,0,0,0,0,0,5,3,2,0,0,0,0,0,0,0,0,0
150774,21040,210,40,-2,2,1,1,0,0,0,0,0,0,1,0,1,0,0,0,0,0,0,1,1,0,0,0,0,0,0,0,0,0,0
150987,21040,210,40,-2,62,24,38,0,0,0,1,0,1,8,2,6,1,1,0,0,0,0,52,21,31,0,0,0,0,0,0,0,0,0
151102,21040,210,40,-2,2,2,0,0,0,0,1,1,0,0,0,0,0,0,0,0,0,0,0,0,0,0,0,0,0,0,0,1,1,0
151111,21040,210,40,-2,221,96,125,0,0,0,47,16,31,9,1,8,6,1,5,0,0,0,140,66,74,3,2,1,0,0,0,16,10,6
151263,21040,210,40,-2,9,4,5,0,0,0,0,0,0,1,1,0,0,0,0,0,0,0,8,3,5,0,0,0,0,0,0,0,0,0
151306,21040,210,40,-2,6,0,6,0,0,0,0,0,0,0,0,0,0,0,0,0,0,0,5,0,5,0,0,0,0,0,0,1,0,1
151324,21040,210,40,-2,10,5,5,0,0,0,1,0,1,2,1,1,1,1,0,0,0,0,6,3,3,0,0,0,0,0,0,0,0,0
151333,21040,210,40,-2,4,0,4,0,0,0,0,0,0,0,0,0,0,0,0,0,0,0,4,0,4,0,0,0,0,0,0,0,0,0
151342,21040,210,40,-2,15,6,9,0,0,0,0,0,0,2,0,2,0,0,0,0,0,0,13,6,7,0,0,0,0,0,0,0,0,0
151351,21040,210,40,-2,88,40,48,0,0,0,8,3,5,4,2,2,8,3,5,0,0,0,49,23,26,1,0,1,0,0,0,18,9,9
151360,21040,210,40,-2,5,1,4,0,0,0,0,0,0,3,0,3,0,0,0,0,0,0,2,1,1,0,0,0,0,0,0,0,0,0
151379,21040,210,40,-2,1,0,1,0,0,0,0,0,0,0,0,0,0,0,0,0,0,0,1,0,1,0,0,0,0,0,0,0,0,0
151388,21040,210,40,-2,1,0,1,0,0,0,0,0,0,0,0,0,0,0,0,0,0,0,1,0,1,0,0,0,0,0,0,0,0,0
151467,21040,210,40,-2,1,0,1,0,0,0,0,0,0,0,0,0,0,0,0,0,0,0,1,0,1,0,0,0,0,0,0,0,0,0
151661,21040,210,40,-2,14,12,2,0,0,0,0,0,0,2,2,0,0,0,0,0,0,0,12,10,2,0,0,0,0,0,0,0,0,0
151777,21040,210,40,-2,8,2,6,0,0,0,0,0,0,0,0,0,0,0,0,0,0,0,7,1,6,0,0,0,1,1,0,0,0,0
151786,21040,210,40,-2,47,17,30,0,0,0,0,0,0,3,0,3,5,3,2,0,0,0,39,14,25,0,0,0,0,0,0,0,0,0
151801,21040,210,40,-2,11,5,6,0,0,0,1,1,0,2,1,1,0,0,0,0,0,0,7,2,5,0,0,0,1,1,0,0,0,0
151810,21040,210,40,-2,6,4,2,0,0,0,0,0,0,5,3,2,0,0,0,0,0,0,1,1,0,0,0,0,0,0,0,0,0,0
152080,21040,210,40,-2,16,8,8,0,0,0,0,0,0,1,0,1,0,0,0,0,0,0,9,5,4,1,0,1,2,0,2,3,3,0
152099,21040,210,40,-2,5,2,3,0,0,0,2,0,2,0,0,0,0,0,0,0,0,0,2,1,1,0,0,0,1,1,0,0,0,0
152318,21040,210,40,-2,6,4,2,0,0,0,0,0,0,0,0,0,0,0,0,0,0,0,3,3,0,0,0,0,0,0,0,3,1,2
152336,21040,210,40,-2,8,1,7,0,0,0,0,0,0,0,0,0,0,0,0,0,0,0,8,1,7,0,0,0,0,0,0,0,0,0
152381,21040,210,40,-2,2,1,1,0,0,0,0,0,0,0,0,0,0,0,0,0,0,0,2,1,1,0,0,0,0,0,0,0,0,0
152390,21040,210,40,-2,9,2,7,0,0,0,0,0,0,0,0,0,0,0,0,0,0,0,8,2,6,0,0,0,0,0,0,1,0,1
152530,21040,210,40,-2,2,1,1,0,0,0,0,0,0,0,0,0,0,0,0,0,0,0,1,0,1,0,0,0,0,0,0,1,1,0
152567,21040,210,40,-2,8,4,4,0,0,0,0,0,0,0,0,0,0,0,0,0,0,0,8,4,4,0,0,0,0,0,0,0,0,0
152600,21040,210,40,-2,4,1,3,0,0,0,0,0,0,0,0,0,0,0,0,0,0,0,4,1,3,0,0,0,0,0,0,0,0,0
152637,21040,210,40,-2,11,6,5,0,0,0,0,0,0,0,0,0,0,0,0,0,0,0,11,6,5,0,0,0,0,0,0,0,0,0
152673,21040,210,40,-2,2,0,2,0,0,0,0,0,0,0,0,0,0,0,0,0,0,0,2,0,2,0,0,0,0,0,0,0,0,0
152798,21040,210,40,-2,5,2,3,0,0,0,0,0,0,0,0,0,0,0,0,0,0,0,5,2,3,0,0,0,0,0,0,0,0,0
152992,21040,210,40,-2,2,2,0,0,0,0,0,0,0,0,0,0,0,0,0,0,0,0,2,2,0,0,0,0,0,0,0,0,0,0
153001,21040,210,40,-2,3,3,0,0,0,0,0,0,0,0,0,0,1,1,0,0,0,0,2,2,0,0,0,0,0,0,0,0,0,0
153126,21040,210,40,-2,5,1,4,0,0,0,0,0,0,1,0,1,0,0,0,0,0,0,4,1,3,0,0,0,0,0,0,0,0,0
153144,21040,210,40,-2,5,2,3,0,0,0,0,0,0,1,1,0,0,0,0,0,0,0,4,1,3,0,0,0,0,0,0,0,0,0
153214,21040,210,40,-2,22,10,12,0,0,0,3,2,1,0,0,0,1,1,0,0,0,0,18,7,11,0,0,0,0,0,0,0,0,0
153241,21040,210,40,-2,3,1,2,0,0,0,0,0,0,0,0,0,0,0,0,0,0,0,2,1,1,0,0,0,0,0,0,1,0,1
153250,21040,210,40,-2,5,4,1,0,0,0,0,0,0,0,0,0,0,0,0,0,0,0,5,4,1,0,0,0,0,0,0,0,0,0
153269,21040,210,40,-2,10,6,4,0,0,0,1,1,0,0,0,0,0,0,0,0,0,0,7,4,3,0,0,0,0,0,0,2,1,1
153278,21040,210,40,-2,5,3,2,0,0,0,0,0,0,0,0,0,1,1,0,0,0,0,4,2,2,0,0,0,0,0,0,0,0,0
153296,21040,210,40,-2,3,1,2,0,0,0,0,0,0,0,0,0,0,0,0,0,0,0,3,1,2,0,0,0,0,0,0,0,0,0
153311,21040,210,40,-2,6,2,4,0,0,0,0,0,0,1,0,1,1,0,1,0,0,0,4,2,2,0,0,0,0,0,0,0,0,0
153320,21040,210,40,-2,1,0,1,0,0,0,0,0,0,0,0,0,0,0,0,0,0,0,1,0,1,0,0,0,0,0,0,0,0,0
153366,21040,210,40,-2,8,4,4,0,0,0,1,1,0,0,0,0,1,1,0,0,0,0,6,2,4,0,0,0,0,0,0,0,0,0
153375,21040,210,40,-2,6,3,3,0,0,0,1,1,0,0,0,0,0,0,0,0,0,0,5,2,3,0,0,0,0,0,0,0,0,0
153384,21040,210,40,-2,19,7,12,0,0,0,2,0,2,1,1,0,2,1,1,0,0,0,12,4,8,1,0,1,1,1,0,0,0,0
153445,21040,210,40,-2,5,1,4,0,0,0,0,0,0,0,0,0,0,0,0,0,0,0,4,1,3,1,0,1,0,0,0,0,0,0
153472,21040,210,40,-2,4,2,2,0,0,0,0,0,0,0,0,0,0,0,0,0,0,0,4,2,2,0,0,0,0,0,0,0,0,0
153524,21040,210,40,-2,5,1,4,0,0,0,0,0,0,0,0,0,0,0,0,0,0,0,4,1,3,0,0,0,1,0,1,0,0,0
153533,21040,210,40,-2,7,4,3,0,0,0,0,0,0,1,1,0,0,0,0,0,0,0,6,3,3,0,0,0,0,0,0,0,0,0
153603,21040,210,40,-2,30,12,18,0,0,0,1,1,0,0,0,0,1,0,1,0,0,0,23,8,15,0,0,0,0,0,0,5,3,2
153621,21040,210,40,-2,1,1,0,0,0,0,0,0,0,0,0,0,0,0,0,0,0,0,1,1,0,0,0,0,0,0,0,0,0,0
153630,21040,210,40,-2,15,8,7,0,0,0,1,0,1,2,2,0,2,2,0,0,0,0,9,4,5,0,0,0,1,0,1,0,0,0
153658,21040,210,40,-2,63,27,36,0,0,0,9,7,2,5,3,2,1,0,1,0,0,0,24,6,18,0,0,0,9,5,4,15,6,9
153737,21040,210,40,-2,12,4,8,0,0,0,0,0,0,2,1,1,0,0,0,0,0,0,10,3,7,0,0,0,0,0,0,0,0,0
153825,21040,210,40,-2,2,1,1,0,0,0,2,1,1,0,0,0,0,0,0,0,0,0,0,0,0,0,0,0,0,0,0,0,0,0
153834,21040,210,40,-2,1,0,1,0,0,0,1,0,1,0,0,0,0,0,0,0,0,0,0,0,0,0,0,0,0,0,0,0,0,0
153861,21040,210,40,-2,19,13,6,0,0,0,6,5,1,1,0,1,0,0,0,0,0,0,10,6,4,0,0,0,2,2,0,0,0,0
153922,21040,210,40,-2,3,2,1,0,0,0,0,0,0,0,0,0,0,0,0,0,0,0,3,2,1,0,0,0,0,0,0,0,0,0
153977,21040,210,40,-2,4,0,4,0,0,0,0,0,0,0,0,0,0,0,0,0,0,0,3,0,3,1,0,1,0,0,0,0,0,0
154004,21040,210,40,-2,1,1,0,0,0,0,0,0,0,0,0,0,0,0,0,0,0,0,1,1,0,0,0,0,0,0,0,0,0,0
154013,21040,210,40,-2,5,1,4,0,0,0,0,0,0,0,0,0,0,0,0,0,0,0,5,1,4,0,0,0,0,0,0,0,0,0
154022,21040,210,40,-2,7,2,5,0,0,0,1,1,0,2,0,2,2,1,1,0,0,0,2,0,2,0,0,0,0,0,0,0,0,0
154059,21040,210,40,-2,9,5,4,0,0,0,0,0,0,0,0,0,0,0,0,0,0,0,9,5,4,0,0,0,0,0,0,0,0,0
154095,21040,210,40,-2,5,2,3,0,0,0,1,1,0,0,0,0,0,0,0,0,0,0,4,1,3,0,0,0,0,0,0,0,0,0
154110,21040,210,40,-2,6,3,3,0,0,0,0,0,0,0,0,0,0,0,0,0,0,0,4,1,3,0,0,0,2,2,0,0,0,0
154129,21040,210,40,-2,2,1,1,0,0,0,1,0,1,1,1,0,0,0,0,0,0,0,0,0,0,0,0,0,0,0,0,0,0,0
154156,21040,210,40,-2,9,4,5,0,0,0,0,0,0,0,0,0,0,0,0,0,0,0,9,4,5,0,0,0,0,0,0,0,0,0
154174,21040,210,40,-2,10,5,5,0,0,0,2,2,0,0,0,0,0,0,0,0,0,0,8,3,5,0,0,0,0,0,0,0,0,0
154235,21040,210,40,-2,7,2,5,0,0,0,1,0,1,0,0,0,0,0,0,0,0,0,6,2,4,0,0,0,0,0,0,0,0,0
154350,21040,210,40,-2,4,2,2,0,0,0,1,1,0,0,0,0,0,0,0,0,0,0,3,1,2,0,0,0,0,0,0,0,0,0
154378,21040,210,40,-2,6,2,4,0,0,0,0,0,0,0,0,0,0,0,0,0,0,0,6,2,4,0,0,0,0,0,0,0,0,0
154396,21040,210,40,-2,5,3,2,0,0,0,0,0,0,1,1,0,0,0,0,0,0,0,4,2,2,0,0,0,0,0,0,0,0,0
154493,21040,210,40,-2,2,2,0,0,0,0,0,0,0,0,0,0,0,0,0,0,0,0,0,0,0,0,0,0,2,2,0,0,0,0
154527,21040,210,40,-2,2,0,2,0,0,0,0,0,0,0,0,0,0,0,0,0,0,0,2,0,2,0,0,0,0,0,0,0,0,0
154572,21040,210,40,-2,3,1,2,0,0,0,0,0,0,0,0,0,0,0,0,0,0,0,3,1,2,0,0,0,0,0,0,0,0,0
154590,21040,210,40,-2,4,1,3,0,0,0,0,0,0,0,0,0,0,0,0,0,0,0,4,1,3,0,0,0,0,0,0,0,0,0
154688,21040,210,40,-2,1,0,1,0,0,0,0,0,0,0,0,0,0,0,0,0,0,0,0,0,0,0,0,0,1,0,1,0,0,0
154712,21040,210,40,-2,1,1,0,0,0,0,0,0,0,0,0,0,0,0,0,0,0,0,1,1,0,0,0,0,0,0,0,0,0,0
154749,21040,210,40,-2,3,0,3,0,0,0,0,0,0,0,0,0,0,0,0,0,0,0,3,0,3,0,0,0,0,0,0,0,0,0
154800,21040,210,40,-2,11,9,2,0,0,0,0,0,0,0,0,0,1,1,0,0,0,0,10,8,2,0,0,0,0,0,0,0,0,0
154855,21040,210,40,-2,2,1,1,0,0,0,0,0,0,0,0,0,0,0,0,0,0,0,2,1,1,0,0,0,0,0,0,0,0,0
154934,21040,210,40,-2,4,2,2,0,0,0,0,0,0,0,0,0,0,0,0,0,0,0,4,2,2,0,0,0,0,0,0,0,0,0
155007,21040,210,40,-2,5,2,3,0,0,0,0,0,0,1,0,1,0,0,0,0,0,0,3,1,2,0,0,0,1,1,0,0,0,0
155025,21040,210,40,-2,7,2,5,0,0,0,1,1,0,1,0,1,0,0,0,0,0,0,5,1,4,0,0,0,0,0,0,0,0,0
155052,21040,210,40,-2,3,1,2,0,0,0,0,0,0,0,0,0,0,0,0,0,0,0,3,1,2,0,0,0,0,0,0,0,0,0
155061,21040,210,40,-2,20,12,8,0,0,0,3,1,2,1,1,0,0,0,0,0,0,0,12,8,4,2,1,1,1,1,0,1,0,1
155089,21040,210,40,-2,2,1,1,1,0,1,0,0,0,1,1,0,0,0,0,0,0,0,0,0,0,0,0,0,0,0,0,0,0,0
155177,21040,210,40,-2,4,3,1,0,0,0,0,0,0,0,0,0,0,0,0,0,0,0,3,2,1,1,1,0,0,0,0,0,0,0
155186,21040,210,40,-2,8,1,7,0,0,0,0,0,0,0,0,0,0,0,0,0,0,0,8,1,7,0,0,0,0,0,0,0,0,0
155210,21040,210,40,-2,15,7,8,0,0,0,0,0,0,0,0,0,0,0,0,0,0,0,12,5,7,1,0,1,2,2,0,0,0,0
155283,21040,210,40,-2,6,1,5,0,0,0,0,0,0,2,0,2,1,0,1,0,0,0,3,1,2,0,0,0,0,0,0,0,0,0
155308,21040,210,40,-2,1,0,1,0,0,0,0,0,0,0,0,0,0,0,0,0,0,0,1,0,1,0,0,0,0,0,0,0,0,0
155317,21040,210,40,-2,106,51,55,0,0,0,9,7,2,5,3,2,3,0,3,0,0,0,70,31,39,5,0,5,2,0,2,12,10,2
155399,21040,210,40,-2,27,12,15,0,0,0,3,1,2,1,0,1,1,1,0,0,0,0,20,9,11,0,0,0,0,0,0,2,1,1
155414,21040,210,40,-2,6,1,5,0,0,0,1,0,1,0,0,0,0,0,0,0,0,0,5,1,4,0,0,0,0,0,0,0,0,0
155487,21040,210,40,-2,1,0,1,0,0,0,0,0,0,0,0,0,0,0,0,0,0,0,0,0,0,0,0,0,1,0,1,0,0,0
155566,21040,210,40,-2,4,4,0,0,0,0,0,0,0,0,0,0,0,0,0,0,0,0,2,2,0,0,0,0,0,0,0,2,2,0
155627,21040,210,40,-2,1,1,0,0,0,0,0,0,0,0,0,0,0,0,0,0,0,0,1,1,0,0,0,0,0,0,0,0,0,0
155681,21040,210,40,-2,2,1,1,1,1,0,1,0,1,0,0,0,0,0,0,0,0,0,0,0,0,0,0,0,0,0,0,0,0,0
155812,21040,210,40,-2,6,1,5,0,0,0,0,0,0,1,0,1,0,0,0,0,0,0,5,1,4,0,0,0,0,0,0,0,0,0
155858,21040,210,40,-2,4,2,2,0,0,0,0,0,0,0,0,0,1,1,0,0,0,0,3,1,2,0,0,0,0,0,0,0,0,0
155973,21040,210,40,-2,4,3,1,0,0,0,0,0,0,0,0,0,0,0,0,0,0,0,4,3,1,0,0,0,0,0,0,0,0,0
156082,21040,210,40,-2,7,2,5,0,0,0,0,0,0,1,0,1,0,0,0,0,0,0,6,2,4,0,0,0,0,0,0,0,0,0
156125,21040,210,40,-2,17,9,8,0,0,0,1,0,1,0,0,0,1,1,0,0,0,0,11,4,7,0,0,0,1,1,0,3,3,0
156134,21040,210,40,-2,6,2,4,1,1,0,0,0,0,0,0,0,0,0,0,0,0,0,5,1,4,0,0,0,0,0,0,0,0,0
156189,21040,210,40,-2,5,3,2,0,0,0,0,0,0,0,0,0,0,0,0,0,0,0,5,3,2,0,0,0,0,0,0,0,0,0
156213,21040,210,40,-2,2,0,2,0,0,0,0,0,0,0,0,0,0,0,0,0,0,0,2,0,2,0,0,0,0,0,0,0,0,0
156222,21040,210,40,-2,2,1,1,0,0,0,0,0,0,0,0,0,1,0,1,0,0,0,1,1,0,0,0,0,0,0,0,0,0,0
156231,21040,210,40,-2,3,1,2,0,0,0,0,0,0,0,0,0,0,0,0,0,0,0,2,0,2,0,0,0,1,1,0,0,0,0
156286,21040,210,40,-2,3,0,3,0,0,0,0,0,0,0,0,0,0,0,0,0,0,0,3,0,3,0,0,0,0,0,0,0,0,0
156295,21040,210,40,-2,6,1,5,0,0,0,1,0,1,1,0,1,0,0,0,0,0,0,4,1,3,0,0,0,0,0,0,0,0,0
156338,21040,210,40,-2,6,1,5,0,0,0,0,0,0,1,0,1,0,0,0,0,0,0,4,1,3,0,0,0,1,0,1,0,0,0
156356,21040,210,40,-2,1,0,1,0,0,0,0,0,0,0,0,0,0,0,0,0,0,0,1,0,1,0,0,0,0,0,0,0,0,0
156365,21040,210,40,-2,3,1,2,0,0,0,0,0,0,0,0,0,0,0,0,0,0,0,3,1,2,0,0,0,0,0,0,0,0,0
156392,21040,210,40,-2,12,3,9,0,0,0,0,0,0,0,0,0,0,0,0,0,0,0,11,3,8,0,0,0,1,0,1,0,0,0
156408,21040,210,40,-2,12,4,8,0,0,0,1,0,1,1,0,1,1,1,0,0,0,0,7,2,5,0,0,0,2,1,1,0,0,0
156471,21040,210,40,-2,18,1,17,0,0,0,0,0,0,3,0,3,0,0,0,0,0,0,15,1,14,0,0,0,0,0,0,0,0,0
156541,21040,210,40,-2,22,13,9,0,0,0,0,0,0,6,4,2,0,0,0,0,0,0,16,9,7,0,0,0,0,0,0,0,0,0
156620,21040,210,40,-2,22,9,13,0,0,0,0,0,0,1,0,1,0,0,0,0,0,0,14,8,6,1,0,1,1,0,1,5,1,4
156648,21040,210,40,-2,7,4,3,0,0,0,0,0,0,0,0,0,0,0,0,0,0,0,7,4,3,0,0,0,0,0,0,0,0,0
156727,21040,210,40,-2,18,5,13,0,0,0,0,0,0,2,0,2,1,0,1,0,0,0,14,5,9,1,0,1,0,0,0,0,0,0
156745,21040,210,40,-2,4,2,2,0,0,0,1,1,0,0,0,0,0,0,0,0,0,0,3,1,2,0,0,0,0,0,0,0,0,0
156790,21040,210,40,-2,4,0,4,0,0,0,0,0,0,0,0,0,0,0,0,0,0,0,4,0,4,0,0,0,0,0,0,0,0,0
156851,21040,210,40,-2,4,0,4,0,0,0,0,0,0,0,0,0,0,0,0,0,0,0,3,0,3,0,0,0,1,0,1,0,0,0
156860,21040,210,40,-2,10,2,8,0,0,0,0,0,0,0,0,0,0,0,0,0,0,0,10,2,8,0,0,0,0,0,0,0,0,0
156921,21040,210,40,-2,18,7,11,1,1,0,2,1,1,2,1,1,0,0,0,0,0,0,12,4,8,1,0,1,0,0,0,0,0,0
157058,21040,210,40,-2,7,3,4,0,0,0,0,0,0,0,0,0,0,0,0,0,0,0,1,0,1,0,0,0,6,3,3,0,0,0
157076,21040,210,40,-2,1,0,1,0,0,0,0,0,0,0,0,0,0,0,0,0,0,0,1,0,1,0,0,0,0,0,0,0,0,0
157085,21040,210,40,-2,13,8,5,0,0,0,0,0,0,2,2,0,2,2,0,0,0,0,8,3,5,0,0,0,0,0,0,1,1,0
157100,21040,210,40,-2,4,1,3,0,0,0,0,0,0,0,0,0,0,0,0,0,0,0,4,1,3,0,0,0,0,0,0,0,0,0
157216,21040,210,40,-2,13,4,9,0,0,0,0,0,0,1,0,1,1,0,1,0,0,0,11,4,7,0,0,0,0,0,0,0,0,0
157289,21040,210,40,-2,64,34,30,0,0,0,4,3,1,4,1,3,4,3,1,0,0,0,46,23,23,0,0,0,0,0,0,6,4,2
157304,21040,210,40,-2,5,4,1,0,0,0,0,0,0,0,0,0,0,0,0,0,0,0,4,3,1,0,0,0,1,1,0,0,0,0
157331,21040,210,40,-2,5,1,4,0,0,0,0,0,0,0,0,0,0,0,0,0,0,0,5,1,4,0,0,0,0,0,0,0,0,0
157377,21040,210,40,-2,11,4,7,0,0,0,1,1,0,0,0,0,0,0,0,0,0,0,9,3,6,0,0,0,1,0,1,0,0,0
157386,21040,210,40,-2,9,3,6,0,0,0,0,0,0,0,0,0,0,0,0,0,0,0,7,2,5,1,0,1,1,1,0,0,0,0
157438,21040,210,40,-2,9,6,3,0,0,0,0,0,0,1,1,0,0,0,0,0,0,0,8,5,3,0,0,0,0,0,0,0,0,0
157447,21040,210,40,-2,21,8,13,0,0,0,0,0,0,3,1,2,0,0,0,0,0,0,15,5,10,0,0,0,0,0,0,3,2,1
157483,21040,210,40,-2,8,3,5,0,0,0,0,0,0,1,0,1,0,0,0,0,0,0,7,3,4,0,0,0,0,0,0,0,0,0
157535,21040,210,40,-2,21,8,13,0,0,0,4,1,3,1,1,0,0,0,0,0,0,0,15,5,10,0,0,0,1,1,0,0,0,0
157553,21040,210,40,-2,5,3,2,0,0,0,0,0,0,0,0,0,0,0,0,0,0,0,5,3,2,0,0,0,0,0,0,0,0,0
157711,21040,210,40,-2,6,4,2,0,0,0,0,0,0,0,0,0,1,1,0,0,0,0,5,3,2,0,0,0,0,0,0,0,0,0
157739,21040,210,40,-2,4,1,3,0,0,0,0,0,0,0,0,0,0,0,0,0,0,0,4,1,3,0,0,0,0,0,0,0,0,0
157748,21040,210,40,-2,1,1,0,0,0,0,0,0,0,0,0,0,0,0,0,0,0,0,0,0,0,0,0,0,1,1,0,0,0,0
157757,21040,210,40,-2,5,0,5,0,0,0,0,0,0,1,0,1,0,0,0,0,0,0,4,0,4,0,0,0,0,0,0,0,0,0
157809,21040,210,40,-2,7,3,4,0,0,0,1,1,0,0,0,0,0,0,0,0,0,0,6,2,4,0,0,0,0,0,0,0,0,0
157818,21040,210,40,-2,3,1,2,0,0,0,0,0,0,0,0,0,0,0,0,0,0,0,3,1,2,0,0,0,0,0,0,0,0,0
157863,21040,210,40,-2,3,1,2,0,0,0,0,0,0,0,0,0,0,0,0,0,0,0,3,1,2,0,0,0,0,0,0,0,0,0
157951,21040,210,40,-2,30,14,16,0,0,0,1,0,1,1,1,0,1,0,1,0,0,0,26,13,13,0,0,0,1,0,1,0,0,0
158088,21040,210,40,-2,17,5,12,0,0,0,0,0,0,4,1,3,0,0,0,0,0,0,7,2,5,0,0,0,6,2,4,0,0,0
158431,21040,210,40,-2,15,3,12,0,0,0,0,0,0,0,0,0,1,0,1,0,0,0,14,3,11,0,0,0,0,0,0,0,0,0
158477,21040,210,40,-2,1,1,0,0,0,0,1,1,0,0,0,0,0,0,0,0,0,0,0,0,0,0,0,0,0,0,0,0,0,0
158662,21040,210,40,-2,11,2,9,0,0,0,0,0,0,1,1,0,0,0,0,0,0,0,10,1,9,0,0,0,0,0,0,0,0,0
158802,21040,210,40,-2,9,5,4,0,0,0,0,0,0,6,2,4,0,0,0,0,0,0,3,3,0,0,0,0,0,0,0,0,0,0
158884,21040,210,40,-2,8,5,3,0,0,0,1,1,0,2,2,0,0,0,0,0,0,0,5,2,3,0,0,0,0,0,0,0,0,0
159009,21040,210,40,-2,1,0,1,0,0,0,0,0,0,1,0,1,0,0,0,0,0,0,0,0,0,0,0,0,0,0,0,0,0,0
159197,21040,210,40,-2,3,2,1,0,0,0,0,0,0,0,0,0,0,0,0,0,0,0,3,2,1,0,0,0,0,0,0,0,0,0
159373,21040,210,40,-2,40,18,22,0,0,0,5,3,2,4,0,4,1,1,0,0,0,0,27,13,14,0,0,0,1,0,1,2,1,1
159391,21040,210,40,-2,56,22,34,0,0,0,1,0,1,7,4,3,6,3,3,0,0,0,36,12,24,2,1,1,1,1,0,3,1,2
159407,21040,210,40,-2,9,3,6,0,0,0,0,0,0,1,1,0,0,0,0,0,0,0,7,2,5,1,0,1,0,0,0,0,0,0
159416,21040,210,40,-2,8,4,4,0,0,0,1,1,0,2,0,2,1,0,1,0,0,0,4,3,1,0,0,0,0,0,0,0,0,0
159647,21040,210,40,-2,10,7,3,0,0,0,2,1,1,0,0,0,0,0,0,0,0,0,8,6,2,0,0,0,0,0,0,0,0,0
159656,21040,210,40,-2,15,5,10,0,0,0,0,0,0,2,1,1,1,1,0,0,0,0,8,3,5,0,0,0,1,0,1,3,0,3
159717,21040,210,40,-2,6,1,5,0,0,0,0,0,0,0,0,0,0,0,0,0,0,0,6,1,5,0,0,0,0,0,0,0,0,0
159939,21040,210,40,-2,8,2,6,0,0,0,1,0,1,1,0,1,0,0,0,0,0,0,5,2,3,1,0,1,0,0,0,0,0,0
159966,21040,210,40,-2,7,0,7,0,0,0,1,0,1,0,0,0,0,0,0,0,0,0,6,0,6,0,0,0,0,0,0,0,0,0
159993,21040,210,40,-2,12,4,8,0,0,0,2,2,0,1,1,0,0,0,0,0,0,0,9,1,8,0,0,0,0,0,0,0,0,0
160010,21040,210,40,-2,6,0,6,0,0,0,0,0,0,2,0,2,0,0,0,0,0,0,4,0,4,0,0,0,0,0,0,0,0,0
160038,21040,210,40,-2,16,6,10,0,0,0,0,0,0,0,0,0,1,1,0,0,0,0,10,2,8,0,0,0,5,3,2,0,0,0
160065,21040,210,40,-2,4,1,3,0,0,0,0,0,0,1,0,1,1,1,0,0,0,0,2,0,2,0,0,0,0,0,0,0,0,0
160074,21040,210,40,-2,3,1,2,0,0,0,0,0,0,0,0,0,0,0,0,0,0,0,3,1,2,0,0,0,0,0,0,0,0,0
160481,21040,210,40,-2,6,3,3,0,0,0,0,0,0,0,0,0,0,0,0,0,0,0,6,3,3,0,0,0,0,0,0,0,0,0
160579,21040,210,40,-2,9,0,9,0,0,0,0,0,0,3,0,3,1,0,1,0,0,0,5,0,5,0,0,0,0,0,0,0,0,0
160612,21040,210,40,-2,36,13,23,0,0,0,0,0,0,4,2,2,1,0,1,0,0,0,28,8,20,0,0,0,0,0,0,3,3,0
160621,21040,210,40,-2,6,1,5,0,0,0,0,0,0,4,0,4,0,0,0,0,0,0,2,1,1,0,0,0,0,0,0,0,0,0
160649,21040,210,40,-2,1,0,1,0,0,0,0,0,0,1,0,1,0,0,0,0,0,0,0,0,0,0,0,0,0,0,0,0,0,0
160658,21040,210,40,-2,6,1,5,0,0,0,0,0,0,0,0,0,1,1,0,0,0,0,5,0,5,0,0,0,0,0,0,0,0,0
160667,21040,210,40,-2,12,6,6,0,0,0,0,0,0,0,0,0,0,0,0,0,0,0,12,6,6,0,0,0,0,0,0,0,0,0
160755,21040,210,40,-2,66,36,30,1,1,0,5,2,3,6,2,4,4,1,3,0,0,0,44,26,18,0,0,0,0,0,0,6,4,2
160904,21040,210,40,-2,5,2,3,0,0,0,0,0,0,4,1,3,0,0,0,0,0,0,0,0,0,0,0,0,0,0,0,1,1,0
160959,21040,210,40,-2,1,0,1,0,0,0,1,0,1,0,0,0,0,0,0,0,0,0,0,0,0,0,0,0,0,0,0,0,0,0
161004,21040,210,40,-2,18,10,8,0,0,0,4,2,2,1,1,0,1,1,0,0,0,0,7,4,3,0,0,0,3,1,2,2,1,1
161022,21040,210,40,-2,2,0,2,0,0,0,0,0,0,0,0,0,0,0,0,0,0,0,2,0,2,0,0,0,0,0,0,0,0,0
161077,21040,210,40,-2,8,5,3,0,0,0,0,0,0,0,0,0,0,0,0,0,0,0,7,4,3,0,0,0,1,1,0,0,0,0
161086,21040,210,40,-2,26,12,14,0,0,0,1,0,1,0,0,0,1,1,0,0,0,0,14,7,7,1,0,1,3,2,1,6,2,4
161138,21040,210,40,-2,6,4,2,0,0,0,0,0,0,0,0,0,0,0,0,0,0,0,6,4,2,0,0,0,0,0,0,0,0,0
161192,21040,210,40,-2,10,4,6,0,0,0,0,0,0,0,0,0,0,0,0,0,0,0,10,4,6,0,0,0,0,0,0,0,0,0
161208,21040,210,40,-2,1,1,0,0,0,0,0,0,0,0,0,0,0,0,0,0,0,0,1,1,0,0,0,0,0,0,0,0,0,0
161226,21040,210,40,-2,2,0,2,0,0,0,0,0,0,0,0,0,0,0,0,0,0,0,2,0,2,0,0,0,0,0,0,0,0,0
161235,21040,210,40,-2,2,1,1,0,0,0,0,0,0,0,0,0,0,0,0,0,0,0,2,1,1,0,0,0,0,0,0,0,0,0
161253,21040,210,40,-2,8,4,4,0,0,0,2,2,0,0,0,0,0,0,0,0,0,0,5,2,3,1,0,1,0,0,0,0,0,0
161299,21040,210,40,-2,5,4,1,0,0,0,0,0,0,0,0,0,0,0,0,0,0,0,5,4,1,0,0,0,0,0,0,0,0,0
161457,21040,210,40,-2,23,10,13,0,0,0,0,0,0,0,0,0,0,0,0,0,0,0,20,9,11,0,0,0,1,0,1,2,1,1
161484,21040,210,40,-2,3,3,0,0,0,0,0,0,0,0,0,0,0,0,0,0,0,0,3,3,0,0,0,0,0,0,0,0,0,0
161509,21040,210,40,-2,2,2,0,0,0,0,0,0,0,0,0,0,0,0,0,0,0,0,2,2,0,0,0,0,0,0,0,0,0,0
161518,21040,210,40,-2,2,0,2,0,0,0,0,0,0,0,0,0,0,0,0,0,0,0,2,0,2,0,0,0,0,0,0,0,0,0
161545,21040,210,40,-2,8,5,3,0,0,0,0,0,0,0,0,0,0,0,0,0,0,0,8,5,3,0,0,0,0,0,0,0,0,0
161554,21040,210,40,-2,7,2,5,0,0,0,1,1,0,0,0,0,0,0,0,0,0,0,6,1,5,0,0,0,0,0,0,0,0,0
161563,21040,210,40,-2,2,1,1,0,0,0,0,0,0,0,0,0,0,0,0,0,0,0,2,1,1,0,0,0,0,0,0,0,0,0
161767,21040,210,40,-2,13,4,9,0,0,0,1,1,0,5,1,4,1,0,1,0,0,0,6,2,4,0,0,0,0,0,0,0,0,0
161864,21040,210,40,-2,7,3,4,0,0,0,1,1,0,3,0,3,0,0,0,0,0,0,3,2,1,0,0,0,0,0,0,0,0,0
161873,21040,210,40,-2,9,2,7,0,0,0,3,1,2,1,0,1,1,0,1,0,0,0,4,1,3,0,0,0,0,0,0,0,0,0
162007,21040,210,40,-2,6,2,4,0,0,0,0,0,0,5,2,3,1,0,1,0,0,0,0,0,0,0,0,0,0,0,0,0,0,0
162061,21040,210,40,-2,1,1,0,0,0,0,0,0,0,1,1,0,0,0,0,0,0,0,0,0,0,0,0,0,0,0,0,0,0,0
162122,21040,210,40,-2,4,3,1,0,0,0,0,0,0,0,0,0,0,0,0,0,0,0,4,3,1,0,0,0,0,0,0,0,0,0
162168,21040,210,40,-2,2,1,1,0,0,0,0,0,0,0,0,0,0,0,0,0,0,0,0,0,0,0,0,0,2,1,1,0,0,0
162210,21040,210,40,-2,1,0,1,0,0,0,0,0,0,0,0,0,0,0,0,0,0,0,1,0,1,0,0,0,0,0,0,0,0,0
162283,21040,210,40,-2,3,1,2,0,0,0,0,0,0,3,1,2,0,0,0,0,0,0,0,0,0,0,0,0,0,0,0,0,0,0
162557,21040,210,40,-2,8,1,7,0,0,0,0,0,0,0,0,0,1,0,1,0,0,0,7,1,6,0,0,0,0,0,0,0,0,0
162706,21040,210,40,-2,1,0,1,0,0,0,0,0,0,0,0,0,0,0,0,0,0,0,1,0,1,0,0,0,0,0,0,0,0,0
162760,21040,210,40,-2,2,1,1,0,0,0,1,0,1,0,0,0,0,0,0,0,0,0,1,1,0,0,0,0,0,0,0,0,0,0
162779,21040,210,40,-2,8,4,4,0,0,0,1,1,0,2,1,1,0,0,0,0,0,0,4,2,2,1,0,1,0,0,0,0,0,0
162928,21040,210,40,-2,127,71,56,0,0,0,26,13,13,11,7,4,6,3,3,0,0,0,68,40,28,2,1,1,1,1,0,13,6,7
163028,21040,210,40,-2,21,21,0,0,0,0,1,1,0,10,10,0,0,0,0,0,0,0,7,7,0,1,1,0,2,2,0,0,0,0
163046,21040,210,40,-2,18,9,9,0,0,0,2,0,2,1,0,1,2,1,1,0,0,0,13,8,5,0,0,0,0,0,0,0,0,0
163204,21040,210,40,-2,10,4,6,0,0,0,1,0,1,0,0,0,0,0,0,0,0,0,4,2,2,0,0,0,5,2,3,0,0,0
163259,21040,210,40,-2,156,71,85,0,0,0,36,20,16,13,6,7,12,3,9,0,0,0,73,30,43,1,0,1,1,1,0,20,11,9
163268,21040,210,40,-2,7,4,3,0,0,0,1,0,1,0,0,0,0,0,0,0,0,0,5,4,1,0,0,0,1,0,1,0,0,0
163286,21040,210,40,-2,43,18,25,0,0,0,4,3,1,2,0,2,6,1,5,0,0,0,18,9,9,0,0,0,8,3,5,5,2,3
163295,21040,210,40,-2,12,6,6,0,0,0,2,1,1,2,1,1,1,0,1,0,0,0,2,1,1,0,0,0,1,1,0,4,2,2
163338,21040,210,40,-2,5,4,1,0,0,0,1,1,0,3,3,0,0,0,0,0,0,0,1,0,1,0,0,0,0,0,0,0,0,0
163426,21040,210,40,-2,27,10,17,0,0,0,2,1,1,12,4,8,2,2,0,0,0,0,7,3,4,0,0,0,1,0,1,3,0,3
163453,21040,210,40,-2,3,3,0,0,0,0,1,1,0,2,2,0,0,0,0,0,0,0,0,0,0,0,0,0,0,0,0,0,0,0
163462,21040,210,40,-2,4,4,0,0,0,0,0,0,0,1,1,0,1,1,0,0,0,0,2,2,0,0,0,0,0,0,0,0,0,0
163578,21040,210,40,-2,7,2,5,0,0,0,0,0,0,1,0,1,0,0,0,0,0,0,6,2,4,0,0,0,0,0,0,0,0,0
163657,21040,210,40,-2,4,2,2,0,0,0,0,0,0,1,0,1,0,0,0,0,0,0,3,2,1,0,0,0,0,0,0,0,0,0
163851,21040,210,40,-2,7,2,5,0,0,0,0,0,0,0,0,0,1,1,0,0,0,0,6,1,5,0,0,0,0,0,0,0,0,0
163912,21040,210,40,-2,4,2,2,0,0,0,0,0,0,0,0,0,0,0,0,0,0,0,3,1,2,0,0,0,0,0,0,1,1,0
164076,21040,210,40,-2,44,25,19,1,0,1,5,3,2,1,0,1,2,1,1,0,0,0,32,20,12,1,0,1,2,1,1,0,0,0
164155,21040,210,40,-2,13,11,2,0,0,0,1,0,1,1,1,0,0,0,0,0,0,0,10,9,1,0,0,0,1,1,0,0,0,0
164173,21040,210,40,-2,6,3,3,0,0,0,0,0,0,2,1,1,0,0,0,0,0,0,4,2,2,0,0,0,0,0,0,0,0,0
164270,21040,210,40,-2,14,5,9,0,0,0,1,0,1,1,0,1,2,1,1,0,0,0,10,4,6,0,0,0,0,0,0,0,0,0
164313,21040,210,40,-2,4,1,3,0,0,0,2,1,1,0,0,0,0,0,0,0,0,0,2,0,2,0,0,0,0,0,0,0,0,0
164368,21040,210,40,-2,16,11,5,0,0,0,5,3,2,1,1,0,2,1,1,0,0,0,5,4,1,0,0,0,3,2,1,0,0,0
164447,21040,210,40,-2,2,0,2,0,0,0,0,0,0,0,0,0,0,0,0,0,0,0,2,0,2,0,0,0,0,0,0,0,0,0
164465,21040,210,40,-2,16,9,7,0,0,0,1,0,1,5,4,1,1,1,0,0,0,0,6,2,4,0,0,0,0,0,0,3,2,1
164492,21040,210,40,-2,3,0,3,0,0,0,0,0,0,0,0,0,0,0,0,0,0,0,3,0,3,0,0,0,0,0,0,0,0,0
164562,21040,210,40,-2,5,2,3,0,0,0,0,0,0,0,0,0,1,0,1,0,0,0,3,2,1,1,0,1,0,0,0,0,0,0
164632,21040,210,40,-2,2,0,2,0,0,0,0,0,0,0,0,0,0,0,0,0,0,0,2,0,2,0,0,0,0,0,0,0,0,0
164739,21040,210,40,-2,13,7,6,0,0,0,4,2,2,0,0,0,0,0,0,0,0,0,9,5,4,0,0,0,0,0,0,0,0,0
164748,21040,210,40,-2,9,8,1,1,1,0,1,1,0,0,0,0,2,2,0,0,0,0,5,4,1,0,0,0,0,0,0,0,0,0
164924,21040,210,40,-2,33,17,16,0,0,0,3,1,2,4,2,2,3,2,1,0,0,0,23,12,11,0,0,0,0,0,0,0,0,0
164988,21040,210,40,-2,205,89,116,0,0,0,30,11,19,14,3,11,19,8,11,0,0,0,95,45,50,4,3,1,22,5,17,21,14,7
165015,21040,210,40,-2,14,7,7,0,0,0,1,1,0,1,0,1,1,0,1,0,0,0,8,5,3,0,0,0,2,1,1,1,0,1
165024,21040,210,40,-2,8,1,7,0,0,0,1,1,0,1,0,1,0,0,0,0,0,0,5,0,5,0,0,0,1,0,1,0,0,0
165264,21040,210,40,-2,1,0,1,0,0,0,0,0,0,0,0,0,0,0,0,0,0,0,1,0,1,0,0,0,0,0,0,0,0,0
165334,21040,210,40,-2,28,15,13,0,0,0,1,0,1,3,1,2,1,1,0,0,0,0,15,9,6,2,0,2,0,0,0,6,4,2
165529,21040,210,40,-2,5,2,3,0,0,0,0,0,0,2,0,2,0,0,0,0,0,0,2,1,1,0,0,0,1,1,0,0,0,0
165574,21040,210,40,-2,2,1,1,0,0,0,0,0,0,0,0,0,0,0,0,0,0,0,2,1,1,0,0,0,0,0,0,0,0,0
165644,21040,210,40,-2,4,3,1,0,0,0,1,1,0,0,0,0,0,0,0,0,0,0,1,0,1,0,0,0,2,2,0,0,0,0
165662,21040,210,40,-2,3,1,2,0,0,0,1,0,1,1,1,0,0,0,0,0,0,0,1,0,1,0,0,0,0,0,0,0,0,0
165671,21040,210,40,-2,3,1,2,0,0,0,0,0,0,0,0,0,0,0,0,0,0,0,3,1,2,0,0,0,0,0,0,0,0,0
165699,21040,210,40,-2,5,1,4,0,0,0,1,0,1,0,0,0,0,0,0,0,0,0,2,1,1,0,0,0,2,0,2,0,0,0
165802,21040,210,40,-2,3,1,2,0,0,0,1,0,1,0,0,0,0,0,0,0,0,0,2,1,1,0,0,0,0,0,0,0,0,0
165820,21040,210,40,-2,1,0,1,0,0,0,0,0,0,0,0,0,0,0,0,0,0,0,1,0,1,0,0,0,0,0,0,0,0,0
165866,21040,210,40,-2,2,0,2,0,0,0,0,0,0,0,0,0,0,0,0,0,0,0,2,0,2,0,0,0,0,0,0,0,0,0
165884,21040,210,40,-2,1,1,0,0,0,0,0,0,0,0,0,0,0,0,0,0,0,0,1,1,0,0,0,0,0,0,0,0,0,0
165936,21040,210,40,-2,8,2,6,0,0,0,2,0,2,0,0,0,0,0,0,0,0,0,4,2,2,0,0,0,2,0,2,0,0,0
165945,21040,210,40,-2,1,0,1,0,0,0,0,0,0,0,0,0,0,0,0,0,0,0,1,0,1,0,0,0,0,0,0,0,0,0
166018,21040,210,40,-2,2,1,1,0,0,0,0,0,0,0,0,0,1,1,0,0,0,0,1,0,1,0,0,0,0,0,0,0,0,0
166027,21040,210,40,-2,101,48,53,0,0,0,6,0,6,2,2,0,14,5,9,0,0,0,59,27,32,2,2,0,1,1,0,17,11,6
166045,21040,210,40,-2,1,0,1,0,0,0,0,0,0,0,0,0,0,0,0,0,0,0,1,0,1,0,0,0,0,0,0,0,0,0
166124,21040,210,40,-2,20,11,9,0,0,0,2,1,1,0,0,0,3,1,2,0,0,0,10,6,4,1,0,1,2,1,1,2,2,0
166133,21040,210,40,-2,1,0,1,0,0,0,1,0,1,0,0,0,0,0,0,0,0,0,0,0,0,0,0,0,0,0,0,0,0,0
166391,21040,210,40,-2,2,1,1,0,0,0,0,0,0,0,0,0,0,0,0,0,0,0,0,0,0,1,1,0,1,0,1,0,0,0
166407,21040,210,40,-2,2,0,2,0,0,0,0,0,0,0,0,0,0,0,0,0,0,0,2,0,2,0,0,0,0,0,0,0,0,0
166452,21040,210,40,-2,9,5,4,0,0,0,2,1,1,2,0,2,0,0,0,0,0,0,5,4,1,0,0,0,0,0,0,0,0,0
166513,21040,210,40,-2,12,6,6,0,0,0,0,0,0,0,0,0,1,0,1,0,0,0,6,3,3,0,0,0,1,1,0,4,2,2
166629,21040,210,40,-2,25,10,15,1,1,0,0,0,0,3,0,3,0,0,0,0,0,0,15,6,9,0,0,0,0,0,0,6,3,3
166638,21040,210,40,-2,13,5,8,0,0,0,1,0,1,1,0,1,1,0,1,0,0,0,8,5,3,0,0,0,2,0,2,0,0,0
166656,21040,210,40,-2,11,1,10,0,0,0,1,1,0,0,0,0,0,0,0,0,0,0,8,0,8,1,0,1,1,0,1,0,0,0
166674,21040,210,40,-2,17,5,12,0,0,0,2,1,1,1,1,0,3,1,2,0,0,0,8,2,6,0,0,0,3,0,3,0,0,0
166708,21040,210,40,-2,108,55,53,0,0,0,33,15,18,3,1,2,5,2,3,0,0,0,59,34,25,0,0,0,5,2,3,3,1,2
166717,21040,210,40,-2,11,3,8,0,0,0,0,0,0,2,0,2,1,0,1,0,0,0,8,3,5,0,0,0,0,0,0,0,0,0
166850,21040,210,40,-2,13,3,10,0,0,0,0,0,0,2,1,1,0,0,0,0,0,0,8,1,7,2,0,2,1,1,0,0,0,0
166869,21040,210,40,-2,9,1,8,0,0,0,0,0,0,0,0,0,0,0,0,0,0,0,9,1,8,0,0,0,0,0,0,0,0,0
166911,21040,210,40,-2,4,1,3,0,0,0,1,0,1,0,0,0,0,0,0,0,0,0,1,0,1,0,0,0,2,1,1,0,0,0
166939,21040,210,40,-2,23,7,16,0,0,0,3,1,2,3,1,2,0,0,0,0,0,0,7,2,5,0,0,0,5,1,4,5,2,3
167057,21040,210,40,-2,3,2,1,0,0,0,0,0,0,1,0,1,0,0,0,0,0,0,2,2,0,0,0,0,0,0,0,0,0,0
167093,21040,210,40,-2,2,0,2,0,0,0,0,0,0,0,0,0,0,0,0,0,0,0,1,0,1,0,0,0,1,0,1,0,0,0
167215,21040,210,40,-2,6,1,5,0,0,0,0,0,0,0,0,0,1,0,1,0,0,0,5,1,4,0,0,0,0,0,0,0,0,0
167260,21040,210,40,-2,4,4,0,0,0,0,0,0,0,1,1,0,0,0,0,0,0,0,3,3,0,0,0,0,0,0,0,0,0,0
167288,21040,210,40,-2,3,2,1,0,0,0,0,0,0,0,0,0,0,0,0,0,0,0,3,2,1,0,0,0,0,0,0,0,0,0
167358,21040,210,40,-2,68,43,25,0,0,0,7,4,3,4,2,2,3,2,1,0,0,0,36,22,14,1,1,0,13,8,5,4,4,0
167394,21040,210,40,-2,3,0,3,0,0,0,0,0,0,1,0,1,0,0,0,0,0,0,2,0,2,0,0,0,0,0,0,0,0,0
167598,21040,210,40,-2,9,1,8,0,0,0,0,0,0,5,1,4,2,0,2,0,0,0,2,0,2,0,0,0,0,0,0,0,0,0
167677,21040,210,40,-2,1,1,0,0,0,0,0,0,0,0,0,0,0,0,0,0,0,0,1,1,0,0,0,0,0,0,0,0,0,0
167729,21040,210,40,-2,16,6,10,0,0,0,0,0,0,1,1,0,1,1,0,0,0,0,14,4,10,0,0,0,0,0,0,0,0,0
167783,21040,210,40,-2,19,7,12,0,0,0,1,0,1,5,1,4,0,0,0,0,0,0,11,5,6,0,0,0,0,0,0,2,1,1
167792,21040,210,40,-2,3,1,2,0,0,0,1,0,1,0,0,0,0,0,0,0,0,0,1,0,1,0,0,0,0,0,0,1,1,0
167899,21040,210,40,-2,14,6,8,0,0,0,3,2,1,1,0,1,0,0,0,0,0,0,9,4,5,1,0,1,0,0,0,0,0,0
167987,21040,210,40,-2,13,4,9,0,0,0,0,0,0,1,0,1,0,0,0,0,0,0,12,4,8,0,0,0,0,0,0,0,0,0
167996,21040,210,40,-2,6,3,3,0,0,0,0,0,0,0,0,0,0,0,0,0,0,0,1,0,1,0,0,0,5,3,2,0,0,0
168005,21040,210,40,-2,2,2,0,0,0,0,0,0,0,0,0,0,0,0,0,0,0,0,2,2,0,0,0,0,0,0,0,0,0,0
168148,21040,210,40,-2,49,22,27,0,0,0,5,2,3,7,3,4,5,3,2,0,0,0,24,11,13,2,1,1,1,0,1,5,2,3
168218,21040,210,40,-2,10,2,8,0,0,0,1,0,1,0,0,0,1,0,1,0,0,0,4,1,3,1,1,0,1,0,1,2,0,2
168227,21040,210,40,-2,8,4,4,0,0,0,1,1,0,0,0,0,0,0,0,0,0,0,5,2,3,0,0,0,2,1,1,0,0,0
168254,21040,210,40,-2,1,0,1,0,0,0,0,0,0,0,0,0,0,0,0,0,0,0,1,0,1,0,0,0,0,0,0,0,0,0
168281,21040,210,40,-2,5,1,4,0,0,0,1,0,1,1,1,0,0,0,0,0,0,0,3,0,3,0,0,0,0,0,0,0,0,0
168342,21040,210,40,-2,18,7,11,0,0,0,2,0,2,3,0,3,4,2,2,0,0,0,4,2,2,0,0,0,0,0,0,5,3,2
168421,21040,210,40,-2,23,14,9,0,0,0,1,0,1,1,0,1,2,1,1,0,0,0,10,7,3,1,0,1,3,2,1,5,4,1
168430,21040,210,40,-2,30,5,25,1,1,0,0,0,0,0,0,0,0,0,0,0,0,0,28,4,24,1,0,1,0,0,0,0,0,0
168528,21040,210,40,-2,3,0,3,0,0,0,0,0,0,0,0,0,0,0,0,0,0,0,3,0,3,0,0,0,0,0,0,0,0,0
168546,21040,210,40,-2,15,6,9,0,0,0,2,0,2,1,1,0,3,1,2,0,0,0,8,3,5,0,0,0,0,0,0,1,1,0
168591,21040,210,40,-2,4,1,3,0,0,0,1,1,0,0,0,0,0,0,0,0,0,0,3,0,3,0,0,0,0,0,0,0,0,0
168607,21040,210,40,-2,4,2,2,0,0,0,0,0,0,0,0,0,0,0,0,0,0,0,4,2,2,0,0,0,0,0,0,0,0,0
168740,21040,210,40,-2,6,3,3,0,0,0,0,0,0,2,2,0,1,1,0,0,0,0,2,0,2,0,0,0,0,0,0,1,0,1
168847,21040,210,40,-2,12,4,8,0,0,0,0,0,0,1,0,1,0,0,0,0,0,0,11,4,7,0,0,0,0,0,0,0,0,0
169220,21040,210,40,-2,2,1,1,0,0,0,0,0,0,1,1,0,0,0,0,0,0,0,1,0,1,0,0,0,0,0,0,0,0,0
169248,21040,210,40,-2,12,6,6,0,0,0,1,0,1,0,0,0,0,0,0,0,0,0,10,5,5,0,0,0,0,0,0,1,1,0
169275,21040,210,40,-2,1,1,0,0,0,0,0,0,0,0,0,0,0,0,0,0,0,0,1,1,0,0,0,0,0,0,0,0,0,0
169327,21040,210,40,-2,2,1,1,0,0,0,0,0,0,0,0,0,0,0,0,0,0,0,2,1,1,0,0,0,0,0,0,0,0,0
169363,21040,210,40,-2,8,4,4,0,0,0,0,0,0,0,0,0,0,0,0,0,0,0,8,4,4,0,0,0,0,0,0,0,0,0
169424,21040,210,40,-2,1,1,0,0,0,0,0,0,0,0,0,0,0,0,0,0,0,0,1,1,0,0,0,0,0,0,0,0,0,0
169479,21040,210,40,-2,11,5,6,0,0,0,0,0,0,2,2,0,0,0,0,0,0,0,6,1,5,1,0,1,1,1,0,1,1,0
169521,21040,210,40,-2,2,0,2,0,0,0,0,0,0,0,0,0,0,0,0,0,0,0,2,0,2,0,0,0,0,0,0,0,0,0
169655,21040,210,40,-2,14,11,3,0,0,0,0,0,0,5,5,0,1,1,0,0,0,0,7,4,3,1,1,0,0,0,0,0,0,0
169716,21040,210,40,-2,18,6,12,0,0,0,1,0,1,0,0,0,1,0,1,0,0,0,4,1,3,0,0,0,2,0,2,10,5,5
169761,21040,210,40,-2,3,1,2,0,0,0,0,0,0,1,0,1,0,0,0,0,0,0,2,1,1,0,0,0,0,0,0,0,0,0
169798,21040,210,40,-2,2,1,1,0,0,0,0,0,0,0,0,0,0,0,0,0,0,0,2,1,1,0,0,0,0,0,0,0,0,0
169983,21040,210,40,-2,5,2,3,0,0,0,2,0,2,0,0,0,0,0,0,0,0,0,2,2,0,1,0,1,0,0,0,0,0,0
169992,21040,210,40,-2,3,2,1,0,0,0,0,0,0,0,0,0,0,0,0,0,0,0,3,2,1,0,0,0,0,0,0,0,0,0
170037,21040,210,40,-2,1,1,0,0,0,0,0,0,0,0,0,0,0,0,0,0,0,0,1,1,0,0,0,0,0,0,0,0,0,0
170055,21040,210,40,-2,3,0,3,0,0,0,0,0,0,1,0,1,0,0,0,0,0,0,2,0,2,0,0,0,0,0,0,0,0,0
170082,21040,210,40,-2,38,22,16,0,0,0,2,1,1,0,0,0,2,1,1,0,0,0,31,18,13,0,0,0,2,2,0,1,0,1
170286,21040,210,40,-2,3,2,1,0,0,0,0,0,0,0,0,0,0,0,0,0,0,0,0,0,0,0,0,0,3,2,1,0,0,0
170301,21040,210,40,-2,11,3,8,0,0,0,1,0,1,0,0,0,0,0,0,0,0,0,8,3,5,1,0,1,0,0,0,1,0,1
170532,21040,210,40,-2,5,4,1,0,0,0,1,1,0,2,1,1,0,0,0,0,0,0,2,2,0,0,0,0,0,0,0,0,0,0
170550,21040,210,40,-2,5,3,2,0,0,0,1,1,0,0,0,0,0,0,0,0,0,0,4,2,2,0,0,0,0,0,0,0,0,0
170587,21040,210,40,-2,4,2,2,0,0,0,0,0,0,0,0,0,0,0,0,0,0,0,4,2,2,0,0,0,0,0,0,0,0,0
170620,21040,210,40,-2,4,2,2,0,0,0,0,0,0,2,1,1,0,0,0,0,0,0,2,1,1,0,0,0,0,0,0,0,0,0
170639,21040,210,40,-2,4,3,1,0,0,0,0,0,0,0,0,0,0,0,0,0,0,0,3,2,1,0,0,0,1,1,0,0,0,0
170657,21040,210,40,-2,8,4,4,0,0,0,0,0,0,2,1,1,0,0,0,0,0,0,6,3,3,0,0,0,0,0,0,0,0,0
170675,21040,210,40,-2,9,7,2,0,0,0,0,0,0,0,0,0,1,1,0,0,0,0,8,6,2,0,0,0,0,0,0,0,0,0
170806,21040,210,40,-2,4,2,2,0,0,0,0,0,0,0,0,0,0,0,0,0,0,0,4,2,2,0,0,0,0,0,0,0,0,0
170976,21040,210,40,-2,623,355,268,2,2,0,44,17,27,19,10,9,12,8,4,0,0,0,236,106,130,11,7,4,16,9,7,283,196,87
171100,21040,210,40,-2,63,28,35,0,0,0,8,7,1,1,0,1,4,1,3,0,0,0,39,13,26,1,0,1,0,0,0,10,7,3
171128,21040,210,40,-2,2,2,0,0,0,0,0,0,0,0,0,0,0,0,0,0,0,0,1,1,0,0,0,0,1,1,0,0,0,0
171137,21040,210,40,-2,6,4,2,0,0,0,1,0,1,0,0,0,0,0,0,0,0,0,4,4,0,1,0,1,0,0,0,0,0,0
171146,21040,210,40,-2,4,1,3,0,0,0,0,0,0,0,0,0,0,0,0,0,0,0,4,1,3,0,0,0,0,0,0,0,0,0
171304,21040,210,40,-2,1,1,0,0,0,0,0,0,0,0,0,0,0,0,0,0,0,0,1,1,0,0,0,0,0,0,0,0,0,0
171395,21040,210,40,-2,3,2,1,0,0,0,0,0,0,0,0,0,0,0,0,0,0,0,3,2,1,0,0,0,0,0,0,0,0,0
171456,21040,210,40,-2,7,3,4,0,0,0,0,0,0,0,0,0,0,0,0,0,0,0,6,3,3,0,0,0,1,0,1,0,0,0
171483,21040,210,40,-2,3,0,3,0,0,0,0,0,0,0,0,0,0,0,0,0,0,0,3,0,3,0,0,0,0,0,0,0,0,0
171535,21040,210,40,-2,11,4,7,0,0,0,0,0,0,2,1,1,0,0,0,0,0,0,9,3,6,0,0,0,0,0,0,0,0,0
171571,21040,210,40,-2,1,0,1,0,0,0,0,0,0,0,0,0,0,0,0,0,0,0,1,0,1,0,0,0,0,0,0,0,0,0
172033,21040,210,40,-2,4,3,1,0,0,0,0,0,0,0,0,0,0,0,0,0,0,0,4,3,1,0,0,0,0,0,0,0,0,0
172200,21040,210,40,-2,5,3,2,0,0,0,0,0,0,1,1,0,0,0,0,0,0,0,3,2,1,0,0,0,1,0,1,0,0,0
172264,21040,210,40,-2,4,1,3,0,0,0,0,0,0,0,0,0,0,0,0,0,0,0,4,1,3,0,0,0,0,0,0,0,0,0
172307,21040,210,40,-2,4,2,2,0,0,0,0,0,0,0,0,0,0,0,0,0,0,0,2,1,1,0,0,0,2,1,1,0,0,0
172334,21040,210,40,-2,5,1,4,0,0,0,0,0,0,0,0,0,0,0,0,0,0,0,5,1,4,0,0,0,0,0,0,0,0,0
172440,21040,210,40,-2,6,1,5,0,0,0,0,0,0,0,0,0,0,0,0,0,0,0,6,1,5,0,0,0,0,0,0,0,0,0
172617,21040,210,40,-2,1,1,0,1,1,0,0,0,0,0,0,0,0,0,0,0,0,0,0,0,0,0,0,0,0,0,0,0,0,0
172635,21040,210,40,-2,3,1,2,0,0,0,0,0,0,2,1,1,0,0,0,0,0,0,1,0,1,0,0,0,0,0,0,0,0,0
172644,21040,210,40,-2,40,19,21,0,0,0,2,0,2,5,2,3,1,1,0,0,0,0,25,14,11,0,0,0,0,0,0,7,2,5
173045,21040,210,40,-2,6,1,5,0,0,0,0,0,0,0,0,0,0,0,0,0,0,0,3,1,2,1,0,1,2,0,2,0,0,0
173063,21040,210,40,-2,1,1,0,0,0,0,0,0,0,0,0,0,0,0,0,0,0,0,1,1,0,0,0,0,0,0,0,0,0,0
173124,21040,210,40,-2,7,4,3,1,0,1,1,1,0,0,0,0,0,0,0,0,0,0,3,2,1,0,0,0,2,1,1,0,0,0
173142,21040,210,40,-2,3,1,2,0,0,0,0,0,0,0,0,0,0,0,0,0,0,0,3,1,2,0,0,0,0,0,0,0,0,0
173160,21040,210,40,-2,2,1,1,0,0,0,0,0,0,0,0,0,0,0,0,0,0,0,2,1,1,0,0,0,0,0,0,0,0,0
173300,21040,210,40,-2,4,2,2,0,0,0,0,0,0,0,0,0,1,0,1,0,0,0,3,2,1,0,0,0,0,0,0,0,0,0
173328,21040,210,40,-2,5,1,4,0,0,0,0,0,0,0,0,0,0,0,0,0,0,0,4,1,3,0,0,0,1,0,1,0,0,0
173416,21040,210,40,-2,1,1,0,0,0,0,0,0,0,0,0,0,0,0,0,0,0,0,1,1,0,0,0,0,0,0,0,0,0,0
173452,21040,210,40,-2,5,5,0,0,0,0,0,0,0,1,1,0,0,0,0,0,0,0,4,4,0,0,0,0,0,0,0,0,0,0
173665,21040,210,40,-2,2,1,1,0,0,0,0,0,0,0,0,0,0,0,0,0,0,0,2,1,1,0,0,0,0,0,0,0,0,0
173799,21040,210,40,-2,1,1,0,0,0,0,1,1,0,0,0,0,0,0,0,0,0,0,0,0,0,0,0,0,0,0,0,0,0,0
173902,21040,210,40,-2,12,6,6,0,0,0,1,0,1,0,0,0,1,0,1,0,0,0,6,5,1,0,0,0,0,0,0,4,1,3
173920,21040,210,40,-2,13,5,8,0,0,0,3,1,2,1,0,1,1,1,0,0,0,0,8,3,5,0,0,0,0,0,0,0,0,0
174020,21040,210,40,-2,1,0,1,0,0,0,0,0,0,0,0,0,0,0,0,0,0,0,1,0,1,0,0,0,0,0,0,0,0,0
174066,21040,210,40,-2,125,72,53,1,0,1,12,8,4,8,5,3,1,0,1,0,0,0,67,39,28,5,2,3,25,16,9,6,2,4
174075,21040,210,40,-2,1,1,0,0,0,0,0,0,0,0,0,0,0,0,0,0,0,0,1,1,0,0,0,0,0,0,0,0,0,0
174127,21040,210,40,-2,2,0,2,0,0,0,0,0,0,1,0,1,0,0,0,0,0,0,1,0,1,0,0,0,0,0,0,0,0,0
174154,21040,210,40,-2,7,0,7,0,0,0,0,0,0,0,0,0,0,0,0,0,0,0,7,0,7,0,0,0,0,0,0,0,0,0
174233,21040,210,40,-2,27,15,12,0,0,0,2,1,1,0,0,0,0,0,0,0,0,0,19,9,10,0,0,0,2,2,0,4,3,1
174358,21040,210,40,-2,11,3,8,0,0,0,0,0,0,0,0,0,0,0,0,0,0,0,9,2,7,0,0,0,1,1,0,1,0,1
174437,21040,210,40,-2,1,0,1,0,0,0,0,0,0,0,0,0,0,0,0,0,0,0,1,0,1,0,0,0,0,0,0,0,0,0
174491,21040,210,40,-2,3,2,1,0,0,0,0,0,0,0,0,0,1,1,0,0,0,0,2,1,1,0,0,0,0,0,0,0,0,0
174507,21040,210,40,-2,2,0,2,0,0,0,0,0,0,0,0,0,0,0,0,0,0,0,2,0,2,0,0,0,0,0,0,0,0,0
174525,21040,210,40,-2,1,1,0,0,0,0,0,0,0,0,0,0,0,0,0,0,0,0,1,1,0,0,0,0,0,0,0,0,0,0
174570,21040,210,40,-2,1,0,1,0,0,0,0,0,0,0,0,0,0,0,0,0,0,0,1,0,1,0,0,0,0,0,0,0,0,0
174747,21040,210,40,-2,6,3,3,0,0,0,1,0,1,1,0,1,0,0,0,0,0,0,3,2,1,0,0,0,1,1,0,0,0,0
174783,21040,210,40,-2,10,4,6,0,0,0,2,2,0,0,0,0,0,0,0,0,0,0,8,2,6,0,0,0,0,0,0,0,0,0
174792,21040,210,40,-2,6,4,2,0,0,0,0,0,0,0,0,0,1,1,0,0,0,0,4,2,2,1,1,0,0,0,0,0,0,0
174817,21040,210,40,-2,3,1,2,0,0,0,0,0,0,1,1,0,0,0,0,0,0,0,2,0,2,0,0,0,0,0,0,0,0,0
174844,21040,210,40,-2,15,9,6,0,0,0,0,0,0,0,0,0,1,1,0,0,0,0,13,7,6,0,0,0,1,1,0,0,0,0
174899,21040,210,40,-2,4,2,2,0,0,0,0,0,0,0,0,0,0,0,0,0,0,0,3,1,2,1,1,0,0,0,0,0,0,0
174914,21040,210,40,-2,14,5,9,0,0,0,2,1,1,1,0,1,2,1,1,0,0,0,8,3,5,0,0,0,0,0,0,1,0,1
175005,21040,210,40,-2,21,2,19,0,0,0,1,1,0,4,0,4,0,0,0,0,0,0,16,1,15,0,0,0,0,0,0,0,0,0
175014,21040,210,40,-2,20,4,16,0,0,0,0,0,0,2,1,1,0,0,0,0,0,0,16,2,14,1,1,0,1,0,1,0,0,0
175041,21040,210,40,-2,1,1,0,0,0,0,0,0,0,0,0,0,0,0,0,0,0,0,1,1,0,0,0,0,0,0,0,0,0,0
175078,21040,210,40,-2,3,1,2,0,0,0,0,0,0,0,0,0,0,0,0,0,0,0,3,1,2,0,0,0,0,0,0,0,0,0
175227,21040,210,40,-2,11,7,4,0,0,0,1,0,1,0,0,0,0,0,0,0,0,0,10,7,3,0,0,0,0,0,0,0,0,0
175272,21040,210,40,-2,12,2,10,0,0,0,0,0,0,0,0,0,1,0,1,0,0,0,10,1,9,0,0,0,1,1,0,0,0,0
175281,21040,210,40,-2,4,0,4,0,0,0,0,0,0,2,0,2,0,0,0,0,0,0,2,0,2,0,0,0,0,0,0,0,0,0
175342,21040,210,40,-2,2,0,2,0,0,0,0,0,0,1,0,1,0,0,0,0,0,0,1,0,1,0,0,0,0,0,0,0,0,0
175421,21040,210,40,-2,1,0,1,0,0,0,0,0,0,1,0,1,0,0,0,0,0,0,0,0,0,0,0,0,0,0,0,0,0,0
175430,21040,210,40,-2,3,2,1,0,0,0,0,0,0,1,1,0,0,0,0,0,0,0,2,1,1,0,0,0,0,0,0,0,0,0
175519,21040,210,40,-2,8,4,4,0,0,0,0,0,0,5,2,3,0,0,0,0,0,0,3,2,1,0,0,0,0,0,0,0,0,0
175573,21040,210,40,-2,4,0,4,0,0,0,0,0,0,1,0,1,0,0,0,0,0,0,2,0,2,1,0,1,0,0,0,0,0,0
175616,21040,210,40,-2,6,3,3,0,0,0,1,1,0,0,0,0,0,0,0,0,0,0,5,2,3,0,0,0,0,0,0,0,0,0
175643,21040,210,40,-2,4,3,1,0,0,0,0,0,0,0,0,0,0,0,0,0,0,0,4,3,1,0,0,0,0,0,0,0,0,0
175652,21040,210,40,-2,2,1,1,0,0,0,0,0,0,1,0,1,0,0,0,0,0,0,1,1,0,0,0,0,0,0,0,0,0,0
175786,21040,210,40,-2,30,12,18,0,0,0,0,0,0,10,2,8,1,0,1,0,0,0,18,10,8,0,0,0,1,0,1,0,0,0
175810,21040,210,40,-2,11,1,10,0,0,0,0,0,0,2,0,2,0,0,0,0,0,0,9,1,8,0,0,0,0,0,0,0,0,0
175829,21040,210,40,-2,5,1,4,0,0,0,0,0,0,0,0,0,0,0,0,0,0,0,5,1,4,0,0,0,0,0,0,0,0,0
175856,21040,210,40,-2,14,2,12,0,0,0,1,1,0,11,1,10,0,0,0,0,0,0,2,0,2,0,0,0,0,0,0,0,0,0
175883,21040,210,40,-2,18,10,8,0,0,0,1,1,0,3,0,3,0,0,0,0,0,0,14,9,5,0,0,0,0,0,0,0,0,0
175935,21040,210,40,-2,7,1,6,0,0,0,0,0,0,3,1,2,0,0,0,0,0,0,3,0,3,0,0,0,1,0,1,0,0,0
175980,21040,210,40,-2,2,1,1,0,0,0,0,0,0,0,0,0,1,0,1,0,0,0,1,1,0,0,0,0,0,0,0,0,0,0
176008,21040,210,40,-2,10,3,7,0,0,0,0,0,0,4,2,2,0,0,0,0,0,0,6,1,5,0,0,0,0,0,0,0,0,0
176017,21040,210,40,-2,84,35,49,0,0,0,5,3,2,13,2,11,3,1,2,0,0,0,45,21,24,2,1,1,1,1,0,15,6,9
176035,21040,210,40,-2,11,1,10,0,0,0,1,1,0,1,0,1,0,0,0,0,0,0,9,0,9,0,0,0,0,0,0,0,0,0
176044,21040,210,40,-2,3,2,1,0,0,0,1,1,0,1,0,1,0,0,0,0,0,0,1,1,0,0,0,0,0,0,0,0,0,0
176053,21040,210,40,-2,9,3,6,0,0,0,0,0,0,0,0,0,0,0,0,0,0,0,4,2,2,0,0,0,5,1,4,0,0,0
176071,21040,210,40,-2,37,16,21,0,0,0,1,1,0,4,0,4,1,0,1,0,0,0,21,10,11,0,0,0,10,5,5,0,0,0
176080,21040,210,40,-2,25,7,18,0,0,0,0,0,0,4,0,4,1,0,1,0,0,0,17,5,12,0,0,0,0,0,0,3,2,1
176169,21040,210,40,-2,8,1,7,0,0,0,0,0,0,0,0,0,0,0,0,0,0,0,6,0,6,0,0,0,2,1,1,0,0,0
176178,21040,210,40,-2,18,7,11,0,0,0,0,0,0,3,1,2,0,0,0,0,0,0,15,6,9,0,0,0,0,0,0,0,0,0
176239,21040,210,40,-2,24,6,18,0,0,0,0,0,0,4,1,3,0,0,0,0,0,0,20,5,15,0,0,0,0,0,0,0,0,0
176318,21040,210,40,-2,12,6,6,0,0,0,0,0,0,11,6,5,0,0,0,0,0,0,1,0,1,0,0,0,0,0,0,0,0,0
176354,21040,210,40,-2,5,1,4,0,0,0,0,0,0,0,0,0,0,0,0,0,0,0,5,1,4,0,0,0,0,0,0,0,0,0
176600,21040,210,40,-2,1,1,0,0,0,0,0,0,0,0,0,0,0,0,0,0,0,0,1,1,0,0,0,0,0,0,0,0,0,0
176628,21040,210,40,-2,3,2,1,0,0,0,0,0,0,0,0,0,0,0,0,0,0,0,3,2,1,0,0,0,0,0,0,0,0,0
176664,21040,210,40,-2,4,3,1,0,0,0,0,0,0,0,0,0,0,0,0,0,0,0,4,3,1,0,0,0,0,0,0,0,0,0
176789,21040,210,40,-2,1,1,0,0,0,0,1,1,0,0,0,0,0,0,0,0,0,0,0,0,0,0,0,0,0,0,0,0,0,0
176910,21040,210,40,-2,1,1,0,0,0,0,0,0,0,0,0,0,0,0,0,0,0,0,1,1,0,0,0,0,0,0,0,0,0,0
176947,21040,210,40,-2,7,2,5,0,0,0,0,0,0,0,0,0,0,0,0,0,0,0,7,2,5,0,0,0,0,0,0,0,0,0
176965,21040,210,40,-2,14,7,7,0,0,0,0,0,0,0,0,0,0,0,0,0,0,0,11,4,7,0,0,0,0,0,0,3,3,0
177065,21040,210,40,-2,4,3,1,0,0,0,0,0,0,0,0,0,0,0,0,0,0,0,4,3,1,0,0,0,0,0,0,0,0,0
177092,21040,210,40,-2,3,3,0,0,0,0,0,0,0,0,0,0,1,1,0,0,0,0,2,2,0,0,0,0,0,0,0,0,0,0
177117,21040,210,40,-2,1,0,1,0,0,0,0,0,0,0,0,0,0,0,0,0,0,0,0,0,0,0,0,0,0,0,0,1,0,1
177126,21040,210,40,-2,2,1,1,0,0,0,0,0,0,0,0,0,0,0,0,0,0,0,2,1,1,0,0,0,0,0,0,0,0,0
177135,21040,210,40,-2,13,5,8,1,1,0,0,0,0,0,0,0,1,0,1,0,0,0,8,3,5,1,0,1,2,1,1,0,0,0
177144,21040,210,40,-2,1,1,0,0,0,0,0,0,0,0,0,0,0,0,0,0,0,0,1,1,0,0,0,0,0,0,0,0,0,0
177214,21040,210,40,-2,2,2,0,0,0,0,0,0,0,0,0,0,0,0,0,0,0,0,0,0,0,0,0,0,2,2,0,0,0,0
177302,21040,210,40,-2,4,4,0,0,0,0,1,1,0,1,1,0,0,0,0,0,0,0,2,2,0,0,0,0,0,0,0,0,0,0
177418,21040,210,40,-2,7,5,2,0,0,0,2,1,1,0,0,0,0,0,0,0,0,0,5,4,1,0,0,0,0,0,0,0,0,0
177472,21040,210,40,-2,10,7,3,0,0,0,0,0,0,0,0,0,0,0,0,0,0,0,8,6,2,0,0,0,2,1,1,0,0,0
177542,21040,210,40,-2,5,2,3,0,0,0,0,0,0,0,0,0,0,0,0,0,0,0,5,2,3,0,0,0,0,0,0,0,0,0
177719,21040,210,40,-2,5,0,5,0,0,0,0,0,0,2,0,2,0,0,0,0,0,0,3,0,3,0,0,0,0,0,0,0,0,0
177746,21040,210,40,-2,4,2,2,0,0,0,0,0,0,1,1,0,1,1,0,0,0,0,2,0,2,0,0,0,0,0,0,0,0,0
177968,21040,210,40,-2,8,1,7,0,0,0,0,0,0,1,0,1,0,0,0,0,0,0,6,0,6,0,0,0,0,0,0,1,1,0
177977,21040,210,40,-2,18,14,4,0,0,0,0,0,0,0,0,0,0,0,0,0,0,0,17,13,4,1,1,0,0,0,0,0,0,0
177986,21040,210,40,-2,6,2,4,0,0,0,0,0,0,0,0,0,0,0,0,0,0,0,5,1,4,1,1,0,0,0,0,0,0,0
177995,21040,210,40,-2,9,4,5,0,0,0,0,0,0,1,1,0,0,0,0,0,0,0,8,3,5,0,0,0,0,0,0,0,0,0
178059,21040,210,40,-2,3,0,3,0,0,0,0,0,0,1,0,1,0,0,0,0,0,0,2,0,2,0,0,0,0,0,0,0,0,0
178183,21040,210,40,-2,2,0,2,0,0,0,0,0,0,0,0,0,0,0,0,0,0,0,2,0,2,0,0,0,0,0,0,0,0,0
178208,21040,210,40,-2,2,2,0,0,0,0,0,0,0,0,0,0,1,1,0,0,0,0,1,1,0,0,0,0,0,0,0,0,0,0
178217,21040,210,40,-2,1,0,1,0,0,0,0,0,0,0,0,0,0,0,0,0,0,0,1,0,1,0,0,0,0,0,0,0,0,0
178244,21040,210,40,-2,6,1,5,0,0,0,0,0,0,1,0,1,0,0,0,0,0,0,5,1,4,0,0,0,0,0,0,0,0,0
178341,21040,210,40,-2,7,3,4,0,0,0,0,0,0,1,0,1,0,0,0,0,0,0,6,3,3,0,0,0,0,0,0,0,0,0
178369,21040,210,40,-2,9,5,4,0,0,0,2,2,0,0,0,0,0,0,0,0,0,0,7,3,4,0,0,0,0,0,0,0,0,0
178387,21040,210,40,-2,6,3,3,0,0,0,0,0,0,0,0,0,1,1,0,0,0,0,3,0,3,0,0,0,2,2,0,0,0,0
178396,21040,210,40,-2,125,63,62,1,0,1,12,10,2,6,3,3,3,1,2,0,0,0,75,36,39,1,1,0,14,4,10,13,8,5
178402,21040,210,40,-2,31,18,13,0,0,0,0,0,0,4,3,1,0,0,0,0,0,0,21,12,9,0,0,0,1,0,1,5,3,2
178411,21040,210,40,-2,3,2,1,0,0,0,0,0,0,0,0,0,0,0,0,0,0,0,1,1,0,0,0,0,1,0,1,1,1,0
178420,21040,210,40,-2,4,0,4,0,0,0,1,0,1,1,0,1,0,0,0,0,0,0,1,0,1,0,0,0,1,0,1,0,0,0
178448,21040,210,40,-2,9,3,6,0,0,0,0,0,0,1,1,0,0,0,0,0,0,0,8,2,6,0,0,0,0,0,0,0,0,0
178615,21040,210,40,-2,10,6,4,0,0,0,1,1,0,1,1,0,0,0,0,0,0,0,6,4,2,0,0,0,0,0,0,2,0,2
178624,21040,210,40,-2,4,1,3,0,0,0,0,0,0,0,0,0,0,0,0,0,0,0,3,0,3,0,0,0,0,0,0,1,1,0
178679,21040,210,40,-2,1,1,0,0,0,0,0,0,0,0,0,0,0,0,0,0,0,0,1,1,0,0,0,0,0,0,0,0,0,0
178697,21040,210,40,-2,8,7,1,0,0,0,0,0,0,0,0,0,0,0,0,0,0,0,8,7,1,0,0,0,0,0,0,0,0,0
178721,21040,210,40,-2,2,0,2,0,0,0,0,0,0,0,0,0,0,0,0,0,0,0,2,0,2,0,0,0,0,0,0,0,0,0
178891,21040,210,40,-2,7,6,1,0,0,0,0,0,0,1,0,1,0,0,0,0,0,0,6,6,0,0,0,0,0,0,0,0,0,0
178989,21040,210,40,-2,4,2,2,0,0,0,0,0,0,0,0,0,0,0,0,0,0,0,4,2,2,0,0,0,0,0,0,0,0,0
179043,21040,210,40,-2,9,2,7,0,0,0,0,0,0,0,0,0,0,0,0,0,0,0,6,2,4,0,0,0,2,0,2,1,0,1
179159,21040,210,40,-2,23,11,12,0,0,0,2,0,2,3,3,0,2,1,1,0,0,0,7,3,4,1,0,1,0,0,0,8,4,4
179308,21040,210,40,-2,27,8,19,0,0,0,0,0,0,2,0,2,0,0,0,0,0,0,20,5,15,0,0,0,3,1,2,2,2,0
179317,21040,210,40,-2,1,1,0,0,0,0,0,0,0,1,1,0,0,0,0,0,0,0,0,0,0,0,0,0,0,0,0,0,0,0
179326,21040,210,40,-2,6,2,4,0,0,0,0,0,0,0,0,0,0,0,0,0,0,0,6,2,4,0,0,0,0,0,0,0,0,0
179344,21040,210,40,-2,4,2,2,0,0,0,0,0,0,0,0,0,0,0,0,0,0,0,2,0,2,0,0,0,2,2,0,0,0,0
179539,21040,210,40,-2,9,2,7,0,0,0,0,0,0,0,0,0,1,0,1,0,0,0,8,2,6,0,0,0,0,0,0,0,0,0
179548,21040,210,40,-2,7,3,4,0,0,0,0,0,0,0,0,0,0,0,0,0,0,0,7,3,4,0,0,0,0,0,0,0,0,0
179557,21040,210,40,-2,13,8,5,0,0,0,1,1,0,0,0,0,0,0,0,0,0,0,11,6,5,0,0,0,1,1,0,0,0,0
179566,21040,210,40,-2,19,5,14,0,0,0,0,0,0,1,1,0,2,0,2,0,0,0,15,4,11,0,0,0,0,0,0,1,0,1
179645,21040,210,40,-2,2,1,1,0,0,0,0,0,0,0,0,0,0,0,0,0,0,0,2,1,1,0,0,0,0,0,0,0,0,0
179812,21040,210,40,-2,8,4,4,0,0,0,0,0,0,0,0,0,1,0,1,0,0,0,6,4,2,1,0,1,0,0,0,0,0,0
179867,21040,210,40,-2,35,18,17,0,0,0,5,1,4,4,2,2,2,1,1,0,0,0,16,9,7,2,1,1,0,0,0,6,4,2
179894,21040,210,40,-2,5,3,2,0,0,0,0,0,0,0,0,0,0,0,0,0,0,0,2,1,1,1,0,1,2,2,0,0,0,0
179946,21040,210,40,-2,1,0,1,0,0,0,0,0,0,0,0,0,0,0,0,0,0,0,1,0,1,0,0,0,0,0,0,0,0,0
179955,21040,210,40,-2,3,2,1,0,0,0,0,0,0,0,0,0,0,0,0,0,0,0,3,2,1,0,0,0,0,0,0,0,0,0
180054,21040,210,40,-2,1,1,0,1,1,0,0,0,0,0,0,0,0,0,0,0,0,0,0,0,0,0,0,0,0,0,0,0,0,0
180106,21040,210,40,-2,12,3,9,0,0,0,0,0,0,0,0,0,0,0,0,0,0,0,6,2,4,0,0,0,6,1,5,0,0,0
180179,21040,210,40,-2,13,5,8,0,0,0,0,0,0,0,0,0,0,0,0,0,0,0,13,5,8,0,0,0,0,0,0,0,0,0
180203,21040,210,40,-2,2,2,0,1,1,0,0,0,0,0,0,0,0,0,0,0,0,0,1,1,0,0,0,0,0,0,0,0,0,0
180212,21040,210,40,-2,2,1,1,0,0,0,0,0,0,0,0,0,0,0,0,0,0,0,2,1,1,0,0,0,0,0,0,0,0,0
180328,21040,210,40,-2,1,1,0,1,1,0,0,0,0,0,0,0,0,0,0,0,0,0,0,0,0,0,0,0,0,0,0,0,0,0
180373,21040,210,40,-2,5,3,2,0,0,0,0,0,0,0,0,0,0,0,0,0,0,0,3,2,1,0,0,0,2,1,1,0,0,0
180416,21040,210,40,-2,2,2,0,0,0,0,0,0,0,0,0,0,0,0,0,0,0,0,2,2,0,0,0,0,0,0,0,0,0,0
180461,21040,210,40,-2,12,4,8,0,0,0,0,0,0,0,0,0,0,0,0,0,0,0,11,4,7,0,0,0,1,0,1,0,0,0
180489,21040,210,40,-2,9,5,4,1,1,0,0,0,0,0,0,0,0,0,0,0,0,0,8,4,4,0,0,0,0,0,0,0,0,0
180595,21040,210,40,-2,4,1,3,0,0,0,0,0,0,0,0,0,0,0,0,0,0,0,2,0,2,0,0,0,2,1,1,0,0,0
180647,21040,210,40,-2,8,5,3,3,2,1,0,0,0,0,0,0,1,0,1,0,0,0,4,3,1,0,0,0,0,0,0,0,0,0
180814,21040,210,40,-2,3,3,0,0,0,0,0,0,0,0,0,0,0,0,0,0,0,0,2,2,0,0,0,0,1,1,0,0,0,0
180832,21040,210,40,-2,4,0,4,0,0,0,0,0,0,0,0,0,0,0,0,0,0,0,4,0,4,0,0,0,0,0,0,0,0,0
180878,21040,210,40,-2,1,0,1,0,0,0,0,0,0,0,0,0,0,0,0,0,0,0,1,0,1,0,0,0,0,0,0,0,0,0
180902,21040,210,40,-2,9,6,3,0,0,0,2,1,1,0,0,0,0,0,0,0,0,0,7,5,2,0,0,0,0,0,0,0,0,0
180948,21040,210,40,-2,1,1,0,0,0,0,0,0,0,0,0,0,0,0,0,0,0,0,1,1,0,0,0,0,0,0,0,0,0,0
180984,21040,210,40,-2,4,2,2,0,0,0,1,1,0,0,0,0,0,0,0,0,0,0,3,1,2,0,0,0,0,0,0,0,0,0
181002,21040,210,40,-2,31,15,16,0,0,0,1,0,1,0,0,0,2,1,1,0,0,0,18,8,10,0,0,0,9,5,4,1,1,0
181020,21040,210,40,-2,7,3,4,0,0,0,2,1,1,0,0,0,0,0,0,0,0,0,5,2,3,0,0,0,0,0,0,0,0,0
181127,21040,210,40,-2,6,1,5,0,0,0,0,0,0,0,0,0,0,0,0,0,0,0,6,1,5,0,0,0,0,0,0,0,0,0
181215,21040,210,40,-2,10,5,5,0,0,0,0,0,0,0,0,0,0,0,0,0,0,0,9,4,5,0,0,0,0,0,0,1,1,0
181303,21040,210,40,-2,12,7,5,0,0,0,0,0,0,0,0,0,1,1,0,0,0,0,11,6,5,0,0,0,0,0,0,0,0,0
181312,21040,210,40,-2,14,12,2,0,0,0,0,0,0,0,0,0,0,0,0,0,0,0,14,12,2,0,0,0,0,0,0,0,0,0
181394,21040,210,40,-2,11,6,5,0,0,0,0,0,0,0,0,0,1,1,0,0,0,0,8,4,4,0,0,0,1,1,0,1,0,1
181419,21040,210,40,-2,3,3,0,2,2,0,1,1,0,0,0,0,0,0,0,0,0,0,0,0,0,0,0,0,0,0,0,0,0,0
181428,21040,210,40,-2,31,15,16,0,0,0,1,0,1,1,0,1,0,0,0,0,0,0,22,10,12,1,1,0,0,0,0,6,4,2
181446,21040,210,40,-2,5,1,4,0,0,0,1,0,1,0,0,0,0,0,0,0,0,0,3,1,2,0,0,0,0,0,0,1,0,1
181464,21040,210,40,-2,12,6,6,0,0,0,1,1,0,0,0,0,1,0,1,0,0,0,6,4,2,1,0,1,0,0,0,3,1,2
181491,21040,210,40,-2,13,10,3,0,0,0,0,0,0,0,0,0,0,0,0,0,0,0,13,10,3,0,0,0,0,0,0,0,0,0
181604,21040,210,40,-2,6,1,5,0,0,0,0,0,0,0,0,0,0,0,0,0,0,0,6,1,5,0,0,0,0,0,0,0,0,0
181640,21040,210,40,-2,20,12,8,0,0,0,1,1,0,1,1,0,0,0,0,0,0,0,18,10,8,0,0,0,0,0,0,0,0,0
181738,21040,210,40,-2,5,1,4,0,0,0,0,0,0,0,0,0,2,0,2,0,0,0,3,1,2,0,0,0,0,0,0,0,0,0
181765,21040,210,40,-2,1,1,0,0,0,0,0,0,0,0,0,0,0,0,0,0,0,0,1,1,0,0,0,0,0,0,0,0,0,0
181783,21040,210,40,-2,1,0,1,0,0,0,0,0,0,0,0,0,0,0,0,0,0,0,1,0,1,0,0,0,0,0,0,0,0,0
181853,21040,210,40,-2,3,2,1,0,0,0,0,0,0,0,0,0,0,0,0,0,0,0,3,2,1,0,0,0,0,0,0,0,0,0
181941,21040,210,40,-2,10,7,3,1,1,0,0,0,0,0,0,0,2,1,1,0,0,0,7,5,2,0,0,0,0,0,0,0,0,0
182148,21040,210,40,-2,14,0,14,0,0,0,0,0,0,1,0,1,4,0,4,0,0,0,9,0,9,0,0,0,0,0,0,0,0,0
182281,21040,210,40,-2,24,13,11,0,0,0,10,6,4,1,0,1,2,0,2,0,0,0,6,3,3,2,1,1,0,0,0,3,3,0
182290,21040,210,40,-2,13,4,9,0,0,0,0,0,0,0,0,0,1,1,0,0,0,0,12,3,9,0,0,0,0,0,0,0,0,0
182306,21040,210,40,-2,3,2,1,0,0,0,0,0,0,0,0,0,0,0,0,0,0,0,3,2,1,0,0,0,0,0,0,0,0,0
182458,21040,210,40,-2,1,0,1,0,0,0,0,0,0,1,0,1,0,0,0,0,0,0,0,0,0,0,0,0,0,0,0,0,0,0
182500,21040,210,40,-2,3,1,2,0,0,0,0,0,0,0,0,0,1,0,1,0,0,0,2,1,1,0,0,0,0,0,0,0,0,0
182634,21040,210,40,-2,5,0,5,0,0,0,0,0,0,0,0,0,0,0,0,0,0,0,5,0,5,0,0,0,0,0,0,0,0,0
182670,21040,210,40,-2,7,1,6,0,0,0,0,0,0,0,0,0,0,0,0,0,0,0,6,0,6,0,0,0,0,0,0,1,1,0
182795,21040,210,40,-2,6,2,4,0,0,0,0,0,0,0,0,0,0,0,0,0,0,0,6,2,4,0,0,0,0,0,0,0,0,0
182829,21040,210,40,-2,1,0,1,0,0,0,0,0,0,0,0,0,0,0,0,0,0,0,1,0,1,0,0,0,0,0,0,0,0,0
182980,21040,210,40,-2,5,0,5,0,0,0,0,0,0,1,0,1,0,0,0,0,0,0,4,0,4,0,0,0,0,0,0,0,0,0
183026,21040,210,40,-2,2,1,1,0,0,0,0,0,0,0,0,0,0,0,0,0,0,0,2,1,1,0,0,0,0,0,0,0,0,0
183044,21040,210,40,-2,23,7,16,0,0,0,1,1,0,0,0,0,1,0,1,0,0,0,13,5,8,1,0,1,3,0,3,4,1,3
183062,21040,210,40,-2,2,2,0,0,0,0,0,0,0,0,0,0,0,0,0,0,0,0,1,1,0,0,0,0,1,1,0,0,0,0
183071,21040,210,40,-2,1,1,0,0,0,0,0,0,0,0,0,0,0,0,0,0,0,0,1,1,0,0,0,0,0,0,0,0,0,0
183080,21040,210,40,-2,12,5,7,0,0,0,0,0,0,0,0,0,0,0,0,0,0,0,10,5,5,0,0,0,1,0,1,1,0,1
183105,21040,210,40,-2,1,1,0,0,0,0,0,0,0,0,0,0,0,0,0,0,0,0,1,1,0,0,0,0,0,0,0,0,0,0
183114,21040,210,40,-2,1,0,1,0,0,0,0,0,0,0,0,0,0,0,0,0,0,0,1,0,1,0,0,0,0,0,0,0,0,0
183123,21040,210,40,-2,5,3,2,0,0,0,0,0,0,0,0,0,0,0,0,0,0,0,4,2,2,0,0,0,1,1,0,0,0,0
183132,21040,210,40,-2,1,0,1,0,0,0,0,0,0,0,0,0,0,0,0,0,0,0,0,0,0,1,0,1,0,0,0,0,0,0
183141,21040,210,40,-2,2,1,1,0,0,0,0,0,0,0,0,0,0,0,0,0,0,0,2,1,1,0,0,0,0,0,0,0,0,0
183150,21040,210,40,-2,1,1,0,0,0,0,0,0,0,0,0,0,0,0,0,0,0,0,1,1,0,0,0,0,0,0,0,0,0,0
183211,21040,210,40,-2,4,0,4,0,0,0,1,0,1,0,0,0,0,0,0,0,0,0,3,0,3,0,0,0,0,0,0,0,0,0
183239,21040,210,40,-2,10,3,7,0,0,0,0,0,0,1,1,0,1,0,1,0,0,0,7,1,6,0,0,0,1,1,0,0,0,0
183248,21040,210,40,-2,2,0,2,0,0,0,0,0,0,0,0,0,0,0,0,0,0,0,2,0,2,0,0,0,0,0,0,0,0,0
183257,21040,210,40,-2,3,1,2,0,0,0,0,0,0,0,0,0,0,0,0,0,0,0,3,1,2,0,0,0,0,0,0,0,0,0
183822,21040,210,40,-2,3,0,3,0,0,0,0,0,0,3,0,3,0,0,0,0,0,0,0,0,0,0,0,0,0,0,0,0,0,0
183859,21040,210,40,-2,4,3,1,0,0,0,0,0,0,0,0,0,0,0,0,0,0,0,3,2,1,0,0,0,1,1,0,0,0,0
183974,21040,210,40,-2,2,1,1,0,0,0,0,0,0,0,0,0,0,0,0,0,0,0,2,1,1,0,0,0,0,0,0,0,0,0
184205,21040,210,40,-2,1,1,0,0,0,0,0,0,0,0,0,0,0,0,0,0,0,0,1,1,0,0,0,0,0,0,0,0,0,0
184348,21040,210,40,-2,1,1,0,0,0,0,1,1,0,0,0,0,0,0,0,0,0,0,0,0,0,0,0,0,0,0,0,0,0,0
184481,21040,210,40,-2,1,0,1,0,0,0,0,0,0,1,0,1,0,0,0,0,0,0,0,0,0,0,0,0,0,0,0,0,0,0
184603,21040,210,40,-2,3,1,2,0,0,0,0,0,0,1,1,0,0,0,0,0,0,0,2,0,2,0,0,0,0,0,0,0,0,0
184612,21040,210,40,-2,16,4,12,0,0,0,0,0,0,1,0,1,4,1,3,0,0,0,10,2,8,1,1,0,0,0,0,0,0,0
184694,21040,210,40,-2,7,2,5,0,0,0,3,1,2,0,0,0,0,0,0,0,0,0,2,0,2,1,1,0,1,0,1,0,0,0
184773,21040,210,40,-2,1,0,1,0,0,0,0,0,0,0,0,0,0,0,0,0,0,0,1,0,1,0,0,0,0,0,0,0,0,0
184782,21040,210,40,-2,56,25,31,0,0,0,5,3,2,8,2,6,2,0,2,0,0,0,34,14,20,2,2,0,2,2,0,3,2,1
184959,21040,210,40,-2,3,0,3,0,0,0,0,0,0,0,0,0,0,0,0,0,0,0,3,0,3,0,0,0,0,0,0,0,0,0
185262,21040,210,40,-2,5,0,5,0,0,0,0,0,0,3,0,3,1,0,1,0,0,0,1,0,1,0,0,0,0,0,0,0,0,0
185572,21040,210,40,-2,9,2,7,0,0,0,0,0,0,0,0,0,1,1,0,0,0,0,7,1,6,1,0,1,0,0,0,0,0,0
185590,21040,210,40,-2,9,3,6,0,0,0,0,0,0,3,1,2,1,0,1,0,0,0,2,2,0,0,0,0,2,0,2,1,0,1
185721,21040,210,40,-2,1,0,1,0,0,0,0,0,0,0,0,0,0,0,0,0,0,0,1,0,1,0,0,0,0,0,0,0,0,0
185828,21040,210,40,-2,12,6,6,0,0,0,5,3,2,0,0,0,1,0,1,0,0,0,3,1,2,0,0,0,0,0,0,3,2,1
186122,21040,210,40,-2,1,1,0,0,0,0,0,0,0,0,0,0,0,0,0,0,0,0,1,1,0,0,0,0,0,0,0,0,0,0
186131,21040,210,40,-2,23,11,12,0,0,0,2,2,0,1,1,0,1,0,1,0,0,0,4,1,3,0,0,0,7,4,3,8,3,5
186201,21040,210,40,-2,1,0,1,0,0,0,0,0,0,1,0,1,0,0,0,0,0,0,0,0,0,0,0,0,0,0,0,0,0,0
186283,21040,210,40,-2,2,0,2,0,0,0,1,0,1,0,0,0,0,0,0,0,0,0,1,0,1,0,0,0,0,0,0,0,0,0
186371,21040,210,40,-2,4,3,1,0,0,0,0,0,0,0,0,0,0,0,0,0,0,0,1,1,0,0,0,0,3,2,1,0,0,0
186380,21040,210,40,-2,147,59,88,0,0,0,7,5,2,5,2,3,4,1,3,0,0,0,22,8,14,0,0,0,99,35,64,10,8,2
186399,21040,210,40,-2,17,8,9,0,0,0,1,0,1,1,0,1,1,1,0,0,0,0,0,0,0,0,0,0,11,6,5,3,1,2
186432,21040,210,40,-2,3,2,1,0,0,0,2,2,0,0,0,0,0,0,0,0,0,0,1,0,1,0,0,0,0,0,0,0,0,0
186584,21040,210,40,-2,13,6,7,0,0,0,0,0,0,0,0,0,1,0,1,0,0,0,10,6,4,1,0,1,1,0,1,0,0,0
186618,21040,210,40,-2,8,1,7,0,0,0,0,0,0,0,0,0,0,0,0,0,0,0,6,0,6,0,0,0,2,1,1,0,0,0
186867,21040,210,40,-2,12,8,4,0,0,0,0,0,0,0,0,0,0,0,0,0,0,0,5,2,3,0,0,0,0,0,0,7,6,1
186876,21040,210,40,-2,7,0,7,0,0,0,0,0,0,0,0,0,0,0,0,0,0,0,7,0,7,0,0,0,0,0,0,0,0,0
187134,21040,210,40,-2,10,7,3,0,0,0,0,0,0,1,1,0,0,0,0,0,0,0,8,6,2,0,0,0,1,0,1,0,0,0
187444,21040,210,40,-2,7,2,5,0,0,0,1,0,1,3,1,2,1,1,0,0,0,0,2,0,2,0,0,0,0,0,0,0,0,0
187532,21040,210,40,-2,6,2,4,0,0,0,0,0,0,0,0,0,1,0,1,0,0,0,5,2,3,0,0,0,0,0,0,0,0,0
187596,21040,210,40,-2,17,12,5,5,3,2,0,0,0,2,1,1,0,0,0,0,0,0,6,5,1,0,0,0,1,1,0,3,2,1
187639,21040,210,40,-2,8,2,6,0,0,0,0,0,0,1,0,1,2,1,1,0,0,0,5,1,4,0,0,0,0,0,0,0,0,0
187648,21040,210,40,-2,4,2,2,0,0,0,0,0,0,0,0,0,0,0,0,0,0,0,3,2,1,0,0,0,0,0,0,1,0,1
187897,21040,210,40,-2,3,0,3,0,0,0,0,0,0,0,0,0,0,0,0,0,0,0,3,0,3,0,0,0,0,0,0,0,0,0
187903,21040,210,40,-2,15,7,8,0,0,0,0,0,0,2,0,2,1,1,0,0,0,0,12,6,6,0,0,0,0,0,0,0,0,0
187958,21040,210,40,-2,2,1,1,1,0,1,0,0,0,0,0,0,0,0,0,0,0,0,0,0,0,0,0,0,0,0,0,1,1,0
187967,21040,210,40,-2,5,1,4,0,0,0,1,0,1,0,0,0,2,1,1,0,0,0,2,0,2,0,0,0,0,0,0,0,0,0
187985,21040,210,40,-2,84,25,59,3,1,2,6,4,2,3,1,2,12,4,8,0,0,0,47,11,36,2,1,1,2,1,1,9,2,7
188030,21040,210,40,-2,11,4,7,0,0,0,0,0,0,0,0,0,1,0,1,0,0,0,10,4,6,0,0,0,0,0,0,0,0,0
188058,21040,210,40,-2,1,1,0,0,0,0,0,0,0,0,0,0,0,0,0,0,0,0,0,0,0,0,0,0,1,1,0,0,0,0
188100,21040,210,40,-2,9,6,3,0,0,0,1,1,0,1,1,0,1,1,0,0,0,0,2,1,1,0,0,0,4,2,2,0,0,0
188137,21040,210,40,-2,5,4,1,0,0,0,0,0,0,0,0,0,3,2,1,0,0,0,1,1,0,1,1,0,0,0,0,0,0,0
188182,21040,210,40,-2,4,1,3,0,0,0,0,0,0,0,0,0,0,0,0,0,0,0,0,0,0,0,0,0,4,1,3,0,0,0
188225,21040,210,40,-2,1,1,0,0,0,0,0,0,0,0,0,0,0,0,0,0,0,0,1,1,0,0,0,0,0,0,0,0,0,0
188261,21040,210,40,-2,2,1,1,0,0,0,0,0,0,0,0,0,0,0,0,0,0,0,2,1,1,0,0,0,0,0,0,0,0,0
188429,21040,210,40,-2,5,2,3,0,0,0,1,0,1,1,0,1,0,0,0,0,0,0,3,2,1,0,0,0,0,0,0,0,0,0
188438,21040,210,40,-2,1,0,1,0,0,0,0,0,0,0,0,0,0,0,0,0,0,0,1,0,1,0,0,0,0,0,0,0,0,0
188517,21040,210,40,-2,2,0,2,0,0,0,0,0,0,0,0,0,0,0,0,0,0,0,1,0,1,0,0,0,1,0,1,0,0,0
188526,21040,210,40,-2,2,1,1,0,0,0,1,1,0,0,0,0,0,0,0,0,0,0,1,0,1,0,0,0,0,0,0,0,0,0
188535,21040,210,40,-2,2,0,2,0,0,0,0,0,0,1,0,1,0,0,0,0,0,0,1,0,1,0,0,0,0,0,0,0,0,0
188580,21040,210,40,-2,15,6,9,0,0,0,2,2,0,1,1,0,1,0,1,0,0,0,10,3,7,0,0,0,1,0,1,0,0,0
188641,21040,210,40,-2,10,2,8,0,0,0,2,1,1,0,0,0,1,0,1,0,0,0,5,0,5,1,0,1,0,0,0,1,1,0
188854,21040,210,40,-2,3,2,1,0,0,0,0,0,0,0,0,0,0,0,0,0,0,0,2,1,1,1,1,0,0,0,0,0,0,0
189015,21040,210,40,-2,1,0,1,0,0,0,0,0,0,0,0,0,0,0,0,0,0,0,1,0,1,0,0,0,0,0,0,0,0,0
189088,21040,210,40,-2,2,1,1,0,0,0,0,0,0,1,1,0,0,0,0,0,0,0,0,0,0,0,0,0,1,0,1,0,0,0
189097,21040,210,40,-2,18,5,13,0,0,0,2,0,2,1,0,1,0,0,0,0,0,0,13,5,8,0,0,0,2,0,2,0,0,0
189413,21040,210,40,-2,2,1,1,0,0,0,0,0,0,1,1,0,1,0,1,0,0,0,0,0,0,0,0,0,0,0,0,0,0,0
189565,21040,210,40,-2,2,0,2,0,0,0,0,0,0,0,0,0,0,0,0,0,0,0,1,0,1,0,0,0,1,0,1,0,0,0
189705,21040,210,40,-2,3,0,3,0,0,0,0,0,0,0,0,0,0,0,0,0,0,0,3,0,3,0,0,0,0,0,0,0,0,0
189811,21040,210,40,-2,1,0,1,0,0,0,1,0,1,0,0,0,0,0,0,0,0,0,0,0,0,0,0,0,0,0,0,0,0,0
189857,21040,210,40,-2,5,5,0,0,0,0,0,0,0,0,0,0,0,0,0,0,0,0,5,5,0,0,0,0,0,0,0,0,0,0
190044,21040,210,40,-2,5,1,4,0,0,0,0,0,0,0,0,0,0,0,0,0,0,0,5,1,4,0,0,0,0,0,0,0,0,0
190071,21040,210,40,-2,2,0,2,0,0,0,0,0,0,0,0,0,0,0,0,0,0,0,2,0,2,0,0,0,0,0,0,0,0,0
190099,21040,210,40,-2,27,14,13,0,0,0,0,0,0,0,0,0,1,1,0,1,1,0,13,5,8,2,1,1,1,0,1,9,6,3
190150,21040,210,40,-2,252,131,121,0,0,0,56,29,27,24,11,13,12,6,6,0,0,0,107,55,52,7,3,4,20,12,8,26,15,11
190169,21040,210,40,-2,1,0,1,0,0,0,0,0,0,0,0,0,0,0,0,0,0,0,1,0,1,0,0,0,0,0,0,0,0,0
190415,21040,210,40,-2,74,37,37,0,0,0,10,5,5,3,2,1,7,4,3,0,0,0,35,20,15,2,0,2,0,0,0,17,6,11
190424,21040,210,40,-2,160,55,105,0,0,0,59,35,24,16,4,12,7,2,5,0,0,0,54,0,54,0,0,0,1,0,1,23,14,9
190442,21040,210,40,-2,1,1,0,0,0,0,0,0,0,1,1,0,0,0,0,0,0,0,0,0,0,0,0,0,0,0,0,0,0,0
190451,21040,210,40,-2,1,0,1,0,0,0,0,0,0,0,0,0,0,0,0,0,0,0,1,0,1,0,0,0,0,0,0,0,0,0
190503,21040,210,40,-2,5,2,3,0,0,0,1,0,1,0,0,0,1,0,1,0,0,0,3,2,1,0,0,0,0,0,0,0,0,0
190512,21040,210,40,-2,5,2,3,0,0,0,0,0,0,0,0,0,1,0,1,0,0,0,3,2,1,0,0,0,0,0,0,1,0,1
190521,21040,210,40,-2,18,7,11,0,0,0,2,1,1,5,1,4,2,2,0,0,0,0,8,3,5,0,0,0,0,0,0,1,0,1
190549,21040,210,40,-2,19,7,12,0,0,0,0,0,0,4,2,2,1,0,1,0,0,0,11,3,8,0,0,0,0,0,0,3,2,1
190567,21040,210,40,-2,12,7,5,0,0,0,1,1,0,0,0,0,1,1,0,0,0,0,8,3,5,2,2,0,0,0,0,0,0,0
190576,21040,210,40,-2,10,0,10,0,0,0,1,0,1,2,0,2,2,0,2,0,0,0,5,0,5,0,0,0,0,0,0,0,0,0
190585,21040,210,40,-2,1,1,0,0,0,0,0,0,0,0,0,0,0,0,0,0,0,0,1,1,0,0,0,0,0,0,0,0,0,0
190594,21040,210,40,-2,7,3,4,0,0,0,1,0,1,1,1,0,2,1,1,0,0,0,3,1,2,0,0,0,0,0,0,0,0,0
190600,21040,210,40,-2,34,13,21,0,0,0,1,0,1,7,4,3,4,1,3,0,0,0,22,8,14,0,0,0,0,0,0,0,0,0
190619,21040,210,40,-2,14,5,9,0,0,0,2,0,2,4,1,3,0,0,0,0,0,0,8,4,4,0,0,0,0,0,0,0,0,0
190628,21040,210,40,-2,1,1,0,0,0,0,0,0,0,0,0,0,1,1,0,0,0,0,0,0,0,0,0,0,0,0,0,0,0,0
190637,21040,210,40,-2,9,4,5,0,0,0,1,0,1,2,0,2,1,1,0,0,0,0,4,3,1,0,0,0,0,0,0,1,0,1
190646,21040,210,40,-2,14,7,7,0,0,0,1,1,0,11,5,6,0,0,0,0,0,0,2,1,1,0,0,0,0,0,0,0,0,0
190655,21040,210,40,-2,3,1,2,0,0,0,1,1,0,1,0,1,0,0,0,0,0,0,1,0,1,0,0,0,0,0,0,0,0,0
190664,21040,210,40,-2,21,8,13,0,0,0,5,2,3,2,0,2,1,0,1,0,0,0,13,6,7,0,0,0,0,0,0,0,0,0
190682,21040,210,40,-2,3,2,1,0,0,0,1,0,1,1,1,0,1,1,0,0,0,0,0,0,0,0,0,0,0,0,0,0,0,0
190691,21040,210,40,-2,1,0,1,0,0,0,0,0,0,1,0,1,0,0,0,0,0,0,0,0,0,0,0,0,0,0,0,0,0,0
190716,21040,210,40,-2,7,2,5,0,0,0,1,0,1,2,0,2,0,0,0,0,0,0,4,2,2,0,0,0,0,0,0,0,0,0
190725,21040,210,40,-2,6,1,5,0,0,0,0,0,0,0,0,0,1,0,1,0,0,0,5,1,4,0,0,0,0,0,0,0,0,0
190761,21040,210,40,-2,1,1,0,0,0,0,0,0,0,0,0,0,0,0,0,0,0,0,1,1,0,0,0,0,0,0,0,0,0,0
190956,21040,210,40,-2,4,0,4,0,0,0,0,0,0,0,0,0,0,0,0,0,0,0,4,0,4,0,0,0,0,0,0,0,0,0
190983,21040,210,40,-2,1,0,1,0,0,0,0,0,0,0,0,0,0,0,0,0,0,0,1,0,1,0,0,0,0,0,0,0,0,0
191205,21040,210,40,-2,2,0,2,0,0,0,1,0,1,0,0,0,0,0,0,0,0,0,1,0,1,0,0,0,0,0,0,0,0,0
191241,21040,210,40,-2,4,3,1,0,0,0,0,0,0,1,1,0,0,0,0,0,0,0,3,2,1,0,0,0,0,0,0,0,0,0
191320,21040,210,40,-2,1,0,1,0,0,0,0,0,0,0,0,0,0,0,0,0,0,0,1,0,1,0,0,0,0,0,0,0,0,0
191515,21040,210,40,-2,24,13,11,0,0,0,2,0,2,0,0,0,1,0,1,0,0,0,9,7,2,1,0,1,2,1,1,9,5,4
191597,21040,210,40,-2,6,1,5,0,0,0,1,0,1,4,0,4,0,0,0,0,0,0,1,1,0,0,0,0,0,0,0,0,0,0
191621,21040,210,40,-2,1,1,0,0,0,0,0,0,0,0,0,0,0,0,0,0,0,0,1,1,0,0,0,0,0,0,0,0,0,0
191630,21040,210,40,-2,13,6,7,0,0,0,1,1,0,1,1,0,2,1,1,0,0,0,8,3,5,0,0,0,1,0,1,0,0,0
191649,21040,210,40,-2,10,5,5,0,0,0,2,1,1,1,0,1,0,0,0,0,0,0,5,3,2,0,0,0,0,0,0,2,1,1
191931,21040,210,40,-2,13,7,6,0,0,0,2,1,1,2,1,1,1,0,1,0,0,0,7,4,3,0,0,0,1,1,0,0,0,0
191968,21040,210,40,-2,6,3,3,0,0,0,0,0,0,0,0,0,0,0,0,0,0,0,2,2,0,0,0,0,4,1,3,0,0,0
192022,21040,210,40,-2,1,1,0,0,0,0,0,0,0,0,0,0,0,0,0,0,0,0,1,1,0,0,0,0,0,0,0,0,0,0
192110,21040,210,40,-2,2,2,0,0,0,0,0,0,0,1,1,0,0,0,0,0,0,0,0,0,0,0,0,0,0,0,0,1,1,0
192192,21040,210,40,-2,2,0,2,0,0,0,0,0,0,0,0,0,0,0,0,0,0,0,2,0,2,0,0,0,0,0,0,0,0,0
192323,21040,210,40,-2,8,5,3,0,0,0,0,0,0,0,0,0,1,1,0,0,0,0,7,4,3,0,0,0,0,0,0,0,0,0
192448,21040,210,40,-2,22,12,10,0,0,0,1,1,0,3,0,3,0,0,0,0,0,0,13,9,4,0,0,0,5,2,3,0,0,0
192688,21040,210,40,-2,2,1,1,0,0,0,1,0,1,0,0,0,1,1,0,0,0,0,0,0,0,0,0,0,0,0,0,0,0,0
192703,21040,210,40,-2,3,1,2,0,0,0,0,0,0,0,0,0,1,0,1,0,0,0,1,1,0,0,0,0,1,0,1,0,0,0
192749,21040,210,40,-2,8,0,8,0,0,0,1,0,1,0,0,0,2,0,2,0,0,0,3,0,3,0,0,0,2,0,2,0,0,0
192785,21040,210,40,-2,1,0,1,0,0,0,0,0,0,0,0,0,0,0,0,0,0,0,1,0,1,0,0,0,0,0,0,0,0,0
192819,21040,210,40,-2,8,2,6,0,0,0,2,1,1,1,0,1,0,0,0,0,0,0,5,1,4,0,0,0,0,0,0,0,0,0
192864,21040,210,40,-2,7,5,2,0,0,0,0,0,0,0,0,0,0,0,0,0,0,0,0,0,0,0,0,0,7,5,2,0,0,0
192925,21040,210,40,-2,11,3,8,1,1,0,0,0,0,2,1,1,0,0,0,1,0,1,7,1,6,0,0,0,0,0,0,0,0,0
193016,21040,210,40,-2,21,6,15,0,0,0,2,1,1,4,1,3,1,0,1,0,0,0,13,3,10,0,0,0,1,1,0,0,0,0
193283,21040,210,40,-2,2,0,2,0,0,0,0,0,0,0,0,0,0,0,0,0,0,0,2,0,2,0,0,0,0,0,0,0,0,0
193308,21040,210,40,-2,9,2,7,0,0,0,3,1,2,1,0,1,2,0,2,0,0,0,3,1,2,0,0,0,0,0,0,0,0,0
193399,21040,210,40,-2,1,1,0,0,0,0,0,0,0,0,0,0,0,0,0,0,0,0,1,1,0,0,0,0,0,0,0,0,0,0
193405,21040,210,40,-2,155,66,89,0,0,0,17,7,10,3,0,3,4,1,3,0,0,0,29,17,12,1,0,1,90,35,55,11,6,5
193478,21040,210,40,-2,2,1,1,0,0,0,0,0,0,0,0,0,0,0,0,0,0,0,2,1,1,0,0,0,0,0,0,0,0,0
193584,21040,210,40,-2,8,2,6,0,0,0,1,0,1,0,0,0,2,1,1,0,0,0,5,1,4,0,0,0,0,0,0,0,0,0
193654,21040,210,40,-2,13,6,7,0,0,0,0,0,0,2,1,1,2,0,2,0,0,0,6,2,4,0,0,0,1,1,0,2,2,0
193821,21040,210,40,-2,2,1,1,0,0,0,0,0,0,0,0,0,0,0,0,0,0,0,1,0,1,0,0,0,1,1,0,0,0,0
193900,21040,210,40,-2,439,200,239,1,0,1,98,50,48,25,8,17,31,12,19,1,1,0,239,109,130,3,1,2,9,3,6,32,16,16
193973,21040,210,40,-2,13,5,8,0,0,0,0,0,0,0,0,0,0,0,0,0,0,0,13,5,8,0,0,0,0,0,0,0,0,0
194028,21040,210,40,-2,4,0,4,0,0,0,0,0,0,0,0,0,0,0,0,0,0,0,4,0,4,0,0,0,0,0,0,0,0,0
194073,21040,210,40,-2,1,0,1,0,0,0,1,0,1,0,0,0,0,0,0,0,0,0,0,0,0,0,0,0,0,0,0,0,0,0
194091,21040,210,40,-2,2,2,0,0,0,0,0,0,0,0,0,0,0,0,0,0,0,0,1,1,0,1,1,0,0,0,0,0,0,0
194310,21040,210,40,-2,22,7,15,0,0,0,2,0,2,2,2,0,4,1,3,0,0,0,11,4,7,0,0,0,2,0,2,1,0,1
194392,21040,210,40,-2,5,4,1,0,0,0,2,2,0,0,0,0,0,0,0,0,0,0,3,2,1,0,0,0,0,0,0,0,0,0
194499,21040,210,40,-2,1,1,0,0,0,0,0,0,0,0,0,0,1,1,0,0,0,0,0,0,0,0,0,0,0,0,0,0,0,0
194578,21040,210,40,-2,5,3,2,0,0,0,2,0,2,0,0,0,0,0,0,0,0,0,3,3,0,0,0,0,0,0,0,0,0,0
194824,21040,210,40,-2,5,3,2,0,0,0,2,2,0,0,0,0,0,0,0,0,0,0,3,1,2,0,0,0,0,0,0,0,0,0
195003,21040,210,40,-2,31,16,15,0,0,0,5,1,4,0,0,0,4,3,1,1,1,0,18,9,9,0,0,0,2,1,1,1,1,0
195030,21040,210,40,-2,62,36,26,0,0,0,8,5,3,4,2,2,3,2,1,0,0,0,36,18,18,0,0,0,0,0,0,11,9,2
195049,21040,210,40,-2,1,1,0,0,0,0,0,0,0,0,0,0,0,0,0,0,0,0,1,1,0,0,0,0,0,0,0,0,0,0
195058,21040,210,40,-2,3,2,1,0,0,0,0,0,0,0,0,0,0,0,0,0,0,0,3,2,1,0,0,0,0,0,0,0,0,0
195128,21040,210,40,-2,4,0,4,0,0,0,1,0,1,1,0,1,0,0,0,0,0,0,2,0,2,0,0,0,0,0,0,0,0,0
195164,21040,210,40,-2,5,1,4,0,0,0,0,0,0,0,0,0,0,0,0,0,0,0,5,1,4,0,0,0,0,0,0,0,0,0
195191,21040,210,40,-2,1,0,1,0,0,0,0,0,0,0,0,0,0,0,0,0,0,0,1,0,1,0,0,0,0,0,0,0,0,0
195216,21040,210,40,-2,8,5,3,0,0,0,1,0,1,0,0,0,1,1,0,0,0,0,5,4,1,0,0,0,1,0,1,0,0,0
195234,21040,210,40,-2,2,1,1,0,0,0,0,0,0,0,0,0,0,0,0,0,0,0,2,1,1,0,0,0,0,0,0,0,0,0
195243,21040,210,40,-2,1,0,1,0,0,0,0,0,0,0,0,0,1,0,1,0,0,0,0,0,0,0,0,0,0,0,0,0,0,0
195438,21040,210,40,-2,3,3,0,0,0,0,0,0,0,0,0,0,0,0,0,0,0,0,3,3,0,0,0,0,0,0,0,0,0,0
195474,21040,210,40,-2,14,7,7,0,0,0,0,0,0,1,0,1,0,0,0,0,0,0,11,6,5,0,0,0,0,0,0,2,1,1
195544,21040,210,40,-2,6,2,4,0,0,0,0,0,0,1,0,1,0,0,0,0,0,0,3,1,2,0,0,0,2,1,1,0,0,0
195720,21040,210,40,-2,13,4,9,0,0,0,0,0,0,2,0,2,0,0,0,0,0,0,10,3,7,0,0,0,1,1,0,0,0,0
195784,21040,210,40,-2,1,0,1,0,0,0,0,0,0,0,0,0,0,0,0,0,0,0,1,0,1,0,0,0,0,0,0,0,0,0
195809,21040,210,40,-2,11,4,7,0,0,0,4,2,2,1,0,1,0,0,0,0,0,0,5,1,4,0,0,0,0,0,0,1,1,0
196006,21040,210,40,-2,13,10,3,0,0,0,1,1,0,1,1,0,1,1,0,0,0,0,9,6,3,0,0,0,0,0,0,1,1,0
196015,21040,210,40,-2,2,1,1,0,0,0,0,0,0,0,0,0,0,0,0,0,0,0,1,0,1,0,0,0,0,0,0,1,1,0
196033,21040,210,40,-2,2,2,0,0,0,0,0,0,0,0,0,0,0,0,0,0,0,0,2,2,0,0,0,0,0,0,0,0,0,0
196060,21040,210,40,-2,7,2,5,0,0,0,0,0,0,0,0,0,0,0,0,0,0,0,6,2,4,0,0,0,0,0,0,1,0,1
196079,21040,210,40,-2,24,11,13,0,0,0,1,1,0,1,0,1,1,0,1,0,0,0,15,5,10,0,0,0,0,0,0,6,5,1
196088,21040,210,40,-2,31,13,18,2,1,1,3,1,2,2,1,1,0,0,0,0,0,0,18,5,13,0,0,0,0,0,0,6,5,1
196097,21040,210,40,-2,89,40,49,0,0,0,18,11,7,2,1,1,9,5,4,0,0,0,47,15,32,1,0,1,9,5,4,3,3,0
196103,21040,210,40,-2,1,1,0,0,0,0,0,0,0,0,0,0,0,0,0,0,0,0,1,1,0,0,0,0,0,0,0,0,0,0
196112,21040,210,40,-2,1,0,1,0,0,0,0,0,0,0,0,0,0,0,0,0,0,0,1,0,1,0,0,0,0,0,0,0,0,0
196121,21040,210,40,-2,2,0,2,0,0,0,0,0,0,0,0,0,0,0,0,0,0,0,2,0,2,0,0,0,0,0,0,0,0,0
196130,21040,210,40,-2,2,0,2,0,0,0,0,0,0,0,0,0,0,0,0,0,0,0,1,0,1,0,0,0,0,0,0,1,0,1
196149,21040,210,40,-2,1,1,0,0,0,0,0,0,0,0,0,0,0,0,0,0,0,0,1,1,0,0,0,0,0,0,0,0,0,0
196158,21040,210,40,-2,3,3,0,0,0,0,0,0,0,1,1,0,0,0,0,0,0,0,2,2,0,0,0,0,0,0,0,0,0,0
196167,21040,210,40,-2,3,1,2,0,0,0,1,1,0,0,0,0,0,0,0,0,0,0,2,0,2,0,0,0,0,0,0,0,0,0
196176,21040,210,40,-2,8,3,5,0,0,0,1,1,0,2,0,2,0,0,0,0,0,0,5,2,3,0,0,0,0,0,0,0,0,0
196185,21040,210,40,-2,11,7,4,1,0,1,1,1,0,0,0,0,0,0,0,0,0,0,9,6,3,0,0,0,0,0,0,0,0,0
196194,21040,210,40,-2,2,0,2,0,0,0,1,0,1,0,0,0,0,0,0,0,0,0,1,0,1,0,0,0,0,0,0,0,0,0
196200,21040,210,40,-2,10,9,1,0,0,0,0,0,0,2,1,1,1,1,0,0,0,0,7,7,0,0,0,0,0,0,0,0,0,0
196219,21040,210,40,-2,3,1,2,0,0,0,0,0,0,1,0,1,1,0,1,0,0,0,1,1,0,0,0,0,0,0,0,0,0,0
196237,21040,210,40,-2,1,1,0,0,0,0,0,0,0,0,0,0,1,1,0,0,0,0,0,0,0,0,0,0,0,0,0,0,0,0
196246,21040,210,40,-2,4,2,2,0,0,0,0,0,0,0,0,0,0,0,0,0,0,0,2,2,0,0,0,0,0,0,0,2,0,2
196255,21040,210,40,-2,11,6,5,0,0,0,1,1,0,3,1,2,2,1,1,0,0,0,5,3,2,0,0,0,0,0,0,0,0,0
196264,21040,210,40,-2,1,0,1,0,0,0,0,0,0,0,0,0,0,0,0,0,0,0,1,0,1,0,0,0,0,0,0,0,0,0
196291,21040,210,40,-2,1,1,0,0,0,0,0,0,0,0,0,0,0,0,0,0,0,0,1,1,0,0,0,0,0,0,0,0,0,0
196307,21040,210,40,-2,42,27,15,0,0,0,11,7,4,1,0,1,1,1,0,0,0,0,19,13,6,0,0,0,0,0,0,10,6,4
196389,21040,210,40,-2,7,2,5,0,0,0,1,1,0,3,1,2,2,0,2,0,0,0,1,0,1,0,0,0,0,0,0,0,0,0
196413,21040,210,40,-2,34,15,19,0,0,0,5,3,2,2,0,2,2,2,0,0,0,0,17,5,12,2,0,2,0,0,0,6,5,1
196431,21040,210,40,-2,2,2,0,0,0,0,0,0,0,0,0,0,0,0,0,0,0,0,2,2,0,0,0,0,0,0,0,0,0,0
196468,21040,210,40,-2,7,3,4,0,0,0,1,0,1,0,0,0,0,0,0,0,0,0,3,0,3,1,1,0,0,0,0,2,2,0
196592,21040,210,40,-2,29,6,23,0,0,0,2,1,1,2,0,2,6,0,6,0,0,0,14,4,10,3,1,2,2,0,2,0,0,0
196653,21040,210,40,-2,6,1,5,0,0,0,0,0,0,1,0,1,0,0,0,0,0,0,5,1,4,0,0,0,0,0,0,0,0,0
196680,21040,210,40,-2,2,0,2,0,0,0,1,0,1,0,0,0,0,0,0,0,0,0,1,0,1,0,0,0,0,0,0,0,0,0
196866,21040,210,40,-2,4,3,1,0,0,0,0,0,0,0,0,0,0,0,0,0,0,0,3,2,1,0,0,0,0,0,0,1,1,0
197027,21040,210,40,-2,1,1,0,0,0,0,0,0,0,0,0,0,0,0,0,0,0,0,1,1,0,0,0,0,0,0,0,0,0,0
197036,21040,210,40,-2,27,15,12,0,0,0,0,0,0,1,0,1,0,0,0,0,0,0,26,15,11,0,0,0,0,0,0,0,0,0
197045,21040,210,40,-2,1,1,0,0,0,0,0,0,0,0,0,0,0,0,0,0,0,0,1,1,0,0,0,0,0,0,0,0,0,0
197133,21040,210,40,-2,25,15,10,0,0,0,0,0,0,3,2,1,2,1,1,0,0,0,12,6,6,1,1,0,3,3,0,4,2,2
197142,21040,210,40,-2,2,1,1,0,0,0,0,0,0,0,0,0,0,0,0,0,0,0,2,1,1,0,0,0,0,0,0,0,0,0
197151,21040,210,40,-2,3,1,2,0,0,0,0,0,0,0,0,0,0,0,0,0,0,0,1,1,0,0,0,0,1,0,1,1,0,1
197230,21040,210,40,-2,3,1,2,0,0,0,0,0,0,0,0,0,1,0,1,0,0,0,1,0,1,1,1,0,0,0,0,0,0,0
197708,21040,210,40,-2,12,5,7,0,0,0,1,0,1,2,1,1,2,1,1,0,0,0,7,3,4,0,0,0,0,0,0,0,0,0
197735,21040,210,40,-2,3,3,0,0,0,0,0,0,0,0,0,0,0,0,0,0,0,0,3,3,0,0,0,0,0,0,0,0,0,0
197814,21040,210,40,-2,5,3,2,0,0,0,0,0,0,1,0,1,0,0,0,0,0,0,4,3,1,0,0,0,0,0,0,0,0,0
197850,21040,210,40,-2,10,4,6,0,0,0,0,0,0,1,0,1,0,0,0,0,0,0,9,4,5,0,0,0,0,0,0,0,0,0
197869,21040,210,40,-2,32,15,17,0,0,0,2,1,1,1,0,1,0,0,0,0,0,0,22,9,13,1,0,1,2,2,0,4,3,1
197887,21040,210,40,-2,11,6,5,0,0,0,0,0,0,0,0,0,0,0,0,0,0,0,11,6,5,0,0,0,0,0,0,0,0,0
197911,21040,210,40,-2,1,0,1,0,0,0,0,0,0,0,0,0,0,0,0,0,0,0,1,0,1,0,0,0,0,0,0,0,0,0
197966,21040,210,40,-2,4,1,3,0,0,0,0,0,0,1,0,1,0,0,0,0,0,0,3,1,2,0,0,0,0,0,0,0,0,0
197984,21040,210,40,-2,1,0,1,0,0,0,0,0,0,0,0,0,1,0,1,0,0,0,0,0,0,0,0,0,0,0,0,0,0,0
197993,21040,210,40,-2,1,0,1,0,0,0,0,0,0,0,0,0,0,0,0,0,0,0,1,0,1,0,0,0,0,0,0,0,0,0
198011,21040,210,40,-2,6,4,2,2,0,2,0,0,0,0,0,0,0,0,0,0,0,0,4,4,0,0,0,0,0,0,0,0,0,0
198039,21040,210,40,-2,14,4,10,0,0,0,0,0,0,1,0,1,0,0,0,0,0,0,13,4,9,0,0,0,0,0,0,0,0,0
198084,21040,210,40,-2,4,0,4,0,0,0,0,0,0,1,0,1,0,0,0,0,0,0,3,0,3,0,0,0,0,0,0,0,0,0
198109,21040,210,40,-2,3,1,2,0,0,0,0,0,0,1,1,0,0,0,0,0,0,0,2,0,2,0,0,0,0,0,0,0,0,0
198118,21040,210,40,-2,14,6,8,0,0,0,0,0,0,0,0,0,0,0,0,0,0,0,14,6,8,0,0,0,0,0,0,0,0,0
198136,21040,210,40,-2,3,3,0,0,0,0,0,0,0,1,1,0,0,0,0,0,0,0,2,2,0,0,0,0,0,0,0,0,0,0
198154,21040,210,40,-2,8,4,4,0,0,0,0,0,0,0,0,0,1,0,1,0,0,0,6,3,3,1,1,0,0,0,0,0,0,0
198206,21040,210,40,-2,4,1,3,0,0,0,0,0,0,0,0,0,0,0,0,0,0,0,4,1,3,0,0,0,0,0,0,0,0,0
198215,21040,210,40,-2,3,1,2,0,0,0,0,0,0,0,0,0,0,0,0,0,0,0,3,1,2,0,0,0,0,0,0,0,0,0
198233,21040,210,40,-2,10,5,5,0,0,0,1,1,0,0,0,0,0,0,0,0,0,0,8,4,4,0,0,0,1,0,1,0,0,0
198251,21040,210,40,-2,8,2,6,0,0,0,0,0,0,2,0,2,0,0,0,0,0,0,6,2,4,0,0,0,0,0,0,0,0,0
198260,21040,210,40,-2,14,7,7,0,0,0,0,0,0,1,0,1,0,0,0,0,0,0,11,7,4,0,0,0,2,0,2,0,0,0
198321,21040,210,40,-2,5,1,4,0,0,0,0,0,0,0,0,0,1,0,1,0,0,0,4,1,3,0,0,0,0,0,0,0,0,0
198330,21040,210,40,-2,9,5,4,0,0,0,0,0,0,0,0,0,0,0,0,0,0,0,9,5,4,0,0,0,0,0,0,0,0,0
198367,21040,210,40,-2,3,1,2,0,0,0,0,0,0,0,0,0,0,0,0,0,0,0,3,1,2,0,0,0,0,0,0,0,0,0
198376,21040,210,40,-2,15,5,10,0,0,0,0,0,0,1,1,0,0,0,0,0,0,0,13,4,9,1,0,1,0,0,0,0,0,0
198385,21040,210,40,-2,13,6,7,0,0,0,2,1,1,0,0,0,2,1,1,0,0,0,9,4,5,0,0,0,0,0,0,0,0,0
198419,21040,210,40,-2,165,84,81,1,0,1,23,11,12,11,5,6,13,5,8,0,0,0,98,51,47,1,1,0,0,0,0,18,11,7
198455,21040,210,40,-2,7,4,3,0,0,0,0,0,0,5,3,2,0,0,0,0,0,0,2,1,1,0,0,0,0,0,0,0,0,0
198464,21040,210,40,-2,31,11,20,0,0,0,1,0,1,3,0,3,5,2,3,0,0,0,15,5,10,2,0,2,1,0,1,4,4,0
198491,21040,210,40,-2,7,2,5,0,0,0,0,0,0,2,1,1,0,0,0,0,0,0,5,1,4,0,0,0,0,0,0,0,0,0
198507,21040,210,40,-2,8,4,4,0,0,0,0,0,0,5,2,3,0,0,0,0,0,0,2,1,1,0,0,0,0,0,0,1,1,0
198516,21040,210,40,-2,23,7,16,0,0,0,2,1,1,3,0,3,1,0,1,0,0,0,17,6,11,0,0,0,0,0,0,0,0,0
198534,21040,210,40,-2,37,17,20,4,2,2,2,2,0,12,5,7,0,0,0,0,0,0,19,8,11,0,0,0,0,0,0,0,0,0
198543,21040,210,40,-2,8,2,6,0,0,0,1,1,0,6,0,6,0,0,0,0,0,0,1,1,0,0,0,0,0,0,0,0,0,0
198552,21040,210,40,-2,14,6,8,0,0,0,0,0,0,6,2,4,0,0,0,0,0,0,7,4,3,1,0,1,0,0,0,0,0,0
198561,21040,210,40,-2,5,0,5,0,0,0,0,0,0,1,0,1,1,0,1,0,0,0,3,0,3,0,0,0,0,0,0,0,0,0
198570,21040,210,40,-2,19,8,11,0,0,0,0,0,0,0,0,0,0,0,0,0,0,0,19,8,11,0,0,0,0,0,0,0,0,0
198598,21040,210,40,-2,1,0,1,0,0,0,0,0,0,0,0,0,0,0,0,0,0,0,1,0,1,0,0,0,0,0,0,0,0,0
198613,21040,210,40,-2,5,4,1,0,0,0,2,1,1,0,0,0,0,0,0,0,0,0,3,3,0,0,0,0,0,0,0,0,0,0
198622,21040,210,40,-2,21,8,13,0,0,0,0,0,0,5,0,5,0,0,0,0,0,0,16,8,8,0,0,0,0,0,0,0,0,0
198640,21040,210,40,-2,3,2,1,0,0,0,0,0,0,0,0,0,0,0,0,0,0,0,3,2,1,0,0,0,0,0,0,0,0,0
198668,21040,210,40,-2,4,0,4,0,0,0,0,0,0,0,0,0,0,0,0,0,0,0,4,0,4,0,0,0,0,0,0,0,0,0
198695,21040,210,40,-2,27,12,15,0,0,0,1,1,0,3,1,2,1,0,1,0,0,0,21,10,11,1,0,1,0,0,0,0,0,0
198710,21040,210,40,-2,2,0,2,0,0,0,0,0,0,0,0,0,0,0,0,0,0,0,2,0,2,0,0,0,0,0,0,0,0,0
198729,21040,210,40,-2,2,0,2,0,0,0,0,0,0,0,0,0,1,0,1,0,0,0,1,0,1,0,0,0,0,0,0,0,0,0
198756,21040,210,40,-2,6,4,2,0,0,0,1,1,0,3,1,2,0,0,0,0,0,0,2,2,0,0,0,0,0,0,0,0,0,0
198774,21040,210,40,-2,7,2,5,0,0,0,0,0,0,0,0,0,0,0,0,0,0,0,7,2,5,0,0,0,0,0,0,0,0,0
198808,21040,210,40,-2,11,5,6,0,0,0,0,0,0,0,0,0,1,1,0,0,0,0,10,4,6,0,0,0,0,0,0,0,0,0
198817,21040,210,40,-2,9,3,6,0,0,0,0,0,0,0,0,0,0,0,0,0,0,0,9,3,6,0,0,0,0,0,0,0,0,0
198835,21040,210,40,-2,11,6,5,0,0,0,1,1,0,1,1,0,0,0,0,0,0,0,8,3,5,0,0,0,1,1,0,0,0,0
198862,21040,210,40,-2,8,2,6,0,0,0,0,0,0,6,2,4,0,0,0,0,0,0,2,0,2,0,0,0,0,0,0,0,0,0
198871,21040,210,40,-2,3,1,2,0,0,0,0,0,0,1,0,1,0,0,0,0,0,0,2,1,1,0,0,0,0,0,0,0,0,0
198899,21040,210,40,-2,1,0,1,0,0,0,0,0,0,0,0,0,0,0,0,0,0,0,1,0,1,0,0,0,0,0,0,0,0,0
198905,21040,210,40,-2,1,1,0,0,0,0,0,0,0,0,0,0,0,0,0,0,0,0,1,1,0,0,0,0,0,0,0,0,0,0
198923,21040,210,40,-2,3,2,1,0,0,0,0,0,0,0,0,0,0,0,0,0,0,0,3,2,1,0,0,0,0,0,0,0,0,0
198950,21040,210,40,-2,5,3,2,0,0,0,0,0,0,0,0,0,1,1,0,0,0,0,3,2,1,0,0,0,1,0,1,0,0,0
198969,21040,210,40,-2,2,0,2,0,0,0,0,0,0,1,0,1,0,0,0,0,0,0,1,0,1,0,0,0,0,0,0,0,0,0
198987,21040,210,40,-2,5,3,2,0,0,0,0,0,0,0,0,0,0,0,0,0,0,0,5,3,2,0,0,0,0,0,0,0,0,0
199023,21040,210,40,-2,4,0,4,0,0,0,0,0,0,0,0,0,0,0,0,0,0,0,4,0,4,0,0,0,0,0,0,0,0,0
199032,21040,210,40,-2,6,3,3,0,0,0,0,0,0,2,0,2,0,0,0,0,0,0,4,3,1,0,0,0,0,0,0,0,0,0
199069,21040,210,40,-2,3,1,2,0,0,0,0,0,0,0,0,0,0,0,0,0,0,0,3,1,2,0,0,0,0,0,0,0,0,0
199087,21040,210,40,-2,6,3,3,0,0,0,0,0,0,0,0,0,0,0,0,0,0,0,5,3,2,1,0,1,0,0,0,0,0,0
199102,21040,210,40,-2,4,2,2,0,0,0,0,0,0,1,1,0,1,0,1,0,0,0,2,1,1,0,0,0,0,0,0,0,0,0
199111,21040,210,40,-2,11,6,5,0,0,0,0,0,0,1,0,1,1,0,1,0,0,0,1,0,1,0,0,0,7,5,2,1,1,0
199120,21040,210,40,-2,58,21,37,0,0,0,2,0,2,5,0,5,4,2,2,0,0,0,21,8,13,2,0,2,20,9,11,4,2,2
199139,21040,210,40,-2,34,15,19,0,0,0,0,0,0,10,3,7,2,0,2,0,0,0,18,9,9,1,0,1,0,0,0,3,3,0
199148,21040,210,40,-2,42,14,28,0,0,0,2,0,2,5,0,5,1,1,0,0,0,0,29,11,18,0,0,0,1,0,1,4,2,2
199157,21040,210,40,-2,11,3,8,0,0,0,0,0,0,4,2,2,0,0,0,0,0,0,4,0,4,0,0,0,3,1,2,0,0,0
199184,21040,210,40,-2,5,1,4,0,0,0,1,0,1,1,0,1,0,0,0,0,0,0,3,1,2,0,0,0,0,0,0,0,0,0
199193,21040,210,40,-2,33,17,16,0,0,0,1,1,0,4,0,4,2,1,1,0,0,0,25,14,11,0,0,0,1,1,0,0,0,0
199209,21040,210,40,-2,3,1,2,0,0,0,0,0,0,0,0,0,0,0,0,0,0,0,3,1,2,0,0,0,0,0,0,0,0,0
199218,21040,210,40,-2,25,7,18,0,0,0,0,0,0,1,1,0,2,0,2,0,0,0,18,4,14,2,1,1,2,1,1,0,0,0
199263,21040,210,40,-2,2,2,0,0,0,0,0,0,0,0,0,0,0,0,0,0,0,0,2,2,0,0,0,0,0,0,0,0,0,0
199272,21040,210,40,-2,1,0,1,0,0,0,0,0,0,0,0,0,0,0,0,0,0,0,1,0,1,0,0,0,0,0,0,0,0,0
199281,21040,210,40,-2,12,4,8,1,0,1,1,0,1,2,0,2,0,0,0,0,0,0,8,4,4,0,0,0,0,0,0,0,0,0
199306,21040,210,40,-2,10,4,6,0,0,0,0,0,0,2,1,1,0,0,0,0,0,0,8,3,5,0,0,0,0,0,0,0,0,0
199324,21040,210,40,-2,9,6,3,0,0,0,0,0,0,2,2,0,1,0,1,0,0,0,6,4,2,0,0,0,0,0,0,0,0,0
199333,21040,210,40,-2,6,1,5,0,0,0,0,0,0,1,0,1,0,0,0,0,0,0,5,1,4,0,0,0,0,0,0,0,0,0
199412,21040,210,40,-2,2,0,2,0,0,0,0,0,0,1,0,1,1,0,1,0,0,0,0,0,0,0,0,0,0,0,0,0,0,0
199421,21040,210,40,-2,2,0,2,0,0,0,0,0,0,0,0,0,0,0,0,0,0,0,1,0,1,0,0,0,1,0,1,0,0,0
199449,21040,210,40,-2,13,7,6,0,0,0,0,0,0,1,1,0,0,0,0,0,0,0,12,6,6,0,0,0,0,0,0,0,0,0
199458,21040,210,40,-2,1,1,0,0,0,0,0,0,0,0,0,0,0,0,0,0,0,0,1,1,0,0,0,0,0,0,0,0,0,0
199467,21040,210,40,-2,2,0,2,0,0,0,0,0,0,0,0,0,0,0,0,0,0,0,2,0,2,0,0,0,0,0,0,0,0,0
199476,21040,210,40,-2,7,1,6,2,1,1,0,0,0,2,0,2,0,0,0,0,0,0,3,0,3,0,0,0,0,0,0,0,0,0
199485,21040,210,40,-2,1,0,1,0,0,0,0,0,0,0,0,0,0,0,0,0,0,0,1,0,1,0,0,0,0,0,0,0,0,0
199494,21040,210,40,-2,5,2,3,0,0,0,0,0,0,2,2,0,0,0,0,0,0,0,3,0,3,0,0,0,0,0,0,0,0,0
199582,21040,210,40,-2,1,1,0,0,0,0,0,0,0,1,1,0,0,0,0,0,0,0,0,0,0,0,0,0,0,0,0,0,0,0
199625,21040,210,40,-2,8,4,4,1,0,1,0,0,0,1,1,0,0,0,0,0,0,0,6,3,3,0,0,0,0,0,0,0,0,0
199634,21040,210,40,-2,7,4,3,0,0,0,0,0,0,0,0,0,0,0,0,0,0,0,7,4,3,0,0,0,0,0,0,0,0,0
199643,21040,210,40,-2,8,2,6,0,0,0,0,0,0,8,2,6,0,0,0,0,0,0,0,0,0,0,0,0,0,0,0,0,0,0
199698,21040,210,40,-2,5,1,4,0,0,0,0,0,0,1,0,1,0,0,0,0,0,0,4,1,3,0,0,0,0,0,0,0,0,0
199722,21040,210,40,-2,12,7,5,0,0,0,0,0,0,2,1,1,0,0,0,0,0,0,10,6,4,0,0,0,0,0,0,0,0,0
199731,21040,210,40,-2,4,1,3,0,0,0,0,0,0,0,0,0,0,0,0,0,0,0,4,1,3,0,0,0,0,0,0,0,0,0
199740,21040,210,40,-2,3,1,2,0,0,0,0,0,0,1,0,1,0,0,0,0,0,0,2,1,1,0,0,0,0,0,0,0,0,0
199759,21040,210,40,-2,1,0,1,0,0,0,0,0,0,0,0,0,0,0,0,0,0,0,1,0,1,0,0,0,0,0,0,0,0,0
199768,21040,210,40,-2,4,2,2,0,0,0,0,0,0,0,0,0,0,0,0,0,0,0,4,2,2,0,0,0,0,0,0,0,0,0
199786,21040,210,40,-2,6,1,5,0,0,0,0,0,0,0,0,0,0,0,0,0,0,0,6,1,5,0,0,0,0,0,0,0,0,0
199795,21040,210,40,-2,3,1,2,0,0,0,0,0,0,0,0,0,0,0,0,0,0,0,3,1,2,0,0,0,0,0,0,0,0,0
199838,21040,210,40,-2,1,1,0,0,0,0,1,1,0,0,0,0,0,0,0,0,0,0,0,0,0,0,0,0,0,0,0,0,0,0
199847,21040,210,40,-2,107,62,45,1,1,0,20,13,7,10,2,8,2,1,1,0,0,0,67,42,25,2,0,2,0,0,0,5,3,2
199856,21040,210,40,-2,34,23,11,0,0,0,2,2,0,5,1,4,0,0,0,0,0,0,21,15,6,0,0,0,6,5,1,0,0,0
199865,21040,210,40,-2,2,0,2,0,0,0,0,0,0,0,0,0,0,0,0,0,0,0,1,0,1,0,0,0,0,0,0,1,0,1
199883,21040,210,40,-2,1,0,1,0,0,0,0,0,0,1,0,1,0,0,0,0,0,0,0,0,0,0,0,0,0,0,0,0,0,0
199892,21040,210,40,-2,10,3,7,0,0,0,0,0,0,0,0,0,0,0,0,0,0,0,10,3,7,0,0,0,0,0,0,0,0,0
199908,21040,210,40,-2,2,1,1,0,0,0,0,0,0,0,0,0,0,0,0,0,0,0,2,1,1,0,0,0,0,0,0,0,0,0
199926,21040,210,40,-2,3,3,0,0,0,0,0,0,0,0,0,0,0,0,0,0,0,0,3,3,0,0,0,0,0,0,0,0,0,0
199953,21040,210,40,-2,2,1,1,0,0,0,0,0,0,1,1,0,0,0,0,0,0,0,1,0,1,0,0,0,0,0,0,0,0,0
199962,21040,210,40,-2,6,3,3,0,0,0,1,0,1,1,1,0,0,0,0,0,0,0,4,2,2,0,0,0,0,0,0,0,0,0
199999,21040,210,40,-2,5,1,4,0,0,0,0,0,0,4,1,3,0,0,0,0,0,0,1,0,1,0,0,0,0,0,0,0,0,0
200004,21040,210,40,-2,23,13,10,0,0,0,0,0,0,3,2,1,2,1,1,0,0,0,17,9,8,0,0,0,0,0,0,1,1,0
200022,21040,210,40,-2,1,0,1,0,0,0,0,0,0,0,0,0,0,0,0,0,0,0,1,0,1,0,0,0,0,0,0,0,0,0
200059,21040,210,40,-2,2,1,1,0,0,0,0,0,0,0,0,0,0,0,0,0,0,0,2,1,1,0,0,0,0,0,0,0,0,0
200156,21040,210,40,-2,7,3,4,0,0,0,0,0,0,0,0,0,0,0,0,0,0,0,7,3,4,0,0,0,0,0,0,0,0,0
200192,21040,210,40,-2,1,0,1,0,0,0,0,0,0,0,0,0,0,0,0,0,0,0,1,0,1,0,0,0,0,0,0,0,0,0
200208,21040,210,40,-2,3,2,1,2,1,1,0,0,0,0,0,0,0,0,0,0,0,0,1,1,0,0,0,0,0,0,0,0,0,0
200217,21040,210,40,-2,11,3,8,0,0,0,1,1,0,0,0,0,0,0,0,0,0,0,10,2,8,0,0,0,0,0,0,0,0,0
200253,21040,210,40,-2,5,3,2,0,0,0,0,0,0,0,0,0,0,0,0,0,0,0,5,3,2,0,0,0,0,0,0,0,0,0
200280,21040,210,40,-2,13,6,7,0,0,0,1,0,1,2,1,1,0,0,0,0,0,0,7,2,5,0,0,0,0,0,0,3,3,0
200314,21040,210,40,-2,3,1,2,1,0,1,0,0,0,0,0,0,0,0,0,0,0,0,2,1,1,0,0,0,0,0,0,0,0,0
200332,21040,210,40,-2,16,5,11,0,0,0,2,1,1,0,0,0,0,0,0,0,0,0,14,4,10,0,0,0,0,0,0,0,0,0
200466,21040,210,40,-2,1,1,0,0,0,0,0,0,0,0,0,0,0,0,0,0,0,0,1,1,0,0,0,0,0,0,0,0,0,0
200527,21040,210,40,-2,4,3,1,3,2,1,0,0,0,0,0,0,0,0,0,0,0,0,1,1,0,0,0,0,0,0,0,0,0,0
200554,21040,210,40,-2,1,1,0,0,0,0,0,0,0,0,0,0,0,0,0,0,0,0,1,1,0,0,0,0,0,0,0,0,0,0
200572,21040,210,40,-2,6,3,3,0,0,0,0,0,0,0,0,0,0,0,0,0,0,0,6,3,3,0,0,0,0,0,0,0,0,0
200590,21040,210,40,-2,1,0,1,0,0,0,0,0,0,0,0,0,0,0,0,0,0,0,1,0,1,0,0,0,0,0,0,0,0,0
200800,21040,210,40,-2,15,6,9,0,0,0,2,1,1,1,0,1,1,0,1,0,0,0,8,4,4,0,0,0,0,0,0,3,1,2
201104,21040,210,40,-2,8,2,6,0,0,0,0,0,0,2,0,2,0,0,0,0,0,0,6,2,4,0,0,0,0,0,0,0,0,0
201140,21040,210,40,-2,1,1,0,0,0,0,0,0,0,0,0,0,0,0,0,0,0,0,1,1,0,0,0,0,0,0,0,0,0,0
201177,21040,210,40,-2,1,0,1,0,0,0,0,0,0,0,0,0,0,0,0,0,0,0,1,0,1,0,0,0,0,0,0,0,0,0
201195,21040,210,40,-2,3,1,2,0,0,0,1,0,1,0,0,0,1,1,0,0,0,0,1,0,1,0,0,0,0,0,0,0,0,0
201283,21040,210,40,-2,1,1,0,0,0,0,0,0,0,0,0,0,0,0,0,0,0,0,1,1,0,0,0,0,0,0,0,0,0,0
201371,21040,210,40,-2,2,0,2,0,0,0,0,0,0,0,0,0,0,0,0,0,0,0,2,0,2,0,0,0,0,0,0,0,0,0
201432,21040,210,40,-2,3,3,0,0,0,0,0,0,0,0,0,0,0,0,0,0,0,0,2,2,0,0,0,0,1,1,0,0,0,0
201441,21040,210,40,-2,25,5,20,0,0,0,0,0,0,1,0,1,0,0,0,0,0,0,12,2,10,0,0,0,12,3,9,0,0,0
201469,21040,210,40,-2,3,1,2,0,0,0,0,0,0,0,0,0,0,0,0,0,0,0,3,1,2,0,0,0,0,0,0,0,0,0
201548,21040,210,40,-2,7,2,5,0,0,0,0,0,0,0,0,0,0,0,0,0,0,0,7,2,5,0,0,0,0,0,0,0,0,0
201645,21040,210,40,-2,32,19,13,0,0,0,4,3,1,3,2,1,3,2,1,0,0,0,18,9,9,0,0,0,1,1,0,3,2,1
201654,21040,210,40,-2,11,3,8,0,0,0,0,0,0,1,1,0,0,0,0,0,0,0,10,2,8,0,0,0,0,0,0,0,0,0
201672,21040,210,40,-2,1,1,0,0,0,0,0,0,0,0,0,0,0,0,0,0,0,0,1,1,0,0,0,0,0,0,0,0,0,0
201690,21040,210,40,-2,4,3,1,0,0,0,0,0,0,1,1,0,0,0,0,0,0,0,3,2,1,0,0,0,0,0,0,0,0,0
201751,21040,210,40,-2,2,0,2,0,0,0,0,0,0,0,0,0,0,0,0,0,0,0,1,0,1,0,0,0,1,0,1,0,0,0
201821,21040,210,40,-2,9,2,7,0,0,0,0,0,0,0,0,0,0,0,0,0,0,0,9,2,7,0,0,0,0,0,0,0,0,0
201885,21040,210,40,-2,121,63,58,0,0,0,17,9,8,5,2,3,4,3,1,0,0,0,74,36,38,2,1,1,9,4,5,10,8,2
201946,21040,210,40,-2,3,0,3,0,0,0,0,0,0,0,0,0,0,0,0,0,0,0,3,0,3,0,0,0,0,0,0,0,0,0
201964,21040,210,40,-2,1,1,0,0,0,0,0,0,0,0,0,0,0,0,0,0,0,0,1,1,0,0,0,0,0,0,0,0,0,0
201973,21040,210,40,-2,8,1,7,0,0,0,0,0,0,0,0,0,0,0,0,0,0,0,7,0,7,0,0,0,1,1,0,0,0,0
202046,21040,210,40,-2,5,3,2,0,0,0,0,0,0,0,0,0,0,0,0,0,0,0,5,3,2,0,0,0,0,0,0,0,0,0
202073,21040,210,40,-2,2,1,1,0,0,0,0,0,0,0,0,0,0,0,0,0,0,0,2,1,1,0,0,0,0,0,0,0,0,0
202134,21040,210,40,-2,14,10,4,0,0,0,1,1,0,0,0,0,0,0,0,0,0,0,11,8,3,0,0,0,0,0,0,2,1,1
202222,21040,210,40,-2,3,1,2,0,0,0,0,0,0,0,0,0,0,0,0,0,0,0,2,0,2,0,0,0,1,1,0,0,0,0
202356,21040,210,40,-2,26,8,18,0,0,0,0,0,0,3,0,3,1,0,1,0,0,0,19,6,13,2,1,1,1,1,0,0,0,0
202480,21040,210,40,-2,42,26,16,0,0,0,3,2,1,2,2,0,1,1,0,0,0,0,36,21,15,0,0,0,0,0,0,0,0,0
202514,21040,210,40,-2,1,0,1,0,0,0,0,0,0,0,0,0,0,0,0,0,0,0,1,0,1,0,0,0,0,0,0,0,0,0
202523,21040,210,40,-2,13,5,8,0,0,0,1,1,0,1,0,1,0,0,0,0,0,0,11,4,7,0,0,0,0,0,0,0,0,0
202648,21040,210,40,-2,3,1,2,0,0,0,1,0,1,0,0,0,0,0,0,0,0,0,1,0,1,0,0,0,1,1,0,0,0,0
202763,21040,210,40,-2,5,3,2,0,0,0,0,0,0,1,1,0,0,0,0,0,0,0,4,2,2,0,0,0,0,0,0,0,0,0
202806,21040,210,40,-2,5,1,4,0,0,0,0,0,0,0,0,0,0,0,0,0,0,0,5,1,4,0,0,0,0,0,0,0,0,0
202912,21040,210,40,-2,6,0,6,0,0,0,0,0,0,0,0,0,0,0,0,0,0,0,6,0,6,0,0,0,0,0,0,0,0,0
203085,21040,210,40,-2,7,4,3,0,0,0,0,0,0,1,0,1,0,0,0,0,0,0,6,4,2,0,0,0,0,0,0,0,0,0
203128,21040,210,40,-2,2,1,1,0,0,0,1,0,1,0,0,0,0,0,0,0,0,0,1,1,0,0,0,0,0,0,0,0,0,0
203155,21040,210,40,-2,11,7,4,0,0,0,0,0,0,1,0,1,0,0,0,0,0,0,10,7,3,0,0,0,0,0,0,0,0,0
203386,21040,210,40,-2,33,5,28,0,0,0,0,0,0,4,0,4,0,0,0,0,0,0,28,5,23,0,0,0,1,0,1,0,0,0
203483,21040,210,40,-2,1,1,0,0,0,0,0,0,0,0,0,0,0,0,0,0,0,0,1,1,0,0,0,0,0,0,0,0,0,0
203492,21040,210,40,-2,2,1,1,0,0,0,0,0,0,0,0,0,0,0,0,0,0,0,1,0,1,0,0,0,0,0,0,1,1,0
203517,21040,210,40,-2,16,8,8,0,0,0,0,0,0,1,0,1,0,0,0,0,0,0,11,5,6,0,0,0,1,1,0,3,2,1
203535,21040,210,40,-2,26,4,22,0,0,0,1,0,1,0,0,0,2,0,2,0,0,0,4,0,4,0,0,0,18,4,14,1,0,1
203544,21040,210,40,-2,4,2,2,0,0,0,0,0,0,1,1,0,0,0,0,0,0,0,3,1,2,0,0,0,0,0,0,0,0,0
203678,21040,210,40,-2,8,4,4,0,0,0,1,1,0,0,0,0,0,0,0,0,0,0,7,3,4,0,0,0,0,0,0,0,0,0
203720,21040,210,40,-2,5,5,0,0,0,0,0,0,0,2,2,0,0,0,0,0,0,0,3,3,0,0,0,0,0,0,0,0,0,0
203748,21040,210,40,-2,2,0,2,0,0,0,0,0,0,0,0,0,0,0,0,0,0,0,2,0,2,0,0,0,0,0,0,0,0,0
203757,21040,210,40,-2,10,1,9,0,0,0,0,0,0,0,0,0,0,0,0,0,0,0,8,0,8,0,0,0,2,1,1,0,0,0
203775,21040,210,40,-2,2,1,1,0,0,0,0,0,0,1,1,0,0,0,0,0,0,0,1,0,1,0,0,0,0,0,0,0,0,0
203845,21040,210,40,-2,12,7,5,0,0,0,0,0,0,0,0,0,1,1,0,0,0,0,11,6,5,0,0,0,0,0,0,0,0,0
203881,21040,210,40,-2,1,0,1,0,0,0,0,0,0,0,0,0,0,0,0,0,0,0,1,0,1,0,0,0,0,0,0,0,0,0
203960,21040,210,40,-2,8,0,8,0,0,0,0,0,0,1,0,1,0,0,0,0,0,0,7,0,7,0,0,0,0,0,0,0,0,0
204006,21040,210,40,-2,1,0,1,0,0,0,0,0,0,0,0,0,0,0,0,0,0,0,1,0,1,0,0,0,0,0,0,0,0,0
204024,21040,210,40,-2,26,11,15,0,0,0,1,0,1,1,0,1,0,0,0,0,0,0,24,11,13,0,0,0,0,0,0,0,0,0
204176,21040,210,40,-2,4,0,4,0,0,0,0,0,0,0,0,0,0,0,0,0,0,0,4,0,4,0,0,0,0,0,0,0,0,0
204185,21040,210,40,-2,4,2,2,0,0,0,1,1,0,0,0,0,0,0,0,0,0,0,3,1,2,0,0,0,0,0,0,0,0,0
204194,21040,210,40,-2,5,4,1,0,0,0,1,1,0,1,1,0,1,1,0,0,0,0,1,1,0,1,0,1,0,0,0,0,0,0
204200,21040,210,40,-2,4,0,4,0,0,0,0,0,0,0,0,0,0,0,0,0,0,0,4,0,4,0,0,0,0,0,0,0,0,0
204255,21040,210,40,-2,2,0,2,0,0,0,0,0,0,0,0,0,0,0,0,0,0,0,2,0,2,0,0,0,0,0,0,0,0,0
204422,21040,210,40,-2,6,3,3,0,0,0,1,1,0,2,1,1,0,0,0,2,1,1,1,0,1,0,0,0,0,0,0,0,0,0
204477,21040,210,40,-2,5,4,1,0,0,0,0,0,0,0,0,0,0,0,0,0,0,0,5,4,1,0,0,0,0,0,0,0,0,0
204501,21040,210,40,-2,35,19,16,0,0,0,0,0,0,0,0,0,1,1,0,0,0,0,23,11,12,0,0,0,1,0,1,10,7,3
204617,21040,210,40,-2,1,1,0,0,0,0,1,1,0,0,0,0,0,0,0,0,0,0,0,0,0,0,0,0,0,0,0,0,0,0
204635,21040,210,40,-2,7,5,2,0,0,0,1,0,1,0,0,0,0,0,0,0,0,0,6,5,1,0,0,0,0,0,0,0,0,0
204796,21040,210,40,-2,196,69,127,0,0,0,33,11,22,12,5,7,8,3,5,0,0,0,120,38,82,3,0,3,13,7,6,7,5,2
204820,21040,210,40,-2,1,0,1,0,0,0,0,0,0,0,0,0,0,0,0,0,0,0,1,0,1,0,0,0,0,0,0,0,0,0
204839,21040,210,40,-2,2,1,1,0,0,0,0,0,0,0,0,0,0,0,0,0,0,0,2,1,1,0,0,0,0,0,0,0,0,0
204848,21040,210,40,-2,1,1,0,0,0,0,0,0,0,0,0,0,0,0,0,0,0,0,1,1,0,0,0,0,0,0,0,0,0,0
204857,21040,210,40,-2,12,2,10,0,0,0,1,0,1,1,0,1,0,0,0,0,0,0,7,1,6,0,0,0,2,0,2,1,1,0
204866,21040,210,40,-2,1,0,1,0,0,0,0,0,0,0,0,0,0,0,0,0,0,0,1,0,1,0,0,0,0,0,0,0,0,0
204909,21040,210,40,-2,5,3,2,0,0,0,0,0,0,0,0,0,0,0,0,0,0,0,4,3,1,0,0,0,1,0,1,0,0,0
204945,21040,210,40,-2,3,0,3,0,0,0,0,0,0,0,0,0,0,0,0,0,0,0,3,0,3,0,0,0,0,0,0,0,0,0
205054,21040,210,40,-2,1,0,1,0,0,0,0,0,0,0,0,0,0,0,0,0,0,0,1,0,1,0,0,0,0,0,0,0,0,0
205179,21040,210,40,-2,3,1,2,0,0,0,0,0,0,0,0,0,0,0,0,0,0,0,3,1,2,0,0,0,0,0,0,0,0,0
205203,21040,210,40,-2,1,1,0,0,0,0,0,0,0,0,0,0,0,0,0,0,0,0,1,1,0,0,0,0,0,0,0,0,0,0
205391,21040,210,40,-2,1,1,0,0,0,0,0,0,0,0,0,0,0,0,0,0,0,0,1,1,0,0,0,0,0,0,0,0,0,0
205841,21040,210,40,-2,10,5,5,0,0,0,0,0,0,0,0,0,0,0,0,0,0,0,9,4,5,0,0,0,1,1,0,0,0,0
205887,21040,210,40,-2,6,0,6,0,0,0,0,0,0,1,0,1,0,0,0,0,0,0,5,0,5,0,0,0,0,0,0,0,0,0
205957,21040,210,40,-2,2,0,2,0,0,0,0,0,0,0,0,0,0,0,0,0,0,0,2,0,2,0,0,0,0,0,0,0,0,0
205966,21040,210,40,-2,4,3,1,0,0,0,0,0,0,0,0,0,0,0,0,0,0,0,4,3,1,0,0,0,0,0,0,0,0,0
206048,21040,210,40,-2,9,8,1,0,0,0,0,0,0,0,0,0,0,0,0,0,0,0,8,7,1,1,1,0,0,0,0,0,0,0
206084,21040,210,40,-2,9,5,4,0,0,0,3,2,1,0,0,0,0,0,0,0,0,0,5,2,3,1,1,0,0,0,0,0,0,0
206279,21040,210,40,-2,1,0,1,0,0,0,0,0,0,0,0,0,0,0,0,0,0,0,1,0,1,0,0,0,0,0,0,0,0,0
206349,21040,210,40,-2,9,0,9,0,0,0,0,0,0,0,0,0,0,0,0,0,0,0,9,0,9,0,0,0,0,0,0,0,0,0
206437,21040,210,40,-2,4,3,1,0,0,0,0,0,0,1,1,0,0,0,0,0,0,0,2,1,1,0,0,0,1,1,0,0,0,0
206446,21040,210,40,-2,11,3,8,0,0,0,0,0,0,0,0,0,1,1,0,0,0,0,10,2,8,0,0,0,0,0,0,0,0,0
206507,21040,210,40,-2,4,2,2,0,0,0,0,0,0,0,0,0,0,0,0,0,0,0,4,2,2,0,0,0,0,0,0,0,0,0
206525,21040,210,40,-2,5,0,5,0,0,0,0,0,0,0,0,0,0,0,0,0,0,0,5,0,5,0,0,0,0,0,0,0,0,0
206589,21040,210,40,-2,11,4,7,0,0,0,0,0,0,1,0,1,1,1,0,0,0,0,7,1,6,0,0,0,0,0,0,2,2,0
206604,21040,210,40,-2,18,6,12,0,0,0,3,2,1,2,0,2,0,0,0,0,0,0,12,3,9,0,0,0,0,0,0,1,1,0
206622,21040,210,40,-2,15,5,10,0,0,0,1,0,1,0,0,0,0,0,0,0,0,0,14,5,9,0,0,0,0,0,0,0,0,0
206695,21040,210,40,-2,21,11,10,0,0,0,0,0,0,0,0,0,0,0,0,0,0,0,15,8,7,1,0,1,0,0,0,5,3,2
206862,21040,210,40,-2,9,4,5,0,0,0,1,0,1,0,0,0,0,0,0,0,0,0,7,4,3,1,0,1,0,0,0,0,0,0
206914,21040,210,40,-2,1,1,0,0,0,0,0,0,0,0,0,0,0,0,0,0,0,0,0,0,0,1,1,0,0,0,0,0,0,0
206923,21040,210,40,-2,1,0,1,0,0,0,0,0,0,0,0,0,0,0,0,0,0,0,1,0,1,0,0,0,0,0,0,0,0,0
206932,21040,210,40,-2,3,1,2,0,0,0,0,0,0,0,0,0,0,0,0,0,0,0,3,1,2,0,0,0,0,0,0,0,0,0
206941,21040,210,40,-2,33,13,20,0,0,0,0,0,0,1,0,1,2,1,1,1,1,0,21,5,16,0,0,0,7,5,2,1,1,0
206996,21040,210,40,-2,7,4,3,1,1,0,1,1,0,0,0,0,1,0,1,0,0,0,4,2,2,0,0,0,0,0,0,0,0,0
207041,21040,210,40,-2,3,2,1,0,0,0,0,0,0,0,0,0,0,0,0,0,0,0,3,2,1,0,0,0,0,0,0,0,0,0
207157,21040,210,40,-2,4,4,0,1,1,0,0,0,0,0,0,0,0,0,0,0,0,0,3,3,0,0,0,0,0,0,0,0,0,0
207209,21040,210,40,-2,6,1,5,0,0,0,0,0,0,4,1,3,0,0,0,0,0,0,2,0,2,0,0,0,0,0,0,0,0,0
207263,21040,210,40,-2,5,1,4,1,0,1,0,0,0,0,0,0,0,0,0,0,0,0,4,1,3,0,0,0,0,0,0,0,0,0
207290,21040,210,40,-2,5,2,3,0,0,0,0,0,0,1,1,0,0,0,0,0,0,0,3,1,2,1,0,1,0,0,0,0,0,0
207306,21040,210,40,-2,5,2,3,0,0,0,0,0,0,0,0,0,0,0,0,0,0,0,4,2,2,0,0,0,1,0,1,0,0,0
207315,21040,210,40,-2,22,8,14,1,1,0,1,0,1,1,0,1,1,0,1,0,0,0,17,7,10,1,0,1,0,0,0,0,0,0
207342,21040,210,40,-2,25,17,8,0,0,0,1,1,0,0,0,0,0,0,0,0,0,0,14,7,7,1,1,0,0,0,0,9,8,1
207351,21040,210,40,-2,3,2,1,0,0,0,0,0,0,0,0,0,0,0,0,0,0,0,3,2,1,0,0,0,0,0,0,0,0,0
207388,21040,210,40,-2,102,48,54,1,1,0,7,3,4,4,4,0,7,3,4,0,0,0,49,15,34,5,1,4,1,0,1,28,21,7
207403,21040,210,40,-2,5,4,1,0,0,0,0,0,0,0,0,0,0,0,0,0,0,0,5,4,1,0,0,0,0,0,0,0,0,0
207449,21040,210,40,-2,14,7,7,0,0,0,3,1,2,0,0,0,0,0,0,0,0,0,9,5,4,2,1,1,0,0,0,0,0,0
207458,21040,210,40,-2,19,11,8,0,0,0,1,1,0,0,0,0,0,0,0,0,0,0,17,9,8,0,0,0,0,0,0,1,1,0
207500,21040,210,40,-2,53,27,26,1,1,0,4,2,2,6,4,2,5,2,3,0,0,0,25,12,13,0,0,0,1,0,1,11,6,5
207564,21040,210,40,-2,8,6,2,0,0,0,0,0,0,1,1,0,0,0,0,0,0,0,6,4,2,1,1,0,0,0,0,0,0,0
207582,21040,210,40,-2,5,5,0,0,0,0,0,0,0,0,0,0,0,0,0,0,0,0,3,3,0,0,0,0,0,0,0,2,2,0
207661,21040,210,40,-2,8,3,5,1,1,0,2,0,2,0,0,0,0,0,0,0,0,0,4,2,2,0,0,0,1,0,1,0,0,0
207670,21040,210,40,-2,1,0,1,0,0,0,0,0,0,1,0,1,0,0,0,0,0,0,0,0,0,0,0,0,0,0,0,0,0,0
207722,21040,210,40,-2,3,1,2,1,1,0,0,0,0,0,0,0,0,0,0,0,0,0,2,0,2,0,0,0,0,0,0,0,0,0
207740,21040,210,40,-2,1,0,1,0,0,0,0,0,0,0,0,0,0,0,0,0,0,0,1,0,1,0,0,0,0,0,0,0,0,0
207847,21040,210,40,-2,4,2,2,0,0,0,0,0,0,0,0,0,0,0,0,0,0,0,4,2,2,0,0,0,0,0,0,0,0,0
207856,21040,210,40,-2,5,2,3,0,0,0,0,0,0,0,0,0,0,0,0,0,0,0,5,2,3,0,0,0,0,0,0,0,0,0
207865,21040,210,40,-2,7,1,6,0,0,0,0,0,0,0,0,0,0,0,0,0,0,0,7,1,6,0,0,0,0,0,0,0,0,0
207935,21040,210,40,-2,15,6,9,1,1,0,0,0,0,2,1,1,4,2,2,0,0,0,6,1,5,2,1,1,0,0,0,0,0,0
207962,21040,210,40,-2,4,4,0,1,1,0,0,0,0,0,0,0,0,0,0,0,0,0,2,2,0,0,0,0,1,1,0,0,0,0
207971,21040,210,40,-2,13,7,6,0,0,0,0,0,0,2,2,0,0,0,0,0,0,0,8,2,6,0,0,0,3,3,0,0,0,0
208390,21040,210,40,-2,11,7,4,0,0,0,0,0,0,0,0,0,2,1,1,0,0,0,6,4,2,0,0,0,2,1,1,1,1,0
208406,21040,210,40,-2,3,1,2,0,0,0,0,0,0,0,0,0,0,0,0,0,0,0,3,1,2,0,0,0,0,0,0,0,0,0
208415,21040,210,40,-2,2,1,1,0,0,0,0,0,0,0,0,0,1,0,1,0,0,0,1,1,0,0,0,0,0,0,0,0,0,0
208479,21040,210,40,-2,2,1,1,0,0,0,1,1,0,0,0,0,0,0,0,0,0,0,1,0,1,0,0,0,0,0,0,0,0,0
208512,21040,210,40,-2,4,2,2,0,0,0,0,0,0,0,0,0,0,0,0,0,0,0,0,0,0,4,2,2,0,0,0,0,0,0
208646,21040,210,40,-2,7,3,4,0,0,0,0,0,0,0,0,0,0,0,0,0,0,0,5,2,3,0,0,0,2,1,1,0,0,0
208822,21040,210,40,-2,10,3,7,0,0,0,0,0,0,1,0,1,0,0,0,0,0,0,8,2,6,0,0,0,1,1,0,0,0,0
209038,21040,210,40,-2,12,3,9,0,0,0,1,1,0,0,0,0,2,2,0,0,0,0,9,0,9,0,0,0,0,0,0,0,0,0
209056,21040,210,40,-2,2,1,1,0,0,0,0,0,0,1,0,1,0,0,0,0,0,0,1,1,0,0,0,0,0,0,0,0,0,0
209065,21040,210,40,-2,2,1,1,0,0,0,0,0,0,0,0,0,0,0,0,0,0,0,2,1,1,0,0,0,0,0,0,0,0,0
209074,21040,210,40,-2,7,1,6,0,0,0,0,0,0,0,0,0,2,0,2,0,0,0,0,0,0,1,0,1,3,1,2,1,0,1
209241,21040,210,40,-2,3,3,0,0,0,0,0,0,0,0,0,0,2,2,0,0,0,0,1,1,0,0,0,0,0,0,0,0,0,0
209250,21040,210,40,-2,1,0,1,0,0,0,0,0,0,0,0,0,0,0,0,0,0,0,1,0,1,0,0,0,0,0,0,0,0,0
209287,21040,210,40,-2,1,1,0,0,0,0,1,1,0,0,0,0,0,0,0,0,0,0,0,0,0,0,0,0,0,0,0,0,0,0
209409,21040,210,40,-2,3,2,1,0,0,0,0,0,0,0,0,0,1,1,0,0,0,0,2,1,1,0,0,0,0,0,0,0,0,0
209490,21040,210,40,-2,222,96,126,0,0,0,46,21,25,8,3,5,8,5,3,1,0,1,119,47,72,4,0,4,24,14,10,12,6,6
209506,21040,210,40,-2,6,2,4,0,0,0,1,0,1,0,0,0,0,0,0,0,0,0,4,1,3,0,0,0,0,0,0,1,1,0
209542,21040,210,40,-2,35,14,21,0,0,0,2,1,1,0,0,0,4,2,2,0,0,0,11,5,6,0,0,0,16,4,12,2,2,0
209551,21040,210,40,-2,17,5,12,0,0,0,1,0,1,1,0,1,0,0,0,0,0,0,9,2,7,1,0,1,3,2,1,2,1,1
209612,21040,210,40,-2,12,4,8,0,0,0,1,1,0,1,0,1,0,0,0,0,0,0,9,2,7,1,1,0,0,0,0,0,0,0
209746,21040,210,40,-2,5,2,3,0,0,0,0,0,0,0,0,0,2,1,1,0,0,0,2,0,2,0,0,0,1,1,0,0,0,0
209807,21040,210,40,-2,8,5,3,0,0,0,0,0,0,1,0,1,2,1,1,0,0,0,3,3,0,1,0,1,0,0,0,1,1,0
209825,21040,210,40,-2,19,5,14,0,0,0,0,0,0,0,0,0,1,1,0,0,0,0,12,3,9,0,0,0,4,0,4,2,1,1
209922,21040,210,40,-2,19,7,12,0,0,0,2,1,1,0,0,0,3,1,2,0,0,0,8,1,7,2,2,0,0,0,0,4,2,2
210146,21040,210,40,-2,2,2,0,0,0,0,0,0,0,0,0,0,0,0,0,0,0,0,2,2,0,0,0,0,0,0,0,0,0,0
210155,21040,210,40,-2,1,0,1,0,0,0,0,0,0,0,0,0,0,0,0,0,0,0,1,0,1,0,0,0,0,0,0,0,0,0
210234,21040,210,40,-2,1,0,1,0,0,0,0,0,0,0,0,0,1,0,1,0,0,0,0,0,0,0,0,0,0,0,0,0,0,0
210270,21040,210,40,-2,7,2,5,0,0,0,0,0,0,0,0,0,0,0,0,0,0,0,5,2,3,1,0,1,1,0,1,0,0,0
210304,21040,210,40,-2,4,3,1,0,0,0,0,0,0,1,1,0,0,0,0,0,0,0,2,1,1,0,0,0,1,1,0,0,0,0
210331,21040,210,40,-2,4,3,1,0,0,0,0,0,0,0,0,0,0,0,0,0,0,0,4,3,1,0,0,0,0,0,0,0,0,0
210368,21040,210,40,-2,2,1,1,0,0,0,0,0,0,0,0,0,0,0,0,0,0,0,2,1,1,0,0,0,0,0,0,0,0,0
210429,21040,210,40,-2,4,3,1,0,0,0,0,0,0,0,0,0,0,0,0,0,0,0,2,1,1,1,1,0,0,0,0,1,1,0
210438,21040,210,40,-2,2,1,1,0,0,0,0,0,0,1,1,0,0,0,0,0,0,0,0,0,0,0,0,0,1,0,1,0,0,0
210492,21040,210,40,-2,1,1,0,0,0,0,0,0,0,0,0,0,0,0,0,0,0,0,1,1,0,0,0,0,0,0,0,0,0,0
210571,21040,210,40,-2,6,3,3,0,0,0,1,0,1,0,0,0,0,0,0,0,0,0,5,3,2,0,0,0,0,0,0,0,0,0
210599,21040,210,40,-2,9,5,4,0,0,0,0,0,0,3,0,3,1,0,1,0,0,0,2,2,0,1,1,0,2,2,0,0,0,0
210605,21040,210,40,-2,10,3,7,0,0,0,1,0,1,2,1,1,0,0,0,0,0,0,6,2,4,0,0,0,1,0,1,0,0,0
210669,21040,210,40,-2,7,5,2,0,0,0,1,0,1,0,0,0,2,2,0,0,0,0,3,3,0,1,0,1,0,0,0,0,0,0
210739,21040,210,40,-2,5,2,3,0,0,0,0,0,0,0,0,0,0,0,0,0,0,0,4,1,3,1,1,0,0,0,0,0,0,0
210775,21040,210,40,-2,6,0,6,0,0,0,0,0,0,1,0,1,0,0,0,0,0,0,5,0,5,0,0,0,0,0,0,0,0,0
210809,21040,210,40,-2,2,1,1,0,0,0,0,0,0,1,0,1,0,0,0,0,0,0,1,1,0,0,0,0,0,0,0,0,0,0
211079,21040,210,40,-2,4,1,3,0,0,0,1,1,0,0,0,0,0,0,0,0,0,0,3,0,3,0,0,0,0,0,0,0,0,0
211088,21040,210,40,-2,5,0,5,0,0,0,1,0,1,1,0,1,0,0,0,0,0,0,3,0,3,0,0,0,0,0,0,0,0,0
211273,21040,210,40,-2,7,2,5,0,0,0,2,0,2,0,0,0,0,0,0,0,0,0,2,1,1,1,1,0,2,0,2,0,0,0
211291,21040,210,40,-2,16,6,10,0,0,0,3,1,2,1,0,1,0,0,0,0,0,0,10,5,5,0,0,0,0,0,0,2,0,2
211352,21040,210,40,-2,1,0,1,0,0,0,0,0,0,0,0,0,0,0,0,0,0,0,1,0,1,0,0,0,0,0,0,0,0,0
211431,21040,210,40,-2,3,1,2,0,0,0,0,0,0,0,0,0,0,0,0,0,0,0,3,1,2,0,0,0,0,0,0,0,0,0
211440,21040,210,40,-2,82,61,21,0,0,0,5,4,1,6,3,3,4,4,0,0,0,0,22,15,7,1,1,0,3,2,1,41,32,9
211468,21040,210,40,-2,5,2,3,0,0,0,0,0,0,0,0,0,0,0,0,0,0,0,5,2,3,0,0,0,0,0,0,0,0,0
211477,21040,210,40,-2,7,2,5,0,0,0,0,0,0,2,0,2,1,0,1,0,0,0,4,2,2,0,0,0,0,0,0,0,0,0
211556,21040,210,40,-2,9,2,7,0,0,0,0,0,0,0,0,0,1,1,0,0,0,0,8,1,7,0,0,0,0,0,0,0,0,0
211583,21040,210,40,-2,4,2,2,0,0,0,1,0,1,1,1,0,0,0,0,0,0,0,2,1,1,0,0,0,0,0,0,0,0,0
211981,21040,210,40,-2,1,0,1,0,0,0,0,0,0,0,0,0,0,0,0,0,0,0,1,0,1,0,0,0,0,0,0,0,0,0
212009,21040,210,40,-2,10,4,6,0,0,0,0,0,0,0,0,0,2,0,2,0,0,0,3,1,2,0,0,0,0,0,0,5,3,2
212045,21040,210,40,-2,1,1,0,0,0,0,0,0,0,0,0,0,0,0,0,0,0,0,1,1,0,0,0,0,0,0,0,0,0,0
212054,21040,210,40,-2,42,19,23,0,0,0,2,0,2,5,3,2,2,1,1,0,0,0,23,10,13,3,1,2,0,0,0,7,4,3
212106,21040,210,40,-2,21,7,14,0,0,0,2,0,2,1,1,0,0,0,0,0,0,0,17,6,11,0,0,0,0,0,0,1,0,1
212115,21040,210,40,-2,2,2,0,0,0,0,0,0,0,0,0,0,0,0,0,0,0,0,2,2,0,0,0,0,0,0,0,0,0,0
212133,21040,210,40,-2,8,4,4,0,0,0,0,0,0,0,0,0,0,0,0,0,0,0,6,4,2,0,0,0,2,0,2,0,0,0
212197,21040,210,40,-2,5,3,2,0,0,0,0,0,0,0,0,0,0,0,0,0,0,0,1,0,1,0,0,0,4,3,1,0,0,0
212577,21040,210,40,-2,9,3,6,0,0,0,3,0,3,1,1,0,0,0,0,0,0,0,3,1,2,0,0,0,0,0,0,2,1,1
212601,21040,210,40,-2,11,5,6,0,0,0,1,1,0,1,0,1,0,0,0,0,0,0,8,3,5,0,0,0,1,1,0,0,0,0
212656,21040,210,40,-2,2,1,1,0,0,0,0,0,0,0,0,0,0,0,0,0,0,0,2,1,1,0,0,0,0,0,0,0,0,0
212674,21040,210,40,-2,13,4,9,0,0,0,0,0,0,0,0,0,0,0,0,0,0,0,7,1,6,0,0,0,0,0,0,6,3,3
212832,21040,210,40,-2,3,1,2,0,0,0,0,0,0,0,0,0,0,0,0,0,0,0,3,1,2,0,0,0,0,0,0,0,0,0
212869,21040,210,40,-2,4,1,3,0,0,0,0,0,0,0,0,0,0,0,0,0,0,0,4,1,3,0,0,0,0,0,0,0,0,0
212911,21040,210,40,-2,19,9,10,0,0,0,3,1,2,0,0,0,1,0,1,0,0,0,9,4,5,0,0,0,1,0,1,5,4,1
212984,21040,210,40,-2,8,5,3,0,0,0,1,1,0,1,1,0,0,0,0,0,0,0,6,3,3,0,0,0,0,0,0,0,0,0
213011,21040,210,40,-2,2,1,1,0,0,0,1,1,0,0,0,0,0,0,0,0,0,0,1,0,1,0,0,0,0,0,0,0,0,0
213233,21040,210,40,-2,4,4,0,0,0,0,0,0,0,0,0,0,0,0,0,0,0,0,4,4,0,0,0,0,0,0,0,0,0,0
213251,21040,210,40,-2,5,2,3,0,0,0,1,1,0,1,0,1,0,0,0,0,0,0,3,1,2,0,0,0,0,0,0,0,0,0
213303,21040,210,40,-2,5,2,3,0,0,0,0,0,0,0,0,0,0,0,0,0,0,0,5,2,3,0,0,0,0,0,0,0,0,0
213321,21040,210,40,-2,2,1,1,0,0,0,0,0,0,0,0,0,0,0,0,0,0,0,2,1,1,0,0,0,0,0,0,0,0,0
213358,21040,210,40,-2,1,0,1,0,0,0,0,0,0,0,0,0,0,0,0,0,0,0,1,0,1,0,0,0,0,0,0,0,0,0
213367,21040,210,40,-2,9,4,5,0,0,0,0,0,0,2,1,1,0,0,0,0,0,0,7,3,4,0,0,0,0,0,0,0,0,0
213385,21040,210,40,-2,11,7,4,0,0,0,0,0,0,0,0,0,0,0,0,0,0,0,9,5,4,0,0,0,0,0,0,2,2,0
213400,21040,210,40,-2,9,5,4,0,0,0,0,0,0,0,0,0,1,1,0,0,0,0,8,4,4,0,0,0,0,0,0,0,0,0
213507,21040,210,40,-2,2,1,1,0,0,0,0,0,0,0,0,0,0,0,0,0,0,0,1,0,1,0,0,0,0,0,0,1,1,0
213525,21040,210,40,-2,3,1,2,0,0,0,1,1,0,0,0,0,0,0,0,0,0,0,2,0,2,0,0,0,0,0,0,0,0,0
213534,21040,210,40,-2,1,0,1,0,0,0,0,0,0,0,0,0,0,0,0,0,0,0,1,0,1,0,0,0,0,0,0,0,0,0
213543,21040,210,40,-2,22,13,9,0,0,0,2,0,2,2,1,1,0,0,0,0,0,0,8,5,3,0,0,0,10,7,3,0,0,0
213570,21040,210,40,-2,2,0,2,0,0,0,0,0,0,1,0,1,0,0,0,0,0,0,1,0,1,0,0,0,0,0,0,0,0,0
213589,21040,210,40,-2,2,2,0,0,0,0,0,0,0,0,0,0,0,0,0,0,0,0,2,2,0,0,0,0,0,0,0,0,0,0
213598,21040,210,40,-2,2,0,2,0,0,0,0,0,0,1,0,1,0,0,0,0,0,0,1,0,1,0,0,0,0,0,0,0,0,0
213631,21040,210,40,-2,1,0,1,0,0,0,1,0,1,0,0,0,0,0,0,0,0,0,0,0,0,0,0,0,0,0,0,0,0,0
213659,21040,210,40,-2,3,1,2,0,0,0,0,0,0,0,0,0,0,0,0,0,0,0,3,1,2,0,0,0,0,0,0,0,0,0
213668,21040,210,40,-2,2,0,2,0,0,0,0,0,0,0,0,0,0,0,0,0,0,0,2,0,2,0,0,0,0,0,0,0,0,0
213826,21040,210,40,-2,14,5,9,0,0,0,1,0,1,0,0,0,2,2,0,0,0,0,11,3,8,0,0,0,0,0,0,0,0,0
213987,21040,210,40,-2,6,2,4,0,0,0,1,0,1,0,0,0,0,0,0,0,0,0,5,2,3,0,0,0,0,0,0,0,0,0
213996,21040,210,40,-2,4,1,3,0,0,0,0,0,0,0,0,0,0,0,0,0,0,0,4,1,3,0,0,0,0,0,0,0,0,0
214069,21040,210,40,-2,7,2,5,0,0,0,2,1,1,0,0,0,0,0,0,0,0,0,5,1,4,0,0,0,0,0,0,0,0,0
214148,21040,210,40,-2,1,1,0,0,0,0,0,0,0,0,0,0,1,1,0,0,0,0,0,0,0,0,0,0,0,0,0,0,0,0
214157,21040,210,40,-2,2,1,1,0,0,0,1,0,1,0,0,0,0,0,0,0,0,0,1,1,0,0,0,0,0,0,0,0,0,0
214166,21040,210,40,-2,8,2,6,0,0,0,0,0,0,0,0,0,0,0,0,0,0,0,8,2,6,0,0,0,0,0,0,0,0,0
214175,21040,210,40,-2,20,8,12,0,0,0,2,0,2,5,3,2,4,1,3,0,0,0,7,2,5,0,0,0,0,0,0,2,2,0
214272,21040,210,40,-2,6,0,6,0,0,0,0,0,0,2,0,2,0,0,0,0,0,0,4,0,4,0,0,0,0,0,0,0,0,0
214290,21040,210,40,-2,10,9,1,0,0,0,0,0,0,0,0,0,0,0,0,0,0,0,10,9,1,0,0,0,0,0,0,0,0,0
214564,21040,210,40,-2,2,1,1,0,0,0,0,0,0,0,0,0,0,0,0,0,0,0,1,1,0,1,0,1,0,0,0,0,0,0
214582,21040,210,40,-2,2,0,2,0,0,0,0,0,0,0,0,0,0,0,0,0,0,0,2,0,2,0,0,0,0,0,0,0,0,0
214892,21040,210,40,-2,11,4,7,0,0,0,0,0,0,0,0,0,0,0,0,0,0,0,11,4,7,0,0,0,0,0,0,0,0,0
214944,21040,210,40,-2,9,8,1,0,0,0,0,0,0,0,0,0,1,1,0,0,0,0,8,7,1,0,0,0,0,0,0,0,0,0
214971,21040,210,40,-2,3,2,1,0,0,0,0,0,0,2,2,0,0,0,0,0,0,0,0,0,0,1,0,1,0,0,0,0,0,0
215053,21040,210,40,-2,2,1,1,0,0,0,0,0,0,0,0,0,0,0,0,0,0,0,2,1,1,0,0,0,0,0,0,0,0,0
215062,21040,210,40,-2,110,43,67,0,0,0,24,14,10,7,1,6,5,1,4,0,0,0,52,16,36,4,1,3,14,8,6,4,2,2
215105,21040,210,40,-2,1,0,1,0,0,0,0,0,0,0,0,0,0,0,0,0,0,0,1,0,1,0,0,0,0,0,0,0,0,0
215114,21040,210,40,-2,3,2,1,0,0,0,0,0,0,0,0,0,0,0,0,0,0,0,3,2,1,0,0,0,0,0,0,0,0,0
215123,21040,210,40,-2,10,5,5,1,1,0,3,0,3,0,0,0,0,0,0,0,0,0,5,4,1,1,0,1,0,0,0,0,0,0
215132,21040,210,40,-2,5,3,2,0,0,0,0,0,0,0,0,0,0,0,0,0,0,0,5,3,2,0,0,0,0,0,0,0,0,0
215239,21040,210,40,-2,1,0,1,0,0,0,0,0,0,1,0,1,0,0,0,0,0,0,0,0,0,0,0,0,0,0,0,0,0,0
215266,21040,210,40,-2,3,3,0,0,0,0,0,0,0,1,1,0,0,0,0,0,0,0,1,1,0,0,0,0,0,0,0,1,1,0
215275,21040,210,40,-2,5,1,4,0,0,0,0,0,0,0,0,0,0,0,0,0,0,0,3,0,3,0,0,0,2,1,1,0,0,0
215284,21040,210,40,-2,4,1,3,0,0,0,0,0,0,0,0,0,0,0,0,0,0,0,3,1,2,0,0,0,0,0,0,1,0,1
215293,21040,210,40,-2,185,80,105,0,0,0,24,10,14,9,1,8,9,5,4,0,0,0,96,44,52,1,0,1,28,9,19,18,11,7
215415,21040,210,40,-2,5,3,2,0,0,0,0,0,0,0,0,0,0,0,0,0,0,0,5,3,2,0,0,0,0,0,0,0,0,0
215442,21040,210,40,-2,5,3,2,0,0,0,1,0,1,1,1,0,0,0,0,0,0,0,3,2,1,0,0,0,0,0,0,0,0,0
215585,21040,210,40,-2,4,0,4,0,0,0,0,0,0,0,0,0,0,0,0,0,0,0,4,0,4,0,0,0,0,0,0,0,0,0
215682,21040,210,40,-2,6,6,0,0,0,0,0,0,0,0,0,0,0,0,0,0,0,0,6,6,0,0,0,0,0,0,0,0,0,0
215691,21040,210,40,-2,1,1,0,0,0,0,1,1,0,0,0,0,0,0,0,0,0,0,0,0,0,0,0,0,0,0,0,0,0,0
215743,21040,210,40,-2,13,1,12,0,0,0,0,0,0,0,0,0,0,0,0,0,0,0,13,1,12,0,0,0,0,0,0,0,0,0
215770,21040,210,40,-2,5,2,3,0,0,0,0,0,0,2,0,2,1,0,1,0,0,0,2,2,0,0,0,0,0,0,0,0,0,0
215798,21040,210,40,-2,2,0,2,0,0,0,0,0,0,0,0,0,0,0,0,0,0,0,0,0,0,0,0,0,2,0,2,0,0,0
215929,21040,210,40,-2,8,5,3,0,0,0,0,0,0,0,0,0,0,0,0,0,0,0,4,3,1,0,0,0,2,1,1,2,1,1
215947,21040,210,40,-2,6,3,3,0,0,0,0,0,0,1,0,1,0,0,0,0,0,0,5,3,2,0,0,0,0,0,0,0,0,0
215992,21040,210,40,-2,2,0,2,0,0,0,0,0,0,0,0,0,0,0,0,0,0,0,2,0,2,0,0,0,0,0,0,0,0,0
216278,21040,210,40,-2,5,5,0,0,0,0,0,0,0,0,0,0,0,0,0,0,0,0,5,5,0,0,0,0,0,0,0,0,0,0
216287,21040,210,40,-2,26,13,13,2,1,1,2,1,1,1,0,1,2,1,1,0,0,0,13,8,5,0,0,0,2,1,1,4,1,3
216339,21040,210,40,-2,148,60,88,0,0,0,21,9,12,21,7,14,2,1,1,0,0,0,71,30,41,0,0,0,18,8,10,15,5,10
216357,21040,210,40,-2,1,1,0,0,0,0,0,0,0,0,0,0,0,0,0,0,0,0,1,1,0,0,0,0,0,0,0,0,0,0
216366,21040,210,40,-2,20,5,15,0,0,0,1,0,1,1,0,1,0,0,0,0,0,0,18,5,13,0,0,0,0,0,0,0,0,0
216436,21040,210,40,-2,7,7,0,0,0,0,0,0,0,1,1,0,0,0,0,0,0,0,6,6,0,0,0,0,0,0,0,0,0,0
216445,21040,210,40,-2,3,2,1,0,0,0,0,0,0,0,0,0,0,0,0,0,0,0,3,2,1,0,0,0,0,0,0,0,0,0
216454,21040,210,40,-2,2,2,0,0,0,0,0,0,0,0,0,0,0,0,0,0,0,0,2,2,0,0,0,0,0,0,0,0,0,0
216463,21040,210,40,-2,2,2,0,0,0,0,0,0,0,0,0,0,0,0,0,0,0,0,2,2,0,0,0,0,0,0,0,0,0,0
216524,21040,210,40,-2,4,2,2,0,0,0,0,0,0,0,0,0,0,0,0,0,0,0,4,2,2,0,0,0,0,0,0,0,0,0
216542,21040,210,40,-2,2,0,2,0,0,0,0,0,0,0,0,0,0,0,0,0,0,0,2,0,2,0,0,0,0,0,0,0,0,0
216597,21040,210,40,-2,40,19,21,1,0,1,2,2,0,1,0,1,2,2,0,0,0,0,28,10,18,0,0,0,0,0,0,6,5,1
216667,21040,210,40,-2,4,1,3,0,0,0,1,0,1,0,0,0,0,0,0,0,0,0,3,1,2,0,0,0,0,0,0,0,0,0
216694,21040,210,40,-2,4,0,4,0,0,0,0,0,0,0,0,0,0,0,0,0,0,0,4,0,4,0,0,0,0,0,0,0,0,0
216764,21040,210,40,-2,2,1,1,0,0,0,0,0,0,0,0,0,0,0,0,0,0,0,1,0,1,0,0,0,0,0,0,1,1,0
216807,21040,210,40,-2,1,1,0,0,0,0,0,0,0,0,0,0,0,0,0,0,0,0,1,1,0,0,0,0,0,0,0,0,0,0
216816,21040,210,40,-2,1,1,0,0,0,0,0,0,0,0,0,0,1,1,0,0,0,0,0,0,0,0,0,0,0,0,0,0,0,0
216825,21040,210,40,-2,3,2,1,0,0,0,0,0,0,0,0,0,0,0,0,0,0,0,3,2,1,0,0,0,0,0,0,0,0,0
216852,21040,210,40,-2,9,4,5,0,0,0,2,1,1,0,0,0,1,0,1,0,0,0,4,1,3,0,0,0,0,0,0,2,2,0
216931,21040,210,40,-2,4,1,3,0,0,0,1,0,1,0,0,0,0,0,0,0,0,0,2,1,1,1,0,1,0,0,0,0,0,0
216940,21040,210,40,-2,1,1,0,0,0,0,0,0,0,0,0,0,0,0,0,0,0,0,1,1,0,0,0,0,0,0,0,0,0,0
217013,21040,210,40,-2,4,2,2,0,0,0,0,0,0,0,0,0,0,0,0,0,0,0,3,1,2,0,0,0,1,1,0,0,0,0
217059,21040,210,40,-2,2,1,1,0,0,0,0,0,0,1,0,1,0,0,0,0,0,0,1,1,0,0,0,0,0,0,0,0,0,0
217156,21040,210,40,-2,53,19,34,0,0,0,4,1,3,4,1,3,2,2,0,0,0,0,25,8,17,1,1,0,3,1,2,14,5,9
217235,21040,210,40,-2,9,2,7,0,0,0,0,0,0,2,1,1,0,0,0,0,0,0,4,1,3,0,0,0,2,0,2,1,0,1
217402,21040,210,40,-2,27,16,11,0,0,0,1,1,0,0,0,0,0,0,0,0,0,0,23,13,10,1,0,1,0,0,0,2,2,0
217420,21040,210,40,-2,2,0,2,0,0,0,0,0,0,1,0,1,0,0,0,0,0,0,1,0,1,0,0,0,0,0,0,0,0,0
217484,21040,210,40,-2,45,16,29,0,0,0,3,1,2,3,0,3,0,0,0,0,0,0,37,15,22,0,0,0,0,0,0,2,0,2
217493,21040,210,40,-2,19,5,14,0,0,0,1,0,1,5,1,4,0,0,0,0,0,0,3,2,1,0,0,0,3,0,3,7,2,5
217518,21040,210,40,-2,3,1,2,0,0,0,0,0,0,0,0,0,0,0,0,0,0,0,0,0,0,0,0,0,0,0,0,3,1,2
217536,21040,210,40,-2,2,1,1,0,0,0,0,0,0,0,0,0,0,0,0,0,0,0,2,1,1,0,0,0,0,0,0,0,0,0
217615,21040,210,40,-2,4,2,2,0,0,0,0,0,0,0,0,0,0,0,0,0,0,0,4,2,2,0,0,0,0,0,0,0,0,0
217624,21040,210,40,-2,16,9,7,0,0,0,0,0,0,12,6,6,0,0,0,0,0,0,4,3,1,0,0,0,0,0,0,0,0,0
217633,21040,210,40,-2,10,4,6,0,0,0,1,0,1,0,0,0,0,0,0,0,0,0,9,4,5,0,0,0,0,0,0,0,0,0
217688,21040,210,40,-2,17,4,13,0,0,0,0,0,0,0,0,0,0,0,0,0,0,0,16,4,12,1,0,1,0,0,0,0,0,0
217712,21040,210,40,-2,2,2,0,0,0,0,0,0,0,0,0,0,0,0,0,0,0,0,2,2,0,0,0,0,0,0,0,0,0,0
217721,21040,210,40,-2,3,2,1,0,0,0,0,0,0,3,2,1,0,0,0,0,0,0,0,0,0,0,0,0,0,0,0,0,0,0
217749,21040,210,40,-2,10,6,4,0,0,0,0,0,0,0,0,0,0,0,0,0,0,0,10,6,4,0,0,0,0,0,0,0,0,0
217776,21040,210,40,-2,1,0,1,0,0,0,0,0,0,0,0,0,0,0,0,0,0,0,0,0,0,1,0,1,0,0,0,0,0,0
217819,21040,210,40,-2,15,11,4,0,0,0,0,0,0,2,1,1,2,2,0,0,0,0,9,6,3,0,0,0,0,0,0,2,2,0
217837,21040,210,40,-2,7,0,7,0,0,0,0,0,0,4,0,4,0,0,0,0,0,0,3,0,3,0,0,0,0,0,0,0,0,0
217864,21040,210,40,-2,4,2,2,0,0,0,0,0,0,0,0,0,1,0,1,0,0,0,0,0,0,0,0,0,3,2,1,0,0,0
217873,21040,210,40,-2,2,0,2,0,0,0,0,0,0,2,0,2,0,0,0,0,0,0,0,0,0,0,0,0,0,0,0,0,0,0
217882,21040,210,40,-2,35,18,17,0,0,0,0,0,0,0,0,0,0,0,0,0,0,0,34,18,16,0,0,0,0,0,0,1,0,1
217907,21040,210,40,-2,5,2,3,0,0,0,0,0,0,0,0,0,0,0,0,0,0,0,5,2,3,0,0,0,0,0,0,0,0,0
217925,21040,210,40,-2,5,3,2,0,0,0,0,0,0,0,0,0,0,0,0,0,0,0,5,3,2,0,0,0,0,0,0,0,0,0
217934,21040,210,40,-2,6,1,5,0,0,0,0,0,0,1,0,1,0,0,0,0,0,0,5,1,4,0,0,0,0,0,0,0,0,0
218025,21040,210,40,-2,6,2,4,0,0,0,0,0,0,2,1,1,0,0,0,0,0,0,4,1,3,0,0,0,0,0,0,0,0,0
218061,21040,210,40,-2,1,0,1,0,0,0,0,0,0,0,0,0,0,0,0,0,0,0,1,0,1,0,0,0,0,0,0,0,0,0
218070,21040,210,40,-2,5,1,4,0,0,0,0,0,0,1,0,1,0,0,0,0,0,0,3,1,2,1,0,1,0,0,0,0,0,0
218113,21040,210,40,-2,29,7,22,0,0,0,1,0,1,5,1,4,0,0,0,0,0,0,23,6,17,0,0,0,0,0,0,0,0,0
218140,21040,210,40,-2,15,4,11,0,0,0,0,0,0,1,0,1,0,0,0,0,0,0,14,4,10,0,0,0,0,0,0,0,0,0
218229,21040,210,40,-2,26,6,20,0,0,0,0,0,0,2,0,2,1,1,0,0,0,0,23,5,18,0,0,0,0,0,0,0,0,0
218238,21040,210,40,-2,1,1,0,0,0,0,0,0,0,0,0,0,0,0,0,0,0,0,1,1,0,0,0,0,0,0,0,0,0,0
218335,21040,210,40,-2,1,1,0,0,0,0,0,0,0,0,0,0,0,0,0,0,0,0,1,1,0,0,0,0,0,0,0,0,0,0
218353,21040,210,40,-2,12,3,9,0,0,0,1,0,1,2,1,1,2,1,1,0,0,0,7,1,6,0,0,0,0,0,0,0,0,0
218399,21040,210,40,-2,2,1,1,0,0,0,0,0,0,2,1,1,0,0,0,0,0,0,0,0,0,0,0,0,0,0,0,0,0,0
218441,21040,210,40,-2,14,9,5,0,0,0,0,0,0,1,1,0,0,0,0,0,0,0,13,8,5,0,0,0,0,0,0,0,0,0
218487,21040,210,40,-2,8,3,5,0,0,0,0,0,0,2,0,2,0,0,0,0,0,0,6,3,3,0,0,0,0,0,0,0,0,0
218520,21040,210,40,-2,15,6,9,0,0,0,0,0,0,5,2,3,1,0,1,0,0,0,9,4,5,0,0,0,0,0,0,0,0,0
218539,21040,210,40,-2,2,0,2,0,0,0,0,0,0,0,0,0,0,0,0,0,0,0,2,0,2,0,0,0,0,0,0,0,0,0
218645,21040,210,40,-2,2,0,2,0,0,0,0,0,0,0,0,0,0,0,0,0,0,0,2,0,2,0,0,0,0,0,0,0,0,0
218663,21040,210,40,-2,37,11,26,0,0,0,0,0,0,5,2,3,0,0,0,0,0,0,28,7,21,4,2,2,0,0,0,0,0,0
218681,21040,210,40,-2,1,0,1,0,0,0,0,0,0,0,0,0,0,0,0,0,0,0,1,0,1,0,0,0,0,0,0,0,0,0
218690,21040,210,40,-2,5,2,3,0,0,0,1,0,1,0,0,0,0,0,0,0,0,0,4,2,2,0,0,0,0,0,0,0,0,0
218706,21040,210,40,-2,1,0,1,0,0,0,0,0,0,0,0,0,0,0,0,0,0,0,1,0,1,0,0,0,0,0,0,0,0,0
218724,21040,210,40,-2,5,3,2,0,0,0,0,0,0,1,1,0,0,0,0,0,0,0,4,2,2,0,0,0,0,0,0,0,0,0
218742,21040,210,40,-2,13,2,11,0,0,0,0,0,0,2,0,2,0,0,0,0,0,0,10,2,8,1,0,1,0,0,0,0,0,0
218751,21040,210,40,-2,4,2,2,0,0,0,0,0,0,0,0,0,0,0,0,0,0,0,3,1,2,1,1,0,0,0,0,0,0,0
218821,21040,210,40,-2,4,1,3,0,0,0,0,0,0,1,1,0,0,0,0,0,0,0,3,0,3,0,0,0,0,0,0,0,0,0
218830,21040,210,40,-2,16,4,12,0,0,0,1,1,0,1,0,1,1,0,1,0,0,0,13,3,10,0,0,0,0,0,0,0,0,0
218858,21040,210,40,-2,7,3,4,0,0,0,0,0,0,2,1,1,0,0,0,0,0,0,5,2,3,0,0,0,0,0,0,0,0,0
218885,21040,210,40,-2,11,5,6,0,0,0,0,0,0,3,1,2,1,0,1,0,0,0,7,4,3,0,0,0,0,0,0,0,0,0
218894,21040,210,40,-2,16,6,10,0,0,0,1,0,1,2,1,1,0,0,0,0,0,0,13,5,8,0,0,0,0,0,0,0,0,0
218955,21040,210,40,-2,6,3,3,0,0,0,0,0,0,2,1,1,0,0,0,0,0,0,4,2,2,0,0,0,0,0,0,0,0,0
218964,21040,210,40,-2,2,1,1,0,0,0,0,0,0,0,0,0,0,0,0,0,0,0,2,1,1,0,0,0,0,0,0,0,0,0
218973,21040,210,40,-2,6,4,2,0,0,0,2,1,1,0,0,0,0,0,0,0,0,0,3,3,0,0,0,0,1,0,1,0,0,0
218991,21040,210,40,-2,18,9,9,0,0,0,0,0,0,3,1,2,0,0,0,0,0,0,15,8,7,0,0,0,0,0,0,0,0,0
219000,21040,210,40,-2,4,2,2,0,0,0,1,1,0,0,0,0,1,1,0,0,0,0,2,0,2,0,0,0,0,0,0,0,0,0
219082,21040,210,40,-2,4,3,1,0,0,0,0,0,0,0,0,0,0,0,0,0,0,0,3,3,0,0,0,0,0,0,0,1,0,1
219091,21040,210,40,-2,5,2,3,0,0,0,0,0,0,0,0,0,0,0,0,0,0,0,5,2,3,0,0,0,0,0,0,0,0,0
219143,21040,210,40,-2,15,10,5,0,0,0,0,0,0,0,0,0,0,0,0,0,0,0,15,10,5,0,0,0,0,0,0,0,0,0
219189,21040,210,40,-2,7,3,4,0,0,0,0,0,0,0,0,0,0,0,0,0,0,0,7,3,4,0,0,0,0,0,0,0,0,0
219198,21040,210,40,-2,2,0,2,0,0,0,0,0,0,0,0,0,0,0,0,0,0,0,2,0,2,0,0,0,0,0,0,0,0,0
219259,21040,210,40,-2,1,0,1,0,0,0,0,0,0,0,0,0,0,0,0,0,0,0,1,0,1,0,0,0,0,0,0,0,0,0
219277,21040,210,40,-2,7,3,4,3,2,1,0,0,0,0,0,0,0,0,0,0,0,0,4,1,3,0,0,0,0,0,0,0,0,0
219295,21040,210,40,-2,4,0,4,0,0,0,0,0,0,0,0,0,0,0,0,0,0,0,4,0,4,0,0,0,0,0,0,0,0,0
219347,21040,210,40,-2,4,3,1,0,0,0,0,0,0,0,0,0,0,0,0,0,0,0,4,3,1,0,0,0,0,0,0,0,0,0
219356,21040,210,40,-2,14,8,6,0,0,0,1,1,0,0,0,0,0,0,0,0,0,0,11,5,6,0,0,0,0,0,0,2,2,0
219374,21040,210,40,-2,3,2,1,2,2,0,0,0,0,0,0,0,0,0,0,0,0,0,1,0,1,0,0,0,0,0,0,0,0,0
219383,21040,210,40,-2,1,1,0,0,0,0,0,0,0,0,0,0,0,0,0,0,0,0,1,1,0,0,0,0,0,0,0,0,0,0
219408,21040,210,40,-2,1,1,0,0,0,0,0,0,0,0,0,0,0,0,0,0,0,0,1,1,0,0,0,0,0,0,0,0,0,0
219426,21040,210,40,-2,15,4,11,0,0,0,0,0,0,0,0,0,0,0,0,0,0,0,15,4,11,0,0,0,0,0,0,0,0,0
219471,21040,210,40,-2,19,8,11,0,0,0,0,0,0,1,0,1,1,1,0,0,0,0,17,7,10,0,0,0,0,0,0,0,0,0
219480,21040,210,40,-2,12,7,5,0,0,0,0,0,0,0,0,0,0,0,0,0,0,0,9,5,4,2,2,0,1,0,1,0,0,0
219505,21040,210,40,-2,1,0,1,0,0,0,0,0,0,1,0,1,0,0,0,0,0,0,0,0,0,0,0,0,0,0,0,0,0,0
219602,21040,210,40,-2,9,3,6,0,0,0,0,0,0,1,0,1,0,0,0,0,0,0,6,2,4,1,0,1,1,1,0,0,0,0
219639,21040,210,40,-2,7,2,5,0,0,0,0,0,0,3,0,3,0,0,0,0,0,0,4,2,2,0,0,0,0,0,0,0,0,0
219709,21040,210,40,-2,25,8,17,0,0,0,0,0,0,7,2,5,0,0,0,0,0,0,16,6,10,0,0,0,2,0,2,0,0,0
219718,21040,210,40,-2,4,1,3,0,0,0,0,0,0,0,0,0,0,0,0,0,0,0,4,1,3,0,0,0,0,0,0,0,0,0
219790,21040,210,40,-2,6,4,2,0,0,0,0,0,0,0,0,0,0,0,0,0,0,0,6,4,2,0,0,0,0,0,0,0,0,0
219824,21040,210,40,-2,24,9,15,0,0,0,0,0,0,1,0,1,1,1,0,0,0,0,20,7,13,2,1,1,0,0,0,0,0,0
219833,21040,210,40,-2,8,2,6,0,0,0,0,0,0,0,0,0,0,0,0,0,0,0,8,2,6,0,0,0,0,0,0,0,0,0
219879,21040,210,40,-2,2,1,1,0,0,0,0,0,0,0,0,0,0,0,0,0,0,0,2,1,1,0,0,0,0,0,0,0,0,0
219888,21040,210,40,-2,17,5,12,1,0,1,3,1,2,0,0,0,0,0,0,0,0,0,12,4,8,0,0,0,1,0,1,0,0,0
219903,21040,210,40,-2,14,1,13,0,0,0,0,0,0,8,0,8,0,0,0,0,0,0,5,0,5,0,0,0,1,1,0,0,0,0
219949,21040,210,40,-2,10,5,5,0,0,0,0,0,0,1,0,1,0,0,0,0,0,0,9,5,4,0,0,0,0,0,0,0,0,0
219976,21040,210,40,-2,2,1,1,0,0,0,0,0,0,0,0,0,0,0,0,0,0,0,1,0,1,0,0,0,1,1,0,0,0,0
220057,21040,210,40,-2,2,1,1,0,0,0,0,0,0,0,0,0,0,0,0,0,0,0,2,1,1,0,0,0,0,0,0,0,0,0
220075,21040,210,40,-2,69,27,42,0,0,0,4,2,2,1,0,1,1,0,1,0,0,0,55,20,35,2,0,2,2,1,1,4,4,0
220118,21040,210,40,-2,6,0,6,0,0,0,0,0,0,1,0,1,0,0,0,0,0,0,5,0,5,0,0,0,0,0,0,0,0,0
220181,21040,210,40,-2,3,2,1,0,0,0,0,0,0,2,2,0,0,0,0,0,0,0,1,0,1,0,0,0,0,0,0,0,0,0
220206,21040,210,40,-2,1,1,0,0,0,0,0,0,0,0,0,0,0,0,0,0,0,0,1,1,0,0,0,0,0,0,0,0,0,0
220215,21040,210,40,-2,6,4,2,0,0,0,0,0,0,0,0,0,0,0,0,0,0,0,6,4,2,0,0,0,0,0,0,0,0,0
220473,21040,210,40,-2,2,2,0,0,0,0,0,0,0,0,0,0,0,0,0,0,0,0,2,2,0,0,0,0,0,0,0,0,0,0
220516,21040,210,40,-2,6,0,6,0,0,0,0,0,0,0,0,0,0,0,0,0,0,0,6,0,6,0,0,0,0,0,0,0,0,0
220552,21040,210,40,-2,56,15,41,1,1,0,4,0,4,7,1,6,2,1,1,0,0,0,40,11,29,2,1,1,0,0,0,0,0,0
220598,21040,210,40,-2,15,8,7,0,0,0,1,1,0,7,3,4,3,1,2,0,0,0,4,3,1,0,0,0,0,0,0,0,0,0
220604,21040,210,40,-2,2,2,0,0,0,0,0,0,0,2,2,0,0,0,0,0,0,0,0,0,0,0,0,0,0,0,0,0,0,0
220613,21040,210,40,-2,2,1,1,0,0,0,0,0,0,0,0,0,0,0,0,0,0,0,2,1,1,0,0,0,0,0,0,0,0,0
220631,21040,210,40,-2,75,28,47,0,0,0,1,1,0,2,2,0,2,1,1,0,0,0,63,22,41,0,0,0,7,2,5,0,0,0
220710,21040,210,40,-2,3,1,2,0,0,0,0,0,0,0,0,0,0,0,0,0,0,0,3,1,2,0,0,0,0,0,0,0,0,0
220792,21040,210,40,-2,10,6,4,0,0,0,2,1,1,8,5,3,0,0,0,0,0,0,0,0,0,0,0,0,0,0,0,0,0,0
220862,21040,210,40,-2,52,26,26,0,0,0,5,2,3,13,6,7,2,2,0,0,0,0,31,15,16,0,0,0,1,1,0,0,0,0
220978,21040,210,40,-2,58,27,31,0,0,0,1,0,1,6,2,4,2,1,1,0,0,0,47,23,24,0,0,0,0,0,0,2,1,1
220996,21040,210,40,-2,2,1,1,0,0,0,0,0,0,0,0,0,0,0,0,0,0,0,2,1,1,0,0,0,0,0,0,0,0,0
221148,21040,210,40,-2,22,22,0,0,0,0,0,0,0,0,0,0,0,0,0,0,0,0,22,22,0,0,0,0,0,0,0,0,0,0
221184,21040,210,40,-2,11,4,7,0,0,0,0,0,0,1,0,1,0,0,0,0,0,0,8,4,4,0,0,0,0,0,0,2,0,2
221351,21040,210,40,-2,16,10,6,0,0,0,1,1,0,1,1,0,2,1,1,0,0,0,4,2,2,0,0,0,6,3,3,2,2,0
221397,21040,210,40,-2,4,1,3,0,0,0,0,0,0,0,0,0,0,0,0,0,0,0,4,1,3,0,0,0,0,0,0,0,0,0
221485,21040,210,40,-2,7,4,3,0,0,0,0,0,0,2,1,1,0,0,0,0,0,0,5,3,2,0,0,0,0,0,0,0,0,0
221519,21040,210,40,-2,12,8,4,0,0,0,1,1,0,0,0,0,0,0,0,0,0,0,8,5,3,0,0,0,1,1,0,2,1,1
221643,21040,210,40,-2,3,3,0,0,0,0,0,0,0,0,0,0,1,1,0,0,0,0,2,2,0,0,0,0,0,0,0,0,0,0
221661,21040,210,40,-2,8,3,5,0,0,0,3,2,1,2,0,2,0,0,0,0,0,0,3,1,2,0,0,0,0,0,0,0,0,0
221670,21040,210,40,-2,4,2,2,0,0,0,1,0,1,0,0,0,0,0,0,0,0,0,3,2,1,0,0,0,0,0,0,0,0,0
221740,21040,210,40,-2,19,12,7,0,0,0,1,0,1,2,0,2,0,0,0,0,0,0,12,8,4,0,0,0,0,0,0,4,4,0
221759,21040,210,40,-2,56,21,35,0,0,0,3,2,1,4,1,3,2,0,2,0,0,0,42,16,26,1,0,1,0,0,0,4,2,2
221768,21040,210,40,-2,11,4,7,0,0,0,0,0,0,2,0,2,0,0,0,0,0,0,9,4,5,0,0,0,0,0,0,0,0,0
221838,21040,210,40,-2,3,2,1,0,0,0,0,0,0,1,1,0,0,0,0,0,0,0,2,1,1,0,0,0,0,0,0,0,0,0
221847,21040,210,40,-2,20,12,8,0,0,0,1,1,0,0,0,0,0,0,0,0,0,0,12,6,6,1,1,0,3,2,1,3,2,1
221908,21040,210,40,-2,4,1,3,0,0,0,0,0,0,0,0,0,0,0,0,0,0,0,4,1,3,0,0,0,0,0,0,0,0,0
221953,21040,210,40,-2,8,3,5,0,0,0,1,1,0,0,0,0,0,0,0,0,0,0,7,2,5,0,0,0,0,0,0,0,0,0
221999,21040,210,40,-2,44,17,27,0,0,0,0,0,0,1,0,1,1,0,1,0,0,0,12,3,9,0,0,0,24,10,14,6,4,2
222053,21040,210,40,-2,6,3,3,0,0,0,0,0,0,0,0,0,0,0,0,0,0,0,6,3,3,0,0,0,0,0,0,0,0,0
222105,21040,210,40,-2,7,7,0,0,0,0,0,0,0,3,3,0,0,0,0,0,0,0,4,4,0,0,0,0,0,0,0,0,0,0
222178,21040,210,40,-2,5,2,3,0,0,0,0,0,0,2,0,2,0,0,0,0,0,0,2,1,1,0,0,0,1,1,0,0,0,0
222576,21040,210,40,-2,1,0,1,0,0,0,0,0,0,1,0,1,0,0,0,0,0,0,0,0,0,0,0,0,0,0,0,0,0,0
222628,21040,210,40,-2,1,0,1,0,0,0,0,0,0,0,0,0,0,0,0,0,0,0,1,0,1,0,0,0,0,0,0,0,0,0
222822,21040,210,40,-2,8,4,4,0,0,0,1,0,1,0,0,0,0,0,0,0,0,0,7,4,3,0,0,0,0,0,0,0,0,0
222831,21040,210,40,-2,8,4,4,0,0,0,0,0,0,1,0,1,0,0,0,0,0,0,6,3,3,0,0,0,1,1,0,0,0,0
222877,21040,210,40,-2,1,1,0,0,0,0,0,0,0,0,0,0,0,0,0,0,0,0,1,1,0,0,0,0,0,0,0,0,0,0
222983,21040,210,40,-2,3,1,2,0,0,0,0,0,0,0,0,0,1,1,0,0,0,0,1,0,1,0,0,0,0,0,0,1,0,1
222992,21040,210,40,-2,18,10,8,0,0,0,1,1,0,4,1,3,2,2,0,0,0,0,11,6,5,0,0,0,0,0,0,0,0,0
223083,21040,210,40,-2,4,0,4,0,0,0,0,0,0,0,0,0,0,0,0,0,0,0,4,0,4,0,0,0,0,0,0,0,0,0
223223,21040,210,40,-2,233,86,147,0,0,0,64,30,34,20,4,16,20,5,15,1,0,1,97,28,69,3,2,1,28,17,11,0,0,0
223232,21040,210,40,-2,25,4,21,0,0,0,0,0,0,4,0,4,1,0,1,0,0,0,16,4,12,0,0,0,4,0,4,0,0,0
223320,21040,210,40,-2,4,1,3,0,0,0,0,0,0,1,1,0,0,0,0,0,0,0,2,0,2,0,0,0,1,0,1,0,0,0
223427,21040,210,40,-2,7,2,5,0,0,0,0,0,0,3,1,2,0,0,0,0,0,0,4,1,3,0,0,0,0,0,0,0,0,0
223506,21040,210,40,-2,5,3,2,0,0,0,0,0,0,1,0,1,0,0,0,0,0,0,3,2,1,1,1,0,0,0,0,0,0,0
223816,21040,210,40,-2,6,1,5,0,0,0,0,0,0,0,0,0,1,0,1,0,0,0,3,1,2,2,0,2,0,0,0,0,0,0
223898,21040,210,40,-2,10,5,5,0,0,0,0,0,0,0,0,0,1,0,1,0,0,0,8,5,3,0,0,0,1,0,1,0,0,0
223922,21040,210,40,-2,5,3,2,0,0,0,0,0,0,0,0,0,0,0,0,0,0,0,5,3,2,0,0,0,0,0,0,0,0,0
224004,21040,210,40,-2,4,0,4,0,0,0,1,0,1,1,0,1,0,0,0,0,0,0,2,0,2,0,0,0,0,0,0,0,0,0
224110,21040,210,40,-2,12,5,7,1,0,1,0,0,0,1,0,1,0,0,0,0,0,0,7,3,4,2,1,1,1,1,0,0,0,0
224147,21040,210,40,-2,6,1,5,0,0,0,1,0,1,0,0,0,0,0,0,0,0,0,3,0,3,0,0,0,0,0,0,2,1,1
224226,21040,210,40,-2,6,2,4,0,0,0,0,0,0,1,0,1,0,0,0,0,0,0,5,2,3,0,0,0,0,0,0,0,0,0
224244,21040,210,40,-2,1,0,1,0,0,0,0,0,0,0,0,0,0,0,0,0,0,0,1,0,1,0,0,0,0,0,0,0,0,0
224323,21040,210,40,-2,6,3,3,0,0,0,0,0,0,0,0,0,0,0,0,0,0,0,6,3,3,0,0,0,0,0,0,0,0,0
224350,21040,210,40,-2,6,4,2,0,0,0,0,0,0,0,0,0,3,2,1,0,0,0,3,2,1,0,0,0,0,0,0,0,0,0
224527,21040,210,40,-2,16,5,11,1,0,1,1,1,0,0,0,0,0,0,0,0,0,0,14,4,10,0,0,0,0,0,0,0,0,0
224545,21040,210,40,-2,4,3,1,0,0,0,0,0,0,0,0,0,0,0,0,0,0,0,2,2,0,0,0,0,1,0,1,1,1,0
224615,21040,210,40,-2,30,8,22,0,0,0,6,1,5,10,2,8,3,2,1,0,0,0,11,3,8,0,0,0,0,0,0,0,0,0
224642,21040,210,40,-2,11,4,7,0,0,0,0,0,0,0,0,0,5,2,3,0,0,0,6,2,4,0,0,0,0,0,0,0,0,0
224660,21040,210,40,-2,16,9,7,0,0,0,0,0,0,0,0,0,9,6,3,0,0,0,5,2,3,1,0,1,1,1,0,0,0,0
224679,21040,210,40,-2,15,14,1,0,0,0,0,0,0,0,0,0,15,14,1,0,0,0,0,0,0,0,0,0,0,0,0,0,0,0
224712,21040,210,40,-2,2,1,1,0,0,0,0,0,0,1,1,0,1,0,1,0,0,0,0,0,0,0,0,0,0,0,0,0,0,0
224891,21040,210,40,-2,1,0,1,0,0,0,0,0,0,0,0,0,0,0,0,0,0,0,1,0,1,0,0,0,0,0,0,0,0,0
225070,21040,210,40,-2,13,6,7,0,0,0,1,0,1,0,0,0,1,0,1,0,0,0,11,6,5,0,0,0,0,0,0,0,0,0
225201,21040,210,40,-2,10,5,5,0,0,0,1,1,0,2,2,0,4,1,3,0,0,0,3,1,2,0,0,0,0,0,0,0,0,0
225247,21040,210,40,-2,5,1,4,0,0,0,0,0,0,0,0,0,0,0,0,0,0,0,5,1,4,0,0,0,0,0,0,0,0,0
225308,21040,210,40,-2,10,2,8,0,0,0,0,0,0,1,1,0,0,0,0,0,0,0,9,1,8,0,0,0,0,0,0,0,0,0
225371,21040,210,40,-2,5,2,3,0,0,0,1,1,0,0,0,0,0,0,0,0,0,0,4,1,3,0,0,0,0,0,0,0,0,0
225399,21040,210,40,-2,16,6,10,0,0,0,0,0,0,3,0,3,1,0,1,0,0,0,12,6,6,0,0,0,0,0,0,0,0,0
225414,21040,210,40,-2,1,0,1,0,0,0,0,0,0,1,0,1,0,0,0,0,0,0,0,0,0,0,0,0,0,0,0,0,0,0
225423,21040,210,40,-2,25,13,12,0,0,0,2,0,2,6,1,5,4,3,1,0,0,0,9,7,2,2,1,1,2,1,1,0,0,0
225432,21040,210,40,-2,4,2,2,0,0,0,1,1,0,1,0,1,0,0,0,0,0,0,2,1,1,0,0,0,0,0,0,0,0,0
225502,21040,210,40,-2,1,1,0,0,0,0,0,0,0,0,0,0,0,0,0,0,0,0,1,1,0,0,0,0,0,0,0,0,0,0
225511,21040,210,40,-2,23,14,9,0,0,0,4,2,2,1,1,0,2,0,2,0,0,0,10,7,3,0,0,0,0,0,0,6,4,2
225520,21040,210,40,-2,6,4,2,0,0,0,1,1,0,0,0,0,1,0,1,0,0,0,4,3,1,0,0,0,0,0,0,0,0,0
225548,21040,210,40,-2,3,2,1,0,0,0,0,0,0,0,0,0,2,2,0,0,0,0,1,0,1,0,0,0,0,0,0,0,0,0
225627,21040,210,40,-2,21,6,15,0,0,0,2,0,2,1,0,1,6,2,4,0,0,0,7,1,6,2,0,2,0,0,0,3,3,0
225885,21040,210,40,-2,1,1,0,0,0,0,0,0,0,0,0,0,1,1,0,0,0,0,0,0,0,0,0,0,0,0,0,0,0,0
226019,21040,210,40,-2,13,5,8,0,0,0,0,0,0,0,0,0,0,0,0,0,0,0,13,5,8,0,0,0,0,0,0,0,0,0
226091,21040,210,40,-2,13,6,7,0,0,0,1,1,0,1,0,1,0,0,0,0,0,0,9,3,6,0,0,0,2,2,0,0,0,0
226134,21040,210,40,-2,5,3,2,0,0,0,0,0,0,0,0,0,5,3,2,0,0,0,0,0,0,0,0,0,0,0,0,0,0,0
226152,21040,210,40,-2,19,8,11,0,0,0,3,1,2,0,0,0,6,1,5,0,0,0,8,5,3,0,0,0,2,1,1,0,0,0
226204,21040,210,40,-2,15,9,6,0,0,0,0,0,0,4,3,1,2,1,1,0,0,0,8,5,3,0,0,0,1,0,1,0,0,0
226277,21040,210,40,-2,35,31,4,0,0,0,1,1,0,2,2,0,4,4,0,0,0,0,26,22,4,1,1,0,1,1,0,0,0,0
226383,21040,210,40,-2,3,2,1,0,0,0,0,0,0,0,0,0,0,0,0,0,0,0,3,2,1,0,0,0,0,0,0,0,0,0
226408,21040,210,40,-2,5,3,2,0,0,0,0,0,0,1,1,0,0,0,0,0,0,0,2,2,0,2,0,2,0,0,0,0,0,0
226471,21040,210,40,-2,6,1,5,1,0,1,0,0,0,0,0,0,0,0,0,0,0,0,5,1,4,0,0,0,0,0,0,0,0,0
226578,21040,210,40,-2,7,4,3,0,0,0,0,0,0,1,1,0,0,0,0,0,0,0,6,3,3,0,0,0,0,0,0,0,0,0
226587,21040,210,40,-2,2,1,1,0,0,0,0,0,0,0,0,0,0,0,0,0,0,0,2,1,1,0,0,0,0,0,0,0,0,0
226806,21040,210,40,-2,8,3,5,0,0,0,1,1,0,0,0,0,4,1,3,0,0,0,3,1,2,0,0,0,0,0,0,0,0,0
226833,21040,210,40,-2,10,1,9,0,0,0,0,0,0,0,0,0,1,0,1,0,0,0,7,1,6,0,0,0,0,0,0,2,0,2
226903,21040,210,40,-2,40,23,17,0,0,0,0,0,0,1,1,0,25,14,11,0,0,0,10,6,4,1,1,0,3,1,2,0,0,0
227146,21040,210,40,-2,7,1,6,0,0,0,0,0,0,0,0,0,1,0,1,0,0,0,6,1,5,0,0,0,0,0,0,0,0,0
227182,21040,210,40,-2,13,8,5,0,0,0,0,0,0,5,2,3,3,3,0,0,0,0,5,3,2,0,0,0,0,0,0,0,0,0
227216,21040,210,40,-2,75,33,42,0,0,0,7,5,2,8,3,5,7,1,6,0,0,0,48,23,25,2,1,1,3,0,3,0,0,0
227225,21040,210,40,-2,6,1,5,0,0,0,0,0,0,0,0,0,0,0,0,0,0,0,6,1,5,0,0,0,0,0,0,0,0,0
227304,21040,210,40,-2,12,7,5,0,0,0,1,1,0,1,0,1,1,0,1,1,1,0,8,5,3,0,0,0,0,0,0,0,0,0
227331,21040,210,40,-2,12,2,10,0,0,0,0,0,0,2,1,1,7,0,7,0,0,0,3,1,2,0,0,0,0,0,0,0,0,0
227368,21040,210,40,-2,114,59,55,0,0,0,7,2,5,3,1,2,50,22,28,0,0,0,40,22,18,1,1,0,3,2,1,10,9,1
227377,21040,210,40,-2,4,3,1,0,0,0,0,0,0,0,0,0,2,1,1,0,0,0,1,1,0,0,0,0,0,0,0,1,1,0
227386,21040,210,40,-2,9,3,6,1,0,1,0,0,0,0,0,0,0,0,0,0,0,0,8,3,5,0,0,0,0,0,0,0,0,0
227401,21040,210,40,-2,10,6,4,0,0,0,0,0,0,1,0,1,2,2,0,0,0,0,7,4,3,0,0,0,0,0,0,0,0,0
227526,21040,210,40,-2,7,5,2,0,0,0,0,0,0,2,1,1,0,0,0,0,0,0,4,3,1,0,0,0,0,0,0,1,1,0
227687,21040,210,40,-2,7,5,2,0,0,0,0,0,0,0,0,0,1,1,0,0,0,0,6,4,2,0,0,0,0,0,0,0,0,0
227757,21040,210,40,-2,23,17,6,0,0,0,1,0,1,2,2,0,3,3,0,0,0,0,11,8,3,0,0,0,6,4,2,0,0,0
227845,21040,210,40,-2,9,5,4,0,0,0,1,0,1,1,0,1,0,0,0,0,0,0,7,5,2,0,0,0,0,0,0,0,0,0
227854,21040,210,40,-2,12,5,7,0,0,0,2,1,1,3,0,3,4,3,1,0,0,0,3,1,2,0,0,0,0,0,0,0,0,0
227863,21040,210,40,-2,9,4,5,0,0,0,1,0,1,1,0,1,1,1,0,0,0,0,5,3,2,0,0,0,0,0,0,1,0,1
227881,21040,210,40,-2,70,26,44,1,0,1,2,0,2,5,0,5,7,5,2,0,0,0,48,19,29,0,0,0,0,0,0,7,2,5
227924,21040,210,40,-2,7,4,3,0,0,0,1,0,1,0,0,0,4,2,2,0,0,0,2,2,0,0,0,0,0,0,0,0,0,0
227979,21040,210,40,-2,24,11,13,0,0,0,0,0,0,9,4,5,2,1,1,0,0,0,12,6,6,0,0,0,0,0,0,1,0,1
228149,21040,210,40,-2,10,6,4,0,0,0,1,0,1,2,1,1,1,1,0,0,0,0,5,3,2,0,0,0,0,0,0,1,1,0
228246,21040,210,40,-2,26,11,15,0,0,0,7,3,4,4,2,2,0,0,0,0,0,0,13,4,9,0,0,0,0,0,0,2,2,0
228316,21040,210,40,-2,7,1,6,0,0,0,0,0,0,0,0,0,5,0,5,0,0,0,2,1,1,0,0,0,0,0,0,0,0,0
228325,21040,210,40,-2,4,4,0,0,0,0,1,1,0,0,0,0,0,0,0,0,0,0,3,3,0,0,0,0,0,0,0,0,0,0
228343,21040,210,40,-2,5,2,3,0,0,0,1,0,1,0,0,0,1,1,0,0,0,0,2,0,2,1,1,0,0,0,0,0,0,0
228431,21040,210,40,-2,1,1,0,0,0,0,0,0,0,0,0,0,0,0,0,0,0,0,0,0,0,0,0,0,0,0,0,1,1,0
228459,21040,210,40,-2,31,14,17,0,0,0,4,3,1,1,1,0,2,1,1,0,0,0,15,5,10,1,0,1,8,4,4,0,0,0
228501,21040,210,40,-2,2,1,1,0,0,0,0,0,0,0,0,0,0,0,0,0,0,0,2,1,1,0,0,0,0,0,0,0,0,0
228529,21040,210,40,-2,21,10,11,1,1,0,1,0,1,1,0,1,2,1,1,0,0,0,14,7,7,0,0,0,0,0,0,2,1,1
228635,21040,210,40,-2,165,75,90,0,0,0,61,28,33,11,5,6,10,4,6,0,0,0,67,30,37,2,1,1,4,1,3,10,6,4
228644,21040,210,40,-2,55,29,26,0,0,0,9,5,4,3,2,1,11,4,7,0,0,0,25,16,9,0,0,0,7,2,5,0,0,0
228653,21040,210,40,-2,19,5,14,0,0,0,2,1,1,5,1,4,3,0,3,0,0,0,9,3,6,0,0,0,0,0,0,0,0,0
228699,21040,210,40,-2,3,0,3,0,0,0,0,0,0,1,0,1,0,0,0,0,0,0,2,0,2,0,0,0,0,0,0,0,0,0
228705,21040,210,40,-2,3,2,1,0,0,0,0,0,0,0,0,0,0,0,0,0,0,0,1,1,0,0,0,0,0,0,0,2,1,1
228723,21040,210,40,-2,103,56,47,0,0,0,12,2,10,4,2,2,8,4,4,0,0,0,63,35,28,2,2,0,10,8,2,4,3,1
228769,21040,210,40,-2,37,11,26,0,0,0,6,3,3,4,0,4,2,1,1,1,0,1,11,2,9,1,0,1,9,3,6,3,2,1
228778,21040,210,40,-2,113,52,61,0,0,0,11,2,9,7,4,3,15,7,8,0,0,0,61,27,34,2,1,1,0,0,0,17,11,6
228787,21040,210,40,-2,22,9,13,0,0,0,1,1,0,0,0,0,0,0,0,0,0,0,8,2,6,2,1,1,11,5,6,0,0,0
228796,21040,210,40,-2,22,6,16,0,0,0,4,2,2,1,1,0,9,1,8,0,0,0,5,2,3,1,0,1,0,0,0,2,0,2
228802,21040,210,40,-2,15,2,13,0,0,0,1,0,1,0,0,0,0,0,0,0,0,0,10,1,9,0,0,0,3,1,2,1,0,1
228875,21040,210,40,-2,30,13,17,0,0,0,2,1,1,4,1,3,4,1,3,0,0,0,15,8,7,0,0,0,3,1,2,2,1,1
228909,21040,210,40,-2,12,3,9,0,0,0,2,1,1,1,0,1,1,1,0,0,0,0,6,1,5,0,0,0,2,0,2,0,0,0
228981,21040,210,40,-2,1,1,0,0,0,0,0,0,0,0,0,0,1,1,0,0,0,0,0,0,0,0,0,0,0,0,0,0,0,0
229018,21040,210,40,-2,6,1,5,0,0,0,0,0,0,0,0,0,1,0,1,0,0,0,5,1,4,0,0,0,0,0,0,0,0,0
229027,21040,210,40,-2,17,10,7,0,0,0,1,0,1,0,0,0,7,5,2,0,0,0,2,1,1,0,0,0,6,3,3,1,1,0
229063,21040,210,40,-2,15,6,9,1,0,1,2,0,2,11,5,6,0,0,0,0,0,0,1,1,0,0,0,0,0,0,0,0,0,0
229115,21040,210,40,-2,30,13,17,0,0,0,1,0,1,1,1,0,4,2,2,0,0,0,20,9,11,0,0,0,0,0,0,4,1,3
229179,21040,210,40,-2,11,0,11,0,0,0,3,0,3,2,0,2,3,0,3,0,0,0,3,0,3,0,0,0,0,0,0,0,0,0
229267,21040,210,40,-2,11,6,5,0,0,0,1,0,1,1,1,0,3,1,2,0,0,0,6,4,2,0,0,0,0,0,0,0,0,0
229300,21040,210,40,-2,178,82,96,0,0,0,51,23,28,10,1,9,21,8,13,1,1,0,51,23,28,4,1,3,20,12,8,20,13,7
229337,21040,210,40,-2,36,15,21,0,0,0,13,6,7,1,0,1,5,1,4,0,0,0,17,8,9,0,0,0,0,0,0,0,0,0
229355,21040,210,40,-2,37,11,26,0,0,0,0,0,0,1,0,1,1,0,1,0,0,0,35,11,24,0,0,0,0,0,0,0,0,0
229504,21040,210,40,-2,7,4,3,0,0,0,0,0,0,0,0,0,0,0,0,0,0,0,7,4,3,0,0,0,0,0,0,0,0,0
229540,21040,210,40,-2,1,0,1,0,0,0,0,0,0,0,0,0,0,0,0,0,0,0,1,0,1,0,0,0,0,0,0,0,0,0
229780,21040,210,40,-2,3,2,1,0,0,0,0,0,0,0,0,0,1,0,1,0,0,0,2,2,0,0,0,0,0,0,0,0,0,0
229799,21040,210,40,-2,12,3,9,0,0,0,2,1,1,1,0,1,0,0,0,0,0,0,6,1,5,0,0,0,3,1,2,0,0,0
229814,21040,210,40,-2,32,15,17,0,0,0,3,2,1,0,0,0,2,1,1,0,0,0,17,6,11,0,0,0,0,0,0,10,6,4
229832,21040,210,40,-2,4,4,0,0,0,0,0,0,0,0,0,0,1,1,0,0,0,0,3,3,0,0,0,0,0,0,0,0,0,0
229841,21040,210,40,-2,11,2,9,0,0,0,0,0,0,3,0,3,1,1,0,0,0,0,5,0,5,0,0,0,2,1,1,0,0,0
229887,21040,210,40,-2,5,0,5,0,0,0,0,0,0,5,0,5,0,0,0,0,0,0,0,0,0,0,0,0,0,0,0,0,0,0
230038,21040,210,40,-2,1,1,0,0,0,0,0,0,0,0,0,0,0,0,0,0,0,0,1,1,0,0,0,0,0,0,0,0,0,0
230047,21040,210,40,-2,9,5,4,0,0,0,1,1,0,0,0,0,1,0,1,1,0,1,5,3,2,0,0,0,0,0,0,1,1,0
230171,21040,210,40,-2,18,8,10,0,0,0,0,0,0,0,0,0,0,0,0,0,0,0,16,6,10,0,0,0,1,1,0,1,1,0
230366,21040,210,40,-2,5,0,5,0,0,0,0,0,0,0,0,0,0,0,0,0,0,0,5,0,5,0,0,0,0,0,0,0,0,0
230418,21040,210,40,-2,1,1,0,0,0,0,0,0,0,0,0,0,0,0,0,0,0,0,1,1,0,0,0,0,0,0,0,0,0,0
230597,21040,210,40,-2,2,1,1,0,0,0,0,0,0,0,0,0,0,0,0,0,0,0,2,1,1,0,0,0,0,0,0,0,0,0
230603,21040,210,40,-2,22,15,7,0,0,0,0,0,0,0,0,0,0,0,0,0,0,0,21,14,7,0,0,0,0,0,0,1,1,0
230728,21040,210,40,-2,32,18,14,0,0,0,0,0,0,0,0,0,3,3,0,0,0,0,26,13,13,1,1,0,2,1,1,0,0,0
230737,21040,210,40,-2,33,16,17,0,0,0,4,1,3,1,0,1,2,1,1,1,0,1,17,9,8,2,1,1,3,2,1,3,2,1
230746,21040,210,40,-2,3,2,1,0,0,0,0,0,0,1,0,1,0,0,0,0,0,0,2,2,0,0,0,0,0,0,0,0,0,0
230764,21040,210,40,-2,38,22,16,1,1,0,1,1,0,2,1,1,3,2,1,0,0,0,24,15,9,2,1,1,1,0,1,4,1,3
230782,21040,210,40,-2,25,11,14,0,0,0,0,0,0,0,0,0,1,1,0,0,0,0,23,10,13,1,0,1,0,0,0,0,0,0
230807,21040,210,40,-2,4,0,4,0,0,0,0,0,0,0,0,0,0,0,0,0,0,0,4,0,4,0,0,0,0,0,0,0,0,0
230816,21040,210,40,-2,2,1,1,0,0,0,1,0,1,0,0,0,0,0,0,0,0,0,1,1,0,0,0,0,0,0,0,0,0,0
230852,21040,210,40,-2,2,1,1,0,0,0,0,0,0,0,0,0,0,0,0,0,0,0,1,1,0,0,0,0,1,0,1,0,0,0
230959,21040,210,40,-2,5,1,4,0,0,0,1,0,1,0,0,0,0,0,0,0,0,0,3,1,2,0,0,0,0,0,0,1,0,1
230995,21040,210,40,-2,11,4,7,0,0,0,0,0,0,0,0,0,0,0,0,0,0,0,10,3,7,0,0,0,1,1,0,0,0,0
231059,21040,210,40,-2,2,1,1,0,0,0,0,0,0,0,0,0,0,0,0,0,0,0,1,0,1,0,0,0,0,0,0,1,1,0
231068,21040,210,40,-2,1,0,1,0,0,0,0,0,0,0,0,0,0,0,0,0,0,0,1,0,1,0,0,0,0,0,0,0,0,0
231147,21040,210,40,-2,8,2,6,0,0,0,0,0,0,1,0,1,0,0,0,0,0,0,6,2,4,0,0,0,1,0,1,0,0,0
231165,21040,210,40,-2,1,0,1,0,0,0,0,0,0,0,0,0,0,0,0,0,0,0,1,0,1,0,0,0,0,0,0,0,0,0
231174,21040,210,40,-2,18,8,10,0,0,0,2,0,2,2,2,0,0,0,0,0,0,0,10,4,6,0,0,0,2,1,1,2,1,1
231411,21040,210,40,-2,3,2,1,0,0,0,0,0,0,1,0,1,0,0,0,0,0,0,2,2,0,0,0,0,0,0,0,0,0,0
231420,21040,210,40,-2,2,1,1,0,0,0,0,0,0,0,0,0,0,0,0,0,0,0,2,1,1,0,0,0,0,0,0,0,0,0
231536,21040,210,40,-2,3,0,3,0,0,0,0,0,0,0,0,0,0,0,0,0,0,0,3,0,3,0,0,0,0,0,0,0,0,0
231554,21040,210,40,-2,1,0,1,0,0,0,0,0,0,0,0,0,0,0,0,0,0,0,1,0,1,0,0,0,0,0,0,0,0,0
231581,21040,210,40,-2,7,5,2,0,0,0,2,2,0,0,0,0,0,0,0,0,0,0,4,3,1,0,0,0,0,0,0,1,0,1
231624,21040,210,40,-2,21,8,13,0,0,0,2,1,1,1,0,1,1,1,0,0,0,0,11,6,5,0,0,0,4,0,4,2,0,2
231651,21040,210,40,-2,4,0,4,0,0,0,0,0,0,1,0,1,0,0,0,0,0,0,3,0,3,0,0,0,0,0,0,0,0,0
231697,21040,210,40,-2,1,0,1,0,0,0,0,0,0,0,0,0,0,0,0,0,0,0,1,0,1,0,0,0,0,0,0,0,0,0
231712,21040,210,40,-2,3,2,1,0,0,0,0,0,0,0,0,0,0,0,0,0,0,0,3,2,1,0,0,0,0,0,0,0,0,0
231785,21040,210,40,-2,8,2,6,0,0,0,0,0,0,4,0,4,0,0,0,0,0,0,2,1,1,1,1,0,1,0,1,0,0,0
231873,21040,210,40,-2,5,1,4,0,0,0,0,0,0,0,0,0,0,0,0,0,0,0,5,1,4,0,0,0,0,0,0,0,0,0
231882,21040,210,40,-2,15,10,5,0,0,0,0,0,0,1,0,1,0,0,0,0,0,0,14,10,4,0,0,0,0,0,0,0,0,0
231970,21040,210,40,-2,20,6,14,0,0,0,4,2,2,3,0,3,1,0,1,0,0,0,12,4,8,0,0,0,0,0,0,0,0,0
232025,21040,210,40,-2,9,3,6,0,0,0,0,0,0,0,0,0,0,0,0,0,0,0,3,1,2,0,0,0,6,2,4,0,0,0
232043,21040,210,40,-2,3,2,1,0,0,0,1,1,0,0,0,0,0,0,0,0,0,0,2,1,1,0,0,0,0,0,0,0,0,0
232052,21040,210,40,-2,1,0,1,0,0,0,1,0,1,0,0,0,0,0,0,0,0,0,0,0,0,0,0,0,0,0,0,0,0,0
232186,21040,210,40,-2,59,37,22,1,1,0,6,4,2,9,7,2,1,1,0,0,0,0,31,16,15,1,1,0,1,1,0,9,6,3
232195,21040,210,40,-2,13,7,6,1,0,1,1,1,0,4,3,1,1,0,1,0,0,0,6,3,3,0,0,0,0,0,0,0,0,0
232256,21040,210,40,-2,3,3,0,0,0,0,1,1,0,0,0,0,0,0,0,0,0,0,2,2,0,0,0,0,0,0,0,0,0,0
232265,21040,210,40,-2,27,10,17,0,0,0,5,2,3,14,5,9,0,0,0,0,0,0,8,3,5,0,0,0,0,0,0,0,0,0
232308,21040,210,40,-2,21,6,15,0,0,0,0,0,0,2,1,1,0,0,0,0,0,0,16,5,11,1,0,1,0,0,0,2,0,2
232414,21040,210,40,-2,8,2,6,0,0,0,0,0,0,1,0,1,0,0,0,0,0,0,7,2,5,0,0,0,0,0,0,0,0,0
232423,21040,210,40,-2,18,7,11,0,0,0,1,1,0,1,1,0,1,1,0,0,0,0,13,4,9,1,0,1,0,0,0,1,0,1
232450,21040,210,40,-2,3,0,3,0,0,0,0,0,0,0,0,0,0,0,0,0,0,0,3,0,3,0,0,0,0,0,0,0,0,0
232557,21040,210,40,-2,48,19,29,0,0,0,1,1,0,11,3,8,2,1,1,0,0,0,34,14,20,0,0,0,0,0,0,0,0,0
232566,21040,210,40,-2,5,2,3,0,0,0,0,0,0,0,0,0,0,0,0,0,0,0,4,1,3,0,0,0,0,0,0,1,1,0
232575,21040,210,40,-2,6,1,5,1,0,1,0,0,0,0,0,0,0,0,0,0,0,0,5,1,4,0,0,0,0,0,0,0,0,0
232609,21040,210,40,-2,5,3,2,0,0,0,1,1,0,0,0,0,0,0,0,0,0,0,2,1,1,0,0,0,2,1,1,0,0,0
232618,21040,210,40,-2,6,1,5,0,0,0,0,0,0,0,0,0,0,0,0,0,0,0,6,1,5,0,0,0,0,0,0,0,0,0
232672,21040,210,40,-2,10,2,8,0,0,0,0,0,0,0,0,0,1,0,1,0,0,0,9,2,7,0,0,0,0,0,0,0,0,0
232681,21040,210,40,-2,7,5,2,0,0,0,1,1,0,0,0,0,0,0,0,0,0,0,6,4,2,0,0,0,0,0,0,0,0,0
232706,21040,210,40,-2,2,1,1,0,0,0,0,0,0,0,0,0,0,0,0,0,0,0,2,1,1,0,0,0,0,0,0,0,0,0
232788,21040,210,40,-2,1,1,0,0,0,0,0,0,0,0,0,0,0,0,0,0,0,0,1,1,0,0,0,0,0,0,0,0,0,0
232867,21040,210,40,-2,4,1,3,0,0,0,0,0,0,0,0,0,0,0,0,0,0,0,4,1,3,0,0,0,0,0,0,0,0,0
232885,21040,210,40,-2,1,0,1,0,0,0,0,0,0,1,0,1,0,0,0,0,0,0,0,0,0,0,0,0,0,0,0,0,0,0
232937,21040,210,40,-2,2,1,1,0,0,0,0,0,0,2,1,1,0,0,0,0,0,0,0,0,0,0,0,0,0,0,0,0,0,0
232946,21040,210,40,-2,8,3,5,0,0,0,0,0,0,2,2,0,0,0,0,0,0,0,6,1,5,0,0,0,0,0,0,0,0,0
232982,21040,210,40,-2,23,12,11,0,0,0,4,2,2,2,1,1,0,0,0,0,0,0,15,8,7,0,0,0,0,0,0,2,1,1
233019,21040,210,40,-2,2,0,2,0,0,0,0,0,0,0,0,0,0,0,0,0,0,0,2,0,2,0,0,0,0,0,0,0,0,0
233082,21040,210,40,-2,2,0,2,0,0,0,0,0,0,0,0,0,0,0,0,0,0,0,2,0,2,0,0,0,0,0,0,0,0,0
233116,21040,210,40,-2,6,2,4,0,0,0,1,1,0,2,1,1,0,0,0,0,0,0,3,0,3,0,0,0,0,0,0,0,0,0
233277,21040,210,40,-2,10,5,5,0,0,0,1,0,1,0,0,0,0,0,0,0,0,0,9,5,4,0,0,0,0,0,0,0,0,0
233295,21040,210,40,-2,12,6,6,0,0,0,0,0,0,2,0,2,1,1,0,0,0,0,9,5,4,0,0,0,0,0,0,0,0,0
233301,21040,210,40,-2,3,0,3,0,0,0,0,0,0,1,0,1,0,0,0,0,0,0,2,0,2,0,0,0,0,0,0,0,0,0
233310,21040,210,40,-2,3,0,3,0,0,0,0,0,0,1,0,1,0,0,0,0,0,0,2,0,2,0,0,0,0,0,0,0,0,0
233329,21040,210,40,-2,12,1,11,0,0,0,2,0,2,1,0,1,3,0,3,0,0,0,5,0,5,0,0,0,1,1,0,0,0,0
233356,21040,210,40,-2,3,2,1,0,0,0,0,0,0,1,1,0,0,0,0,0,0,0,2,1,1,0,0,0,0,0,0,0,0,0
233374,21040,210,40,-2,23,12,11,0,0,0,1,0,1,1,1,0,0,0,0,0,0,0,15,8,7,1,0,1,1,1,0,4,2,2
233408,21040,210,40,-2,2,0,2,0,0,0,0,0,0,0,0,0,0,0,0,0,0,0,2,0,2,0,0,0,0,0,0,0,0,0
233426,21040,210,40,-2,13,8,5,0,0,0,0,0,0,0,0,0,1,1,0,0,0,0,11,6,5,1,1,0,0,0,0,0,0,0
233541,21040,210,40,-2,23,7,16,0,0,0,0,0,0,3,2,1,0,0,0,0,0,0,14,4,10,0,0,0,5,1,4,1,0,1
233611,21040,210,40,-2,1,1,0,0,0,0,0,0,0,0,0,0,0,0,0,0,0,0,1,1,0,0,0,0,0,0,0,0,0,0
233639,21040,210,40,-2,1,0,1,0,0,0,0,0,0,0,0,0,0,0,0,0,0,0,1,0,1,0,0,0,0,0,0,0,0,0
233718,21040,210,40,-2,9,2,7,0,0,0,0,0,0,1,0,1,1,0,1,0,0,0,7,2,5,0,0,0,0,0,0,0,0,0
233754,21040,210,40,-2,1,1,0,0,0,0,0,0,0,0,0,0,0,0,0,0,0,0,1,1,0,0,0,0,0,0,0,0,0,0
233772,21040,210,40,-2,12,6,6,0,0,0,0,0,0,1,1,0,0,0,0,0,0,0,11,5,6,0,0,0,0,0,0,0,0,0
233897,21040,210,40,-2,2,1,1,0,0,0,0,0,0,0,0,0,0,0,0,0,0,0,2,1,1,0,0,0,0,0,0,0,0,0
233903,21040,210,40,-2,1,1,0,0,0,0,0,0,0,0,0,0,0,0,0,0,0,0,1,1,0,0,0,0,0,0,0,0,0,0
233921,21040,210,40,-2,79,32,47,0,0,0,7,3,4,3,2,1,8,4,4,0,0,0,45,17,28,1,1,0,0,0,0,15,5,10
233949,21040,210,40,-2,2,1,1,0,0,0,1,1,0,0,0,0,0,0,0,0,0,0,1,0,1,0,0,0,0,0,0,0,0,0
234030,21040,210,40,-2,84,37,47,0,0,0,7,3,4,12,4,8,4,2,2,0,0,0,52,22,30,2,0,2,0,0,0,7,6,1
234076,21040,210,40,-2,102,59,43,0,0,0,12,10,2,3,2,1,2,0,2,0,0,0,59,34,25,3,3,0,11,9,2,12,1,11
234085,21040,210,40,-2,6,2,4,0,0,0,1,0,1,0,0,0,0,0,0,0,0,0,5,2,3,0,0,0,0,0,0,0,0,0
234155,21040,210,40,-2,19,12,7,0,0,0,3,3,0,11,5,6,1,0,1,0,0,0,4,4,0,0,0,0,0,0,0,0,0,0
234207,21040,210,40,-2,14,5,9,0,0,0,0,0,0,1,0,1,4,2,2,0,0,0,3,2,1,0,0,0,4,1,3,2,0,2
234377,21040,210,40,-2,1,0,1,0,0,0,0,0,0,0,0,0,0,0,0,0,0,0,1,0,1,0,0,0,0,0,0,0,0,0
234696,21040,210,40,-2,2,1,1,0,0,0,0,0,0,0,0,0,0,0,0,0,0,0,2,1,1,0,0,0,0,0,0,0,0,0
234827,21040,210,40,-2,9,4,5,0,0,0,2,2,0,2,0,2,0,0,0,0,0,0,5,2,3,0,0,0,0,0,0,0,0,0
234915,21040,210,40,-2,7,4,3,0,0,0,2,2,0,0,0,0,0,0,0,0,0,0,4,1,3,0,0,0,1,1,0,0,0,0
234933,21040,210,40,-2,10,1,9,0,0,0,1,0,1,1,1,0,0,0,0,0,0,0,7,0,7,0,0,0,1,0,1,0,0,0
234951,21040,210,40,-2,3,2,1,0,0,0,0,0,0,1,1,0,0,0,0,0,0,0,2,1,1,0,0,0,0,0,0,0,0,0
234979,21040,210,40,-2,2,1,1,0,0,0,0,0,0,0,0,0,0,0,0,0,0,0,2,1,1,0,0,0,0,0,0,0,0,0
235024,21040,210,40,-2,2,0,2,0,0,0,0,0,0,0,0,0,1,0,1,0,0,0,0,0,0,1,0,1,0,0,0,0,0,0
235097,21040,210,40,-2,32,15,17,1,1,0,3,1,2,1,0,1,1,1,0,0,0,0,25,11,14,0,0,0,0,0,0,1,1,0
235103,21040,210,40,-2,3,0,3,0,0,0,0,0,0,0,0,0,0,0,0,0,0,0,3,0,3,0,0,0,0,0,0,0,0,0
235149,21040,210,40,-2,3,2,1,0,0,0,1,1,0,0,0,0,0,0,0,0,0,0,1,1,0,1,0,1,0,0,0,0,0,0
235167,21040,210,40,-2,3,1,2,0,0,0,0,0,0,0,0,0,0,0,0,0,0,0,0,0,0,0,0,0,3,1,2,0,0,0
235237,21040,210,40,-2,1,0,1,0,0,0,0,0,0,0,0,0,0,0,0,0,0,0,1,0,1,0,0,0,0,0,0,0,0,0
235316,21040,210,40,-2,25,15,10,0,0,0,4,4,0,1,1,0,1,0,1,0,0,0,14,5,9,0,0,0,3,3,0,2,2,0
235422,21040,210,40,-2,4,0,4,0,0,0,1,0,1,0,0,0,1,0,1,0,0,0,2,0,2,0,0,0,0,0,0,0,0,0
235431,21040,210,40,-2,7,4,3,0,0,0,0,0,0,1,0,1,0,0,0,0,0,0,5,3,2,0,0,0,1,1,0,0,0,0
235671,21040,210,40,-2,3,1,2,0,0,0,1,0,1,0,0,0,0,0,0,0,0,0,2,1,1,0,0,0,0,0,0,0,0,0
235699,21040,210,40,-2,7,1,6,0,0,0,1,0,1,0,0,0,0,0,0,0,0,0,6,1,5,0,0,0,0,0,0,0,0,0
236188,21040,210,40,-2,9,1,8,0,0,0,0,0,0,0,0,0,0,0,0,1,0,1,7,1,6,1,0,1,0,0,0,0,0,0
236212,21040,210,40,-2,10,9,1,0,0,0,0,0,0,0,0,0,0,0,0,0,0,0,9,8,1,0,0,0,1,1,0,0,0,0
236230,21040,210,40,-2,12,4,8,0,0,0,0,0,0,0,0,0,0,0,0,0,0,0,11,4,7,0,0,0,1,0,1,0,0,0
236258,21040,210,40,-2,3,1,2,0,0,0,0,0,0,0,0,0,0,0,0,0,0,0,2,0,2,0,0,0,1,1,0,0,0,0
236328,21040,210,40,-2,7,2,5,0,0,0,1,0,1,0,0,0,0,0,0,0,0,0,6,2,4,0,0,0,0,0,0,0,0,0
236382,21040,210,40,-2,1,1,0,0,0,0,0,0,0,1,1,0,0,0,0,0,0,0,0,0,0,0,0,0,0,0,0,0,0,0
236452,21040,210,40,-2,2,1,1,0,0,0,0,0,0,0,0,0,0,0,0,0,0,0,2,1,1,0,0,0,0,0,0,0,0,0
236513,21040,210,40,-2,3,3,0,0,0,0,1,1,0,0,0,0,0,0,0,0,0,0,1,1,0,0,0,0,1,1,0,0,0,0
236577,21040,210,40,-2,8,3,5,0,0,0,0,0,0,0,0,0,1,1,0,0,0,0,4,2,2,0,0,0,1,0,1,2,0,2
236595,21040,210,40,-2,44,18,26,0,0,0,8,6,2,1,0,1,0,0,0,0,0,0,29,10,19,1,1,0,5,1,4,0,0,0
236610,21040,210,40,-2,8,1,7,0,0,0,1,0,1,1,0,1,0,0,0,0,0,0,5,1,4,0,0,0,1,0,1,0,0,0
236638,21040,210,40,-2,1,1,0,0,0,0,0,0,0,0,0,0,0,0,0,0,0,0,1,1,0,0,0,0,0,0,0,0,0,0
236692,21040,210,40,-2,2,1,1,0,0,0,0,0,0,0,0,0,0,0,0,0,0,0,2,1,1,0,0,0,0,0,0,0,0,0
236708,21040,210,40,-2,3,0,3,0,0,0,0,0,0,0,0,0,0,0,0,0,0,0,3,0,3,0,0,0,0,0,0,0,0,0
236753,21040,210,40,-2,6,4,2,0,0,0,0,0,0,0,0,0,1,1,0,1,0,1,2,2,0,0,0,0,2,1,1,0,0,0
236887,21040,210,40,-2,2,2,0,0,0,0,0,0,0,0,0,0,0,0,0,0,0,0,2,2,0,0,0,0,0,0,0,0,0,0
236896,21040,210,40,-2,6,5,1,0,0,0,1,1,0,0,0,0,1,0,1,0,0,0,4,4,0,0,0,0,0,0,0,0,0,0
236939,21040,210,40,-2,7,2,5,1,0,1,1,1,0,0,0,0,0,0,0,0,0,0,1,0,1,0,0,0,3,1,2,1,0,1
236948,21040,210,40,-2,248,113,135,0,0,0,40,17,23,12,3,9,15,8,7,1,0,1,124,51,73,3,3,0,29,17,12,24,14,10
236975,21040,210,40,-2,2,1,1,0,0,0,0,0,0,0,0,0,1,1,0,0,0,0,1,0,1,0,0,0,0,0,0,0,0,0
237011,21040,210,40,-2,9,5,4,0,0,0,1,0,1,0,0,0,0,0,0,0,0,0,6,3,3,0,0,0,1,1,0,1,1,0
237039,21040,210,40,-2,1,0,1,0,0,0,0,0,0,0,0,0,0,0,0,0,0,0,1,0,1,0,0,0,0,0,0,0,0,0
237057,21040,210,40,-2,11,6,5,0,0,0,0,0,0,0,0,0,1,0,1,0,0,0,8,5,3,0,0,0,0,0,0,2,1,1
237066,21040,210,40,-2,11,5,6,0,0,0,0,0,0,0,0,0,0,0,0,0,0,0,11,5,6,0,0,0,0,0,0,0,0,0
237109,21040,210,40,-2,3,0,3,0,0,0,0,0,0,0,0,0,2,0,2,0,0,0,1,0,1,0,0,0,0,0,0,0,0,0
237215,21040,210,40,-2,8,3,5,0,0,0,0,0,0,0,0,0,0,0,0,0,0,0,8,3,5,0,0,0,0,0,0,0,0,0
237312,21040,210,40,-2,21,7,14,0,0,0,0,0,0,3,0,3,1,1,0,0,0,0,17,6,11,0,0,0,0,0,0,0,0,0
237330,21040,210,40,-2,2,1,1,0,0,0,0,0,0,0,0,0,0,0,0,0,0,0,2,1,1,0,0,0,0,0,0,0,0,0
237358,21040,210,40,-2,8,3,5,0,0,0,0,0,0,0,0,0,0,0,0,0,0,0,8,3,5,0,0,0,0,0,0,0,0,0
237525,21040,210,40,-2,38,20,18,1,0,1,7,5,2,2,1,1,1,1,0,0,0,0,26,13,13,0,0,0,1,0,1,0,0,0
237686,21040,210,40,-2,6,1,5,0,0,0,0,0,0,0,0,0,0,0,0,0,0,0,6,1,5,0,0,0,0,0,0,0,0,0
237701,21040,210,40,-2,4,0,4,0,0,0,0,0,0,1,0,1,0,0,0,0,0,0,3,0,3,0,0,0,0,0,0,0,0,0
237792,21040,210,40,-2,2,1,1,0,0,0,0,0,0,0,0,0,0,0,0,0,0,0,2,1,1,0,0,0,0,0,0,0,0,0
237817,21040,210,40,-2,6,1,5,0,0,0,0,0,0,0,0,0,0,0,0,0,0,0,6,1,5,0,0,0,0,0,0,0,0,0
237899,21040,210,40,-2,5,1,4,0,0,0,0,0,0,0,0,0,0,0,0,0,0,0,5,1,4,0,0,0,0,0,0,0,0,0
237932,21040,210,40,-2,4,2,2,0,0,0,1,1,0,0,0,0,0,0,0,0,0,0,2,1,1,0,0,0,1,0,1,0,0,0
237950,21040,210,40,-2,3,2,1,0,0,0,1,1,0,0,0,0,0,0,0,0,0,0,1,0,1,0,0,0,0,0,0,1,1,0
237969,21040,210,40,-2,2,1,1,0,0,0,0,0,0,0,0,0,0,0,0,0,0,0,2,1,1,0,0,0,0,0,0,0,0,0
238014,21040,210,40,-2,8,1,7,0,0,0,1,1,0,1,0,1,0,0,0,0,0,0,6,0,6,0,0,0,0,0,0,0,0,0
238032,21040,210,40,-2,32,12,20,0,0,0,1,0,1,1,1,0,1,0,1,0,0,0,26,9,17,1,1,0,1,1,0,1,0,1
238078,21040,210,40,-2,4,2,2,0,0,0,0,0,0,0,0,0,0,0,0,0,0,0,4,2,2,0,0,0,0,0,0,0,0,0
238193,21040,210,40,-2,4,1,3,0,0,0,0,0,0,1,1,0,0,0,0,0,0,0,3,0,3,0,0,0,0,0,0,0,0,0
238263,21040,210,40,-2,14,4,10,0,0,0,0,0,0,1,1,0,2,1,1,0,0,0,10,1,9,0,0,0,1,1,0,0,0,0
238324,21040,210,40,-2,1,0,1,0,0,0,0,0,0,0,0,0,0,0,0,0,0,0,1,0,1,0,0,0,0,0,0,0,0,0
238333,21040,210,40,-2,8,4,4,0,0,0,0,0,0,0,0,0,0,0,0,0,0,0,8,4,4,0,0,0,0,0,0,0,0,0
238397,21040,210,40,-2,9,8,1,0,0,0,0,0,0,2,2,0,0,0,0,0,0,0,6,6,0,0,0,0,1,0,1,0,0,0
238430,21040,210,40,-2,2,1,1,0,0,0,0,0,0,0,0,0,0,0,0,0,0,0,2,1,1,0,0,0,0,0,0,0,0,0
238458,21040,210,40,-2,10,2,8,0,0,0,0,0,0,0,0,0,0,0,0,0,0,0,9,2,7,0,0,0,1,0,1,0,0,0
238476,21040,210,40,-2,9,4,5,0,0,0,0,0,0,0,0,0,0,0,0,0,0,0,8,4,4,0,0,0,1,0,1,0,0,0
238616,21040,210,40,-2,17,5,12,0,0,0,0,0,0,0,0,0,1,0,1,0,0,0,16,5,11,0,0,0,0,0,0,0,0,0
238661,21040,210,40,-2,2,1,1,0,0,0,0,0,0,1,1,0,0,0,0,0,0,0,0,0,0,0,0,0,0,0,0,1,0,1
238722,21040,210,40,-2,5,3,2,0,0,0,0,0,0,0,0,0,0,0,0,0,0,0,5,3,2,0,0,0,0,0,0,0,0,0
238759,21040,210,40,-2,15,5,10,0,0,0,1,0,1,1,0,1,0,0,0,1,1,0,12,4,8,0,0,0,0,0,0,0,0,0
239008,21040,210,40,-2,4,2,2,0,0,0,0,0,0,1,0,1,0,0,0,0,0,0,3,2,1,0,0,0,0,0,0,0,0,0
239017,21040,210,40,-2,2,0,2,0,0,0,0,0,0,0,0,0,0,0,0,0,0,0,2,0,2,0,0,0,0,0,0,0,0,0
239071,21040,210,40,-2,3,2,1,0,0,0,0,0,0,0,0,0,0,0,0,0,0,0,3,2,1,0,0,0,0,0,0,0,0,0
239105,21040,210,40,-2,21,9,12,0,0,0,1,1,0,2,1,1,2,1,1,0,0,0,13,5,8,1,0,1,0,0,0,2,1,1
239169,21040,210,40,-2,65,38,27,0,0,0,12,7,5,3,3,0,4,3,1,0,0,0,46,25,21,0,0,0,0,0,0,0,0,0
239220,21040,210,40,-2,9,4,5,0,0,0,1,1,0,0,0,0,0,0,0,0,0,0,8,3,5,0,0,0,0,0,0,0,0,0
239248,21040,210,40,-2,9,6,3,0,0,0,0,0,0,0,0,0,1,0,1,0,0,0,8,6,2,0,0,0,0,0,0,0,0,0
239309,21040,210,40,-2,7,2,5,0,0,0,0,0,0,2,1,1,0,0,0,0,0,0,1,1,0,4,0,4,0,0,0,0,0,0
239318,21040,210,40,-2,9,6,3,0,0,0,0,0,0,0,0,0,0,0,0,0,0,0,9,6,3,0,0,0,0,0,0,0,0,0
239372,21040,210,40,-2,1,1,0,0,0,0,0,0,0,0,0,0,0,0,0,0,0,0,1,1,0,0,0,0,0,0,0,0,0,0
239442,21040,210,40,-2,2,0,2,0,0,0,0,0,0,0,0,0,0,0,0,0,0,0,2,0,2,0,0,0,0,0,0,0,0,0
239460,21040,210,40,-2,17,6,11,0,0,0,1,0,1,0,0,0,0,0,0,0,0,0,15,6,9,0,0,0,1,0,1,0,0,0
239488,21040,210,40,-2,18,14,4,0,0,0,0,0,0,0,0,0,0,0,0,0,0,0,18,14,4,0,0,0,0,0,0,0,0,0
239512,21040,210,40,-2,2,0,2,0,0,0,0,0,0,0,0,0,0,0,0,0,0,0,2,0,2,0,0,0,0,0,0,0,0,0
239716,21040,210,40,-2,4,1,3,0,0,0,0,0,0,0,0,0,0,0,0,0,0,0,3,1,2,0,0,0,1,0,1,0,0,0
239910,21040,210,40,-2,2,0,2,0,0,0,0,0,0,1,0,1,0,0,0,0,0,0,1,0,1,0,0,0,0,0,0,0,0,0
240107,21040,210,40,-2,8,3,5,0,0,0,0,0,0,0,0,0,0,0,0,0,0,0,8,3,5,0,0,0,0,0,0,0,0,0
240116,21040,210,40,-2,17,9,8,0,0,0,1,0,1,0,0,0,1,1,0,0,0,0,15,8,7,0,0,0,0,0,0,0,0,0
240125,21040,210,40,-2,13,7,6,0,0,0,0,0,0,0,0,0,1,1,0,0,0,0,11,5,6,0,0,0,1,1,0,0,0,0
240198,21040,210,40,-2,11,5,6,0,0,0,0,0,0,0,0,0,0,0,0,0,0,0,11,5,6,0,0,0,0,0,0,0,0,0
240268,21040,210,40,-2,5,1,4,0,0,0,0,0,0,0,0,0,0,0,0,0,0,0,4,1,3,0,0,0,1,0,1,0,0,0
240277,21040,210,40,-2,7,2,5,1,0,1,1,1,0,0,0,0,0,0,0,0,0,0,5,1,4,0,0,0,0,0,0,0,0,0
240329,21040,210,40,-2,1,0,1,0,0,0,1,0,1,0,0,0,0,0,0,0,0,0,0,0,0,0,0,0,0,0,0,0,0,0
240338,21040,210,40,-2,2,2,0,0,0,0,0,0,0,0,0,0,0,0,0,0,0,0,2,2,0,0,0,0,0,0,0,0,0,0
240365,21040,210,40,-2,5,3,2,0,0,0,0,0,0,0,0,0,0,0,0,0,0,0,3,1,2,0,0,0,1,1,0,1,1,0
240374,21040,210,40,-2,11,7,4,0,0,0,1,1,0,0,0,0,0,0,0,0,0,0,7,5,2,0,0,0,1,1,0,2,0,2
240392,21040,210,40,-2,19,1,18,0,0,0,0,0,0,1,0,1,0,0,0,0,0,0,16,1,15,1,0,1,1,0,1,0,0,0
240426,21040,210,40,-2,7,1,6,0,0,0,1,0,1,0,0,0,0,0,0,0,0,0,6,1,5,0,0,0,0,0,0,0,0,0
240444,21040,210,40,-2,141,63,78,0,0,0,16,8,8,7,1,6,6,0,6,0,0,0,95,46,49,3,1,2,6,1,5,8,6,2
240453,21040,210,40,-2,8,2,6,0,0,0,1,0,1,2,0,2,0,0,0,0,0,0,4,1,3,0,0,0,0,0,0,1,1,0
240471,21040,210,40,-2,1,0,1,0,0,0,0,0,0,0,0,0,0,0,0,0,0,0,1,0,1,0,0,0,0,0,0,0,0,0
240480,21040,210,40,-2,8,2,6,0,0,0,0,0,0,0,0,0,0,0,0,0,0,0,8,2,6,0,0,0,0,0,0,0,0,0
240514,21040,210,40,-2,7,4,3,0,0,0,0,0,0,0,0,0,0,0,0,0,0,0,5,2,3,0,0,0,2,2,0,0,0,0
240620,21040,210,40,-2,12,3,9,0,0,0,0,0,0,0,0,0,1,0,1,0,0,0,10,3,7,0,0,0,1,0,1,0,0,0
240657,21040,210,40,-2,3,2,1,0,0,0,0,0,0,0,0,0,0,0,0,0,0,0,3,2,1,0,0,0,0,0,0,0,0,0
240666,21040,210,40,-2,2,1,1,0,0,0,0,0,0,0,0,0,0,0,0,0,0,0,2,1,1,0,0,0,0,0,0,0,0,0
240693,21040,210,40,-2,6,4,2,0,0,0,0,0,0,0,0,0,0,0,0,0,0,0,6,4,2,0,0,0,0,0,0,0,0,0
240718,21040,210,40,-2,14,13,1,0,0,0,0,0,0,0,0,0,0,0,0,0,0,0,14,13,1,0,0,0,0,0,0,0,0,0
240727,21040,210,40,-2,21,8,13,0,0,0,0,0,0,0,0,0,0,0,0,0,0,0,12,3,9,0,0,0,7,4,3,2,1,1
240745,21040,210,40,-2,3,0,3,0,0,0,2,0,2,0,0,0,0,0,0,0,0,0,1,0,1,0,0,0,0,0,0,0,0,0
240754,21040,210,40,-2,3,0,3,0,0,0,2,0,2,0,0,0,0,0,0,1,0,1,0,0,0,0,0,0,0,0,0,0,0,0
240790,21040,210,40,-2,1,1,0,0,0,0,0,0,0,0,0,0,0,0,0,1,1,0,0,0,0,0,0,0,0,0,0,0,0,0
241191,21040,210,40,-2,1,0,1,0,0,0,0,0,0,0,0,0,1,0,1,0,0,0,0,0,0,0,0,0,0,0,0,0,0,0
241225,21040,210,40,-2,3,1,2,0,0,0,0,0,0,0,0,0,3,1,2,0,0,0,0,0,0,0,0,0,0,0,0,0,0,0
241331,21040,210,40,-2,2,1,1,0,0,0,0,0,0,0,0,0,2,1,1,0,0,0,0,0,0,0,0,0,0,0,0,0,0,0
241395,21040,210,40,-2,1,0,1,0,0,0,0,0,0,0,0,0,1,0,1,0,0,0,0,0,0,0,0,0,0,0,0,0,0,0
241410,21040,210,40,-2,5,2,3,0,0,0,0,0,0,0,0,0,5,2,3,0,0,0,0,0,0,0,0,0,0,0,0,0,0,0
241739,21040,210,40,-2,10,2,8,0,0,0,0,0,0,0,0,0,10,2,8,0,0,0,0,0,0,0,0,0,0,0,0,0,0,0
241836,21040,210,40,-2,5,1,4,0,0,0,0,0,0,0,0,0,5,1,4,0,0,0,0,0,0,0,0,0,0,0,0,0,0,0
242130,21040,210,40,-2,1,1,0,0,0,0,0,0,0,0,0,0,1,1,0,0,0,0,0,0,0,0,0,0,0,0,0,0,0,0
242617,21040,210,40,-2,2,0,2,0,0,0,0,0,0,0,0,0,2,0,2,0,0,0,0,0,0,0,0,0,0,0,0,0,0,0
242635,21040,210,40,-2,12,6,6,0,0,0,0,0,0,0,0,0,12,6,6,0,0,0,0,0,0,0,0,0,0,0,0,0,0,0
242644,21040,210,40,-2,5,2,3,0,0,0,0,0,0,0,0,0,5,2,3,0,0,0,0,0,0,0,0,0,0,0,0,0,0,0
242653,21040,210,40,-2,8,3,5,0,0,0,0,0,0,0,0,0,8,3,5,0,0,0,0,0,0,0,0,0,0,0,0,0,0,0
242662,21040,210,40,-2,5,2,3,0,0,0,0,0,0,0,0,0,5,2,3,0,0,0,0,0,0,0,0,0,0,0,0,0,0,0
242680,21040,210,40,-2,3,0,3,0,0,0,0,0,0,0,0,0,3,0,3,0,0,0,0,0,0,0,0,0,0,0,0,0,0,0
242699,21040,210,40,-2,5,5,0,0,0,0,0,0,0,0,0,0,5,5,0,0,0,0,0,0,0,0,0,0,0,0,0,0,0,0
242705,21040,210,40,-2,6,3,3,0,0,0,0,0,0,0,0,0,6,3,3,0,0,0,0,0,0,0,0,0,0,0,0,0,0,0
243081,21040,210,40,-2,5,2,3,0,0,0,0,0,0,0,0,0,5,2,3,0,0,0,0,0,0,0,0,0,0,0,0,0,0,0
243197,21040,210,40,-2,9,5,4,0,0,0,0,0,0,0,0,0,0,0,0,0,0,0,0,0,0,0,0,0,9,5,4,0,0,0
243346,21040,210,40,-2,1,1,0,0,0,0,0,0,0,0,0,0,1,1,0,0,0,0,0,0,0,0,0,0,0,0,0,0,0,0
243443,21040,210,40,-2,15,4,11,0,0,0,0,0,0,0,0,0,15,4,11,0,0,0,0,0,0,0,0,0,0,0,0,0,0,0
243568,21040,210,40,-2,7,3,4,0,0,0,0,0,0,0,0,0,7,3,4,0,0,0,0,0,0,0,0,0,0,0,0,0,0,0
243586,21040,210,40,-2,2,0,2,0,0,0,0,0,0,0,0,0,2,0,2,0,0,0,0,0,0,0,0,0,0,0,0,0,0,0
243601,21040,210,40,-2,3,1,2,0,0,0,0,0,0,0,0,0,2,1,1,0,0,0,1,0,1,0,0,0,0,0,0,0,0,0
243638,21040,210,40,-2,4,4,0,0,0,0,2,2,0,0,0,0,0,0,0,2,2,0,0,0,0,0,0,0,0,0,0,0,0,0
243647,21040,210,40,-2,1,0,1,0,0,0,0,0,0,0,0,0,0,0,0,1,0,1,0,0,0,0,0,0,0,0,0,0,0,0
243744,21040,210,40,-2,44,30,14,0,0,0,16,8,8,2,1,1,1,1,0,0,0,0,17,14,3,2,2,0,6,4,2,0,0,0
243780,21040,210,40,-2,12,10,2,0,0,0,1,0,1,0,0,0,0,0,0,0,0,0,1,1,0,1,1,0,0,0,0,9,8,1
243823,21040,210,40,-2,12,8,4,0,0,0,0,0,0,1,1,0,0,0,0,0,0,0,7,5,2,0,0,0,4,2,2,0,0,0
243832,21040,210,40,-2,9,1,8,0,0,0,0,0,0,0,0,0,9,1,8,0,0,0,0,0,0,0,0,0,0,0,0,0,0,0
244437,21040,210,40,-2,5,4,1,0,0,0,0,0,0,1,1,0,0,0,0,0,0,0,4,3,1,0,0,0,0,0,0,0,0,0
244446,21040,210,40,-2,27,7,20,0,0,0,1,1,0,17,4,13,0,0,0,0,0,0,9,2,7,0,0,0,0,0,0,0,0,0
245953,21040,210,40,-2,4,3,1,0,0,0,0,0,0,1,1,0,0,0,0,0,0,0,3,2,1,0,0,0,0,0,0,0,0,0
246354,21040,210,40,-2,5,2,3,0,0,0,1,0,1,0,0,0,3,1,2,0,0,0,1,1,0,0,0,0,0,0,0,0,0,0
246813,21040,210,40,-2,35,21,14,2,2,0,2,0,2,8,3,5,0,0,0,0,0,0,23,16,7,0,0,0,0,0,0,0,0,0
246974,21040,210,40,-2,5,1,4,0,0,0,0,0,0,0,0,0,2,0,2,0,0,0,3,1,2,0,0,0,0,0,0,0,0,0
247649,21040,210,40,-2,4,0,4,0,0,0,0,0,0,0,0,0,0,0,0,0,0,0,4,0,4,0,0,0,0,0,0,0,0,0
247834,21040,210,40,-2,28,11,17,0,0,0,1,1,0,5,3,2,1,0,1,0,0,0,19,7,12,0,0,0,2,0,2,0,0,0
247940,21040,210,40,-2,4,1,3,0,0,0,0,0,0,0,0,0,0,0,0,0,0,0,4,1,3,0,0,0,0,0,0,0,0,0
248934,21040,210,40,-2,68,11,57,0,0,0,1,1,0,18,2,16,2,1,1,0,0,0,42,5,37,2,1,1,3,1,2,0,0,0
250027,21040,210,40,-2,5,1,4,0,0,0,0,0,0,0,0,0,0,0,0,0,0,0,5,1,4,0,0,0,0,0,0,0,0,0
251312,21040,210,40,-2,1,0,1,0,0,0,0,0,0,0,0,0,0,0,0,0,0,0,1,0,1,0,0,0,0,0,0,0,0,0
260372,21040,210,40,-2,2,1,1,2,1,1,0,0,0,0,0,0,0,0,0,0,0,0,0,0,0,0,0,0,0,0,0,0,0,0
260691,21040,210,40,-2,4,2,2,0,0,0,0,0,0,0,0,0,0,0,0,0,0,0,4,2,2,0,0,0,0,0,0,0,0,0
260789,21040,210,40,-2,5,0,5,0,0,0,1,0,1,0,0,0,2,0,2,0,0,0,2,0,2,0,0,0,0,0,0,0,0,0
260992,21040,210,40,-2,4,0,4,0,0,0,0,0,0,2,0,2,0,0,0,0,0,0,2,0,2,0,0,0,0,0,0,0,0,0
262086,21040,210,40,-2,7,0,7,0,0,0,1,0,1,3,0,3,1,0,1,0,0,0,2,0,2,0,0,0,0,0,0,0,0,0
262129,21040,210,40,-2,2,0,2,0,0,0,1,0,1,0,0,0,0,0,0,0,0,0,0,0,0,0,0,0,0,0,0,1,0,1
363633,21040,210,40,-2,1,0,1,0,0,0,0,0,0,0,0,0,1,0,1,0,0,0,0,0,0,0,0,0,0,0,0,0,0,0
363934,21040,210,40,-2,3,2,1,0,0,0,1,0,1,0,0,0,0,0,0,0,0,0,2,2,0,0,0,0,0,0,0,0,0,0
364016,21040,210,40,-2,7,2,5,0,0,0,0,0,0,1,1,0,1,0,1,0,0,0,4,1,3,1,0,1,0,0,0,0,0,0
364025,21040,210,40,-2,5,2,3,0,0,0,0,0,0,1,0,1,0,0,0,0,0,0,4,2,2,0,0,0,0,0,0,0,0,0
366252,21040,210,40,-2,6,6,0,0,0,0,0,0,0,0,0,0,0,0,0,0,0,0,6,6,0,0,0,0,0,0,0,0,0,0
366270,21040,210,40,-2,3,0,3,0,0,0,0,0,0,2,0,2,0,0,0,0,0,0,1,0,1,0,0,0,0,0,0,0,0,0
366340,21040,210,40,-2,1,0,1,0,0,0,0,0,0,0,0,0,0,0,0,0,0,0,1,0,1,0,0,0,0,0,0,0,0,0
366553,21040,210,40,-2,20,5,15,0,0,0,0,0,0,2,0,2,1,1,0,0,0,0,17,4,13,0,0,0,0,0,0,0,0,0
366711,21040,210,40,-2,3,0,3,0,0,0,0,0,0,0,0,0,1,0,1,0,0,0,2,0,2,0,0,0,0,0,0,0,0,0
367459,21040,210,40,-2,13,2,11,0,0,0,1,0,1,0,0,0,0,0,0,0,0,0,11,2,9,0,0,0,1,0,1,0,0,0
367954,21040,210,40,-2,25,3,22,0,0,0,1,0,1,0,0,0,1,0,1,0,0,0,22,3,19,1,0,1,0,0,0,0,0,0
368629,21040,210,40,-2,2,0,2,0,0,0,0,0,0,0,0,0,1,0,1,0,0,0,1,0,1,0,0,0,0,0,0,0,0,0
368911,21040,210,40,-2,9,3,6,0,0,0,1,1,0,0,0,0,0,0,0,0,0,0,8,2,6,0,0,0,0,0,0,0,0,0
372329,21040,210,40,-2,3,0,3,0,0,0,0,0,0,0,0,0,1,0,1,0,0,0,2,0,2,0,0,0,0,0,0,0,0,0
376695,21040,210,40,-2,4,3,1,0,0,0,0,0,0,0,0,0,0,0,0,1,1,0,3,2,1,0,0,0,0,0,0,0,0,0
377555,21040,210,40,-2,5,2,3,0,0,0,2,1,1,0,0,0,1,0,1,0,0,0,2,1,1,0,0,0,0,0,0,0,0,0
377564,21040,210,40,-2,9,5,4,0,0,0,1,0,1,0,0,0,0,0,0,0,0,0,6,4,2,1,0,1,1,1,0,0,0,0
378105,21040,210,40,-2,5,3,2,0,0,0,0,0,0,0,0,0,3,2,1,0,0,0,2,1,1,0,0,0,0,0,0,0,0,0
378576,21040,210,40,-2,1,0,1,0,0,0,0,0,0,0,0,0,0,0,0,0,0,0,0,0,0,0,0,0,1,0,1,0,0,0
379746,21040,210,40,-2,3,1,2,0,0,0,0,0,0,1,0,1,0,0,0,0,0,0,2,1,1,0,0,0,0,0,0,0,0,0
380359,21040,210,40,-2,3,1,2,1,1,0,0,0,0,0,0,0,0,0,0,0,0,0,2,0,2,0,0,0,0,0,0,0,0,0
380377,21040,210,40,-2,5,2,3,1,1,0,0,0,0,1,1,0,0,0,0,0,0,0,1,0,1,2,0,2,0,0,0,0,0,0
380438,21040,210,40,-2,8,2,6,0,0,0,0,0,0,0,0,0,0,0,0,0,0,0,7,1,6,1,1,0,0,0,0,0,0,0
382957,21040,210,40,-2,6,2,4,0,0,0,0,0,0,1,0,1,0,0,0,0,0,0,3,1,2,0,0,0,2,1,1,0,0,0
384254,21040,210,40,-2,5,1,4,0,0,0,0,0,0,3,1,2,1,0,1,0,0,0,1,0,1,0,0,0,0,0,0,0,0,0
384333,21040,210,40,-2,6,1,5,0,0,0,0,0,0,0,0,0,1,0,1,0,0,0,5,1,4,0,0,0,0,0,0,0,0,0
385415,21040,210,40,-2,1,0,1,0,0,0,0,0,0,0,0,0,0,0,0,0,0,0,1,0,1,0,0,0,0,0,0,0,0,0
385503,21040,210,40,-2,3,0,3,0,0,0,0,0,0,1,0,1,0,0,0,0,0,0,2,0,2,0,0,0,0,0,0,0,0,0
385619,21040,210,40,-2,4,4,0,0,0,0,1,1,0,0,0,0,1,1,0,0,0,0,0,0,0,2,2,0,0,0,0,0,0,0
386472,21040,210,40,-2,3,0,3,0,0,0,0,0,0,1,0,1,0,0,0,0,0,0,1,0,1,0,0,0,1,0,1,0,0,0
392257,21040,210,40,-2,13,1,12,0,0,0,1,0,1,7,0,7,2,1,1,0,0,0,3,0,3,0,0,0,0,0,0,0,0,0
392415,21040,210,40,-2,1,0,1,0,0,0,0,0,0,1,0,1,0,0,0,0,0,0,0,0,0,0,0,0,0,0,0,0,0,0
399869,21040,210,40,-2,1,1,0,0,0,0,0,0,0,0,0,0,0,0,0,0,0,0,1,1,0,0,0,0,0,0,0,0,0,0
399911,21040,210,40,-2,3,1,2,0,0,0,2,0,2,0,0,0,0,0,0,0,0,0,1,1,0,0,0,0,0,0,0,0,0,0
403469,21040,210,40,-2,1,0,1,0,0,0,0,0,0,0,0,0,0,0,0,0,0,0,1,0,1,0,0,0,0,0,0,0,0,0
404222,21040,210,40,-2,1,1,0,0,0,0,0,0,0,0,0,0,1,1,0,0,0,0,0,0,0,0,0,0,0,0,0,0,0,0
404426,21040,210,40,-2,3,1,2,1,1,0,0,0,0,0,0,0,1,0,1,0,0,0,1,0,1,0,0,0,0,0,0,0,0,0
404912,21040,210,40,-2,5,1,4,0,0,0,0,0,0,1,1,0,0,0,0,0,0,0,4,0,4,0,0,0,0,0,0,0,0,0
404994,21040,210,40,-2,6,2,4,0,0,0,0,0,0,0,0,0,3,1,2,0,0,0,3,1,2,0,0,0,0,0,0,0,0,0
405872,21040,210,40,-2,2,1,1,0,0,0,0,0,0,0,0,0,0,0,0,0,0,0,2,1,1,0,0,0,0,0,0,0,0,0
406024,21040,210,40,-2,20,2,18,0,0,0,1,0,1,1,0,1,3,1,2,0,0,0,14,1,13,1,0,1,0,0,0,0,0,0
406033,21040,210,40,-2,20,3,17,0,0,0,3,1,2,0,0,0,7,1,6,0,0,0,9,1,8,0,0,0,1,0,1,0,0,0
407629,21040,210,40,-2,28,15,13,0,0,0,4,2,2,1,0,1,0,0,0,0,0,0,23,13,10,0,0,0,0,0,0,0,0,0
408729,21040,210,40,-2,1,0,1,0,0,0,0,0,0,0,0,0,0,0,0,0,0,0,1,0,1,0,0,0,0,0,0,0,0,0
408844,21040,210,40,-2,13,7,6,0,0,0,0,0,0,2,1,1,11,6,5,0,0,0,0,0,0,0,0,0,0,0,0,0,0,0
409254,21040,210,40,-2,1,0,1,0,0,0,0,0,0,1,0,1,0,0,0,0,0,0,0,0,0,0,0,0,0,0,0,0,0,0
409315,21040,210,40,-2,54,34,20,0,0,0,3,1,2,0,0,0,36,21,15,0,0,0,10,7,3,0,0,0,2,2,0,3,3,0
409698,21040,210,40,-2,2,1,1,0,0,0,0,0,0,0,0,0,1,1,0,0,0,0,1,0,1,0,0,0,0,0,0,0,0,0
412173,21040,210,40,-2,3,0,3,0,0,0,0,0,0,0,0,0,0,0,0,0,0,0,3,0,3,0,0,0,0,0,0,0,0,0
413413,21040,210,40,-2,6,1,5,0,0,0,0,0,0,1,0,1,0,0,0,0,0,0,4,1,3,0,0,0,1,0,1,0,0,0
413626,21040,210,40,-2,1,1,0,0,0,0,0,0,0,0,0,0,0,0,0,0,0,0,1,1,0,0,0,0,0,0,0,0,0,0
414966,21040,210,40,-2,1,0,1,0,0,0,0,0,0,0,0,0,0,0,0,0,0,0,1,0,1,0,0,0,0,0,0,0,0,0
416458,21040,210,40,-2,1,0,1,0,0,0,1,0,1,0,0,0,0,0,0,0,0,0,0,0,0,0,0,0,0,0,0,0,0,0
420398,21040,210,40,-2,2,0,2,0,0,0,1,0,1,0,0,0,0,0,0,0,0,0,1,0,1,0,0,0,0,0,0,0,0,0
420440,21040,210,40,-2,3,0,3,0,0,0,0,0,0,0,0,0,0,0,0,0,0,0,3,0,3,0,0,0,0,0,0,0,0,0
420538,21040,210,40,-2,1,1,0,0,0,0,0,0,0,0,0,0,0,0,0,0,0,0,1,1,0,0,0,0,0,0,0,0,0,0
420556,21040,210,40,-2,4,2,2,0,0,0,0,0,0,0,0,0,1,0,1,0,0,0,3,2,1,0,0,0,0,0,0,0,0,0
422020,21040,210,40,-2,2,2,0,0,0,0,0,0,0,0,0,0,1,1,0,0,0,0,0,0,0,0,0,0,1,1,0,0,0,0
422695,21040,210,40,-2,2,0,2,0,0,0,0,0,0,0,0,0,0,0,0,0,0,0,2,0,2,0,0,0,0,0,0,0,0,0
423643,21040,210,40,-2,4,4,0,0,0,0,0,0,0,2,2,0,0,0,0,0,0,0,2,2,0,0,0,0,0,0,0,0,0,0
423652,21040,210,40,-2,4,1,3,0,0,0,0,0,0,0,0,0,0,0,0,0,0,0,4,1,3,0,0,0,0,0,0,0,0,0
426314,21040,210,40,-2,6,3,3,0,0,0,0,0,0,0,0,0,0,0,0,0,0,0,2,1,1,1,1,0,3,1,2,0,0,0
428170,21040,210,40,-2,8,0,8,0,0,0,1,0,1,2,0,2,3,0,3,0,0,0,2,0,2,0,0,0,0,0,0,0,0,0
428392,21040,210,40,-2,4,1,3,0,0,0,0,0,0,0,0,0,0,0,0,0,0,0,4,1,3,0,0,0,0,0,0,0,0,0
429094,21040,210,40,-2,1,0,1,0,0,0,1,0,1,0,0,0,0,0,0,0,0,0,0,0,0,0,0,0,0,0,0,0,0,0
431141,21040,210,40,-2,21,4,17,0,0,0,1,0,1,1,0,1,6,1,5,1,0,1,11,3,8,0,0,0,1,0,1,0,0,0
433004,21040,210,40,-2,7,5,2,1,1,0,2,1,1,0,0,0,0,0,0,0,0,0,4,3,1,0,0,0,0,0,0,0,0,0
433013,21040,210,40,-2,8,2,6,0,0,0,0,0,0,0,0,0,4,1,3,0,0,0,4,1,3,0,0,0,0,0,0,0,0,0
433174,21040,210,40,-2,8,1,7,0,0,0,1,1,0,1,0,1,0,0,0,0,0,0,6,0,6,0,0,0,0,0,0,0,0,0
433387,21040,210,40,-2,224,88,136,1,1,0,8,3,5,50,25,25,17,3,14,0,0,0,131,48,83,5,3,2,12,5,7,0,0,0
433420,21040,210,40,-2,9,9,0,0,0,0,0,0,0,0,0,0,2,2,0,0,0,0,7,7,0,0,0,0,0,0,0,0,0,0
433536,21040,210,40,-2,3,0,3,0,0,0,0,0,0,1,0,1,0,0,0,0,0,0,2,0,2,0,0,0,0,0,0,0,0,0
433660,21040,210,40,-2,39,16,23,0,0,0,6,2,4,3,1,2,4,1,3,0,0,0,18,9,9,2,0,2,0,0,0,6,3,3
434016,21040,210,40,-2,2,1,1,0,0,0,0,0,0,0,0,0,0,0,0,0,0,0,2,1,1,0,0,0,0,0,0,0,0,0
434061,21040,210,40,-2,20,8,12,0,0,0,1,0,1,10,2,8,0,0,0,1,0,1,7,5,2,0,0,0,0,0,0,1,1,0
434140,21040,210,40,-2,4,1,3,0,0,0,0,0,0,0,0,0,0,0,0,0,0,0,4,1,3,0,0,0,0,0,0,0,0,0
434584,21040,210,40,-2,1,1,0,0,0,0,1,1,0,0,0,0,0,0,0,0,0,0,0,0,0,0,0,0,0,0,0,0,0,0
434672,21040,210,40,-2,14,3,11,0,0,0,2,0,2,4,1,3,1,0,1,0,0,0,6,1,5,0,0,0,0,0,0,1,1,0
434751,21040,210,40,-2,1,1,0,1,1,0,0,0,0,0,0,0,0,0,0,0,0,0,0,0,0,0,0,0,0,0,0,0,0,0
435000,21040,210,40,-2,91,50,41,0,0,0,12,6,6,2,1,1,4,2,2,0,0,0,36,19,17,1,0,1,0,0,0,36,22,14
436304,21040,210,40,-2,12,5,7,0,0,0,0,0,0,4,1,3,1,1,0,0,0,0,7,3,4,0,0,0,0,0,0,0,0,0
436429,21040,210,40,-2,9,0,9,0,0,0,0,0,0,1,0,1,2,0,2,0,0,0,5,0,5,0,0,0,1,0,1,0,0,0
437103,21040,210,40,-2,5,1,4,0,0,0,0,0,0,3,0,3,0,0,0,0,0,0,2,1,1,0,0,0,0,0,0,0,0,0
437635,21040,210,40,-2,18,6,12,0,0,0,0,0,0,3,0,3,7,3,4,0,0,0,7,2,5,1,1,0,0,0,0,0,0,0
437936,21040,210,40,-2,4,3,1,0,0,0,1,1,0,0,0,0,1,1,0,0,0,0,2,1,1,0,0,0,0,0,0,0,0,0
438258,21040,210,40,-2,5,0,5,0,0,0,0,0,0,0,0,0,0,0,0,1,0,1,3,0,3,1,0,1,0,0,0,0,0,0
438708,21040,210,40,-2,3,1,2,0,0,0,0,0,0,0,0,0,0,0,0,0,0,0,3,1,2,0,0,0,0,0,0,0,0,0
439118,21040,210,40,-2,2,0,2,0,0,0,0,0,0,0,0,0,0,0,0,0,0,0,1,0,1,0,0,0,1,0,1,0,0,0
439367,21040,210,40,-2,5,1,4,0,0,0,0,0,0,0,0,0,2,0,2,0,0,0,3,1,2,0,0,0,0,0,0,0,0,0
439446,21040,210,40,-2,1,1,0,0,0,0,1,1,0,0,0,0,0,0,0,0,0,0,0,0,0,0,0,0,0,0,0,0,0,0
439570,21040,210,40,-2,8,1,7,0,0,0,0,0,0,2,0,2,0,0,0,0,0,0,6,1,5,0,0,0,0,0,0,0,0,0
439701,21040,210,40,-2,1,1,0,0,0,0,0,0,0,0,0,0,0,0,0,0,0,0,1,1,0,0,0,0,0,0,0,0,0,0
439738,21040,210,40,-2,1,0,1,0,0,0,0,0,0,1,0,1,0,0,0,0,0,0,0,0,0,0,0,0,0,0,0,0,0,0
439792,21040,210,40,-2,4,0,4,0,0,0,0,0,0,2,0,2,0,0,0,0,0,0,2,0,2,0,0,0,0,0,0,0,0,0
440031,21040,210,40,-2,10,2,8,0,0,0,1,0,1,2,0,2,0,0,0,0,0,0,6,1,5,0,0,0,1,1,0,0,0,0
440262,21040,210,40,-2,1,1,0,0,0,0,0,0,0,0,0,0,1,1,0,0,0,0,0,0,0,0,0,0,0,0,0,0,0,0
440396,21040,210,40,-2,1,0,1,0,0,0,0,0,0,0,0,0,0,0,0,0,0,0,1,0,1,0,0,0,0,0,0,0,0,0
440402,21040,210,40,-2,12,4,8,0,0,0,0,0,0,0,0,0,1,1,0,0,0,0,11,3,8,0,0,0,0,0,0,0,0,0
440794,21040,210,40,-2,1,0,1,0,0,0,0,0,0,1,0,1,0,0,0,0,0,0,0,0,0,0,0,0,0,0,0,0,0,0
440916,21040,210,40,-2,13,7,6,0,0,0,1,1,0,7,2,5,0,0,0,0,0,0,5,4,1,0,0,0,0,0,0,0,0,0
441025,21040,210,40,-2,3,3,0,0,0,0,0,0,0,0,0,0,0,0,0,0,0,0,3,3,0,0,0,0,0,0,0,0,0,0
441131,21040,210,40,-2,1,1,0,0,0,0,0,0,0,0,0,0,0,0,0,0,0,0,1,1,0,0,0,0,0,0,0,0,0,0
441371,21040,210,40,-2,50,9,41,0,0,0,1,0,1,20,2,18,3,2,1,0,0,0,23,5,18,1,0,1,2,0,2,0,0,0
441423,21040,210,40,-2,3,2,1,0,0,0,0,0,0,0,0,0,3,2,1,0,0,0,0,0,0,0,0,0,0,0,0,0,0,0
441609,21040,210,40,-2,1,1,0,0,0,0,0,0,0,0,0,0,0,0,0,0,0,0,1,1,0,0,0,0,0,0,0,0,0,0
441636,21040,210,40,-2,4,1,3,0,0,0,0,0,0,1,0,1,0,0,0,0,0,0,3,1,2,0,0,0,0,0,0,0,0,0
441742,21040,210,40,-2,2,1,1,0,0,0,1,1,0,1,0,1,0,0,0,0,0,0,0,0,0,0,0,0,0,0,0,0,0,0
441760,21040,210,40,-2,4,0,4,1,0,1,0,0,0,0,0,0,0,0,0,0,0,0,3,0,3,0,0,0,0,0,0,0,0,0
441900,21040,210,40,-2,6,1,5,0,0,0,0,0,0,0,0,0,1,0,1,0,0,0,5,1,4,0,0,0,0,0,0,0,0,0
441937,21040,210,40,-2,1,1,0,0,0,0,0,0,0,0,0,0,0,0,0,0,0,0,0,0,0,1,1,0,0,0,0,0,0,0
441982,21040,210,40,-2,1,0,1,0,0,0,0,0,0,0,0,0,1,0,1,0,0,0,0,0,0,0,0,0,0,0,0,0,0,0
442134,21040,210,40,-2,2,0,2,0,0,0,0,0,0,0,0,0,1,0,1,0,0,0,1,0,1,0,0,0,0,0,0,0,0,0
442356,21040,210,40,-2,16,0,16,0,0,0,1,0,1,0,0,0,0,0,0,0,0,0,15,0,15,0,0,0,0,0,0,0,0,0
442426,21040,210,40,-2,2,1,1,0,0,0,0,0,0,0,0,0,0,0,0,0,0,0,2,1,1,0,0,0,0,0,0,0,0,0
442444,21040,210,40,-2,4,2,2,0,0,0,0,0,0,0,0,0,0,0,0,0,0,0,3,2,1,0,0,0,1,0,1,0,0,0
442602,21040,210,40,-2,5,0,5,0,0,0,0,0,0,0,0,0,1,0,1,0,0,0,3,0,3,1,0,1,0,0,0,0,0,0
442781,21040,210,40,-2,4,2,2,2,0,2,2,2,0,0,0,0,0,0,0,0,0,0,0,0,0,0,0,0,0,0,0,0,0,0
442806,21040,210,40,-2,7,4,3,0,0,0,1,0,1,1,0,1,0,0,0,0,0,0,5,4,1,0,0,0,0,0,0,0,0,0
442930,21040,210,40,-2,1,0,1,0,0,0,0,0,0,0,0,0,0,0,0,0,0,0,1,0,1,0,0,0,0,0,0,0,0,0
443128,21040,210,40,-2,1,1,0,0,0,0,0,0,0,0,0,0,0,0,0,0,0,0,1,1,0,0,0,0,0,0,0,0,0,0
443261,21040,210,40,-2,5,1,4,0,0,0,0,0,0,3,1,2,0,0,0,0,0,0,2,0,2,0,0,0,0,0,0,0,0,0
443377,21040,210,40,-2,3,3,0,0,0,0,0,0,0,0,0,0,0,0,0,0,0,0,3,3,0,0,0,0,0,0,0,0,0,0
443410,21040,210,40,-2,3,1,2,0,0,0,0,0,0,0,0,0,0,0,0,0,0,0,3,1,2,0,0,0,0,0,0,0,0,0
443492,21040,210,40,-2,2,1,1,0,0,0,0,0,0,0,0,0,0,0,0,0,0,0,2,1,1,0,0,0,0,0,0,0,0,0
443599,21040,210,40,-2,1,1,0,0,0,0,0,0,0,0,0,0,0,0,0,0,0,0,1,1,0,0,0,0,0,0,0,0,0,0
443650,21040,210,40,-2,3,1,2,0,0,0,0,0,0,0,0,0,0,0,0,0,0,0,3,1,2,0,0,0,0,0,0,0,0,0
443748,21040,210,40,-2,1,0,1,0,0,0,0,0,0,1,0,1,0,0,0,0,0,0,0,0,0,0,0,0,0,0,0,0,0,0
444088,21040,210,40,-2,4,0,4,1,0,1,0,0,0,0,0,0,1,0,1,1,0,1,1,0,1,0,0,0,0,0,0,0,0,0
444130,21040,210,40,-2,6,3,3,0,0,0,0,0,0,2,1,1,0,0,0,0,0,0,4,2,2,0,0,0,0,0,0,0,0,0
444556,21040,210,40,-2,5,3,2,0,0,0,0,0,0,0,0,0,0,0,0,1,0,1,1,0,1,1,1,0,2,2,0,0,0,0
444787,21040,210,40,-2,65,7,58,0,0,0,1,0,1,10,0,10,0,0,0,0,0,0,47,5,42,0,0,0,7,2,5,0,0,0
444811,21040,210,40,-2,3,1,2,0,0,0,0,0,0,2,1,1,0,0,0,0,0,0,1,0,1,0,0,0,0,0,0,0,0,0
444866,21040,210,40,-2,3,0,3,0,0,0,0,0,0,1,0,1,0,0,0,0,0,0,1,0,1,1,0,1,0,0,0,0,0,0
444954,21040,210,40,-2,7,3,4,0,0,0,0,0,0,0,0,0,1,0,1,0,0,0,6,3,3,0,0,0,0,0,0,0,0,0
445188,21040,210,40,-2,12,6,6,0,0,0,0,0,0,1,1,0,1,0,1,0,0,0,6,2,4,1,0,1,2,2,0,1,1,0
445230,21040,210,40,-2,4,2,2,0,0,0,0,0,0,1,0,1,1,1,0,0,0,0,2,1,1,0,0,0,0,0,0,0,0,0
445692,21040,210,40,-2,2,2,0,0,0,0,0,0,0,0,0,0,0,0,0,0,0,0,2,2,0,0,0,0,0,0,0,0,0,0
445735,21040,210,40,-2,9,4,5,0,0,0,0,0,0,0,0,0,3,2,1,0,0,0,6,2,4,0,0,0,0,0,0,0,0,0
445744,21040,210,40,-2,1,0,1,0,0,0,0,0,0,0,0,0,0,0,0,0,0,0,1,0,1,0,0,0,0,0,0,0,0,0
445869,21040,210,40,-2,5,2,3,0,0,0,0,0,0,1,0,1,0,0,0,0,0,0,3,2,1,0,0,0,1,0,1,0,0,0
445948,21040,210,40,-2,30,11,19,0,0,0,1,0,1,6,2,4,9,1,8,1,1,0,10,4,6,2,2,0,1,1,0,0,0,0
446048,21040,210,40,-2,9,6,3,0,0,0,1,0,1,0,0,0,1,1,0,0,0,0,7,5,2,0,0,0,0,0,0,0,0,0
446118,21040,210,40,-2,14,3,11,0,0,0,3,1,2,3,0,3,4,1,3,0,0,0,4,1,3,0,0,0,0,0,0,0,0,0
446127,21040,210,40,-2,1,0,1,0,0,0,0,0,0,0,0,0,0,0,0,0,0,0,1,0,1,0,0,0,0,0,0,0,0,0
446385,21040,210,40,-2,1,0,1,0,0,0,1,0,1,0,0,0,0,0,0,0,0,0,0,0,0,0,0,0,0,0,0,0,0,0
446552,21040,210,40,-2,18,10,8,0,0,0,0,0,0,1,1,0,4,3,1,0,0,0,12,5,7,1,1,0,0,0,0,0,0,0
446561,21040,210,40,-2,8,4,4,0,0,0,1,0,1,1,1,0,1,1,0,0,0,0,5,2,3,0,0,0,0,0,0,0,0,0
446604,21040,210,40,-2,12,12,0,0,0,0,0,0,0,0,0,0,0,0,0,0,0,0,12,12,0,0,0,0,0,0,0,0,0,0
446640,21040,210,40,-2,6,6,0,0,0,0,1,1,0,0,0,0,0,0,0,0,0,0,3,3,0,0,0,0,2,2,0,0,0,0
446774,21040,210,40,-2,7,3,4,0,0,0,0,0,0,0,0,0,0,0,0,0,0,0,7,3,4,0,0,0,0,0,0,0,0,0
447014,21040,210,40,-2,1,0,1,0,0,0,0,0,0,0,0,0,0,0,0,0,0,0,1,0,1,0,0,0,0,0,0,0,0,0
447263,21040,210,40,-2,43,5,38,0,0,0,1,0,1,2,1,1,0,0,0,0,0,0,27,2,25,0,0,0,13,2,11,0,0,0
447351,21040,210,40,-2,4,1,3,0,0,0,0,0,0,0,0,0,1,0,1,0,0,0,3,1,2,0,0,0,0,0,0,0,0,0
447582,21040,210,40,-2,8,3,5,0,0,0,0,0,0,1,1,0,0,0,0,0,0,0,7,2,5,0,0,0,0,0,0,0,0,0
447591,21040,210,40,-2,7,1,6,0,0,0,0,0,0,5,0,5,0,0,0,0,0,0,1,0,1,1,1,0,0,0,0,0,0,0
447689,21040,210,40,-2,13,4,9,0,0,0,0,0,0,3,1,2,0,0,0,0,0,0,10,3,7,0,0,0,0,0,0,0,0,0
447953,21040,210,40,-2,2,2,0,0,0,0,1,1,0,0,0,0,1,1,0,0,0,0,0,0,0,0,0,0,0,0,0,0,0,0
448354,21040,210,40,-2,2,1,1,0,0,0,0,0,0,0,0,0,0,0,0,0,0,0,2,1,1,0,0,0,0,0,0,0,0,0
448594,21040,210,40,-2,1,0,1,0,0,0,0,0,0,0,0,0,0,0,0,0,0,0,0,0,0,0,0,0,1,0,1,0,0,0
448600,21040,210,40,-2,7,1,6,0,0,0,0,0,0,0,0,0,0,0,0,0,0,0,7,1,6,0,0,0,0,0,0,0,0,0
448673,21040,210,40,-2,15,3,12,0,0,0,1,1,0,0,0,0,1,0,1,0,0,0,12,2,10,0,0,0,1,0,1,0,0,0
448859,21040,210,40,-2,2,2,0,0,0,0,0,0,0,0,0,0,0,0,0,0,0,0,2,2,0,0,0,0,0,0,0,0,0,0
449074,21040,210,40,-2,4,1,3,0,0,0,0,0,0,0,0,0,1,0,1,0,0,0,2,1,1,1,0,1,0,0,0,0,0,0
449250,21040,210,40,-2,8,1,7,0,0,0,0,0,0,1,0,1,2,0,2,1,0,1,4,1,3,0,0,0,0,0,0,0,0,0
449339,21040,210,40,-2,3,1,2,0,0,0,0,0,0,0,0,0,1,0,1,0,0,0,1,0,1,0,0,0,1,1,0,0,0,0
449524,21040,210,40,-2,3,0,3,0,0,0,0,0,0,0,0,0,0,0,0,0,0,0,3,0,3,0,0,0,0,0,0,0,0,0
449728,21040,210,40,-2,2,0,2,0,0,0,0,0,0,0,0,0,0,0,0,0,0,0,2,0,2,0,0,0,0,0,0,0,0,0
449764,21040,210,40,-2,1,1,0,0,0,0,0,0,0,0,0,0,0,0,0,0,0,0,1,1,0,0,0,0,0,0,0,0,0,0
449889,21040,210,40,-2,4,0,4,0,0,0,0,0,0,1,0,1,0,0,0,0,0,0,3,0,3,0,0,0,0,0,0,0,0,0
449898,21040,210,40,-2,4,1,3,0,0,0,0,0,0,1,0,1,0,0,0,0,0,0,3,1,2,0,0,0,0,0,0,0,0,0
449922,21040,210,40,-2,1,1,0,0,0,0,1,1,0,0,0,0,0,0,0,0,0,0,0,0,0,0,0,0,0,0,0,0,0,0
450058,21040,210,40,-2,15,2,13,0,0,0,1,0,1,2,0,2,0,0,0,0,0,0,11,2,9,1,0,1,0,0,0,0,0,0
450067,21040,210,40,-2,4,0,4,0,0,0,0,0,0,0,0,0,0,0,0,0,0,0,4,0,4,0,0,0,0,0,0,0,0,0
450571,21040,210,40,-2,1,0,1,0,0,0,0,0,0,0,0,0,0,0,0,0,0,0,1,0,1,0,0,0,0,0,0,0,0,0
450696,21040,210,40,-2,5,1,4,0,0,0,0,0,0,1,1,0,1,0,1,0,0,0,3,0,3,0,0,0,0,0,0,0,0,0
450702,21040,210,40,-2,2,0,2,0,0,0,0,0,0,0,0,0,0,0,0,0,0,0,2,0,2,0,0,0,0,0,0,0,0,0
450933,21040,210,40,-2,4,0,4,0,0,0,0,0,0,1,0,1,0,0,0,0,0,0,3,0,3,0,0,0,0,0,0,0,0,0
451103,21040,210,40,-2,3,0,3,0,0,0,0,0,0,0,0,0,3,0,3,0,0,0,0,0,0,0,0,0,0,0,0,0,0,0
451404,21040,210,40,-2,6,6,0,0,0,0,0,0,0,0,0,0,0,0,0,0,0,0,6,6,0,0,0,0,0,0,0,0,0,0
451510,21040,210,40,-2,2,1,1,0,0,0,0,0,0,0,0,0,0,0,0,0,0,0,2,1,1,0,0,0,0,0,0,0,0,0
451750,21040,210,40,-2,8,0,8,0,0,0,1,0,1,1,0,1,0,0,0,0,0,0,6,0,6,0,0,0,0,0,0,0,0,0
451927,21040,210,40,-2,1,1,0,0,0,0,0,0,0,0,0,0,0,0,0,0,0,0,1,1,0,0,0,0,0,0,0,0,0,0
452124,21040,210,40,-2,5,0,5,0,0,0,0,0,0,1,0,1,0,0,0,0,0,0,4,0,4,0,0,0,0,0,0,0,0,0
452373,21040,210,40,-2,1,0,1,0,0,0,0,0,0,1,0,1,0,0,0,0,0,0,0,0,0,0,0,0,0,0,0,0,0,0
452948,21040,210,40,-2,6,0,6,0,0,0,0,0,0,1,0,1,0,0,0,0,0,0,5,0,5,0,0,0,0,0,0,0,0,0
454218,21040,210,40,-2,75,11,64,0,0,0,4,2,2,18,3,15,4,1,3,0,0,0,41,4,37,3,0,3,5,1,4,0,0,0
454786,21040,210,40,-2,3,1,2,0,0,0,0,0,0,1,0,1,0,0,0,0,0,0,2,1,1,0,0,0,0,0,0,0,0,0
454810,21040,210,40,-2,64,32,32,1,0,1,3,0,3,5,1,4,2,2,0,0,0,0,46,26,20,5,2,3,2,1,1,0,0,0
454829,21040,210,40,-2,13,0,13,0,0,0,1,0,1,0,0,0,0,0,0,0,0,0,11,0,11,0,0,0,1,0,1,0,0,0
454856,21040,210,40,-2,2,0,2,0,0,0,0,0,0,0,0,0,0,0,0,0,0,0,2,0,2,0,0,0,0,0,0,0,0,0
455114,21040,210,40,-2,19,13,6,0,0,0,0,0,0,0,0,0,1,1,0,0,0,0,17,11,6,0,0,0,1,1,0,0,0,0
455196,21040,210,40,-2,15,1,14,0,0,0,0,0,0,5,1,4,2,0,2,0,0,0,8,0,8,0,0,0,0,0,0,0,0,0
455257,21040,210,40,-2,1,1,0,0,0,0,0,0,0,0,0,0,0,0,0,0,0,0,1,1,0,0,0,0,0,0,0,0,0,0
455406,21040,210,40,-2,5,2,3,0,0,0,0,0,0,0,0,0,0,0,0,0,0,0,4,1,3,1,1,0,0,0,0,0,0,0
455433,21040,210,40,-2,1,1,0,0,0,0,0,0,0,0,0,0,0,0,0,0,0,0,0,0,0,1,1,0,0,0,0,0,0,0
455479,21040,210,40,-2,3,1,2,0,0,0,0,0,0,0,0,0,0,0,0,0,0,0,3,1,2,0,0,0,0,0,0,0,0,0
455628,21040,210,40,-2,6,3,3,0,0,0,0,0,0,5,2,3,0,0,0,0,0,0,1,1,0,0,0,0,0,0,0,0,0,0
455664,21040,210,40,-2,12,4,8,0,0,0,0,0,0,2,0,2,1,1,0,0,0,0,7,2,5,2,1,1,0,0,0,0,0,0
455804,21040,210,40,-2,3,2,1,0,0,0,0,0,0,0,0,0,0,0,0,0,0,0,3,2,1,0,0,0,0,0,0,0,0,0
455813,21040,210,40,-2,1,0,1,0,0,0,0,0,0,0,0,0,0,0,0,0,0,0,1,0,1,0,0,0,0,0,0,0,0,0
456038,21040,210,40,-2,2,0,2,0,0,0,0,0,0,0,0,0,1,0,1,0,0,0,1,0,1,0,0,0,0,0,0,0,0,0
456205,21040,210,40,-2,5,2,3,0,0,0,0,0,0,1,0,1,0,0,0,0,0,0,4,2,2,0,0,0,0,0,0,0,0,0
456214,21040,210,40,-2,4,3,1,0,0,0,0,0,0,0,0,0,1,1,0,0,0,0,3,2,1,0,0,0,0,0,0,0,0,0
456454,21040,210,40,-2,5,3,2,0,0,0,0,0,0,0,0,0,0,0,0,0,0,0,5,3,2,0,0,0,0,0,0,0,0,0
456490,21040,210,40,-2,1,1,0,0,0,0,0,0,0,0,0,0,1,1,0,0,0,0,0,0,0,0,0,0,0,0,0,0,0,0
456579,21040,210,40,-2,2,1,1,0,0,0,0,0,0,0,0,0,0,0,0,0,0,0,2,1,1,0,0,0,0,0,0,0,0,0
456852,21040,210,40,-2,1,1,0,0,0,0,0,0,0,1,1,0,0,0,0,0,0,0,0,0,0,0,0,0,0,0,0,0,0,0
457086,21040,210,40,-2,1,1,0,0,0,0,1,1,0,0,0,0,0,0,0,0,0,0,0,0,0,0,0,0,0,0,0,0,0,0
457101,21040,210,40,-2,8,2,6,0,0,0,1,1,0,1,0,1,1,1,0,0,0,0,4,0,4,0,0,0,1,0,1,0,0,0
457110,21040,210,40,-2,1,0,1,0,0,0,0,0,0,0,0,0,0,0,0,0,0,0,1,0,1,0,0,0,0,0,0,0,0,0
457299,21040,210,40,-2,3,1,2,0,0,0,1,0,1,0,0,0,2,1,1,0,0,0,0,0,0,0,0,0,0,0,0,0,0,0
457527,21040,210,40,-2,4,0,4,0,0,0,0,0,0,0,0,0,1,0,1,0,0,0,3,0,3,0,0,0,0,0,0,0,0,0
458210,21040,210,40,-2,5,2,3,0,0,0,2,0,2,0,0,0,1,1,0,0,0,0,2,1,1,0,0,0,0,0,0,0,0,0
458229,21040,210,40,-2,3,0,3,0,0,0,0,0,0,0,0,0,1,0,1,0,0,0,2,0,2,0,0,0,0,0,0,0,0,0
458405,21040,210,40,-2,3,2,1,0,0,0,0,0,0,2,2,0,0,0,0,0,0,0,0,0,0,1,0,1,0,0,0,0,0,0
458441,21040,210,40,-2,1,0,1,0,0,0,0,0,0,1,0,1,0,0,0,0,0,0,0,0,0,0,0,0,0,0,0,0,0,0
458681,21040,210,40,-2,5,2,3,0,0,0,0,0,0,1,1,0,0,0,0,0,0,0,4,1,3,0,0,0,0,0,0,0,0,0
459204,21040,210,40,-2,22,1,21,0,0,0,8,0,8,3,0,3,0,0,0,0,0,0,10,1,9,1,0,1,0,0,0,0,0,0
459213,21040,210,40,-2,14,2,12,0,0,0,3,0,3,0,0,0,1,0,1,1,0,1,6,1,5,0,0,0,3,1,2,0,0,0
459259,21040,210,40,-2,4,0,4,0,0,0,2,0,2,1,0,1,0,0,0,0,0,0,1,0,1,0,0,0,0,0,0,0,0,0
459268,21040,210,40,-2,2,0,2,0,0,0,0,0,0,1,0,1,0,0,0,0,0,0,1,0,1,0,0,0,0,0,0,0,0,0
459727,21040,210,40,-2,3,1,2,0,0,0,0,0,0,1,0,1,0,0,0,0,0,0,2,1,1,0,0,0,0,0,0,0,0,0
459736,21040,210,40,-2,2,0,2,0,0,0,0,0,0,0,0,0,0,0,0,0,0,0,1,0,1,1,0,1,0,0,0,0,0,0
459745,21040,210,40,-2,2,0,2,0,0,0,1,0,1,0,0,0,0,0,0,0,0,0,1,0,1,0,0,0,0,0,0,0,0,0
459824,21040,210,40,-2,9,2,7,0,0,0,1,0,1,1,0,1,0,0,0,0,0,0,7,2,5,0,0,0,0,0,0,0,0,0
459842,21040,210,40,-2,4,1,3,0,0,0,0,0,0,1,0,1,0,0,0,0,0,0,3,1,2,0,0,0,0,0,0,0,0,0
459851,21040,210,40,-2,6,2,4,0,0,0,0,0,0,0,0,0,0,0,0,0,0,0,6,2,4,0,0,0,0,0,0,0,0,0
459949,21040,210,40,-2,19,10,9,0,0,0,0,0,0,0,0,0,8,6,2,0,0,0,9,4,5,0,0,0,1,0,1,1,0,1
460020,21040,210,40,-2,1,0,1,0,0,0,0,0,0,1,0,1,0,0,0,0,0,0,0,0,0,0,0,0,0,0,0,0,0,0
460136,21040,210,40,-2,8,0,8,0,0,0,0,0,0,3,0,3,2,0,2,0,0,0,2,0,2,1,0,1,0,0,0,0,0,0
460181,21040,210,40,-2,1,0,1,0,0,0,0,0,0,0,0,0,0,0,0,0,0,0,1,0,1,0,0,0,0,0,0,0,0,0
460206,21040,210,40,-2,4,2,2,0,0,0,0,0,0,0,0,0,2,2,0,0,0,0,2,0,2,0,0,0,0,0,0,0,0,0
460677,21040,210,40,-2,3,0,3,0,0,0,0,0,0,0,0,0,3,0,3,0,0,0,0,0,0,0,0,0,0,0,0,0,0,0
460738,21040,210,40,-2,2,0,2,0,0,0,0,0,0,0,0,0,0,0,0,0,0,0,1,0,1,0,0,0,1,0,1,0,0,0
460756,21040,210,40,-2,1,0,1,0,0,0,1,0,1,0,0,0,0,0,0,0,0,0,0,0,0,0,0,0,0,0,0,0,0,0
460826,21040,210,40,-2,6,1,5,0,0,0,0,0,0,5,1,4,1,0,1,0,0,0,0,0,0,0,0,0,0,0,0,0,0,0
460835,21040,210,40,-2,3,1,2,0,0,0,0,0,0,0,0,0,0,0,0,0,0,0,3,1,2,0,0,0,0,0,0,0,0,0
461148,21040,210,40,-2,3,0,3,0,0,0,0,0,0,0,0,0,1,0,1,0,0,0,2,0,2,0,0,0,0,0,0,0,0,0
461218,21040,210,40,-2,1,0,1,0,0,0,0,0,0,0,0,0,0,0,0,0,0,0,1,0,1,0,0,0,0,0,0,0,0,0
461689,21040,210,40,-2,5,3,2,0,0,0,0,0,0,0,0,0,1,1,0,0,0,0,4,2,2,0,0,0,0,0,0,0,0,0
461795,21040,210,40,-2,4,3,1,0,0,0,2,1,1,1,1,0,0,0,0,0,0,0,1,1,0,0,0,0,0,0,0,0,0,0
464226,21040,210,40,-2,4,1,3,0,0,0,0,0,0,0,0,0,2,1,1,0,0,0,2,0,2,0,0,0,0,0,0,0,0,0
475033,21040,210,40,-2,9,2,7,0,0,0,1,0,1,2,0,2,3,2,1,0,0,0,3,0,3,0,0,0,0,0,0,0,0,0
475121,21040,210,40,-2,16,1,15,1,0,1,0,0,0,2,0,2,0,0,0,0,0,0,13,1,12,0,0,0,0,0,0,0,0,0
475176,21040,210,40,-2,2,1,1,0,0,0,0,0,0,0,0,0,0,0,0,0,0,0,0,0,0,2,1,1,0,0,0,0,0,0
475398,21040,210,40,-2,1,0,1,0,0,0,0,0,0,0,0,0,0,0,0,0,0,0,1,0,1,0,0,0,0,0,0,0,0,0
475495,21040,210,40,-2,11,5,6,0,0,0,0,0,0,0,0,0,1,1,0,0,0,0,10,4,6,0,0,0,0,0,0,0,0,0
475608,21040,210,40,-2,4,2,2,0,0,0,0,0,0,0,0,0,0,0,0,0,0,0,4,2,2,0,0,0,0,0,0,0,0,0
475714,21040,210,40,-2,1,0,1,0,0,0,0,0,0,0,0,0,1,0,1,0,0,0,0,0,0,0,0,0,0,0,0,0,0,0
476717,21040,210,40,-2,1,1,0,0,0,0,0,0,0,0,0,0,0,0,0,0,0,0,1,1,0,0,0,0,0,0,0,0,0,0
476726,21040,210,40,-2,11,3,8,0,0,0,0,0,0,0,0,0,10,3,7,1,0,1,0,0,0,0,0,0,0,0,0,0,0,0
476975,21040,210,40,-2,2,1,1,0,0,0,0,0,0,0,0,0,0,0,0,0,0,0,2,1,1,0,0,0,0,0,0,0,0,0
477039,21040,210,40,-2,12,0,12,0,0,0,1,0,1,5,0,5,2,0,2,0,0,0,4,0,4,0,0,0,0,0,0,0,0,0
480073,21040,210,40,-2,3,1,2,0,0,0,1,1,0,0,0,0,0,0,0,0,0,0,2,0,2,0,0,0,0,0,0,0,0,0
480657,21040,210,40,-2,1,0,1,0,0,0,0,0,0,0,0,0,0,0,0,0,0,0,1,0,1,0,0,0,0,0,0,0,0,0
480790,21040,210,40,-2,6,3,3,0,0,0,1,0,1,0,0,0,0,0,0,0,0,0,5,3,2,0,0,0,0,0,0,0,0,0
480824,21040,210,40,-2,4,0,4,0,0,0,0,0,0,1,0,1,1,0,1,0,0,0,2,0,2,0,0,0,0,0,0,0,0,0
480833,21040,210,40,-2,5,1,4,0,0,0,0,0,0,2,0,2,1,1,0,0,0,0,2,0,2,0,0,0,0,0,0,0,0,0
480967,21040,210,40,-2,2,1,1,2,1,1,0,0,0,0,0,0,0,0,0,0,0,0,0,0,0,0,0,0,0,0,0,0,0,0
481535,21040,210,40,-2,2,2,0,0,0,0,1,1,0,0,0,0,0,0,0,0,0,0,0,0,0,0,0,0,0,0,0,1,1,0
481775,21040,210,40,-2,1,1,0,0,0,0,0,0,0,0,0,0,1,1,0,0,0,0,0,0,0,0,0,0,0,0,0,0,0,0
482149,21040,210,40,-2,63,33,30,0,0,0,9,4,5,4,1,3,6,3,3,0,0,0,33,18,15,0,0,0,2,2,0,9,5,4
482158,21040,210,40,-2,3,1,2,0,0,0,0,0,0,0,0,0,0,0,0,0,0,0,3,1,2,0,0,0,0,0,0,0,0,0
482477,21040,210,40,-2,1,1,0,0,0,0,0,0,0,0,0,0,0,0,0,0,0,0,1,1,0,0,0,0,0,0,0,0,0,0
482635,21040,210,40,-2,1,1,0,0,0,0,0,0,0,0,0,0,0,0,0,0,0,0,1,1,0,0,0,0,0,0,0,0,0,0
482680,21040,210,40,-2,22,14,8,0,0,0,0,0,0,1,0,1,1,0,1,0,0,0,17,12,5,0,0,0,3,2,1,0,0,0
482699,21040,210,40,-2,1,1,0,0,0,0,0,0,0,0,0,0,0,0,0,0,0,0,1,1,0,0,0,0,0,0,0,0,0,0
482705,21040,210,40,-2,9,5,4,0,0,0,0,0,0,1,1,0,0,0,0,0,0,0,1,1,0,0,0,0,5,2,3,2,1,1
482936,21040,210,40,-2,12,10,2,0,0,0,2,1,1,0,0,0,0,0,0,0,0,0,6,5,1,0,0,0,0,0,0,4,4,0
483036,21040,210,40,-2,3,2,1,0,0,0,1,0,1,0,0,0,0,0,0,0,0,0,0,0,0,0,0,0,0,0,0,2,2,0
483045,21040,210,40,-2,25,13,12,0,0,0,0,0,0,4,1,3,0,0,0,1,1,0,20,11,9,0,0,0,0,0,0,0,0,0
483124,21040,210,40,-2,61,26,35,0,0,0,2,0,2,2,1,1,5,1,4,0,0,0,31,16,15,1,0,1,17,6,11,3,2,1
483212,21040,210,40,-2,24,12,12,0,0,0,0,0,0,6,3,3,0,0,0,0,0,0,15,6,9,2,2,0,0,0,0,1,1,0
483595,21040,210,40,-2,32,15,17,0,0,0,0,0,0,0,0,0,31,15,16,0,0,0,1,0,1,0,0,0,0,0,0,0,0,0
483975,21040,210,40,-2,7,5,2,0,0,0,0,0,0,1,1,0,0,0,0,0,0,0,6,4,2,0,0,0,0,0,0,0,0,0
484002,21040,210,40,-2,17,5,12,1,1,0,3,0,3,2,0,2,4,2,2,0,0,0,7,2,5,0,0,0,0,0,0,0,0,0
484066,21040,210,40,-2,6,0,6,0,0,0,0,0,0,0,0,0,0,0,0,0,0,0,6,0,6,0,0,0,0,0,0,0,0,0
484613,21040,210,40,-2,7,2,5,0,0,0,1,0,1,2,1,1,0,0,0,0,0,0,3,1,2,0,0,0,1,0,1,0,0,0
484844,21040,210,40,-2,1,0,1,0,0,0,1,0,1,0,0,0,0,0,0,0,0,0,0,0,0,0,0,0,0,0,0,0,0,0
484905,21040,210,40,-2,5,2,3,0,0,0,0,0,0,1,0,1,0,0,0,0,0,0,4,2,2,0,0,0,0,0,0,0,0,0
484932,21040,210,40,-2,2,1,1,0,0,0,0,0,0,0,0,0,0,0,0,0,0,0,2,1,1,0,0,0,0,0,0,0,0,0
485111,21040,210,40,-2,1,0,1,0,0,0,0,0,0,0,0,0,0,0,0,0,0,0,1,0,1,0,0,0,0,0,0,0,0,0
485272,21040,210,40,-2,2,0,2,0,0,0,0,0,0,0,0,0,1,0,1,0,0,0,1,0,1,0,0,0,0,0,0,0,0,0
485458,21040,210,40,-2,18,9,9,0,0,0,1,0,1,1,1,0,0,0,0,0,0,0,16,8,8,0,0,0,0,0,0,0,0,0
485698,21040,210,40,-2,5,4,1,0,0,0,0,0,0,1,1,0,0,0,0,0,0,0,4,3,1,0,0,0,0,0,0,0,0,0
485768,21040,210,40,-2,8,7,1,0,0,0,0,0,0,2,1,1,5,5,0,0,0,0,1,1,0,0,0,0,0,0,0,0,0,0
486053,21040,210,40,-2,2,2,0,0,0,0,0,0,0,0,0,0,0,0,0,0,0,0,2,2,0,0,0,0,0,0,0,0,0,0
486813,21040,210,40,-2,4,2,2,0,0,0,0,0,0,0,0,0,2,1,1,0,0,0,2,1,1,0,0,0,0,0,0,0,0,0
486822,21040,210,40,-2,14,3,11,0,0,0,0,0,0,0,0,0,4,1,3,0,0,0,10,2,8,0,0,0,0,0,0,0,0,0
486840,21040,210,40,-2,82,34,48,0,0,0,9,4,5,7,4,3,3,3,0,0,0,0,57,21,36,0,0,0,1,1,0,5,1,4
486901,21040,210,40,-2,2,0,2,0,0,0,0,0,0,1,0,1,0,0,0,0,0,0,1,0,1,0,0,0,0,0,0,0,0,0
487010,21040,210,40,-2,92,55,37,0,0,0,15,11,4,6,1,5,2,1,1,0,0,0,52,33,19,0,0,0,0,0,0,17,9,8
487162,21040,210,40,-2,16,9,7,0,0,0,0,0,0,4,3,1,0,0,0,0,0,0,12,6,6,0,0,0,0,0,0,0,0,0
487302,21040,210,40,-2,2,0,2,0,0,0,0,0,0,0,0,0,0,0,0,0,0,0,2,0,2,0,0,0,0,0,0,0,0,0
487320,21040,210,40,-2,63,54,9,0,0,0,1,1,0,1,0,1,19,15,4,0,0,0,41,38,3,0,0,0,1,0,1,0,0,0
487524,21040,210,40,-2,7,3,4,0,0,0,1,1,0,0,0,0,0,0,0,0,0,0,6,2,4,0,0,0,0,0,0,0,0,0
487588,21040,210,40,-2,2,0,2,0,0,0,0,0,0,2,0,2,0,0,0,0,0,0,0,0,0,0,0,0,0,0,0,0,0,0
487861,21040,210,40,-2,3,1,2,0,0,0,0,0,0,0,0,0,0,0,0,0,0,0,3,1,2,0,0,0,0,0,0,0,0,0
487977,21040,210,40,-2,4,0,4,0,0,0,0,0,0,1,0,1,0,0,0,0,0,0,3,0,3,0,0,0,0,0,0,0,0,0
488077,21040,210,40,-2,1,0,1,0,0,0,1,0,1,0,0,0,0,0,0,0,0,0,0,0,0,0,0,0,0,0,0,0,0,0
488305,21040,210,40,-2,1,1,0,0,0,0,0,0,0,0,0,0,0,0,0,0,0,0,1,1,0,0,0,0,0,0,0,0,0,0
488527,21040,210,40,-2,12,5,7,0,0,0,2,0,2,0,0,0,1,1,0,0,0,0,8,3,5,0,0,0,1,1,0,0,0,0
488554,21040,210,40,-2,3,2,1,0,0,0,0,0,0,0,0,0,0,0,0,0,0,0,3,2,1,0,0,0,0,0,0,0,0,0
488572,21040,210,40,-2,11,5,6,0,0,0,5,3,2,1,0,1,0,0,0,0,0,0,4,1,3,1,1,0,0,0,0,0,0,0
489201,21040,210,40,-2,4,2,2,0,0,0,1,0,1,0,0,0,1,0,1,0,0,0,2,2,0,0,0,0,0,0,0,0,0,0
489283,21040,210,40,-2,9,4,5,0,0,0,0,0,0,0,0,0,7,3,4,0,0,0,2,1,1,0,0,0,0,0,0,0,0,0
489779,21040,210,40,-2,6,3,3,0,0,0,0,0,0,2,1,1,0,0,0,0,0,0,3,1,2,0,0,0,1,1,0,0,0,0
489858,21040,210,40,-2,5,2,3,0,0,0,3,1,2,0,0,0,0,0,0,0,0,0,2,1,1,0,0,0,0,0,0,0,0,0
489937,21040,210,40,-2,12,8,4,0,0,0,6,5,1,1,0,1,0,0,0,0,0,0,5,3,2,0,0,0,0,0,0,0,0,0
490106,21040,210,40,-2,1,0,1,0,0,0,1,0,1,0,0,0,0,0,0,0,0,0,0,0,0,0,0,0,0,0,0,0,0,0
490133,21040,210,40,-2,3,2,1,0,0,0,0,0,0,0,0,0,0,0,0,0,0,0,0,0,0,0,0,0,3,2,1,0,0,0
490373,21040,210,40,-2,11,2,9,0,0,0,1,1,0,1,0,1,0,0,0,0,0,0,7,1,6,1,0,1,1,0,1,0,0,0
490805,21040,210,40,-2,3,1,2,0,0,0,0,0,0,0,0,0,0,0,0,0,0,0,2,1,1,0,0,0,0,0,0,1,0,1
490878,21040,210,40,-2,2,0,2,0,0,0,0,0,0,0,0,0,1,0,1,0,0,0,1,0,1,0,0,0,0,0,0,0,0,0
490975,21040,210,40,-2,2,1,1,0,0,0,1,1,0,0,0,0,1,0,1,0,0,0,0,0,0,0,0,0,0,0,0,0,0,0
491057,21040,210,40,-2,2,2,0,0,0,0,0,0,0,0,0,0,0,0,0,0,0,0,2,2,0,0,0,0,0,0,0,0,0,0
491181,21040,210,40,-2,3,0,3,0,0,0,0,0,0,0,0,0,0,0,0,0,0,0,3,0,3,0,0,0,0,0,0,0,0,0
491525,21040,210,40,-2,1,1,0,0,0,0,0,0,0,0,0,0,0,0,0,0,0,0,1,1,0,0,0,0,0,0,0,0,0,0
491844,21040,210,40,-2,6,3,3,5,2,3,0,0,0,0,0,0,0,0,0,0,0,0,1,1,0,0,0,0,0,0,0,0,0,0
492449,21040,210,40,-2,3,1,2,0,0,0,0,0,0,0,0,0,3,1,2,0,0,0,0,0,0,0,0,0,0,0,0,0,0,0
492476,21040,210,40,-2,1,0,1,0,0,0,0,0,0,0,0,0,1,0,1,0,0,0,0,0,0,0,0,0,0,0,0,0,0,0
492607,21040,210,40,-2,1,0,1,0,0,0,0,0,0,0,0,0,0,0,0,0,0,0,1,0,1,0,0,0,0,0,0,0,0,0
492689,21040,210,40,-2,47,27,20,0,0,0,7,4,3,3,0,3,10,6,4,0,0,0,21,14,7,0,0,0,0,0,0,6,3,3
492722,21040,210,40,-2,6,0,6,0,0,0,0,0,0,1,0,1,3,0,3,0,0,0,1,0,1,1,0,1,0,0,0,0,0,0
493080,21040,210,40,-2,1,1,0,0,0,0,0,0,0,0,0,0,0,0,0,0,0,0,0,0,0,1,1,0,0,0,0,0,0,0
493646,21040,210,40,-2,7,0,7,0,0,0,0,0,0,0,0,0,0,0,0,0,0,0,7,0,7,0,0,0,0,0,0,0,0,0
494010,21040,210,40,-2,1,0,1,0,0,0,0,0,0,0,0,0,0,0,0,0,0,0,1,0,1,0,0,0,0,0,0,0,0,0
494278,21040,210,40,-2,2,1,1,0,0,0,0,0,0,0,0,0,2,1,1,0,0,0,0,0,0,0,0,0,0,0,0,0,0,0
494287,21040,210,40,-2,8,0,8,0,0,0,0,0,0,0,0,0,8,0,8,0,0,0,0,0,0,0,0,0,0,0,0,0,0,0
494436,21040,210,40,-2,4,0,4,0,0,0,0,0,0,0,0,0,0,0,0,0,0,0,4,0,4,0,0,0,0,0,0,0,0,0
494588,21040,210,40,-2,2,1,1,0,0,0,0,0,0,0,0,0,0,0,0,0,0,0,1,1,0,1,0,1,0,0,0,0,0,0
494603,21040,210,40,-2,3,3,0,0,0,0,0,0,0,0,0,0,0,0,0,0,0,0,3,3,0,0,0,0,0,0,0,0,0,0
494843,21040,210,40,-2,4,0,4,0,0,0,1,0,1,3,0,3,0,0,0,0,0,0,0,0,0,0,0,0,0,0,0,0,0,0
494852,21040,210,40,-2,10,4,6,0,0,0,0,0,0,1,0,1,0,0,0,0,0,0,9,4,5,0,0,0,0,0,0,0,0,0
494959,21040,210,40,-2,1,1,0,0,0,0,0,0,0,1,1,0,0,0,0,0,0,0,0,0,0,0,0,0,0,0,0,0,0,0
495314,21040,210,40,-2,2,0,2,0,0,0,2,0,2,0,0,0,0,0,0,0,0,0,0,0,0,0,0,0,0,0,0,0,0,0
495767,21040,210,40,-2,183,92,91,0,0,0,30,16,14,12,5,7,11,9,2,0,0,0,106,52,54,4,3,1,8,3,5,12,4,8
496043,21040,210,40,-2,1,1,0,0,0,0,1,1,0,0,0,0,0,0,0,0,0,0,0,0,0,0,0,0,0,0,0,0,0,0
496627,21040,210,40,-2,5,3,2,0,0,0,1,1,0,0,0,0,0,0,0,0,0,0,4,2,2,0,0,0,0,0,0,0,0,0
496991,21040,210,40,-2,7,0,7,0,0,0,0,0,0,6,0,6,0,0,0,0,0,0,0,0,0,1,0,1,0,0,0,0,0,0
100706,21041,210,41,-2,11,1,10,0,0,0,1,0,1,1,0,1,0,0,0,0,0,0,8,0,8,0,0,0,0,0,0,1,1,0
101116,21041,210,41,-2,1,1,0,0,0,0,0,0,0,0,0,0,0,0,0,0,0,0,1,1,0,0,0,0,0,0,0,0,0,0
101709,21041,210,41,-2,5,1,4,0,0,0,0,0,0,2,0,2,0,0,0,0,0,0,3,1,2,0,0,0,0,0,0,0,0,0
101879,21041,210,41,-2,3,0,3,0,0,0,0,0,0,0,0,0,0,0,0,0,0,0,3,0,3,0,0,0,0,0,0,0,0,0
102368,21041,210,41,-2,22,10,12,0,0,0,0,0,0,0,0,0,0,0,0,0,0,0,15,5,10,1,0,1,0,0,0,6,5,1
102553,21041,210,41,-2,3,0,3,1,0,1,1,0,1,0,0,0,0,0,0,0,0,0,1,0,1,0,0,0,0,0,0,0,0,0
102632,21041,210,41,-2,1,0,1,0,0,0,0,0,0,0,0,0,0,0,0,0,0,0,1,0,1,0,0,0,0,0,0,0,0,0
102845,21041,210,41,-2,29,13,16,1,0,1,1,0,1,5,2,3,3,1,2,0,0,0,19,10,9,0,0,0,0,0,0,0,0,0
103893,21041,210,41,-2,15,2,13,0,0,0,0,0,0,0,0,0,1,1,0,0,0,0,12,1,11,1,0,1,1,0,1,0,0,0
103909,21041,210,41,-2,7,3,4,0,0,0,0,0,0,0,0,0,1,0,1,0,0,0,5,2,3,0,0,0,1,1,0,0,0,0
103927,21041,210,41,-2,6,0,6,0,0,0,0,0,0,1,0,1,0,0,0,0,0,0,5,0,5,0,0,0,0,0,0,0,0,0
104090,21041,210,41,-2,8,2,6,0,0,0,0,0,0,0,0,0,0,0,0,0,0,0,7,2,5,1,0,1,0,0,0,0,0,0
104151,21041,210,41,-2,5,4,1,0,0,0,1,1,0,1,1,0,1,0,1,0,0,0,0,0,0,0,0,0,2,2,0,0,0,0
104179,21041,210,41,-2,3,2,1,0,0,0,0,0,0,0,0,0,0,0,0,0,0,0,3,2,1,0,0,0,0,0,0,0,0,0
104717,21041,210,41,-2,30,5,25,0,0,0,0,0,0,12,2,10,1,0,1,0,0,0,16,3,13,0,0,0,1,0,1,0,0,0
105534,21041,210,41,-2,12,5,7,0,0,0,0,0,0,0,0,0,4,0,4,0,0,0,5,2,3,3,3,0,0,0,0,0,0,0
105543,21041,210,41,-2,10,1,9,0,0,0,0,0,0,0,0,0,3,0,3,0,0,0,7,1,6,0,0,0,0,0,0,0,0,0
105589,21041,210,41,-2,1,0,1,0,0,0,0,0,0,1,0,1,0,0,0,0,0,0,0,0,0,0,0,0,0,0,0,0,0,0
105659,21041,210,41,-2,7,6,1,1,0,1,0,0,0,2,2,0,2,2,0,0,0,0,2,2,0,0,0,0,0,0,0,0,0,0
106397,21041,210,41,-2,31,14,17,0,0,0,0,0,0,5,3,2,4,3,1,0,0,0,19,7,12,0,0,0,2,1,1,1,0,1
106546,21041,210,41,-2,11,1,10,0,0,0,0,0,0,0,0,0,0,0,0,0,0,0,11,1,10,0,0,0,0,0,0,0,0,0
106704,21041,210,41,-2,16,8,8,0,0,0,0,0,0,3,1,2,0,0,0,0,0,0,12,6,6,1,1,0,0,0,0,0,0,0
106713,21041,210,41,-2,3,0,3,0,0,0,0,0,0,0,0,0,0,0,0,0,0,0,3,0,3,0,0,0,0,0,0,0,0,0
107080,21041,210,41,-2,5,2,3,0,0,0,0,0,0,0,0,0,0,0,0,0,0,0,4,2,2,0,0,0,0,0,0,1,0,1
107141,21041,210,41,-2,4,1,3,0,0,0,0,0,0,0,0,0,0,0,0,0,0,0,3,1,2,0,0,0,1,0,1,0,0,0
107558,21041,210,41,-2,2,0,2,0,0,0,0,0,0,0,0,0,0,0,0,0,0,0,2,0,2,0,0,0,0,0,0,0,0,0
108092,21041,210,41,-2,6,3,3,0,0,0,2,2,0,0,0,0,0,0,0,0,0,0,4,1,3,0,0,0,0,0,0,0,0,0
108232,21041,210,41,-2,1,1,0,0,0,0,0,0,0,0,0,0,0,0,0,0,0,0,1,1,0,0,0,0,0,0,0,0,0,0
110219,21041,210,41,-2,3,0,3,0,0,0,0,0,0,1,0,1,0,0,0,0,0,0,2,0,2,0,0,0,0,0,0,0,0,0
110370,21041,210,41,-2,1,0,1,0,0,0,0,0,0,0,0,0,0,0,0,0,0,0,0,0,0,0,0,0,0,0,0,1,0,1
110404,21041,210,41,-2,12,9,3,0,0,0,1,0,1,0,0,0,2,2,0,0,0,0,3,1,2,0,0,0,0,0,0,6,6,0
110468,21041,210,41,-2,9,3,6,0,0,0,1,0,1,1,0,1,1,0,1,0,0,0,6,3,3,0,0,0,0,0,0,0,0,0
110486,21041,210,41,-2,1,1,0,0,0,0,0,0,0,0,0,0,0,0,0,0,0,0,0,0,0,1,1,0,0,0,0,0,0,0
110495,21041,210,41,-2,3,0,3,0,0,0,0,0,0,1,0,1,0,0,0,0,0,0,2,0,2,0,0,0,0,0,0,0,0,0
110538,21041,210,41,-2,1,1,0,0,0,0,0,0,0,0,0,0,0,0,0,0,0,0,1,1,0,0,0,0,0,0,0,0,0,0
110635,21041,210,41,-2,9,4,5,0,0,0,1,0,1,1,0,1,0,0,0,0,0,0,5,2,3,0,0,0,0,0,0,2,2,0
110644,21041,210,41,-2,95,37,58,0,0,0,16,3,13,5,2,3,13,2,11,0,0,0,43,18,25,0,0,0,4,1,3,14,11,3
110653,21041,210,41,-2,86,51,35,0,0,0,25,17,8,3,0,3,6,3,3,1,1,0,36,20,16,3,2,1,9,6,3,3,2,1
110662,21041,210,41,-2,272,144,128,0,0,0,90,39,51,5,3,2,16,11,5,0,0,0,101,59,42,8,4,4,17,7,10,35,21,14
110671,21041,210,41,-2,11,5,6,0,0,0,4,3,1,0,0,0,2,1,1,0,0,0,4,0,4,0,0,0,0,0,0,1,1,0
110680,21041,210,41,-2,103,41,62,0,0,0,27,11,16,2,0,2,10,6,4,0,0,0,54,22,32,0,0,0,4,1,3,6,1,5
110699,21041,210,41,-2,215,90,125,0,0,0,65,25,40,15,6,9,15,10,5,0,0,0,84,35,49,8,3,5,13,5,8,15,6,9
110705,21041,210,41,-2,1,1,0,0,0,0,0,0,0,0,0,0,0,0,0,0,0,0,1,1,0,0,0,0,0,0,0,0,0,0
110714,21041,210,41,-2,2,1,1,0,0,0,0,0,0,0,0,0,1,1,0,0,0,0,1,0,1,0,0,0,0,0,0,0,0,0
111391,21041,210,41,-2,3,1,2,0,0,0,0,0,0,0,0,0,0,0,0,0,0,0,3,1,2,0,0,0,0,0,0,0,0,0
111948,21041,210,41,-2,11,5,6,0,0,0,0,0,0,0,0,0,4,1,3,0,0,0,5,3,2,0,0,0,2,1,1,0,0,0
111966,21041,210,41,-2,1,1,0,0,0,0,0,0,0,0,0,0,0,0,0,0,0,0,0,0,0,0,0,0,1,1,0,0,0,0
112075,21041,210,41,-2,3,0,3,0,0,0,0,0,0,1,0,1,0,0,0,0,0,0,1,0,1,0,0,0,1,0,1,0,0,0
112127,21041,210,41,-2,1,0,1,0,0,0,1,0,1,0,0,0,0,0,0,0,0,0,0,0,0,0,0,0,0,0,0,0,0,0
112260,21041,210,41,-2,2,1,1,0,0,0,0,0,0,0,0,0,0,0,0,0,0,0,2,1,1,0,0,0,0,0,0,0,0,0
112394,21041,210,41,-2,1,1,0,0,0,0,0,0,0,0,0,0,0,0,0,0,0,0,1,1,0,0,0,0,0,0,0,0,0,0
112570,21041,210,41,-2,1,1,0,0,0,0,0,0,0,1,1,0,0,0,0,0,0,0,0,0,0,0,0,0,0,0,0,0,0,0
114549,21041,210,41,-2,2,2,0,0,0,0,0,0,0,0,0,0,0,0,0,0,0,0,2,2,0,0,0,0,0,0,0,0,0,0
114840,21041,210,41,-2,1,0,1,0,0,0,0,0,0,1,0,1,0,0,0,0,0,0,0,0,0,0,0,0,0,0,0,0,0,0
115083,21041,210,41,-2,1,0,1,0,0,0,0,0,0,0,0,0,0,0,0,0,0,0,1,0,1,0,0,0,0,0,0,0,0,0
115746,21041,210,41,-2,5,1,4,0,0,0,0,0,0,0,0,0,0,0,0,0,0,0,5,1,4,0,0,0,0,0,0,0,0,0
115931,21041,210,41,-2,7,5,2,0,0,0,0,0,0,2,1,1,3,2,1,0,0,0,2,2,0,0,0,0,0,0,0,0,0,0
117636,21041,210,41,-2,4,1,3,0,0,0,0,0,0,0,0,0,0,0,0,0,0,0,3,1,2,1,0,1,0,0,0,0,0,0
117946,21041,210,41,-2,20,5,15,0,0,0,2,1,1,3,1,2,1,0,1,0,0,0,7,1,6,0,0,0,7,2,5,0,0,0
118198,21041,210,41,-2,1,1,0,0,0,0,0,0,0,0,0,0,0,0,0,0,0,0,1,1,0,0,0,0,0,0,0,0,0,0
118693,21041,210,41,-2,4,2,2,0,0,0,0,0,0,0,0,0,0,0,0,0,0,0,3,2,1,0,0,0,1,0,1,0,0,0
119058,21041,210,41,-2,1,0,1,0,0,0,0,0,0,0,0,0,0,0,0,0,0,0,1,0,1,0,0,0,0,0,0,0,0,0
119270,21041,210,41,-2,1,0,1,0,0,0,0,0,0,0,0,0,0,0,0,1,0,1,0,0,0,0,0,0,0,0,0,0,0,0
119605,21041,210,41,-2,3,0,3,0,0,0,0,0,0,0,0,0,0,0,0,0,0,0,2,0,2,0,0,0,1,0,1,0,0,0
120254,21041,210,41,-2,2,1,1,0,0,0,0,0,0,0,0,0,0,0,0,0,0,0,1,0,1,0,0,0,0,0,0,1,1,0
120661,21041,210,41,-2,3,1,2,1,0,1,0,0,0,0,0,0,1,0,1,0,0,0,1,1,0,0,0,0,0,0,0,0,0,0
120883,21041,210,41,-2,27,10,17,0,0,0,5,1,4,3,0,3,2,0,2,0,0,0,14,7,7,1,1,0,2,1,1,0,0,0
122409,21041,210,41,-2,2,1,1,0,0,0,0,0,0,0,0,0,0,0,0,0,0,0,2,1,1,0,0,0,0,0,0,0,0,0
122436,21041,210,41,-2,1,0,1,0,0,0,0,0,0,0,0,0,0,0,0,0,0,0,1,0,1,0,0,0,0,0,0,0,0,0
122612,21041,210,41,-2,1,0,1,0,0,0,1,0,1,0,0,0,0,0,0,0,0,0,0,0,0,0,0,0,0,0,0,0,0,0
122649,21041,210,41,-2,1,1,0,0,0,0,0,0,0,0,0,0,0,0,0,0,0,0,1,1,0,0,0,0,0,0,0,0,0,0
122685,21041,210,41,-2,7,2,5,0,0,0,0,0,0,1,0,1,2,2,0,0,0,0,3,0,3,1,0,1,0,0,0,0,0,0
122694,21041,210,41,-2,4,0,4,0,0,0,1,0,1,0,0,0,0,0,0,0,0,0,2,0,2,1,0,1,0,0,0,0,0,0
122931,21041,210,41,-2,11,6,5,0,0,0,1,0,1,0,0,0,0,0,0,0,0,0,10,6,4,0,0,0,0,0,0,0,0,0
123457,21041,210,41,-2,3,3,0,0,0,0,0,0,0,0,0,0,0,0,0,0,0,0,2,2,0,0,0,0,1,1,0,0,0,0
123633,21041,210,41,-2,2,1,1,0,0,0,0,0,0,0,0,0,0,0,0,0,0,0,2,1,1,0,0,0,0,0,0,0,0,0
123679,21041,210,41,-2,10,2,8,0,0,0,2,0,2,0,0,0,3,1,2,0,0,0,3,0,3,1,0,1,1,1,0,0,0,0
123952,21041,210,41,-2,2,2,0,0,0,0,0,0,0,1,1,0,0,0,0,0,0,0,1,1,0,0,0,0,0,0,0,0,0,0
123961,21041,210,41,-2,19,13,6,0,0,0,1,0,1,1,0,1,0,0,0,0,0,0,14,11,3,1,1,0,0,0,0,2,1,1
124292,21041,210,41,-2,1,1,0,0,0,0,0,0,0,0,0,0,0,0,0,0,0,0,1,1,0,0,0,0,0,0,0,0,0,0
124706,21041,210,41,-2,4,1,3,0,0,0,0,0,0,0,0,0,1,0,1,0,0,0,1,0,1,1,0,1,1,1,0,0,0,0
124937,21041,210,41,-2,4,2,2,0,0,0,1,0,1,0,0,0,2,2,0,0,0,0,1,0,1,0,0,0,0,0,0,0,0,0
125231,21041,210,41,-2,14,5,9,0,0,0,0,0,0,9,3,6,1,0,1,0,0,0,2,1,1,1,0,1,1,1,0,0,0,0
125532,21041,210,41,-2,8,0,8,1,0,1,1,0,1,2,0,2,0,0,0,1,0,1,3,0,3,0,0,0,0,0,0,0,0,0
126207,21041,210,41,-2,1,0,1,0,0,0,0,0,0,0,0,0,0,0,0,0,0,0,1,0,1,0,0,0,0,0,0,0,0,0
126562,21041,210,41,-2,231,51,180,1,0,1,11,0,11,0,0,0,11,4,7,0,0,0,152,35,117,3,0,3,50,12,38,3,0,3
126669,21041,210,41,-2,6,1,5,0,0,0,0,0,0,0,0,0,0,0,0,0,0,0,5,1,4,1,0,1,0,0,0,0,0,0
126687,21041,210,41,-2,6,0,6,0,0,0,1,0,1,0,0,0,1,0,1,0,0,0,3,0,3,1,0,1,0,0,0,0,0,0
126818,21041,210,41,-2,9,7,2,0,0,0,0,0,0,0,0,0,1,1,0,0,0,0,7,5,2,0,0,0,1,1,0,0,0,0
126951,21041,210,41,-2,17,15,2,0,0,0,0,0,0,1,1,0,0,0,0,0,0,0,16,14,2,0,0,0,0,0,0,0,0,0
127060,21041,210,41,-2,23,9,14,3,0,3,0,0,0,2,1,1,1,1,0,0,0,0,9,4,5,5,2,3,1,1,0,2,0,2
127185,21041,210,41,-2,4,1,3,0,0,0,0,0,0,0,0,0,0,0,0,0,0,0,3,0,3,0,0,0,1,1,0,0,0,0
127653,21041,210,41,-2,2,0,2,0,0,0,0,0,0,0,0,0,0,0,0,0,0,0,0,0,0,0,0,0,2,0,2,0,0,0
127945,21041,210,41,-2,6,1,5,0,0,0,0,0,0,0,0,0,0,0,0,0,0,0,6,1,5,0,0,0,0,0,0,0,0,0
128179,21041,210,41,-2,6,2,4,1,1,0,0,0,0,1,0,1,2,0,2,0,0,0,2,1,1,0,0,0,0,0,0,0,0,0
128188,21041,210,41,-2,15,5,10,0,0,0,0,0,0,0,0,0,3,1,2,0,0,0,8,3,5,0,0,0,4,1,3,0,0,0
128328,21041,210,41,-2,33,20,13,0,0,0,1,0,1,0,0,0,0,0,0,0,0,0,32,20,12,0,0,0,0,0,0,0,0,0
128498,21041,210,41,-2,5,1,4,0,0,0,1,0,1,1,1,0,2,0,2,0,0,0,1,0,1,0,0,0,0,0,0,0,0,0
128902,21041,210,41,-2,3,2,1,0,0,0,0,0,0,0,0,0,0,0,0,0,0,0,3,2,1,0,0,0,0,0,0,0,0,0
129020,21041,210,41,-2,2,2,0,0,0,0,1,1,0,0,0,0,0,0,0,0,0,0,0,0,0,0,0,0,0,0,0,1,1,0
129525,21041,210,41,-2,7,3,4,0,0,0,0,0,0,0,0,0,0,0,0,0,0,0,6,3,3,1,0,1,0,0,0,0,0,0
130183,21041,210,41,-2,2,0,2,0,0,0,0,0,0,0,0,0,0,0,0,0,0,0,2,0,2,0,0,0,0,0,0,0,0,0
130226,21041,210,41,-2,9,5,4,0,0,0,0,0,0,0,0,0,0,0,0,0,0,0,9,5,4,0,0,0,0,0,0,0,0,0
130314,21041,210,41,-2,2,0,2,0,0,0,0,0,0,0,0,0,0,0,0,0,0,0,2,0,2,0,0,0,0,0,0,0,0,0
130590,21041,210,41,-2,7,4,3,0,0,0,1,1,0,2,1,1,0,0,0,0,0,0,3,2,1,0,0,0,0,0,0,1,0,1
130697,21041,210,41,-2,6,3,3,0,0,0,2,0,2,1,0,1,2,2,0,0,0,0,1,1,0,0,0,0,0,0,0,0,0,0
130794,21041,210,41,-2,21,11,10,0,0,0,2,2,0,3,1,2,0,0,0,0,0,0,6,3,3,0,0,0,2,1,1,8,4,4
130907,21041,210,41,-2,21,6,15,1,0,1,0,0,0,6,3,3,0,0,0,0,0,0,14,3,11,0,0,0,0,0,0,0,0,0
130943,21041,210,41,-2,4,1,3,0,0,0,0,0,0,0,0,0,0,0,0,0,0,0,2,0,2,0,0,0,0,0,0,2,1,1
131113,21041,210,41,-2,3,1,2,0,0,0,1,1,0,0,0,0,1,0,1,0,0,0,1,0,1,0,0,0,0,0,0,0,0,0
131159,21041,210,41,-2,2,1,1,0,0,0,1,1,0,0,0,0,0,0,0,0,0,0,1,0,1,0,0,0,0,0,0,0,0,0
131469,21041,210,41,-2,6,1,5,0,0,0,2,1,1,0,0,0,0,0,0,0,0,0,4,0,4,0,0,0,0,0,0,0,0,0
131496,21041,210,41,-2,26,15,11,0,0,0,1,0,1,0,0,0,1,0,1,0,0,0,10,5,5,0,0,0,3,2,1,11,8,3
131520,21041,210,41,-2,10,1,9,0,0,0,3,1,2,6,0,6,0,0,0,0,0,0,1,0,1,0,0,0,0,0,0,0,0,0
131803,21041,210,41,-2,11,8,3,0,0,0,3,2,1,2,1,1,0,0,0,0,0,0,3,3,0,0,0,0,3,2,1,0,0,0
132471,21041,210,41,-2,2,0,2,0,0,0,0,0,0,1,0,1,0,0,0,0,0,0,1,0,1,0,0,0,0,0,0,0,0,0
133465,21041,210,41,-2,8,2,6,0,0,0,0,0,0,4,0,4,1,0,1,0,0,0,2,1,1,0,0,0,1,1,0,0,0,0
133845,21041,210,41,-2,5,0,5,0,0,0,0,0,0,1,0,1,2,0,2,0,0,0,2,0,2,0,0,0,0,0,0,0,0,0
133854,21041,210,41,-2,1,1,0,0,0,0,0,0,0,1,1,0,0,0,0,0,0,0,0,0,0,0,0,0,0,0,0,0,0,0
133863,21041,210,41,-2,4,1,3,0,0,0,1,1,0,0,0,0,2,0,2,0,0,0,0,0,0,0,0,0,1,0,1,0,0,0
133881,21041,210,41,-2,4,3,1,0,0,0,0,0,0,0,0,0,0,0,0,0,0,0,4,3,1,0,0,0,0,0,0,0,0,0
133951,21041,210,41,-2,2,1,1,0,0,0,0,0,0,0,0,0,0,0,0,0,0,0,2,1,1,0,0,0,0,0,0,0,0,0
134237,21041,210,41,-2,24,19,5,0,0,0,1,1,0,2,1,1,5,3,2,0,0,0,15,13,2,1,1,0,0,0,0,0,0,0
135081,21041,210,41,-2,37,16,21,1,1,0,2,0,2,9,3,6,8,4,4,0,0,0,15,7,8,2,1,1,0,0,0,0,0,0
135726,21041,210,41,-2,1,0,1,0,0,0,0,0,0,0,0,0,1,0,1,0,0,0,0,0,0,0,0,0,0,0,0,0,0,0
136215,21041,210,41,-2,5,2,3,0,0,0,1,0,1,0,0,0,0,0,0,0,0,0,4,2,2,0,0,0,0,0,0,0,0,0
136950,21041,210,41,-2,11,3,8,0,0,0,0,0,0,1,0,1,1,1,0,0,0,0,6,2,4,0,0,0,1,0,1,2,0,2
138309,21041,210,41,-2,35,5,30,0,0,0,0,0,0,8,0,8,0,0,0,0,0,0,26,5,21,1,0,1,0,0,0,0,0,0
138840,21041,210,41,-2,14,3,11,1,0,1,0,0,0,12,3,9,1,0,1,0,0,0,0,0,0,0,0,0,0,0,0,0,0,0
139357,21041,210,41,-2,19,6,13,0,0,0,1,1,0,9,2,7,1,1,0,0,0,0,8,2,6,0,0,0,0,0,0,0,0,0
139579,21041,210,41,-2,5,2,3,0,0,0,0,0,0,2,1,1,0,0,0,0,0,0,3,1,2,0,0,0,0,0,0,0,0,0
139658,21041,210,41,-2,7,1,6,0,0,0,1,0,1,1,0,1,0,0,0,0,0,0,4,1,3,0,0,0,0,0,0,1,0,1
140012,21041,210,41,-2,11,5,6,0,0,0,0,0,0,4,2,2,0,0,0,0,0,0,7,3,4,0,0,0,0,0,0,0,0,0
140146,21041,210,41,-2,1,0,1,0,0,0,0,0,0,1,0,1,0,0,0,0,0,0,0,0,0,0,0,0,0,0,0,0,0,0
140447,21041,210,41,-2,1,0,1,0,0,0,0,0,0,1,0,1,0,0,0,0,0,0,0,0,0,0,0,0,0,0,0,0,0,0
140942,21041,210,41,-2,22,10,12,0,0,0,1,0,1,5,0,5,2,1,1,0,0,0,12,8,4,2,1,1,0,0,0,0,0,0
141060,21041,210,41,-2,1,0,1,0,0,0,0,0,0,1,0,1,0,0,0,0,0,0,0,0,0,0,0,0,0,0,0,0,0,0
141255,21041,210,41,-2,24,7,17,0,0,0,0,0,0,3,1,2,0,0,0,0,0,0,21,6,15,0,0,0,0,0,0,0,0,0
141264,21041,210,41,-2,1,0,1,0,0,0,0,0,0,0,0,0,0,0,0,0,0,0,1,0,1,0,0,0,0,0,0,0,0,0
141644,21041,210,41,-2,11,2,9,0,0,0,1,0,1,1,0,1,1,0,1,0,0,0,8,2,6,0,0,0,0,0,0,0,0,0
142054,21041,210,41,-2,10,0,10,0,0,0,0,0,0,0,0,0,1,0,1,0,0,0,7,0,7,1,0,1,1,0,1,0,0,0
142832,21041,210,41,-2,5,2,3,0,0,0,0,0,0,0,0,0,1,0,1,0,0,0,3,1,2,0,0,0,1,1,0,0,0,0
143853,21041,210,41,-2,3,2,1,0,0,0,1,0,1,0,0,0,0,0,0,0,0,0,2,2,0,0,0,0,0,0,0,0,0,0
143978,21041,210,41,-2,3,1,2,0,0,0,1,1,0,0,0,0,0,0,0,0,0,0,2,0,2,0,0,0,0,0,0,0,0,0
144014,21041,210,41,-2,1,0,1,0,0,0,1,0,1,0,0,0,0,0,0,0,0,0,0,0,0,0,0,0,0,0,0,0,0,0
144050,21041,210,41,-2,131,67,64,0,0,0,24,9,15,4,2,2,4,1,3,0,0,0,60,33,27,3,1,2,13,8,5,23,13,10
144485,21041,210,41,-2,1,1,0,0,0,0,1,1,0,0,0,0,0,0,0,0,0,0,0,0,0,0,0,0,0,0,0,0,0,0
144740,21041,210,41,-2,1,0,1,0,0,0,0,0,0,0,0,0,0,0,0,0,0,0,1,0,1,0,0,0,0,0,0,0,0,0
145239,21041,210,41,-2,4,0,4,0,0,0,0,0,0,1,0,1,0,0,0,0,0,0,3,0,3,0,0,0,0,0,0,0,0,0
145275,21041,210,41,-2,4,1,3,0,0,0,0,0,0,1,0,1,2,1,1,0,0,0,1,0,1,0,0,0,0,0,0,0,0,0
145558,21041,210,41,-2,2,1,1,0,0,0,1,0,1,0,0,0,0,0,0,0,0,0,1,1,0,0,0,0,0,0,0,0,0,0
145691,21041,210,41,-2,1,0,1,0,0,0,0,0,0,0,0,0,0,0,0,0,0,0,1,0,1,0,0,0,0,0,0,0,0,0
146472,21041,210,41,-2,1,0,1,0,0,0,0,0,0,0,0,0,0,0,0,0,0,0,1,0,1,0,0,0,0,0,0,0,0,0
146481,21041,210,41,-2,1,1,0,0,0,0,0,0,0,0,0,0,0,0,0,0,0,0,1,1,0,0,0,0,0,0,0,0,0,0
146700,21041,210,41,-2,8,7,1,0,0,0,0,0,0,2,1,1,1,1,0,0,0,0,5,5,0,0,0,0,0,0,0,0,0,0
146719,21041,210,41,-2,17,11,6,0,0,0,2,1,1,0,0,0,4,3,1,0,0,0,8,5,3,0,0,0,1,1,0,2,1,1
147660,21041,210,41,-2,4,4,0,0,0,0,1,1,0,0,0,0,0,0,0,0,0,0,3,3,0,0,0,0,0,0,0,0,0,0
147679,21041,210,41,-2,1,0,1,0,0,0,0,0,0,0,0,0,0,0,0,0,0,0,1,0,1,0,0,0,0,0,0,0,0,0
147697,21041,210,41,-2,2,0,2,0,0,0,0,0,0,0,0,0,0,0,0,0,0,0,2,0,2,0,0,0,0,0,0,0,0,0
147703,21041,210,41,-2,5,2,3,0,0,0,1,1,0,0,0,0,0,0,0,0,0,0,0,0,0,0,0,0,0,0,0,4,1,3
147767,21041,210,41,-2,58,35,23,0,0,0,12,7,5,5,3,2,6,4,2,0,0,0,20,13,7,1,0,1,1,0,1,13,8,5
148380,21041,210,41,-2,3,3,0,0,0,0,0,0,0,0,0,0,0,0,0,0,0,0,2,2,0,0,0,0,1,1,0,0,0,0
148876,21041,210,41,-2,2,2,0,0,0,0,1,1,0,0,0,0,1,1,0,0,0,0,0,0,0,0,0,0,0,0,0,0,0,0
149028,21041,210,41,-2,1,0,1,0,0,0,0,0,0,0,0,0,0,0,0,0,0,0,1,0,1,0,0,0,0,0,0,0,0,0
149222,21041,210,41,-2,7,3,4,0,0,0,3,2,1,0,0,0,0,0,0,0,0,0,3,1,2,1,0,1,0,0,0,0,0,0
149639,21041,210,41,-2,1,0,1,0,0,0,0,0,0,0,0,0,1,0,1,0,0,0,0,0,0,0,0,0,0,0,0,0,0,0
150163,21041,210,41,-2,23,11,12,0,0,0,0,0,0,2,1,1,1,0,1,0,0,0,20,10,10,0,0,0,0,0,0,0,0,0
150400,21041,210,41,-2,2,1,1,0,0,0,0,0,0,0,0,0,2,1,1,0,0,0,0,0,0,0,0,0,0,0,0,0,0,0
150774,21041,210,41,-2,1,1,0,0,0,0,0,0,0,0,0,0,0,0,0,0,0,0,1,1,0,0,0,0,0,0,0,0,0,0
151102,21041,210,41,-2,2,2,0,0,0,0,1,1,0,0,0,0,0,0,0,0,0,0,0,0,0,0,0,0,0,0,0,1,1,0
151111,21041,210,41,-2,192,88,104,0,0,0,43,15,28,7,1,6,6,1,5,0,0,0,120,60,60,3,2,1,0,0,0,13,9,4
151324,21041,210,41,-2,7,3,4,0,0,0,1,0,1,1,1,0,0,0,0,0,0,0,5,2,3,0,0,0,0,0,0,0,0,0
151333,21041,210,41,-2,3,0,3,0,0,0,0,0,0,0,0,0,0,0,0,0,0,0,3,0,3,0,0,0,0,0,0,0,0,0
151342,21041,210,41,-2,1,0,1,0,0,0,0,0,0,0,0,0,0,0,0,0,0,0,1,0,1,0,0,0,0,0,0,0,0,0
151351,21041,210,41,-2,30,16,14,0,0,0,1,0,1,2,2,0,4,1,3,0,0,0,17,9,8,0,0,0,0,0,0,6,4,2
151360,21041,210,41,-2,1,0,1,0,0,0,0,0,0,0,0,0,0,0,0,0,0,0,1,0,1,0,0,0,0,0,0,0,0,0
151379,21041,210,41,-2,1,0,1,0,0,0,0,0,0,0,0,0,0,0,0,0,0,0,1,0,1,0,0,0,0,0,0,0,0,0
151467,21041,210,41,-2,1,0,1,0,0,0,0,0,0,0,0,0,0,0,0,0,0,0,1,0,1,0,0,0,0,0,0,0,0,0
151661,21041,210,41,-2,14,12,2,0,0,0,0,0,0,2,2,0,0,0,0,0,0,0,12,10,2,0,0,0,0,0,0,0,0,0
151801,21041,210,41,-2,8,4,4,0,0,0,1,1,0,2,1,1,0,0,0,0,0,0,5,2,3,0,0,0,0,0,0,0,0,0
151810,21041,210,41,-2,6,4,2,0,0,0,0,0,0,5,3,2,0,0,0,0,0,0,1,1,0,0,0,0,0,0,0,0,0,0
152080,21041,210,41,-2,7,5,2,0,0,0,0,0,0,0,0,0,0,0,0,0,0,0,4,3,1,0,0,0,1,0,1,2,2,0
152673,21041,210,41,-2,2,0,2,0,0,0,0,0,0,0,0,0,0,0,0,0,0,0,2,0,2,0,0,0,0,0,0,0,0,0
153126,21041,210,41,-2,4,1,3,0,0,0,0,0,0,0,0,0,0,0,0,0,0,0,4,1,3,0,0,0,0,0,0,0,0,0
153144,21041,210,41,-2,1,0,1,0,0,0,0,0,0,0,0,0,0,0,0,0,0,0,1,0,1,0,0,0,0,0,0,0,0,0
153241,21041,210,41,-2,1,0,1,0,0,0,0,0,0,0,0,0,0,0,0,0,0,0,0,0,0,0,0,0,0,0,0,1,0,1
153250,21041,210,41,-2,5,4,1,0,0,0,0,0,0,0,0,0,0,0,0,0,0,0,5,4,1,0,0,0,0,0,0,0,0,0
153269,21041,210,41,-2,10,6,4,0,0,0,1,1,0,0,0,0,0,0,0,0,0,0,7,4,3,0,0,0,0,0,0,2,1,1
153278,21041,210,41,-2,5,3,2,0,0,0,0,0,0,0,0,0,1,1,0,0,0,0,4,2,2,0,0,0,0,0,0,0,0,0
153296,21041,210,41,-2,3,1,2,0,0,0,0,0,0,0,0,0,0,0,0,0,0,0,3,1,2,0,0,0,0,0,0,0,0,0
153366,21041,210,41,-2,8,4,4,0,0,0,1,1,0,0,0,0,1,1,0,0,0,0,6,2,4,0,0,0,0,0,0,0,0,0
153375,21041,210,41,-2,2,1,1,0,0,0,0,0,0,0,0,0,0,0,0,0,0,0,2,1,1,0,0,0,0,0,0,0,0,0
153384,21041,210,41,-2,12,5,7,0,0,0,1,0,1,1,1,0,2,1,1,0,0,0,6,2,4,1,0,1,1,1,0,0,0,0
153603,21041,210,41,-2,25,11,14,0,0,0,1,1,0,0,0,0,1,0,1,0,0,0,18,7,11,0,0,0,0,0,0,5,3,2
153658,21041,210,41,-2,63,27,36,0,0,0,9,7,2,5,3,2,1,0,1,0,0,0,24,6,18,0,0,0,9,5,4,15,6,9
153825,21041,210,41,-2,1,0,1,0,0,0,1,0,1,0,0,0,0,0,0,0,0,0,0,0,0,0,0,0,0,0,0,0,0,0
153861,21041,210,41,-2,19,13,6,0,0,0,6,5,1,1,0,1,0,0,0,0,0,0,10,6,4,0,0,0,2,2,0,0,0,0
153922,21041,210,41,-2,3,2,1,0,0,0,0,0,0,0,0,0,0,0,0,0,0,0,3,2,1,0,0,0,0,0,0,0,0,0
153977,21041,210,41,-2,4,0,4,0,0,0,0,0,0,0,0,0,0,0,0,0,0,0,3,0,3,1,0,1,0,0,0,0,0,0
154004,21041,210,41,-2,1,1,0,0,0,0,0,0,0,0,0,0,0,0,0,0,0,0,1,1,0,0,0,0,0,0,0,0,0,0
154013,21041,210,41,-2,5,1,4,0,0,0,0,0,0,0,0,0,0,0,0,0,0,0,5,1,4,0,0,0,0,0,0,0,0,0
154022,21041,210,41,-2,7,2,5,0,0,0,1,1,0,2,0,2,2,1,1,0,0,0,2,0,2,0,0,0,0,0,0,0,0,0
154095,21041,210,41,-2,2,1,1,0,0,0,0,0,0,0,0,0,0,0,0,0,0,0,2,1,1,0,0,0,0,0,0,0,0,0
154174,21041,210,41,-2,10,5,5,0,0,0,2,2,0,0,0,0,0,0,0,0,0,0,8,3,5,0,0,0,0,0,0,0,0,0
154378,21041,210,41,-2,6,2,4,0,0,0,0,0,0,0,0,0,0,0,0,0,0,0,6,2,4,0,0,0,0,0,0,0,0,0
155283,21041,210,41,-2,6,1,5,0,0,0,0,0,0,2,0,2,1,0,1,0,0,0,3,1,2,0,0,0,0,0,0,0,0,0
155317,21041,210,41,-2,50,29,21,0,0,0,3,3,0,2,1,1,2,0,2,0,0,0,30,17,13,2,0,2,1,0,1,10,8,2
155399,21041,210,41,-2,8,7,1,0,0,0,0,0,0,0,0,0,1,1,0,0,0,0,6,5,1,0,0,0,0,0,0,1,1,0
156134,21041,210,41,-2,6,2,4,1,1,0,0,0,0,0,0,0,0,0,0,0,0,0,5,1,4,0,0,0,0,0,0,0,0,0
156213,21041,210,41,-2,1,0,1,0,0,0,0,0,0,0,0,0,0,0,0,0,0,0,1,0,1,0,0,0,0,0,0,0,0,0
156295,21041,210,41,-2,4,0,4,0,0,0,1,0,1,1,0,1,0,0,0,0,0,0,2,0,2,0,0,0,0,0,0,0,0,0
156408,21041,210,41,-2,3,2,1,0,0,0,0,0,0,1,0,1,1,1,0,0,0,0,1,1,0,0,0,0,0,0,0,0,0,0
156471,21041,210,41,-2,18,1,17,0,0,0,0,0,0,3,0,3,0,0,0,0,0,0,15,1,14,0,0,0,0,0,0,0,0,0
157085,21041,210,41,-2,4,3,1,0,0,0,0,0,0,0,0,0,2,2,0,0,0,0,2,1,1,0,0,0,0,0,0,0,0,0
157289,21041,210,41,-2,20,9,11,0,0,0,1,0,1,1,0,1,1,0,1,0,0,0,13,6,7,0,0,0,0,0,0,4,3,1
157748,21041,210,41,-2,1,1,0,0,0,0,0,0,0,0,0,0,0,0,0,0,0,0,0,0,0,0,0,0,1,1,0,0,0,0
157818,21041,210,41,-2,1,0,1,0,0,0,0,0,0,0,0,0,0,0,0,0,0,0,1,0,1,0,0,0,0,0,0,0,0,0
157951,21041,210,41,-2,10,6,4,0,0,0,0,0,0,1,1,0,0,0,0,0,0,0,9,5,4,0,0,0,0,0,0,0,0,0
159197,21041,210,41,-2,3,2,1,0,0,0,0,0,0,0,0,0,0,0,0,0,0,0,3,2,1,0,0,0,0,0,0,0,0,0
160658,21041,210,41,-2,6,1,5,0,0,0,0,0,0,0,0,0,1,1,0,0,0,0,5,0,5,0,0,0,0,0,0,0,0,0
160959,21041,210,41,-2,1,0,1,0,0,0,1,0,1,0,0,0,0,0,0,0,0,0,0,0,0,0,0,0,0,0,0,0,0,0
161004,21041,210,41,-2,1,1,0,0,0,0,0,0,0,0,0,0,0,0,0,0,0,0,0,0,0,0,0,0,0,0,0,1,1,0
161086,21041,210,41,-2,11,3,8,0,0,0,0,0,0,0,0,0,0,0,0,0,0,0,6,2,4,1,0,1,2,1,1,2,0,2
161226,21041,210,41,-2,1,0,1,0,0,0,0,0,0,0,0,0,0,0,0,0,0,0,1,0,1,0,0,0,0,0,0,0,0,0
161253,21041,210,41,-2,4,2,2,0,0,0,0,0,0,0,0,0,0,0,0,0,0,0,4,2,2,0,0,0,0,0,0,0,0,0
161299,21041,210,41,-2,3,2,1,0,0,0,0,0,0,0,0,0,0,0,0,0,0,0,3,2,1,0,0,0,0,0,0,0,0,0
161509,21041,210,41,-2,1,1,0,0,0,0,0,0,0,0,0,0,0,0,0,0,0,0,1,1,0,0,0,0,0,0,0,0,0,0
161554,21041,210,41,-2,2,1,1,0,0,0,0,0,0,0,0,0,0,0,0,0,0,0,2,1,1,0,0,0,0,0,0,0,0,0
161873,21041,210,41,-2,6,0,6,0,0,0,2,0,2,0,0,0,1,0,1,0,0,0,3,0,3,0,0,0,0,0,0,0,0,0
162007,21041,210,41,-2,1,0,1,0,0,0,0,0,0,1,0,1,0,0,0,0,0,0,0,0,0,0,0,0,0,0,0,0,0,0
162168,21041,210,41,-2,1,0,1,0,0,0,0,0,0,0,0,0,0,0,0,0,0,0,0,0,0,0,0,0,1,0,1,0,0,0
162706,21041,210,41,-2,1,0,1,0,0,0,0,0,0,0,0,0,0,0,0,0,0,0,1,0,1,0,0,0,0,0,0,0,0,0
162779,21041,210,41,-2,8,4,4,0,0,0,1,1,0,2,1,1,0,0,0,0,0,0,4,2,2,1,0,1,0,0,0,0,0,0
162928,21041,210,41,-2,27,19,8,0,0,0,4,3,1,4,2,2,0,0,0,0,0,0,14,11,3,0,0,0,1,1,0,4,2,2
163028,21041,210,41,-2,21,21,0,0,0,0,1,1,0,10,10,0,0,0,0,0,0,0,7,7,0,1,1,0,2,2,0,0,0,0
163295,21041,210,41,-2,12,6,6,0,0,0,2,1,1,2,1,1,1,0,1,0,0,0,2,1,1,0,0,0,1,1,0,4,2,2
163453,21041,210,41,-2,3,3,0,0,0,0,1,1,0,2,2,0,0,0,0,0,0,0,0,0,0,0,0,0,0,0,0,0,0,0
163462,21041,210,41,-2,3,3,0,0,0,0,0,0,0,0,0,0,1,1,0,0,0,0,2,2,0,0,0,0,0,0,0,0,0,0
163851,21041,210,41,-2,1,0,1,0,0,0,0,0,0,0,0,0,0,0,0,0,0,0,1,0,1,0,0,0,0,0,0,0,0,0
163912,21041,210,41,-2,4,2,2,0,0,0,0,0,0,0,0,0,0,0,0,0,0,0,3,1,2,0,0,0,0,0,0,1,1,0
164155,21041,210,41,-2,13,11,2,0,0,0,1,0,1,1,1,0,0,0,0,0,0,0,10,9,1,0,0,0,1,1,0,0,0,0
164173,21041,210,41,-2,1,0,1,0,0,0,0,0,0,0,0,0,0,0,0,0,0,0,1,0,1,0,0,0,0,0,0,0,0,0
164313,21041,210,41,-2,2,0,2,0,0,0,0,0,0,0,0,0,0,0,0,0,0,0,2,0,2,0,0,0,0,0,0,0,0,0
164368,21041,210,41,-2,16,11,5,0,0,0,5,3,2,1,1,0,2,1,1,0,0,0,5,4,1,0,0,0,3,2,1,0,0,0
164465,21041,210,41,-2,6,1,5,0,0,0,1,0,1,2,1,1,0,0,0,0,0,0,3,0,3,0,0,0,0,0,0,0,0,0
164562,21041,210,41,-2,2,1,1,0,0,0,0,0,0,0,0,0,0,0,0,0,0,0,2,1,1,0,0,0,0,0,0,0,0,0
164632,21041,210,41,-2,1,0,1,0,0,0,0,0,0,0,0,0,0,0,0,0,0,0,1,0,1,0,0,0,0,0,0,0,0,0
164748,21041,210,41,-2,9,8,1,1,1,0,1,1,0,0,0,0,2,2,0,0,0,0,5,4,1,0,0,0,0,0,0,0,0,0
164924,21041,210,41,-2,9,4,5,0,0,0,0,0,0,3,1,2,1,0,1,0,0,0,5,3,2,0,0,0,0,0,0,0,0,0
164988,21041,210,41,-2,166,74,92,0,0,0,25,9,16,11,3,8,16,7,9,0,0,0,81,40,41,4,3,1,19,5,14,10,7,3
165015,21041,210,41,-2,8,2,6,0,0,0,1,1,0,0,0,0,1,0,1,0,0,0,3,0,3,0,0,0,2,1,1,1,0,1
165334,21041,210,41,-2,16,9,7,0,0,0,1,0,1,2,1,1,1,1,0,0,0,0,11,7,4,0,0,0,0,0,0,1,0,1
165699,21041,210,41,-2,5,1,4,0,0,0,1,0,1,0,0,0,0,0,0,0,0,0,2,1,1,0,0,0,2,0,2,0,0,0
165866,21041,210,41,-2,2,0,2,0,0,0,0,0,0,0,0,0,0,0,0,0,0,0,2,0,2,0,0,0,0,0,0,0,0,0
166018,21041,210,41,-2,1,0,1,0,0,0,0,0,0,0,0,0,0,0,0,0,0,0,1,0,1,0,0,0,0,0,0,0,0,0
166027,21041,210,41,-2,8,3,5,0,0,0,0,0,0,0,0,0,3,0,3,0,0,0,4,2,2,0,0,0,0,0,0,1,1,0
166045,21041,210,41,-2,1,0,1,0,0,0,0,0,0,0,0,0,0,0,0,0,0,0,1,0,1,0,0,0,0,0,0,0,0,0
166407,21041,210,41,-2,2,0,2,0,0,0,0,0,0,0,0,0,0,0,0,0,0,0,2,0,2,0,0,0,0,0,0,0,0,0
166452,21041,210,41,-2,6,3,3,0,0,0,2,1,1,2,0,2,0,0,0,0,0,0,2,2,0,0,0,0,0,0,0,0,0,0
166629,21041,210,41,-2,5,1,4,0,0,0,0,0,0,2,0,2,0,0,0,0,0,0,1,0,1,0,0,0,0,0,0,2,1,1
166638,21041,210,41,-2,2,0,2,0,0,0,0,0,0,0,0,0,1,0,1,0,0,0,1,0,1,0,0,0,0,0,0,0,0,0
166708,21041,210,41,-2,108,55,53,0,0,0,33,15,18,3,1,2,5,2,3,0,0,0,59,34,25,0,0,0,5,2,3,3,1,2
166717,21041,210,41,-2,11,3,8,0,0,0,0,0,0,2,0,2,1,0,1,0,0,0,8,3,5,0,0,0,0,0,0,0,0,0
166869,21041,210,41,-2,9,1,8,0,0,0,0,0,0,0,0,0,0,0,0,0,0,0,9,1,8,0,0,0,0,0,0,0,0,0
166911,21041,210,41,-2,4,1,3,0,0,0,1,0,1,0,0,0,0,0,0,0,0,0,1,0,1,0,0,0,2,1,1,0,0,0
166939,21041,210,41,-2,7,2,5,0,0,0,0,0,0,0,0,0,0,0,0,0,0,0,5,1,4,0,0,0,1,0,1,1,1,0
167260,21041,210,41,-2,2,2,0,0,0,0,0,0,0,0,0,0,0,0,0,0,0,0,2,2,0,0,0,0,0,0,0,0,0,0
167358,21041,210,41,-2,13,7,6,0,0,0,0,0,0,1,0,1,1,1,0,0,0,0,9,5,4,0,0,0,2,1,1,0,0,0
167783,21041,210,41,-2,4,3,1,0,0,0,0,0,0,1,1,0,0,0,0,0,0,0,2,1,1,0,0,0,0,0,0,1,1,0
167792,21041,210,41,-2,3,1,2,0,0,0,1,0,1,0,0,0,0,0,0,0,0,0,1,0,1,0,0,0,0,0,0,1,1,0
167899,21041,210,41,-2,6,2,4,0,0,0,1,0,1,1,0,1,0,0,0,0,0,0,4,2,2,0,0,0,0,0,0,0,0,0
167987,21041,210,41,-2,3,1,2,0,0,0,0,0,0,0,0,0,0,0,0,0,0,0,3,1,2,0,0,0,0,0,0,0,0,0
167996,21041,210,41,-2,6,3,3,0,0,0,0,0,0,0,0,0,0,0,0,0,0,0,1,0,1,0,0,0,5,3,2,0,0,0
168148,21041,210,41,-2,37,18,19,0,0,0,4,2,2,6,2,4,2,2,0,0,0,0,19,10,9,2,1,1,1,0,1,3,1,2
168218,21041,210,41,-2,5,0,5,0,0,0,1,0,1,0,0,0,1,0,1,0,0,0,2,0,2,0,0,0,0,0,0,1,0,1
168227,21041,210,41,-2,2,1,1,0,0,0,0,0,0,0,0,0,0,0,0,0,0,0,1,0,1,0,0,0,1,1,0,0,0,0
168281,21041,210,41,-2,2,0,2,0,0,0,1,0,1,0,0,0,0,0,0,0,0,0,1,0,1,0,0,0,0,0,0,0,0,0
168342,21041,210,41,-2,7,2,5,0,0,0,1,0,1,1,0,1,3,1,2,0,0,0,1,0,1,0,0,0,0,0,0,1,1,0
168528,21041,210,41,-2,1,0,1,0,0,0,0,0,0,0,0,0,0,0,0,0,0,0,1,0,1,0,0,0,0,0,0,0,0,0
168607,21041,210,41,-2,4,2,2,0,0,0,0,0,0,0,0,0,0,0,0,0,0,0,4,2,2,0,0,0,0,0,0,0,0,0
169248,21041,210,41,-2,3,1,2,0,0,0,0,0,0,0,0,0,0,0,0,0,0,0,3,1,2,0,0,0,0,0,0,0,0,0
169363,21041,210,41,-2,6,3,3,0,0,0,0,0,0,0,0,0,0,0,0,0,0,0,6,3,3,0,0,0,0,0,0,0,0,0
169479,21041,210,41,-2,11,5,6,0,0,0,0,0,0,2,2,0,0,0,0,0,0,0,6,1,5,1,0,1,1,1,0,1,1,0
169655,21041,210,41,-2,14,11,3,0,0,0,0,0,0,5,5,0,1,1,0,0,0,0,7,4,3,1,1,0,0,0,0,0,0,0
169716,21041,210,41,-2,2,0,2,0,0,0,1,0,1,0,0,0,0,0,0,0,0,0,0,0,0,0,0,0,0,0,0,1,0,1
169761,21041,210,41,-2,3,1,2,0,0,0,0,0,0,1,0,1,0,0,0,0,0,0,2,1,1,0,0,0,0,0,0,0,0,0
169798,21041,210,41,-2,2,1,1,0,0,0,0,0,0,0,0,0,0,0,0,0,0,0,2,1,1,0,0,0,0,0,0,0,0,0
170286,21041,210,41,-2,3,2,1,0,0,0,0,0,0,0,0,0,0,0,0,0,0,0,0,0,0,0,0,0,3,2,1,0,0,0
170532,21041,210,41,-2,1,1,0,0,0,0,0,0,0,0,0,0,0,0,0,0,0,0,1,1,0,0,0,0,0,0,0,0,0,0
170550,21041,210,41,-2,4,2,2,0,0,0,0,0,0,0,0,0,0,0,0,0,0,0,4,2,2,0,0,0,0,0,0,0,0,0
170620,21041,210,41,-2,3,2,1,0,0,0,0,0,0,2,1,1,0,0,0,0,0,0,1,1,0,0,0,0,0,0,0,0,0,0
170976,21041,210,41,-2,166,82,84,0,0,0,25,9,16,4,2,2,4,2,2,0,0,0,94,44,50,2,1,1,8,4,4,29,20,9
171100,21041,210,41,-2,17,11,6,0,0,0,3,3,0,0,0,0,0,0,0,0,0,0,10,6,4,0,0,0,0,0,0,4,2,2
171128,21041,210,41,-2,2,2,0,0,0,0,0,0,0,0,0,0,0,0,0,0,0,0,1,1,0,0,0,0,1,1,0,0,0,0
171137,21041,210,41,-2,3,3,0,0,0,0,0,0,0,0,0,0,0,0,0,0,0,0,3,3,0,0,0,0,0,0,0,0,0,0
171146,21041,210,41,-2,4,1,3,0,0,0,0,0,0,0,0,0,0,0,0,0,0,0,4,1,3,0,0,0,0,0,0,0,0,0
171456,21041,210,41,-2,2,1,1,0,0,0,0,0,0,0,0,0,0,0,0,0,0,0,2,1,1,0,0,0,0,0,0,0,0,0
171535,21041,210,41,-2,10,3,7,0,0,0,0,0,0,2,1,1,0,0,0,0,0,0,8,2,6,0,0,0,0,0,0,0,0,0
171571,21041,210,41,-2,1,0,1,0,0,0,0,0,0,0,0,0,0,0,0,0,0,0,1,0,1,0,0,0,0,0,0,0,0,0
172033,21041,210,41,-2,4,3,1,0,0,0,0,0,0,0,0,0,0,0,0,0,0,0,4,3,1,0,0,0,0,0,0,0,0,0
172617,21041,210,41,-2,1,1,0,1,1,0,0,0,0,0,0,0,0,0,0,0,0,0,0,0,0,0,0,0,0,0,0,0,0,0
172635,21041,210,41,-2,3,1,2,0,0,0,0,0,0,2,1,1,0,0,0,0,0,0,1,0,1,0,0,0,0,0,0,0,0,0
172644,21041,210,41,-2,39,19,20,0,0,0,2,0,2,5,2,3,1,1,0,0,0,0,24,14,10,0,0,0,0,0,0,7,2,5
173300,21041,210,41,-2,4,2,2,0,0,0,0,0,0,0,0,0,1,0,1,0,0,0,3,2,1,0,0,0,0,0,0,0,0,0
173328,21041,210,41,-2,1,1,0,0,0,0,0,0,0,0,0,0,0,0,0,0,0,0,1,1,0,0,0,0,0,0,0,0,0,0
173452,21041,210,41,-2,5,5,0,0,0,0,0,0,0,1,1,0,0,0,0,0,0,0,4,4,0,0,0,0,0,0,0,0,0,0
174066,21041,210,41,-2,6,2,4,0,0,0,0,0,0,2,1,1,0,0,0,0,0,0,1,0,1,0,0,0,2,1,1,1,0,1
174127,21041,210,41,-2,2,0,2,0,0,0,0,0,0,1,0,1,0,0,0,0,0,0,1,0,1,0,0,0,0,0,0,0,0,0
174154,21041,210,41,-2,7,0,7,0,0,0,0,0,0,0,0,0,0,0,0,0,0,0,7,0,7,0,0,0,0,0,0,0,0,0
174233,21041,210,41,-2,1,0,1,0,0,0,0,0,0,0,0,0,0,0,0,0,0,0,1,0,1,0,0,0,0,0,0,0,0,0
174525,21041,210,41,-2,1,1,0,0,0,0,0,0,0,0,0,0,0,0,0,0,0,0,1,1,0,0,0,0,0,0,0,0,0,0
174844,21041,210,41,-2,3,2,1,0,0,0,0,0,0,0,0,0,1,1,0,0,0,0,1,0,1,0,0,0,1,1,0,0,0,0
175005,21041,210,41,-2,13,1,12,0,0,0,0,0,0,1,0,1,0,0,0,0,0,0,12,1,11,0,0,0,0,0,0,0,0,0
175014,21041,210,41,-2,20,4,16,0,0,0,0,0,0,2,1,1,0,0,0,0,0,0,16,2,14,1,1,0,1,0,1,0,0,0
175227,21041,210,41,-2,11,7,4,0,0,0,1,0,1,0,0,0,0,0,0,0,0,0,10,7,3,0,0,0,0,0,0,0,0,0
175342,21041,210,41,-2,2,0,2,0,0,0,0,0,0,1,0,1,0,0,0,0,0,0,1,0,1,0,0,0,0,0,0,0,0,0
176789,21041,210,41,-2,1,1,0,0,0,0,1,1,0,0,0,0,0,0,0,0,0,0,0,0,0,0,0,0,0,0,0,0,0,0
177092,21041,210,41,-2,3,3,0,0,0,0,0,0,0,0,0,0,1,1,0,0,0,0,2,2,0,0,0,0,0,0,0,0,0,0
177302,21041,210,41,-2,4,4,0,0,0,0,1,1,0,1,1,0,0,0,0,0,0,0,2,2,0,0,0,0,0,0,0,0,0,0
177986,21041,210,41,-2,2,1,1,0,0,0,0,0,0,0,0,0,0,0,0,0,0,0,1,0,1,1,1,0,0,0,0,0,0,0
178183,21041,210,41,-2,2,0,2,0,0,0,0,0,0,0,0,0,0,0,0,0,0,0,2,0,2,0,0,0,0,0,0,0,0,0
178208,21041,210,41,-2,2,2,0,0,0,0,0,0,0,0,0,0,1,1,0,0,0,0,1,1,0,0,0,0,0,0,0,0,0,0
178891,21041,210,41,-2,7,6,1,0,0,0,0,0,0,1,0,1,0,0,0,0,0,0,6,6,0,0,0,0,0,0,0,0,0,0
179159,21041,210,41,-2,1,0,1,0,0,0,0,0,0,0,0,0,0,0,0,0,0,0,0,0,0,1,0,1,0,0,0,0,0,0
179317,21041,210,41,-2,1,1,0,0,0,0,0,0,0,1,1,0,0,0,0,0,0,0,0,0,0,0,0,0,0,0,0,0,0,0
179557,21041,210,41,-2,6,3,3,0,0,0,1,1,0,0,0,0,0,0,0,0,0,0,4,1,3,0,0,0,1,1,0,0,0,0
179812,21041,210,41,-2,8,4,4,0,0,0,0,0,0,0,0,0,1,0,1,0,0,0,6,4,2,1,0,1,0,0,0,0,0,0
179955,21041,210,41,-2,3,2,1,0,0,0,0,0,0,0,0,0,0,0,0,0,0,0,3,2,1,0,0,0,0,0,0,0,0,0
180054,21041,210,41,-2,1,1,0,1,1,0,0,0,0,0,0,0,0,0,0,0,0,0,0,0,0,0,0,0,0,0,0,0,0,0
180647,21041,210,41,-2,8,5,3,3,2,1,0,0,0,0,0,0,1,0,1,0,0,0,4,3,1,0,0,0,0,0,0,0,0,0
180814,21041,210,41,-2,3,3,0,0,0,0,0,0,0,0,0,0,0,0,0,0,0,0,2,2,0,0,0,0,1,1,0,0,0,0
180984,21041,210,41,-2,3,1,2,0,0,0,0,0,0,0,0,0,0,0,0,0,0,0,3,1,2,0,0,0,0,0,0,0,0,0
181446,21041,210,41,-2,1,0,1,0,0,0,0,0,0,0,0,0,0,0,0,0,0,0,1,0,1,0,0,0,0,0,0,0,0,0
181464,21041,210,41,-2,5,3,2,0,0,0,0,0,0,0,0,0,1,0,1,0,0,0,2,2,0,1,0,1,0,0,0,1,1,0
181941,21041,210,41,-2,10,7,3,1,1,0,0,0,0,0,0,0,2,1,1,0,0,0,7,5,2,0,0,0,0,0,0,0,0,0
182148,21041,210,41,-2,14,0,14,0,0,0,0,0,0,1,0,1,4,0,4,0,0,0,9,0,9,0,0,0,0,0,0,0,0,0
182634,21041,210,41,-2,5,0,5,0,0,0,0,0,0,0,0,0,0,0,0,0,0,0,5,0,5,0,0,0,0,0,0,0,0,0
182670,21041,210,41,-2,7,1,6,0,0,0,0,0,0,0,0,0,0,0,0,0,0,0,6,0,6,0,0,0,0,0,0,1,1,0
182829,21041,210,41,-2,1,0,1,0,0,0,0,0,0,0,0,0,0,0,0,0,0,0,1,0,1,0,0,0,0,0,0,0,0,0
182980,21041,210,41,-2,5,0,5,0,0,0,0,0,0,1,0,1,0,0,0,0,0,0,4,0,4,0,0,0,0,0,0,0,0,0
183044,21041,210,41,-2,23,7,16,0,0,0,1,1,0,0,0,0,1,0,1,0,0,0,13,5,8,1,0,1,3,0,3,4,1,3
183062,21041,210,41,-2,2,2,0,0,0,0,0,0,0,0,0,0,0,0,0,0,0,0,1,1,0,0,0,0,1,1,0,0,0,0
183071,21041,210,41,-2,1,1,0,0,0,0,0,0,0,0,0,0,0,0,0,0,0,0,1,1,0,0,0,0,0,0,0,0,0,0
183080,21041,210,41,-2,12,5,7,0,0,0,0,0,0,0,0,0,0,0,0,0,0,0,10,5,5,0,0,0,1,0,1,1,0,1
183248,21041,210,41,-2,2,0,2,0,0,0,0,0,0,0,0,0,0,0,0,0,0,0,2,0,2,0,0,0,0,0,0,0,0,0
183257,21041,210,41,-2,3,1,2,0,0,0,0,0,0,0,0,0,0,0,0,0,0,0,3,1,2,0,0,0,0,0,0,0,0,0
184782,21041,210,41,-2,14,8,6,0,0,0,0,0,0,2,2,0,0,0,0,0,0,0,9,4,5,0,0,0,1,1,0,2,1,1
184959,21041,210,41,-2,3,0,3,0,0,0,0,0,0,0,0,0,0,0,0,0,0,0,3,0,3,0,0,0,0,0,0,0,0,0
185572,21041,210,41,-2,6,1,5,0,0,0,0,0,0,0,0,0,1,1,0,0,0,0,5,0,5,0,0,0,0,0,0,0,0,0
185721,21041,210,41,-2,1,0,1,0,0,0,0,0,0,0,0,0,0,0,0,0,0,0,1,0,1,0,0,0,0,0,0,0,0,0
186131,21041,210,41,-2,3,1,2,0,0,0,0,0,0,1,1,0,0,0,0,0,0,0,2,0,2,0,0,0,0,0,0,0,0,0
186283,21041,210,41,-2,2,0,2,0,0,0,1,0,1,0,0,0,0,0,0,0,0,0,1,0,1,0,0,0,0,0,0,0,0,0
186371,21041,210,41,-2,4,3,1,0,0,0,0,0,0,0,0,0,0,0,0,0,0,0,1,1,0,0,0,0,3,2,1,0,0,0
186380,21041,210,41,-2,147,59,88,0,0,0,7,5,2,5,2,3,4,1,3,0,0,0,22,8,14,0,0,0,99,35,64,10,8,2
186399,21041,210,41,-2,17,8,9,0,0,0,1,0,1,1,0,1,1,1,0,0,0,0,0,0,0,0,0,0,11,6,5,3,1,2
186584,21041,210,41,-2,1,0,1,0,0,0,0,0,0,0,0,0,0,0,0,0,0,0,1,0,1,0,0,0,0,0,0,0,0,0
186867,21041,210,41,-2,12,8,4,0,0,0,0,0,0,0,0,0,0,0,0,0,0,0,5,2,3,0,0,0,0,0,0,7,6,1
187967,21041,210,41,-2,5,1,4,0,0,0,1,0,1,0,0,0,2,1,1,0,0,0,2,0,2,0,0,0,0,0,0,0,0,0
188030,21041,210,41,-2,7,4,3,0,0,0,0,0,0,0,0,0,1,0,1,0,0,0,6,4,2,0,0,0,0,0,0,0,0,0
188429,21041,210,41,-2,3,1,2,0,0,0,0,0,0,1,0,1,0,0,0,0,0,0,2,1,1,0,0,0,0,0,0,0,0,0
188517,21041,210,41,-2,2,0,2,0,0,0,0,0,0,0,0,0,0,0,0,0,0,0,1,0,1,0,0,0,1,0,1,0,0,0
188580,21041,210,41,-2,15,6,9,0,0,0,2,2,0,1,1,0,1,0,1,0,0,0,10,3,7,0,0,0,1,0,1,0,0,0
188641,21041,210,41,-2,2,0,2,0,0,0,0,0,0,0,0,0,0,0,0,0,0,0,2,0,2,0,0,0,0,0,0,0,0,0
188854,21041,210,41,-2,3,2,1,0,0,0,0,0,0,0,0,0,0,0,0,0,0,0,2,1,1,1,1,0,0,0,0,0,0,0
189088,21041,210,41,-2,2,1,1,0,0,0,0,0,0,1,1,0,0,0,0,0,0,0,0,0,0,0,0,0,1,0,1,0,0,0
189097,21041,210,41,-2,1,1,0,0,0,0,0,0,0,0,0,0,0,0,0,0,0,0,1,1,0,0,0,0,0,0,0,0,0,0
189565,21041,210,41,-2,2,0,2,0,0,0,0,0,0,0,0,0,0,0,0,0,0,0,1,0,1,0,0,0,1,0,1,0,0,0
189705,21041,210,41,-2,3,0,3,0,0,0,0,0,0,0,0,0,0,0,0,0,0,0,3,0,3,0,0,0,0,0,0,0,0,0
189811,21041,210,41,-2,1,0,1,0,0,0,1,0,1,0,0,0,0,0,0,0,0,0,0,0,0,0,0,0,0,0,0,0,0,0
190044,21041,210,41,-2,5,1,4,0,0,0,0,0,0,0,0,0,0,0,0,0,0,0,5,1,4,0,0,0,0,0,0,0,0,0
190071,21041,210,41,-2,2,0,2,0,0,0,0,0,0,0,0,0,0,0,0,0,0,0,2,0,2,0,0,0,0,0,0,0,0,0
190415,21041,210,41,-2,22,13,9,0,0,0,3,2,1,0,0,0,2,2,0,0,0,0,13,7,6,0,0,0,0,0,0,4,2,2
190451,21041,210,41,-2,1,0,1,0,0,0,0,0,0,0,0,0,0,0,0,0,0,0,1,0,1,0,0,0,0,0,0,0,0,0
190503,21041,210,41,-2,5,2,3,0,0,0,1,0,1,0,0,0,1,0,1,0,0,0,3,2,1,0,0,0,0,0,0,0,0,0
190956,21041,210,41,-2,4,0,4,0,0,0,0,0,0,0,0,0,0,0,0,0,0,0,4,0,4,0,0,0,0,0,0,0,0,0
191241,21041,210,41,-2,1,1,0,0,0,0,0,0,0,0,0,0,0,0,0,0,0,0,1,1,0,0,0,0,0,0,0,0,0,0
191320,21041,210,41,-2,1,0,1,0,0,0,0,0,0,0,0,0,0,0,0,0,0,0,1,0,1,0,0,0,0,0,0,0,0,0
191515,21041,210,41,-2,5,3,2,0,0,0,0,0,0,0,0,0,0,0,0,0,0,0,2,2,0,0,0,0,0,0,0,3,1,2
191630,21041,210,41,-2,6,3,3,0,0,0,1,1,0,1,1,0,1,0,1,0,0,0,3,1,2,0,0,0,0,0,0,0,0,0
191649,21041,210,41,-2,2,1,1,0,0,0,0,0,0,0,0,0,0,0,0,0,0,0,2,1,1,0,0,0,0,0,0,0,0,0
191968,21041,210,41,-2,4,2,2,0,0,0,0,0,0,0,0,0,0,0,0,0,0,0,1,1,0,0,0,0,3,1,2,0,0,0
192323,21041,210,41,-2,3,2,1,0,0,0,0,0,0,0,0,0,0,0,0,0,0,0,3,2,1,0,0,0,0,0,0,0,0,0
192688,21041,210,41,-2,2,1,1,0,0,0,1,0,1,0,0,0,1,1,0,0,0,0,0,0,0,0,0,0,0,0,0,0,0,0
193308,21041,210,41,-2,9,2,7,0,0,0,3,1,2,1,0,1,2,0,2,0,0,0,3,1,2,0,0,0,0,0,0,0,0,0
193654,21041,210,41,-2,4,2,2,0,0,0,0,0,0,1,1,0,1,0,1,0,0,0,2,1,1,0,0,0,0,0,0,0,0,0
193900,21041,210,41,-2,439,200,239,1,0,1,98,50,48,25,8,17,31,12,19,1,1,0,239,109,130,3,1,2,9,3,6,32,16,16
194091,21041,210,41,-2,2,2,0,0,0,0,0,0,0,0,0,0,0,0,0,0,0,0,1,1,0,1,1,0,0,0,0,0,0,0
194578,21041,210,41,-2,5,3,2,0,0,0,2,0,2,0,0,0,0,0,0,0,0,0,3,3,0,0,0,0,0,0,0,0,0,0
194824,21041,210,41,-2,5,3,2,0,0,0,2,2,0,0,0,0,0,0,0,0,0,0,3,1,2,0,0,0,0,0,0,0,0,0
195003,21041,210,41,-2,1,1,0,0,0,0,0,0,0,0,0,0,0,0,0,0,0,0,1,1,0,0,0,0,0,0,0,0,0,0
195030,21041,210,41,-2,49,32,17,0,0,0,6,4,2,3,1,2,2,1,1,0,0,0,27,17,10,0,0,0,0,0,0,11,9,2
195128,21041,210,41,-2,4,0,4,0,0,0,1,0,1,1,0,1,0,0,0,0,0,0,2,0,2,0,0,0,0,0,0,0,0,0
195720,21041,210,41,-2,9,2,7,0,0,0,0,0,0,2,0,2,0,0,0,0,0,0,6,1,5,0,0,0,1,1,0,0,0,0
195784,21041,210,41,-2,1,0,1,0,0,0,0,0,0,0,0,0,0,0,0,0,0,0,1,0,1,0,0,0,0,0,0,0,0,0
196015,21041,210,41,-2,2,1,1,0,0,0,0,0,0,0,0,0,0,0,0,0,0,0,1,0,1,0,0,0,0,0,0,1,1,0
196060,21041,210,41,-2,1,0,1,0,0,0,0,0,0,0,0,0,0,0,0,0,0,0,1,0,1,0,0,0,0,0,0,0,0,0
196079,21041,210,41,-2,8,3,5,0,0,0,0,0,0,1,0,1,1,0,1,0,0,0,6,3,3,0,0,0,0,0,0,0,0,0
196088,21041,210,41,-2,19,7,12,2,1,1,1,0,1,2,1,1,0,0,0,0,0,0,13,4,9,0,0,0,0,0,0,1,1,0
196097,21041,210,41,-2,4,2,2,0,0,0,0,0,0,0,0,0,0,0,0,0,0,0,1,0,1,0,0,0,1,0,1,2,2,0
196112,21041,210,41,-2,1,0,1,0,0,0,0,0,0,0,0,0,0,0,0,0,0,0,1,0,1,0,0,0,0,0,0,0,0,0
196176,21041,210,41,-2,1,0,1,0,0,0,0,0,0,1,0,1,0,0,0,0,0,0,0,0,0,0,0,0,0,0,0,0,0,0
196307,21041,210,41,-2,24,15,9,0,0,0,9,6,3,0,0,0,0,0,0,0,0,0,15,9,6,0,0,0,0,0,0,0,0,0
196389,21041,210,41,-2,7,2,5,0,0,0,1,1,0,3,1,2,2,0,2,0,0,0,1,0,1,0,0,0,0,0,0,0,0,0
196413,21041,210,41,-2,32,14,18,0,0,0,5,3,2,2,0,2,2,2,0,0,0,0,16,5,11,2,0,2,0,0,0,5,4,1
196468,21041,210,41,-2,4,2,2,0,0,0,1,0,1,0,0,0,0,0,0,0,0,0,1,0,1,1,1,0,0,0,0,1,1,0
196592,21041,210,41,-2,2,0,2,0,0,0,0,0,0,0,0,0,0,0,0,0,0,0,2,0,2,0,0,0,0,0,0,0,0,0
196680,21041,210,41,-2,1,0,1,0,0,0,0,0,0,0,0,0,0,0,0,0,0,0,1,0,1,0,0,0,0,0,0,0,0,0
196866,21041,210,41,-2,2,2,0,0,0,0,0,0,0,0,0,0,0,0,0,0,0,0,1,1,0,0,0,0,0,0,0,1,1,0
197036,21041,210,41,-2,9,4,5,0,0,0,0,0,0,0,0,0,0,0,0,0,0,0,9,4,5,0,0,0,0,0,0,0,0,0
197133,21041,210,41,-2,10,6,4,0,0,0,0,0,0,3,2,1,1,0,1,0,0,0,2,1,1,1,1,0,2,2,0,1,0,1
197230,21041,210,41,-2,3,1,2,0,0,0,0,0,0,0,0,0,1,0,1,0,0,0,1,0,1,1,1,0,0,0,0,0,0,0
197869,21041,210,41,-2,1,1,0,0,0,0,0,0,0,0,0,0,0,0,0,0,0,0,1,1,0,0,0,0,0,0,0,0,0,0
198109,21041,210,41,-2,3,1,2,0,0,0,0,0,0,1,1,0,0,0,0,0,0,0,2,0,2,0,0,0,0,0,0,0,0,0
198385,21041,210,41,-2,9,4,5,0,0,0,2,1,1,0,0,0,1,0,1,0,0,0,6,3,3,0,0,0,0,0,0,0,0,0
198419,21041,210,41,-2,85,41,44,1,0,1,11,5,6,6,4,2,6,1,5,0,0,0,50,23,27,1,1,0,0,0,0,10,7,3
198464,21041,210,41,-2,8,5,3,0,0,0,0,0,0,0,0,0,1,1,0,0,0,0,3,1,2,0,0,0,1,0,1,3,3,0
198507,21041,210,41,-2,4,2,2,0,0,0,0,0,0,1,0,1,0,0,0,0,0,0,2,1,1,0,0,0,0,0,0,1,1,0
198552,21041,210,41,-2,14,6,8,0,0,0,0,0,0,6,2,4,0,0,0,0,0,0,7,4,3,1,0,1,0,0,0,0,0,0
199111,21041,210,41,-2,5,3,2,0,0,0,0,0,0,0,0,0,0,0,0,0,0,0,0,0,0,0,0,0,4,2,2,1,1,0
199120,21041,210,41,-2,9,3,6,0,0,0,2,0,2,1,0,1,2,1,1,0,0,0,2,1,1,0,0,0,2,1,1,0,0,0
199139,21041,210,41,-2,20,7,13,0,0,0,0,0,0,7,1,6,1,0,1,0,0,0,9,4,5,1,0,1,0,0,0,2,2,0
199148,21041,210,41,-2,7,0,7,0,0,0,1,0,1,2,0,2,0,0,0,0,0,0,3,0,3,0,0,0,1,0,1,0,0,0
199157,21041,210,41,-2,2,0,2,0,0,0,0,0,0,1,0,1,0,0,0,0,0,0,0,0,0,0,0,0,1,0,1,0,0,0
199184,21041,210,41,-2,5,1,4,0,0,0,1,0,1,1,0,1,0,0,0,0,0,0,3,1,2,0,0,0,0,0,0,0,0,0
199193,21041,210,41,-2,20,9,11,0,0,0,1,1,0,2,0,2,2,1,1,0,0,0,14,6,8,0,0,0,1,1,0,0,0,0
199272,21041,210,41,-2,1,0,1,0,0,0,0,0,0,0,0,0,0,0,0,0,0,0,1,0,1,0,0,0,0,0,0,0,0,0
199281,21041,210,41,-2,1,0,1,0,0,0,1,0,1,0,0,0,0,0,0,0,0,0,0,0,0,0,0,0,0,0,0,0,0,0
199698,21041,210,41,-2,5,1,4,0,0,0,0,0,0,1,0,1,0,0,0,0,0,0,4,1,3,0,0,0,0,0,0,0,0,0
199759,21041,210,41,-2,1,0,1,0,0,0,0,0,0,0,0,0,0,0,0,0,0,0,1,0,1,0,0,0,0,0,0,0,0,0
199847,21041,210,41,-2,12,6,6,1,1,0,3,2,1,2,0,2,0,0,0,0,0,0,6,3,3,0,0,0,0,0,0,0,0,0
199883,21041,210,41,-2,1,0,1,0,0,0,0,0,0,1,0,1,0,0,0,0,0,0,0,0,0,0,0,0,0,0,0,0,0,0
200004,21041,210,41,-2,4,3,1,0,0,0,0,0,0,1,1,0,0,0,0,0,0,0,3,2,1,0,0,0,0,0,0,0,0,0
200156,21041,210,41,-2,7,3,4,0,0,0,0,0,0,0,0,0,0,0,0,0,0,0,7,3,4,0,0,0,0,0,0,0,0,0
200217,21041,210,41,-2,11,3,8,0,0,0,1,1,0,0,0,0,0,0,0,0,0,0,10,2,8,0,0,0,0,0,0,0,0,0
200572,21041,210,41,-2,2,1,1,0,0,0,0,0,0,0,0,0,0,0,0,0,0,0,2,1,1,0,0,0,0,0,0,0,0,0
200590,21041,210,41,-2,1,0,1,0,0,0,0,0,0,0,0,0,0,0,0,0,0,0,1,0,1,0,0,0,0,0,0,0,0,0
201177,21041,210,41,-2,1,0,1,0,0,0,0,0,0,0,0,0,0,0,0,0,0,0,1,0,1,0,0,0,0,0,0,0,0,0
201371,21041,210,41,-2,2,0,2,0,0,0,0,0,0,0,0,0,0,0,0,0,0,0,2,0,2,0,0,0,0,0,0,0,0,0
201469,21041,210,41,-2,3,1,2,0,0,0,0,0,0,0,0,0,0,0,0,0,0,0,3,1,2,0,0,0,0,0,0,0,0,0
201645,21041,210,41,-2,16,7,9,0,0,0,1,0,1,1,0,1,1,1,0,0,0,0,11,4,7,0,0,0,1,1,0,1,1,0
201690,21041,210,41,-2,4,3,1,0,0,0,0,0,0,1,1,0,0,0,0,0,0,0,3,2,1,0,0,0,0,0,0,0,0,0
201751,21041,210,41,-2,2,0,2,0,0,0,0,0,0,0,0,0,0,0,0,0,0,0,1,0,1,0,0,0,1,0,1,0,0,0
201821,21041,210,41,-2,9,2,7,0,0,0,0,0,0,0,0,0,0,0,0,0,0,0,9,2,7,0,0,0,0,0,0,0,0,0
201885,21041,210,41,-2,121,63,58,0,0,0,17,9,8,5,2,3,4,3,1,0,0,0,74,36,38,2,1,1,9,4,5,10,8,2
201946,21041,210,41,-2,3,0,3,0,0,0,0,0,0,0,0,0,0,0,0,0,0,0,3,0,3,0,0,0,0,0,0,0,0,0
202046,21041,210,41,-2,1,1,0,0,0,0,0,0,0,0,0,0,0,0,0,0,0,0,1,1,0,0,0,0,0,0,0,0,0,0
202648,21041,210,41,-2,3,1,2,0,0,0,1,0,1,0,0,0,0,0,0,0,0,0,1,0,1,0,0,0,1,1,0,0,0,0
202806,21041,210,41,-2,5,1,4,0,0,0,0,0,0,0,0,0,0,0,0,0,0,0,5,1,4,0,0,0,0,0,0,0,0,0
202912,21041,210,41,-2,6,0,6,0,0,0,0,0,0,0,0,0,0,0,0,0,0,0,6,0,6,0,0,0,0,0,0,0,0,0
203085,21041,210,41,-2,5,3,2,0,0,0,0,0,0,1,0,1,0,0,0,0,0,0,4,3,1,0,0,0,0,0,0,0,0,0
203155,21041,210,41,-2,11,7,4,0,0,0,0,0,0,1,0,1,0,0,0,0,0,0,10,7,3,0,0,0,0,0,0,0,0,0
203386,21041,210,41,-2,33,5,28,0,0,0,0,0,0,4,0,4,0,0,0,0,0,0,28,5,23,0,0,0,1,0,1,0,0,0
203720,21041,210,41,-2,5,5,0,0,0,0,0,0,0,2,2,0,0,0,0,0,0,0,3,3,0,0,0,0,0,0,0,0,0,0
204006,21041,210,41,-2,1,0,1,0,0,0,0,0,0,0,0,0,0,0,0,0,0,0,1,0,1,0,0,0,0,0,0,0,0,0
204024,21041,210,41,-2,26,11,15,0,0,0,1,0,1,1,0,1,0,0,0,0,0,0,24,11,13,0,0,0,0,0,0,0,0,0
204185,21041,210,41,-2,2,0,2,0,0,0,0,0,0,0,0,0,0,0,0,0,0,0,2,0,2,0,0,0,0,0,0,0,0,0
204477,21041,210,41,-2,1,1,0,0,0,0,0,0,0,0,0,0,0,0,0,0,0,0,1,1,0,0,0,0,0,0,0,0,0,0
204501,21041,210,41,-2,9,5,4,0,0,0,0,0,0,0,0,0,0,0,0,0,0,0,5,2,3,0,0,0,1,0,1,3,3,0
204796,21041,210,41,-2,196,69,127,0,0,0,33,11,22,12,5,7,8,3,5,0,0,0,120,38,82,3,0,3,13,7,6,7,5,2
205054,21041,210,41,-2,1,0,1,0,0,0,0,0,0,0,0,0,0,0,0,0,0,0,1,0,1,0,0,0,0,0,0,0,0,0
205179,21041,210,41,-2,3,1,2,0,0,0,0,0,0,0,0,0,0,0,0,0,0,0,3,1,2,0,0,0,0,0,0,0,0,0
205887,21041,210,41,-2,6,0,6,0,0,0,0,0,0,1,0,1,0,0,0,0,0,0,5,0,5,0,0,0,0,0,0,0,0,0
206048,21041,210,41,-2,1,1,0,0,0,0,0,0,0,0,0,0,0,0,0,0,0,0,1,1,0,0,0,0,0,0,0,0,0,0
206525,21041,210,41,-2,4,0,4,0,0,0,0,0,0,0,0,0,0,0,0,0,0,0,4,0,4,0,0,0,0,0,0,0,0,0
206604,21041,210,41,-2,5,0,5,0,0,0,1,0,1,0,0,0,0,0,0,0,0,0,4,0,4,0,0,0,0,0,0,0,0,0
206923,21041,210,41,-2,1,0,1,0,0,0,0,0,0,0,0,0,0,0,0,0,0,0,1,0,1,0,0,0,0,0,0,0,0,0
206932,21041,210,41,-2,3,1,2,0,0,0,0,0,0,0,0,0,0,0,0,0,0,0,3,1,2,0,0,0,0,0,0,0,0,0
207403,21041,210,41,-2,4,3,1,0,0,0,0,0,0,0,0,0,0,0,0,0,0,0,4,3,1,0,0,0,0,0,0,0,0,0
207458,21041,210,41,-2,3,1,2,0,0,0,0,0,0,0,0,0,0,0,0,0,0,0,3,1,2,0,0,0,0,0,0,0,0,0
207500,21041,210,41,-2,22,11,11,0,0,0,1,1,0,5,3,2,1,0,1,0,0,0,11,6,5,0,0,0,1,0,1,3,1,2
207564,21041,210,41,-2,8,6,2,0,0,0,0,0,0,1,1,0,0,0,0,0,0,0,6,4,2,1,1,0,0,0,0,0,0,0
207582,21041,210,41,-2,2,2,0,0,0,0,0,0,0,0,0,0,0,0,0,0,0,0,1,1,0,0,0,0,0,0,0,1,1,0
207661,21041,210,41,-2,8,3,5,1,1,0,2,0,2,0,0,0,0,0,0,0,0,0,4,2,2,0,0,0,1,0,1,0,0,0
207962,21041,210,41,-2,4,4,0,1,1,0,0,0,0,0,0,0,0,0,0,0,0,0,2,2,0,0,0,0,1,1,0,0,0,0
207971,21041,210,41,-2,8,4,4,0,0,0,0,0,0,2,2,0,0,0,0,0,0,0,5,1,4,0,0,0,1,1,0,0,0,0
208479,21041,210,41,-2,2,1,1,0,0,0,1,1,0,0,0,0,0,0,0,0,0,0,1,0,1,0,0,0,0,0,0,0,0,0
209065,21041,210,41,-2,1,0,1,0,0,0,0,0,0,0,0,0,0,0,0,0,0,0,1,0,1,0,0,0,0,0,0,0,0,0
209490,21041,210,41,-2,1,0,1,0,0,0,1,0,1,0,0,0,0,0,0,0,0,0,0,0,0,0,0,0,0,0,0,0,0,0
209551,21041,210,41,-2,14,3,11,0,0,0,1,0,1,1,0,1,0,0,0,0,0,0,7,1,6,1,0,1,2,1,1,2,1,1
209612,21041,210,41,-2,2,0,2,0,0,0,0,0,0,0,0,0,0,0,0,0,0,0,2,0,2,0,0,0,0,0,0,0,0,0
209807,21041,210,41,-2,3,1,2,0,0,0,0,0,0,1,0,1,2,1,1,0,0,0,0,0,0,0,0,0,0,0,0,0,0,0
209922,21041,210,41,-2,6,2,4,0,0,0,0,0,0,0,0,0,1,0,1,0,0,0,1,0,1,2,2,0,0,0,0,2,0,2
210234,21041,210,41,-2,1,0,1,0,0,0,0,0,0,0,0,0,1,0,1,0,0,0,0,0,0,0,0,0,0,0,0,0,0,0
210438,21041,210,41,-2,2,1,1,0,0,0,0,0,0,1,1,0,0,0,0,0,0,0,0,0,0,0,0,0,1,0,1,0,0,0
210599,21041,210,41,-2,9,5,4,0,0,0,0,0,0,3,0,3,1,0,1,0,0,0,2,2,0,1,1,0,2,2,0,0,0,0
210605,21041,210,41,-2,10,3,7,0,0,0,1,0,1,2,1,1,0,0,0,0,0,0,6,2,4,0,0,0,1,0,1,0,0,0
210669,21041,210,41,-2,4,2,2,0,0,0,1,0,1,0,0,0,0,0,0,0,0,0,2,2,0,1,0,1,0,0,0,0,0,0
210809,21041,210,41,-2,2,1,1,0,0,0,0,0,0,1,0,1,0,0,0,0,0,0,1,1,0,0,0,0,0,0,0,0,0,0
211291,21041,210,41,-2,3,0,3,0,0,0,0,0,0,1,0,1,0,0,0,0,0,0,1,0,1,0,0,0,0,0,0,1,0,1
211440,21041,210,41,-2,7,4,3,0,0,0,0,0,0,0,0,0,1,1,0,0,0,0,3,1,2,1,1,0,1,1,0,1,0,1
211556,21041,210,41,-2,9,2,7,0,0,0,0,0,0,0,0,0,1,1,0,0,0,0,8,1,7,0,0,0,0,0,0,0,0,0
212045,21041,210,41,-2,1,1,0,0,0,0,0,0,0,0,0,0,0,0,0,0,0,0,1,1,0,0,0,0,0,0,0,0,0,0
212054,21041,210,41,-2,22,12,10,0,0,0,2,0,2,3,3,0,0,0,0,0,0,0,11,6,5,2,1,1,0,0,0,4,2,2
212115,21041,210,41,-2,2,2,0,0,0,0,0,0,0,0,0,0,0,0,0,0,0,0,2,2,0,0,0,0,0,0,0,0,0,0
212577,21041,210,41,-2,2,1,1,0,0,0,0,0,0,0,0,0,0,0,0,0,0,0,1,0,1,0,0,0,0,0,0,1,1,0
212674,21041,210,41,-2,2,1,1,0,0,0,0,0,0,0,0,0,0,0,0,0,0,0,1,1,0,0,0,0,0,0,0,1,0,1
212911,21041,210,41,-2,19,9,10,0,0,0,3,1,2,0,0,0,1,0,1,0,0,0,9,4,5,0,0,0,1,0,1,5,4,1
213233,21041,210,41,-2,4,4,0,0,0,0,0,0,0,0,0,0,0,0,0,0,0,0,4,4,0,0,0,0,0,0,0,0,0,0
213385,21041,210,41,-2,2,1,1,0,0,0,0,0,0,0,0,0,0,0,0,0,0,0,1,0,1,0,0,0,0,0,0,1,1,0
213507,21041,210,41,-2,1,0,1,0,0,0,0,0,0,0,0,0,0,0,0,0,0,0,1,0,1,0,0,0,0,0,0,0,0,0
213534,21041,210,41,-2,1,0,1,0,0,0,0,0,0,0,0,0,0,0,0,0,0,0,1,0,1,0,0,0,0,0,0,0,0,0
213543,21041,210,41,-2,12,7,5,0,0,0,2,0,2,2,1,1,0,0,0,0,0,0,6,4,2,0,0,0,2,2,0,0,0,0
213570,21041,210,41,-2,2,0,2,0,0,0,0,0,0,1,0,1,0,0,0,0,0,0,1,0,1,0,0,0,0,0,0,0,0,0
213589,21041,210,41,-2,2,2,0,0,0,0,0,0,0,0,0,0,0,0,0,0,0,0,2,2,0,0,0,0,0,0,0,0,0,0
213668,21041,210,41,-2,2,0,2,0,0,0,0,0,0,0,0,0,0,0,0,0,0,0,2,0,2,0,0,0,0,0,0,0,0,0
213996,21041,210,41,-2,2,0,2,0,0,0,0,0,0,0,0,0,0,0,0,0,0,0,2,0,2,0,0,0,0,0,0,0,0,0
214175,21041,210,41,-2,6,2,4,0,0,0,1,0,1,2,2,0,1,0,1,0,0,0,2,0,2,0,0,0,0,0,0,0,0,0
214290,21041,210,41,-2,10,9,1,0,0,0,0,0,0,0,0,0,0,0,0,0,0,0,10,9,1,0,0,0,0,0,0,0,0,0
214582,21041,210,41,-2,2,0,2,0,0,0,0,0,0,0,0,0,0,0,0,0,0,0,2,0,2,0,0,0,0,0,0,0,0,0
214944,21041,210,41,-2,9,8,1,0,0,0,0,0,0,0,0,0,1,1,0,0,0,0,8,7,1,0,0,0,0,0,0,0,0,0
215053,21041,210,41,-2,1,0,1,0,0,0,0,0,0,0,0,0,0,0,0,0,0,0,1,0,1,0,0,0,0,0,0,0,0,0
215062,21041,210,41,-2,4,0,4,0,0,0,1,0,1,1,0,1,1,0,1,0,0,0,1,0,1,0,0,0,0,0,0,0,0,0
215105,21041,210,41,-2,1,0,1,0,0,0,0,0,0,0,0,0,0,0,0,0,0,0,1,0,1,0,0,0,0,0,0,0,0,0
215293,21041,210,41,-2,73,28,45,0,0,0,9,2,7,2,0,2,4,2,2,0,0,0,37,17,20,1,0,1,16,4,12,4,3,1
215415,21041,210,41,-2,5,3,2,0,0,0,0,0,0,0,0,0,0,0,0,0,0,0,5,3,2,0,0,0,0,0,0,0,0,0
215585,21041,210,41,-2,4,0,4,0,0,0,0,0,0,0,0,0,0,0,0,0,0,0,4,0,4,0,0,0,0,0,0,0,0,0
215682,21041,210,41,-2,6,6,0,0,0,0,0,0,0,0,0,0,0,0,0,0,0,0,6,6,0,0,0,0,0,0,0,0,0,0
215691,21041,210,41,-2,1,1,0,0,0,0,1,1,0,0,0,0,0,0,0,0,0,0,0,0,0,0,0,0,0,0,0,0,0,0
215743,21041,210,41,-2,13,1,12,0,0,0,0,0,0,0,0,0,0,0,0,0,0,0,13,1,12,0,0,0,0,0,0,0,0,0
215992,21041,210,41,-2,2,0,2,0,0,0,0,0,0,0,0,0,0,0,0,0,0,0,2,0,2,0,0,0,0,0,0,0,0,0
216287,21041,210,41,-2,18,8,10,1,0,1,1,1,0,1,0,1,2,1,1,0,0,0,7,4,3,0,0,0,2,1,1,4,1,3
216339,21041,210,41,-2,148,60,88,0,0,0,21,9,12,21,7,14,2,1,1,0,0,0,71,30,41,0,0,0,18,8,10,15,5,10
216366,21041,210,41,-2,8,3,5,0,0,0,0,0,0,0,0,0,0,0,0,0,0,0,8,3,5,0,0,0,0,0,0,0,0,0
216436,21041,210,41,-2,7,7,0,0,0,0,0,0,0,1,1,0,0,0,0,0,0,0,6,6,0,0,0,0,0,0,0,0,0,0
216445,21041,210,41,-2,3,2,1,0,0,0,0,0,0,0,0,0,0,0,0,0,0,0,3,2,1,0,0,0,0,0,0,0,0,0
216454,21041,210,41,-2,2,2,0,0,0,0,0,0,0,0,0,0,0,0,0,0,0,0,2,2,0,0,0,0,0,0,0,0,0,0
216463,21041,210,41,-2,1,1,0,0,0,0,0,0,0,0,0,0,0,0,0,0,0,0,1,1,0,0,0,0,0,0,0,0,0,0
216597,21041,210,41,-2,1,0,1,0,0,0,0,0,0,0,0,0,0,0,0,0,0,0,1,0,1,0,0,0,0,0,0,0,0,0
216667,21041,210,41,-2,4,1,3,0,0,0,1,0,1,0,0,0,0,0,0,0,0,0,3,1,2,0,0,0,0,0,0,0,0,0
216764,21041,210,41,-2,2,1,1,0,0,0,0,0,0,0,0,0,0,0,0,0,0,0,1,0,1,0,0,0,0,0,0,1,1,0
216816,21041,210,41,-2,1,1,0,0,0,0,0,0,0,0,0,0,1,1,0,0,0,0,0,0,0,0,0,0,0,0,0,0,0,0
217156,21041,210,41,-2,32,9,23,0,0,0,4,1,3,1,0,1,0,0,0,0,0,0,17,4,13,1,1,0,1,1,0,8,2,6
217235,21041,210,41,-2,9,2,7,0,0,0,0,0,0,2,1,1,0,0,0,0,0,0,4,1,3,0,0,0,2,0,2,1,0,1
217484,21041,210,41,-2,4,1,3,0,0,0,0,0,0,1,0,1,0,0,0,0,0,0,2,1,1,0,0,0,0,0,0,1,0,1
217493,21041,210,41,-2,7,1,6,0,0,0,0,0,0,4,1,3,0,0,0,0,0,0,0,0,0,0,0,0,1,0,1,2,0,2
217518,21041,210,41,-2,3,1,2,0,0,0,0,0,0,0,0,0,0,0,0,0,0,0,0,0,0,0,0,0,0,0,0,3,1,2
217615,21041,210,41,-2,4,2,2,0,0,0,0,0,0,0,0,0,0,0,0,0,0,0,4,2,2,0,0,0,0,0,0,0,0,0
217688,21041,210,41,-2,2,0,2,0,0,0,0,0,0,0,0,0,0,0,0,0,0,0,2,0,2,0,0,0,0,0,0,0,0,0
217712,21041,210,41,-2,2,2,0,0,0,0,0,0,0,0,0,0,0,0,0,0,0,0,2,2,0,0,0,0,0,0,0,0,0,0
217819,21041,210,41,-2,5,3,2,0,0,0,0,0,0,2,1,1,0,0,0,0,0,0,3,2,1,0,0,0,0,0,0,0,0,0
217837,21041,210,41,-2,7,0,7,0,0,0,0,0,0,4,0,4,0,0,0,0,0,0,3,0,3,0,0,0,0,0,0,0,0,0
218025,21041,210,41,-2,6,2,4,0,0,0,0,0,0,2,1,1,0,0,0,0,0,0,4,1,3,0,0,0,0,0,0,0,0,0
218113,21041,210,41,-2,29,7,22,0,0,0,1,0,1,5,1,4,0,0,0,0,0,0,23,6,17,0,0,0,0,0,0,0,0,0
218140,21041,210,41,-2,15,4,11,0,0,0,0,0,0,1,0,1,0,0,0,0,0,0,14,4,10,0,0,0,0,0,0,0,0,0
218353,21041,210,41,-2,12,3,9,0,0,0,1,0,1,2,1,1,2,1,1,0,0,0,7,1,6,0,0,0,0,0,0,0,0,0
218487,21041,210,41,-2,8,3,5,0,0,0,0,0,0,2,0,2,0,0,0,0,0,0,6,3,3,0,0,0,0,0,0,0,0,0
218520,21041,210,41,-2,15,6,9,0,0,0,0,0,0,5,2,3,1,0,1,0,0,0,9,4,5,0,0,0,0,0,0,0,0,0
218663,21041,210,41,-2,6,3,3,0,0,0,0,0,0,0,0,0,0,0,0,0,0,0,5,2,3,1,1,0,0,0,0,0,0,0
218830,21041,210,41,-2,16,4,12,0,0,0,1,1,0,1,0,1,1,0,1,0,0,0,13,3,10,0,0,0,0,0,0,0,0,0
218858,21041,210,41,-2,7,3,4,0,0,0,0,0,0,2,1,1,0,0,0,0,0,0,5,2,3,0,0,0,0,0,0,0,0,0
218885,21041,210,41,-2,11,5,6,0,0,0,0,0,0,3,1,2,1,0,1,0,0,0,7,4,3,0,0,0,0,0,0,0,0,0
218894,21041,210,41,-2,16,6,10,0,0,0,1,0,1,2,1,1,0,0,0,0,0,0,13,5,8,0,0,0,0,0,0,0,0,0
218955,21041,210,41,-2,6,3,3,0,0,0,0,0,0,2,1,1,0,0,0,0,0,0,4,2,2,0,0,0,0,0,0,0,0,0
218964,21041,210,41,-2,1,1,0,0,0,0,0,0,0,0,0,0,0,0,0,0,0,0,1,1,0,0,0,0,0,0,0,0,0,0
218991,21041,210,41,-2,18,9,9,0,0,0,0,0,0,3,1,2,0,0,0,0,0,0,15,8,7,0,0,0,0,0,0,0,0,0
219000,21041,210,41,-2,2,1,1,0,0,0,0,0,0,0,0,0,1,1,0,0,0,0,1,0,1,0,0,0,0,0,0,0,0,0
219408,21041,210,41,-2,1,1,0,0,0,0,0,0,0,0,0,0,0,0,0,0,0,0,1,1,0,0,0,0,0,0,0,0,0,0
219426,21041,210,41,-2,15,4,11,0,0,0,0,0,0,0,0,0,0,0,0,0,0,0,15,4,11,0,0,0,0,0,0,0,0,0
219505,21041,210,41,-2,1,0,1,0,0,0,0,0,0,1,0,1,0,0,0,0,0,0,0,0,0,0,0,0,0,0,0,0,0,0
219602,21041,210,41,-2,1,1,0,0,0,0,0,0,0,0,0,0,0,0,0,0,0,0,1,1,0,0,0,0,0,0,0,0,0,0
219639,21041,210,41,-2,7,2,5,0,0,0,0,0,0,3,0,3,0,0,0,0,0,0,4,2,2,0,0,0,0,0,0,0,0,0
219709,21041,210,41,-2,6,4,2,0,0,0,0,0,0,3,1,2,0,0,0,0,0,0,3,3,0,0,0,0,0,0,0,0,0,0
219879,21041,210,41,-2,1,0,1,0,0,0,0,0,0,0,0,0,0,0,0,0,0,0,1,0,1,0,0,0,0,0,0,0,0,0
219903,21041,210,41,-2,14,1,13,0,0,0,0,0,0,8,0,8,0,0,0,0,0,0,5,0,5,0,0,0,1,1,0,0,0,0
220118,21041,210,41,-2,6,0,6,0,0,0,0,0,0,1,0,1,0,0,0,0,0,0,5,0,5,0,0,0,0,0,0,0,0,0
220206,21041,210,41,-2,1,1,0,0,0,0,0,0,0,0,0,0,0,0,0,0,0,0,1,1,0,0,0,0,0,0,0,0,0,0
220552,21041,210,41,-2,56,15,41,1,1,0,4,0,4,7,1,6,2,1,1,0,0,0,40,11,29,2,1,1,0,0,0,0,0,0
220710,21041,210,41,-2,1,0,1,0,0,0,0,0,0,0,0,0,0,0,0,0,0,0,1,0,1,0,0,0,0,0,0,0,0,0
220862,21041,210,41,-2,15,2,13,0,0,0,0,0,0,4,0,4,0,0,0,0,0,0,11,2,9,0,0,0,0,0,0,0,0,0
220978,21041,210,41,-2,6,3,3,0,0,0,0,0,0,0,0,0,1,0,1,0,0,0,5,3,2,0,0,0,0,0,0,0,0,0
220996,21041,210,41,-2,2,1,1,0,0,0,0,0,0,0,0,0,0,0,0,0,0,0,2,1,1,0,0,0,0,0,0,0,0,0
221148,21041,210,41,-2,22,22,0,0,0,0,0,0,0,0,0,0,0,0,0,0,0,0,22,22,0,0,0,0,0,0,0,0,0,0
221397,21041,210,41,-2,1,1,0,0,0,0,0,0,0,0,0,0,0,0,0,0,0,0,1,1,0,0,0,0,0,0,0,0,0,0
221670,21041,210,41,-2,4,2,2,0,0,0,1,0,1,0,0,0,0,0,0,0,0,0,3,2,1,0,0,0,0,0,0,0,0,0
221759,21041,210,41,-2,52,19,33,0,0,0,2,1,1,4,1,3,1,0,1,0,0,0,40,15,25,1,0,1,0,0,0,4,2,2
221847,21041,210,41,-2,2,2,0,0,0,0,0,0,0,0,0,0,0,0,0,0,0,0,0,0,0,1,1,0,1,1,0,0,0,0
221999,21041,210,41,-2,22,10,12,0,0,0,0,0,0,1,0,1,0,0,0,0,0,0,5,2,3,0,0,0,13,6,7,3,2,1
222105,21041,210,41,-2,7,7,0,0,0,0,0,0,0,3,3,0,0,0,0,0,0,0,4,4,0,0,0,0,0,0,0,0,0,0
222178,21041,210,41,-2,1,1,0,0,0,0,0,0,0,0,0,0,0,0,0,0,0,0,1,1,0,0,0,0,0,0,0,0,0,0
222831,21041,210,41,-2,8,4,4,0,0,0,0,0,0,1,0,1,0,0,0,0,0,0,6,3,3,0,0,0,1,1,0,0,0,0
222877,21041,210,41,-2,1,1,0,0,0,0,0,0,0,0,0,0,0,0,0,0,0,0,1,1,0,0,0,0,0,0,0,0,0,0
223083,21041,210,41,-2,4,0,4,0,0,0,0,0,0,0,0,0,0,0,0,0,0,0,4,0,4,0,0,0,0,0,0,0,0,0
223427,21041,210,41,-2,2,0,2,0,0,0,0,0,0,1,0,1,0,0,0,0,0,0,1,0,1,0,0,0,0,0,0,0,0,0
224004,21041,210,41,-2,2,0,2,0,0,0,1,0,1,0,0,0,0,0,0,0,0,0,1,0,1,0,0,0,0,0,0,0,0,0
224660,21041,210,41,-2,16,9,7,0,0,0,0,0,0,0,0,0,9,6,3,0,0,0,5,2,3,1,0,1,1,1,0,0,0,0
224679,21041,210,41,-2,15,14,1,0,0,0,0,0,0,0,0,0,15,14,1,0,0,0,0,0,0,0,0,0,0,0,0,0,0,0
224712,21041,210,41,-2,1,0,1,0,0,0,0,0,0,0,0,0,1,0,1,0,0,0,0,0,0,0,0,0,0,0,0,0,0,0
225201,21041,210,41,-2,10,5,5,0,0,0,1,1,0,2,2,0,4,1,3,0,0,0,3,1,2,0,0,0,0,0,0,0,0,0
225399,21041,210,41,-2,1,1,0,0,0,0,0,0,0,0,0,0,0,0,0,0,0,0,1,1,0,0,0,0,0,0,0,0,0,0
226204,21041,210,41,-2,1,0,1,0,0,0,0,0,0,0,0,0,0,0,0,0,0,0,1,0,1,0,0,0,0,0,0,0,0,0
226277,21041,210,41,-2,35,31,4,0,0,0,1,1,0,2,2,0,4,4,0,0,0,0,26,22,4,1,1,0,1,1,0,0,0,0
226903,21041,210,41,-2,40,23,17,0,0,0,0,0,0,1,1,0,25,14,11,0,0,0,10,6,4,1,1,0,3,1,2,0,0,0
227368,21041,210,41,-2,93,43,50,0,0,0,6,2,4,3,1,2,39,14,25,0,0,0,34,17,17,1,1,0,3,2,1,7,6,1
227757,21041,210,41,-2,14,11,3,0,0,0,1,0,1,2,2,0,2,2,0,0,0,0,5,4,1,0,0,0,4,3,1,0,0,0
228149,21041,210,41,-2,1,1,0,0,0,0,0,0,0,0,0,0,0,0,0,0,0,0,0,0,0,0,0,0,0,0,0,1,1,0
228246,21041,210,41,-2,2,0,2,0,0,0,0,0,0,1,0,1,0,0,0,0,0,0,1,0,1,0,0,0,0,0,0,0,0,0
228343,21041,210,41,-2,4,1,3,0,0,0,1,0,1,0,0,0,1,1,0,0,0,0,2,0,2,0,0,0,0,0,0,0,0,0
228459,21041,210,41,-2,7,2,5,0,0,0,0,0,0,1,1,0,0,0,0,0,0,0,5,1,4,0,0,0,1,0,1,0,0,0
228529,21041,210,41,-2,21,10,11,1,1,0,1,0,1,1,0,1,2,1,1,0,0,0,14,7,7,0,0,0,0,0,0,2,1,1
228705,21041,210,41,-2,3,2,1,0,0,0,0,0,0,0,0,0,0,0,0,0,0,0,1,1,0,0,0,0,0,0,0,2,1,1
228778,21041,210,41,-2,25,18,7,0,0,0,3,1,2,3,3,0,2,1,1,0,0,0,13,9,4,0,0,0,0,0,0,4,4,0
229027,21041,210,41,-2,2,2,0,0,0,0,0,0,0,0,0,0,1,1,0,0,0,0,1,1,0,0,0,0,0,0,0,0,0,0
229267,21041,210,41,-2,1,0,1,0,0,0,0,0,0,0,0,0,0,0,0,0,0,0,1,0,1,0,0,0,0,0,0,0,0,0
229887,21041,210,41,-2,2,0,2,0,0,0,0,0,0,2,0,2,0,0,0,0,0,0,0,0,0,0,0,0,0,0,0,0,0,0
230171,21041,210,41,-2,2,0,2,0,0,0,0,0,0,0,0,0,0,0,0,0,0,0,2,0,2,0,0,0,0,0,0,0,0,0
230366,21041,210,41,-2,5,0,5,0,0,0,0,0,0,0,0,0,0,0,0,0,0,0,5,0,5,0,0,0,0,0,0,0,0,0
230418,21041,210,41,-2,1,1,0,0,0,0,0,0,0,0,0,0,0,0,0,0,0,0,1,1,0,0,0,0,0,0,0,0,0,0
230597,21041,210,41,-2,2,1,1,0,0,0,0,0,0,0,0,0,0,0,0,0,0,0,2,1,1,0,0,0,0,0,0,0,0,0
230737,21041,210,41,-2,19,10,9,0,0,0,3,1,2,0,0,0,0,0,0,0,0,0,12,6,6,0,0,0,2,2,0,2,1,1
230807,21041,210,41,-2,4,0,4,0,0,0,0,0,0,0,0,0,0,0,0,0,0,0,4,0,4,0,0,0,0,0,0,0,0,0
230816,21041,210,41,-2,2,1,1,0,0,0,1,0,1,0,0,0,0,0,0,0,0,0,1,1,0,0,0,0,0,0,0,0,0,0
230852,21041,210,41,-2,1,0,1,0,0,0,0,0,0,0,0,0,0,0,0,0,0,0,0,0,0,0,0,0,1,0,1,0,0,0
230959,21041,210,41,-2,4,0,4,0,0,0,1,0,1,0,0,0,0,0,0,0,0,0,2,0,2,0,0,0,0,0,0,1,0,1
230995,21041,210,41,-2,1,1,0,0,0,0,0,0,0,0,0,0,0,0,0,0,0,0,1,1,0,0,0,0,0,0,0,0,0,0
231059,21041,210,41,-2,1,1,0,0,0,0,0,0,0,0,0,0,0,0,0,0,0,0,0,0,0,0,0,0,0,0,0,1,1,0
231068,21041,210,41,-2,1,0,1,0,0,0,0,0,0,0,0,0,0,0,0,0,0,0,1,0,1,0,0,0,0,0,0,0,0,0
231147,21041,210,41,-2,3,0,3,0,0,0,0,0,0,0,0,0,0,0,0,0,0,0,2,0,2,0,0,0,1,0,1,0,0,0
231411,21041,210,41,-2,3,2,1,0,0,0,0,0,0,1,0,1,0,0,0,0,0,0,2,2,0,0,0,0,0,0,0,0,0,0
231420,21041,210,41,-2,2,1,1,0,0,0,0,0,0,0,0,0,0,0,0,0,0,0,2,1,1,0,0,0,0,0,0,0,0,0
231624,21041,210,41,-2,9,1,8,0,0,0,2,1,1,1,0,1,0,0,0,0,0,0,3,0,3,0,0,0,3,0,3,0,0,0
231712,21041,210,41,-2,1,1,0,0,0,0,0,0,0,0,0,0,0,0,0,0,0,0,1,1,0,0,0,0,0,0,0,0,0,0
231785,21041,210,41,-2,8,2,6,0,0,0,0,0,0,4,0,4,0,0,0,0,0,0,2,1,1,1,1,0,1,0,1,0,0,0
231970,21041,210,41,-2,20,6,14,0,0,0,4,2,2,3,0,3,1,0,1,0,0,0,12,4,8,0,0,0,0,0,0,0,0,0
232186,21041,210,41,-2,20,15,5,1,1,0,3,1,2,2,2,0,1,1,0,0,0,0,9,7,2,1,1,0,0,0,0,3,2,1
232308,21041,210,41,-2,12,4,8,0,0,0,0,0,0,0,0,0,0,0,0,0,0,0,11,4,7,1,0,1,0,0,0,0,0,0
232672,21041,210,41,-2,10,2,8,0,0,0,0,0,0,0,0,0,1,0,1,0,0,0,9,2,7,0,0,0,0,0,0,0,0,0
233082,21041,210,41,-2,2,0,2,0,0,0,0,0,0,0,0,0,0,0,0,0,0,0,2,0,2,0,0,0,0,0,0,0,0,0
233301,21041,210,41,-2,3,0,3,0,0,0,0,0,0,1,0,1,0,0,0,0,0,0,2,0,2,0,0,0,0,0,0,0,0,0
233329,21041,210,41,-2,12,1,11,0,0,0,2,0,2,1,0,1,3,0,3,0,0,0,5,0,5,0,0,0,1,1,0,0,0,0
233408,21041,210,41,-2,2,0,2,0,0,0,0,0,0,0,0,0,0,0,0,0,0,0,2,0,2,0,0,0,0,0,0,0,0,0
233718,21041,210,41,-2,8,2,6,0,0,0,0,0,0,1,0,1,1,0,1,0,0,0,6,2,4,0,0,0,0,0,0,0,0,0
234076,21041,210,41,-2,58,27,31,0,0,0,6,5,1,3,2,1,1,0,1,0,0,0,33,13,20,2,2,0,6,4,2,7,1,6
234207,21041,210,41,-2,3,1,2,0,0,0,0,0,0,1,0,1,0,0,0,0,0,0,1,0,1,0,0,0,1,1,0,0,0,0
234915,21041,210,41,-2,7,4,3,0,0,0,2,2,0,0,0,0,0,0,0,0,0,0,4,1,3,0,0,0,1,1,0,0,0,0
235024,21041,210,41,-2,1,0,1,0,0,0,0,0,0,0,0,0,0,0,0,0,0,0,0,0,0,1,0,1,0,0,0,0,0,0
235167,21041,210,41,-2,2,1,1,0,0,0,0,0,0,0,0,0,0,0,0,0,0,0,0,0,0,0,0,0,2,1,1,0,0,0
236212,21041,210,41,-2,10,9,1,0,0,0,0,0,0,0,0,0,0,0,0,0,0,0,9,8,1,0,0,0,1,1,0,0,0,0
236577,21041,210,41,-2,1,1,0,0,0,0,0,0,0,0,0,0,0,0,0,0,0,0,1,1,0,0,0,0,0,0,0,0,0,0
236939,21041,210,41,-2,7,2,5,1,0,1,1,1,0,0,0,0,0,0,0,0,0,0,1,0,1,0,0,0,3,1,2,1,0,1
236948,21041,210,41,-2,14,4,10,0,0,0,1,0,1,0,0,0,1,1,0,0,0,0,9,3,6,0,0,0,2,0,2,1,0,1
237011,21041,210,41,-2,1,1,0,0,0,0,0,0,0,0,0,0,0,0,0,0,0,0,1,1,0,0,0,0,0,0,0,0,0,0
237525,21041,210,41,-2,1,1,0,0,0,0,1,1,0,0,0,0,0,0,0,0,0,0,0,0,0,0,0,0,0,0,0,0,0,0
238476,21041,210,41,-2,5,3,2,0,0,0,0,0,0,0,0,0,0,0,0,0,0,0,5,3,2,0,0,0,0,0,0,0,0,0
238616,21041,210,41,-2,10,5,5,0,0,0,0,0,0,0,0,0,1,0,1,0,0,0,9,5,4,0,0,0,0,0,0,0,0,0
238722,21041,210,41,-2,5,3,2,0,0,0,0,0,0,0,0,0,0,0,0,0,0,0,5,3,2,0,0,0,0,0,0,0,0,0
239169,21041,210,41,-2,18,11,7,0,0,0,2,1,1,0,0,0,2,2,0,0,0,0,14,8,6,0,0,0,0,0,0,0,0,0
239318,21041,210,41,-2,6,3,3,0,0,0,0,0,0,0,0,0,0,0,0,0,0,0,6,3,3,0,0,0,0,0,0,0,0,0
239512,21041,210,41,-2,2,0,2,0,0,0,0,0,0,0,0,0,0,0,0,0,0,0,2,0,2,0,0,0,0,0,0,0,0,0
240268,21041,210,41,-2,5,1,4,0,0,0,0,0,0,0,0,0,0,0,0,0,0,0,4,1,3,0,0,0,1,0,1,0,0,0
240277,21041,210,41,-2,7,2,5,1,0,1,1,1,0,0,0,0,0,0,0,0,0,0,5,1,4,0,0,0,0,0,0,0,0,0
240329,21041,210,41,-2,1,0,1,0,0,0,1,0,1,0,0,0,0,0,0,0,0,0,0,0,0,0,0,0,0,0,0,0,0,0
240338,21041,210,41,-2,2,2,0,0,0,0,0,0,0,0,0,0,0,0,0,0,0,0,2,2,0,0,0,0,0,0,0,0,0,0
240365,21041,210,41,-2,5,3,2,0,0,0,0,0,0,0,0,0,0,0,0,0,0,0,3,1,2,0,0,0,1,1,0,1,1,0
240374,21041,210,41,-2,11,7,4,0,0,0,1,1,0,0,0,0,0,0,0,0,0,0,7,5,2,0,0,0,1,1,0,2,0,2
240392,21041,210,41,-2,19,1,18,0,0,0,0,0,0,1,0,1,0,0,0,0,0,0,16,1,15,1,0,1,1,0,1,0,0,0
240426,21041,210,41,-2,7,1,6,0,0,0,1,0,1,0,0,0,0,0,0,0,0,0,6,1,5,0,0,0,0,0,0,0,0,0
240444,21041,210,41,-2,141,63,78,0,0,0,16,8,8,7,1,6,6,0,6,0,0,0,95,46,49,3,1,2,6,1,5,8,6,2
240453,21041,210,41,-2,8,2,6,0,0,0,1,0,1,2,0,2,0,0,0,0,0,0,4,1,3,0,0,0,0,0,0,1,1,0
240471,21041,210,41,-2,1,0,1,0,0,0,0,0,0,0,0,0,0,0,0,0,0,0,1,0,1,0,0,0,0,0,0,0,0,0
240480,21041,210,41,-2,8,2,6,0,0,0,0,0,0,0,0,0,0,0,0,0,0,0,8,2,6,0,0,0,0,0,0,0,0,0
240718,21041,210,41,-2,14,13,1,0,0,0,0,0,0,0,0,0,0,0,0,0,0,0,14,13,1,0,0,0,0,0,0,0,0,0
240727,21041,210,41,-2,8,2,6,0,0,0,0,0,0,0,0,0,0,0,0,0,0,0,4,0,4,0,0,0,3,1,2,1,1,0
240754,21041,210,41,-2,1,0,1,0,0,0,0,0,0,0,0,0,0,0,0,1,0,1,0,0,0,0,0,0,0,0,0,0,0,0
240790,21041,210,41,-2,1,1,0,0,0,0,0,0,0,0,0,0,0,0,0,1,1,0,0,0,0,0,0,0,0,0,0,0,0,0
241836,21041,210,41,-2,5,1,4,0,0,0,0,0,0,0,0,0,5,1,4,0,0,0,0,0,0,0,0,0,0,0,0,0,0,0
243081,21041,210,41,-2,5,2,3,0,0,0,0,0,0,0,0,0,5,2,3,0,0,0,0,0,0,0,0,0,0,0,0,0,0,0
243568,21041,210,41,-2,7,3,4,0,0,0,0,0,0,0,0,0,7,3,4,0,0,0,0,0,0,0,0,0,0,0,0,0,0,0
243586,21041,210,41,-2,2,0,2,0,0,0,0,0,0,0,0,0,2,0,2,0,0,0,0,0,0,0,0,0,0,0,0,0,0,0
243638,21041,210,41,-2,4,4,0,0,0,0,2,2,0,0,0,0,0,0,0,2,2,0,0,0,0,0,0,0,0,0,0,0,0,0
243744,21041,210,41,-2,44,30,14,0,0,0,16,8,8,2,1,1,1,1,0,0,0,0,17,14,3,2,2,0,6,4,2,0,0,0
243780,21041,210,41,-2,11,9,2,0,0,0,1,0,1,0,0,0,0,0,0,0,0,0,1,1,0,1,1,0,0,0,0,8,7,1
244446,21041,210,41,-2,27,7,20,0,0,0,1,1,0,17,4,13,0,0,0,0,0,0,9,2,7,0,0,0,0,0,0,0,0,0
246813,21041,210,41,-2,35,21,14,2,2,0,2,0,2,8,3,5,0,0,0,0,0,0,23,16,7,0,0,0,0,0,0,0,0,0
246974,21041,210,41,-2,5,1,4,0,0,0,0,0,0,0,0,0,2,0,2,0,0,0,3,1,2,0,0,0,0,0,0,0,0,0
247649,21041,210,41,-2,4,0,4,0,0,0,0,0,0,0,0,0,0,0,0,0,0,0,4,0,4,0,0,0,0,0,0,0,0,0
248934,21041,210,41,-2,68,11,57,0,0,0,1,1,0,18,2,16,2,1,1,0,0,0,42,5,37,2,1,1,3,1,2,0,0,0
250027,21041,210,41,-2,5,1,4,0,0,0,0,0,0,0,0,0,0,0,0,0,0,0,5,1,4,0,0,0,0,0,0,0,0,0
251312,21041,210,41,-2,1,0,1,0,0,0,0,0,0,0,0,0,0,0,0,0,0,0,1,0,1,0,0,0,0,0,0,0,0,0
260691,21041,210,41,-2,4,2,2,0,0,0,0,0,0,0,0,0,0,0,0,0,0,0,4,2,2,0,0,0,0,0,0,0,0,0
260789,21041,210,41,-2,5,0,5,0,0,0,1,0,1,0,0,0,2,0,2,0,0,0,2,0,2,0,0,0,0,0,0,0,0,0
260992,21041,210,41,-2,4,0,4,0,0,0,0,0,0,2,0,2,0,0,0,0,0,0,2,0,2,0,0,0,0,0,0,0,0,0
366270,21041,210,41,-2,3,0,3,0,0,0,0,0,0,2,0,2,0,0,0,0,0,0,1,0,1,0,0,0,0,0,0,0,0,0
366553,21041,210,41,-2,20,5,15,0,0,0,0,0,0,2,0,2,1,1,0,0,0,0,17,4,13,0,0,0,0,0,0,0,0,0
367954,21041,210,41,-2,25,3,22,0,0,0,1,0,1,0,0,0,1,0,1,0,0,0,22,3,19,1,0,1,0,0,0,0,0,0
368629,21041,210,41,-2,2,0,2,0,0,0,0,0,0,0,0,0,1,0,1,0,0,0,1,0,1,0,0,0,0,0,0,0,0,0
368911,21041,210,41,-2,9,3,6,0,0,0,1,1,0,0,0,0,0,0,0,0,0,0,8,2,6,0,0,0,0,0,0,0,0,0
372329,21041,210,41,-2,3,0,3,0,0,0,0,0,0,0,0,0,1,0,1,0,0,0,2,0,2,0,0,0,0,0,0,0,0,0
376695,21041,210,41,-2,4,3,1,0,0,0,0,0,0,0,0,0,0,0,0,1,1,0,3,2,1,0,0,0,0,0,0,0,0,0
377555,21041,210,41,-2,4,1,3,0,0,0,1,0,1,0,0,0,1,0,1,0,0,0,2,1,1,0,0,0,0,0,0,0,0,0
377564,21041,210,41,-2,4,2,2,0,0,0,1,0,1,0,0,0,0,0,0,0,0,0,1,1,0,1,0,1,1,1,0,0,0,0
378105,21041,210,41,-2,5,3,2,0,0,0,0,0,0,0,0,0,3,2,1,0,0,0,2,1,1,0,0,0,0,0,0,0,0,0
379746,21041,210,41,-2,3,1,2,0,0,0,0,0,0,1,0,1,0,0,0,0,0,0,2,1,1,0,0,0,0,0,0,0,0,0
380438,21041,210,41,-2,8,2,6,0,0,0,0,0,0,0,0,0,0,0,0,0,0,0,7,1,6,1,1,0,0,0,0,0,0,0
382957,21041,210,41,-2,6,2,4,0,0,0,0,0,0,1,0,1,0,0,0,0,0,0,3,1,2,0,0,0,2,1,1,0,0,0
385503,21041,210,41,-2,3,0,3,0,0,0,0,0,0,1,0,1,0,0,0,0,0,0,2,0,2,0,0,0,0,0,0,0,0,0
385619,21041,210,41,-2,4,4,0,0,0,0,1,1,0,0,0,0,1,1,0,0,0,0,0,0,0,2,2,0,0,0,0,0,0,0
386472,21041,210,41,-2,3,0,3,0,0,0,0,0,0,1,0,1,0,0,0,0,0,0,1,0,1,0,0,0,1,0,1,0,0,0
392257,21041,210,41,-2,13,1,12,0,0,0,1,0,1,7,0,7,2,1,1,0,0,0,3,0,3,0,0,0,0,0,0,0,0,0
392415,21041,210,41,-2,1,0,1,0,0,0,0,0,0,1,0,1,0,0,0,0,0,0,0,0,0,0,0,0,0,0,0,0,0,0
399869,21041,210,41,-2,1,1,0,0,0,0,0,0,0,0,0,0,0,0,0,0,0,0,1,1,0,0,0,0,0,0,0,0,0,0
404912,21041,210,41,-2,5,1,4,0,0,0,0,0,0,1,1,0,0,0,0,0,0,0,4,0,4,0,0,0,0,0,0,0,0,0
406024,21041,210,41,-2,20,2,18,0,0,0,1,0,1,1,0,1,3,1,2,0,0,0,14,1,13,1,0,1,0,0,0,0,0,0
406033,21041,210,41,-2,20,3,17,0,0,0,3,1,2,0,0,0,7,1,6,0,0,0,9,1,8,0,0,0,1,0,1,0,0,0
407629,21041,210,41,-2,28,15,13,0,0,0,4,2,2,1,0,1,0,0,0,0,0,0,23,13,10,0,0,0,0,0,0,0,0,0
408729,21041,210,41,-2,1,0,1,0,0,0,0,0,0,0,0,0,0,0,0,0,0,0,1,0,1,0,0,0,0,0,0,0,0,0
409254,21041,210,41,-2,1,0,1,0,0,0,0,0,0,1,0,1,0,0,0,0,0,0,0,0,0,0,0,0,0,0,0,0,0,0
412173,21041,210,41,-2,3,0,3,0,0,0,0,0,0,0,0,0,0,0,0,0,0,0,3,0,3,0,0,0,0,0,0,0,0,0
416458,21041,210,41,-2,1,0,1,0,0,0,1,0,1,0,0,0,0,0,0,0,0,0,0,0,0,0,0,0,0,0,0,0,0,0
422020,21041,210,41,-2,2,2,0,0,0,0,0,0,0,0,0,0,1,1,0,0,0,0,0,0,0,0,0,0,1,1,0,0,0,0
423643,21041,210,41,-2,4,4,0,0,0,0,0,0,0,2,2,0,0,0,0,0,0,0,2,2,0,0,0,0,0,0,0,0,0,0
423652,21041,210,41,-2,4,1,3,0,0,0,0,0,0,0,0,0,0,0,0,0,0,0,4,1,3,0,0,0,0,0,0,0,0,0
428170,21041,210,41,-2,8,0,8,0,0,0,1,0,1,2,0,2,3,0,3,0,0,0,2,0,2,0,0,0,0,0,0,0,0,0
428392,21041,210,41,-2,4,1,3,0,0,0,0,0,0,0,0,0,0,0,0,0,0,0,4,1,3,0,0,0,0,0,0,0,0,0
429094,21041,210,41,-2,1,0,1,0,0,0,1,0,1,0,0,0,0,0,0,0,0,0,0,0,0,0,0,0,0,0,0,0,0,0
431141,21041,210,41,-2,21,4,17,0,0,0,1,0,1,1,0,1,6,1,5,1,0,1,11,3,8,0,0,0,1,0,1,0,0,0
433004,21041,210,41,-2,7,5,2,1,1,0,2,1,1,0,0,0,0,0,0,0,0,0,4,3,1,0,0,0,0,0,0,0,0,0
433013,21041,210,41,-2,8,2,6,0,0,0,0,0,0,0,0,0,4,1,3,0,0,0,4,1,3,0,0,0,0,0,0,0,0,0
433174,21041,210,41,-2,8,1,7,0,0,0,1,1,0,1,0,1,0,0,0,0,0,0,6,0,6,0,0,0,0,0,0,0,0,0
433387,21041,210,41,-2,224,88,136,1,1,0,8,3,5,50,25,25,17,3,14,0,0,0,131,48,83,5,3,2,12,5,7,0,0,0
433420,21041,210,41,-2,9,9,0,0,0,0,0,0,0,0,0,0,2,2,0,0,0,0,7,7,0,0,0,0,0,0,0,0,0,0
433536,21041,210,41,-2,3,0,3,0,0,0,0,0,0,1,0,1,0,0,0,0,0,0,2,0,2,0,0,0,0,0,0,0,0,0
433660,21041,210,41,-2,33,11,22,0,0,0,5,2,3,3,1,2,4,1,3,0,0,0,14,5,9,2,0,2,0,0,0,5,2,3
434140,21041,210,41,-2,4,1,3,0,0,0,0,0,0,0,0,0,0,0,0,0,0,0,4,1,3,0,0,0,0,0,0,0,0,0
436429,21041,210,41,-2,9,0,9,0,0,0,0,0,0,1,0,1,2,0,2,0,0,0,5,0,5,0,0,0,1,0,1,0,0,0
437635,21041,210,41,-2,18,6,12,0,0,0,0,0,0,3,0,3,7,3,4,0,0,0,7,2,5,1,1,0,0,0,0,0,0,0
437936,21041,210,41,-2,4,3,1,0,0,0,1,1,0,0,0,0,1,1,0,0,0,0,2,1,1,0,0,0,0,0,0,0,0,0
438258,21041,210,41,-2,5,0,5,0,0,0,0,0,0,0,0,0,0,0,0,1,0,1,3,0,3,1,0,1,0,0,0,0,0,0
439118,21041,210,41,-2,2,0,2,0,0,0,0,0,0,0,0,0,0,0,0,0,0,0,1,0,1,0,0,0,1,0,1,0,0,0
439367,21041,210,41,-2,5,1,4,0,0,0,0,0,0,0,0,0,2,0,2,0,0,0,3,1,2,0,0,0,0,0,0,0,0,0
439446,21041,210,41,-2,1,1,0,0,0,0,1,1,0,0,0,0,0,0,0,0,0,0,0,0,0,0,0,0,0,0,0,0,0,0
439570,21041,210,41,-2,8,1,7,0,0,0,0,0,0,2,0,2,0,0,0,0,0,0,6,1,5,0,0,0,0,0,0,0,0,0
439738,21041,210,41,-2,1,0,1,0,0,0,0,0,0,1,0,1,0,0,0,0,0,0,0,0,0,0,0,0,0,0,0,0,0,0
439792,21041,210,41,-2,4,0,4,0,0,0,0,0,0,2,0,2,0,0,0,0,0,0,2,0,2,0,0,0,0,0,0,0,0,0
440031,21041,210,41,-2,10,2,8,0,0,0,1,0,1,2,0,2,0,0,0,0,0,0,6,1,5,0,0,0,1,1,0,0,0,0
440794,21041,210,41,-2,1,0,1,0,0,0,0,0,0,1,0,1,0,0,0,0,0,0,0,0,0,0,0,0,0,0,0,0,0,0
441025,21041,210,41,-2,3,3,0,0,0,0,0,0,0,0,0,0,0,0,0,0,0,0,3,3,0,0,0,0,0,0,0,0,0,0
441371,21041,210,41,-2,50,9,41,0,0,0,1,0,1,20,2,18,3,2,1,0,0,0,23,5,18,1,0,1,2,0,2,0,0,0
441423,21041,210,41,-2,3,2,1,0,0,0,0,0,0,0,0,0,3,2,1,0,0,0,0,0,0,0,0,0,0,0,0,0,0,0
441636,21041,210,41,-2,4,1,3,0,0,0,0,0,0,1,0,1,0,0,0,0,0,0,3,1,2,0,0,0,0,0,0,0,0,0
441742,21041,210,41,-2,2,1,1,0,0,0,1,1,0,1,0,1,0,0,0,0,0,0,0,0,0,0,0,0,0,0,0,0,0,0
441982,21041,210,41,-2,1,0,1,0,0,0,0,0,0,0,0,0,1,0,1,0,0,0,0,0,0,0,0,0,0,0,0,0,0,0
442134,21041,210,41,-2,2,0,2,0,0,0,0,0,0,0,0,0,1,0,1,0,0,0,1,0,1,0,0,0,0,0,0,0,0,0
442426,21041,210,41,-2,2,1,1,0,0,0,0,0,0,0,0,0,0,0,0,0,0,0,2,1,1,0,0,0,0,0,0,0,0,0
442444,21041,210,41,-2,4,2,2,0,0,0,0,0,0,0,0,0,0,0,0,0,0,0,3,2,1,0,0,0,1,0,1,0,0,0
442602,21041,210,41,-2,5,0,5,0,0,0,0,0,0,0,0,0,1,0,1,0,0,0,3,0,3,1,0,1,0,0,0,0,0,0
442930,21041,210,41,-2,1,0,1,0,0,0,0,0,0,0,0,0,0,0,0,0,0,0,1,0,1,0,0,0,0,0,0,0,0,0
443128,21041,210,41,-2,1,1,0,0,0,0,0,0,0,0,0,0,0,0,0,0,0,0,1,1,0,0,0,0,0,0,0,0,0,0
443261,21041,210,41,-2,5,1,4,0,0,0,0,0,0,3,1,2,0,0,0,0,0,0,2,0,2,0,0,0,0,0,0,0,0,0
443377,21041,210,41,-2,3,3,0,0,0,0,0,0,0,0,0,0,0,0,0,0,0,0,3,3,0,0,0,0,0,0,0,0,0,0
443410,21041,210,41,-2,3,1,2,0,0,0,0,0,0,0,0,0,0,0,0,0,0,0,3,1,2,0,0,0,0,0,0,0,0,0
443599,21041,210,41,-2,1,1,0,0,0,0,0,0,0,0,0,0,0,0,0,0,0,0,1,1,0,0,0,0,0,0,0,0,0,0
443650,21041,210,41,-2,3,1,2,0,0,0,0,0,0,0,0,0,0,0,0,0,0,0,3,1,2,0,0,0,0,0,0,0,0,0
443748,21041,210,41,-2,1,0,1,0,0,0,0,0,0,1,0,1,0,0,0,0,0,0,0,0,0,0,0,0,0,0,0,0,0,0
444088,21041,210,41,-2,4,0,4,1,0,1,0,0,0,0,0,0,1,0,1,1,0,1,1,0,1,0,0,0,0,0,0,0,0,0
444130,21041,210,41,-2,6,3,3,0,0,0,0,0,0,2,1,1,0,0,0,0,0,0,4,2,2,0,0,0,0,0,0,0,0,0
444556,21041,210,41,-2,5,3,2,0,0,0,0,0,0,0,0,0,0,0,0,1,0,1,1,0,1,1,1,0,2,2,0,0,0,0
444787,21041,210,41,-2,65,7,58,0,0,0,1,0,1,10,0,10,0,0,0,0,0,0,47,5,42,0,0,0,7,2,5,0,0,0
444811,21041,210,41,-2,3,1,2,0,0,0,0,0,0,2,1,1,0,0,0,0,0,0,1,0,1,0,0,0,0,0,0,0,0,0
444866,21041,210,41,-2,3,0,3,0,0,0,0,0,0,1,0,1,0,0,0,0,0,0,1,0,1,1,0,1,0,0,0,0,0,0
444954,21041,210,41,-2,1,0,1,0,0,0,0,0,0,0,0,0,1,0,1,0,0,0,0,0,0,0,0,0,0,0,0,0,0,0
445230,21041,210,41,-2,4,2,2,0,0,0,0,0,0,1,0,1,1,1,0,0,0,0,2,1,1,0,0,0,0,0,0,0,0,0
445692,21041,210,41,-2,2,2,0,0,0,0,0,0,0,0,0,0,0,0,0,0,0,0,2,2,0,0,0,0,0,0,0,0,0,0
445735,21041,210,41,-2,8,4,4,0,0,0,0,0,0,0,0,0,3,2,1,0,0,0,5,2,3,0,0,0,0,0,0,0,0,0
445744,21041,210,41,-2,1,0,1,0,0,0,0,0,0,0,0,0,0,0,0,0,0,0,1,0,1,0,0,0,0,0,0,0,0,0
445869,21041,210,41,-2,5,2,3,0,0,0,0,0,0,1,0,1,0,0,0,0,0,0,3,2,1,0,0,0,1,0,1,0,0,0
445948,21041,210,41,-2,30,11,19,0,0,0,1,0,1,6,2,4,9,1,8,1,1,0,10,4,6,2,2,0,1,1,0,0,0,0
446048,21041,210,41,-2,3,2,1,0,0,0,1,0,1,0,0,0,1,1,0,0,0,0,1,1,0,0,0,0,0,0,0,0,0,0
446118,21041,210,41,-2,14,3,11,0,0,0,3,1,2,3,0,3,4,1,3,0,0,0,4,1,3,0,0,0,0,0,0,0,0,0
446127,21041,210,41,-2,1,0,1,0,0,0,0,0,0,0,0,0,0,0,0,0,0,0,1,0,1,0,0,0,0,0,0,0,0,0
446385,21041,210,41,-2,1,0,1,0,0,0,1,0,1,0,0,0,0,0,0,0,0,0,0,0,0,0,0,0,0,0,0,0,0,0
446552,21041,210,41,-2,18,10,8,0,0,0,0,0,0,1,1,0,4,3,1,0,0,0,12,5,7,1,1,0,0,0,0,0,0,0
446561,21041,210,41,-2,8,4,4,0,0,0,1,0,1,1,1,0,1,1,0,0,0,0,5,2,3,0,0,0,0,0,0,0,0,0
446604,21041,210,41,-2,12,12,0,0,0,0,0,0,0,0,0,0,0,0,0,0,0,0,12,12,0,0,0,0,0,0,0,0,0,0
446640,21041,210,41,-2,6,6,0,0,0,0,1,1,0,0,0,0,0,0,0,0,0,0,3,3,0,0,0,0,2,2,0,0,0,0
447014,21041,210,41,-2,1,0,1,0,0,0,0,0,0,0,0,0,0,0,0,0,0,0,1,0,1,0,0,0,0,0,0,0,0,0
447263,21041,210,41,-2,43,5,38,0,0,0,1,0,1,2,1,1,0,0,0,0,0,0,27,2,25,0,0,0,13,2,11,0,0,0
447351,21041,210,41,-2,4,1,3,0,0,0,0,0,0,0,0,0,1,0,1,0,0,0,3,1,2,0,0,0,0,0,0,0,0,0
447591,21041,210,41,-2,7,1,6,0,0,0,0,0,0,5,0,5,0,0,0,0,0,0,1,0,1,1,1,0,0,0,0,0,0,0
448354,21041,210,41,-2,2,1,1,0,0,0,0,0,0,0,0,0,0,0,0,0,0,0,2,1,1,0,0,0,0,0,0,0,0,0
448600,21041,210,41,-2,7,1,6,0,0,0,0,0,0,0,0,0,0,0,0,0,0,0,7,1,6,0,0,0,0,0,0,0,0,0
448673,21041,210,41,-2,15,3,12,0,0,0,1,1,0,0,0,0,1,0,1,0,0,0,12,2,10,0,0,0,1,0,1,0,0,0
448859,21041,210,41,-2,2,2,0,0,0,0,0,0,0,0,0,0,0,0,0,0,0,0,2,2,0,0,0,0,0,0,0,0,0,0
449074,21041,210,41,-2,4,1,3,0,0,0,0,0,0,0,0,0,1,0,1,0,0,0,2,1,1,1,0,1,0,0,0,0,0,0
449250,21041,210,41,-2,8,1,7,0,0,0,0,0,0,1,0,1,2,0,2,1,0,1,4,1,3,0,0,0,0,0,0,0,0,0
449339,21041,210,41,-2,3,1,2,0,0,0,0,0,0,0,0,0,1,0,1,0,0,0,1,0,1,0,0,0,1,1,0,0,0,0
449524,21041,210,41,-2,3,0,3,0,0,0,0,0,0,0,0,0,0,0,0,0,0,0,3,0,3,0,0,0,0,0,0,0,0,0
449728,21041,210,41,-2,2,0,2,0,0,0,0,0,0,0,0,0,0,0,0,0,0,0,2,0,2,0,0,0,0,0,0,0,0,0
449764,21041,210,41,-2,1,1,0,0,0,0,0,0,0,0,0,0,0,0,0,0,0,0,1,1,0,0,0,0,0,0,0,0,0,0
449889,21041,210,41,-2,4,0,4,0,0,0,0,0,0,1,0,1,0,0,0,0,0,0,3,0,3,0,0,0,0,0,0,0,0,0
449898,21041,210,41,-2,4,1,3,0,0,0,0,0,0,1,0,1,0,0,0,0,0,0,3,1,2,0,0,0,0,0,0,0,0,0
450058,21041,210,41,-2,15,2,13,0,0,0,1,0,1,2,0,2,0,0,0,0,0,0,11,2,9,1,0,1,0,0,0,0,0,0
450067,21041,210,41,-2,4,0,4,0,0,0,0,0,0,0,0,0,0,0,0,0,0,0,4,0,4,0,0,0,0,0,0,0,0,0
450571,21041,210,41,-2,1,0,1,0,0,0,0,0,0,0,0,0,0,0,0,0,0,0,1,0,1,0,0,0,0,0,0,0,0,0
450696,21041,210,41,-2,5,1,4,0,0,0,0,0,0,1,1,0,1,0,1,0,0,0,3,0,3,0,0,0,0,0,0,0,0,0
450702,21041,210,41,-2,2,0,2,0,0,0,0,0,0,0,0,0,0,0,0,0,0,0,2,0,2,0,0,0,0,0,0,0,0,0
450933,21041,210,41,-2,4,0,4,0,0,0,0,0,0,1,0,1,0,0,0,0,0,0,3,0,3,0,0,0,0,0,0,0,0,0
451103,21041,210,41,-2,3,0,3,0,0,0,0,0,0,0,0,0,3,0,3,0,0,0,0,0,0,0,0,0,0,0,0,0,0,0
451750,21041,210,41,-2,8,0,8,0,0,0,1,0,1,1,0,1,0,0,0,0,0,0,6,0,6,0,0,0,0,0,0,0,0,0
451927,21041,210,41,-2,1,1,0,0,0,0,0,0,0,0,0,0,0,0,0,0,0,0,1,1,0,0,0,0,0,0,0,0,0,0
452124,21041,210,41,-2,5,0,5,0,0,0,0,0,0,1,0,1,0,0,0,0,0,0,4,0,4,0,0,0,0,0,0,0,0,0
452373,21041,210,41,-2,1,0,1,0,0,0,0,0,0,1,0,1,0,0,0,0,0,0,0,0,0,0,0,0,0,0,0,0,0,0
452948,21041,210,41,-2,6,0,6,0,0,0,0,0,0,1,0,1,0,0,0,0,0,0,5,0,5,0,0,0,0,0,0,0,0,0
454218,21041,210,41,-2,75,11,64,0,0,0,4,2,2,18,3,15,4,1,3,0,0,0,41,4,37,3,0,3,5,1,4,0,0,0
454786,21041,210,41,-2,3,1,2,0,0,0,0,0,0,1,0,1,0,0,0,0,0,0,2,1,1,0,0,0,0,0,0,0,0,0
454810,21041,210,41,-2,64,32,32,1,0,1,3,0,3,5,1,4,2,2,0,0,0,0,46,26,20,5,2,3,2,1,1,0,0,0
454829,21041,210,41,-2,13,0,13,0,0,0,1,0,1,0,0,0,0,0,0,0,0,0,11,0,11,0,0,0,1,0,1,0,0,0
454856,21041,210,41,-2,2,0,2,0,0,0,0,0,0,0,0,0,0,0,0,0,0,0,2,0,2,0,0,0,0,0,0,0,0,0
455196,21041,210,41,-2,15,1,14,0,0,0,0,0,0,5,1,4,2,0,2,0,0,0,8,0,8,0,0,0,0,0,0,0,0,0
455406,21041,210,41,-2,5,2,3,0,0,0,0,0,0,0,0,0,0,0,0,0,0,0,4,1,3,1,1,0,0,0,0,0,0,0
455433,21041,210,41,-2,1,1,0,0,0,0,0,0,0,0,0,0,0,0,0,0,0,0,0,0,0,1,1,0,0,0,0,0,0,0
455479,21041,210,41,-2,3,1,2,0,0,0,0,0,0,0,0,0,0,0,0,0,0,0,3,1,2,0,0,0,0,0,0,0,0,0
455628,21041,210,41,-2,6,3,3,0,0,0,0,0,0,5,2,3,0,0,0,0,0,0,1,1,0,0,0,0,0,0,0,0,0,0
455664,21041,210,41,-2,12,4,8,0,0,0,0,0,0,2,0,2,1,1,0,0,0,0,7,2,5,2,1,1,0,0,0,0,0,0
455813,21041,210,41,-2,1,0,1,0,0,0,0,0,0,0,0,0,0,0,0,0,0,0,1,0,1,0,0,0,0,0,0,0,0,0
456038,21041,210,41,-2,2,0,2,0,0,0,0,0,0,0,0,0,1,0,1,0,0,0,1,0,1,0,0,0,0,0,0,0,0,0
456205,21041,210,41,-2,5,2,3,0,0,0,0,0,0,1,0,1,0,0,0,0,0,0,4,2,2,0,0,0,0,0,0,0,0,0
456214,21041,210,41,-2,4,3,1,0,0,0,0,0,0,0,0,0,1,1,0,0,0,0,3,2,1,0,0,0,0,0,0,0,0,0
456454,21041,210,41,-2,5,3,2,0,0,0,0,0,0,0,0,0,0,0,0,0,0,0,5,3,2,0,0,0,0,0,0,0,0,0
456579,21041,210,41,-2,2,1,1,0,0,0,0,0,0,0,0,0,0,0,0,0,0,0,2,1,1,0,0,0,0,0,0,0,0,0
456852,21041,210,41,-2,1,1,0,0,0,0,0,0,0,1,1,0,0,0,0,0,0,0,0,0,0,0,0,0,0,0,0,0,0,0
457101,21041,210,41,-2,8,2,6,0,0,0,1,1,0,1,0,1,1,1,0,0,0,0,4,0,4,0,0,0,1,0,1,0,0,0
457110,21041,210,41,-2,1,0,1,0,0,0,0,0,0,0,0,0,0,0,0,0,0,0,1,0,1,0,0,0,0,0,0,0,0,0
457299,21041,210,41,-2,3,1,2,0,0,0,1,0,1,0,0,0,2,1,1,0,0,0,0,0,0,0,0,0,0,0,0,0,0,0
458210,21041,210,41,-2,5,2,3,0,0,0,2,0,2,0,0,0,1,1,0,0,0,0,2,1,1,0,0,0,0,0,0,0,0,0
458229,21041,210,41,-2,3,0,3,0,0,0,0,0,0,0,0,0,1,0,1,0,0,0,2,0,2,0,0,0,0,0,0,0,0,0
458405,21041,210,41,-2,3,2,1,0,0,0,0,0,0,2,2,0,0,0,0,0,0,0,0,0,0,1,0,1,0,0,0,0,0,0
458441,21041,210,41,-2,1,0,1,0,0,0,0,0,0,1,0,1,0,0,0,0,0,0,0,0,0,0,0,0,0,0,0,0,0,0
458681,21041,210,41,-2,5,2,3,0,0,0,0,0,0,1,1,0,0,0,0,0,0,0,4,1,3,0,0,0,0,0,0,0,0,0
459204,21041,210,41,-2,22,1,21,0,0,0,8,0,8,3,0,3,0,0,0,0,0,0,10,1,9,1,0,1,0,0,0,0,0,0
459213,21041,210,41,-2,14,2,12,0,0,0,3,0,3,0,0,0,1,0,1,1,0,1,6,1,5,0,0,0,3,1,2,0,0,0
459259,21041,210,41,-2,4,0,4,0,0,0,2,0,2,1,0,1,0,0,0,0,0,0,1,0,1,0,0,0,0,0,0,0,0,0
459268,21041,210,41,-2,2,0,2,0,0,0,0,0,0,1,0,1,0,0,0,0,0,0,1,0,1,0,0,0,0,0,0,0,0,0
459727,21041,210,41,-2,3,1,2,0,0,0,0,0,0,1,0,1,0,0,0,0,0,0,2,1,1,0,0,0,0,0,0,0,0,0
459736,21041,210,41,-2,1,0,1,0,0,0,0,0,0,0,0,0,0,0,0,0,0,0,0,0,0,1,0,1,0,0,0,0,0,0
459745,21041,210,41,-2,2,0,2,0,0,0,1,0,1,0,0,0,0,0,0,0,0,0,1,0,1,0,0,0,0,0,0,0,0,0
459824,21041,210,41,-2,4,1,3,0,0,0,1,0,1,0,0,0,0,0,0,0,0,0,3,1,2,0,0,0,0,0,0,0,0,0
459842,21041,210,41,-2,4,1,3,0,0,0,0,0,0,1,0,1,0,0,0,0,0,0,3,1,2,0,0,0,0,0,0,0,0,0
459851,21041,210,41,-2,6,2,4,0,0,0,0,0,0,0,0,0,0,0,0,0,0,0,6,2,4,0,0,0,0,0,0,0,0,0
460020,21041,210,41,-2,1,0,1,0,0,0,0,0,0,1,0,1,0,0,0,0,0,0,0,0,0,0,0,0,0,0,0,0,0,0
460136,21041,210,41,-2,8,0,8,0,0,0,0,0,0,3,0,3,2,0,2,0,0,0,2,0,2,1,0,1,0,0,0,0,0,0
460181,21041,210,41,-2,1,0,1,0,0,0,0,0,0,0,0,0,0,0,0,0,0,0,1,0,1,0,0,0,0,0,0,0,0,0
460206,21041,210,41,-2,4,2,2,0,0,0,0,0,0,0,0,0,2,2,0,0,0,0,2,0,2,0,0,0,0,0,0,0,0,0
460738,21041,210,41,-2,2,0,2,0,0,0,0,0,0,0,0,0,0,0,0,0,0,0,1,0,1,0,0,0,1,0,1,0,0,0
460756,21041,210,41,-2,1,0,1,0,0,0,1,0,1,0,0,0,0,0,0,0,0,0,0,0,0,0,0,0,0,0,0,0,0,0
460826,21041,210,41,-2,6,1,5,0,0,0,0,0,0,5,1,4,1,0,1,0,0,0,0,0,0,0,0,0,0,0,0,0,0,0
460835,21041,210,41,-2,3,1,2,0,0,0,0,0,0,0,0,0,0,0,0,0,0,0,3,1,2,0,0,0,0,0,0,0,0,0
461218,21041,210,41,-2,1,0,1,0,0,0,0,0,0,0,0,0,0,0,0,0,0,0,1,0,1,0,0,0,0,0,0,0,0,0
461689,21041,210,41,-2,5,3,2,0,0,0,0,0,0,0,0,0,1,1,0,0,0,0,4,2,2,0,0,0,0,0,0,0,0,0
475033,21041,210,41,-2,8,2,6,0,0,0,1,0,1,1,0,1,3,2,1,0,0,0,3,0,3,0,0,0,0,0,0,0,0,0
475121,21041,210,41,-2,16,1,15,1,0,1,0,0,0,2,0,2,0,0,0,0,0,0,13,1,12,0,0,0,0,0,0,0,0,0
475176,21041,210,41,-2,2,1,1,0,0,0,0,0,0,0,0,0,0,0,0,0,0,0,0,0,0,2,1,1,0,0,0,0,0,0
475398,21041,210,41,-2,1,0,1,0,0,0,0,0,0,0,0,0,0,0,0,0,0,0,1,0,1,0,0,0,0,0,0,0,0,0
475495,21041,210,41,-2,11,5,6,0,0,0,0,0,0,0,0,0,1,1,0,0,0,0,10,4,6,0,0,0,0,0,0,0,0,0
475608,21041,210,41,-2,4,2,2,0,0,0,0,0,0,0,0,0,0,0,0,0,0,0,4,2,2,0,0,0,0,0,0,0,0,0
475714,21041,210,41,-2,1,0,1,0,0,0,0,0,0,0,0,0,1,0,1,0,0,0,0,0,0,0,0,0,0,0,0,0,0,0
476726,21041,210,41,-2,11,3,8,0,0,0,0,0,0,0,0,0,10,3,7,1,0,1,0,0,0,0,0,0,0,0,0,0,0,0
476975,21041,210,41,-2,2,1,1,0,0,0,0,0,0,0,0,0,0,0,0,0,0,0,2,1,1,0,0,0,0,0,0,0,0,0
477039,21041,210,41,-2,12,0,12,0,0,0,1,0,1,5,0,5,2,0,2,0,0,0,4,0,4,0,0,0,0,0,0,0,0,0
480073,21041,210,41,-2,3,1,2,0,0,0,1,1,0,0,0,0,0,0,0,0,0,0,2,0,2,0,0,0,0,0,0,0,0,0
480657,21041,210,41,-2,1,0,1,0,0,0,0,0,0,0,0,0,0,0,0,0,0,0,1,0,1,0,0,0,0,0,0,0,0,0
480790,21041,210,41,-2,1,0,1,0,0,0,1,0,1,0,0,0,0,0,0,0,0,0,0,0,0,0,0,0,0,0,0,0,0,0
480824,21041,210,41,-2,4,0,4,0,0,0,0,0,0,1,0,1,1,0,1,0,0,0,2,0,2,0,0,0,0,0,0,0,0,0
480833,21041,210,41,-2,5,1,4,0,0,0,0,0,0,2,0,2,1,1,0,0,0,0,2,0,2,0,0,0,0,0,0,0,0,0
480967,21041,210,41,-2,2,1,1,2,1,1,0,0,0,0,0,0,0,0,0,0,0,0,0,0,0,0,0,0,0,0,0,0,0,0
481535,21041,210,41,-2,2,2,0,0,0,0,1,1,0,0,0,0,0,0,0,0,0,0,0,0,0,0,0,0,0,0,0,1,1,0
481775,21041,210,41,-2,1,1,0,0,0,0,0,0,0,0,0,0,1,1,0,0,0,0,0,0,0,0,0,0,0,0,0,0,0,0
482477,21041,210,41,-2,1,1,0,0,0,0,0,0,0,0,0,0,0,0,0,0,0,0,1,1,0,0,0,0,0,0,0,0,0,0
482635,21041,210,41,-2,1,1,0,0,0,0,0,0,0,0,0,0,0,0,0,0,0,0,1,1,0,0,0,0,0,0,0,0,0,0
482936,21041,210,41,-2,10,8,2,0,0,0,1,0,1,0,0,0,0,0,0,0,0,0,6,5,1,0,0,0,0,0,0,3,3,0
483045,21041,210,41,-2,25,13,12,0,0,0,0,0,0,4,1,3,0,0,0,1,1,0,20,11,9,0,0,0,0,0,0,0,0,0
483595,21041,210,41,-2,6,6,0,0,0,0,0,0,0,0,0,0,6,6,0,0,0,0,0,0,0,0,0,0,0,0,0,0,0,0
483975,21041,210,41,-2,7,5,2,0,0,0,0,0,0,1,1,0,0,0,0,0,0,0,6,4,2,0,0,0,0,0,0,0,0,0
484002,21041,210,41,-2,17,5,12,1,1,0,3,0,3,2,0,2,4,2,2,0,0,0,7,2,5,0,0,0,0,0,0,0,0,0
484066,21041,210,41,-2,6,0,6,0,0,0,0,0,0,0,0,0,0,0,0,0,0,0,6,0,6,0,0,0,0,0,0,0,0,0
484613,21041,210,41,-2,7,2,5,0,0,0,1,0,1,2,1,1,0,0,0,0,0,0,3,1,2,0,0,0,1,0,1,0,0,0
484844,21041,210,41,-2,1,0,1,0,0,0,1,0,1,0,0,0,0,0,0,0,0,0,0,0,0,0,0,0,0,0,0,0,0,0
485272,21041,210,41,-2,2,0,2,0,0,0,0,0,0,0,0,0,1,0,1,0,0,0,1,0,1,0,0,0,0,0,0,0,0,0
485458,21041,210,41,-2,18,9,9,0,0,0,1,0,1,1,1,0,0,0,0,0,0,0,16,8,8,0,0,0,0,0,0,0,0,0
486053,21041,210,41,-2,2,2,0,0,0,0,0,0,0,0,0,0,0,0,0,0,0,0,2,2,0,0,0,0,0,0,0,0,0,0
486813,21041,210,41,-2,4,2,2,0,0,0,0,0,0,0,0,0,2,1,1,0,0,0,2,1,1,0,0,0,0,0,0,0,0,0
486822,21041,210,41,-2,14,3,11,0,0,0,0,0,0,0,0,0,4,1,3,0,0,0,10,2,8,0,0,0,0,0,0,0,0,0
487162,21041,210,41,-2,16,9,7,0,0,0,0,0,0,4,3,1,0,0,0,0,0,0,12,6,6,0,0,0,0,0,0,0,0,0
487302,21041,210,41,-2,2,0,2,0,0,0,0,0,0,0,0,0,0,0,0,0,0,0,2,0,2,0,0,0,0,0,0,0,0,0
487588,21041,210,41,-2,2,0,2,0,0,0,0,0,0,2,0,2,0,0,0,0,0,0,0,0,0,0,0,0,0,0,0,0,0,0
487861,21041,210,41,-2,3,1,2,0,0,0,0,0,0,0,0,0,0,0,0,0,0,0,3,1,2,0,0,0,0,0,0,0,0,0
487977,21041,210,41,-2,4,0,4,0,0,0,0,0,0,1,0,1,0,0,0,0,0,0,3,0,3,0,0,0,0,0,0,0,0,0
488077,21041,210,41,-2,1,0,1,0,0,0,1,0,1,0,0,0,0,0,0,0,0,0,0,0,0,0,0,0,0,0,0,0,0,0
488305,21041,210,41,-2,1,1,0,0,0,0,0,0,0,0,0,0,0,0,0,0,0,0,1,1,0,0,0,0,0,0,0,0,0,0
488554,21041,210,41,-2,3,2,1,0,0,0,0,0,0,0,0,0,0,0,0,0,0,0,3,2,1,0,0,0,0,0,0,0,0,0
489283,21041,210,41,-2,9,4,5,0,0,0,0,0,0,0,0,0,7,3,4,0,0,0,2,1,1,0,0,0,0,0,0,0,0,0
489779,21041,210,41,-2,6,3,3,0,0,0,0,0,0,2,1,1,0,0,0,0,0,0,3,1,2,0,0,0,1,1,0,0,0,0
489858,21041,210,41,-2,5,2,3,0,0,0,3,1,2,0,0,0,0,0,0,0,0,0,2,1,1,0,0,0,0,0,0,0,0,0
489937,21041,210,41,-2,12,8,4,0,0,0,6,5,1,1,0,1,0,0,0,0,0,0,5,3,2,0,0,0,0,0,0,0,0,0
490106,21041,210,41,-2,1,0,1,0,0,0,1,0,1,0,0,0,0,0,0,0,0,0,0,0,0,0,0,0,0,0,0,0,0,0
490133,21041,210,41,-2,2,2,0,0,0,0,0,0,0,0,0,0,0,0,0,0,0,0,0,0,0,0,0,0,2,2,0,0,0,0
490373,21041,210,41,-2,11,2,9,0,0,0,1,1,0,1,0,1,0,0,0,0,0,0,7,1,6,1,0,1,1,0,1,0,0,0
490805,21041,210,41,-2,3,1,2,0,0,0,0,0,0,0,0,0,0,0,0,0,0,0,2,1,1,0,0,0,0,0,0,1,0,1
490878,21041,210,41,-2,2,0,2,0,0,0,0,0,0,0,0,0,1,0,1,0,0,0,1,0,1,0,0,0,0,0,0,0,0,0
490975,21041,210,41,-2,2,1,1,0,0,0,1,1,0,0,0,0,1,0,1,0,0,0,0,0,0,0,0,0,0,0,0,0,0,0
491181,21041,210,41,-2,3,0,3,0,0,0,0,0,0,0,0,0,0,0,0,0,0,0,3,0,3,0,0,0,0,0,0,0,0,0
492449,21041,210,41,-2,3,1,2,0,0,0,0,0,0,0,0,0,3,1,2,0,0,0,0,0,0,0,0,0,0,0,0,0,0,0
492607,21041,210,41,-2,1,0,1,0,0,0,0,0,0,0,0,0,0,0,0,0,0,0,1,0,1,0,0,0,0,0,0,0,0,0
492722,21041,210,41,-2,6,0,6,0,0,0,0,0,0,1,0,1,3,0,3,0,0,0,1,0,1,1,0,1,0,0,0,0,0,0
493080,21041,210,41,-2,1,1,0,0,0,0,0,0,0,0,0,0,0,0,0,0,0,0,0,0,0,1,1,0,0,0,0,0,0,0
494010,21041,210,41,-2,1,0,1,0,0,0,0,0,0,0,0,0,0,0,0,0,0,0,1,0,1,0,0,0,0,0,0,0,0,0
494436,21041,210,41,-2,4,0,4,0,0,0,0,0,0,0,0,0,0,0,0,0,0,0,4,0,4,0,0,0,0,0,0,0,0,0
494588,21041,210,41,-2,2,1,1,0,0,0,0,0,0,0,0,0,0,0,0,0,0,0,1,1,0,1,0,1,0,0,0,0,0,0
494603,21041,210,41,-2,3,3,0,0,0,0,0,0,0,0,0,0,0,0,0,0,0,0,3,3,0,0,0,0,0,0,0,0,0,0
494843,21041,210,41,-2,4,0,4,0,0,0,1,0,1,3,0,3,0,0,0,0,0,0,0,0,0,0,0,0,0,0,0,0,0,0
494852,21041,210,41,-2,10,4,6,0,0,0,0,0,0,1,0,1,0,0,0,0,0,0,9,4,5,0,0,0,0,0,0,0,0,0
494959,21041,210,41,-2,1,1,0,0,0,0,0,0,0,1,1,0,0,0,0,0,0,0,0,0,0,0,0,0,0,0,0,0,0,0
495314,21041,210,41,-2,2,0,2,0,0,0,2,0,2,0,0,0,0,0,0,0,0,0,0,0,0,0,0,0,0,0,0,0,0,0
495767,21041,210,41,-2,105,56,49,0,0,0,23,11,12,3,2,1,7,7,0,0,0,0,56,29,27,4,3,1,4,1,3,8,3,5
496043,21041,210,41,-2,1,1,0,0,0,0,1,1,0,0,0,0,0,0,0,0,0,0,0,0,0,0,0,0,0,0,0,0,0,0
496627,21041,210,41,-2,5,3,2,0,0,0,1,1,0,0,0,0,0,0,0,0,0,0,4,2,2,0,0,0,0,0,0,0,0,0
496991,21041,210,41,-2,7,0,7,0,0,0,0,0,0,6,0,6,0,0,0,0,0,0,0,0,0,1,0,1,0,0,0,0,0,0
100654,21042,210,42,-2,5,3,2,0,0,0,1,1,0,3,1,2,0,0,0,0,0,0,0,0,0,0,0,0,1,1,0,0,0,0
100663,21042,210,42,-2,105,53,52,0,0,0,12,9,3,6,1,5,1,0,1,0,0,0,64,27,37,3,2,1,0,0,0,19,14,5
100690,21042,210,42,-2,2,2,0,0,0,0,0,0,0,0,0,0,0,0,0,0,0,0,2,2,0,0,0,0,0,0,0,0,0,0
100706,21042,210,42,-2,5,0,5,0,0,0,0,0,0,0,0,0,2,0,2,0,0,0,3,0,3,0,0,0,0,0,0,0,0,0
100724,21042,210,42,-2,1,0,1,0,0,0,0,0,0,1,0,1,0,0,0,0,0,0,0,0,0,0,0,0,0,0,0,0,0,0
100751,21042,210,42,-2,96,44,52,0,0,0,4,2,2,8,3,5,2,1,1,0,0,0,67,32,35,2,1,1,1,0,1,12,5,7
100830,21042,210,42,-2,5,1,4,0,0,0,1,0,1,0,0,0,0,0,0,0,0,0,1,1,0,0,0,0,3,0,3,0,0,0
100937,21042,210,42,-2,5,2,3,0,0,0,1,0,1,1,1,0,0,0,0,0,0,0,3,1,2,0,0,0,0,0,0,0,0,0
101161,21042,210,42,-2,2,1,1,0,0,0,0,0,0,0,0,0,0,0,0,0,0,0,2,1,1,0,0,0,0,0,0,0,0,0
101240,21042,210,42,-2,1,1,0,0,0,0,0,0,0,0,0,0,0,0,0,0,0,0,1,1,0,0,0,0,0,0,0,0,0,0
101286,21042,210,42,-2,1,1,0,0,0,0,0,0,0,0,0,0,0,0,0,0,0,0,1,1,0,0,0,0,0,0,0,0,0,0
101295,21042,210,42,-2,1,0,1,0,0,0,0,0,0,1,0,1,0,0,0,0,0,0,0,0,0,0,0,0,0,0,0,0,0,0
101301,21042,210,42,-2,5,2,3,0,0,0,0,0,0,2,0,2,0,0,0,0,0,0,1,1,0,0,0,0,2,1,1,0,0,0
101435,21042,210,42,-2,3,2,1,0,0,0,0,0,0,1,0,1,0,0,0,0,0,0,0,0,0,0,0,0,2,2,0,0,0,0
101480,21042,210,42,-2,4,1,3,0,0,0,0,0,0,1,0,1,0,0,0,0,0,0,3,1,2,0,0,0,0,0,0,0,0,0
101505,21042,210,42,-2,9,3,6,0,0,0,0,0,0,2,1,1,0,0,0,0,0,0,7,2,5,0,0,0,0,0,0,0,0,0
101514,21042,210,42,-2,4,0,4,0,0,0,0,0,0,0,0,0,0,0,0,0,0,0,4,0,4,0,0,0,0,0,0,0,0,0
101587,21042,210,42,-2,3,0,3,0,0,0,1,0,1,0,0,0,0,0,0,0,0,0,1,0,1,0,0,0,1,0,1,0,0,0
101675,21042,210,42,-2,12,3,9,0,0,0,0,0,0,7,2,5,0,0,0,0,0,0,5,1,4,0,0,0,0,0,0,0,0,0
101693,21042,210,42,-2,2,0,2,0,0,0,0,0,0,0,0,0,0,0,0,0,0,0,2,0,2,0,0,0,0,0,0,0,0,0
101709,21042,210,42,-2,3,0,3,1,0,1,0,0,0,0,0,0,0,0,0,0,0,0,2,0,2,0,0,0,0,0,0,0,0,0
101879,21042,210,42,-2,10,4,6,0,0,0,0,0,0,3,0,3,0,0,0,0,0,0,7,4,3,0,0,0,0,0,0,0,0,0
101897,21042,210,42,-2,2,2,0,0,0,0,0,0,0,0,0,0,0,0,0,0,0,0,2,2,0,0,0,0,0,0,0,0,0,0
102049,21042,210,42,-2,3,0,3,0,0,0,0,0,0,0,0,0,0,0,0,0,0,0,3,0,3,0,0,0,0,0,0,0,0,0
102067,21042,210,42,-2,2,1,1,0,0,0,0,0,0,1,1,0,0,0,0,0,0,0,1,0,1,0,0,0,0,0,0,0,0,0
102094,21042,210,42,-2,48,25,23,0,0,0,6,4,2,3,1,2,1,0,1,0,0,0,34,20,14,3,0,3,1,0,1,0,0,0
102234,21042,210,42,-2,3,0,3,0,0,0,0,0,0,0,0,0,0,0,0,0,0,0,3,0,3,0,0,0,0,0,0,0,0,0
102377,21042,210,42,-2,2,1,1,0,0,0,0,0,0,1,0,1,0,0,0,0,0,0,1,1,0,0,0,0,0,0,0,0,0,0
102553,21042,210,42,-2,12,5,7,0,0,0,0,0,0,0,0,0,0,0,0,0,0,0,10,4,6,1,0,1,1,1,0,0,0,0
102614,21042,210,42,-2,3,1,2,0,0,0,0,0,0,0,0,0,0,0,0,0,0,0,1,1,0,1,0,1,1,0,1,0,0,0
102632,21042,210,42,-2,3,2,1,0,0,0,1,0,1,0,0,0,0,0,0,0,0,0,2,2,0,0,0,0,0,0,0,0,0,0
102669,21042,210,42,-2,5,0,5,0,0,0,0,0,0,0,0,0,0,0,0,0,0,0,5,0,5,0,0,0,0,0,0,0,0,0
104151,21042,210,42,-2,154,63,91,1,0,1,6,2,4,4,2,2,16,4,12,0,0,0,79,38,41,3,1,2,36,13,23,9,3,6
104160,21042,210,42,-2,14,6,8,0,0,0,1,0,1,0,0,0,3,1,2,0,0,0,6,4,2,0,0,0,4,1,3,0,0,0
104179,21042,210,42,-2,53,29,24,1,1,0,5,4,1,5,3,2,5,2,3,0,0,0,30,14,16,0,0,0,2,1,1,5,4,1
104346,21042,210,42,-2,1,1,0,0,0,0,0,0,0,0,0,0,0,0,0,0,0,0,1,1,0,0,0,0,0,0,0,0,0,0
104425,21042,210,42,-2,17,8,9,0,0,0,0,0,0,1,0,1,3,2,1,0,0,0,12,6,6,0,0,0,1,0,1,0,0,0
104577,21042,210,42,-2,3,2,1,0,0,0,0,0,0,0,0,0,0,0,0,0,0,0,3,2,1,0,0,0,0,0,0,0,0,0
104586,21042,210,42,-2,10,9,1,0,0,0,1,1,0,1,1,0,0,0,0,0,0,0,8,7,1,0,0,0,0,0,0,0,0,0
104708,21042,210,42,-2,11,4,7,0,0,0,0,0,0,0,0,0,0,0,0,0,0,0,11,4,7,0,0,0,0,0,0,0,0,0
104717,21042,210,42,-2,25,8,17,0,0,0,3,3,0,1,0,1,1,0,1,0,0,0,18,5,13,2,0,2,0,0,0,0,0,0
105145,21042,210,42,-2,1,0,1,0,0,0,0,0,0,0,0,0,0,0,0,0,0,0,1,0,1,0,0,0,0,0,0,0,0,0
105154,21042,210,42,-2,19,10,9,0,0,0,1,1,0,1,0,1,3,0,3,0,0,0,12,8,4,2,1,1,0,0,0,0,0,0
105206,21042,210,42,-2,6,1,5,0,0,0,1,0,1,0,0,0,0,0,0,0,0,0,3,0,3,1,0,1,1,1,0,0,0,0
105297,21042,210,42,-2,4,4,0,3,3,0,0,0,0,0,0,0,0,0,0,0,0,0,1,1,0,0,0,0,0,0,0,0,0,0
105330,21042,210,42,-2,66,27,39,0,0,0,3,0,3,1,1,0,2,0,2,0,0,0,58,25,33,0,0,0,2,1,1,0,0,0
105428,21042,210,42,-2,5,0,5,0,0,0,0,0,0,0,0,0,1,0,1,0,0,0,4,0,4,0,0,0,0,0,0,0,0,0
105525,21042,210,42,-2,5,2,3,1,1,0,0,0,0,1,0,1,0,0,0,0,0,0,3,1,2,0,0,0,0,0,0,0,0,0
105589,21042,210,42,-2,2,1,1,0,0,0,0,0,0,0,0,0,0,0,0,0,0,0,1,1,0,0,0,0,1,0,1,0,0,0
105747,21042,210,42,-2,2,1,1,0,0,0,0,0,0,0,0,0,0,0,0,0,0,0,2,1,1,0,0,0,0,0,0,0,0,0
105899,21042,210,42,-2,1,1,0,0,0,0,0,0,0,0,0,0,0,0,0,0,0,0,1,1,0,0,0,0,0,0,0,0,0,0
106148,21042,210,42,-2,12,8,4,0,0,0,0,0,0,0,0,0,0,0,0,0,0,0,12,8,4,0,0,0,0,0,0,0,0,0
106245,21042,210,42,-2,6,2,4,0,0,0,0,0,0,1,0,1,0,0,0,0,0,0,5,2,3,0,0,0,0,0,0,0,0,0
106263,21042,210,42,-2,2,0,2,0,0,0,0,0,0,0,0,0,0,0,0,0,0,0,2,0,2,0,0,0,0,0,0,0,0,0
106306,21042,210,42,-2,1,1,0,0,0,0,0,0,0,1,1,0,0,0,0,0,0,0,0,0,0,0,0,0,0,0,0,0,0,0
106397,21042,210,42,-2,26,9,17,0,0,0,1,1,0,0,0,0,0,0,0,0,0,0,19,7,12,0,0,0,3,0,3,3,1,2
106412,21042,210,42,-2,2,0,2,0,0,0,0,0,0,1,0,1,0,0,0,0,0,0,1,0,1,0,0,0,0,0,0,0,0,0
106449,21042,210,42,-2,15,8,7,0,0,0,0,0,0,0,0,0,0,0,0,0,0,0,14,7,7,1,1,0,0,0,0,0,0,0
106458,21042,210,42,-2,15,5,10,0,0,0,0,0,0,0,0,0,0,0,0,0,0,0,12,3,9,0,0,0,1,1,0,2,1,1
106467,21042,210,42,-2,8,3,5,0,0,0,1,0,1,0,0,0,0,0,0,0,0,0,6,3,3,0,0,0,1,0,1,0,0,0
106485,21042,210,42,-2,11,6,5,0,0,0,0,0,0,0,0,0,0,0,0,0,0,0,10,6,4,0,0,0,1,0,1,0,0,0
106625,21042,210,42,-2,6,3,3,0,0,0,0,0,0,0,0,0,0,0,0,0,0,0,6,3,3,0,0,0,0,0,0,0,0,0
106795,21042,210,42,-2,6,2,4,0,0,0,0,0,0,0,0,0,0,0,0,0,0,0,6,2,4,0,0,0,0,0,0,0,0,0
106999,21042,210,42,-2,5,2,3,0,0,0,0,0,0,0,0,0,0,0,0,0,0,0,5,2,3,0,0,0,0,0,0,0,0,0
107044,21042,210,42,-2,14,4,10,0,0,0,0,0,0,0,0,0,1,0,1,0,0,0,12,4,8,0,0,0,0,0,0,1,0,1
107071,21042,210,42,-2,3,3,0,0,0,0,0,0,0,0,0,0,0,0,0,0,0,0,3,3,0,0,0,0,0,0,0,0,0,0
107318,21042,210,42,-2,2,2,0,0,0,0,0,0,0,1,1,0,0,0,0,0,0,0,1,1,0,0,0,0,0,0,0,0,0,0
107327,21042,210,42,-2,2,1,1,0,0,0,0,0,0,0,0,0,0,0,0,0,0,0,2,1,1,0,0,0,0,0,0,0,0,0
107460,21042,210,42,-2,4,1,3,0,0,0,0,0,0,0,0,0,0,0,0,0,0,0,4,1,3,0,0,0,0,0,0,0,0,0
107512,21042,210,42,-2,5,3,2,0,0,0,0,0,0,0,0,0,0,0,0,0,0,0,5,3,2,0,0,0,0,0,0,0,0,0
107521,21042,210,42,-2,14,8,6,0,0,0,0,0,0,4,2,2,0,0,0,0,0,0,10,6,4,0,0,0,0,0,0,0,0,0
107549,21042,210,42,-2,7,4,3,0,0,0,0,0,0,0,0,0,0,0,0,0,0,0,7,4,3,0,0,0,0,0,0,0,0,0
107585,21042,210,42,-2,5,3,2,0,0,0,0,0,0,0,0,0,0,0,0,0,0,0,5,3,2,0,0,0,0,0,0,0,0,0
107600,21042,210,42,-2,2,0,2,0,0,0,1,0,1,1,0,1,0,0,0,0,0,0,0,0,0,0,0,0,0,0,0,0,0,0
107619,21042,210,42,-2,4,0,4,0,0,0,0,0,0,1,0,1,0,0,0,0,0,0,3,0,3,0,0,0,0,0,0,0,0,0
107637,21042,210,42,-2,3,1,2,0,0,0,0,0,0,1,1,0,0,0,0,0,0,0,1,0,1,1,0,1,0,0,0,0,0,0
107664,21042,210,42,-2,1,1,0,0,0,0,0,0,0,0,0,0,0,0,0,0,0,0,1,1,0,0,0,0,0,0,0,0,0,0
107725,21042,210,42,-2,4,2,2,0,0,0,0,0,0,0,0,0,0,0,0,0,0,0,4,2,2,0,0,0,0,0,0,0,0,0
107743,21042,210,42,-2,1,0,1,0,0,0,0,0,0,0,0,0,0,0,0,0,0,0,1,0,1,0,0,0,0,0,0,0,0,0
107840,21042,210,42,-2,2,1,1,0,0,0,0,0,0,2,1,1,0,0,0,0,0,0,0,0,0,0,0,0,0,0,0,0,0,0
107974,21042,210,42,-2,3,0,3,0,0,0,0,0,0,1,0,1,0,0,0,0,0,0,2,0,2,0,0,0,0,0,0,0,0,0
107983,21042,210,42,-2,3,2,1,0,0,0,0,0,0,0,0,0,0,0,0,0,0,0,3,2,1,0,0,0,0,0,0,0,0,0
107992,21042,210,42,-2,12,6,6,0,0,0,0,0,0,2,0,2,0,0,0,0,0,0,10,6,4,0,0,0,0,0,0,0,0,0
108092,21042,210,42,-2,4,1,3,0,0,0,1,1,0,0,0,0,0,0,0,0,0,0,3,0,3,0,0,0,0,0,0,0,0,0
108870,21042,210,42,-2,1,1,0,0,0,0,0,0,0,0,0,0,0,0,0,0,0,0,1,1,0,0,0,0,0,0,0,0,0,0
109785,21042,210,42,-2,12,3,9,0,0,0,4,1,3,3,1,2,1,1,0,0,0,0,4,0,4,0,0,0,0,0,0,0,0,0
110316,21042,210,42,-2,3,1,2,0,0,0,0,0,0,2,1,1,0,0,0,0,0,0,1,0,1,0,0,0,0,0,0,0,0,0
110361,21042,210,42,-2,10,2,8,0,0,0,0,0,0,1,0,1,0,0,0,0,0,0,9,2,7,0,0,0,0,0,0,0,0,0
110413,21042,210,42,-2,10,4,6,0,0,0,0,0,0,1,1,0,2,1,1,0,0,0,6,2,4,1,0,1,0,0,0,0,0,0
110422,21042,210,42,-2,13,9,4,0,0,0,2,2,0,0,0,0,3,2,1,0,0,0,5,4,1,0,0,0,0,0,0,3,1,2
110486,21042,210,42,-2,6,3,3,0,0,0,1,0,1,0,0,0,3,2,1,0,0,0,1,1,0,0,0,0,1,0,1,0,0,0
110495,21042,210,42,-2,4,2,2,1,1,0,1,0,1,1,1,0,0,0,0,0,0,0,1,0,1,0,0,0,0,0,0,0,0,0
110510,21042,210,42,-2,5,2,3,0,0,0,0,0,0,1,0,1,0,0,0,0,0,0,4,2,2,0,0,0,0,0,0,0,0,0
110538,21042,210,42,-2,2,2,0,0,0,0,0,0,0,0,0,0,0,0,0,0,0,0,1,1,0,0,0,0,0,0,0,1,1,0
110547,21042,210,42,-2,3,0,3,0,0,0,0,0,0,0,0,0,1,0,1,0,0,0,1,0,1,0,0,0,1,0,1,0,0,0
110565,21042,210,42,-2,2,0,2,0,0,0,1,0,1,0,0,0,0,0,0,0,0,0,1,0,1,0,0,0,0,0,0,0,0,0
110583,21042,210,42,-2,2,0,2,0,0,0,1,0,1,0,0,0,0,0,0,0,0,0,1,0,1,0,0,0,0,0,0,0,0,0
110592,21042,210,42,-2,1,1,0,0,0,0,0,0,0,0,0,0,0,0,0,0,0,0,0,0,0,0,0,0,1,1,0,0,0,0
110635,21042,210,42,-2,52,28,24,0,0,0,6,2,4,2,1,1,2,2,0,0,0,0,28,17,11,1,0,1,7,4,3,6,2,4
110644,21042,210,42,-2,62,30,32,0,0,0,4,1,3,2,1,1,3,1,2,0,0,0,33,18,15,2,1,1,4,0,4,14,8,6
110653,21042,210,42,-2,30,13,17,0,0,0,2,1,1,0,0,0,0,0,0,0,0,0,19,6,13,0,0,0,2,2,0,7,4,3
110662,21042,210,42,-2,49,28,21,0,0,0,6,3,3,1,0,1,6,4,2,1,0,1,22,14,8,1,1,0,2,2,0,10,4,6
110671,21042,210,42,-2,18,12,6,0,0,0,1,1,0,1,1,0,3,0,3,0,0,0,7,5,2,1,1,0,1,1,0,4,3,1
110680,21042,210,42,-2,49,25,24,1,0,1,5,1,4,0,0,0,4,1,3,0,0,0,18,10,8,2,0,2,3,2,1,16,11,5
110699,21042,210,42,-2,1,1,0,0,0,0,0,0,0,0,0,0,0,0,0,0,0,0,0,0,0,0,0,0,0,0,0,1,1,0
110705,21042,210,42,-2,26,15,11,0,0,0,5,2,3,0,0,0,2,2,0,0,0,0,9,5,4,1,0,1,1,0,1,8,6,2
110714,21042,210,42,-2,9,3,6,0,0,0,1,0,1,1,1,0,0,0,0,0,0,0,3,2,1,2,0,2,0,0,0,2,0,2
111081,21042,210,42,-2,8,4,4,0,0,0,2,1,1,1,1,0,0,0,0,0,0,0,3,1,2,0,0,0,0,0,0,2,1,1
111188,21042,210,42,-2,2,2,0,0,0,0,0,0,0,0,0,0,0,0,0,0,0,0,2,2,0,0,0,0,0,0,0,0,0,0
111939,21042,210,42,-2,3,2,1,0,0,0,0,0,0,0,0,0,1,1,0,0,0,0,2,1,1,0,0,0,0,0,0,0,0,0
111948,21042,210,42,-2,7,3,4,0,0,0,0,0,0,1,1,0,0,0,0,0,0,0,3,1,2,0,0,0,3,1,2,0,0,0
111966,21042,210,42,-2,6,1,5,0,0,0,2,1,1,2,0,2,0,0,0,0,0,0,1,0,1,0,0,0,1,0,1,0,0,0
112075,21042,210,42,-2,6,4,2,0,0,0,0,0,0,0,0,0,0,0,0,0,0,0,3,2,1,0,0,0,3,2,1,0,0,0
112251,21042,210,42,-2,1,0,1,0,0,0,0,0,0,0,0,0,1,0,1,0,0,0,0,0,0,0,0,0,0,0,0,0,0,0
112260,21042,210,42,-2,10,3,7,0,0,0,3,1,2,0,0,0,1,0,1,0,0,0,2,1,1,0,0,0,1,1,0,3,0,3
112525,21042,210,42,-2,18,7,11,0,0,0,6,3,3,2,0,2,1,1,0,0,0,0,5,1,4,1,0,1,3,2,1,0,0,0
112561,21042,210,42,-2,15,8,7,0,0,0,0,0,0,0,0,0,1,0,1,0,0,0,12,7,5,2,1,1,0,0,0,0,0,0
112826,21042,210,42,-2,5,1,4,0,0,0,0,0,0,1,0,1,1,0,1,0,0,0,2,1,1,1,0,1,0,0,0,0,0,0
113333,21042,210,42,-2,2,1,1,0,0,0,0,0,0,0,0,0,0,0,0,0,0,0,1,1,0,0,0,0,0,0,0,1,0,1
113698,21042,210,42,-2,5,3,2,0,0,0,0,0,0,0,0,0,0,0,0,0,0,0,4,3,1,0,0,0,1,0,1,0,0,0
114266,21042,210,42,-2,4,0,4,0,0,0,2,0,2,0,0,0,1,0,1,0,0,0,0,0,0,0,0,0,1,0,1,0,0,0
114433,21042,210,42,-2,1,0,1,0,0,0,0,0,0,0,0,0,1,0,1,0,0,0,0,0,0,0,0,0,0,0,0,0,0,0
114716,21042,210,42,-2,4,1,3,0,0,0,0,0,0,0,0,0,2,0,2,0,0,0,2,1,1,0,0,0,0,0,0,0,0,0
114789,21042,210,42,-2,6,3,3,1,1,0,0,0,0,1,0,1,1,1,0,0,0,0,2,1,1,1,0,1,0,0,0,0,0,0
114813,21042,210,42,-2,1,0,1,0,0,0,0,0,0,0,0,0,1,0,1,0,0,0,0,0,0,0,0,0,0,0,0,0,0,0
115083,21042,210,42,-2,2,0,2,0,0,0,0,0,0,0,0,0,0,0,0,0,0,0,2,0,2,0,0,0,0,0,0,0,0,0
115296,21042,210,42,-2,1,1,0,0,0,0,0,0,0,0,0,0,0,0,0,0,0,0,0,0,0,0,0,0,1,1,0,0,0,0
115409,21042,210,42,-2,3,1,2,0,0,0,0,0,0,0,0,0,0,0,0,0,0,0,2,1,1,0,0,0,1,0,1,0,0,0
115728,21042,210,42,-2,2,1,1,0,0,0,1,1,0,1,0,1,0,0,0,0,0,0,0,0,0,0,0,0,0,0,0,0,0,0
115746,21042,210,42,-2,1,1,0,0,0,0,0,0,0,0,0,0,0,0,0,0,0,0,1,1,0,0,0,0,0,0,0,0,0,0
115755,21042,210,42,-2,1,1,0,0,0,0,0,0,0,0,0,0,0,0,0,0,0,0,0,0,0,0,0,0,1,1,0,0,0,0
115861,21042,210,42,-2,3,0,3,0,0,0,1,0,1,0,0,0,2,0,2,0,0,0,0,0,0,0,0,0,0,0,0,0,0,0
117140,21042,210,42,-2,3,2,1,0,0,0,0,0,0,0,0,0,0,0,0,0,0,0,2,1,1,0,0,0,1,1,0,0,0,0
117168,21042,210,42,-2,1,0,1,0,0,0,1,0,1,0,0,0,0,0,0,0,0,0,0,0,0,0,0,0,0,0,0,0,0,0
117557,21042,210,42,-2,1,1,0,0,0,0,0,0,0,0,0,0,0,0,0,0,0,0,1,1,0,0,0,0,0,0,0,0,0,0
117636,21042,210,42,-2,18,4,14,0,0,0,3,0,3,2,1,1,3,2,1,0,0,0,9,1,8,0,0,0,0,0,0,1,0,1
117672,21042,210,42,-2,1,0,1,0,0,0,0,0,0,0,0,0,0,0,0,0,0,0,0,0,0,1,0,1,0,0,0,0,0,0
117751,21042,210,42,-2,3,1,2,0,0,0,0,0,0,1,0,1,0,0,0,0,0,0,2,1,1,0,0,0,0,0,0,0,0,0
117894,21042,210,42,-2,3,2,1,0,0,0,1,0,1,1,1,0,0,0,0,0,0,0,1,1,0,0,0,0,0,0,0,0,0,0
118684,21042,210,42,-2,3,1,2,0,0,0,1,0,1,0,0,0,2,1,1,0,0,0,0,0,0,0,0,0,0,0,0,0,0,0
118718,21042,210,42,-2,1,0,1,0,0,0,0,0,0,0,0,0,1,0,1,0,0,0,0,0,0,0,0,0,0,0,0,0,0,0
118976,21042,210,42,-2,61,23,38,0,0,0,3,0,3,0,0,0,16,5,11,0,0,0,41,18,23,1,0,1,0,0,0,0,0,0
119137,21042,210,42,-2,2,1,1,0,0,0,0,0,0,0,0,0,0,0,0,0,0,0,1,0,1,0,0,0,0,0,0,1,1,0
119173,21042,210,42,-2,7,2,5,0,0,0,2,0,2,0,0,0,1,1,0,0,0,0,4,1,3,0,0,0,0,0,0,0,0,0
119331,21042,210,42,-2,1,0,1,0,0,0,0,0,0,0,0,0,0,0,0,0,0,0,1,0,1,0,0,0,0,0,0,0,0,0
119605,21042,210,42,-2,4,3,1,0,0,0,0,0,0,1,1,0,0,0,0,0,0,0,2,2,0,0,0,0,1,0,1,0,0,0
119678,21042,210,42,-2,10,8,2,0,0,0,0,0,0,1,0,1,0,0,0,0,0,0,7,6,1,0,0,0,2,2,0,0,0,0
120254,21042,210,42,-2,13,8,5,0,0,0,0,0,0,0,0,0,2,2,0,0,0,0,4,3,1,0,0,0,7,3,4,0,0,0
120290,21042,210,42,-2,4,0,4,0,0,0,1,0,1,2,0,2,1,0,1,0,0,0,0,0,0,0,0,0,0,0,0,0,0,0
120403,21042,210,42,-2,2,0,2,0,0,0,0,0,0,0,0,0,0,0,0,0,0,0,2,0,2,0,0,0,0,0,0,0,0,0
120421,21042,210,42,-2,2,1,1,0,0,0,0,0,0,0,0,0,1,0,1,0,0,0,1,1,0,0,0,0,0,0,0,0,0,0
120698,21042,210,42,-2,2,1,1,0,0,0,0,0,0,0,0,0,0,0,0,0,0,0,2,1,1,0,0,0,0,0,0,0,0,0
120865,21042,210,42,-2,7,3,4,0,0,0,1,0,1,1,0,1,1,0,1,0,0,0,4,3,1,0,0,0,0,0,0,0,0,0
121150,21042,210,42,-2,27,9,18,0,0,0,0,0,0,0,0,0,4,3,1,0,0,0,23,6,17,0,0,0,0,0,0,0,0,0
121309,21042,210,42,-2,1,0,1,0,0,0,0,0,0,0,0,0,0,0,0,0,0,0,0,0,0,1,0,1,0,0,0,0,0,0
121691,21042,210,42,-2,10,4,6,0,0,0,3,1,2,1,0,1,2,1,1,0,0,0,3,2,1,0,0,0,1,0,1,0,0,0
121707,21042,210,42,-2,1,0,1,0,0,0,0,0,0,0,0,0,0,0,0,0,0,0,1,0,1,0,0,0,0,0,0,0,0,0
122296,21042,210,42,-2,9,2,7,0,0,0,3,2,1,0,0,0,1,0,1,0,0,0,2,0,2,0,0,0,3,0,3,0,0,0
122409,21042,210,42,-2,11,6,5,1,1,0,3,2,1,0,0,0,3,1,2,0,0,0,4,2,2,0,0,0,0,0,0,0,0,0
122597,21042,210,42,-2,2,1,1,0,0,0,0,0,0,0,0,0,1,0,1,0,0,0,1,1,0,0,0,0,0,0,0,0,0,0
122612,21042,210,42,-2,10,3,7,0,0,0,0,0,0,3,1,2,1,0,1,0,0,0,5,1,4,0,0,0,1,1,0,0,0,0
122746,21042,210,42,-2,1,0,1,0,0,0,0,0,0,1,0,1,0,0,0,0,0,0,0,0,0,0,0,0,0,0,0,0,0,0
122755,21042,210,42,-2,5,1,4,0,0,0,2,0,2,1,0,1,1,1,0,0,0,0,1,0,1,0,0,0,0,0,0,0,0,0
122931,21042,210,42,-2,12,10,2,0,0,0,3,3,0,2,2,0,1,0,1,0,0,0,5,5,0,0,0,0,0,0,0,1,0,1
123299,21042,210,42,-2,1,1,0,0,0,0,0,0,0,0,0,0,0,0,0,0,0,0,0,0,0,0,0,0,1,1,0,0,0,0
123554,21042,210,42,-2,2,1,1,0,0,0,0,0,0,0,0,0,1,1,0,0,0,0,1,0,1,0,0,0,0,0,0,0,0,0
123572,21042,210,42,-2,2,1,1,0,0,0,0,0,0,0,0,0,0,0,0,0,0,0,0,0,0,0,0,0,0,0,0,2,1,1
123651,21042,210,42,-2,2,2,0,0,0,0,0,0,0,0,0,0,0,0,0,0,0,0,2,2,0,0,0,0,0,0,0,0,0,0
123961,21042,210,42,-2,17,7,10,0,0,0,6,3,3,2,0,2,0,0,0,0,0,0,5,3,2,1,0,1,0,0,0,3,1,2
123970,21042,210,42,-2,5,2,3,0,0,0,1,1,0,2,0,2,0,0,0,0,0,0,1,0,1,0,0,0,0,0,0,1,1,0
125028,21042,210,42,-2,2,1,1,0,0,0,0,0,0,0,0,0,0,0,0,0,0,0,2,1,1,0,0,0,0,0,0,0,0,0
125727,21042,210,42,-2,3,2,1,0,0,0,0,0,0,1,0,1,0,0,0,0,0,0,1,1,0,0,0,0,1,1,0,0,0,0
125763,21042,210,42,-2,3,2,1,0,0,0,0,0,0,0,0,0,1,1,0,0,0,0,2,1,1,0,0,0,0,0,0,0,0,0
125897,21042,210,42,-2,2,2,0,0,0,0,0,0,0,0,0,0,0,0,0,0,0,0,2,2,0,0,0,0,0,0,0,0,0,0
126119,21042,210,42,-2,12,4,8,0,0,0,1,0,1,0,0,0,1,1,0,0,0,0,10,3,7,0,0,0,0,0,0,0,0,0
126182,21042,210,42,-2,5,4,1,0,0,0,0,0,0,0,0,0,0,0,0,0,0,0,4,3,1,0,0,0,0,0,0,1,1,0
126562,21042,210,42,-2,7,4,3,0,0,0,1,0,1,1,1,0,0,0,0,0,0,0,4,2,2,0,0,0,1,1,0,0,0,0
126580,21042,210,42,-2,8,2,6,0,0,0,1,1,0,0,0,0,1,0,1,0,0,0,6,1,5,0,0,0,0,0,0,0,0,0
126614,21042,210,42,-2,21,11,10,0,0,0,3,2,1,1,1,0,1,0,1,0,0,0,9,4,5,0,0,0,1,1,0,6,3,3
126669,21042,210,42,-2,7,3,4,0,0,0,1,1,0,0,0,0,0,0,0,0,0,0,6,2,4,0,0,0,0,0,0,0,0,0
126711,21042,210,42,-2,8,2,6,0,0,0,0,0,0,0,0,0,1,1,0,0,0,0,7,1,6,0,0,0,0,0,0,0,0,0
126748,21042,210,42,-2,4,1,3,0,0,0,0,0,0,1,1,0,1,0,1,0,0,0,2,0,2,0,0,0,0,0,0,0,0,0
126775,21042,210,42,-2,14,6,8,0,0,0,0,0,0,0,0,0,0,0,0,0,0,0,8,5,3,0,0,0,5,0,5,1,1,0
126818,21042,210,42,-2,6,3,3,0,0,0,0,0,0,0,0,0,0,0,0,0,0,0,3,1,2,0,0,0,3,2,1,0,0,0
126863,21042,210,42,-2,9,4,5,1,1,0,2,0,2,0,0,0,0,0,0,0,0,0,5,2,3,0,0,0,0,0,0,1,1,0
126942,21042,210,42,-2,14,4,10,0,0,0,1,0,1,0,0,0,1,1,0,0,0,0,10,2,8,1,0,1,1,1,0,0,0,0
126979,21042,210,42,-2,3,1,2,0,0,0,0,0,0,1,0,1,0,0,0,0,0,0,2,1,1,0,0,0,0,0,0,0,0,0
127060,21042,210,42,-2,13,7,6,0,0,0,0,0,0,0,0,0,2,0,2,0,0,0,6,3,3,4,3,1,1,1,0,0,0,0
127185,21042,210,42,-2,1,0,1,0,0,0,0,0,0,0,0,0,0,0,0,0,0,0,1,0,1,0,0,0,0,0,0,0,0,0
127200,21042,210,42,-2,1,1,0,0,0,0,1,1,0,0,0,0,0,0,0,0,0,0,0,0,0,0,0,0,0,0,0,0,0,0
127556,21042,210,42,-2,19,8,11,0,0,0,0,0,0,0,0,0,1,0,1,0,0,0,18,8,10,0,0,0,0,0,0,0,0,0
127565,21042,210,42,-2,15,6,9,0,0,0,5,3,2,2,1,1,2,0,2,0,0,0,5,1,4,0,0,0,1,1,0,0,0,0
127617,21042,210,42,-2,3,3,0,0,0,0,0,0,0,0,0,0,1,1,0,0,0,0,2,2,0,0,0,0,0,0,0,0,0,0
127653,21042,210,42,-2,11,2,9,0,0,0,0,0,0,2,0,2,2,0,2,0,0,0,5,1,4,0,0,0,2,1,1,0,0,0
127732,21042,210,42,-2,8,3,5,0,0,0,0,0,0,0,0,0,0,0,0,0,0,0,8,3,5,0,0,0,0,0,0,0,0,0
127741,21042,210,42,-2,11,5,6,0,0,0,2,1,1,0,0,0,2,1,1,0,0,0,7,3,4,0,0,0,0,0,0,0,0,0
127778,21042,210,42,-2,3,0,3,1,0,1,0,0,0,0,0,0,1,0,1,0,0,0,1,0,1,0,0,0,0,0,0,0,0,0
127820,21042,210,42,-2,24,11,13,1,1,0,1,0,1,4,1,3,1,0,1,0,0,0,16,9,7,1,0,1,0,0,0,0,0,0
127909,21042,210,42,-2,6,3,3,0,0,0,2,1,1,0,0,0,0,0,0,0,0,0,4,2,2,0,0,0,0,0,0,0,0,0
127918,21042,210,42,-2,18,6,12,0,0,0,0,0,0,2,0,2,1,0,1,0,0,0,12,5,7,1,1,0,2,0,2,0,0,0
128106,21042,210,42,-2,14,7,7,0,0,0,4,2,2,0,0,0,1,0,1,0,0,0,8,4,4,0,0,0,1,1,0,0,0,0
128258,21042,210,42,-2,4,2,2,0,0,0,0,0,0,0,0,0,0,0,0,0,0,0,4,2,2,0,0,0,0,0,0,0,0,0
128328,21042,210,42,-2,9,5,4,0,0,0,0,0,0,0,0,0,0,0,0,0,0,0,9,5,4,0,0,0,0,0,0,0,0,0
128391,21042,210,42,-2,12,8,4,0,0,0,0,0,0,0,0,0,2,1,1,0,0,0,9,7,2,0,0,0,0,0,0,1,0,1
128744,21042,210,42,-2,132,68,64,0,0,0,12,9,3,9,4,5,9,3,6,0,0,0,91,44,47,2,2,0,9,6,3,0,0,0
128771,21042,210,42,-2,7,4,3,0,0,0,0,0,0,0,0,0,1,1,0,0,0,0,6,3,3,0,0,0,0,0,0,0,0,0
128902,21042,210,42,-2,2,2,0,0,0,0,0,0,0,0,0,0,0,0,0,0,0,0,1,1,0,0,0,0,0,0,0,1,1,0
129020,21042,210,42,-2,71,28,43,0,0,0,12,5,7,3,1,2,1,1,0,0,0,0,39,13,26,2,1,1,2,0,2,12,7,5
129154,21042,210,42,-2,4,0,4,0,0,0,1,0,1,0,0,0,0,0,0,0,0,0,2,0,2,1,0,1,0,0,0,0,0,0
129215,21042,210,42,-2,2,1,1,0,0,0,1,0,1,0,0,0,0,0,0,0,0,0,1,1,0,0,0,0,0,0,0,0,0,0
129242,21042,210,42,-2,15,6,9,0,0,0,1,0,1,1,1,0,2,1,1,0,0,0,11,4,7,0,0,0,0,0,0,0,0,0
129525,21042,210,42,-2,7,5,2,0,0,0,0,0,0,2,2,0,1,1,0,0,0,0,3,1,2,0,0,0,1,1,0,0,0,0
129543,21042,210,42,-2,1,1,0,0,0,0,0,0,0,0,0,0,0,0,0,0,0,0,1,1,0,0,0,0,0,0,0,0,0,0
129774,21042,210,42,-2,2,1,1,0,0,0,0,0,0,0,0,0,0,0,0,0,0,0,2,1,1,0,0,0,0,0,0,0,0,0
129941,21042,210,42,-2,9,3,6,0,0,0,0,0,0,0,0,0,0,0,0,0,0,0,9,3,6,0,0,0,0,0,0,0,0,0
130110,21042,210,42,-2,6,2,4,0,0,0,1,0,1,0,0,0,0,0,0,0,0,0,5,2,3,0,0,0,0,0,0,0,0,0
130226,21042,210,42,-2,3,1,2,0,0,0,1,1,0,0,0,0,0,0,0,0,0,0,2,0,2,0,0,0,0,0,0,0,0,0
130253,21042,210,42,-2,25,5,20,0,0,0,1,0,1,3,0,3,3,0,3,0,0,0,15,4,11,0,0,0,3,1,2,0,0,0
130314,21042,210,42,-2,3,0,3,0,0,0,0,0,0,0,0,0,2,0,2,0,0,0,1,0,1,0,0,0,0,0,0,0,0,0
130493,21042,210,42,-2,2,0,2,0,0,0,1,0,1,0,0,0,0,0,0,0,0,0,1,0,1,0,0,0,0,0,0,0,0,0
130590,21042,210,42,-2,6,3,3,0,0,0,1,0,1,0,0,0,1,1,0,0,0,0,3,2,1,1,0,1,0,0,0,0,0,0
130606,21042,210,42,-2,1,1,0,0,0,0,0,0,0,0,0,0,0,0,0,0,0,0,1,1,0,0,0,0,0,0,0,0,0,0
130624,21042,210,42,-2,7,3,4,0,0,0,0,0,0,0,0,0,1,1,0,0,0,0,6,2,4,0,0,0,0,0,0,0,0,0
130697,21042,210,42,-2,16,7,9,1,0,1,0,0,0,2,0,2,1,1,0,0,0,0,9,4,5,0,0,0,0,0,0,3,2,1
130776,21042,210,42,-2,1,0,1,0,0,0,0,0,0,0,0,0,0,0,0,0,0,0,0,0,0,1,0,1,0,0,0,0,0,0
130794,21042,210,42,-2,52,21,31,0,0,0,8,2,6,5,1,4,3,1,2,0,0,0,24,13,11,2,0,2,1,0,1,9,4,5
130934,21042,210,42,-2,21,8,13,0,0,0,2,0,2,2,0,2,0,0,0,0,0,0,17,8,9,0,0,0,0,0,0,0,0,0
130943,21042,210,42,-2,16,10,6,0,0,0,0,0,0,2,1,1,3,3,0,0,0,0,10,5,5,0,0,0,0,0,0,1,1,0
131159,21042,210,42,-2,33,11,22,0,0,0,3,1,2,8,4,4,0,0,0,0,0,0,20,4,16,0,0,0,2,2,0,0,0,0
131283,21042,210,42,-2,4,3,1,0,0,0,0,0,0,0,0,0,2,2,0,0,0,0,2,1,1,0,0,0,0,0,0,0,0,0
131450,21042,210,42,-2,2,1,1,0,0,0,0,0,0,1,1,0,0,0,0,0,0,0,1,0,1,0,0,0,0,0,0,0,0,0
131469,21042,210,42,-2,34,11,23,0,0,0,3,1,2,5,0,5,3,0,3,0,0,0,20,8,12,0,0,0,3,2,1,0,0,0
131496,21042,210,42,-2,13,4,9,0,0,0,2,1,1,3,2,1,0,0,0,0,0,0,6,1,5,0,0,0,2,0,2,0,0,0
131520,21042,210,42,-2,52,26,26,0,0,0,5,1,4,25,15,10,7,4,3,0,0,0,5,2,3,3,1,2,7,3,4,0,0,0
131876,21042,210,42,-2,4,1,3,0,0,0,0,0,0,3,1,2,0,0,0,0,0,0,1,0,1,0,0,0,0,0,0,0,0,0
132408,21042,210,42,-2,1,0,1,0,0,0,0,0,0,0,0,0,0,0,0,0,0,0,1,0,1,0,0,0,0,0,0,0,0,0
132471,21042,210,42,-2,14,5,9,0,0,0,0,0,0,2,0,2,2,0,2,0,0,0,6,3,3,0,0,0,1,1,0,3,1,2
132602,21042,210,42,-2,2,0,2,0,0,0,0,0,0,1,0,1,0,0,0,0,0,0,1,0,1,0,0,0,0,0,0,0,0,0
132657,21042,210,42,-2,11,7,4,0,0,0,0,0,0,0,0,0,3,2,1,1,0,1,5,4,1,2,1,1,0,0,0,0,0,0
132842,21042,210,42,-2,4,2,2,0,0,0,0,0,0,0,0,0,4,2,2,0,0,0,0,0,0,0,0,0,0,0,0,0,0,0
132879,21042,210,42,-2,1,0,1,0,0,0,0,0,0,0,0,0,0,0,0,0,0,0,1,0,1,0,0,0,0,0,0,0,0,0
132903,21042,210,42,-2,10,3,7,0,0,0,1,0,1,1,1,0,2,0,2,0,0,0,5,2,3,1,0,1,0,0,0,0,0,0
133492,21042,210,42,-2,11,4,7,0,0,0,1,1,0,0,0,0,0,0,0,0,0,0,9,3,6,0,0,0,1,0,1,0,0,0
133508,21042,210,42,-2,1,1,0,0,0,0,0,0,0,1,1,0,0,0,0,0,0,0,0,0,0,0,0,0,0,0,0,0,0,0
133553,21042,210,42,-2,23,11,12,0,0,0,3,2,1,0,0,0,1,1,0,0,0,0,14,7,7,0,0,0,2,1,1,3,0,3
133669,21042,210,42,-2,7,4,3,0,0,0,0,0,0,1,0,1,1,0,1,0,0,0,4,3,1,0,0,0,0,0,0,1,1,0
133711,21042,210,42,-2,14,9,5,0,0,0,1,1,0,1,0,1,0,0,0,0,0,0,11,7,4,0,0,0,1,1,0,0,0,0
133809,21042,210,42,-2,2,1,1,0,0,0,0,0,0,0,0,0,0,0,0,0,0,0,2,1,1,0,0,0,0,0,0,0,0,0
133872,21042,210,42,-2,5,0,5,0,0,0,0,0,0,1,0,1,3,0,3,0,0,0,1,0,1,0,0,0,0,0,0,0,0,0
133881,21042,210,42,-2,8,6,2,1,1,0,1,0,1,0,0,0,0,0,0,0,0,0,4,3,1,0,0,0,1,1,0,1,1,0
133951,21042,210,42,-2,87,44,43,0,0,0,5,3,2,8,2,6,27,12,15,0,0,0,40,20,20,0,0,0,0,0,0,7,7,0
134079,21042,210,42,-2,5,3,2,0,0,0,0,0,0,1,0,1,0,0,0,0,0,0,4,3,1,0,0,0,0,0,0,0,0,0
134097,21042,210,42,-2,60,29,31,0,0,0,1,0,1,5,4,1,4,2,2,0,0,0,45,22,23,0,0,0,1,0,1,4,1,3
134130,21042,210,42,-2,39,19,20,0,0,0,2,1,1,3,1,2,4,3,1,0,0,0,24,9,15,0,0,0,1,1,0,5,4,1
134945,21042,210,42,-2,10,2,8,0,0,0,1,0,1,3,1,2,0,0,0,0,0,0,6,1,5,0,0,0,0,0,0,0,0,0
135160,21042,210,42,-2,1,0,1,0,0,0,0,0,0,0,0,0,0,0,0,0,0,0,1,0,1,0,0,0,0,0,0,0,0,0
135391,21042,210,42,-2,4,2,2,0,0,0,0,0,0,1,1,0,0,0,0,0,0,0,3,1,2,0,0,0,0,0,0,0,0,0
135726,21042,210,42,-2,30,16,14,0,0,0,2,2,0,2,1,1,6,4,2,0,0,0,14,5,9,0,0,0,3,1,2,3,3,0
136172,21042,210,42,-2,23,9,14,0,0,0,4,2,2,2,0,2,0,0,0,1,0,1,15,6,9,0,0,0,0,0,0,1,1,0
136215,21042,210,42,-2,103,44,59,0,0,0,5,2,3,9,1,8,14,7,7,0,0,0,61,26,35,0,0,0,1,1,0,13,7,6
136330,21042,210,42,-2,11,6,5,0,0,0,0,0,0,2,2,0,2,1,1,0,0,0,6,2,4,0,0,0,0,0,0,1,1,0
136473,21042,210,42,-2,8,4,4,0,0,0,0,0,0,0,0,0,0,0,0,0,0,0,7,4,3,1,0,1,0,0,0,0,0,0
136516,21042,210,42,-2,5,0,5,0,0,0,0,0,0,1,0,1,0,0,0,0,0,0,4,0,4,0,0,0,0,0,0,0,0,0
136701,21042,210,42,-2,4,4,0,0,0,0,1,1,0,0,0,0,1,1,0,0,0,0,1,1,0,0,0,0,0,0,0,1,1,0
136774,21042,210,42,-2,6,3,3,0,0,0,0,0,0,0,0,0,1,1,0,0,0,0,5,2,3,0,0,0,0,0,0,0,0,0
136950,21042,210,42,-2,11,5,6,0,0,0,1,0,1,0,0,0,1,0,1,0,0,0,9,5,4,0,0,0,0,0,0,0,0,0
137315,21042,210,42,-2,3,3,0,0,0,0,0,0,0,0,0,0,0,0,0,0,0,0,3,3,0,0,0,0,0,0,0,0,0,0
137351,21042,210,42,-2,124,51,73,0,0,0,16,8,8,5,1,4,6,3,3,0,0,0,66,27,39,12,5,7,2,1,1,17,6,11
137476,21042,210,42,-2,15,8,7,0,0,0,0,0,0,1,1,0,5,2,3,0,0,0,9,5,4,0,0,0,0,0,0,0,0,0
137546,21042,210,42,-2,8,5,3,0,0,0,0,0,0,0,0,0,0,0,0,0,0,0,7,5,2,0,0,0,0,0,0,1,0,1
137564,21042,210,42,-2,6,3,3,0,0,0,0,0,0,0,0,0,0,0,0,0,0,0,6,3,3,0,0,0,0,0,0,0,0,0
137759,21042,210,42,-2,7,2,5,0,0,0,0,0,0,0,0,0,0,0,0,0,0,0,6,1,5,0,0,0,1,1,0,0,0,0
137847,21042,210,42,-2,28,17,11,0,0,0,5,4,1,4,1,3,1,1,0,0,0,0,10,6,4,1,1,0,7,4,3,0,0,0
137962,21042,210,42,-2,1,1,0,0,0,0,0,0,0,0,0,0,0,0,0,0,0,0,1,1,0,0,0,0,0,0,0,0,0,0
138187,21042,210,42,-2,5,0,5,0,0,0,0,0,0,3,0,3,0,0,0,0,0,0,2,0,2,0,0,0,0,0,0,0,0,0
138275,21042,210,42,-2,4,2,2,0,0,0,0,0,0,2,0,2,0,0,0,0,0,0,2,2,0,0,0,0,0,0,0,0,0,0
138293,21042,210,42,-2,5,2,3,0,0,0,0,0,0,0,0,0,0,0,0,0,0,0,5,2,3,0,0,0,0,0,0,0,0,0
138354,21042,210,42,-2,1,0,1,0,0,0,0,0,0,0,0,0,0,0,0,0,0,0,1,0,1,0,0,0,0,0,0,0,0,0
138558,21042,210,42,-2,2,0,2,0,0,0,0,0,0,0,0,0,0,0,0,0,0,0,2,0,2,0,0,0,0,0,0,0,0,0
138600,21042,210,42,-2,3,2,1,0,0,0,1,1,0,0,0,0,0,0,0,0,0,0,2,1,1,0,0,0,0,0,0,0,0,0
138682,21042,210,42,-2,11,3,8,0,0,0,1,0,1,9,3,6,0,0,0,0,0,0,1,0,1,0,0,0,0,0,0,0,0,0
138716,21042,210,42,-2,11,3,8,0,0,0,2,2,0,6,1,5,1,0,1,0,0,0,2,0,2,0,0,0,0,0,0,0,0,0
138761,21042,210,42,-2,2,1,1,0,0,0,0,0,0,1,1,0,0,0,0,0,0,0,1,0,1,0,0,0,0,0,0,0,0,0
138868,21042,210,42,-2,4,3,1,0,0,0,0,0,0,0,0,0,0,0,0,0,0,0,4,3,1,0,0,0,0,0,0,0,0,0
138901,21042,210,42,-2,1,1,0,0,0,0,0,0,0,1,1,0,0,0,0,0,0,0,0,0,0,0,0,0,0,0,0,0,0,0
138947,21042,210,42,-2,4,2,2,0,0,0,1,0,1,3,2,1,0,0,0,0,0,0,0,0,0,0,0,0,0,0,0,0,0,0
138956,21042,210,42,-2,16,7,9,0,0,0,0,0,0,7,2,5,2,1,1,0,0,0,7,4,3,0,0,0,0,0,0,0,0,0
139199,21042,210,42,-2,20,4,16,0,0,0,3,2,1,2,0,2,1,0,1,0,0,0,14,2,12,0,0,0,0,0,0,0,0,0
139205,21042,210,42,-2,4,3,1,0,0,0,0,0,0,0,0,0,0,0,0,0,0,0,4,3,1,0,0,0,0,0,0,0,0,0
139250,21042,210,42,-2,7,4,3,0,0,0,0,0,0,1,1,0,1,1,0,0,0,0,5,2,3,0,0,0,0,0,0,0,0,0
139278,21042,210,42,-2,18,5,13,0,0,0,0,0,0,4,1,3,0,0,0,0,0,0,14,4,10,0,0,0,0,0,0,0,0,0
139311,21042,210,42,-2,3,2,1,0,0,0,0,0,0,0,0,0,0,0,0,0,0,0,3,2,1,0,0,0,0,0,0,0,0,0
139393,21042,210,42,-2,1,1,0,0,0,0,0,0,0,0,0,0,0,0,0,0,0,0,1,1,0,0,0,0,0,0,0,0,0,0
139463,21042,210,42,-2,3,1,2,0,0,0,1,0,1,0,0,0,0,0,0,0,0,0,2,1,1,0,0,0,0,0,0,0,0,0
139630,21042,210,42,-2,3,2,1,0,0,0,0,0,0,0,0,0,0,0,0,0,0,0,3,2,1,0,0,0,0,0,0,0,0,0
139658,21042,210,42,-2,19,5,14,0,0,0,8,1,7,3,1,2,0,0,0,0,0,0,8,3,5,0,0,0,0,0,0,0,0,0
139700,21042,210,42,-2,4,0,4,0,0,0,0,0,0,0,0,0,1,0,1,0,0,0,2,0,2,1,0,1,0,0,0,0,0,0
139719,21042,210,42,-2,4,1,3,0,0,0,0,0,0,3,0,3,0,0,0,0,0,0,1,1,0,0,0,0,0,0,0,0,0,0
139755,21042,210,42,-2,10,5,5,0,0,0,1,0,1,1,1,0,1,1,0,0,0,0,5,1,4,1,1,0,0,0,0,1,1,0
139764,21042,210,42,-2,1,0,1,0,0,0,0,0,0,0,0,0,0,0,0,0,0,0,1,0,1,0,0,0,0,0,0,0,0,0
139861,21042,210,42,-2,9,4,5,0,0,0,0,0,0,1,0,1,1,0,1,0,0,0,6,4,2,0,0,0,0,0,0,1,0,1
139931,21042,210,42,-2,33,14,19,0,0,0,5,2,3,2,0,2,1,0,1,0,0,0,23,10,13,0,0,0,2,2,0,0,0,0
139940,21042,210,42,-2,52,23,29,0,0,0,6,2,4,14,4,10,2,0,2,0,0,0,24,12,12,0,0,0,1,1,0,5,4,1
139959,21042,210,42,-2,35,20,15,0,0,0,3,3,0,3,2,1,2,1,1,0,0,0,17,9,8,1,1,0,1,0,1,8,4,4
139968,21042,210,42,-2,1,0,1,0,0,0,0,0,0,0,0,0,0,0,0,0,0,0,1,0,1,0,0,0,0,0,0,0,0,0
140243,21042,210,42,-2,13,2,11,0,0,0,2,0,2,1,0,1,1,1,0,0,0,0,9,1,8,0,0,0,0,0,0,0,0,0
140252,21042,210,42,-2,4,2,2,0,0,0,0,0,0,0,0,0,0,0,0,0,0,0,4,2,2,0,0,0,0,0,0,0,0,0
140331,21042,210,42,-2,18,7,11,0,0,0,0,0,0,4,0,4,1,0,1,0,0,0,13,7,6,0,0,0,0,0,0,0,0,0
140447,21042,210,42,-2,24,9,15,0,0,0,4,2,2,6,0,6,1,0,1,0,0,0,12,6,6,0,0,0,0,0,0,1,1,0
140562,21042,210,42,-2,19,6,13,0,0,0,3,1,2,13,4,9,0,0,0,0,0,0,2,1,1,1,0,1,0,0,0,0,0,0
140678,21042,210,42,-2,10,6,4,0,0,0,0,0,0,0,0,0,0,0,0,0,0,0,10,6,4,0,0,0,0,0,0,0,0,0
140696,21042,210,42,-2,13,8,5,0,0,0,1,1,0,3,2,1,0,0,0,0,0,0,8,4,4,1,1,0,0,0,0,0,0,0
140720,21042,210,42,-2,2,1,1,0,0,0,0,0,0,2,1,1,0,0,0,0,0,0,0,0,0,0,0,0,0,0,0,0,0,0
140818,21042,210,42,-2,13,5,8,0,0,0,0,0,0,1,0,1,0,0,0,0,0,0,11,4,7,1,1,0,0,0,0,0,0,0
140872,21042,210,42,-2,5,3,2,0,0,0,0,0,0,1,0,1,0,0,0,0,0,0,4,3,1,0,0,0,0,0,0,0,0,0
140951,21042,210,42,-2,78,39,39,0,0,0,4,2,2,10,2,8,2,2,0,0,0,0,47,24,23,4,2,2,6,3,3,5,4,1
140960,21042,210,42,-2,1,0,1,0,0,0,0,0,0,0,0,0,0,0,0,0,0,0,1,0,1,0,0,0,0,0,0,0,0,0
141006,21042,210,42,-2,4,3,1,0,0,0,0,0,0,1,1,0,0,0,0,0,0,0,3,2,1,0,0,0,0,0,0,0,0,0
141060,21042,210,42,-2,12,7,5,0,0,0,3,1,2,6,3,3,1,1,0,0,0,0,2,2,0,0,0,0,0,0,0,0,0,0
141185,21042,210,42,-2,2,2,0,0,0,0,0,0,0,0,0,0,0,0,0,0,0,0,2,2,0,0,0,0,0,0,0,0,0,0
141237,21042,210,42,-2,3,1,2,0,0,0,0,0,0,0,0,0,0,0,0,0,0,0,3,1,2,0,0,0,0,0,0,0,0,0
141264,21042,210,42,-2,10,2,8,0,0,0,0,0,0,2,0,2,0,0,0,0,0,0,8,2,6,0,0,0,0,0,0,0,0,0
141325,21042,210,42,-2,1,1,0,0,0,0,0,0,0,1,1,0,0,0,0,0,0,0,0,0,0,0,0,0,0,0,0,0,0,0
141334,21042,210,42,-2,13,4,9,0,0,0,0,0,0,4,1,3,0,0,0,0,0,0,8,2,6,0,0,0,1,1,0,0,0,0
141361,21042,210,42,-2,3,2,1,0,0,0,0,0,0,0,0,0,0,0,0,0,0,0,1,1,0,0,0,0,2,1,1,0,0,0
141486,21042,210,42,-2,8,1,7,0,0,0,1,0,1,0,0,0,1,0,1,1,1,0,3,0,3,2,0,2,0,0,0,0,0,0
141574,21042,210,42,-2,6,4,2,0,0,0,1,1,0,0,0,0,0,0,0,0,0,0,4,3,1,1,0,1,0,0,0,0,0,0
141644,21042,210,42,-2,6,1,5,0,0,0,2,0,2,0,0,0,1,0,1,2,1,1,1,0,1,0,0,0,0,0,0,0,0,0
141811,21042,210,42,-2,1,0,1,0,0,0,0,0,0,0,0,0,0,0,0,0,0,0,1,0,1,0,0,0,0,0,0,0,0,0
142115,21042,210,42,-2,40,13,27,0,0,0,1,0,1,0,0,0,3,2,1,0,0,0,29,7,22,2,0,2,1,0,1,4,4,0
142179,21042,210,42,-2,4,2,2,0,0,0,0,0,0,0,0,0,0,0,0,0,0,0,4,2,2,0,0,0,0,0,0,0,0,0
142276,21042,210,42,-2,11,6,5,0,0,0,1,1,0,0,0,0,0,0,0,0,0,0,9,4,5,0,0,0,1,1,0,0,0,0
142285,21042,210,42,-2,5,3,2,0,0,0,0,0,0,0,0,0,0,0,0,0,0,0,4,3,1,0,0,0,0,0,0,1,0,1
142294,21042,210,42,-2,2,2,0,0,0,0,0,0,0,0,0,0,0,0,0,0,0,0,2,2,0,0,0,0,0,0,0,0,0,0
142328,21042,210,42,-2,4,0,4,0,0,0,0,0,0,0,0,0,0,0,0,0,0,0,4,0,4,0,0,0,0,0,0,0,0,0
142443,21042,210,42,-2,4,2,2,0,0,0,0,0,0,0,0,0,0,0,0,0,0,0,3,2,1,1,0,1,0,0,0,0,0,0
142559,21042,210,42,-2,17,6,11,0,0,0,0,0,0,0,0,0,1,0,1,0,0,0,13,4,9,1,1,0,2,1,1,0,0,0
142832,21042,210,42,-2,4,0,4,0,0,0,0,0,0,3,0,3,0,0,0,0,0,0,1,0,1,0,0,0,0,0,0,0,0,0
143084,21042,210,42,-2,7,2,5,0,0,0,0,0,0,2,1,1,0,0,0,0,0,0,5,1,4,0,0,0,0,0,0,0,0,0
143118,21042,210,42,-2,16,3,13,0,0,0,0,0,0,2,0,2,1,0,1,0,0,0,13,3,10,0,0,0,0,0,0,0,0,0
143279,21042,210,42,-2,2,1,1,0,0,0,0,0,0,0,0,0,0,0,0,0,0,0,1,0,1,0,0,0,1,1,0,0,0,0
143297,21042,210,42,-2,1,0,1,0,0,0,0,0,0,0,0,0,0,0,0,0,0,0,1,0,1,0,0,0,0,0,0,0,0,0
143358,21042,210,42,-2,18,7,11,0,0,0,2,1,1,1,0,1,0,0,0,0,0,0,14,5,9,1,1,0,0,0,0,0,0,0
144005,21042,210,42,-2,3,2,1,0,0,0,0,0,0,1,1,0,0,0,0,0,0,0,0,0,0,0,0,0,2,1,1,0,0,0
144050,21042,210,42,-2,32,18,14,0,0,0,2,0,2,1,0,1,2,1,1,0,0,0,14,7,7,0,0,0,1,1,0,12,9,3
144281,21042,210,42,-2,3,1,2,0,0,0,0,0,0,0,0,0,0,0,0,0,0,0,3,1,2,0,0,0,0,0,0,0,0,0
144351,21042,210,42,-2,4,1,3,0,0,0,0,0,0,0,0,0,0,0,0,0,0,0,4,1,3,0,0,0,0,0,0,0,0,0
144740,21042,210,42,-2,16,9,7,0,0,0,2,1,1,3,1,2,1,1,0,0,0,0,6,3,3,0,0,0,3,3,0,1,0,1
144865,21042,210,42,-2,5,2,3,0,0,0,0,0,0,0,0,0,1,1,0,0,0,0,4,1,3,0,0,0,0,0,0,0,0,0
144892,21042,210,42,-2,14,5,9,0,0,0,0,0,0,0,0,0,0,0,0,0,0,0,6,1,5,0,0,0,7,3,4,1,1,0
144962,21042,210,42,-2,4,1,3,0,0,0,0,0,0,1,1,0,0,0,0,0,0,0,2,0,2,0,0,0,1,0,1,0,0,0
145336,21042,210,42,-2,8,5,3,0,0,0,2,2,0,1,0,1,0,0,0,0,0,0,5,3,2,0,0,0,0,0,0,0,0,0
145558,21042,210,42,-2,2,0,2,0,0,0,2,0,2,0,0,0,0,0,0,0,0,0,0,0,0,0,0,0,0,0,0,0,0,0
145600,21042,210,42,-2,67,26,41,0,0,0,16,7,9,6,3,3,5,1,4,0,0,0,30,10,20,2,0,2,1,1,0,7,4,3
145619,21042,210,42,-2,1,0,1,0,0,0,0,0,0,0,0,0,0,0,0,0,0,0,1,0,1,0,0,0,0,0,0,0,0,0
145637,21042,210,42,-2,47,21,26,2,2,0,3,2,1,4,1,3,5,4,1,0,0,0,26,10,16,1,0,1,2,1,1,4,1,3
145682,21042,210,42,-2,1,0,1,0,0,0,0,0,0,0,0,0,0,0,0,0,0,0,1,0,1,0,0,0,0,0,0,0,0,0
145725,21042,210,42,-2,11,9,2,0,0,0,1,1,0,1,1,0,0,0,0,0,0,0,2,2,0,0,0,0,6,4,2,1,1,0
145813,21042,210,42,-2,12,1,11,0,0,0,0,0,0,0,0,0,1,0,1,0,0,0,6,1,5,0,0,0,5,0,5,0,0,0
146339,21042,210,42,-2,4,3,1,0,0,0,0,0,0,0,0,0,1,1,0,0,0,0,1,1,0,0,0,0,0,0,0,2,1,1
146427,21042,210,42,-2,2,1,1,0,0,0,0,0,0,0,0,0,0,0,0,0,0,0,1,0,1,0,0,0,0,0,0,1,1,0
146481,21042,210,42,-2,1,0,1,0,0,0,0,0,0,0,0,0,0,0,0,0,0,0,1,0,1,0,0,0,0,0,0,0,0,0
146533,21042,210,42,-2,2,0,2,0,0,0,0,0,0,0,0,0,0,0,0,0,0,0,2,0,2,0,0,0,0,0,0,0,0,0
146612,21042,210,42,-2,9,2,7,0,0,0,0,0,0,0,0,0,0,0,0,0,0,0,9,2,7,0,0,0,0,0,0,0,0,0
146667,21042,210,42,-2,1,1,0,0,0,0,0,0,0,0,0,0,0,0,0,0,0,0,1,1,0,0,0,0,0,0,0,0,0,0
146676,21042,210,42,-2,2,2,0,0,0,0,0,0,0,0,0,0,0,0,0,0,0,0,2,2,0,0,0,0,0,0,0,0,0,0
146719,21042,210,42,-2,35,17,18,0,0,0,1,1,0,5,2,3,3,1,2,0,0,0,25,13,12,0,0,0,1,0,1,0,0,0
146755,21042,210,42,-2,5,1,4,0,0,0,0,0,0,0,0,0,0,0,0,0,0,0,5,1,4,0,0,0,0,0,0,0,0,0
146816,21042,210,42,-2,1,1,0,0,0,0,0,0,0,0,0,0,0,0,0,0,0,0,1,1,0,0,0,0,0,0,0,0,0,0
147004,21042,210,42,-2,1,0,1,0,0,0,0,0,0,0,0,0,0,0,0,0,0,0,1,0,1,0,0,0,0,0,0,0,0,0
147013,21042,210,42,-2,2,1,1,0,0,0,0,0,0,0,0,0,0,0,0,0,0,0,2,1,1,0,0,0,0,0,0,0,0,0
147129,21042,210,42,-2,2,0,2,0,0,0,0,0,0,0,0,0,0,0,0,0,0,0,2,0,2,0,0,0,0,0,0,0,0,0
147244,21042,210,42,-2,3,2,1,0,0,0,0,0,0,0,0,0,0,0,0,0,0,0,3,2,1,0,0,0,0,0,0,0,0,0
147369,21042,210,42,-2,2,1,1,0,0,0,0,0,0,0,0,0,0,0,0,0,0,0,2,1,1,0,0,0,0,0,0,0,0,0
147411,21042,210,42,-2,1,0,1,0,0,0,0,0,0,0,0,0,0,0,0,0,0,0,1,0,1,0,0,0,0,0,0,0,0,0
147536,21042,210,42,-2,24,2,22,0,0,0,0,0,0,6,1,5,4,0,4,0,0,0,10,1,9,1,0,1,0,0,0,3,0,3
147660,21042,210,42,-2,5,0,5,0,0,0,0,0,0,0,0,0,0,0,0,0,0,0,3,0,3,0,0,0,1,0,1,1,0,1
147679,21042,210,42,-2,2,1,1,0,0,0,2,1,1,0,0,0,0,0,0,0,0,0,0,0,0,0,0,0,0,0,0,0,0,0
147703,21042,210,42,-2,3,1,2,0,0,0,0,0,0,1,0,1,0,0,0,0,0,0,1,1,0,0,0,0,0,0,0,1,0,1
147767,21042,210,42,-2,2,0,2,0,0,0,0,0,0,0,0,0,0,0,0,0,0,0,0,0,0,0,0,0,0,0,0,2,0,2
147828,21042,210,42,-2,6,3,3,0,0,0,0,0,0,0,0,0,0,0,0,0,0,0,6,3,3,0,0,0,0,0,0,0,0,0
147916,21042,210,42,-2,4,3,1,0,0,0,0,0,0,1,1,0,0,0,0,0,0,0,2,1,1,0,0,0,1,1,0,0,0,0
148016,21042,210,42,-2,4,2,2,0,0,0,0,0,0,0,0,0,0,0,0,0,0,0,2,0,2,0,0,0,2,2,0,0,0,0
148131,21042,210,42,-2,1,1,0,0,0,0,0,0,0,0,0,0,0,0,0,0,0,0,1,1,0,0,0,0,0,0,0,0,0,0
148487,21042,210,42,-2,5,2,3,0,0,0,0,0,0,0,0,0,0,0,0,0,0,0,1,1,0,0,0,0,4,1,3,0,0,0
148496,21042,210,42,-2,4,1,3,0,0,0,1,1,0,2,0,2,0,0,0,0,0,0,1,0,1,0,0,0,0,0,0,0,0,0
148511,21042,210,42,-2,7,2,5,0,0,0,0,0,0,0,0,0,1,0,1,0,0,0,5,2,3,1,0,1,0,0,0,0,0,0
148584,21042,210,42,-2,1,0,1,0,0,0,0,0,0,0,0,0,0,0,0,0,0,0,1,0,1,0,0,0,0,0,0,0,0,0
148593,21042,210,42,-2,2,0,2,0,0,0,0,0,0,0,0,0,0,0,0,0,0,0,2,0,2,0,0,0,0,0,0,0,0,0
148627,21042,210,42,-2,8,1,7,0,0,0,1,0,1,0,0,0,0,0,0,0,0,0,2,0,2,0,0,0,5,1,4,0,0,0
148654,21042,210,42,-2,2,1,1,0,0,0,0,0,0,0,0,0,0,0,0,0,0,0,2,1,1,0,0,0,0,0,0,0,0,0
148982,21042,210,42,-2,1,1,0,0,0,0,0,0,0,0,0,0,0,0,0,0,0,0,1,1,0,0,0,0,0,0,0,0,0,0
149222,21042,210,42,-2,6,2,4,0,0,0,3,2,1,0,0,0,0,0,0,0,0,0,3,0,3,0,0,0,0,0,0,0,0,0
149329,21042,210,42,-2,1,1,0,0,0,0,0,0,0,0,0,0,0,0,0,0,0,0,1,1,0,0,0,0,0,0,0,0,0,0
149365,21042,210,42,-2,2,1,1,0,0,0,0,0,0,1,0,1,0,0,0,0,0,0,0,0,0,0,0,0,1,1,0,0,0,0
149505,21042,210,42,-2,2,0,2,0,0,0,0,0,0,0,0,0,0,0,0,0,0,0,2,0,2,0,0,0,0,0,0,0,0,0
149781,21042,210,42,-2,6,3,3,0,0,0,1,0,1,0,0,0,0,0,0,0,0,0,4,3,1,0,0,0,0,0,0,1,0,1
150066,21042,210,42,-2,5,1,4,0,0,0,0,0,0,0,0,0,0,0,0,0,0,0,5,1,4,0,0,0,0,0,0,0,0,0
150172,21042,210,42,-2,4,2,2,0,0,0,0,0,0,0,0,0,1,0,1,0,0,0,3,2,1,0,0,0,0,0,0,0,0,0
150400,21042,210,42,-2,8,4,4,0,0,0,3,1,2,0,0,0,1,1,0,0,0,0,4,2,2,0,0,0,0,0,0,0,0,0
150455,21042,210,42,-2,11,7,4,0,0,0,1,1,0,4,3,1,1,1,0,0,0,0,3,2,1,0,0,0,0,0,0,2,0,2
150534,21042,210,42,-2,14,6,8,0,0,0,0,0,0,0,0,0,0,0,0,0,0,0,4,2,2,0,0,0,10,4,6,0,0,0
150604,21042,210,42,-2,4,2,2,0,0,0,0,0,0,0,0,0,0,0,0,0,0,0,4,2,2,0,0,0,0,0,0,0,0,0
150668,21042,210,42,-2,3,0,3,0,0,0,0,0,0,1,0,1,0,0,0,0,0,0,2,0,2,0,0,0,0,0,0,0,0,0
150677,21042,210,42,-2,2,1,1,0,0,0,0,0,0,0,0,0,0,0,0,0,0,0,1,1,0,0,0,0,1,0,1,0,0,0
150756,21042,210,42,-2,7,5,2,0,0,0,0,0,0,2,2,0,0,0,0,0,0,0,5,3,2,0,0,0,0,0,0,0,0,0
150774,21042,210,42,-2,1,0,1,0,0,0,0,0,0,1,0,1,0,0,0,0,0,0,0,0,0,0,0,0,0,0,0,0,0,0
150987,21042,210,42,-2,51,19,32,0,0,0,1,0,1,5,0,5,1,1,0,0,0,0,44,18,26,0,0,0,0,0,0,0,0,0
151111,21042,210,42,-2,29,8,21,0,0,0,4,1,3,2,0,2,0,0,0,0,0,0,20,6,14,0,0,0,0,0,0,3,1,2
151263,21042,210,42,-2,9,4,5,0,0,0,0,0,0,1,1,0,0,0,0,0,0,0,8,3,5,0,0,0,0,0,0,0,0,0
151306,21042,210,42,-2,6,0,6,0,0,0,0,0,0,0,0,0,0,0,0,0,0,0,5,0,5,0,0,0,0,0,0,1,0,1
151324,21042,210,42,-2,3,2,1,0,0,0,0,0,0,1,0,1,1,1,0,0,0,0,1,1,0,0,0,0,0,0,0,0,0,0
151333,21042,210,42,-2,1,0,1,0,0,0,0,0,0,0,0,0,0,0,0,0,0,0,1,0,1,0,0,0,0,0,0,0,0,0
151342,21042,210,42,-2,14,6,8,0,0,0,0,0,0,2,0,2,0,0,0,0,0,0,12,6,6,0,0,0,0,0,0,0,0,0
151351,21042,210,42,-2,58,24,34,0,0,0,7,3,4,2,0,2,4,2,2,0,0,0,32,14,18,1,0,1,0,0,0,12,5,7
151360,21042,210,42,-2,4,1,3,0,0,0,0,0,0,3,0,3,0,0,0,0,0,0,1,1,0,0,0,0,0,0,0,0,0,0
151388,21042,210,42,-2,1,0,1,0,0,0,0,0,0,0,0,0,0,0,0,0,0,0,1,0,1,0,0,0,0,0,0,0,0,0
151777,21042,210,42,-2,8,2,6,0,0,0,0,0,0,0,0,0,0,0,0,0,0,0,7,1,6,0,0,0,1,1,0,0,0,0
151786,21042,210,42,-2,47,17,30,0,0,0,0,0,0,3,0,3,5,3,2,0,0,0,39,14,25,0,0,0,0,0,0,0,0,0
151801,21042,210,42,-2,3,1,2,0,0,0,0,0,0,0,0,0,0,0,0,0,0,0,2,0,2,0,0,0,1,1,0,0,0,0
152080,21042,210,42,-2,9,3,6,0,0,0,0,0,0,1,0,1,0,0,0,0,0,0,5,2,3,1,0,1,1,0,1,1,1,0
152099,21042,210,42,-2,5,2,3,0,0,0,2,0,2,0,0,0,0,0,0,0,0,0,2,1,1,0,0,0,1,1,0,0,0,0
152318,21042,210,42,-2,6,4,2,0,0,0,0,0,0,0,0,0,0,0,0,0,0,0,3,3,0,0,0,0,0,0,0,3,1,2
152336,21042,210,42,-2,8,1,7,0,0,0,0,0,0,0,0,0,0,0,0,0,0,0,8,1,7,0,0,0,0,0,0,0,0,0
152381,21042,210,42,-2,2,1,1,0,0,0,0,0,0,0,0,0,0,0,0,0,0,0,2,1,1,0,0,0,0,0,0,0,0,0
152390,21042,210,42,-2,6,2,4,0,0,0,0,0,0,0,0,0,0,0,0,0,0,0,5,2,3,0,0,0,0,0,0,1,0,1
152530,21042,210,42,-2,2,1,1,0,0,0,0,0,0,0,0,0,0,0,0,0,0,0,1,0,1,0,0,0,0,0,0,1,1,0
152567,21042,210,42,-2,8,4,4,0,0,0,0,0,0,0,0,0,0,0,0,0,0,0,8,4,4,0,0,0,0,0,0,0,0,0
152600,21042,210,42,-2,4,1,3,0,0,0,0,0,0,0,0,0,0,0,0,0,0,0,4,1,3,0,0,0,0,0,0,0,0,0
152637,21042,210,42,-2,11,6,5,0,0,0,0,0,0,0,0,0,0,0,0,0,0,0,11,6,5,0,0,0,0,0,0,0,0,0
152798,21042,210,42,-2,5,2,3,0,0,0,0,0,0,0,0,0,0,0,0,0,0,0,5,2,3,0,0,0,0,0,0,0,0,0
153001,21042,210,42,-2,3,3,0,0,0,0,0,0,0,0,0,0,1,1,0,0,0,0,2,2,0,0,0,0,0,0,0,0,0,0
153126,21042,210,42,-2,1,0,1,0,0,0,0,0,0,1,0,1,0,0,0,0,0,0,0,0,0,0,0,0,0,0,0,0,0,0
153144,21042,210,42,-2,4,2,2,0,0,0,0,0,0,1,1,0,0,0,0,0,0,0,3,1,2,0,0,0,0,0,0,0,0,0
153214,21042,210,42,-2,22,10,12,0,0,0,3,2,1,0,0,0,1,1,0,0,0,0,18,7,11,0,0,0,0,0,0,0,0,0
153241,21042,210,42,-2,2,1,1,0,0,0,0,0,0,0,0,0,0,0,0,0,0,0,2,1,1,0,0,0,0,0,0,0,0,0
153311,21042,210,42,-2,6,2,4,0,0,0,0,0,0,1,0,1,1,0,1,0,0,0,4,2,2,0,0,0,0,0,0,0,0,0
153320,21042,210,42,-2,1,0,1,0,0,0,0,0,0,0,0,0,0,0,0,0,0,0,1,0,1,0,0,0,0,0,0,0,0,0
153375,21042,210,42,-2,4,2,2,0,0,0,1,1,0,0,0,0,0,0,0,0,0,0,3,1,2,0,0,0,0,0,0,0,0,0
153384,21042,210,42,-2,7,2,5,0,0,0,1,0,1,0,0,0,0,0,0,0,0,0,6,2,4,0,0,0,0,0,0,0,0,0
153445,21042,210,42,-2,5,1,4,0,0,0,0,0,0,0,0,0,0,0,0,0,0,0,4,1,3,1,0,1,0,0,0,0,0,0
153472,21042,210,42,-2,4,2,2,0,0,0,0,0,0,0,0,0,0,0,0,0,0,0,4,2,2,0,0,0,0,0,0,0,0,0
153524,21042,210,42,-2,5,1,4,0,0,0,0,0,0,0,0,0,0,0,0,0,0,0,4,1,3,0,0,0,1,0,1,0,0,0
153533,21042,210,42,-2,7,4,3,0,0,0,0,0,0,1,1,0,0,0,0,0,0,0,6,3,3,0,0,0,0,0,0,0,0,0
153603,21042,210,42,-2,1,0,1,0,0,0,0,0,0,0,0,0,0,0,0,0,0,0,1,0,1,0,0,0,0,0,0,0,0,0
153621,21042,210,42,-2,1,1,0,0,0,0,0,0,0,0,0,0,0,0,0,0,0,0,1,1,0,0,0,0,0,0,0,0,0,0
153630,21042,210,42,-2,15,8,7,0,0,0,1,0,1,2,2,0,2,2,0,0,0,0,9,4,5,0,0,0,1,0,1,0,0,0
153737,21042,210,42,-2,12,4,8,0,0,0,0,0,0,2,1,1,0,0,0,0,0,0,10,3,7,0,0,0,0,0,0,0,0,0
153825,21042,210,42,-2,1,1,0,0,0,0,1,1,0,0,0,0,0,0,0,0,0,0,0,0,0,0,0,0,0,0,0,0,0,0
153834,21042,210,42,-2,1,0,1,0,0,0,1,0,1,0,0,0,0,0,0,0,0,0,0,0,0,0,0,0,0,0,0,0,0,0
154059,21042,210,42,-2,9,5,4,0,0,0,0,0,0,0,0,0,0,0,0,0,0,0,9,5,4,0,0,0,0,0,0,0,0,0
154110,21042,210,42,-2,6,3,3,0,0,0,0,0,0,0,0,0,0,0,0,0,0,0,4,1,3,0,0,0,2,2,0,0,0,0
154129,21042,210,42,-2,2,1,1,0,0,0,1,0,1,1,1,0,0,0,0,0,0,0,0,0,0,0,0,0,0,0,0,0,0,0
154156,21042,210,42,-2,9,4,5,0,0,0,0,0,0,0,0,0,0,0,0,0,0,0,9,4,5,0,0,0,0,0,0,0,0,0
154235,21042,210,42,-2,7,2,5,0,0,0,1,0,1,0,0,0,0,0,0,0,0,0,6,2,4,0,0,0,0,0,0,0,0,0
154350,21042,210,42,-2,4,2,2,0,0,0,1,1,0,0,0,0,0,0,0,0,0,0,3,1,2,0,0,0,0,0,0,0,0,0
154396,21042,210,42,-2,5,3,2,0,0,0,0,0,0,1,1,0,0,0,0,0,0,0,4,2,2,0,0,0,0,0,0,0,0,0
154493,21042,210,42,-2,2,2,0,0,0,0,0,0,0,0,0,0,0,0,0,0,0,0,0,0,0,0,0,0,2,2,0,0,0,0
154527,21042,210,42,-2,2,0,2,0,0,0,0,0,0,0,0,0,0,0,0,0,0,0,2,0,2,0,0,0,0,0,0,0,0,0
154572,21042,210,42,-2,3,1,2,0,0,0,0,0,0,0,0,0,0,0,0,0,0,0,3,1,2,0,0,0,0,0,0,0,0,0
154590,21042,210,42,-2,4,1,3,0,0,0,0,0,0,0,0,0,0,0,0,0,0,0,4,1,3,0,0,0,0,0,0,0,0,0
154688,21042,210,42,-2,1,0,1,0,0,0,0,0,0,0,0,0,0,0,0,0,0,0,0,0,0,0,0,0,1,0,1,0,0,0
154712,21042,210,42,-2,1,1,0,0,0,0,0,0,0,0,0,0,0,0,0,0,0,0,1,1,0,0,0,0,0,0,0,0,0,0
154749,21042,210,42,-2,3,0,3,0,0,0,0,0,0,0,0,0,0,0,0,0,0,0,3,0,3,0,0,0,0,0,0,0,0,0
154800,21042,210,42,-2,11,9,2,0,0,0,0,0,0,0,0,0,1,1,0,0,0,0,10,8,2,0,0,0,0,0,0,0,0,0
154855,21042,210,42,-2,2,1,1,0,0,0,0,0,0,0,0,0,0,0,0,0,0,0,2,1,1,0,0,0,0,0,0,0,0,0
154934,21042,210,42,-2,4,2,2,0,0,0,0,0,0,0,0,0,0,0,0,0,0,0,4,2,2,0,0,0,0,0,0,0,0,0
155007,21042,210,42,-2,5,2,3,0,0,0,0,0,0,1,0,1,0,0,0,0,0,0,3,1,2,0,0,0,1,1,0,0,0,0
155025,21042,210,42,-2,7,2,5,0,0,0,1,1,0,1,0,1,0,0,0,0,0,0,5,1,4,0,0,0,0,0,0,0,0,0
155052,21042,210,42,-2,3,1,2,0,0,0,0,0,0,0,0,0,0,0,0,0,0,0,3,1,2,0,0,0,0,0,0,0,0,0
155061,21042,210,42,-2,20,12,8,0,0,0,3,1,2,1,1,0,0,0,0,0,0,0,12,8,4,2,1,1,1,1,0,1,0,1
155089,21042,210,42,-2,2,1,1,1,0,1,0,0,0,1,1,0,0,0,0,0,0,0,0,0,0,0,0,0,0,0,0,0,0,0
155177,21042,210,42,-2,4,3,1,0,0,0,0,0,0,0,0,0,0,0,0,0,0,0,3,2,1,1,1,0,0,0,0,0,0,0
155186,21042,210,42,-2,8,1,7,0,0,0,0,0,0,0,0,0,0,0,0,0,0,0,8,1,7,0,0,0,0,0,0,0,0,0
155210,21042,210,42,-2,15,7,8,0,0,0,0,0,0,0,0,0,0,0,0,0,0,0,12,5,7,1,0,1,2,2,0,0,0,0
155308,21042,210,42,-2,1,0,1,0,0,0,0,0,0,0,0,0,0,0,0,0,0,0,1,0,1,0,0,0,0,0,0,0,0,0
155317,21042,210,42,-2,54,22,32,0,0,0,6,4,2,3,2,1,1,0,1,0,0,0,39,14,25,2,0,2,1,0,1,2,2,0
155399,21042,210,42,-2,19,5,14,0,0,0,3,1,2,1,0,1,0,0,0,0,0,0,14,4,10,0,0,0,0,0,0,1,0,1
155414,21042,210,42,-2,6,1,5,0,0,0,1,0,1,0,0,0,0,0,0,0,0,0,5,1,4,0,0,0,0,0,0,0,0,0
155487,21042,210,42,-2,1,0,1,0,0,0,0,0,0,0,0,0,0,0,0,0,0,0,0,0,0,0,0,0,1,0,1,0,0,0
155566,21042,210,42,-2,4,4,0,0,0,0,0,0,0,0,0,0,0,0,0,0,0,0,2,2,0,0,0,0,0,0,0,2,2,0
155627,21042,210,42,-2,1,1,0,0,0,0,0,0,0,0,0,0,0,0,0,0,0,0,1,1,0,0,0,0,0,0,0,0,0,0
155681,21042,210,42,-2,2,1,1,1,1,0,1,0,1,0,0,0,0,0,0,0,0,0,0,0,0,0,0,0,0,0,0,0,0,0
155812,21042,210,42,-2,6,1,5,0,0,0,0,0,0,1,0,1,0,0,0,0,0,0,5,1,4,0,0,0,0,0,0,0,0,0
155858,21042,210,42,-2,4,2,2,0,0,0,0,0,0,0,0,0,1,1,0,0,0,0,3,1,2,0,0,0,0,0,0,0,0,0
155973,21042,210,42,-2,4,3,1,0,0,0,0,0,0,0,0,0,0,0,0,0,0,0,4,3,1,0,0,0,0,0,0,0,0,0
156082,21042,210,42,-2,7,2,5,0,0,0,0,0,0,1,0,1,0,0,0,0,0,0,6,2,4,0,0,0,0,0,0,0,0,0
156125,21042,210,42,-2,17,9,8,0,0,0,1,0,1,0,0,0,1,1,0,0,0,0,11,4,7,0,0,0,1,1,0,3,3,0
156213,21042,210,42,-2,1,0,1,0,0,0,0,0,0,0,0,0,0,0,0,0,0,0,1,0,1,0,0,0,0,0,0,0,0,0
156222,21042,210,42,-2,2,1,1,0,0,0,0,0,0,0,0,0,1,0,1,0,0,0,1,1,0,0,0,0,0,0,0,0,0,0
156286,21042,210,42,-2,3,0,3,0,0,0,0,0,0,0,0,0,0,0,0,0,0,0,3,0,3,0,0,0,0,0,0,0,0,0
156295,21042,210,42,-2,2,1,1,0,0,0,0,0,0,0,0,0,0,0,0,0,0,0,2,1,1,0,0,0,0,0,0,0,0,0
156338,21042,210,42,-2,3,0,3,0,0,0,0,0,0,0,0,0,0,0,0,0,0,0,3,0,3,0,0,0,0,0,0,0,0,0
156356,21042,210,42,-2,1,0,1,0,0,0,0,0,0,0,0,0,0,0,0,0,0,0,1,0,1,0,0,0,0,0,0,0,0,0
156365,21042,210,42,-2,3,1,2,0,0,0,0,0,0,0,0,0,0,0,0,0,0,0,3,1,2,0,0,0,0,0,0,0,0,0
156392,21042,210,42,-2,2,2,0,0,0,0,0,0,0,0,0,0,0,0,0,0,0,0,2,2,0,0,0,0,0,0,0,0,0,0
156408,21042,210,42,-2,9,2,7,0,0,0,1,0,1,0,0,0,0,0,0,0,0,0,6,1,5,0,0,0,2,1,1,0,0,0
156541,21042,210,42,-2,22,13,9,0,0,0,0,0,0,6,4,2,0,0,0,0,0,0,16,9,7,0,0,0,0,0,0,0,0,0
156620,21042,210,42,-2,18,8,10,0,0,0,0,0,0,0,0,0,0,0,0,0,0,0,12,7,5,1,0,1,1,0,1,4,1,3
156727,21042,210,42,-2,18,5,13,0,0,0,0,0,0,2,0,2,1,0,1,0,0,0,14,5,9,1,0,1,0,0,0,0,0,0
156745,21042,210,42,-2,3,1,2,0,0,0,0,0,0,0,0,0,0,0,0,0,0,0,3,1,2,0,0,0,0,0,0,0,0,0
157058,21042,210,42,-2,7,3,4,0,0,0,0,0,0,0,0,0,0,0,0,0,0,0,1,0,1,0,0,0,6,3,3,0,0,0
157076,21042,210,42,-2,1,0,1,0,0,0,0,0,0,0,0,0,0,0,0,0,0,0,1,0,1,0,0,0,0,0,0,0,0,0
157085,21042,210,42,-2,8,4,4,0,0,0,0,0,0,1,1,0,0,0,0,0,0,0,6,2,4,0,0,0,0,0,0,1,1,0
157100,21042,210,42,-2,4,1,3,0,0,0,0,0,0,0,0,0,0,0,0,0,0,0,4,1,3,0,0,0,0,0,0,0,0,0
157216,21042,210,42,-2,13,4,9,0,0,0,0,0,0,1,0,1,1,0,1,0,0,0,11,4,7,0,0,0,0,0,0,0,0,0
157289,21042,210,42,-2,43,24,19,0,0,0,3,3,0,3,1,2,3,3,0,0,0,0,32,16,16,0,0,0,0,0,0,2,1,1
157377,21042,210,42,-2,11,4,7,0,0,0,1,1,0,0,0,0,0,0,0,0,0,0,9,3,6,0,0,0,1,0,1,0,0,0
157386,21042,210,42,-2,9,3,6,0,0,0,0,0,0,0,0,0,0,0,0,0,0,0,7,2,5,1,0,1,1,1,0,0,0,0
157447,21042,210,42,-2,21,8,13,0,0,0,0,0,0,3,1,2,0,0,0,0,0,0,15,5,10,0,0,0,0,0,0,3,2,1
157483,21042,210,42,-2,1,1,0,0,0,0,0,0,0,0,0,0,0,0,0,0,0,0,1,1,0,0,0,0,0,0,0,0,0,0
157535,21042,210,42,-2,21,8,13,0,0,0,4,1,3,1,1,0,0,0,0,0,0,0,15,5,10,0,0,0,1,1,0,0,0,0
157711,21042,210,42,-2,1,0,1,0,0,0,0,0,0,0,0,0,0,0,0,0,0,0,1,0,1,0,0,0,0,0,0,0,0,0
157757,21042,210,42,-2,1,0,1,0,0,0,0,0,0,1,0,1,0,0,0,0,0,0,0,0,0,0,0,0,0,0,0,0,0,0
157809,21042,210,42,-2,7,3,4,0,0,0,1,1,0,0,0,0,0,0,0,0,0,0,6,2,4,0,0,0,0,0,0,0,0,0
157818,21042,210,42,-2,2,1,1,0,0,0,0,0,0,0,0,0,0,0,0,0,0,0,2,1,1,0,0,0,0,0,0,0,0,0
157951,21042,210,42,-2,20,8,12,0,0,0,1,0,1,0,0,0,1,0,1,0,0,0,17,8,9,0,0,0,1,0,1,0,0,0
158088,21042,210,42,-2,14,5,9,0,0,0,0,0,0,3,1,2,0,0,0,0,0,0,5,2,3,0,0,0,6,2,4,0,0,0
158431,21042,210,42,-2,15,3,12,0,0,0,0,0,0,0,0,0,1,0,1,0,0,0,14,3,11,0,0,0,0,0,0,0,0,0
158477,21042,210,42,-2,1,1,0,0,0,0,1,1,0,0,0,0,0,0,0,0,0,0,0,0,0,0,0,0,0,0,0,0,0,0
158662,21042,210,42,-2,6,1,5,0,0,0,0,0,0,1,1,0,0,0,0,0,0,0,5,0,5,0,0,0,0,0,0,0,0,0
158802,21042,210,42,-2,9,5,4,0,0,0,0,0,0,6,2,4,0,0,0,0,0,0,3,3,0,0,0,0,0,0,0,0,0,0
158884,21042,210,42,-2,5,4,1,0,0,0,1,1,0,2,2,0,0,0,0,0,0,0,2,1,1,0,0,0,0,0,0,0,0,0
159009,21042,210,42,-2,1,0,1,0,0,0,0,0,0,1,0,1,0,0,0,0,0,0,0,0,0,0,0,0,0,0,0,0,0,0
159373,21042,210,42,-2,40,18,22,0,0,0,5,3,2,4,0,4,1,1,0,0,0,0,27,13,14,0,0,0,1,0,1,2,1,1
159391,21042,210,42,-2,56,22,34,0,0,0,1,0,1,7,4,3,6,3,3,0,0,0,36,12,24,2,1,1,1,1,0,3,1,2
159407,21042,210,42,-2,9,3,6,0,0,0,0,0,0,1,1,0,0,0,0,0,0,0,7,2,5,1,0,1,0,0,0,0,0,0
159416,21042,210,42,-2,8,4,4,0,0,0,1,1,0,2,0,2,1,0,1,0,0,0,4,3,1,0,0,0,0,0,0,0,0,0
159647,21042,210,42,-2,10,7,3,0,0,0,2,1,1,0,0,0,0,0,0,0,0,0,8,6,2,0,0,0,0,0,0,0,0,0
159656,21042,210,42,-2,15,5,10,0,0,0,0,0,0,2,1,1,1,1,0,0,0,0,8,3,5,0,0,0,1,0,1,3,0,3
159717,21042,210,42,-2,6,1,5,0,0,0,0,0,0,0,0,0,0,0,0,0,0,0,6,1,5,0,0,0,0,0,0,0,0,0
159939,21042,210,42,-2,8,2,6,0,0,0,1,0,1,1,0,1,0,0,0,0,0,0,5,2,3,1,0,1,0,0,0,0,0,0
159966,21042,210,42,-2,7,0,7,0,0,0,1,0,1,0,0,0,0,0,0,0,0,0,6,0,6,0,0,0,0,0,0,0,0,0
160010,21042,210,42,-2,5,0,5,0,0,0,0,0,0,2,0,2,0,0,0,0,0,0,3,0,3,0,0,0,0,0,0,0,0,0
160038,21042,210,42,-2,2,0,2,0,0,0,0,0,0,0,0,0,0,0,0,0,0,0,1,0,1,0,0,0,1,0,1,0,0,0
160065,21042,210,42,-2,4,1,3,0,0,0,0,0,0,1,0,1,1,1,0,0,0,0,2,0,2,0,0,0,0,0,0,0,0,0
160074,21042,210,42,-2,3,1,2,0,0,0,0,0,0,0,0,0,0,0,0,0,0,0,3,1,2,0,0,0,0,0,0,0,0,0
160481,21042,210,42,-2,6,3,3,0,0,0,0,0,0,0,0,0,0,0,0,0,0,0,6,3,3,0,0,0,0,0,0,0,0,0
160579,21042,210,42,-2,8,0,8,0,0,0,0,0,0,2,0,2,1,0,1,0,0,0,5,0,5,0,0,0,0,0,0,0,0,0
160612,21042,210,42,-2,35,13,22,0,0,0,0,0,0,4,2,2,1,0,1,0,0,0,27,8,19,0,0,0,0,0,0,3,3,0
160621,21042,210,42,-2,6,1,5,0,0,0,0,0,0,4,0,4,0,0,0,0,0,0,2,1,1,0,0,0,0,0,0,0,0,0
160667,21042,210,42,-2,10,4,6,0,0,0,0,0,0,0,0,0,0,0,0,0,0,0,10,4,6,0,0,0,0,0,0,0,0,0
160755,21042,210,42,-2,66,36,30,1,1,0,5,2,3,6,2,4,4,1,3,0,0,0,44,26,18,0,0,0,0,0,0,6,4,2
160904,21042,210,42,-2,5,2,3,0,0,0,0,0,0,4,1,3,0,0,0,0,0,0,0,0,0,0,0,0,0,0,0,1,1,0
161004,21042,210,42,-2,17,9,8,0,0,0,4,2,2,1,1,0,1,1,0,0,0,0,7,4,3,0,0,0,3,1,2,1,0,1
161077,21042,210,42,-2,8,5,3,0,0,0,0,0,0,0,0,0,0,0,0,0,0,0,7,4,3,0,0,0,1,1,0,0,0,0
161086,21042,210,42,-2,14,9,5,0,0,0,1,0,1,0,0,0,1,1,0,0,0,0,8,5,3,0,0,0,1,1,0,3,2,1
161138,21042,210,42,-2,6,4,2,0,0,0,0,0,0,0,0,0,0,0,0,0,0,0,6,4,2,0,0,0,0,0,0,0,0,0
161192,21042,210,42,-2,10,4,6,0,0,0,0,0,0,0,0,0,0,0,0,0,0,0,10,4,6,0,0,0,0,0,0,0,0,0
161208,21042,210,42,-2,1,1,0,0,0,0,0,0,0,0,0,0,0,0,0,0,0,0,1,1,0,0,0,0,0,0,0,0,0,0
161226,21042,210,42,-2,1,0,1,0,0,0,0,0,0,0,0,0,0,0,0,0,0,0,1,0,1,0,0,0,0,0,0,0,0,0
161235,21042,210,42,-2,2,1,1,0,0,0,0,0,0,0,0,0,0,0,0,0,0,0,2,1,1,0,0,0,0,0,0,0,0,0
161253,21042,210,42,-2,4,2,2,0,0,0,2,2,0,0,0,0,0,0,0,0,0,0,1,0,1,1,0,1,0,0,0,0,0,0
161299,21042,210,42,-2,2,2,0,0,0,0,0,0,0,0,0,0,0,0,0,0,0,0,2,2,0,0,0,0,0,0,0,0,0,0
161457,21042,210,42,-2,23,10,13,0,0,0,0,0,0,0,0,0,0,0,0,0,0,0,20,9,11,0,0,0,1,0,1,2,1,1
161484,21042,210,42,-2,3,3,0,0,0,0,0,0,0,0,0,0,0,0,0,0,0,0,3,3,0,0,0,0,0,0,0,0,0,0
161509,21042,210,42,-2,1,1,0,0,0,0,0,0,0,0,0,0,0,0,0,0,0,0,1,1,0,0,0,0,0,0,0,0,0,0
161518,21042,210,42,-2,1,0,1,0,0,0,0,0,0,0,0,0,0,0,0,0,0,0,1,0,1,0,0,0,0,0,0,0,0,0
161545,21042,210,42,-2,8,5,3,0,0,0,0,0,0,0,0,0,0,0,0,0,0,0,8,5,3,0,0,0,0,0,0,0,0,0
161554,21042,210,42,-2,5,1,4,0,0,0,1,1,0,0,0,0,0,0,0,0,0,0,4,0,4,0,0,0,0,0,0,0,0,0
161563,21042,210,42,-2,2,1,1,0,0,0,0,0,0,0,0,0,0,0,0,0,0,0,2,1,1,0,0,0,0,0,0,0,0,0
161873,21042,210,42,-2,3,2,1,0,0,0,1,1,0,1,0,1,0,0,0,0,0,0,1,1,0,0,0,0,0,0,0,0,0,0
162007,21042,210,42,-2,5,2,3,0,0,0,0,0,0,4,2,2,1,0,1,0,0,0,0,0,0,0,0,0,0,0,0,0,0,0
162061,21042,210,42,-2,1,1,0,0,0,0,0,0,0,1,1,0,0,0,0,0,0,0,0,0,0,0,0,0,0,0,0,0,0,0
162122,21042,210,42,-2,4,3,1,0,0,0,0,0,0,0,0,0,0,0,0,0,0,0,4,3,1,0,0,0,0,0,0,0,0,0
162168,21042,210,42,-2,1,1,0,0,0,0,0,0,0,0,0,0,0,0,0,0,0,0,0,0,0,0,0,0,1,1,0,0,0,0
162210,21042,210,42,-2,1,0,1,0,0,0,0,0,0,0,0,0,0,0,0,0,0,0,1,0,1,0,0,0,0,0,0,0,0,0
162283,21042,210,42,-2,3,1,2,0,0,0,0,0,0,3,1,2,0,0,0,0,0,0,0,0,0,0,0,0,0,0,0,0,0,0
162760,21042,210,42,-2,2,1,1,0,0,0,1,0,1,0,0,0,0,0,0,0,0,0,1,1,0,0,0,0,0,0,0,0,0,0
162928,21042,210,42,-2,99,52,47,0,0,0,22,10,12,7,5,2,6,3,3,0,0,0,53,29,24,2,1,1,0,0,0,9,4,5
163046,21042,210,42,-2,18,9,9,0,0,0,2,0,2,1,0,1,2,1,1,0,0,0,13,8,5,0,0,0,0,0,0,0,0,0
163204,21042,210,42,-2,10,4,6,0,0,0,1,0,1,0,0,0,0,0,0,0,0,0,4,2,2,0,0,0,5,2,3,0,0,0
163259,21042,210,42,-2,156,71,85,0,0,0,36,20,16,13,6,7,12,3,9,0,0,0,73,30,43,1,0,1,1,1,0,20,11,9
163268,21042,210,42,-2,7,4,3,0,0,0,1,0,1,0,0,0,0,0,0,0,0,0,5,4,1,0,0,0,1,0,1,0,0,0
163286,21042,210,42,-2,43,18,25,0,0,0,4,3,1,2,0,2,6,1,5,0,0,0,18,9,9,0,0,0,8,3,5,5,2,3
163338,21042,210,42,-2,2,1,1,0,0,0,0,0,0,1,1,0,0,0,0,0,0,0,1,0,1,0,0,0,0,0,0,0,0,0
163426,21042,210,42,-2,27,10,17,0,0,0,2,1,1,12,4,8,2,2,0,0,0,0,7,3,4,0,0,0,1,0,1,3,0,3
163462,21042,210,42,-2,1,1,0,0,0,0,0,0,0,1,1,0,0,0,0,0,0,0,0,0,0,0,0,0,0,0,0,0,0,0
163578,21042,210,42,-2,7,2,5,0,0,0,0,0,0,1,0,1,0,0,0,0,0,0,6,2,4,0,0,0,0,0,0,0,0,0
163657,21042,210,42,-2,4,2,2,0,0,0,0,0,0,1,0,1,0,0,0,0,0,0,3,2,1,0,0,0,0,0,0,0,0,0
164076,21042,210,42,-2,20,8,12,0,0,0,2,1,1,1,0,1,2,1,1,0,0,0,13,5,8,1,0,1,1,1,0,0,0,0
164173,21042,210,42,-2,5,3,2,0,0,0,0,0,0,2,1,1,0,0,0,0,0,0,3,2,1,0,0,0,0,0,0,0,0,0
164270,21042,210,42,-2,14,5,9,0,0,0,1,0,1,1,0,1,2,1,1,0,0,0,10,4,6,0,0,0,0,0,0,0,0,0
164313,21042,210,42,-2,2,1,1,0,0,0,2,1,1,0,0,0,0,0,0,0,0,0,0,0,0,0,0,0,0,0,0,0,0,0
164447,21042,210,42,-2,2,0,2,0,0,0,0,0,0,0,0,0,0,0,0,0,0,0,2,0,2,0,0,0,0,0,0,0,0,0
164465,21042,210,42,-2,9,7,2,0,0,0,0,0,0,2,2,0,1,1,0,0,0,0,3,2,1,0,0,0,0,0,0,3,2,1
164492,21042,210,42,-2,3,0,3,0,0,0,0,0,0,0,0,0,0,0,0,0,0,0,3,0,3,0,0,0,0,0,0,0,0,0
164562,21042,210,42,-2,3,1,2,0,0,0,0,0,0,0,0,0,1,0,1,0,0,0,1,1,0,1,0,1,0,0,0,0,0,0
164632,21042,210,42,-2,1,0,1,0,0,0,0,0,0,0,0,0,0,0,0,0,0,0,1,0,1,0,0,0,0,0,0,0,0,0
164739,21042,210,42,-2,13,7,6,0,0,0,4,2,2,0,0,0,0,0,0,0,0,0,9,5,4,0,0,0,0,0,0,0,0,0
164924,21042,210,42,-2,24,13,11,0,0,0,3,1,2,1,1,0,2,2,0,0,0,0,18,9,9,0,0,0,0,0,0,0,0,0
164988,21042,210,42,-2,35,15,20,0,0,0,5,2,3,3,0,3,3,1,2,0,0,0,12,5,7,0,0,0,3,0,3,9,7,2
165015,21042,210,42,-2,6,5,1,0,0,0,0,0,0,1,0,1,0,0,0,0,0,0,5,5,0,0,0,0,0,0,0,0,0,0
165024,21042,210,42,-2,8,1,7,0,0,0,1,1,0,1,0,1,0,0,0,0,0,0,5,0,5,0,0,0,1,0,1,0,0,0
165264,21042,210,42,-2,1,0,1,0,0,0,0,0,0,0,0,0,0,0,0,0,0,0,1,0,1,0,0,0,0,0,0,0,0,0
165334,21042,210,42,-2,12,6,6,0,0,0,0,0,0,1,0,1,0,0,0,0,0,0,4,2,2,2,0,2,0,0,0,5,4,1
165529,21042,210,42,-2,5,2,3,0,0,0,0,0,0,2,0,2,0,0,0,0,0,0,2,1,1,0,0,0,1,1,0,0,0,0
165574,21042,210,42,-2,2,1,1,0,0,0,0,0,0,0,0,0,0,0,0,0,0,0,2,1,1,0,0,0,0,0,0,0,0,0
165644,21042,210,42,-2,4,3,1,0,0,0,1,1,0,0,0,0,0,0,0,0,0,0,1,0,1,0,0,0,2,2,0,0,0,0
165662,21042,210,42,-2,3,1,2,0,0,0,1,0,1,1,1,0,0,0,0,0,0,0,1,0,1,0,0,0,0,0,0,0,0,0
165671,21042,210,42,-2,3,1,2,0,0,0,0,0,0,0,0,0,0,0,0,0,0,0,3,1,2,0,0,0,0,0,0,0,0,0
165802,21042,210,42,-2,3,1,2,0,0,0,1,0,1,0,0,0,0,0,0,0,0,0,2,1,1,0,0,0,0,0,0,0,0,0
165820,21042,210,42,-2,1,0,1,0,0,0,0,0,0,0,0,0,0,0,0,0,0,0,1,0,1,0,0,0,0,0,0,0,0,0
165884,21042,210,42,-2,1,1,0,0,0,0,0,0,0,0,0,0,0,0,0,0,0,0,1,1,0,0,0,0,0,0,0,0,0,0
165936,21042,210,42,-2,8,2,6,0,0,0,2,0,2,0,0,0,0,0,0,0,0,0,4,2,2,0,0,0,2,0,2,0,0,0
165945,21042,210,42,-2,1,0,1,0,0,0,0,0,0,0,0,0,0,0,0,0,0,0,1,0,1,0,0,0,0,0,0,0,0,0
166018,21042,210,42,-2,1,1,0,0,0,0,0,0,0,0,0,0,1,1,0,0,0,0,0,0,0,0,0,0,0,0,0,0,0,0
166027,21042,210,42,-2,93,45,48,0,0,0,6,0,6,2,2,0,11,5,6,0,0,0,55,25,30,2,2,0,1,1,0,16,10,6
166124,21042,210,42,-2,20,11,9,0,0,0,2,1,1,0,0,0,3,1,2,0,0,0,10,6,4,1,0,1,2,1,1,2,2,0
166133,21042,210,42,-2,1,0,1,0,0,0,1,0,1,0,0,0,0,0,0,0,0,0,0,0,0,0,0,0,0,0,0,0,0,0
166391,21042,210,42,-2,2,1,1,0,0,0,0,0,0,0,0,0,0,0,0,0,0,0,0,0,0,1,1,0,1,0,1,0,0,0
166452,21042,210,42,-2,3,2,1,0,0,0,0,0,0,0,0,0,0,0,0,0,0,0,3,2,1,0,0,0,0,0,0,0,0,0
166513,21042,210,42,-2,12,6,6,0,0,0,0,0,0,0,0,0,1,0,1,0,0,0,6,3,3,0,0,0,1,1,0,4,2,2
166629,21042,210,42,-2,20,9,11,1,1,0,0,0,0,1,0,1,0,0,0,0,0,0,14,6,8,0,0,0,0,0,0,4,2,2
166638,21042,210,42,-2,3,1,2,0,0,0,0,0,0,1,0,1,0,0,0,0,0,0,2,1,1,0,0,0,0,0,0,0,0,0
166656,21042,210,42,-2,11,1,10,0,0,0,1,1,0,0,0,0,0,0,0,0,0,0,8,0,8,1,0,1,1,0,1,0,0,0
166674,21042,210,42,-2,17,5,12,0,0,0,2,1,1,1,1,0,3,1,2,0,0,0,8,2,6,0,0,0,3,0,3,0,0,0
166850,21042,210,42,-2,13,3,10,0,0,0,0,0,0,2,1,1,0,0,0,0,0,0,8,1,7,2,0,2,1,1,0,0,0,0
166939,21042,210,42,-2,16,5,11,0,0,0,3,1,2,3,1,2,0,0,0,0,0,0,2,1,1,0,0,0,4,1,3,4,1,3
167057,21042,210,42,-2,3,2,1,0,0,0,0,0,0,1,0,1,0,0,0,0,0,0,2,2,0,0,0,0,0,0,0,0,0,0
167093,21042,210,42,-2,2,0,2,0,0,0,0,0,0,0,0,0,0,0,0,0,0,0,1,0,1,0,0,0,1,0,1,0,0,0
167215,21042,210,42,-2,6,1,5,0,0,0,0,0,0,0,0,0,1,0,1,0,0,0,5,1,4,0,0,0,0,0,0,0,0,0
167260,21042,210,42,-2,2,2,0,0,0,0,0,0,0,1,1,0,0,0,0,0,0,0,1,1,0,0,0,0,0,0,0,0,0,0
167288,21042,210,42,-2,3,2,1,0,0,0,0,0,0,0,0,0,0,0,0,0,0,0,3,2,1,0,0,0,0,0,0,0,0,0
167358,21042,210,42,-2,55,36,19,0,0,0,7,4,3,3,2,1,2,1,1,0,0,0,27,17,10,1,1,0,11,7,4,4,4,0
167394,21042,210,42,-2,3,0,3,0,0,0,0,0,0,1,0,1,0,0,0,0,0,0,2,0,2,0,0,0,0,0,0,0,0,0
167598,21042,210,42,-2,9,1,8,0,0,0,0,0,0,5,1,4,2,0,2,0,0,0,2,0,2,0,0,0,0,0,0,0,0,0
167677,21042,210,42,-2,1,1,0,0,0,0,0,0,0,0,0,0,0,0,0,0,0,0,1,1,0,0,0,0,0,0,0,0,0,0
167729,21042,210,42,-2,16,6,10,0,0,0,0,0,0,1,1,0,1,1,0,0,0,0,14,4,10,0,0,0,0,0,0,0,0,0
167783,21042,210,42,-2,15,4,11,0,0,0,1,0,1,4,0,4,0,0,0,0,0,0,9,4,5,0,0,0,0,0,0,1,0,1
167899,21042,210,42,-2,8,4,4,0,0,0,2,2,0,0,0,0,0,0,0,0,0,0,5,2,3,1,0,1,0,0,0,0,0,0
167987,21042,210,42,-2,10,3,7,0,0,0,0,0,0,1,0,1,0,0,0,0,0,0,9,3,6,0,0,0,0,0,0,0,0,0
168005,21042,210,42,-2,2,2,0,0,0,0,0,0,0,0,0,0,0,0,0,0,0,0,2,2,0,0,0,0,0,0,0,0,0,0
168148,21042,210,42,-2,12,4,8,0,0,0,1,0,1,1,1,0,3,1,2,0,0,0,5,1,4,0,0,0,0,0,0,2,1,1
168218,21042,210,42,-2,5,2,3,0,0,0,0,0,0,0,0,0,0,0,0,0,0,0,2,1,1,1,1,0,1,0,1,1,0,1
168227,21042,210,42,-2,4,3,1,0,0,0,1,1,0,0,0,0,0,0,0,0,0,0,3,2,1,0,0,0,0,0,0,0,0,0
168254,21042,210,42,-2,1,0,1,0,0,0,0,0,0,0,0,0,0,0,0,0,0,0,1,0,1,0,0,0,0,0,0,0,0,0
168281,21042,210,42,-2,3,1,2,0,0,0,0,0,0,1,1,0,0,0,0,0,0,0,2,0,2,0,0,0,0,0,0,0,0,0
168342,21042,210,42,-2,11,5,6,0,0,0,1,0,1,2,0,2,1,1,0,0,0,0,3,2,1,0,0,0,0,0,0,4,2,2
168421,21042,210,42,-2,1,0,1,0,0,0,0,0,0,0,0,0,0,0,0,0,0,0,1,0,1,0,0,0,0,0,0,0,0,0
168430,21042,210,42,-2,30,5,25,1,1,0,0,0,0,0,0,0,0,0,0,0,0,0,28,4,24,1,0,1,0,0,0,0,0,0
168528,21042,210,42,-2,2,0,2,0,0,0,0,0,0,0,0,0,0,0,0,0,0,0,2,0,2,0,0,0,0,0,0,0,0,0
168546,21042,210,42,-2,15,6,9,0,0,0,2,0,2,1,1,0,3,1,2,0,0,0,8,3,5,0,0,0,0,0,0,1,1,0
168591,21042,210,42,-2,3,0,3,0,0,0,0,0,0,0,0,0,0,0,0,0,0,0,3,0,3,0,0,0,0,0,0,0,0,0
168740,21042,210,42,-2,6,3,3,0,0,0,0,0,0,2,2,0,1,1,0,0,0,0,2,0,2,0,0,0,0,0,0,1,0,1
168847,21042,210,42,-2,12,4,8,0,0,0,0,0,0,1,0,1,0,0,0,0,0,0,11,4,7,0,0,0,0,0,0,0,0,0
169220,21042,210,42,-2,2,1,1,0,0,0,0,0,0,1,1,0,0,0,0,0,0,0,1,0,1,0,0,0,0,0,0,0,0,0
169248,21042,210,42,-2,9,5,4,0,0,0,1,0,1,0,0,0,0,0,0,0,0,0,7,4,3,0,0,0,0,0,0,1,1,0
169275,21042,210,42,-2,1,1,0,0,0,0,0,0,0,0,0,0,0,0,0,0,0,0,1,1,0,0,0,0,0,0,0,0,0,0
169327,21042,210,42,-2,2,1,1,0,0,0,0,0,0,0,0,0,0,0,0,0,0,0,2,1,1,0,0,0,0,0,0,0,0,0
169363,21042,210,42,-2,2,1,1,0,0,0,0,0,0,0,0,0,0,0,0,0,0,0,2,1,1,0,0,0,0,0,0,0,0,0
169424,21042,210,42,-2,1,1,0,0,0,0,0,0,0,0,0,0,0,0,0,0,0,0,1,1,0,0,0,0,0,0,0,0,0,0
169521,21042,210,42,-2,2,0,2,0,0,0,0,0,0,0,0,0,0,0,0,0,0,0,2,0,2,0,0,0,0,0,0,0,0,0
169716,21042,210,42,-2,16,6,10,0,0,0,0,0,0,0,0,0,1,0,1,0,0,0,4,1,3,0,0,0,2,0,2,9,5,4
169983,21042,210,42,-2,5,2,3,0,0,0,2,0,2,0,0,0,0,0,0,0,0,0,2,2,0,1,0,1,0,0,0,0,0,0
169992,21042,210,42,-2,3,2,1,0,0,0,0,0,0,0,0,0,0,0,0,0,0,0,3,2,1,0,0,0,0,0,0,0,0,0
170037,21042,210,42,-2,1,1,0,0,0,0,0,0,0,0,0,0,0,0,0,0,0,0,1,1,0,0,0,0,0,0,0,0,0,0
170055,21042,210,42,-2,3,0,3,0,0,0,0,0,0,1,0,1,0,0,0,0,0,0,2,0,2,0,0,0,0,0,0,0,0,0
170082,21042,210,42,-2,38,22,16,0,0,0,2,1,1,0,0,0,2,1,1,0,0,0,31,18,13,0,0,0,2,2,0,1,0,1
170301,21042,210,42,-2,11,3,8,0,0,0,1,0,1,0,0,0,0,0,0,0,0,0,8,3,5,1,0,1,0,0,0,1,0,1
170532,21042,210,42,-2,4,3,1,0,0,0,1,1,0,2,1,1,0,0,0,0,0,0,1,1,0,0,0,0,0,0,0,0,0,0
170550,21042,210,42,-2,1,1,0,0,0,0,1,1,0,0,0,0,0,0,0,0,0,0,0,0,0,0,0,0,0,0,0,0,0,0
170587,21042,210,42,-2,4,2,2,0,0,0,0,0,0,0,0,0,0,0,0,0,0,0,4,2,2,0,0,0,0,0,0,0,0,0
170620,21042,210,42,-2,1,0,1,0,0,0,0,0,0,0,0,0,0,0,0,0,0,0,1,0,1,0,0,0,0,0,0,0,0,0
170639,21042,210,42,-2,2,2,0,0,0,0,0,0,0,0,0,0,0,0,0,0,0,0,1,1,0,0,0,0,1,1,0,0,0,0
170657,21042,210,42,-2,8,4,4,0,0,0,0,0,0,2,1,1,0,0,0,0,0,0,6,3,3,0,0,0,0,0,0,0,0,0
170675,21042,210,42,-2,7,5,2,0,0,0,0,0,0,0,0,0,1,1,0,0,0,0,6,4,2,0,0,0,0,0,0,0,0,0
170806,21042,210,42,-2,4,2,2,0,0,0,0,0,0,0,0,0,0,0,0,0,0,0,4,2,2,0,0,0,0,0,0,0,0,0
170976,21042,210,42,-2,421,257,164,1,1,0,18,7,11,15,8,7,8,6,2,0,0,0,116,54,62,7,5,2,8,5,3,248,171,77
171100,21042,210,42,-2,42,14,28,0,0,0,4,3,1,1,0,1,4,1,3,0,0,0,26,5,21,1,0,1,0,0,0,6,5,1
171137,21042,210,42,-2,1,0,1,0,0,0,1,0,1,0,0,0,0,0,0,0,0,0,0,0,0,0,0,0,0,0,0,0,0,0
171304,21042,210,42,-2,1,1,0,0,0,0,0,0,0,0,0,0,0,0,0,0,0,0,1,1,0,0,0,0,0,0,0,0,0,0
171456,21042,210,42,-2,5,2,3,0,0,0,0,0,0,0,0,0,0,0,0,0,0,0,4,2,2,0,0,0,1,0,1,0,0,0
171483,21042,210,42,-2,3,0,3,0,0,0,0,0,0,0,0,0,0,0,0,0,0,0,3,0,3,0,0,0,0,0,0,0,0,0
172200,21042,210,42,-2,5,3,2,0,0,0,0,0,0,1,1,0,0,0,0,0,0,0,3,2,1,0,0,0,1,0,1,0,0,0
172264,21042,210,42,-2,4,1,3,0,0,0,0,0,0,0,0,0,0,0,0,0,0,0,4,1,3,0,0,0,0,0,0,0,0,0
172307,21042,210,42,-2,4,2,2,0,0,0,0,0,0,0,0,0,0,0,0,0,0,0,2,1,1,0,0,0,2,1,1,0,0,0
172334,21042,210,42,-2,5,1,4,0,0,0,0,0,0,0,0,0,0,0,0,0,0,0,5,1,4,0,0,0,0,0,0,0,0,0
172644,21042,210,42,-2,1,0,1,0,0,0,0,0,0,0,0,0,0,0,0,0,0,0,1,0,1,0,0,0,0,0,0,0,0,0
173045,21042,210,42,-2,6,1,5,0,0,0,0,0,0,0,0,0,0,0,0,0,0,0,3,1,2,1,0,1,2,0,2,0,0,0
173063,21042,210,42,-2,1,1,0,0,0,0,0,0,0,0,0,0,0,0,0,0,0,0,1,1,0,0,0,0,0,0,0,0,0,0
173124,21042,210,42,-2,7,4,3,1,0,1,1,1,0,0,0,0,0,0,0,0,0,0,3,2,1,0,0,0,2,1,1,0,0,0
173142,21042,210,42,-2,1,0,1,0,0,0,0,0,0,0,0,0,0,0,0,0,0,0,1,0,1,0,0,0,0,0,0,0,0,0
173160,21042,210,42,-2,2,1,1,0,0,0,0,0,0,0,0,0,0,0,0,0,0,0,2,1,1,0,0,0,0,0,0,0,0,0
173328,21042,210,42,-2,4,0,4,0,0,0,0,0,0,0,0,0,0,0,0,0,0,0,3,0,3,0,0,0,1,0,1,0,0,0
173416,21042,210,42,-2,1,1,0,0,0,0,0,0,0,0,0,0,0,0,0,0,0,0,1,1,0,0,0,0,0,0,0,0,0,0
173665,21042,210,42,-2,2,1,1,0,0,0,0,0,0,0,0,0,0,0,0,0,0,0,2,1,1,0,0,0,0,0,0,0,0,0
173799,21042,210,42,-2,1,1,0,0,0,0,1,1,0,0,0,0,0,0,0,0,0,0,0,0,0,0,0,0,0,0,0,0,0,0
173902,21042,210,42,-2,12,6,6,0,0,0,1,0,1,0,0,0,1,0,1,0,0,0,6,5,1,0,0,0,0,0,0,4,1,3
173920,21042,210,42,-2,13,5,8,0,0,0,3,1,2,1,0,1,1,1,0,0,0,0,8,3,5,0,0,0,0,0,0,0,0,0
174020,21042,210,42,-2,1,0,1,0,0,0,0,0,0,0,0,0,0,0,0,0,0,0,1,0,1,0,0,0,0,0,0,0,0,0
174066,21042,210,42,-2,118,69,49,1,0,1,12,8,4,6,4,2,1,0,1,0,0,0,66,39,27,5,2,3,23,15,8,4,1,3
174075,21042,210,42,-2,1,1,0,0,0,0,0,0,0,0,0,0,0,0,0,0,0,0,1,1,0,0,0,0,0,0,0,0,0,0
174233,21042,210,42,-2,26,15,11,0,0,0,2,1,1,0,0,0,0,0,0,0,0,0,18,9,9,0,0,0,2,2,0,4,3,1
174358,21042,210,42,-2,11,3,8,0,0,0,0,0,0,0,0,0,0,0,0,0,0,0,9,2,7,0,0,0,1,1,0,1,0,1
174437,21042,210,42,-2,1,0,1,0,0,0,0,0,0,0,0,0,0,0,0,0,0,0,1,0,1,0,0,0,0,0,0,0,0,0
174491,21042,210,42,-2,3,2,1,0,0,0,0,0,0,0,0,0,1,1,0,0,0,0,2,1,1,0,0,0,0,0,0,0,0,0
174507,21042,210,42,-2,2,0,2,0,0,0,0,0,0,0,0,0,0,0,0,0,0,0,2,0,2,0,0,0,0,0,0,0,0,0
174570,21042,210,42,-2,1,0,1,0,0,0,0,0,0,0,0,0,0,0,0,0,0,0,1,0,1,0,0,0,0,0,0,0,0,0
174747,21042,210,42,-2,6,3,3,0,0,0,1,0,1,1,0,1,0,0,0,0,0,0,3,2,1,0,0,0,1,1,0,0,0,0
174783,21042,210,42,-2,10,4,6,0,0,0,2,2,0,0,0,0,0,0,0,0,0,0,8,2,6,0,0,0,0,0,0,0,0,0
174792,21042,210,42,-2,6,4,2,0,0,0,0,0,0,0,0,0,1,1,0,0,0,0,4,2,2,1,1,0,0,0,0,0,0,0
174817,21042,210,42,-2,3,1,2,0,0,0,0,0,0,1,1,0,0,0,0,0,0,0,2,0,2,0,0,0,0,0,0,0,0,0
174844,21042,210,42,-2,12,7,5,0,0,0,0,0,0,0,0,0,0,0,0,0,0,0,12,7,5,0,0,0,0,0,0,0,0,0
174899,21042,210,42,-2,4,2,2,0,0,0,0,0,0,0,0,0,0,0,0,0,0,0,3,1,2,1,1,0,0,0,0,0,0,0
174914,21042,210,42,-2,14,5,9,0,0,0,2,1,1,1,0,1,2,1,1,0,0,0,8,3,5,0,0,0,0,0,0,1,0,1
175005,21042,210,42,-2,8,1,7,0,0,0,1,1,0,3,0,3,0,0,0,0,0,0,4,0,4,0,0,0,0,0,0,0,0,0
175041,21042,210,42,-2,1,1,0,0,0,0,0,0,0,0,0,0,0,0,0,0,0,0,1,1,0,0,0,0,0,0,0,0,0,0
175078,21042,210,42,-2,3,1,2,0,0,0,0,0,0,0,0,0,0,0,0,0,0,0,3,1,2,0,0,0,0,0,0,0,0,0
175272,21042,210,42,-2,12,2,10,0,0,0,0,0,0,0,0,0,1,0,1,0,0,0,10,1,9,0,0,0,1,1,0,0,0,0
175281,21042,210,42,-2,4,0,4,0,0,0,0,0,0,2,0,2,0,0,0,0,0,0,2,0,2,0,0,0,0,0,0,0,0,0
175421,21042,210,42,-2,1,0,1,0,0,0,0,0,0,1,0,1,0,0,0,0,0,0,0,0,0,0,0,0,0,0,0,0,0,0
175430,21042,210,42,-2,3,2,1,0,0,0,0,0,0,1,1,0,0,0,0,0,0,0,2,1,1,0,0,0,0,0,0,0,0,0
175519,21042,210,42,-2,8,4,4,0,0,0,0,0,0,5,2,3,0,0,0,0,0,0,3,2,1,0,0,0,0,0,0,0,0,0
175573,21042,210,42,-2,4,0,4,0,0,0,0,0,0,1,0,1,0,0,0,0,0,0,2,0,2,1,0,1,0,0,0,0,0,0
175616,21042,210,42,-2,6,3,3,0,0,0,1,1,0,0,0,0,0,0,0,0,0,0,5,2,3,0,0,0,0,0,0,0,0,0
175643,21042,210,42,-2,1,1,0,0,0,0,0,0,0,0,0,0,0,0,0,0,0,0,1,1,0,0,0,0,0,0,0,0,0,0
175652,21042,210,42,-2,2,1,1,0,0,0,0,0,0,1,0,1,0,0,0,0,0,0,1,1,0,0,0,0,0,0,0,0,0,0
175786,21042,210,42,-2,30,12,18,0,0,0,0,0,0,10,2,8,1,0,1,0,0,0,18,10,8,0,0,0,1,0,1,0,0,0
175810,21042,210,42,-2,11,1,10,0,0,0,0,0,0,2,0,2,0,0,0,0,0,0,9,1,8,0,0,0,0,0,0,0,0,0
175829,21042,210,42,-2,5,1,4,0,0,0,0,0,0,0,0,0,0,0,0,0,0,0,5,1,4,0,0,0,0,0,0,0,0,0
175856,21042,210,42,-2,14,2,12,0,0,0,1,1,0,11,1,10,0,0,0,0,0,0,2,0,2,0,0,0,0,0,0,0,0,0
175883,21042,210,42,-2,12,6,6,0,0,0,1,1,0,2,0,2,0,0,0,0,0,0,9,5,4,0,0,0,0,0,0,0,0,0
175935,21042,210,42,-2,7,1,6,0,0,0,0,0,0,3,1,2,0,0,0,0,0,0,3,0,3,0,0,0,1,0,1,0,0,0
175980,21042,210,42,-2,2,1,1,0,0,0,0,0,0,0,0,0,1,0,1,0,0,0,1,1,0,0,0,0,0,0,0,0,0,0
176008,21042,210,42,-2,10,3,7,0,0,0,0,0,0,4,2,2,0,0,0,0,0,0,6,1,5,0,0,0,0,0,0,0,0,0
176017,21042,210,42,-2,81,35,46,0,0,0,5,3,2,13,2,11,3,1,2,0,0,0,45,21,24,2,1,1,1,1,0,12,6,6
176035,21042,210,42,-2,11,1,10,0,0,0,1,1,0,1,0,1,0,0,0,0,0,0,9,0,9,0,0,0,0,0,0,0,0,0
176044,21042,210,42,-2,3,2,1,0,0,0,1,1,0,1,0,1,0,0,0,0,0,0,1,1,0,0,0,0,0,0,0,0,0,0
176053,21042,210,42,-2,9,3,6,0,0,0,0,0,0,0,0,0,0,0,0,0,0,0,4,2,2,0,0,0,5,1,4,0,0,0
176071,21042,210,42,-2,37,16,21,0,0,0,1,1,0,4,0,4,1,0,1,0,0,0,21,10,11,0,0,0,10,5,5,0,0,0
176169,21042,210,42,-2,8,1,7,0,0,0,0,0,0,0,0,0,0,0,0,0,0,0,6,0,6,0,0,0,2,1,1,0,0,0
176178,21042,210,42,-2,18,7,11,0,0,0,0,0,0,3,1,2,0,0,0,0,0,0,15,6,9,0,0,0,0,0,0,0,0,0
176239,21042,210,42,-2,24,6,18,0,0,0,0,0,0,4,1,3,0,0,0,0,0,0,20,5,15,0,0,0,0,0,0,0,0,0
176318,21042,210,42,-2,12,6,6,0,0,0,0,0,0,11,6,5,0,0,0,0,0,0,1,0,1,0,0,0,0,0,0,0,0,0
176354,21042,210,42,-2,5,1,4,0,0,0,0,0,0,0,0,0,0,0,0,0,0,0,5,1,4,0,0,0,0,0,0,0,0,0
176600,21042,210,42,-2,1,1,0,0,0,0,0,0,0,0,0,0,0,0,0,0,0,0,1,1,0,0,0,0,0,0,0,0,0,0
176628,21042,210,42,-2,3,2,1,0,0,0,0,0,0,0,0,0,0,0,0,0,0,0,3,2,1,0,0,0,0,0,0,0,0,0
176664,21042,210,42,-2,4,3,1,0,0,0,0,0,0,0,0,0,0,0,0,0,0,0,4,3,1,0,0,0,0,0,0,0,0,0
176910,21042,210,42,-2,1,1,0,0,0,0,0,0,0,0,0,0,0,0,0,0,0,0,1,1,0,0,0,0,0,0,0,0,0,0
176947,21042,210,42,-2,7,2,5,0,0,0,0,0,0,0,0,0,0,0,0,0,0,0,7,2,5,0,0,0,0,0,0,0,0,0
176965,21042,210,42,-2,14,7,7,0,0,0,0,0,0,0,0,0,0,0,0,0,0,0,11,4,7,0,0,0,0,0,0,3,3,0
177065,21042,210,42,-2,4,3,1,0,0,0,0,0,0,0,0,0,0,0,0,0,0,0,4,3,1,0,0,0,0,0,0,0,0,0
177117,21042,210,42,-2,1,0,1,0,0,0,0,0,0,0,0,0,0,0,0,0,0,0,0,0,0,0,0,0,0,0,0,1,0,1
177126,21042,210,42,-2,2,1,1,0,0,0,0,0,0,0,0,0,0,0,0,0,0,0,2,1,1,0,0,0,0,0,0,0,0,0
177135,21042,210,42,-2,13,5,8,1,1,0,0,0,0,0,0,0,1,0,1,0,0,0,8,3,5,1,0,1,2,1,1,0,0,0
177214,21042,210,42,-2,2,2,0,0,0,0,0,0,0,0,0,0,0,0,0,0,0,0,0,0,0,0,0,0,2,2,0,0,0,0
177418,21042,210,42,-2,7,5,2,0,0,0,2,1,1,0,0,0,0,0,0,0,0,0,5,4,1,0,0,0,0,0,0,0,0,0
177472,21042,210,42,-2,9,6,3,0,0,0,0,0,0,0,0,0,0,0,0,0,0,0,7,5,2,0,0,0,2,1,1,0,0,0
177542,21042,210,42,-2,5,2,3,0,0,0,0,0,0,0,0,0,0,0,0,0,0,0,5,2,3,0,0,0,0,0,0,0,0,0
177719,21042,210,42,-2,5,0,5,0,0,0,0,0,0,2,0,2,0,0,0,0,0,0,3,0,3,0,0,0,0,0,0,0,0,0
177746,21042,210,42,-2,4,2,2,0,0,0,0,0,0,1,1,0,1,1,0,0,0,0,2,0,2,0,0,0,0,0,0,0,0,0
177968,21042,210,42,-2,8,1,7,0,0,0,0,0,0,1,0,1,0,0,0,0,0,0,6,0,6,0,0,0,0,0,0,1,1,0
177977,21042,210,42,-2,18,14,4,0,0,0,0,0,0,0,0,0,0,0,0,0,0,0,17,13,4,1,1,0,0,0,0,0,0,0
177986,21042,210,42,-2,4,1,3,0,0,0,0,0,0,0,0,0,0,0,0,0,0,0,4,1,3,0,0,0,0,0,0,0,0,0
177995,21042,210,42,-2,9,4,5,0,0,0,0,0,0,1,1,0,0,0,0,0,0,0,8,3,5,0,0,0,0,0,0,0,0,0
178059,21042,210,42,-2,3,0,3,0,0,0,0,0,0,1,0,1,0,0,0,0,0,0,2,0,2,0,0,0,0,0,0,0,0,0
178217,21042,210,42,-2,1,0,1,0,0,0,0,0,0,0,0,0,0,0,0,0,0,0,1,0,1,0,0,0,0,0,0,0,0,0
178244,21042,210,42,-2,6,1,5,0,0,0,0,0,0,1,0,1,0,0,0,0,0,0,5,1,4,0,0,0,0,0,0,0,0,0
178341,21042,210,42,-2,7,3,4,0,0,0,0,0,0,1,0,1,0,0,0,0,0,0,6,3,3,0,0,0,0,0,0,0,0,0
178369,21042,210,42,-2,9,5,4,0,0,0,2,2,0,0,0,0,0,0,0,0,0,0,7,3,4,0,0,0,0,0,0,0,0,0
178387,21042,210,42,-2,6,3,3,0,0,0,0,0,0,0,0,0,1,1,0,0,0,0,3,0,3,0,0,0,2,2,0,0,0,0
178396,21042,210,42,-2,125,63,62,1,0,1,12,10,2,6,3,3,3,1,2,0,0,0,75,36,39,1,1,0,14,4,10,13,8,5
178402,21042,210,42,-2,31,18,13,0,0,0,0,0,0,4,3,1,0,0,0,0,0,0,21,12,9,0,0,0,1,0,1,5,3,2
178411,21042,210,42,-2,3,2,1,0,0,0,0,0,0,0,0,0,0,0,0,0,0,0,1,1,0,0,0,0,1,0,1,1,1,0
178420,21042,210,42,-2,4,0,4,0,0,0,1,0,1,1,0,1,0,0,0,0,0,0,1,0,1,0,0,0,1,0,1,0,0,0
178448,21042,210,42,-2,9,3,6,0,0,0,0,0,0,1,1,0,0,0,0,0,0,0,8,2,6,0,0,0,0,0,0,0,0,0
178615,21042,210,42,-2,10,6,4,0,0,0,1,1,0,1,1,0,0,0,0,0,0,0,6,4,2,0,0,0,0,0,0,2,0,2
178624,21042,210,42,-2,4,1,3,0,0,0,0,0,0,0,0,0,0,0,0,0,0,0,3,0,3,0,0,0,0,0,0,1,1,0
178679,21042,210,42,-2,1,1,0,0,0,0,0,0,0,0,0,0,0,0,0,0,0,0,1,1,0,0,0,0,0,0,0,0,0,0
178697,21042,210,42,-2,8,7,1,0,0,0,0,0,0,0,0,0,0,0,0,0,0,0,8,7,1,0,0,0,0,0,0,0,0,0
178721,21042,210,42,-2,2,0,2,0,0,0,0,0,0,0,0,0,0,0,0,0,0,0,2,0,2,0,0,0,0,0,0,0,0,0
178989,21042,210,42,-2,4,2,2,0,0,0,0,0,0,0,0,0,0,0,0,0,0,0,4,2,2,0,0,0,0,0,0,0,0,0
179043,21042,210,42,-2,9,2,7,0,0,0,0,0,0,0,0,0,0,0,0,0,0,0,6,2,4,0,0,0,2,0,2,1,0,1
179159,21042,210,42,-2,22,11,11,0,0,0,2,0,2,3,3,0,2,1,1,0,0,0,7,3,4,0,0,0,0,0,0,8,4,4
179308,21042,210,42,-2,14,3,11,0,0,0,0,0,0,0,0,0,0,0,0,0,0,0,11,1,10,0,0,0,2,1,1,1,1,0
179326,21042,210,42,-2,6,2,4,0,0,0,0,0,0,0,0,0,0,0,0,0,0,0,6,2,4,0,0,0,0,0,0,0,0,0
179344,21042,210,42,-2,4,2,2,0,0,0,0,0,0,0,0,0,0,0,0,0,0,0,2,0,2,0,0,0,2,2,0,0,0,0
179539,21042,210,42,-2,9,2,7,0,0,0,0,0,0,0,0,0,1,0,1,0,0,0,8,2,6,0,0,0,0,0,0,0,0,0
179548,21042,210,42,-2,7,3,4,0,0,0,0,0,0,0,0,0,0,0,0,0,0,0,7,3,4,0,0,0,0,0,0,0,0,0
179557,21042,210,42,-2,7,5,2,0,0,0,0,0,0,0,0,0,0,0,0,0,0,0,7,5,2,0,0,0,0,0,0,0,0,0
179566,21042,210,42,-2,19,5,14,0,0,0,0,0,0,1,1,0,2,0,2,0,0,0,15,4,11,0,0,0,0,0,0,1,0,1
179645,21042,210,42,-2,2,1,1,0,0,0,0,0,0,0,0,0,0,0,0,0,0,0,2,1,1,0,0,0,0,0,0,0,0,0
179867,21042,210,42,-2,35,18,17,0,0,0,5,1,4,4,2,2,2,1,1,0,0,0,16,9,7,2,1,1,0,0,0,6,4,2
179894,21042,210,42,-2,5,3,2,0,0,0,0,0,0,0,0,0,0,0,0,0,0,0,2,1,1,1,0,1,2,2,0,0,0,0
179946,21042,210,42,-2,1,0,1,0,0,0,0,0,0,0,0,0,0,0,0,0,0,0,1,0,1,0,0,0,0,0,0,0,0,0
180106,21042,210,42,-2,12,3,9,0,0,0,0,0,0,0,0,0,0,0,0,0,0,0,6,2,4,0,0,0,6,1,5,0,0,0
180179,21042,210,42,-2,13,5,8,0,0,0,0,0,0,0,0,0,0,0,0,0,0,0,13,5,8,0,0,0,0,0,0,0,0,0
180203,21042,210,42,-2,1,1,0,0,0,0,0,0,0,0,0,0,0,0,0,0,0,0,1,1,0,0,0,0,0,0,0,0,0,0
180212,21042,210,42,-2,2,1,1,0,0,0,0,0,0,0,0,0,0,0,0,0,0,0,2,1,1,0,0,0,0,0,0,0,0,0
180328,21042,210,42,-2,1,1,0,1,1,0,0,0,0,0,0,0,0,0,0,0,0,0,0,0,0,0,0,0,0,0,0,0,0,0
180373,21042,210,42,-2,5,3,2,0,0,0,0,0,0,0,0,0,0,0,0,0,0,0,3,2,1,0,0,0,2,1,1,0,0,0
180416,21042,210,42,-2,2,2,0,0,0,0,0,0,0,0,0,0,0,0,0,0,0,0,2,2,0,0,0,0,0,0,0,0,0,0
180461,21042,210,42,-2,1,0,1,0,0,0,0,0,0,0,0,0,0,0,0,0,0,0,0,0,0,0,0,0,1,0,1,0,0,0
180489,21042,210,42,-2,8,5,3,1,1,0,0,0,0,0,0,0,0,0,0,0,0,0,7,4,3,0,0,0,0,0,0,0,0,0
180595,21042,210,42,-2,4,1,3,0,0,0,0,0,0,0,0,0,0,0,0,0,0,0,2,0,2,0,0,0,2,1,1,0,0,0
180832,21042,210,42,-2,4,0,4,0,0,0,0,0,0,0,0,0,0,0,0,0,0,0,4,0,4,0,0,0,0,0,0,0,0,0
180878,21042,210,42,-2,1,0,1,0,0,0,0,0,0,0,0,0,0,0,0,0,0,0,1,0,1,0,0,0,0,0,0,0,0,0
180948,21042,210,42,-2,1,1,0,0,0,0,0,0,0,0,0,0,0,0,0,0,0,0,1,1,0,0,0,0,0,0,0,0,0,0
180984,21042,210,42,-2,1,1,0,0,0,0,1,1,0,0,0,0,0,0,0,0,0,0,0,0,0,0,0,0,0,0,0,0,0,0
181002,21042,210,42,-2,31,15,16,0,0,0,1,0,1,0,0,0,2,1,1,0,0,0,18,8,10,0,0,0,9,5,4,1,1,0
181020,21042,210,42,-2,7,3,4,0,0,0,2,1,1,0,0,0,0,0,0,0,0,0,5,2,3,0,0,0,0,0,0,0,0,0
181127,21042,210,42,-2,6,1,5,0,0,0,0,0,0,0,0,0,0,0,0,0,0,0,6,1,5,0,0,0,0,0,0,0,0,0
181215,21042,210,42,-2,10,5,5,0,0,0,0,0,0,0,0,0,0,0,0,0,0,0,9,4,5,0,0,0,0,0,0,1,1,0
181303,21042,210,42,-2,12,7,5,0,0,0,0,0,0,0,0,0,1,1,0,0,0,0,11,6,5,0,0,0,0,0,0,0,0,0
181312,21042,210,42,-2,14,12,2,0,0,0,0,0,0,0,0,0,0,0,0,0,0,0,14,12,2,0,0,0,0,0,0,0,0,0
181394,21042,210,42,-2,11,6,5,0,0,0,0,0,0,0,0,0,1,1,0,0,0,0,8,4,4,0,0,0,1,1,0,1,0,1
181419,21042,210,42,-2,3,3,0,2,2,0,1,1,0,0,0,0,0,0,0,0,0,0,0,0,0,0,0,0,0,0,0,0,0,0
181428,21042,210,42,-2,29,15,14,0,0,0,1,0,1,0,0,0,0,0,0,0,0,0,21,10,11,1,1,0,0,0,0,6,4,2
181446,21042,210,42,-2,4,1,3,0,0,0,1,0,1,0,0,0,0,0,0,0,0,0,2,1,1,0,0,0,0,0,0,1,0,1
181464,21042,210,42,-2,7,3,4,0,0,0,1,1,0,0,0,0,0,0,0,0,0,0,4,2,2,0,0,0,0,0,0,2,0,2
181491,21042,210,42,-2,13,10,3,0,0,0,0,0,0,0,0,0,0,0,0,0,0,0,13,10,3,0,0,0,0,0,0,0,0,0
181604,21042,210,42,-2,6,1,5,0,0,0,0,0,0,0,0,0,0,0,0,0,0,0,6,1,5,0,0,0,0,0,0,0,0,0
181640,21042,210,42,-2,20,12,8,0,0,0,1,1,0,1,1,0,0,0,0,0,0,0,18,10,8,0,0,0,0,0,0,0,0,0
181738,21042,210,42,-2,5,1,4,0,0,0,0,0,0,0,0,0,2,0,2,0,0,0,3,1,2,0,0,0,0,0,0,0,0,0
181765,21042,210,42,-2,1,1,0,0,0,0,0,0,0,0,0,0,0,0,0,0,0,0,1,1,0,0,0,0,0,0,0,0,0,0
181783,21042,210,42,-2,1,0,1,0,0,0,0,0,0,0,0,0,0,0,0,0,0,0,1,0,1,0,0,0,0,0,0,0,0,0
181853,21042,210,42,-2,3,2,1,0,0,0,0,0,0,0,0,0,0,0,0,0,0,0,3,2,1,0,0,0,0,0,0,0,0,0
182281,21042,210,42,-2,24,13,11,0,0,0,10,6,4,1,0,1,2,0,2,0,0,0,6,3,3,2,1,1,0,0,0,3,3,0
182290,21042,210,42,-2,13,4,9,0,0,0,0,0,0,0,0,0,1,1,0,0,0,0,12,3,9,0,0,0,0,0,0,0,0,0
182306,21042,210,42,-2,3,2,1,0,0,0,0,0,0,0,0,0,0,0,0,0,0,0,3,2,1,0,0,0,0,0,0,0,0,0
182458,21042,210,42,-2,1,0,1,0,0,0,0,0,0,1,0,1,0,0,0,0,0,0,0,0,0,0,0,0,0,0,0,0,0,0
182500,21042,210,42,-2,3,1,2,0,0,0,0,0,0,0,0,0,1,0,1,0,0,0,2,1,1,0,0,0,0,0,0,0,0,0
182795,21042,210,42,-2,6,2,4,0,0,0,0,0,0,0,0,0,0,0,0,0,0,0,6,2,4,0,0,0,0,0,0,0,0,0
183026,21042,210,42,-2,2,1,1,0,0,0,0,0,0,0,0,0,0,0,0,0,0,0,2,1,1,0,0,0,0,0,0,0,0,0
183105,21042,210,42,-2,1,1,0,0,0,0,0,0,0,0,0,0,0,0,0,0,0,0,1,1,0,0,0,0,0,0,0,0,0,0
183114,21042,210,42,-2,1,0,1,0,0,0,0,0,0,0,0,0,0,0,0,0,0,0,1,0,1,0,0,0,0,0,0,0,0,0
183123,21042,210,42,-2,5,3,2,0,0,0,0,0,0,0,0,0,0,0,0,0,0,0,4,2,2,0,0,0,1,1,0,0,0,0
183132,21042,210,42,-2,1,0,1,0,0,0,0,0,0,0,0,0,0,0,0,0,0,0,0,0,0,1,0,1,0,0,0,0,0,0
183141,21042,210,42,-2,2,1,1,0,0,0,0,0,0,0,0,0,0,0,0,0,0,0,2,1,1,0,0,0,0,0,0,0,0,0
183150,21042,210,42,-2,1,1,0,0,0,0,0,0,0,0,0,0,0,0,0,0,0,0,1,1,0,0,0,0,0,0,0,0,0,0
183211,21042,210,42,-2,4,0,4,0,0,0,1,0,1,0,0,0,0,0,0,0,0,0,3,0,3,0,0,0,0,0,0,0,0,0
183239,21042,210,42,-2,10,3,7,0,0,0,0,0,0,1,1,0,1,0,1,0,0,0,7,1,6,0,0,0,1,1,0,0,0,0
183822,21042,210,42,-2,3,0,3,0,0,0,0,0,0,3,0,3,0,0,0,0,0,0,0,0,0,0,0,0,0,0,0,0,0,0
183859,21042,210,42,-2,2,2,0,0,0,0,0,0,0,0,0,0,0,0,0,0,0,0,2,2,0,0,0,0,0,0,0,0,0,0
183974,21042,210,42,-2,2,1,1,0,0,0,0,0,0,0,0,0,0,0,0,0,0,0,2,1,1,0,0,0,0,0,0,0,0,0
184205,21042,210,42,-2,1,1,0,0,0,0,0,0,0,0,0,0,0,0,0,0,0,0,1,1,0,0,0,0,0,0,0,0,0,0
184348,21042,210,42,-2,1,1,0,0,0,0,1,1,0,0,0,0,0,0,0,0,0,0,0,0,0,0,0,0,0,0,0,0,0,0
184481,21042,210,42,-2,1,0,1,0,0,0,0,0,0,1,0,1,0,0,0,0,0,0,0,0,0,0,0,0,0,0,0,0,0,0
184603,21042,210,42,-2,3,1,2,0,0,0,0,0,0,1,1,0,0,0,0,0,0,0,2,0,2,0,0,0,0,0,0,0,0,0
184612,21042,210,42,-2,16,4,12,0,0,0,0,0,0,1,0,1,4,1,3,0,0,0,10,2,8,1,1,0,0,0,0,0,0,0
184694,21042,210,42,-2,7,2,5,0,0,0,3,1,2,0,0,0,0,0,0,0,0,0,2,0,2,1,1,0,1,0,1,0,0,0
184773,21042,210,42,-2,1,0,1,0,0,0,0,0,0,0,0,0,0,0,0,0,0,0,1,0,1,0,0,0,0,0,0,0,0,0
184782,21042,210,42,-2,42,17,25,0,0,0,5,3,2,6,0,6,2,0,2,0,0,0,25,10,15,2,2,0,1,1,0,1,1,0
185262,21042,210,42,-2,5,0,5,0,0,0,0,0,0,3,0,3,1,0,1,0,0,0,1,0,1,0,0,0,0,0,0,0,0,0
185572,21042,210,42,-2,3,1,2,0,0,0,0,0,0,0,0,0,0,0,0,0,0,0,2,1,1,1,0,1,0,0,0,0,0,0
185590,21042,210,42,-2,9,3,6,0,0,0,0,0,0,3,1,2,1,0,1,0,0,0,2,2,0,0,0,0,2,0,2,1,0,1
185828,21042,210,42,-2,11,6,5,0,0,0,5,3,2,0,0,0,1,0,1,0,0,0,2,1,1,0,0,0,0,0,0,3,2,1
186122,21042,210,42,-2,1,1,0,0,0,0,0,0,0,0,0,0,0,0,0,0,0,0,1,1,0,0,0,0,0,0,0,0,0,0
186131,21042,210,42,-2,20,10,10,0,0,0,2,2,0,0,0,0,1,0,1,0,0,0,2,1,1,0,0,0,7,4,3,8,3,5
186201,21042,210,42,-2,1,0,1,0,0,0,0,0,0,1,0,1,0,0,0,0,0,0,0,0,0,0,0,0,0,0,0,0,0,0
186432,21042,210,42,-2,3,2,1,0,0,0,2,2,0,0,0,0,0,0,0,0,0,0,1,0,1,0,0,0,0,0,0,0,0,0
186584,21042,210,42,-2,12,6,6,0,0,0,0,0,0,0,0,0,1,0,1,0,0,0,9,6,3,1,0,1,1,0,1,0,0,0
186618,21042,210,42,-2,8,1,7,0,0,0,0,0,0,0,0,0,0,0,0,0,0,0,6,0,6,0,0,0,2,1,1,0,0,0
186876,21042,210,42,-2,7,0,7,0,0,0,0,0,0,0,0,0,0,0,0,0,0,0,7,0,7,0,0,0,0,0,0,0,0,0
187134,21042,210,42,-2,10,7,3,0,0,0,0,0,0,1,1,0,0,0,0,0,0,0,8,6,2,0,0,0,1,0,1,0,0,0
187444,21042,210,42,-2,7,2,5,0,0,0,1,0,1,3,1,2,1,1,0,0,0,0,2,0,2,0,0,0,0,0,0,0,0,0
187532,21042,210,42,-2,4,2,2,0,0,0,0,0,0,0,0,0,1,0,1,0,0,0,3,2,1,0,0,0,0,0,0,0,0,0
187639,21042,210,42,-2,8,2,6,0,0,0,0,0,0,1,0,1,2,1,1,0,0,0,5,1,4,0,0,0,0,0,0,0,0,0
187648,21042,210,42,-2,4,2,2,0,0,0,0,0,0,0,0,0,0,0,0,0,0,0,3,2,1,0,0,0,0,0,0,1,0,1
187897,21042,210,42,-2,3,0,3,0,0,0,0,0,0,0,0,0,0,0,0,0,0,0,3,0,3,0,0,0,0,0,0,0,0,0
187903,21042,210,42,-2,15,7,8,0,0,0,0,0,0,2,0,2,1,1,0,0,0,0,12,6,6,0,0,0,0,0,0,0,0,0
187958,21042,210,42,-2,2,1,1,1,0,1,0,0,0,0,0,0,0,0,0,0,0,0,0,0,0,0,0,0,0,0,0,1,1,0
187985,21042,210,42,-2,84,25,59,3,1,2,6,4,2,3,1,2,12,4,8,0,0,0,47,11,36,2,1,1,2,1,1,9,2,7
188030,21042,210,42,-2,4,0,4,0,0,0,0,0,0,0,0,0,0,0,0,0,0,0,4,0,4,0,0,0,0,0,0,0,0,0
188100,21042,210,42,-2,9,6,3,0,0,0,1,1,0,1,1,0,1,1,0,0,0,0,2,1,1,0,0,0,4,2,2,0,0,0
188137,21042,210,42,-2,5,4,1,0,0,0,0,0,0,0,0,0,3,2,1,0,0,0,1,1,0,1,1,0,0,0,0,0,0,0
188182,21042,210,42,-2,4,1,3,0,0,0,0,0,0,0,0,0,0,0,0,0,0,0,0,0,0,0,0,0,4,1,3,0,0,0
188225,21042,210,42,-2,1,1,0,0,0,0,0,0,0,0,0,0,0,0,0,0,0,0,1,1,0,0,0,0,0,0,0,0,0,0
188261,21042,210,42,-2,2,1,1,0,0,0,0,0,0,0,0,0,0,0,0,0,0,0,2,1,1,0,0,0,0,0,0,0,0,0
188429,21042,210,42,-2,2,1,1,0,0,0,1,0,1,0,0,0,0,0,0,0,0,0,1,1,0,0,0,0,0,0,0,0,0,0
188526,21042,210,42,-2,2,1,1,0,0,0,1,1,0,0,0,0,0,0,0,0,0,0,1,0,1,0,0,0,0,0,0,0,0,0
188535,21042,210,42,-2,1,0,1,0,0,0,0,0,0,0,0,0,0,0,0,0,0,0,1,0,1,0,0,0,0,0,0,0,0,0
188641,21042,210,42,-2,6,1,5,0,0,0,2,1,1,0,0,0,1,0,1,0,0,0,3,0,3,0,0,0,0,0,0,0,0,0
189015,21042,210,42,-2,1,0,1,0,0,0,0,0,0,0,0,0,0,0,0,0,0,0,1,0,1,0,0,0,0,0,0,0,0,0
189097,21042,210,42,-2,17,4,13,0,0,0,2,0,2,1,0,1,0,0,0,0,0,0,12,4,8,0,0,0,2,0,2,0,0,0
189413,21042,210,42,-2,2,1,1,0,0,0,0,0,0,1,1,0,1,0,1,0,0,0,0,0,0,0,0,0,0,0,0,0,0,0
189857,21042,210,42,-2,5,5,0,0,0,0,0,0,0,0,0,0,0,0,0,0,0,0,5,5,0,0,0,0,0,0,0,0,0,0
190099,21042,210,42,-2,27,14,13,0,0,0,0,0,0,0,0,0,1,1,0,1,1,0,13,5,8,2,1,1,1,0,1,9,6,3
190150,21042,210,42,-2,167,88,79,0,0,0,37,20,17,15,8,7,8,3,5,0,0,0,79,45,34,6,2,4,13,8,5,9,2,7
190169,21042,210,42,-2,1,0,1,0,0,0,0,0,0,0,0,0,0,0,0,0,0,0,1,0,1,0,0,0,0,0,0,0,0,0
190415,21042,210,42,-2,25,9,16,0,0,0,3,1,2,1,0,1,4,1,3,0,0,0,10,6,4,2,0,2,0,0,0,5,1,4
190424,21042,210,42,-2,160,55,105,0,0,0,59,35,24,16,4,12,7,2,5,0,0,0,54,0,54,0,0,0,1,0,1,23,14,9
190442,21042,210,42,-2,1,1,0,0,0,0,0,0,0,1,1,0,0,0,0,0,0,0,0,0,0,0,0,0,0,0,0,0,0,0
190512,21042,210,42,-2,5,2,3,0,0,0,0,0,0,0,0,0,1,0,1,0,0,0,3,2,1,0,0,0,0,0,0,1,0,1
190521,21042,210,42,-2,18,7,11,0,0,0,2,1,1,5,1,4,2,2,0,0,0,0,8,3,5,0,0,0,0,0,0,1,0,1
190549,21042,210,42,-2,19,7,12,0,0,0,0,0,0,4,2,2,1,0,1,0,0,0,11,3,8,0,0,0,0,0,0,3,2,1
190567,21042,210,42,-2,12,7,5,0,0,0,1,1,0,0,0,0,1,1,0,0,0,0,8,3,5,2,2,0,0,0,0,0,0,0
190576,21042,210,42,-2,10,0,10,0,0,0,1,0,1,2,0,2,2,0,2,0,0,0,5,0,5,0,0,0,0,0,0,0,0,0
190585,21042,210,42,-2,1,1,0,0,0,0,0,0,0,0,0,0,0,0,0,0,0,0,1,1,0,0,0,0,0,0,0,0,0,0
190594,21042,210,42,-2,7,3,4,0,0,0,1,0,1,1,1,0,2,1,1,0,0,0,3,1,2,0,0,0,0,0,0,0,0,0
190600,21042,210,42,-2,34,13,21,0,0,0,1,0,1,7,4,3,4,1,3,0,0,0,22,8,14,0,0,0,0,0,0,0,0,0
190619,21042,210,42,-2,14,5,9,0,0,0,2,0,2,4,1,3,0,0,0,0,0,0,8,4,4,0,0,0,0,0,0,0,0,0
190628,21042,210,42,-2,1,1,0,0,0,0,0,0,0,0,0,0,1,1,0,0,0,0,0,0,0,0,0,0,0,0,0,0,0,0
190637,21042,210,42,-2,9,4,5,0,0,0,1,0,1,2,0,2,1,1,0,0,0,0,4,3,1,0,0,0,0,0,0,1,0,1
190646,21042,210,42,-2,14,7,7,0,0,0,1,1,0,11,5,6,0,0,0,0,0,0,2,1,1,0,0,0,0,0,0,0,0,0
190655,21042,210,42,-2,3,1,2,0,0,0,1,1,0,1,0,1,0,0,0,0,0,0,1,0,1,0,0,0,0,0,0,0,0,0
190664,21042,210,42,-2,21,8,13,0,0,0,5,2,3,2,0,2,1,0,1,0,0,0,13,6,7,0,0,0,0,0,0,0,0,0
190682,21042,210,42,-2,3,2,1,0,0,0,1,0,1,1,1,0,1,1,0,0,0,0,0,0,0,0,0,0,0,0,0,0,0,0
190691,21042,210,42,-2,1,0,1,0,0,0,0,0,0,1,0,1,0,0,0,0,0,0,0,0,0,0,0,0,0,0,0,0,0,0
190716,21042,210,42,-2,7,2,5,0,0,0,1,0,1,2,0,2,0,0,0,0,0,0,4,2,2,0,0,0,0,0,0,0,0,0
190725,21042,210,42,-2,2,1,1,0,0,0,0,0,0,0,0,0,1,0,1,0,0,0,1,1,0,0,0,0,0,0,0,0,0,0
190761,21042,210,42,-2,1,1,0,0,0,0,0,0,0,0,0,0,0,0,0,0,0,0,1,1,0,0,0,0,0,0,0,0,0,0
190983,21042,210,42,-2,1,0,1,0,0,0,0,0,0,0,0,0,0,0,0,0,0,0,1,0,1,0,0,0,0,0,0,0,0,0
191241,21042,210,42,-2,2,2,0,0,0,0,0,0,0,1,1,0,0,0,0,0,0,0,1,1,0,0,0,0,0,0,0,0,0,0
191515,21042,210,42,-2,19,10,9,0,0,0,2,0,2,0,0,0,1,0,1,0,0,0,7,5,2,1,0,1,2,1,1,6,4,2
191597,21042,210,42,-2,6,1,5,0,0,0,1,0,1,4,0,4,0,0,0,0,0,0,1,1,0,0,0,0,0,0,0,0,0,0
191621,21042,210,42,-2,1,1,0,0,0,0,0,0,0,0,0,0,0,0,0,0,0,0,1,1,0,0,0,0,0,0,0,0,0,0
191630,21042,210,42,-2,7,3,4,0,0,0,0,0,0,0,0,0,1,1,0,0,0,0,5,2,3,0,0,0,1,0,1,0,0,0
191649,21042,210,42,-2,7,3,4,0,0,0,1,0,1,1,0,1,0,0,0,0,0,0,3,2,1,0,0,0,0,0,0,2,1,1
191968,21042,210,42,-2,2,1,1,0,0,0,0,0,0,0,0,0,0,0,0,0,0,0,1,1,0,0,0,0,1,0,1,0,0,0
192110,21042,210,42,-2,2,2,0,0,0,0,0,0,0,1,1,0,0,0,0,0,0,0,0,0,0,0,0,0,0,0,0,1,1,0
192192,21042,210,42,-2,2,0,2,0,0,0,0,0,0,0,0,0,0,0,0,0,0,0,2,0,2,0,0,0,0,0,0,0,0,0
192323,21042,210,42,-2,5,3,2,0,0,0,0,0,0,0,0,0,1,1,0,0,0,0,4,2,2,0,0,0,0,0,0,0,0,0
192448,21042,210,42,-2,22,12,10,0,0,0,1,1,0,3,0,3,0,0,0,0,0,0,13,9,4,0,0,0,5,2,3,0,0,0
192703,21042,210,42,-2,3,1,2,0,0,0,0,0,0,0,0,0,1,0,1,0,0,0,1,1,0,0,0,0,1,0,1,0,0,0
192749,21042,210,42,-2,8,0,8,0,0,0,1,0,1,0,0,0,2,0,2,0,0,0,3,0,3,0,0,0,2,0,2,0,0,0
192819,21042,210,42,-2,8,2,6,0,0,0,2,1,1,1,0,1,0,0,0,0,0,0,5,1,4,0,0,0,0,0,0,0,0,0
192864,21042,210,42,-2,7,5,2,0,0,0,0,0,0,0,0,0,0,0,0,0,0,0,0,0,0,0,0,0,7,5,2,0,0,0
192925,21042,210,42,-2,11,3,8,1,1,0,0,0,0,2,1,1,0,0,0,1,0,1,7,1,6,0,0,0,0,0,0,0,0,0
193016,21042,210,42,-2,21,6,15,0,0,0,2,1,1,4,1,3,1,0,1,0,0,0,13,3,10,0,0,0,1,1,0,0,0,0
193283,21042,210,42,-2,1,0,1,0,0,0,0,0,0,0,0,0,0,0,0,0,0,0,1,0,1,0,0,0,0,0,0,0,0,0
193399,21042,210,42,-2,1,1,0,0,0,0,0,0,0,0,0,0,0,0,0,0,0,0,1,1,0,0,0,0,0,0,0,0,0,0
193405,21042,210,42,-2,155,66,89,0,0,0,17,7,10,3,0,3,4,1,3,0,0,0,29,17,12,1,0,1,90,35,55,11,6,5
193478,21042,210,42,-2,2,1,1,0,0,0,0,0,0,0,0,0,0,0,0,0,0,0,2,1,1,0,0,0,0,0,0,0,0,0
193584,21042,210,42,-2,8,2,6,0,0,0,1,0,1,0,0,0,2,1,1,0,0,0,5,1,4,0,0,0,0,0,0,0,0,0
193654,21042,210,42,-2,6,3,3,0,0,0,0,0,0,1,0,1,1,0,1,0,0,0,1,0,1,0,0,0,1,1,0,2,2,0
193821,21042,210,42,-2,2,1,1,0,0,0,0,0,0,0,0,0,0,0,0,0,0,0,1,0,1,0,0,0,1,1,0,0,0,0
193973,21042,210,42,-2,13,5,8,0,0,0,0,0,0,0,0,0,0,0,0,0,0,0,13,5,8,0,0,0,0,0,0,0,0,0
194028,21042,210,42,-2,4,0,4,0,0,0,0,0,0,0,0,0,0,0,0,0,0,0,4,0,4,0,0,0,0,0,0,0,0,0
194073,21042,210,42,-2,1,0,1,0,0,0,1,0,1,0,0,0,0,0,0,0,0,0,0,0,0,0,0,0,0,0,0,0,0,0
194310,21042,210,42,-2,22,7,15,0,0,0,2,0,2,2,2,0,4,1,3,0,0,0,11,4,7,0,0,0,2,0,2,1,0,1
194392,21042,210,42,-2,5,4,1,0,0,0,2,2,0,0,0,0,0,0,0,0,0,0,3,2,1,0,0,0,0,0,0,0,0,0
195003,21042,210,42,-2,30,15,15,0,0,0,5,1,4,0,0,0,4,3,1,1,1,0,17,8,9,0,0,0,2,1,1,1,1,0
195030,21042,210,42,-2,13,4,9,0,0,0,2,1,1,1,1,0,1,1,0,0,0,0,9,1,8,0,0,0,0,0,0,0,0,0
195049,21042,210,42,-2,1,1,0,0,0,0,0,0,0,0,0,0,0,0,0,0,0,0,1,1,0,0,0,0,0,0,0,0,0,0
195164,21042,210,42,-2,5,1,4,0,0,0,0,0,0,0,0,0,0,0,0,0,0,0,5,1,4,0,0,0,0,0,0,0,0,0
195191,21042,210,42,-2,1,0,1,0,0,0,0,0,0,0,0,0,0,0,0,0,0,0,1,0,1,0,0,0,0,0,0,0,0,0
195216,21042,210,42,-2,8,5,3,0,0,0,1,0,1,0,0,0,1,1,0,0,0,0,5,4,1,0,0,0,1,0,1,0,0,0
195234,21042,210,42,-2,2,1,1,0,0,0,0,0,0,0,0,0,0,0,0,0,0,0,2,1,1,0,0,0,0,0,0,0,0,0
195243,21042,210,42,-2,1,0,1,0,0,0,0,0,0,0,0,0,1,0,1,0,0,0,0,0,0,0,0,0,0,0,0,0,0,0
195438,21042,210,42,-2,3,3,0,0,0,0,0,0,0,0,0,0,0,0,0,0,0,0,3,3,0,0,0,0,0,0,0,0,0,0
195474,21042,210,42,-2,14,7,7,0,0,0,0,0,0,1,0,1,0,0,0,0,0,0,11,6,5,0,0,0,0,0,0,2,1,1
195544,21042,210,42,-2,6,2,4,0,0,0,0,0,0,1,0,1,0,0,0,0,0,0,3,1,2,0,0,0,2,1,1,0,0,0
195720,21042,210,42,-2,4,2,2,0,0,0,0,0,0,0,0,0,0,0,0,0,0,0,4,2,2,0,0,0,0,0,0,0,0,0
195809,21042,210,42,-2,11,4,7,0,0,0,4,2,2,1,0,1,0,0,0,0,0,0,5,1,4,0,0,0,0,0,0,1,1,0
196006,21042,210,42,-2,5,5,0,0,0,0,1,1,0,1,1,0,1,1,0,0,0,0,2,2,0,0,0,0,0,0,0,0,0,0
196033,21042,210,42,-2,2,2,0,0,0,0,0,0,0,0,0,0,0,0,0,0,0,0,2,2,0,0,0,0,0,0,0,0,0,0
196060,21042,210,42,-2,1,0,1,0,0,0,0,0,0,0,0,0,0,0,0,0,0,0,0,0,0,0,0,0,0,0,0,1,0,1
196079,21042,210,42,-2,16,8,8,0,0,0,1,1,0,0,0,0,0,0,0,0,0,0,9,2,7,0,0,0,0,0,0,6,5,1
196088,21042,210,42,-2,12,6,6,0,0,0,2,1,1,0,0,0,0,0,0,0,0,0,5,1,4,0,0,0,0,0,0,5,4,1
196097,21042,210,42,-2,85,38,47,0,0,0,18,11,7,2,1,1,9,5,4,0,0,0,46,15,31,1,0,1,8,5,3,1,1,0
196121,21042,210,42,-2,2,0,2,0,0,0,0,0,0,0,0,0,0,0,0,0,0,0,2,0,2,0,0,0,0,0,0,0,0,0
196130,21042,210,42,-2,1,0,1,0,0,0,0,0,0,0,0,0,0,0,0,0,0,0,0,0,0,0,0,0,0,0,0,1,0,1
196158,21042,210,42,-2,2,2,0,0,0,0,0,0,0,0,0,0,0,0,0,0,0,0,2,2,0,0,0,0,0,0,0,0,0,0
196167,21042,210,42,-2,3,1,2,0,0,0,1,1,0,0,0,0,0,0,0,0,0,0,2,0,2,0,0,0,0,0,0,0,0,0
196176,21042,210,42,-2,7,3,4,0,0,0,1,1,0,1,0,1,0,0,0,0,0,0,5,2,3,0,0,0,0,0,0,0,0,0
196185,21042,210,42,-2,11,7,4,1,0,1,1,1,0,0,0,0,0,0,0,0,0,0,9,6,3,0,0,0,0,0,0,0,0,0
196194,21042,210,42,-2,2,0,2,0,0,0,1,0,1,0,0,0,0,0,0,0,0,0,1,0,1,0,0,0,0,0,0,0,0,0
196200,21042,210,42,-2,10,9,1,0,0,0,0,0,0,2,1,1,1,1,0,0,0,0,7,7,0,0,0,0,0,0,0,0,0,0
196219,21042,210,42,-2,3,1,2,0,0,0,0,0,0,1,0,1,1,0,1,0,0,0,1,1,0,0,0,0,0,0,0,0,0,0
196237,21042,210,42,-2,1,1,0,0,0,0,0,0,0,0,0,0,1,1,0,0,0,0,0,0,0,0,0,0,0,0,0,0,0,0
196246,21042,210,42,-2,4,2,2,0,0,0,0,0,0,0,0,0,0,0,0,0,0,0,2,2,0,0,0,0,0,0,0,2,0,2
196255,21042,210,42,-2,11,6,5,0,0,0,1,1,0,3,1,2,2,1,1,0,0,0,5,3,2,0,0,0,0,0,0,0,0,0
196264,21042,210,42,-2,1,0,1,0,0,0,0,0,0,0,0,0,0,0,0,0,0,0,1,0,1,0,0,0,0,0,0,0,0,0
196291,21042,210,42,-2,1,1,0,0,0,0,0,0,0,0,0,0,0,0,0,0,0,0,1,1,0,0,0,0,0,0,0,0,0,0
196307,21042,210,42,-2,18,12,6,0,0,0,2,1,1,1,0,1,1,1,0,0,0,0,4,4,0,0,0,0,0,0,0,10,6,4
196431,21042,210,42,-2,2,2,0,0,0,0,0,0,0,0,0,0,0,0,0,0,0,0,2,2,0,0,0,0,0,0,0,0,0,0
196468,21042,210,42,-2,1,0,1,0,0,0,0,0,0,0,0,0,0,0,0,0,0,0,1,0,1,0,0,0,0,0,0,0,0,0
196592,21042,210,42,-2,27,6,21,0,0,0,2,1,1,2,0,2,6,0,6,0,0,0,12,4,8,3,1,2,2,0,2,0,0,0
196653,21042,210,42,-2,6,1,5,0,0,0,0,0,0,1,0,1,0,0,0,0,0,0,5,1,4,0,0,0,0,0,0,0,0,0
196680,21042,210,42,-2,1,0,1,0,0,0,1,0,1,0,0,0,0,0,0,0,0,0,0,0,0,0,0,0,0,0,0,0,0,0
196866,21042,210,42,-2,2,1,1,0,0,0,0,0,0,0,0,0,0,0,0,0,0,0,2,1,1,0,0,0,0,0,0,0,0,0
197027,21042,210,42,-2,1,1,0,0,0,0,0,0,0,0,0,0,0,0,0,0,0,0,1,1,0,0,0,0,0,0,0,0,0,0
197036,21042,210,42,-2,18,11,7,0,0,0,0,0,0,1,0,1,0,0,0,0,0,0,17,11,6,0,0,0,0,0,0,0,0,0
197045,21042,210,42,-2,1,1,0,0,0,0,0,0,0,0,0,0,0,0,0,0,0,0,1,1,0,0,0,0,0,0,0,0,0,0
197133,21042,210,42,-2,15,9,6,0,0,0,0,0,0,0,0,0,1,1,0,0,0,0,10,5,5,0,0,0,1,1,0,3,2,1
197142,21042,210,42,-2,2,1,1,0,0,0,0,0,0,0,0,0,0,0,0,0,0,0,2,1,1,0,0,0,0,0,0,0,0,0
197151,21042,210,42,-2,3,1,2,0,0,0,0,0,0,0,0,0,0,0,0,0,0,0,1,1,0,0,0,0,1,0,1,1,0,1
197708,21042,210,42,-2,12,5,7,0,0,0,1,0,1,2,1,1,2,1,1,0,0,0,7,3,4,0,0,0,0,0,0,0,0,0
197735,21042,210,42,-2,3,3,0,0,0,0,0,0,0,0,0,0,0,0,0,0,0,0,3,3,0,0,0,0,0,0,0,0,0,0
197814,21042,210,42,-2,5,3,2,0,0,0,0,0,0,1,0,1,0,0,0,0,0,0,4,3,1,0,0,0,0,0,0,0,0,0
197850,21042,210,42,-2,10,4,6,0,0,0,0,0,0,1,0,1,0,0,0,0,0,0,9,4,5,0,0,0,0,0,0,0,0,0
197869,21042,210,42,-2,30,14,16,0,0,0,2,1,1,1,0,1,0,0,0,0,0,0,20,8,12,1,0,1,2,2,0,4,3,1
197887,21042,210,42,-2,11,6,5,0,0,0,0,0,0,0,0,0,0,0,0,0,0,0,11,6,5,0,0,0,0,0,0,0,0,0
197911,21042,210,42,-2,1,0,1,0,0,0,0,0,0,0,0,0,0,0,0,0,0,0,1,0,1,0,0,0,0,0,0,0,0,0
197966,21042,210,42,-2,4,1,3,0,0,0,0,0,0,1,0,1,0,0,0,0,0,0,3,1,2,0,0,0,0,0,0,0,0,0
197984,21042,210,42,-2,1,0,1,0,0,0,0,0,0,0,0,0,1,0,1,0,0,0,0,0,0,0,0,0,0,0,0,0,0,0
197993,21042,210,42,-2,1,0,1,0,0,0,0,0,0,0,0,0,0,0,0,0,0,0,1,0,1,0,0,0,0,0,0,0,0,0
198011,21042,210,42,-2,6,4,2,2,0,2,0,0,0,0,0,0,0,0,0,0,0,0,4,4,0,0,0,0,0,0,0,0,0,0
198039,21042,210,42,-2,14,4,10,0,0,0,0,0,0,1,0,1,0,0,0,0,0,0,13,4,9,0,0,0,0,0,0,0,0,0
198084,21042,210,42,-2,4,0,4,0,0,0,0,0,0,1,0,1,0,0,0,0,0,0,3,0,3,0,0,0,0,0,0,0,0,0
198118,21042,210,42,-2,14,6,8,0,0,0,0,0,0,0,0,0,0,0,0,0,0,0,14,6,8,0,0,0,0,0,0,0,0,0
198136,21042,210,42,-2,3,3,0,0,0,0,0,0,0,1,1,0,0,0,0,0,0,0,2,2,0,0,0,0,0,0,0,0,0,0
198154,21042,210,42,-2,7,4,3,0,0,0,0,0,0,0,0,0,1,0,1,0,0,0,5,3,2,1,1,0,0,0,0,0,0,0
198206,21042,210,42,-2,4,1,3,0,0,0,0,0,0,0,0,0,0,0,0,0,0,0,4,1,3,0,0,0,0,0,0,0,0,0
198233,21042,210,42,-2,10,5,5,0,0,0,1,1,0,0,0,0,0,0,0,0,0,0,8,4,4,0,0,0,1,0,1,0,0,0
198251,21042,210,42,-2,8,2,6,0,0,0,0,0,0,2,0,2,0,0,0,0,0,0,6,2,4,0,0,0,0,0,0,0,0,0
198260,21042,210,42,-2,14,7,7,0,0,0,0,0,0,1,0,1,0,0,0,0,0,0,11,7,4,0,0,0,2,0,2,0,0,0
198321,21042,210,42,-2,2,1,1,0,0,0,0,0,0,0,0,0,0,0,0,0,0,0,2,1,1,0,0,0,0,0,0,0,0,0
198330,21042,210,42,-2,9,5,4,0,0,0,0,0,0,0,0,0,0,0,0,0,0,0,9,5,4,0,0,0,0,0,0,0,0,0
198367,21042,210,42,-2,3,1,2,0,0,0,0,0,0,0,0,0,0,0,0,0,0,0,3,1,2,0,0,0,0,0,0,0,0,0
198376,21042,210,42,-2,15,5,10,0,0,0,0,0,0,1,1,0,0,0,0,0,0,0,13,4,9,1,0,1,0,0,0,0,0,0
198385,21042,210,42,-2,4,2,2,0,0,0,0,0,0,0,0,0,1,1,0,0,0,0,3,1,2,0,0,0,0,0,0,0,0,0
198419,21042,210,42,-2,80,43,37,0,0,0,12,6,6,5,1,4,7,4,3,0,0,0,48,28,20,0,0,0,0,0,0,8,4,4
198455,21042,210,42,-2,7,4,3,0,0,0,0,0,0,5,3,2,0,0,0,0,0,0,2,1,1,0,0,0,0,0,0,0,0,0
198464,21042,210,42,-2,2,1,1,0,0,0,0,0,0,0,0,0,0,0,0,0,0,0,2,1,1,0,0,0,0,0,0,0,0,0
198491,21042,210,42,-2,7,2,5,0,0,0,0,0,0,2,1,1,0,0,0,0,0,0,5,1,4,0,0,0,0,0,0,0,0,0
198507,21042,210,42,-2,3,1,2,0,0,0,0,0,0,3,1,2,0,0,0,0,0,0,0,0,0,0,0,0,0,0,0,0,0,0
198516,21042,210,42,-2,23,7,16,0,0,0,2,1,1,3,0,3,1,0,1,0,0,0,17,6,11,0,0,0,0,0,0,0,0,0
198534,21042,210,42,-2,33,16,17,3,2,1,2,2,0,11,5,6,0,0,0,0,0,0,17,7,10,0,0,0,0,0,0,0,0,0
198543,21042,210,42,-2,8,2,6,0,0,0,1,1,0,6,0,6,0,0,0,0,0,0,1,1,0,0,0,0,0,0,0,0,0,0
198561,21042,210,42,-2,5,0,5,0,0,0,0,0,0,1,0,1,1,0,1,0,0,0,3,0,3,0,0,0,0,0,0,0,0,0
198598,21042,210,42,-2,1,0,1,0,0,0,0,0,0,0,0,0,0,0,0,0,0,0,1,0,1,0,0,0,0,0,0,0,0,0
198613,21042,210,42,-2,5,4,1,0,0,0,2,1,1,0,0,0,0,0,0,0,0,0,3,3,0,0,0,0,0,0,0,0,0,0
198622,21042,210,42,-2,21,8,13,0,0,0,0,0,0,5,0,5,0,0,0,0,0,0,16,8,8,0,0,0,0,0,0,0,0,0
198640,21042,210,42,-2,3,2,1,0,0,0,0,0,0,0,0,0,0,0,0,0,0,0,3,2,1,0,0,0,0,0,0,0,0,0
198668,21042,210,42,-2,4,0,4,0,0,0,0,0,0,0,0,0,0,0,0,0,0,0,4,0,4,0,0,0,0,0,0,0,0,0
198695,21042,210,42,-2,27,12,15,0,0,0,1,1,0,3,1,2,1,0,1,0,0,0,21,10,11,1,0,1,0,0,0,0,0,0
198710,21042,210,42,-2,2,0,2,0,0,0,0,0,0,0,0,0,0,0,0,0,0,0,2,0,2,0,0,0,0,0,0,0,0,0
198729,21042,210,42,-2,2,0,2,0,0,0,0,0,0,0,0,0,1,0,1,0,0,0,1,0,1,0,0,0,0,0,0,0,0,0
198756,21042,210,42,-2,6,4,2,0,0,0,1,1,0,3,1,2,0,0,0,0,0,0,2,2,0,0,0,0,0,0,0,0,0,0
198774,21042,210,42,-2,7,2,5,0,0,0,0,0,0,0,0,0,0,0,0,0,0,0,7,2,5,0,0,0,0,0,0,0,0,0
198808,21042,210,42,-2,11,5,6,0,0,0,0,0,0,0,0,0,1,1,0,0,0,0,10,4,6,0,0,0,0,0,0,0,0,0
198817,21042,210,42,-2,9,3,6,0,0,0,0,0,0,0,0,0,0,0,0,0,0,0,9,3,6,0,0,0,0,0,0,0,0,0
198835,21042,210,42,-2,11,6,5,0,0,0,1,1,0,1,1,0,0,0,0,0,0,0,8,3,5,0,0,0,1,1,0,0,0,0
198862,21042,210,42,-2,8,2,6,0,0,0,0,0,0,6,2,4,0,0,0,0,0,0,2,0,2,0,0,0,0,0,0,0,0,0
198871,21042,210,42,-2,3,1,2,0,0,0,0,0,0,1,0,1,0,0,0,0,0,0,2,1,1,0,0,0,0,0,0,0,0,0
198899,21042,210,42,-2,1,0,1,0,0,0,0,0,0,0,0,0,0,0,0,0,0,0,1,0,1,0,0,0,0,0,0,0,0,0
198905,21042,210,42,-2,1,1,0,0,0,0,0,0,0,0,0,0,0,0,0,0,0,0,1,1,0,0,0,0,0,0,0,0,0,0
198923,21042,210,42,-2,3,2,1,0,0,0,0,0,0,0,0,0,0,0,0,0,0,0,3,2,1,0,0,0,0,0,0,0,0,0
198950,21042,210,42,-2,5,3,2,0,0,0,0,0,0,0,0,0,1,1,0,0,0,0,3,2,1,0,0,0,1,0,1,0,0,0
198969,21042,210,42,-2,2,0,2,0,0,0,0,0,0,1,0,1,0,0,0,0,0,0,1,0,1,0,0,0,0,0,0,0,0,0
198987,21042,210,42,-2,5,3,2,0,0,0,0,0,0,0,0,0,0,0,0,0,0,0,5,3,2,0,0,0,0,0,0,0,0,0
199023,21042,210,42,-2,4,0,4,0,0,0,0,0,0,0,0,0,0,0,0,0,0,0,4,0,4,0,0,0,0,0,0,0,0,0
199032,21042,210,42,-2,6,3,3,0,0,0,0,0,0,2,0,2,0,0,0,0,0,0,4,3,1,0,0,0,0,0,0,0,0,0
199069,21042,210,42,-2,3,1,2,0,0,0,0,0,0,0,0,0,0,0,0,0,0,0,3,1,2,0,0,0,0,0,0,0,0,0
199087,21042,210,42,-2,6,3,3,0,0,0,0,0,0,0,0,0,0,0,0,0,0,0,5,3,2,1,0,1,0,0,0,0,0,0
199102,21042,210,42,-2,2,1,1,0,0,0,0,0,0,1,1,0,0,0,0,0,0,0,1,0,1,0,0,0,0,0,0,0,0,0
199111,21042,210,42,-2,5,2,3,0,0,0,0,0,0,1,0,1,1,0,1,0,0,0,1,0,1,0,0,0,2,2,0,0,0,0
199120,21042,210,42,-2,37,13,24,0,0,0,0,0,0,3,0,3,0,0,0,0,0,0,15,4,11,2,0,2,15,8,7,2,1,1
199139,21042,210,42,-2,13,8,5,0,0,0,0,0,0,3,2,1,1,0,1,0,0,0,8,5,3,0,0,0,0,0,0,1,1,0
199148,21042,210,42,-2,34,14,20,0,0,0,1,0,1,3,0,3,1,1,0,0,0,0,26,11,15,0,0,0,0,0,0,3,2,1
199157,21042,210,42,-2,9,3,6,0,0,0,0,0,0,3,2,1,0,0,0,0,0,0,4,0,4,0,0,0,2,1,1,0,0,0
199193,21042,210,42,-2,5,3,2,0,0,0,0,0,0,1,0,1,0,0,0,0,0,0,4,3,1,0,0,0,0,0,0,0,0,0
199209,21042,210,42,-2,3,1,2,0,0,0,0,0,0,0,0,0,0,0,0,0,0,0,3,1,2,0,0,0,0,0,0,0,0,0
199218,21042,210,42,-2,25,7,18,0,0,0,0,0,0,1,1,0,2,0,2,0,0,0,18,4,14,2,1,1,2,1,1,0,0,0
199263,21042,210,42,-2,2,2,0,0,0,0,0,0,0,0,0,0,0,0,0,0,0,0,2,2,0,0,0,0,0,0,0,0,0,0
199281,21042,210,42,-2,11,4,7,1,0,1,0,0,0,2,0,2,0,0,0,0,0,0,8,4,4,0,0,0,0,0,0,0,0,0
199306,21042,210,42,-2,7,3,4,0,0,0,0,0,0,0,0,0,0,0,0,0,0,0,7,3,4,0,0,0,0,0,0,0,0,0
199324,21042,210,42,-2,9,6,3,0,0,0,0,0,0,2,2,0,1,0,1,0,0,0,6,4,2,0,0,0,0,0,0,0,0,0
199333,21042,210,42,-2,6,1,5,0,0,0,0,0,0,1,0,1,0,0,0,0,0,0,5,1,4,0,0,0,0,0,0,0,0,0
199412,21042,210,42,-2,2,0,2,0,0,0,0,0,0,1,0,1,1,0,1,0,0,0,0,0,0,0,0,0,0,0,0,0,0,0
199421,21042,210,42,-2,2,0,2,0,0,0,0,0,0,0,0,0,0,0,0,0,0,0,1,0,1,0,0,0,1,0,1,0,0,0
199449,21042,210,42,-2,13,7,6,0,0,0,0,0,0,1,1,0,0,0,0,0,0,0,12,6,6,0,0,0,0,0,0,0,0,0
199458,21042,210,42,-2,1,1,0,0,0,0,0,0,0,0,0,0,0,0,0,0,0,0,1,1,0,0,0,0,0,0,0,0,0,0
199467,21042,210,42,-2,2,0,2,0,0,0,0,0,0,0,0,0,0,0,0,0,0,0,2,0,2,0,0,0,0,0,0,0,0,0
199476,21042,210,42,-2,3,1,2,1,1,0,0,0,0,1,0,1,0,0,0,0,0,0,1,0,1,0,0,0,0,0,0,0,0,0
199485,21042,210,42,-2,1,0,1,0,0,0,0,0,0,0,0,0,0,0,0,0,0,0,1,0,1,0,0,0,0,0,0,0,0,0
199494,21042,210,42,-2,5,2,3,0,0,0,0,0,0,2,2,0,0,0,0,0,0,0,3,0,3,0,0,0,0,0,0,0,0,0
199582,21042,210,42,-2,1,1,0,0,0,0,0,0,0,1,1,0,0,0,0,0,0,0,0,0,0,0,0,0,0,0,0,0,0,0
199625,21042,210,42,-2,8,4,4,1,0,1,0,0,0,1,1,0,0,0,0,0,0,0,6,3,3,0,0,0,0,0,0,0,0,0
199634,21042,210,42,-2,7,4,3,0,0,0,0,0,0,0,0,0,0,0,0,0,0,0,7,4,3,0,0,0,0,0,0,0,0,0
199643,21042,210,42,-2,8,2,6,0,0,0,0,0,0,8,2,6,0,0,0,0,0,0,0,0,0,0,0,0,0,0,0,0,0,0
199722,21042,210,42,-2,12,7,5,0,0,0,0,0,0,2,1,1,0,0,0,0,0,0,10,6,4,0,0,0,0,0,0,0,0,0
199731,21042,210,42,-2,4,1,3,0,0,0,0,0,0,0,0,0,0,0,0,0,0,0,4,1,3,0,0,0,0,0,0,0,0,0
199740,21042,210,42,-2,3,1,2,0,0,0,0,0,0,1,0,1,0,0,0,0,0,0,2,1,1,0,0,0,0,0,0,0,0,0
199768,21042,210,42,-2,4,2,2,0,0,0,0,0,0,0,0,0,0,0,0,0,0,0,4,2,2,0,0,0,0,0,0,0,0,0
199786,21042,210,42,-2,6,1,5,0,0,0,0,0,0,0,0,0,0,0,0,0,0,0,6,1,5,0,0,0,0,0,0,0,0,0
199795,21042,210,42,-2,3,1,2,0,0,0,0,0,0,0,0,0,0,0,0,0,0,0,3,1,2,0,0,0,0,0,0,0,0,0
199838,21042,210,42,-2,1,1,0,0,0,0,1,1,0,0,0,0,0,0,0,0,0,0,0,0,0,0,0,0,0,0,0,0,0,0
199847,21042,210,42,-2,95,56,39,0,0,0,17,11,6,8,2,6,2,1,1,0,0,0,61,39,22,2,0,2,0,0,0,5,3,2
199856,21042,210,42,-2,30,22,8,0,0,0,2,2,0,4,1,3,0,0,0,0,0,0,19,14,5,0,0,0,5,5,0,0,0,0
199865,21042,210,42,-2,2,0,2,0,0,0,0,0,0,0,0,0,0,0,0,0,0,0,1,0,1,0,0,0,0,0,0,1,0,1
199892,21042,210,42,-2,10,3,7,0,0,0,0,0,0,0,0,0,0,0,0,0,0,0,10,3,7,0,0,0,0,0,0,0,0,0
199908,21042,210,42,-2,2,1,1,0,0,0,0,0,0,0,0,0,0,0,0,0,0,0,2,1,1,0,0,0,0,0,0,0,0,0
199926,21042,210,42,-2,3,3,0,0,0,0,0,0,0,0,0,0,0,0,0,0,0,0,3,3,0,0,0,0,0,0,0,0,0,0
199962,21042,210,42,-2,6,3,3,0,0,0,1,0,1,1,1,0,0,0,0,0,0,0,4,2,2,0,0,0,0,0,0,0,0,0
199999,21042,210,42,-2,1,1,0,0,0,0,0,0,0,1,1,0,0,0,0,0,0,0,0,0,0,0,0,0,0,0,0,0,0,0
200004,21042,210,42,-2,15,8,7,0,0,0,0,0,0,2,1,1,2,1,1,0,0,0,10,5,5,0,0,0,0,0,0,1,1,0
200022,21042,210,42,-2,1,0,1,0,0,0,0,0,0,0,0,0,0,0,0,0,0,0,1,0,1,0,0,0,0,0,0,0,0,0
200059,21042,210,42,-2,2,1,1,0,0,0,0,0,0,0,0,0,0,0,0,0,0,0,2,1,1,0,0,0,0,0,0,0,0,0
200192,21042,210,42,-2,1,0,1,0,0,0,0,0,0,0,0,0,0,0,0,0,0,0,1,0,1,0,0,0,0,0,0,0,0,0
200208,21042,210,42,-2,3,2,1,2,1,1,0,0,0,0,0,0,0,0,0,0,0,0,1,1,0,0,0,0,0,0,0,0,0,0
200253,21042,210,42,-2,5,3,2,0,0,0,0,0,0,0,0,0,0,0,0,0,0,0,5,3,2,0,0,0,0,0,0,0,0,0
200280,21042,210,42,-2,13,6,7,0,0,0,1,0,1,2,1,1,0,0,0,0,0,0,7,2,5,0,0,0,0,0,0,3,3,0
200314,21042,210,42,-2,3,1,2,1,0,1,0,0,0,0,0,0,0,0,0,0,0,0,2,1,1,0,0,0,0,0,0,0,0,0
200332,21042,210,42,-2,16,5,11,0,0,0,2,1,1,0,0,0,0,0,0,0,0,0,14,4,10,0,0,0,0,0,0,0,0,0
200554,21042,210,42,-2,1,1,0,0,0,0,0,0,0,0,0,0,0,0,0,0,0,0,1,1,0,0,0,0,0,0,0,0,0,0
200572,21042,210,42,-2,4,2,2,0,0,0,0,0,0,0,0,0,0,0,0,0,0,0,4,2,2,0,0,0,0,0,0,0,0,0
200800,21042,210,42,-2,15,6,9,0,0,0,2,1,1,1,0,1,1,0,1,0,0,0,8,4,4,0,0,0,0,0,0,3,1,2
201104,21042,210,42,-2,8,2,6,0,0,0,0,0,0,2,0,2,0,0,0,0,0,0,6,2,4,0,0,0,0,0,0,0,0,0
201140,21042,210,42,-2,1,1,0,0,0,0,0,0,0,0,0,0,0,0,0,0,0,0,1,1,0,0,0,0,0,0,0,0,0,0
201195,21042,210,42,-2,3,1,2,0,0,0,1,0,1,0,0,0,1,1,0,0,0,0,1,0,1,0,0,0,0,0,0,0,0,0
201283,21042,210,42,-2,1,1,0,0,0,0,0,0,0,0,0,0,0,0,0,0,0,0,1,1,0,0,0,0,0,0,0,0,0,0
201432,21042,210,42,-2,3,3,0,0,0,0,0,0,0,0,0,0,0,0,0,0,0,0,2,2,0,0,0,0,1,1,0,0,0,0
201441,21042,210,42,-2,25,5,20,0,0,0,0,0,0,1,0,1,0,0,0,0,0,0,12,2,10,0,0,0,12,3,9,0,0,0
201548,21042,210,42,-2,7,2,5,0,0,0,0,0,0,0,0,0,0,0,0,0,0,0,7,2,5,0,0,0,0,0,0,0,0,0
201645,21042,210,42,-2,16,12,4,0,0,0,3,3,0,2,2,0,2,1,1,0,0,0,7,5,2,0,0,0,0,0,0,2,1,1
201654,21042,210,42,-2,11,3,8,0,0,0,0,0,0,1,1,0,0,0,0,0,0,0,10,2,8,0,0,0,0,0,0,0,0,0
201672,21042,210,42,-2,1,1,0,0,0,0,0,0,0,0,0,0,0,0,0,0,0,0,1,1,0,0,0,0,0,0,0,0,0,0
201964,21042,210,42,-2,1,1,0,0,0,0,0,0,0,0,0,0,0,0,0,0,0,0,1,1,0,0,0,0,0,0,0,0,0,0
201973,21042,210,42,-2,8,1,7,0,0,0,0,0,0,0,0,0,0,0,0,0,0,0,7,0,7,0,0,0,1,1,0,0,0,0
202046,21042,210,42,-2,4,2,2,0,0,0,0,0,0,0,0,0,0,0,0,0,0,0,4,2,2,0,0,0,0,0,0,0,0,0
202073,21042,210,42,-2,2,1,1,0,0,0,0,0,0,0,0,0,0,0,0,0,0,0,2,1,1,0,0,0,0,0,0,0,0,0
202134,21042,210,42,-2,14,10,4,0,0,0,1,1,0,0,0,0,0,0,0,0,0,0,11,8,3,0,0,0,0,0,0,2,1,1
202222,21042,210,42,-2,3,1,2,0,0,0,0,0,0,0,0,0,0,0,0,0,0,0,2,0,2,0,0,0,1,1,0,0,0,0
202480,21042,210,42,-2,42,26,16,0,0,0,3,2,1,2,2,0,1,1,0,0,0,0,36,21,15,0,0,0,0,0,0,0,0,0
202514,21042,210,42,-2,1,0,1,0,0,0,0,0,0,0,0,0,0,0,0,0,0,0,1,0,1,0,0,0,0,0,0,0,0,0
202523,21042,210,42,-2,13,5,8,0,0,0,1,1,0,1,0,1,0,0,0,0,0,0,11,4,7,0,0,0,0,0,0,0,0,0
202763,21042,210,42,-2,5,3,2,0,0,0,0,0,0,1,1,0,0,0,0,0,0,0,4,2,2,0,0,0,0,0,0,0,0,0
203085,21042,210,42,-2,2,1,1,0,0,0,0,0,0,0,0,0,0,0,0,0,0,0,2,1,1,0,0,0,0,0,0,0,0,0
203128,21042,210,42,-2,2,1,1,0,0,0,1,0,1,0,0,0,0,0,0,0,0,0,1,1,0,0,0,0,0,0,0,0,0,0
203483,21042,210,42,-2,1,1,0,0,0,0,0,0,0,0,0,0,0,0,0,0,0,0,1,1,0,0,0,0,0,0,0,0,0,0
203492,21042,210,42,-2,2,1,1,0,0,0,0,0,0,0,0,0,0,0,0,0,0,0,1,0,1,0,0,0,0,0,0,1,1,0
203517,21042,210,42,-2,16,8,8,0,0,0,0,0,0,1,0,1,0,0,0,0,0,0,11,5,6,0,0,0,1,1,0,3,2,1
203535,21042,210,42,-2,26,4,22,0,0,0,1,0,1,0,0,0,2,0,2,0,0,0,4,0,4,0,0,0,18,4,14,1,0,1
203544,21042,210,42,-2,4,2,2,0,0,0,0,0,0,1,1,0,0,0,0,0,0,0,3,1,2,0,0,0,0,0,0,0,0,0
203678,21042,210,42,-2,8,4,4,0,0,0,1,1,0,0,0,0,0,0,0,0,0,0,7,3,4,0,0,0,0,0,0,0,0,0
203748,21042,210,42,-2,2,0,2,0,0,0,0,0,0,0,0,0,0,0,0,0,0,0,2,0,2,0,0,0,0,0,0,0,0,0
203757,21042,210,42,-2,10,1,9,0,0,0,0,0,0,0,0,0,0,0,0,0,0,0,8,0,8,0,0,0,2,1,1,0,0,0
203775,21042,210,42,-2,2,1,1,0,0,0,0,0,0,1,1,0,0,0,0,0,0,0,1,0,1,0,0,0,0,0,0,0,0,0
203845,21042,210,42,-2,12,7,5,0,0,0,0,0,0,0,0,0,1,1,0,0,0,0,11,6,5,0,0,0,0,0,0,0,0,0
203881,21042,210,42,-2,1,0,1,0,0,0,0,0,0,0,0,0,0,0,0,0,0,0,1,0,1,0,0,0,0,0,0,0,0,0
203960,21042,210,42,-2,8,0,8,0,0,0,0,0,0,1,0,1,0,0,0,0,0,0,7,0,7,0,0,0,0,0,0,0,0,0
204176,21042,210,42,-2,4,0,4,0,0,0,0,0,0,0,0,0,0,0,0,0,0,0,4,0,4,0,0,0,0,0,0,0,0,0
204185,21042,210,42,-2,2,2,0,0,0,0,1,1,0,0,0,0,0,0,0,0,0,0,1,1,0,0,0,0,0,0,0,0,0,0
204194,21042,210,42,-2,5,4,1,0,0,0,1,1,0,1,1,0,1,1,0,0,0,0,1,1,0,1,0,1,0,0,0,0,0,0
204200,21042,210,42,-2,4,0,4,0,0,0,0,0,0,0,0,0,0,0,0,0,0,0,4,0,4,0,0,0,0,0,0,0,0,0
204255,21042,210,42,-2,2,0,2,0,0,0,0,0,0,0,0,0,0,0,0,0,0,0,2,0,2,0,0,0,0,0,0,0,0,0
204422,21042,210,42,-2,6,3,3,0,0,0,1,1,0,2,1,1,0,0,0,2,1,1,1,0,1,0,0,0,0,0,0,0,0,0
204477,21042,210,42,-2,4,3,1,0,0,0,0,0,0,0,0,0,0,0,0,0,0,0,4,3,1,0,0,0,0,0,0,0,0,0
204501,21042,210,42,-2,9,4,5,0,0,0,0,0,0,0,0,0,1,1,0,0,0,0,5,3,2,0,0,0,0,0,0,3,0,3
204617,21042,210,42,-2,1,1,0,0,0,0,1,1,0,0,0,0,0,0,0,0,0,0,0,0,0,0,0,0,0,0,0,0,0,0
204635,21042,210,42,-2,7,5,2,0,0,0,1,0,1,0,0,0,0,0,0,0,0,0,6,5,1,0,0,0,0,0,0,0,0,0
204820,21042,210,42,-2,1,0,1,0,0,0,0,0,0,0,0,0,0,0,0,0,0,0,1,0,1,0,0,0,0,0,0,0,0,0
204839,21042,210,42,-2,2,1,1,0,0,0,0,0,0,0,0,0,0,0,0,0,0,0,2,1,1,0,0,0,0,0,0,0,0,0
204848,21042,210,42,-2,1,1,0,0,0,0,0,0,0,0,0,0,0,0,0,0,0,0,1,1,0,0,0,0,0,0,0,0,0,0
204857,21042,210,42,-2,12,2,10,0,0,0,1,0,1,1,0,1,0,0,0,0,0,0,7,1,6,0,0,0,2,0,2,1,1,0
204866,21042,210,42,-2,1,0,1,0,0,0,0,0,0,0,0,0,0,0,0,0,0,0,1,0,1,0,0,0,0,0,0,0,0,0
204909,21042,210,42,-2,5,3,2,0,0,0,0,0,0,0,0,0,0,0,0,0,0,0,4,3,1,0,0,0,1,0,1,0,0,0
205203,21042,210,42,-2,1,1,0,0,0,0,0,0,0,0,0,0,0,0,0,0,0,0,1,1,0,0,0,0,0,0,0,0,0,0
205391,21042,210,42,-2,1,1,0,0,0,0,0,0,0,0,0,0,0,0,0,0,0,0,1,1,0,0,0,0,0,0,0,0,0,0
205841,21042,210,42,-2,10,5,5,0,0,0,0,0,0,0,0,0,0,0,0,0,0,0,9,4,5,0,0,0,1,1,0,0,0,0
205957,21042,210,42,-2,2,0,2,0,0,0,0,0,0,0,0,0,0,0,0,0,0,0,2,0,2,0,0,0,0,0,0,0,0,0
206048,21042,210,42,-2,8,7,1,0,0,0,0,0,0,0,0,0,0,0,0,0,0,0,7,6,1,1,1,0,0,0,0,0,0,0
206084,21042,210,42,-2,3,1,2,0,0,0,0,0,0,0,0,0,0,0,0,0,0,0,3,1,2,0,0,0,0,0,0,0,0,0
206279,21042,210,42,-2,1,0,1,0,0,0,0,0,0,0,0,0,0,0,0,0,0,0,1,0,1,0,0,0,0,0,0,0,0,0
206349,21042,210,42,-2,9,0,9,0,0,0,0,0,0,0,0,0,0,0,0,0,0,0,9,0,9,0,0,0,0,0,0,0,0,0
206437,21042,210,42,-2,4,3,1,0,0,0,0,0,0,1,1,0,0,0,0,0,0,0,2,1,1,0,0,0,1,1,0,0,0,0
206446,21042,210,42,-2,11,3,8,0,0,0,0,0,0,0,0,0,1,1,0,0,0,0,10,2,8,0,0,0,0,0,0,0,0,0
206507,21042,210,42,-2,4,2,2,0,0,0,0,0,0,0,0,0,0,0,0,0,0,0,4,2,2,0,0,0,0,0,0,0,0,0
206525,21042,210,42,-2,1,0,1,0,0,0,0,0,0,0,0,0,0,0,0,0,0,0,1,0,1,0,0,0,0,0,0,0,0,0
206589,21042,210,42,-2,11,4,7,0,0,0,0,0,0,1,0,1,1,1,0,0,0,0,7,1,6,0,0,0,0,0,0,2,2,0
206604,21042,210,42,-2,7,3,4,0,0,0,1,1,0,1,0,1,0,0,0,0,0,0,4,1,3,0,0,0,0,0,0,1,1,0
206622,21042,210,42,-2,14,5,9,0,0,0,0,0,0,0,0,0,0,0,0,0,0,0,14,5,9,0,0,0,0,0,0,0,0,0
206695,21042,210,42,-2,21,11,10,0,0,0,0,0,0,0,0,0,0,0,0,0,0,0,15,8,7,1,0,1,0,0,0,5,3,2
206862,21042,210,42,-2,9,4,5,0,0,0,1,0,1,0,0,0,0,0,0,0,0,0,7,4,3,1,0,1,0,0,0,0,0,0
206914,21042,210,42,-2,1,1,0,0,0,0,0,0,0,0,0,0,0,0,0,0,0,0,0,0,0,1,1,0,0,0,0,0,0,0
206941,21042,210,42,-2,33,13,20,0,0,0,0,0,0,1,0,1,2,1,1,1,1,0,21,5,16,0,0,0,7,5,2,1,1,0
206996,21042,210,42,-2,7,4,3,1,1,0,1,1,0,0,0,0,1,0,1,0,0,0,4,2,2,0,0,0,0,0,0,0,0,0
207041,21042,210,42,-2,3,2,1,0,0,0,0,0,0,0,0,0,0,0,0,0,0,0,3,2,1,0,0,0,0,0,0,0,0,0
207157,21042,210,42,-2,4,4,0,1,1,0,0,0,0,0,0,0,0,0,0,0,0,0,3,3,0,0,0,0,0,0,0,0,0,0
207209,21042,210,42,-2,6,1,5,0,0,0,0,0,0,4,1,3,0,0,0,0,0,0,2,0,2,0,0,0,0,0,0,0,0,0
207263,21042,210,42,-2,3,1,2,0,0,0,0,0,0,0,0,0,0,0,0,0,0,0,3,1,2,0,0,0,0,0,0,0,0,0
207290,21042,210,42,-2,5,2,3,0,0,0,0,0,0,1,1,0,0,0,0,0,0,0,3,1,2,1,0,1,0,0,0,0,0,0
207306,21042,210,42,-2,5,2,3,0,0,0,0,0,0,0,0,0,0,0,0,0,0,0,4,2,2,0,0,0,1,0,1,0,0,0
207315,21042,210,42,-2,22,8,14,1,1,0,1,0,1,1,0,1,1,0,1,0,0,0,17,7,10,1,0,1,0,0,0,0,0,0
207342,21042,210,42,-2,25,17,8,0,0,0,1,1,0,0,0,0,0,0,0,0,0,0,14,7,7,1,1,0,0,0,0,9,8,1
207351,21042,210,42,-2,3,2,1,0,0,0,0,0,0,0,0,0,0,0,0,0,0,0,3,2,1,0,0,0,0,0,0,0,0,0
207388,21042,210,42,-2,102,48,54,1,1,0,7,3,4,4,4,0,7,3,4,0,0,0,49,15,34,5,1,4,1,0,1,28,21,7
207403,21042,210,42,-2,1,1,0,0,0,0,0,0,0,0,0,0,0,0,0,0,0,0,1,1,0,0,0,0,0,0,0,0,0,0
207449,21042,210,42,-2,14,7,7,0,0,0,3,1,2,0,0,0,0,0,0,0,0,0,9,5,4,2,1,1,0,0,0,0,0,0
207458,21042,210,42,-2,16,10,6,0,0,0,1,1,0,0,0,0,0,0,0,0,0,0,14,8,6,0,0,0,0,0,0,1,1,0
207500,21042,210,42,-2,28,14,14,1,1,0,3,1,2,1,1,0,4,2,2,0,0,0,12,5,7,0,0,0,0,0,0,7,4,3
207582,21042,210,42,-2,3,3,0,0,0,0,0,0,0,0,0,0,0,0,0,0,0,0,2,2,0,0,0,0,0,0,0,1,1,0
207670,21042,210,42,-2,1,0,1,0,0,0,0,0,0,1,0,1,0,0,0,0,0,0,0,0,0,0,0,0,0,0,0,0,0,0
207722,21042,210,42,-2,2,0,2,0,0,0,0,0,0,0,0,0,0,0,0,0,0,0,2,0,2,0,0,0,0,0,0,0,0,0
207740,21042,210,42,-2,1,0,1,0,0,0,0,0,0,0,0,0,0,0,0,0,0,0,1,0,1,0,0,0,0,0,0,0,0,0
207847,21042,210,42,-2,4,2,2,0,0,0,0,0,0,0,0,0,0,0,0,0,0,0,4,2,2,0,0,0,0,0,0,0,0,0
207856,21042,210,42,-2,2,0,2,0,0,0,0,0,0,0,0,0,0,0,0,0,0,0,2,0,2,0,0,0,0,0,0,0,0,0
207865,21042,210,42,-2,7,1,6,0,0,0,0,0,0,0,0,0,0,0,0,0,0,0,7,1,6,0,0,0,0,0,0,0,0,0
207935,21042,210,42,-2,15,6,9,1,1,0,0,0,0,2,1,1,4,2,2,0,0,0,6,1,5,2,1,1,0,0,0,0,0,0
207971,21042,210,42,-2,5,3,2,0,0,0,0,0,0,0,0,0,0,0,0,0,0,0,3,1,2,0,0,0,2,2,0,0,0,0
208390,21042,210,42,-2,11,7,4,0,0,0,0,0,0,0,0,0,2,1,1,0,0,0,6,4,2,0,0,0,2,1,1,1,1,0
208406,21042,210,42,-2,3,1,2,0,0,0,0,0,0,0,0,0,0,0,0,0,0,0,3,1,2,0,0,0,0,0,0,0,0,0
208415,21042,210,42,-2,2,1,1,0,0,0,0,0,0,0,0,0,1,0,1,0,0,0,1,1,0,0,0,0,0,0,0,0,0,0
208646,21042,210,42,-2,7,3,4,0,0,0,0,0,0,0,0,0,0,0,0,0,0,0,5,2,3,0,0,0,2,1,1,0,0,0
208822,21042,210,42,-2,10,3,7,0,0,0,0,0,0,1,0,1,0,0,0,0,0,0,8,2,6,0,0,0,1,1,0,0,0,0
209038,21042,210,42,-2,12,3,9,0,0,0,1,1,0,0,0,0,2,2,0,0,0,0,9,0,9,0,0,0,0,0,0,0,0,0
209056,21042,210,42,-2,2,1,1,0,0,0,0,0,0,1,0,1,0,0,0,0,0,0,1,1,0,0,0,0,0,0,0,0,0,0
209065,21042,210,42,-2,1,1,0,0,0,0,0,0,0,0,0,0,0,0,0,0,0,0,1,1,0,0,0,0,0,0,0,0,0,0
209074,21042,210,42,-2,7,1,6,0,0,0,0,0,0,0,0,0,2,0,2,0,0,0,0,0,0,1,0,1,3,1,2,1,0,1
209241,21042,210,42,-2,3,3,0,0,0,0,0,0,0,0,0,0,2,2,0,0,0,0,1,1,0,0,0,0,0,0,0,0,0,0
209250,21042,210,42,-2,1,0,1,0,0,0,0,0,0,0,0,0,0,0,0,0,0,0,1,0,1,0,0,0,0,0,0,0,0,0
209287,21042,210,42,-2,1,1,0,0,0,0,1,1,0,0,0,0,0,0,0,0,0,0,0,0,0,0,0,0,0,0,0,0,0,0
209409,21042,210,42,-2,3,2,1,0,0,0,0,0,0,0,0,0,1,1,0,0,0,0,2,1,1,0,0,0,0,0,0,0,0,0
209490,21042,210,42,-2,219,96,123,0,0,0,45,21,24,8,3,5,8,5,3,1,0,1,118,47,71,4,0,4,24,14,10,11,6,5
209506,21042,210,42,-2,6,2,4,0,0,0,1,0,1,0,0,0,0,0,0,0,0,0,4,1,3,0,0,0,0,0,0,1,1,0
209542,21042,210,42,-2,35,14,21,0,0,0,2,1,1,0,0,0,4,2,2,0,0,0,11,5,6,0,0,0,16,4,12,2,2,0
209551,21042,210,42,-2,3,2,1,0,0,0,0,0,0,0,0,0,0,0,0,0,0,0,2,1,1,0,0,0,1,1,0,0,0,0
209612,21042,210,42,-2,10,4,6,0,0,0,1,1,0,1,0,1,0,0,0,0,0,0,7,2,5,1,1,0,0,0,0,0,0,0
209746,21042,210,42,-2,5,2,3,0,0,0,0,0,0,0,0,0,2,1,1,0,0,0,2,0,2,0,0,0,1,1,0,0,0,0
209807,21042,210,42,-2,5,4,1,0,0,0,0,0,0,0,0,0,0,0,0,0,0,0,3,3,0,1,0,1,0,0,0,1,1,0
209825,21042,210,42,-2,17,4,13,0,0,0,0,0,0,0,0,0,1,1,0,0,0,0,11,2,9,0,0,0,3,0,3,2,1,1
209922,21042,210,42,-2,13,5,8,0,0,0,2,1,1,0,0,0,2,1,1,0,0,0,7,1,6,0,0,0,0,0,0,2,2,0
210146,21042,210,42,-2,2,2,0,0,0,0,0,0,0,0,0,0,0,0,0,0,0,0,2,2,0,0,0,0,0,0,0,0,0,0
210155,21042,210,42,-2,1,0,1,0,0,0,0,0,0,0,0,0,0,0,0,0,0,0,1,0,1,0,0,0,0,0,0,0,0,0
210270,21042,210,42,-2,7,2,5,0,0,0,0,0,0,0,0,0,0,0,0,0,0,0,5,2,3,1,0,1,1,0,1,0,0,0
210304,21042,210,42,-2,3,2,1,0,0,0,0,0,0,1,1,0,0,0,0,0,0,0,1,0,1,0,0,0,1,1,0,0,0,0
210331,21042,210,42,-2,4,3,1,0,0,0,0,0,0,0,0,0,0,0,0,0,0,0,4,3,1,0,0,0,0,0,0,0,0,0
210368,21042,210,42,-2,2,1,1,0,0,0,0,0,0,0,0,0,0,0,0,0,0,0,2,1,1,0,0,0,0,0,0,0,0,0
210429,21042,210,42,-2,4,3,1,0,0,0,0,0,0,0,0,0,0,0,0,0,0,0,2,1,1,1,1,0,0,0,0,1,1,0
210492,21042,210,42,-2,1,1,0,0,0,0,0,0,0,0,0,0,0,0,0,0,0,0,1,1,0,0,0,0,0,0,0,0,0,0
210571,21042,210,42,-2,6,3,3,0,0,0,1,0,1,0,0,0,0,0,0,0,0,0,5,3,2,0,0,0,0,0,0,0,0,0
210669,21042,210,42,-2,3,3,0,0,0,0,0,0,0,0,0,0,2,2,0,0,0,0,1,1,0,0,0,0,0,0,0,0,0,0
210739,21042,210,42,-2,5,2,3,0,0,0,0,0,0,0,0,0,0,0,0,0,0,0,4,1,3,1,1,0,0,0,0,0,0,0
210775,21042,210,42,-2,6,0,6,0,0,0,0,0,0,1,0,1,0,0,0,0,0,0,5,0,5,0,0,0,0,0,0,0,0,0
211088,21042,210,42,-2,5,0,5,0,0,0,1,0,1,1,0,1,0,0,0,0,0,0,3,0,3,0,0,0,0,0,0,0,0,0
211291,21042,210,42,-2,13,6,7,0,0,0,3,1,2,0,0,0,0,0,0,0,0,0,9,5,4,0,0,0,0,0,0,1,0,1
211352,21042,210,42,-2,1,0,1,0,0,0,0,0,0,0,0,0,0,0,0,0,0,0,1,0,1,0,0,0,0,0,0,0,0,0
211431,21042,210,42,-2,3,1,2,0,0,0,0,0,0,0,0,0,0,0,0,0,0,0,3,1,2,0,0,0,0,0,0,0,0,0
211440,21042,210,42,-2,75,57,18,0,0,0,5,4,1,6,3,3,3,3,0,0,0,0,19,14,5,0,0,0,2,1,1,40,32,8
211468,21042,210,42,-2,5,2,3,0,0,0,0,0,0,0,0,0,0,0,0,0,0,0,5,2,3,0,0,0,0,0,0,0,0,0
211477,21042,210,42,-2,7,2,5,0,0,0,0,0,0,2,0,2,1,0,1,0,0,0,4,2,2,0,0,0,0,0,0,0,0,0
211583,21042,210,42,-2,1,0,1,0,0,0,1,0,1,0,0,0,0,0,0,0,0,0,0,0,0,0,0,0,0,0,0,0,0,0
211981,21042,210,42,-2,1,0,1,0,0,0,0,0,0,0,0,0,0,0,0,0,0,0,1,0,1,0,0,0,0,0,0,0,0,0
212009,21042,210,42,-2,9,4,5,0,0,0,0,0,0,0,0,0,1,0,1,0,0,0,3,1,2,0,0,0,0,0,0,5,3,2
212054,21042,210,42,-2,20,7,13,0,0,0,0,0,0,2,0,2,2,1,1,0,0,0,12,4,8,1,0,1,0,0,0,3,2,1
212106,21042,210,42,-2,21,7,14,0,0,0,2,0,2,1,1,0,0,0,0,0,0,0,17,6,11,0,0,0,0,0,0,1,0,1
212133,21042,210,42,-2,8,4,4,0,0,0,0,0,0,0,0,0,0,0,0,0,0,0,6,4,2,0,0,0,2,0,2,0,0,0
212197,21042,210,42,-2,5,3,2,0,0,0,0,0,0,0,0,0,0,0,0,0,0,0,1,0,1,0,0,0,4,3,1,0,0,0
212577,21042,210,42,-2,7,2,5,0,0,0,3,0,3,1,1,0,0,0,0,0,0,0,2,1,1,0,0,0,0,0,0,1,0,1
212601,21042,210,42,-2,11,5,6,0,0,0,1,1,0,1,0,1,0,0,0,0,0,0,8,3,5,0,0,0,1,1,0,0,0,0
212656,21042,210,42,-2,2,1,1,0,0,0,0,0,0,0,0,0,0,0,0,0,0,0,2,1,1,0,0,0,0,0,0,0,0,0
212674,21042,210,42,-2,11,3,8,0,0,0,0,0,0,0,0,0,0,0,0,0,0,0,6,0,6,0,0,0,0,0,0,5,3,2
212832,21042,210,42,-2,3,1,2,0,0,0,0,0,0,0,0,0,0,0,0,0,0,0,3,1,2,0,0,0,0,0,0,0,0,0
212869,21042,210,42,-2,4,1,3,0,0,0,0,0,0,0,0,0,0,0,0,0,0,0,4,1,3,0,0,0,0,0,0,0,0,0
212984,21042,210,42,-2,8,5,3,0,0,0,1,1,0,1,1,0,0,0,0,0,0,0,6,3,3,0,0,0,0,0,0,0,0,0
213011,21042,210,42,-2,2,1,1,0,0,0,1,1,0,0,0,0,0,0,0,0,0,0,1,0,1,0,0,0,0,0,0,0,0,0
213251,21042,210,42,-2,5,2,3,0,0,0,1,1,0,1,0,1,0,0,0,0,0,0,3,1,2,0,0,0,0,0,0,0,0,0
213303,21042,210,42,-2,5,2,3,0,0,0,0,0,0,0,0,0,0,0,0,0,0,0,5,2,3,0,0,0,0,0,0,0,0,0
213321,21042,210,42,-2,2,1,1,0,0,0,0,0,0,0,0,0,0,0,0,0,0,0,2,1,1,0,0,0,0,0,0,0,0,0
213358,21042,210,42,-2,1,0,1,0,0,0,0,0,0,0,0,0,0,0,0,0,0,0,1,0,1,0,0,0,0,0,0,0,0,0
213367,21042,210,42,-2,9,4,5,0,0,0,0,0,0,2,1,1,0,0,0,0,0,0,7,3,4,0,0,0,0,0,0,0,0,0
213385,21042,210,42,-2,9,6,3,0,0,0,0,0,0,0,0,0,0,0,0,0,0,0,8,5,3,0,0,0,0,0,0,1,1,0
213400,21042,210,42,-2,9,5,4,0,0,0,0,0,0,0,0,0,1,1,0,0,0,0,8,4,4,0,0,0,0,0,0,0,0,0
213507,21042,210,42,-2,1,1,0,0,0,0,0,0,0,0,0,0,0,0,0,0,0,0,0,0,0,0,0,0,0,0,0,1,1,0
213525,21042,210,42,-2,3,1,2,0,0,0,1,1,0,0,0,0,0,0,0,0,0,0,2,0,2,0,0,0,0,0,0,0,0,0
213543,21042,210,42,-2,10,6,4,0,0,0,0,0,0,0,0,0,0,0,0,0,0,0,2,1,1,0,0,0,8,5,3,0,0,0
213598,21042,210,42,-2,2,0,2,0,0,0,0,0,0,1,0,1,0,0,0,0,0,0,1,0,1,0,0,0,0,0,0,0,0,0
213631,21042,210,42,-2,1,0,1,0,0,0,1,0,1,0,0,0,0,0,0,0,0,0,0,0,0,0,0,0,0,0,0,0,0,0
213659,21042,210,42,-2,3,1,2,0,0,0,0,0,0,0,0,0,0,0,0,0,0,0,3,1,2,0,0,0,0,0,0,0,0,0
213826,21042,210,42,-2,14,5,9,0,0,0,1,0,1,0,0,0,2,2,0,0,0,0,11,3,8,0,0,0,0,0,0,0,0,0
213987,21042,210,42,-2,6,2,4,0,0,0,1,0,1,0,0,0,0,0,0,0,0,0,5,2,3,0,0,0,0,0,0,0,0,0
213996,21042,210,42,-2,2,1,1,0,0,0,0,0,0,0,0,0,0,0,0,0,0,0,2,1,1,0,0,0,0,0,0,0,0,0
214069,21042,210,42,-2,7,2,5,0,0,0,2,1,1,0,0,0,0,0,0,0,0,0,5,1,4,0,0,0,0,0,0,0,0,0
214157,21042,210,42,-2,2,1,1,0,0,0,1,0,1,0,0,0,0,0,0,0,0,0,1,1,0,0,0,0,0,0,0,0,0,0
214166,21042,210,42,-2,8,2,6,0,0,0,0,0,0,0,0,0,0,0,0,0,0,0,8,2,6,0,0,0,0,0,0,0,0,0
214175,21042,210,42,-2,13,5,8,0,0,0,1,0,1,3,1,2,3,1,2,0,0,0,4,1,3,0,0,0,0,0,0,2,2,0
214272,21042,210,42,-2,6,0,6,0,0,0,0,0,0,2,0,2,0,0,0,0,0,0,4,0,4,0,0,0,0,0,0,0,0,0
214564,21042,210,42,-2,2,1,1,0,0,0,0,0,0,0,0,0,0,0,0,0,0,0,1,1,0,1,0,1,0,0,0,0,0,0
214971,21042,210,42,-2,3,2,1,0,0,0,0,0,0,2,2,0,0,0,0,0,0,0,0,0,0,1,0,1,0,0,0,0,0,0
215053,21042,210,42,-2,1,1,0,0,0,0,0,0,0,0,0,0,0,0,0,0,0,0,1,1,0,0,0,0,0,0,0,0,0,0
215062,21042,210,42,-2,106,43,63,0,0,0,23,14,9,6,1,5,4,1,3,0,0,0,51,16,35,4,1,3,14,8,6,4,2,2
215114,21042,210,42,-2,3,2,1,0,0,0,0,0,0,0,0,0,0,0,0,0,0,0,3,2,1,0,0,0,0,0,0,0,0,0
215123,21042,210,42,-2,10,5,5,1,1,0,3,0,3,0,0,0,0,0,0,0,0,0,5,4,1,1,0,1,0,0,0,0,0,0
215132,21042,210,42,-2,5,3,2,0,0,0,0,0,0,0,0,0,0,0,0,0,0,0,5,3,2,0,0,0,0,0,0,0,0,0
215293,21042,210,42,-2,65,33,32,0,0,0,10,7,3,3,1,2,4,3,1,0,0,0,36,16,20,0,0,0,6,2,4,6,4,2
215770,21042,210,42,-2,5,2,3,0,0,0,0,0,0,2,0,2,1,0,1,0,0,0,2,2,0,0,0,0,0,0,0,0,0,0
215798,21042,210,42,-2,2,0,2,0,0,0,0,0,0,0,0,0,0,0,0,0,0,0,0,0,0,0,0,0,2,0,2,0,0,0
215929,21042,210,42,-2,8,5,3,0,0,0,0,0,0,0,0,0,0,0,0,0,0,0,4,3,1,0,0,0,2,1,1,2,1,1
215947,21042,210,42,-2,6,3,3,0,0,0,0,0,0,1,0,1,0,0,0,0,0,0,5,3,2,0,0,0,0,0,0,0,0,0
216278,21042,210,42,-2,5,5,0,0,0,0,0,0,0,0,0,0,0,0,0,0,0,0,5,5,0,0,0,0,0,0,0,0,0,0
216287,21042,210,42,-2,8,5,3,1,1,0,1,0,1,0,0,0,0,0,0,0,0,0,6,4,2,0,0,0,0,0,0,0,0,0
216357,21042,210,42,-2,1,1,0,0,0,0,0,0,0,0,0,0,0,0,0,0,0,0,1,1,0,0,0,0,0,0,0,0,0,0
216366,21042,210,42,-2,12,2,10,0,0,0,1,0,1,1,0,1,0,0,0,0,0,0,10,2,8,0,0,0,0,0,0,0,0,0
216463,21042,210,42,-2,1,1,0,0,0,0,0,0,0,0,0,0,0,0,0,0,0,0,1,1,0,0,0,0,0,0,0,0,0,0
216524,21042,210,42,-2,4,2,2,0,0,0,0,0,0,0,0,0,0,0,0,0,0,0,4,2,2,0,0,0,0,0,0,0,0,0
216542,21042,210,42,-2,2,0,2,0,0,0,0,0,0,0,0,0,0,0,0,0,0,0,2,0,2,0,0,0,0,0,0,0,0,0
216597,21042,210,42,-2,39,19,20,1,0,1,2,2,0,1,0,1,2,2,0,0,0,0,27,10,17,0,0,0,0,0,0,6,5,1
216694,21042,210,42,-2,4,0,4,0,0,0,0,0,0,0,0,0,0,0,0,0,0,0,4,0,4,0,0,0,0,0,0,0,0,0
216807,21042,210,42,-2,1,1,0,0,0,0,0,0,0,0,0,0,0,0,0,0,0,0,1,1,0,0,0,0,0,0,0,0,0,0
216825,21042,210,42,-2,3,2,1,0,0,0,0,0,0,0,0,0,0,0,0,0,0,0,3,2,1,0,0,0,0,0,0,0,0,0
216852,21042,210,42,-2,9,4,5,0,0,0,2,1,1,0,0,0,1,0,1,0,0,0,4,1,3,0,0,0,0,0,0,2,2,0
216931,21042,210,42,-2,4,1,3,0,0,0,1,0,1,0,0,0,0,0,0,0,0,0,2,1,1,1,0,1,0,0,0,0,0,0
216940,21042,210,42,-2,1,1,0,0,0,0,0,0,0,0,0,0,0,0,0,0,0,0,1,1,0,0,0,0,0,0,0,0,0,0
217013,21042,210,42,-2,4,2,2,0,0,0,0,0,0,0,0,0,0,0,0,0,0,0,3,1,2,0,0,0,1,1,0,0,0,0
217059,21042,210,42,-2,2,1,1,0,0,0,0,0,0,1,0,1,0,0,0,0,0,0,1,1,0,0,0,0,0,0,0,0,0,0
217156,21042,210,42,-2,14,7,7,0,0,0,0,0,0,3,1,2,2,2,0,0,0,0,5,3,2,0,0,0,1,0,1,3,1,2
217402,21042,210,42,-2,21,12,9,0,0,0,0,0,0,0,0,0,0,0,0,0,0,0,20,12,8,1,0,1,0,0,0,0,0,0
217420,21042,210,42,-2,2,0,2,0,0,0,0,0,0,1,0,1,0,0,0,0,0,0,1,0,1,0,0,0,0,0,0,0,0,0
217484,21042,210,42,-2,38,13,25,0,0,0,3,1,2,2,0,2,0,0,0,0,0,0,32,12,20,0,0,0,0,0,0,1,0,1
217493,21042,210,42,-2,12,4,8,0,0,0,1,0,1,1,0,1,0,0,0,0,0,0,3,2,1,0,0,0,2,0,2,5,2,3
217536,21042,210,42,-2,2,1,1,0,0,0,0,0,0,0,0,0,0,0,0,0,0,0,2,1,1,0,0,0,0,0,0,0,0,0
217624,21042,210,42,-2,16,9,7,0,0,0,0,0,0,12,6,6,0,0,0,0,0,0,4,3,1,0,0,0,0,0,0,0,0,0
217633,21042,210,42,-2,10,4,6,0,0,0,1,0,1,0,0,0,0,0,0,0,0,0,9,4,5,0,0,0,0,0,0,0,0,0
217688,21042,210,42,-2,15,4,11,0,0,0,0,0,0,0,0,0,0,0,0,0,0,0,14,4,10,1,0,1,0,0,0,0,0,0
217721,21042,210,42,-2,3,2,1,0,0,0,0,0,0,3,2,1,0,0,0,0,0,0,0,0,0,0,0,0,0,0,0,0,0,0
217749,21042,210,42,-2,10,6,4,0,0,0,0,0,0,0,0,0,0,0,0,0,0,0,10,6,4,0,0,0,0,0,0,0,0,0
217776,21042,210,42,-2,1,0,1,0,0,0,0,0,0,0,0,0,0,0,0,0,0,0,0,0,0,1,0,1,0,0,0,0,0,0
217819,21042,210,42,-2,10,8,2,0,0,0,0,0,0,0,0,0,2,2,0,0,0,0,6,4,2,0,0,0,0,0,0,2,2,0
217864,21042,210,42,-2,4,2,2,0,0,0,0,0,0,0,0,0,1,0,1,0,0,0,0,0,0,0,0,0,3,2,1,0,0,0
217873,21042,210,42,-2,2,0,2,0,0,0,0,0,0,2,0,2,0,0,0,0,0,0,0,0,0,0,0,0,0,0,0,0,0,0
217882,21042,210,42,-2,35,18,17,0,0,0,0,0,0,0,0,0,0,0,0,0,0,0,34,18,16,0,0,0,0,0,0,1,0,1
217907,21042,210,42,-2,5,2,3,0,0,0,0,0,0,0,0,0,0,0,0,0,0,0,5,2,3,0,0,0,0,0,0,0,0,0
217925,21042,210,42,-2,5,3,2,0,0,0,0,0,0,0,0,0,0,0,0,0,0,0,5,3,2,0,0,0,0,0,0,0,0,0
217934,21042,210,42,-2,6,1,5,0,0,0,0,0,0,1,0,1,0,0,0,0,0,0,5,1,4,0,0,0,0,0,0,0,0,0
218061,21042,210,42,-2,1,0,1,0,0,0,0,0,0,0,0,0,0,0,0,0,0,0,1,0,1,0,0,0,0,0,0,0,0,0
218070,21042,210,42,-2,5,1,4,0,0,0,0,0,0,1,0,1,0,0,0,0,0,0,3,1,2,1,0,1,0,0,0,0,0,0
218229,21042,210,42,-2,4,1,3,0,0,0,0,0,0,0,0,0,0,0,0,0,0,0,4,1,3,0,0,0,0,0,0,0,0,0
218238,21042,210,42,-2,1,1,0,0,0,0,0,0,0,0,0,0,0,0,0,0,0,0,1,1,0,0,0,0,0,0,0,0,0,0
218335,21042,210,42,-2,1,1,0,0,0,0,0,0,0,0,0,0,0,0,0,0,0,0,1,1,0,0,0,0,0,0,0,0,0,0
218399,21042,210,42,-2,2,1,1,0,0,0,0,0,0,2,1,1,0,0,0,0,0,0,0,0,0,0,0,0,0,0,0,0,0,0
218441,21042,210,42,-2,14,9,5,0,0,0,0,0,0,1,1,0,0,0,0,0,0,0,13,8,5,0,0,0,0,0,0,0,0,0
218539,21042,210,42,-2,2,0,2,0,0,0,0,0,0,0,0,0,0,0,0,0,0,0,2,0,2,0,0,0,0,0,0,0,0,0
218645,21042,210,42,-2,2,0,2,0,0,0,0,0,0,0,0,0,0,0,0,0,0,0,2,0,2,0,0,0,0,0,0,0,0,0
218663,21042,210,42,-2,31,8,23,0,0,0,0,0,0,5,2,3,0,0,0,0,0,0,23,5,18,3,1,2,0,0,0,0,0,0
218681,21042,210,42,-2,1,0,1,0,0,0,0,0,0,0,0,0,0,0,0,0,0,0,1,0,1,0,0,0,0,0,0,0,0,0
218690,21042,210,42,-2,5,2,3,0,0,0,1,0,1,0,0,0,0,0,0,0,0,0,4,2,2,0,0,0,0,0,0,0,0,0
218706,21042,210,42,-2,1,0,1,0,0,0,0,0,0,0,0,0,0,0,0,0,0,0,1,0,1,0,0,0,0,0,0,0,0,0
218724,21042,210,42,-2,5,3,2,0,0,0,0,0,0,1,1,0,0,0,0,0,0,0,4,2,2,0,0,0,0,0,0,0,0,0
218742,21042,210,42,-2,13,2,11,0,0,0,0,0,0,2,0,2,0,0,0,0,0,0,10,2,8,1,0,1,0,0,0,0,0,0
218821,21042,210,42,-2,4,1,3,0,0,0,0,0,0,1,1,0,0,0,0,0,0,0,3,0,3,0,0,0,0,0,0,0,0,0
218964,21042,210,42,-2,1,0,1,0,0,0,0,0,0,0,0,0,0,0,0,0,0,0,1,0,1,0,0,0,0,0,0,0,0,0
218973,21042,210,42,-2,6,4,2,0,0,0,2,1,1,0,0,0,0,0,0,0,0,0,3,3,0,0,0,0,1,0,1,0,0,0
219000,21042,210,42,-2,2,1,1,0,0,0,1,1,0,0,0,0,0,0,0,0,0,0,1,0,1,0,0,0,0,0,0,0,0,0
219082,21042,210,42,-2,4,3,1,0,0,0,0,0,0,0,0,0,0,0,0,0,0,0,3,3,0,0,0,0,0,0,0,1,0,1
219091,21042,210,42,-2,5,2,3,0,0,0,0,0,0,0,0,0,0,0,0,0,0,0,5,2,3,0,0,0,0,0,0,0,0,0
219143,21042,210,42,-2,15,10,5,0,0,0,0,0,0,0,0,0,0,0,0,0,0,0,15,10,5,0,0,0,0,0,0,0,0,0
219189,21042,210,42,-2,7,3,4,0,0,0,0,0,0,0,0,0,0,0,0,0,0,0,7,3,4,0,0,0,0,0,0,0,0,0
219198,21042,210,42,-2,2,0,2,0,0,0,0,0,0,0,0,0,0,0,0,0,0,0,2,0,2,0,0,0,0,0,0,0,0,0
219259,21042,210,42,-2,1,0,1,0,0,0,0,0,0,0,0,0,0,0,0,0,0,0,1,0,1,0,0,0,0,0,0,0,0,0
219277,21042,210,42,-2,7,3,4,3,2,1,0,0,0,0,0,0,0,0,0,0,0,0,4,1,3,0,0,0,0,0,0,0,0,0
219347,21042,210,42,-2,4,3,1,0,0,0,0,0,0,0,0,0,0,0,0,0,0,0,4,3,1,0,0,0,0,0,0,0,0,0
219356,21042,210,42,-2,14,8,6,0,0,0,1,1,0,0,0,0,0,0,0,0,0,0,11,5,6,0,0,0,0,0,0,2,2,0
219374,21042,210,42,-2,3,2,1,2,2,0,0,0,0,0,0,0,0,0,0,0,0,0,1,0,1,0,0,0,0,0,0,0,0,0
219383,21042,210,42,-2,1,1,0,0,0,0,0,0,0,0,0,0,0,0,0,0,0,0,1,1,0,0,0,0,0,0,0,0,0,0
219471,21042,210,42,-2,19,8,11,0,0,0,0,0,0,1,0,1,1,1,0,0,0,0,17,7,10,0,0,0,0,0,0,0,0,0
219480,21042,210,42,-2,12,7,5,0,0,0,0,0,0,0,0,0,0,0,0,0,0,0,9,5,4,2,2,0,1,0,1,0,0,0
219602,21042,210,42,-2,8,2,6,0,0,0,0,0,0,1,0,1,0,0,0,0,0,0,5,1,4,1,0,1,1,1,0,0,0,0
219709,21042,210,42,-2,16,4,12,0,0,0,0,0,0,1,1,0,0,0,0,0,0,0,13,3,10,0,0,0,2,0,2,0,0,0
219718,21042,210,42,-2,4,1,3,0,0,0,0,0,0,0,0,0,0,0,0,0,0,0,4,1,3,0,0,0,0,0,0,0,0,0
219790,21042,210,42,-2,6,4,2,0,0,0,0,0,0,0,0,0,0,0,0,0,0,0,6,4,2,0,0,0,0,0,0,0,0,0
219824,21042,210,42,-2,24,9,15,0,0,0,0,0,0,1,0,1,1,1,0,0,0,0,20,7,13,2,1,1,0,0,0,0,0,0
219833,21042,210,42,-2,8,2,6,0,0,0,0,0,0,0,0,0,0,0,0,0,0,0,8,2,6,0,0,0,0,0,0,0,0,0
219879,21042,210,42,-2,1,1,0,0,0,0,0,0,0,0,0,0,0,0,0,0,0,0,1,1,0,0,0,0,0,0,0,0,0,0
219888,21042,210,42,-2,14,5,9,1,0,1,2,1,1,0,0,0,0,0,0,0,0,0,10,4,6,0,0,0,1,0,1,0,0,0
219949,21042,210,42,-2,10,5,5,0,0,0,0,0,0,1,0,1,0,0,0,0,0,0,9,5,4,0,0,0,0,0,0,0,0,0
219976,21042,210,42,-2,2,1,1,0,0,0,0,0,0,0,0,0,0,0,0,0,0,0,1,0,1,0,0,0,1,1,0,0,0,0
220057,21042,210,42,-2,2,1,1,0,0,0,0,0,0,0,0,0,0,0,0,0,0,0,2,1,1,0,0,0,0,0,0,0,0,0
220075,21042,210,42,-2,69,27,42,0,0,0,4,2,2,1,0,1,1,0,1,0,0,0,55,20,35,2,0,2,2,1,1,4,4,0
220181,21042,210,42,-2,3,2,1,0,0,0,0,0,0,2,2,0,0,0,0,0,0,0,1,0,1,0,0,0,0,0,0,0,0,0
220215,21042,210,42,-2,6,4,2,0,0,0,0,0,0,0,0,0,0,0,0,0,0,0,6,4,2,0,0,0,0,0,0,0,0,0
220473,21042,210,42,-2,2,2,0,0,0,0,0,0,0,0,0,0,0,0,0,0,0,0,2,2,0,0,0,0,0,0,0,0,0,0
220516,21042,210,42,-2,6,0,6,0,0,0,0,0,0,0,0,0,0,0,0,0,0,0,6,0,6,0,0,0,0,0,0,0,0,0
220598,21042,210,42,-2,15,8,7,0,0,0,1,1,0,7,3,4,3,1,2,0,0,0,4,3,1,0,0,0,0,0,0,0,0,0
220604,21042,210,42,-2,2,2,0,0,0,0,0,0,0,2,2,0,0,0,0,0,0,0,0,0,0,0,0,0,0,0,0,0,0,0
220613,21042,210,42,-2,2,1,1,0,0,0,0,0,0,0,0,0,0,0,0,0,0,0,2,1,1,0,0,0,0,0,0,0,0,0
220631,21042,210,42,-2,75,28,47,0,0,0,1,1,0,2,2,0,2,1,1,0,0,0,63,22,41,0,0,0,7,2,5,0,0,0
220710,21042,210,42,-2,2,1,1,0,0,0,0,0,0,0,0,0,0,0,0,0,0,0,2,1,1,0,0,0,0,0,0,0,0,0
220792,21042,210,42,-2,10,6,4,0,0,0,2,1,1,8,5,3,0,0,0,0,0,0,0,0,0,0,0,0,0,0,0,0,0,0
220862,21042,210,42,-2,36,23,13,0,0,0,5,2,3,8,5,3,2,2,0,0,0,0,20,13,7,0,0,0,1,1,0,0,0,0
220978,21042,210,42,-2,48,22,26,0,0,0,1,0,1,6,2,4,1,1,0,0,0,0,38,18,20,0,0,0,0,0,0,2,1,1
221184,21042,210,42,-2,2,1,1,0,0,0,0,0,0,0,0,0,0,0,0,0,0,0,2,1,1,0,0,0,0,0,0,0,0,0
221351,21042,210,42,-2,16,10,6,0,0,0,1,1,0,1,1,0,2,1,1,0,0,0,4,2,2,0,0,0,6,3,3,2,2,0
221485,21042,210,42,-2,7,4,3,0,0,0,0,0,0,2,1,1,0,0,0,0,0,0,5,3,2,0,0,0,0,0,0,0,0,0
221519,21042,210,42,-2,12,8,4,0,0,0,1,1,0,0,0,0,0,0,0,0,0,0,8,5,3,0,0,0,1,1,0,2,1,1
221643,21042,210,42,-2,3,3,0,0,0,0,0,0,0,0,0,0,1,1,0,0,0,0,2,2,0,0,0,0,0,0,0,0,0,0
221661,21042,210,42,-2,8,3,5,0,0,0,3,2,1,2,0,2,0,0,0,0,0,0,3,1,2,0,0,0,0,0,0,0,0,0
221740,21042,210,42,-2,19,12,7,0,0,0,1,0,1,2,0,2,0,0,0,0,0,0,12,8,4,0,0,0,0,0,0,4,4,0
221768,21042,210,42,-2,11,4,7,0,0,0,0,0,0,2,0,2,0,0,0,0,0,0,9,4,5,0,0,0,0,0,0,0,0,0
221838,21042,210,42,-2,2,1,1,0,0,0,0,0,0,1,1,0,0,0,0,0,0,0,1,0,1,0,0,0,0,0,0,0,0,0
221847,21042,210,42,-2,18,10,8,0,0,0,1,1,0,0,0,0,0,0,0,0,0,0,12,6,6,0,0,0,2,1,1,3,2,1
221908,21042,210,42,-2,4,1,3,0,0,0,0,0,0,0,0,0,0,0,0,0,0,0,4,1,3,0,0,0,0,0,0,0,0,0
221953,21042,210,42,-2,4,2,2,0,0,0,1,1,0,0,0,0,0,0,0,0,0,0,3,1,2,0,0,0,0,0,0,0,0,0
221999,21042,210,42,-2,13,4,9,0,0,0,0,0,0,0,0,0,1,0,1,0,0,0,3,0,3,0,0,0,7,3,4,2,1,1
222053,21042,210,42,-2,2,0,2,0,0,0,0,0,0,0,0,0,0,0,0,0,0,0,2,0,2,0,0,0,0,0,0,0,0,0
222178,21042,210,42,-2,4,1,3,0,0,0,0,0,0,2,0,2,0,0,0,0,0,0,1,0,1,0,0,0,1,1,0,0,0,0
222576,21042,210,42,-2,1,0,1,0,0,0,0,0,0,1,0,1,0,0,0,0,0,0,0,0,0,0,0,0,0,0,0,0,0,0
222628,21042,210,42,-2,1,0,1,0,0,0,0,0,0,0,0,0,0,0,0,0,0,0,1,0,1,0,0,0,0,0,0,0,0,0
222822,21042,210,42,-2,8,4,4,0,0,0,1,0,1,0,0,0,0,0,0,0,0,0,7,4,3,0,0,0,0,0,0,0,0,0
222983,21042,210,42,-2,3,1,2,0,0,0,0,0,0,0,0,0,1,1,0,0,0,0,1,0,1,0,0,0,0,0,0,1,0,1
222992,21042,210,42,-2,18,10,8,0,0,0,1,1,0,4,1,3,2,2,0,0,0,0,11,6,5,0,0,0,0,0,0,0,0,0
223223,21042,210,42,-2,233,86,147,0,0,0,64,30,34,20,4,16,20,5,15,1,0,1,97,28,69,3,2,1,28,17,11,0,0,0
223232,21042,210,42,-2,25,4,21,0,0,0,0,0,0,4,0,4,1,0,1,0,0,0,16,4,12,0,0,0,4,0,4,0,0,0
223320,21042,210,42,-2,4,1,3,0,0,0,0,0,0,1,1,0,0,0,0,0,0,0,2,0,2,0,0,0,1,0,1,0,0,0
223506,21042,210,42,-2,5,3,2,0,0,0,0,0,0,1,0,1,0,0,0,0,0,0,3,2,1,1,1,0,0,0,0,0,0,0
223816,21042,210,42,-2,6,1,5,0,0,0,0,0,0,0,0,0,1,0,1,0,0,0,3,1,2,2,0,2,0,0,0,0,0,0
223898,21042,210,42,-2,10,5,5,0,0,0,0,0,0,0,0,0,1,0,1,0,0,0,8,5,3,0,0,0,1,0,1,0,0,0
223922,21042,210,42,-2,5,3,2,0,0,0,0,0,0,0,0,0,0,0,0,0,0,0,5,3,2,0,0,0,0,0,0,0,0,0
224004,21042,210,42,-2,2,0,2,0,0,0,0,0,0,1,0,1,0,0,0,0,0,0,1,0,1,0,0,0,0,0,0,0,0,0
224110,21042,210,42,-2,3,2,1,0,0,0,0,0,0,1,0,1,0,0,0,0,0,0,1,1,0,0,0,0,1,1,0,0,0,0
224147,21042,210,42,-2,6,1,5,0,0,0,1,0,1,0,0,0,0,0,0,0,0,0,3,0,3,0,0,0,0,0,0,2,1,1
224226,21042,210,42,-2,6,2,4,0,0,0,0,0,0,1,0,1,0,0,0,0,0,0,5,2,3,0,0,0,0,0,0,0,0,0
224244,21042,210,42,-2,1,0,1,0,0,0,0,0,0,0,0,0,0,0,0,0,0,0,1,0,1,0,0,0,0,0,0,0,0,0
224323,21042,210,42,-2,6,3,3,0,0,0,0,0,0,0,0,0,0,0,0,0,0,0,6,3,3,0,0,0,0,0,0,0,0,0
224350,21042,210,42,-2,2,1,1,0,0,0,0,0,0,0,0,0,2,1,1,0,0,0,0,0,0,0,0,0,0,0,0,0,0,0
224527,21042,210,42,-2,16,5,11,1,0,1,1,1,0,0,0,0,0,0,0,0,0,0,14,4,10,0,0,0,0,0,0,0,0,0
224545,21042,210,42,-2,4,3,1,0,0,0,0,0,0,0,0,0,0,0,0,0,0,0,2,2,0,0,0,0,1,0,1,1,1,0
224615,21042,210,42,-2,30,8,22,0,0,0,6,1,5,10,2,8,3,2,1,0,0,0,11,3,8,0,0,0,0,0,0,0,0,0
224712,21042,210,42,-2,1,1,0,0,0,0,0,0,0,1,1,0,0,0,0,0,0,0,0,0,0,0,0,0,0,0,0,0,0,0
224891,21042,210,42,-2,1,0,1,0,0,0,0,0,0,0,0,0,0,0,0,0,0,0,1,0,1,0,0,0,0,0,0,0,0,0
225070,21042,210,42,-2,13,6,7,0,0,0,1,0,1,0,0,0,1,0,1,0,0,0,11,6,5,0,0,0,0,0,0,0,0,0
225247,21042,210,42,-2,5,1,4,0,0,0,0,0,0,0,0,0,0,0,0,0,0,0,5,1,4,0,0,0,0,0,0,0,0,0
225308,21042,210,42,-2,3,2,1,0,0,0,0,0,0,1,1,0,0,0,0,0,0,0,2,1,1,0,0,0,0,0,0,0,0,0
225371,21042,210,42,-2,5,2,3,0,0,0,1,1,0,0,0,0,0,0,0,0,0,0,4,1,3,0,0,0,0,0,0,0,0,0
225399,21042,210,42,-2,15,5,10,0,0,0,0,0,0,3,0,3,1,0,1,0,0,0,11,5,6,0,0,0,0,0,0,0,0,0
225423,21042,210,42,-2,25,13,12,0,0,0,2,0,2,6,1,5,4,3,1,0,0,0,9,7,2,2,1,1,2,1,1,0,0,0
225432,21042,210,42,-2,4,2,2,0,0,0,1,1,0,1,0,1,0,0,0,0,0,0,2,1,1,0,0,0,0,0,0,0,0,0
225502,21042,210,42,-2,1,1,0,0,0,0,0,0,0,0,0,0,0,0,0,0,0,0,1,1,0,0,0,0,0,0,0,0,0,0
225511,21042,210,42,-2,22,13,9,0,0,0,4,2,2,1,1,0,2,0,2,0,0,0,10,7,3,0,0,0,0,0,0,5,3,2
225520,21042,210,42,-2,6,4,2,0,0,0,1,1,0,0,0,0,1,0,1,0,0,0,4,3,1,0,0,0,0,0,0,0,0,0
225548,21042,210,42,-2,3,2,1,0,0,0,0,0,0,0,0,0,2,2,0,0,0,0,1,0,1,0,0,0,0,0,0,0,0,0
225627,21042,210,42,-2,21,6,15,0,0,0,2,0,2,1,0,1,6,2,4,0,0,0,7,1,6,2,0,2,0,0,0,3,3,0
225885,21042,210,42,-2,1,1,0,0,0,0,0,0,0,0,0,0,1,1,0,0,0,0,0,0,0,0,0,0,0,0,0,0,0,0
226019,21042,210,42,-2,2,0,2,0,0,0,0,0,0,0,0,0,0,0,0,0,0,0,2,0,2,0,0,0,0,0,0,0,0,0
226091,21042,210,42,-2,9,6,3,0,0,0,1,1,0,0,0,0,0,0,0,0,0,0,6,3,3,0,0,0,2,2,0,0,0,0
226134,21042,210,42,-2,3,1,2,0,0,0,0,0,0,0,0,0,3,1,2,0,0,0,0,0,0,0,0,0,0,0,0,0,0,0
226152,21042,210,42,-2,19,8,11,0,0,0,3,1,2,0,0,0,6,1,5,0,0,0,8,5,3,0,0,0,2,1,1,0,0,0
226204,21042,210,42,-2,14,9,5,0,0,0,0,0,0,4,3,1,2,1,1,0,0,0,7,5,2,0,0,0,1,0,1,0,0,0
226408,21042,210,42,-2,5,3,2,0,0,0,0,0,0,1,1,0,0,0,0,0,0,0,2,2,0,2,0,2,0,0,0,0,0,0
226471,21042,210,42,-2,6,1,5,1,0,1,0,0,0,0,0,0,0,0,0,0,0,0,5,1,4,0,0,0,0,0,0,0,0,0
226578,21042,210,42,-2,5,3,2,0,0,0,0,0,0,1,1,0,0,0,0,0,0,0,4,2,2,0,0,0,0,0,0,0,0,0
226587,21042,210,42,-2,2,1,1,0,0,0,0,0,0,0,0,0,0,0,0,0,0,0,2,1,1,0,0,0,0,0,0,0,0,0
226806,21042,210,42,-2,8,3,5,0,0,0,1,1,0,0,0,0,4,1,3,0,0,0,3,1,2,0,0,0,0,0,0,0,0,0
226833,21042,210,42,-2,8,1,7,0,0,0,0,0,0,0,0,0,1,0,1,0,0,0,5,1,4,0,0,0,0,0,0,2,0,2
227146,21042,210,42,-2,7,1,6,0,0,0,0,0,0,0,0,0,1,0,1,0,0,0,6,1,5,0,0,0,0,0,0,0,0,0
227182,21042,210,42,-2,13,8,5,0,0,0,0,0,0,5,2,3,3,3,0,0,0,0,5,3,2,0,0,0,0,0,0,0,0,0
227216,21042,210,42,-2,46,21,25,0,0,0,6,5,1,5,2,3,2,0,2,0,0,0,31,14,17,0,0,0,2,0,2,0,0,0
227225,21042,210,42,-2,6,1,5,0,0,0,0,0,0,0,0,0,0,0,0,0,0,0,6,1,5,0,0,0,0,0,0,0,0,0
227304,21042,210,42,-2,12,7,5,0,0,0,1,1,0,1,0,1,1,0,1,1,1,0,8,5,3,0,0,0,0,0,0,0,0,0
227331,21042,210,42,-2,12,2,10,0,0,0,0,0,0,2,1,1,7,0,7,0,0,0,3,1,2,0,0,0,0,0,0,0,0,0
227368,21042,210,42,-2,21,16,5,0,0,0,1,0,1,0,0,0,11,8,3,0,0,0,6,5,1,0,0,0,0,0,0,3,3,0
227377,21042,210,42,-2,4,3,1,0,0,0,0,0,0,0,0,0,2,1,1,0,0,0,1,1,0,0,0,0,0,0,0,1,1,0
227386,21042,210,42,-2,9,3,6,1,0,1,0,0,0,0,0,0,0,0,0,0,0,0,8,3,5,0,0,0,0,0,0,0,0,0
227401,21042,210,42,-2,10,6,4,0,0,0,0,0,0,1,0,1,2,2,0,0,0,0,7,4,3,0,0,0,0,0,0,0,0,0
227526,21042,210,42,-2,1,1,0,0,0,0,0,0,0,0,0,0,0,0,0,0,0,0,1,1,0,0,0,0,0,0,0,0,0,0
227687,21042,210,42,-2,4,2,2,0,0,0,0,0,0,0,0,0,0,0,0,0,0,0,4,2,2,0,0,0,0,0,0,0,0,0
227757,21042,210,42,-2,9,6,3,0,0,0,0,0,0,0,0,0,1,1,0,0,0,0,6,4,2,0,0,0,2,1,1,0,0,0
227845,21042,210,42,-2,8,5,3,0,0,0,1,0,1,0,0,0,0,0,0,0,0,0,7,5,2,0,0,0,0,0,0,0,0,0
227854,21042,210,42,-2,12,5,7,0,0,0,2,1,1,3,0,3,4,3,1,0,0,0,3,1,2,0,0,0,0,0,0,0,0,0
227863,21042,210,42,-2,9,4,5,0,0,0,1,0,1,1,0,1,1,1,0,0,0,0,5,3,2,0,0,0,0,0,0,1,0,1
227881,21042,210,42,-2,43,15,28,1,0,1,0,0,0,4,0,4,3,1,2,0,0,0,30,12,18,0,0,0,0,0,0,5,2,3
227924,21042,210,42,-2,7,4,3,0,0,0,1,0,1,0,0,0,4,2,2,0,0,0,2,2,0,0,0,0,0,0,0,0,0,0
227979,21042,210,42,-2,24,11,13,0,0,0,0,0,0,9,4,5,2,1,1,0,0,0,12,6,6,0,0,0,0,0,0,1,0,1
228149,21042,210,42,-2,9,5,4,0,0,0,1,0,1,2,1,1,1,1,0,0,0,0,5,3,2,0,0,0,0,0,0,0,0,0
228246,21042,210,42,-2,23,11,12,0,0,0,7,3,4,3,2,1,0,0,0,0,0,0,11,4,7,0,0,0,0,0,0,2,2,0
228316,21042,210,42,-2,7,1,6,0,0,0,0,0,0,0,0,0,5,0,5,0,0,0,2,1,1,0,0,0,0,0,0,0,0,0
228325,21042,210,42,-2,4,4,0,0,0,0,1,1,0,0,0,0,0,0,0,0,0,0,3,3,0,0,0,0,0,0,0,0,0,0
228343,21042,210,42,-2,1,1,0,0,0,0,0,0,0,0,0,0,0,0,0,0,0,0,0,0,0,1,1,0,0,0,0,0,0,0
228459,21042,210,42,-2,24,12,12,0,0,0,4,3,1,0,0,0,2,1,1,0,0,0,10,4,6,1,0,1,7,4,3,0,0,0
228501,21042,210,42,-2,1,0,1,0,0,0,0,0,0,0,0,0,0,0,0,0,0,0,1,0,1,0,0,0,0,0,0,0,0,0
228635,21042,210,42,-2,165,75,90,0,0,0,61,28,33,11,5,6,10,4,6,0,0,0,67,30,37,2,1,1,4,1,3,10,6,4
228644,21042,210,42,-2,55,29,26,0,0,0,9,5,4,3,2,1,11,4,7,0,0,0,25,16,9,0,0,0,7,2,5,0,0,0
228653,21042,210,42,-2,19,5,14,0,0,0,2,1,1,5,1,4,3,0,3,0,0,0,9,3,6,0,0,0,0,0,0,0,0,0
228699,21042,210,42,-2,3,0,3,0,0,0,0,0,0,1,0,1,0,0,0,0,0,0,2,0,2,0,0,0,0,0,0,0,0,0
228723,21042,210,42,-2,88,47,41,0,0,0,12,2,10,4,2,2,8,4,4,0,0,0,51,28,23,1,1,0,8,7,1,4,3,1
228769,21042,210,42,-2,7,3,4,0,0,0,0,0,0,0,0,0,2,1,1,0,0,0,2,1,1,0,0,0,3,1,2,0,0,0
228778,21042,210,42,-2,82,32,50,0,0,0,7,1,6,4,1,3,12,5,7,0,0,0,44,17,27,2,1,1,0,0,0,13,7,6
228787,21042,210,42,-2,22,9,13,0,0,0,1,1,0,0,0,0,0,0,0,0,0,0,8,2,6,2,1,1,11,5,6,0,0,0
228796,21042,210,42,-2,22,6,16,0,0,0,4,2,2,1,1,0,9,1,8,0,0,0,5,2,3,1,0,1,0,0,0,2,0,2
228802,21042,210,42,-2,14,2,12,0,0,0,1,0,1,0,0,0,0,0,0,0,0,0,9,1,8,0,0,0,3,1,2,1,0,1
228875,21042,210,42,-2,30,13,17,0,0,0,2,1,1,4,1,3,4,1,3,0,0,0,15,8,7,0,0,0,3,1,2,2,1,1
228909,21042,210,42,-2,12,3,9,0,0,0,2,1,1,1,0,1,1,1,0,0,0,0,6,1,5,0,0,0,2,0,2,0,0,0
228981,21042,210,42,-2,1,1,0,0,0,0,0,0,0,0,0,0,1,1,0,0,0,0,0,0,0,0,0,0,0,0,0,0,0,0
229018,21042,210,42,-2,6,1,5,0,0,0,0,0,0,0,0,0,1,0,1,0,0,0,5,1,4,0,0,0,0,0,0,0,0,0
229027,21042,210,42,-2,15,8,7,0,0,0,1,0,1,0,0,0,6,4,2,0,0,0,1,0,1,0,0,0,6,3,3,1,1,0
229063,21042,210,42,-2,15,6,9,1,0,1,2,0,2,11,5,6,0,0,0,0,0,0,1,1,0,0,0,0,0,0,0,0,0,0
229115,21042,210,42,-2,2,0,2,0,0,0,0,0,0,0,0,0,0,0,0,0,0,0,2,0,2,0,0,0,0,0,0,0,0,0
229179,21042,210,42,-2,11,0,11,0,0,0,3,0,3,2,0,2,3,0,3,0,0,0,3,0,3,0,0,0,0,0,0,0,0,0
229267,21042,210,42,-2,10,6,4,0,0,0,1,0,1,1,1,0,3,1,2,0,0,0,5,4,1,0,0,0,0,0,0,0,0,0
229300,21042,210,42,-2,178,82,96,0,0,0,51,23,28,10,1,9,21,8,13,1,1,0,51,23,28,4,1,3,20,12,8,20,13,7
229337,21042,210,42,-2,36,15,21,0,0,0,13,6,7,1,0,1,5,1,4,0,0,0,17,8,9,0,0,0,0,0,0,0,0,0
229355,21042,210,42,-2,37,11,26,0,0,0,0,0,0,1,0,1,1,0,1,0,0,0,35,11,24,0,0,0,0,0,0,0,0,0
229504,21042,210,42,-2,7,4,3,0,0,0,0,0,0,0,0,0,0,0,0,0,0,0,7,4,3,0,0,0,0,0,0,0,0,0
229780,21042,210,42,-2,3,2,1,0,0,0,0,0,0,0,0,0,1,0,1,0,0,0,2,2,0,0,0,0,0,0,0,0,0,0
229799,21042,210,42,-2,12,3,9,0,0,0,2,1,1,1,0,1,0,0,0,0,0,0,6,1,5,0,0,0,3,1,2,0,0,0
229814,21042,210,42,-2,32,15,17,0,0,0,3,2,1,0,0,0,2,1,1,0,0,0,17,6,11,0,0,0,0,0,0,10,6,4
229832,21042,210,42,-2,4,4,0,0,0,0,0,0,0,0,0,0,1,1,0,0,0,0,3,3,0,0,0,0,0,0,0,0,0,0
229841,21042,210,42,-2,11,2,9,0,0,0,0,0,0,3,0,3,1,1,0,0,0,0,5,0,5,0,0,0,2,1,1,0,0,0
229887,21042,210,42,-2,3,0,3,0,0,0,0,0,0,3,0,3,0,0,0,0,0,0,0,0,0,0,0,0,0,0,0,0,0,0
230038,21042,210,42,-2,1,1,0,0,0,0,0,0,0,0,0,0,0,0,0,0,0,0,1,1,0,0,0,0,0,0,0,0,0,0
230047,21042,210,42,-2,9,5,4,0,0,0,1,1,0,0,0,0,1,0,1,1,0,1,5,3,2,0,0,0,0,0,0,1,1,0
230171,21042,210,42,-2,16,8,8,0,0,0,0,0,0,0,0,0,0,0,0,0,0,0,14,6,8,0,0,0,1,1,0,1,1,0
230603,21042,210,42,-2,22,15,7,0,0,0,0,0,0,0,0,0,0,0,0,0,0,0,21,14,7,0,0,0,0,0,0,1,1,0
230728,21042,210,42,-2,32,18,14,0,0,0,0,0,0,0,0,0,3,3,0,0,0,0,26,13,13,1,1,0,2,1,1,0,0,0
230737,21042,210,42,-2,14,6,8,0,0,0,1,0,1,1,0,1,2,1,1,1,0,1,5,3,2,2,1,1,1,0,1,1,1,0
230746,21042,210,42,-2,3,2,1,0,0,0,0,0,0,1,0,1,0,0,0,0,0,0,2,2,0,0,0,0,0,0,0,0,0,0
230764,21042,210,42,-2,30,18,12,1,1,0,1,1,0,2,1,1,2,1,1,0,0,0,17,12,5,2,1,1,1,0,1,4,1,3
230782,21042,210,42,-2,25,11,14,0,0,0,0,0,0,0,0,0,1,1,0,0,0,0,23,10,13,1,0,1,0,0,0,0,0,0
230852,21042,210,42,-2,1,1,0,0,0,0,0,0,0,0,0,0,0,0,0,0,0,0,1,1,0,0,0,0,0,0,0,0,0,0
230959,21042,210,42,-2,1,1,0,0,0,0,0,0,0,0,0,0,0,0,0,0,0,0,1,1,0,0,0,0,0,0,0,0,0,0
230995,21042,210,42,-2,9,3,6,0,0,0,0,0,0,0,0,0,0,0,0,0,0,0,8,2,6,0,0,0,1,1,0,0,0,0
231059,21042,210,42,-2,1,0,1,0,0,0,0,0,0,0,0,0,0,0,0,0,0,0,1,0,1,0,0,0,0,0,0,0,0,0
231147,21042,210,42,-2,5,2,3,0,0,0,0,0,0,1,0,1,0,0,0,0,0,0,4,2,2,0,0,0,0,0,0,0,0,0
231165,21042,210,42,-2,1,0,1,0,0,0,0,0,0,0,0,0,0,0,0,0,0,0,1,0,1,0,0,0,0,0,0,0,0,0
231174,21042,210,42,-2,18,8,10,0,0,0,2,0,2,2,2,0,0,0,0,0,0,0,10,4,6,0,0,0,2,1,1,2,1,1
231536,21042,210,42,-2,3,0,3,0,0,0,0,0,0,0,0,0,0,0,0,0,0,0,3,0,3,0,0,0,0,0,0,0,0,0
231554,21042,210,42,-2,1,0,1,0,0,0,0,0,0,0,0,0,0,0,0,0,0,0,1,0,1,0,0,0,0,0,0,0,0,0
231581,21042,210,42,-2,7,5,2,0,0,0,2,2,0,0,0,0,0,0,0,0,0,0,4,3,1,0,0,0,0,0,0,1,0,1
231624,21042,210,42,-2,11,7,4,0,0,0,0,0,0,0,0,0,1,1,0,0,0,0,7,6,1,0,0,0,1,0,1,2,0,2
231651,21042,210,42,-2,4,0,4,0,0,0,0,0,0,1,0,1,0,0,0,0,0,0,3,0,3,0,0,0,0,0,0,0,0,0
231697,21042,210,42,-2,1,0,1,0,0,0,0,0,0,0,0,0,0,0,0,0,0,0,1,0,1,0,0,0,0,0,0,0,0,0
231712,21042,210,42,-2,2,1,1,0,0,0,0,0,0,0,0,0,0,0,0,0,0,0,2,1,1,0,0,0,0,0,0,0,0,0
231873,21042,210,42,-2,5,1,4,0,0,0,0,0,0,0,0,0,0,0,0,0,0,0,5,1,4,0,0,0,0,0,0,0,0,0
231882,21042,210,42,-2,15,10,5,0,0,0,0,0,0,1,0,1,0,0,0,0,0,0,14,10,4,0,0,0,0,0,0,0,0,0
232025,21042,210,42,-2,9,3,6,0,0,0,0,0,0,0,0,0,0,0,0,0,0,0,3,1,2,0,0,0,6,2,4,0,0,0
232043,21042,210,42,-2,3,2,1,0,0,0,1,1,0,0,0,0,0,0,0,0,0,0,2,1,1,0,0,0,0,0,0,0,0,0
232052,21042,210,42,-2,1,0,1,0,0,0,1,0,1,0,0,0,0,0,0,0,0,0,0,0,0,0,0,0,0,0,0,0,0,0
232186,21042,210,42,-2,39,22,17,0,0,0,3,3,0,7,5,2,0,0,0,0,0,0,22,9,13,0,0,0,1,1,0,6,4,2
232195,21042,210,42,-2,13,7,6,1,0,1,1,1,0,4,3,1,1,0,1,0,0,0,6,3,3,0,0,0,0,0,0,0,0,0
232256,21042,210,42,-2,3,3,0,0,0,0,1,1,0,0,0,0,0,0,0,0,0,0,2,2,0,0,0,0,0,0,0,0,0,0
232265,21042,210,42,-2,27,10,17,0,0,0,5,2,3,14,5,9,0,0,0,0,0,0,8,3,5,0,0,0,0,0,0,0,0,0
232308,21042,210,42,-2,8,2,6,0,0,0,0,0,0,1,1,0,0,0,0,0,0,0,5,1,4,0,0,0,0,0,0,2,0,2
232414,21042,210,42,-2,8,2,6,0,0,0,0,0,0,1,0,1,0,0,0,0,0,0,7,2,5,0,0,0,0,0,0,0,0,0
232423,21042,210,42,-2,18,7,11,0,0,0,1,1,0,1,1,0,1,1,0,0,0,0,13,4,9,1,0,1,0,0,0,1,0,1
232450,21042,210,42,-2,3,0,3,0,0,0,0,0,0,0,0,0,0,0,0,0,0,0,3,0,3,0,0,0,0,0,0,0,0,0
232557,21042,210,42,-2,48,19,29,0,0,0,1,1,0,11,3,8,2,1,1,0,0,0,34,14,20,0,0,0,0,0,0,0,0,0
232566,21042,210,42,-2,5,2,3,0,0,0,0,0,0,0,0,0,0,0,0,0,0,0,4,1,3,0,0,0,0,0,0,1,1,0
232575,21042,210,42,-2,6,1,5,1,0,1,0,0,0,0,0,0,0,0,0,0,0,0,5,1,4,0,0,0,0,0,0,0,0,0
232609,21042,210,42,-2,5,3,2,0,0,0,1,1,0,0,0,0,0,0,0,0,0,0,2,1,1,0,0,0,2,1,1,0,0,0
232618,21042,210,42,-2,3,1,2,0,0,0,0,0,0,0,0,0,0,0,0,0,0,0,3,1,2,0,0,0,0,0,0,0,0,0
232706,21042,210,42,-2,2,1,1,0,0,0,0,0,0,0,0,0,0,0,0,0,0,0,2,1,1,0,0,0,0,0,0,0,0,0
232788,21042,210,42,-2,1,1,0,0,0,0,0,0,0,0,0,0,0,0,0,0,0,0,1,1,0,0,0,0,0,0,0,0,0,0
232867,21042,210,42,-2,4,1,3,0,0,0,0,0,0,0,0,0,0,0,0,0,0,0,4,1,3,0,0,0,0,0,0,0,0,0
232885,21042,210,42,-2,1,0,1,0,0,0,0,0,0,1,0,1,0,0,0,0,0,0,0,0,0,0,0,0,0,0,0,0,0,0
232937,21042,210,42,-2,1,1,0,0,0,0,0,0,0,1,1,0,0,0,0,0,0,0,0,0,0,0,0,0,0,0,0,0,0,0
232946,21042,210,42,-2,8,3,5,0,0,0,0,0,0,2,2,0,0,0,0,0,0,0,6,1,5,0,0,0,0,0,0,0,0,0
232982,21042,210,42,-2,23,12,11,0,0,0,4,2,2,2,1,1,0,0,0,0,0,0,15,8,7,0,0,0,0,0,0,2,1,1
233019,21042,210,42,-2,2,0,2,0,0,0,0,0,0,0,0,0,0,0,0,0,0,0,2,0,2,0,0,0,0,0,0,0,0,0
233116,21042,210,42,-2,6,2,4,0,0,0,1,1,0,2,1,1,0,0,0,0,0,0,3,0,3,0,0,0,0,0,0,0,0,0
233277,21042,210,42,-2,10,5,5,0,0,0,1,0,1,0,0,0,0,0,0,0,0,0,9,5,4,0,0,0,0,0,0,0,0,0
233295,21042,210,42,-2,12,6,6,0,0,0,0,0,0,2,0,2,1,1,0,0,0,0,9,5,4,0,0,0,0,0,0,0,0,0
233310,21042,210,42,-2,3,0,3,0,0,0,0,0,0,1,0,1,0,0,0,0,0,0,2,0,2,0,0,0,0,0,0,0,0,0
233374,21042,210,42,-2,14,8,6,0,0,0,1,0,1,1,1,0,0,0,0,0,0,0,8,5,3,0,0,0,0,0,0,4,2,2
233426,21042,210,42,-2,13,8,5,0,0,0,0,0,0,0,0,0,1,1,0,0,0,0,11,6,5,1,1,0,0,0,0,0,0,0
233541,21042,210,42,-2,23,7,16,0,0,0,0,0,0,3,2,1,0,0,0,0,0,0,14,4,10,0,0,0,5,1,4,1,0,1
233611,21042,210,42,-2,1,1,0,0,0,0,0,0,0,0,0,0,0,0,0,0,0,0,1,1,0,0,0,0,0,0,0,0,0,0
233639,21042,210,42,-2,1,0,1,0,0,0,0,0,0,0,0,0,0,0,0,0,0,0,1,0,1,0,0,0,0,0,0,0,0,0
233754,21042,210,42,-2,1,1,0,0,0,0,0,0,0,0,0,0,0,0,0,0,0,0,1,1,0,0,0,0,0,0,0,0,0,0
233772,21042,210,42,-2,12,6,6,0,0,0,0,0,0,1,1,0,0,0,0,0,0,0,11,5,6,0,0,0,0,0,0,0,0,0
233897,21042,210,42,-2,2,1,1,0,0,0,0,0,0,0,0,0,0,0,0,0,0,0,2,1,1,0,0,0,0,0,0,0,0,0
233903,21042,210,42,-2,1,1,0,0,0,0,0,0,0,0,0,0,0,0,0,0,0,0,1,1,0,0,0,0,0,0,0,0,0,0
233921,21042,210,42,-2,79,32,47,0,0,0,7,3,4,3,2,1,8,4,4,0,0,0,45,17,28,1,1,0,0,0,0,15,5,10
233949,21042,210,42,-2,2,1,1,0,0,0,1,1,0,0,0,0,0,0,0,0,0,0,1,0,1,0,0,0,0,0,0,0,0,0
234030,21042,210,42,-2,84,37,47,0,0,0,7,3,4,12,4,8,4,2,2,0,0,0,52,22,30,2,0,2,0,0,0,7,6,1
234076,21042,210,42,-2,44,32,12,0,0,0,6,5,1,0,0,0,1,0,1,0,0,0,26,21,5,1,1,0,5,5,0,5,0,5
234085,21042,210,42,-2,6,2,4,0,0,0,1,0,1,0,0,0,0,0,0,0,0,0,5,2,3,0,0,0,0,0,0,0,0,0
234155,21042,210,42,-2,19,12,7,0,0,0,3,3,0,11,5,6,1,0,1,0,0,0,4,4,0,0,0,0,0,0,0,0,0,0
234207,21042,210,42,-2,11,4,7,0,0,0,0,0,0,0,0,0,4,2,2,0,0,0,2,2,0,0,0,0,3,0,3,2,0,2
234377,21042,210,42,-2,1,0,1,0,0,0,0,0,0,0,0,0,0,0,0,0,0,0,1,0,1,0,0,0,0,0,0,0,0,0
234696,21042,210,42,-2,2,1,1,0,0,0,0,0,0,0,0,0,0,0,0,0,0,0,2,1,1,0,0,0,0,0,0,0,0,0
234827,21042,210,42,-2,9,4,5,0,0,0,2,2,0,2,0,2,0,0,0,0,0,0,5,2,3,0,0,0,0,0,0,0,0,0
234933,21042,210,42,-2,10,1,9,0,0,0,1,0,1,1,1,0,0,0,0,0,0,0,7,0,7,0,0,0,1,0,1,0,0,0
234951,21042,210,42,-2,3,2,1,0,0,0,0,0,0,1,1,0,0,0,0,0,0,0,2,1,1,0,0,0,0,0,0,0,0,0
234979,21042,210,42,-2,2,1,1,0,0,0,0,0,0,0,0,0,0,0,0,0,0,0,2,1,1,0,0,0,0,0,0,0,0,0
235024,21042,210,42,-2,1,0,1,0,0,0,0,0,0,0,0,0,1,0,1,0,0,0,0,0,0,0,0,0,0,0,0,0,0,0
235097,21042,210,42,-2,32,15,17,1,1,0,3,1,2,1,0,1,1,1,0,0,0,0,25,11,14,0,0,0,0,0,0,1,1,0
235103,21042,210,42,-2,3,0,3,0,0,0,0,0,0,0,0,0,0,0,0,0,0,0,3,0,3,0,0,0,0,0,0,0,0,0
235149,21042,210,42,-2,2,2,0,0,0,0,1,1,0,0,0,0,0,0,0,0,0,0,1,1,0,0,0,0,0,0,0,0,0,0
235237,21042,210,42,-2,1,0,1,0,0,0,0,0,0,0,0,0,0,0,0,0,0,0,1,0,1,0,0,0,0,0,0,0,0,0
235316,21042,210,42,-2,24,14,10,0,0,0,4,4,0,1,1,0,1,0,1,0,0,0,13,4,9,0,0,0,3,3,0,2,2,0
235422,21042,210,42,-2,4,0,4,0,0,0,1,0,1,0,0,0,1,0,1,0,0,0,2,0,2,0,0,0,0,0,0,0,0,0
235431,21042,210,42,-2,7,4,3,0,0,0,0,0,0,1,0,1,0,0,0,0,0,0,5,3,2,0,0,0,1,1,0,0,0,0
235671,21042,210,42,-2,3,1,2,0,0,0,1,0,1,0,0,0,0,0,0,0,0,0,2,1,1,0,0,0,0,0,0,0,0,0
235699,21042,210,42,-2,7,1,6,0,0,0,1,0,1,0,0,0,0,0,0,0,0,0,6,1,5,0,0,0,0,0,0,0,0,0
236188,21042,210,42,-2,9,1,8,0,0,0,0,0,0,0,0,0,0,0,0,1,0,1,7,1,6,1,0,1,0,0,0,0,0,0
236230,21042,210,42,-2,11,4,7,0,0,0,0,0,0,0,0,0,0,0,0,0,0,0,11,4,7,0,0,0,0,0,0,0,0,0
236258,21042,210,42,-2,3,1,2,0,0,0,0,0,0,0,0,0,0,0,0,0,0,0,2,0,2,0,0,0,1,1,0,0,0,0
236328,21042,210,42,-2,7,2,5,0,0,0,1,0,1,0,0,0,0,0,0,0,0,0,6,2,4,0,0,0,0,0,0,0,0,0
236382,21042,210,42,-2,1,1,0,0,0,0,0,0,0,1,1,0,0,0,0,0,0,0,0,0,0,0,0,0,0,0,0,0,0,0
236452,21042,210,42,-2,2,1,1,0,0,0,0,0,0,0,0,0,0,0,0,0,0,0,2,1,1,0,0,0,0,0,0,0,0,0
236513,21042,210,42,-2,3,3,0,0,0,0,1,1,0,0,0,0,0,0,0,0,0,0,1,1,0,0,0,0,1,1,0,0,0,0
236577,21042,210,42,-2,7,2,5,0,0,0,0,0,0,0,0,0,1,1,0,0,0,0,3,1,2,0,0,0,1,0,1,2,0,2
236595,21042,210,42,-2,44,18,26,0,0,0,8,6,2,1,0,1,0,0,0,0,0,0,29,10,19,1,1,0,5,1,4,0,0,0
236610,21042,210,42,-2,8,1,7,0,0,0,1,0,1,1,0,1,0,0,0,0,0,0,5,1,4,0,0,0,1,0,1,0,0,0
236638,21042,210,42,-2,1,1,0,0,0,0,0,0,0,0,0,0,0,0,0,0,0,0,1,1,0,0,0,0,0,0,0,0,0,0
236692,21042,210,42,-2,2,1,1,0,0,0,0,0,0,0,0,0,0,0,0,0,0,0,2,1,1,0,0,0,0,0,0,0,0,0
236708,21042,210,42,-2,3,0,3,0,0,0,0,0,0,0,0,0,0,0,0,0,0,0,3,0,3,0,0,0,0,0,0,0,0,0
236753,21042,210,42,-2,6,4,2,0,0,0,0,0,0,0,0,0,1,1,0,1,0,1,2,2,0,0,0,0,2,1,1,0,0,0
236887,21042,210,42,-2,2,2,0,0,0,0,0,0,0,0,0,0,0,0,0,0,0,0,2,2,0,0,0,0,0,0,0,0,0,0
236896,21042,210,42,-2,6,5,1,0,0,0,1,1,0,0,0,0,1,0,1,0,0,0,4,4,0,0,0,0,0,0,0,0,0,0
236948,21042,210,42,-2,234,109,125,0,0,0,39,17,22,12,3,9,14,7,7,1,0,1,115,48,67,3,3,0,27,17,10,23,14,9
236975,21042,210,42,-2,2,1,1,0,0,0,0,0,0,0,0,0,1,1,0,0,0,0,1,0,1,0,0,0,0,0,0,0,0,0
237011,21042,210,42,-2,8,4,4,0,0,0,1,0,1,0,0,0,0,0,0,0,0,0,5,2,3,0,0,0,1,1,0,1,1,0
237039,21042,210,42,-2,1,0,1,0,0,0,0,0,0,0,0,0,0,0,0,0,0,0,1,0,1,0,0,0,0,0,0,0,0,0
237057,21042,210,42,-2,11,6,5,0,0,0,0,0,0,0,0,0,1,0,1,0,0,0,8,5,3,0,0,0,0,0,0,2,1,1
237066,21042,210,42,-2,11,5,6,0,0,0,0,0,0,0,0,0,0,0,0,0,0,0,11,5,6,0,0,0,0,0,0,0,0,0
237109,21042,210,42,-2,3,0,3,0,0,0,0,0,0,0,0,0,2,0,2,0,0,0,1,0,1,0,0,0,0,0,0,0,0,0
237215,21042,210,42,-2,8,3,5,0,0,0,0,0,0,0,0,0,0,0,0,0,0,0,8,3,5,0,0,0,0,0,0,0,0,0
237312,21042,210,42,-2,21,7,14,0,0,0,0,0,0,3,0,3,1,1,0,0,0,0,17,6,11,0,0,0,0,0,0,0,0,0
237330,21042,210,42,-2,2,1,1,0,0,0,0,0,0,0,0,0,0,0,0,0,0,0,2,1,1,0,0,0,0,0,0,0,0,0
237358,21042,210,42,-2,8,3,5,0,0,0,0,0,0,0,0,0,0,0,0,0,0,0,8,3,5,0,0,0,0,0,0,0,0,0
237525,21042,210,42,-2,37,19,18,1,0,1,6,4,2,2,1,1,1,1,0,0,0,0,26,13,13,0,0,0,1,0,1,0,0,0
237686,21042,210,42,-2,6,1,5,0,0,0,0,0,0,0,0,0,0,0,0,0,0,0,6,1,5,0,0,0,0,0,0,0,0,0
237701,21042,210,42,-2,4,0,4,0,0,0,0,0,0,1,0,1,0,0,0,0,0,0,3,0,3,0,0,0,0,0,0,0,0,0
237792,21042,210,42,-2,2,1,1,0,0,0,0,0,0,0,0,0,0,0,0,0,0,0,2,1,1,0,0,0,0,0,0,0,0,0
237817,21042,210,42,-2,6,1,5,0,0,0,0,0,0,0,0,0,0,0,0,0,0,0,6,1,5,0,0,0,0,0,0,0,0,0
237899,21042,210,42,-2,5,1,4,0,0,0,0,0,0,0,0,0,0,0,0,0,0,0,5,1,4,0,0,0,0,0,0,0,0,0
237932,21042,210,42,-2,4,2,2,0,0,0,1,1,0,0,0,0,0,0,0,0,0,0,2,1,1,0,0,0,1,0,1,0,0,0
237950,21042,210,42,-2,3,2,1,0,0,0,1,1,0,0,0,0,0,0,0,0,0,0,1,0,1,0,0,0,0,0,0,1,1,0
237969,21042,210,42,-2,2,1,1,0,0,0,0,0,0,0,0,0,0,0,0,0,0,0,2,1,1,0,0,0,0,0,0,0,0,0
238014,21042,210,42,-2,8,1,7,0,0,0,1,1,0,1,0,1,0,0,0,0,0,0,6,0,6,0,0,0,0,0,0,0,0,0
238032,21042,210,42,-2,32,12,20,0,0,0,1,0,1,1,1,0,1,0,1,0,0,0,26,9,17,1,1,0,1,1,0,1,0,1
238078,21042,210,42,-2,4,2,2,0,0,0,0,0,0,0,0,0,0,0,0,0,0,0,4,2,2,0,0,0,0,0,0,0,0,0
238193,21042,210,42,-2,4,1,3,0,0,0,0,0,0,1,1,0,0,0,0,0,0,0,3,0,3,0,0,0,0,0,0,0,0,0
238263,21042,210,42,-2,14,4,10,0,0,0,0,0,0,1,1,0,2,1,1,0,0,0,10,1,9,0,0,0,1,1,0,0,0,0
238324,21042,210,42,-2,1,0,1,0,0,0,0,0,0,0,0,0,0,0,0,0,0,0,1,0,1,0,0,0,0,0,0,0,0,0
238333,21042,210,42,-2,8,4,4,0,0,0,0,0,0,0,0,0,0,0,0,0,0,0,8,4,4,0,0,0,0,0,0,0,0,0
238397,21042,210,42,-2,9,8,1,0,0,0,0,0,0,2,2,0,0,0,0,0,0,0,6,6,0,0,0,0,1,0,1,0,0,0
238430,21042,210,42,-2,2,1,1,0,0,0,0,0,0,0,0,0,0,0,0,0,0,0,2,1,1,0,0,0,0,0,0,0,0,0
238458,21042,210,42,-2,10,2,8,0,0,0,0,0,0,0,0,0,0,0,0,0,0,0,9,2,7,0,0,0,1,0,1,0,0,0
238476,21042,210,42,-2,4,1,3,0,0,0,0,0,0,0,0,0,0,0,0,0,0,0,3,1,2,0,0,0,1,0,1,0,0,0
238616,21042,210,42,-2,7,0,7,0,0,0,0,0,0,0,0,0,0,0,0,0,0,0,7,0,7,0,0,0,0,0,0,0,0,0
238661,21042,210,42,-2,2,1,1,0,0,0,0,0,0,1,1,0,0,0,0,0,0,0,0,0,0,0,0,0,0,0,0,1,0,1
238759,21042,210,42,-2,15,5,10,0,0,0,1,0,1,1,0,1,0,0,0,1,1,0,12,4,8,0,0,0,0,0,0,0,0,0
239008,21042,210,42,-2,4,2,2,0,0,0,0,0,0,1,0,1,0,0,0,0,0,0,3,2,1,0,0,0,0,0,0,0,0,0
239017,21042,210,42,-2,2,0,2,0,0,0,0,0,0,0,0,0,0,0,0,0,0,0,2,0,2,0,0,0,0,0,0,0,0,0
239071,21042,210,42,-2,3,2,1,0,0,0,0,0,0,0,0,0,0,0,0,0,0,0,3,2,1,0,0,0,0,0,0,0,0,0
239105,21042,210,42,-2,21,9,12,0,0,0,1,1,0,2,1,1,2,1,1,0,0,0,13,5,8,1,0,1,0,0,0,2,1,1
239169,21042,210,42,-2,47,27,20,0,0,0,10,6,4,3,3,0,2,1,1,0,0,0,32,17,15,0,0,0,0,0,0,0,0,0
239248,21042,210,42,-2,9,6,3,0,0,0,0,0,0,0,0,0,1,0,1,0,0,0,8,6,2,0,0,0,0,0,0,0,0,0
239309,21042,210,42,-2,7,2,5,0,0,0,0,0,0,2,1,1,0,0,0,0,0,0,1,1,0,4,0,4,0,0,0,0,0,0
239318,21042,210,42,-2,3,3,0,0,0,0,0,0,0,0,0,0,0,0,0,0,0,0,3,3,0,0,0,0,0,0,0,0,0,0
239372,21042,210,42,-2,1,1,0,0,0,0,0,0,0,0,0,0,0,0,0,0,0,0,1,1,0,0,0,0,0,0,0,0,0,0
239442,21042,210,42,-2,2,0,2,0,0,0,0,0,0,0,0,0,0,0,0,0,0,0,2,0,2,0,0,0,0,0,0,0,0,0
239460,21042,210,42,-2,17,6,11,0,0,0,1,0,1,0,0,0,0,0,0,0,0,0,15,6,9,0,0,0,1,0,1,0,0,0
239488,21042,210,42,-2,18,14,4,0,0,0,0,0,0,0,0,0,0,0,0,0,0,0,18,14,4,0,0,0,0,0,0,0,0,0
239716,21042,210,42,-2,3,0,3,0,0,0,0,0,0,0,0,0,0,0,0,0,0,0,2,0,2,0,0,0,1,0,1,0,0,0
239910,21042,210,42,-2,2,0,2,0,0,0,0,0,0,1,0,1,0,0,0,0,0,0,1,0,1,0,0,0,0,0,0,0,0,0
240107,21042,210,42,-2,8,3,5,0,0,0,0,0,0,0,0,0,0,0,0,0,0,0,8,3,5,0,0,0,0,0,0,0,0,0
240116,21042,210,42,-2,17,9,8,0,0,0,1,0,1,0,0,0,1,1,0,0,0,0,15,8,7,0,0,0,0,0,0,0,0,0
240125,21042,210,42,-2,13,7,6,0,0,0,0,0,0,0,0,0,1,1,0,0,0,0,11,5,6,0,0,0,1,1,0,0,0,0
240198,21042,210,42,-2,11,5,6,0,0,0,0,0,0,0,0,0,0,0,0,0,0,0,11,5,6,0,0,0,0,0,0,0,0,0
240514,21042,210,42,-2,7,4,3,0,0,0,0,0,0,0,0,0,0,0,0,0,0,0,5,2,3,0,0,0,2,2,0,0,0,0
240620,21042,210,42,-2,11,3,8,0,0,0,0,0,0,0,0,0,1,0,1,0,0,0,10,3,7,0,0,0,0,0,0,0,0,0
240657,21042,210,42,-2,3,2,1,0,0,0,0,0,0,0,0,0,0,0,0,0,0,0,3,2,1,0,0,0,0,0,0,0,0,0
240666,21042,210,42,-2,2,1,1,0,0,0,0,0,0,0,0,0,0,0,0,0,0,0,2,1,1,0,0,0,0,0,0,0,0,0
240693,21042,210,42,-2,6,4,2,0,0,0,0,0,0,0,0,0,0,0,0,0,0,0,6,4,2,0,0,0,0,0,0,0,0,0
240727,21042,210,42,-2,13,6,7,0,0,0,0,0,0,0,0,0,0,0,0,0,0,0,8,3,5,0,0,0,4,3,1,1,0,1
240745,21042,210,42,-2,2,0,2,0,0,0,2,0,2,0,0,0,0,0,0,0,0,0,0,0,0,0,0,0,0,0,0,0,0,0
240754,21042,210,42,-2,2,0,2,0,0,0,2,0,2,0,0,0,0,0,0,0,0,0,0,0,0,0,0,0,0,0,0,0,0,0
241225,21042,210,42,-2,3,1,2,0,0,0,0,0,0,0,0,0,3,1,2,0,0,0,0,0,0,0,0,0,0,0,0,0,0,0
241331,21042,210,42,-2,2,1,1,0,0,0,0,0,0,0,0,0,2,1,1,0,0,0,0,0,0,0,0,0,0,0,0,0,0,0
241395,21042,210,42,-2,1,0,1,0,0,0,0,0,0,0,0,0,1,0,1,0,0,0,0,0,0,0,0,0,0,0,0,0,0,0
241410,21042,210,42,-2,5,2,3,0,0,0,0,0,0,0,0,0,5,2,3,0,0,0,0,0,0,0,0,0,0,0,0,0,0,0
241739,21042,210,42,-2,10,2,8,0,0,0,0,0,0,0,0,0,10,2,8,0,0,0,0,0,0,0,0,0,0,0,0,0,0,0
242617,21042,210,42,-2,2,0,2,0,0,0,0,0,0,0,0,0,2,0,2,0,0,0,0,0,0,0,0,0,0,0,0,0,0,0
242635,21042,210,42,-2,12,6,6,0,0,0,0,0,0,0,0,0,12,6,6,0,0,0,0,0,0,0,0,0,0,0,0,0,0,0
242644,21042,210,42,-2,5,2,3,0,0,0,0,0,0,0,0,0,5,2,3,0,0,0,0,0,0,0,0,0,0,0,0,0,0,0
242653,21042,210,42,-2,8,3,5,0,0,0,0,0,0,0,0,0,8,3,5,0,0,0,0,0,0,0,0,0,0,0,0,0,0,0
242662,21042,210,42,-2,5,2,3,0,0,0,0,0,0,0,0,0,5,2,3,0,0,0,0,0,0,0,0,0,0,0,0,0,0,0
242680,21042,210,42,-2,3,0,3,0,0,0,0,0,0,0,0,0,3,0,3,0,0,0,0,0,0,0,0,0,0,0,0,0,0,0
242699,21042,210,42,-2,5,5,0,0,0,0,0,0,0,0,0,0,5,5,0,0,0,0,0,0,0,0,0,0,0,0,0,0,0,0
242705,21042,210,42,-2,6,3,3,0,0,0,0,0,0,0,0,0,6,3,3,0,0,0,0,0,0,0,0,0,0,0,0,0,0,0
243197,21042,210,42,-2,9,5,4,0,0,0,0,0,0,0,0,0,0,0,0,0,0,0,0,0,0,0,0,0,9,5,4,0,0,0
243346,21042,210,42,-2,1,1,0,0,0,0,0,0,0,0,0,0,1,1,0,0,0,0,0,0,0,0,0,0,0,0,0,0,0,0
243443,21042,210,42,-2,2,1,1,0,0,0,0,0,0,0,0,0,2,1,1,0,0,0,0,0,0,0,0,0,0,0,0,0,0,0
243601,21042,210,42,-2,3,1,2,0,0,0,0,0,0,0,0,0,2,1,1,0,0,0,1,0,1,0,0,0,0,0,0,0,0,0
243647,21042,210,42,-2,1,0,1,0,0,0,0,0,0,0,0,0,0,0,0,1,0,1,0,0,0,0,0,0,0,0,0,0,0,0
243780,21042,210,42,-2,1,1,0,0,0,0,0,0,0,0,0,0,0,0,0,0,0,0,0,0,0,0,0,0,0,0,0,1,1,0
243823,21042,210,42,-2,12,8,4,0,0,0,0,0,0,1,1,0,0,0,0,0,0,0,7,5,2,0,0,0,4,2,2,0,0,0
243832,21042,210,42,-2,9,1,8,0,0,0,0,0,0,0,0,0,9,1,8,0,0,0,0,0,0,0,0,0,0,0,0,0,0,0
244437,21042,210,42,-2,5,4,1,0,0,0,0,0,0,1,1,0,0,0,0,0,0,0,4,3,1,0,0,0,0,0,0,0,0,0
245953,21042,210,42,-2,4,3,1,0,0,0,0,0,0,1,1,0,0,0,0,0,0,0,3,2,1,0,0,0,0,0,0,0,0,0
246354,21042,210,42,-2,5,2,3,0,0,0,1,0,1,0,0,0,3,1,2,0,0,0,1,1,0,0,0,0,0,0,0,0,0,0
247834,21042,210,42,-2,28,11,17,0,0,0,1,1,0,5,3,2,1,0,1,0,0,0,19,7,12,0,0,0,2,0,2,0,0,0
247940,21042,210,42,-2,2,1,1,0,0,0,0,0,0,0,0,0,0,0,0,0,0,0,2,1,1,0,0,0,0,0,0,0,0,0
260372,21042,210,42,-2,2,1,1,2,1,1,0,0,0,0,0,0,0,0,0,0,0,0,0,0,0,0,0,0,0,0,0,0,0,0
262086,21042,210,42,-2,7,0,7,0,0,0,1,0,1,3,0,3,1,0,1,0,0,0,2,0,2,0,0,0,0,0,0,0,0,0
262129,21042,210,42,-2,2,0,2,0,0,0,1,0,1,0,0,0,0,0,0,0,0,0,0,0,0,0,0,0,0,0,0,1,0,1
363934,21042,210,42,-2,3,2,1,0,0,0,1,0,1,0,0,0,0,0,0,0,0,0,2,2,0,0,0,0,0,0,0,0,0,0
364016,21042,210,42,-2,7,2,5,0,0,0,0,0,0,1,1,0,1,0,1,0,0,0,4,1,3,1,0,1,0,0,0,0,0,0
364025,21042,210,42,-2,5,2,3,0,0,0,0,0,0,1,0,1,0,0,0,0,0,0,4,2,2,0,0,0,0,0,0,0,0,0
366252,21042,210,42,-2,5,5,0,0,0,0,0,0,0,0,0,0,0,0,0,0,0,0,5,5,0,0,0,0,0,0,0,0,0,0
367459,21042,210,42,-2,13,2,11,0,0,0,1,0,1,0,0,0,0,0,0,0,0,0,11,2,9,0,0,0,1,0,1,0,0,0
377555,21042,210,42,-2,1,1,0,0,0,0,1,1,0,0,0,0,0,0,0,0,0,0,0,0,0,0,0,0,0,0,0,0,0,0
377564,21042,210,42,-2,5,3,2,0,0,0,0,0,0,0,0,0,0,0,0,0,0,0,5,3,2,0,0,0,0,0,0,0,0,0
378576,21042,210,42,-2,1,0,1,0,0,0,0,0,0,0,0,0,0,0,0,0,0,0,0,0,0,0,0,0,1,0,1,0,0,0
380359,21042,210,42,-2,3,1,2,1,1,0,0,0,0,0,0,0,0,0,0,0,0,0,2,0,2,0,0,0,0,0,0,0,0,0
380377,21042,210,42,-2,5,2,3,1,1,0,0,0,0,1,1,0,0,0,0,0,0,0,1,0,1,2,0,2,0,0,0,0,0,0
384254,21042,210,42,-2,5,1,4,0,0,0,0,0,0,3,1,2,1,0,1,0,0,0,1,0,1,0,0,0,0,0,0,0,0,0
384333,21042,210,42,-2,6,1,5,0,0,0,0,0,0,0,0,0,1,0,1,0,0,0,5,1,4,0,0,0,0,0,0,0,0,0
385415,21042,210,42,-2,1,0,1,0,0,0,0,0,0,0,0,0,0,0,0,0,0,0,1,0,1,0,0,0,0,0,0,0,0,0
399911,21042,210,42,-2,3,1,2,0,0,0,2,0,2,0,0,0,0,0,0,0,0,0,1,1,0,0,0,0,0,0,0,0,0,0
404222,21042,210,42,-2,1,1,0,0,0,0,0,0,0,0,0,0,1,1,0,0,0,0,0,0,0,0,0,0,0,0,0,0,0,0
404426,21042,210,42,-2,3,1,2,1,1,0,0,0,0,0,0,0,1,0,1,0,0,0,1,0,1,0,0,0,0,0,0,0,0,0
405872,21042,210,42,-2,2,1,1,0,0,0,0,0,0,0,0,0,0,0,0,0,0,0,2,1,1,0,0,0,0,0,0,0,0,0
409315,21042,210,42,-2,54,34,20,0,0,0,3,1,2,0,0,0,36,21,15,0,0,0,10,7,3,0,0,0,2,2,0,3,3,0
413413,21042,210,42,-2,6,1,5,0,0,0,0,0,0,1,0,1,0,0,0,0,0,0,4,1,3,0,0,0,1,0,1,0,0,0
413626,21042,210,42,-2,1,1,0,0,0,0,0,0,0,0,0,0,0,0,0,0,0,0,1,1,0,0,0,0,0,0,0,0,0,0
414966,21042,210,42,-2,1,0,1,0,0,0,0,0,0,0,0,0,0,0,0,0,0,0,1,0,1,0,0,0,0,0,0,0,0,0
420398,21042,210,42,-2,2,0,2,0,0,0,1,0,1,0,0,0,0,0,0,0,0,0,1,0,1,0,0,0,0,0,0,0,0,0
420440,21042,210,42,-2,3,0,3,0,0,0,0,0,0,0,0,0,0,0,0,0,0,0,3,0,3,0,0,0,0,0,0,0,0,0
420538,21042,210,42,-2,1,1,0,0,0,0,0,0,0,0,0,0,0,0,0,0,0,0,1,1,0,0,0,0,0,0,0,0,0,0
420556,21042,210,42,-2,4,2,2,0,0,0,0,0,0,0,0,0,1,0,1,0,0,0,3,2,1,0,0,0,0,0,0,0,0,0
422695,21042,210,42,-2,2,0,2,0,0,0,0,0,0,0,0,0,0,0,0,0,0,0,2,0,2,0,0,0,0,0,0,0,0,0
426314,21042,210,42,-2,6,3,3,0,0,0,0,0,0,0,0,0,0,0,0,0,0,0,2,1,1,1,1,0,3,1,2,0,0,0
433660,21042,210,42,-2,6,5,1,0,0,0,1,0,1,0,0,0,0,0,0,0,0,0,4,4,0,0,0,0,0,0,0,1,1,0
434016,21042,210,42,-2,2,1,1,0,0,0,0,0,0,0,0,0,0,0,0,0,0,0,2,1,1,0,0,0,0,0,0,0,0,0
434061,21042,210,42,-2,20,8,12,0,0,0,1,0,1,10,2,8,0,0,0,1,0,1,7,5,2,0,0,0,0,0,0,1,1,0
434584,21042,210,42,-2,1,1,0,0,0,0,1,1,0,0,0,0,0,0,0,0,0,0,0,0,0,0,0,0,0,0,0,0,0,0
434672,21042,210,42,-2,14,3,11,0,0,0,2,0,2,4,1,3,1,0,1,0,0,0,6,1,5,0,0,0,0,0,0,1,1,0
434751,21042,210,42,-2,1,1,0,1,1,0,0,0,0,0,0,0,0,0,0,0,0,0,0,0,0,0,0,0,0,0,0,0,0,0
435000,21042,210,42,-2,91,50,41,0,0,0,12,6,6,2,1,1,4,2,2,0,0,0,36,19,17,1,0,1,0,0,0,36,22,14
436304,21042,210,42,-2,12,5,7,0,0,0,0,0,0,4,1,3,1,1,0,0,0,0,7,3,4,0,0,0,0,0,0,0,0,0
437103,21042,210,42,-2,5,1,4,0,0,0,0,0,0,3,0,3,0,0,0,0,0,0,2,1,1,0,0,0,0,0,0,0,0,0
438708,21042,210,42,-2,3,1,2,0,0,0,0,0,0,0,0,0,0,0,0,0,0,0,3,1,2,0,0,0,0,0,0,0,0,0
439701,21042,210,42,-2,1,1,0,0,0,0,0,0,0,0,0,0,0,0,0,0,0,0,1,1,0,0,0,0,0,0,0,0,0,0
440396,21042,210,42,-2,1,0,1,0,0,0,0,0,0,0,0,0,0,0,0,0,0,0,1,0,1,0,0,0,0,0,0,0,0,0
440402,21042,210,42,-2,12,4,8,0,0,0,0,0,0,0,0,0,1,1,0,0,0,0,11,3,8,0,0,0,0,0,0,0,0,0
440916,21042,210,42,-2,13,7,6,0,0,0,1,1,0,7,2,5,0,0,0,0,0,0,5,4,1,0,0,0,0,0,0,0,0,0
441131,21042,210,42,-2,1,1,0,0,0,0,0,0,0,0,0,0,0,0,0,0,0,0,1,1,0,0,0,0,0,0,0,0,0,0
441609,21042,210,42,-2,1,1,0,0,0,0,0,0,0,0,0,0,0,0,0,0,0,0,1,1,0,0,0,0,0,0,0,0,0,0
441760,21042,210,42,-2,1,0,1,0,0,0,0,0,0,0,0,0,0,0,0,0,0,0,1,0,1,0,0,0,0,0,0,0,0,0
441900,21042,210,42,-2,6,1,5,0,0,0,0,0,0,0,0,0,1,0,1,0,0,0,5,1,4,0,0,0,0,0,0,0,0,0
441937,21042,210,42,-2,1,1,0,0,0,0,0,0,0,0,0,0,0,0,0,0,0,0,0,0,0,1,1,0,0,0,0,0,0,0
442356,21042,210,42,-2,16,0,16,0,0,0,1,0,1,0,0,0,0,0,0,0,0,0,15,0,15,0,0,0,0,0,0,0,0,0
442781,21042,210,42,-2,4,2,2,2,0,2,2,2,0,0,0,0,0,0,0,0,0,0,0,0,0,0,0,0,0,0,0,0,0,0
442806,21042,210,42,-2,7,4,3,0,0,0,1,0,1,1,0,1,0,0,0,0,0,0,5,4,1,0,0,0,0,0,0,0,0,0
443492,21042,210,42,-2,2,1,1,0,0,0,0,0,0,0,0,0,0,0,0,0,0,0,2,1,1,0,0,0,0,0,0,0,0,0
444954,21042,210,42,-2,6,3,3,0,0,0,0,0,0,0,0,0,0,0,0,0,0,0,6,3,3,0,0,0,0,0,0,0,0,0
445188,21042,210,42,-2,12,6,6,0,0,0,0,0,0,1,1,0,1,0,1,0,0,0,6,2,4,1,0,1,2,2,0,1,1,0
445735,21042,210,42,-2,1,0,1,0,0,0,0,0,0,0,0,0,0,0,0,0,0,0,1,0,1,0,0,0,0,0,0,0,0,0
446048,21042,210,42,-2,6,4,2,0,0,0,0,0,0,0,0,0,0,0,0,0,0,0,6,4,2,0,0,0,0,0,0,0,0,0
446774,21042,210,42,-2,7,3,4,0,0,0,0,0,0,0,0,0,0,0,0,0,0,0,7,3,4,0,0,0,0,0,0,0,0,0
447582,21042,210,42,-2,8,3,5,0,0,0,0,0,0,1,1,0,0,0,0,0,0,0,7,2,5,0,0,0,0,0,0,0,0,0
447689,21042,210,42,-2,13,4,9,0,0,0,0,0,0,3,1,2,0,0,0,0,0,0,10,3,7,0,0,0,0,0,0,0,0,0
447953,21042,210,42,-2,2,2,0,0,0,0,1,1,0,0,0,0,1,1,0,0,0,0,0,0,0,0,0,0,0,0,0,0,0,0
448594,21042,210,42,-2,1,0,1,0,0,0,0,0,0,0,0,0,0,0,0,0,0,0,0,0,0,0,0,0,1,0,1,0,0,0
449922,21042,210,42,-2,1,1,0,0,0,0,1,1,0,0,0,0,0,0,0,0,0,0,0,0,0,0,0,0,0,0,0,0,0,0
451404,21042,210,42,-2,6,6,0,0,0,0,0,0,0,0,0,0,0,0,0,0,0,0,6,6,0,0,0,0,0,0,0,0,0,0
451510,21042,210,42,-2,1,0,1,0,0,0,0,0,0,0,0,0,0,0,0,0,0,0,1,0,1,0,0,0,0,0,0,0,0,0
455114,21042,210,42,-2,19,13,6,0,0,0,0,0,0,0,0,0,1,1,0,0,0,0,17,11,6,0,0,0,1,1,0,0,0,0
455257,21042,210,42,-2,1,1,0,0,0,0,0,0,0,0,0,0,0,0,0,0,0,0,1,1,0,0,0,0,0,0,0,0,0,0
455804,21042,210,42,-2,3,2,1,0,0,0,0,0,0,0,0,0,0,0,0,0,0,0,3,2,1,0,0,0,0,0,0,0,0,0
456490,21042,210,42,-2,1,1,0,0,0,0,0,0,0,0,0,0,1,1,0,0,0,0,0,0,0,0,0,0,0,0,0,0,0,0
457086,21042,210,42,-2,1,1,0,0,0,0,1,1,0,0,0,0,0,0,0,0,0,0,0,0,0,0,0,0,0,0,0,0,0,0
457527,21042,210,42,-2,4,0,4,0,0,0,0,0,0,0,0,0,1,0,1,0,0,0,3,0,3,0,0,0,0,0,0,0,0,0
459736,21042,210,42,-2,1,0,1,0,0,0,0,0,0,0,0,0,0,0,0,0,0,0,1,0,1,0,0,0,0,0,0,0,0,0
459824,21042,210,42,-2,5,1,4,0,0,0,0,0,0,1,0,1,0,0,0,0,0,0,4,1,3,0,0,0,0,0,0,0,0,0
459949,21042,210,42,-2,19,10,9,0,0,0,0,0,0,0,0,0,8,6,2,0,0,0,9,4,5,0,0,0,1,0,1,1,0,1
461795,21042,210,42,-2,4,3,1,0,0,0,2,1,1,1,1,0,0,0,0,0,0,0,1,1,0,0,0,0,0,0,0,0,0,0
464226,21042,210,42,-2,4,1,3,0,0,0,0,0,0,0,0,0,2,1,1,0,0,0,2,0,2,0,0,0,0,0,0,0,0,0
476717,21042,210,42,-2,1,1,0,0,0,0,0,0,0,0,0,0,0,0,0,0,0,0,1,1,0,0,0,0,0,0,0,0,0,0
480790,21042,210,42,-2,5,3,2,0,0,0,0,0,0,0,0,0,0,0,0,0,0,0,5,3,2,0,0,0,0,0,0,0,0,0
482149,21042,210,42,-2,63,33,30,0,0,0,9,4,5,4,1,3,6,3,3,0,0,0,33,18,15,0,0,0,2,2,0,9,5,4
482158,21042,210,42,-2,3,1,2,0,0,0,0,0,0,0,0,0,0,0,0,0,0,0,3,1,2,0,0,0,0,0,0,0,0,0
482680,21042,210,42,-2,22,14,8,0,0,0,0,0,0,1,0,1,1,0,1,0,0,0,17,12,5,0,0,0,3,2,1,0,0,0
482699,21042,210,42,-2,1,1,0,0,0,0,0,0,0,0,0,0,0,0,0,0,0,0,1,1,0,0,0,0,0,0,0,0,0,0
482705,21042,210,42,-2,9,5,4,0,0,0,0,0,0,1,1,0,0,0,0,0,0,0,1,1,0,0,0,0,5,2,3,2,1,1
483124,21042,210,42,-2,61,26,35,0,0,0,2,0,2,2,1,1,5,1,4,0,0,0,31,16,15,1,0,1,17,6,11,3,2,1
483212,21042,210,42,-2,10,6,4,0,0,0,0,0,0,3,2,1,0,0,0,0,0,0,5,2,3,1,1,0,0,0,0,1,1,0
483595,21042,210,42,-2,20,6,14,0,0,0,0,0,0,0,0,0,19,6,13,0,0,0,1,0,1,0,0,0,0,0,0,0,0,0
484905,21042,210,42,-2,4,2,2,0,0,0,0,0,0,1,0,1,0,0,0,0,0,0,3,2,1,0,0,0,0,0,0,0,0,0
484932,21042,210,42,-2,2,1,1,0,0,0,0,0,0,0,0,0,0,0,0,0,0,0,2,1,1,0,0,0,0,0,0,0,0,0
485111,21042,210,42,-2,1,0,1,0,0,0,0,0,0,0,0,0,0,0,0,0,0,0,1,0,1,0,0,0,0,0,0,0,0,0
485698,21042,210,42,-2,5,4,1,0,0,0,0,0,0,1,1,0,0,0,0,0,0,0,4,3,1,0,0,0,0,0,0,0,0,0
486840,21042,210,42,-2,82,34,48,0,0,0,9,4,5,7,4,3,3,3,0,0,0,0,57,21,36,0,0,0,1,1,0,5,1,4
486901,21042,210,42,-2,2,0,2,0,0,0,0,0,0,1,0,1,0,0,0,0,0,0,1,0,1,0,0,0,0,0,0,0,0,0
487010,21042,210,42,-2,92,55,37,0,0,0,15,11,4,6,1,5,2,1,1,0,0,0,52,33,19,0,0,0,0,0,0,17,9,8
487320,21042,210,42,-2,62,53,9,0,0,0,1,1,0,1,0,1,18,14,4,0,0,0,41,38,3,0,0,0,1,0,1,0,0,0
487524,21042,210,42,-2,7,3,4,0,0,0,1,1,0,0,0,0,0,0,0,0,0,0,6,2,4,0,0,0,0,0,0,0,0,0
488527,21042,210,42,-2,12,5,7,0,0,0,2,0,2,0,0,0,1,1,0,0,0,0,8,3,5,0,0,0,1,1,0,0,0,0
488572,21042,210,42,-2,11,5,6,0,0,0,5,3,2,1,0,1,0,0,0,0,0,0,4,1,3,1,1,0,0,0,0,0,0,0
489201,21042,210,42,-2,4,2,2,0,0,0,1,0,1,0,0,0,1,0,1,0,0,0,2,2,0,0,0,0,0,0,0,0,0,0
490133,21042,210,42,-2,1,0,1,0,0,0,0,0,0,0,0,0,0,0,0,0,0,0,0,0,0,0,0,0,1,0,1,0,0,0
491057,21042,210,42,-2,2,2,0,0,0,0,0,0,0,0,0,0,0,0,0,0,0,0,2,2,0,0,0,0,0,0,0,0,0,0
491525,21042,210,42,-2,1,1,0,0,0,0,0,0,0,0,0,0,0,0,0,0,0,0,1,1,0,0,0,0,0,0,0,0,0,0
492476,21042,210,42,-2,1,0,1,0,0,0,0,0,0,0,0,0,1,0,1,0,0,0,0,0,0,0,0,0,0,0,0,0,0,0
492689,21042,210,42,-2,47,27,20,0,0,0,7,4,3,3,0,3,10,6,4,0,0,0,21,14,7,0,0,0,0,0,0,6,3,3
493646,21042,210,42,-2,7,0,7,0,0,0,0,0,0,0,0,0,0,0,0,0,0,0,7,0,7,0,0,0,0,0,0,0,0,0
494278,21042,210,42,-2,2,1,1,0,0,0,0,0,0,0,0,0,2,1,1,0,0,0,0,0,0,0,0,0,0,0,0,0,0,0
494287,21042,210,42,-2,8,0,8,0,0,0,0,0,0,0,0,0,8,0,8,0,0,0,0,0,0,0,0,0,0,0,0,0,0,0
495767,21042,210,42,-2,78,36,42,0,0,0,7,5,2,9,3,6,4,2,2,0,0,0,50,23,27,0,0,0,4,2,2,4,1,3
100690,21043,210,43,-2,1,1,0,0,0,0,0,0,0,0,0,0,0,0,0,0,0,0,1,1,0,0,0,0,0,0,0,0,0,0
100751,21043,210,43,-2,2,0,2,0,0,0,0,0,0,0,0,0,1,0,1,0,0,0,1,0,1,0,0,0,0,0,0,0,0,0
100858,21043,210,43,-2,26,12,14,0,0,0,1,1,0,2,0,2,0,0,0,1,1,0,15,8,7,0,0,0,0,0,0,7,2,5
101514,21043,210,43,-2,1,0,1,0,0,0,0,0,0,0,0,0,0,0,0,0,0,0,1,0,1,0,0,0,0,0,0,0,0,0
102049,21043,210,43,-2,7,2,5,0,0,0,0,0,0,1,0,1,1,0,1,0,0,0,5,2,3,0,0,0,0,0,0,0,0,0
102553,21043,210,43,-2,1,1,0,0,0,0,0,0,0,0,0,0,0,0,0,0,0,0,1,1,0,0,0,0,0,0,0,0,0,0
102614,21043,210,43,-2,1,1,0,0,0,0,0,0,0,0,0,0,0,0,0,0,0,0,1,1,0,0,0,0,0,0,0,0,0,0
104346,21043,210,43,-2,2,2,0,0,0,0,0,0,0,1,1,0,0,0,0,0,0,0,1,1,0,0,0,0,0,0,0,0,0,0
106397,21043,210,43,-2,4,1,3,0,0,0,0,0,0,0,0,0,0,0,0,0,0,0,2,0,2,0,0,0,2,1,1,0,0,0
106810,21043,210,43,-2,5,2,3,0,0,0,0,0,0,0,0,0,0,0,0,0,0,0,5,2,3,0,0,0,0,0,0,0,0,0
106883,21043,210,43,-2,5,2,3,0,0,0,0,0,0,0,0,0,0,0,0,0,0,0,5,2,3,0,0,0,0,0,0,0,0,0
106980,21043,210,43,-2,13,7,6,0,0,0,0,0,0,0,0,0,0,0,0,0,0,0,13,7,6,0,0,0,0,0,0,0,0,0
107637,21043,210,43,-2,9,3,6,0,0,0,0,0,0,4,2,2,1,1,0,0,0,0,4,0,4,0,0,0,0,0,0,0,0,0
107664,21043,210,43,-2,8,6,2,0,0,0,0,0,0,2,1,1,0,0,0,0,0,0,5,4,1,0,0,0,1,1,0,0,0,0
108232,21043,210,43,-2,1,1,0,0,0,0,0,0,0,0,0,0,0,0,0,0,0,0,1,1,0,0,0,0,0,0,0,0,0,0
109208,21043,210,43,-2,1,1,0,0,0,0,0,0,0,0,0,0,1,1,0,0,0,0,0,0,0,0,0,0,0,0,0,0,0,0
110404,21043,210,43,-2,1,0,1,0,0,0,0,0,0,0,0,0,0,0,0,0,0,0,1,0,1,0,0,0,0,0,0,0,0,0
110422,21043,210,43,-2,2,0,2,0,0,0,0,0,0,0,0,0,0,0,0,0,0,0,1,0,1,0,0,0,0,0,0,1,0,1
110486,21043,210,43,-2,1,0,1,0,0,0,0,0,0,0,0,0,0,0,0,0,0,0,0,0,0,1,0,1,0,0,0,0,0,0
110495,21043,210,43,-2,2,1,1,0,0,0,0,0,0,0,0,0,0,0,0,0,0,0,0,0,0,1,0,1,1,1,0,0,0,0
110510,21043,210,43,-2,5,2,3,0,0,0,0,0,0,0,0,0,0,0,0,0,0,0,4,2,2,0,0,0,1,0,1,0,0,0
110556,21043,210,43,-2,5,1,4,0,0,0,2,1,1,0,0,0,2,0,2,0,0,0,1,0,1,0,0,0,0,0,0,0,0,0
110565,21043,210,43,-2,2,2,0,0,0,0,0,0,0,1,1,0,0,0,0,0,0,0,1,1,0,0,0,0,0,0,0,0,0,0
110574,21043,210,43,-2,2,2,0,0,0,0,0,0,0,1,1,0,0,0,0,0,0,0,1,1,0,0,0,0,0,0,0,0,0,0
110583,21043,210,43,-2,2,0,2,0,0,0,0,0,0,0,0,0,0,0,0,0,0,0,2,0,2,0,0,0,0,0,0,0,0,0
110592,21043,210,43,-2,4,0,4,0,0,0,2,0,2,0,0,0,1,0,1,0,0,0,1,0,1,0,0,0,0,0,0,0,0,0
110608,21043,210,43,-2,2,1,1,0,0,0,0,0,0,0,0,0,0,0,0,0,0,0,1,0,1,0,0,0,1,1,0,0,0,0
110617,21043,210,43,-2,1,1,0,0,0,0,0,0,0,0,0,0,0,0,0,0,0,0,0,0,0,0,0,0,1,1,0,0,0,0
110644,21043,210,43,-2,1,1,0,0,0,0,0,0,0,0,0,0,0,0,0,0,0,0,1,1,0,0,0,0,0,0,0,0,0,0
110662,21043,210,43,-2,1,0,1,0,0,0,0,0,0,0,0,0,0,0,0,0,0,0,1,0,1,0,0,0,0,0,0,0,0,0
110714,21043,210,43,-2,1,0,1,0,0,0,0,0,0,0,0,0,0,0,0,0,0,0,1,0,1,0,0,0,0,0,0,0,0,0
111887,21043,210,43,-2,1,1,0,0,0,0,0,0,0,0,0,0,0,0,0,0,0,0,1,1,0,0,0,0,0,0,0,0,0,0
111920,21043,210,43,-2,1,1,0,0,0,0,0,0,0,0,0,0,0,0,0,0,0,0,1,1,0,0,0,0,0,0,0,0,0,0
111939,21043,210,43,-2,1,0,1,0,0,0,0,0,0,0,0,0,1,0,1,0,0,0,0,0,0,0,0,0,0,0,0,0,0,0
111948,21043,210,43,-2,5,2,3,0,0,0,2,0,2,0,0,0,0,0,0,0,0,0,2,1,1,0,0,0,1,1,0,0,0,0
112561,21043,210,43,-2,3,1,2,0,0,0,0,0,0,1,0,1,1,0,1,0,0,0,1,1,0,0,0,0,0,0,0,0,0,0
112826,21043,210,43,-2,1,0,1,0,0,0,0,0,0,0,0,0,0,0,0,0,0,0,1,0,1,0,0,0,0,0,0,0,0,0
113573,21043,210,43,-2,5,4,1,0,0,0,0,0,0,0,0,0,2,2,0,0,0,0,3,2,1,0,0,0,0,0,0,0,0,0
114266,21043,210,43,-2,1,0,1,0,0,0,1,0,1,0,0,0,0,0,0,0,0,0,0,0,0,0,0,0,0,0,0,0,0,0
114433,21043,210,43,-2,1,1,0,0,0,0,0,0,0,0,0,0,1,1,0,0,0,0,0,0,0,0,0,0,0,0,0,0,0,0
114789,21043,210,43,-2,1,0,1,0,0,0,0,0,0,0,0,0,0,0,0,0,0,0,1,0,1,0,0,0,0,0,0,0,0,0
114938,21043,210,43,-2,1,0,1,0,0,0,0,0,0,0,0,0,1,0,1,0,0,0,0,0,0,0,0,0,0,0,0,0,0,0
115755,21043,210,43,-2,4,3,1,0,0,0,1,1,0,0,0,0,1,0,1,0,0,0,0,0,0,0,0,0,2,2,0,0,0,0
115861,21043,210,43,-2,7,1,6,0,0,0,0,0,0,1,0,1,5,1,4,0,0,0,1,0,1,0,0,0,0,0,0,0,0,0
117715,21043,210,43,-2,1,0,1,0,0,0,0,0,0,0,0,0,0,0,0,0,0,0,0,0,0,0,0,0,1,0,1,0,0,0
117894,21043,210,43,-2,4,2,2,0,0,0,1,1,0,1,0,1,0,0,0,0,0,0,2,1,1,0,0,0,0,0,0,0,0,0
118347,21043,210,43,-2,1,1,0,0,0,0,0,0,0,0,0,0,0,0,0,0,0,0,1,1,0,0,0,0,0,0,0,0,0,0
118976,21043,210,43,-2,8,2,6,0,0,0,0,0,0,0,0,0,1,0,1,0,0,0,7,2,5,0,0,0,0,0,0,0,0,0
119137,21043,210,43,-2,1,0,1,0,0,0,0,0,0,0,0,0,0,0,0,0,0,0,1,0,1,0,0,0,0,0,0,0,0,0
120421,21043,210,43,-2,1,1,0,0,0,0,1,1,0,0,0,0,0,0,0,0,0,0,0,0,0,0,0,0,0,0,0,0,0,0
121044,21043,210,43,-2,3,1,2,0,0,0,0,0,0,0,0,0,0,0,0,0,0,0,1,1,0,0,0,0,1,0,1,1,0,1
121619,21043,210,43,-2,1,0,1,0,0,0,0,0,0,0,0,0,0,0,0,0,0,0,0,0,0,0,0,0,1,0,1,0,0,0
122180,21043,210,43,-2,1,1,0,0,0,0,0,0,0,0,0,0,0,0,0,0,0,0,1,1,0,0,0,0,0,0,0,0,0,0
122409,21043,210,43,-2,13,7,6,1,1,0,0,0,0,1,1,0,3,2,1,0,0,0,6,1,5,0,0,0,1,1,0,1,1,0
122597,21043,210,43,-2,10,4,6,0,0,0,3,1,2,1,0,1,1,0,1,0,0,0,5,3,2,0,0,0,0,0,0,0,0,0
122612,21043,210,43,-2,1,0,1,0,0,0,0,0,0,0,0,0,1,0,1,0,0,0,0,0,0,0,0,0,0,0,0,0,0,0
122728,21043,210,43,-2,1,1,0,0,0,0,1,1,0,0,0,0,0,0,0,0,0,0,0,0,0,0,0,0,0,0,0,0,0,0
122755,21043,210,43,-2,3,1,2,0,0,0,0,0,0,0,0,0,0,0,0,0,0,0,2,1,1,0,0,0,1,0,1,0,0,0
123217,21043,210,43,-2,1,1,0,0,0,0,0,0,0,0,0,0,0,0,0,0,0,0,0,0,0,1,1,0,0,0,0,0,0,0
125727,21043,210,43,-2,2,2,0,0,0,0,1,1,0,1,1,0,0,0,0,0,0,0,0,0,0,0,0,0,0,0,0,0,0,0
126562,21043,210,43,-2,1,0,1,0,0,0,0,0,0,1,0,1,0,0,0,0,0,0,0,0,0,0,0,0,0,0,0,0,0,0
126775,21043,210,43,-2,4,3,1,0,0,0,0,0,0,0,0,0,1,1,0,0,0,0,2,1,1,0,0,0,1,1,0,0,0,0
127556,21043,210,43,-2,1,0,1,0,0,0,0,0,0,0,0,0,0,0,0,0,0,0,1,0,1,0,0,0,0,0,0,0,0,0
127884,21043,210,43,-2,8,2,6,1,0,1,1,1,0,0,0,0,1,0,1,0,0,0,5,1,4,0,0,0,0,0,0,0,0,0
128106,21043,210,43,-2,4,2,2,0,0,0,1,0,1,0,0,0,1,1,0,0,0,0,2,1,1,0,0,0,0,0,0,0,0,0
128328,21043,210,43,-2,11,6,5,0,0,0,0,0,0,0,0,0,0,0,0,0,0,0,2,1,1,0,0,0,9,5,4,0,0,0
129020,21043,210,43,-2,3,2,1,0,0,0,0,0,0,0,0,0,0,0,0,0,0,0,2,1,1,0,0,0,0,0,0,1,1,0
129525,21043,210,43,-2,8,4,4,0,0,0,0,0,0,0,0,0,0,0,0,0,0,0,6,3,3,0,0,0,0,0,0,2,1,1
130590,21043,210,43,-2,4,2,2,0,0,0,0,0,0,2,1,1,1,0,1,0,0,0,1,1,0,0,0,0,0,0,0,0,0,0
130794,21043,210,43,-2,11,4,7,0,0,0,2,1,1,0,0,0,0,0,0,0,0,0,6,1,5,0,0,0,0,0,0,3,2,1
131496,21043,210,43,-2,3,1,2,0,0,0,0,0,0,1,0,1,0,0,0,0,0,0,2,1,1,0,0,0,0,0,0,0,0,0
132693,21043,210,43,-2,3,1,2,0,0,0,0,0,0,2,1,1,0,0,0,0,0,0,1,0,1,0,0,0,0,0,0,0,0,0
132851,21043,210,43,-2,2,0,2,0,0,0,0,0,0,0,0,0,0,0,0,0,0,0,1,0,1,1,0,1,0,0,0,0,0,0
133702,21043,210,43,-2,2,2,0,0,0,0,0,0,0,0,0,0,0,0,0,0,0,0,2,2,0,0,0,0,0,0,0,0,0,0
133872,21043,210,43,-2,1,0,1,0,0,0,0,0,0,0,0,0,0,0,0,0,0,0,1,0,1,0,0,0,0,0,0,0,0,0
134343,21043,210,43,-2,12,3,9,0,0,0,0,0,0,1,0,1,1,0,1,0,0,0,8,2,6,0,0,0,2,1,1,0,0,0
134495,21043,210,43,-2,1,1,0,0,0,0,0,0,0,0,0,0,0,0,0,0,0,0,1,1,0,0,0,0,0,0,0,0,0,0
134608,21043,210,43,-2,2,1,1,0,0,0,0,0,0,1,0,1,0,0,0,0,0,0,1,1,0,0,0,0,0,0,0,0,0,0
136145,21043,210,43,-2,2,0,2,0,0,0,0,0,0,0,0,0,0,0,0,0,0,0,2,0,2,0,0,0,0,0,0,0,0,0
136233,21043,210,43,-2,12,6,6,0,0,0,0,0,0,1,0,1,3,2,1,0,0,0,6,3,3,1,1,0,0,0,0,1,0,1
136950,21043,210,43,-2,1,1,0,0,0,0,0,0,0,0,0,0,0,0,0,0,0,0,1,1,0,0,0,0,0,0,0,0,0,0
137078,21043,210,43,-2,9,0,9,0,0,0,0,0,0,0,0,0,1,0,1,0,0,0,6,0,6,0,0,0,2,0,2,0,0,0
137351,21043,210,43,-2,7,4,3,0,0,0,2,2,0,0,0,0,1,0,1,0,0,0,4,2,2,0,0,0,0,0,0,0,0,0
138354,21043,210,43,-2,6,3,3,0,0,0,1,1,0,1,0,1,0,0,0,0,0,0,4,2,2,0,0,0,0,0,0,0,0,0
138682,21043,210,43,-2,4,3,1,0,0,0,1,1,0,1,0,1,0,0,0,0,0,0,1,1,0,0,0,0,1,1,0,0,0,0
138761,21043,210,43,-2,2,1,1,0,0,0,0,0,0,0,0,0,0,0,0,0,0,0,2,1,1,0,0,0,0,0,0,0,0,0
138947,21043,210,43,-2,18,9,9,0,0,0,2,2,0,14,5,9,0,0,0,0,0,0,1,1,0,0,0,0,0,0,0,1,1,0
139144,21043,210,43,-2,14,8,6,0,0,0,1,1,0,2,0,2,1,0,1,0,0,0,8,6,2,1,0,1,0,0,0,1,1,0
139658,21043,210,43,-2,2,0,2,0,0,0,2,0,2,0,0,0,0,0,0,0,0,0,0,0,0,0,0,0,0,0,0,0,0,0
140012,21043,210,43,-2,2,1,1,0,0,0,0,0,0,1,0,1,1,1,0,0,0,0,0,0,0,0,0,0,0,0,0,0,0,0
140252,21043,210,43,-2,3,2,1,0,0,0,0,0,0,0,0,0,0,0,0,0,0,0,3,2,1,0,0,0,0,0,0,0,0,0
140678,21043,210,43,-2,1,0,1,0,0,0,0,0,0,0,0,0,0,0,0,0,0,0,1,0,1,0,0,0,0,0,0,0,0,0
141167,21043,210,43,-2,10,3,7,0,0,0,0,0,0,2,2,0,0,0,0,0,0,0,8,1,7,0,0,0,0,0,0,0,0,0
142294,21043,210,43,-2,4,3,1,0,0,0,1,1,0,0,0,0,1,1,0,0,0,0,1,0,1,0,0,0,0,0,0,1,1,0
144050,21043,210,43,-2,10,9,1,0,0,0,0,0,0,1,1,0,0,0,0,0,0,0,6,6,0,0,0,0,0,0,0,3,2,1
145707,21043,210,43,-2,1,0,1,0,0,0,0,0,0,0,0,0,0,0,0,0,0,0,1,0,1,0,0,0,0,0,0,0,0,0
145813,21043,210,43,-2,3,0,3,0,0,0,0,0,0,0,0,0,0,0,0,0,0,0,3,0,3,0,0,0,0,0,0,0,0,0
146366,21043,210,43,-2,1,1,0,0,0,0,0,0,0,0,0,0,0,0,0,0,0,0,1,1,0,0,0,0,0,0,0,0,0,0
148487,21043,210,43,-2,3,3,0,0,0,0,1,1,0,1,1,0,0,0,0,0,0,0,0,0,0,0,0,0,1,1,0,0,0,0
148575,21043,210,43,-2,1,1,0,0,0,0,0,0,0,0,0,0,0,0,0,0,0,0,1,1,0,0,0,0,0,0,0,0,0,0
149222,21043,210,43,-2,17,13,4,0,0,0,1,0,1,1,0,1,2,2,0,0,0,0,13,11,2,0,0,0,0,0,0,0,0,0
149781,21043,210,43,-2,1,1,0,0,0,0,0,0,0,0,0,0,0,0,0,0,0,0,1,1,0,0,0,0,0,0,0,0,0,0
150136,21043,210,43,-2,1,0,1,0,0,0,0,0,0,0,0,0,0,0,0,0,0,0,1,0,1,0,0,0,0,0,0,0,0,0
150987,21043,210,43,-2,11,5,6,0,0,0,0,0,0,3,2,1,0,0,0,0,0,0,8,3,5,0,0,0,0,0,0,0,0,0
152390,21043,210,43,-2,3,0,3,0,0,0,0,0,0,0,0,0,0,0,0,0,0,0,3,0,3,0,0,0,0,0,0,0,0,0
152992,21043,210,43,-2,2,2,0,0,0,0,0,0,0,0,0,0,0,0,0,0,0,0,2,2,0,0,0,0,0,0,0,0,0,0
153603,21043,210,43,-2,4,1,3,0,0,0,0,0,0,0,0,0,0,0,0,0,0,0,4,1,3,0,0,0,0,0,0,0,0,0
154095,21043,210,43,-2,3,1,2,0,0,0,1,1,0,0,0,0,0,0,0,0,0,0,2,0,2,0,0,0,0,0,0,0,0,0
155317,21043,210,43,-2,2,0,2,0,0,0,0,0,0,0,0,0,0,0,0,0,0,0,1,0,1,1,0,1,0,0,0,0,0,0
156189,21043,210,43,-2,5,3,2,0,0,0,0,0,0,0,0,0,0,0,0,0,0,0,5,3,2,0,0,0,0,0,0,0,0,0
156231,21043,210,43,-2,3,1,2,0,0,0,0,0,0,0,0,0,0,0,0,0,0,0,2,0,2,0,0,0,1,1,0,0,0,0
156338,21043,210,43,-2,3,1,2,0,0,0,0,0,0,1,0,1,0,0,0,0,0,0,1,1,0,0,0,0,1,0,1,0,0,0
156392,21043,210,43,-2,10,1,9,0,0,0,0,0,0,0,0,0,0,0,0,0,0,0,9,1,8,0,0,0,1,0,1,0,0,0
156620,21043,210,43,-2,4,1,3,0,0,0,0,0,0,1,0,1,0,0,0,0,0,0,2,1,1,0,0,0,0,0,0,1,0,1
156648,21043,210,43,-2,7,4,3,0,0,0,0,0,0,0,0,0,0,0,0,0,0,0,7,4,3,0,0,0,0,0,0,0,0,0
156745,21043,210,43,-2,1,1,0,0,0,0,1,1,0,0,0,0,0,0,0,0,0,0,0,0,0,0,0,0,0,0,0,0,0,0
156790,21043,210,43,-2,4,0,4,0,0,0,0,0,0,0,0,0,0,0,0,0,0,0,4,0,4,0,0,0,0,0,0,0,0,0
156851,21043,210,43,-2,4,0,4,0,0,0,0,0,0,0,0,0,0,0,0,0,0,0,3,0,3,0,0,0,1,0,1,0,0,0
156860,21043,210,43,-2,10,2,8,0,0,0,0,0,0,0,0,0,0,0,0,0,0,0,10,2,8,0,0,0,0,0,0,0,0,0
156921,21043,210,43,-2,18,7,11,1,1,0,2,1,1,2,1,1,0,0,0,0,0,0,12,4,8,1,0,1,0,0,0,0,0,0
157085,21043,210,43,-2,1,1,0,0,0,0,0,0,0,1,1,0,0,0,0,0,0,0,0,0,0,0,0,0,0,0,0,0,0,0
157289,21043,210,43,-2,1,1,0,0,0,0,0,0,0,0,0,0,0,0,0,0,0,0,1,1,0,0,0,0,0,0,0,0,0,0
157304,21043,210,43,-2,5,4,1,0,0,0,0,0,0,0,0,0,0,0,0,0,0,0,4,3,1,0,0,0,1,1,0,0,0,0
157331,21043,210,43,-2,5,1,4,0,0,0,0,0,0,0,0,0,0,0,0,0,0,0,5,1,4,0,0,0,0,0,0,0,0,0
157438,21043,210,43,-2,9,6,3,0,0,0,0,0,0,1,1,0,0,0,0,0,0,0,8,5,3,0,0,0,0,0,0,0,0,0
157483,21043,210,43,-2,7,2,5,0,0,0,0,0,0,1,0,1,0,0,0,0,0,0,6,2,4,0,0,0,0,0,0,0,0,0
157553,21043,210,43,-2,5,3,2,0,0,0,0,0,0,0,0,0,0,0,0,0,0,0,5,3,2,0,0,0,0,0,0,0,0,0
157711,21043,210,43,-2,5,4,1,0,0,0,0,0,0,0,0,0,1,1,0,0,0,0,4,3,1,0,0,0,0,0,0,0,0,0
157739,21043,210,43,-2,4,1,3,0,0,0,0,0,0,0,0,0,0,0,0,0,0,0,4,1,3,0,0,0,0,0,0,0,0,0
157757,21043,210,43,-2,4,0,4,0,0,0,0,0,0,0,0,0,0,0,0,0,0,0,4,0,4,0,0,0,0,0,0,0,0,0
157863,21043,210,43,-2,3,1,2,0,0,0,0,0,0,0,0,0,0,0,0,0,0,0,3,1,2,0,0,0,0,0,0,0,0,0
158088,21043,210,43,-2,3,0,3,0,0,0,0,0,0,1,0,1,0,0,0,0,0,0,2,0,2,0,0,0,0,0,0,0,0,0
158662,21043,210,43,-2,5,1,4,0,0,0,0,0,0,0,0,0,0,0,0,0,0,0,5,1,4,0,0,0,0,0,0,0,0,0
158884,21043,210,43,-2,3,1,2,0,0,0,0,0,0,0,0,0,0,0,0,0,0,0,3,1,2,0,0,0,0,0,0,0,0,0
159993,21043,210,43,-2,12,4,8,0,0,0,2,2,0,1,1,0,0,0,0,0,0,0,9,1,8,0,0,0,0,0,0,0,0,0
160010,21043,210,43,-2,1,0,1,0,0,0,0,0,0,0,0,0,0,0,0,0,0,0,1,0,1,0,0,0,0,0,0,0,0,0
160038,21043,210,43,-2,14,6,8,0,0,0,0,0,0,0,0,0,1,1,0,0,0,0,9,2,7,0,0,0,4,3,1,0,0,0
160579,21043,210,43,-2,1,0,1,0,0,0,0,0,0,1,0,1,0,0,0,0,0,0,0,0,0,0,0,0,0,0,0,0,0,0
160612,21043,210,43,-2,1,0,1,0,0,0,0,0,0,0,0,0,0,0,0,0,0,0,1,0,1,0,0,0,0,0,0,0,0,0
160649,21043,210,43,-2,1,0,1,0,0,0,0,0,0,1,0,1,0,0,0,0,0,0,0,0,0,0,0,0,0,0,0,0,0,0
160667,21043,210,43,-2,2,2,0,0,0,0,0,0,0,0,0,0,0,0,0,0,0,0,2,2,0,0,0,0,0,0,0,0,0,0
161022,21043,210,43,-2,2,0,2,0,0,0,0,0,0,0,0,0,0,0,0,0,0,0,2,0,2,0,0,0,0,0,0,0,0,0
161086,21043,210,43,-2,1,0,1,0,0,0,0,0,0,0,0,0,0,0,0,0,0,0,0,0,0,0,0,0,0,0,0,1,0,1
161518,21043,210,43,-2,1,0,1,0,0,0,0,0,0,0,0,0,0,0,0,0,0,0,1,0,1,0,0,0,0,0,0,0,0,0
161767,21043,210,43,-2,13,4,9,0,0,0,1,1,0,5,1,4,1,0,1,0,0,0,6,2,4,0,0,0,0,0,0,0,0,0
161864,21043,210,43,-2,7,3,4,0,0,0,1,1,0,3,0,3,0,0,0,0,0,0,3,2,1,0,0,0,0,0,0,0,0,0
162557,21043,210,43,-2,8,1,7,0,0,0,0,0,0,0,0,0,1,0,1,0,0,0,7,1,6,0,0,0,0,0,0,0,0,0
162928,21043,210,43,-2,1,0,1,0,0,0,0,0,0,0,0,0,0,0,0,0,0,0,1,0,1,0,0,0,0,0,0,0,0,0
163338,21043,210,43,-2,3,3,0,0,0,0,1,1,0,2,2,0,0,0,0,0,0,0,0,0,0,0,0,0,0,0,0,0,0,0
163851,21043,210,43,-2,6,2,4,0,0,0,0,0,0,0,0,0,1,1,0,0,0,0,5,1,4,0,0,0,0,0,0,0,0,0
164076,21043,210,43,-2,24,17,7,1,0,1,3,2,1,0,0,0,0,0,0,0,0,0,19,15,4,0,0,0,1,0,1,0,0,0
164465,21043,210,43,-2,1,1,0,0,0,0,0,0,0,1,1,0,0,0,0,0,0,0,0,0,0,0,0,0,0,0,0,0,0,0
164988,21043,210,43,-2,4,0,4,0,0,0,0,0,0,0,0,0,0,0,0,0,0,0,2,0,2,0,0,0,0,0,0,2,0,2
166638,21043,210,43,-2,8,4,4,0,0,0,1,0,1,0,0,0,0,0,0,0,0,0,5,4,1,0,0,0,2,0,2,0,0,0
168227,21043,210,43,-2,2,0,2,0,0,0,0,0,0,0,0,0,0,0,0,0,0,0,1,0,1,0,0,0,1,0,1,0,0,0
168421,21043,210,43,-2,22,14,8,0,0,0,1,0,1,1,0,1,2,1,1,0,0,0,9,7,2,1,0,1,3,2,1,5,4,1
168591,21043,210,43,-2,1,1,0,0,0,0,1,1,0,0,0,0,0,0,0,0,0,0,0,0,0,0,0,0,0,0,0,0,0,0
170639,21043,210,43,-2,2,1,1,0,0,0,0,0,0,0,0,0,0,0,0,0,0,0,2,1,1,0,0,0,0,0,0,0,0,0
170675,21043,210,43,-2,2,2,0,0,0,0,0,0,0,0,0,0,0,0,0,0,0,0,2,2,0,0,0,0,0,0,0,0,0,0
170976,21043,210,43,-2,36,16,20,1,1,0,1,1,0,0,0,0,0,0,0,0,0,0,26,8,18,2,1,1,0,0,0,6,5,1
171100,21043,210,43,-2,4,3,1,0,0,0,1,1,0,0,0,0,0,0,0,0,0,0,3,2,1,0,0,0,0,0,0,0,0,0
171137,21043,210,43,-2,2,1,1,0,0,0,0,0,0,0,0,0,0,0,0,0,0,0,1,1,0,1,0,1,0,0,0,0,0,0
171395,21043,210,43,-2,3,2,1,0,0,0,0,0,0,0,0,0,0,0,0,0,0,0,3,2,1,0,0,0,0,0,0,0,0,0
171535,21043,210,43,-2,1,1,0,0,0,0,0,0,0,0,0,0,0,0,0,0,0,0,1,1,0,0,0,0,0,0,0,0,0,0
172440,21043,210,43,-2,6,1,5,0,0,0,0,0,0,0,0,0,0,0,0,0,0,0,6,1,5,0,0,0,0,0,0,0,0,0
173142,21043,210,43,-2,2,1,1,0,0,0,0,0,0,0,0,0,0,0,0,0,0,0,2,1,1,0,0,0,0,0,0,0,0,0
174066,21043,210,43,-2,1,1,0,0,0,0,0,0,0,0,0,0,0,0,0,0,0,0,0,0,0,0,0,0,0,0,0,1,1,0
175643,21043,210,43,-2,3,2,1,0,0,0,0,0,0,0,0,0,0,0,0,0,0,0,3,2,1,0,0,0,0,0,0,0,0,0
175883,21043,210,43,-2,6,4,2,0,0,0,0,0,0,1,0,1,0,0,0,0,0,0,5,4,1,0,0,0,0,0,0,0,0,0
176017,21043,210,43,-2,3,0,3,0,0,0,0,0,0,0,0,0,0,0,0,0,0,0,0,0,0,0,0,0,0,0,0,3,0,3
176080,21043,210,43,-2,25,7,18,0,0,0,0,0,0,4,0,4,1,0,1,0,0,0,17,5,12,0,0,0,0,0,0,3,2,1
177144,21043,210,43,-2,1,1,0,0,0,0,0,0,0,0,0,0,0,0,0,0,0,0,1,1,0,0,0,0,0,0,0,0,0,0
177472,21043,210,43,-2,1,1,0,0,0,0,0,0,0,0,0,0,0,0,0,0,0,0,1,1,0,0,0,0,0,0,0,0,0,0
179308,21043,210,43,-2,13,5,8,0,0,0,0,0,0,2,0,2,0,0,0,0,0,0,9,4,5,0,0,0,1,0,1,1,1,0
180203,21043,210,43,-2,1,1,0,1,1,0,0,0,0,0,0,0,0,0,0,0,0,0,0,0,0,0,0,0,0,0,0,0,0,0
180461,21043,210,43,-2,11,4,7,0,0,0,0,0,0,0,0,0,0,0,0,0,0,0,11,4,7,0,0,0,0,0,0,0,0,0
180489,21043,210,43,-2,1,0,1,0,0,0,0,0,0,0,0,0,0,0,0,0,0,0,1,0,1,0,0,0,0,0,0,0,0,0
180902,21043,210,43,-2,9,6,3,0,0,0,2,1,1,0,0,0,0,0,0,0,0,0,7,5,2,0,0,0,0,0,0,0,0,0
181428,21043,210,43,-2,2,0,2,0,0,0,0,0,0,1,0,1,0,0,0,0,0,0,1,0,1,0,0,0,0,0,0,0,0,0
183859,21043,210,43,-2,2,1,1,0,0,0,0,0,0,0,0,0,0,0,0,0,0,0,1,0,1,0,0,0,1,1,0,0,0,0
185828,21043,210,43,-2,1,0,1,0,0,0,0,0,0,0,0,0,0,0,0,0,0,0,1,0,1,0,0,0,0,0,0,0,0,0
187532,21043,210,43,-2,2,0,2,0,0,0,0,0,0,0,0,0,0,0,0,0,0,0,2,0,2,0,0,0,0,0,0,0,0,0
187596,21043,210,43,-2,17,12,5,5,3,2,0,0,0,2,1,1,0,0,0,0,0,0,6,5,1,0,0,0,1,1,0,3,2,1
188058,21043,210,43,-2,1,1,0,0,0,0,0,0,0,0,0,0,0,0,0,0,0,0,0,0,0,0,0,0,1,1,0,0,0,0
188438,21043,210,43,-2,1,0,1,0,0,0,0,0,0,0,0,0,0,0,0,0,0,0,1,0,1,0,0,0,0,0,0,0,0,0
188535,21043,210,43,-2,1,0,1,0,0,0,0,0,0,1,0,1,0,0,0,0,0,0,0,0,0,0,0,0,0,0,0,0,0,0
188641,21043,210,43,-2,2,1,1,0,0,0,0,0,0,0,0,0,0,0,0,0,0,0,0,0,0,1,0,1,0,0,0,1,1,0
190150,21043,210,43,-2,85,43,42,0,0,0,19,9,10,9,3,6,4,3,1,0,0,0,28,10,18,1,1,0,7,4,3,17,13,4
190415,21043,210,43,-2,27,15,12,0,0,0,4,2,2,2,2,0,1,1,0,0,0,0,12,7,5,0,0,0,0,0,0,8,3,5
190725,21043,210,43,-2,4,0,4,0,0,0,0,0,0,0,0,0,0,0,0,0,0,0,4,0,4,0,0,0,0,0,0,0,0,0
191205,21043,210,43,-2,2,0,2,0,0,0,1,0,1,0,0,0,0,0,0,0,0,0,1,0,1,0,0,0,0,0,0,0,0,0
191241,21043,210,43,-2,1,0,1,0,0,0,0,0,0,0,0,0,0,0,0,0,0,0,1,0,1,0,0,0,0,0,0,0,0,0
191649,21043,210,43,-2,1,1,0,0,0,0,1,1,0,0,0,0,0,0,0,0,0,0,0,0,0,0,0,0,0,0,0,0,0,0
191931,21043,210,43,-2,13,7,6,0,0,0,2,1,1,2,1,1,1,0,1,0,0,0,7,4,3,0,0,0,1,1,0,0,0,0
192022,21043,210,43,-2,1,1,0,0,0,0,0,0,0,0,0,0,0,0,0,0,0,0,1,1,0,0,0,0,0,0,0,0,0,0
192785,21043,210,43,-2,1,0,1,0,0,0,0,0,0,0,0,0,0,0,0,0,0,0,1,0,1,0,0,0,0,0,0,0,0,0
193283,21043,210,43,-2,1,0,1,0,0,0,0,0,0,0,0,0,0,0,0,0,0,0,1,0,1,0,0,0,0,0,0,0,0,0
193654,21043,210,43,-2,3,1,2,0,0,0,0,0,0,0,0,0,0,0,0,0,0,0,3,1,2,0,0,0,0,0,0,0,0,0
194499,21043,210,43,-2,1,1,0,0,0,0,0,0,0,0,0,0,1,1,0,0,0,0,0,0,0,0,0,0,0,0,0,0,0,0
195058,21043,210,43,-2,3,2,1,0,0,0,0,0,0,0,0,0,0,0,0,0,0,0,3,2,1,0,0,0,0,0,0,0,0,0
196006,21043,210,43,-2,8,5,3,0,0,0,0,0,0,0,0,0,0,0,0,0,0,0,7,4,3,0,0,0,0,0,0,1,1,0
196060,21043,210,43,-2,5,2,3,0,0,0,0,0,0,0,0,0,0,0,0,0,0,0,5,2,3,0,0,0,0,0,0,0,0,0
196103,21043,210,43,-2,1,1,0,0,0,0,0,0,0,0,0,0,0,0,0,0,0,0,1,1,0,0,0,0,0,0,0,0,0,0
196130,21043,210,43,-2,1,0,1,0,0,0,0,0,0,0,0,0,0,0,0,0,0,0,1,0,1,0,0,0,0,0,0,0,0,0
196149,21043,210,43,-2,1,1,0,0,0,0,0,0,0,0,0,0,0,0,0,0,0,0,1,1,0,0,0,0,0,0,0,0,0,0
196158,21043,210,43,-2,1,1,0,0,0,0,0,0,0,1,1,0,0,0,0,0,0,0,0,0,0,0,0,0,0,0,0,0,0,0
196413,21043,210,43,-2,2,1,1,0,0,0,0,0,0,0,0,0,0,0,0,0,0,0,1,0,1,0,0,0,0,0,0,1,1,0
196468,21043,210,43,-2,2,1,1,0,0,0,0,0,0,0,0,0,0,0,0,0,0,0,1,0,1,0,0,0,0,0,0,1,1,0
197869,21043,210,43,-2,1,0,1,0,0,0,0,0,0,0,0,0,0,0,0,0,0,0,1,0,1,0,0,0,0,0,0,0,0,0
198154,21043,210,43,-2,1,0,1,0,0,0,0,0,0,0,0,0,0,0,0,0,0,0,1,0,1,0,0,0,0,0,0,0,0,0
198215,21043,210,43,-2,3,1,2,0,0,0,0,0,0,0,0,0,0,0,0,0,0,0,3,1,2,0,0,0,0,0,0,0,0,0
198321,21043,210,43,-2,3,0,3,0,0,0,0,0,0,0,0,0,1,0,1,0,0,0,2,0,2,0,0,0,0,0,0,0,0,0
198464,21043,210,43,-2,21,5,16,0,0,0,1,0,1,3,0,3,4,1,3,0,0,0,10,3,7,2,0,2,0,0,0,1,1,0
198507,21043,210,43,-2,1,1,0,0,0,0,0,0,0,1,1,0,0,0,0,0,0,0,0,0,0,0,0,0,0,0,0,0,0,0
198534,21043,210,43,-2,4,1,3,1,0,1,0,0,0,1,0,1,0,0,0,0,0,0,2,1,1,0,0,0,0,0,0,0,0,0
198570,21043,210,43,-2,19,8,11,0,0,0,0,0,0,0,0,0,0,0,0,0,0,0,19,8,11,0,0,0,0,0,0,0,0,0
199102,21043,210,43,-2,2,1,1,0,0,0,0,0,0,0,0,0,1,0,1,0,0,0,1,1,0,0,0,0,0,0,0,0,0,0
199111,21043,210,43,-2,1,1,0,0,0,0,0,0,0,0,0,0,0,0,0,0,0,0,0,0,0,0,0,0,1,1,0,0,0,0
199120,21043,210,43,-2,12,5,7,0,0,0,0,0,0,1,0,1,2,1,1,0,0,0,4,3,1,0,0,0,3,0,3,2,1,1
199139,21043,210,43,-2,1,0,1,0,0,0,0,0,0,0,0,0,0,0,0,0,0,0,1,0,1,0,0,0,0,0,0,0,0,0
199148,21043,210,43,-2,1,0,1,0,0,0,0,0,0,0,0,0,0,0,0,0,0,0,0,0,0,0,0,0,0,0,0,1,0,1
199193,21043,210,43,-2,8,5,3,0,0,0,0,0,0,1,0,1,0,0,0,0,0,0,7,5,2,0,0,0,0,0,0,0,0,0
199306,21043,210,43,-2,3,1,2,0,0,0,0,0,0,2,1,1,0,0,0,0,0,0,1,0,1,0,0,0,0,0,0,0,0,0
199476,21043,210,43,-2,4,0,4,1,0,1,0,0,0,1,0,1,0,0,0,0,0,0,2,0,2,0,0,0,0,0,0,0,0,0
199856,21043,210,43,-2,4,1,3,0,0,0,0,0,0,1,0,1,0,0,0,0,0,0,2,1,1,0,0,0,1,0,1,0,0,0
199953,21043,210,43,-2,2,1,1,0,0,0,0,0,0,1,1,0,0,0,0,0,0,0,1,0,1,0,0,0,0,0,0,0,0,0
199999,21043,210,43,-2,4,0,4,0,0,0,0,0,0,3,0,3,0,0,0,0,0,0,1,0,1,0,0,0,0,0,0,0,0,0
200004,21043,210,43,-2,4,2,2,0,0,0,0,0,0,0,0,0,0,0,0,0,0,0,4,2,2,0,0,0,0,0,0,0,0,0
200466,21043,210,43,-2,1,1,0,0,0,0,0,0,0,0,0,0,0,0,0,0,0,0,1,1,0,0,0,0,0,0,0,0,0,0
200527,21043,210,43,-2,4,3,1,3,2,1,0,0,0,0,0,0,0,0,0,0,0,0,1,1,0,0,0,0,0,0,0,0,0,0
202356,21043,210,43,-2,26,8,18,0,0,0,0,0,0,3,0,3,1,0,1,0,0,0,19,6,13,2,1,1,1,1,0,0,0,0
204501,21043,210,43,-2,17,10,7,0,0,0,0,0,0,0,0,0,0,0,0,0,0,0,13,6,7,0,0,0,0,0,0,4,4,0
204945,21043,210,43,-2,3,0,3,0,0,0,0,0,0,0,0,0,0,0,0,0,0,0,3,0,3,0,0,0,0,0,0,0,0,0
205966,21043,210,43,-2,4,3,1,0,0,0,0,0,0,0,0,0,0,0,0,0,0,0,4,3,1,0,0,0,0,0,0,0,0,0
206084,21043,210,43,-2,6,4,2,0,0,0,3,2,1,0,0,0,0,0,0,0,0,0,2,1,1,1,1,0,0,0,0,0,0,0
206604,21043,210,43,-2,6,3,3,0,0,0,1,1,0,1,0,1,0,0,0,0,0,0,4,2,2,0,0,0,0,0,0,0,0,0
206622,21043,210,43,-2,1,0,1,0,0,0,1,0,1,0,0,0,0,0,0,0,0,0,0,0,0,0,0,0,0,0,0,0,0,0
207263,21043,210,43,-2,2,0,2,1,0,1,0,0,0,0,0,0,0,0,0,0,0,0,1,0,1,0,0,0,0,0,0,0,0,0
207500,21043,210,43,-2,3,2,1,0,0,0,0,0,0,0,0,0,0,0,0,0,0,0,2,1,1,0,0,0,0,0,0,1,1,0
207722,21043,210,43,-2,1,1,0,1,1,0,0,0,0,0,0,0,0,0,0,0,0,0,0,0,0,0,0,0,0,0,0,0,0,0
207856,21043,210,43,-2,3,2,1,0,0,0,0,0,0,0,0,0,0,0,0,0,0,0,3,2,1,0,0,0,0,0,0,0,0,0
208512,21043,210,43,-2,4,2,2,0,0,0,0,0,0,0,0,0,0,0,0,0,0,0,0,0,0,4,2,2,0,0,0,0,0,0
209490,21043,210,43,-2,2,0,2,0,0,0,0,0,0,0,0,0,0,0,0,0,0,0,1,0,1,0,0,0,0,0,0,1,0,1
209825,21043,210,43,-2,2,1,1,0,0,0,0,0,0,0,0,0,0,0,0,0,0,0,1,1,0,0,0,0,1,0,1,0,0,0
210304,21043,210,43,-2,1,1,0,0,0,0,0,0,0,0,0,0,0,0,0,0,0,0,1,1,0,0,0,0,0,0,0,0,0,0
211079,21043,210,43,-2,4,1,3,0,0,0,1,1,0,0,0,0,0,0,0,0,0,0,3,0,3,0,0,0,0,0,0,0,0,0
211273,21043,210,43,-2,7,2,5,0,0,0,2,0,2,0,0,0,0,0,0,0,0,0,2,1,1,1,1,0,2,0,2,0,0,0
211583,21043,210,43,-2,3,2,1,0,0,0,0,0,0,1,1,0,0,0,0,0,0,0,2,1,1,0,0,0,0,0,0,0,0,0
212009,21043,210,43,-2,1,0,1,0,0,0,0,0,0,0,0,0,1,0,1,0,0,0,0,0,0,0,0,0,0,0,0,0,0,0
214148,21043,210,43,-2,1,1,0,0,0,0,0,0,0,0,0,0,1,1,0,0,0,0,0,0,0,0,0,0,0,0,0,0,0,0
214175,21043,210,43,-2,1,1,0,0,0,0,0,0,0,0,0,0,0,0,0,0,0,0,1,1,0,0,0,0,0,0,0,0,0,0
214892,21043,210,43,-2,11,4,7,0,0,0,0,0,0,0,0,0,0,0,0,0,0,0,11,4,7,0,0,0,0,0,0,0,0,0
215239,21043,210,43,-2,1,0,1,0,0,0,0,0,0,1,0,1,0,0,0,0,0,0,0,0,0,0,0,0,0,0,0,0,0,0
215266,21043,210,43,-2,3,3,0,0,0,0,0,0,0,1,1,0,0,0,0,0,0,0,1,1,0,0,0,0,0,0,0,1,1,0
215275,21043,210,43,-2,5,1,4,0,0,0,0,0,0,0,0,0,0,0,0,0,0,0,3,0,3,0,0,0,2,1,1,0,0,0
215284,21043,210,43,-2,4,1,3,0,0,0,0,0,0,0,0,0,0,0,0,0,0,0,3,1,2,0,0,0,0,0,0,1,0,1
215293,21043,210,43,-2,47,19,28,0,0,0,5,1,4,4,0,4,1,0,1,0,0,0,23,11,12,0,0,0,6,3,3,8,4,4
215442,21043,210,43,-2,5,3,2,0,0,0,1,0,1,1,1,0,0,0,0,0,0,0,3,2,1,0,0,0,0,0,0,0,0,0
217156,21043,210,43,-2,7,3,4,0,0,0,0,0,0,0,0,0,0,0,0,0,0,0,3,1,2,0,0,0,1,0,1,3,2,1
217402,21043,210,43,-2,6,4,2,0,0,0,1,1,0,0,0,0,0,0,0,0,0,0,3,1,2,0,0,0,0,0,0,2,2,0
217484,21043,210,43,-2,3,2,1,0,0,0,0,0,0,0,0,0,0,0,0,0,0,0,3,2,1,0,0,0,0,0,0,0,0,0
218229,21043,210,43,-2,22,5,17,0,0,0,0,0,0,2,0,2,1,1,0,0,0,0,19,4,15,0,0,0,0,0,0,0,0,0
218751,21043,210,43,-2,4,2,2,0,0,0,0,0,0,0,0,0,0,0,0,0,0,0,3,1,2,1,1,0,0,0,0,0,0,0
219295,21043,210,43,-2,4,0,4,0,0,0,0,0,0,0,0,0,0,0,0,0,0,0,4,0,4,0,0,0,0,0,0,0,0,0
219709,21043,210,43,-2,3,0,3,0,0,0,0,0,0,3,0,3,0,0,0,0,0,0,0,0,0,0,0,0,0,0,0,0,0,0
219888,21043,210,43,-2,3,0,3,0,0,0,1,0,1,0,0,0,0,0,0,0,0,0,2,0,2,0,0,0,0,0,0,0,0,0
220862,21043,210,43,-2,1,1,0,0,0,0,0,0,0,1,1,0,0,0,0,0,0,0,0,0,0,0,0,0,0,0,0,0,0,0
220978,21043,210,43,-2,4,2,2,0,0,0,0,0,0,0,0,0,0,0,0,0,0,0,4,2,2,0,0,0,0,0,0,0,0,0
221184,21043,210,43,-2,9,3,6,0,0,0,0,0,0,1,0,1,0,0,0,0,0,0,6,3,3,0,0,0,0,0,0,2,0,2
221397,21043,210,43,-2,3,0,3,0,0,0,0,0,0,0,0,0,0,0,0,0,0,0,3,0,3,0,0,0,0,0,0,0,0,0
221759,21043,210,43,-2,4,2,2,0,0,0,1,1,0,0,0,0,1,0,1,0,0,0,2,1,1,0,0,0,0,0,0,0,0,0
221838,21043,210,43,-2,1,1,0,0,0,0,0,0,0,0,0,0,0,0,0,0,0,0,1,1,0,0,0,0,0,0,0,0,0,0
221953,21043,210,43,-2,4,1,3,0,0,0,0,0,0,0,0,0,0,0,0,0,0,0,4,1,3,0,0,0,0,0,0,0,0,0
221999,21043,210,43,-2,9,3,6,0,0,0,0,0,0,0,0,0,0,0,0,0,0,0,4,1,3,0,0,0,4,1,3,1,1,0
222053,21043,210,43,-2,4,3,1,0,0,0,0,0,0,0,0,0,0,0,0,0,0,0,4,3,1,0,0,0,0,0,0,0,0,0
223427,21043,210,43,-2,5,2,3,0,0,0,0,0,0,2,1,1,0,0,0,0,0,0,3,1,2,0,0,0,0,0,0,0,0,0
224110,21043,210,43,-2,9,3,6,1,0,1,0,0,0,0,0,0,0,0,0,0,0,0,6,2,4,2,1,1,0,0,0,0,0,0
224350,21043,210,43,-2,4,3,1,0,0,0,0,0,0,0,0,0,1,1,0,0,0,0,3,2,1,0,0,0,0,0,0,0,0,0
224642,21043,210,43,-2,11,4,7,0,0,0,0,0,0,0,0,0,5,2,3,0,0,0,6,2,4,0,0,0,0,0,0,0,0,0
225308,21043,210,43,-2,7,0,7,0,0,0,0,0,0,0,0,0,0,0,0,0,0,0,7,0,7,0,0,0,0,0,0,0,0,0
225414,21043,210,43,-2,1,0,1,0,0,0,0,0,0,1,0,1,0,0,0,0,0,0,0,0,0,0,0,0,0,0,0,0,0,0
225511,21043,210,43,-2,1,1,0,0,0,0,0,0,0,0,0,0,0,0,0,0,0,0,0,0,0,0,0,0,0,0,0,1,1,0
226019,21043,210,43,-2,11,5,6,0,0,0,0,0,0,0,0,0,0,0,0,0,0,0,11,5,6,0,0,0,0,0,0,0,0,0
226091,21043,210,43,-2,4,0,4,0,0,0,0,0,0,1,0,1,0,0,0,0,0,0,3,0,3,0,0,0,0,0,0,0,0,0
226134,21043,210,43,-2,2,2,0,0,0,0,0,0,0,0,0,0,2,2,0,0,0,0,0,0,0,0,0,0,0,0,0,0,0,0
226383,21043,210,43,-2,3,2,1,0,0,0,0,0,0,0,0,0,0,0,0,0,0,0,3,2,1,0,0,0,0,0,0,0,0,0
226578,21043,210,43,-2,2,1,1,0,0,0,0,0,0,0,0,0,0,0,0,0,0,0,2,1,1,0,0,0,0,0,0,0,0,0
226833,21043,210,43,-2,2,0,2,0,0,0,0,0,0,0,0,0,0,0,0,0,0,0,2,0,2,0,0,0,0,0,0,0,0,0
227216,21043,210,43,-2,29,12,17,0,0,0,1,0,1,3,1,2,5,1,4,0,0,0,17,9,8,2,1,1,1,0,1,0,0,0
227526,21043,210,43,-2,6,4,2,0,0,0,0,0,0,2,1,1,0,0,0,0,0,0,3,2,1,0,0,0,0,0,0,1,1,0
227687,21043,210,43,-2,3,3,0,0,0,0,0,0,0,0,0,0,1,1,0,0,0,0,2,2,0,0,0,0,0,0,0,0,0,0
227845,21043,210,43,-2,1,0,1,0,0,0,0,0,0,1,0,1,0,0,0,0,0,0,0,0,0,0,0,0,0,0,0,0,0,0
227881,21043,210,43,-2,27,11,16,0,0,0,2,0,2,1,0,1,4,4,0,0,0,0,18,7,11,0,0,0,0,0,0,2,0,2
228246,21043,210,43,-2,1,0,1,0,0,0,0,0,0,0,0,0,0,0,0,0,0,0,1,0,1,0,0,0,0,0,0,0,0,0
228431,21043,210,43,-2,1,1,0,0,0,0,0,0,0,0,0,0,0,0,0,0,0,0,0,0,0,0,0,0,0,0,0,1,1,0
228501,21043,210,43,-2,1,1,0,0,0,0,0,0,0,0,0,0,0,0,0,0,0,0,1,1,0,0,0,0,0,0,0,0,0,0
228723,21043,210,43,-2,15,9,6,0,0,0,0,0,0,0,0,0,0,0,0,0,0,0,12,7,5,1,1,0,2,1,1,0,0,0
228769,21043,210,43,-2,30,8,22,0,0,0,6,3,3,4,0,4,0,0,0,1,0,1,9,1,8,1,0,1,6,2,4,3,2,1
228778,21043,210,43,-2,6,2,4,0,0,0,1,0,1,0,0,0,1,1,0,0,0,0,4,1,3,0,0,0,0,0,0,0,0,0
228802,21043,210,43,-2,1,0,1,0,0,0,0,0,0,0,0,0,0,0,0,0,0,0,1,0,1,0,0,0,0,0,0,0,0,0
229115,21043,210,43,-2,28,13,15,0,0,0,1,0,1,1,1,0,4,2,2,0,0,0,18,9,9,0,0,0,0,0,0,4,1,3
229540,21043,210,43,-2,1,0,1,0,0,0,0,0,0,0,0,0,0,0,0,0,0,0,1,0,1,0,0,0,0,0,0,0,0,0
230764,21043,210,43,-2,8,4,4,0,0,0,0,0,0,0,0,0,1,1,0,0,0,0,7,3,4,0,0,0,0,0,0,0,0,0
230995,21043,210,43,-2,1,0,1,0,0,0,0,0,0,0,0,0,0,0,0,0,0,0,1,0,1,0,0,0,0,0,0,0,0,0
231624,21043,210,43,-2,1,0,1,0,0,0,0,0,0,0,0,0,0,0,0,0,0,0,1,0,1,0,0,0,0,0,0,0,0,0
232308,21043,210,43,-2,1,0,1,0,0,0,0,0,0,1,0,1,0,0,0,0,0,0,0,0,0,0,0,0,0,0,0,0,0,0
232618,21043,210,43,-2,3,0,3,0,0,0,0,0,0,0,0,0,0,0,0,0,0,0,3,0,3,0,0,0,0,0,0,0,0,0
232681,21043,210,43,-2,7,5,2,0,0,0,1,1,0,0,0,0,0,0,0,0,0,0,6,4,2,0,0,0,0,0,0,0,0,0
232937,21043,210,43,-2,1,0,1,0,0,0,0,0,0,1,0,1,0,0,0,0,0,0,0,0,0,0,0,0,0,0,0,0,0,0
233356,21043,210,43,-2,3,2,1,0,0,0,0,0,0,1,1,0,0,0,0,0,0,0,2,1,1,0,0,0,0,0,0,0,0,0
233374,21043,210,43,-2,9,4,5,0,0,0,0,0,0,0,0,0,0,0,0,0,0,0,7,3,4,1,0,1,1,1,0,0,0,0
233718,21043,210,43,-2,1,0,1,0,0,0,0,0,0,0,0,0,0,0,0,0,0,0,1,0,1,0,0,0,0,0,0,0,0,0
235149,21043,210,43,-2,1,0,1,0,0,0,0,0,0,0,0,0,0,0,0,0,0,0,0,0,0,1,0,1,0,0,0,0,0,0
235167,21043,210,43,-2,1,0,1,0,0,0,0,0,0,0,0,0,0,0,0,0,0,0,0,0,0,0,0,0,1,0,1,0,0,0
235316,21043,210,43,-2,1,1,0,0,0,0,0,0,0,0,0,0,0,0,0,0,0,0,1,1,0,0,0,0,0,0,0,0,0,0
236230,21043,210,43,-2,1,0,1,0,0,0,0,0,0,0,0,0,0,0,0,0,0,0,0,0,0,0,0,0,1,0,1,0,0,0
239220,21043,210,43,-2,9,4,5,0,0,0,1,1,0,0,0,0,0,0,0,0,0,0,8,3,5,0,0,0,0,0,0,0,0,0
239716,21043,210,43,-2,1,1,0,0,0,0,0,0,0,0,0,0,0,0,0,0,0,0,1,1,0,0,0,0,0,0,0,0,0,0
240620,21043,210,43,-2,1,0,1,0,0,0,0,0,0,0,0,0,0,0,0,0,0,0,0,0,0,0,0,0,1,0,1,0,0,0
240745,21043,210,43,-2,1,0,1,0,0,0,0,0,0,0,0,0,0,0,0,0,0,0,1,0,1,0,0,0,0,0,0,0,0,0
241191,21043,210,43,-2,1,0,1,0,0,0,0,0,0,0,0,0,1,0,1,0,0,0,0,0,0,0,0,0,0,0,0,0,0,0
242130,21043,210,43,-2,1,1,0,0,0,0,0,0,0,0,0,0,1,1,0,0,0,0,0,0,0,0,0,0,0,0,0,0,0,0
243443,21043,210,43,-2,13,3,10,0,0,0,0,0,0,0,0,0,13,3,10,0,0,0,0,0,0,0,0,0,0,0,0,0,0,0
247940,21043,210,43,-2,2,0,2,0,0,0,0,0,0,0,0,0,0,0,0,0,0,0,2,0,2,0,0,0,0,0,0,0,0,0
363633,21043,210,43,-2,1,0,1,0,0,0,0,0,0,0,0,0,1,0,1,0,0,0,0,0,0,0,0,0,0,0,0,0,0,0
366252,21043,210,43,-2,1,1,0,0,0,0,0,0,0,0,0,0,0,0,0,0,0,0,1,1,0,0,0,0,0,0,0,0,0,0
366340,21043,210,43,-2,1,0,1,0,0,0,0,0,0,0,0,0,0,0,0,0,0,0,1,0,1,0,0,0,0,0,0,0,0,0
366711,21043,210,43,-2,3,0,3,0,0,0,0,0,0,0,0,0,1,0,1,0,0,0,2,0,2,0,0,0,0,0,0,0,0,0
403469,21043,210,43,-2,1,0,1,0,0,0,0,0,0,0,0,0,0,0,0,0,0,0,1,0,1,0,0,0,0,0,0,0,0,0
404994,21043,210,43,-2,6,2,4,0,0,0,0,0,0,0,0,0,3,1,2,0,0,0,3,1,2,0,0,0,0,0,0,0,0,0
408844,21043,210,43,-2,13,7,6,0,0,0,0,0,0,2,1,1,11,6,5,0,0,0,0,0,0,0,0,0,0,0,0,0,0,0
409698,21043,210,43,-2,2,1,1,0,0,0,0,0,0,0,0,0,1,1,0,0,0,0,1,0,1,0,0,0,0,0,0,0,0,0
440262,21043,210,43,-2,1,1,0,0,0,0,0,0,0,0,0,0,1,1,0,0,0,0,0,0,0,0,0,0,0,0,0,0,0,0
441760,21043,210,43,-2,3,0,3,1,0,1,0,0,0,0,0,0,0,0,0,0,0,0,2,0,2,0,0,0,0,0,0,0,0,0
451510,21043,210,43,-2,1,1,0,0,0,0,0,0,0,0,0,0,0,0,0,0,0,0,1,1,0,0,0,0,0,0,0,0,0,0
460677,21043,210,43,-2,3,0,3,0,0,0,0,0,0,0,0,0,3,0,3,0,0,0,0,0,0,0,0,0,0,0,0,0,0,0
461148,21043,210,43,-2,3,0,3,0,0,0,0,0,0,0,0,0,1,0,1,0,0,0,2,0,2,0,0,0,0,0,0,0,0,0
475033,21043,210,43,-2,1,0,1,0,0,0,0,0,0,1,0,1,0,0,0,0,0,0,0,0,0,0,0,0,0,0,0,0,0,0
482936,21043,210,43,-2,2,2,0,0,0,0,1,1,0,0,0,0,0,0,0,0,0,0,0,0,0,0,0,0,0,0,0,1,1,0
483036,21043,210,43,-2,3,2,1,0,0,0,1,0,1,0,0,0,0,0,0,0,0,0,0,0,0,0,0,0,0,0,0,2,2,0
483212,21043,210,43,-2,14,6,8,0,0,0,0,0,0,3,1,2,0,0,0,0,0,0,10,4,6,1,1,0,0,0,0,0,0,0
483595,21043,210,43,-2,6,3,3,0,0,0,0,0,0,0,0,0,6,3,3,0,0,0,0,0,0,0,0,0,0,0,0,0,0,0
484905,21043,210,43,-2,1,0,1,0,0,0,0,0,0,0,0,0,0,0,0,0,0,0,1,0,1,0,0,0,0,0,0,0,0,0
485768,21043,210,43,-2,8,7,1,0,0,0,0,0,0,2,1,1,5,5,0,0,0,0,1,1,0,0,0,0,0,0,0,0,0,0
487320,21043,210,43,-2,1,1,0,0,0,0,0,0,0,0,0,0,1,1,0,0,0,0,0,0,0,0,0,0,0,0,0,0,0,0
491844,21043,210,43,-2,6,3,3,5,2,3,0,0,0,0,0,0,0,0,0,0,0,0,1,1,0,0,0,0,0,0,0,0,0,0
100706,21044,210,44,-2,11,1,10,0,0,0,1,0,1,1,0,1,0,0,0,0,0,0,8,0,8,0,0,0,0,0,0,1,1,0
101879,21044,210,44,-2,3,0,3,0,0,0,0,0,0,0,0,0,0,0,0,0,0,0,3,0,3,0,0,0,0,0,0,0,0,0
104151,21044,210,44,-2,5,4,1,0,0,0,1,1,0,1,1,0,1,0,1,0,0,0,0,0,0,0,0,0,2,2,0,0,0,0
104179,21044,210,44,-2,3,2,1,0,0,0,0,0,0,0,0,0,0,0,0,0,0,0,3,2,1,0,0,0,0,0,0,0,0,0
105589,21044,210,44,-2,1,0,1,0,0,0,0,0,0,1,0,1,0,0,0,0,0,0,0,0,0,0,0,0,0,0,0,0,0,0
106397,21044,210,44,-2,1,1,0,0,0,0,0,0,0,1,1,0,0,0,0,0,0,0,0,0,0,0,0,0,0,0,0,0,0,0
107080,21044,210,44,-2,5,2,3,0,0,0,0,0,0,0,0,0,0,0,0,0,0,0,4,2,2,0,0,0,0,0,0,1,0,1
107141,21044,210,44,-2,4,1,3,0,0,0,0,0,0,0,0,0,0,0,0,0,0,0,3,1,2,0,0,0,1,0,1,0,0,0
108092,21044,210,44,-2,6,3,3,0,0,0,2,2,0,0,0,0,0,0,0,0,0,0,4,1,3,0,0,0,0,0,0,0,0,0
110370,21044,210,44,-2,1,0,1,0,0,0,0,0,0,0,0,0,0,0,0,0,0,0,0,0,0,0,0,0,0,0,0,1,0,1
110404,21044,210,44,-2,12,9,3,0,0,0,1,0,1,0,0,0,2,2,0,0,0,0,3,1,2,0,0,0,0,0,0,6,6,0
110468,21044,210,44,-2,9,3,6,0,0,0,1,0,1,1,0,1,1,0,1,0,0,0,6,3,3,0,0,0,0,0,0,0,0,0
110486,21044,210,44,-2,1,1,0,0,0,0,0,0,0,0,0,0,0,0,0,0,0,0,0,0,0,1,1,0,0,0,0,0,0,0
110495,21044,210,44,-2,3,0,3,0,0,0,0,0,0,1,0,1,0,0,0,0,0,0,2,0,2,0,0,0,0,0,0,0,0,0
110538,21044,210,44,-2,1,1,0,0,0,0,0,0,0,0,0,0,0,0,0,0,0,0,1,1,0,0,0,0,0,0,0,0,0,0
110635,21044,210,44,-2,9,4,5,0,0,0,1,0,1,1,0,1,0,0,0,0,0,0,5,2,3,0,0,0,0,0,0,2,2,0
110644,21044,210,44,-2,95,37,58,0,0,0,16,3,13,5,2,3,13,2,11,0,0,0,43,18,25,0,0,0,4,1,3,14,11,3
110653,21044,210,44,-2,86,51,35,0,0,0,25,17,8,3,0,3,6,3,3,1,1,0,36,20,16,3,2,1,9,6,3,3,2,1
110662,21044,210,44,-2,272,144,128,0,0,0,90,39,51,5,3,2,16,11,5,0,0,0,101,59,42,8,4,4,17,7,10,35,21,14
110671,21044,210,44,-2,11,5,6,0,0,0,4,3,1,0,0,0,2,1,1,0,0,0,4,0,4,0,0,0,0,0,0,1,1,0
110680,21044,210,44,-2,103,41,62,0,0,0,27,11,16,2,0,2,10,6,4,0,0,0,54,22,32,0,0,0,4,1,3,6,1,5
110699,21044,210,44,-2,215,90,125,0,0,0,65,25,40,15,6,9,15,10,5,0,0,0,84,35,49,8,3,5,13,5,8,15,6,9
110705,21044,210,44,-2,1,1,0,0,0,0,0,0,0,0,0,0,0,0,0,0,0,0,1,1,0,0,0,0,0,0,0,0,0,0
110714,21044,210,44,-2,2,1,1,0,0,0,0,0,0,0,0,0,1,1,0,0,0,0,1,0,1,0,0,0,0,0,0,0,0,0
111391,21044,210,44,-2,3,1,2,0,0,0,0,0,0,0,0,0,0,0,0,0,0,0,3,1,2,0,0,0,0,0,0,0,0,0
111948,21044,210,44,-2,11,5,6,0,0,0,0,0,0,0,0,0,4,1,3,0,0,0,5,3,2,0,0,0,2,1,1,0,0,0
111966,21044,210,44,-2,1,1,0,0,0,0,0,0,0,0,0,0,0,0,0,0,0,0,0,0,0,0,0,0,1,1,0,0,0,0
112075,21044,210,44,-2,3,0,3,0,0,0,0,0,0,1,0,1,0,0,0,0,0,0,1,0,1,0,0,0,1,0,1,0,0,0
112127,21044,210,44,-2,1,0,1,0,0,0,1,0,1,0,0,0,0,0,0,0,0,0,0,0,0,0,0,0,0,0,0,0,0,0
112260,21044,210,44,-2,2,1,1,0,0,0,0,0,0,0,0,0,0,0,0,0,0,0,2,1,1,0,0,0,0,0,0,0,0,0
114549,21044,210,44,-2,2,2,0,0,0,0,0,0,0,0,0,0,0,0,0,0,0,0,2,2,0,0,0,0,0,0,0,0,0,0
114840,21044,210,44,-2,1,0,1,0,0,0,0,0,0,1,0,1,0,0,0,0,0,0,0,0,0,0,0,0,0,0,0,0,0,0
115083,21044,210,44,-2,1,0,1,0,0,0,0,0,0,0,0,0,0,0,0,0,0,0,1,0,1,0,0,0,0,0,0,0,0,0
115746,21044,210,44,-2,5,1,4,0,0,0,0,0,0,0,0,0,0,0,0,0,0,0,5,1,4,0,0,0,0,0,0,0,0,0
117636,21044,210,44,-2,4,1,3,0,0,0,0,0,0,0,0,0,0,0,0,0,0,0,3,1,2,1,0,1,0,0,0,0,0,0
117946,21044,210,44,-2,20,5,15,0,0,0,2,1,1,3,1,2,1,0,1,0,0,0,7,1,6,0,0,0,7,2,5,0,0,0
118693,21044,210,44,-2,4,2,2,0,0,0,0,0,0,0,0,0,0,0,0,0,0,0,3,2,1,0,0,0,1,0,1,0,0,0
119058,21044,210,44,-2,1,0,1,0,0,0,0,0,0,0,0,0,0,0,0,0,0,0,1,0,1,0,0,0,0,0,0,0,0,0
119605,21044,210,44,-2,3,0,3,0,0,0,0,0,0,0,0,0,0,0,0,0,0,0,2,0,2,0,0,0,1,0,1,0,0,0
120254,21044,210,44,-2,2,1,1,0,0,0,0,0,0,0,0,0,0,0,0,0,0,0,1,0,1,0,0,0,0,0,0,1,1,0
120883,21044,210,44,-2,27,10,17,0,0,0,5,1,4,3,0,3,2,0,2,0,0,0,14,7,7,1,1,0,2,1,1,0,0,0
122409,21044,210,44,-2,2,1,1,0,0,0,0,0,0,0,0,0,0,0,0,0,0,0,2,1,1,0,0,0,0,0,0,0,0,0
122612,21044,210,44,-2,1,0,1,0,0,0,1,0,1,0,0,0,0,0,0,0,0,0,0,0,0,0,0,0,0,0,0,0,0,0
122649,21044,210,44,-2,1,1,0,0,0,0,0,0,0,0,0,0,0,0,0,0,0,0,1,1,0,0,0,0,0,0,0,0,0,0
122931,21044,210,44,-2,11,6,5,0,0,0,1,0,1,0,0,0,0,0,0,0,0,0,10,6,4,0,0,0,0,0,0,0,0,0
123457,21044,210,44,-2,3,3,0,0,0,0,0,0,0,0,0,0,0,0,0,0,0,0,2,2,0,0,0,0,1,1,0,0,0,0
123952,21044,210,44,-2,2,2,0,0,0,0,0,0,0,1,1,0,0,0,0,0,0,0,1,1,0,0,0,0,0,0,0,0,0,0
123961,21044,210,44,-2,19,13,6,0,0,0,1,0,1,1,0,1,0,0,0,0,0,0,14,11,3,1,1,0,0,0,0,2,1,1
126818,21044,210,44,-2,9,7,2,0,0,0,0,0,0,0,0,0,1,1,0,0,0,0,7,5,2,0,0,0,1,1,0,0,0,0
127060,21044,210,44,-2,23,9,14,3,0,3,0,0,0,2,1,1,1,1,0,0,0,0,9,4,5,5,2,3,1,1,0,2,0,2
127653,21044,210,44,-2,2,0,2,0,0,0,0,0,0,0,0,0,0,0,0,0,0,0,0,0,0,0,0,0,2,0,2,0,0,0
128328,21044,210,44,-2,33,20,13,0,0,0,1,0,1,0,0,0,0,0,0,0,0,0,32,20,12,0,0,0,0,0,0,0,0,0
128498,21044,210,44,-2,5,1,4,0,0,0,1,0,1,1,1,0,2,0,2,0,0,0,1,0,1,0,0,0,0,0,0,0,0,0
128902,21044,210,44,-2,2,1,1,0,0,0,0,0,0,0,0,0,0,0,0,0,0,0,2,1,1,0,0,0,0,0,0,0,0,0
129020,21044,210,44,-2,2,2,0,0,0,0,1,1,0,0,0,0,0,0,0,0,0,0,0,0,0,0,0,0,0,0,0,1,1,0
129525,21044,210,44,-2,7,3,4,0,0,0,0,0,0,0,0,0,0,0,0,0,0,0,6,3,3,1,0,1,0,0,0,0,0,0
130226,21044,210,44,-2,9,5,4,0,0,0,0,0,0,0,0,0,0,0,0,0,0,0,9,5,4,0,0,0,0,0,0,0,0,0
130314,21044,210,44,-2,2,0,2,0,0,0,0,0,0,0,0,0,0,0,0,0,0,0,2,0,2,0,0,0,0,0,0,0,0,0
130590,21044,210,44,-2,7,4,3,0,0,0,1,1,0,2,1,1,0,0,0,0,0,0,3,2,1,0,0,0,0,0,0,1,0,1
130697,21044,210,44,-2,6,3,3,0,0,0,2,0,2,1,0,1,2,2,0,0,0,0,1,1,0,0,0,0,0,0,0,0,0,0
130794,21044,210,44,-2,21,11,10,0,0,0,2,2,0,3,1,2,0,0,0,0,0,0,6,3,3,0,0,0,2,1,1,8,4,4
130943,21044,210,44,-2,4,1,3,0,0,0,0,0,0,0,0,0,0,0,0,0,0,0,2,0,2,0,0,0,0,0,0,2,1,1
131113,21044,210,44,-2,3,1,2,0,0,0,1,1,0,0,0,0,1,0,1,0,0,0,1,0,1,0,0,0,0,0,0,0,0,0
131159,21044,210,44,-2,2,1,1,0,0,0,1,1,0,0,0,0,0,0,0,0,0,0,1,0,1,0,0,0,0,0,0,0,0,0
131469,21044,210,44,-2,6,1,5,0,0,0,2,1,1,0,0,0,0,0,0,0,0,0,4,0,4,0,0,0,0,0,0,0,0,0
131496,21044,210,44,-2,26,15,11,0,0,0,1,0,1,0,0,0,1,0,1,0,0,0,10,5,5,0,0,0,3,2,1,11,8,3
131520,21044,210,44,-2,10,1,9,0,0,0,3,1,2,6,0,6,0,0,0,0,0,0,1,0,1,0,0,0,0,0,0,0,0,0
132471,21044,210,44,-2,2,0,2,0,0,0,0,0,0,1,0,1,0,0,0,0,0,0,1,0,1,0,0,0,0,0,0,0,0,0
133881,21044,210,44,-2,4,3,1,0,0,0,0,0,0,0,0,0,0,0,0,0,0,0,4,3,1,0,0,0,0,0,0,0,0,0
133951,21044,210,44,-2,2,1,1,0,0,0,0,0,0,0,0,0,0,0,0,0,0,0,2,1,1,0,0,0,0,0,0,0,0,0
135726,21044,210,44,-2,1,0,1,0,0,0,0,0,0,0,0,0,1,0,1,0,0,0,0,0,0,0,0,0,0,0,0,0,0,0
136215,21044,210,44,-2,5,2,3,0,0,0,1,0,1,0,0,0,0,0,0,0,0,0,4,2,2,0,0,0,0,0,0,0,0,0
136950,21044,210,44,-2,9,2,7,0,0,0,0,0,0,1,0,1,1,1,0,0,0,0,4,1,3,0,0,0,1,0,1,2,0,2
139658,21044,210,44,-2,7,1,6,0,0,0,1,0,1,1,0,1,0,0,0,0,0,0,4,1,3,0,0,0,0,0,0,1,0,1
140146,21044,210,44,-2,1,0,1,0,0,0,0,0,0,1,0,1,0,0,0,0,0,0,0,0,0,0,0,0,0,0,0,0,0,0
141060,21044,210,44,-2,1,0,1,0,0,0,0,0,0,1,0,1,0,0,0,0,0,0,0,0,0,0,0,0,0,0,0,0,0,0
141644,21044,210,44,-2,11,2,9,0,0,0,1,0,1,1,0,1,1,0,1,0,0,0,8,2,6,0,0,0,0,0,0,0,0,0
142832,21044,210,44,-2,3,1,2,0,0,0,0,0,0,0,0,0,0,0,0,0,0,0,3,1,2,0,0,0,0,0,0,0,0,0
143853,21044,210,44,-2,3,2,1,0,0,0,1,0,1,0,0,0,0,0,0,0,0,0,2,2,0,0,0,0,0,0,0,0,0,0
143978,21044,210,44,-2,3,1,2,0,0,0,1,1,0,0,0,0,0,0,0,0,0,0,2,0,2,0,0,0,0,0,0,0,0,0
144014,21044,210,44,-2,1,0,1,0,0,0,1,0,1,0,0,0,0,0,0,0,0,0,0,0,0,0,0,0,0,0,0,0,0,0
144050,21044,210,44,-2,131,67,64,0,0,0,24,9,15,4,2,2,4,1,3,0,0,0,60,33,27,3,1,2,13,8,5,23,13,10
144740,21044,210,44,-2,1,0,1,0,0,0,0,0,0,0,0,0,0,0,0,0,0,0,1,0,1,0,0,0,0,0,0,0,0,0
145275,21044,210,44,-2,4,1,3,0,0,0,0,0,0,1,0,1,2,1,1,0,0,0,1,0,1,0,0,0,0,0,0,0,0,0
145558,21044,210,44,-2,2,1,1,0,0,0,1,0,1,0,0,0,0,0,0,0,0,0,1,1,0,0,0,0,0,0,0,0,0,0
145691,21044,210,44,-2,1,0,1,0,0,0,0,0,0,0,0,0,0,0,0,0,0,0,1,0,1,0,0,0,0,0,0,0,0,0
146472,21044,210,44,-2,1,0,1,0,0,0,0,0,0,0,0,0,0,0,0,0,0,0,1,0,1,0,0,0,0,0,0,0,0,0
146481,21044,210,44,-2,1,1,0,0,0,0,0,0,0,0,0,0,0,0,0,0,0,0,1,1,0,0,0,0,0,0,0,0,0,0
146719,21044,210,44,-2,17,11,6,0,0,0,2,1,1,0,0,0,4,3,1,0,0,0,8,5,3,0,0,0,1,1,0,2,1,1
147660,21044,210,44,-2,4,4,0,0,0,0,1,1,0,0,0,0,0,0,0,0,0,0,3,3,0,0,0,0,0,0,0,0,0,0
147679,21044,210,44,-2,1,0,1,0,0,0,0,0,0,0,0,0,0,0,0,0,0,0,1,0,1,0,0,0,0,0,0,0,0,0
147703,21044,210,44,-2,5,2,3,0,0,0,1,1,0,0,0,0,0,0,0,0,0,0,0,0,0,0,0,0,0,0,0,4,1,3
147767,21044,210,44,-2,58,35,23,0,0,0,12,7,5,5,3,2,6,4,2,0,0,0,20,13,7,1,0,1,1,0,1,13,8,5
148380,21044,210,44,-2,3,3,0,0,0,0,0,0,0,0,0,0,0,0,0,0,0,0,2,2,0,0,0,0,1,1,0,0,0,0
148876,21044,210,44,-2,2,2,0,0,0,0,1,1,0,0,0,0,1,1,0,0,0,0,0,0,0,0,0,0,0,0,0,0,0,0
149222,21044,210,44,-2,7,3,4,0,0,0,3,2,1,0,0,0,0,0,0,0,0,0,3,1,2,1,0,1,0,0,0,0,0,0
150163,21044,210,44,-2,23,11,12,0,0,0,0,0,0,2,1,1,1,0,1,0,0,0,20,10,10,0,0,0,0,0,0,0,0,0
150400,21044,210,44,-2,2,1,1,0,0,0,0,0,0,0,0,0,2,1,1,0,0,0,0,0,0,0,0,0,0,0,0,0,0,0
150774,21044,210,44,-2,1,1,0,0,0,0,0,0,0,0,0,0,0,0,0,0,0,0,1,1,0,0,0,0,0,0,0,0,0,0
151111,21044,210,44,-2,6,3,3,0,0,0,0,0,0,0,0,0,1,0,1,0,0,0,5,3,2,0,0,0,0,0,0,0,0,0
151324,21044,210,44,-2,7,3,4,0,0,0,1,0,1,1,1,0,0,0,0,0,0,0,5,2,3,0,0,0,0,0,0,0,0,0
151351,21044,210,44,-2,2,0,2,0,0,0,0,0,0,0,0,0,0,0,0,0,0,0,1,0,1,0,0,0,0,0,0,1,0,1
151801,21044,210,44,-2,8,4,4,0,0,0,1,1,0,2,1,1,0,0,0,0,0,0,5,2,3,0,0,0,0,0,0,0,0,0
152080,21044,210,44,-2,7,5,2,0,0,0,0,0,0,0,0,0,0,0,0,0,0,0,4,3,1,0,0,0,1,0,1,2,2,0
152673,21044,210,44,-2,2,0,2,0,0,0,0,0,0,0,0,0,0,0,0,0,0,0,2,0,2,0,0,0,0,0,0,0,0,0
153126,21044,210,44,-2,4,1,3,0,0,0,0,0,0,0,0,0,0,0,0,0,0,0,4,1,3,0,0,0,0,0,0,0,0,0
153144,21044,210,44,-2,1,0,1,0,0,0,0,0,0,0,0,0,0,0,0,0,0,0,1,0,1,0,0,0,0,0,0,0,0,0
153241,21044,210,44,-2,1,0,1,0,0,0,0,0,0,0,0,0,0,0,0,0,0,0,0,0,0,0,0,0,0,0,0,1,0,1
153250,21044,210,44,-2,5,4,1,0,0,0,0,0,0,0,0,0,0,0,0,0,0,0,5,4,1,0,0,0,0,0,0,0,0,0
153278,21044,210,44,-2,5,3,2,0,0,0,0,0,0,0,0,0,1,1,0,0,0,0,4,2,2,0,0,0,0,0,0,0,0,0
153366,21044,210,44,-2,8,4,4,0,0,0,1,1,0,0,0,0,1,1,0,0,0,0,6,2,4,0,0,0,0,0,0,0,0,0
153375,21044,210,44,-2,2,1,1,0,0,0,0,0,0,0,0,0,0,0,0,0,0,0,2,1,1,0,0,0,0,0,0,0,0,0
153384,21044,210,44,-2,11,5,6,0,0,0,0,0,0,1,1,0,2,1,1,0,0,0,6,2,4,1,0,1,1,1,0,0,0,0
153603,21044,210,44,-2,25,11,14,0,0,0,1,1,0,0,0,0,1,0,1,0,0,0,18,7,11,0,0,0,0,0,0,5,3,2
153658,21044,210,44,-2,63,27,36,0,0,0,9,7,2,5,3,2,1,0,1,0,0,0,24,6,18,0,0,0,9,5,4,15,6,9
153825,21044,210,44,-2,1,0,1,0,0,0,1,0,1,0,0,0,0,0,0,0,0,0,0,0,0,0,0,0,0,0,0,0,0,0
153977,21044,210,44,-2,4,0,4,0,0,0,0,0,0,0,0,0,0,0,0,0,0,0,3,0,3,1,0,1,0,0,0,0,0,0
154013,21044,210,44,-2,5,1,4,0,0,0,0,0,0,0,0,0,0,0,0,0,0,0,5,1,4,0,0,0,0,0,0,0,0,0
154095,21044,210,44,-2,2,1,1,0,0,0,0,0,0,0,0,0,0,0,0,0,0,0,2,1,1,0,0,0,0,0,0,0,0,0
155317,21044,210,44,-2,48,28,20,0,0,0,3,3,0,2,1,1,2,0,2,0,0,0,29,16,13,1,0,1,1,0,1,10,8,2
156134,21044,210,44,-2,6,2,4,1,1,0,0,0,0,0,0,0,0,0,0,0,0,0,5,1,4,0,0,0,0,0,0,0,0,0
156213,21044,210,44,-2,1,0,1,0,0,0,0,0,0,0,0,0,0,0,0,0,0,0,1,0,1,0,0,0,0,0,0,0,0,0
156295,21044,210,44,-2,4,0,4,0,0,0,1,0,1,1,0,1,0,0,0,0,0,0,2,0,2,0,0,0,0,0,0,0,0,0
156408,21044,210,44,-2,3,2,1,0,0,0,0,0,0,1,0,1,1,1,0,0,0,0,1,1,0,0,0,0,0,0,0,0,0,0
157085,21044,210,44,-2,4,3,1,0,0,0,0,0,0,0,0,0,2,2,0,0,0,0,2,1,1,0,0,0,0,0,0,0,0,0
157289,21044,210,44,-2,20,9,11,0,0,0,1,0,1,1,0,1,1,0,1,0,0,0,13,6,7,0,0,0,0,0,0,4,3,1
157748,21044,210,44,-2,1,1,0,0,0,0,0,0,0,0,0,0,0,0,0,0,0,0,0,0,0,0,0,0,1,1,0,0,0,0
157818,21044,210,44,-2,1,0,1,0,0,0,0,0,0,0,0,0,0,0,0,0,0,0,1,0,1,0,0,0,0,0,0,0,0,0
157951,21044,210,44,-2,10,6,4,0,0,0,0,0,0,1,1,0,0,0,0,0,0,0,9,5,4,0,0,0,0,0,0,0,0,0
160658,21044,210,44,-2,6,1,5,0,0,0,0,0,0,0,0,0,1,1,0,0,0,0,5,0,5,0,0,0,0,0,0,0,0,0
160959,21044,210,44,-2,1,0,1,0,0,0,1,0,1,0,0,0,0,0,0,0,0,0,0,0,0,0,0,0,0,0,0,0,0,0
161004,21044,210,44,-2,1,1,0,0,0,0,0,0,0,0,0,0,0,0,0,0,0,0,0,0,0,0,0,0,0,0,0,1,1,0
161086,21044,210,44,-2,11,3,8,0,0,0,0,0,0,0,0,0,0,0,0,0,0,0,6,2,4,1,0,1,2,1,1,2,0,2
161226,21044,210,44,-2,1,0,1,0,0,0,0,0,0,0,0,0,0,0,0,0,0,0,1,0,1,0,0,0,0,0,0,0,0,0
161253,21044,210,44,-2,4,2,2,0,0,0,0,0,0,0,0,0,0,0,0,0,0,0,4,2,2,0,0,0,0,0,0,0,0,0
161509,21044,210,44,-2,1,1,0,0,0,0,0,0,0,0,0,0,0,0,0,0,0,0,1,1,0,0,0,0,0,0,0,0,0,0
161554,21044,210,44,-2,1,0,1,0,0,0,0,0,0,0,0,0,0,0,0,0,0,0,1,0,1,0,0,0,0,0,0,0,0,0
161873,21044,210,44,-2,6,0,6,0,0,0,2,0,2,0,0,0,1,0,1,0,0,0,3,0,3,0,0,0,0,0,0,0,0,0
162007,21044,210,44,-2,1,0,1,0,0,0,0,0,0,1,0,1,0,0,0,0,0,0,0,0,0,0,0,0,0,0,0,0,0,0
162168,21044,210,44,-2,1,0,1,0,0,0,0,0,0,0,0,0,0,0,0,0,0,0,0,0,0,0,0,0,1,0,1,0,0,0
162706,21044,210,44,-2,1,0,1,0,0,0,0,0,0,0,0,0,0,0,0,0,0,0,1,0,1,0,0,0,0,0,0,0,0,0
162779,21044,210,44,-2,1,0,1,0,0,0,0,0,0,0,0,0,0,0,0,0,0,0,0,0,0,1,0,1,0,0,0,0,0,0
162928,21044,210,44,-2,27,19,8,0,0,0,4,3,1,4,2,2,0,0,0,0,0,0,14,11,3,0,0,0,1,1,0,4,2,2
163295,21044,210,44,-2,12,6,6,0,0,0,2,1,1,2,1,1,1,0,1,0,0,0,2,1,1,0,0,0,1,1,0,4,2,2
163453,21044,210,44,-2,3,3,0,0,0,0,1,1,0,2,2,0,0,0,0,0,0,0,0,0,0,0,0,0,0,0,0,0,0,0
163462,21044,210,44,-2,3,3,0,0,0,0,0,0,0,0,0,0,1,1,0,0,0,0,2,2,0,0,0,0,0,0,0,0,0,0
163851,21044,210,44,-2,1,0,1,0,0,0,0,0,0,0,0,0,0,0,0,0,0,0,1,0,1,0,0,0,0,0,0,0,0,0
163912,21044,210,44,-2,4,2,2,0,0,0,0,0,0,0,0,0,0,0,0,0,0,0,3,1,2,0,0,0,0,0,0,1,1,0
164155,21044,210,44,-2,13,11,2,0,0,0,1,0,1,1,1,0,0,0,0,0,0,0,10,9,1,0,0,0,1,1,0,0,0,0
164173,21044,210,44,-2,1,0,1,0,0,0,0,0,0,0,0,0,0,0,0,0,0,0,1,0,1,0,0,0,0,0,0,0,0,0
164313,21044,210,44,-2,2,0,2,0,0,0,0,0,0,0,0,0,0,0,0,0,0,0,2,0,2,0,0,0,0,0,0,0,0,0
164368,21044,210,44,-2,16,11,5,0,0,0,5,3,2,1,1,0,2,1,1,0,0,0,5,4,1,0,0,0,3,2,1,0,0,0
164465,21044,210,44,-2,6,1,5,0,0,0,1,0,1,2,1,1,0,0,0,0,0,0,3,0,3,0,0,0,0,0,0,0,0,0
164562,21044,210,44,-2,2,1,1,0,0,0,0,0,0,0,0,0,0,0,0,0,0,0,2,1,1,0,0,0,0,0,0,0,0,0
164748,21044,210,44,-2,9,8,1,1,1,0,1,1,0,0,0,0,2,2,0,0,0,0,5,4,1,0,0,0,0,0,0,0,0,0
164924,21044,210,44,-2,9,4,5,0,0,0,0,0,0,3,1,2,1,0,1,0,0,0,5,3,2,0,0,0,0,0,0,0,0,0
164988,21044,210,44,-2,37,22,15,0,0,0,3,0,3,5,2,3,4,3,1,0,0,0,19,12,7,0,0,0,0,0,0,6,5,1
165015,21044,210,44,-2,8,2,6,0,0,0,1,1,0,0,0,0,1,0,1,0,0,0,3,0,3,0,0,0,2,1,1,1,0,1
165334,21044,210,44,-2,16,9,7,0,0,0,1,0,1,2,1,1,1,1,0,0,0,0,11,7,4,0,0,0,0,0,0,1,0,1
165866,21044,210,44,-2,2,0,2,0,0,0,0,0,0,0,0,0,0,0,0,0,0,0,2,0,2,0,0,0,0,0,0,0,0,0
166018,21044,210,44,-2,1,0,1,0,0,0,0,0,0,0,0,0,0,0,0,0,0,0,1,0,1,0,0,0,0,0,0,0,0,0
166027,21044,210,44,-2,8,3,5,0,0,0,0,0,0,0,0,0,3,0,3,0,0,0,4,2,2,0,0,0,0,0,0,1,1,0
166407,21044,210,44,-2,2,0,2,0,0,0,0,0,0,0,0,0,0,0,0,0,0,0,2,0,2,0,0,0,0,0,0,0,0,0
166452,21044,210,44,-2,6,3,3,0,0,0,2,1,1,2,0,2,0,0,0,0,0,0,2,2,0,0,0,0,0,0,0,0,0,0
166629,21044,210,44,-2,5,1,4,0,0,0,0,0,0,2,0,2,0,0,0,0,0,0,1,0,1,0,0,0,0,0,0,2,1,1
166638,21044,210,44,-2,2,0,2,0,0,0,0,0,0,0,0,0,1,0,1,0,0,0,1,0,1,0,0,0,0,0,0,0,0,0
166717,21044,210,44,-2,11,3,8,0,0,0,0,0,0,2,0,2,1,0,1,0,0,0,8,3,5,0,0,0,0,0,0,0,0,0
166869,21044,210,44,-2,9,1,8,0,0,0,0,0,0,0,0,0,0,0,0,0,0,0,9,1,8,0,0,0,0,0,0,0,0,0
166911,21044,210,44,-2,4,1,3,0,0,0,1,0,1,0,0,0,0,0,0,0,0,0,1,0,1,0,0,0,2,1,1,0,0,0
166939,21044,210,44,-2,7,2,5,0,0,0,0,0,0,0,0,0,0,0,0,0,0,0,5,1,4,0,0,0,1,0,1,1,1,0
167260,21044,210,44,-2,2,2,0,0,0,0,0,0,0,0,0,0,0,0,0,0,0,0,2,2,0,0,0,0,0,0,0,0,0,0
167358,21044,210,44,-2,13,7,6,0,0,0,0,0,0,1,0,1,1,1,0,0,0,0,9,5,4,0,0,0,2,1,1,0,0,0
167783,21044,210,44,-2,4,3,1,0,0,0,0,0,0,1,1,0,0,0,0,0,0,0,2,1,1,0,0,0,0,0,0,1,1,0
167792,21044,210,44,-2,3,1,2,0,0,0,1,0,1,0,0,0,0,0,0,0,0,0,1,0,1,0,0,0,0,0,0,1,1,0
167899,21044,210,44,-2,6,2,4,0,0,0,1,0,1,1,0,1,0,0,0,0,0,0,4,2,2,0,0,0,0,0,0,0,0,0
167987,21044,210,44,-2,3,1,2,0,0,0,0,0,0,0,0,0,0,0,0,0,0,0,3,1,2,0,0,0,0,0,0,0,0,0
167996,21044,210,44,-2,6,3,3,0,0,0,0,0,0,0,0,0,0,0,0,0,0,0,1,0,1,0,0,0,5,3,2,0,0,0
168148,21044,210,44,-2,37,18,19,0,0,0,4,2,2,6,2,4,2,2,0,0,0,0,19,10,9,2,1,1,1,0,1,3,1,2
168218,21044,210,44,-2,5,0,5,0,0,0,1,0,1,0,0,0,1,0,1,0,0,0,2,0,2,0,0,0,0,0,0,1,0,1
168281,21044,210,44,-2,2,0,2,0,0,0,1,0,1,0,0,0,0,0,0,0,0,0,1,0,1,0,0,0,0,0,0,0,0,0
168342,21044,210,44,-2,7,2,5,0,0,0,1,0,1,1,0,1,3,1,2,0,0,0,1,0,1,0,0,0,0,0,0,1,1,0
168528,21044,210,44,-2,1,0,1,0,0,0,0,0,0,0,0,0,0,0,0,0,0,0,1,0,1,0,0,0,0,0,0,0,0,0
168607,21044,210,44,-2,4,2,2,0,0,0,0,0,0,0,0,0,0,0,0,0,0,0,4,2,2,0,0,0,0,0,0,0,0,0
169248,21044,210,44,-2,3,1,2,0,0,0,0,0,0,0,0,0,0,0,0,0,0,0,3,1,2,0,0,0,0,0,0,0,0,0
169363,21044,210,44,-2,6,3,3,0,0,0,0,0,0,0,0,0,0,0,0,0,0,0,6,3,3,0,0,0,0,0,0,0,0,0
169716,21044,210,44,-2,2,0,2,0,0,0,1,0,1,0,0,0,0,0,0,0,0,0,0,0,0,0,0,0,0,0,0,1,0,1
169798,21044,210,44,-2,2,1,1,0,0,0,0,0,0,0,0,0,0,0,0,0,0,0,2,1,1,0,0,0,0,0,0,0,0,0
170286,21044,210,44,-2,3,2,1,0,0,0,0,0,0,0,0,0,0,0,0,0,0,0,0,0,0,0,0,0,3,2,1,0,0,0
170532,21044,210,44,-2,1,1,0,0,0,0,0,0,0,0,0,0,0,0,0,0,0,0,1,1,0,0,0,0,0,0,0,0,0,0
170550,21044,210,44,-2,4,2,2,0,0,0,0,0,0,0,0,0,0,0,0,0,0,0,4,2,2,0,0,0,0,0,0,0,0,0
170620,21044,210,44,-2,3,2,1,0,0,0,0,0,0,2,1,1,0,0,0,0,0,0,1,1,0,0,0,0,0,0,0,0,0,0
170976,21044,210,44,-2,166,82,84,0,0,0,25,9,16,4,2,2,4,2,2,0,0,0,94,44,50,2,1,1,8,4,4,29,20,9
171100,21044,210,44,-2,17,11,6,0,0,0,3,3,0,0,0,0,0,0,0,0,0,0,10,6,4,0,0,0,0,0,0,4,2,2
171128,21044,210,44,-2,1,1,0,0,0,0,0,0,0,0,0,0,0,0,0,0,0,0,0,0,0,0,0,0,1,1,0,0,0,0
171137,21044,210,44,-2,3,3,0,0,0,0,0,0,0,0,0,0,0,0,0,0,0,0,3,3,0,0,0,0,0,0,0,0,0,0
171146,21044,210,44,-2,4,1,3,0,0,0,0,0,0,0,0,0,0,0,0,0,0,0,4,1,3,0,0,0,0,0,0,0,0,0
171456,21044,210,44,-2,2,1,1,0,0,0,0,0,0,0,0,0,0,0,0,0,0,0,2,1,1,0,0,0,0,0,0,0,0,0
171535,21044,210,44,-2,10,3,7,0,0,0,0,0,0,2,1,1,0,0,0,0,0,0,8,2,6,0,0,0,0,0,0,0,0,0
171571,21044,210,44,-2,1,0,1,0,0,0,0,0,0,0,0,0,0,0,0,0,0,0,1,0,1,0,0,0,0,0,0,0,0,0
172033,21044,210,44,-2,4,3,1,0,0,0,0,0,0,0,0,0,0,0,0,0,0,0,4,3,1,0,0,0,0,0,0,0,0,0
172617,21044,210,44,-2,1,1,0,1,1,0,0,0,0,0,0,0,0,0,0,0,0,0,0,0,0,0,0,0,0,0,0,0,0,0
172644,21044,210,44,-2,39,19,20,0,0,0,2,0,2,5,2,3,1,1,0,0,0,0,24,14,10,0,0,0,0,0,0,7,2,5
173300,21044,210,44,-2,4,2,2,0,0,0,0,0,0,0,0,0,1,0,1,0,0,0,3,2,1,0,0,0,0,0,0,0,0,0
173328,21044,210,44,-2,1,1,0,0,0,0,0,0,0,0,0,0,0,0,0,0,0,0,1,1,0,0,0,0,0,0,0,0,0,0
174066,21044,210,44,-2,6,2,4,0,0,0,0,0,0,2,1,1,0,0,0,0,0,0,1,0,1,0,0,0,2,1,1,1,0,1
174127,21044,210,44,-2,2,0,2,0,0,0,0,0,0,1,0,1,0,0,0,0,0,0,1,0,1,0,0,0,0,0,0,0,0,0
174233,21044,210,44,-2,1,0,1,0,0,0,0,0,0,0,0,0,0,0,0,0,0,0,1,0,1,0,0,0,0,0,0,0,0,0
174844,21044,210,44,-2,3,2,1,0,0,0,0,0,0,0,0,0,1,1,0,0,0,0,1,0,1,0,0,0,1,1,0,0,0,0
175005,21044,210,44,-2,13,1,12,0,0,0,0,0,0,1,0,1,0,0,0,0,0,0,12,1,11,0,0,0,0,0,0,0,0,0
177092,21044,210,44,-2,3,3,0,0,0,0,0,0,0,0,0,0,1,1,0,0,0,0,2,2,0,0,0,0,0,0,0,0,0,0
177986,21044,210,44,-2,2,1,1,0,0,0,0,0,0,0,0,0,0,0,0,0,0,0,1,0,1,1,1,0,0,0,0,0,0,0
178183,21044,210,44,-2,2,0,2,0,0,0,0,0,0,0,0,0,0,0,0,0,0,0,2,0,2,0,0,0,0,0,0,0,0,0
178208,21044,210,44,-2,2,2,0,0,0,0,0,0,0,0,0,0,1,1,0,0,0,0,1,1,0,0,0,0,0,0,0,0,0,0
179159,21044,210,44,-2,1,0,1,0,0,0,0,0,0,0,0,0,0,0,0,0,0,0,0,0,0,1,0,1,0,0,0,0,0,0
179317,21044,210,44,-2,1,1,0,0,0,0,0,0,0,1,1,0,0,0,0,0,0,0,0,0,0,0,0,0,0,0,0,0,0,0
179557,21044,210,44,-2,6,3,3,0,0,0,1,1,0,0,0,0,0,0,0,0,0,0,4,1,3,0,0,0,1,1,0,0,0,0
179812,21044,210,44,-2,8,4,4,0,0,0,0,0,0,0,0,0,1,0,1,0,0,0,6,4,2,1,0,1,0,0,0,0,0,0
179955,21044,210,44,-2,3,2,1,0,0,0,0,0,0,0,0,0,0,0,0,0,0,0,3,2,1,0,0,0,0,0,0,0,0,0
180647,21044,210,44,-2,8,5,3,3,2,1,0,0,0,0,0,0,1,0,1,0,0,0,4,3,1,0,0,0,0,0,0,0,0,0
180814,21044,210,44,-2,3,3,0,0,0,0,0,0,0,0,0,0,0,0,0,0,0,0,2,2,0,0,0,0,1,1,0,0,0,0
180984,21044,210,44,-2,3,1,2,0,0,0,0,0,0,0,0,0,0,0,0,0,0,0,3,1,2,0,0,0,0,0,0,0,0,0
181446,21044,210,44,-2,1,0,1,0,0,0,0,0,0,0,0,0,0,0,0,0,0,0,1,0,1,0,0,0,0,0,0,0,0,0
181464,21044,210,44,-2,5,3,2,0,0,0,0,0,0,0,0,0,1,0,1,0,0,0,2,2,0,1,0,1,0,0,0,1,1,0
182634,21044,210,44,-2,5,0,5,0,0,0,0,0,0,0,0,0,0,0,0,0,0,0,5,0,5,0,0,0,0,0,0,0,0,0
182670,21044,210,44,-2,7,1,6,0,0,0,0,0,0,0,0,0,0,0,0,0,0,0,6,0,6,0,0,0,0,0,0,1,1,0
182829,21044,210,44,-2,1,0,1,0,0,0,0,0,0,0,0,0,0,0,0,0,0,0,1,0,1,0,0,0,0,0,0,0,0,0
182980,21044,210,44,-2,5,0,5,0,0,0,0,0,0,1,0,1,0,0,0,0,0,0,4,0,4,0,0,0,0,0,0,0,0,0
183044,21044,210,44,-2,23,7,16,0,0,0,1,1,0,0,0,0,1,0,1,0,0,0,13,5,8,1,0,1,3,0,3,4,1,3
183062,21044,210,44,-2,2,2,0,0,0,0,0,0,0,0,0,0,0,0,0,0,0,0,1,1,0,0,0,0,1,1,0,0,0,0
183071,21044,210,44,-2,1,1,0,0,0,0,0,0,0,0,0,0,0,0,0,0,0,0,1,1,0,0,0,0,0,0,0,0,0,0
183080,21044,210,44,-2,12,5,7,0,0,0,0,0,0,0,0,0,0,0,0,0,0,0,10,5,5,0,0,0,1,0,1,1,0,1
183257,21044,210,44,-2,3,1,2,0,0,0,0,0,0,0,0,0,0,0,0,0,0,0,3,1,2,0,0,0,0,0,0,0,0,0
184782,21044,210,44,-2,14,8,6,0,0,0,0,0,0,2,2,0,0,0,0,0,0,0,9,4,5,0,0,0,1,1,0,2,1,1
185572,21044,210,44,-2,6,1,5,0,0,0,0,0,0,0,0,0,1,1,0,0,0,0,5,0,5,0,0,0,0,0,0,0,0,0
186131,21044,210,44,-2,3,1,2,0,0,0,0,0,0,1,1,0,0,0,0,0,0,0,2,0,2,0,0,0,0,0,0,0,0,0
186283,21044,210,44,-2,2,0,2,0,0,0,1,0,1,0,0,0,0,0,0,0,0,0,1,0,1,0,0,0,0,0,0,0,0,0
186371,21044,210,44,-2,4,3,1,0,0,0,0,0,0,0,0,0,0,0,0,0,0,0,1,1,0,0,0,0,3,2,1,0,0,0
186380,21044,210,44,-2,147,59,88,0,0,0,7,5,2,5,2,3,4,1,3,0,0,0,22,8,14,0,0,0,99,35,64,10,8,2
186399,21044,210,44,-2,17,8,9,0,0,0,1,0,1,1,0,1,1,1,0,0,0,0,0,0,0,0,0,0,11,6,5,3,1,2
186867,21044,210,44,-2,12,8,4,0,0,0,0,0,0,0,0,0,0,0,0,0,0,0,5,2,3,0,0,0,0,0,0,7,6,1
188030,21044,210,44,-2,7,4,3,0,0,0,0,0,0,0,0,0,1,0,1,0,0,0,6,4,2,0,0,0,0,0,0,0,0,0
188429,21044,210,44,-2,3,1,2,0,0,0,0,0,0,1,0,1,0,0,0,0,0,0,2,1,1,0,0,0,0,0,0,0,0,0
188580,21044,210,44,-2,15,6,9,0,0,0,2,2,0,1,1,0,1,0,1,0,0,0,10,3,7,0,0,0,1,0,1,0,0,0
188641,21044,210,44,-2,2,0,2,0,0,0,0,0,0,0,0,0,0,0,0,0,0,0,2,0,2,0,0,0,0,0,0,0,0,0
189088,21044,210,44,-2,2,1,1,0,0,0,0,0,0,1,1,0,0,0,0,0,0,0,0,0,0,0,0,0,1,0,1,0,0,0
189097,21044,210,44,-2,1,1,0,0,0,0,0,0,0,0,0,0,0,0,0,0,0,0,1,1,0,0,0,0,0,0,0,0,0,0
190071,21044,210,44,-2,2,0,2,0,0,0,0,0,0,0,0,0,0,0,0,0,0,0,2,0,2,0,0,0,0,0,0,0,0,0
190415,21044,210,44,-2,22,13,9,0,0,0,3,2,1,0,0,0,2,2,0,0,0,0,13,7,6,0,0,0,0,0,0,4,2,2
190503,21044,210,44,-2,5,2,3,0,0,0,1,0,1,0,0,0,1,0,1,0,0,0,3,2,1,0,0,0,0,0,0,0,0,0
191241,21044,210,44,-2,1,1,0,0,0,0,0,0,0,0,0,0,0,0,0,0,0,0,1,1,0,0,0,0,0,0,0,0,0,0
191320,21044,210,44,-2,1,0,1,0,0,0,0,0,0,0,0,0,0,0,0,0,0,0,1,0,1,0,0,0,0,0,0,0,0,0
191515,21044,210,44,-2,4,3,1,0,0,0,0,0,0,0,0,0,0,0,0,0,0,0,2,2,0,0,0,0,0,0,0,2,1,1
191630,21044,210,44,-2,6,3,3,0,0,0,1,1,0,1,1,0,1,0,1,0,0,0,3,1,2,0,0,0,0,0,0,0,0,0
191968,21044,210,44,-2,4,2,2,0,0,0,0,0,0,0,0,0,0,0,0,0,0,0,1,1,0,0,0,0,3,1,2,0,0,0
192323,21044,210,44,-2,3,2,1,0,0,0,0,0,0,0,0,0,0,0,0,0,0,0,3,2,1,0,0,0,0,0,0,0,0,0
193654,21044,210,44,-2,4,2,2,0,0,0,0,0,0,1,1,0,1,0,1,0,0,0,2,1,1,0,0,0,0,0,0,0,0,0
194091,21044,210,44,-2,2,2,0,0,0,0,0,0,0,0,0,0,0,0,0,0,0,0,1,1,0,1,1,0,0,0,0,0,0,0
194578,21044,210,44,-2,5,3,2,0,0,0,2,0,2,0,0,0,0,0,0,0,0,0,3,3,0,0,0,0,0,0,0,0,0,0
194824,21044,210,44,-2,5,3,2,0,0,0,2,2,0,0,0,0,0,0,0,0,0,0,3,1,2,0,0,0,0,0,0,0,0,0
195003,21044,210,44,-2,1,1,0,0,0,0,0,0,0,0,0,0,0,0,0,0,0,0,1,1,0,0,0,0,0,0,0,0,0,0
195030,21044,210,44,-2,49,32,17,0,0,0,6,4,2,3,1,2,2,1,1,0,0,0,27,17,10,0,0,0,0,0,0,11,9,2
195128,21044,210,44,-2,4,0,4,0,0,0,1,0,1,1,0,1,0,0,0,0,0,0,2,0,2,0,0,0,0,0,0,0,0,0
195720,21044,210,44,-2,9,2,7,0,0,0,0,0,0,2,0,2,0,0,0,0,0,0,6,1,5,0,0,0,1,1,0,0,0,0
196015,21044,210,44,-2,2,1,1,0,0,0,0,0,0,0,0,0,0,0,0,0,0,0,1,0,1,0,0,0,0,0,0,1,1,0
196060,21044,210,44,-2,1,0,1,0,0,0,0,0,0,0,0,0,0,0,0,0,0,0,1,0,1,0,0,0,0,0,0,0,0,0
196079,21044,210,44,-2,8,3,5,0,0,0,0,0,0,1,0,1,1,0,1,0,0,0,6,3,3,0,0,0,0,0,0,0,0,0
196088,21044,210,44,-2,19,7,12,2,1,1,1,0,1,2,1,1,0,0,0,0,0,0,13,4,9,0,0,0,0,0,0,1,1,0
196097,21044,210,44,-2,4,2,2,0,0,0,0,0,0,0,0,0,0,0,0,0,0,0,1,0,1,0,0,0,1,0,1,2,2,0
196112,21044,210,44,-2,1,0,1,0,0,0,0,0,0,0,0,0,0,0,0,0,0,0,1,0,1,0,0,0,0,0,0,0,0,0
196176,21044,210,44,-2,1,0,1,0,0,0,0,0,0,1,0,1,0,0,0,0,0,0,0,0,0,0,0,0,0,0,0,0,0,0
196307,21044,210,44,-2,24,15,9,0,0,0,9,6,3,0,0,0,0,0,0,0,0,0,15,9,6,0,0,0,0,0,0,0,0,0
196389,21044,210,44,-2,7,2,5,0,0,0,1,1,0,3,1,2,2,0,2,0,0,0,1,0,1,0,0,0,0,0,0,0,0,0
196413,21044,210,44,-2,32,14,18,0,0,0,5,3,2,2,0,2,2,2,0,0,0,0,16,5,11,2,0,2,0,0,0,5,4,1
196468,21044,210,44,-2,4,2,2,0,0,0,1,0,1,0,0,0,0,0,0,0,0,0,1,0,1,1,1,0,0,0,0,1,1,0
196592,21044,210,44,-2,2,0,2,0,0,0,0,0,0,0,0,0,0,0,0,0,0,0,2,0,2,0,0,0,0,0,0,0,0,0
196866,21044,210,44,-2,2,2,0,0,0,0,0,0,0,0,0,0,0,0,0,0,0,0,1,1,0,0,0,0,0,0,0,1,1,0
197036,21044,210,44,-2,9,4,5,0,0,0,0,0,0,0,0,0,0,0,0,0,0,0,9,4,5,0,0,0,0,0,0,0,0,0
197133,21044,210,44,-2,10,6,4,0,0,0,0,0,0,3,2,1,1,0,1,0,0,0,2,1,1,1,1,0,2,2,0,1,0,1
197230,21044,210,44,-2,3,1,2,0,0,0,0,0,0,0,0,0,1,0,1,0,0,0,1,0,1,1,1,0,0,0,0,0,0,0
197869,21044,210,44,-2,1,1,0,0,0,0,0,0,0,0,0,0,0,0,0,0,0,0,1,1,0,0,0,0,0,0,0,0,0,0
198385,21044,210,44,-2,9,4,5,0,0,0,2,1,1,0,0,0,1,0,1,0,0,0,6,3,3,0,0,0,0,0,0,0,0,0
198419,21044,210,44,-2,85,41,44,1,0,1,11,5,6,6,4,2,6,1,5,0,0,0,50,23,27,1,1,0,0,0,0,10,7,3
198464,21044,210,44,-2,8,5,3,0,0,0,0,0,0,0,0,0,1,1,0,0,0,0,3,1,2,0,0,0,1,0,1,3,3,0
198507,21044,210,44,-2,4,2,2,0,0,0,0,0,0,1,0,1,0,0,0,0,0,0,2,1,1,0,0,0,0,0,0,1,1,0
199111,21044,210,44,-2,5,3,2,0,0,0,0,0,0,0,0,0,0,0,0,0,0,0,0,0,0,0,0,0,4,2,2,1,1,0
199120,21044,210,44,-2,9,3,6,0,0,0,2,0,2,1,0,1,2,1,1,0,0,0,2,1,1,0,0,0,2,1,1,0,0,0
199139,21044,210,44,-2,20,7,13,0,0,0,0,0,0,7,1,6,1,0,1,0,0,0,9,4,5,1,0,1,0,0,0,2,2,0
199148,21044,210,44,-2,7,0,7,0,0,0,1,0,1,2,0,2,0,0,0,0,0,0,3,0,3,0,0,0,1,0,1,0,0,0
199157,21044,210,44,-2,2,0,2,0,0,0,0,0,0,1,0,1,0,0,0,0,0,0,0,0,0,0,0,0,1,0,1,0,0,0
199184,21044,210,44,-2,5,1,4,0,0,0,1,0,1,1,0,1,0,0,0,0,0,0,3,1,2,0,0,0,0,0,0,0,0,0
199193,21044,210,44,-2,20,9,11,0,0,0,1,1,0,2,0,2,2,1,1,0,0,0,14,6,8,0,0,0,1,1,0,0,0,0
199272,21044,210,44,-2,1,0,1,0,0,0,0,0,0,0,0,0,0,0,0,0,0,0,1,0,1,0,0,0,0,0,0,0,0,0
199281,21044,210,44,-2,1,0,1,0,0,0,1,0,1,0,0,0,0,0,0,0,0,0,0,0,0,0,0,0,0,0,0,0,0,0
199698,21044,210,44,-2,5,1,4,0,0,0,0,0,0,1,0,1,0,0,0,0,0,0,4,1,3,0,0,0,0,0,0,0,0,0
199759,21044,210,44,-2,1,0,1,0,0,0,0,0,0,0,0,0,0,0,0,0,0,0,1,0,1,0,0,0,0,0,0,0,0,0
199847,21044,210,44,-2,5,2,3,0,0,0,2,1,1,1,0,1,0,0,0,0,0,0,2,1,1,0,0,0,0,0,0,0,0,0
200004,21044,210,44,-2,4,3,1,0,0,0,0,0,0,1,1,0,0,0,0,0,0,0,3,2,1,0,0,0,0,0,0,0,0,0
200156,21044,210,44,-2,7,3,4,0,0,0,0,0,0,0,0,0,0,0,0,0,0,0,7,3,4,0,0,0,0,0,0,0,0,0
200572,21044,210,44,-2,2,1,1,0,0,0,0,0,0,0,0,0,0,0,0,0,0,0,2,1,1,0,0,0,0,0,0,0,0,0
201177,21044,210,44,-2,1,0,1,0,0,0,0,0,0,0,0,0,0,0,0,0,0,0,1,0,1,0,0,0,0,0,0,0,0,0
201371,21044,210,44,-2,2,0,2,0,0,0,0,0,0,0,0,0,0,0,0,0,0,0,2,0,2,0,0,0,0,0,0,0,0,0
201690,21044,210,44,-2,4,3,1,0,0,0,0,0,0,1,1,0,0,0,0,0,0,0,3,2,1,0,0,0,0,0,0,0,0,0
201885,21044,210,44,-2,121,63,58,0,0,0,17,9,8,5,2,3,4,3,1,0,0,0,74,36,38,2,1,1,9,4,5,10,8,2
201946,21044,210,44,-2,3,0,3,0,0,0,0,0,0,0,0,0,0,0,0,0,0,0,3,0,3,0,0,0,0,0,0,0,0,0
202046,21044,210,44,-2,1,1,0,0,0,0,0,0,0,0,0,0,0,0,0,0,0,0,1,1,0,0,0,0,0,0,0,0,0,0
202648,21044,210,44,-2,3,1,2,0,0,0,1,0,1,0,0,0,0,0,0,0,0,0,1,0,1,0,0,0,1,1,0,0,0,0
203085,21044,210,44,-2,5,3,2,0,0,0,0,0,0,1,0,1,0,0,0,0,0,0,4,3,1,0,0,0,0,0,0,0,0,0
204006,21044,210,44,-2,1,0,1,0,0,0,0,0,0,0,0,0,0,0,0,0,0,0,1,0,1,0,0,0,0,0,0,0,0,0
204024,21044,210,44,-2,26,11,15,0,0,0,1,0,1,1,0,1,0,0,0,0,0,0,24,11,13,0,0,0,0,0,0,0,0,0
204477,21044,210,44,-2,1,1,0,0,0,0,0,0,0,0,0,0,0,0,0,0,0,0,1,1,0,0,0,0,0,0,0,0,0,0
204501,21044,210,44,-2,5,3,2,0,0,0,0,0,0,0,0,0,0,0,0,0,0,0,4,2,2,0,0,0,0,0,0,1,1,0
204796,21044,210,44,-2,196,69,127,0,0,0,33,11,22,12,5,7,8,3,5,0,0,0,120,38,82,3,0,3,13,7,6,7,5,2
206048,21044,210,44,-2,1,1,0,0,0,0,0,0,0,0,0,0,0,0,0,0,0,0,1,1,0,0,0,0,0,0,0,0,0,0
206525,21044,210,44,-2,4,0,4,0,0,0,0,0,0,0,0,0,0,0,0,0,0,0,4,0,4,0,0,0,0,0,0,0,0,0
206604,21044,210,44,-2,1,0,1,0,0,0,0,0,0,0,0,0,0,0,0,0,0,0,1,0,1,0,0,0,0,0,0,0,0,0
207403,21044,210,44,-2,4,3,1,0,0,0,0,0,0,0,0,0,0,0,0,0,0,0,4,3,1,0,0,0,0,0,0,0,0,0
207458,21044,210,44,-2,3,1,2,0,0,0,0,0,0,0,0,0,0,0,0,0,0,0,3,1,2,0,0,0,0,0,0,0,0,0
207500,21044,210,44,-2,22,11,11,0,0,0,1,1,0,5,3,2,1,0,1,0,0,0,11,6,5,0,0,0,1,0,1,3,1,2
207582,21044,210,44,-2,2,2,0,0,0,0,0,0,0,0,0,0,0,0,0,0,0,0,1,1,0,0,0,0,0,0,0,1,1,0
207971,21044,210,44,-2,8,4,4,0,0,0,0,0,0,2,2,0,0,0,0,0,0,0,5,1,4,0,0,0,1,1,0,0,0,0
209065,21044,210,44,-2,1,0,1,0,0,0,0,0,0,0,0,0,0,0,0,0,0,0,1,0,1,0,0,0,0,0,0,0,0,0
209490,21044,210,44,-2,1,0,1,0,0,0,1,0,1,0,0,0,0,0,0,0,0,0,0,0,0,0,0,0,0,0,0,0,0,0
209612,21044,210,44,-2,2,0,2,0,0,0,0,0,0,0,0,0,0,0,0,0,0,0,2,0,2,0,0,0,0,0,0,0,0,0
209807,21044,210,44,-2,3,1,2,0,0,0,0,0,0,1,0,1,2,1,1,0,0,0,0,0,0,0,0,0,0,0,0,0,0,0
209922,21044,210,44,-2,6,2,4,0,0,0,0,0,0,0,0,0,1,0,1,0,0,0,1,0,1,2,2,0,0,0,0,2,0,2
210234,21044,210,44,-2,1,0,1,0,0,0,0,0,0,0,0,0,1,0,1,0,0,0,0,0,0,0,0,0,0,0,0,0,0,0
210669,21044,210,44,-2,4,2,2,0,0,0,1,0,1,0,0,0,0,0,0,0,0,0,2,2,0,1,0,1,0,0,0,0,0,0
210809,21044,210,44,-2,2,1,1,0,0,0,0,0,0,1,0,1,0,0,0,0,0,0,1,1,0,0,0,0,0,0,0,0,0,0
211291,21044,210,44,-2,3,0,3,0,0,0,0,0,0,1,0,1,0,0,0,0,0,0,1,0,1,0,0,0,0,0,0,1,0,1
211440,21044,210,44,-2,7,4,3,0,0,0,0,0,0,0,0,0,1,1,0,0,0,0,3,1,2,1,1,0,1,1,0,1,0,1
211556,21044,210,44,-2,9,2,7,0,0,0,0,0,0,0,0,0,1,1,0,0,0,0,8,1,7,0,0,0,0,0,0,0,0,0
212054,21044,210,44,-2,22,12,10,0,0,0,2,0,2,3,3,0,0,0,0,0,0,0,11,6,5,2,1,1,0,0,0,4,2,2
212115,21044,210,44,-2,2,2,0,0,0,0,0,0,0,0,0,0,0,0,0,0,0,0,2,2,0,0,0,0,0,0,0,0,0,0
212577,21044,210,44,-2,2,1,1,0,0,0,0,0,0,0,0,0,0,0,0,0,0,0,1,0,1,0,0,0,0,0,0,1,1,0
212674,21044,210,44,-2,1,1,0,0,0,0,0,0,0,0,0,0,0,0,0,0,0,0,1,1,0,0,0,0,0,0,0,0,0,0
212911,21044,210,44,-2,19,9,10,0,0,0,3,1,2,0,0,0,1,0,1,0,0,0,9,4,5,0,0,0,1,0,1,5,4,1
213233,21044,210,44,-2,4,4,0,0,0,0,0,0,0,0,0,0,0,0,0,0,0,0,4,4,0,0,0,0,0,0,0,0,0,0
213385,21044,210,44,-2,2,1,1,0,0,0,0,0,0,0,0,0,0,0,0,0,0,0,1,0,1,0,0,0,0,0,0,1,1,0
213507,21044,210,44,-2,1,0,1,0,0,0,0,0,0,0,0,0,0,0,0,0,0,0,1,0,1,0,0,0,0,0,0,0,0,0
213543,21044,210,44,-2,12,7,5,0,0,0,2,0,2,2,1,1,0,0,0,0,0,0,6,4,2,0,0,0,2,2,0,0,0,0
213668,21044,210,44,-2,1,0,1,0,0,0,0,0,0,0,0,0,0,0,0,0,0,0,1,0,1,0,0,0,0,0,0,0,0,0
214175,21044,210,44,-2,6,2,4,0,0,0,1,0,1,2,2,0,1,0,1,0,0,0,2,0,2,0,0,0,0,0,0,0,0,0
215053,21044,210,44,-2,1,0,1,0,0,0,0,0,0,0,0,0,0,0,0,0,0,0,1,0,1,0,0,0,0,0,0,0,0,0
215062,21044,210,44,-2,4,0,4,0,0,0,1,0,1,1,0,1,1,0,1,0,0,0,1,0,1,0,0,0,0,0,0,0,0,0
215105,21044,210,44,-2,1,0,1,0,0,0,0,0,0,0,0,0,0,0,0,0,0,0,1,0,1,0,0,0,0,0,0,0,0,0
215293,21044,210,44,-2,73,28,45,0,0,0,9,2,7,2,0,2,4,2,2,0,0,0,37,17,20,1,0,1,16,4,12,4,3,1
215585,21044,210,44,-2,4,0,4,0,0,0,0,0,0,0,0,0,0,0,0,0,0,0,4,0,4,0,0,0,0,0,0,0,0,0
215691,21044,210,44,-2,1,1,0,0,0,0,1,1,0,0,0,0,0,0,0,0,0,0,0,0,0,0,0,0,0,0,0,0,0,0
216287,21044,210,44,-2,18,8,10,1,0,1,1,1,0,1,0,1,2,1,1,0,0,0,7,4,3,0,0,0,2,1,1,4,1,3
216339,21044,210,44,-2,55,18,37,0,0,0,4,1,3,16,6,10,1,1,0,0,0,0,21,6,15,0,0,0,2,0,2,11,4,7
216366,21044,210,44,-2,8,3,5,0,0,0,0,0,0,0,0,0,0,0,0,0,0,0,8,3,5,0,0,0,0,0,0,0,0,0
216463,21044,210,44,-2,1,1,0,0,0,0,0,0,0,0,0,0,0,0,0,0,0,0,1,1,0,0,0,0,0,0,0,0,0,0
216597,21044,210,44,-2,1,0,1,0,0,0,0,0,0,0,0,0,0,0,0,0,0,0,1,0,1,0,0,0,0,0,0,0,0,0
216667,21044,210,44,-2,4,1,3,0,0,0,1,0,1,0,0,0,0,0,0,0,0,0,3,1,2,0,0,0,0,0,0,0,0,0
216764,21044,210,44,-2,2,1,1,0,0,0,0,0,0,0,0,0,0,0,0,0,0,0,1,0,1,0,0,0,0,0,0,1,1,0
216816,21044,210,44,-2,1,1,0,0,0,0,0,0,0,0,0,0,1,1,0,0,0,0,0,0,0,0,0,0,0,0,0,0,0,0
217156,21044,210,44,-2,32,9,23,0,0,0,4,1,3,1,0,1,0,0,0,0,0,0,17,4,13,1,1,0,1,1,0,8,2,6
217484,21044,210,44,-2,4,1,3,0,0,0,0,0,0,1,0,1,0,0,0,0,0,0,2,1,1,0,0,0,0,0,0,1,0,1
217493,21044,210,44,-2,7,1,6,0,0,0,0,0,0,4,1,3,0,0,0,0,0,0,0,0,0,0,0,0,1,0,1,2,0,2
217518,21044,210,44,-2,3,1,2,0,0,0,0,0,0,0,0,0,0,0,0,0,0,0,0,0,0,0,0,0,0,0,0,3,1,2
217688,21044,210,44,-2,2,0,2,0,0,0,0,0,0,0,0,0,0,0,0,0,0,0,2,0,2,0,0,0,0,0,0,0,0,0
217819,21044,210,44,-2,5,3,2,0,0,0,0,0,0,2,1,1,0,0,0,0,0,0,3,2,1,0,0,0,0,0,0,0,0,0
218663,21044,210,44,-2,6,3,3,0,0,0,0,0,0,0,0,0,0,0,0,0,0,0,5,2,3,1,1,0,0,0,0,0,0,0
218964,21044,210,44,-2,1,1,0,0,0,0,0,0,0,0,0,0,0,0,0,0,0,0,1,1,0,0,0,0,0,0,0,0,0,0
219000,21044,210,44,-2,2,1,1,0,0,0,0,0,0,0,0,0,1,1,0,0,0,0,1,0,1,0,0,0,0,0,0,0,0,0
219602,21044,210,44,-2,1,1,0,0,0,0,0,0,0,0,0,0,0,0,0,0,0,0,1,1,0,0,0,0,0,0,0,0,0,0
219709,21044,210,44,-2,6,4,2,0,0,0,0,0,0,3,1,2,0,0,0,0,0,0,3,3,0,0,0,0,0,0,0,0,0,0
219879,21044,210,44,-2,1,0,1,0,0,0,0,0,0,0,0,0,0,0,0,0,0,0,1,0,1,0,0,0,0,0,0,0,0,0
220710,21044,210,44,-2,1,0,1,0,0,0,0,0,0,0,0,0,0,0,0,0,0,0,1,0,1,0,0,0,0,0,0,0,0,0
221847,21044,210,44,-2,2,2,0,0,0,0,0,0,0,0,0,0,0,0,0,0,0,0,0,0,0,1,1,0,1,1,0,0,0,0
221999,21044,210,44,-2,22,10,12,0,0,0,0,0,0,1,0,1,0,0,0,0,0,0,5,2,3,0,0,0,13,6,7,3,2,1
222178,21044,210,44,-2,1,1,0,0,0,0,0,0,0,0,0,0,0,0,0,0,0,0,1,1,0,0,0,0,0,0,0,0,0,0
223427,21044,210,44,-2,2,0,2,0,0,0,0,0,0,1,0,1,0,0,0,0,0,0,1,0,1,0,0,0,0,0,0,0,0,0
224004,21044,210,44,-2,2,0,2,0,0,0,1,0,1,0,0,0,0,0,0,0,0,0,1,0,1,0,0,0,0,0,0,0,0,0
225399,21044,210,44,-2,1,1,0,0,0,0,0,0,0,0,0,0,0,0,0,0,0,0,1,1,0,0,0,0,0,0,0,0,0,0
227368,21044,210,44,-2,93,43,50,0,0,0,6,2,4,3,1,2,39,14,25,0,0,0,34,17,17,1,1,0,3,2,1,7,6,1
227757,21044,210,44,-2,14,11,3,0,0,0,1,0,1,2,2,0,2,2,0,0,0,0,5,4,1,0,0,0,4,3,1,0,0,0
228149,21044,210,44,-2,1,1,0,0,0,0,0,0,0,0,0,0,0,0,0,0,0,0,0,0,0,0,0,0,0,0,0,1,1,0
228246,21044,210,44,-2,2,0,2,0,0,0,0,0,0,1,0,1,0,0,0,0,0,0,1,0,1,0,0,0,0,0,0,0,0,0
228343,21044,210,44,-2,2,1,1,0,0,0,0,0,0,0,0,0,1,1,0,0,0,0,1,0,1,0,0,0,0,0,0,0,0,0
228459,21044,210,44,-2,7,2,5,0,0,0,0,0,0,1,1,0,0,0,0,0,0,0,5,1,4,0,0,0,1,0,1,0,0,0
228778,21044,210,44,-2,25,18,7,0,0,0,3,1,2,3,3,0,2,1,1,0,0,0,13,9,4,0,0,0,0,0,0,4,4,0
229027,21044,210,44,-2,2,2,0,0,0,0,0,0,0,0,0,0,1,1,0,0,0,0,1,1,0,0,0,0,0,0,0,0,0,0
229267,21044,210,44,-2,1,0,1,0,0,0,0,0,0,0,0,0,0,0,0,0,0,0,1,0,1,0,0,0,0,0,0,0,0,0
230171,21044,210,44,-2,2,0,2,0,0,0,0,0,0,0,0,0,0,0,0,0,0,0,2,0,2,0,0,0,0,0,0,0,0,0
230597,21044,210,44,-2,2,1,1,0,0,0,0,0,0,0,0,0,0,0,0,0,0,0,2,1,1,0,0,0,0,0,0,0,0,0
230737,21044,210,44,-2,19,10,9,0,0,0,3,1,2,0,0,0,0,0,0,0,0,0,12,6,6,0,0,0,2,2,0,2,1,1
230807,21044,210,44,-2,4,0,4,0,0,0,0,0,0,0,0,0,0,0,0,0,0,0,4,0,4,0,0,0,0,0,0,0,0,0
230816,21044,210,44,-2,2,1,1,0,0,0,1,0,1,0,0,0,0,0,0,0,0,0,1,1,0,0,0,0,0,0,0,0,0,0
230852,21044,210,44,-2,1,0,1,0,0,0,0,0,0,0,0,0,0,0,0,0,0,0,0,0,0,0,0,0,1,0,1,0,0,0
230959,21044,210,44,-2,4,0,4,0,0,0,1,0,1,0,0,0,0,0,0,0,0,0,2,0,2,0,0,0,0,0,0,1,0,1
230995,21044,210,44,-2,1,1,0,0,0,0,0,0,0,0,0,0,0,0,0,0,0,0,1,1,0,0,0,0,0,0,0,0,0,0
231059,21044,210,44,-2,1,1,0,0,0,0,0,0,0,0,0,0,0,0,0,0,0,0,0,0,0,0,0,0,0,0,0,1,1,0
231068,21044,210,44,-2,1,0,1,0,0,0,0,0,0,0,0,0,0,0,0,0,0,0,1,0,1,0,0,0,0,0,0,0,0,0
231147,21044,210,44,-2,3,0,3,0,0,0,0,0,0,0,0,0,0,0,0,0,0,0,2,0,2,0,0,0,1,0,1,0,0,0
231420,21044,210,44,-2,2,1,1,0,0,0,0,0,0,0,0,0,0,0,0,0,0,0,2,1,1,0,0,0,0,0,0,0,0,0
231624,21044,210,44,-2,7,1,6,0,0,0,2,1,1,0,0,0,0,0,0,0,0,0,3,0,3,0,0,0,2,0,2,0,0,0
231712,21044,210,44,-2,1,1,0,0,0,0,0,0,0,0,0,0,0,0,0,0,0,0,1,1,0,0,0,0,0,0,0,0,0,0
231970,21044,210,44,-2,20,6,14,0,0,0,4,2,2,3,0,3,1,0,1,0,0,0,12,4,8,0,0,0,0,0,0,0,0,0
232186,21044,210,44,-2,20,15,5,1,1,0,3,1,2,2,2,0,1,1,0,0,0,0,9,7,2,1,1,0,0,0,0,3,2,1
232308,21044,210,44,-2,12,4,8,0,0,0,0,0,0,0,0,0,0,0,0,0,0,0,11,4,7,1,0,1,0,0,0,0,0,0
232672,21044,210,44,-2,10,2,8,0,0,0,0,0,0,0,0,0,1,0,1,0,0,0,9,2,7,0,0,0,0,0,0,0,0,0
233301,21044,210,44,-2,3,0,3,0,0,0,0,0,0,1,0,1,0,0,0,0,0,0,2,0,2,0,0,0,0,0,0,0,0,0
233718,21044,210,44,-2,8,2,6,0,0,0,0,0,0,1,0,1,1,0,1,0,0,0,6,2,4,0,0,0,0,0,0,0,0,0
234076,21044,210,44,-2,58,27,31,0,0,0,6,5,1,3,2,1,1,0,1,0,0,0,33,13,20,2,2,0,6,4,2,7,1,6
234207,21044,210,44,-2,3,1,2,0,0,0,0,0,0,1,0,1,0,0,0,0,0,0,1,0,1,0,0,0,1,1,0,0,0,0
235024,21044,210,44,-2,1,0,1,0,0,0,0,0,0,0,0,0,0,0,0,0,0,0,0,0,0,1,0,1,0,0,0,0,0,0
235167,21044,210,44,-2,2,1,1,0,0,0,0,0,0,0,0,0,0,0,0,0,0,0,0,0,0,0,0,0,2,1,1,0,0,0
236577,21044,210,44,-2,1,1,0,0,0,0,0,0,0,0,0,0,0,0,0,0,0,0,1,1,0,0,0,0,0,0,0,0,0,0
236948,21044,210,44,-2,14,4,10,0,0,0,1,0,1,0,0,0,1,1,0,0,0,0,9,3,6,0,0,0,2,0,2,1,0,1
237011,21044,210,44,-2,1,1,0,0,0,0,0,0,0,0,0,0,0,0,0,0,0,0,1,1,0,0,0,0,0,0,0,0,0,0
237525,21044,210,44,-2,1,1,0,0,0,0,1,1,0,0,0,0,0,0,0,0,0,0,0,0,0,0,0,0,0,0,0,0,0,0
238476,21044,210,44,-2,5,3,2,0,0,0,0,0,0,0,0,0,0,0,0,0,0,0,5,3,2,0,0,0,0,0,0,0,0,0
238616,21044,210,44,-2,10,5,5,0,0,0,0,0,0,0,0,0,1,0,1,0,0,0,9,5,4,0,0,0,0,0,0,0,0,0
238722,21044,210,44,-2,5,3,2,0,0,0,0,0,0,0,0,0,0,0,0,0,0,0,5,3,2,0,0,0,0,0,0,0,0,0
239169,21044,210,44,-2,18,11,7,0,0,0,2,1,1,0,0,0,2,2,0,0,0,0,14,8,6,0,0,0,0,0,0,0,0,0
239318,21044,210,44,-2,6,3,3,0,0,0,0,0,0,0,0,0,0,0,0,0,0,0,6,3,3,0,0,0,0,0,0,0,0,0
240727,21044,210,44,-2,8,2,6,0,0,0,0,0,0,0,0,0,0,0,0,0,0,0,4,0,4,0,0,0,3,1,2,1,1,0
240754,21044,210,44,-2,1,0,1,0,0,0,0,0,0,0,0,0,0,0,0,1,0,1,0,0,0,0,0,0,0,0,0,0,0,0
240790,21044,210,44,-2,1,1,0,0,0,0,0,0,0,0,0,0,0,0,0,1,1,0,0,0,0,0,0,0,0,0,0,0,0,0
243568,21044,210,44,-2,7,3,4,0,0,0,0,0,0,0,0,0,7,3,4,0,0,0,0,0,0,0,0,0,0,0,0,0,0,0
243638,21044,210,44,-2,4,4,0,0,0,0,2,2,0,0,0,0,0,0,0,2,2,0,0,0,0,0,0,0,0,0,0,0,0,0
243744,21044,210,44,-2,44,30,14,0,0,0,16,8,8,2,1,1,1,1,0,0,0,0,17,14,3,2,2,0,6,4,2,0,0,0
243780,21044,210,44,-2,11,9,2,0,0,0,1,0,1,0,0,0,0,0,0,0,0,0,1,1,0,1,1,0,0,0,0,8,7,1
244446,21044,210,44,-2,27,7,20,0,0,0,1,1,0,17,4,13,0,0,0,0,0,0,9,2,7,0,0,0,0,0,0,0,0,0
376695,21044,210,44,-2,4,3,1,0,0,0,0,0,0,0,0,0,0,0,0,1,1,0,3,2,1,0,0,0,0,0,0,0,0,0
377555,21044,210,44,-2,4,1,3,0,0,0,1,0,1,0,0,0,1,0,1,0,0,0,2,1,1,0,0,0,0,0,0,0,0,0
377564,21044,210,44,-2,4,2,2,0,0,0,1,0,1,0,0,0,0,0,0,0,0,0,1,1,0,1,0,1,1,1,0,0,0,0
407629,21044,210,44,-2,28,15,13,0,0,0,4,2,2,1,0,1,0,0,0,0,0,0,23,13,10,0,0,0,0,0,0,0,0,0
409254,21044,210,44,-2,1,0,1,0,0,0,0,0,0,1,0,1,0,0,0,0,0,0,0,0,0,0,0,0,0,0,0,0,0,0
423643,21044,210,44,-2,4,4,0,0,0,0,0,0,0,2,2,0,0,0,0,0,0,0,2,2,0,0,0,0,0,0,0,0,0,0
428392,21044,210,44,-2,4,1,3,0,0,0,0,0,0,0,0,0,0,0,0,0,0,0,4,1,3,0,0,0,0,0,0,0,0,0
429094,21044,210,44,-2,1,0,1,0,0,0,1,0,1,0,0,0,0,0,0,0,0,0,0,0,0,0,0,0,0,0,0,0,0,0
433004,21044,210,44,-2,7,5,2,1,1,0,2,1,1,0,0,0,0,0,0,0,0,0,4,3,1,0,0,0,0,0,0,0,0,0
433660,21044,210,44,-2,33,11,22,0,0,0,5,2,3,3,1,2,4,1,3,0,0,0,14,5,9,2,0,2,0,0,0,5,2,3
439446,21044,210,44,-2,1,1,0,0,0,0,1,1,0,0,0,0,0,0,0,0,0,0,0,0,0,0,0,0,0,0,0,0,0,0
440031,21044,210,44,-2,10,2,8,0,0,0,1,0,1,2,0,2,0,0,0,0,0,0,6,1,5,0,0,0,1,1,0,0,0,0
440794,21044,210,44,-2,1,0,1,0,0,0,0,0,0,1,0,1,0,0,0,0,0,0,0,0,0,0,0,0,0,0,0,0,0,0
441982,21044,210,44,-2,1,0,1,0,0,0,0,0,0,0,0,0,1,0,1,0,0,0,0,0,0,0,0,0,0,0,0,0,0,0
443128,21044,210,44,-2,1,1,0,0,0,0,0,0,0,0,0,0,0,0,0,0,0,0,1,1,0,0,0,0,0,0,0,0,0,0
444954,21044,210,44,-2,1,0,1,0,0,0,0,0,0,0,0,0,1,0,1,0,0,0,0,0,0,0,0,0,0,0,0,0,0,0
445735,21044,210,44,-2,8,4,4,0,0,0,0,0,0,0,0,0,3,2,1,0,0,0,5,2,3,0,0,0,0,0,0,0,0,0
445869,21044,210,44,-2,5,2,3,0,0,0,0,0,0,1,0,1,0,0,0,0,0,0,3,2,1,0,0,0,1,0,1,0,0,0
446048,21044,210,44,-2,3,2,1,0,0,0,1,0,1,0,0,0,1,1,0,0,0,0,1,1,0,0,0,0,0,0,0,0,0,0
451927,21044,210,44,-2,1,1,0,0,0,0,0,0,0,0,0,0,0,0,0,0,0,0,1,1,0,0,0,0,0,0,0,0,0,0
455406,21044,210,44,-2,5,2,3,0,0,0,0,0,0,0,0,0,0,0,0,0,0,0,4,1,3,1,1,0,0,0,0,0,0,0
455433,21044,210,44,-2,1,1,0,0,0,0,0,0,0,0,0,0,0,0,0,0,0,0,0,0,0,1,1,0,0,0,0,0,0,0
455664,21044,210,44,-2,12,4,8,0,0,0,0,0,0,2,0,2,1,1,0,0,0,0,7,2,5,2,1,1,0,0,0,0,0,0
455813,21044,210,44,-2,1,0,1,0,0,0,0,0,0,0,0,0,0,0,0,0,0,0,1,0,1,0,0,0,0,0,0,0,0,0
457299,21044,210,44,-2,3,1,2,0,0,0,1,0,1,0,0,0,2,1,1,0,0,0,0,0,0,0,0,0,0,0,0,0,0,0
459736,21044,210,44,-2,1,0,1,0,0,0,0,0,0,0,0,0,0,0,0,0,0,0,0,0,0,1,0,1,0,0,0,0,0,0
459745,21044,210,44,-2,2,0,2,0,0,0,1,0,1,0,0,0,0,0,0,0,0,0,1,0,1,0,0,0,0,0,0,0,0,0
459824,21044,210,44,-2,4,1,3,0,0,0,1,0,1,0,0,0,0,0,0,0,0,0,3,1,2,0,0,0,0,0,0,0,0,0
460738,21044,210,44,-2,2,0,2,0,0,0,0,0,0,0,0,0,0,0,0,0,0,0,1,0,1,0,0,0,1,0,1,0,0,0
475608,21044,210,44,-2,4,2,2,0,0,0,0,0,0,0,0,0,0,0,0,0,0,0,4,2,2,0,0,0,0,0,0,0,0,0
480790,21044,210,44,-2,1,0,1,0,0,0,1,0,1,0,0,0,0,0,0,0,0,0,0,0,0,0,0,0,0,0,0,0,0,0
482936,21044,210,44,-2,9,7,2,0,0,0,1,0,1,0,0,0,0,0,0,0,0,0,5,4,1,0,0,0,0,0,0,3,3,0
483595,21044,210,44,-2,6,6,0,0,0,0,0,0,0,0,0,0,6,6,0,0,0,0,0,0,0,0,0,0,0,0,0,0,0,0
483975,21044,210,44,-2,7,5,2,0,0,0,0,0,0,1,1,0,0,0,0,0,0,0,6,4,2,0,0,0,0,0,0,0,0,0
488554,21044,210,44,-2,3,2,1,0,0,0,0,0,0,0,0,0,0,0,0,0,0,0,3,2,1,0,0,0,0,0,0,0,0,0
489937,21044,210,44,-2,12,8,4,0,0,0,6,5,1,1,0,1,0,0,0,0,0,0,5,3,2,0,0,0,0,0,0,0,0,0
492607,21044,210,44,-2,1,0,1,0,0,0,0,0,0,0,0,0,0,0,0,0,0,0,1,0,1,0,0,0,0,0,0,0,0,0
495314,21044,210,44,-2,2,0,2,0,0,0,2,0,2,0,0,0,0,0,0,0,0,0,0,0,0,0,0,0,0,0,0,0,0,0
495767,21044,210,44,-2,38,16,22,0,0,0,2,0,2,2,1,1,3,3,0,0,0,0,21,9,12,0,0,0,2,0,2,8,3,5
496043,21044,210,44,-2,1,1,0,0,0,0,1,1,0,0,0,0,0,0,0,0,0,0,0,0,0,0,0,0,0,0,0,0,0,0
496627,21044,210,44,-2,5,3,2,0,0,0,1,1,0,0,0,0,0,0,0,0,0,0,4,2,2,0,0,0,0,0,0,0,0,0
101116,21045,210,45,-2,1,1,0,0,0,0,0,0,0,0,0,0,0,0,0,0,0,0,1,1,0,0,0,0,0,0,0,0,0,0
101709,21045,210,45,-2,5,1,4,0,0,0,0,0,0,2,0,2,0,0,0,0,0,0,3,1,2,0,0,0,0,0,0,0,0,0
102368,21045,210,45,-2,22,10,12,0,0,0,0,0,0,0,0,0,0,0,0,0,0,0,15,5,10,1,0,1,0,0,0,6,5,1
102553,21045,210,45,-2,3,0,3,1,0,1,1,0,1,0,0,0,0,0,0,0,0,0,1,0,1,0,0,0,0,0,0,0,0,0
102632,21045,210,45,-2,1,0,1,0,0,0,0,0,0,0,0,0,0,0,0,0,0,0,1,0,1,0,0,0,0,0,0,0,0,0
102845,21045,210,45,-2,29,13,16,1,0,1,1,0,1,5,2,3,3,1,2,0,0,0,19,10,9,0,0,0,0,0,0,0,0,0
103893,21045,210,45,-2,15,2,13,0,0,0,0,0,0,0,0,0,1,1,0,0,0,0,12,1,11,1,0,1,1,0,1,0,0,0
103909,21045,210,45,-2,7,3,4,0,0,0,0,0,0,0,0,0,1,0,1,0,0,0,5,2,3,0,0,0,1,1,0,0,0,0
103927,21045,210,45,-2,6,0,6,0,0,0,0,0,0,1,0,1,0,0,0,0,0,0,5,0,5,0,0,0,0,0,0,0,0,0
104090,21045,210,45,-2,8,2,6,0,0,0,0,0,0,0,0,0,0,0,0,0,0,0,7,2,5,1,0,1,0,0,0,0,0,0
104717,21045,210,45,-2,30,5,25,0,0,0,0,0,0,12,2,10,1,0,1,0,0,0,16,3,13,0,0,0,1,0,1,0,0,0
105534,21045,210,45,-2,12,5,7,0,0,0,0,0,0,0,0,0,4,0,4,0,0,0,5,2,3,3,3,0,0,0,0,0,0,0
105543,21045,210,45,-2,10,1,9,0,0,0,0,0,0,0,0,0,3,0,3,0,0,0,7,1,6,0,0,0,0,0,0,0,0,0
105659,21045,210,45,-2,7,6,1,1,0,1,0,0,0,2,2,0,2,2,0,0,0,0,2,2,0,0,0,0,0,0,0,0,0,0
106397,21045,210,45,-2,30,13,17,0,0,0,0,0,0,4,2,2,4,3,1,0,0,0,19,7,12,0,0,0,2,1,1,1,0,1
106546,21045,210,45,-2,11,1,10,0,0,0,0,0,0,0,0,0,0,0,0,0,0,0,11,1,10,0,0,0,0,0,0,0,0,0
106704,21045,210,45,-2,16,8,8,0,0,0,0,0,0,3,1,2,0,0,0,0,0,0,12,6,6,1,1,0,0,0,0,0,0,0
106713,21045,210,45,-2,3,0,3,0,0,0,0,0,0,0,0,0,0,0,0,0,0,0,3,0,3,0,0,0,0,0,0,0,0,0
107558,21045,210,45,-2,2,0,2,0,0,0,0,0,0,0,0,0,0,0,0,0,0,0,2,0,2,0,0,0,0,0,0,0,0,0
108232,21045,210,45,-2,1,1,0,0,0,0,0,0,0,0,0,0,0,0,0,0,0,0,1,1,0,0,0,0,0,0,0,0,0,0
110219,21045,210,45,-2,3,0,3,0,0,0,0,0,0,1,0,1,0,0,0,0,0,0,2,0,2,0,0,0,0,0,0,0,0,0
112394,21045,210,45,-2,1,1,0,0,0,0,0,0,0,0,0,0,0,0,0,0,0,0,1,1,0,0,0,0,0,0,0,0,0,0
112570,21045,210,45,-2,1,1,0,0,0,0,0,0,0,1,1,0,0,0,0,0,0,0,0,0,0,0,0,0,0,0,0,0,0,0
115931,21045,210,45,-2,7,5,2,0,0,0,0,0,0,2,1,1,3,2,1,0,0,0,2,2,0,0,0,0,0,0,0,0,0,0
118198,21045,210,45,-2,1,1,0,0,0,0,0,0,0,0,0,0,0,0,0,0,0,0,1,1,0,0,0,0,0,0,0,0,0,0
119270,21045,210,45,-2,1,0,1,0,0,0,0,0,0,0,0,0,0,0,0,1,0,1,0,0,0,0,0,0,0,0,0,0,0,0
120661,21045,210,45,-2,3,1,2,1,0,1,0,0,0,0,0,0,1,0,1,0,0,0,1,1,0,0,0,0,0,0,0,0,0,0
122436,21045,210,45,-2,1,0,1,0,0,0,0,0,0,0,0,0,0,0,0,0,0,0,1,0,1,0,0,0,0,0,0,0,0,0
122685,21045,210,45,-2,7,2,5,0,0,0,0,0,0,1,0,1,2,2,0,0,0,0,3,0,3,1,0,1,0,0,0,0,0,0
122694,21045,210,45,-2,4,0,4,0,0,0,1,0,1,0,0,0,0,0,0,0,0,0,2,0,2,1,0,1,0,0,0,0,0,0
123633,21045,210,45,-2,2,1,1,0,0,0,0,0,0,0,0,0,0,0,0,0,0,0,2,1,1,0,0,0,0,0,0,0,0,0
123679,21045,210,45,-2,10,2,8,0,0,0,2,0,2,0,0,0,3,1,2,0,0,0,3,0,3,1,0,1,1,1,0,0,0,0
124292,21045,210,45,-2,1,1,0,0,0,0,0,0,0,0,0,0,0,0,0,0,0,0,1,1,0,0,0,0,0,0,0,0,0,0
124706,21045,210,45,-2,4,1,3,0,0,0,0,0,0,0,0,0,1,0,1,0,0,0,1,0,1,1,0,1,1,1,0,0,0,0
124937,21045,210,45,-2,4,2,2,0,0,0,1,0,1,0,0,0,2,2,0,0,0,0,1,0,1,0,0,0,0,0,0,0,0,0
125231,21045,210,45,-2,14,5,9,0,0,0,0,0,0,9,3,6,1,0,1,0,0,0,2,1,1,1,0,1,1,1,0,0,0,0
125532,21045,210,45,-2,8,0,8,1,0,1,1,0,1,2,0,2,0,0,0,1,0,1,3,0,3,0,0,0,0,0,0,0,0,0
126207,21045,210,45,-2,1,0,1,0,0,0,0,0,0,0,0,0,0,0,0,0,0,0,1,0,1,0,0,0,0,0,0,0,0,0
126562,21045,210,45,-2,231,51,180,1,0,1,11,0,11,0,0,0,11,4,7,0,0,0,152,35,117,3,0,3,50,12,38,3,0,3
126669,21045,210,45,-2,6,1,5,0,0,0,0,0,0,0,0,0,0,0,0,0,0,0,5,1,4,1,0,1,0,0,0,0,0,0
126687,21045,210,45,-2,6,0,6,0,0,0,1,0,1,0,0,0,1,0,1,0,0,0,3,0,3,1,0,1,0,0,0,0,0,0
126951,21045,210,45,-2,17,15,2,0,0,0,0,0,0,1,1,0,0,0,0,0,0,0,16,14,2,0,0,0,0,0,0,0,0,0
127185,21045,210,45,-2,4,1,3,0,0,0,0,0,0,0,0,0,0,0,0,0,0,0,3,0,3,0,0,0,1,1,0,0,0,0
127945,21045,210,45,-2,6,1,5,0,0,0,0,0,0,0,0,0,0,0,0,0,0,0,6,1,5,0,0,0,0,0,0,0,0,0
128179,21045,210,45,-2,6,2,4,1,1,0,0,0,0,1,0,1,2,0,2,0,0,0,2,1,1,0,0,0,0,0,0,0,0,0
128188,21045,210,45,-2,15,5,10,0,0,0,0,0,0,0,0,0,3,1,2,0,0,0,8,3,5,0,0,0,4,1,3,0,0,0
128902,21045,210,45,-2,1,1,0,0,0,0,0,0,0,0,0,0,0,0,0,0,0,0,1,1,0,0,0,0,0,0,0,0,0,0
130183,21045,210,45,-2,2,0,2,0,0,0,0,0,0,0,0,0,0,0,0,0,0,0,2,0,2,0,0,0,0,0,0,0,0,0
130907,21045,210,45,-2,21,6,15,1,0,1,0,0,0,6,3,3,0,0,0,0,0,0,14,3,11,0,0,0,0,0,0,0,0,0
131803,21045,210,45,-2,11,8,3,0,0,0,3,2,1,2,1,1,0,0,0,0,0,0,3,3,0,0,0,0,3,2,1,0,0,0
133465,21045,210,45,-2,8,2,6,0,0,0,0,0,0,4,0,4,1,0,1,0,0,0,2,1,1,0,0,0,1,1,0,0,0,0
133845,21045,210,45,-2,5,0,5,0,0,0,0,0,0,1,0,1,2,0,2,0,0,0,2,0,2,0,0,0,0,0,0,0,0,0
133854,21045,210,45,-2,1,1,0,0,0,0,0,0,0,1,1,0,0,0,0,0,0,0,0,0,0,0,0,0,0,0,0,0,0,0
133863,21045,210,45,-2,4,1,3,0,0,0,1,1,0,0,0,0,2,0,2,0,0,0,0,0,0,0,0,0,1,0,1,0,0,0
134237,21045,210,45,-2,24,19,5,0,0,0,1,1,0,2,1,1,5,3,2,0,0,0,15,13,2,1,1,0,0,0,0,0,0,0
135081,21045,210,45,-2,37,16,21,1,1,0,2,0,2,9,3,6,8,4,4,0,0,0,15,7,8,2,1,1,0,0,0,0,0,0
136950,21045,210,45,-2,2,1,1,0,0,0,0,0,0,0,0,0,0,0,0,0,0,0,2,1,1,0,0,0,0,0,0,0,0,0
138309,21045,210,45,-2,35,5,30,0,0,0,0,0,0,8,0,8,0,0,0,0,0,0,26,5,21,1,0,1,0,0,0,0,0,0
138840,21045,210,45,-2,14,3,11,1,0,1,0,0,0,12,3,9,1,0,1,0,0,0,0,0,0,0,0,0,0,0,0,0,0,0
139357,21045,210,45,-2,19,6,13,0,0,0,1,1,0,9,2,7,1,1,0,0,0,0,8,2,6,0,0,0,0,0,0,0,0,0
139579,21045,210,45,-2,5,2,3,0,0,0,0,0,0,2,1,1,0,0,0,0,0,0,3,1,2,0,0,0,0,0,0,0,0,0
140012,21045,210,45,-2,11,5,6,0,0,0,0,0,0,4,2,2,0,0,0,0,0,0,7,3,4,0,0,0,0,0,0,0,0,0
140447,21045,210,45,-2,1,0,1,0,0,0,0,0,0,1,0,1,0,0,0,0,0,0,0,0,0,0,0,0,0,0,0,0,0,0
140942,21045,210,45,-2,22,10,12,0,0,0,1,0,1,5,0,5,2,1,1,0,0,0,12,8,4,2,1,1,0,0,0,0,0,0
141255,21045,210,45,-2,24,7,17,0,0,0,0,0,0,3,1,2,0,0,0,0,0,0,21,6,15,0,0,0,0,0,0,0,0,0
141264,21045,210,45,-2,1,0,1,0,0,0,0,0,0,0,0,0,0,0,0,0,0,0,1,0,1,0,0,0,0,0,0,0,0,0
142054,21045,210,45,-2,10,0,10,0,0,0,0,0,0,0,0,0,1,0,1,0,0,0,7,0,7,1,0,1,1,0,1,0,0,0
142832,21045,210,45,-2,2,1,1,0,0,0,0,0,0,0,0,0,1,0,1,0,0,0,0,0,0,0,0,0,1,1,0,0,0,0
144485,21045,210,45,-2,1,1,0,0,0,0,1,1,0,0,0,0,0,0,0,0,0,0,0,0,0,0,0,0,0,0,0,0,0,0
145239,21045,210,45,-2,4,0,4,0,0,0,0,0,0,1,0,1,0,0,0,0,0,0,3,0,3,0,0,0,0,0,0,0,0,0
146700,21045,210,45,-2,8,7,1,0,0,0,0,0,0,2,1,1,1,1,0,0,0,0,5,5,0,0,0,0,0,0,0,0,0,0
147697,21045,210,45,-2,2,0,2,0,0,0,0,0,0,0,0,0,0,0,0,0,0,0,2,0,2,0,0,0,0,0,0,0,0,0
149028,21045,210,45,-2,1,0,1,0,0,0,0,0,0,0,0,0,0,0,0,0,0,0,1,0,1,0,0,0,0,0,0,0,0,0
149639,21045,210,45,-2,1,0,1,0,0,0,0,0,0,0,0,0,1,0,1,0,0,0,0,0,0,0,0,0,0,0,0,0,0,0
151102,21045,210,45,-2,2,2,0,0,0,0,1,1,0,0,0,0,0,0,0,0,0,0,0,0,0,0,0,0,0,0,0,1,1,0
151111,21045,210,45,-2,186,85,101,0,0,0,43,15,28,7,1,6,5,1,4,0,0,0,115,57,58,3,2,1,0,0,0,13,9,4
151333,21045,210,45,-2,3,0,3,0,0,0,0,0,0,0,0,0,0,0,0,0,0,0,3,0,3,0,0,0,0,0,0,0,0,0
151342,21045,210,45,-2,1,0,1,0,0,0,0,0,0,0,0,0,0,0,0,0,0,0,1,0,1,0,0,0,0,0,0,0,0,0
151351,21045,210,45,-2,28,16,12,0,0,0,1,0,1,2,2,0,4,1,3,0,0,0,16,9,7,0,0,0,0,0,0,5,4,1
151360,21045,210,45,-2,1,0,1,0,0,0,0,0,0,0,0,0,0,0,0,0,0,0,1,0,1,0,0,0,0,0,0,0,0,0
151379,21045,210,45,-2,1,0,1,0,0,0,0,0,0,0,0,0,0,0,0,0,0,0,1,0,1,0,0,0,0,0,0,0,0,0
151467,21045,210,45,-2,1,0,1,0,0,0,0,0,0,0,0,0,0,0,0,0,0,0,1,0,1,0,0,0,0,0,0,0,0,0
151661,21045,210,45,-2,14,12,2,0,0,0,0,0,0,2,2,0,0,0,0,0,0,0,12,10,2,0,0,0,0,0,0,0,0,0
151810,21045,210,45,-2,6,4,2,0,0,0,0,0,0,5,3,2,0,0,0,0,0,0,1,1,0,0,0,0,0,0,0,0,0,0
153269,21045,210,45,-2,10,6,4,0,0,0,1,1,0,0,0,0,0,0,0,0,0,0,7,4,3,0,0,0,0,0,0,2,1,1
153296,21045,210,45,-2,3,1,2,0,0,0,0,0,0,0,0,0,0,0,0,0,0,0,3,1,2,0,0,0,0,0,0,0,0,0
153384,21045,210,45,-2,1,0,1,0,0,0,1,0,1,0,0,0,0,0,0,0,0,0,0,0,0,0,0,0,0,0,0,0,0,0
153861,21045,210,45,-2,19,13,6,0,0,0,6,5,1,1,0,1,0,0,0,0,0,0,10,6,4,0,0,0,2,2,0,0,0,0
153922,21045,210,45,-2,3,2,1,0,0,0,0,0,0,0,0,0,0,0,0,0,0,0,3,2,1,0,0,0,0,0,0,0,0,0
154004,21045,210,45,-2,1,1,0,0,0,0,0,0,0,0,0,0,0,0,0,0,0,0,1,1,0,0,0,0,0,0,0,0,0,0
154022,21045,210,45,-2,7,2,5,0,0,0,1,1,0,2,0,2,2,1,1,0,0,0,2,0,2,0,0,0,0,0,0,0,0,0
154174,21045,210,45,-2,10,5,5,0,0,0,2,2,0,0,0,0,0,0,0,0,0,0,8,3,5,0,0,0,0,0,0,0,0,0
154378,21045,210,45,-2,6,2,4,0,0,0,0,0,0,0,0,0,0,0,0,0,0,0,6,2,4,0,0,0,0,0,0,0,0,0
155283,21045,210,45,-2,6,1,5,0,0,0,0,0,0,2,0,2,1,0,1,0,0,0,3,1,2,0,0,0,0,0,0,0,0,0
155317,21045,210,45,-2,2,1,1,0,0,0,0,0,0,0,0,0,0,0,0,0,0,0,1,1,0,1,0,1,0,0,0,0,0,0
155399,21045,210,45,-2,8,7,1,0,0,0,0,0,0,0,0,0,1,1,0,0,0,0,6,5,1,0,0,0,0,0,0,1,1,0
156471,21045,210,45,-2,18,1,17,0,0,0,0,0,0,3,0,3,0,0,0,0,0,0,15,1,14,0,0,0,0,0,0,0,0,0
159197,21045,210,45,-2,3,2,1,0,0,0,0,0,0,0,0,0,0,0,0,0,0,0,3,2,1,0,0,0,0,0,0,0,0,0
161299,21045,210,45,-2,3,2,1,0,0,0,0,0,0,0,0,0,0,0,0,0,0,0,3,2,1,0,0,0,0,0,0,0,0,0
161554,21045,210,45,-2,1,1,0,0,0,0,0,0,0,0,0,0,0,0,0,0,0,0,1,1,0,0,0,0,0,0,0,0,0,0
162779,21045,210,45,-2,7,4,3,0,0,0,1,1,0,2,1,1,0,0,0,0,0,0,4,2,2,0,0,0,0,0,0,0,0,0
163028,21045,210,45,-2,21,21,0,0,0,0,1,1,0,10,10,0,0,0,0,0,0,0,7,7,0,1,1,0,2,2,0,0,0,0
164632,21045,210,45,-2,1,0,1,0,0,0,0,0,0,0,0,0,0,0,0,0,0,0,1,0,1,0,0,0,0,0,0,0,0,0
164988,21045,210,45,-2,129,52,77,0,0,0,22,9,13,6,1,5,12,4,8,0,0,0,62,28,34,4,3,1,19,5,14,4,2,2
165699,21045,210,45,-2,5,1,4,0,0,0,1,0,1,0,0,0,0,0,0,0,0,0,2,1,1,0,0,0,2,0,2,0,0,0
166045,21045,210,45,-2,1,0,1,0,0,0,0,0,0,0,0,0,0,0,0,0,0,0,1,0,1,0,0,0,0,0,0,0,0,0
166708,21045,210,45,-2,108,55,53,0,0,0,33,15,18,3,1,2,5,2,3,0,0,0,59,34,25,0,0,0,5,2,3,3,1,2
168227,21045,210,45,-2,2,1,1,0,0,0,0,0,0,0,0,0,0,0,0,0,0,0,1,0,1,0,0,0,1,1,0,0,0,0
169479,21045,210,45,-2,11,5,6,0,0,0,0,0,0,2,2,0,0,0,0,0,0,0,6,1,5,1,0,1,1,1,0,1,1,0
169655,21045,210,45,-2,14,11,3,0,0,0,0,0,0,5,5,0,1,1,0,0,0,0,7,4,3,1,1,0,0,0,0,0,0,0
169761,21045,210,45,-2,3,1,2,0,0,0,0,0,0,1,0,1,0,0,0,0,0,0,2,1,1,0,0,0,0,0,0,0,0,0
171128,21045,210,45,-2,1,1,0,0,0,0,0,0,0,0,0,0,0,0,0,0,0,0,1,1,0,0,0,0,0,0,0,0,0,0
172635,21045,210,45,-2,3,1,2,0,0,0,0,0,0,2,1,1,0,0,0,0,0,0,1,0,1,0,0,0,0,0,0,0,0,0
173452,21045,210,45,-2,5,5,0,0,0,0,0,0,0,1,1,0,0,0,0,0,0,0,4,4,0,0,0,0,0,0,0,0,0,0
174154,21045,210,45,-2,7,0,7,0,0,0,0,0,0,0,0,0,0,0,0,0,0,0,7,0,7,0,0,0,0,0,0,0,0,0
174525,21045,210,45,-2,1,1,0,0,0,0,0,0,0,0,0,0,0,0,0,0,0,0,1,1,0,0,0,0,0,0,0,0,0,0
175014,21045,210,45,-2,20,4,16,0,0,0,0,0,0,2,1,1,0,0,0,0,0,0,16,2,14,1,1,0,1,0,1,0,0,0
175227,21045,210,45,-2,11,7,4,0,0,0,1,0,1,0,0,0,0,0,0,0,0,0,10,7,3,0,0,0,0,0,0,0,0,0
175342,21045,210,45,-2,2,0,2,0,0,0,0,0,0,1,0,1,0,0,0,0,0,0,1,0,1,0,0,0,0,0,0,0,0,0
176789,21045,210,45,-2,1,1,0,0,0,0,1,1,0,0,0,0,0,0,0,0,0,0,0,0,0,0,0,0,0,0,0,0,0,0
177302,21045,210,45,-2,4,4,0,0,0,0,1,1,0,1,1,0,0,0,0,0,0,0,2,2,0,0,0,0,0,0,0,0,0,0
178891,21045,210,45,-2,7,6,1,0,0,0,0,0,0,1,0,1,0,0,0,0,0,0,6,6,0,0,0,0,0,0,0,0,0,0
180054,21045,210,45,-2,1,1,0,1,1,0,0,0,0,0,0,0,0,0,0,0,0,0,0,0,0,0,0,0,0,0,0,0,0,0
181941,21045,210,45,-2,10,7,3,1,1,0,0,0,0,0,0,0,2,1,1,0,0,0,7,5,2,0,0,0,0,0,0,0,0,0
182148,21045,210,45,-2,14,0,14,0,0,0,0,0,0,1,0,1,4,0,4,0,0,0,9,0,9,0,0,0,0,0,0,0,0,0
183248,21045,210,45,-2,2,0,2,0,0,0,0,0,0,0,0,0,0,0,0,0,0,0,2,0,2,0,0,0,0,0,0,0,0,0
184959,21045,210,45,-2,3,0,3,0,0,0,0,0,0,0,0,0,0,0,0,0,0,0,3,0,3,0,0,0,0,0,0,0,0,0
185721,21045,210,45,-2,1,0,1,0,0,0,0,0,0,0,0,0,0,0,0,0,0,0,1,0,1,0,0,0,0,0,0,0,0,0
186584,21045,210,45,-2,1,0,1,0,0,0,0,0,0,0,0,0,0,0,0,0,0,0,1,0,1,0,0,0,0,0,0,0,0,0
187967,21045,210,45,-2,5,1,4,0,0,0,1,0,1,0,0,0,2,1,1,0,0,0,2,0,2,0,0,0,0,0,0,0,0,0
188517,21045,210,45,-2,2,0,2,0,0,0,0,0,0,0,0,0,0,0,0,0,0,0,1,0,1,0,0,0,1,0,1,0,0,0
188854,21045,210,45,-2,3,2,1,0,0,0,0,0,0,0,0,0,0,0,0,0,0,0,2,1,1,1,1,0,0,0,0,0,0,0
189565,21045,210,45,-2,2,0,2,0,0,0,0,0,0,0,0,0,0,0,0,0,0,0,1,0,1,0,0,0,1,0,1,0,0,0
189705,21045,210,45,-2,3,0,3,0,0,0,0,0,0,0,0,0,0,0,0,0,0,0,3,0,3,0,0,0,0,0,0,0,0,0
189811,21045,210,45,-2,1,0,1,0,0,0,1,0,1,0,0,0,0,0,0,0,0,0,0,0,0,0,0,0,0,0,0,0,0,0
190044,21045,210,45,-2,5,1,4,0,0,0,0,0,0,0,0,0,0,0,0,0,0,0,5,1,4,0,0,0,0,0,0,0,0,0
190451,21045,210,45,-2,1,0,1,0,0,0,0,0,0,0,0,0,0,0,0,0,0,0,1,0,1,0,0,0,0,0,0,0,0,0
190956,21045,210,45,-2,4,0,4,0,0,0,0,0,0,0,0,0,0,0,0,0,0,0,4,0,4,0,0,0,0,0,0,0,0,0
191515,21045,210,45,-2,1,0,1,0,0,0,0,0,0,0,0,0,0,0,0,0,0,0,0,0,0,0,0,0,0,0,0,1,0,1
191649,21045,210,45,-2,2,1,1,0,0,0,0,0,0,0,0,0,0,0,0,0,0,0,2,1,1,0,0,0,0,0,0,0,0,0
192688,21045,210,45,-2,2,1,1,0,0,0,1,0,1,0,0,0,1,1,0,0,0,0,0,0,0,0,0,0,0,0,0,0,0,0
193308,21045,210,45,-2,9,2,7,0,0,0,3,1,2,1,0,1,2,0,2,0,0,0,3,1,2,0,0,0,0,0,0,0,0,0
193900,21045,210,45,-2,439,200,239,1,0,1,98,50,48,25,8,17,31,12,19,1,1,0,239,109,130,3,1,2,9,3,6,32,16,16
195784,21045,210,45,-2,1,0,1,0,0,0,0,0,0,0,0,0,0,0,0,0,0,0,1,0,1,0,0,0,0,0,0,0,0,0
196680,21045,210,45,-2,1,0,1,0,0,0,0,0,0,0,0,0,0,0,0,0,0,0,1,0,1,0,0,0,0,0,0,0,0,0
198109,21045,210,45,-2,3,1,2,0,0,0,0,0,0,1,1,0,0,0,0,0,0,0,2,0,2,0,0,0,0,0,0,0,0,0
198552,21045,210,45,-2,14,6,8,0,0,0,0,0,0,6,2,4,0,0,0,0,0,0,7,4,3,1,0,1,0,0,0,0,0,0
199847,21045,210,45,-2,7,4,3,1,1,0,1,1,0,1,0,1,0,0,0,0,0,0,4,2,2,0,0,0,0,0,0,0,0,0
199883,21045,210,45,-2,1,0,1,0,0,0,0,0,0,1,0,1,0,0,0,0,0,0,0,0,0,0,0,0,0,0,0,0,0,0
200217,21045,210,45,-2,11,3,8,0,0,0,1,1,0,0,0,0,0,0,0,0,0,0,10,2,8,0,0,0,0,0,0,0,0,0
200590,21045,210,45,-2,1,0,1,0,0,0,0,0,0,0,0,0,0,0,0,0,0,0,1,0,1,0,0,0,0,0,0,0,0,0
201469,21045,210,45,-2,3,1,2,0,0,0,0,0,0,0,0,0,0,0,0,0,0,0,3,1,2,0,0,0,0,0,0,0,0,0
201645,21045,210,45,-2,16,7,9,0,0,0,1,0,1,1,0,1,1,1,0,0,0,0,11,4,7,0,0,0,1,1,0,1,1,0
201751,21045,210,45,-2,2,0,2,0,0,0,0,0,0,0,0,0,0,0,0,0,0,0,1,0,1,0,0,0,1,0,1,0,0,0
201821,21045,210,45,-2,9,2,7,0,0,0,0,0,0,0,0,0,0,0,0,0,0,0,9,2,7,0,0,0,0,0,0,0,0,0
202806,21045,210,45,-2,5,1,4,0,0,0,0,0,0,0,0,0,0,0,0,0,0,0,5,1,4,0,0,0,0,0,0,0,0,0
202912,21045,210,45,-2,6,0,6,0,0,0,0,0,0,0,0,0,0,0,0,0,0,0,6,0,6,0,0,0,0,0,0,0,0,0
203155,21045,210,45,-2,11,7,4,0,0,0,0,0,0,1,0,1,0,0,0,0,0,0,10,7,3,0,0,0,0,0,0,0,0,0
203386,21045,210,45,-2,33,5,28,0,0,0,0,0,0,4,0,4,0,0,0,0,0,0,28,5,23,0,0,0,1,0,1,0,0,0
203720,21045,210,45,-2,5,5,0,0,0,0,0,0,0,2,2,0,0,0,0,0,0,0,3,3,0,0,0,0,0,0,0,0,0,0
204185,21045,210,45,-2,2,0,2,0,0,0,0,0,0,0,0,0,0,0,0,0,0,0,2,0,2,0,0,0,0,0,0,0,0,0
204501,21045,210,45,-2,4,2,2,0,0,0,0,0,0,0,0,0,0,0,0,0,0,0,1,0,1,0,0,0,1,0,1,2,2,0
205054,21045,210,45,-2,1,0,1,0,0,0,0,0,0,0,0,0,0,0,0,0,0,0,1,0,1,0,0,0,0,0,0,0,0,0
205179,21045,210,45,-2,3,1,2,0,0,0,0,0,0,0,0,0,0,0,0,0,0,0,3,1,2,0,0,0,0,0,0,0,0,0
205887,21045,210,45,-2,6,0,6,0,0,0,0,0,0,1,0,1,0,0,0,0,0,0,5,0,5,0,0,0,0,0,0,0,0,0
206604,21045,210,45,-2,4,0,4,0,0,0,1,0,1,0,0,0,0,0,0,0,0,0,3,0,3,0,0,0,0,0,0,0,0,0
206923,21045,210,45,-2,1,0,1,0,0,0,0,0,0,0,0,0,0,0,0,0,0,0,1,0,1,0,0,0,0,0,0,0,0,0
206932,21045,210,45,-2,3,1,2,0,0,0,0,0,0,0,0,0,0,0,0,0,0,0,3,1,2,0,0,0,0,0,0,0,0,0
207564,21045,210,45,-2,8,6,2,0,0,0,0,0,0,1,1,0,0,0,0,0,0,0,6,4,2,1,1,0,0,0,0,0,0,0
207661,21045,210,45,-2,8,3,5,1,1,0,2,0,2,0,0,0,0,0,0,0,0,0,4,2,2,0,0,0,1,0,1,0,0,0
207962,21045,210,45,-2,4,4,0,1,1,0,0,0,0,0,0,0,0,0,0,0,0,0,2,2,0,0,0,0,1,1,0,0,0,0
208479,21045,210,45,-2,2,1,1,0,0,0,1,1,0,0,0,0,0,0,0,0,0,0,1,0,1,0,0,0,0,0,0,0,0,0
209551,21045,210,45,-2,14,3,11,0,0,0,1,0,1,1,0,1,0,0,0,0,0,0,7,1,6,1,0,1,2,1,1,2,1,1
210438,21045,210,45,-2,2,1,1,0,0,0,0,0,0,1,1,0,0,0,0,0,0,0,0,0,0,0,0,0,1,0,1,0,0,0
210599,21045,210,45,-2,9,5,4,0,0,0,0,0,0,3,0,3,1,0,1,0,0,0,2,2,0,1,1,0,2,2,0,0,0,0
210605,21045,210,45,-2,10,3,7,0,0,0,1,0,1,2,1,1,0,0,0,0,0,0,6,2,4,0,0,0,1,0,1,0,0,0
212045,21045,210,45,-2,1,1,0,0,0,0,0,0,0,0,0,0,0,0,0,0,0,0,1,1,0,0,0,0,0,0,0,0,0,0
212674,21045,210,45,-2,1,0,1,0,0,0,0,0,0,0,0,0,0,0,0,0,0,0,0,0,0,0,0,0,0,0,0,1,0,1
213534,21045,210,45,-2,1,0,1,0,0,0,0,0,0,0,0,0,0,0,0,0,0,0,1,0,1,0,0,0,0,0,0,0,0,0
213570,21045,210,45,-2,2,0,2,0,0,0,0,0,0,1,0,1,0,0,0,0,0,0,1,0,1,0,0,0,0,0,0,0,0,0
213589,21045,210,45,-2,2,2,0,0,0,0,0,0,0,0,0,0,0,0,0,0,0,0,2,2,0,0,0,0,0,0,0,0,0,0
213668,21045,210,45,-2,1,0,1,0,0,0,0,0,0,0,0,0,0,0,0,0,0,0,1,0,1,0,0,0,0,0,0,0,0,0
213996,21045,210,45,-2,2,0,2,0,0,0,0,0,0,0,0,0,0,0,0,0,0,0,2,0,2,0,0,0,0,0,0,0,0,0
214290,21045,210,45,-2,10,9,1,0,0,0,0,0,0,0,0,0,0,0,0,0,0,0,10,9,1,0,0,0,0,0,0,0,0,0
214582,21045,210,45,-2,2,0,2,0,0,0,0,0,0,0,0,0,0,0,0,0,0,0,2,0,2,0,0,0,0,0,0,0,0,0
214944,21045,210,45,-2,9,8,1,0,0,0,0,0,0,0,0,0,1,1,0,0,0,0,8,7,1,0,0,0,0,0,0,0,0,0
215415,21045,210,45,-2,5,3,2,0,0,0,0,0,0,0,0,0,0,0,0,0,0,0,5,3,2,0,0,0,0,0,0,0,0,0
215682,21045,210,45,-2,6,6,0,0,0,0,0,0,0,0,0,0,0,0,0,0,0,0,6,6,0,0,0,0,0,0,0,0,0,0
215743,21045,210,45,-2,13,1,12,0,0,0,0,0,0,0,0,0,0,0,0,0,0,0,13,1,12,0,0,0,0,0,0,0,0,0
215992,21045,210,45,-2,2,0,2,0,0,0,0,0,0,0,0,0,0,0,0,0,0,0,2,0,2,0,0,0,0,0,0,0,0,0
216339,21045,210,45,-2,93,42,51,0,0,0,17,8,9,5,1,4,1,0,1,0,0,0,50,24,26,0,0,0,16,8,8,4,1,3
216436,21045,210,45,-2,7,7,0,0,0,0,0,0,0,1,1,0,0,0,0,0,0,0,6,6,0,0,0,0,0,0,0,0,0,0
216445,21045,210,45,-2,3,2,1,0,0,0,0,0,0,0,0,0,0,0,0,0,0,0,3,2,1,0,0,0,0,0,0,0,0,0
216454,21045,210,45,-2,2,2,0,0,0,0,0,0,0,0,0,0,0,0,0,0,0,0,2,2,0,0,0,0,0,0,0,0,0,0
217235,21045,210,45,-2,9,2,7,0,0,0,0,0,0,2,1,1,0,0,0,0,0,0,4,1,3,0,0,0,2,0,2,1,0,1
217615,21045,210,45,-2,4,2,2,0,0,0,0,0,0,0,0,0,0,0,0,0,0,0,4,2,2,0,0,0,0,0,0,0,0,0
217712,21045,210,45,-2,2,2,0,0,0,0,0,0,0,0,0,0,0,0,0,0,0,0,2,2,0,0,0,0,0,0,0,0,0,0
217837,21045,210,45,-2,7,0,7,0,0,0,0,0,0,4,0,4,0,0,0,0,0,0,3,0,3,0,0,0,0,0,0,0,0,0
218025,21045,210,45,-2,6,2,4,0,0,0,0,0,0,2,1,1,0,0,0,0,0,0,4,1,3,0,0,0,0,0,0,0,0,0
218113,21045,210,45,-2,29,7,22,0,0,0,1,0,1,5,1,4,0,0,0,0,0,0,23,6,17,0,0,0,0,0,0,0,0,0
218140,21045,210,45,-2,15,4,11,0,0,0,0,0,0,1,0,1,0,0,0,0,0,0,14,4,10,0,0,0,0,0,0,0,0,0
218353,21045,210,45,-2,12,3,9,0,0,0,1,0,1,2,1,1,2,1,1,0,0,0,7,1,6,0,0,0,0,0,0,0,0,0
218487,21045,210,45,-2,8,3,5,0,0,0,0,0,0,2,0,2,0,0,0,0,0,0,6,3,3,0,0,0,0,0,0,0,0,0
218520,21045,210,45,-2,15,6,9,0,0,0,0,0,0,5,2,3,1,0,1,0,0,0,9,4,5,0,0,0,0,0,0,0,0,0
218830,21045,210,45,-2,16,4,12,0,0,0,1,1,0,1,0,1,1,0,1,0,0,0,13,3,10,0,0,0,0,0,0,0,0,0
218858,21045,210,45,-2,7,3,4,0,0,0,0,0,0,2,1,1,0,0,0,0,0,0,5,2,3,0,0,0,0,0,0,0,0,0
218885,21045,210,45,-2,11,5,6,0,0,0,0,0,0,3,1,2,1,0,1,0,0,0,7,4,3,0,0,0,0,0,0,0,0,0
218894,21045,210,45,-2,16,6,10,0,0,0,1,0,1,2,1,1,0,0,0,0,0,0,13,5,8,0,0,0,0,0,0,0,0,0
218955,21045,210,45,-2,6,3,3,0,0,0,0,0,0,2,1,1,0,0,0,0,0,0,4,2,2,0,0,0,0,0,0,0,0,0
218991,21045,210,45,-2,18,9,9,0,0,0,0,0,0,3,1,2,0,0,0,0,0,0,15,8,7,0,0,0,0,0,0,0,0,0
219408,21045,210,45,-2,1,1,0,0,0,0,0,0,0,0,0,0,0,0,0,0,0,0,1,1,0,0,0,0,0,0,0,0,0,0
219426,21045,210,45,-2,15,4,11,0,0,0,0,0,0,0,0,0,0,0,0,0,0,0,15,4,11,0,0,0,0,0,0,0,0,0
219505,21045,210,45,-2,1,0,1,0,0,0,0,0,0,1,0,1,0,0,0,0,0,0,0,0,0,0,0,0,0,0,0,0,0,0
219639,21045,210,45,-2,7,2,5,0,0,0,0,0,0,3,0,3,0,0,0,0,0,0,4,2,2,0,0,0,0,0,0,0,0,0
219903,21045,210,45,-2,14,1,13,0,0,0,0,0,0,8,0,8,0,0,0,0,0,0,5,0,5,0,0,0,1,1,0,0,0,0
220118,21045,210,45,-2,6,0,6,0,0,0,0,0,0,1,0,1,0,0,0,0,0,0,5,0,5,0,0,0,0,0,0,0,0,0
220206,21045,210,45,-2,1,1,0,0,0,0,0,0,0,0,0,0,0,0,0,0,0,0,1,1,0,0,0,0,0,0,0,0,0,0
220552,21045,210,45,-2,56,15,41,1,1,0,4,0,4,7,1,6,2,1,1,0,0,0,40,11,29,2,1,1,0,0,0,0,0,0
220862,21045,210,45,-2,15,2,13,0,0,0,0,0,0,4,0,4,0,0,0,0,0,0,11,2,9,0,0,0,0,0,0,0,0,0
220978,21045,210,45,-2,6,3,3,0,0,0,0,0,0,0,0,0,1,0,1,0,0,0,5,3,2,0,0,0,0,0,0,0,0,0
220996,21045,210,45,-2,2,1,1,0,0,0,0,0,0,0,0,0,0,0,0,0,0,0,2,1,1,0,0,0,0,0,0,0,0,0
221148,21045,210,45,-2,22,22,0,0,0,0,0,0,0,0,0,0,0,0,0,0,0,0,22,22,0,0,0,0,0,0,0,0,0,0
221397,21045,210,45,-2,1,1,0,0,0,0,0,0,0,0,0,0,0,0,0,0,0,0,1,1,0,0,0,0,0,0,0,0,0,0
221670,21045,210,45,-2,4,2,2,0,0,0,1,0,1,0,0,0,0,0,0,0,0,0,3,2,1,0,0,0,0,0,0,0,0,0
221759,21045,210,45,-2,52,19,33,0,0,0,2,1,1,4,1,3,1,0,1,0,0,0,40,15,25,1,0,1,0,0,0,4,2,2
222105,21045,210,45,-2,7,7,0,0,0,0,0,0,0,3,3,0,0,0,0,0,0,0,4,4,0,0,0,0,0,0,0,0,0,0
222831,21045,210,45,-2,8,4,4,0,0,0,0,0,0,1,0,1,0,0,0,0,0,0,6,3,3,0,0,0,1,1,0,0,0,0
222877,21045,210,45,-2,1,1,0,0,0,0,0,0,0,0,0,0,0,0,0,0,0,0,1,1,0,0,0,0,0,0,0,0,0,0
223083,21045,210,45,-2,4,0,4,0,0,0,0,0,0,0,0,0,0,0,0,0,0,0,4,0,4,0,0,0,0,0,0,0,0,0
224660,21045,210,45,-2,16,9,7,0,0,0,0,0,0,0,0,0,9,6,3,0,0,0,5,2,3,1,0,1,1,1,0,0,0,0
224679,21045,210,45,-2,15,14,1,0,0,0,0,0,0,0,0,0,15,14,1,0,0,0,0,0,0,0,0,0,0,0,0,0,0,0
224712,21045,210,45,-2,1,0,1,0,0,0,0,0,0,0,0,0,1,0,1,0,0,0,0,0,0,0,0,0,0,0,0,0,0,0
225201,21045,210,45,-2,10,5,5,0,0,0,1,1,0,2,2,0,4,1,3,0,0,0,3,1,2,0,0,0,0,0,0,0,0,0
226204,21045,210,45,-2,1,0,1,0,0,0,0,0,0,0,0,0,0,0,0,0,0,0,1,0,1,0,0,0,0,0,0,0,0,0
226277,21045,210,45,-2,35,31,4,0,0,0,1,1,0,2,2,0,4,4,0,0,0,0,26,22,4,1,1,0,1,1,0,0,0,0
226903,21045,210,45,-2,40,23,17,0,0,0,0,0,0,1,1,0,25,14,11,0,0,0,10,6,4,1,1,0,3,1,2,0,0,0
228343,21045,210,45,-2,2,0,2,0,0,0,1,0,1,0,0,0,0,0,0,0,0,0,1,0,1,0,0,0,0,0,0,0,0,0
228529,21045,210,45,-2,21,10,11,1,1,0,1,0,1,1,0,1,2,1,1,0,0,0,14,7,7,0,0,0,0,0,0,2,1,1
228705,21045,210,45,-2,3,2,1,0,0,0,0,0,0,0,0,0,0,0,0,0,0,0,1,1,0,0,0,0,0,0,0,2,1,1
229887,21045,210,45,-2,2,0,2,0,0,0,0,0,0,2,0,2,0,0,0,0,0,0,0,0,0,0,0,0,0,0,0,0,0,0
230366,21045,210,45,-2,5,0,5,0,0,0,0,0,0,0,0,0,0,0,0,0,0,0,5,0,5,0,0,0,0,0,0,0,0,0
230418,21045,210,45,-2,1,1,0,0,0,0,0,0,0,0,0,0,0,0,0,0,0,0,1,1,0,0,0,0,0,0,0,0,0,0
231411,21045,210,45,-2,3,2,1,0,0,0,0,0,0,1,0,1,0,0,0,0,0,0,2,2,0,0,0,0,0,0,0,0,0,0
231624,21045,210,45,-2,2,0,2,0,0,0,0,0,0,1,0,1,0,0,0,0,0,0,0,0,0,0,0,0,1,0,1,0,0,0
231785,21045,210,45,-2,8,2,6,0,0,0,0,0,0,4,0,4,0,0,0,0,0,0,2,1,1,1,1,0,1,0,1,0,0,0
233082,21045,210,45,-2,2,0,2,0,0,0,0,0,0,0,0,0,0,0,0,0,0,0,2,0,2,0,0,0,0,0,0,0,0,0
233329,21045,210,45,-2,12,1,11,0,0,0,2,0,2,1,0,1,3,0,3,0,0,0,5,0,5,0,0,0,1,1,0,0,0,0
233408,21045,210,45,-2,2,0,2,0,0,0,0,0,0,0,0,0,0,0,0,0,0,0,2,0,2,0,0,0,0,0,0,0,0,0
234915,21045,210,45,-2,7,4,3,0,0,0,2,2,0,0,0,0,0,0,0,0,0,0,4,1,3,0,0,0,1,1,0,0,0,0
236212,21045,210,45,-2,10,9,1,0,0,0,0,0,0,0,0,0,0,0,0,0,0,0,9,8,1,0,0,0,1,1,0,0,0,0
236939,21045,210,45,-2,7,2,5,1,0,1,1,1,0,0,0,0,0,0,0,0,0,0,1,0,1,0,0,0,3,1,2,1,0,1
239512,21045,210,45,-2,2,0,2,0,0,0,0,0,0,0,0,0,0,0,0,0,0,0,2,0,2,0,0,0,0,0,0,0,0,0
240268,21045,210,45,-2,5,1,4,0,0,0,0,0,0,0,0,0,0,0,0,0,0,0,4,1,3,0,0,0,1,0,1,0,0,0
240277,21045,210,45,-2,7,2,5,1,0,1,1,1,0,0,0,0,0,0,0,0,0,0,5,1,4,0,0,0,0,0,0,0,0,0
240329,21045,210,45,-2,1,0,1,0,0,0,1,0,1,0,0,0,0,0,0,0,0,0,0,0,0,0,0,0,0,0,0,0,0,0
240338,21045,210,45,-2,2,2,0,0,0,0,0,0,0,0,0,0,0,0,0,0,0,0,2,2,0,0,0,0,0,0,0,0,0,0
240365,21045,210,45,-2,5,3,2,0,0,0,0,0,0,0,0,0,0,0,0,0,0,0,3,1,2,0,0,0,1,1,0,1,1,0
240374,21045,210,45,-2,11,7,4,0,0,0,1,1,0,0,0,0,0,0,0,0,0,0,7,5,2,0,0,0,1,1,0,2,0,2
240392,21045,210,45,-2,19,1,18,0,0,0,0,0,0,1,0,1,0,0,0,0,0,0,16,1,15,1,0,1,1,0,1,0,0,0
240426,21045,210,45,-2,7,1,6,0,0,0,1,0,1,0,0,0,0,0,0,0,0,0,6,1,5,0,0,0,0,0,0,0,0,0
240444,21045,210,45,-2,141,63,78,0,0,0,16,8,8,7,1,6,6,0,6,0,0,0,95,46,49,3,1,2,6,1,5,8,6,2
240453,21045,210,45,-2,8,2,6,0,0,0,1,0,1,2,0,2,0,0,0,0,0,0,4,1,3,0,0,0,0,0,0,1,1,0
240471,21045,210,45,-2,1,0,1,0,0,0,0,0,0,0,0,0,0,0,0,0,0,0,1,0,1,0,0,0,0,0,0,0,0,0
240480,21045,210,45,-2,8,2,6,0,0,0,0,0,0,0,0,0,0,0,0,0,0,0,8,2,6,0,0,0,0,0,0,0,0,0
240718,21045,210,45,-2,14,13,1,0,0,0,0,0,0,0,0,0,0,0,0,0,0,0,14,13,1,0,0,0,0,0,0,0,0,0
241836,21045,210,45,-2,5,1,4,0,0,0,0,0,0,0,0,0,5,1,4,0,0,0,0,0,0,0,0,0,0,0,0,0,0,0
243081,21045,210,45,-2,5,2,3,0,0,0,0,0,0,0,0,0,5,2,3,0,0,0,0,0,0,0,0,0,0,0,0,0,0,0
243586,21045,210,45,-2,2,0,2,0,0,0,0,0,0,0,0,0,2,0,2,0,0,0,0,0,0,0,0,0,0,0,0,0,0,0
246813,21045,210,45,-2,35,21,14,2,2,0,2,0,2,8,3,5,0,0,0,0,0,0,23,16,7,0,0,0,0,0,0,0,0,0
246974,21045,210,45,-2,5,1,4,0,0,0,0,0,0,0,0,0,2,0,2,0,0,0,3,1,2,0,0,0,0,0,0,0,0,0
247649,21045,210,45,-2,4,0,4,0,0,0,0,0,0,0,0,0,0,0,0,0,0,0,4,0,4,0,0,0,0,0,0,0,0,0
248934,21045,210,45,-2,68,11,57,0,0,0,1,1,0,18,2,16,2,1,1,0,0,0,42,5,37,2,1,1,3,1,2,0,0,0
250027,21045,210,45,-2,5,1,4,0,0,0,0,0,0,0,0,0,0,0,0,0,0,0,5,1,4,0,0,0,0,0,0,0,0,0
251312,21045,210,45,-2,1,0,1,0,0,0,0,0,0,0,0,0,0,0,0,0,0,0,1,0,1,0,0,0,0,0,0,0,0,0
260691,21045,210,45,-2,4,2,2,0,0,0,0,0,0,0,0,0,0,0,0,0,0,0,4,2,2,0,0,0,0,0,0,0,0,0
260789,21045,210,45,-2,5,0,5,0,0,0,1,0,1,0,0,0,2,0,2,0,0,0,2,0,2,0,0,0,0,0,0,0,0,0
260992,21045,210,45,-2,4,0,4,0,0,0,0,0,0,2,0,2,0,0,0,0,0,0,2,0,2,0,0,0,0,0,0,0,0,0
366270,21045,210,45,-2,3,0,3,0,0,0,0,0,0,2,0,2,0,0,0,0,0,0,1,0,1,0,0,0,0,0,0,0,0,0
366553,21045,210,45,-2,20,5,15,0,0,0,0,0,0,2,0,2,1,1,0,0,0,0,17,4,13,0,0,0,0,0,0,0,0,0
367954,21045,210,45,-2,25,3,22,0,0,0,1,0,1,0,0,0,1,0,1,0,0,0,22,3,19,1,0,1,0,0,0,0,0,0
368629,21045,210,45,-2,2,0,2,0,0,0,0,0,0,0,0,0,1,0,1,0,0,0,1,0,1,0,0,0,0,0,0,0,0,0
368911,21045,210,45,-2,9,3,6,0,0,0,1,1,0,0,0,0,0,0,0,0,0,0,8,2,6,0,0,0,0,0,0,0,0,0
372329,21045,210,45,-2,3,0,3,0,0,0,0,0,0,0,0,0,1,0,1,0,0,0,2,0,2,0,0,0,0,0,0,0,0,0
378105,21045,210,45,-2,5,3,2,0,0,0,0,0,0,0,0,0,3,2,1,0,0,0,2,1,1,0,0,0,0,0,0,0,0,0
379746,21045,210,45,-2,3,1,2,0,0,0,0,0,0,1,0,1,0,0,0,0,0,0,2,1,1,0,0,0,0,0,0,0,0,0
380438,21045,210,45,-2,8,2,6,0,0,0,0,0,0,0,0,0,0,0,0,0,0,0,7,1,6,1,1,0,0,0,0,0,0,0
382957,21045,210,45,-2,6,2,4,0,0,0,0,0,0,1,0,1,0,0,0,0,0,0,3,1,2,0,0,0,2,1,1,0,0,0
385503,21045,210,45,-2,3,0,3,0,0,0,0,0,0,1,0,1,0,0,0,0,0,0,2,0,2,0,0,0,0,0,0,0,0,0
385619,21045,210,45,-2,4,4,0,0,0,0,1,1,0,0,0,0,1,1,0,0,0,0,0,0,0,2,2,0,0,0,0,0,0,0
386472,21045,210,45,-2,3,0,3,0,0,0,0,0,0,1,0,1,0,0,0,0,0,0,1,0,1,0,0,0,1,0,1,0,0,0
392257,21045,210,45,-2,13,1,12,0,0,0,1,0,1,7,0,7,2,1,1,0,0,0,3,0,3,0,0,0,0,0,0,0,0,0
392415,21045,210,45,-2,1,0,1,0,0,0,0,0,0,1,0,1,0,0,0,0,0,0,0,0,0,0,0,0,0,0,0,0,0,0
399869,21045,210,45,-2,1,1,0,0,0,0,0,0,0,0,0,0,0,0,0,0,0,0,1,1,0,0,0,0,0,0,0,0,0,0
404912,21045,210,45,-2,5,1,4,0,0,0,0,0,0,1,1,0,0,0,0,0,0,0,4,0,4,0,0,0,0,0,0,0,0,0
406024,21045,210,45,-2,20,2,18,0,0,0,1,0,1,1,0,1,3,1,2,0,0,0,14,1,13,1,0,1,0,0,0,0,0,0
406033,21045,210,45,-2,20,3,17,0,0,0,3,1,2,0,0,0,7,1,6,0,0,0,9,1,8,0,0,0,1,0,1,0,0,0
408729,21045,210,45,-2,1,0,1,0,0,0,0,0,0,0,0,0,0,0,0,0,0,0,1,0,1,0,0,0,0,0,0,0,0,0
412173,21045,210,45,-2,3,0,3,0,0,0,0,0,0,0,0,0,0,0,0,0,0,0,3,0,3,0,0,0,0,0,0,0,0,0
416458,21045,210,45,-2,1,0,1,0,0,0,1,0,1,0,0,0,0,0,0,0,0,0,0,0,0,0,0,0,0,0,0,0,0,0
422020,21045,210,45,-2,2,2,0,0,0,0,0,0,0,0,0,0,1,1,0,0,0,0,0,0,0,0,0,0,1,1,0,0,0,0
423652,21045,210,45,-2,4,1,3,0,0,0,0,0,0,0,0,0,0,0,0,0,0,0,4,1,3,0,0,0,0,0,0,0,0,0
428170,21045,210,45,-2,8,0,8,0,0,0,1,0,1,2,0,2,3,0,3,0,0,0,2,0,2,0,0,0,0,0,0,0,0,0
431141,21045,210,45,-2,21,4,17,0,0,0,1,0,1,1,0,1,6,1,5,1,0,1,11,3,8,0,0,0,1,0,1,0,0,0
433013,21045,210,45,-2,8,2,6,0,0,0,0,0,0,0,0,0,4,1,3,0,0,0,4,1,3,0,0,0,0,0,0,0,0,0
433174,21045,210,45,-2,8,1,7,0,0,0,1,1,0,1,0,1,0,0,0,0,0,0,6,0,6,0,0,0,0,0,0,0,0,0
433387,21045,210,45,-2,224,88,136,1,1,0,8,3,5,50,25,25,17,3,14,0,0,0,131,48,83,5,3,2,12,5,7,0,0,0
433420,21045,210,45,-2,9,9,0,0,0,0,0,0,0,0,0,0,2,2,0,0,0,0,7,7,0,0,0,0,0,0,0,0,0,0
433536,21045,210,45,-2,3,0,3,0,0,0,0,0,0,1,0,1,0,0,0,0,0,0,2,0,2,0,0,0,0,0,0,0,0,0
434140,21045,210,45,-2,4,1,3,0,0,0,0,0,0,0,0,0,0,0,0,0,0,0,4,1,3,0,0,0,0,0,0,0,0,0
436429,21045,210,45,-2,9,0,9,0,0,0,0,0,0,1,0,1,2,0,2,0,0,0,5,0,5,0,0,0,1,0,1,0,0,0
437635,21045,210,45,-2,18,6,12,0,0,0,0,0,0,3,0,3,7,3,4,0,0,0,7,2,5,1,1,0,0,0,0,0,0,0
437936,21045,210,45,-2,4,3,1,0,0,0,1,1,0,0,0,0,1,1,0,0,0,0,2,1,1,0,0,0,0,0,0,0,0,0
438258,21045,210,45,-2,5,0,5,0,0,0,0,0,0,0,0,0,0,0,0,1,0,1,3,0,3,1,0,1,0,0,0,0,0,0
439118,21045,210,45,-2,2,0,2,0,0,0,0,0,0,0,0,0,0,0,0,0,0,0,1,0,1,0,0,0,1,0,1,0,0,0
439367,21045,210,45,-2,5,1,4,0,0,0,0,0,0,0,0,0,2,0,2,0,0,0,3,1,2,0,0,0,0,0,0,0,0,0
439570,21045,210,45,-2,8,1,7,0,0,0,0,0,0,2,0,2,0,0,0,0,0,0,6,1,5,0,0,0,0,0,0,0,0,0
439738,21045,210,45,-2,1,0,1,0,0,0,0,0,0,1,0,1,0,0,0,0,0,0,0,0,0,0,0,0,0,0,0,0,0,0
439792,21045,210,45,-2,4,0,4,0,0,0,0,0,0,2,0,2,0,0,0,0,0,0,2,0,2,0,0,0,0,0,0,0,0,0
441025,21045,210,45,-2,3,3,0,0,0,0,0,0,0,0,0,0,0,0,0,0,0,0,3,3,0,0,0,0,0,0,0,0,0,0
441371,21045,210,45,-2,50,9,41,0,0,0,1,0,1,20,2,18,3,2,1,0,0,0,23,5,18,1,0,1,2,0,2,0,0,0
441423,21045,210,45,-2,3,2,1,0,0,0,0,0,0,0,0,0,3,2,1,0,0,0,0,0,0,0,0,0,0,0,0,0,0,0
441636,21045,210,45,-2,4,1,3,0,0,0,0,0,0,1,0,1,0,0,0,0,0,0,3,1,2,0,0,0,0,0,0,0,0,0
441742,21045,210,45,-2,2,1,1,0,0,0,1,1,0,1,0,1,0,0,0,0,0,0,0,0,0,0,0,0,0,0,0,0,0,0
442134,21045,210,45,-2,2,0,2,0,0,0,0,0,0,0,0,0,1,0,1,0,0,0,1,0,1,0,0,0,0,0,0,0,0,0
442426,21045,210,45,-2,2,1,1,0,0,0,0,0,0,0,0,0,0,0,0,0,0,0,2,1,1,0,0,0,0,0,0,0,0,0
442444,21045,210,45,-2,4,2,2,0,0,0,0,0,0,0,0,0,0,0,0,0,0,0,3,2,1,0,0,0,1,0,1,0,0,0
442602,21045,210,45,-2,5,0,5,0,0,0,0,0,0,0,0,0,1,0,1,0,0,0,3,0,3,1,0,1,0,0,0,0,0,0
442930,21045,210,45,-2,1,0,1,0,0,0,0,0,0,0,0,0,0,0,0,0,0,0,1,0,1,0,0,0,0,0,0,0,0,0
443261,21045,210,45,-2,5,1,4,0,0,0,0,0,0,3,1,2,0,0,0,0,0,0,2,0,2,0,0,0,0,0,0,0,0,0
443377,21045,210,45,-2,3,3,0,0,0,0,0,0,0,0,0,0,0,0,0,0,0,0,3,3,0,0,0,0,0,0,0,0,0,0
443410,21045,210,45,-2,3,1,2,0,0,0,0,0,0,0,0,0,0,0,0,0,0,0,3,1,2,0,0,0,0,0,0,0,0,0
443599,21045,210,45,-2,1,1,0,0,0,0,0,0,0,0,0,0,0,0,0,0,0,0,1,1,0,0,0,0,0,0,0,0,0,0
443650,21045,210,45,-2,3,1,2,0,0,0,0,0,0,0,0,0,0,0,0,0,0,0,3,1,2,0,0,0,0,0,0,0,0,0
443748,21045,210,45,-2,1,0,1,0,0,0,0,0,0,1,0,1,0,0,0,0,0,0,0,0,0,0,0,0,0,0,0,0,0,0
444088,21045,210,45,-2,4,0,4,1,0,1,0,0,0,0,0,0,1,0,1,1,0,1,1,0,1,0,0,0,0,0,0,0,0,0
444130,21045,210,45,-2,6,3,3,0,0,0,0,0,0,2,1,1,0,0,0,0,0,0,4,2,2,0,0,0,0,0,0,0,0,0
444556,21045,210,45,-2,5,3,2,0,0,0,0,0,0,0,0,0,0,0,0,1,0,1,1,0,1,1,1,0,2,2,0,0,0,0
444787,21045,210,45,-2,65,7,58,0,0,0,1,0,1,10,0,10,0,0,0,0,0,0,47,5,42,0,0,0,7,2,5,0,0,0
444811,21045,210,45,-2,3,1,2,0,0,0,0,0,0,2,1,1,0,0,0,0,0,0,1,0,1,0,0,0,0,0,0,0,0,0
444866,21045,210,45,-2,3,0,3,0,0,0,0,0,0,1,0,1,0,0,0,0,0,0,1,0,1,1,0,1,0,0,0,0,0,0
445230,21045,210,45,-2,4,2,2,0,0,0,0,0,0,1,0,1,1,1,0,0,0,0,2,1,1,0,0,0,0,0,0,0,0,0
445692,21045,210,45,-2,2,2,0,0,0,0,0,0,0,0,0,0,0,0,0,0,0,0,2,2,0,0,0,0,0,0,0,0,0,0
445744,21045,210,45,-2,1,0,1,0,0,0,0,0,0,0,0,0,0,0,0,0,0,0,1,0,1,0,0,0,0,0,0,0,0,0
445948,21045,210,45,-2,30,11,19,0,0,0,1,0,1,6,2,4,9,1,8,1,1,0,10,4,6,2,2,0,1,1,0,0,0,0
446118,21045,210,45,-2,14,3,11,0,0,0,3,1,2,3,0,3,4,1,3,0,0,0,4,1,3,0,0,0,0,0,0,0,0,0
446127,21045,210,45,-2,1,0,1,0,0,0,0,0,0,0,0,0,0,0,0,0,0,0,1,0,1,0,0,0,0,0,0,0,0,0
446385,21045,210,45,-2,1,0,1,0,0,0,1,0,1,0,0,0,0,0,0,0,0,0,0,0,0,0,0,0,0,0,0,0,0,0
446552,21045,210,45,-2,18,10,8,0,0,0,0,0,0,1,1,0,4,3,1,0,0,0,12,5,7,1,1,0,0,0,0,0,0,0
446561,21045,210,45,-2,8,4,4,0,0,0,1,0,1,1,1,0,1,1,0,0,0,0,5,2,3,0,0,0,0,0,0,0,0,0
446604,21045,210,45,-2,12,12,0,0,0,0,0,0,0,0,0,0,0,0,0,0,0,0,12,12,0,0,0,0,0,0,0,0,0,0
446640,21045,210,45,-2,6,6,0,0,0,0,1,1,0,0,0,0,0,0,0,0,0,0,3,3,0,0,0,0,2,2,0,0,0,0
447014,21045,210,45,-2,1,0,1,0,0,0,0,0,0,0,0,0,0,0,0,0,0,0,1,0,1,0,0,0,0,0,0,0,0,0
447263,21045,210,45,-2,43,5,38,0,0,0,1,0,1,2,1,1,0,0,0,0,0,0,27,2,25,0,0,0,13,2,11,0,0,0
447351,21045,210,45,-2,4,1,3,0,0,0,0,0,0,0,0,0,1,0,1,0,0,0,3,1,2,0,0,0,0,0,0,0,0,0
447591,21045,210,45,-2,7,1,6,0,0,0,0,0,0,5,0,5,0,0,0,0,0,0,1,0,1,1,1,0,0,0,0,0,0,0
448354,21045,210,45,-2,2,1,1,0,0,0,0,0,0,0,0,0,0,0,0,0,0,0,2,1,1,0,0,0,0,0,0,0,0,0
448600,21045,210,45,-2,7,1,6,0,0,0,0,0,0,0,0,0,0,0,0,0,0,0,7,1,6,0,0,0,0,0,0,0,0,0
448673,21045,210,45,-2,15,3,12,0,0,0,1,1,0,0,0,0,1,0,1,0,0,0,12,2,10,0,0,0,1,0,1,0,0,0
448859,21045,210,45,-2,2,2,0,0,0,0,0,0,0,0,0,0,0,0,0,0,0,0,2,2,0,0,0,0,0,0,0,0,0,0
449074,21045,210,45,-2,4,1,3,0,0,0,0,0,0,0,0,0,1,0,1,0,0,0,2,1,1,1,0,1,0,0,0,0,0,0
449250,21045,210,45,-2,8,1,7,0,0,0,0,0,0,1,0,1,2,0,2,1,0,1,4,1,3,0,0,0,0,0,0,0,0,0
449339,21045,210,45,-2,3,1,2,0,0,0,0,0,0,0,0,0,1,0,1,0,0,0,1,0,1,0,0,0,1,1,0,0,0,0
449524,21045,210,45,-2,3,0,3,0,0,0,0,0,0,0,0,0,0,0,0,0,0,0,3,0,3,0,0,0,0,0,0,0,0,0
449728,21045,210,45,-2,2,0,2,0,0,0,0,0,0,0,0,0,0,0,0,0,0,0,2,0,2,0,0,0,0,0,0,0,0,0
449764,21045,210,45,-2,1,1,0,0,0,0,0,0,0,0,0,0,0,0,0,0,0,0,1,1,0,0,0,0,0,0,0,0,0,0
449889,21045,210,45,-2,4,0,4,0,0,0,0,0,0,1,0,1,0,0,0,0,0,0,3,0,3,0,0,0,0,0,0,0,0,0
449898,21045,210,45,-2,4,1,3,0,0,0,0,0,0,1,0,1,0,0,0,0,0,0,3,1,2,0,0,0,0,0,0,0,0,0
450058,21045,210,45,-2,15,2,13,0,0,0,1,0,1,2,0,2,0,0,0,0,0,0,11,2,9,1,0,1,0,0,0,0,0,0
450067,21045,210,45,-2,4,0,4,0,0,0,0,0,0,0,0,0,0,0,0,0,0,0,4,0,4,0,0,0,0,0,0,0,0,0
450571,21045,210,45,-2,1,0,1,0,0,0,0,0,0,0,0,0,0,0,0,0,0,0,1,0,1,0,0,0,0,0,0,0,0,0
450696,21045,210,45,-2,5,1,4,0,0,0,0,0,0,1,1,0,1,0,1,0,0,0,3,0,3,0,0,0,0,0,0,0,0,0
450702,21045,210,45,-2,2,0,2,0,0,0,0,0,0,0,0,0,0,0,0,0,0,0,2,0,2,0,0,0,0,0,0,0,0,0
450933,21045,210,45,-2,4,0,4,0,0,0,0,0,0,1,0,1,0,0,0,0,0,0,3,0,3,0,0,0,0,0,0,0,0,0
451103,21045,210,45,-2,3,0,3,0,0,0,0,0,0,0,0,0,3,0,3,0,0,0,0,0,0,0,0,0,0,0,0,0,0,0
451750,21045,210,45,-2,8,0,8,0,0,0,1,0,1,1,0,1,0,0,0,0,0,0,6,0,6,0,0,0,0,0,0,0,0,0
452124,21045,210,45,-2,5,0,5,0,0,0,0,0,0,1,0,1,0,0,0,0,0,0,4,0,4,0,0,0,0,0,0,0,0,0
452373,21045,210,45,-2,1,0,1,0,0,0,0,0,0,1,0,1,0,0,0,0,0,0,0,0,0,0,0,0,0,0,0,0,0,0
452948,21045,210,45,-2,6,0,6,0,0,0,0,0,0,1,0,1,0,0,0,0,0,0,5,0,5,0,0,0,0,0,0,0,0,0
454218,21045,210,45,-2,75,11,64,0,0,0,4,2,2,18,3,15,4,1,3,0,0,0,41,4,37,3,0,3,5,1,4,0,0,0
454786,21045,210,45,-2,3,1,2,0,0,0,0,0,0,1,0,1,0,0,0,0,0,0,2,1,1,0,0,0,0,0,0,0,0,0
454810,21045,210,45,-2,64,32,32,1,0,1,3,0,3,5,1,4,2,2,0,0,0,0,46,26,20,5,2,3,2,1,1,0,0,0
454829,21045,210,45,-2,13,0,13,0,0,0,1,0,1,0,0,0,0,0,0,0,0,0,11,0,11,0,0,0,1,0,1,0,0,0
454856,21045,210,45,-2,2,0,2,0,0,0,0,0,0,0,0,0,0,0,0,0,0,0,2,0,2,0,0,0,0,0,0,0,0,0
455196,21045,210,45,-2,15,1,14,0,0,0,0,0,0,5,1,4,2,0,2,0,0,0,8,0,8,0,0,0,0,0,0,0,0,0
455479,21045,210,45,-2,3,1,2,0,0,0,0,0,0,0,0,0,0,0,0,0,0,0,3,1,2,0,0,0,0,0,0,0,0,0
455628,21045,210,45,-2,6,3,3,0,0,0,0,0,0,5,2,3,0,0,0,0,0,0,1,1,0,0,0,0,0,0,0,0,0,0
456038,21045,210,45,-2,2,0,2,0,0,0,0,0,0,0,0,0,1,0,1,0,0,0,1,0,1,0,0,0,0,0,0,0,0,0
456205,21045,210,45,-2,5,2,3,0,0,0,0,0,0,1,0,1,0,0,0,0,0,0,4,2,2,0,0,0,0,0,0,0,0,0
456214,21045,210,45,-2,4,3,1,0,0,0,0,0,0,0,0,0,1,1,0,0,0,0,3,2,1,0,0,0,0,0,0,0,0,0
456454,21045,210,45,-2,5,3,2,0,0,0,0,0,0,0,0,0,0,0,0,0,0,0,5,3,2,0,0,0,0,0,0,0,0,0
456579,21045,210,45,-2,2,1,1,0,0,0,0,0,0,0,0,0,0,0,0,0,0,0,2,1,1,0,0,0,0,0,0,0,0,0
456852,21045,210,45,-2,1,1,0,0,0,0,0,0,0,1,1,0,0,0,0,0,0,0,0,0,0,0,0,0,0,0,0,0,0,0
457101,21045,210,45,-2,8,2,6,0,0,0,1,1,0,1,0,1,1,1,0,0,0,0,4,0,4,0,0,0,1,0,1,0,0,0
457110,21045,210,45,-2,1,0,1,0,0,0,0,0,0,0,0,0,0,0,0,0,0,0,1,0,1,0,0,0,0,0,0,0,0,0
458210,21045,210,45,-2,5,2,3,0,0,0,2,0,2,0,0,0,1,1,0,0,0,0,2,1,1,0,0,0,0,0,0,0,0,0
458229,21045,210,45,-2,3,0,3,0,0,0,0,0,0,0,0,0,1,0,1,0,0,0,2,0,2,0,0,0,0,0,0,0,0,0
458405,21045,210,45,-2,3,2,1,0,0,0,0,0,0,2,2,0,0,0,0,0,0,0,0,0,0,1,0,1,0,0,0,0,0,0
458441,21045,210,45,-2,1,0,1,0,0,0,0,0,0,1,0,1,0,0,0,0,0,0,0,0,0,0,0,0,0,0,0,0,0,0
458681,21045,210,45,-2,5,2,3,0,0,0,0,0,0,1,1,0,0,0,0,0,0,0,4,1,3,0,0,0,0,0,0,0,0,0
459204,21045,210,45,-2,22,1,21,0,0,0,8,0,8,3,0,3,0,0,0,0,0,0,10,1,9,1,0,1,0,0,0,0,0,0
459213,21045,210,45,-2,14,2,12,0,0,0,3,0,3,0,0,0,1,0,1,1,0,1,6,1,5,0,0,0,3,1,2,0,0,0
459259,21045,210,45,-2,4,0,4,0,0,0,2,0,2,1,0,1,0,0,0,0,0,0,1,0,1,0,0,0,0,0,0,0,0,0
459268,21045,210,45,-2,2,0,2,0,0,0,0,0,0,1,0,1,0,0,0,0,0,0,1,0,1,0,0,0,0,0,0,0,0,0
459727,21045,210,45,-2,3,1,2,0,0,0,0,0,0,1,0,1,0,0,0,0,0,0,2,1,1,0,0,0,0,0,0,0,0,0
459842,21045,210,45,-2,4,1,3,0,0,0,0,0,0,1,0,1,0,0,0,0,0,0,3,1,2,0,0,0,0,0,0,0,0,0
459851,21045,210,45,-2,6,2,4,0,0,0,0,0,0,0,0,0,0,0,0,0,0,0,6,2,4,0,0,0,0,0,0,0,0,0
460020,21045,210,45,-2,1,0,1,0,0,0,0,0,0,1,0,1,0,0,0,0,0,0,0,0,0,0,0,0,0,0,0,0,0,0
460136,21045,210,45,-2,8,0,8,0,0,0,0,0,0,3,0,3,2,0,2,0,0,0,2,0,2,1,0,1,0,0,0,0,0,0
460181,21045,210,45,-2,1,0,1,0,0,0,0,0,0,0,0,0,0,0,0,0,0,0,1,0,1,0,0,0,0,0,0,0,0,0
460206,21045,210,45,-2,4,2,2,0,0,0,0,0,0,0,0,0,2,2,0,0,0,0,2,0,2,0,0,0,0,0,0,0,0,0
460756,21045,210,45,-2,1,0,1,0,0,0,1,0,1,0,0,0,0,0,0,0,0,0,0,0,0,0,0,0,0,0,0,0,0,0
460826,21045,210,45,-2,6,1,5,0,0,0,0,0,0,5,1,4,1,0,1,0,0,0,0,0,0,0,0,0,0,0,0,0,0,0
460835,21045,210,45,-2,3,1,2,0,0,0,0,0,0,0,0,0,0,0,0,0,0,0,3,1,2,0,0,0,0,0,0,0,0,0
461218,21045,210,45,-2,1,0,1,0,0,0,0,0,0,0,0,0,0,0,0,0,0,0,1,0,1,0,0,0,0,0,0,0,0,0
461689,21045,210,45,-2,5,3,2,0,0,0,0,0,0,0,0,0,1,1,0,0,0,0,4,2,2,0,0,0,0,0,0,0,0,0
475033,21045,210,45,-2,8,2,6,0,0,0,1,0,1,1,0,1,3,2,1,0,0,0,3,0,3,0,0,0,0,0,0,0,0,0
475121,21045,210,45,-2,16,1,15,1,0,1,0,0,0,2,0,2,0,0,0,0,0,0,13,1,12,0,0,0,0,0,0,0,0,0
475176,21045,210,45,-2,2,1,1,0,0,0,0,0,0,0,0,0,0,0,0,0,0,0,0,0,0,2,1,1,0,0,0,0,0,0
475398,21045,210,45,-2,1,0,1,0,0,0,0,0,0,0,0,0,0,0,0,0,0,0,1,0,1,0,0,0,0,0,0,0,0,0
475495,21045,210,45,-2,11,5,6,0,0,0,0,0,0,0,0,0,1,1,0,0,0,0,10,4,6,0,0,0,0,0,0,0,0,0
475714,21045,210,45,-2,1,0,1,0,0,0,0,0,0,0,0,0,1,0,1,0,0,0,0,0,0,0,0,0,0,0,0,0,0,0
476726,21045,210,45,-2,11,3,8,0,0,0,0,0,0,0,0,0,10,3,7,1,0,1,0,0,0,0,0,0,0,0,0,0,0,0
476975,21045,210,45,-2,2,1,1,0,0,0,0,0,0,0,0,0,0,0,0,0,0,0,2,1,1,0,0,0,0,0,0,0,0,0
477039,21045,210,45,-2,12,0,12,0,0,0,1,0,1,5,0,5,2,0,2,0,0,0,4,0,4,0,0,0,0,0,0,0,0,0
480073,21045,210,45,-2,3,1,2,0,0,0,1,1,0,0,0,0,0,0,0,0,0,0,2,0,2,0,0,0,0,0,0,0,0,0
480657,21045,210,45,-2,1,0,1,0,0,0,0,0,0,0,0,0,0,0,0,0,0,0,1,0,1,0,0,0,0,0,0,0,0,0
480824,21045,210,45,-2,4,0,4,0,0,0,0,0,0,1,0,1,1,0,1,0,0,0,2,0,2,0,0,0,0,0,0,0,0,0
480833,21045,210,45,-2,5,1,4,0,0,0,0,0,0,2,0,2,1,1,0,0,0,0,2,0,2,0,0,0,0,0,0,0,0,0
480967,21045,210,45,-2,2,1,1,2,1,1,0,0,0,0,0,0,0,0,0,0,0,0,0,0,0,0,0,0,0,0,0,0,0,0
481535,21045,210,45,-2,2,2,0,0,0,0,1,1,0,0,0,0,0,0,0,0,0,0,0,0,0,0,0,0,0,0,0,1,1,0
481775,21045,210,45,-2,1,1,0,0,0,0,0,0,0,0,0,0,1,1,0,0,0,0,0,0,0,0,0,0,0,0,0,0,0,0
482477,21045,210,45,-2,1,1,0,0,0,0,0,0,0,0,0,0,0,0,0,0,0,0,1,1,0,0,0,0,0,0,0,0,0,0
482635,21045,210,45,-2,1,1,0,0,0,0,0,0,0,0,0,0,0,0,0,0,0,0,1,1,0,0,0,0,0,0,0,0,0,0
482936,21045,210,45,-2,1,1,0,0,0,0,0,0,0,0,0,0,0,0,0,0,0,0,1,1,0,0,0,0,0,0,0,0,0,0
483045,21045,210,45,-2,25,13,12,0,0,0,0,0,0,4,1,3,0,0,0,1,1,0,20,11,9,0,0,0,0,0,0,0,0,0
484002,21045,210,45,-2,17,5,12,1,1,0,3,0,3,2,0,2,4,2,2,0,0,0,7,2,5,0,0,0,0,0,0,0,0,0
484066,21045,210,45,-2,6,0,6,0,0,0,0,0,0,0,0,0,0,0,0,0,0,0,6,0,6,0,0,0,0,0,0,0,0,0
484613,21045,210,45,-2,7,2,5,0,0,0,1,0,1,2,1,1,0,0,0,0,0,0,3,1,2,0,0,0,1,0,1,0,0,0
484844,21045,210,45,-2,1,0,1,0,0,0,1,0,1,0,0,0,0,0,0,0,0,0,0,0,0,0,0,0,0,0,0,0,0,0
485272,21045,210,45,-2,2,0,2,0,0,0,0,0,0,0,0,0,1,0,1,0,0,0,1,0,1,0,0,0,0,0,0,0,0,0
485458,21045,210,45,-2,18,9,9,0,0,0,1,0,1,1,1,0,0,0,0,0,0,0,16,8,8,0,0,0,0,0,0,0,0,0
486053,21045,210,45,-2,2,2,0,0,0,0,0,0,0,0,0,0,0,0,0,0,0,0,2,2,0,0,0,0,0,0,0,0,0,0
486813,21045,210,45,-2,4,2,2,0,0,0,0,0,0,0,0,0,2,1,1,0,0,0,2,1,1,0,0,0,0,0,0,0,0,0
486822,21045,210,45,-2,14,3,11,0,0,0,0,0,0,0,0,0,4,1,3,0,0,0,10,2,8,0,0,0,0,0,0,0,0,0
487162,21045,210,45,-2,16,9,7,0,0,0,0,0,0,4,3,1,0,0,0,0,0,0,12,6,6,0,0,0,0,0,0,0,0,0
487302,21045,210,45,-2,2,0,2,0,0,0,0,0,0,0,0,0,0,0,0,0,0,0,2,0,2,0,0,0,0,0,0,0,0,0
487588,21045,210,45,-2,2,0,2,0,0,0,0,0,0,2,0,2,0,0,0,0,0,0,0,0,0,0,0,0,0,0,0,0,0,0
487861,21045,210,45,-2,3,1,2,0,0,0,0,0,0,0,0,0,0,0,0,0,0,0,3,1,2,0,0,0,0,0,0,0,0,0
487977,21045,210,45,-2,4,0,4,0,0,0,0,0,0,1,0,1,0,0,0,0,0,0,3,0,3,0,0,0,0,0,0,0,0,0
488077,21045,210,45,-2,1,0,1,0,0,0,1,0,1,0,0,0,0,0,0,0,0,0,0,0,0,0,0,0,0,0,0,0,0,0
488305,21045,210,45,-2,1,1,0,0,0,0,0,0,0,0,0,0,0,0,0,0,0,0,1,1,0,0,0,0,0,0,0,0,0,0
489283,21045,210,45,-2,9,4,5,0,0,0,0,0,0,0,0,0,7,3,4,0,0,0,2,1,1,0,0,0,0,0,0,0,0,0
489779,21045,210,45,-2,6,3,3,0,0,0,0,0,0,2,1,1,0,0,0,0,0,0,3,1,2,0,0,0,1,1,0,0,0,0
489858,21045,210,45,-2,5,2,3,0,0,0,3,1,2,0,0,0,0,0,0,0,0,0,2,1,1,0,0,0,0,0,0,0,0,0
490106,21045,210,45,-2,1,0,1,0,0,0,1,0,1,0,0,0,0,0,0,0,0,0,0,0,0,0,0,0,0,0,0,0,0,0
490133,21045,210,45,-2,2,2,0,0,0,0,0,0,0,0,0,0,0,0,0,0,0,0,0,0,0,0,0,0,2,2,0,0,0,0
490373,21045,210,45,-2,11,2,9,0,0,0,1,1,0,1,0,1,0,0,0,0,0,0,7,1,6,1,0,1,1,0,1,0,0,0
490805,21045,210,45,-2,3,1,2,0,0,0,0,0,0,0,0,0,0,0,0,0,0,0,2,1,1,0,0,0,0,0,0,1,0,1
490878,21045,210,45,-2,2,0,2,0,0,0,0,0,0,0,0,0,1,0,1,0,0,0,1,0,1,0,0,0,0,0,0,0,0,0
490975,21045,210,45,-2,2,1,1,0,0,0,1,1,0,0,0,0,1,0,1,0,0,0,0,0,0,0,0,0,0,0,0,0,0,0
491181,21045,210,45,-2,3,0,3,0,0,0,0,0,0,0,0,0,0,0,0,0,0,0,3,0,3,0,0,0,0,0,0,0,0,0
492449,21045,210,45,-2,3,1,2,0,0,0,0,0,0,0,0,0,3,1,2,0,0,0,0,0,0,0,0,0,0,0,0,0,0,0
492722,21045,210,45,-2,6,0,6,0,0,0,0,0,0,1,0,1,3,0,3,0,0,0,1,0,1,1,0,1,0,0,0,0,0,0
493080,21045,210,45,-2,1,1,0,0,0,0,0,0,0,0,0,0,0,0,0,0,0,0,0,0,0,1,1,0,0,0,0,0,0,0
494010,21045,210,45,-2,1,0,1,0,0,0,0,0,0,0,0,0,0,0,0,0,0,0,1,0,1,0,0,0,0,0,0,0,0,0
494436,21045,210,45,-2,4,0,4,0,0,0,0,0,0,0,0,0,0,0,0,0,0,0,4,0,4,0,0,0,0,0,0,0,0,0
494588,21045,210,45,-2,2,1,1,0,0,0,0,0,0,0,0,0,0,0,0,0,0,0,1,1,0,1,0,1,0,0,0,0,0,0
494603,21045,210,45,-2,3,3,0,0,0,0,0,0,0,0,0,0,0,0,0,0,0,0,3,3,0,0,0,0,0,0,0,0,0,0
494843,21045,210,45,-2,4,0,4,0,0,0,1,0,1,3,0,3,0,0,0,0,0,0,0,0,0,0,0,0,0,0,0,0,0,0
494852,21045,210,45,-2,10,4,6,0,0,0,0,0,0,1,0,1,0,0,0,0,0,0,9,4,5,0,0,0,0,0,0,0,0,0
494959,21045,210,45,-2,1,1,0,0,0,0,0,0,0,1,1,0,0,0,0,0,0,0,0,0,0,0,0,0,0,0,0,0,0,0
495767,21045,210,45,-2,67,40,27,0,0,0,21,11,10,1,1,0,4,4,0,0,0,0,35,20,15,4,3,1,2,1,1,0,0,0
496991,21045,210,45,-2,7,0,7,0,0,0,0,0,0,6,0,6,0,0,0,0,0,0,0,0,0,1,0,1,0,0,0,0,0,0
100760,21050,210,50,-2,2,2,0,0,0,0,0,0,0,1,1,0,0,0,0,0,0,0,1,1,0,0,0,0,0,0,0,0,0,0
100830,21050,210,50,-2,3,2,1,0,0,0,0,0,0,0,0,0,0,0,0,0,0,0,3,2,1,0,0,0,0,0,0,0,0,0
102270,21050,210,50,-2,1,1,0,0,0,0,0,0,0,1,1,0,0,0,0,0,0,0,0,0,0,0,0,0,0,0,0,0,0,0
104179,21050,210,50,-2,2,1,1,0,0,0,1,1,0,0,0,0,0,0,0,0,0,0,1,0,1,0,0,0,0,0,0,0,0,0
105145,21050,210,50,-2,4,1,3,0,0,0,0,0,0,0,0,0,0,0,0,0,0,0,4,1,3,0,0,0,0,0,0,0,0,0
105215,21050,210,50,-2,1,1,0,0,0,0,0,0,0,0,0,0,0,0,0,0,0,0,1,1,0,0,0,0,0,0,0,0,0,0
105668,21050,210,50,-2,3,0,3,0,0,0,0,0,0,0,0,0,0,0,0,0,0,0,3,0,3,0,0,0,0,0,0,0,0,0
106041,21050,210,50,-2,9,9,0,0,0,0,1,1,0,0,0,0,4,4,0,0,0,0,4,4,0,0,0,0,0,0,0,0,0,0
107974,21050,210,50,-2,1,1,0,0,0,0,0,0,0,1,1,0,0,0,0,0,0,0,0,0,0,0,0,0,0,0,0,0,0,0
109040,21050,210,50,-2,15,5,10,0,0,0,2,1,1,2,1,1,6,0,6,0,0,0,5,3,2,0,0,0,0,0,0,0,0,0
110644,21050,210,50,-2,1,0,1,0,0,0,0,0,0,0,0,0,1,0,1,0,0,0,0,0,0,0,0,0,0,0,0,0,0,0
110662,21050,210,50,-2,12,9,3,0,0,0,6,4,2,0,0,0,1,1,0,0,0,0,4,3,1,0,0,0,0,0,0,1,1,0
110680,21050,210,50,-2,13,7,6,0,0,0,1,1,0,0,0,0,2,2,0,0,0,0,7,4,3,1,0,1,0,0,0,2,0,2
110714,21050,210,50,-2,2,0,2,0,0,0,0,0,0,0,0,0,0,0,0,0,0,0,1,0,1,0,0,0,0,0,0,1,0,1
111461,21050,210,50,-2,3,1,2,0,0,0,0,0,0,0,0,0,0,0,0,0,0,0,3,1,2,0,0,0,0,0,0,0,0,0
115010,21050,210,50,-2,12,2,10,0,0,0,4,1,3,1,1,0,4,0,4,0,0,0,2,0,2,1,0,1,0,0,0,0,0,0
120078,21050,210,50,-2,16,3,13,0,0,0,2,1,1,2,0,2,8,0,8,0,0,0,2,2,0,1,0,1,1,0,1,0,0,0
121345,21050,210,50,-2,13,4,9,0,0,0,2,1,1,1,0,1,3,1,2,0,0,0,5,2,3,0,0,0,2,0,2,0,0,0
123095,21050,210,50,-2,42,15,27,0,0,0,4,1,3,8,2,6,4,3,1,0,0,0,20,7,13,2,2,0,4,0,4,0,0,0
124557,21050,210,50,-2,24,18,6,0,0,0,2,1,1,0,0,0,1,0,1,0,0,0,17,14,3,0,0,0,1,1,0,3,2,1
126605,21050,210,50,-2,8,8,0,0,0,0,0,0,0,0,0,0,1,1,0,0,0,0,6,6,0,0,0,0,1,1,0,0,0,0
126784,21050,210,50,-2,2,2,0,0,0,0,0,0,0,0,0,0,0,0,0,0,0,0,2,2,0,0,0,0,0,0,0,0,0,0
126818,21050,210,50,-2,8,5,3,0,0,0,1,0,1,0,0,0,0,0,0,0,0,0,4,2,2,0,0,0,2,2,0,1,1,0
126827,21050,210,50,-2,3,1,2,0,0,0,0,0,0,0,0,0,0,0,0,0,0,0,3,1,2,0,0,0,0,0,0,0,0,0
130217,21050,210,50,-2,1,1,0,0,0,0,0,0,0,0,0,0,0,0,0,0,0,0,1,1,0,0,0,0,0,0,0,0,0,0
131405,21050,210,50,-2,2,1,1,0,0,0,0,0,0,0,0,0,0,0,0,0,0,0,2,1,1,0,0,0,0,0,0,0,0,0
131450,21050,210,50,-2,2,1,1,0,0,0,1,1,0,0,0,0,0,0,0,0,0,0,0,0,0,1,0,1,0,0,0,0,0,0
133650,21050,210,50,-2,5,2,3,0,0,0,0,0,0,5,2,3,0,0,0,0,0,0,0,0,0,0,0,0,0,0,0,0,0,0
133951,21050,210,50,-2,9,2,7,0,0,0,0,0,0,1,0,1,4,1,3,0,0,0,4,1,3,0,0,0,0,0,0,0,0,0
134097,21050,210,50,-2,6,3,3,0,0,0,1,1,0,0,0,0,0,0,0,0,0,0,2,1,1,0,0,0,0,0,0,3,1,2
137281,21050,210,50,-2,11,5,6,0,0,0,0,0,0,0,0,0,1,0,1,0,0,0,10,5,5,0,0,0,0,0,0,0,0,0
137759,21050,210,50,-2,12,2,10,0,0,0,1,0,1,2,0,2,2,1,1,0,0,0,7,1,6,0,0,0,0,0,0,0,0,0
137801,21050,210,50,-2,3,0,3,0,0,0,0,0,0,0,0,0,0,0,0,0,0,0,2,0,2,1,0,1,0,0,0,0,0,0
137847,21050,210,50,-2,2,2,0,0,0,0,0,0,0,0,0,0,0,0,0,1,1,0,1,1,0,0,0,0,0,0,0,0,0,0
138682,21050,210,50,-2,3,2,1,0,0,0,0,0,0,2,1,1,0,0,0,0,0,0,1,1,0,0,0,0,0,0,0,0,0,0
138929,21050,210,50,-2,3,1,2,0,0,0,0,0,0,0,0,0,0,0,0,0,0,0,3,1,2,0,0,0,0,0,0,0,0,0
139384,21050,210,50,-2,13,5,8,0,0,0,0,0,0,0,0,0,1,1,0,0,0,0,12,4,8,0,0,0,0,0,0,0,0,0
139755,21050,210,50,-2,15,8,7,0,0,0,2,1,1,0,0,0,0,0,0,0,0,0,11,7,4,0,0,0,0,0,0,2,0,2
139940,21050,210,50,-2,2,2,0,0,0,0,0,0,0,0,0,0,0,0,0,0,0,0,2,2,0,0,0,0,0,0,0,0,0,0
139986,21050,210,50,-2,11,5,6,0,0,0,1,1,0,2,0,2,1,1,0,0,0,0,7,3,4,0,0,0,0,0,0,0,0,0
142276,21050,210,50,-2,1,1,0,0,0,0,0,0,0,0,0,0,0,0,0,0,0,0,1,1,0,0,0,0,0,0,0,0,0,0
142522,21050,210,50,-2,21,15,6,0,0,0,0,0,0,0,0,0,1,1,0,0,0,0,19,14,5,0,0,0,1,0,1,0,0,0
143853,21050,210,50,-2,2,0,2,0,0,0,0,0,0,0,0,0,0,0,0,0,0,0,2,0,2,0,0,0,0,0,0,0,0,0
145558,21050,210,50,-2,2,0,2,0,0,0,0,0,0,0,0,0,0,0,0,0,0,0,2,0,2,0,0,0,0,0,0,0,0,0
150215,21050,210,50,-2,1,0,1,0,0,0,0,0,0,1,0,1,0,0,0,0,0,0,0,0,0,0,0,0,0,0,0,0,0,0
150455,21050,210,50,-2,1,1,0,0,0,0,0,0,0,0,0,0,0,0,0,0,0,0,0,0,0,0,0,0,0,0,0,1,1,0
150668,21050,210,50,-2,1,1,0,0,0,0,0,0,0,0,0,0,0,0,0,0,0,0,1,1,0,0,0,0,0,0,0,0,0,0
151102,21050,210,50,-2,9,4,5,0,0,0,0,0,0,0,0,0,0,0,0,0,0,0,6,3,3,1,0,1,1,1,0,1,0,1
152080,21050,210,50,-2,28,14,14,0,0,0,1,0,1,0,0,0,4,2,2,0,0,0,14,8,6,1,0,1,2,1,1,6,3,3
153162,21050,210,50,-2,3,1,2,0,0,0,0,0,0,0,0,0,0,0,0,0,0,0,2,1,1,0,0,0,0,0,0,1,0,1
153737,21050,210,50,-2,3,2,1,0,0,0,1,1,0,0,0,0,0,0,0,0,0,0,2,1,1,0,0,0,0,0,0,0,0,0
154110,21050,210,50,-2,1,1,0,0,0,0,0,0,0,0,0,0,0,0,0,0,0,0,1,1,0,0,0,0,0,0,0,0,0,0
154378,21050,210,50,-2,3,1,2,0,0,0,0,0,0,0,0,0,0,0,0,0,0,0,3,1,2,0,0,0,0,0,0,0,0,0
154952,21050,210,50,-2,1,0,1,0,0,0,0,0,0,0,0,0,0,0,0,0,0,0,1,0,1,0,0,0,0,0,0,0,0,0
155104,21050,210,50,-2,2,2,0,0,0,0,0,0,0,0,0,0,0,0,0,0,0,0,2,2,0,0,0,0,0,0,0,0,0,0
155195,21050,210,50,-2,4,2,2,0,0,0,0,0,0,0,0,0,0,0,0,0,0,0,4,2,2,0,0,0,0,0,0,0,0,0
155593,21050,210,50,-2,1,1,0,0,0,0,0,0,0,0,0,0,0,0,0,0,0,0,1,1,0,0,0,0,0,0,0,0,0,0
156134,21050,210,50,-2,1,1,0,0,0,0,0,0,0,1,1,0,0,0,0,0,0,0,0,0,0,0,0,0,0,0,0,0,0,0
156365,21050,210,50,-2,5,2,3,0,0,0,0,0,0,0,0,0,0,0,0,0,0,0,4,2,2,0,0,0,1,0,1,0,0,0
157021,21050,210,50,-2,3,1,2,0,0,0,0,0,0,1,0,1,0,0,0,0,0,0,2,1,1,0,0,0,0,0,0,0,0,0
159009,21050,210,50,-2,14,6,8,0,0,0,2,1,1,9,3,6,0,0,0,0,0,0,2,1,1,0,0,0,0,0,0,1,1,0
159993,21050,210,50,-2,3,2,1,0,0,0,0,0,0,2,2,0,0,0,0,0,0,0,1,0,1,0,0,0,0,0,0,0,0,0
160621,21050,210,50,-2,16,6,10,0,0,0,0,0,0,13,6,7,0,0,0,0,0,0,3,0,3,0,0,0,0,0,0,0,0,0
160658,21050,210,50,-2,20,5,15,0,0,0,1,0,1,1,0,1,4,0,4,0,0,0,11,3,8,0,0,0,1,0,1,2,2,0
160995,21050,210,50,-2,5,2,3,0,0,0,0,0,0,0,0,0,0,0,0,0,0,0,5,2,3,0,0,0,0,0,0,0,0,0
161572,21050,210,50,-2,2,1,1,0,0,0,0,0,0,0,0,0,0,0,0,0,0,0,2,1,1,0,0,0,0,0,0,0,0,0
166683,21050,210,50,-2,54,39,15,0,0,0,2,1,1,12,9,3,3,2,1,0,0,0,14,9,5,4,2,2,6,6,0,13,10,3
166708,21050,210,50,-2,81,41,40,0,0,0,6,2,4,2,1,1,3,0,3,0,0,0,13,6,7,0,0,0,0,0,0,57,32,25
168421,21050,210,50,-2,1,0,1,0,0,0,0,0,0,0,0,0,0,0,0,0,0,0,1,0,1,0,0,0,0,0,0,0,0,0
169080,21050,210,50,-2,4,1,3,0,0,0,1,0,1,0,0,0,0,0,0,0,0,0,3,1,2,0,0,0,0,0,0,0,0,0
170286,21050,210,50,-2,10,9,1,0,0,0,0,0,0,0,0,0,0,0,0,0,0,0,0,0,0,0,0,0,10,9,1,0,0,0
171100,21050,210,50,-2,5,1,4,0,0,0,0,0,0,0,0,0,1,0,1,0,0,0,3,1,2,0,0,0,0,0,0,1,0,1
173258,21050,210,50,-2,14,7,7,0,0,0,2,1,1,0,0,0,4,2,2,0,0,0,7,4,3,1,0,1,0,0,0,0,0,0
174066,21050,210,50,-2,47,17,30,0,0,0,3,1,2,2,1,1,3,1,2,0,0,0,31,13,18,3,1,2,2,0,2,3,0,3
174075,21050,210,50,-2,4,1,3,0,0,0,0,0,0,0,0,0,0,0,0,0,0,0,4,1,3,0,0,0,0,0,0,0,0,0
174251,21050,210,50,-2,4,2,2,0,0,0,0,0,0,0,0,0,0,0,0,0,0,0,1,1,0,1,0,1,2,1,1,0,0,0
175786,21050,210,50,-2,1,1,0,0,0,0,0,0,0,1,1,0,0,0,0,0,0,0,0,0,0,0,0,0,0,0,0,0,0,0
176178,21050,210,50,-2,3,0,3,0,0,0,0,0,0,1,0,1,0,0,0,0,0,0,2,0,2,0,0,0,0,0,0,0,0,0
176965,21050,210,50,-2,2,1,1,0,0,0,0,0,0,0,0,0,0,0,0,0,0,0,2,1,1,0,0,0,0,0,0,0,0,0
177038,21050,210,50,-2,1,1,0,0,0,0,0,0,0,1,1,0,0,0,0,0,0,0,0,0,0,0,0,0,0,0,0,0,0,0
180197,21050,210,50,-2,3,1,2,0,0,0,0,0,0,0,0,0,0,0,0,0,0,0,3,1,2,0,0,0,0,0,0,0,0,0
181428,21050,210,50,-2,2,1,1,0,0,0,0,0,0,0,0,0,0,0,0,0,0,0,0,0,0,0,0,0,1,0,1,1,1,0
183655,21050,210,50,-2,1,0,1,0,0,0,0,0,0,0,0,0,0,0,0,0,0,0,1,0,1,0,0,0,0,0,0,0,0,0
183938,21050,210,50,-2,3,2,1,0,0,0,1,1,0,0,0,0,0,0,0,0,0,0,2,1,1,0,0,0,0,0,0,0,0,0
185828,21050,210,50,-2,2,1,1,0,0,0,0,0,0,0,0,0,0,0,0,0,0,0,2,1,1,0,0,0,0,0,0,0,0,0
185873,21050,210,50,-2,6,2,4,0,0,0,2,0,2,0,0,0,1,1,0,0,0,0,3,1,2,0,0,0,0,0,0,0,0,0
187596,21050,210,50,-2,1,1,0,1,1,0,0,0,0,0,0,0,0,0,0,0,0,0,0,0,0,0,0,0,0,0,0,0,0,0
187912,21050,210,50,-2,1,1,0,0,0,0,0,0,0,1,1,0,0,0,0,0,0,0,0,0,0,0,0,0,0,0,0,0,0,0
188580,21050,210,50,-2,23,16,7,0,0,0,4,3,1,0,0,0,3,2,1,0,0,0,14,11,3,0,0,0,2,0,2,0,0,0
190099,21050,210,50,-2,5,2,3,0,0,0,2,0,2,0,0,0,1,1,0,0,0,0,2,1,1,0,0,0,0,0,0,0,0,0
191241,21050,210,50,-2,39,15,24,0,0,0,4,0,4,1,1,0,4,1,3,0,0,0,21,9,12,0,0,0,6,3,3,3,1,2
191515,21050,210,50,-2,3,2,1,0,0,0,1,1,0,0,0,0,1,0,1,0,0,0,0,0,0,0,0,0,0,0,0,1,1,0
193201,21050,210,50,-2,1,0,1,0,0,0,0,0,0,0,0,0,0,0,0,0,0,0,1,0,1,0,0,0,0,0,0,0,0,0
193247,21050,210,50,-2,1,1,0,0,0,0,0,0,0,0,0,0,0,0,0,0,0,0,1,1,0,0,0,0,0,0,0,0,0,0
193751,21050,210,50,-2,1,0,1,0,0,0,0,0,0,0,0,0,0,0,0,0,0,0,1,0,1,0,0,0,0,0,0,0,0,0
194091,21050,210,50,-2,6,2,4,0,0,0,0,0,0,2,1,1,0,0,0,0,0,0,3,1,2,1,0,1,0,0,0,0,0,0
195720,21050,210,50,-2,1,0,1,0,0,0,0,0,0,0,0,0,0,0,0,0,0,0,1,0,1,0,0,0,0,0,0,0,0,0
197850,21050,210,50,-2,1,1,0,0,0,0,0,0,0,0,0,0,0,0,0,0,0,0,1,1,0,0,0,0,0,0,0,0,0,0
197911,21050,210,50,-2,1,1,0,0,0,0,1,1,0,0,0,0,0,0,0,0,0,0,0,0,0,0,0,0,0,0,0,0,0,0
198543,21050,210,50,-2,2,1,1,0,0,0,0,0,0,0,0,0,0,0,0,0,0,0,0,0,0,0,0,0,0,0,0,2,1,1
199148,21050,210,50,-2,1,0,1,0,0,0,0,0,0,0,0,0,0,0,0,0,0,0,1,0,1,0,0,0,0,0,0,0,0,0
200022,21050,210,50,-2,2,1,1,0,0,0,0,0,0,0,0,0,0,0,0,0,0,0,2,1,1,0,0,0,0,0,0,0,0,0
200226,21050,210,50,-2,1,0,1,0,0,0,0,0,0,0,0,0,0,0,0,0,0,0,1,0,1,0,0,0,0,0,0,0,0,0
200280,21050,210,50,-2,38,18,20,1,0,1,2,1,1,1,1,0,1,0,1,0,0,0,18,8,10,0,0,0,0,0,0,15,8,7
200305,21050,210,50,-2,7,3,4,0,0,0,0,0,0,0,0,0,0,0,0,0,0,0,7,3,4,0,0,0,0,0,0,0,0,0
200341,21050,210,50,-2,5,1,4,0,0,0,0,0,0,0,0,0,0,0,0,0,0,0,5,1,4,0,0,0,0,0,0,0,0,0
201821,21050,210,50,-2,1,0,1,0,0,0,0,0,0,0,0,0,0,0,0,0,0,0,1,0,1,0,0,0,0,0,0,0,0,0
204440,21050,210,50,-2,7,5,2,0,0,0,0,0,0,0,0,0,0,0,0,0,0,0,7,5,2,0,0,0,0,0,0,0,0,0
204608,21050,210,50,-2,3,1,2,0,0,0,0,0,0,1,0,1,0,0,0,0,0,0,2,1,1,0,0,0,0,0,0,0,0,0
204796,21050,210,50,-2,20,6,14,0,0,0,5,1,4,0,0,0,0,0,0,0,0,0,15,5,10,0,0,0,0,0,0,0,0,0
205966,21050,210,50,-2,1,1,0,0,0,0,0,0,0,0,0,0,0,0,0,0,0,0,1,1,0,0,0,0,0,0,0,0,0,0
207254,21050,210,50,-2,25,25,0,2,2,0,4,4,0,1,1,0,4,4,0,0,0,0,14,14,0,0,0,0,0,0,0,0,0,0
207388,21050,210,50,-2,1,1,0,0,0,0,1,1,0,0,0,0,0,0,0,0,0,0,0,0,0,0,0,0,0,0,0,0,0,0
209056,21050,210,50,-2,2,0,2,0,0,0,0,0,0,0,0,0,0,0,0,0,0,0,1,0,1,1,0,1,0,0,0,0,0,0
209506,21050,210,50,-2,9,7,2,0,0,0,0,0,0,0,0,0,0,0,0,0,0,0,9,7,2,0,0,0,0,0,0,0,0,0
209612,21050,210,50,-2,2,0,2,0,0,0,0,0,0,0,0,0,0,0,0,0,0,0,1,0,1,0,0,0,0,0,0,1,0,1
211079,21050,210,50,-2,1,0,1,0,0,0,0,0,0,0,0,0,0,0,0,0,0,0,1,0,1,0,0,0,0,0,0,0,0,0
211440,21050,210,50,-2,72,51,21,0,0,0,5,5,0,2,0,2,2,1,1,0,0,0,16,8,8,4,4,0,3,2,1,40,31,9
212434,21050,210,50,-2,6,5,1,0,0,0,0,0,0,0,0,0,0,0,0,0,0,0,6,5,1,0,0,0,0,0,0,0,0,0
212975,21050,210,50,-2,2,1,1,0,0,0,0,0,0,0,0,0,0,0,0,0,0,0,2,1,1,0,0,0,0,0,0,0,0,0
213181,21050,210,50,-2,8,0,8,0,0,0,0,0,0,0,0,0,0,0,0,0,0,0,8,0,8,0,0,0,0,0,0,0,0,0
214564,21050,210,50,-2,11,3,8,0,0,0,4,2,2,1,0,1,0,0,0,0,0,0,6,1,5,0,0,0,0,0,0,0,0,0
215381,21050,210,50,-2,11,9,2,0,0,0,0,0,0,0,0,0,0,0,0,0,0,0,11,9,2,0,0,0,0,0,0,0,0,0
215743,21050,210,50,-2,1,1,0,0,0,0,0,0,0,0,0,0,0,0,0,0,0,0,1,1,0,0,0,0,0,0,0,0,0,0
216287,21050,210,50,-2,1,0,1,0,0,0,0,0,0,0,0,0,0,0,0,0,0,0,0,0,0,0,0,0,0,0,0,1,0,1
216782,21050,210,50,-2,15,3,12,0,0,0,0,0,0,0,0,0,0,0,0,0,0,0,14,3,11,1,0,1,0,0,0,0,0,0
217077,21050,210,50,-2,2,0,2,0,0,0,0,0,0,0,0,0,0,0,0,0,0,0,2,0,2,0,0,0,0,0,0,0,0,0
217156,21050,210,50,-2,5,2,3,0,0,0,1,0,1,0,0,0,0,0,0,0,0,0,3,1,2,0,0,0,0,0,0,1,1,0
217688,21050,210,50,-2,12,6,6,1,0,1,0,0,0,4,3,1,1,0,1,0,0,0,5,2,3,1,1,0,0,0,0,0,0,0
218229,21050,210,50,-2,5,0,5,0,0,0,0,0,0,3,0,3,0,0,0,0,0,0,0,0,0,1,0,1,1,0,1,0,0,0
219143,21050,210,50,-2,1,1,0,0,0,0,0,0,0,0,0,0,0,0,0,0,0,0,1,1,0,0,0,0,0,0,0,0,0,0
219426,21050,210,50,-2,3,1,2,0,0,0,0,0,0,0,0,0,0,0,0,0,0,0,3,1,2,0,0,0,0,0,0,0,0,0
219471,21050,210,50,-2,1,0,1,0,0,0,0,0,0,0,0,0,0,0,0,0,0,0,1,0,1,0,0,0,0,0,0,0,0,0
219888,21050,210,50,-2,1,1,0,0,0,0,0,0,0,0,0,0,0,0,0,0,0,0,1,1,0,0,0,0,0,0,0,0,0,0
220181,21050,210,50,-2,2,1,1,0,0,0,0,0,0,2,1,1,0,0,0,0,0,0,0,0,0,0,0,0,0,0,0,0,0,0
220631,21050,210,50,-2,1,0,1,0,0,0,0,0,0,0,0,0,0,0,0,0,0,0,1,0,1,0,0,0,0,0,0,0,0,0
223463,21050,210,50,-2,1,1,0,0,0,0,0,0,0,1,1,0,0,0,0,0,0,0,0,0,0,0,0,0,0,0,0,0,0,0
224712,21050,210,50,-2,1,0,1,0,0,0,0,0,0,0,0,0,0,0,0,0,0,0,1,0,1,0,0,0,0,0,0,0,0,0
224891,21050,210,50,-2,2,1,1,0,0,0,0,0,0,0,0,0,1,0,1,0,0,0,1,1,0,0,0,0,0,0,0,0,0,0
225414,21050,210,50,-2,7,0,7,0,0,0,2,0,2,0,0,0,0,0,0,0,0,0,3,0,3,0,0,0,0,0,0,2,0,2
225502,21050,210,50,-2,1,0,1,0,0,0,0,0,0,0,0,0,0,0,0,0,0,0,1,0,1,0,0,0,0,0,0,0,0,0
225511,21050,210,50,-2,9,2,7,0,0,0,3,0,3,1,0,1,2,1,1,0,0,0,3,1,2,0,0,0,0,0,0,0,0,0
226231,21050,210,50,-2,7,6,1,0,0,0,0,0,0,0,0,0,0,0,0,0,0,0,6,5,1,0,0,0,1,1,0,0,0,0
226806,21050,210,50,-2,2,2,0,0,0,0,0,0,0,0,0,0,0,0,0,0,0,0,2,2,0,0,0,0,0,0,0,0,0,0
227216,21050,210,50,-2,16,5,11,0,0,0,0,0,0,2,1,1,2,0,2,0,0,0,11,3,8,0,0,0,1,1,0,0,0,0
227854,21050,210,50,-2,4,2,2,0,0,0,1,0,1,0,0,0,0,0,0,0,0,0,3,2,1,0,0,0,0,0,0,0,0,0
227924,21050,210,50,-2,5,0,5,0,0,0,0,0,0,1,0,1,2,0,2,0,0,0,2,0,2,0,0,0,0,0,0,0,0,0
228316,21050,210,50,-2,1,1,0,0,0,0,0,0,0,0,0,0,1,1,0,0,0,0,0,0,0,0,0,0,0,0,0,0,0,0
228459,21050,210,50,-2,3,2,1,0,0,0,0,0,0,1,1,0,1,1,0,0,0,0,1,0,1,0,0,0,0,0,0,0,0,0
228705,21050,210,50,-2,1,0,1,0,0,0,0,0,0,0,0,0,0,0,0,0,0,0,1,0,1,0,0,0,0,0,0,0,0,0
229018,21050,210,50,-2,14,8,6,0,0,0,1,1,0,0,0,0,2,1,1,0,0,0,10,5,5,0,0,0,0,0,0,1,1,0
230038,21050,210,50,-2,3,0,3,0,0,0,0,0,0,0,0,0,0,0,0,0,0,0,3,0,3,0,0,0,0,0,0,0,0,0
230764,21050,210,50,-2,9,5,4,0,0,0,0,0,0,1,0,1,0,0,0,0,0,0,4,2,2,1,1,0,1,1,0,2,1,1
232016,21050,210,50,-2,4,2,2,0,0,0,0,0,0,3,1,2,0,0,0,0,0,0,1,1,0,0,0,0,0,0,0,0,0,0
232265,21050,210,50,-2,1,0,1,0,0,0,0,0,0,1,0,1,0,0,0,0,0,0,0,0,0,0,0,0,0,0,0,0,0,0
232797,21050,210,50,-2,2,1,1,0,0,0,1,1,0,0,0,0,0,0,0,0,0,0,1,0,1,0,0,0,0,0,0,0,0,0
232982,21050,210,50,-2,1,0,1,0,0,0,0,0,0,0,0,0,0,0,0,0,0,0,1,0,1,0,0,0,0,0,0,0,0,0
234085,21050,210,50,-2,1,1,0,0,0,0,0,0,0,0,0,0,0,0,0,0,0,0,1,1,0,0,0,0,0,0,0,0,0,0
234827,21050,210,50,-2,10,10,0,0,0,0,1,1,0,0,0,0,2,2,0,0,0,0,5,5,0,2,2,0,0,0,0,0,0,0
236948,21050,210,50,-2,1,1,0,0,0,0,0,0,0,0,0,0,0,0,0,0,0,0,1,1,0,0,0,0,0,0,0,0,0,0
237367,21050,210,50,-2,1,1,0,0,0,0,0,0,0,0,0,0,0,0,0,0,0,0,1,1,0,0,0,0,0,0,0,0,0,0
237996,21050,210,50,-2,12,3,9,0,0,0,0,0,0,0,0,0,0,0,0,0,0,0,12,3,9,0,0,0,0,0,0,0,0,0
241304,21050,210,50,-2,3,0,3,0,0,0,0,0,0,0,0,0,3,0,3,0,0,0,0,0,0,0,0,0,0,0,0,0,0,0
243443,21050,210,50,-2,1,0,1,0,0,0,0,0,0,0,0,0,1,0,1,0,0,0,0,0,0,0,0,0,0,0,0,0,0,0
243744,21050,210,50,-2,322,167,155,2,1,1,64,29,35,11,2,9,22,9,13,1,1,0,100,58,42,9,5,4,67,33,34,46,29,17
243780,21050,210,50,-2,24,12,12,0,0,0,1,0,1,0,0,0,3,1,2,0,0,0,18,10,8,1,1,0,1,0,1,0,0,0
246354,21050,210,50,-2,1,0,1,0,0,0,0,0,0,0,0,0,1,0,1,0,0,0,0,0,0,0,0,0,0,0,0,0,0,0
261861,21050,210,50,-2,1,0,1,0,0,0,0,0,0,0,0,0,0,0,0,0,0,0,1,0,1,0,0,0,0,0,0,0,0,0
262129,21050,210,50,-2,5,2,3,0,0,0,3,1,2,0,0,0,0,0,0,0,0,0,1,1,0,0,0,0,0,0,0,1,0,1
363934,21050,210,50,-2,1,1,0,0,0,0,0,0,0,0,0,0,0,0,0,0,0,0,0,0,0,1,1,0,0,0,0,0,0,0
366465,21050,210,50,-2,9,8,1,0,0,0,0,0,0,1,1,0,1,1,0,0,0,0,7,6,1,0,0,0,0,0,0,0,0,0
369400,21050,210,50,-2,6,6,0,0,0,0,0,0,0,0,0,0,1,1,0,0,0,0,4,4,0,1,1,0,0,0,0,0,0,0
377111,21050,210,50,-2,1,0,1,0,0,0,0,0,0,1,0,1,0,0,0,0,0,0,0,0,0,0,0,0,0,0,0,0,0,0
377458,21050,210,50,-2,12,4,8,0,0,0,0,0,0,6,0,6,0,0,0,0,0,0,6,4,2,0,0,0,0,0,0,0,0,0
404055,21050,210,50,-2,5,2,3,0,0,0,0,0,0,1,0,1,0,0,0,0,0,0,3,1,2,0,0,0,1,1,0,0,0,0
413680,21050,210,50,-2,7,7,0,0,0,0,0,0,0,2,2,0,3,3,0,0,0,0,2,2,0,0,0,0,0,0,0,0,0,0
418126,21050,210,50,-2,1,0,1,0,0,0,0,0,0,0,0,0,0,0,0,0,0,0,1,0,1,0,0,0,0,0,0,0,0,0
418533,21050,210,50,-2,4,2,2,0,0,0,0,0,0,0,0,0,0,0,0,0,0,0,4,2,2,0,0,0,0,0,0,0,0,0
420024,21050,210,50,-2,3,0,3,0,0,0,1,0,1,1,0,1,0,0,0,0,0,0,1,0,1,0,0,0,0,0,0,0,0,0
420398,21050,210,50,-2,1,1,0,0,0,0,0,0,0,0,0,0,0,0,0,0,0,0,1,1,0,0,0,0,0,0,0,0,0,0
420431,21050,210,50,-2,9,3,6,0,0,0,0,0,0,1,0,1,0,0,0,0,0,0,8,3,5,0,0,0,0,0,0,0,0,0
421708,21050,210,50,-2,16,3,13,0,0,0,0,0,0,5,0,5,0,0,0,0,0,0,10,3,7,1,0,1,0,0,0,0,0,0
423643,21050,210,50,-2,9,1,8,0,0,0,1,0,1,0,0,0,1,0,1,0,0,0,7,1,6,0,0,0,0,0,0,0,0,0
427982,21050,210,50,-2,11,7,4,0,0,0,0,0,0,7,3,4,0,0,0,0,0,0,4,4,0,0,0,0,0,0,0,0,0,0
434821,21050,210,50,-2,1,0,1,0,0,0,0,0,0,1,0,1,0,0,0,0,0,0,0,0,0,0,0,0,0,0,0,0,0,0
438179,21050,210,50,-2,4,0,4,0,0,0,0,0,0,1,0,1,2,0,2,0,0,0,1,0,1,0,0,0,0,0,0,0,0,0
438498,21050,210,50,-2,10,1,9,0,0,0,0,0,0,2,0,2,0,0,0,0,0,0,7,1,6,0,0,0,1,0,1,0,0,0
438504,21050,210,50,-2,2,2,0,0,0,0,0,0,0,0,0,0,2,2,0,0,0,0,0,0,0,0,0,0,0,0,0,0,0,0
438586,21050,210,50,-2,1,1,0,0,0,0,0,0,0,1,1,0,0,0,0,0,0,0,0,0,0,0,0,0,0,0,0,0,0,0
440059,21050,210,50,-2,13,12,1,0,0,0,1,1,0,1,1,0,1,1,0,0,0,0,10,9,1,0,0,0,0,0,0,0,0,0
441052,21050,210,50,-2,5,2,3,0,0,0,0,0,0,0,0,0,2,2,0,0,0,0,2,0,2,1,0,1,0,0,0,0,0,0
441229,21050,210,50,-2,18,7,11,0,0,0,0,0,0,1,0,1,4,3,1,0,0,0,10,3,7,0,0,0,3,1,2,0,0,0
442383,21050,210,50,-2,7,1,6,0,0,0,0,0,0,0,0,0,0,0,0,0,0,0,7,1,6,0,0,0,0,0,0,0,0,0
443331,21050,210,50,-2,3,0,3,0,0,0,1,0,1,0,0,0,0,0,0,0,0,0,2,0,2,0,0,0,0,0,0,0,0,0
443748,21050,210,50,-2,4,1,3,1,0,1,0,0,0,2,1,1,0,0,0,0,0,0,0,0,0,1,0,1,0,0,0,0,0,0
444565,21050,210,50,-2,1,1,0,0,0,0,0,0,0,0,0,0,0,0,0,0,0,0,1,1,0,0,0,0,0,0,0,0,0,0
445027,21050,210,50,-2,6,2,4,1,0,1,0,0,0,2,1,1,0,0,0,0,0,0,3,1,2,0,0,0,0,0,0,0,0,0
445203,21050,210,50,-2,1,0,1,0,0,0,0,0,0,0,0,0,0,0,0,0,0,0,1,0,1,0,0,0,0,0,0,0,0,0
445461,21050,210,50,-2,4,2,2,0,0,0,0,0,0,2,0,2,0,0,0,0,0,0,1,1,0,0,0,0,1,1,0,0,0,0
447421,21050,210,50,-2,4,1,3,0,0,0,0,0,0,1,1,0,0,0,0,0,0,0,3,0,3,0,0,0,0,0,0,0,0,0
447768,21050,210,50,-2,5,1,4,0,0,0,0,0,0,3,0,3,1,1,0,0,0,0,1,0,1,0,0,0,0,0,0,0,0,0
447777,21050,210,50,-2,3,1,2,0,0,0,0,0,0,0,0,0,1,0,1,0,0,0,2,1,1,0,0,0,0,0,0,0,0,0
450128,21050,210,50,-2,3,0,3,0,0,0,0,0,0,0,0,0,0,0,0,0,0,0,3,0,3,0,0,0,0,0,0,0,0,0
451228,21050,210,50,-2,1,1,0,0,0,0,0,0,0,0,0,0,0,0,0,0,0,0,1,1,0,0,0,0,0,0,0,0,0,0
451477,21050,210,50,-2,6,5,1,0,0,0,0,0,0,0,0,0,0,0,0,0,0,0,5,4,1,1,1,0,0,0,0,0,0,0
451556,21050,210,50,-2,26,12,14,0,0,0,0,0,0,0,0,0,25,11,14,0,0,0,1,1,0,0,0,0,0,0,0,0,0,0
454698,21050,210,50,-2,6,1,5,0,0,0,0,0,0,1,0,1,3,0,3,0,0,0,2,1,1,0,0,0,0,0,0,0,0,0
456959,21050,210,50,-2,2,0,2,0,0,0,1,0,1,0,0,0,0,0,0,0,0,0,0,0,0,1,0,1,0,0,0,0,0,0
460543,21050,210,50,-2,3,3,0,0,0,0,0,0,0,0,0,0,0,0,0,0,0,0,2,2,0,1,1,0,0,0,0,0,0,0
482990,21050,210,50,-2,1,0,1,0,0,0,0,0,0,0,0,0,0,0,0,0,0,0,1,0,1,0,0,0,0,0,0,0,0,0
483647,21050,210,50,-2,6,1,5,0,0,0,0,0,0,0,0,0,0,0,0,0,0,0,6,1,5,0,0,0,0,0,0,0,0,0
484905,21050,210,50,-2,15,7,8,0,0,0,0,0,0,1,1,0,3,1,2,0,0,0,10,5,5,0,0,0,1,0,1,0,0,0
485519,21050,210,50,-2,1,1,0,0,0,0,0,0,0,0,0,0,0,0,0,0,0,0,1,1,0,0,0,0,0,0,0,0,0,0
485546,21050,210,50,-2,1,0,1,0,0,0,0,0,0,1,0,1,0,0,0,0,0,0,0,0,0,0,0,0,0,0,0,0,0,0
486424,21050,210,50,-2,2,1,1,0,0,0,0,0,0,2,1,1,0,0,0,0,0,0,0,0,0,0,0,0,0,0,0,0,0,0
487375,21050,210,50,-2,12,5,7,1,1,0,2,1,1,2,0,2,1,1,0,0,0,0,5,2,3,1,0,1,0,0,0,0,0,0
487384,21050,210,50,-2,1,1,0,0,0,0,0,0,0,0,0,0,0,0,0,0,0,0,0,0,0,1,1,0,0,0,0,0,0,0
487393,21050,210,50,-2,8,2,6,0,0,0,0,0,0,4,1,3,1,1,0,0,0,0,0,0,0,2,0,2,1,0,1,0,0,0
487409,21050,210,50,-2,3,0,3,0,0,0,0,0,0,0,0,0,3,0,3,0,0,0,0,0,0,0,0,0,0,0,0,0,0,0
487418,21050,210,50,-2,6,3,3,0,0,0,0,0,0,1,0,1,2,1,1,0,0,0,2,1,1,0,0,0,1,1,0,0,0,0
487427,21050,210,50,-2,5,1,4,0,0,0,0,0,0,2,1,1,1,0,1,0,0,0,1,0,1,1,0,1,0,0,0,0,0,0
487445,21050,210,50,-2,4,1,3,0,0,0,0,0,0,1,0,1,1,1,0,0,0,0,0,0,0,2,0,2,0,0,0,0,0,0
487472,21050,210,50,-2,11,4,7,0,0,0,1,1,0,4,1,3,5,2,3,0,0,0,1,0,1,0,0,0,0,0,0,0,0,0
487490,21050,210,50,-2,3,1,2,0,0,0,0,0,0,1,0,1,1,0,1,0,0,0,0,0,0,0,0,0,1,1,0,0,0,0
487597,21050,210,50,-2,15,15,0,0,0,0,0,0,0,0,0,0,7,7,0,1,1,0,7,7,0,0,0,0,0,0,0,0,0,0
488730,21050,210,50,-2,1,1,0,0,0,0,0,0,0,0,0,0,0,0,0,0,0,0,1,1,0,0,0,0,0,0,0,0,0,0
490559,21050,210,50,-2,2,1,1,0,0,0,0,0,0,1,0,1,0,0,0,0,0,0,1,1,0,0,0,0,0,0,0,0,0,0
490805,21050,210,50,-2,2,1,1,0,0,0,0,0,0,1,0,1,0,0,0,0,0,0,0,0,0,0,0,0,0,0,0,1,1,0
494162,21050,210,50,-2,8,1,7,0,0,0,1,0,1,4,0,4,0,0,0,0,0,0,3,1,2,0,0,0,0,0,0,0,0,0
494250,21050,210,50,-2,9,1,8,0,0,0,0,0,0,2,0,2,0,0,0,0,0,0,7,1,6,0,0,0,0,0,0,0,0,0
494746,21050,210,50,-2,3,2,1,0,0,0,0,0,0,0,0,0,0,0,0,1,1,0,0,0,0,0,0,0,2,1,1,0,0,0
494755,21050,210,50,-2,1,0,1,0,0,0,0,0,0,0,0,0,0,0,0,0,0,0,1,0,1,0,0,0,0,0,0,0,0,0
495420,21050,210,50,-2,2,0,2,0,0,0,1,0,1,0,0,0,0,0,0,0,0,0,1,0,1,0,0,0,0,0,0,0,0,0
495439,21050,210,50,-2,4,1,3,0,0,0,0,0,0,2,0,2,2,1,1,0,0,0,0,0,0,0,0,0,0,0,0,0,0,0
495448,21050,210,50,-2,5,1,4,0,0,0,0,0,0,0,0,0,0,0,0,0,0,0,4,0,4,1,1,0,0,0,0,0,0,0
495457,21050,210,50,-2,2,0,2,0,0,0,0,0,0,0,0,0,1,0,1,0,0,0,1,0,1,0,0,0,0,0,0,0,0,0
495767,21050,210,50,-2,13,8,5,0,0,0,0,0,0,0,0,0,0,0,0,0,0,0,5,3,2,0,0,0,0,0,0,8,5,3
496283,21050,210,50,-2,3,2,1,0,0,0,0,0,0,0,0,0,0,0,0,0,0,0,3,2,1,0,0,0,0,0,0,0,0,0
496326,21050,210,50,-2,7,1,6,0,0,0,1,1,0,0,0,0,0,0,0,0,0,0,6,0,6,0,0,0,0,0,0,0,0,0
497277,21050,210,50,-2,3,0,3,0,0,0,0,0,0,0,0,0,0,0,0,0,0,0,2,0,2,1,0,1,0,0,0,0,0,0
497286,21050,210,50,-2,3,3,0,0,0,0,0,0,0,0,0,0,1,1,0,0,0,0,2,2,0,0,0,0,0,0,0,0,0,0
100724,22000,220,0,-2,4,3,1,0,0,0,1,1,0,1,1,0,0,0,0,0,0,0,0,0,0,0,0,0,2,1,1,0,0,0
100751,22000,220,0,-2,17,12,5,0,0,0,2,1,1,2,2,0,0,0,0,0,0,0,10,6,4,0,0,0,0,0,0,3,3,0
100858,22000,220,0,-2,3,0,3,0,0,0,0,0,0,0,0,0,0,0,0,0,0,0,2,0,2,0,0,0,0,0,0,1,0,1
102094,22000,220,0,-2,11,4,7,0,0,0,6,4,2,2,0,2,0,0,0,0,0,0,3,0,3,0,0,0,0,0,0,0,0,0
102377,22000,220,0,-2,3,3,0,0,0,0,0,0,0,3,3,0,0,0,0,0,0,0,0,0,0,0,0,0,0,0,0,0,0,0
102553,22000,220,0,-2,4,2,2,0,0,0,0,0,0,0,0,0,0,0,0,0,0,0,4,2,2,0,0,0,0,0,0,0,0,0
102614,22000,220,0,-2,32,24,8,1,1,0,0,0,0,0,0,0,1,1,0,0,0,0,14,11,3,2,0,2,2,2,0,12,9,3
102632,22000,220,0,-2,1,1,0,0,0,0,0,0,0,0,0,0,0,0,0,0,0,0,1,1,0,0,0,0,0,0,0,0,0,0
102669,22000,220,0,-2,2,1,1,1,0,1,0,0,0,0,0,0,0,0,0,0,0,0,1,1,0,0,0,0,0,0,0,0,0,0
104151,22000,220,0,-2,12,7,5,0,0,0,0,0,0,1,1,0,0,0,0,0,0,0,3,1,2,0,0,0,5,3,2,3,2,1
104179,22000,220,0,-2,51,27,24,1,0,1,2,1,1,0,0,0,4,3,1,0,0,0,16,7,9,0,0,0,3,3,0,25,13,12
105136,22000,220,0,-2,2,0,2,0,0,0,0,0,0,0,0,0,1,0,1,0,0,0,1,0,1,0,0,0,0,0,0,0,0,0
105330,22000,220,0,-2,3,0,3,0,0,0,0,0,0,0,0,0,1,0,1,0,0,0,2,0,2,0,0,0,0,0,0,0,0,0
106263,22000,220,0,-2,14,10,4,0,0,0,7,5,2,0,0,0,0,0,0,0,0,0,5,3,2,0,0,0,0,0,0,2,2,0
110398,22000,220,0,-2,8,4,4,0,0,0,2,1,1,1,0,1,0,0,0,0,0,0,5,3,2,0,0,0,0,0,0,0,0,0
110404,22000,220,0,-2,212,147,65,0,0,0,12,4,8,1,0,1,7,4,3,1,0,1,55,38,17,2,0,2,3,2,1,131,99,32
110608,22000,220,0,-2,5,3,2,0,0,0,1,1,0,0,0,0,2,1,1,0,0,0,0,0,0,1,0,1,0,0,0,1,1,0
110635,22000,220,0,-2,559,320,239,1,0,1,44,23,21,7,3,4,33,20,13,0,0,0,122,54,68,10,4,6,24,11,13,318,205,113
110644,22000,220,0,-2,565,256,309,2,1,1,57,20,37,4,2,2,40,18,22,2,0,2,171,67,104,19,4,15,27,12,15,243,132,111
110653,22000,220,0,-2,319,175,144,0,0,0,31,10,21,6,5,1,29,10,19,0,0,0,69,40,29,9,2,7,6,4,2,169,104,65
110662,22000,220,0,-2,473,263,210,0,0,0,54,22,32,11,7,4,26,11,15,0,0,0,98,52,46,7,2,5,17,8,9,260,161,99
110671,22000,220,0,-2,167,98,69,0,0,0,22,12,10,0,0,0,13,5,8,0,0,0,31,15,16,2,2,0,4,3,1,95,61,34
110680,22000,220,0,-2,555,300,255,0,0,0,42,23,19,9,2,7,24,7,17,1,0,1,125,66,59,5,2,3,7,3,4,342,197,145
110699,22000,220,0,-2,588,263,325,0,0,0,91,45,46,20,3,17,44,24,20,1,0,1,122,49,73,17,11,6,14,3,11,279,128,151
110705,22000,220,0,-2,184,109,75,0,0,0,2,1,1,2,1,1,11,6,5,0,0,0,50,29,21,3,1,2,11,5,6,105,66,39
110714,22000,220,0,-2,110,63,47,0,0,0,6,4,2,2,0,2,13,3,10,0,0,0,39,24,15,6,3,3,7,5,2,37,24,13
111948,22000,220,0,-2,1,1,0,0,0,0,0,0,0,0,0,0,0,0,0,0,0,0,0,0,0,0,0,0,1,1,0,0,0,0
111966,22000,220,0,-2,19,10,9,0,0,0,2,1,1,3,1,2,3,2,1,0,0,0,1,0,1,0,0,0,10,6,4,0,0,0
112251,22000,220,0,-2,1,0,1,0,0,0,0,0,0,0,0,0,0,0,0,0,0,0,0,0,0,0,0,0,1,0,1,0,0,0
113573,22000,220,0,-2,1,0,1,0,0,0,0,0,0,0,0,0,0,0,0,0,0,0,1,0,1,0,0,0,0,0,0,0,0,0
117636,22000,220,0,-2,2,1,1,0,0,0,0,0,0,0,0,0,0,0,0,0,0,0,1,1,0,0,0,0,0,0,0,1,0,1
119678,22000,220,0,-2,12,6,6,0,0,0,1,1,0,0,0,0,1,1,0,0,0,0,10,4,6,0,0,0,0,0,0,0,0,0
122506,22000,220,0,-2,1,1,0,0,0,0,0,0,0,0,0,0,0,0,0,0,0,0,1,1,0,0,0,0,0,0,0,0,0,0
122612,22000,220,0,-2,1,0,1,0,0,0,0,0,0,0,0,0,1,0,1,0,0,0,0,0,0,0,0,0,0,0,0,0,0,0
122931,22000,220,0,-2,1,0,1,0,0,0,0,0,0,0,0,0,1,0,1,0,0,0,0,0,0,0,0,0,0,0,0,0,0,0
123961,22000,220,0,-2,10,6,4,0,0,0,1,0,1,1,0,1,1,1,0,0,0,0,4,3,1,1,0,1,1,1,0,1,1,0
124557,22000,220,0,-2,2,2,0,0,0,0,0,0,0,0,0,0,0,0,0,0,0,0,0,0,0,0,0,0,0,0,0,2,2,0
126562,22000,220,0,-2,199,89,110,0,0,0,14,5,9,3,2,1,15,5,10,0,0,0,91,41,50,4,1,3,39,17,22,33,18,15
126580,22000,220,0,-2,7,4,3,0,0,0,1,0,1,0,0,0,1,1,0,0,0,0,5,3,2,0,0,0,0,0,0,0,0,0
126614,22000,220,0,-2,177,102,75,1,1,0,20,17,3,1,0,1,7,1,6,0,0,0,71,36,35,4,1,3,4,2,2,69,44,25
126775,22000,220,0,-2,23,19,4,0,0,0,1,1,0,0,0,0,2,1,1,0,0,0,5,3,2,0,0,0,0,0,0,15,14,1
126818,22000,220,0,-2,167,76,91,2,1,1,11,9,2,4,2,2,14,3,11,0,0,0,85,41,44,6,2,4,32,11,21,13,7,6
127060,22000,220,0,-2,3,2,1,0,0,0,0,0,0,0,0,0,0,0,0,0,0,0,2,2,0,1,0,1,0,0,0,0,0,0
128328,22000,220,0,-2,1,1,0,0,0,0,0,0,0,0,0,0,0,0,0,0,0,0,1,1,0,0,0,0,0,0,0,0,0,0
129020,22000,220,0,-2,128,64,64,1,0,1,12,4,8,2,0,2,11,4,7,0,0,0,46,21,25,2,1,1,3,2,1,51,32,19
129491,22000,220,0,-2,2,0,2,0,0,0,0,0,0,0,0,0,0,0,0,0,0,0,2,0,2,0,0,0,0,0,0,0,0,0
130314,22000,220,0,-2,1,0,1,0,0,0,0,0,0,0,0,0,0,0,0,0,0,0,1,0,1,0,0,0,0,0,0,0,0,0
130590,22000,220,0,-2,1,0,1,0,0,0,0,0,0,0,0,0,0,0,0,0,0,0,0,0,0,0,0,0,1,0,1,0,0,0
130794,22000,220,0,-2,446,201,245,1,0,1,46,19,27,17,4,13,26,9,17,0,0,0,139,51,88,11,4,7,12,7,5,194,107,87
130934,22000,220,0,-2,6,4,2,0,0,0,3,3,0,0,0,0,0,0,0,0,0,0,3,1,2,0,0,0,0,0,0,0,0,0
131159,22000,220,0,-2,10,3,7,0,0,0,1,0,1,3,1,2,0,0,0,0,0,0,5,1,4,0,0,0,0,0,0,1,1,0
131283,22000,220,0,-2,16,9,7,0,0,0,1,1,0,0,0,0,0,0,0,0,0,0,8,4,4,0,0,0,1,1,0,6,3,3
131399,22000,220,0,-2,1,0,1,0,0,0,0,0,0,0,0,0,0,0,0,0,0,0,1,0,1,0,0,0,0,0,0,0,0,0
131469,22000,220,0,-2,3,1,2,0,0,0,0,0,0,0,0,0,0,0,0,0,0,0,3,1,2,0,0,0,0,0,0,0,0,0
131496,22000,220,0,-2,76,35,41,0,0,0,7,3,4,8,4,4,3,1,2,0,0,0,20,7,13,0,0,0,10,5,5,28,15,13
131520,22000,220,0,-2,42,14,28,0,0,0,8,4,4,13,2,11,2,0,2,0,0,0,7,6,1,0,0,0,11,2,9,1,0,1
132903,22000,220,0,-2,5,2,3,0,0,0,0,0,0,0,0,0,0,0,0,0,0,0,1,0,1,0,0,0,0,0,0,4,2,2
133553,22000,220,0,-2,2,1,1,0,0,0,0,0,0,0,0,0,1,0,1,0,0,0,0,0,0,0,0,0,0,0,0,1,1,0
133650,22000,220,0,-2,3,2,1,0,0,0,1,1,0,0,0,0,0,0,0,0,0,0,0,0,0,0,0,0,0,0,0,2,1,1
133669,22000,220,0,-2,5,0,5,0,0,0,0,0,0,1,0,1,2,0,2,0,0,0,2,0,2,0,0,0,0,0,0,0,0,0
133872,22000,220,0,-2,1,1,0,0,0,0,0,0,0,0,0,0,0,0,0,0,0,0,1,1,0,0,0,0,0,0,0,0,0,0
133951,22000,220,0,-2,35,20,15,0,0,0,3,2,1,2,0,2,5,4,1,0,0,0,8,2,6,0,0,0,0,0,0,17,12,5
134097,22000,220,0,-2,43,20,23,0,0,0,1,0,1,2,0,2,7,2,5,0,0,0,15,8,7,0,0,0,0,0,0,18,10,8
134130,22000,220,0,-2,22,11,11,0,0,0,2,2,0,0,0,0,3,2,1,0,0,0,5,0,5,0,0,0,1,0,1,11,7,4
135726,22000,220,0,-2,13,7,6,0,0,0,3,3,0,3,1,2,2,0,2,0,0,0,3,2,1,0,0,0,0,0,0,2,1,1
137351,22000,220,0,-2,91,54,37,1,1,0,8,6,2,0,0,0,1,1,0,0,0,0,26,10,16,2,0,2,1,0,1,52,36,16
138840,22000,220,0,-2,2,0,2,0,0,0,0,0,0,1,0,1,0,0,0,0,0,0,1,0,1,0,0,0,0,0,0,0,0,0
138947,22000,220,0,-2,2,2,0,0,0,0,1,1,0,0,0,0,0,0,0,0,0,0,0,0,0,0,0,0,1,1,0,0,0,0
139658,22000,220,0,-2,181,84,97,0,0,0,11,6,5,10,3,7,10,2,8,0,0,0,75,33,42,4,3,1,1,1,0,70,36,34
139755,22000,220,0,-2,379,282,97,0,0,0,45,29,16,35,24,11,26,21,5,0,0,0,178,136,42,8,5,3,25,23,2,62,44,18
139940,22000,220,0,-2,2,2,0,0,0,0,1,1,0,0,0,0,0,0,0,0,0,0,0,0,0,0,0,0,0,0,0,1,1,0
139959,22000,220,0,-2,5,4,1,0,0,0,1,1,0,0,0,0,1,1,0,0,0,0,2,1,1,0,0,0,0,0,0,1,1,0
140252,22000,220,0,-2,2,1,1,0,0,0,0,0,0,0,0,0,0,0,0,0,0,0,2,1,1,0,0,0,0,0,0,0,0,0
140447,22000,220,0,-2,1,0,1,0,0,0,1,0,1,0,0,0,0,0,0,0,0,0,0,0,0,0,0,0,0,0,0,0,0,0
140553,22000,220,0,-2,6,5,1,0,0,0,0,0,0,4,3,1,0,0,0,0,0,0,1,1,0,0,0,0,1,1,0,0,0,0
141574,22000,220,0,-2,6,3,3,0,0,0,3,1,2,0,0,0,0,0,0,0,0,0,2,2,0,1,0,1,0,0,0,0,0,0
141644,22000,220,0,-2,4,1,3,0,0,0,0,0,0,0,0,0,0,0,0,0,0,0,4,1,3,0,0,0,0,0,0,0,0,0
142115,22000,220,0,-2,9,6,3,0,0,0,1,1,0,0,0,0,1,0,1,0,0,0,6,4,2,0,0,0,0,0,0,1,1,0
143853,22000,220,0,-2,3,2,1,0,0,0,0,0,0,0,0,0,1,1,0,0,0,0,2,1,1,0,0,0,0,0,0,0,0,0
144050,22000,220,0,-2,425,230,195,0,0,0,41,17,24,11,2,9,17,6,11,0,0,0,120,55,65,9,7,2,10,5,5,217,138,79
145600,22000,220,0,-2,8,5,3,0,0,0,2,2,0,0,0,0,1,1,0,0,0,0,4,1,3,0,0,0,1,1,0,0,0,0
145637,22000,220,0,-2,6,3,3,0,0,0,0,0,0,1,0,1,1,1,0,0,0,0,0,0,0,0,0,0,0,0,0,4,2,2
146719,22000,220,0,-2,19,12,7,0,0,0,5,4,1,0,0,0,2,2,0,0,0,0,4,1,3,0,0,0,0,0,0,8,5,3
147767,22000,220,0,-2,506,303,203,0,0,0,23,17,6,6,2,4,16,7,9,0,0,0,121,61,60,6,5,1,5,2,3,329,209,120
149222,22000,220,0,-2,18,8,10,0,0,0,1,1,0,1,1,0,2,2,0,0,0,0,14,4,10,0,0,0,0,0,0,0,0,0
149781,22000,220,0,-2,1,1,0,0,0,0,0,0,0,0,0,0,0,0,0,0,0,0,1,1,0,0,0,0,0,0,0,0,0,0
150163,22000,220,0,-2,4,2,2,0,0,0,2,1,1,0,0,0,0,0,0,0,0,0,2,1,1,0,0,0,0,0,0,0,0,0
151111,22000,220,0,-2,91,56,35,0,0,0,6,3,3,4,1,3,3,1,2,0,0,0,21,10,11,3,2,1,0,0,0,54,39,15
151351,22000,220,0,-2,97,47,50,1,0,1,5,3,2,0,0,0,7,2,5,0,0,0,34,17,17,1,0,1,0,0,0,49,25,24
151360,22000,220,0,-2,1,1,0,0,0,0,0,0,0,0,0,0,0,0,0,0,0,0,0,0,0,0,0,0,0,0,0,1,1,0
152080,22000,220,0,-2,111,69,42,0,0,0,2,1,1,1,0,1,1,0,1,0,0,0,38,23,15,2,1,1,2,2,0,65,42,23
153603,22000,220,0,-2,155,93,62,0,0,0,6,2,4,1,0,1,6,4,2,0,0,0,64,31,33,1,1,0,0,0,0,77,55,22
153658,22000,220,0,-2,80,47,33,0,0,0,2,0,2,1,1,0,2,1,1,0,0,0,15,7,8,0,0,0,8,2,6,52,36,16
154174,22000,220,0,-2,2,1,1,0,0,0,0,0,0,0,0,0,0,0,0,0,0,0,2,1,1,0,0,0,0,0,0,0,0,0
155089,22000,220,0,-2,1,1,0,0,0,0,0,0,0,0,0,0,0,0,0,0,0,0,1,1,0,0,0,0,0,0,0,0,0,0
155317,22000,220,0,-2,247,81,166,1,0,1,18,8,10,13,3,10,20,5,15,0,0,0,130,37,93,11,2,9,9,1,8,45,25,20
155399,22000,220,0,-2,5,2,3,0,0,0,1,1,0,0,0,0,0,0,0,0,0,0,3,0,3,0,0,0,0,0,0,1,1,0
157085,22000,220,0,-2,98,53,45,0,0,0,6,4,2,1,0,1,3,2,1,0,0,0,19,10,9,2,1,1,0,0,0,67,36,31
157289,22000,220,0,-2,30,19,11,0,0,0,5,2,3,1,0,1,2,1,1,0,0,0,17,12,5,0,0,0,1,1,0,4,3,1
159373,22000,220,0,-2,13,3,10,0,0,0,3,1,2,2,0,2,0,0,0,0,0,0,5,2,3,0,0,0,0,0,0,3,0,3
159391,22000,220,0,-2,9,7,2,0,0,0,2,2,0,0,0,0,1,0,1,0,0,0,3,3,0,0,0,0,1,0,1,2,2,0
159647,22000,220,0,-2,1,1,0,0,0,0,0,0,0,0,0,0,0,0,0,0,0,0,0,0,0,0,0,0,0,0,0,1,1,0
159939,22000,220,0,-2,2,1,1,0,0,0,0,0,0,1,0,1,0,0,0,0,0,0,0,0,0,0,0,0,0,0,0,1,1,0
160621,22000,220,0,-2,3,2,1,0,0,0,0,0,0,2,1,1,1,1,0,0,0,0,0,0,0,0,0,0,0,0,0,0,0,0
160755,22000,220,0,-2,7,3,4,0,0,0,1,0,1,1,1,0,0,0,0,0,0,0,4,2,2,0,0,0,0,0,0,1,0,1
161253,22000,220,0,-2,5,2,3,0,0,0,1,0,1,0,0,0,0,0,0,0,0,0,3,1,2,0,0,0,0,0,0,1,1,0
161457,22000,220,0,-2,11,3,8,0,0,0,0,0,0,0,0,0,1,0,1,0,0,0,10,3,7,0,0,0,0,0,0,0,0,0
162928,22000,220,0,-2,140,63,77,7,2,5,26,11,15,8,2,6,5,2,3,0,0,0,68,32,36,1,1,0,0,0,0,25,13,12
163259,22000,220,0,-2,131,73,58,0,0,0,20,13,7,10,6,4,4,2,2,0,0,0,34,16,18,3,0,3,0,0,0,60,36,24
163268,22000,220,0,-2,19,11,8,0,0,0,0,0,0,2,0,2,1,1,0,0,0,0,9,6,3,0,0,0,2,1,1,5,3,2
163286,22000,220,0,-2,263,144,119,0,0,0,24,9,15,10,4,6,11,6,5,0,0,0,101,48,53,2,0,2,22,14,8,93,63,30
163338,22000,220,0,-2,1,0,1,0,0,0,0,0,0,1,0,1,0,0,0,0,0,0,0,0,0,0,0,0,0,0,0,0,0,0
163453,22000,220,0,-2,3,2,1,0,0,0,0,0,0,1,0,1,0,0,0,0,0,0,0,0,0,0,0,0,1,1,0,1,1,0
164076,22000,220,0,-2,1,1,0,0,0,0,1,1,0,0,0,0,0,0,0,0,0,0,0,0,0,0,0,0,0,0,0,0,0,0
164155,22000,220,0,-2,8,7,1,0,0,0,0,0,0,0,0,0,1,0,1,0,0,0,6,6,0,0,0,0,1,1,0,0,0,0
164924,22000,220,0,-2,83,33,50,0,0,0,3,2,1,6,3,3,2,1,1,0,0,0,38,9,29,1,0,1,4,1,3,29,17,12
164988,22000,220,0,-2,204,97,107,0,0,0,20,10,10,6,2,4,7,2,5,0,0,0,64,30,34,3,0,3,8,4,4,96,49,47
165015,22000,220,0,-2,6,3,3,0,0,0,0,0,0,1,1,0,1,0,1,0,0,0,3,1,2,0,0,0,0,0,0,1,1,0
165334,22000,220,0,-2,1,1,0,0,0,0,0,0,0,0,0,0,0,0,0,0,0,0,0,0,0,0,0,0,0,0,0,1,1,0
166027,22000,220,0,-2,584,335,249,1,0,1,58,33,25,14,7,7,21,9,12,0,0,0,164,92,72,7,1,6,3,1,2,316,192,124
166513,22000,220,0,-2,24,15,9,0,0,0,1,1,0,0,0,0,0,0,0,0,0,0,3,1,2,1,0,1,1,1,0,18,12,6
166629,22000,220,0,-2,93,48,45,0,0,0,2,2,0,1,0,1,4,1,3,0,0,0,35,18,17,0,0,0,0,0,0,51,27,24
166683,22000,220,0,-2,823,541,282,0,0,0,74,40,34,15,6,9,20,8,12,0,0,0,270,177,93,8,2,6,33,26,7,403,282,121
166708,22000,220,0,-2,172,58,114,0,0,0,27,14,13,11,4,7,12,5,7,0,0,0,98,29,69,0,0,0,5,2,3,19,4,15
166717,22000,220,0,-2,3,0,3,0,0,0,0,0,0,0,0,0,0,0,0,0,0,0,0,0,0,0,0,0,3,0,3,0,0,0
166869,22000,220,0,-2,3,1,2,0,0,0,0,0,0,0,0,0,0,0,0,0,0,0,3,1,2,0,0,0,0,0,0,0,0,0
167358,22000,220,0,-2,84,63,21,0,0,0,12,7,5,1,1,0,0,0,0,0,0,0,19,13,6,0,0,0,11,9,2,41,33,8
167525,22000,220,0,-2,2,2,0,0,0,0,1,1,0,0,0,0,0,0,0,0,0,0,1,1,0,0,0,0,0,0,0,0,0,0
168148,22000,220,0,-2,89,41,48,0,0,0,15,6,9,7,5,2,14,6,8,0,0,0,31,14,17,2,2,0,4,2,2,16,6,10
168421,22000,220,0,-2,22,15,7,0,0,0,1,0,1,0,0,0,0,0,0,0,0,0,0,0,0,0,0,0,2,2,0,19,13,6
169248,22000,220,0,-2,1,1,0,0,0,0,1,1,0,0,0,0,0,0,0,0,0,0,0,0,0,0,0,0,0,0,0,0,0,0
171100,22000,220,0,-2,131,82,49,0,0,0,3,3,0,3,1,2,5,3,2,0,0,0,35,19,16,0,0,0,0,0,0,85,56,29
171128,22000,220,0,-2,15,13,2,0,0,0,0,0,0,0,0,0,1,1,0,0,0,0,6,5,1,0,0,0,7,6,1,1,1,0
171571,22000,220,0,-2,1,0,1,0,0,0,0,0,0,0,0,0,0,0,0,0,0,0,1,0,1,0,0,0,0,0,0,0,0,0
172644,22000,220,0,-2,139,54,85,0,0,0,16,3,13,5,3,2,6,3,3,0,0,0,54,19,35,8,2,6,2,1,1,48,23,25
172699,22000,220,0,-2,1,1,0,0,0,0,0,0,0,0,0,0,0,0,0,0,0,0,1,1,0,0,0,0,0,0,0,0,0,0
174066,22000,220,0,-2,355,201,154,1,0,1,40,28,12,7,6,1,10,4,6,0,0,0,116,61,55,7,2,5,38,17,21,136,83,53
174233,22000,220,0,-2,3,2,1,0,0,0,0,0,0,0,0,0,0,0,0,0,0,0,2,1,1,0,0,0,0,0,0,1,1,0
175856,22000,220,0,-2,12,5,7,1,0,1,1,0,1,5,1,4,1,1,0,0,0,0,3,2,1,0,0,0,0,0,0,1,1,0
175883,22000,220,0,-2,1,0,1,0,0,0,0,0,0,0,0,0,0,0,0,0,0,0,1,0,1,0,0,0,0,0,0,0,0,0
176071,22000,220,0,-2,1,1,0,0,0,0,0,0,0,0,0,0,0,0,0,0,0,0,0,0,0,0,0,0,1,1,0,0,0,0
176080,22000,220,0,-2,4,2,2,0,0,0,1,0,1,0,0,0,1,0,1,0,0,0,0,0,0,0,0,0,0,0,0,2,2,0
176628,22000,220,0,-2,1,1,0,0,0,0,0,0,0,0,0,0,0,0,0,0,0,0,1,1,0,0,0,0,0,0,0,0,0,0
177940,22000,220,0,-2,3,3,0,0,0,0,2,2,0,0,0,0,0,0,0,0,0,0,1,1,0,0,0,0,0,0,0,0,0,0
178396,22000,220,0,-2,5,5,0,0,0,0,0,0,0,1,1,0,0,0,0,0,0,0,3,3,0,0,0,0,1,1,0,0,0,0
178402,22000,220,0,-2,4,3,1,0,0,0,1,1,0,0,0,0,1,1,0,0,0,0,2,1,1,0,0,0,0,0,0,0,0,0
178411,22000,220,0,-2,3,2,1,0,0,0,1,1,0,0,0,0,0,0,0,0,0,0,0,0,0,0,0,0,0,0,0,2,1,1
178420,22000,220,0,-2,1,1,0,0,0,0,0,0,0,0,0,0,0,0,0,0,0,0,1,1,0,0,0,0,0,0,0,0,0,0
179159,22000,220,0,-2,27,16,11,0,0,0,1,1,0,0,0,0,1,1,0,0,0,0,10,5,5,0,0,0,0,0,0,15,9,6
179867,22000,220,0,-2,257,172,85,0,0,0,66,46,20,10,6,4,12,8,4,1,1,0,69,45,24,2,2,0,1,1,0,96,63,33
180054,22000,220,0,-2,1,0,1,1,0,1,0,0,0,0,0,0,0,0,0,0,0,0,0,0,0,0,0,0,0,0,0,0,0,0
180416,22000,220,0,-2,2,0,2,0,0,0,0,0,0,0,0,0,0,0,0,0,0,0,2,0,2,0,0,0,0,0,0,0,0,0
180461,22000,220,0,-2,55,31,24,1,0,1,3,3,0,0,0,0,1,0,1,0,0,0,35,17,18,3,2,1,3,3,0,9,6,3
180489,22000,220,0,-2,1,1,0,0,0,0,0,0,0,0,0,0,0,0,0,0,0,0,1,1,0,0,0,0,0,0,0,0,0,0
181312,22000,220,0,-2,1,1,0,0,0,0,0,0,0,0,0,0,0,0,0,0,0,0,1,1,0,0,0,0,0,0,0,0,0,0
181394,22000,220,0,-2,2,2,0,0,0,0,0,0,0,0,0,0,0,0,0,0,0,0,2,2,0,0,0,0,0,0,0,0,0,0
181428,22000,220,0,-2,13,9,4,0,0,0,2,2,0,0,0,0,0,0,0,0,0,0,9,6,3,0,0,0,1,1,0,1,0,1
181464,22000,220,0,-2,60,42,18,0,0,0,3,3,0,0,0,0,2,1,1,0,0,0,15,7,8,0,0,0,0,0,0,40,31,9
182281,22000,220,0,-2,7,4,3,0,0,0,0,0,0,0,0,0,0,0,0,0,0,0,6,3,3,0,0,0,0,0,0,1,1,0
182290,22000,220,0,-2,12,6,6,0,0,0,1,0,1,0,0,0,1,0,1,0,0,0,6,2,4,0,0,0,0,0,0,4,4,0
182670,22000,220,0,-2,1,0,1,0,0,0,0,0,0,0,0,0,0,0,0,0,0,0,1,0,1,0,0,0,0,0,0,0,0,0
183044,22000,220,0,-2,39,20,19,0,0,0,3,1,2,0,0,0,4,3,1,0,0,0,11,4,7,1,0,1,0,0,0,20,12,8
183062,22000,220,0,-2,1,0,1,0,0,0,0,0,0,0,0,0,0,0,0,0,0,0,1,0,1,0,0,0,0,0,0,0,0,0
183974,22000,220,0,-2,1,0,1,0,0,0,0,0,0,0,0,0,0,0,0,0,0,0,1,0,1,0,0,0,0,0,0,0,0,0
185828,22000,220,0,-2,12,8,4,0,0,0,1,1,0,0,0,0,1,0,1,0,0,0,3,1,2,0,0,0,1,1,0,6,5,1
186371,22000,220,0,-2,4,1,3,0,0,0,0,0,0,0,0,0,0,0,0,0,0,0,0,0,0,0,0,0,2,1,1,2,0,2
186380,22000,220,0,-2,291,130,161,0,0,0,7,2,5,6,2,4,4,1,3,0,0,0,15,6,9,2,1,1,193,78,115,64,40,24
186399,22000,220,0,-2,20,12,8,0,0,0,0,0,0,1,0,1,0,0,0,0,0,0,2,1,1,0,0,0,3,1,2,14,10,4
186867,22000,220,0,-2,11,8,3,0,0,0,1,0,1,0,0,0,1,1,0,0,0,0,2,2,0,0,0,0,0,0,0,7,5,2
187985,22000,220,0,-2,44,20,24,0,0,0,4,2,2,0,0,0,4,1,3,0,0,0,16,7,9,0,0,0,0,0,0,20,10,10
188526,22000,220,0,-2,13,5,8,0,0,0,1,0,1,1,0,1,0,0,0,0,0,0,7,3,4,1,0,1,0,0,0,3,2,1
190150,22000,220,0,-2,523,278,245,0,0,0,34,14,20,21,9,12,21,9,12,0,0,0,100,56,44,4,2,2,6,2,4,337,186,151
190415,22000,220,0,-2,305,174,131,1,0,1,10,6,4,8,1,7,14,6,8,0,0,0,107,57,50,4,2,2,0,0,0,161,102,59
192785,22000,220,0,-2,1,0,1,0,0,0,0,0,0,0,0,0,0,0,0,0,0,0,1,0,1,0,0,0,0,0,0,0,0,0
193830,22000,220,0,-2,10,6,4,0,0,0,4,2,2,2,1,1,0,0,0,0,0,0,4,3,1,0,0,0,0,0,0,0,0,0
193900,22000,220,0,-2,372,133,239,1,0,1,47,14,33,28,9,19,35,11,24,1,0,1,107,35,72,8,1,7,42,10,32,103,53,50
194824,22000,220,0,-2,21,11,10,0,0,0,12,8,4,1,1,0,0,0,0,0,0,0,8,2,6,0,0,0,0,0,0,0,0,0
195003,22000,220,0,-2,1,0,1,0,0,0,0,0,0,1,0,1,0,0,0,0,0,0,0,0,0,0,0,0,0,0,0,0,0,0
195030,22000,220,0,-2,109,75,34,0,0,0,7,4,3,4,2,2,0,0,0,0,0,0,34,23,11,0,0,0,0,0,0,64,46,18
195049,22000,220,0,-2,38,27,11,0,0,0,1,1,0,0,0,0,3,2,1,0,0,0,14,11,3,1,1,0,0,0,0,19,12,7
195526,22000,220,0,-2,2,2,0,0,0,0,0,0,0,0,0,0,0,0,0,0,0,0,2,2,0,0,0,0,0,0,0,0,0,0
196079,22000,220,0,-2,14,7,7,0,0,0,1,0,1,0,0,0,0,0,0,0,0,0,11,5,6,1,1,0,0,0,0,1,1,0
196088,22000,220,0,-2,7,4,3,0,0,0,0,0,0,3,1,2,4,3,1,0,0,0,0,0,0,0,0,0,0,0,0,0,0,0
196097,22000,220,0,-2,13,9,4,0,0,0,1,1,0,1,0,1,0,0,0,0,0,0,5,3,2,0,0,0,1,1,0,5,4,1
196413,22000,220,0,-2,22,12,10,1,1,0,3,1,2,0,0,0,1,0,1,0,0,0,4,1,3,0,0,0,0,0,0,13,9,4
199102,22000,220,0,-2,10,6,4,0,0,0,0,0,0,1,1,0,0,0,0,0,0,0,0,0,0,0,0,0,0,0,0,9,5,4
199120,22000,220,0,-2,24,10,14,0,0,0,0,0,0,2,0,2,1,1,0,0,0,0,16,5,11,0,0,0,2,1,1,3,3,0
199148,22000,220,0,-2,7,7,0,0,0,0,0,0,0,0,0,0,0,0,0,0,0,0,4,4,0,0,0,0,0,0,0,3,3,0
199193,22000,220,0,-2,6,3,3,0,0,0,2,1,1,0,0,0,0,0,0,0,0,0,3,2,1,0,0,0,0,0,0,1,0,1
199218,22000,220,0,-2,4,1,3,0,0,0,0,0,0,0,0,0,0,0,0,0,0,0,1,0,1,0,0,0,3,1,2,0,0,0
199847,22000,220,0,-2,7,3,4,0,0,0,0,0,0,0,0,0,0,0,0,0,0,0,3,1,2,0,0,0,0,0,0,4,2,2
200253,22000,220,0,-2,9,1,8,0,0,0,0,0,0,0,0,0,0,0,0,0,0,0,9,1,8,0,0,0,0,0,0,0,0,0
200332,22000,220,0,-2,26,20,6,0,0,0,2,2,0,0,0,0,1,0,1,0,0,0,4,2,2,0,0,0,2,2,0,17,14,3
201441,22000,220,0,-2,1,1,0,0,0,0,0,0,0,0,0,0,0,0,0,0,0,0,1,1,0,0,0,0,0,0,0,0,0,0
201645,22000,220,0,-2,86,41,45,0,0,0,38,20,18,8,2,6,3,2,1,0,0,0,29,13,16,0,0,0,1,1,0,7,3,4
201690,22000,220,0,-2,4,3,1,0,0,0,2,2,0,1,1,0,0,0,0,0,0,0,1,0,1,0,0,0,0,0,0,0,0,0
201885,22000,220,0,-2,13,6,7,0,0,0,3,2,1,1,1,0,0,0,0,0,0,0,4,1,3,0,0,0,2,0,2,3,2,1
204796,22000,220,0,-2,9,7,2,0,0,0,4,3,1,0,0,0,2,2,0,0,0,0,3,2,1,0,0,0,0,0,0,0,0,0
206084,22000,220,0,-2,18,15,3,0,0,0,11,9,2,0,0,0,0,0,0,0,0,0,7,6,1,0,0,0,0,0,0,0,0,0
206604,22000,220,0,-2,2,1,1,0,0,0,0,0,0,0,0,0,0,0,0,0,0,0,0,0,0,0,0,0,0,0,0,2,1,1
207500,22000,220,0,-2,43,27,16,0,0,0,1,1,0,0,0,0,5,4,1,0,0,0,16,8,8,0,0,0,0,0,0,21,14,7
207971,22000,220,0,-2,2,1,1,0,0,0,0,0,0,0,0,0,0,0,0,0,0,0,1,0,1,1,1,0,0,0,0,0,0,0
209038,22000,220,0,-2,1,1,0,0,0,0,0,0,0,0,0,0,0,0,0,0,0,0,1,1,0,0,0,0,0,0,0,0,0,0
209490,22000,220,0,-2,56,19,37,0,0,0,6,1,5,1,1,0,5,2,3,0,0,0,19,6,13,2,0,2,5,2,3,18,7,11
209542,22000,220,0,-2,133,72,61,0,0,0,5,4,1,0,0,0,4,2,2,0,0,0,42,22,20,6,1,5,41,22,19,35,21,14
209551,22000,220,0,-2,66,33,33,0,0,0,2,1,1,1,0,1,3,2,1,0,0,0,39,17,22,1,0,1,2,1,1,18,12,6
209612,22000,220,0,-2,1,0,1,0,0,0,0,0,0,0,0,0,0,0,0,0,0,0,0,0,0,0,0,0,0,0,0,1,0,1
209807,22000,220,0,-2,3,2,1,0,0,0,1,1,0,0,0,0,1,1,0,0,0,0,1,0,1,0,0,0,0,0,0,0,0,0
210234,22000,220,0,-2,1,0,1,0,0,0,0,0,0,0,0,0,0,0,0,0,0,0,0,0,0,0,0,0,1,0,1,0,0,0
210809,22000,220,0,-2,2,0,2,0,0,0,0,0,0,0,0,0,0,0,0,0,0,0,2,0,2,0,0,0,0,0,0,0,0,0
211440,22000,220,0,-2,5,5,0,0,0,0,0,0,0,0,0,0,0,0,0,0,0,0,2,2,0,0,0,0,1,1,0,2,2,0
212054,22000,220,0,-2,26,10,16,0,0,0,1,0,1,0,0,0,0,0,0,0,0,0,10,3,7,1,0,1,1,0,1,13,7,6
212911,22000,220,0,-2,3,0,3,0,0,0,0,0,0,0,0,0,1,0,1,0,0,0,2,0,2,0,0,0,0,0,0,0,0,0
213233,22000,220,0,-2,1,0,1,0,0,0,0,0,0,0,0,0,0,0,0,0,0,0,1,0,1,0,0,0,0,0,0,0,0,0
215062,22000,220,0,-2,474,264,210,0,0,0,58,28,30,18,5,13,17,6,11,0,0,0,111,58,53,5,2,3,41,23,18,224,142,82
215123,22000,220,0,-2,4,1,3,0,0,0,0,0,0,0,0,0,0,0,0,0,0,0,2,0,2,1,1,0,1,0,1,0,0,0
215132,22000,220,0,-2,1,1,0,0,0,0,0,0,0,0,0,0,0,0,0,0,0,0,1,1,0,0,0,0,0,0,0,0,0,0
215293,22000,220,0,-2,220,115,105,0,0,0,5,4,1,2,0,2,5,3,2,0,0,0,53,25,28,1,0,1,10,3,7,144,80,64
216366,22000,220,0,-2,5,2,3,0,0,0,0,0,0,0,0,0,0,0,0,0,0,0,2,1,1,1,0,1,0,0,0,2,1,1
216597,22000,220,0,-2,5,4,1,0,0,0,0,0,0,0,0,0,0,0,0,0,0,0,1,0,1,0,0,0,0,0,0,4,4,0
217156,22000,220,0,-2,169,87,82,1,1,0,19,12,7,6,2,4,7,5,2,0,0,0,51,19,32,2,0,2,13,8,5,70,40,30
217165,22000,220,0,-2,1,0,1,0,0,0,0,0,0,0,0,0,0,0,0,0,0,0,0,0,0,1,0,1,0,0,0,0,0,0
217484,22000,220,0,-2,1,0,1,0,0,0,0,0,0,0,0,0,0,0,0,0,0,0,1,0,1,0,0,0,0,0,0,0,0,0
217882,22000,220,0,-2,61,40,21,0,0,0,2,1,1,0,0,0,0,0,0,0,0,0,32,20,12,0,0,0,0,0,0,27,19,8
218335,22000,220,0,-2,28,17,11,0,0,0,2,2,0,1,0,1,1,0,1,0,0,0,24,15,9,0,0,0,0,0,0,0,0,0
218663,22000,220,0,-2,83,48,35,0,0,0,3,1,2,2,1,1,3,2,1,0,0,0,18,8,10,0,0,0,0,0,0,57,36,21
218733,22000,220,0,-2,3,1,2,0,0,0,1,1,0,2,0,2,0,0,0,0,0,0,0,0,0,0,0,0,0,0,0,0,0,0
219356,22000,220,0,-2,7,3,4,0,0,0,1,0,1,0,0,0,0,0,0,0,0,0,4,1,3,0,0,0,0,0,0,2,2,0
220075,22000,220,0,-2,8,2,6,0,0,0,0,0,0,0,0,0,0,0,0,0,0,0,4,0,4,0,0,0,1,0,1,3,2,1
220862,22000,220,0,-2,14,12,2,0,0,0,7,5,2,0,0,0,0,0,0,0,0,0,6,6,0,0,0,0,0,0,0,1,1,0
220978,22000,220,0,-2,3,2,1,0,0,0,1,1,0,0,0,0,1,1,0,0,0,0,1,0,1,0,0,0,0,0,0,0,0,0
221759,22000,220,0,-2,4,1,3,0,0,0,0,0,0,0,0,0,1,0,1,0,0,0,3,1,2,0,0,0,0,0,0,0,0,0
221768,22000,220,0,-2,1,0,1,0,0,0,0,0,0,0,0,0,0,0,0,0,0,0,1,0,1,0,0,0,0,0,0,0,0,0
221838,22000,220,0,-2,1,1,0,0,0,0,0,0,0,0,0,0,0,0,0,0,0,0,1,1,0,0,0,0,0,0,0,0,0,0
221847,22000,220,0,-2,5,5,0,0,0,0,0,0,0,0,0,0,0,0,0,0,0,0,3,3,0,0,0,0,0,0,0,2,2,0
221999,22000,220,0,-2,27,11,16,0,0,0,3,1,2,1,0,1,2,1,1,0,0,0,6,3,3,0,0,0,6,1,5,9,5,4
223223,22000,220,0,-2,495,151,344,0,0,0,120,38,82,66,15,51,81,25,56,3,2,1,123,37,86,25,7,18,77,27,50,0,0,0
225414,22000,220,0,-2,2,0,2,0,0,0,1,0,1,0,0,0,0,0,0,0,0,0,1,0,1,0,0,0,0,0,0,0,0,0
225511,22000,220,0,-2,8,3,5,0,0,0,3,2,1,2,0,2,0,0,0,0,0,0,1,0,1,0,0,0,0,0,0,2,1,1
227216,22000,220,0,-2,22,13,9,0,0,0,8,6,2,0,0,0,2,2,0,1,0,1,4,2,2,1,0,1,1,0,1,5,3,2
227368,22000,220,0,-2,13,6,7,0,0,0,0,0,0,0,0,0,4,2,2,0,0,0,5,2,3,0,0,0,0,0,0,4,2,2
228246,22000,220,0,-2,38,24,14,0,0,0,10,8,2,1,1,0,0,0,0,0,0,0,17,9,8,0,0,0,0,0,0,10,6,4
228459,22000,220,0,-2,18,11,7,0,0,0,5,5,0,1,1,0,2,0,2,0,0,0,4,2,2,1,1,0,5,2,3,0,0,0
228644,22000,220,0,-2,18,12,6,0,0,0,5,4,1,0,0,0,2,1,1,0,0,0,7,4,3,0,0,0,3,2,1,1,1,0
228653,22000,220,0,-2,2,0,2,0,0,0,0,0,0,0,0,0,0,0,0,0,0,0,2,0,2,0,0,0,0,0,0,0,0,0
228705,22000,220,0,-2,1,1,0,0,0,0,0,0,0,0,0,0,1,1,0,0,0,0,0,0,0,0,0,0,0,0,0,0,0,0
228723,22000,220,0,-2,99,63,36,0,0,0,43,32,11,5,3,2,8,5,3,0,0,0,28,16,12,0,0,0,9,5,4,6,2,4
228769,22000,220,0,-2,36,25,11,0,0,0,13,10,3,0,0,0,1,1,0,0,0,0,7,5,2,2,1,1,7,3,4,6,5,1
228787,22000,220,0,-2,31,19,12,0,0,0,11,9,2,1,0,1,1,0,1,0,0,0,12,7,5,0,0,0,5,2,3,1,1,0
228796,22000,220,0,-2,4,2,2,0,0,0,0,0,0,0,0,0,2,1,1,0,0,0,1,0,1,0,0,0,0,0,0,1,1,0
228802,22000,220,0,-2,15,10,5,0,0,0,2,1,1,2,1,1,0,0,0,0,0,0,3,2,1,0,0,0,0,0,0,8,6,2
228875,22000,220,0,-2,12,3,9,0,0,0,0,0,0,5,2,3,1,0,1,0,0,0,6,1,5,0,0,0,0,0,0,0,0,0
228909,22000,220,0,-2,18,5,13,0,0,0,3,2,1,2,1,1,4,0,4,0,0,0,5,2,3,1,0,1,1,0,1,2,0,2
229027,22000,220,0,-2,31,16,15,0,0,0,2,2,0,0,0,0,5,2,3,0,0,0,4,0,4,0,0,0,5,2,3,15,10,5
229115,22000,220,0,-2,32,25,7,0,0,0,2,1,1,0,0,0,2,2,0,0,0,0,8,6,2,0,0,0,0,0,0,20,16,4
229267,22000,220,0,-2,1,0,1,0,0,0,0,0,0,0,0,0,0,0,0,0,0,0,1,0,1,0,0,0,0,0,0,0,0,0
230038,22000,220,0,-2,1,1,0,0,0,0,0,0,0,0,0,0,0,0,0,0,0,0,0,0,0,1,1,0,0,0,0,0,0,0
230764,22000,220,0,-2,206,111,95,0,0,0,11,5,6,1,1,0,14,3,11,0,0,0,82,46,36,1,0,1,11,6,5,86,50,36
231147,22000,220,0,-2,1,1,0,0,0,0,0,0,0,0,0,0,0,0,0,0,0,0,0,0,0,1,1,0,0,0,0,0,0,0
231174,22000,220,0,-2,57,26,31,0,0,0,4,1,3,0,0,0,2,0,2,0,0,0,30,13,17,1,1,0,3,2,1,17,9,8
231624,22000,220,0,-2,10,6,4,0,0,0,0,0,0,0,0,0,1,0,1,0,0,0,3,1,2,0,0,0,1,1,0,5,4,1
231712,22000,220,0,-2,1,0,1,0,0,0,0,0,0,0,0,0,0,0,0,0,0,0,1,0,1,0,0,0,0,0,0,0,0,0
231970,22000,220,0,-2,20,4,16,0,0,0,4,0,4,3,0,3,0,0,0,0,0,0,12,4,8,1,0,1,0,0,0,0,0,0
232186,22000,220,0,-2,48,26,22,0,0,0,6,3,3,1,0,1,3,2,1,0,0,0,19,11,8,1,0,1,0,0,0,18,10,8
232982,22000,220,0,-2,1,0,1,0,0,0,0,0,0,0,0,0,0,0,0,0,0,0,1,0,1,0,0,0,0,0,0,0,0,0
233921,22000,220,0,-2,156,110,46,1,1,0,9,8,1,4,3,1,3,3,0,0,0,0,57,37,20,1,1,0,0,0,0,81,57,24
234030,22000,220,0,-2,63,26,37,0,0,0,1,0,1,5,0,5,1,0,1,0,0,0,15,3,12,0,0,0,1,1,0,40,22,18
234076,22000,220,0,-2,17,7,10,0,0,0,2,0,2,1,0,1,0,0,0,0,0,0,6,5,1,0,0,0,2,0,2,6,2,4
234155,22000,220,0,-2,1,1,0,0,0,0,0,0,0,1,1,0,0,0,0,0,0,0,0,0,0,0,0,0,0,0,0,0,0,0
235750,22000,220,0,-2,1,0,1,0,0,0,0,0,0,0,0,0,0,0,0,0,0,0,0,0,0,1,0,1,0,0,0,0,0,0
236939,22000,220,0,-2,3,3,0,0,0,0,1,1,0,0,0,0,0,0,0,0,0,0,1,1,0,0,0,0,1,1,0,0,0,0
236948,22000,220,0,-2,586,247,339,1,0,1,70,16,54,11,2,9,33,11,22,0,0,0,250,98,152,24,6,18,38,15,23,159,99,60
237880,22000,220,0,-2,2,1,1,0,0,0,0,0,0,0,0,0,1,1,0,0,0,0,1,0,1,0,0,0,0,0,0,0,0,0
238032,22000,220,0,-2,13,9,4,0,0,0,2,2,0,0,0,0,0,0,0,0,0,0,5,2,3,0,0,0,0,0,0,6,5,1
239105,22000,220,0,-2,3,2,1,0,0,0,1,0,1,0,0,0,0,0,0,0,0,0,0,0,0,0,0,0,0,0,0,2,2,0
240444,22000,220,0,-2,20,15,5,0,0,0,3,2,1,0,0,0,2,1,1,0,0,0,8,7,1,0,0,0,3,2,1,4,3,1
240727,22000,220,0,-2,45,21,24,0,0,0,6,1,5,0,0,0,1,0,1,0,0,0,14,5,9,0,0,0,12,4,8,12,11,1
240754,22000,220,0,-2,1,1,0,0,0,0,0,0,0,0,0,0,0,0,0,1,1,0,0,0,0,0,0,0,0,0,0,0,0,0
243081,22000,220,0,-2,24,5,19,0,0,0,0,0,0,0,0,0,24,5,19,0,0,0,0,0,0,0,0,0,0,0,0,0,0,0
243160,22000,220,0,-2,6,2,4,0,0,0,0,0,0,0,0,0,1,0,1,1,0,1,0,0,0,0,0,0,3,1,2,1,1,0
243197,22000,220,0,-2,3,1,2,0,0,0,0,0,0,0,0,0,0,0,0,0,0,0,0,0,0,0,0,0,3,1,2,0,0,0
243568,22000,220,0,-2,3,0,3,0,0,0,0,0,0,0,0,0,3,0,3,0,0,0,0,0,0,0,0,0,0,0,0,0,0,0
243647,22000,220,0,-2,1,0,1,0,0,0,0,0,0,0,0,0,0,0,0,1,0,1,0,0,0,0,0,0,0,0,0,0,0,0
243744,22000,220,0,-2,163,104,59,0,0,0,27,17,10,3,2,1,5,3,2,0,0,0,46,29,17,5,2,3,19,17,2,58,34,24
243780,22000,220,0,-2,145,105,40,2,2,0,3,3,0,5,3,2,0,0,0,0,0,0,22,10,12,4,1,3,0,0,0,109,86,23
244446,22000,220,0,-2,1,0,1,0,0,0,0,0,0,0,0,0,0,0,0,0,0,0,1,0,1,0,0,0,0,0,0,0,0,0
248934,22000,220,0,-2,1,0,1,0,0,0,1,0,1,0,0,0,0,0,0,0,0,0,0,0,0,0,0,0,0,0,0,0,0,0
376695,22000,220,0,-2,2,2,0,0,0,0,0,0,0,0,0,0,0,0,0,2,2,0,0,0,0,0,0,0,0,0,0,0,0,0
377555,22000,220,0,-2,3,0,3,0,0,0,0,0,0,0,0,0,0,0,0,0,0,0,0,0,0,0,0,0,0,0,0,3,0,3
377564,22000,220,0,-2,4,2,2,0,0,0,1,1,0,0,0,0,0,0,0,0,0,0,1,0,1,0,0,0,0,0,0,2,1,1
380377,22000,220,0,-2,1,0,1,1,0,1,0,0,0,0,0,0,0,0,0,0,0,0,0,0,0,0,0,0,0,0,0,0,0,0
385415,22000,220,0,-2,68,33,35,0,0,0,7,4,3,0,0,0,2,1,1,0,0,0,24,13,11,0,0,0,0,0,0,35,15,20
416801,22000,220,0,-2,1,0,1,0,0,0,0,0,0,0,0,0,0,0,0,0,0,0,1,0,1,0,0,0,0,0,0,0,0,0
420246,22000,220,0,-2,4,2,2,0,0,0,0,0,0,1,1,0,0,0,0,0,0,0,3,1,2,0,0,0,0,0,0,0,0,0
423643,22000,220,0,-2,12,2,10,0,0,0,1,0,1,0,0,0,2,1,1,0,0,0,7,1,6,1,0,1,1,0,1,0,0,0
435000,22000,220,0,-2,1,0,1,0,0,0,0,0,0,0,0,0,0,0,0,0,0,0,1,0,1,0,0,0,0,0,0,0,0,0
440031,22000,220,0,-2,11,7,4,0,0,0,7,5,2,0,0,0,0,0,0,0,0,0,2,0,2,1,1,0,1,1,0,0,0,0
445188,22000,220,0,-2,38,18,20,0,0,0,2,1,1,0,0,0,6,2,4,0,0,0,10,3,7,1,1,0,1,1,0,18,10,8
445735,22000,220,0,-2,2,2,0,0,0,0,0,0,0,0,0,0,0,0,0,0,0,0,2,2,0,0,0,0,0,0,0,0,0,0
446640,22000,220,0,-2,2,0,2,0,0,0,1,0,1,0,0,0,0,0,0,0,0,0,1,0,1,0,0,0,0,0,0,0,0,0
455406,22000,220,0,-2,1,0,1,0,0,0,0,0,0,0,0,0,0,0,0,0,0,0,1,0,1,0,0,0,0,0,0,0,0,0
460376,22000,220,0,-2,4,1,3,0,0,0,0,0,0,0,0,0,0,0,0,0,0,0,3,0,3,1,1,0,0,0,0,0,0,0
475033,22000,220,0,-2,2,1,1,0,0,0,1,0,1,0,0,0,0,0,0,0,0,0,1,1,0,0,0,0,0,0,0,0,0,0
481030,22000,220,0,-2,2,1,1,0,0,0,0,0,0,0,0,0,0,0,0,0,0,0,2,1,1,0,0,0,0,0,0,0,0,0
481535,22000,220,0,-2,57,18,39,0,0,0,9,1,8,0,0,0,8,7,1,0,0,0,16,6,10,3,1,2,0,0,0,21,3,18
482149,22000,220,0,-2,11,7,4,0,0,0,1,1,0,0,0,0,2,1,1,0,0,0,6,4,2,0,0,0,0,0,0,2,1,1
484905,22000,220,0,-2,1,0,1,0,0,0,0,0,0,1,0,1,0,0,0,0,0,0,0,0,0,0,0,0,0,0,0,0,0,0
487010,22000,220,0,-2,67,33,34,0,0,0,1,0,1,2,1,1,2,1,1,0,0,0,10,3,7,0,0,0,0,0,0,52,28,24
487092,22000,220,0,-2,1,0,1,0,0,0,0,0,0,1,0,1,0,0,0,0,0,0,0,0,0,0,0,0,0,0,0,0,0,0
488846,22000,220,0,-2,1,0,1,0,0,0,1,0,1,0,0,0,0,0,0,0,0,0,0,0,0,0,0,0,0,0,0,0,0,0
490133,22000,220,0,-2,1,1,0,0,0,0,0,0,0,0,0,0,0,0,0,0,0,0,1,1,0,0,0,0,0,0,0,0,0,0
490373,22000,220,0,-2,10,3,7,0,0,0,0,0,0,0,0,0,0,0,0,0,0,0,4,0,4,1,1,0,1,1,0,4,1,3
490805,22000,220,0,-2,1,1,0,0,0,0,0,0,0,0,0,0,0,0,0,0,0,0,0,0,0,0,0,0,0,0,0,1,1,0
492689,22000,220,0,-2,1,0,1,0,0,0,1,0,1,0,0,0,0,0,0,0,0,0,0,0,0,0,0,0,0,0,0,0,0,0
495767,22000,220,0,-2,226,142,84,0,0,0,40,24,16,9,6,3,9,5,4,0,0,0,84,42,42,2,0,2,3,3,0,79,62,17
100858,23000,230,0,-2,8,3,5,0,0,0,0,0,0,0,0,0,0,0,0,0,0,0,8,3,5,0,0,0,0,0,0,0,0,0
101587,23000,230,0,-2,2,0,2,0,0,0,0,0,0,0,0,0,0,0,0,0,0,0,2,0,2,0,0,0,0,0,0,0,0,0
102377,23000,230,0,-2,5,3,2,0,0,0,0,0,0,5,3,2,0,0,0,0,0,0,0,0,0,0,0,0,0,0,0,0,0,0
102553,23000,230,0,-2,13,4,9,1,0,1,0,0,0,1,0,1,1,1,0,0,0,0,9,3,6,1,0,1,0,0,0,0,0,0
102614,23000,230,0,-2,5,3,2,1,1,0,0,0,0,0,0,0,0,0,0,0,0,0,3,2,1,1,0,1,0,0,0,0,0,0
104151,23000,230,0,-2,4,2,2,0,0,0,0,0,0,1,0,1,0,0,0,0,0,0,1,1,0,1,0,1,1,1,0,0,0,0
105136,23000,230,0,-2,1,1,0,0,0,0,0,0,0,0,0,0,0,0,0,0,0,0,0,0,0,0,0,0,1,1,0,0,0,0
106263,23000,230,0,-2,2,1,1,0,0,0,0,0,0,1,0,1,0,0,0,0,0,0,1,1,0,0,0,0,0,0,0,0,0,0
106397,23000,230,0,-2,3,1,2,0,0,0,0,0,0,0,0,0,0,0,0,0,0,0,3,1,2,0,0,0,0,0,0,0,0,0
106412,23000,230,0,-2,1,0,1,0,0,0,0,0,0,1,0,1,0,0,0,0,0,0,0,0,0,0,0,0,0,0,0,0,0,0
107983,23000,230,0,-2,6,3,3,0,0,0,0,0,0,1,0,1,0,0,0,0,0,0,5,3,2,0,0,0,0,0,0,0,0,0
110635,23000,230,0,-2,9,1,8,0,0,0,1,0,1,1,0,1,1,1,0,0,0,0,5,0,5,0,0,0,1,0,1,0,0,0
110644,23000,230,0,-2,2,0,2,0,0,0,0,0,0,0,0,0,0,0,0,0,0,0,2,0,2,0,0,0,0,0,0,0,0,0
110662,23000,230,0,-2,1,0,1,0,0,0,0,0,0,1,0,1,0,0,0,0,0,0,0,0,0,0,0,0,0,0,0,0,0,0
111461,23000,230,0,-2,1,1,0,0,0,0,0,0,0,1,1,0,0,0,0,0,0,0,0,0,0,0,0,0,0,0,0,0,0,0
117636,23000,230,0,-2,1,0,1,0,0,0,0,0,0,0,0,0,0,0,0,0,0,0,0,0,0,1,0,1,0,0,0,0,0,0
118888,23000,230,0,-2,2,0,2,0,0,0,0,0,0,1,0,1,1,0,1,0,0,0,0,0,0,0,0,0,0,0,0,0,0,0
121707,23000,230,0,-2,2,2,0,0,0,0,0,0,0,0,0,0,0,0,0,0,0,0,2,2,0,0,0,0,0,0,0,0,0,0
122506,23000,230,0,-2,1,1,0,0,0,0,0,0,0,0,0,0,0,0,0,0,0,0,1,1,0,0,0,0,0,0,0,0,0,0
123961,23000,230,0,-2,240,113,127,1,0,1,68,35,33,12,0,12,17,6,11,0,0,0,108,55,53,15,6,9,10,4,6,9,7,2
126562,23000,230,0,-2,16,3,13,0,0,0,1,0,1,0,0,0,2,0,2,0,0,0,11,3,8,0,0,0,2,0,2,0,0,0
126580,23000,230,0,-2,2,1,1,0,0,0,0,0,0,1,0,1,0,0,0,0,0,0,1,1,0,0,0,0,0,0,0,0,0,0
126614,23000,230,0,-2,1,1,0,0,0,0,0,0,0,1,1,0,0,0,0,0,0,0,0,0,0,0,0,0,0,0,0,0,0,0
126818,23000,230,0,-2,10,2,8,0,0,0,0,0,0,0,0,0,1,0,1,0,0,0,9,2,7,0,0,0,0,0,0,0,0,0
129020,23000,230,0,-2,2,1,1,0,0,0,0,0,0,0,0,0,0,0,0,0,0,0,1,0,1,1,1,0,0,0,0,0,0,0
130794,23000,230,0,-2,39,19,20,0,0,0,8,3,5,2,0,2,2,0,2,0,0,0,16,10,6,2,1,1,4,2,2,5,3,2
131520,23000,230,0,-2,18,4,14,0,0,0,1,0,1,9,1,8,0,0,0,0,0,0,1,0,1,2,1,1,5,2,3,0,0,0
133650,23000,230,0,-2,4,4,0,0,0,0,0,0,0,4,4,0,0,0,0,0,0,0,0,0,0,0,0,0,0,0,0,0,0,0
133669,23000,230,0,-2,4,1,3,0,0,0,0,0,0,1,1,0,1,0,1,0,0,0,2,0,2,0,0,0,0,0,0,0,0,0
134079,23000,230,0,-2,1,1,0,0,0,0,0,0,0,0,0,0,0,0,0,0,0,0,0,0,0,0,0,0,1,1,0,0,0,0
134130,23000,230,0,-2,115,57,58,0,0,0,12,6,6,9,1,8,16,7,9,0,0,0,50,23,27,0,0,0,8,6,2,20,14,6
135726,23000,230,0,-2,124,66,58,0,0,0,27,12,15,6,1,5,24,10,14,0,0,0,44,32,12,3,0,3,8,4,4,12,7,5
138840,23000,230,0,-2,3,0,3,0,0,0,0,0,0,3,0,3,0,0,0,0,0,0,0,0,0,0,0,0,0,0,0,0,0,0
139658,23000,230,0,-2,208,97,111,0,0,0,44,21,23,26,9,17,20,6,14,1,1,0,94,50,44,3,2,1,3,1,2,17,7,10
139931,23000,230,0,-2,1,1,0,0,0,0,0,0,0,0,0,0,0,0,0,0,0,0,1,1,0,0,0,0,0,0,0,0,0,0
139940,23000,230,0,-2,2,1,1,0,0,0,0,0,0,2,1,1,0,0,0,0,0,0,0,0,0,0,0,0,0,0,0,0,0,0
139959,23000,230,0,-2,23,5,18,0,0,0,1,1,0,5,2,3,2,0,2,0,0,0,12,2,10,2,0,2,0,0,0,1,0,1
140447,23000,230,0,-2,4,0,4,0,0,0,0,0,0,2,0,2,1,0,1,0,0,0,1,0,1,0,0,0,0,0,0,0,0,0
140553,23000,230,0,-2,3,2,1,0,0,0,0,0,0,3,2,1,0,0,0,0,0,0,0,0,0,0,0,0,0,0,0,0,0,0
140942,23000,230,0,-2,6,2,4,0,0,0,0,0,0,2,1,1,0,0,0,0,0,0,4,1,3,0,0,0,0,0,0,0,0,0
141574,23000,230,0,-2,1,0,1,0,0,0,0,0,0,0,0,0,0,0,0,0,0,0,1,0,1,0,0,0,0,0,0,0,0,0
142285,23000,230,0,-2,2,1,1,0,0,0,0,0,0,0,0,0,0,0,0,0,0,0,2,1,1,0,0,0,0,0,0,0,0,0
143358,23000,230,0,-2,1,1,0,0,0,0,0,0,0,0,0,0,0,0,0,0,0,0,1,1,0,0,0,0,0,0,0,0,0,0
147590,23000,230,0,-2,1,0,1,0,0,0,0,0,0,0,0,0,0,0,0,0,0,0,1,0,1,0,0,0,0,0,0,0,0,0
151102,23000,230,0,-2,1,1,0,0,0,0,0,0,0,0,0,0,0,0,0,0,0,0,1,1,0,0,0,0,0,0,0,0,0,0
153603,23000,230,0,-2,22,7,15,0,0,0,0,0,0,0,0,0,1,1,0,0,0,0,20,6,14,1,0,1,0,0,0,0,0,0
155089,23000,230,0,-2,2,0,2,0,0,0,0,0,0,0,0,0,0,0,0,0,0,0,2,0,2,0,0,0,0,0,0,0,0,0
155210,23000,230,0,-2,2,1,1,0,0,0,0,0,0,0,0,0,0,0,0,0,0,0,1,1,0,1,0,1,0,0,0,0,0,0
155317,23000,230,0,-2,4,3,1,0,0,0,0,0,0,0,0,0,1,1,0,0,0,0,3,2,1,0,0,0,0,0,0,0,0,0
155399,23000,230,0,-2,2,2,0,0,0,0,0,0,0,0,0,0,0,0,0,0,0,0,0,0,0,0,0,0,0,0,0,2,2,0
157085,23000,230,0,-2,92,52,40,1,1,0,13,8,5,1,0,1,2,1,1,1,1,0,52,26,26,0,0,0,0,0,0,22,15,7
159391,23000,230,0,-2,28,8,20,1,0,1,0,0,0,2,0,2,2,1,1,0,0,0,19,5,14,1,0,1,1,1,0,2,1,1
159939,23000,230,0,-2,56,13,43,0,0,0,3,0,3,21,4,17,1,1,0,0,0,0,30,7,23,1,1,0,0,0,0,0,0,0
160621,23000,230,0,-2,11,3,8,0,0,0,0,0,0,11,3,8,0,0,0,0,0,0,0,0,0,0,0,0,0,0,0,0,0,0
161253,23000,230,0,-2,3,2,1,0,0,0,0,0,0,0,0,0,0,0,0,0,0,0,2,1,1,0,0,0,0,0,0,1,1,0
161873,23000,230,0,-2,6,5,1,0,0,0,1,1,0,1,1,0,0,0,0,0,0,0,4,3,1,0,0,0,0,0,0,0,0,0
162122,23000,230,0,-2,3,3,0,0,0,0,0,0,0,3,3,0,0,0,0,0,0,0,0,0,0,0,0,0,0,0,0,0,0,0
162168,23000,230,0,-2,1,1,0,0,0,0,0,0,0,0,0,0,0,0,0,0,0,0,1,1,0,0,0,0,0,0,0,0,0,0
162928,23000,230,0,-2,11,2,9,0,0,0,1,0,1,5,1,4,1,0,1,0,0,0,4,1,3,0,0,0,0,0,0,0,0,0
163426,23000,230,0,-2,2,2,0,0,0,0,0,0,0,1,1,0,1,1,0,0,0,0,0,0,0,0,0,0,0,0,0,0,0,0
169442,23000,230,0,-2,1,0,1,0,0,0,0,0,0,0,0,0,0,0,0,0,0,0,1,0,1,0,0,0,0,0,0,0,0,0
171100,23000,230,0,-2,21,4,17,1,0,1,0,0,0,0,0,0,0,0,0,0,0,0,20,4,16,0,0,0,0,0,0,0,0,0
174066,23000,230,0,-2,31,5,26,1,0,1,1,0,1,3,0,3,1,1,0,0,0,0,22,4,18,2,0,2,0,0,0,1,0,1
174233,23000,230,0,-2,1,0,1,0,0,0,0,0,0,0,0,0,0,0,0,0,0,0,1,0,1,0,0,0,0,0,0,0,0,0
176080,23000,230,0,-2,15,6,9,0,0,0,1,0,1,1,1,0,0,0,0,0,0,0,11,5,6,0,0,0,1,0,1,1,0,1
178396,23000,230,0,-2,5,3,2,0,0,0,0,0,0,0,0,0,0,0,0,0,0,0,4,2,2,0,0,0,0,0,0,1,1,0
179159,23000,230,0,-2,44,27,17,1,0,1,9,8,1,2,1,1,1,0,1,0,0,0,27,15,12,0,0,0,0,0,0,4,3,1
179867,23000,230,0,-2,133,66,67,0,0,0,25,9,16,10,2,8,6,4,2,0,0,0,76,44,32,3,2,1,12,4,8,1,1,0
180054,23000,230,0,-2,1,1,0,1,1,0,0,0,0,0,0,0,0,0,0,0,0,0,0,0,0,0,0,0,0,0,0,0,0,0
180461,23000,230,0,-2,21,11,10,0,0,0,0,0,0,0,0,0,2,1,1,0,0,0,18,10,8,1,0,1,0,0,0,0,0,0
180489,23000,230,0,-2,30,7,23,0,0,0,11,1,10,0,0,0,2,0,2,0,0,0,14,5,9,0,0,0,1,0,1,2,1,1
181419,23000,230,0,-2,4,2,2,3,1,2,0,0,0,0,0,0,0,0,0,0,0,0,1,1,0,0,0,0,0,0,0,0,0,0
181428,23000,230,0,-2,35,19,16,2,0,2,7,4,3,1,1,0,3,1,2,0,0,0,21,13,8,0,0,0,1,0,1,0,0,0
181464,23000,230,0,-2,9,6,3,0,0,0,0,0,0,0,0,0,0,0,0,0,0,0,8,5,3,0,0,0,0,0,0,1,1,0
182290,23000,230,0,-2,2,0,2,0,0,0,0,0,0,0,0,0,0,0,0,0,0,0,1,0,1,0,0,0,0,0,0,1,0,1
183859,23000,230,0,-2,3,0,3,0,0,0,0,0,0,0,0,0,0,0,0,0,0,0,3,0,3,0,0,0,0,0,0,0,0,0
185536,23000,230,0,-2,2,1,1,0,0,0,0,0,0,1,1,0,0,0,0,0,0,0,1,0,1,0,0,0,0,0,0,0,0,0
188030,23000,230,0,-2,1,1,0,0,0,0,1,1,0,0,0,0,0,0,0,0,0,0,0,0,0,0,0,0,0,0,0,0,0,0
188137,23000,230,0,-2,1,1,0,0,0,0,0,0,0,0,0,0,1,1,0,0,0,0,0,0,0,0,0,0,0,0,0,0,0,0
190415,23000,230,0,-2,15,3,12,0,0,0,1,0,1,1,0,1,1,0,1,0,0,0,8,3,5,2,0,2,0,0,0,2,0,2
190512,23000,230,0,-2,1,1,0,0,0,0,0,0,0,0,0,0,0,0,0,0,0,0,1,1,0,0,0,0,0,0,0,0,0,0
190716,23000,230,0,-2,6,0,6,0,0,0,0,0,0,2,0,2,0,0,0,0,0,0,4,0,4,0,0,0,0,0,0,0,0,0
196097,23000,230,0,-2,2,2,0,0,0,0,2,2,0,0,0,0,0,0,0,0,0,0,0,0,0,0,0,0,0,0,0,0,0,0
196121,23000,230,0,-2,1,1,0,0,0,0,0,0,0,0,0,0,0,0,0,0,0,0,1,1,0,0,0,0,0,0,0,0,0,0
196699,23000,230,0,-2,1,0,1,0,0,0,0,0,0,0,0,0,0,0,0,0,0,0,1,0,1,0,0,0,0,0,0,0,0,0
198464,23000,230,0,-2,41,16,25,0,0,0,4,1,3,0,0,0,5,1,4,0,0,0,23,11,12,0,0,0,3,1,2,6,2,4
198710,23000,230,0,-2,1,0,1,0,0,0,0,0,0,0,0,0,0,0,0,0,0,0,1,0,1,0,0,0,0,0,0,0,0,0
198817,23000,230,0,-2,2,1,1,0,0,0,0,0,0,1,0,1,0,0,0,0,0,0,1,1,0,0,0,0,0,0,0,0,0,0
199120,23000,230,0,-2,125,49,76,0,0,0,9,5,4,6,1,5,3,2,1,0,0,0,48,20,28,5,2,3,54,19,35,0,0,0
199193,23000,230,0,-2,4,1,3,0,0,0,0,0,0,1,0,1,0,0,0,0,0,0,3,1,2,0,0,0,0,0,0,0,0,0
199324,23000,230,0,-2,3,0,3,0,0,0,0,0,0,1,0,1,0,0,0,0,0,0,2,0,2,0,0,0,0,0,0,0,0,0
200332,23000,230,0,-2,11,2,9,0,0,0,1,0,1,0,0,0,0,0,0,0,0,0,9,1,8,0,0,0,0,0,0,1,1,0
201885,23000,230,0,-2,5,2,3,0,0,0,1,1,0,0,0,0,0,0,0,0,0,0,2,0,2,0,0,0,1,1,0,1,0,1
204264,23000,230,0,-2,1,1,0,0,0,0,0,0,0,0,0,0,0,0,0,0,0,0,1,1,0,0,0,0,0,0,0,0,0,0
206084,23000,230,0,-2,21,11,10,0,0,0,4,2,2,2,2,0,0,0,0,0,0,0,13,6,7,0,0,0,1,0,1,1,1,0
207263,23000,230,0,-2,1,0,1,0,0,0,0,0,0,0,0,0,0,0,0,0,0,0,1,0,1,0,0,0,0,0,0,0,0,0
209506,23000,230,0,-2,1,0,1,0,0,0,0,0,0,0,0,0,0,0,0,0,0,0,1,0,1,0,0,0,0,0,0,0,0,0
209542,23000,230,0,-2,7,2,5,0,0,0,0,0,0,0,0,0,0,0,0,0,0,0,4,1,3,0,0,0,3,1,2,0,0,0
209551,23000,230,0,-2,19,4,15,0,0,0,1,0,1,1,0,1,2,1,1,0,0,0,14,3,11,0,0,0,1,0,1,0,0,0
209612,23000,230,0,-2,1,0,1,0,0,0,0,0,0,0,0,0,0,0,0,0,0,0,1,0,1,0,0,0,0,0,0,0,0,0
209807,23000,230,0,-2,4,0,4,0,0,0,2,0,2,0,0,0,0,0,0,0,0,0,0,0,0,2,0,2,0,0,0,0,0,0
210155,23000,230,0,-2,1,0,1,0,0,0,0,0,0,0,0,0,0,0,0,0,0,0,1,0,1,0,0,0,0,0,0,0,0,0
215062,23000,230,0,-2,164,72,92,0,0,0,35,18,17,13,3,10,10,7,3,0,0,0,92,39,53,1,0,1,3,2,1,10,3,7
215293,23000,230,0,-2,5,1,4,0,0,0,0,0,0,0,0,0,1,0,1,0,0,0,4,1,3,0,0,0,0,0,0,0,0,0
216366,23000,230,0,-2,56,27,29,0,0,0,17,8,9,2,1,1,1,0,1,0,0,0,25,14,11,5,1,4,4,2,2,2,1,1
217882,23000,230,0,-2,13,3,10,0,0,0,0,0,0,0,0,0,0,0,0,0,0,0,13,3,10,0,0,0,0,0,0,0,0,0
218663,23000,230,0,-2,4,2,2,0,0,0,0,0,0,0,0,0,0,0,0,0,0,0,1,1,0,0,0,0,0,0,0,3,1,2
218733,23000,230,0,-2,4,3,1,0,0,0,0,0,0,4,3,1,0,0,0,0,0,0,0,0,0,0,0,0,0,0,0,0,0,0
219356,23000,230,0,-2,11,3,8,0,0,0,0,0,0,0,0,0,0,0,0,0,0,0,11,3,8,0,0,0,0,0,0,0,0,0
220075,23000,230,0,-2,4,2,2,0,0,0,0,0,0,0,0,0,0,0,0,0,0,0,3,2,1,0,0,0,0,0,0,1,0,1
221759,23000,230,0,-2,2,1,1,0,0,0,0,0,0,1,0,1,0,0,0,0,0,0,1,1,0,0,0,0,0,0,0,0,0,0
221768,23000,230,0,-2,1,0,1,0,0,0,0,0,0,0,0,0,0,0,0,0,0,0,1,0,1,0,0,0,0,0,0,0,0,0
224891,23000,230,0,-2,2,1,1,0,0,0,0,0,0,0,0,0,0,0,0,0,0,0,2,1,1,0,0,0,0,0,0,0,0,0
227304,23000,230,0,-2,2,0,2,0,0,0,0,0,0,1,0,1,1,0,1,0,0,0,0,0,0,0,0,0,0,0,0,0,0,0
227881,23000,230,0,-2,1,0,1,0,0,0,0,0,0,0,0,0,1,0,1,0,0,0,0,0,0,0,0,0,0,0,0,0,0,0
228635,23000,230,0,-2,26,19,7,0,0,0,9,7,2,1,0,1,1,1,0,0,0,0,6,5,1,1,0,1,0,0,0,8,6,2
228644,23000,230,0,-2,98,30,68,1,1,0,14,5,9,9,1,8,28,5,23,0,0,0,32,11,21,1,1,0,12,6,6,1,0,1
228653,23000,230,0,-2,18,14,4,0,0,0,2,2,0,3,3,0,3,2,1,0,0,0,8,6,2,0,0,0,0,0,0,2,1,1
229027,23000,230,0,-2,2,2,0,0,0,0,0,0,0,0,0,0,1,1,0,0,0,0,1,1,0,0,0,0,0,0,0,0,0,0
229115,23000,230,0,-2,6,1,5,0,0,0,0,0,0,0,0,0,3,0,3,1,0,1,2,1,1,0,0,0,0,0,0,0,0,0
230038,23000,230,0,-2,1,1,0,0,0,0,0,0,0,0,0,0,0,0,0,0,0,0,1,1,0,0,0,0,0,0,0,0,0,0
230728,23000,230,0,-2,7,2,5,0,0,0,1,0,1,0,0,0,0,0,0,0,0,0,6,2,4,0,0,0,0,0,0,0,0,0
230764,23000,230,0,-2,95,42,53,0,0,0,12,5,7,2,1,1,6,1,5,0,0,0,62,28,34,1,1,0,6,2,4,6,4,2
231059,23000,230,0,-2,1,1,0,0,0,0,0,0,0,0,0,0,0,0,0,0,0,0,1,1,0,0,0,0,0,0,0,0,0,0
231147,23000,230,0,-2,1,1,0,0,0,0,0,0,0,0,0,0,0,0,0,0,0,0,1,1,0,0,0,0,0,0,0,0,0,0
231970,23000,230,0,-2,4,3,1,0,0,0,0,0,0,3,2,1,0,0,0,0,0,0,1,1,0,0,0,0,0,0,0,0,0,0
233921,23000,230,0,-2,1,1,0,0,0,0,0,0,0,0,0,0,1,1,0,0,0,0,0,0,0,0,0,0,0,0,0,0,0,0
234155,23000,230,0,-2,5,4,1,0,0,0,0,0,0,5,4,1,0,0,0,0,0,0,0,0,0,0,0,0,0,0,0,0,0,0
236939,23000,230,0,-2,1,0,1,0,0,0,0,0,0,0,0,0,1,0,1,0,0,0,0,0,0,0,0,0,0,0,0,0,0,0
238032,23000,230,0,-2,161,88,73,0,0,0,24,17,7,2,0,2,6,2,4,0,0,0,99,50,49,2,1,1,8,6,2,20,12,8
240727,23000,230,0,-2,3,0,3,0,0,0,0,0,0,0,0,0,0,0,0,0,0,0,3,0,3,0,0,0,0,0,0,0,0,0
240754,23000,230,0,-2,1,1,0,0,0,0,1,1,0,0,0,0,0,0,0,0,0,0,0,0,0,0,0,0,0,0,0,0,0,0
240790,23000,230,0,-2,1,1,0,0,0,0,0,0,0,0,0,0,0,0,0,0,0,0,0,0,0,0,0,0,0,0,0,1,1,0
242617,23000,230,0,-2,1,1,0,0,0,0,0,0,0,0,0,0,1,1,0,0,0,0,0,0,0,0,0,0,0,0,0,0,0,0
242644,23000,230,0,-2,2,0,2,0,0,0,0,0,0,0,0,0,2,0,2,0,0,0,0,0,0,0,0,0,0,0,0,0,0,0
242653,23000,230,0,-2,1,1,0,0,0,0,0,0,0,0,0,0,1,1,0,0,0,0,0,0,0,0,0,0,0,0,0,0,0,0
242662,23000,230,0,-2,1,1,0,0,0,0,0,0,0,0,0,0,1,1,0,0,0,0,0,0,0,0,0,0,0,0,0,0,0,0
242671,23000,230,0,-2,4,2,2,0,0,0,0,0,0,0,0,0,4,2,2,0,0,0,0,0,0,0,0,0,0,0,0,0,0,0
243197,23000,230,0,-2,11,3,8,0,0,0,0,0,0,0,0,0,0,0,0,0,0,0,0,0,0,0,0,0,11,3,8,0,0,0
243568,23000,230,0,-2,5,4,1,0,0,0,0,0,0,0,0,0,5,4,1,0,0,0,0,0,0,0,0,0,0,0,0,0,0,0
243638,23000,230,0,-2,4,2,2,0,0,0,0,0,0,0,0,0,0,0,0,4,2,2,0,0,0,0,0,0,0,0,0,0,0,0
243780,23000,230,0,-2,17,11,6,0,0,0,2,2,0,3,2,1,0,0,0,0,0,0,12,7,5,0,0,0,0,0,0,0,0,0
260372,23000,230,0,-2,2,1,1,1,0,1,0,0,0,0,0,0,0,0,0,0,0,0,1,1,0,0,0,0,0,0,0,0,0,0
366340,23000,230,0,-2,2,1,1,2,1,1,0,0,0,0,0,0,0,0,0,0,0,0,0,0,0,0,0,0,0,0,0,0,0,0
441070,23000,230,0,-2,1,1,0,0,0,0,0,0,0,0,0,0,0,0,0,0,0,0,1,1,0,0,0,0,0,0,0,0,0,0
445735,23000,230,0,-2,3,0,3,0,0,0,0,0,0,3,0,3,0,0,0,0,0,0,0,0,0,0,0,0,0,0,0,0,0,0
484905,23000,230,0,-2,1,1,0,0,0,0,0,0,0,1,1,0,0,0,0,0,0,0,0,0,0,0,0,0,0,0,0,0,0,0
487162,23000,230,0,-2,2,0,2,0,0,0,0,0,0,0,0,0,0,0,0,0,0,0,2,0,2,0,0,0,0,0,0,0,0,0
490805,23000,230,0,-2,1,0,1,0,0,0,0,0,0,0,0,0,0,0,0,0,0,0,1,0,1,0,0,0,0,0,0,0,0,0
491844,23000,230,0,-2,1,0,1,1,0,1,0,0,0,0,0,0,0,0,0,0,0,0,0,0,0,0,0,0,0,0,0,0,0,0
495767,23000,230,0,-2,1,0,1,0,0,0,0,0,0,0,0,0,1,0,1,0,0,0,0,0,0,0,0,0,0,0,0,0,0,0
100654,25000,250,0,-2,4,2,2,0,0,0,0,0,0,2,0,2,0,0,0,0,0,0,2,2,0,0,0,0,0,0,0,0,0,0
100663,25000,250,0,-2,38,11,27,0,0,0,1,0,1,8,3,5,2,0,2,0,0,0,25,8,17,1,0,1,1,0,1,0,0,0
100724,25000,250,0,-2,23,6,17,0,0,0,0,0,0,17,5,12,0,0,0,0,0,0,0,0,0,0,0,0,6,1,5,0,0,0
100751,25000,250,0,-2,25,5,20,0,0,0,0,0,0,3,0,3,1,0,1,0,0,0,20,5,15,1,0,1,0,0,0,0,0,0
100812,25000,250,0,-2,6,1,5,0,0,0,0,0,0,1,0,1,0,0,0,0,0,0,5,1,4,0,0,0,0,0,0,0,0,0
100830,25000,250,0,-2,3,1,2,0,0,0,0,0,0,1,0,1,0,0,0,0,0,0,1,1,0,0,0,0,1,0,1,0,0,0
100858,25000,250,0,-2,44,1,43,0,0,0,0,0,0,22,0,22,0,0,0,0,0,0,22,1,21,0,0,0,0,0,0,0,0,0
100937,25000,250,0,-2,5,0,5,0,0,0,0,0,0,1,0,1,0,0,0,0,0,0,4,0,4,0,0,0,0,0,0,0,0,0
101116,25000,250,0,-2,1,0,1,0,0,0,0,0,0,0,0,0,0,0,0,0,0,0,1,0,1,0,0,0,0,0,0,0,0,0
101161,25000,250,0,-2,16,3,13,0,0,0,0,0,0,7,1,6,0,0,0,0,0,0,9,2,7,0,0,0,0,0,0,0,0,0
101189,25000,250,0,-2,2,2,0,0,0,0,0,0,0,0,0,0,0,0,0,0,0,0,2,2,0,0,0,0,0,0,0,0,0,0
101240,25000,250,0,-2,1,1,0,0,0,0,0,0,0,0,0,0,0,0,0,0,0,0,1,1,0,0,0,0,0,0,0,0,0,0
101286,25000,250,0,-2,5,1,4,0,0,0,0,0,0,3,1,2,0,0,0,0,0,0,2,0,2,0,0,0,0,0,0,0,0,0
101295,25000,250,0,-2,2,0,2,0,0,0,0,0,0,0,0,0,0,0,0,0,0,0,2,0,2,0,0,0,0,0,0,0,0,0
101365,25000,250,0,-2,3,1,2,0,0,0,0,0,0,2,1,1,0,0,0,0,0,0,1,0,1,0,0,0,0,0,0,0,0,0
101471,25000,250,0,-2,4,1,3,0,0,0,0,0,0,1,0,1,0,0,0,0,0,0,3,1,2,0,0,0,0,0,0,0,0,0
101480,25000,250,0,-2,7,2,5,0,0,0,0,0,0,1,1,0,0,0,0,0,0,0,6,1,5,0,0,0,0,0,0,0,0,0
101505,25000,250,0,-2,4,2,2,0,0,0,0,0,0,1,0,1,0,0,0,0,0,0,3,2,1,0,0,0,0,0,0,0,0,0
101514,25000,250,0,-2,1,1,0,0,0,0,0,0,0,0,0,0,0,0,0,0,0,0,1,1,0,0,0,0,0,0,0,0,0,0
101675,25000,250,0,-2,3,2,1,0,0,0,0,0,0,3,2,1,0,0,0,0,0,0,0,0,0,0,0,0,0,0,0,0,0,0
101709,25000,250,0,-2,2,0,2,0,0,0,0,0,0,0,0,0,0,0,0,0,0,0,2,0,2,0,0,0,0,0,0,0,0,0
101736,25000,250,0,-2,5,1,4,0,0,0,0,0,0,1,0,1,0,0,0,0,0,0,3,1,2,0,0,0,1,0,1,0,0,0
101879,25000,250,0,-2,7,3,4,0,0,0,0,0,0,0,0,0,0,0,0,0,0,0,7,3,4,0,0,0,0,0,0,0,0,0
101897,25000,250,0,-2,1,0,1,0,0,0,0,0,0,0,0,0,0,0,0,0,0,0,1,0,1,0,0,0,0,0,0,0,0,0
102094,25000,250,0,-2,33,13,20,0,0,0,0,0,0,10,4,6,0,0,0,0,0,0,21,8,13,1,0,1,1,1,0,0,0,0
102234,25000,250,0,-2,1,0,1,0,0,0,0,0,0,0,0,0,0,0,0,0,0,0,1,0,1,0,0,0,0,0,0,0,0,0
102298,25000,250,0,-2,1,0,1,0,0,0,0,0,0,1,0,1,0,0,0,0,0,0,0,0,0,0,0,0,0,0,0,0,0,0
102313,25000,250,0,-2,1,0,1,0,0,0,0,0,0,1,0,1,0,0,0,0,0,0,0,0,0,0,0,0,0,0,0,0,0,0
102368,25000,250,0,-2,9,1,8,0,0,0,0,0,0,3,0,3,0,0,0,0,0,0,6,1,5,0,0,0,0,0,0,0,0,0
102395,25000,250,0,-2,5,2,3,0,0,0,0,0,0,1,0,1,0,0,0,0,0,0,4,2,2,0,0,0,0,0,0,0,0,0
102429,25000,250,0,-2,2,0,2,0,0,0,0,0,0,0,0,0,0,0,0,0,0,0,2,0,2,0,0,0,0,0,0,0,0,0
102553,25000,250,0,-2,4,1,3,1,1,0,1,0,1,0,0,0,2,0,2,0,0,0,0,0,0,0,0,0,0,0,0,0,0,0
102614,25000,250,0,-2,5,1,4,0,0,0,1,0,1,0,0,0,0,0,0,0,0,0,3,1,2,0,0,0,1,0,1,0,0,0
102669,25000,250,0,-2,6,1,5,2,0,2,0,0,0,0,0,0,0,0,0,0,0,0,3,1,2,1,0,1,0,0,0,0,0,0
103893,25000,250,0,-2,7,1,6,1,0,1,0,0,0,1,1,0,1,0,1,0,0,0,4,0,4,0,0,0,0,0,0,0,0,0
103909,25000,250,0,-2,4,1,3,0,0,0,0,0,0,1,0,1,1,0,1,0,0,0,2,1,1,0,0,0,0,0,0,0,0,0
103927,25000,250,0,-2,6,0,6,0,0,0,0,0,0,0,0,0,2,0,2,1,0,1,2,0,2,1,0,1,0,0,0,0,0,0
104090,25000,250,0,-2,9,2,7,0,0,0,1,1,0,2,0,2,1,0,1,0,0,0,4,1,3,1,0,1,0,0,0,0,0,0
104151,25000,250,0,-2,57,20,37,2,1,1,3,0,3,3,1,2,10,3,7,0,0,0,24,8,16,1,1,0,9,3,6,5,3,2
104160,25000,250,0,-2,1,0,1,0,0,0,0,0,0,0,0,0,1,0,1,0,0,0,0,0,0,0,0,0,0,0,0,0,0,0
104179,25000,250,0,-2,26,6,20,1,1,0,2,0,2,2,0,2,8,2,6,0,0,0,11,1,10,1,1,0,0,0,0,1,1,0
104346,25000,250,0,-2,3,2,1,0,0,0,0,0,0,0,0,0,0,0,0,0,0,0,2,1,1,1,1,0,0,0,0,0,0,0
104425,25000,250,0,-2,3,1,2,0,0,0,0,0,0,1,0,1,1,0,1,0,0,0,1,1,0,0,0,0,0,0,0,0,0,0
104577,25000,250,0,-2,3,1,2,0,0,0,0,0,0,0,0,0,0,0,0,0,0,0,3,1,2,0,0,0,0,0,0,0,0,0
104586,25000,250,0,-2,75,50,25,0,0,0,5,4,1,2,2,0,7,4,3,1,0,1,38,20,18,2,2,0,18,16,2,2,2,0
104708,25000,250,0,-2,4,2,2,0,0,0,0,0,0,2,2,0,1,0,1,0,0,0,1,0,1,0,0,0,0,0,0,0,0,0
104717,25000,250,0,-2,10,2,8,0,0,0,0,0,0,1,0,1,1,0,1,0,0,0,8,2,6,0,0,0,0,0,0,0,0,0
105145,25000,250,0,-2,7,0,7,0,0,0,0,0,0,1,0,1,3,0,3,0,0,0,3,0,3,0,0,0,0,0,0,0,0,0
105154,25000,250,0,-2,6,3,3,0,0,0,1,0,1,0,0,0,2,1,1,0,0,0,3,2,1,0,0,0,0,0,0,0,0,0
105206,25000,250,0,-2,1,0,1,0,0,0,0,0,0,1,0,1,0,0,0,0,0,0,0,0,0,0,0,0,0,0,0,0,0,0
105297,25000,250,0,-2,2,0,2,2,0,2,0,0,0,0,0,0,0,0,0,0,0,0,0,0,0,0,0,0,0,0,0,0,0,0
105330,25000,250,0,-2,17,3,14,1,0,1,0,0,0,0,0,0,3,2,1,0,0,0,13,1,12,0,0,0,0,0,0,0,0,0
105349,25000,250,0,-2,3,1,2,0,0,0,0,0,0,0,0,0,0,0,0,0,0,0,2,1,1,0,0,0,1,0,1,0,0,0
105428,25000,250,0,-2,3,2,1,0,0,0,0,0,0,0,0,0,1,1,0,0,0,0,2,1,1,0,0,0,0,0,0,0,0,0
105525,25000,250,0,-2,31,12,19,0,0,0,0,0,0,2,1,1,9,4,5,0,0,0,16,6,10,2,1,1,2,0,2,0,0,0
105534,25000,250,0,-2,4,0,4,0,0,0,0,0,0,0,0,0,3,0,3,0,0,0,1,0,1,0,0,0,0,0,0,0,0,0
105543,25000,250,0,-2,3,2,1,1,1,0,0,0,0,0,0,0,1,1,0,0,0,0,1,0,1,0,0,0,0,0,0,0,0,0
105668,25000,250,0,-2,3,0,3,0,0,0,1,0,1,1,0,1,0,0,0,0,0,0,1,0,1,0,0,0,0,0,0,0,0,0
105747,25000,250,0,-2,3,1,2,0,0,0,0,0,0,0,0,0,1,0,1,0,0,0,2,1,1,0,0,0,0,0,0,0,0,0
106148,25000,250,0,-2,8,3,5,0,0,0,2,1,1,0,0,0,2,0,2,0,0,0,4,2,2,0,0,0,0,0,0,0,0,0
106245,25000,250,0,-2,20,7,13,0,0,0,0,0,0,9,2,7,1,1,0,0,0,0,10,4,6,0,0,0,0,0,0,0,0,0
106263,25000,250,0,-2,123,71,52,0,0,0,16,10,6,8,1,7,1,1,0,0,0,0,63,37,26,1,0,1,4,2,2,30,20,10
106306,25000,250,0,-2,3,1,2,0,0,0,0,0,0,3,1,2,0,0,0,0,0,0,0,0,0,0,0,0,0,0,0,0,0,0
106397,25000,250,0,-2,30,7,23,0,0,0,0,0,0,2,0,2,1,0,1,0,0,0,27,7,20,0,0,0,0,0,0,0,0,0
106412,25000,250,0,-2,2,1,1,0,0,0,0,0,0,1,0,1,0,0,0,0,0,0,0,0,0,0,0,0,0,0,0,1,1,0
106449,25000,250,0,-2,1,0,1,0,0,0,1,0,1,0,0,0,0,0,0,0,0,0,0,0,0,0,0,0,0,0,0,0,0,0
106458,25000,250,0,-2,8,0,8,0,0,0,0,0,0,4,0,4,1,0,1,0,0,0,3,0,3,0,0,0,0,0,0,0,0,0
106704,25000,250,0,-2,5,2,3,0,0,0,0,0,0,2,1,1,0,0,0,0,0,0,3,1,2,0,0,0,0,0,0,0,0,0
106713,25000,250,0,-2,1,0,1,0,0,0,0,0,0,0,0,0,0,0,0,0,0,0,1,0,1,0,0,0,0,0,0,0,0,0
106795,25000,250,0,-2,6,1,5,1,0,1,0,0,0,2,1,1,0,0,0,0,0,0,3,0,3,0,0,0,0,0,0,0,0,0
106883,25000,250,0,-2,7,2,5,0,0,0,0,0,0,6,2,4,0,0,0,0,0,0,1,0,1,0,0,0,0,0,0,0,0,0
106999,25000,250,0,-2,2,0,2,0,0,0,0,0,0,0,0,0,0,0,0,0,0,0,2,0,2,0,0,0,0,0,0,0,0,0
107044,25000,250,0,-2,10,3,7,0,0,0,0,0,0,0,0,0,0,0,0,0,0,0,9,3,6,1,0,1,0,0,0,0,0,0
107080,25000,250,0,-2,1,0,1,0,0,0,0,0,0,0,0,0,0,0,0,0,0,0,1,0,1,0,0,0,0,0,0,0,0,0
107141,25000,250,0,-2,1,0,1,0,0,0,0,0,0,0,0,0,0,0,0,0,0,0,1,0,1,0,0,0,0,0,0,0,0,0
107327,25000,250,0,-2,1,0,1,0,0,0,0,0,0,0,0,0,0,0,0,0,0,0,1,0,1,0,0,0,0,0,0,0,0,0
107512,25000,250,0,-2,1,0,1,0,0,0,0,0,0,0,0,0,0,0,0,0,0,0,1,0,1,0,0,0,0,0,0,0,0,0
107521,25000,250,0,-2,2,0,2,0,0,0,0,0,0,0,0,0,0,0,0,0,0,0,2,0,2,0,0,0,0,0,0,0,0,0
107549,25000,250,0,-2,7,3,4,0,0,0,0,0,0,0,0,0,0,0,0,0,0,0,7,3,4,0,0,0,0,0,0,0,0,0
107585,25000,250,0,-2,3,1,2,0,0,0,0,0,0,0,0,0,0,0,0,0,0,0,3,1,2,0,0,0,0,0,0,0,0,0
107600,25000,250,0,-2,2,1,1,0,0,0,0,0,0,2,1,1,0,0,0,0,0,0,0,0,0,0,0,0,0,0,0,0,0,0
107619,25000,250,0,-2,5,1,4,0,0,0,0,0,0,1,0,1,0,0,0,0,0,0,4,1,3,0,0,0,0,0,0,0,0,0
107637,25000,250,0,-2,1,0,1,0,0,0,0,0,0,1,0,1,0,0,0,0,0,0,0,0,0,0,0,0,0,0,0,0,0,0
107664,25000,250,0,-2,5,1,4,0,0,0,0,0,0,3,1,2,0,0,0,0,0,0,2,0,2,0,0,0,0,0,0,0,0,0
107725,25000,250,0,-2,9,3,6,0,0,0,0,0,0,2,1,1,1,1,0,0,0,0,6,1,5,0,0,0,0,0,0,0,0,0
107743,25000,250,0,-2,2,0,2,0,0,0,0,0,0,0,0,0,0,0,0,0,0,0,2,0,2,0,0,0,0,0,0,0,0,0
107840,25000,250,0,-2,15,4,11,0,0,0,0,0,0,13,4,9,0,0,0,0,0,0,2,0,2,0,0,0,0,0,0,0,0,0
107877,25000,250,0,-2,1,0,1,0,0,0,0,0,0,0,0,0,0,0,0,0,0,0,1,0,1,0,0,0,0,0,0,0,0,0
107974,25000,250,0,-2,13,4,9,0,0,0,0,0,0,6,1,5,0,0,0,0,0,0,7,3,4,0,0,0,0,0,0,0,0,0
107983,25000,250,0,-2,8,6,2,0,0,0,0,0,0,1,1,0,0,0,0,0,0,0,7,5,2,0,0,0,0,0,0,0,0,0
107992,25000,250,0,-2,3,2,1,0,0,0,0,0,0,1,1,0,0,0,0,0,0,0,2,1,1,0,0,0,0,0,0,0,0,0
108092,25000,250,0,-2,4,1,3,0,0,0,0,0,0,0,0,0,0,0,0,0,0,0,3,0,3,0,0,0,0,0,0,1,1,0
108232,25000,250,0,-2,22,7,15,0,0,0,6,1,5,4,1,3,7,3,4,0,0,0,4,1,3,1,1,0,0,0,0,0,0,0
108870,25000,250,0,-2,1,0,1,0,0,0,0,0,0,0,0,0,0,0,0,0,0,0,1,0,1,0,0,0,0,0,0,0,0,0
109208,25000,250,0,-2,1,0,1,0,0,0,0,0,0,0,0,0,0,0,0,0,0,0,1,0,1,0,0,0,0,0,0,0,0,0
109350,25000,250,0,-2,1,0,1,0,0,0,0,0,0,0,0,0,0,0,0,0,0,0,1,0,1,0,0,0,0,0,0,0,0,0
109819,25000,250,0,-2,3,1,2,0,0,0,0,0,0,0,0,0,1,0,1,0,0,0,2,1,1,0,0,0,0,0,0,0,0,0
109907,25000,250,0,-2,3,1,2,0,0,0,0,0,0,2,1,1,1,0,1,0,0,0,0,0,0,0,0,0,0,0,0,0,0,0
110097,25000,250,0,-2,6,4,2,0,0,0,1,1,0,0,0,0,3,2,1,0,0,0,1,0,1,0,0,0,0,0,0,1,1,0
110219,25000,250,0,-2,61,17,44,1,0,1,0,0,0,17,6,11,10,3,7,1,0,1,32,8,24,0,0,0,0,0,0,0,0,0
110316,25000,250,0,-2,5,0,5,0,0,0,2,0,2,0,0,0,1,0,1,0,0,0,2,0,2,0,0,0,0,0,0,0,0,0
110361,25000,250,0,-2,2,1,1,0,0,0,1,0,1,1,1,0,0,0,0,0,0,0,0,0,0,0,0,0,0,0,0,0,0,0
110370,25000,250,0,-2,1,1,0,0,0,0,0,0,0,0,0,0,0,0,0,0,0,0,0,0,0,0,0,0,0,0,0,1,1,0
110398,25000,250,0,-2,4,0,4,0,0,0,0,0,0,0,0,0,0,0,0,0,0,0,3,0,3,0,0,0,1,0,1,0,0,0
110404,25000,250,0,-2,2,0,2,0,0,0,0,0,0,1,0,1,1,0,1,0,0,0,0,0,0,0,0,0,0,0,0,0,0,0
110413,25000,250,0,-2,7,2,5,0,0,0,0,0,0,0,0,0,2,1,1,0,0,0,5,1,4,0,0,0,0,0,0,0,0,0
110422,25000,250,0,-2,3,1,2,0,0,0,0,0,0,0,0,0,2,1,1,0,0,0,0,0,0,0,0,0,1,0,1,0,0,0
110468,25000,250,0,-2,15,3,12,0,0,0,3,1,2,3,0,3,3,1,2,1,0,1,5,1,4,0,0,0,0,0,0,0,0,0
110486,25000,250,0,-2,1,1,0,0,0,0,0,0,0,0,0,0,0,0,0,0,0,0,1,1,0,0,0,0,0,0,0,0,0,0
110495,25000,250,0,-2,5,1,4,0,0,0,0,0,0,0,0,0,4,1,3,0,0,0,1,0,1,0,0,0,0,0,0,0,0,0
110529,25000,250,0,-2,1,0,1,0,0,0,0,0,0,0,0,0,0,0,0,0,0,0,1,0,1,0,0,0,0,0,0,0,0,0
110538,25000,250,0,-2,1,0,1,0,0,0,0,0,0,0,0,0,1,0,1,0,0,0,0,0,0,0,0,0,0,0,0,0,0,0
110547,25000,250,0,-2,2,0,2,0,0,0,0,0,0,0,0,0,0,0,0,0,0,0,2,0,2,0,0,0,0,0,0,0,0,0
110556,25000,250,0,-2,2,0,2,0,0,0,0,0,0,0,0,0,0,0,0,0,0,0,2,0,2,0,0,0,0,0,0,0,0,0
110565,25000,250,0,-2,2,0,2,0,0,0,0,0,0,0,0,0,1,0,1,0,0,0,1,0,1,0,0,0,0,0,0,0,0,0
110574,25000,250,0,-2,4,1,3,0,0,0,3,1,2,0,0,0,0,0,0,0,0,0,1,0,1,0,0,0,0,0,0,0,0,0
110583,25000,250,0,-2,8,1,7,0,0,0,1,0,1,0,0,0,2,0,2,0,0,0,3,1,2,0,0,0,0,0,0,2,0,2
110592,25000,250,0,-2,1,0,1,0,0,0,1,0,1,0,0,0,0,0,0,0,0,0,0,0,0,0,0,0,0,0,0,0,0,0
110608,25000,250,0,-2,5,0,5,0,0,0,0,0,0,0,0,0,1,0,1,0,0,0,1,0,1,0,0,0,3,0,3,0,0,0
110617,25000,250,0,-2,3,0,3,0,0,0,1,0,1,0,0,0,1,0,1,0,0,0,1,0,1,0,0,0,0,0,0,0,0,0
110635,25000,250,0,-2,132,39,93,1,1,0,19,3,16,9,4,5,31,12,19,0,0,0,38,13,25,6,1,5,16,3,13,12,2,10
110644,25000,250,0,-2,77,18,59,1,1,0,12,4,8,6,1,5,25,4,21,0,0,0,25,4,21,5,2,3,2,2,0,1,0,1
110653,25000,250,0,-2,76,18,58,1,0,1,14,5,9,2,2,0,26,6,20,0,0,0,26,4,22,2,0,2,4,0,4,1,1,0
110662,25000,250,0,-2,153,48,105,1,1,0,32,9,23,13,2,11,45,16,29,1,1,0,36,12,24,9,1,8,10,6,4,6,0,6
110671,25000,250,0,-2,41,12,29,0,0,0,4,2,2,4,1,3,22,7,15,0,0,0,8,2,6,0,0,0,2,0,2,1,0,1
110680,25000,250,0,-2,123,27,96,0,0,0,28,6,22,10,2,8,43,8,35,1,1,0,32,8,24,2,0,2,4,0,4,3,2,1
110699,25000,250,0,-2,14,6,8,0,0,0,4,1,3,1,1,0,2,1,1,0,0,0,6,2,4,0,0,0,0,0,0,1,1,0
110705,25000,250,0,-2,55,16,39,0,0,0,5,1,4,7,1,6,18,5,13,0,0,0,16,6,10,3,1,2,1,1,0,5,1,4
110714,25000,250,0,-2,43,13,30,0,0,0,6,2,4,0,0,0,12,3,9,1,1,0,16,4,12,2,0,2,6,3,3,0,0,0
110778,25000,250,0,-2,5,0,5,0,0,0,4,0,4,0,0,0,0,0,0,0,0,0,1,0,1,0,0,0,0,0,0,0,0,0
111081,25000,250,0,-2,2,1,1,0,0,0,0,0,0,0,0,0,0,0,0,0,0,0,1,1,0,0,0,0,0,0,0,1,0,1
111391,25000,250,0,-2,1,0,1,0,0,0,0,0,0,0,0,0,0,0,0,0,0,0,1,0,1,0,0,0,0,0,0,0,0,0
111461,25000,250,0,-2,6,0,6,0,0,0,0,0,0,1,0,1,3,0,3,0,0,0,2,0,2,0,0,0,0,0,0,0,0,0
111920,25000,250,0,-2,1,0,1,0,0,0,0,0,0,0,0,0,0,0,0,0,0,0,0,0,0,1,0,1,0,0,0,0,0,0
111948,25000,250,0,-2,9,1,8,0,0,0,1,0,1,0,0,0,1,0,1,0,0,0,2,1,1,0,0,0,5,0,5,0,0,0
111966,25000,250,0,-2,6,1,5,0,0,0,1,0,1,0,0,0,1,0,1,0,0,0,1,1,0,0,0,0,3,0,3,0,0,0
112075,25000,250,0,-2,7,1,6,0,0,0,0,0,0,0,0,0,0,0,0,0,0,0,2,1,1,0,0,0,5,0,5,0,0,0
112251,25000,250,0,-2,6,2,4,0,0,0,2,0,2,1,1,0,1,0,1,0,0,0,2,1,1,0,0,0,0,0,0,0,0,0
112260,25000,250,0,-2,2,0,2,0,0,0,1,0,1,0,0,0,0,0,0,0,0,0,1,0,1,0,0,0,0,0,0,0,0,0
112394,25000,250,0,-2,1,0,1,0,0,0,0,0,0,0,0,0,0,0,0,0,0,0,1,0,1,0,0,0,0,0,0,0,0,0
112561,25000,250,0,-2,4,1,3,0,0,0,0,0,0,0,0,0,0,0,0,0,0,0,4,1,3,0,0,0,0,0,0,0,0,0
112570,25000,250,0,-2,3,0,3,0,0,0,0,0,0,0,0,0,2,0,2,0,0,0,1,0,1,0,0,0,0,0,0,0,0,0
112686,25000,250,0,-2,3,1,2,0,0,0,0,0,0,1,0,1,2,1,1,0,0,0,0,0,0,0,0,0,0,0,0,0,0,0
113096,25000,250,0,-2,2,1,1,0,0,0,1,1,0,0,0,0,0,0,0,0,0,0,1,0,1,0,0,0,0,0,0,0,0,0
113111,25000,250,0,-2,1,0,1,0,0,0,0,0,0,0,0,0,1,0,1,0,0,0,0,0,0,0,0,0,0,0,0,0,0,0
113193,25000,250,0,-2,2,2,0,0,0,0,0,0,0,0,0,0,1,1,0,0,0,0,1,1,0,0,0,0,0,0,0,0,0,0
113218,25000,250,0,-2,1,0,1,0,0,0,0,0,0,0,0,0,1,0,1,0,0,0,0,0,0,0,0,0,0,0,0,0,0,0
113573,25000,250,0,-2,1,1,0,0,0,0,0,0,0,0,0,0,1,1,0,0,0,0,0,0,0,0,0,0,0,0,0,0,0,0
113582,25000,250,0,-2,3,0,3,0,0,0,0,0,0,0,0,0,0,0,0,0,0,0,3,0,3,0,0,0,0,0,0,0,0,0
113698,25000,250,0,-2,5,0,5,0,0,0,0,0,0,0,0,0,1,0,1,0,0,0,3,0,3,1,0,1,0,0,0,0,0,0
113704,25000,250,0,-2,2,0,2,0,0,0,0,0,0,0,0,0,0,0,0,0,0,0,2,0,2,0,0,0,0,0,0,0,0,0
113856,25000,250,0,-2,5,1,4,0,0,0,1,1,0,0,0,0,0,0,0,0,0,0,1,0,1,0,0,0,3,0,3,0,0,0
113980,25000,250,0,-2,2,2,0,0,0,0,0,0,0,1,1,0,0,0,0,0,0,0,0,0,0,0,0,0,1,1,0,0,0,0
114354,25000,250,0,-2,1,0,1,0,0,0,0,0,0,0,0,0,0,0,0,0,0,0,0,0,0,0,0,0,1,0,1,0,0,0
114549,25000,250,0,-2,5,1,4,0,0,0,0,0,0,0,0,0,2,0,2,0,0,0,3,1,2,0,0,0,0,0,0,0,0,0
114716,25000,250,0,-2,1,1,0,0,0,0,0,0,0,0,0,0,0,0,0,0,0,0,1,1,0,0,0,0,0,0,0,0,0,0
114813,25000,250,0,-2,6,2,4,0,0,0,1,1,0,1,0,1,1,0,1,0,0,0,3,1,2,0,0,0,0,0,0,0,0,0
114840,25000,250,0,-2,2,0,2,0,0,0,1,0,1,0,0,0,0,0,0,0,0,0,1,0,1,0,0,0,0,0,0,0,0,0
115010,25000,250,0,-2,4,1,3,0,0,0,0,0,0,0,0,0,0,0,0,0,0,0,0,0,0,3,0,3,1,1,0,0,0,0
115083,25000,250,0,-2,2,1,1,0,0,0,0,0,0,0,0,0,0,0,0,0,0,0,2,1,1,0,0,0,0,0,0,0,0,0
115126,25000,250,0,-2,1,1,0,0,0,0,0,0,0,0,0,0,0,0,0,0,0,0,1,1,0,0,0,0,0,0,0,0,0,0
115214,25000,250,0,-2,2,1,1,0,0,0,0,0,0,0,0,0,0,0,0,0,0,0,1,1,0,1,0,1,0,0,0,0,0,0
115296,25000,250,0,-2,3,1,2,0,0,0,0,0,0,0,0,0,0,0,0,0,0,0,2,1,1,0,0,0,1,0,1,0,0,0
115409,25000,250,0,-2,8,0,8,1,0,1,2,0,2,0,0,0,1,0,1,0,0,0,4,0,4,0,0,0,0,0,0,0,0,0
115728,25000,250,0,-2,7,1,6,0,0,0,0,0,0,2,0,2,1,0,1,0,0,0,3,1,2,0,0,0,1,0,1,0,0,0
115746,25000,250,0,-2,7,1,6,0,0,0,0,0,0,0,0,0,3,0,3,0,0,0,3,1,2,1,0,1,0,0,0,0,0,0
115755,25000,250,0,-2,3,0,3,0,0,0,0,0,0,0,0,0,0,0,0,0,0,0,3,0,3,0,0,0,0,0,0,0,0,0
115861,25000,250,0,-2,1,0,1,0,0,0,0,0,0,0,0,0,1,0,1,0,0,0,0,0,0,0,0,0,0,0,0,0,0,0
115931,25000,250,0,-2,12,6,6,0,0,0,1,1,0,3,2,1,5,1,4,0,0,0,3,2,1,0,0,0,0,0,0,0,0,0
117052,25000,250,0,-2,1,0,1,0,0,0,0,0,0,0,0,0,1,0,1,0,0,0,0,0,0,0,0,0,0,0,0,0,0,0
117104,25000,250,0,-2,2,1,1,0,0,0,0,0,0,0,0,0,2,1,1,0,0,0,0,0,0,0,0,0,0,0,0,0,0,0
117168,25000,250,0,-2,2,0,2,0,0,0,0,0,0,0,0,0,1,0,1,0,0,0,1,0,1,0,0,0,0,0,0,0,0,0
117195,25000,250,0,-2,1,0,1,0,0,0,0,0,0,0,0,0,0,0,0,0,0,0,1,0,1,0,0,0,0,0,0,0,0,0
117247,25000,250,0,-2,1,0,1,0,0,0,0,0,0,1,0,1,0,0,0,0,0,0,0,0,0,0,0,0,0,0,0,0,0,0
117274,25000,250,0,-2,2,1,1,0,0,0,0,0,0,0,0,0,0,0,0,1,1,0,1,0,1,0,0,0,0,0,0,0,0,0
117520,25000,250,0,-2,1,0,1,0,0,0,0,0,0,0,0,0,0,0,0,0,0,0,1,0,1,0,0,0,0,0,0,0,0,0
117627,25000,250,0,-2,4,0,4,0,0,0,0,0,0,1,0,1,3,0,3,0,0,0,0,0,0,0,0,0,0,0,0,0,0,0
117645,25000,250,0,-2,1,0,1,0,0,0,0,0,0,0,0,0,1,0,1,0,0,0,0,0,0,0,0,0,0,0,0,0,0,0
117672,25000,250,0,-2,6,3,3,0,0,0,1,0,1,1,1,0,2,1,1,0,0,0,2,1,1,0,0,0,0,0,0,0,0,0
117681,25000,250,0,-2,2,0,2,0,0,0,0,0,0,1,0,1,0,0,0,0,0,0,0,0,0,0,0,0,1,0,1,0,0,0
117690,25000,250,0,-2,1,0,1,0,0,0,0,0,0,0,0,0,0,0,0,0,0,0,0,0,0,0,0,0,1,0,1,0,0,0
117706,25000,250,0,-2,2,0,2,0,0,0,0,0,0,0,0,0,2,0,2,0,0,0,0,0,0,0,0,0,0,0,0,0,0,0
117733,25000,250,0,-2,2,1,1,0,0,0,0,0,0,1,0,1,0,0,0,0,0,0,1,1,0,0,0,0,0,0,0,0,0,0
117751,25000,250,0,-2,1,0,1,0,0,0,0,0,0,0,0,0,0,0,0,0,0,0,1,0,1,0,0,0,0,0,0,0,0,0
117788,25000,250,0,-2,3,2,1,0,0,0,0,0,0,0,0,0,0,0,0,0,0,0,0,0,0,0,0,0,3,2,1,0,0,0
117803,25000,250,0,-2,1,1,0,0,0,0,0,0,0,0,0,0,0,0,0,0,0,0,1,1,0,0,0,0,0,0,0,0,0,0
117867,25000,250,0,-2,1,1,0,0,0,0,0,0,0,0,0,0,0,0,0,0,0,0,1,1,0,0,0,0,0,0,0,0,0,0
117946,25000,250,0,-2,11,5,6,0,0,0,0,0,0,0,0,0,1,0,1,0,0,0,1,0,1,1,1,0,8,4,4,0,0,0
118198,25000,250,0,-2,1,0,1,0,0,0,0,0,0,0,0,0,0,0,0,0,0,0,1,0,1,0,0,0,0,0,0,0,0,0
118693,25000,250,0,-2,17,8,9,0,0,0,4,0,4,1,0,1,4,3,1,0,0,0,8,5,3,0,0,0,0,0,0,0,0,0
118718,25000,250,0,-2,3,2,1,0,0,0,0,0,0,0,0,0,1,0,1,0,0,0,1,1,0,0,0,0,0,0,0,1,1,0
118888,25000,250,0,-2,1,1,0,0,0,0,0,0,0,0,0,0,0,0,0,0,0,0,1,1,0,0,0,0,0,0,0,0,0,0
118976,25000,250,0,-2,5,0,5,0,0,0,1,0,1,0,0,0,2,0,2,0,0,0,1,0,1,1,0,1,0,0,0,0,0,0
119058,25000,250,0,-2,1,1,0,0,0,0,0,0,0,0,0,0,0,0,0,0,0,0,0,0,0,0,0,0,1,1,0,0,0,0
119067,25000,250,0,-2,4,1,3,0,0,0,0,0,0,0,0,0,3,0,3,0,0,0,0,0,0,1,1,0,0,0,0,0,0,0
119137,25000,250,0,-2,2,0,2,0,0,0,1,0,1,0,0,0,1,0,1,0,0,0,0,0,0,0,0,0,0,0,0,0,0,0
119164,25000,250,0,-2,1,0,1,0,0,0,0,0,0,0,0,0,1,0,1,0,0,0,0,0,0,0,0,0,0,0,0,0,0,0
119173,25000,250,0,-2,3,1,2,0,0,0,0,0,0,0,0,0,2,0,2,0,0,0,1,1,0,0,0,0,0,0,0,0,0,0
119216,25000,250,0,-2,5,1,4,0,0,0,1,0,1,0,0,0,3,1,2,0,0,0,1,0,1,0,0,0,0,0,0,0,0,0
119678,25000,250,0,-2,9,4,5,0,0,0,2,1,1,2,1,1,0,0,0,0,0,0,5,2,3,0,0,0,0,0,0,0,0,0
119775,25000,250,0,-2,6,3,3,0,0,0,0,0,0,0,0,0,3,1,2,0,0,0,3,2,1,0,0,0,0,0,0,0,0,0
120078,25000,250,0,-2,2,0,2,0,0,0,0,0,0,0,0,0,2,0,2,0,0,0,0,0,0,0,0,0,0,0,0,0,0,0
120166,25000,250,0,-2,1,1,0,0,0,0,1,1,0,0,0,0,0,0,0,0,0,0,0,0,0,0,0,0,0,0,0,0,0,0
120254,25000,250,0,-2,9,3,6,0,0,0,1,1,0,0,0,0,3,1,2,0,0,0,4,1,3,1,0,1,0,0,0,0,0,0
120403,25000,250,0,-2,5,2,3,0,0,0,1,0,1,1,1,0,3,1,2,0,0,0,0,0,0,0,0,0,0,0,0,0,0,0
120421,25000,250,0,-2,3,2,1,0,0,0,0,0,0,0,0,0,1,0,1,0,0,0,1,1,0,0,0,0,0,0,0,1,1,0
120698,25000,250,0,-2,1,0,1,0,0,0,0,0,0,0,0,0,0,0,0,0,0,0,1,0,1,0,0,0,0,0,0,0,0,0
120795,25000,250,0,-2,1,0,1,0,0,0,0,0,0,0,0,0,0,0,0,0,0,0,1,0,1,0,0,0,0,0,0,0,0,0
120865,25000,250,0,-2,5,2,3,0,0,0,0,0,0,0,0,0,3,2,1,0,0,0,1,0,1,1,0,1,0,0,0,0,0,0
120883,25000,250,0,-2,1,0,1,0,0,0,0,0,0,0,0,0,1,0,1,0,0,0,0,0,0,0,0,0,0,0,0,0,0,0
120971,25000,250,0,-2,1,0,1,0,0,0,0,0,0,0,0,0,0,0,0,0,0,0,0,0,0,0,0,0,1,0,1,0,0,0
121044,25000,250,0,-2,2,0,2,0,0,0,1,0,1,0,0,0,1,0,1,0,0,0,0,0,0,0,0,0,0,0,0,0,0,0
121150,25000,250,0,-2,48,18,30,0,0,0,9,4,5,3,0,3,11,5,6,0,0,0,22,8,14,2,1,1,1,0,1,0,0,0
121257,25000,250,0,-2,3,1,2,0,0,0,1,0,1,0,0,0,1,1,0,0,0,0,0,0,0,0,0,0,1,0,1,0,0,0
121309,25000,250,0,-2,11,1,10,0,0,0,1,1,0,1,0,1,4,0,4,0,0,0,5,0,5,0,0,0,0,0,0,0,0,0
121345,25000,250,0,-2,10,3,7,0,0,0,1,1,0,1,0,1,5,2,3,0,0,0,2,0,2,0,0,0,1,0,1,0,0,0
121619,25000,250,0,-2,1,0,1,0,0,0,1,0,1,0,0,0,0,0,0,0,0,0,0,0,0,0,0,0,0,0,0,0,0,0
121691,25000,250,0,-2,3,0,3,0,0,0,0,0,0,0,0,0,1,0,1,0,0,0,0,0,0,0,0,0,2,0,2,0,0,0
122296,25000,250,0,-2,7,3,4,0,0,0,0,0,0,0,0,0,1,1,0,0,0,0,1,1,0,0,0,0,5,1,4,0,0,0
122409,25000,250,0,-2,6,2,4,0,0,0,0,0,0,1,0,1,0,0,0,0,0,0,3,1,2,0,0,0,1,1,0,1,0,1
122436,25000,250,0,-2,15,3,12,0,0,0,1,0,1,4,1,3,3,0,3,0,0,0,6,2,4,1,0,1,0,0,0,0,0,0
122454,25000,250,0,-2,1,0,1,0,0,0,0,0,0,1,0,1,0,0,0,0,0,0,0,0,0,0,0,0,0,0,0,0,0,0
122506,25000,250,0,-2,2,2,0,0,0,0,0,0,0,0,0,0,1,1,0,0,0,0,1,1,0,0,0,0,0,0,0,0,0,0
122597,25000,250,0,-2,7,1,6,0,0,0,0,0,0,1,0,1,1,0,1,0,0,0,2,0,2,0,0,0,2,1,1,1,0,1
122612,25000,250,0,-2,7,2,5,1,0,1,0,0,0,1,0,1,0,0,0,0,0,0,3,1,2,2,1,1,0,0,0,0,0,0
122685,25000,250,0,-2,23,6,17,0,0,0,3,1,2,3,2,1,6,1,5,0,0,0,10,2,8,0,0,0,1,0,1,0,0,0
122694,25000,250,0,-2,4,2,2,0,0,0,0,0,0,1,1,0,1,1,0,0,0,0,2,0,2,0,0,0,0,0,0,0,0,0
122728,25000,250,0,-2,5,1,4,0,0,0,0,0,0,0,0,0,0,0,0,0,0,0,4,0,4,0,0,0,1,1,0,0,0,0
122746,25000,250,0,-2,1,0,1,0,0,0,0,0,0,0,0,0,0,0,0,0,0,0,0,0,0,0,0,0,1,0,1,0,0,0
122755,25000,250,0,-2,4,2,2,0,0,0,2,1,1,0,0,0,0,0,0,0,0,0,2,1,1,0,0,0,0,0,0,0,0,0
122931,25000,250,0,-2,25,9,16,0,0,0,9,4,5,1,1,0,1,0,1,0,0,0,9,3,6,1,1,0,3,0,3,1,0,1
123013,25000,250,0,-2,2,0,2,0,0,0,0,0,0,0,0,0,1,0,1,0,0,0,1,0,1,0,0,0,0,0,0,0,0,0
123095,25000,250,0,-2,3,1,2,0,0,0,2,1,1,0,0,0,0,0,0,0,0,0,1,0,1,0,0,0,0,0,0,0,0,0
123165,25000,250,0,-2,8,1,7,0,0,0,2,0,2,0,0,0,6,1,5,0,0,0,0,0,0,0,0,0,0,0,0,0,0,0
123217,25000,250,0,-2,4,4,0,0,0,0,0,0,0,0,0,0,1,1,0,0,0,0,2,2,0,0,0,0,0,0,0,1,1,0
123299,25000,250,0,-2,1,0,1,0,0,0,0,0,0,0,0,0,0,0,0,0,0,0,1,0,1,0,0,0,0,0,0,0,0,0
123457,25000,250,0,-2,1,0,1,0,0,0,0,0,0,0,0,0,0,0,0,0,0,0,1,0,1,0,0,0,0,0,0,0,0,0
123509,25000,250,0,-2,1,1,0,0,0,0,1,1,0,0,0,0,0,0,0,0,0,0,0,0,0,0,0,0,0,0,0,0,0,0
123563,25000,250,0,-2,3,3,0,0,0,0,0,0,0,0,0,0,1,1,0,0,0,0,1,1,0,1,1,0,0,0,0,0,0,0
123800,25000,250,0,-2,3,1,2,0,0,0,0,0,0,1,0,1,2,1,1,0,0,0,0,0,0,0,0,0,0,0,0,0,0,0
123943,25000,250,0,-2,2,1,1,0,0,0,1,1,0,0,0,0,0,0,0,0,0,0,1,0,1,0,0,0,0,0,0,0,0,0
123952,25000,250,0,-2,2,1,1,0,0,0,0,0,0,0,0,0,1,1,0,0,0,0,1,0,1,0,0,0,0,0,0,0,0,0
123961,25000,250,0,-2,11,4,7,0,0,0,0,0,0,0,0,0,4,1,3,0,0,0,6,2,4,1,1,0,0,0,0,0,0,0
123970,25000,250,0,-2,1,0,1,0,0,0,0,0,0,1,0,1,0,0,0,0,0,0,0,0,0,0,0,0,0,0,0,0,0,0
124283,25000,250,0,-2,2,0,2,0,0,0,0,0,0,1,0,1,1,0,1,0,0,0,0,0,0,0,0,0,0,0,0,0,0,0
124292,25000,250,0,-2,4,2,2,0,0,0,0,0,0,0,0,0,0,0,0,0,0,0,4,2,2,0,0,0,0,0,0,0,0,0
124557,25000,250,0,-2,5,3,2,0,0,0,0,0,0,1,1,0,1,1,0,0,0,0,3,1,2,0,0,0,0,0,0,0,0,0
125028,25000,250,0,-2,5,0,5,1,0,1,0,0,0,0,0,0,0,0,0,0,0,0,1,0,1,0,0,0,2,0,2,1,0,1
125091,25000,250,0,-2,1,0,1,0,0,0,0,0,0,0,0,0,1,0,1,0,0,0,0,0,0,0,0,0,0,0,0,0,0,0
125231,25000,250,0,-2,55,16,39,1,0,1,1,1,0,14,4,10,3,1,2,0,0,0,30,6,24,4,3,1,2,1,1,0,0,0
125471,25000,250,0,-2,1,0,1,0,0,0,0,0,0,0,0,0,0,0,0,0,0,0,1,0,1,0,0,0,0,0,0,0,0,0
125532,25000,250,0,-2,12,3,9,0,0,0,0,0,0,2,1,1,4,1,3,0,0,0,4,0,4,0,0,0,2,1,1,0,0,0
125727,25000,250,0,-2,5,2,3,0,0,0,0,0,0,0,0,0,2,1,1,0,0,0,3,1,2,0,0,0,0,0,0,0,0,0
125763,25000,250,0,-2,15,4,11,1,1,0,0,0,0,0,0,0,7,1,6,0,0,0,6,2,4,0,0,0,1,0,1,0,0,0
125897,25000,250,0,-2,3,0,3,0,0,0,0,0,0,0,0,0,1,0,1,0,0,0,2,0,2,0,0,0,0,0,0,0,0,0
126012,25000,250,0,-2,1,0,1,0,0,0,0,0,0,0,0,0,0,0,0,0,0,0,1,0,1,0,0,0,0,0,0,0,0,0
126049,25000,250,0,-2,2,0,2,0,0,0,0,0,0,0,0,0,0,0,0,0,0,0,2,0,2,0,0,0,0,0,0,0,0,0
126182,25000,250,0,-2,5,0,5,0,0,0,1,0,1,0,0,0,1,0,1,0,0,0,3,0,3,0,0,0,0,0,0,0,0,0
126289,25000,250,0,-2,16,4,12,0,0,0,1,0,1,1,0,1,3,0,3,0,0,0,9,3,6,2,1,1,0,0,0,0,0,0
126359,25000,250,0,-2,2,0,2,0,0,0,0,0,0,0,0,0,1,0,1,0,0,0,1,0,1,0,0,0,0,0,0,0,0,0
126562,25000,250,0,-2,62,10,52,1,0,1,4,0,4,1,1,0,7,2,5,0,0,0,42,6,36,0,0,0,7,1,6,0,0,0
126580,25000,250,0,-2,27,13,14,0,0,0,0,0,0,3,1,2,5,3,2,0,0,0,16,7,9,2,2,0,1,0,1,0,0,0
126605,25000,250,0,-2,2,0,2,0,0,0,0,0,0,0,0,0,0,0,0,0,0,0,2,0,2,0,0,0,0,0,0,0,0,0
126614,25000,250,0,-2,3,1,2,0,0,0,1,1,0,0,0,0,1,0,1,0,0,0,1,0,1,0,0,0,0,0,0,0,0,0
126669,25000,250,0,-2,5,2,3,0,0,0,1,0,1,0,0,0,0,0,0,0,0,0,4,2,2,0,0,0,0,0,0,0,0,0
126678,25000,250,0,-2,33,8,25,1,0,1,2,0,2,2,1,1,7,1,6,0,0,0,18,6,12,0,0,0,0,0,0,3,0,3
126711,25000,250,0,-2,3,1,2,0,0,0,0,0,0,0,0,0,0,0,0,0,0,0,2,0,2,0,0,0,1,1,0,0,0,0
126775,25000,250,0,-2,12,5,7,0,0,0,0,0,0,0,0,0,2,1,1,1,1,0,8,3,5,0,0,0,1,0,1,0,0,0
126818,25000,250,0,-2,40,14,26,0,0,0,1,1,0,5,1,4,5,2,3,0,0,0,25,7,18,1,1,0,3,2,1,0,0,0
126827,25000,250,0,-2,7,2,5,0,0,0,0,0,0,4,1,3,0,0,0,0,0,0,3,1,2,0,0,0,0,0,0,0,0,0
126863,25000,250,0,-2,22,11,11,1,1,0,1,0,1,2,2,0,5,3,2,0,0,0,13,5,8,0,0,0,0,0,0,0,0,0
126942,25000,250,0,-2,10,3,7,1,0,1,1,0,1,1,0,1,1,0,1,0,0,0,6,3,3,0,0,0,0,0,0,0,0,0
126951,25000,250,0,-2,5,1,4,1,0,1,0,0,0,0,0,0,2,0,2,0,0,0,2,1,1,0,0,0,0,0,0,0,0,0
126979,25000,250,0,-2,5,3,2,0,0,0,0,0,0,1,0,1,0,0,0,0,0,0,4,3,1,0,0,0,0,0,0,0,0,0
127060,25000,250,0,-2,20,4,16,2,0,2,0,0,0,1,0,1,1,1,0,0,0,0,7,1,6,9,2,7,0,0,0,0,0,0
127185,25000,250,0,-2,7,2,5,0,0,0,0,0,0,0,0,0,0,0,0,0,0,0,7,2,5,0,0,0,0,0,0,0,0,0
127200,25000,250,0,-2,5,1,4,1,0,1,0,0,0,0,0,0,1,0,1,0,0,0,3,1,2,0,0,0,0,0,0,0,0,0
127273,25000,250,0,-2,1,0,1,0,0,0,0,0,0,0,0,0,0,0,0,0,0,0,1,0,1,0,0,0,0,0,0,0,0,0
127389,25000,250,0,-2,5,1,4,0,0,0,1,1,0,0,0,0,3,0,3,0,0,0,1,0,1,0,0,0,0,0,0,0,0,0
127556,25000,250,0,-2,2,2,0,0,0,0,0,0,0,0,0,0,0,0,0,0,0,0,1,1,0,0,0,0,1,1,0,0,0,0
127565,25000,250,0,-2,6,2,4,0,0,0,0,0,0,0,0,0,1,0,1,0,0,0,4,1,3,1,1,0,0,0,0,0,0,0
127617,25000,250,0,-2,5,1,4,0,0,0,0,0,0,0,0,0,1,0,1,0,0,0,4,1,3,0,0,0,0,0,0,0,0,0
127653,25000,250,0,-2,4,2,2,0,0,0,0,0,0,0,0,0,1,1,0,0,0,0,1,1,0,0,0,0,2,0,2,0,0,0
127732,25000,250,0,-2,3,1,2,0,0,0,0,0,0,1,1,0,2,0,2,0,0,0,0,0,0,0,0,0,0,0,0,0,0,0
127741,25000,250,0,-2,15,2,13,0,0,0,0,0,0,2,0,2,2,0,2,0,0,0,11,2,9,0,0,0,0,0,0,0,0,0
127778,25000,250,0,-2,26,3,23,0,0,0,0,0,0,1,0,1,16,2,14,0,0,0,9,1,8,0,0,0,0,0,0,0,0,0
127820,25000,250,0,-2,6,3,3,1,1,0,0,0,0,0,0,0,0,0,0,0,0,0,5,2,3,0,0,0,0,0,0,0,0,0
127884,25000,250,0,-2,10,1,9,0,0,0,0,0,0,0,0,0,4,1,3,0,0,0,6,0,6,0,0,0,0,0,0,0,0,0
127909,25000,250,0,-2,12,3,9,0,0,0,2,1,1,2,1,1,1,0,1,0,0,0,7,1,6,0,0,0,0,0,0,0,0,0
127945,25000,250,0,-2,11,2,9,0,0,0,1,0,1,0,0,0,1,0,1,0,0,0,8,2,6,1,0,1,0,0,0,0,0,0
128106,25000,250,0,-2,4,1,3,0,0,0,0,0,0,0,0,0,2,1,1,0,0,0,2,0,2,0,0,0,0,0,0,0,0,0
128258,25000,250,0,-2,8,3,5,0,0,0,0,0,0,0,0,0,3,1,2,0,0,0,5,2,3,0,0,0,0,0,0,0,0,0
128328,25000,250,0,-2,10,3,7,0,0,0,0,0,0,0,0,0,0,0,0,0,0,0,7,3,4,2,0,2,1,0,1,0,0,0
128391,25000,250,0,-2,7,4,3,0,0,0,0,0,0,0,0,0,1,0,1,0,0,0,5,4,1,1,0,1,0,0,0,0,0,0
128498,25000,250,0,-2,4,2,2,0,0,0,0,0,0,0,0,0,2,1,1,0,0,0,2,1,1,0,0,0,0,0,0,0,0,0
128577,25000,250,0,-2,4,1,3,0,0,0,0,0,0,0,0,0,0,0,0,0,0,0,4,1,3,0,0,0,0,0,0,0,0,0
128744,25000,250,0,-2,96,31,65,0,0,0,5,2,3,10,2,8,16,3,13,1,0,1,62,22,40,1,1,0,1,1,0,0,0,0
128771,25000,250,0,-2,4,2,2,0,0,0,1,0,1,0,0,0,0,0,0,0,0,0,3,2,1,0,0,0,0,0,0,0,0,0
128780,25000,250,0,-2,1,0,1,0,0,0,0,0,0,0,0,0,0,0,0,0,0,0,1,0,1,0,0,0,0,0,0,0,0,0
128902,25000,250,0,-2,1,0,1,0,0,0,0,0,0,0,0,0,0,0,0,0,0,0,0,0,0,0,0,0,1,0,1,0,0,0
129020,25000,250,0,-2,5,1,4,0,0,0,0,0,0,1,0,1,0,0,0,0,0,0,4,1,3,0,0,0,0,0,0,0,0,0
129154,25000,250,0,-2,12,2,10,0,0,0,0,0,0,3,1,2,0,0,0,0,0,0,9,1,8,0,0,0,0,0,0,0,0,0
129215,25000,250,0,-2,10,2,8,0,0,0,1,1,0,3,1,2,2,0,2,0,0,0,4,0,4,0,0,0,0,0,0,0,0,0
129242,25000,250,0,-2,25,10,15,0,0,0,1,1,0,2,0,2,3,1,2,0,0,0,19,8,11,0,0,0,0,0,0,0,0,0
129491,25000,250,0,-2,3,1,2,0,0,0,0,0,0,1,1,0,0,0,0,0,0,0,2,0,2,0,0,0,0,0,0,0,0,0
129695,25000,250,0,-2,1,0,1,0,0,0,0,0,0,1,0,1,0,0,0,0,0,0,0,0,0,0,0,0,0,0,0,0,0,0
129729,25000,250,0,-2,2,0,2,0,0,0,0,0,0,0,0,0,1,0,1,0,0,0,0,0,0,0,0,0,1,0,1,0,0,0
129756,25000,250,0,-2,2,0,2,0,0,0,0,0,0,0,0,0,0,0,0,0,0,0,2,0,2,0,0,0,0,0,0,0,0,0
129808,25000,250,0,-2,1,1,0,0,0,0,0,0,0,0,0,0,0,0,0,0,0,0,1,1,0,0,0,0,0,0,0,0,0,0
129941,25000,250,0,-2,1,1,0,0,0,0,0,0,0,0,0,0,0,0,0,0,0,0,1,1,0,0,0,0,0,0,0,0,0,0
130040,25000,250,0,-2,2,2,0,0,0,0,1,1,0,0,0,0,0,0,0,0,0,0,0,0,0,0,0,0,1,1,0,0,0,0
130110,25000,250,0,-2,1,1,0,0,0,0,0,0,0,0,0,0,1,1,0,0,0,0,0,0,0,0,0,0,0,0,0,0,0,0
130217,25000,250,0,-2,2,2,0,0,0,0,0,0,0,0,0,0,0,0,0,0,0,0,2,2,0,0,0,0,0,0,0,0,0,0
130253,25000,250,0,-2,9,3,6,0,0,0,0,0,0,0,0,0,0,0,0,0,0,0,1,0,1,0,0,0,8,3,5,0,0,0
130314,25000,250,0,-2,48,4,44,0,0,0,1,0,1,6,1,5,7,1,6,0,0,0,32,2,30,2,0,2,0,0,0,0,0,0
130396,25000,250,0,-2,5,0,5,0,0,0,0,0,0,1,0,1,2,0,2,0,0,0,1,0,1,0,0,0,1,0,1,0,0,0
130493,25000,250,0,-2,9,3,6,0,0,0,1,0,1,1,1,0,3,1,2,0,0,0,4,1,3,0,0,0,0,0,0,0,0,0
130590,25000,250,0,-2,8,0,8,0,0,0,0,0,0,1,0,1,1,0,1,0,0,0,4,0,4,1,0,1,1,0,1,0,0,0
130624,25000,250,0,-2,49,30,19,1,1,0,0,0,0,1,1,0,0,0,0,0,0,0,23,19,4,1,1,0,23,8,15,0,0,0
130697,25000,250,0,-2,11,7,4,0,0,0,0,0,0,0,0,0,3,1,2,0,0,0,5,4,1,0,0,0,1,1,0,2,1,1
130776,25000,250,0,-2,3,3,0,0,0,0,0,0,0,0,0,0,1,1,0,0,0,0,1,1,0,1,1,0,0,0,0,0,0,0
130794,25000,250,0,-2,22,7,15,0,0,0,1,0,1,1,0,1,0,0,0,0,0,0,12,4,8,3,2,1,4,1,3,1,0,1
130934,25000,250,0,-2,20,2,18,0,0,0,0,0,0,11,2,9,0,0,0,0,0,0,9,0,9,0,0,0,0,0,0,0,0,0
130943,25000,250,0,-2,8,3,5,0,0,0,2,0,2,0,0,0,0,0,0,0,0,0,5,2,3,1,1,0,0,0,0,0,0,0
131113,25000,250,0,-2,4,1,3,0,0,0,0,0,0,1,0,1,0,0,0,0,0,0,3,1,2,0,0,0,0,0,0,0,0,0
131159,25000,250,0,-2,6,1,5,0,0,0,1,0,1,2,0,2,0,0,0,0,0,0,2,1,1,0,0,0,0,0,0,1,0,1
131283,25000,250,0,-2,10,3,7,0,0,0,1,0,1,0,0,0,2,1,1,0,0,0,2,1,1,0,0,0,4,1,3,1,0,1
131399,25000,250,0,-2,3,2,1,0,0,0,1,0,1,2,2,0,0,0,0,0,0,0,0,0,0,0,0,0,0,0,0,0,0,0
131450,25000,250,0,-2,3,0,3,0,0,0,0,0,0,0,0,0,0,0,0,0,0,0,3,0,3,0,0,0,0,0,0,0,0,0
131469,25000,250,0,-2,110,34,76,0,0,0,9,2,7,34,8,26,13,4,9,0,0,0,48,18,30,6,2,4,0,0,0,0,0,0
131496,25000,250,0,-2,8,2,6,0,0,0,1,0,1,0,0,0,0,0,0,0,0,0,6,2,4,0,0,0,0,0,0,1,0,1
131520,25000,250,0,-2,5,1,4,0,0,0,0,0,0,3,0,3,1,1,0,0,0,0,0,0,0,0,0,0,1,0,1,0,0,0
131803,25000,250,0,-2,63,16,47,0,0,0,1,1,0,33,4,29,2,1,1,0,0,0,20,7,13,0,0,0,7,3,4,0,0,0
131876,25000,250,0,-2,3,2,1,0,0,0,0,0,0,1,1,0,0,0,0,0,0,0,2,1,1,0,0,0,0,0,0,0,0,0
131973,25000,250,0,-2,2,2,0,0,0,0,0,0,0,2,2,0,0,0,0,0,0,0,0,0,0,0,0,0,0,0,0,0,0,0
132471,25000,250,0,-2,1,0,1,0,0,0,0,0,0,0,0,0,1,0,1,0,0,0,0,0,0,0,0,0,0,0,0,0,0,0
132602,25000,250,0,-2,8,2,6,0,0,0,0,0,0,6,2,4,0,0,0,0,0,0,2,0,2,0,0,0,0,0,0,0,0,0
132657,25000,250,0,-2,8,3,5,0,0,0,0,0,0,1,1,0,1,0,1,0,0,0,4,2,2,1,0,1,1,0,1,0,0,0
132693,25000,250,0,-2,1,1,0,0,0,0,0,0,0,0,0,0,1,1,0,0,0,0,0,0,0,0,0,0,0,0,0,0,0,0
132709,25000,250,0,-2,9,0,9,0,0,0,1,0,1,3,0,3,3,0,3,0,0,0,2,0,2,0,0,0,0,0,0,0,0,0
132851,25000,250,0,-2,1,0,1,0,0,0,0,0,0,0,0,0,0,0,0,0,0,0,1,0,1,0,0,0,0,0,0,0,0,0
132903,25000,250,0,-2,2,1,1,0,0,0,0,0,0,0,0,0,0,0,0,0,0,0,2,1,1,0,0,0,0,0,0,0,0,0
133021,25000,250,0,-2,1,0,1,0,0,0,0,0,0,0,0,0,0,0,0,0,0,0,1,0,1,0,0,0,0,0,0,0,0,0
133386,25000,250,0,-2,3,0,3,0,0,0,0,0,0,0,0,0,0,0,0,0,0,0,3,0,3,0,0,0,0,0,0,0,0,0
133465,25000,250,0,-2,8,3,5,0,0,0,0,0,0,3,0,3,1,0,1,0,0,0,4,3,1,0,0,0,0,0,0,0,0,0
133492,25000,250,0,-2,1,0,1,0,0,0,0,0,0,0,0,0,0,0,0,0,0,0,1,0,1,0,0,0,0,0,0,0,0,0
133508,25000,250,0,-2,9,6,3,0,0,0,0,0,0,1,1,0,3,1,2,0,0,0,5,4,1,0,0,0,0,0,0,0,0,0
133526,25000,250,0,-2,4,4,0,0,0,0,0,0,0,3,3,0,0,0,0,0,0,0,1,1,0,0,0,0,0,0,0,0,0,0
133553,25000,250,0,-2,132,84,48,0,0,0,10,7,3,9,4,5,12,7,5,1,0,1,67,37,30,0,0,0,23,20,3,10,9,1
133650,25000,250,0,-2,8,5,3,0,0,0,0,0,0,8,5,3,0,0,0,0,0,0,0,0,0,0,0,0,0,0,0,0,0,0
133669,25000,250,0,-2,32,9,23,0,0,0,3,2,1,6,3,3,5,1,4,0,0,0,18,3,15,0,0,0,0,0,0,0,0,0
133702,25000,250,0,-2,5,1,4,0,0,0,0,0,0,1,1,0,2,0,2,0,0,0,1,0,1,1,0,1,0,0,0,0,0,0
133711,25000,250,0,-2,1,0,1,0,0,0,0,0,0,0,0,0,0,0,0,0,0,0,1,0,1,0,0,0,0,0,0,0,0,0
133809,25000,250,0,-2,1,1,0,0,0,0,0,0,0,0,0,0,0,0,0,0,0,0,1,1,0,0,0,0,0,0,0,0,0,0
133863,25000,250,0,-2,1,0,1,0,0,0,0,0,0,1,0,1,0,0,0,0,0,0,0,0,0,0,0,0,0,0,0,0,0,0
133872,25000,250,0,-2,7,2,5,0,0,0,0,0,0,0,0,0,5,1,4,0,0,0,1,0,1,1,1,0,0,0,0,0,0,0
133881,25000,250,0,-2,4,0,4,0,0,0,0,0,0,0,0,0,0,0,0,0,0,0,3,0,3,1,0,1,0,0,0,0,0,0
133951,25000,250,0,-2,3,0,3,0,0,0,0,0,0,0,0,0,0,0,0,0,0,0,3,0,3,0,0,0,0,0,0,0,0,0
133979,25000,250,0,-2,7,0,7,0,0,0,0,0,0,7,0,7,0,0,0,0,0,0,0,0,0,0,0,0,0,0,0,0,0,0
134079,25000,250,0,-2,11,2,9,0,0,0,0,0,0,1,0,1,3,1,2,0,0,0,7,1,6,0,0,0,0,0,0,0,0,0
134130,25000,250,0,-2,67,15,52,0,0,0,1,0,1,12,2,10,6,2,4,0,0,0,43,10,33,0,0,0,3,1,2,2,0,2
134343,25000,250,0,-2,2,1,1,0,0,0,0,0,0,0,0,0,0,0,0,0,0,0,2,1,1,0,0,0,0,0,0,0,0,0
134495,25000,250,0,-2,4,2,2,0,0,0,0,0,0,0,0,0,1,1,0,0,0,0,3,1,2,0,0,0,0,0,0,0,0,0
134608,25000,250,0,-2,2,1,1,0,0,0,0,0,0,0,0,0,1,1,0,0,0,0,1,0,1,0,0,0,0,0,0,0,0,0
134945,25000,250,0,-2,9,5,4,2,1,1,0,0,0,1,1,0,0,0,0,0,0,0,6,3,3,0,0,0,0,0,0,0,0,0
135081,25000,250,0,-2,4,1,3,0,0,0,0,0,0,0,0,0,2,0,2,0,0,0,2,1,1,0,0,0,0,0,0,0,0,0
135160,25000,250,0,-2,1,0,1,0,0,0,0,0,0,0,0,0,0,0,0,0,0,0,1,0,1,0,0,0,0,0,0,0,0,0
135364,25000,250,0,-2,1,1,0,0,0,0,0,0,0,0,0,0,0,0,0,0,0,0,1,1,0,0,0,0,0,0,0,0,0,0
135391,25000,250,0,-2,7,4,3,0,0,0,0,0,0,1,1,0,0,0,0,0,0,0,6,3,3,0,0,0,0,0,0,0,0,0
135717,25000,250,0,-2,3,0,3,0,0,0,0,0,0,2,0,2,0,0,0,0,0,0,1,0,1,0,0,0,0,0,0,0,0,0
135726,25000,250,0,-2,19,4,15,0,0,0,1,0,1,3,2,1,5,2,3,0,0,0,7,0,7,0,0,0,2,0,2,1,0,1
136172,25000,250,0,-2,14,5,9,0,0,0,0,0,0,0,0,0,0,0,0,0,0,0,10,4,6,2,0,2,0,0,0,2,1,1
136215,25000,250,0,-2,96,19,77,0,0,0,1,0,1,15,2,13,39,7,32,0,0,0,38,10,28,0,0,0,0,0,0,3,0,3
136233,25000,250,0,-2,10,6,4,0,0,0,1,0,1,1,0,1,1,1,0,1,1,0,5,4,1,1,0,1,0,0,0,0,0,0
136330,25000,250,0,-2,18,11,7,0,0,0,0,0,0,2,1,1,4,4,0,0,0,0,9,3,6,0,0,0,1,1,0,2,2,0
136358,25000,250,0,-2,9,2,7,0,0,0,0,0,0,3,0,3,2,0,2,0,0,0,4,2,2,0,0,0,0,0,0,0,0,0
136400,25000,250,0,-2,1,0,1,0,0,0,0,0,0,0,0,0,1,0,1,0,0,0,0,0,0,0,0,0,0,0,0,0,0,0
136473,25000,250,0,-2,6,4,2,0,0,0,0,0,0,2,2,0,1,0,1,0,0,0,3,2,1,0,0,0,0,0,0,0,0,0
136516,25000,250,0,-2,10,2,8,0,0,0,0,0,0,0,0,0,0,0,0,0,0,0,9,2,7,0,0,0,1,0,1,0,0,0
136774,25000,250,0,-2,2,0,2,0,0,0,0,0,0,0,0,0,0,0,0,0,0,0,2,0,2,0,0,0,0,0,0,0,0,0
136950,25000,250,0,-2,10,1,9,0,0,0,0,0,0,2,0,2,0,0,0,0,0,0,8,1,7,0,0,0,0,0,0,0,0,0
137032,25000,250,0,-2,15,6,9,1,0,1,0,0,0,2,1,1,2,0,2,0,0,0,9,4,5,0,0,0,1,1,0,0,0,0
137078,25000,250,0,-2,10,4,6,0,0,0,1,0,1,2,0,2,2,2,0,0,0,0,5,2,3,0,0,0,0,0,0,0,0,0
137209,25000,250,0,-2,4,2,2,0,0,0,0,0,0,2,0,2,0,0,0,0,0,0,2,2,0,0,0,0,0,0,0,0,0,0
137281,25000,250,0,-2,7,2,5,0,0,0,1,1,0,1,0,1,1,0,1,0,0,0,4,1,3,0,0,0,0,0,0,0,0,0
137315,25000,250,0,-2,3,3,0,0,0,0,0,0,0,1,1,0,0,0,0,0,0,0,2,2,0,0,0,0,0,0,0,0,0,0
137351,25000,250,0,-2,57,22,35,0,0,0,1,0,1,7,2,5,6,2,4,0,0,0,35,15,20,7,2,5,1,1,0,0,0,0
137476,25000,250,0,-2,9,5,4,0,0,0,0,0,0,2,2,0,5,2,3,0,0,0,2,1,1,0,0,0,0,0,0,0,0,0
137546,25000,250,0,-2,4,2,2,0,0,0,0,0,0,0,0,0,0,0,0,0,0,0,4,2,2,0,0,0,0,0,0,0,0,0
137564,25000,250,0,-2,2,0,2,0,0,0,0,0,0,0,0,0,0,0,0,0,0,0,2,0,2,0,0,0,0,0,0,0,0,0
137759,25000,250,0,-2,6,0,6,0,0,0,0,0,0,2,0,2,1,0,1,0,0,0,3,0,3,0,0,0,0,0,0,0,0,0
137847,25000,250,0,-2,7,1,6,0,0,0,0,0,0,1,0,1,0,0,0,0,0,0,4,1,3,1,0,1,1,0,1,0,0,0
137962,25000,250,0,-2,2,2,0,0,0,0,0,0,0,1,1,0,0,0,0,0,0,0,1,1,0,0,0,0,0,0,0,0,0,0
138187,25000,250,0,-2,3,1,2,0,0,0,0,0,0,1,0,1,2,1,1,0,0,0,0,0,0,0,0,0,0,0,0,0,0,0
138309,25000,250,0,-2,22,5,17,0,0,0,0,0,0,3,0,3,2,2,0,0,0,0,15,2,13,2,1,1,0,0,0,0,0,0
138354,25000,250,0,-2,5,3,2,0,0,0,0,0,0,0,0,0,0,0,0,0,0,0,5,3,2,0,0,0,0,0,0,0,0,0
138558,25000,250,0,-2,6,3,3,0,0,0,0,0,0,1,1,0,1,1,0,0,0,0,4,1,3,0,0,0,0,0,0,0,0,0
138600,25000,250,0,-2,4,0,4,0,0,0,0,0,0,1,0,1,1,0,1,0,0,0,2,0,2,0,0,0,0,0,0,0,0,0
138682,25000,250,0,-2,5,0,5,0,0,0,0,0,0,4,0,4,0,0,0,0,0,0,1,0,1,0,0,0,0,0,0,0,0,0
138716,25000,250,0,-2,7,3,4,0,0,0,0,0,0,5,2,3,0,0,0,0,0,0,1,0,1,0,0,0,1,1,0,0,0,0
138840,25000,250,0,-2,1,0,1,0,0,0,0,0,0,1,0,1,0,0,0,0,0,0,0,0,0,0,0,0,0,0,0,0,0,0
138868,25000,250,0,-2,9,3,6,0,0,0,0,0,0,3,2,1,0,0,0,0,0,0,6,1,5,0,0,0,0,0,0,0,0,0
138901,25000,250,0,-2,1,0,1,0,0,0,0,0,0,1,0,1,0,0,0,0,0,0,0,0,0,0,0,0,0,0,0,0,0,0
138929,25000,250,0,-2,2,2,0,0,0,0,0,0,0,0,0,0,0,0,0,0,0,0,2,2,0,0,0,0,0,0,0,0,0,0
138956,25000,250,0,-2,1,0,1,0,0,0,0,0,0,0,0,0,0,0,0,0,0,0,1,0,1,0,0,0,0,0,0,0,0,0
139205,25000,250,0,-2,1,0,1,0,0,0,0,0,0,0,0,0,0,0,0,0,0,0,1,0,1,0,0,0,0,0,0,0,0,0
139250,25000,250,0,-2,2,1,1,0,0,0,0,0,0,0,0,0,1,0,1,0,0,0,1,1,0,0,0,0,0,0,0,0,0,0
139278,25000,250,0,-2,4,3,1,0,0,0,0,0,0,1,1,0,0,0,0,0,0,0,3,2,1,0,0,0,0,0,0,0,0,0
139311,25000,250,0,-2,12,2,10,0,0,0,0,0,0,9,1,8,1,0,1,0,0,0,2,1,1,0,0,0,0,0,0,0,0,0
139348,25000,250,0,-2,1,1,0,0,0,0,0,0,0,0,0,0,0,0,0,0,0,0,1,1,0,0,0,0,0,0,0,0,0,0
139357,25000,250,0,-2,1,0,1,0,0,0,0,0,0,0,0,0,0,0,0,0,0,0,1,0,1,0,0,0,0,0,0,0,0,0
139366,25000,250,0,-2,19,7,12,0,0,0,1,1,0,6,2,4,3,1,2,0,0,0,7,2,5,2,1,1,0,0,0,0,0,0
139463,25000,250,0,-2,2,0,2,0,0,0,0,0,0,0,0,0,1,0,1,0,0,0,1,0,1,0,0,0,0,0,0,0,0,0
139579,25000,250,0,-2,9,1,8,0,0,0,1,0,1,1,0,1,1,0,1,0,0,0,5,1,4,0,0,0,1,0,1,0,0,0
139621,25000,250,0,-2,1,0,1,0,0,0,0,0,0,0,0,0,0,0,0,0,0,0,1,0,1,0,0,0,0,0,0,0,0,0
139658,25000,250,0,-2,188,42,146,0,0,0,17,4,13,76,15,61,10,3,7,0,0,0,82,19,63,2,0,2,0,0,0,1,1,0
139700,25000,250,0,-2,4,2,2,0,0,0,0,0,0,2,2,0,0,0,0,0,0,0,2,0,2,0,0,0,0,0,0,0,0,0
139719,25000,250,0,-2,16,1,15,0,0,0,0,0,0,15,1,14,1,0,1,0,0,0,0,0,0,0,0,0,0,0,0,0,0,0
139755,25000,250,0,-2,56,18,38,0,0,0,4,1,3,21,5,16,3,0,3,0,0,0,20,11,9,7,1,6,1,0,1,0,0,0
139764,25000,250,0,-2,3,0,3,0,0,0,1,0,1,0,0,0,0,0,0,0,0,0,2,0,2,0,0,0,0,0,0,0,0,0
139861,25000,250,0,-2,13,0,13,0,0,0,1,0,1,2,0,2,2,0,2,0,0,0,8,0,8,0,0,0,0,0,0,0,0,0
139931,25000,250,0,-2,33,13,20,0,0,0,0,0,0,9,5,4,3,0,3,0,0,0,20,7,13,1,1,0,0,0,0,0,0,0
139940,25000,250,0,-2,86,23,63,0,0,0,4,2,2,44,9,35,6,3,3,1,0,1,28,7,21,2,1,1,0,0,0,1,1,0
139959,25000,250,0,-2,52,8,44,0,0,0,0,0,0,10,1,9,1,0,1,1,0,1,33,5,28,1,0,1,6,2,4,0,0,0
139968,25000,250,0,-2,1,1,0,0,0,0,0,0,0,0,0,0,0,0,0,0,0,0,1,1,0,0,0,0,0,0,0,0,0,0
139986,25000,250,0,-2,4,1,3,0,0,0,0,0,0,1,0,1,0,0,0,0,0,0,3,1,2,0,0,0,0,0,0,0,0,0
140012,25000,250,0,-2,5,2,3,0,0,0,1,0,1,0,0,0,1,0,1,0,0,0,3,2,1,0,0,0,0,0,0,0,0,0
140234,25000,250,0,-2,2,1,1,0,0,0,0,0,0,1,1,0,0,0,0,0,0,0,1,0,1,0,0,0,0,0,0,0,0,0
140252,25000,250,0,-2,17,4,13,0,0,0,0,0,0,11,4,7,2,0,2,0,0,0,4,0,4,0,0,0,0,0,0,0,0,0
140331,25000,250,0,-2,7,1,6,0,0,0,0,0,0,1,0,1,0,0,0,0,0,0,6,1,5,0,0,0,0,0,0,0,0,0
140340,25000,250,0,-2,2,0,2,0,0,0,0,0,0,2,0,2,0,0,0,0,0,0,0,0,0,0,0,0,0,0,0,0,0,0
140447,25000,250,0,-2,10,2,8,0,0,0,0,0,0,2,0,2,1,0,1,0,0,0,7,2,5,0,0,0,0,0,0,0,0,0
140553,25000,250,0,-2,14,3,11,0,0,0,0,0,0,13,3,10,0,0,0,0,0,0,1,0,1,0,0,0,0,0,0,0,0,0
140562,25000,250,0,-2,67,25,42,0,0,0,2,1,1,59,21,38,4,2,2,0,0,0,0,0,0,0,0,0,0,0,0,2,1,1
140678,25000,250,0,-2,3,0,3,0,0,0,0,0,0,0,0,0,0,0,0,0,0,0,3,0,3,0,0,0,0,0,0,0,0,0
140696,25000,250,0,-2,1,1,0,0,0,0,0,0,0,1,1,0,0,0,0,0,0,0,0,0,0,0,0,0,0,0,0,0,0,0
140720,25000,250,0,-2,12,7,5,0,0,0,0,0,0,12,7,5,0,0,0,0,0,0,0,0,0,0,0,0,0,0,0,0,0,0
140818,25000,250,0,-2,8,3,5,0,0,0,0,0,0,0,0,0,0,0,0,0,0,0,8,3,5,0,0,0,0,0,0,0,0,0
140872,25000,250,0,-2,3,1,2,0,0,0,0,0,0,1,0,1,0,0,0,0,0,0,2,1,1,0,0,0,0,0,0,0,0,0
140942,25000,250,0,-2,5,1,4,0,0,0,0,0,0,3,1,2,0,0,0,0,0,0,2,0,2,0,0,0,0,0,0,0,0,0
140951,25000,250,0,-2,8,6,2,0,0,0,0,0,0,0,0,0,0,0,0,0,0,0,7,5,2,0,0,0,1,1,0,0,0,0
140960,25000,250,0,-2,7,3,4,0,0,0,0,0,0,5,2,3,1,1,0,0,0,0,1,0,1,0,0,0,0,0,0,0,0,0
140988,25000,250,0,-2,2,0,2,0,0,0,0,0,0,0,0,0,0,0,0,0,0,0,2,0,2,0,0,0,0,0,0,0,0,0
141185,25000,250,0,-2,1,0,1,0,0,0,0,0,0,0,0,0,0,0,0,0,0,0,1,0,1,0,0,0,0,0,0,0,0,0
141237,25000,250,0,-2,1,1,0,0,0,0,0,0,0,0,0,0,0,0,0,0,0,0,1,1,0,0,0,0,0,0,0,0,0,0
141255,25000,250,0,-2,2,1,1,0,0,0,0,0,0,1,1,0,0,0,0,0,0,0,1,0,1,0,0,0,0,0,0,0,0,0
141264,25000,250,0,-2,6,1,5,0,0,0,0,0,0,2,0,2,1,0,1,0,0,0,2,0,2,1,1,0,0,0,0,0,0,0
141325,25000,250,0,-2,6,0,6,0,0,0,0,0,0,2,0,2,0,0,0,0,0,0,4,0,4,0,0,0,0,0,0,0,0,0
141334,25000,250,0,-2,17,3,14,0,0,0,0,0,0,5,1,4,0,0,0,0,0,0,12,2,10,0,0,0,0,0,0,0,0,0
141486,25000,250,0,-2,2,0,2,0,0,0,1,0,1,0,0,0,1,0,1,0,0,0,0,0,0,0,0,0,0,0,0,0,0,0
141574,25000,250,0,-2,10,5,5,0,0,0,1,0,1,0,0,0,2,2,0,1,1,0,4,1,3,2,1,1,0,0,0,0,0,0
141644,25000,250,0,-2,18,5,13,0,0,0,7,3,4,0,0,0,3,0,3,1,1,0,5,1,4,2,0,2,0,0,0,0,0,0
141680,25000,250,0,-2,1,0,1,0,0,0,1,0,1,0,0,0,0,0,0,0,0,0,0,0,0,0,0,0,0,0,0,0,0,0
141796,25000,250,0,-2,1,0,1,0,0,0,0,0,0,0,0,0,0,0,0,1,0,1,0,0,0,0,0,0,0,0,0,0,0,0
141811,25000,250,0,-2,1,0,1,0,0,0,0,0,0,0,0,0,0,0,0,1,0,1,0,0,0,0,0,0,0,0,0,0,0,0
141839,25000,250,0,-2,2,0,2,0,0,0,0,0,0,0,0,0,0,0,0,0,0,0,1,0,1,1,0,1,0,0,0,0,0,0
141963,25000,250,0,-2,3,2,1,0,0,0,2,1,1,0,0,0,0,0,0,0,0,0,1,1,0,0,0,0,0,0,0,0,0,0
141990,25000,250,0,-2,1,0,1,0,0,0,0,0,0,0,0,0,0,0,0,0,0,0,1,0,1,0,0,0,0,0,0,0,0,0
142054,25000,250,0,-2,3,1,2,0,0,0,0,0,0,0,0,0,1,1,0,0,0,0,2,0,2,0,0,0,0,0,0,0,0,0
142115,25000,250,0,-2,36,8,28,0,0,0,1,0,1,1,1,0,6,1,5,0,0,0,25,5,20,2,1,1,1,0,1,0,0,0
142276,25000,250,0,-2,9,3,6,1,0,1,0,0,0,0,0,0,0,0,0,0,0,0,8,3,5,0,0,0,0,0,0,0,0,0
142285,25000,250,0,-2,11,6,5,0,0,0,0,0,0,1,1,0,2,2,0,0,0,0,7,3,4,0,0,0,1,0,1,0,0,0
142294,25000,250,0,-2,2,0,2,0,0,0,0,0,0,0,0,0,0,0,0,0,0,0,1,0,1,1,0,1,0,0,0,0,0,0
142328,25000,250,0,-2,3,1,2,0,0,0,0,0,0,0,0,0,0,0,0,0,0,0,3,1,2,0,0,0,0,0,0,0,0,0
142443,25000,250,0,-2,12,1,11,0,0,0,0,0,0,0,0,0,0,0,0,0,0,0,9,1,8,0,0,0,3,0,3,0,0,0
142461,25000,250,0,-2,1,1,0,0,0,0,0,0,0,0,0,0,0,0,0,0,0,0,1,1,0,0,0,0,0,0,0,0,0,0
142522,25000,250,0,-2,8,5,3,0,0,0,0,0,0,0,0,0,0,0,0,0,0,0,8,5,3,0,0,0,0,0,0,0,0,0
142559,25000,250,0,-2,15,0,15,0,0,0,0,0,0,0,0,0,7,0,7,0,0,0,8,0,8,0,0,0,0,0,0,0,0,0
142832,25000,250,0,-2,6,1,5,0,0,0,0,0,0,0,0,0,2,1,1,0,0,0,1,0,1,0,0,0,3,0,3,0,0,0
143048,25000,250,0,-2,5,0,5,0,0,0,0,0,0,0,0,0,1,0,1,0,0,0,3,0,3,1,0,1,0,0,0,0,0,0
143084,25000,250,0,-2,1,0,1,0,0,0,0,0,0,0,0,0,1,0,1,0,0,0,0,0,0,0,0,0,0,0,0,0,0,0
143118,25000,250,0,-2,3,0,3,0,0,0,0,0,0,1,0,1,0,0,0,0,0,0,2,0,2,0,0,0,0,0,0,0,0,0
143215,25000,250,0,-2,1,0,1,0,0,0,0,0,0,0,0,0,0,0,0,0,0,0,0,0,0,0,0,0,1,0,1,0,0,0
143279,25000,250,0,-2,2,0,2,0,0,0,0,0,0,0,0,0,0,0,0,0,0,0,0,0,0,0,0,0,2,0,2,0,0,0
143288,25000,250,0,-2,1,0,1,0,0,0,0,0,0,0,0,0,0,0,0,0,0,0,1,0,1,0,0,0,0,0,0,0,0,0
143297,25000,250,0,-2,1,0,1,0,0,0,0,0,0,0,0,0,0,0,0,0,0,0,1,0,1,0,0,0,0,0,0,0,0,0
143358,25000,250,0,-2,3,1,2,0,0,0,0,0,0,1,0,1,0,0,0,0,0,0,2,1,1,0,0,0,0,0,0,0,0,0
143659,25000,250,0,-2,1,0,1,0,0,0,0,0,0,0,0,0,0,0,0,0,0,0,1,0,1,0,0,0,0,0,0,0,0,0
143978,25000,250,0,-2,7,2,5,0,0,0,0,0,0,2,1,1,2,1,1,0,0,0,2,0,2,1,0,1,0,0,0,0,0,0
144005,25000,250,0,-2,14,11,3,0,0,0,0,0,0,5,4,1,0,0,0,0,0,0,2,1,1,0,0,0,7,6,1,0,0,0
144014,25000,250,0,-2,1,1,0,0,0,0,0,0,0,0,0,0,1,1,0,0,0,0,0,0,0,0,0,0,0,0,0,0,0,0
144050,25000,250,0,-2,44,12,32,0,0,0,3,0,3,8,2,6,7,2,5,0,0,0,20,5,15,0,0,0,1,0,1,5,3,2
144184,25000,250,0,-2,6,1,5,0,0,0,0,0,0,2,1,1,1,0,1,0,0,0,2,0,2,1,0,1,0,0,0,0,0,0
144209,25000,250,0,-2,2,0,2,0,0,0,0,0,0,0,0,0,0,0,0,0,0,0,2,0,2,0,0,0,0,0,0,0,0,0
144281,25000,250,0,-2,3,1,2,0,0,0,0,0,0,0,0,0,0,0,0,0,0,0,2,0,2,1,1,0,0,0,0,0,0,0
144500,25000,250,0,-2,3,0,3,0,0,0,0,0,0,0,0,0,1,0,1,0,0,0,2,0,2,0,0,0,0,0,0,0,0,0
144740,25000,250,0,-2,14,8,6,0,0,0,0,0,0,3,1,2,3,3,0,0,0,0,6,4,2,0,0,0,1,0,1,1,0,1
144777,25000,250,0,-2,66,8,58,0,0,0,1,0,1,13,1,12,11,2,9,0,0,0,30,5,25,2,0,2,9,0,9,0,0,0
144865,25000,250,0,-2,9,1,8,0,0,0,0,0,0,2,0,2,0,0,0,0,0,0,7,1,6,0,0,0,0,0,0,0,0,0
144892,25000,250,0,-2,1,0,1,0,0,0,0,0,0,0,0,0,0,0,0,0,0,0,1,0,1,0,0,0,0,0,0,0,0,0
144944,25000,250,0,-2,2,0,2,0,0,0,0,0,0,0,0,0,0,0,0,0,0,0,2,0,2,0,0,0,0,0,0,0,0,0
144962,25000,250,0,-2,2,0,2,0,0,0,0,0,0,0,0,0,1,0,1,0,0,0,1,0,1,0,0,0,0,0,0,0,0,0
144971,25000,250,0,-2,6,2,4,0,0,0,0,0,0,2,2,0,0,0,0,0,0,0,4,0,4,0,0,0,0,0,0,0,0,0
145336,25000,250,0,-2,9,0,9,0,0,0,1,0,1,4,0,4,0,0,0,0,0,0,2,0,2,0,0,0,2,0,2,0,0,0
145372,25000,250,0,-2,4,4,0,0,0,0,0,0,0,0,0,0,0,0,0,0,0,0,4,4,0,0,0,0,0,0,0,0,0,0
145521,25000,250,0,-2,1,1,0,0,0,0,0,0,0,0,0,0,1,1,0,0,0,0,0,0,0,0,0,0,0,0,0,0,0,0
145558,25000,250,0,-2,1,1,0,0,0,0,0,0,0,0,0,0,0,0,0,0,0,0,1,1,0,0,0,0,0,0,0,0,0,0
145600,25000,250,0,-2,9,1,8,0,0,0,2,0,2,0,0,0,3,0,3,0,0,0,4,1,3,0,0,0,0,0,0,0,0,0
145619,25000,250,0,-2,1,0,1,0,0,0,0,0,0,0,0,0,0,0,0,0,0,0,1,0,1,0,0,0,0,0,0,0,0,0
145637,25000,250,0,-2,52,10,42,0,0,0,3,0,3,3,1,2,8,0,8,0,0,0,35,9,26,2,0,2,0,0,0,1,0,1
145646,25000,250,0,-2,6,2,4,0,0,0,1,0,1,0,0,0,1,0,1,0,0,0,3,1,2,1,1,0,0,0,0,0,0,0
145682,25000,250,0,-2,2,0,2,0,0,0,0,0,0,2,0,2,0,0,0,0,0,0,0,0,0,0,0,0,0,0,0,0,0,0
145707,25000,250,0,-2,2,1,1,0,0,0,0,0,0,0,0,0,0,0,0,0,0,0,2,1,1,0,0,0,0,0,0,0,0,0
145725,25000,250,0,-2,15,8,7,0,0,0,0,0,0,2,1,1,0,0,0,0,0,0,1,1,0,0,0,0,5,1,4,7,5,2
145813,25000,250,0,-2,32,11,21,0,0,0,0,0,0,4,1,3,2,0,2,0,0,0,15,4,11,0,0,0,9,5,4,2,1,1
146339,25000,250,0,-2,11,2,9,0,0,0,0,0,0,2,0,2,1,0,1,0,0,0,6,2,4,1,0,1,1,0,1,0,0,0
146348,25000,250,0,-2,2,0,2,0,0,0,0,0,0,0,0,0,0,0,0,0,0,0,2,0,2,0,0,0,0,0,0,0,0,0
146366,25000,250,0,-2,3,1,2,0,0,0,0,0,0,0,0,0,0,0,0,0,0,0,3,1,2,0,0,0,0,0,0,0,0,0
146427,25000,250,0,-2,9,5,4,0,0,0,1,1,0,1,1,0,0,0,0,0,0,0,6,3,3,0,0,0,1,0,1,0,0,0
146472,25000,250,0,-2,7,2,5,0,0,0,1,0,1,2,1,1,0,0,0,0,0,0,4,1,3,0,0,0,0,0,0,0,0,0
146481,25000,250,0,-2,10,5,5,0,0,0,1,0,1,1,0,1,1,0,1,0,0,0,7,5,2,0,0,0,0,0,0,0,0,0
146506,25000,250,0,-2,2,0,2,0,0,0,0,0,0,0,0,0,0,0,0,0,0,0,1,0,1,0,0,0,1,0,1,0,0,0
146612,25000,250,0,-2,9,8,1,0,0,0,0,0,0,0,0,0,1,1,0,0,0,0,8,7,1,0,0,0,0,0,0,0,0,0
146676,25000,250,0,-2,1,0,1,0,0,0,0,0,0,0,0,0,0,0,0,0,0,0,1,0,1,0,0,0,0,0,0,0,0,0
146685,25000,250,0,-2,6,3,3,0,0,0,0,0,0,2,1,1,1,1,0,0,0,0,2,0,2,0,0,0,1,1,0,0,0,0
146700,25000,250,0,-2,2,0,2,0,0,0,0,0,0,1,0,1,0,0,0,0,0,0,1,0,1,0,0,0,0,0,0,0,0,0
146728,25000,250,0,-2,2,1,1,0,0,0,0,0,0,1,0,1,1,1,0,0,0,0,0,0,0,0,0,0,0,0,0,0,0,0
146755,25000,250,0,-2,1,0,1,0,0,0,0,0,0,0,0,0,0,0,0,0,0,0,1,0,1,0,0,0,0,0,0,0,0,0
146816,25000,250,0,-2,3,1,2,0,0,0,1,0,1,1,1,0,0,0,0,0,0,0,1,0,1,0,0,0,0,0,0,0,0,0
146977,25000,250,0,-2,1,0,1,0,0,0,0,0,0,1,0,1,0,0,0,0,0,0,0,0,0,0,0,0,0,0,0,0,0,0
147004,25000,250,0,-2,1,1,0,0,0,0,0,0,0,0,0,0,0,0,0,0,0,0,1,1,0,0,0,0,0,0,0,0,0,0
147013,25000,250,0,-2,7,0,7,0,0,0,0,0,0,0,0,0,0,0,0,0,0,0,7,0,7,0,0,0,0,0,0,0,0,0
147369,25000,250,0,-2,1,0,1,0,0,0,0,0,0,0,0,0,0,0,0,0,0,0,1,0,1,0,0,0,0,0,0,0,0,0
147378,25000,250,0,-2,3,0,3,0,0,0,0,0,0,2,0,2,0,0,0,0,0,0,1,0,1,0,0,0,0,0,0,0,0,0
147536,25000,250,0,-2,17,4,13,0,0,0,2,0,2,3,0,3,5,2,3,0,0,0,7,2,5,0,0,0,0,0,0,0,0,0
147679,25000,250,0,-2,5,1,4,0,0,0,1,0,1,3,1,2,1,0,1,0,0,0,0,0,0,0,0,0,0,0,0,0,0,0
147703,25000,250,0,-2,16,3,13,0,0,0,1,0,1,1,0,1,0,0,0,0,0,0,11,2,9,0,0,0,0,0,0,3,1,2
147767,25000,250,0,-2,20,7,13,0,0,0,4,1,3,4,2,2,1,0,1,0,0,0,11,4,7,0,0,0,0,0,0,0,0,0
147776,25000,250,0,-2,4,2,2,0,0,0,0,0,0,0,0,0,1,1,0,0,0,0,3,1,2,0,0,0,0,0,0,0,0,0
147800,25000,250,0,-2,1,0,1,0,0,0,0,0,0,0,0,0,1,0,1,0,0,0,0,0,0,0,0,0,0,0,0,0,0,0
148256,25000,250,0,-2,3,0,3,0,0,0,0,0,0,0,0,0,0,0,0,0,0,0,3,0,3,0,0,0,0,0,0,0,0,0
148292,25000,250,0,-2,2,1,1,0,0,0,1,0,1,1,1,0,0,0,0,0,0,0,0,0,0,0,0,0,0,0,0,0,0,0
148380,25000,250,0,-2,1,1,0,0,0,0,0,0,0,0,0,0,1,1,0,0,0,0,0,0,0,0,0,0,0,0,0,0,0,0
148405,25000,250,0,-2,1,1,0,0,0,0,0,0,0,0,0,0,0,0,0,0,0,0,1,1,0,0,0,0,0,0,0,0,0,0
148487,25000,250,0,-2,24,7,17,0,0,0,0,0,0,4,0,4,3,1,2,0,0,0,2,0,2,1,1,0,11,2,9,3,3,0
148496,25000,250,0,-2,6,2,4,0,0,0,1,0,1,0,0,0,2,0,2,0,0,0,2,1,1,1,1,0,0,0,0,0,0,0
148575,25000,250,0,-2,1,1,0,0,0,0,0,0,0,0,0,0,0,0,0,0,0,0,1,1,0,0,0,0,0,0,0,0,0,0
148593,25000,250,0,-2,1,0,1,0,0,0,0,0,0,0,0,0,0,0,0,0,0,0,1,0,1,0,0,0,0,0,0,0,0,0
148627,25000,250,0,-2,6,2,4,0,0,0,0,0,0,1,0,1,1,0,1,0,0,0,2,1,1,0,0,0,2,1,1,0,0,0
148654,25000,250,0,-2,2,1,1,0,0,0,0,0,0,0,0,0,0,0,0,0,0,0,2,1,1,0,0,0,0,0,0,0,0,0
148672,25000,250,0,-2,1,0,1,0,0,0,0,0,0,0,0,0,0,0,0,0,0,0,1,0,1,0,0,0,0,0,0,0,0,0
148876,25000,250,0,-2,7,2,5,0,0,0,0,0,0,0,0,0,7,2,5,0,0,0,0,0,0,0,0,0,0,0,0,0,0,0
149028,25000,250,0,-2,1,0,1,0,0,0,0,0,0,1,0,1,0,0,0,0,0,0,0,0,0,0,0,0,0,0,0,0,0,0
149222,25000,250,0,-2,11,7,4,0,0,0,1,1,0,2,1,1,0,0,0,0,0,0,7,5,2,0,0,0,0,0,0,1,0,1
149231,25000,250,0,-2,15,7,8,0,0,0,1,1,0,2,0,2,0,0,0,0,0,0,12,6,6,0,0,0,0,0,0,0,0,0
149365,25000,250,0,-2,1,0,1,0,0,0,0,0,0,1,0,1,0,0,0,0,0,0,0,0,0,0,0,0,0,0,0,0,0,0
149505,25000,250,0,-2,2,0,2,0,0,0,0,0,0,1,0,1,0,0,0,0,0,0,1,0,1,0,0,0,0,0,0,0,0,0
149514,25000,250,0,-2,1,0,1,0,0,0,1,0,1,0,0,0,0,0,0,0,0,0,0,0,0,0,0,0,0,0,0,0,0,0
149727,25000,250,0,-2,1,0,1,0,0,0,0,0,0,0,0,0,0,0,0,0,0,0,1,0,1,0,0,0,0,0,0,0,0,0
149763,25000,250,0,-2,3,0,3,0,0,0,1,0,1,1,0,1,0,0,0,0,0,0,1,0,1,0,0,0,0,0,0,0,0,0
149772,25000,250,0,-2,11,3,8,0,0,0,0,0,0,1,1,0,0,0,0,0,0,0,10,2,8,0,0,0,0,0,0,0,0,0
149781,25000,250,0,-2,7,0,7,0,0,0,0,0,0,1,0,1,0,0,0,0,0,0,4,0,4,0,0,0,2,0,2,0,0,0
149842,25000,250,0,-2,11,2,9,0,0,0,0,0,0,1,0,1,3,1,2,0,0,0,7,1,6,0,0,0,0,0,0,0,0,0
150136,25000,250,0,-2,1,1,0,0,0,0,0,0,0,0,0,0,1,1,0,0,0,0,0,0,0,0,0,0,0,0,0,0,0,0
150163,25000,250,0,-2,2,0,2,0,0,0,0,0,0,0,0,0,0,0,0,0,0,0,2,0,2,0,0,0,0,0,0,0,0,0
150172,25000,250,0,-2,3,2,1,0,0,0,0,0,0,0,0,0,0,0,0,0,0,0,3,2,1,0,0,0,0,0,0,0,0,0
150288,25000,250,0,-2,2,2,0,0,0,0,0,0,0,0,0,0,0,0,0,0,0,0,2,2,0,0,0,0,0,0,0,0,0,0
150400,25000,250,0,-2,1,0,1,0,0,0,0,0,0,0,0,0,0,0,0,0,0,0,1,0,1,0,0,0,0,0,0,0,0,0
150455,25000,250,0,-2,2,1,1,0,0,0,0,0,0,0,0,0,1,1,0,0,0,0,1,0,1,0,0,0,0,0,0,0,0,0
150534,25000,250,0,-2,8,1,7,0,0,0,0,0,0,0,0,0,0,0,0,0,0,0,3,1,2,1,0,1,4,0,4,0,0,0
150604,25000,250,0,-2,7,2,5,0,0,0,0,0,0,3,2,1,0,0,0,0,0,0,3,0,3,0,0,0,0,0,0,1,0,1
150668,25000,250,0,-2,2,1,1,0,0,0,0,0,0,0,0,0,2,1,1,0,0,0,0,0,0,0,0,0,0,0,0,0,0,0
150677,25000,250,0,-2,1,1,0,0,0,0,0,0,0,0,0,0,0,0,0,0,0,0,1,1,0,0,0,0,0,0,0,0,0,0
150756,25000,250,0,-2,5,1,4,0,0,0,0,0,0,1,0,1,0,0,0,0,0,0,4,1,3,0,0,0,0,0,0,0,0,0
150941,25000,250,0,-2,5,1,4,0,0,0,0,0,0,0,0,0,1,1,0,0,0,0,4,0,4,0,0,0,0,0,0,0,0,0
150987,25000,250,0,-2,48,30,18,0,0,0,1,1,0,2,0,2,0,0,0,0,0,0,44,29,15,1,0,1,0,0,0,0,0,0
151102,25000,250,0,-2,1,0,1,0,0,0,0,0,0,0,0,0,0,0,0,0,0,0,1,0,1,0,0,0,0,0,0,0,0,0
151111,25000,250,0,-2,10,1,9,0,0,0,1,0,1,1,0,1,0,0,0,0,0,0,8,1,7,0,0,0,0,0,0,0,0,0
151263,25000,250,0,-2,9,4,5,0,0,0,0,0,0,2,1,1,2,0,2,0,0,0,4,2,2,1,1,0,0,0,0,0,0,0
151290,25000,250,0,-2,19,8,11,0,0,0,0,0,0,3,1,2,1,1,0,0,0,0,15,6,9,0,0,0,0,0,0,0,0,0
151306,25000,250,0,-2,6,1,5,0,0,0,0,0,0,0,0,0,0,0,0,0,0,0,6,1,5,0,0,0,0,0,0,0,0,0
151324,25000,250,0,-2,10,2,8,0,0,0,0,0,0,1,0,1,2,0,2,0,0,0,6,2,4,1,0,1,0,0,0,0,0,0
151333,25000,250,0,-2,1,0,1,0,0,0,0,0,0,0,0,0,0,0,0,0,0,0,1,0,1,0,0,0,0,0,0,0,0,0
151342,25000,250,0,-2,1,0,1,0,0,0,0,0,0,1,0,1,0,0,0,0,0,0,0,0,0,0,0,0,0,0,0,0,0,0
151351,25000,250,0,-2,29,5,24,1,1,0,1,0,1,1,0,1,1,1,0,0,0,0,23,3,20,0,0,0,0,0,0,2,0,2
151379,25000,250,0,-2,1,0,1,0,0,0,0,0,0,0,0,0,0,0,0,0,0,0,1,0,1,0,0,0,0,0,0,0,0,0
151388,25000,250,0,-2,1,1,0,0,0,0,0,0,0,0,0,0,0,0,0,0,0,0,1,1,0,0,0,0,0,0,0,0,0,0
151777,25000,250,0,-2,3,0,3,0,0,0,0,0,0,0,0,0,0,0,0,0,0,0,3,0,3,0,0,0,0,0,0,0,0,0
151786,25000,250,0,-2,4,1,3,0,0,0,0,0,0,0,0,0,0,0,0,0,0,0,3,1,2,0,0,0,1,0,1,0,0,0
151801,25000,250,0,-2,16,6,10,0,0,0,0,0,0,1,0,1,2,0,2,0,0,0,13,6,7,0,0,0,0,0,0,0,0,0
151810,25000,250,0,-2,2,0,2,0,0,0,0,0,0,1,0,1,0,0,0,0,0,0,1,0,1,0,0,0,0,0,0,0,0,0
152080,25000,250,0,-2,28,14,14,0,0,0,3,2,1,3,3,0,5,1,4,0,0,0,16,7,9,0,0,0,1,1,0,0,0,0
152099,25000,250,0,-2,29,16,13,0,0,0,0,0,0,2,2,0,0,0,0,0,0,0,27,14,13,0,0,0,0,0,0,0,0,0
152336,25000,250,0,-2,1,0,1,0,0,0,0,0,0,0,0,0,0,0,0,0,0,0,1,0,1,0,0,0,0,0,0,0,0,0
152381,25000,250,0,-2,4,1,3,0,0,0,0,0,0,0,0,0,1,0,1,0,0,0,3,1,2,0,0,0,0,0,0,0,0,0
152390,25000,250,0,-2,2,0,2,0,0,0,0,0,0,0,0,0,0,0,0,0,0,0,1,0,1,0,0,0,0,0,0,1,0,1
152530,25000,250,0,-2,1,0,1,0,0,0,0,0,0,0,0,0,0,0,0,0,0,0,1,0,1,0,0,0,0,0,0,0,0,0
152637,25000,250,0,-2,7,5,2,0,0,0,0,0,0,0,0,0,0,0,0,0,0,0,7,5,2,0,0,0,0,0,0,0,0,0
152798,25000,250,0,-2,2,1,1,0,0,0,0,0,0,0,0,0,0,0,0,0,0,0,2,1,1,0,0,0,0,0,0,0,0,0
152992,25000,250,0,-2,1,0,1,0,0,0,0,0,0,0,0,0,0,0,0,0,0,0,1,0,1,0,0,0,0,0,0,0,0,0
153001,25000,250,0,-2,5,5,0,0,0,0,0,0,0,0,0,0,0,0,0,0,0,0,5,5,0,0,0,0,0,0,0,0,0,0
153144,25000,250,0,-2,7,1,6,0,0,0,0,0,0,1,1,0,2,0,2,0,0,0,4,0,4,0,0,0,0,0,0,0,0,0
153162,25000,250,0,-2,4,2,2,0,0,0,0,0,0,1,1,0,0,0,0,0,0,0,3,1,2,0,0,0,0,0,0,0,0,0
153214,25000,250,0,-2,14,2,12,0,0,0,0,0,0,1,0,1,0,0,0,0,0,0,12,2,10,1,0,1,0,0,0,0,0,0
153250,25000,250,0,-2,1,0,1,0,0,0,0,0,0,0,0,0,0,0,0,0,0,0,1,0,1,0,0,0,0,0,0,0,0,0
153269,25000,250,0,-2,9,1,8,0,0,0,0,0,0,2,0,2,1,0,1,0,0,0,6,1,5,0,0,0,0,0,0,0,0,0
153278,25000,250,0,-2,17,10,7,0,0,0,0,0,0,0,0,0,2,1,1,0,0,0,13,7,6,1,1,0,1,1,0,0,0,0
153296,25000,250,0,-2,2,1,1,0,0,0,0,0,0,0,0,0,0,0,0,0,0,0,2,1,1,0,0,0,0,0,0,0,0,0
153311,25000,250,0,-2,13,3,10,0,0,0,0,0,0,0,0,0,0,0,0,0,0,0,13,3,10,0,0,0,0,0,0,0,0,0
153366,25000,250,0,-2,4,1,3,0,0,0,0,0,0,0,0,0,0,0,0,0,0,0,4,1,3,0,0,0,0,0,0,0,0,0
153375,25000,250,0,-2,6,1,5,0,0,0,0,0,0,1,0,1,0,0,0,0,0,0,5,1,4,0,0,0,0,0,0,0,0,0
153384,25000,250,0,-2,7,1,6,0,0,0,0,0,0,0,0,0,0,0,0,0,0,0,7,1,6,0,0,0,0,0,0,0,0,0
153445,25000,250,0,-2,9,1,8,0,0,0,0,0,0,0,0,0,2,0,2,0,0,0,7,1,6,0,0,0,0,0,0,0,0,0
153472,25000,250,0,-2,4,1,3,0,0,0,0,0,0,0,0,0,0,0,0,0,0,0,4,1,3,0,0,0,0,0,0,0,0,0
153524,25000,250,0,-2,1,1,0,0,0,0,0,0,0,0,0,0,0,0,0,0,0,0,1,1,0,0,0,0,0,0,0,0,0,0
153533,25000,250,0,-2,3,1,2,0,0,0,0,0,0,0,0,0,0,0,0,0,0,0,3,1,2,0,0,0,0,0,0,0,0,0
153603,25000,250,0,-2,13,2,11,0,0,0,1,0,1,1,0,1,0,0,0,0,0,0,11,2,9,0,0,0,0,0,0,0,0,0
153621,25000,250,0,-2,10,3,7,0,0,0,2,1,1,1,1,0,1,0,1,0,0,0,6,1,5,0,0,0,0,0,0,0,0,0
153630,25000,250,0,-2,1,1,0,0,0,0,0,0,0,0,0,0,0,0,0,0,0,0,1,1,0,0,0,0,0,0,0,0,0,0
153658,25000,250,0,-2,50,16,34,0,0,0,2,0,2,2,2,0,6,1,5,0,0,0,33,13,20,2,0,2,5,0,5,0,0,0
153737,25000,250,0,-2,14,6,8,1,0,1,0,0,0,2,2,0,0,0,0,0,0,0,9,3,6,0,0,0,2,1,1,0,0,0
153825,25000,250,0,-2,2,1,1,0,0,0,0,0,0,0,0,0,0,0,0,0,0,0,2,1,1,0,0,0,0,0,0,0,0,0
153834,25000,250,0,-2,1,1,0,0,0,0,0,0,0,0,0,0,0,0,0,0,0,0,1,1,0,0,0,0,0,0,0,0,0,0
153861,25000,250,0,-2,6,1,5,0,0,0,0,0,0,0,0,0,0,0,0,0,0,0,6,1,5,0,0,0,0,0,0,0,0,0
153922,25000,250,0,-2,2,0,2,0,0,0,0,0,0,0,0,0,1,0,1,0,0,0,1,0,1,0,0,0,0,0,0,0,0,0
153977,25000,250,0,-2,8,1,7,0,0,0,0,0,0,0,0,0,2,0,2,0,0,0,6,1,5,0,0,0,0,0,0,0,0,0
154004,25000,250,0,-2,1,0,1,0,0,0,0,0,0,0,0,0,0,0,0,0,0,0,1,0,1,0,0,0,0,0,0,0,0,0
154013,25000,250,0,-2,5,1,4,0,0,0,0,0,0,1,1,0,0,0,0,0,0,0,4,0,4,0,0,0,0,0,0,0,0,0
154022,25000,250,0,-2,15,6,9,0,0,0,1,0,1,4,2,2,2,1,1,0,0,0,8,3,5,0,0,0,0,0,0,0,0,0
154059,25000,250,0,-2,2,0,2,0,0,0,1,0,1,0,0,0,0,0,0,0,0,0,1,0,1,0,0,0,0,0,0,0,0,0
154095,25000,250,0,-2,8,2,6,0,0,0,0,0,0,0,0,0,1,0,1,0,0,0,7,2,5,0,0,0,0,0,0,0,0,0
154101,25000,250,0,-2,1,0,1,0,0,0,0,0,0,0,0,0,0,0,0,0,0,0,1,0,1,0,0,0,0,0,0,0,0,0
154110,25000,250,0,-2,8,2,6,0,0,0,0,0,0,1,1,0,0,0,0,0,0,0,6,1,5,0,0,0,1,0,1,0,0,0
154129,25000,250,0,-2,1,0,1,0,0,0,0,0,0,0,0,0,0,0,0,0,0,0,1,0,1,0,0,0,0,0,0,0,0,0
154174,25000,250,0,-2,9,3,6,0,0,0,0,0,0,0,0,0,0,0,0,0,0,0,6,1,5,2,2,0,1,0,1,0,0,0
154235,25000,250,0,-2,6,1,5,0,0,0,0,0,0,1,0,1,0,0,0,0,0,0,4,1,3,0,0,0,1,0,1,0,0,0
154396,25000,250,0,-2,4,2,2,0,0,0,0,0,0,0,0,0,0,0,0,0,0,0,4,2,2,0,0,0,0,0,0,0,0,0
154518,25000,250,0,-2,32,9,23,0,0,0,1,0,1,6,1,5,2,1,1,0,0,0,23,7,16,0,0,0,0,0,0,0,0,0
154527,25000,250,0,-2,1,0,1,0,0,0,0,0,0,0,0,0,0,0,0,0,0,0,1,0,1,0,0,0,0,0,0,0,0,0
154536,25000,250,0,-2,3,0,3,0,0,0,0,0,0,0,0,0,0,0,0,0,0,0,3,0,3,0,0,0,0,0,0,0,0,0
154572,25000,250,0,-2,8,4,4,0,0,0,0,0,0,0,0,0,3,1,2,0,0,0,4,3,1,1,0,1,0,0,0,0,0,0
154642,25000,250,0,-2,3,3,0,0,0,0,0,0,0,0,0,0,0,0,0,0,0,0,3,3,0,0,0,0,0,0,0,0,0,0
154688,25000,250,0,-2,9,3,6,0,0,0,0,0,0,2,0,2,0,0,0,0,0,0,6,2,4,0,0,0,1,1,0,0,0,0
154697,25000,250,0,-2,1,1,0,0,0,0,0,0,0,0,0,0,0,0,0,0,0,0,1,1,0,0,0,0,0,0,0,0,0,0
154749,25000,250,0,-2,1,0,1,0,0,0,0,0,0,0,0,0,0,0,0,0,0,0,1,0,1,0,0,0,0,0,0,0,0,0
154800,25000,250,0,-2,8,3,5,1,1,0,0,0,0,0,0,0,0,0,0,0,0,0,6,2,4,1,0,1,0,0,0,0,0,0
154855,25000,250,0,-2,1,1,0,0,0,0,0,0,0,0,0,0,0,0,0,0,0,0,1,1,0,0,0,0,0,0,0,0,0,0
154907,25000,250,0,-2,1,1,0,0,0,0,0,0,0,0,0,0,0,0,0,0,0,0,1,1,0,0,0,0,0,0,0,0,0,0
154952,25000,250,0,-2,11,3,8,0,0,0,0,0,0,1,0,1,1,0,1,0,0,0,9,3,6,0,0,0,0,0,0,0,0,0
154998,25000,250,0,-2,14,3,11,0,0,0,0,0,0,1,1,0,1,0,1,0,0,0,12,2,10,0,0,0,0,0,0,0,0,0
155007,25000,250,0,-2,10,4,6,0,0,0,0,0,0,1,0,1,2,1,1,0,0,0,6,3,3,1,0,1,0,0,0,0,0,0
155025,25000,250,0,-2,4,1,3,0,0,0,0,0,0,0,0,0,0,0,0,0,0,0,4,1,3,0,0,0,0,0,0,0,0,0
155070,25000,250,0,-2,2,1,1,0,0,0,0,0,0,0,0,0,0,0,0,0,0,0,2,1,1,0,0,0,0,0,0,0,0,0
155089,25000,250,0,-2,3,1,2,0,0,0,0,0,0,0,0,0,0,0,0,0,0,0,3,1,2,0,0,0,0,0,0,0,0,0
155098,25000,250,0,-2,2,1,1,0,0,0,0,0,0,0,0,0,0,0,0,0,0,0,2,1,1,0,0,0,0,0,0,0,0,0
155104,25000,250,0,-2,2,0,2,0,0,0,0,0,0,0,0,0,1,0,1,0,0,0,1,0,1,0,0,0,0,0,0,0,0,0
155195,25000,250,0,-2,4,0,4,0,0,0,0,0,0,0,0,0,0,0,0,0,0,0,4,0,4,0,0,0,0,0,0,0,0,0
155292,25000,250,0,-2,8,2,6,0,0,0,0,0,0,0,0,0,1,0,1,0,0,0,7,2,5,0,0,0,0,0,0,0,0,0
155308,25000,250,0,-2,2,2,0,0,0,0,1,1,0,0,0,0,1,1,0,0,0,0,0,0,0,0,0,0,0,0,0,0,0,0
155317,25000,250,0,-2,77,23,54,1,1,0,4,0,4,19,6,13,2,1,1,0,0,0,48,14,34,3,1,2,0,0,0,0,0,0
155399,25000,250,0,-2,15,3,12,0,0,0,1,0,1,0,0,0,2,1,1,0,0,0,12,2,10,0,0,0,0,0,0,0,0,0
155414,25000,250,0,-2,1,0,1,0,0,0,0,0,0,0,0,0,0,0,0,0,0,0,1,0,1,0,0,0,0,0,0,0,0,0
155450,25000,250,0,-2,3,0,3,0,0,0,0,0,0,0,0,0,0,0,0,0,0,0,2,0,2,1,0,1,0,0,0,0,0,0
155487,25000,250,0,-2,2,0,2,0,0,0,0,0,0,0,0,0,0,0,0,0,0,0,0,0,0,0,0,0,2,0,2,0,0,0
155511,25000,250,0,-2,2,1,1,0,0,0,0,0,0,0,0,0,1,1,0,0,0,0,1,0,1,0,0,0,0,0,0,0,0,0
155566,25000,250,0,-2,2,0,2,0,0,0,0,0,0,0,0,0,0,0,0,0,0,0,2,0,2,0,0,0,0,0,0,0,0,0
155593,25000,250,0,-2,1,0,1,0,0,0,0,0,0,0,0,0,0,0,0,0,0,0,1,0,1,0,0,0,0,0,0,0,0,0
155618,25000,250,0,-2,2,0,2,0,0,0,0,0,0,0,0,0,0,0,0,0,0,0,2,0,2,0,0,0,0,0,0,0,0,0
155715,25000,250,0,-2,1,0,1,0,0,0,0,0,0,0,0,0,0,0,0,0,0,0,1,0,1,0,0,0,0,0,0,0,0,0
155812,25000,250,0,-2,4,1,3,0,0,0,1,0,1,1,1,0,0,0,0,0,0,0,1,0,1,1,0,1,0,0,0,0,0,0
155830,25000,250,0,-2,2,1,1,0,0,0,0,0,0,0,0,0,0,0,0,0,0,0,2,1,1,0,0,0,0,0,0,0,0,0
155858,25000,250,0,-2,3,0,3,0,0,0,0,0,0,0,0,0,0,0,0,0,0,0,2,0,2,1,0,1,0,0,0,0,0,0
155937,25000,250,0,-2,1,0,1,0,0,0,0,0,0,0,0,0,0,0,0,0,0,0,1,0,1,0,0,0,0,0,0,0,0,0
155973,25000,250,0,-2,1,1,0,0,0,0,0,0,0,0,0,0,0,0,0,0,0,0,1,1,0,0,0,0,0,0,0,0,0,0
156082,25000,250,0,-2,4,1,3,1,0,1,0,0,0,0,0,0,0,0,0,0,0,0,1,1,0,0,0,0,2,0,2,0,0,0
156125,25000,250,0,-2,2,0,2,0,0,0,0,0,0,0,0,0,0,0,0,0,0,0,2,0,2,0,0,0,0,0,0,0,0,0
156189,25000,250,0,-2,1,1,0,0,0,0,0,0,0,0,0,0,0,0,0,0,0,0,1,1,0,0,0,0,0,0,0,0,0,0
156213,25000,250,0,-2,5,0,5,0,0,0,0,0,0,1,0,1,0,0,0,0,0,0,4,0,4,0,0,0,0,0,0,0,0,0
156222,25000,250,0,-2,1,0,1,0,0,0,1,0,1,0,0,0,0,0,0,0,0,0,0,0,0,0,0,0,0,0,0,0,0,0
156286,25000,250,0,-2,2,1,1,0,0,0,0,0,0,0,0,0,0,0,0,0,0,0,2,1,1,0,0,0,0,0,0,0,0,0
156295,25000,250,0,-2,12,1,11,0,0,0,0,0,0,1,0,1,0,0,0,0,0,0,11,1,10,0,0,0,0,0,0,0,0,0
156356,25000,250,0,-2,1,0,1,0,0,0,0,0,0,0,0,0,0,0,0,0,0,0,1,0,1,0,0,0,0,0,0,0,0,0
156365,25000,250,0,-2,7,4,3,0,0,0,0,0,0,0,0,0,0,0,0,0,0,0,5,3,2,0,0,0,2,1,1,0,0,0
156392,25000,250,0,-2,4,1,3,0,0,0,0,0,0,1,0,1,0,0,0,0,0,0,3,1,2,0,0,0,0,0,0,0,0,0
156408,25000,250,0,-2,5,1,4,0,0,0,1,0,1,2,0,2,0,0,0,0,0,0,2,1,1,0,0,0,0,0,0,0,0,0
156471,25000,250,0,-2,4,0,4,0,0,0,0,0,0,1,0,1,0,0,0,0,0,0,3,0,3,0,0,0,0,0,0,0,0,0
156541,25000,250,0,-2,1,0,1,0,0,0,0,0,0,0,0,0,0,0,0,0,0,0,1,0,1,0,0,0,0,0,0,0,0,0
156620,25000,250,0,-2,70,11,59,0,0,0,0,0,0,3,0,3,1,0,1,0,0,0,57,9,48,7,2,5,0,0,0,2,0,2
156648,25000,250,0,-2,1,0,1,0,0,0,0,0,0,0,0,0,0,0,0,0,0,0,1,0,1,0,0,0,0,0,0,0,0,0
156727,25000,250,0,-2,4,0,4,0,0,0,0,0,0,2,0,2,0,0,0,0,0,0,2,0,2,0,0,0,0,0,0,0,0,0
156745,25000,250,0,-2,5,1,4,0,0,0,0,0,0,0,0,0,0,0,0,0,0,0,5,1,4,0,0,0,0,0,0,0,0,0
156921,25000,250,0,-2,4,1,3,0,0,0,0,0,0,2,1,1,0,0,0,0,0,0,2,0,2,0,0,0,0,0,0,0,0,0
157058,25000,250,0,-2,3,2,1,0,0,0,0,0,0,2,1,1,0,0,0,0,0,0,1,1,0,0,0,0,0,0,0,0,0,0
157076,25000,250,0,-2,1,1,0,0,0,0,0,0,0,0,0,0,0,0,0,0,0,0,1,1,0,0,0,0,0,0,0,0,0,0
157085,25000,250,0,-2,18,4,14,0,0,0,0,0,0,2,0,2,1,0,1,0,0,0,14,3,11,1,1,0,0,0,0,0,0,0
157100,25000,250,0,-2,1,0,1,0,0,0,0,0,0,0,0,0,0,0,0,0,0,0,1,0,1,0,0,0,0,0,0,0,0,0
157216,25000,250,0,-2,4,0,4,0,0,0,0,0,0,0,0,0,0,0,0,0,0,0,4,0,4,0,0,0,0,0,0,0,0,0
157289,25000,250,0,-2,19,4,15,0,0,0,1,0,1,3,2,1,2,1,1,0,0,0,12,1,11,1,0,1,0,0,0,0,0,0
157304,25000,250,0,-2,3,2,1,0,0,0,0,0,0,0,0,0,0,0,0,0,0,0,2,1,1,0,0,0,1,1,0,0,0,0
157377,25000,250,0,-2,1,0,1,0,0,0,0,0,0,0,0,0,0,0,0,0,0,0,1,0,1,0,0,0,0,0,0,0,0,0
157386,25000,250,0,-2,1,0,1,0,0,0,0,0,0,0,0,0,0,0,0,0,0,0,1,0,1,0,0,0,0,0,0,0,0,0
157438,25000,250,0,-2,2,0,2,0,0,0,0,0,0,0,0,0,0,0,0,0,0,0,1,0,1,0,0,0,1,0,1,0,0,0
157447,25000,250,0,-2,6,2,4,0,0,0,0,0,0,2,1,1,0,0,0,0,0,0,4,1,3,0,0,0,0,0,0,0,0,0
157535,25000,250,0,-2,2,1,1,0,0,0,0,0,0,0,0,0,0,0,0,0,0,0,2,1,1,0,0,0,0,0,0,0,0,0
157553,25000,250,0,-2,5,1,4,0,0,0,0,0,0,0,0,0,0,0,0,0,0,0,5,1,4,0,0,0,0,0,0,0,0,0
157739,25000,250,0,-2,2,1,1,0,0,0,0,0,0,0,0,0,0,0,0,0,0,0,2,1,1,0,0,0,0,0,0,0,0,0
157748,25000,250,0,-2,14,7,7,0,0,0,0,0,0,2,2,0,0,0,0,0,0,0,10,5,5,0,0,0,2,0,2,0,0,0
157757,25000,250,0,-2,2,1,1,0,0,0,0,0,0,0,0,0,0,0,0,0,0,0,2,1,1,0,0,0,0,0,0,0,0,0
157809,25000,250,0,-2,2,0,2,0,0,0,0,0,0,0,0,0,0,0,0,0,0,0,2,0,2,0,0,0,0,0,0,0,0,0
157818,25000,250,0,-2,3,0,3,0,0,0,0,0,0,0,0,0,0,0,0,0,0,0,2,0,2,0,0,0,1,0,1,0,0,0
157854,25000,250,0,-2,2,0,2,0,0,0,0,0,0,0,0,0,0,0,0,0,0,0,1,0,1,1,0,1,0,0,0,0,0,0
157951,25000,250,0,-2,2,0,2,0,0,0,0,0,0,1,0,1,0,0,0,0,0,0,1,0,1,0,0,0,0,0,0,0,0,0
158088,25000,250,0,-2,1,0,1,0,0,0,0,0,0,1,0,1,0,0,0,0,0,0,0,0,0,0,0,0,0,0,0,0,0,0
158431,25000,250,0,-2,2,1,1,0,0,0,0,0,0,2,1,1,0,0,0,0,0,0,0,0,0,0,0,0,0,0,0,0,0,0
158477,25000,250,0,-2,1,1,0,0,0,0,0,0,0,0,0,0,0,0,0,0,0,0,1,1,0,0,0,0,0,0,0,0,0,0
158662,25000,250,0,-2,4,0,4,0,0,0,0,0,0,4,0,4,0,0,0,0,0,0,0,0,0,0,0,0,0,0,0,0,0,0
158802,25000,250,0,-2,12,4,8,0,0,0,2,1,1,9,3,6,0,0,0,0,0,0,0,0,0,0,0,0,1,0,1,0,0,0
158884,25000,250,0,-2,2,0,2,0,0,0,0,0,0,0,0,0,0,0,0,0,0,0,2,0,2,0,0,0,0,0,0,0,0,0
159373,25000,250,0,-2,1,0,1,0,0,0,0,0,0,1,0,1,0,0,0,0,0,0,0,0,0,0,0,0,0,0,0,0,0,0
159382,25000,250,0,-2,2,0,2,0,0,0,0,0,0,2,0,2,0,0,0,0,0,0,0,0,0,0,0,0,0,0,0,0,0,0
159391,25000,250,0,-2,19,5,14,0,0,0,1,0,1,3,0,3,1,0,1,0,0,0,12,3,9,0,0,0,1,1,0,1,1,0
159407,25000,250,0,-2,2,0,2,0,0,0,0,0,0,0,0,0,0,0,0,0,0,0,2,0,2,0,0,0,0,0,0,0,0,0
159416,25000,250,0,-2,2,0,2,0,0,0,0,0,0,0,0,0,0,0,0,0,0,0,2,0,2,0,0,0,0,0,0,0,0,0
159568,25000,250,0,-2,1,1,0,0,0,0,0,0,0,0,0,0,0,0,0,0,0,0,1,1,0,0,0,0,0,0,0,0,0,0
159647,25000,250,0,-2,11,4,7,0,0,0,0,0,0,3,2,1,1,1,0,0,0,0,7,1,6,0,0,0,0,0,0,0,0,0
159656,25000,250,0,-2,2,2,0,0,0,0,1,1,0,1,1,0,0,0,0,0,0,0,0,0,0,0,0,0,0,0,0,0,0,0
159717,25000,250,0,-2,5,3,2,0,0,0,0,0,0,3,2,1,0,0,0,0,0,0,2,1,1,0,0,0,0,0,0,0,0,0
159939,25000,250,0,-2,14,4,10,0,0,0,0,0,0,3,0,3,1,1,0,0,0,0,10,3,7,0,0,0,0,0,0,0,0,0
159948,25000,250,0,-2,3,0,3,0,0,0,0,0,0,2,0,2,0,0,0,0,0,0,1,0,1,0,0,0,0,0,0,0,0,0
159966,25000,250,0,-2,4,0,4,0,0,0,0,0,0,1,0,1,0,0,0,0,0,0,3,0,3,0,0,0,0,0,0,0,0,0
159993,25000,250,0,-2,4,0,4,0,0,0,1,0,1,0,0,0,0,0,0,0,0,0,3,0,3,0,0,0,0,0,0,0,0,0
160038,25000,250,0,-2,15,3,12,0,0,0,0,0,0,4,1,3,2,0,2,0,0,0,8,2,6,0,0,0,0,0,0,1,0,1
160074,25000,250,0,-2,4,1,3,0,0,0,0,0,0,0,0,0,0,0,0,0,0,0,4,1,3,0,0,0,0,0,0,0,0,0
160612,25000,250,0,-2,7,2,5,0,0,0,0,0,0,1,1,0,1,0,1,0,0,0,5,1,4,0,0,0,0,0,0,0,0,0
160621,25000,250,0,-2,2,2,0,0,0,0,0,0,0,2,2,0,0,0,0,0,0,0,0,0,0,0,0,0,0,0,0,0,0,0
160630,25000,250,0,-2,7,2,5,0,0,0,0,0,0,7,2,5,0,0,0,0,0,0,0,0,0,0,0,0,0,0,0,0,0,0
160649,25000,250,0,-2,16,4,12,0,0,0,0,0,0,16,4,12,0,0,0,0,0,0,0,0,0,0,0,0,0,0,0,0,0,0
160658,25000,250,0,-2,3,1,2,0,0,0,0,0,0,0,0,0,0,0,0,0,0,0,3,1,2,0,0,0,0,0,0,0,0,0
160755,25000,250,0,-2,9,1,8,0,0,0,1,0,1,2,0,2,2,0,2,0,0,0,4,1,3,0,0,0,0,0,0,0,0,0
160904,25000,250,0,-2,2,1,1,0,0,0,0,0,0,2,1,1,0,0,0,0,0,0,0,0,0,0,0,0,0,0,0,0,0,0
160977,25000,250,0,-2,5,2,3,0,0,0,0,0,0,0,0,0,0,0,0,0,0,0,5,2,3,0,0,0,0,0,0,0,0,0
161004,25000,250,0,-2,3,1,2,0,0,0,0,0,0,0,0,0,0,0,0,0,0,0,3,1,2,0,0,0,0,0,0,0,0,0
161022,25000,250,0,-2,1,1,0,0,0,0,0,0,0,0,0,0,0,0,0,0,0,0,1,1,0,0,0,0,0,0,0,0,0,0
161077,25000,250,0,-2,4,2,2,0,0,0,0,0,0,0,0,0,0,0,0,0,0,0,4,2,2,0,0,0,0,0,0,0,0,0
161086,25000,250,0,-2,6,3,3,0,0,0,0,0,0,0,0,0,0,0,0,0,0,0,6,3,3,0,0,0,0,0,0,0,0,0
161138,25000,250,0,-2,3,3,0,0,0,0,0,0,0,0,0,0,0,0,0,0,0,0,3,3,0,0,0,0,0,0,0,0,0,0
161192,25000,250,0,-2,2,2,0,0,0,0,0,0,0,0,0,0,0,0,0,0,0,0,2,2,0,0,0,0,0,0,0,0,0,0
161226,25000,250,0,-2,2,0,2,0,0,0,0,0,0,0,0,0,0,0,0,0,0,0,2,0,2,0,0,0,0,0,0,0,0,0
161253,25000,250,0,-2,8,2,6,0,0,0,0,0,0,0,0,0,1,1,0,0,0,0,7,1,6,0,0,0,0,0,0,0,0,0
161299,25000,250,0,-2,1,0,1,0,0,0,0,0,0,0,0,0,0,0,0,0,0,0,1,0,1,0,0,0,0,0,0,0,0,0
161457,25000,250,0,-2,28,7,21,0,0,0,0,0,0,0,0,0,2,0,2,0,0,0,26,7,19,0,0,0,0,0,0,0,0,0
161484,25000,250,0,-2,1,0,1,0,0,0,0,0,0,0,0,0,0,0,0,0,0,0,1,0,1,0,0,0,0,0,0,0,0,0
161509,25000,250,0,-2,1,0,1,0,0,0,0,0,0,1,0,1,0,0,0,0,0,0,0,0,0,0,0,0,0,0,0,0,0,0
161518,25000,250,0,-2,1,1,0,0,0,0,0,0,0,0,0,0,0,0,0,0,0,0,1,1,0,0,0,0,0,0,0,0,0,0
161545,25000,250,0,-2,10,3,7,0,0,0,0,0,0,0,0,0,0,0,0,0,0,0,9,2,7,0,0,0,1,1,0,0,0,0
161554,25000,250,0,-2,3,2,1,0,0,0,0,0,0,0,0,0,0,0,0,0,0,0,3,2,1,0,0,0,0,0,0,0,0,0
161563,25000,250,0,-2,4,1,3,0,0,0,0,0,0,0,0,0,1,0,1,0,0,0,3,1,2,0,0,0,0,0,0,0,0,0
161572,25000,250,0,-2,21,5,16,0,0,0,0,0,0,1,1,0,0,0,0,0,0,0,19,4,15,0,0,0,1,0,1,0,0,0
161767,25000,250,0,-2,15,5,10,0,0,0,0,0,0,3,2,1,1,1,0,0,0,0,11,2,9,0,0,0,0,0,0,0,0,0
161873,25000,250,0,-2,4,0,4,0,0,0,0,0,0,3,0,3,0,0,0,0,0,0,1,0,1,0,0,0,0,0,0,0,0,0
162061,25000,250,0,-2,6,3,3,0,0,0,0,0,0,4,1,3,0,0,0,0,0,0,2,2,0,0,0,0,0,0,0,0,0,0
162104,25000,250,0,-2,1,0,1,0,0,0,0,0,0,0,0,0,0,0,0,0,0,0,1,0,1,0,0,0,0,0,0,0,0,0
162122,25000,250,0,-2,5,3,2,0,0,0,0,0,0,2,2,0,1,1,0,0,0,0,2,0,2,0,0,0,0,0,0,0,0,0
162168,25000,250,0,-2,2,1,1,0,0,0,0,0,0,1,1,0,0,0,0,0,0,0,1,0,1,0,0,0,0,0,0,0,0,0
162283,25000,250,0,-2,1,0,1,0,0,0,0,0,0,0,0,0,1,0,1,0,0,0,0,0,0,0,0,0,0,0,0,0,0,0
162557,25000,250,0,-2,5,3,2,0,0,0,0,0,0,0,0,0,2,2,0,0,0,0,1,0,1,0,0,0,2,1,1,0,0,0
162609,25000,250,0,-2,1,0,1,0,0,0,0,0,0,0,0,0,0,0,0,0,0,0,1,0,1,0,0,0,0,0,0,0,0,0
162654,25000,250,0,-2,2,0,2,0,0,0,0,0,0,0,0,0,0,0,0,0,0,0,2,0,2,0,0,0,0,0,0,0,0,0
162690,25000,250,0,-2,2,2,0,0,0,0,0,0,0,0,0,0,1,1,0,0,0,0,0,0,0,0,0,0,1,1,0,0,0,0
162760,25000,250,0,-2,2,0,2,0,0,0,0,0,0,0,0,0,0,0,0,0,0,0,2,0,2,0,0,0,0,0,0,0,0,0
162779,25000,250,0,-2,6,1,5,0,0,0,0,0,0,3,0,3,0,0,0,0,0,0,3,1,2,0,0,0,0,0,0,0,0,0
162928,25000,250,0,-2,122,40,82,0,0,0,7,3,4,35,10,25,4,1,3,0,0,0,70,22,48,5,3,2,1,1,0,0,0,0
163028,25000,250,0,-2,2,0,2,0,0,0,0,0,0,0,0,0,0,0,0,0,0,0,1,0,1,1,0,1,0,0,0,0,0,0
163204,25000,250,0,-2,4,1,3,0,0,0,1,0,1,1,0,1,0,0,0,0,0,0,0,0,0,0,0,0,2,1,1,0,0,0
163259,25000,250,0,-2,6,2,4,0,0,0,0,0,0,1,1,0,2,1,1,0,0,0,3,0,3,0,0,0,0,0,0,0,0,0
163286,25000,250,0,-2,10,4,6,0,0,0,1,0,1,1,0,1,1,0,1,0,0,0,6,3,3,0,0,0,1,1,0,0,0,0
163295,25000,250,0,-2,1,0,1,0,0,0,0,0,0,0,0,0,0,0,0,0,0,0,0,0,0,0,0,0,1,0,1,0,0,0
163426,25000,250,0,-2,5,0,5,0,0,0,1,0,1,4,0,4,0,0,0,0,0,0,0,0,0,0,0,0,0,0,0,0,0,0
163453,25000,250,0,-2,6,4,2,0,0,0,0,0,0,3,2,1,0,0,0,0,0,0,0,0,0,0,0,0,1,1,0,2,1,1
163462,25000,250,0,-2,6,2,4,0,0,0,0,0,0,1,0,1,0,0,0,0,0,0,3,2,1,2,0,2,0,0,0,0,0,0
163657,25000,250,0,-2,2,0,2,0,0,0,0,0,0,1,0,1,0,0,0,0,0,0,1,0,1,0,0,0,0,0,0,0,0,0
163976,25000,250,0,-2,4,3,1,0,0,0,0,0,0,0,0,0,0,0,0,0,0,0,4,3,1,0,0,0,0,0,0,0,0,0
164076,25000,250,0,-2,2,0,2,0,0,0,1,0,1,1,0,1,0,0,0,0,0,0,0,0,0,0,0,0,0,0,0,0,0,0
164155,25000,250,0,-2,9,6,3,0,0,0,1,0,1,1,1,0,1,1,0,0,0,0,6,4,2,0,0,0,0,0,0,0,0,0
164173,25000,250,0,-2,12,4,8,0,0,0,0,0,0,5,1,4,0,0,0,0,0,0,7,3,4,0,0,0,0,0,0,0,0,0
164216,25000,250,0,-2,5,3,2,0,0,0,0,0,0,0,0,0,1,1,0,0,0,0,4,2,2,0,0,0,0,0,0,0,0,0
164270,25000,250,0,-2,3,1,2,0,0,0,0,0,0,0,0,0,0,0,0,0,0,0,3,1,2,0,0,0,0,0,0,0,0,0
164313,25000,250,0,-2,1,1,0,0,0,0,0,0,0,0,0,0,0,0,0,0,0,0,1,1,0,0,0,0,0,0,0,0,0,0
164368,25000,250,0,-2,20,8,12,0,0,0,1,0,1,5,1,4,1,1,0,0,0,0,11,5,6,0,0,0,2,1,1,0,0,0
164447,25000,250,0,-2,7,0,7,0,0,0,0,0,0,1,0,1,1,0,1,0,0,0,4,0,4,1,0,1,0,0,0,0,0,0
164465,25000,250,0,-2,8,4,4,1,1,0,1,1,0,0,0,0,2,1,1,0,0,0,3,1,2,0,0,0,1,0,1,0,0,0
164492,25000,250,0,-2,2,1,1,0,0,0,0,0,0,0,0,0,0,0,0,0,0,0,1,0,1,1,1,0,0,0,0,0,0,0
164562,25000,250,0,-2,2,1,1,0,0,0,0,0,0,0,0,0,0,0,0,0,0,0,2,1,1,0,0,0,0,0,0,0,0,0
164580,25000,250,0,-2,5,3,2,0,0,0,0,0,0,0,0,0,2,1,1,0,0,0,3,2,1,0,0,0,0,0,0,0,0,0
164739,25000,250,0,-2,4,2,2,0,0,0,1,1,0,0,0,0,0,0,0,0,0,0,1,0,1,0,0,0,1,1,0,1,0,1
164748,25000,250,0,-2,2,0,2,0,0,0,0,0,0,0,0,0,0,0,0,0,0,0,2,0,2,0,0,0,0,0,0,0,0,0
164775,25000,250,0,-2,6,2,4,0,0,0,0,0,0,1,0,1,1,0,1,0,0,0,4,2,2,0,0,0,0,0,0,0,0,0
164924,25000,250,0,-2,19,10,9,0,0,0,1,0,1,1,1,0,0,0,0,0,0,0,17,9,8,0,0,0,0,0,0,0,0,0
164988,25000,250,0,-2,26,6,20,1,0,1,1,1,0,2,1,1,3,0,3,0,0,0,14,2,12,0,0,0,3,1,2,2,1,1
165015,25000,250,0,-2,12,1,11,0,0,0,2,0,2,3,1,2,0,0,0,0,0,0,7,0,7,0,0,0,0,0,0,0,0,0
165033,25000,250,0,-2,9,1,8,0,0,0,0,0,0,1,0,1,1,0,1,0,0,0,6,1,5,0,0,0,1,0,1,0,0,0
165167,25000,250,0,-2,1,0,1,0,0,0,0,0,0,0,0,0,0,0,0,0,0,0,0,0,0,1,0,1,0,0,0,0,0,0
165194,25000,250,0,-2,4,2,2,0,0,0,0,0,0,0,0,0,0,0,0,0,0,0,3,1,2,0,0,0,1,1,0,0,0,0
165264,25000,250,0,-2,2,1,1,0,0,0,0,0,0,1,1,0,0,0,0,0,0,0,1,0,1,0,0,0,0,0,0,0,0,0
165334,25000,250,0,-2,17,5,12,1,0,1,1,1,0,0,0,0,2,2,0,0,0,0,11,2,9,0,0,0,0,0,0,2,0,2
165529,25000,250,0,-2,2,1,1,0,0,0,0,0,0,0,0,0,0,0,0,0,0,0,2,1,1,0,0,0,0,0,0,0,0,0
165574,25000,250,0,-2,16,4,12,0,0,0,0,0,0,0,0,0,0,0,0,0,0,0,16,4,12,0,0,0,0,0,0,0,0,0
165662,25000,250,0,-2,20,4,16,0,0,0,2,0,2,4,0,4,0,0,0,0,0,0,12,3,9,2,1,1,0,0,0,0,0,0
165671,25000,250,0,-2,18,9,9,0,0,0,1,1,0,4,2,2,0,0,0,0,0,0,13,6,7,0,0,0,0,0,0,0,0,0
165699,25000,250,0,-2,16,7,9,0,0,0,0,0,0,2,2,0,0,0,0,0,0,0,9,3,6,0,0,0,5,2,3,0,0,0
165802,25000,250,0,-2,14,5,9,0,0,0,0,0,0,3,0,3,2,0,2,0,0,0,9,5,4,0,0,0,0,0,0,0,0,0
165820,25000,250,0,-2,8,2,6,0,0,0,1,0,1,0,0,0,1,1,0,0,0,0,6,1,5,0,0,0,0,0,0,0,0,0
165866,25000,250,0,-2,2,0,2,0,0,0,1,0,1,0,0,0,0,0,0,0,0,0,1,0,1,0,0,0,0,0,0,0,0,0
165884,25000,250,0,-2,2,1,1,0,0,0,0,0,0,1,1,0,1,0,1,0,0,0,0,0,0,0,0,0,0,0,0,0,0,0
165936,25000,250,0,-2,12,4,8,0,0,0,2,1,1,0,0,0,0,0,0,0,0,0,7,1,6,0,0,0,3,2,1,0,0,0
165981,25000,250,0,-2,14,2,12,0,0,0,1,0,1,1,0,1,0,0,0,0,0,0,12,2,10,0,0,0,0,0,0,0,0,0
166018,25000,250,0,-2,7,5,2,0,0,0,0,0,0,1,1,0,2,1,1,0,0,0,4,3,1,0,0,0,0,0,0,0,0,0
166027,25000,250,0,-2,70,20,50,0,0,0,14,3,11,5,2,3,12,4,8,0,0,0,30,7,23,1,0,1,0,0,0,8,4,4
166054,25000,250,0,-2,3,1,2,0,0,0,0,0,0,0,0,0,0,0,0,0,0,0,3,1,2,0,0,0,0,0,0,0,0,0
166124,25000,250,0,-2,13,5,8,0,0,0,0,0,0,0,0,0,3,1,2,0,0,0,10,4,6,0,0,0,0,0,0,0,0,0
166391,25000,250,0,-2,7,2,5,0,0,0,0,0,0,0,0,0,1,0,1,0,0,0,5,1,4,0,0,0,1,1,0,0,0,0
166513,25000,250,0,-2,1,0,1,0,0,0,0,0,0,0,0,0,0,0,0,0,0,0,1,0,1,0,0,0,0,0,0,0,0,0
166629,25000,250,0,-2,29,11,18,0,0,0,1,0,1,1,0,1,4,1,3,0,0,0,22,9,13,0,0,0,0,0,0,1,1,0
166638,25000,250,0,-2,1,0,1,0,0,0,0,0,0,0,0,0,0,0,0,0,0,0,0,0,0,1,0,1,0,0,0,0,0,0
166647,25000,250,0,-2,8,3,5,0,0,0,0,0,0,3,1,2,0,0,0,0,0,0,4,2,2,0,0,0,1,0,1,0,0,0
166674,25000,250,0,-2,1,1,0,0,0,0,0,0,0,0,0,0,0,0,0,0,0,0,1,1,0,0,0,0,0,0,0,0,0,0
166683,25000,250,0,-2,12,3,9,0,0,0,0,0,0,1,1,0,0,0,0,0,0,0,9,2,7,0,0,0,2,0,2,0,0,0
166692,25000,250,0,-2,1,0,1,0,0,0,0,0,0,0,0,0,0,0,0,0,0,0,1,0,1,0,0,0,0,0,0,0,0,0
166708,25000,250,0,-2,3,1,2,0,0,0,0,0,0,0,0,0,1,0,1,0,0,0,2,1,1,0,0,0,0,0,0,0,0,0
166823,25000,250,0,-2,6,1,5,0,0,0,1,0,1,2,0,2,0,0,0,0,0,0,3,1,2,0,0,0,0,0,0,0,0,0
166850,25000,250,0,-2,19,8,11,0,0,0,0,0,0,2,1,1,1,1,0,0,0,0,14,5,9,0,0,0,2,1,1,0,0,0
166869,25000,250,0,-2,5,0,5,0,0,0,1,0,1,1,0,1,1,0,1,0,0,0,1,0,1,1,0,1,0,0,0,0,0,0
166887,25000,250,0,-2,3,1,2,0,0,0,0,0,0,1,0,1,0,0,0,0,0,0,2,1,1,0,0,0,0,0,0,0,0,0
166911,25000,250,0,-2,8,2,6,0,0,0,0,0,0,0,0,0,0,0,0,0,0,0,0,0,0,0,0,0,8,2,6,0,0,0
166939,25000,250,0,-2,4,1,3,0,0,0,0,0,0,0,0,0,0,0,0,0,0,0,0,0,0,1,1,0,3,0,3,0,0,0
167057,25000,250,0,-2,1,0,1,0,0,0,0,0,0,0,0,0,0,0,0,0,0,0,0,0,0,0,0,0,1,0,1,0,0,0
167215,25000,250,0,-2,2,0,2,0,0,0,0,0,0,0,0,0,0,0,0,0,0,0,2,0,2,0,0,0,0,0,0,0,0,0
167260,25000,250,0,-2,2,2,0,0,0,0,0,0,0,0,0,0,1,1,0,0,0,0,1,1,0,0,0,0,0,0,0,0,0,0
167288,25000,250,0,-2,10,3,7,0,0,0,0,0,0,1,0,1,1,0,1,0,0,0,8,3,5,0,0,0,0,0,0,0,0,0
167358,25000,250,0,-2,79,17,62,0,0,0,5,2,3,6,0,6,5,2,3,0,0,0,54,12,42,0,0,0,9,1,8,0,0,0
167376,25000,250,0,-2,7,3,4,0,0,0,0,0,0,0,0,0,2,0,2,0,0,0,4,2,2,0,0,0,1,1,0,0,0,0
167394,25000,250,0,-2,2,1,1,0,0,0,0,0,0,0,0,0,1,1,0,0,0,0,1,0,1,0,0,0,0,0,0,0,0,0
167525,25000,250,0,-2,8,3,5,0,0,0,1,1,0,0,0,0,1,1,0,0,0,0,6,1,5,0,0,0,0,0,0,0,0,0
167598,25000,250,0,-2,12,3,9,0,0,0,0,0,0,2,0,2,1,0,1,0,0,0,8,3,5,0,0,0,1,0,1,0,0,0
167631,25000,250,0,-2,4,1,3,0,0,0,1,0,1,2,0,2,0,0,0,0,0,0,1,1,0,0,0,0,0,0,0,0,0,0
167729,25000,250,0,-2,2,0,2,0,0,0,0,0,0,0,0,0,0,0,0,0,0,0,2,0,2,0,0,0,0,0,0,0,0,0
167783,25000,250,0,-2,7,0,7,0,0,0,0,0,0,0,0,0,0,0,0,0,0,0,7,0,7,0,0,0,0,0,0,0,0,0
167835,25000,250,0,-2,14,1,13,0,0,0,0,0,0,0,0,0,3,0,3,0,0,0,11,1,10,0,0,0,0,0,0,0,0,0
167899,25000,250,0,-2,10,2,8,0,0,0,0,0,0,2,1,1,0,0,0,0,0,0,7,1,6,0,0,0,1,0,1,0,0,0
167905,25000,250,0,-2,2,0,2,0,0,0,0,0,0,1,0,1,1,0,1,0,0,0,0,0,0,0,0,0,0,0,0,0,0,0
167987,25000,250,0,-2,3,2,1,0,0,0,0,0,0,1,0,1,0,0,0,0,0,0,1,1,0,0,0,0,0,0,0,1,1,0
168005,25000,250,0,-2,4,1,3,0,0,0,0,0,0,1,0,1,0,0,0,0,0,0,3,1,2,0,0,0,0,0,0,0,0,0
168148,25000,250,0,-2,28,10,18,0,0,0,0,0,0,4,3,1,3,1,2,0,0,0,20,6,14,0,0,0,1,0,1,0,0,0
168218,25000,250,0,-2,2,0,2,0,0,0,0,0,0,0,0,0,0,0,0,0,0,0,2,0,2,0,0,0,0,0,0,0,0,0
168227,25000,250,0,-2,15,4,11,0,0,0,0,0,0,1,1,0,1,0,1,0,0,0,9,3,6,0,0,0,4,0,4,0,0,0
168254,25000,250,0,-2,2,1,1,0,0,0,0,0,0,0,0,0,0,0,0,0,0,0,1,0,1,0,0,0,1,1,0,0,0,0
168263,25000,250,0,-2,12,3,9,0,0,0,0,0,0,2,1,1,2,1,1,0,0,0,8,1,7,0,0,0,0,0,0,0,0,0
168281,25000,250,0,-2,1,1,0,0,0,0,0,0,0,0,0,0,0,0,0,0,0,0,0,0,0,1,1,0,0,0,0,0,0,0
168342,25000,250,0,-2,7,2,5,0,0,0,0,0,0,0,0,0,2,0,2,0,0,0,4,2,2,1,0,1,0,0,0,0,0,0
168421,25000,250,0,-2,2,1,1,0,0,0,1,1,0,0,0,0,0,0,0,0,0,0,1,0,1,0,0,0,0,0,0,0,0,0
168528,25000,250,0,-2,1,0,1,0,0,0,0,0,0,0,0,0,0,0,0,0,0,0,1,0,1,0,0,0,0,0,0,0,0,0
168546,25000,250,0,-2,7,4,3,0,0,0,0,0,0,3,0,3,1,1,0,0,0,0,3,3,0,0,0,0,0,0,0,0,0,0
168591,25000,250,0,-2,9,5,4,0,0,0,0,0,0,1,1,0,0,0,0,0,0,0,8,4,4,0,0,0,0,0,0,0,0,0
168740,25000,250,0,-2,9,3,6,0,0,0,1,1,0,1,1,0,1,1,0,0,0,0,5,0,5,0,0,0,1,0,1,0,0,0
168786,25000,250,0,-2,7,2,5,0,0,0,0,0,0,0,0,0,0,0,0,0,0,0,4,2,2,0,0,0,3,0,3,0,0,0
168847,25000,250,0,-2,2,0,2,0,0,0,1,0,1,0,0,0,0,0,0,0,0,0,1,0,1,0,0,0,0,0,0,0,0,0
168883,25000,250,0,-2,4,2,2,0,0,0,0,0,0,0,0,0,0,0,0,0,0,0,4,2,2,0,0,0,0,0,0,0,0,0
169080,25000,250,0,-2,1,1,0,0,0,0,0,0,0,0,0,0,0,0,0,0,0,0,1,1,0,0,0,0,0,0,0,0,0,0
169099,25000,250,0,-2,1,0,1,0,0,0,0,0,0,0,0,0,1,0,1,0,0,0,0,0,0,0,0,0,0,0,0,0,0,0
169220,25000,250,0,-2,1,0,1,0,0,0,0,0,0,0,0,0,0,0,0,0,0,0,1,0,1,0,0,0,0,0,0,0,0,0
169327,25000,250,0,-2,1,0,1,0,0,0,0,0,0,0,0,0,0,0,0,0,0,0,1,0,1,0,0,0,0,0,0,0,0,0
169363,25000,250,0,-2,7,0,7,0,0,0,0,0,0,1,0,1,0,0,0,0,0,0,6,0,6,0,0,0,0,0,0,0,0,0
169479,25000,250,0,-2,2,0,2,0,0,0,0,0,0,0,0,0,0,0,0,0,0,0,2,0,2,0,0,0,0,0,0,0,0,0
169521,25000,250,0,-2,10,4,6,0,0,0,0,0,0,2,2,0,0,0,0,0,0,0,7,1,6,0,0,0,1,1,0,0,0,0
169716,25000,250,0,-2,10,3,7,0,0,0,0,0,0,1,1,0,0,0,0,0,0,0,7,1,6,0,0,0,0,0,0,2,1,1
169798,25000,250,0,-2,2,1,1,0,0,0,0,0,0,0,0,0,0,0,0,0,0,0,2,1,1,0,0,0,0,0,0,0,0,0
169910,25000,250,0,-2,8,2,6,0,0,0,0,0,0,1,0,1,1,1,0,0,0,0,6,1,5,0,0,0,0,0,0,0,0,0
169974,25000,250,0,-2,3,1,2,0,0,0,0,0,0,1,1,0,0,0,0,0,0,0,2,0,2,0,0,0,0,0,0,0,0,0
169983,25000,250,0,-2,2,0,2,0,0,0,0,0,0,0,0,0,0,0,0,0,0,0,2,0,2,0,0,0,0,0,0,0,0,0
170037,25000,250,0,-2,3,2,1,0,0,0,0,0,0,0,0,0,0,0,0,0,0,0,3,2,1,0,0,0,0,0,0,0,0,0
170082,25000,250,0,-2,3,1,2,0,0,0,1,0,1,0,0,0,0,0,0,0,0,0,1,0,1,1,1,0,0,0,0,0,0,0
170240,25000,250,0,-2,19,7,12,0,0,0,0,0,0,3,0,3,0,0,0,0,0,0,16,7,9,0,0,0,0,0,0,0,0,0
170286,25000,250,0,-2,10,3,7,0,0,0,0,0,0,0,0,0,0,0,0,0,0,0,0,0,0,0,0,0,10,3,7,0,0,0
170301,25000,250,0,-2,2,1,1,0,0,0,0,0,0,0,0,0,0,0,0,0,0,0,2,1,1,0,0,0,0,0,0,0,0,0
170532,25000,250,0,-2,1,0,1,0,0,0,0,0,0,0,0,0,0,0,0,0,0,0,1,0,1,0,0,0,0,0,0,0,0,0
170541,25000,250,0,-2,13,5,8,0,0,0,0,0,0,1,0,1,0,0,0,0,0,0,10,3,7,0,0,0,2,2,0,0,0,0
170587,25000,250,0,-2,2,1,1,0,0,0,0,0,0,0,0,0,0,0,0,0,0,0,2,1,1,0,0,0,0,0,0,0,0,0
170657,25000,250,0,-2,1,0,1,0,0,0,0,0,0,0,0,0,0,0,0,0,0,0,1,0,1,0,0,0,0,0,0,0,0,0
170790,25000,250,0,-2,4,0,4,0,0,0,0,0,0,1,0,1,0,0,0,0,0,0,2,0,2,0,0,0,1,0,1,0,0,0
170806,25000,250,0,-2,19,5,14,0,0,0,1,0,1,4,2,2,1,0,1,1,0,1,9,0,9,2,2,0,1,1,0,0,0,0
170967,25000,250,0,-2,4,2,2,0,0,0,0,0,0,2,2,0,0,0,0,0,0,0,2,0,2,0,0,0,0,0,0,0,0,0
170976,25000,250,0,-2,144,42,102,0,0,0,15,1,14,30,15,15,14,6,8,0,0,0,79,19,60,3,0,3,1,0,1,2,1,1
171100,25000,250,0,-2,58,15,43,1,0,1,3,1,2,5,1,4,3,2,1,0,0,0,27,9,18,1,0,1,0,0,0,18,2,16
171128,25000,250,0,-2,3,0,3,0,0,0,0,0,0,0,0,0,0,0,0,0,0,0,3,0,3,0,0,0,0,0,0,0,0,0
171137,25000,250,0,-2,26,4,22,0,0,0,0,0,0,6,2,4,1,0,1,0,0,0,18,2,16,1,0,1,0,0,0,0,0,0
171146,25000,250,0,-2,12,6,6,0,0,0,0,0,0,4,3,1,1,1,0,0,0,0,7,2,5,0,0,0,0,0,0,0,0,0
171155,25000,250,0,-2,2,1,1,0,0,0,0,0,0,0,0,0,0,0,0,0,0,0,2,1,1,0,0,0,0,0,0,0,0,0
171225,25000,250,0,-2,2,1,1,0,0,0,0,0,0,0,0,0,0,0,0,0,0,0,1,0,1,0,0,0,1,1,0,0,0,0
171456,25000,250,0,-2,6,3,3,0,0,0,0,0,0,0,0,0,1,1,0,0,0,0,5,2,3,0,0,0,0,0,0,0,0,0
171483,25000,250,0,-2,3,3,0,0,0,0,0,0,0,0,0,0,0,0,0,0,0,0,3,3,0,0,0,0,0,0,0,0,0,0
171492,25000,250,0,-2,3,1,2,0,0,0,0,0,0,1,1,0,0,0,0,0,0,0,2,0,2,0,0,0,0,0,0,0,0,0
171571,25000,250,0,-2,10,3,7,0,0,0,1,1,0,3,0,3,0,0,0,0,0,0,6,2,4,0,0,0,0,0,0,0,0,0
172033,25000,250,0,-2,1,0,1,0,0,0,0,0,0,0,0,0,0,0,0,0,0,0,1,0,1,0,0,0,0,0,0,0,0,0
172051,25000,250,0,-2,2,0,2,0,0,0,0,0,0,0,0,0,0,0,0,0,0,0,2,0,2,0,0,0,0,0,0,0,0,0
172200,25000,250,0,-2,5,1,4,0,0,0,0,0,0,2,0,2,0,0,0,0,0,0,3,1,2,0,0,0,0,0,0,0,0,0
172264,25000,250,0,-2,8,4,4,0,0,0,0,0,0,0,0,0,1,1,0,0,0,0,7,3,4,0,0,0,0,0,0,0,0,0
172307,25000,250,0,-2,1,0,1,0,0,0,0,0,0,0,0,0,0,0,0,0,0,0,1,0,1,0,0,0,0,0,0,0,0,0
172440,25000,250,0,-2,3,1,2,0,0,0,0,0,0,0,0,0,0,0,0,0,0,0,3,1,2,0,0,0,0,0,0,0,0,0
172477,25000,250,0,-2,2,1,1,0,0,0,0,0,0,0,0,0,1,0,1,0,0,0,1,1,0,0,0,0,0,0,0,0,0,0
172635,25000,250,0,-2,2,0,2,0,0,0,0,0,0,1,0,1,0,0,0,0,0,0,0,0,0,0,0,0,1,0,1,0,0,0
172644,25000,250,0,-2,14,3,11,0,0,0,1,0,1,2,0,2,1,1,0,0,0,0,10,2,8,0,0,0,0,0,0,0,0,0
172699,25000,250,0,-2,12,4,8,0,0,0,0,0,0,1,0,1,2,0,2,0,0,0,9,4,5,0,0,0,0,0,0,0,0,0
172918,25000,250,0,-2,1,1,0,0,0,0,0,0,0,0,0,0,0,0,0,0,0,0,1,1,0,0,0,0,0,0,0,0,0,0
172963,25000,250,0,-2,1,0,1,0,0,0,0,0,0,0,0,0,0,0,0,0,0,0,1,0,1,0,0,0,0,0,0,0,0,0
173063,25000,250,0,-2,2,0,2,0,0,0,0,0,0,2,0,2,0,0,0,0,0,0,0,0,0,0,0,0,0,0,0,0,0,0
173124,25000,250,0,-2,1,0,1,0,0,0,0,0,0,0,0,0,0,0,0,0,0,0,1,0,1,0,0,0,0,0,0,0,0,0
173142,25000,250,0,-2,2,1,1,0,0,0,0,0,0,0,0,0,1,1,0,0,0,0,1,0,1,0,0,0,0,0,0,0,0,0
173160,25000,250,0,-2,2,0,2,0,0,0,0,0,0,0,0,0,0,0,0,0,0,0,1,0,1,1,0,1,0,0,0,0,0,0
173203,25000,250,0,-2,1,0,1,0,0,0,0,0,0,0,0,0,0,0,0,0,0,0,1,0,1,0,0,0,0,0,0,0,0,0
173258,25000,250,0,-2,6,2,4,0,0,0,0,0,0,2,1,1,1,1,0,0,0,0,3,0,3,0,0,0,0,0,0,0,0,0
173300,25000,250,0,-2,3,1,2,0,0,0,0,0,0,0,0,0,0,0,0,0,0,0,3,1,2,0,0,0,0,0,0,0,0,0
173328,25000,250,0,-2,13,4,9,0,0,0,0,0,0,2,0,2,1,0,1,0,0,0,7,3,4,0,0,0,1,1,0,2,0,2
173452,25000,250,0,-2,3,0,3,0,0,0,0,0,0,0,0,0,0,0,0,0,0,0,2,0,2,1,0,1,0,0,0,0,0,0
173461,25000,250,0,-2,3,0,3,0,0,0,0,0,0,0,0,0,0,0,0,0,0,0,3,0,3,0,0,0,0,0,0,0,0,0
173559,25000,250,0,-2,1,1,0,0,0,0,0,0,0,0,0,0,0,0,0,0,0,0,1,1,0,0,0,0,0,0,0,0,0,0
173638,25000,250,0,-2,2,0,2,0,0,0,0,0,0,0,0,0,0,0,0,0,0,0,2,0,2,0,0,0,0,0,0,0,0,0
173665,25000,250,0,-2,9,2,7,0,0,0,0,0,0,1,0,1,0,0,0,0,0,0,8,2,6,0,0,0,0,0,0,0,0,0
173708,25000,250,0,-2,4,2,2,0,0,0,1,0,1,0,0,0,0,0,0,0,0,0,3,2,1,0,0,0,0,0,0,0,0,0
173799,25000,250,0,-2,3,2,1,0,0,0,0,0,0,1,1,0,0,0,0,0,0,0,2,1,1,0,0,0,0,0,0,0,0,0
173902,25000,250,0,-2,23,5,18,0,0,0,2,1,1,1,0,1,2,1,1,0,0,0,17,3,14,1,0,1,0,0,0,0,0,0
173911,25000,250,0,-2,1,1,0,0,0,0,0,0,0,1,1,0,0,0,0,0,0,0,0,0,0,0,0,0,0,0,0,0,0,0
173920,25000,250,0,-2,13,6,7,0,0,0,0,0,0,0,0,0,3,1,2,0,0,0,8,3,5,2,2,0,0,0,0,0,0,0
173957,25000,250,0,-2,7,0,7,0,0,0,0,0,0,2,0,2,0,0,0,0,0,0,5,0,5,0,0,0,0,0,0,0,0,0
174020,25000,250,0,-2,10,2,8,0,0,0,4,0,4,0,0,0,0,0,0,0,0,0,5,1,4,1,1,0,0,0,0,0,0,0
174066,25000,250,0,-2,33,11,22,0,0,0,2,1,1,1,0,1,4,1,3,0,0,0,21,7,14,3,2,1,1,0,1,1,0,1
174075,25000,250,0,-2,1,0,1,0,0,0,0,0,0,0,0,0,0,0,0,0,0,0,1,0,1,0,0,0,0,0,0,0,0,0
174127,25000,250,0,-2,4,1,3,0,0,0,1,0,1,0,0,0,1,1,0,0,0,0,2,0,2,0,0,0,0,0,0,0,0,0
174136,25000,250,0,-2,6,1,5,0,0,0,4,1,3,0,0,0,0,0,0,0,0,0,2,0,2,0,0,0,0,0,0,0,0,0
174154,25000,250,0,-2,3,0,3,1,0,1,0,0,0,0,0,0,0,0,0,0,0,0,2,0,2,0,0,0,0,0,0,0,0,0
174233,25000,250,0,-2,5,1,4,0,0,0,1,0,1,0,0,0,0,0,0,0,0,0,3,1,2,0,0,0,0,0,0,1,0,1
174358,25000,250,0,-2,2,1,1,0,0,0,0,0,0,0,0,0,0,0,0,0,0,0,2,1,1,0,0,0,0,0,0,0,0,0
174376,25000,250,0,-2,6,3,3,0,0,0,1,1,0,1,0,1,0,0,0,0,0,0,4,2,2,0,0,0,0,0,0,0,0,0
174428,25000,250,0,-2,8,4,4,0,0,0,0,0,0,2,2,0,0,0,0,0,0,0,5,1,4,1,1,0,0,0,0,0,0,0
174437,25000,250,0,-2,3,0,3,0,0,0,0,0,0,0,0,0,0,0,0,0,0,0,3,0,3,0,0,0,0,0,0,0,0,0
174491,25000,250,0,-2,6,1,5,0,0,0,1,0,1,0,0,0,1,0,1,0,0,0,4,1,3,0,0,0,0,0,0,0,0,0
174738,25000,250,0,-2,2,0,2,0,0,0,0,0,0,0,0,0,0,0,0,0,0,0,2,0,2,0,0,0,0,0,0,0,0,0
174747,25000,250,0,-2,3,0,3,0,0,0,0,0,0,1,0,1,0,0,0,0,0,0,2,0,2,0,0,0,0,0,0,0,0,0
174756,25000,250,0,-2,1,0,1,0,0,0,0,0,0,0,0,0,0,0,0,0,0,0,1,0,1,0,0,0,0,0,0,0,0,0
174783,25000,250,0,-2,10,4,6,0,0,0,1,0,1,3,2,1,0,0,0,0,0,0,5,1,4,0,0,0,1,1,0,0,0,0
174792,25000,250,0,-2,2,1,1,0,0,0,0,0,0,0,0,0,0,0,0,0,0,0,2,1,1,0,0,0,0,0,0,0,0,0
174817,25000,250,0,-2,5,0,5,0,0,0,0,0,0,0,0,0,0,0,0,0,0,0,5,0,5,0,0,0,0,0,0,0,0,0
174844,25000,250,0,-2,10,3,7,1,0,1,1,1,0,0,0,0,2,2,0,0,0,0,6,0,6,0,0,0,0,0,0,0,0,0
174862,25000,250,0,-2,1,0,1,0,0,0,0,0,0,0,0,0,0,0,0,0,0,0,1,0,1,0,0,0,0,0,0,0,0,0
174899,25000,250,0,-2,5,1,4,0,0,0,0,0,0,0,0,0,1,0,1,0,0,0,3,1,2,1,0,1,0,0,0,0,0,0
174914,25000,250,0,-2,5,1,4,0,0,0,1,0,1,0,0,0,0,0,0,0,0,0,4,1,3,0,0,0,0,0,0,0,0,0
175014,25000,250,0,-2,18,3,15,0,0,0,1,0,1,0,0,0,2,0,2,0,0,0,14,3,11,1,0,1,0,0,0,0,0,0
175041,25000,250,0,-2,5,4,1,0,0,0,2,1,1,1,1,0,0,0,0,0,0,0,2,2,0,0,0,0,0,0,0,0,0,0
175078,25000,250,0,-2,1,0,1,0,0,0,0,0,0,0,0,0,0,0,0,0,0,0,1,0,1,0,0,0,0,0,0,0,0,0
175236,25000,250,0,-2,1,0,1,0,0,0,0,0,0,0,0,0,0,0,0,0,0,0,1,0,1,0,0,0,0,0,0,0,0,0
175263,25000,250,0,-2,1,1,0,0,0,0,1,1,0,0,0,0,0,0,0,0,0,0,0,0,0,0,0,0,0,0,0,0,0,0
175272,25000,250,0,-2,3,1,2,0,0,0,0,0,0,0,0,0,0,0,0,0,0,0,3,1,2,0,0,0,0,0,0,0,0,0
175281,25000,250,0,-2,3,0,3,0,0,0,0,0,0,0,0,0,0,0,0,0,0,0,3,0,3,0,0,0,0,0,0,0,0,0
175315,25000,250,0,-2,6,0,6,0,0,0,2,0,2,0,0,0,1,0,1,0,0,0,2,0,2,0,0,0,1,0,1,0,0,0
175342,25000,250,0,-2,3,0,3,0,0,0,0,0,0,3,0,3,0,0,0,0,0,0,0,0,0,0,0,0,0,0,0,0,0,0
175421,25000,250,0,-2,18,4,14,0,0,0,0,0,0,11,2,9,0,0,0,0,0,0,7,2,5,0,0,0,0,0,0,0,0,0
175519,25000,250,0,-2,2,2,0,0,0,0,0,0,0,2,2,0,0,0,0,0,0,0,0,0,0,0,0,0,0,0,0,0,0,0
175616,25000,250,0,-2,18,5,13,0,0,0,0,0,0,6,0,6,2,1,1,0,0,0,10,4,6,0,0,0,0,0,0,0,0,0
175652,25000,250,0,-2,2,1,1,0,0,0,0,0,0,1,0,1,0,0,0,0,0,0,1,1,0,0,0,0,0,0,0,0,0,0
175786,25000,250,0,-2,9,2,7,0,0,0,0,0,0,8,1,7,0,0,0,0,0,0,1,1,0,0,0,0,0,0,0,0,0,0
175810,25000,250,0,-2,6,1,5,0,0,0,1,0,1,2,0,2,0,0,0,0,0,0,3,1,2,0,0,0,0,0,0,0,0,0
175829,25000,250,0,-2,4,1,3,0,0,0,0,0,0,0,0,0,1,0,1,0,0,0,3,1,2,0,0,0,0,0,0,0,0,0
175883,25000,250,0,-2,2,0,2,0,0,0,0,0,0,2,0,2,0,0,0,0,0,0,0,0,0,0,0,0,0,0,0,0,0,0
175935,25000,250,0,-2,2,0,2,0,0,0,0,0,0,0,0,0,0,0,0,0,0,0,2,0,2,0,0,0,0,0,0,0,0,0
175980,25000,250,0,-2,1,1,0,0,0,0,0,0,0,0,0,0,0,0,0,0,0,0,1,1,0,0,0,0,0,0,0,0,0,0
176008,25000,250,0,-2,4,1,3,0,0,0,0,0,0,2,0,2,0,0,0,0,0,0,2,1,1,0,0,0,0,0,0,0,0,0
176017,25000,250,0,-2,14,1,13,0,0,0,0,0,0,3,0,3,0,0,0,0,0,0,11,1,10,0,0,0,0,0,0,0,0,0
176035,25000,250,0,-2,1,1,0,0,0,0,0,0,0,0,0,0,0,0,0,0,0,0,1,1,0,0,0,0,0,0,0,0,0,0
176044,25000,250,0,-2,3,0,3,0,0,0,0,0,0,3,0,3,0,0,0,0,0,0,0,0,0,0,0,0,0,0,0,0,0,0
176053,25000,250,0,-2,4,0,4,0,0,0,0,0,0,1,0,1,0,0,0,0,0,0,3,0,3,0,0,0,0,0,0,0,0,0
176071,25000,250,0,-2,4,0,4,0,0,0,1,0,1,0,0,0,0,0,0,0,0,0,3,0,3,0,0,0,0,0,0,0,0,0
176080,25000,250,0,-2,62,17,45,1,0,1,2,1,1,15,2,13,2,1,1,0,0,0,39,13,26,1,0,1,0,0,0,2,0,2
176169,25000,250,0,-2,5,2,3,0,0,0,0,0,0,0,0,0,0,0,0,0,0,0,4,1,3,0,0,0,1,1,0,0,0,0
176239,25000,250,0,-2,9,0,9,0,0,0,0,0,0,1,0,1,1,0,1,0,0,0,7,0,7,0,0,0,0,0,0,0,0,0
176354,25000,250,0,-2,1,0,1,0,0,0,0,0,0,0,0,0,0,0,0,0,0,0,1,0,1,0,0,0,0,0,0,0,0,0
176406,25000,250,0,-2,7,2,5,0,0,0,0,0,0,6,2,4,0,0,0,0,0,0,0,0,0,0,0,0,1,0,1,0,0,0
176451,25000,250,0,-2,1,0,1,0,0,0,0,0,0,0,0,0,0,0,0,0,0,0,1,0,1,0,0,0,0,0,0,0,0,0
176479,25000,250,0,-2,15,8,7,0,0,0,1,1,0,3,3,0,1,1,0,0,0,0,9,2,7,0,0,0,1,1,0,0,0,0
176600,25000,250,0,-2,1,1,0,0,0,0,0,0,0,0,0,0,0,0,0,0,0,0,1,1,0,0,0,0,0,0,0,0,0,0
176628,25000,250,0,-2,14,4,10,0,0,0,0,0,0,4,1,3,1,0,1,0,0,0,9,3,6,0,0,0,0,0,0,0,0,0
176965,25000,250,0,-2,3,1,2,0,0,0,0,0,0,0,0,0,0,0,0,0,0,0,2,1,1,0,0,0,1,0,1,0,0,0
177038,25000,250,0,-2,1,0,1,0,0,0,0,0,0,0,0,0,0,0,0,0,0,0,1,0,1,0,0,0,0,0,0,0,0,0
177065,25000,250,0,-2,1,0,1,0,0,0,0,0,0,0,0,0,0,0,0,0,0,0,0,0,0,0,0,0,1,0,1,0,0,0
177126,25000,250,0,-2,1,0,1,0,0,0,0,0,0,0,0,0,0,0,0,0,0,0,1,0,1,0,0,0,0,0,0,0,0,0
177135,25000,250,0,-2,6,0,6,0,0,0,0,0,0,0,0,0,0,0,0,0,0,0,5,0,5,0,0,0,1,0,1,0,0,0
177144,25000,250,0,-2,3,0,3,0,0,0,0,0,0,0,0,0,0,0,0,0,0,0,3,0,3,0,0,0,0,0,0,0,0,0
177214,25000,250,0,-2,11,2,9,0,0,0,0,0,0,0,0,0,0,0,0,0,0,0,4,0,4,0,0,0,7,2,5,0,0,0
177250,25000,250,0,-2,3,2,1,0,0,0,0,0,0,0,0,0,0,0,0,0,0,0,3,2,1,0,0,0,0,0,0,0,0,0
177418,25000,250,0,-2,2,0,2,0,0,0,0,0,0,0,0,0,0,0,0,0,0,0,2,0,2,0,0,0,0,0,0,0,0,0
177472,25000,250,0,-2,18,5,13,0,0,0,0,0,0,0,0,0,2,0,2,1,0,1,13,3,10,0,0,0,2,2,0,0,0,0
177551,25000,250,0,-2,1,0,1,0,0,0,0,0,0,1,0,1,0,0,0,0,0,0,0,0,0,0,0,0,0,0,0,0,0,0
177676,25000,250,0,-2,2,0,2,0,0,0,0,0,0,0,0,0,0,0,0,0,0,0,2,0,2,0,0,0,0,0,0,0,0,0
177746,25000,250,0,-2,2,1,1,0,0,0,0,0,0,1,0,1,0,0,0,0,0,0,1,1,0,0,0,0,0,0,0,0,0,0
177940,25000,250,0,-2,6,0,6,0,0,0,0,0,0,4,0,4,1,0,1,0,0,0,1,0,1,0,0,0,0,0,0,0,0,0
177968,25000,250,0,-2,18,7,11,0,0,0,3,2,1,2,1,1,0,0,0,0,0,0,13,4,9,0,0,0,0,0,0,0,0,0
177977,25000,250,0,-2,2,1,1,0,0,0,0,0,0,0,0,0,0,0,0,0,0,0,2,1,1,0,0,0,0,0,0,0,0,0
177986,25000,250,0,-2,15,5,10,0,0,0,0,0,0,2,2,0,1,0,1,0,0,0,12,3,9,0,0,0,0,0,0,0,0,0
177995,25000,250,0,-2,2,0,2,0,0,0,0,0,0,0,0,0,0,0,0,0,0,0,0,0,0,0,0,0,2,0,2,0,0,0
178217,25000,250,0,-2,1,0,1,0,0,0,0,0,0,0,0,0,0,0,0,0,0,0,1,0,1,0,0,0,0,0,0,0,0,0
178341,25000,250,0,-2,10,2,8,0,0,0,0,0,0,0,0,0,0,0,0,1,1,0,8,1,7,0,0,0,1,0,1,0,0,0
178369,25000,250,0,-2,3,1,2,0,0,0,0,0,0,0,0,0,0,0,0,0,0,0,3,1,2,0,0,0,0,0,0,0,0,0
178387,25000,250,0,-2,19,8,11,0,0,0,0,0,0,1,1,0,0,0,0,0,0,0,10,5,5,1,0,1,7,2,5,0,0,0
178396,25000,250,0,-2,57,11,46,0,0,0,4,0,4,1,1,0,5,2,3,0,0,0,42,6,36,1,1,0,2,0,2,2,1,1
178402,25000,250,0,-2,17,4,13,0,0,0,0,0,0,1,0,1,2,1,1,0,0,0,12,2,10,0,0,0,2,1,1,0,0,0
178411,25000,250,0,-2,6,1,5,0,0,0,0,0,0,0,0,0,1,0,1,0,0,0,5,1,4,0,0,0,0,0,0,0,0,0
178420,25000,250,0,-2,3,1,2,0,0,0,0,0,0,0,0,0,0,0,0,0,0,0,2,0,2,0,0,0,0,0,0,1,1,0
178439,25000,250,0,-2,4,0,4,0,0,0,0,0,0,0,0,0,0,0,0,0,0,0,4,0,4,0,0,0,0,0,0,0,0,0
178448,25000,250,0,-2,3,0,3,0,0,0,0,0,0,0,0,0,0,0,0,0,0,0,3,0,3,0,0,0,0,0,0,0,0,0
178518,25000,250,0,-2,1,1,0,0,0,0,0,0,0,1,1,0,0,0,0,0,0,0,0,0,0,0,0,0,0,0,0,0,0,0
178615,25000,250,0,-2,6,0,6,0,0,0,0,0,0,0,0,0,0,0,0,0,0,0,6,0,6,0,0,0,0,0,0,0,0,0
178624,25000,250,0,-2,19,3,16,0,0,0,0,0,0,0,0,0,0,0,0,0,0,0,18,3,15,0,0,0,0,0,0,1,0,1
178679,25000,250,0,-2,1,0,1,0,0,0,0,0,0,0,0,0,0,0,0,0,0,0,1,0,1,0,0,0,0,0,0,0,0,0
178721,25000,250,0,-2,23,4,19,1,0,1,1,1,0,1,0,1,2,0,2,0,0,0,17,3,14,1,0,1,0,0,0,0,0,0
178891,25000,250,0,-2,4,0,4,0,0,0,0,0,0,1,0,1,0,0,0,0,0,0,3,0,3,0,0,0,0,0,0,0,0,0
178989,25000,250,0,-2,1,0,1,0,0,0,0,0,0,0,0,0,1,0,1,0,0,0,0,0,0,0,0,0,0,0,0,0,0,0
179043,25000,250,0,-2,1,0,1,0,0,0,0,0,0,0,0,0,0,0,0,0,0,0,1,0,1,0,0,0,0,0,0,0,0,0
179159,25000,250,0,-2,4,2,2,0,0,0,0,0,0,0,0,0,0,0,0,0,0,0,2,2,0,1,0,1,0,0,0,1,0,1
179308,25000,250,0,-2,7,1,6,0,0,0,0,0,0,2,0,2,0,0,0,0,0,0,5,1,4,0,0,0,0,0,0,0,0,0
179326,25000,250,0,-2,1,0,1,0,0,0,0,0,0,0,0,0,0,0,0,0,0,0,1,0,1,0,0,0,0,0,0,0,0,0
179539,25000,250,0,-2,1,0,1,0,0,0,0,0,0,0,0,0,0,0,0,0,0,0,1,0,1,0,0,0,0,0,0,0,0,0
179548,25000,250,0,-2,2,0,2,0,0,0,0,0,0,0,0,0,0,0,0,0,0,0,2,0,2,0,0,0,0,0,0,0,0,0
179557,25000,250,0,-2,6,2,4,0,0,0,0,0,0,0,0,0,0,0,0,0,0,0,6,2,4,0,0,0,0,0,0,0,0,0
179566,25000,250,0,-2,8,2,6,0,0,0,0,0,0,0,0,0,0,0,0,0,0,0,8,2,6,0,0,0,0,0,0,0,0,0
179645,25000,250,0,-2,1,1,0,0,0,0,0,0,0,0,0,0,0,0,0,0,0,0,1,1,0,0,0,0,0,0,0,0,0,0
179715,25000,250,0,-2,4,0,4,0,0,0,0,0,0,0,0,0,0,0,0,0,0,0,4,0,4,0,0,0,0,0,0,0,0,0
179812,25000,250,0,-2,6,2,4,0,0,0,0,0,0,0,0,0,2,1,1,0,0,0,4,1,3,0,0,0,0,0,0,0,0,0
179867,25000,250,0,-2,29,5,24,0,0,0,4,0,4,4,0,4,2,1,1,0,0,0,19,4,15,0,0,0,0,0,0,0,0,0
179894,25000,250,0,-2,4,1,3,0,0,0,0,0,0,1,1,0,2,0,2,0,0,0,0,0,0,1,0,1,0,0,0,0,0,0
179946,25000,250,0,-2,4,1,3,0,0,0,0,0,0,0,0,0,0,0,0,0,0,0,4,1,3,0,0,0,0,0,0,0,0,0
179955,25000,250,0,-2,2,1,1,0,0,0,0,0,0,0,0,0,0,0,0,0,0,0,2,1,1,0,0,0,0,0,0,0,0,0
179964,25000,250,0,-2,2,2,0,0,0,0,0,0,0,1,1,0,0,0,0,0,0,0,1,1,0,0,0,0,0,0,0,0,0,0
180106,25000,250,0,-2,4,2,2,0,0,0,0,0,0,0,0,0,0,0,0,0,0,0,2,1,1,0,0,0,2,1,1,0,0,0
180179,25000,250,0,-2,2,1,1,0,0,0,0,0,0,0,0,0,0,0,0,0,0,0,2,1,1,0,0,0,0,0,0,0,0,0
180197,25000,250,0,-2,2,2,0,0,0,0,0,0,0,0,0,0,0,0,0,0,0,0,2,2,0,0,0,0,0,0,0,0,0,0
180203,25000,250,0,-2,4,2,2,4,2,2,0,0,0,0,0,0,0,0,0,0,0,0,0,0,0,0,0,0,0,0,0,0,0,0
180212,25000,250,0,-2,5,2,3,4,2,2,0,0,0,0,0,0,0,0,0,0,0,0,1,0,1,0,0,0,0,0,0,0,0,0
180249,25000,250,0,-2,4,1,3,0,0,0,0,0,0,0,0,0,0,0,0,0,0,0,4,1,3,0,0,0,0,0,0,0,0,0
180258,25000,250,0,-2,2,1,1,0,0,0,0,0,0,0,0,0,0,0,0,0,0,0,2,1,1,0,0,0,0,0,0,0,0,0
180373,25000,250,0,-2,1,0,1,0,0,0,0,0,0,0,0,0,0,0,0,0,0,0,1,0,1,0,0,0,0,0,0,0,0,0
180416,25000,250,0,-2,3,0,3,0,0,0,0,0,0,0,0,0,0,0,0,0,0,0,3,0,3,0,0,0,0,0,0,0,0,0
180461,25000,250,0,-2,15,4,11,0,0,0,1,0,1,0,0,0,0,0,0,0,0,0,12,4,8,1,0,1,1,0,1,0,0,0
180489,25000,250,0,-2,4,0,4,1,0,1,0,0,0,0,0,0,0,0,0,0,0,0,2,0,2,1,0,1,0,0,0,0,0,0
180692,25000,250,0,-2,1,0,1,0,0,0,0,0,0,0,0,0,0,0,0,0,0,0,0,0,0,0,0,0,1,0,1,0,0,0
180832,25000,250,0,-2,1,0,1,0,0,0,0,0,0,0,0,0,0,0,0,0,0,0,1,0,1,0,0,0,0,0,0,0,0,0
180948,25000,250,0,-2,4,2,2,0,0,0,0,0,0,0,0,0,0,0,0,0,0,0,4,2,2,0,0,0,0,0,0,0,0,0
180984,25000,250,0,-2,9,1,8,0,0,0,0,0,0,1,0,1,0,0,0,0,0,0,8,1,7,0,0,0,0,0,0,0,0,0
181002,25000,250,0,-2,3,1,2,0,0,0,0,0,0,0,0,0,0,0,0,0,0,0,1,0,1,0,0,0,2,1,1,0,0,0
181020,25000,250,0,-2,2,0,2,0,0,0,0,0,0,0,0,0,0,0,0,0,0,0,2,0,2,0,0,0,0,0,0,0,0,0
181127,25000,250,0,-2,3,1,2,0,0,0,0,0,0,0,0,0,0,0,0,0,0,0,3,1,2,0,0,0,0,0,0,0,0,0
181303,25000,250,0,-2,6,2,4,0,0,0,0,0,0,0,0,0,2,0,2,0,0,0,4,2,2,0,0,0,0,0,0,0,0,0
181312,25000,250,0,-2,1,0,1,0,0,0,0,0,0,0,0,0,0,0,0,0,0,0,1,0,1,0,0,0,0,0,0,0,0,0
181330,25000,250,0,-2,10,4,6,0,0,0,0,0,0,1,1,0,0,0,0,0,0,0,9,3,6,0,0,0,0,0,0,0,0,0
181419,25000,250,0,-2,4,0,4,3,0,3,0,0,0,0,0,0,0,0,0,0,0,0,1,0,1,0,0,0,0,0,0,0,0,0
181428,25000,250,0,-2,1,0,1,0,0,0,0,0,0,0,0,0,0,0,0,0,0,0,1,0,1,0,0,0,0,0,0,0,0,0
181446,25000,250,0,-2,1,0,1,0,0,0,0,0,0,0,0,0,1,0,1,0,0,0,0,0,0,0,0,0,0,0,0,0,0,0
181464,25000,250,0,-2,32,5,27,0,0,0,1,0,1,1,0,1,1,1,0,0,0,0,27,2,25,1,1,0,0,0,0,1,1,0
181534,25000,250,0,-2,3,1,2,0,0,0,0,0,0,0,0,0,0,0,0,0,0,0,3,1,2,0,0,0,0,0,0,0,0,0
181604,25000,250,0,-2,5,0,5,0,0,0,0,0,0,1,0,1,0,0,0,0,0,0,3,0,3,1,0,1,0,0,0,0,0,0
181640,25000,250,0,-2,2,0,2,0,0,0,0,0,0,0,0,0,0,0,0,0,0,0,2,0,2,0,0,0,0,0,0,0,0,0
181747,25000,250,0,-2,4,1,3,0,0,0,0,0,0,0,0,0,0,0,0,0,0,0,4,1,3,0,0,0,0,0,0,0,0,0
181783,25000,250,0,-2,12,6,6,0,0,0,0,0,0,0,0,0,1,1,0,0,0,0,11,5,6,0,0,0,0,0,0,0,0,0
181817,25000,250,0,-2,1,0,1,0,0,0,0,0,0,0,0,0,0,0,0,0,0,0,1,0,1,0,0,0,0,0,0,0,0,0
181853,25000,250,0,-2,5,1,4,0,0,0,0,0,0,1,0,1,0,0,0,0,0,0,4,1,3,0,0,0,0,0,0,0,0,0
182005,25000,250,0,-2,1,0,1,0,0,0,0,0,0,0,0,0,1,0,1,0,0,0,0,0,0,0,0,0,0,0,0,0,0,0
182148,25000,250,0,-2,9,4,5,0,0,0,1,1,0,3,2,1,1,0,1,0,0,0,4,1,3,0,0,0,0,0,0,0,0,0
182281,25000,250,0,-2,14,2,12,1,1,0,1,0,1,1,1,0,2,0,2,0,0,0,6,0,6,1,0,1,1,0,1,1,0,1
182290,25000,250,0,-2,2,0,2,0,0,0,1,0,1,0,0,0,0,0,0,0,0,0,1,0,1,0,0,0,0,0,0,0,0,0
182306,25000,250,0,-2,4,0,4,0,0,0,0,0,0,0,0,0,2,0,2,0,0,0,2,0,2,0,0,0,0,0,0,0,0,0
182458,25000,250,0,-2,3,1,2,0,0,0,0,0,0,0,0,0,0,0,0,0,0,0,3,1,2,0,0,0,0,0,0,0,0,0
182500,25000,250,0,-2,3,0,3,0,0,0,0,0,0,0,0,0,1,0,1,0,0,0,2,0,2,0,0,0,0,0,0,0,0,0
182670,25000,250,0,-2,53,16,37,0,0,0,1,0,1,1,0,1,2,1,1,0,0,0,49,15,34,0,0,0,0,0,0,0,0,0
182795,25000,250,0,-2,1,1,0,0,0,0,0,0,0,0,0,0,1,1,0,0,0,0,0,0,0,0,0,0,0,0,0,0,0,0
182980,25000,250,0,-2,5,3,2,0,0,0,0,0,0,0,0,0,0,0,0,0,0,0,5,3,2,0,0,0,0,0,0,0,0,0
183026,25000,250,0,-2,21,2,19,0,0,0,0,0,0,2,0,2,2,0,2,0,0,0,13,2,11,0,0,0,4,0,4,0,0,0
183044,25000,250,0,-2,32,7,25,0,0,0,0,0,0,0,0,0,2,1,1,0,0,0,30,6,24,0,0,0,0,0,0,0,0,0
183062,25000,250,0,-2,5,1,4,0,0,0,0,0,0,0,0,0,0,0,0,0,0,0,5,1,4,0,0,0,0,0,0,0,0,0
183071,25000,250,0,-2,1,1,0,0,0,0,0,0,0,0,0,0,0,0,0,0,0,0,1,1,0,0,0,0,0,0,0,0,0,0
183080,25000,250,0,-2,5,0,5,0,0,0,0,0,0,0,0,0,0,0,0,0,0,0,4,0,4,0,0,0,1,0,1,0,0,0
183099,25000,250,0,-2,3,1,2,0,0,0,0,0,0,0,0,0,0,0,0,0,0,0,3,1,2,0,0,0,0,0,0,0,0,0
183105,25000,250,0,-2,1,1,0,0,0,0,0,0,0,0,0,0,0,0,0,0,0,0,1,1,0,0,0,0,0,0,0,0,0,0
183123,25000,250,0,-2,3,1,2,0,0,0,0,0,0,0,0,0,0,0,0,0,0,0,3,1,2,0,0,0,0,0,0,0,0,0
183132,25000,250,0,-2,3,0,3,0,0,0,0,0,0,0,0,0,0,0,0,0,0,0,3,0,3,0,0,0,0,0,0,0,0,0
183141,25000,250,0,-2,2,1,1,0,0,0,0,0,0,0,0,0,1,1,0,0,0,0,1,0,1,0,0,0,0,0,0,0,0,0
183150,25000,250,0,-2,3,1,2,0,0,0,0,0,0,0,0,0,0,0,0,0,0,0,3,1,2,0,0,0,0,0,0,0,0,0
183211,25000,250,0,-2,6,4,2,0,0,0,1,0,1,1,1,0,0,0,0,0,0,0,4,3,1,0,0,0,0,0,0,0,0,0
183239,25000,250,0,-2,6,0,6,0,0,0,1,0,1,0,0,0,0,0,0,0,0,0,4,0,4,0,0,0,1,0,1,0,0,0
183257,25000,250,0,-2,2,0,2,0,0,0,0,0,0,0,0,0,0,0,0,0,0,0,1,0,1,0,0,0,1,0,1,0,0,0
183488,25000,250,0,-2,1,0,1,0,0,0,1,0,1,0,0,0,0,0,0,0,0,0,0,0,0,0,0,0,0,0,0,0,0,0
183655,25000,250,0,-2,1,0,1,0,0,0,0,0,0,1,0,1,0,0,0,0,0,0,0,0,0,0,0,0,0,0,0,0,0,0
183743,25000,250,0,-2,2,0,2,0,0,0,0,0,0,1,0,1,0,0,0,0,0,0,1,0,1,0,0,0,0,0,0,0,0,0
183789,25000,250,0,-2,7,1,6,0,0,0,0,0,0,0,0,0,3,0,3,0,0,0,4,1,3,0,0,0,0,0,0,0,0,0
183859,25000,250,0,-2,9,4,5,0,0,0,1,0,1,0,0,0,0,0,0,0,0,0,8,4,4,0,0,0,0,0,0,0,0,0
183910,25000,250,0,-2,5,3,2,0,0,0,0,0,0,0,0,0,0,0,0,0,0,0,5,3,2,0,0,0,0,0,0,0,0,0
183938,25000,250,0,-2,6,4,2,0,0,0,0,0,0,2,1,1,0,0,0,0,0,0,3,3,0,0,0,0,1,0,1,0,0,0
184481,25000,250,0,-2,14,7,7,0,0,0,0,0,0,5,3,2,5,2,3,0,0,0,3,1,2,0,0,0,1,1,0,0,0,0
184612,25000,250,0,-2,4,1,3,0,0,0,1,0,1,0,0,0,2,0,2,0,0,0,0,0,0,0,0,0,0,0,0,1,1,0
184694,25000,250,0,-2,2,1,1,0,0,0,0,0,0,0,0,0,0,0,0,0,0,0,2,1,1,0,0,0,0,0,0,0,0,0
184773,25000,250,0,-2,3,1,2,0,0,0,0,0,0,0,0,0,0,0,0,0,0,0,2,1,1,1,0,1,0,0,0,0,0,0
184782,25000,250,0,-2,12,8,4,0,0,0,0,0,0,0,0,0,0,0,0,0,0,0,6,3,3,1,1,0,1,1,0,4,3,1
184791,25000,250,0,-2,5,1,4,0,0,0,0,0,0,1,0,1,0,0,0,0,0,0,4,1,3,0,0,0,0,0,0,0,0,0
184959,25000,250,0,-2,1,0,1,0,0,0,0,0,0,0,0,0,0,0,0,0,0,0,1,0,1,0,0,0,0,0,0,0,0,0
184995,25000,250,0,-2,4,0,4,0,0,0,0,0,0,2,0,2,0,0,0,0,0,0,2,0,2,0,0,0,0,0,0,0,0,0
185129,25000,250,0,-2,6,0,6,0,0,0,0,0,0,2,0,2,1,0,1,0,0,0,2,0,2,1,0,1,0,0,0,0,0,0
185509,25000,250,0,-2,7,3,4,0,0,0,0,0,0,4,1,3,1,1,0,0,0,0,2,1,1,0,0,0,0,0,0,0,0,0
185536,25000,250,0,-2,1,1,0,0,0,0,0,0,0,0,0,0,0,0,0,0,0,0,1,1,0,0,0,0,0,0,0,0,0,0
185572,25000,250,0,-2,2,0,2,0,0,0,0,0,0,0,0,0,0,0,0,0,0,0,2,0,2,0,0,0,0,0,0,0,0,0
185590,25000,250,0,-2,1,1,0,0,0,0,0,0,0,0,0,0,0,0,0,0,0,0,1,1,0,0,0,0,0,0,0,0,0,0
185828,25000,250,0,-2,5,3,2,0,0,0,2,2,0,2,1,1,0,0,0,0,0,0,0,0,0,0,0,0,1,0,1,0,0,0
185873,25000,250,0,-2,8,2,6,0,0,0,0,0,0,0,0,0,1,0,1,0,0,0,7,2,5,0,0,0,0,0,0,0,0,0
186034,25000,250,0,-2,9,3,6,0,0,0,2,0,2,3,2,1,2,1,1,0,0,0,2,0,2,0,0,0,0,0,0,0,0,0
186201,25000,250,0,-2,7,5,2,0,0,0,0,0,0,0,0,0,1,1,0,0,0,0,6,4,2,0,0,0,0,0,0,0,0,0
186371,25000,250,0,-2,11,4,7,0,0,0,0,0,0,1,0,1,1,1,0,0,0,0,3,1,2,0,0,0,6,2,4,0,0,0
186380,25000,250,0,-2,37,12,25,0,0,0,4,2,2,1,0,1,4,0,4,0,0,0,7,1,6,0,0,0,21,9,12,0,0,0
186399,25000,250,0,-2,6,0,6,0,0,0,0,0,0,0,0,0,1,0,1,0,0,0,2,0,2,0,0,0,3,0,3,0,0,0
186432,25000,250,0,-2,9,4,5,0,0,0,0,0,0,1,0,1,3,2,1,0,0,0,5,2,3,0,0,0,0,0,0,0,0,0
186469,25000,250,0,-2,1,0,1,0,0,0,0,0,0,0,0,0,0,0,0,0,0,0,1,0,1,0,0,0,0,0,0,0,0,0
186584,25000,250,0,-2,13,4,9,0,0,0,0,0,0,3,0,3,1,1,0,0,0,0,7,3,4,1,0,1,1,0,1,0,0,0
186618,25000,250,0,-2,5,1,4,0,0,0,0,0,0,3,1,2,0,0,0,0,0,0,1,0,1,0,0,0,1,0,1,0,0,0
186645,25000,250,0,-2,6,3,3,0,0,0,0,0,0,0,0,0,1,0,1,0,0,0,4,2,2,1,1,0,0,0,0,0,0,0
186867,25000,250,0,-2,9,4,5,0,0,0,1,0,1,1,0,1,0,0,0,0,0,0,6,3,3,0,0,0,1,1,0,0,0,0
186876,25000,250,0,-2,8,3,5,0,0,0,0,0,0,2,2,0,0,0,0,0,0,0,6,1,5,0,0,0,0,0,0,0,0,0
187046,25000,250,0,-2,1,1,0,0,0,0,0,0,0,0,0,0,0,0,0,0,0,0,1,1,0,0,0,0,0,0,0,0,0,0
187134,25000,250,0,-2,8,2,6,0,0,0,0,0,0,1,1,0,2,0,2,0,0,0,4,0,4,0,0,0,1,1,0,0,0,0
187198,25000,250,0,-2,32,11,21,0,0,0,0,0,0,14,3,11,7,6,1,0,0,0,8,2,6,0,0,0,3,0,3,0,0,0
187444,25000,250,0,-2,1,0,1,0,0,0,0,0,0,1,0,1,0,0,0,0,0,0,0,0,0,0,0,0,0,0,0,0,0,0
187532,25000,250,0,-2,16,6,10,0,0,0,0,0,0,0,0,0,8,1,7,0,0,0,7,5,2,0,0,0,1,0,1,0,0,0
187596,25000,250,0,-2,3,1,2,2,0,2,0,0,0,0,0,0,0,0,0,0,0,0,1,1,0,0,0,0,0,0,0,0,0,0
187639,25000,250,0,-2,18,3,15,2,0,2,1,0,1,1,1,0,4,0,4,1,0,1,9,2,7,0,0,0,0,0,0,0,0,0
187648,25000,250,0,-2,7,2,5,0,0,0,0,0,0,0,0,0,0,0,0,0,0,0,5,1,4,0,0,0,1,1,0,1,0,1
187666,25000,250,0,-2,6,2,4,1,1,0,0,0,0,0,0,0,4,1,3,0,0,0,1,0,1,0,0,0,0,0,0,0,0,0
187745,25000,250,0,-2,2,0,2,2,0,2,0,0,0,0,0,0,0,0,0,0,0,0,0,0,0,0,0,0,0,0,0,0,0,0
187897,25000,250,0,-2,7,0,7,1,0,1,0,0,0,0,0,0,0,0,0,0,0,0,4,0,4,0,0,0,2,0,2,0,0,0
187903,25000,250,0,-2,1,0,1,0,0,0,0,0,0,0,0,0,0,0,0,0,0,0,1,0,1,0,0,0,0,0,0,0,0,0
187912,25000,250,0,-2,2,2,0,0,0,0,0,0,0,0,0,0,0,0,0,0,0,0,2,2,0,0,0,0,0,0,0,0,0,0
187967,25000,250,0,-2,14,2,12,0,0,0,1,1,0,0,0,0,7,1,6,0,0,0,6,0,6,0,0,0,0,0,0,0,0,0
187985,25000,250,0,-2,29,8,21,1,0,1,1,0,1,1,0,1,13,4,9,0,0,0,9,3,6,1,0,1,3,1,2,0,0,0
188030,25000,250,0,-2,4,1,3,0,0,0,0,0,0,1,0,1,2,1,1,0,0,0,1,0,1,0,0,0,0,0,0,0,0,0
188049,25000,250,0,-2,1,1,0,0,0,0,0,0,0,0,0,0,1,1,0,0,0,0,0,0,0,0,0,0,0,0,0,0,0,0
188058,25000,250,0,-2,1,0,1,0,0,0,0,0,0,0,0,0,0,0,0,0,0,0,0,0,0,0,0,0,1,0,1,0,0,0
188100,25000,250,0,-2,2,1,1,0,0,0,0,0,0,0,0,0,0,0,0,0,0,0,2,1,1,0,0,0,0,0,0,0,0,0
188137,25000,250,0,-2,21,4,17,0,0,0,0,0,0,0,0,0,13,1,12,0,0,0,5,3,2,0,0,0,0,0,0,3,0,3
188225,25000,250,0,-2,2,1,1,0,0,0,0,0,0,0,0,0,0,0,0,0,0,0,2,1,1,0,0,0,0,0,0,0,0,0
188304,25000,250,0,-2,9,1,8,0,0,0,0,0,0,0,0,0,6,0,6,0,0,0,3,1,2,0,0,0,0,0,0,0,0,0
188340,25000,250,0,-2,5,2,3,0,0,0,1,1,0,1,0,1,1,0,1,0,0,0,2,1,1,0,0,0,0,0,0,0,0,0
188517,25000,250,0,-2,1,0,1,0,0,0,0,0,0,0,0,0,0,0,0,0,0,0,1,0,1,0,0,0,0,0,0,0,0,0
188526,25000,250,0,-2,1,0,1,0,0,0,0,0,0,0,0,0,0,0,0,0,0,0,1,0,1,0,0,0,0,0,0,0,0,0
188535,25000,250,0,-2,1,1,0,0,0,0,0,0,0,0,0,0,1,1,0,0,0,0,0,0,0,0,0,0,0,0,0,0,0,0
188641,25000,250,0,-2,8,3,5,0,0,0,0,0,0,1,0,1,0,0,0,0,0,0,7,3,4,0,0,0,0,0,0,0,0,0
189088,25000,250,0,-2,36,13,23,0,0,0,3,2,1,7,1,6,0,0,0,0,0,0,25,9,16,0,0,0,1,1,0,0,0,0
189228,25000,250,0,-2,13,5,8,0,0,0,0,0,0,4,2,2,2,0,2,0,0,0,5,1,4,2,2,0,0,0,0,0,0,0
189547,25000,250,0,-2,4,1,3,0,0,0,0,0,0,0,0,0,0,0,0,0,0,0,4,1,3,0,0,0,0,0,0,0,0,0
189565,25000,250,0,-2,2,0,2,0,0,0,0,0,0,0,0,0,0,0,0,0,0,0,2,0,2,0,0,0,0,0,0,0,0,0
189592,25000,250,0,-2,2,0,2,0,0,0,0,0,0,0,0,0,0,0,0,0,0,0,2,0,2,0,0,0,0,0,0,0,0,0
189705,25000,250,0,-2,2,0,2,0,0,0,0,0,0,0,0,0,0,0,0,0,0,0,2,0,2,0,0,0,0,0,0,0,0,0
189811,25000,250,0,-2,1,0,1,0,0,0,0,0,0,0,0,0,1,0,1,0,0,0,0,0,0,0,0,0,0,0,0,0,0,0
189848,25000,250,0,-2,1,0,1,0,0,0,0,0,0,0,0,0,0,0,0,0,0,0,1,0,1,0,0,0,0,0,0,0,0,0
190035,25000,250,0,-2,4,1,3,0,0,0,0,0,0,0,0,0,2,0,2,0,0,0,2,1,1,0,0,0,0,0,0,0,0,0
190044,25000,250,0,-2,1,0,1,0,0,0,0,0,0,0,0,0,0,0,0,0,0,0,0,0,0,0,0,0,1,0,1,0,0,0
190080,25000,250,0,-2,1,0,1,0,0,0,0,0,0,1,0,1,0,0,0,0,0,0,0,0,0,0,0,0,0,0,0,0,0,0
190099,25000,250,0,-2,4,2,2,0,0,0,0,0,0,0,0,0,0,0,0,0,0,0,4,2,2,0,0,0,0,0,0,0,0,0
190114,25000,250,0,-2,6,1,5,0,0,0,1,0,1,1,0,1,0,0,0,0,0,0,1,0,1,0,0,0,3,1,2,0,0,0
190150,25000,250,0,-2,36,10,26,0,0,0,4,0,4,6,0,6,6,2,4,0,0,0,18,7,11,0,0,0,2,1,1,0,0,0
190372,25000,250,0,-2,5,1,4,0,0,0,2,1,1,0,0,0,1,0,1,0,0,0,1,0,1,0,0,0,1,0,1,0,0,0
190415,25000,250,0,-2,22,6,16,0,0,0,1,0,1,4,1,3,3,0,3,0,0,0,13,5,8,1,0,1,0,0,0,0,0,0
190424,25000,250,0,-2,1,1,0,0,0,0,0,0,0,0,0,0,0,0,0,0,0,0,1,1,0,0,0,0,0,0,0,0,0,0
190503,25000,250,0,-2,1,1,0,0,0,0,0,0,0,0,0,0,0,0,0,0,0,0,1,1,0,0,0,0,0,0,0,0,0,0
190512,25000,250,0,-2,3,1,2,0,0,0,2,1,1,1,0,1,0,0,0,0,0,0,0,0,0,0,0,0,0,0,0,0,0,0
190521,25000,250,0,-2,6,2,4,0,0,0,0,0,0,0,0,0,4,1,3,0,0,0,2,1,1,0,0,0,0,0,0,0,0,0
190567,25000,250,0,-2,4,3,1,0,0,0,0,0,0,0,0,0,0,0,0,0,0,0,4,3,1,0,0,0,0,0,0,0,0,0
190576,25000,250,0,-2,5,2,3,0,0,0,1,0,1,0,0,0,3,1,2,0,0,0,1,1,0,0,0,0,0,0,0,0,0,0
190585,25000,250,0,-2,3,0,3,0,0,0,1,0,1,1,0,1,1,0,1,0,0,0,0,0,0,0,0,0,0,0,0,0,0,0
190600,25000,250,0,-2,4,1,3,0,0,0,0,0,0,0,0,0,2,0,2,0,0,0,2,1,1,0,0,0,0,0,0,0,0,0
190619,25000,250,0,-2,1,0,1,0,0,0,0,0,0,0,0,0,1,0,1,0,0,0,0,0,0,0,0,0,0,0,0,0,0,0
190628,25000,250,0,-2,1,1,0,0,0,0,0,0,0,0,0,0,0,0,0,0,0,0,1,1,0,0,0,0,0,0,0,0,0,0
190655,25000,250,0,-2,3,0,3,0,0,0,1,0,1,0,0,0,1,0,1,0,0,0,1,0,1,0,0,0,0,0,0,0,0,0
190664,25000,250,0,-2,3,1,2,0,0,0,0,0,0,2,1,1,0,0,0,0,0,0,1,0,1,0,0,0,0,0,0,0,0,0
190673,25000,250,0,-2,4,1,3,0,0,0,1,1,0,0,0,0,1,0,1,0,0,0,2,0,2,0,0,0,0,0,0,0,0,0
190691,25000,250,0,-2,2,0,2,0,0,0,0,0,0,2,0,2,0,0,0,0,0,0,0,0,0,0,0,0,0,0,0,0,0,0
190761,25000,250,0,-2,1,0,1,0,0,0,0,0,0,0,0,0,0,0,0,0,0,0,1,0,1,0,0,0,0,0,0,0,0,0
190983,25000,250,0,-2,1,1,0,0,0,0,0,0,0,0,0,0,0,0,0,0,0,0,1,1,0,0,0,0,0,0,0,0,0,0
191083,25000,250,0,-2,4,3,1,0,0,0,0,0,0,0,0,0,0,0,0,0,0,0,4,3,1,0,0,0,0,0,0,0,0,0
191126,25000,250,0,-2,1,0,1,0,0,0,0,0,0,1,0,1,0,0,0,0,0,0,0,0,0,0,0,0,0,0,0,0,0,0
191199,25000,250,0,-2,1,0,1,0,0,0,0,0,0,0,0,0,0,0,0,0,0,0,0,0,0,0,0,0,1,0,1,0,0,0
191205,25000,250,0,-2,5,3,2,0,0,0,0,0,0,2,2,0,0,0,0,0,0,0,3,1,2,0,0,0,0,0,0,0,0,0
191241,25000,250,0,-2,2,1,1,0,0,0,0,0,0,0,0,0,0,0,0,0,0,0,2,1,1,0,0,0,0,0,0,0,0,0
191302,25000,250,0,-2,4,0,4,0,0,0,0,0,0,0,0,0,0,0,0,0,0,0,4,0,4,0,0,0,0,0,0,0,0,0
191339,25000,250,0,-2,7,1,6,0,0,0,0,0,0,0,0,0,0,0,0,0,0,0,6,1,5,1,0,1,0,0,0,0,0,0
191515,25000,250,0,-2,6,2,4,0,0,0,1,0,1,1,1,0,0,0,0,0,0,0,4,1,3,0,0,0,0,0,0,0,0,0
191533,25000,250,0,-2,9,4,5,0,0,0,0,0,0,1,0,1,0,0,0,0,0,0,8,4,4,0,0,0,0,0,0,0,0,0
191612,25000,250,0,-2,1,0,1,0,0,0,0,0,0,0,0,0,0,0,0,0,0,0,1,0,1,0,0,0,0,0,0,0,0,0
191621,25000,250,0,-2,1,0,1,0,0,0,0,0,0,0,0,0,0,0,0,0,0,0,1,0,1,0,0,0,0,0,0,0,0,0
191630,25000,250,0,-2,7,4,3,0,0,0,0,0,0,0,0,0,1,1,0,0,0,0,6,3,3,0,0,0,0,0,0,0,0,0
191649,25000,250,0,-2,16,5,11,0,0,0,1,0,1,2,1,1,3,1,2,0,0,0,10,3,7,0,0,0,0,0,0,0,0,0
191676,25000,250,0,-2,1,1,0,0,0,0,0,0,0,0,0,0,0,0,0,0,0,0,1,1,0,0,0,0,0,0,0,0,0,0
191931,25000,250,0,-2,8,1,7,0,0,0,0,0,0,1,1,0,0,0,0,0,0,0,7,0,7,0,0,0,0,0,0,0,0,0
192022,25000,250,0,-2,4,2,2,0,0,0,0,0,0,0,0,0,0,0,0,0,0,0,3,2,1,0,0,0,1,0,1,0,0,0
192040,25000,250,0,-2,4,0,4,0,0,0,0,0,0,0,0,0,0,0,0,0,0,0,4,0,4,0,0,0,0,0,0,0,0,0
192110,25000,250,0,-2,3,1,2,0,0,0,0,0,0,0,0,0,0,0,0,0,0,0,3,1,2,0,0,0,0,0,0,0,0,0
192192,25000,250,0,-2,1,0,1,0,0,0,0,0,0,0,0,0,0,0,0,0,0,0,1,0,1,0,0,0,0,0,0,0,0,0
192271,25000,250,0,-2,4,1,3,0,0,0,1,1,0,1,0,1,1,0,1,0,0,0,1,0,1,0,0,0,0,0,0,0,0,0
192323,25000,250,0,-2,1,0,1,0,0,0,0,0,0,0,0,0,0,0,0,0,0,0,0,0,0,0,0,0,1,0,1,0,0,0
192509,25000,250,0,-2,7,1,6,0,0,0,4,0,4,0,0,0,3,1,2,0,0,0,0,0,0,0,0,0,0,0,0,0,0,0
192688,25000,250,0,-2,2,0,2,0,0,0,0,0,0,0,0,0,1,0,1,0,0,0,1,0,1,0,0,0,0,0,0,0,0,0
192712,25000,250,0,-2,5,3,2,0,0,0,1,1,0,2,2,0,0,0,0,0,0,0,2,0,2,0,0,0,0,0,0,0,0,0
192785,25000,250,0,-2,5,0,5,0,0,0,0,0,0,0,0,0,0,0,0,0,0,0,5,0,5,0,0,0,0,0,0,0,0,0
192819,25000,250,0,-2,1,0,1,0,0,0,0,0,0,0,0,0,0,0,0,0,0,0,1,0,1,0,0,0,0,0,0,0,0,0
192864,25000,250,0,-2,1,0,1,0,0,0,0,0,0,0,0,0,0,0,0,0,0,0,1,0,1,0,0,0,0,0,0,0,0,0
192925,25000,250,0,-2,16,5,11,0,0,0,0,0,0,3,1,2,1,0,1,0,0,0,11,3,8,1,1,0,0,0,0,0,0,0
193283,25000,250,0,-2,5,3,2,0,0,0,0,0,0,1,0,1,0,0,0,0,0,0,4,3,1,0,0,0,0,0,0,0,0,0
193292,25000,250,0,-2,3,1,2,0,0,0,0,0,0,2,1,1,0,0,0,0,0,0,1,0,1,0,0,0,0,0,0,0,0,0
193353,25000,250,0,-2,2,1,1,0,0,0,0,0,0,0,0,0,0,0,0,0,0,0,2,1,1,0,0,0,0,0,0,0,0,0
193399,25000,250,0,-2,10,1,9,0,0,0,0,0,0,2,0,2,4,0,4,0,0,0,4,1,3,0,0,0,0,0,0,0,0,0
193478,25000,250,0,-2,1,1,0,0,0,0,0,0,0,0,0,0,0,0,0,0,0,0,1,1,0,0,0,0,0,0,0,0,0,0
193584,25000,250,0,-2,1,0,1,0,0,0,0,0,0,0,0,0,0,0,0,0,0,0,1,0,1,0,0,0,0,0,0,0,0,0
193654,25000,250,0,-2,4,0,4,0,0,0,0,0,0,1,0,1,1,0,1,0,0,0,2,0,2,0,0,0,0,0,0,0,0,0
193751,25000,250,0,-2,6,2,4,0,0,0,0,0,0,0,0,0,0,0,0,0,0,0,6,2,4,0,0,0,0,0,0,0,0,0
193821,25000,250,0,-2,5,1,4,0,0,0,0,0,0,1,0,1,0,0,0,0,0,0,4,1,3,0,0,0,0,0,0,0,0,0
193894,25000,250,0,-2,2,1,1,0,0,0,0,0,0,1,0,1,0,0,0,0,0,0,1,1,0,0,0,0,0,0,0,0,0,0
193900,25000,250,0,-2,106,34,72,1,1,0,15,6,9,26,6,20,11,2,9,0,0,0,44,14,30,3,0,3,6,5,1,0,0,0
193946,25000,250,0,-2,2,2,0,0,0,0,0,0,0,0,0,0,0,0,0,0,0,0,2,2,0,0,0,0,0,0,0,0,0,0
194091,25000,250,0,-2,4,1,3,0,0,0,1,0,1,0,0,0,0,0,0,0,0,0,3,1,2,0,0,0,0,0,0,0,0,0
194116,25000,250,0,-2,2,0,2,0,0,0,0,0,0,0,0,0,1,0,1,0,0,0,1,0,1,0,0,0,0,0,0,0,0,0
194222,25000,250,0,-2,8,2,6,1,0,1,0,0,0,3,2,1,0,0,0,0,0,0,4,0,4,0,0,0,0,0,0,0,0,0
194310,25000,250,0,-2,3,3,0,0,0,0,0,0,0,0,0,0,1,1,0,0,0,0,2,2,0,0,0,0,0,0,0,0,0,0
194392,25000,250,0,-2,4,2,2,0,0,0,0,0,0,0,0,0,0,0,0,0,0,0,4,2,2,0,0,0,0,0,0,0,0,0
194578,25000,250,0,-2,7,2,5,0,0,0,0,0,0,1,1,0,1,0,1,0,0,0,4,1,3,0,0,0,1,0,1,0,0,0
194824,25000,250,0,-2,8,4,4,0,0,0,0,0,0,2,2,0,0,0,0,0,0,0,6,2,4,0,0,0,0,0,0,0,0,0
194958,25000,250,0,-2,2,0,2,0,0,0,0,0,0,0,0,0,0,0,0,0,0,0,2,0,2,0,0,0,0,0,0,0,0,0
195003,25000,250,0,-2,1,1,0,0,0,0,0,0,0,0,0,0,0,0,0,0,0,0,1,1,0,0,0,0,0,0,0,0,0,0
195030,25000,250,0,-2,26,6,20,0,0,0,1,0,1,3,0,3,8,3,5,0,0,0,13,2,11,1,1,0,0,0,0,0,0,0
195049,25000,250,0,-2,5,2,3,0,0,0,0,0,0,0,0,0,1,0,1,0,0,0,4,2,2,0,0,0,0,0,0,0,0,0
195058,25000,250,0,-2,5,1,4,0,0,0,1,0,1,1,0,1,1,1,0,0,0,0,2,0,2,0,0,0,0,0,0,0,0,0
195128,25000,250,0,-2,13,1,12,0,0,0,0,0,0,1,0,1,3,0,3,0,0,0,9,1,8,0,0,0,0,0,0,0,0,0
195164,25000,250,0,-2,1,0,1,0,0,0,0,0,0,0,0,0,0,0,0,0,0,0,1,0,1,0,0,0,0,0,0,0,0,0
195173,25000,250,0,-2,7,3,4,0,0,0,1,1,0,1,0,1,1,1,0,0,0,0,2,0,2,2,1,1,0,0,0,0,0,0
195216,25000,250,0,-2,14,4,10,0,0,0,0,0,0,0,0,0,2,2,0,0,0,0,12,2,10,0,0,0,0,0,0,0,0,0
195234,25000,250,0,-2,2,1,1,0,0,0,0,0,0,1,1,0,0,0,0,0,0,0,1,0,1,0,0,0,0,0,0,0,0,0
195322,25000,250,0,-2,4,1,3,0,0,0,0,0,0,0,0,0,1,0,1,0,0,0,3,1,2,0,0,0,0,0,0,0,0,0
195474,25000,250,0,-2,4,2,2,0,0,0,0,0,0,0,0,0,0,0,0,0,0,0,4,2,2,0,0,0,0,0,0,0,0,0
195526,25000,250,0,-2,3,1,2,0,0,0,0,0,0,0,0,0,0,0,0,0,0,0,2,0,2,0,0,0,0,0,0,1,1,0
195720,25000,250,0,-2,5,1,4,0,0,0,1,0,1,0,0,0,1,0,1,0,0,0,3,1,2,0,0,0,0,0,0,0,0,0
195809,25000,250,0,-2,11,5,6,0,0,0,0,0,0,4,2,2,2,1,1,0,0,0,5,2,3,0,0,0,0,0,0,0,0,0
195988,25000,250,0,-2,1,0,1,0,0,0,0,0,0,0,0,0,0,0,0,0,0,0,1,0,1,0,0,0,0,0,0,0,0,0
196006,25000,250,0,-2,2,2,0,0,0,0,0,0,0,0,0,0,1,1,0,0,0,0,1,1,0,0,0,0,0,0,0,0,0,0
196015,25000,250,0,-2,4,0,4,0,0,0,0,0,0,0,0,0,0,0,0,0,0,0,4,0,4,0,0,0,0,0,0,0,0,0
196024,25000,250,0,-2,4,2,2,0,0,0,0,0,0,0,0,0,1,1,0,0,0,0,2,0,2,1,1,0,0,0,0,0,0,0
196033,25000,250,0,-2,1,0,1,0,0,0,0,0,0,0,0,0,0,0,0,0,0,0,1,0,1,0,0,0,0,0,0,0,0,0
196060,25000,250,0,-2,5,1,4,0,0,0,1,0,1,0,0,0,0,0,0,0,0,0,4,1,3,0,0,0,0,0,0,0,0,0
196079,25000,250,0,-2,5,3,2,0,0,0,0,0,0,2,1,1,0,0,0,0,0,0,3,2,1,0,0,0,0,0,0,0,0,0
196088,25000,250,0,-2,8,0,8,0,0,0,1,0,1,3,0,3,1,0,1,0,0,0,2,0,2,0,0,0,0,0,0,1,0,1
196097,25000,250,0,-2,11,4,7,0,0,0,0,0,0,0,0,0,1,0,1,0,0,0,9,3,6,0,0,0,1,1,0,0,0,0
196121,25000,250,0,-2,1,0,1,0,0,0,0,0,0,0,0,0,0,0,0,0,0,0,1,0,1,0,0,0,0,0,0,0,0,0
196130,25000,250,0,-2,2,1,1,0,0,0,0,0,0,2,1,1,0,0,0,0,0,0,0,0,0,0,0,0,0,0,0,0,0,0
196167,25000,250,0,-2,1,1,0,0,0,0,0,0,0,0,0,0,0,0,0,0,0,0,1,1,0,0,0,0,0,0,0,0,0,0
196176,25000,250,0,-2,1,0,1,0,0,0,0,0,0,0,0,0,0,0,0,0,0,0,1,0,1,0,0,0,0,0,0,0,0,0
196185,25000,250,0,-2,6,0,6,0,0,0,0,0,0,0,0,0,2,0,2,0,0,0,4,0,4,0,0,0,0,0,0,0,0,0
196194,25000,250,0,-2,1,1,0,0,0,0,0,0,0,0,0,0,0,0,0,0,0,0,1,1,0,0,0,0,0,0,0,0,0,0
196219,25000,250,0,-2,5,3,2,0,0,0,0,0,0,0,0,0,3,1,2,0,0,0,2,2,0,0,0,0,0,0,0,0,0,0
196264,25000,250,0,-2,2,0,2,0,0,0,0,0,0,1,0,1,0,0,0,0,0,0,1,0,1,0,0,0,0,0,0,0,0,0
196307,25000,250,0,-2,2,0,2,0,0,0,0,0,0,0,0,0,0,0,0,0,0,0,2,0,2,0,0,0,0,0,0,0,0,0
196413,25000,250,0,-2,4,2,2,0,0,0,0,0,0,0,0,0,0,0,0,0,0,0,1,1,0,1,1,0,2,0,2,0,0,0
196468,25000,250,0,-2,51,5,46,0,0,0,8,1,7,9,0,9,4,0,4,0,0,0,18,3,15,4,1,3,0,0,0,8,0,8
196592,25000,250,0,-2,9,1,8,1,0,1,1,0,1,0,0,0,0,0,0,0,0,0,5,1,4,0,0,0,2,0,2,0,0,0
196653,25000,250,0,-2,4,2,2,0,0,0,0,0,0,2,2,0,0,0,0,0,0,0,2,0,2,0,0,0,0,0,0,0,0,0
196680,25000,250,0,-2,14,3,11,0,0,0,0,0,0,2,1,1,1,0,1,1,0,1,10,2,8,0,0,0,0,0,0,0,0,0
196699,25000,250,0,-2,2,0,2,0,0,0,0,0,0,1,0,1,0,0,0,0,0,0,1,0,1,0,0,0,0,0,0,0,0,0
197027,25000,250,0,-2,3,2,1,0,0,0,0,0,0,0,0,0,0,0,0,0,0,0,3,2,1,0,0,0,0,0,0,0,0,0
197036,25000,250,0,-2,12,8,4,0,0,0,1,1,0,0,0,0,0,0,0,0,0,0,11,7,4,0,0,0,0,0,0,0,0,0
197045,25000,250,0,-2,14,3,11,0,0,0,1,0,1,1,1,0,0,0,0,0,0,0,12,2,10,0,0,0,0,0,0,0,0,0
197133,25000,250,0,-2,10,3,7,0,0,0,2,0,2,0,0,0,0,0,0,0,0,0,5,2,3,1,0,1,1,1,0,1,0,1
197142,25000,250,0,-2,3,1,2,0,0,0,0,0,0,0,0,0,0,0,0,0,0,0,3,1,2,0,0,0,0,0,0,0,0,0
197197,25000,250,0,-2,6,3,3,0,0,0,0,0,0,1,0,1,0,0,0,0,0,0,5,3,2,0,0,0,0,0,0,0,0,0
197230,25000,250,0,-2,4,3,1,0,0,0,0,0,0,1,1,0,1,1,0,0,0,0,2,1,1,0,0,0,0,0,0,0,0,0
197285,25000,250,0,-2,4,2,2,0,0,0,0,0,0,0,0,0,3,2,1,0,0,0,1,0,1,0,0,0,0,0,0,0,0,0
197708,25000,250,0,-2,13,6,7,0,0,0,0,0,0,1,0,1,0,0,0,0,0,0,12,6,6,0,0,0,0,0,0,0,0,0
197814,25000,250,0,-2,1,0,1,0,0,0,0,0,0,0,0,0,0,0,0,0,0,0,1,0,1,0,0,0,0,0,0,0,0,0
197850,25000,250,0,-2,2,0,2,0,0,0,0,0,0,2,0,2,0,0,0,0,0,0,0,0,0,0,0,0,0,0,0,0,0,0
197869,25000,250,0,-2,26,8,18,0,0,0,1,0,1,1,0,1,1,0,1,0,0,0,21,6,15,1,1,0,1,1,0,0,0,0
197887,25000,250,0,-2,2,1,1,0,0,0,0,0,0,0,0,0,0,0,0,0,0,0,2,1,1,0,0,0,0,0,0,0,0,0
197911,25000,250,0,-2,1,0,1,0,0,0,0,0,0,0,0,0,0,0,0,0,0,0,1,0,1,0,0,0,0,0,0,0,0,0
197984,25000,250,0,-2,7,1,6,0,0,0,0,0,0,0,0,0,0,0,0,0,0,0,7,1,6,0,0,0,0,0,0,0,0,0
197993,25000,250,0,-2,1,0,1,0,0,0,0,0,0,0,0,0,1,0,1,0,0,0,0,0,0,0,0,0,0,0,0,0,0,0
198039,25000,250,0,-2,4,1,3,0,0,0,0,0,0,0,0,0,0,0,0,0,0,0,4,1,3,0,0,0,0,0,0,0,0,0
198084,25000,250,0,-2,4,0,4,0,0,0,0,0,0,0,0,0,0,0,0,0,0,0,3,0,3,0,0,0,1,0,1,0,0,0
198109,25000,250,0,-2,3,1,2,0,0,0,0,0,0,2,1,1,0,0,0,0,0,0,1,0,1,0,0,0,0,0,0,0,0,0
198136,25000,250,0,-2,7,2,5,0,0,0,0,0,0,0,0,0,0,0,0,0,0,0,7,2,5,0,0,0,0,0,0,0,0,0
198154,25000,250,0,-2,7,3,4,0,0,0,0,0,0,0,0,0,0,0,0,0,0,0,7,3,4,0,0,0,0,0,0,0,0,0
198215,25000,250,0,-2,2,1,1,0,0,0,0,0,0,2,1,1,0,0,0,0,0,0,0,0,0,0,0,0,0,0,0,0,0,0
198251,25000,250,0,-2,1,0,1,0,0,0,0,0,0,0,0,0,0,0,0,0,0,0,1,0,1,0,0,0,0,0,0,0,0,0
198260,25000,250,0,-2,13,4,9,0,0,0,0,0,0,4,2,2,1,0,1,0,0,0,8,2,6,0,0,0,0,0,0,0,0,0
198303,25000,250,0,-2,5,2,3,0,0,0,0,0,0,3,2,1,0,0,0,0,0,0,1,0,1,0,0,0,1,0,1,0,0,0
198321,25000,250,0,-2,2,0,2,0,0,0,0,0,0,0,0,0,0,0,0,0,0,0,2,0,2,0,0,0,0,0,0,0,0,0
198330,25000,250,0,-2,2,1,1,0,0,0,0,0,0,1,0,1,0,0,0,0,0,0,1,1,0,0,0,0,0,0,0,0,0,0
198367,25000,250,0,-2,1,1,0,0,0,0,0,0,0,1,1,0,0,0,0,0,0,0,0,0,0,0,0,0,0,0,0,0,0,0
198376,25000,250,0,-2,8,5,3,0,0,0,0,0,0,2,2,0,0,0,0,0,0,0,5,3,2,0,0,0,1,0,1,0,0,0
198385,25000,250,0,-2,4,1,3,0,0,0,0,0,0,0,0,0,0,0,0,0,0,0,3,0,3,0,0,0,0,0,0,1,1,0
198419,25000,250,0,-2,47,16,31,0,0,0,2,0,2,17,4,13,6,2,4,0,0,0,19,7,12,2,2,0,0,0,0,1,1,0
198464,25000,250,0,-2,14,2,12,0,0,0,0,0,0,3,0,3,2,0,2,0,0,0,9,2,7,0,0,0,0,0,0,0,0,0
198507,25000,250,0,-2,2,1,1,0,0,0,0,0,0,1,0,1,0,0,0,0,0,0,1,1,0,0,0,0,0,0,0,0,0,0
198516,25000,250,0,-2,18,8,10,0,0,0,0,0,0,2,0,2,0,0,0,0,0,0,14,7,7,0,0,0,1,1,0,1,0,1
198534,25000,250,0,-2,7,2,5,0,0,0,0,0,0,3,0,3,1,1,0,0,0,0,3,1,2,0,0,0,0,0,0,0,0,0
198543,25000,250,0,-2,11,4,7,0,0,0,0,0,0,7,3,4,1,0,1,0,0,0,3,1,2,0,0,0,0,0,0,0,0,0
198570,25000,250,0,-2,14,5,9,0,0,0,0,0,0,4,2,2,0,0,0,0,0,0,10,3,7,0,0,0,0,0,0,0,0,0
198598,25000,250,0,-2,3,1,2,0,0,0,0,0,0,2,0,2,0,0,0,0,0,0,1,1,0,0,0,0,0,0,0,0,0,0
198613,25000,250,0,-2,13,5,8,0,0,0,0,0,0,2,1,1,1,1,0,0,0,0,10,3,7,0,0,0,0,0,0,0,0,0
198622,25000,250,0,-2,4,2,2,0,0,0,0,0,0,2,0,2,0,0,0,0,0,0,2,2,0,0,0,0,0,0,0,0,0,0
198695,25000,250,0,-2,11,2,9,0,0,0,0,0,0,3,1,2,0,0,0,0,0,0,7,1,6,1,0,1,0,0,0,0,0,0
198710,25000,250,0,-2,1,0,1,0,0,0,0,0,0,0,0,0,0,0,0,0,0,0,1,0,1,0,0,0,0,0,0,0,0,0
198729,25000,250,0,-2,1,0,1,0,0,0,0,0,0,1,0,1,0,0,0,0,0,0,0,0,0,0,0,0,0,0,0,0,0,0
198756,25000,250,0,-2,1,0,1,0,0,0,0,0,0,1,0,1,0,0,0,0,0,0,0,0,0,0,0,0,0,0,0,0,0,0
198774,25000,250,0,-2,3,0,3,0,0,0,0,0,0,1,0,1,0,0,0,0,0,0,1,0,1,0,0,0,1,0,1,0,0,0
198808,25000,250,0,-2,4,1,3,0,0,0,0,0,0,0,0,0,0,0,0,0,0,0,4,1,3,0,0,0,0,0,0,0,0,0
198835,25000,250,0,-2,4,1,3,0,0,0,0,0,0,1,1,0,0,0,0,0,0,0,3,0,3,0,0,0,0,0,0,0,0,0
198862,25000,250,0,-2,2,0,2,0,0,0,0,0,0,1,0,1,0,0,0,0,0,0,1,0,1,0,0,0,0,0,0,0,0,0
198871,25000,250,0,-2,2,1,1,0,0,0,0,0,0,1,0,1,0,0,0,0,0,0,1,1,0,0,0,0,0,0,0,0,0,0
198899,25000,250,0,-2,3,2,1,0,0,0,0,0,0,0,0,0,0,0,0,0,0,0,3,2,1,0,0,0,0,0,0,0,0,0
198950,25000,250,0,-2,1,1,0,0,0,0,0,0,0,0,0,0,0,0,0,0,0,0,1,1,0,0,0,0,0,0,0,0,0,0
198978,25000,250,0,-2,3,1,2,0,0,0,0,0,0,1,0,1,1,0,1,0,0,0,1,1,0,0,0,0,0,0,0,0,0,0
199032,25000,250,0,-2,10,1,9,0,0,0,0,0,0,2,1,1,0,0,0,0,0,0,8,0,8,0,0,0,0,0,0,0,0,0
199069,25000,250,0,-2,3,0,3,0,0,0,0,0,0,0,0,0,0,0,0,0,0,0,3,0,3,0,0,0,0,0,0,0,0,0
199087,25000,250,0,-2,1,1,0,0,0,0,0,0,0,1,1,0,0,0,0,0,0,0,0,0,0,0,0,0,0,0,0,0,0,0
199102,25000,250,0,-2,3,2,1,0,0,0,0,0,0,0,0,0,0,0,0,0,0,0,2,2,0,0,0,0,1,0,1,0,0,0
199111,25000,250,0,-2,2,2,0,0,0,0,0,0,0,0,0,0,0,0,0,0,0,0,2,2,0,0,0,0,0,0,0,0,0,0
199120,25000,250,0,-2,38,12,26,1,0,1,2,1,1,11,3,8,0,0,0,0,0,0,22,7,15,1,0,1,1,1,0,0,0,0
199139,25000,250,0,-2,20,5,15,0,0,0,0,0,0,4,1,3,1,0,1,0,0,0,14,3,11,0,0,0,0,0,0,1,1,0
199148,25000,250,0,-2,32,11,21,0,0,0,0,0,0,12,4,8,4,1,3,0,0,0,14,5,9,1,1,0,1,0,1,0,0,0
199157,25000,250,0,-2,9,4,5,0,0,0,0,0,0,4,3,1,0,0,0,0,0,0,1,0,1,0,0,0,4,1,3,0,0,0
199175,25000,250,0,-2,2,1,1,0,0,0,0,0,0,1,1,0,0,0,0,0,0,0,1,0,1,0,0,0,0,0,0,0,0,0
199184,25000,250,0,-2,1,0,1,0,0,0,0,0,0,0,0,0,0,0,0,0,0,0,1,0,1,0,0,0,0,0,0,0,0,0
199193,25000,250,0,-2,100,37,63,1,1,0,2,1,1,19,5,14,5,1,4,0,0,0,66,25,41,4,3,1,2,0,2,1,1,0
199209,25000,250,0,-2,9,4,5,0,0,0,0,0,0,5,3,2,0,0,0,0,0,0,4,1,3,0,0,0,0,0,0,0,0,0
199218,25000,250,0,-2,20,5,15,0,0,0,0,0,0,4,2,2,3,1,2,0,0,0,12,2,10,1,0,1,0,0,0,0,0,0
199272,25000,250,0,-2,6,1,5,0,0,0,0,0,0,3,1,2,0,0,0,0,0,0,2,0,2,0,0,0,1,0,1,0,0,0
199281,25000,250,0,-2,4,0,4,1,0,1,0,0,0,0,0,0,0,0,0,0,0,0,3,0,3,0,0,0,0,0,0,0,0,0
199306,25000,250,0,-2,1,0,1,0,0,0,0,0,0,0,0,0,0,0,0,0,0,0,1,0,1,0,0,0,0,0,0,0,0,0
199333,25000,250,0,-2,1,0,1,0,0,0,0,0,0,0,0,0,0,0,0,0,0,0,1,0,1,0,0,0,0,0,0,0,0,0
199412,25000,250,0,-2,14,4,10,1,0,1,1,0,1,2,1,1,2,0,2,0,0,0,8,3,5,0,0,0,0,0,0,0,0,0
199449,25000,250,0,-2,4,2,2,0,0,0,0,0,0,2,1,1,1,0,1,0,0,0,1,1,0,0,0,0,0,0,0,0,0,0
199458,25000,250,0,-2,4,3,1,0,0,0,0,0,0,1,1,0,0,0,0,0,0,0,3,2,1,0,0,0,0,0,0,0,0,0
199476,25000,250,0,-2,1,0,1,0,0,0,0,0,0,0,0,0,0,0,0,0,0,0,1,0,1,0,0,0,0,0,0,0,0,0
199485,25000,250,0,-2,1,1,0,0,0,0,0,0,0,0,0,0,0,0,0,0,0,0,1,1,0,0,0,0,0,0,0,0,0,0
199494,25000,250,0,-2,3,1,2,0,0,0,0,0,0,0,0,0,0,0,0,0,0,0,3,1,2,0,0,0,0,0,0,0,0,0
199607,25000,250,0,-2,3,1,2,0,0,0,0,0,0,0,0,0,1,0,1,0,0,0,2,1,1,0,0,0,0,0,0,0,0,0
199643,25000,250,0,-2,5,1,4,0,0,0,0,0,0,5,1,4,0,0,0,0,0,0,0,0,0,0,0,0,0,0,0,0,0,0
199722,25000,250,0,-2,4,3,1,0,0,0,0,0,0,0,0,0,0,0,0,0,0,0,4,3,1,0,0,0,0,0,0,0,0,0
199731,25000,250,0,-2,2,0,2,0,0,0,0,0,0,0,0,0,0,0,0,0,0,0,2,0,2,0,0,0,0,0,0,0,0,0
199759,25000,250,0,-2,8,7,1,0,0,0,0,0,0,0,0,0,0,0,0,0,0,0,8,7,1,0,0,0,0,0,0,0,0,0
199786,25000,250,0,-2,1,1,0,0,0,0,0,0,0,0,0,0,0,0,0,0,0,0,1,1,0,0,0,0,0,0,0,0,0,0
199795,25000,250,0,-2,3,0,3,0,0,0,0,0,0,0,0,0,0,0,0,0,0,0,3,0,3,0,0,0,0,0,0,0,0,0
199838,25000,250,0,-2,4,2,2,1,0,1,0,0,0,0,0,0,0,0,0,0,0,0,3,2,1,0,0,0,0,0,0,0,0,0
199847,25000,250,0,-2,24,10,14,0,0,0,1,0,1,5,2,3,1,0,1,0,0,0,16,7,9,0,0,0,0,0,0,1,1,0
199856,25000,250,0,-2,21,11,10,0,0,0,0,0,0,6,2,4,1,0,1,0,0,0,8,5,3,0,0,0,6,4,2,0,0,0
199908,25000,250,0,-2,1,1,0,0,0,0,0,0,0,0,0,0,0,0,0,0,0,0,1,1,0,0,0,0,0,0,0,0,0,0
199926,25000,250,0,-2,1,0,1,0,0,0,0,0,0,0,0,0,0,0,0,0,0,0,1,0,1,0,0,0,0,0,0,0,0,0
199953,25000,250,0,-2,4,1,3,0,0,0,0,0,0,2,1,1,0,0,0,0,0,0,2,0,2,0,0,0,0,0,0,0,0,0
199962,25000,250,0,-2,13,1,12,0,0,0,0,0,0,3,0,3,1,0,1,0,0,0,9,1,8,0,0,0,0,0,0,0,0,0
199999,25000,250,0,-2,6,2,4,0,0,0,0,0,0,6,2,4,0,0,0,0,0,0,0,0,0,0,0,0,0,0,0,0,0,0
200004,25000,250,0,-2,10,4,6,0,0,0,0,0,0,1,1,0,0,0,0,0,0,0,9,3,6,0,0,0,0,0,0,0,0,0
200022,25000,250,0,-2,5,2,3,0,0,0,0,0,0,0,0,0,0,0,0,0,0,0,5,2,3,0,0,0,0,0,0,0,0,0
200059,25000,250,0,-2,2,0,2,0,0,0,0,0,0,0,0,0,0,0,0,0,0,0,2,0,2,0,0,0,0,0,0,0,0,0
200192,25000,250,0,-2,2,0,2,0,0,0,0,0,0,0,0,0,0,0,0,0,0,0,2,0,2,0,0,0,0,0,0,0,0,0
200226,25000,250,0,-2,13,0,13,0,0,0,0,0,0,0,0,0,1,0,1,0,0,0,9,0,9,2,0,2,1,0,1,0,0,0
200253,25000,250,0,-2,4,1,3,0,0,0,0,0,0,0,0,0,0,0,0,0,0,0,4,1,3,0,0,0,0,0,0,0,0,0
200280,25000,250,0,-2,16,3,13,0,0,0,0,0,0,0,0,0,0,0,0,0,0,0,14,2,12,2,1,1,0,0,0,0,0,0
200332,25000,250,0,-2,11,4,7,1,1,0,0,0,0,0,0,0,0,0,0,0,0,0,7,2,5,0,0,0,2,0,2,1,1,0
200341,25000,250,0,-2,1,1,0,0,0,0,0,0,0,0,0,0,0,0,0,0,0,0,1,1,0,0,0,0,0,0,0,0,0,0
200466,25000,250,0,-2,1,0,1,0,0,0,0,0,0,1,0,1,0,0,0,0,0,0,0,0,0,0,0,0,0,0,0,0,0,0
200527,25000,250,0,-2,1,1,0,1,1,0,0,0,0,0,0,0,0,0,0,0,0,0,0,0,0,0,0,0,0,0,0,0,0,0
200590,25000,250,0,-2,1,0,1,0,0,0,0,0,0,0,0,0,0,0,0,0,0,0,1,0,1,0,0,0,0,0,0,0,0,0
200785,25000,250,0,-2,1,0,1,0,0,0,0,0,0,1,0,1,0,0,0,0,0,0,0,0,0,0,0,0,0,0,0,0,0,0
200800,25000,250,0,-2,21,8,13,0,0,0,0,0,0,2,0,2,1,1,0,0,0,0,17,7,10,0,0,0,0,0,0,1,0,1
201061,25000,250,0,-2,1,0,1,0,0,0,0,0,0,0,0,0,0,0,0,0,0,0,1,0,1,0,0,0,0,0,0,0,0,0
201104,25000,250,0,-2,43,22,21,0,0,0,0,0,0,7,3,4,3,3,0,0,0,0,33,16,17,0,0,0,0,0,0,0,0,0
201177,25000,250,0,-2,1,1,0,0,0,0,0,0,0,0,0,0,0,0,0,0,0,0,1,1,0,0,0,0,0,0,0,0,0,0
201195,25000,250,0,-2,13,2,11,0,0,0,0,0,0,1,0,1,1,1,0,0,0,0,11,1,10,0,0,0,0,0,0,0,0,0
201548,25000,250,0,-2,11,2,9,0,0,0,0,0,0,3,0,3,0,0,0,0,0,0,7,1,6,1,1,0,0,0,0,0,0,0
201645,25000,250,0,-2,17,6,11,0,0,0,2,0,2,3,1,2,1,1,0,1,1,0,9,3,6,0,0,0,1,0,1,0,0,0
201654,25000,250,0,-2,2,0,2,0,0,0,0,0,0,0,0,0,0,0,0,0,0,0,2,0,2,0,0,0,0,0,0,0,0,0
201690,25000,250,0,-2,32,12,20,0,0,0,3,0,3,14,5,9,1,1,0,0,0,0,13,5,8,0,0,0,1,1,0,0,0,0
201751,25000,250,0,-2,2,0,2,0,0,0,0,0,0,0,0,0,0,0,0,0,0,0,2,0,2,0,0,0,0,0,0,0,0,0
201821,25000,250,0,-2,4,2,2,0,0,0,0,0,0,0,0,0,0,0,0,0,0,0,4,2,2,0,0,0,0,0,0,0,0,0
201885,25000,250,0,-2,12,4,8,0,0,0,0,0,0,2,2,0,1,1,0,0,0,0,8,1,7,0,0,0,1,0,1,0,0,0
201928,25000,250,0,-2,3,1,2,0,0,0,2,1,1,0,0,0,0,0,0,0,0,0,1,0,1,0,0,0,0,0,0,0,0,0
201955,25000,250,0,-2,1,0,1,0,0,0,0,0,0,0,0,0,0,0,0,0,0,0,1,0,1,0,0,0,0,0,0,0,0,0
201973,25000,250,0,-2,9,3,6,0,0,0,0,0,0,3,2,1,0,0,0,0,0,0,6,1,5,0,0,0,0,0,0,0,0,0
202046,25000,250,0,-2,5,1,4,0,0,0,0,0,0,0,0,0,1,1,0,0,0,0,4,0,4,0,0,0,0,0,0,0,0,0
202134,25000,250,0,-2,5,4,1,0,0,0,0,0,0,0,0,0,0,0,0,0,0,0,5,4,1,0,0,0,0,0,0,0,0,0
202170,25000,250,0,-2,4,0,4,0,0,0,0,0,0,1,0,1,0,0,0,0,0,0,3,0,3,0,0,0,0,0,0,0,0,0
202222,25000,250,0,-2,1,0,1,0,0,0,0,0,0,0,0,0,0,0,0,0,0,0,1,0,1,0,0,0,0,0,0,0,0,0
202356,25000,250,0,-2,5,2,3,0,0,0,1,1,0,1,0,1,1,0,1,0,0,0,2,1,1,0,0,0,0,0,0,0,0,0
202480,25000,250,0,-2,22,5,17,0,0,0,0,0,0,1,0,1,1,1,0,0,0,0,18,3,15,0,0,0,1,0,1,1,1,0
202514,25000,250,0,-2,8,3,5,0,0,0,0,0,0,0,0,0,0,0,0,0,0,0,8,3,5,0,0,0,0,0,0,0,0,0
202523,25000,250,0,-2,3,1,2,0,0,0,0,0,0,0,0,0,0,0,0,0,0,0,3,1,2,0,0,0,0,0,0,0,0,0
202763,25000,250,0,-2,9,1,8,0,0,0,0,0,0,0,0,0,0,0,0,0,0,0,9,1,8,0,0,0,0,0,0,0,0,0
202912,25000,250,0,-2,7,1,6,0,0,0,1,0,1,2,0,2,1,1,0,0,0,0,3,0,3,0,0,0,0,0,0,0,0,0
203067,25000,250,0,-2,10,5,5,0,0,0,0,0,0,0,0,0,0,0,0,0,0,0,10,5,5,0,0,0,0,0,0,0,0,0
203155,25000,250,0,-2,5,4,1,0,0,0,0,0,0,0,0,0,0,0,0,0,0,0,5,4,1,0,0,0,0,0,0,0,0,0
203331,25000,250,0,-2,3,0,3,0,0,0,0,0,0,0,0,0,0,0,0,0,0,0,3,0,3,0,0,0,0,0,0,0,0,0
203368,25000,250,0,-2,3,0,3,0,0,0,0,0,0,0,0,0,0,0,0,0,0,0,3,0,3,0,0,0,0,0,0,0,0,0
203517,25000,250,0,-2,15,3,12,0,0,0,0,0,0,0,0,0,2,0,2,0,0,0,12,2,10,1,1,0,0,0,0,0,0,0
203526,25000,250,0,-2,1,1,0,0,0,0,0,0,0,0,0,0,0,0,0,0,0,0,1,1,0,0,0,0,0,0,0,0,0,0
203535,25000,250,0,-2,5,3,2,0,0,0,0,0,0,1,0,1,0,0,0,0,0,0,1,0,1,0,0,0,3,3,0,0,0,0
203678,25000,250,0,-2,2,1,1,0,0,0,0,0,0,0,0,0,0,0,0,0,0,0,2,1,1,0,0,0,0,0,0,0,0,0
203748,25000,250,0,-2,4,1,3,0,0,0,0,0,0,0,0,0,0,0,0,0,0,0,4,1,3,0,0,0,0,0,0,0,0,0
203757,25000,250,0,-2,4,0,4,0,0,0,0,0,0,0,0,0,0,0,0,0,0,0,4,0,4,0,0,0,0,0,0,0,0,0
203881,25000,250,0,-2,1,1,0,0,0,0,0,0,0,0,0,0,0,0,0,0,0,0,1,1,0,0,0,0,0,0,0,0,0,0
204006,25000,250,0,-2,1,1,0,0,0,0,0,0,0,0,0,0,0,0,0,0,0,0,1,1,0,0,0,0,0,0,0,0,0,0
204015,25000,250,0,-2,2,2,0,0,0,0,0,0,0,0,0,0,0,0,0,0,0,0,2,2,0,0,0,0,0,0,0,0,0,0
204024,25000,250,0,-2,16,4,12,0,0,0,0,0,0,1,0,1,0,0,0,0,0,0,13,4,9,0,0,0,2,0,2,0,0,0
204176,25000,250,0,-2,2,1,1,0,0,0,0,0,0,1,1,0,0,0,0,0,0,0,1,0,1,0,0,0,0,0,0,0,0,0
204185,25000,250,0,-2,9,5,4,0,0,0,0,0,0,1,0,1,2,2,0,0,0,0,6,3,3,0,0,0,0,0,0,0,0,0
204194,25000,250,0,-2,3,1,2,0,0,0,0,0,0,0,0,0,0,0,0,0,0,0,3,1,2,0,0,0,0,0,0,0,0,0
204200,25000,250,0,-2,5,1,4,0,0,0,0,0,0,0,0,0,0,0,0,0,0,0,4,1,3,1,0,1,0,0,0,0,0,0
204422,25000,250,0,-2,2,0,2,0,0,0,0,0,0,0,0,0,0,0,0,0,0,0,2,0,2,0,0,0,0,0,0,0,0,0
204440,25000,250,0,-2,1,0,1,0,0,0,0,0,0,0,0,0,0,0,0,0,0,0,1,0,1,0,0,0,0,0,0,0,0,0
204468,25000,250,0,-2,5,2,3,0,0,0,0,0,0,2,1,1,0,0,0,0,0,0,3,1,2,0,0,0,0,0,0,0,0,0
204477,25000,250,0,-2,9,2,7,0,0,0,0,0,0,0,0,0,0,0,0,0,0,0,8,1,7,0,0,0,1,1,0,0,0,0
204486,25000,250,0,-2,3,0,3,0,0,0,0,0,0,0,0,0,0,0,0,0,0,0,3,0,3,0,0,0,0,0,0,0,0,0
204501,25000,250,0,-2,32,8,24,0,0,0,2,1,1,5,2,3,1,1,0,0,0,0,20,3,17,0,0,0,1,0,1,3,1,2
204635,25000,250,0,-2,1,0,1,0,0,0,0,0,0,0,0,0,0,0,0,0,0,0,1,0,1,0,0,0,0,0,0,0,0,0
204796,25000,250,0,-2,70,14,56,0,0,0,0,0,0,10,2,8,4,0,4,0,0,0,52,11,41,1,0,1,2,0,2,1,1,0
204857,25000,250,0,-2,7,4,3,0,0,0,1,1,0,1,0,1,0,0,0,0,0,0,4,2,2,0,0,0,1,1,0,0,0,0
204909,25000,250,0,-2,6,0,6,0,0,0,1,0,1,0,0,0,1,0,1,0,0,0,4,0,4,0,0,0,0,0,0,0,0,0
204936,25000,250,0,-2,3,1,2,0,0,0,0,0,0,0,0,0,0,0,0,0,0,0,3,1,2,0,0,0,0,0,0,0,0,0
204945,25000,250,0,-2,8,1,7,0,0,0,0,0,0,0,0,0,0,0,0,0,0,0,8,1,7,0,0,0,0,0,0,0,0,0
205179,25000,250,0,-2,1,1,0,0,0,0,0,0,0,0,0,0,0,0,0,0,0,0,1,1,0,0,0,0,0,0,0,0,0,0
205203,25000,250,0,-2,1,0,1,0,0,0,0,0,0,0,0,0,0,0,0,0,0,0,1,0,1,0,0,0,0,0,0,0,0,0
205391,25000,250,0,-2,4,2,2,0,0,0,1,0,1,0,0,0,0,0,0,0,0,0,3,2,1,0,0,0,0,0,0,0,0,0
205443,25000,250,0,-2,5,0,5,0,0,0,0,0,0,0,0,0,0,0,0,0,0,0,5,0,5,0,0,0,0,0,0,0,0,0
205470,25000,250,0,-2,16,2,14,0,0,0,1,1,0,4,1,3,0,0,0,0,0,0,10,0,10,1,0,1,0,0,0,0,0,0
205957,25000,250,0,-2,6,3,3,0,0,0,0,0,0,0,0,0,1,1,0,0,0,0,5,2,3,0,0,0,0,0,0,0,0,0
206011,25000,250,0,-2,5,2,3,0,0,0,0,0,0,0,0,0,0,0,0,0,0,0,5,2,3,0,0,0,0,0,0,0,0,0
206048,25000,250,0,-2,6,3,3,0,0,0,0,0,0,1,0,1,0,0,0,0,0,0,5,3,2,0,0,0,0,0,0,0,0,0
206084,25000,250,0,-2,9,2,7,0,0,0,0,0,0,2,1,1,1,1,0,0,0,0,6,0,6,0,0,0,0,0,0,0,0,0
206349,25000,250,0,-2,2,1,1,0,0,0,0,0,0,2,1,1,0,0,0,0,0,0,0,0,0,0,0,0,0,0,0,0,0,0
206437,25000,250,0,-2,2,0,2,0,0,0,0,0,0,0,0,0,0,0,0,0,0,0,2,0,2,0,0,0,0,0,0,0,0,0
206507,25000,250,0,-2,1,0,1,0,0,0,0,0,0,0,0,0,0,0,0,0,0,0,1,0,1,0,0,0,0,0,0,0,0,0
206525,25000,250,0,-2,4,1,3,0,0,0,1,1,0,0,0,0,0,0,0,0,0,0,2,0,2,1,0,1,0,0,0,0,0,0
206589,25000,250,0,-2,3,1,2,0,0,0,0,0,0,0,0,0,0,0,0,0,0,0,3,1,2,0,0,0,0,0,0,0,0,0
206604,25000,250,0,-2,5,4,1,0,0,0,1,1,0,1,1,0,1,1,0,0,0,0,2,1,1,0,0,0,0,0,0,0,0,0
206622,25000,250,0,-2,12,5,7,0,0,0,0,0,0,4,2,2,0,0,0,0,0,0,8,3,5,0,0,0,0,0,0,0,0,0
206695,25000,250,0,-2,4,2,2,0,0,0,0,0,0,2,1,1,0,0,0,0,0,0,2,1,1,0,0,0,0,0,0,0,0,0
206835,25000,250,0,-2,4,1,3,0,0,0,0,0,0,0,0,0,0,0,0,0,0,0,4,1,3,0,0,0,0,0,0,0,0,0
206862,25000,250,0,-2,5,0,5,0,0,0,0,0,0,0,0,0,0,0,0,0,0,0,5,0,5,0,0,0,0,0,0,0,0,0
206914,25000,250,0,-2,18,6,12,0,0,0,0,0,0,4,1,3,4,3,1,0,0,0,7,1,6,3,1,2,0,0,0,0,0,0
206923,25000,250,0,-2,7,2,5,1,0,1,0,0,0,0,0,0,0,0,0,0,0,0,6,2,4,0,0,0,0,0,0,0,0,0
206932,25000,250,0,-2,1,0,1,0,0,0,0,0,0,0,0,0,0,0,0,0,0,0,1,0,1,0,0,0,0,0,0,0,0,0
206941,25000,250,0,-2,27,10,17,1,0,1,0,0,0,1,1,0,2,0,2,0,0,0,10,5,5,0,0,0,13,4,9,0,0,0
206996,25000,250,0,-2,1,0,1,0,0,0,0,0,0,0,0,0,0,0,0,0,0,0,1,0,1,0,0,0,0,0,0,0,0,0
207041,25000,250,0,-2,4,1,3,0,0,0,0,0,0,0,0,0,0,0,0,0,0,0,3,1,2,0,0,0,1,0,1,0,0,0
207050,25000,250,0,-2,5,1,4,1,0,1,0,0,0,1,0,1,0,0,0,0,0,0,3,1,2,0,0,0,0,0,0,0,0,0
207069,25000,250,0,-2,1,1,0,0,0,0,0,0,0,0,0,0,0,0,0,0,0,0,1,1,0,0,0,0,0,0,0,0,0,0
207236,25000,250,0,-2,10,2,8,3,0,3,0,0,0,0,0,0,0,0,0,0,0,0,6,1,5,0,0,0,1,1,0,0,0,0
207254,25000,250,0,-2,5,0,5,2,0,2,0,0,0,0,0,0,0,0,0,0,0,0,3,0,3,0,0,0,0,0,0,0,0,0
207263,25000,250,0,-2,11,3,8,2,0,2,0,0,0,0,0,0,0,0,0,0,0,0,7,3,4,2,0,2,0,0,0,0,0,0
207281,25000,250,0,-2,5,1,4,0,0,0,0,0,0,0,0,0,1,0,1,0,0,0,4,1,3,0,0,0,0,0,0,0,0,0
207306,25000,250,0,-2,1,0,1,0,0,0,0,0,0,0,0,0,0,0,0,0,0,0,1,0,1,0,0,0,0,0,0,0,0,0
207315,25000,250,0,-2,6,2,4,0,0,0,0,0,0,0,0,0,0,0,0,0,0,0,6,2,4,0,0,0,0,0,0,0,0,0
207324,25000,250,0,-2,1,0,1,0,0,0,0,0,0,0,0,0,0,0,0,0,0,0,1,0,1,0,0,0,0,0,0,0,0,0
207351,25000,250,0,-2,1,0,1,0,0,0,0,0,0,0,0,0,0,0,0,0,0,0,1,0,1,0,0,0,0,0,0,0,0,0
207388,25000,250,0,-2,28,7,21,3,0,3,0,0,0,0,0,0,1,0,1,0,0,0,24,7,17,0,0,0,0,0,0,0,0,0
207397,25000,250,0,-2,1,0,1,0,0,0,0,0,0,0,0,0,0,0,0,0,0,0,1,0,1,0,0,0,0,0,0,0,0,0
207403,25000,250,0,-2,4,3,1,0,0,0,0,0,0,0,0,0,0,0,0,0,0,0,3,3,0,0,0,0,1,0,1,0,0,0
207449,25000,250,0,-2,14,4,10,0,0,0,1,0,1,2,1,1,2,0,2,0,0,0,8,2,6,1,1,0,0,0,0,0,0,0
207458,25000,250,0,-2,2,1,1,0,0,0,0,0,0,0,0,0,0,0,0,0,0,0,2,1,1,0,0,0,0,0,0,0,0,0
207500,25000,250,0,-2,65,16,49,0,0,0,1,0,1,9,3,6,3,0,3,0,0,0,43,10,33,8,3,5,1,0,1,0,0,0
207564,25000,250,0,-2,3,1,2,0,0,0,0,0,0,0,0,0,0,0,0,0,0,0,3,1,2,0,0,0,0,0,0,0,0,0
207582,25000,250,0,-2,2,0,2,1,0,1,0,0,0,0,0,0,0,0,0,0,0,0,1,0,1,0,0,0,0,0,0,0,0,0
207661,25000,250,0,-2,1,0,1,0,0,0,0,0,0,0,0,0,0,0,0,0,0,0,1,0,1,0,0,0,0,0,0,0,0,0
207856,25000,250,0,-2,4,0,4,0,0,0,0,0,0,0,0,0,0,0,0,0,0,0,2,0,2,0,0,0,0,0,0,2,0,2
207865,25000,250,0,-2,3,2,1,0,0,0,0,0,0,0,0,0,0,0,0,0,0,0,3,2,1,0,0,0,0,0,0,0,0,0
207935,25000,250,0,-2,11,3,8,1,1,0,0,0,0,1,0,1,2,0,2,0,0,0,7,2,5,0,0,0,0,0,0,0,0,0
207971,25000,250,0,-2,13,4,9,1,1,0,0,0,0,1,0,1,1,1,0,0,0,0,7,2,5,1,0,1,2,0,2,0,0,0
208035,25000,250,0,-2,3,0,3,0,0,0,0,0,0,0,0,0,0,0,0,0,0,0,3,0,3,0,0,0,0,0,0,0,0,0
208318,25000,250,0,-2,1,1,0,0,0,0,0,0,0,0,0,0,0,0,0,0,0,0,1,1,0,0,0,0,0,0,0,0,0,0
208390,25000,250,0,-2,14,5,9,0,0,0,0,0,0,0,0,0,6,2,4,0,0,0,8,3,5,0,0,0,0,0,0,0,0,0
208415,25000,250,0,-2,6,2,4,0,0,0,0,0,0,0,0,0,2,1,1,0,0,0,4,1,3,0,0,0,0,0,0,0,0,0
208479,25000,250,0,-2,3,1,2,0,0,0,0,0,0,0,0,0,0,0,0,0,0,0,3,1,2,0,0,0,0,0,0,0,0,0
208822,25000,250,0,-2,7,1,6,0,0,0,1,0,1,1,1,0,3,0,3,0,0,0,2,0,2,0,0,0,0,0,0,0,0,0
209038,25000,250,0,-2,2,1,1,0,0,0,0,0,0,0,0,0,0,0,0,0,0,0,2,1,1,0,0,0,0,0,0,0,0,0
209056,25000,250,0,-2,13,6,7,0,0,0,2,1,1,0,0,0,4,2,2,1,0,1,6,3,3,0,0,0,0,0,0,0,0,0
209065,25000,250,0,-2,3,0,3,0,0,0,0,0,0,0,0,0,0,0,0,0,0,0,3,0,3,0,0,0,0,0,0,0,0,0
209074,25000,250,0,-2,7,3,4,0,0,0,0,0,0,0,0,0,0,0,0,0,0,0,5,2,3,0,0,0,2,1,1,0,0,0
209250,25000,250,0,-2,1,0,1,0,0,0,0,0,0,0,0,0,0,0,0,0,0,0,1,0,1,0,0,0,0,0,0,0,0,0
209409,25000,250,0,-2,1,1,0,0,0,0,0,0,0,0,0,0,0,0,0,0,0,0,1,1,0,0,0,0,0,0,0,0,0,0
209490,25000,250,0,-2,5,2,3,0,0,0,0,0,0,2,1,1,0,0,0,0,0,0,2,1,1,1,0,1,0,0,0,0,0,0
209506,25000,250,0,-2,5,0,5,0,0,0,0,0,0,0,0,0,1,0,1,1,0,1,2,0,2,1,0,1,0,0,0,0,0,0
209542,25000,250,0,-2,80,18,62,1,0,1,3,1,2,0,0,0,10,3,7,1,0,1,34,8,26,5,1,4,26,5,21,0,0,0
209551,25000,250,0,-2,112,21,91,0,0,0,6,1,5,7,4,3,17,3,14,0,0,0,68,9,59,10,2,8,2,1,1,2,1,1
209612,25000,250,0,-2,5,1,4,0,0,0,0,0,0,0,0,0,0,0,0,0,0,0,5,1,4,0,0,0,0,0,0,0,0,0
209746,25000,250,0,-2,2,0,2,0,0,0,2,0,2,0,0,0,0,0,0,0,0,0,0,0,0,0,0,0,0,0,0,0,0,0
209807,25000,250,0,-2,5,1,4,0,0,0,0,0,0,0,0,0,0,0,0,0,0,0,4,1,3,1,0,1,0,0,0,0,0,0
209825,25000,250,0,-2,4,2,2,0,0,0,1,0,1,0,0,0,1,1,0,0,0,0,2,1,1,0,0,0,0,0,0,0,0,0
209922,25000,250,0,-2,7,2,5,1,0,1,0,0,0,0,0,0,0,0,0,0,0,0,4,2,2,2,0,2,0,0,0,0,0,0
210234,25000,250,0,-2,7,4,3,0,0,0,0,0,0,0,0,0,2,1,1,0,0,0,4,2,2,0,0,0,1,1,0,0,0,0
210270,25000,250,0,-2,1,1,0,0,0,0,0,0,0,0,0,0,0,0,0,0,0,0,0,0,0,1,1,0,0,0,0,0,0,0
210304,25000,250,0,-2,1,0,1,0,0,0,0,0,0,0,0,0,1,0,1,0,0,0,0,0,0,0,0,0,0,0,0,0,0,0
210331,25000,250,0,-2,1,0,1,0,0,0,0,0,0,0,0,0,1,0,1,0,0,0,0,0,0,0,0,0,0,0,0,0,0,0
210368,25000,250,0,-2,1,0,1,0,0,0,0,0,0,0,0,0,0,0,0,0,0,0,1,0,1,0,0,0,0,0,0,0,0,0
210429,25000,250,0,-2,3,2,1,0,0,0,1,1,0,0,0,0,0,0,0,0,0,0,2,1,1,0,0,0,0,0,0,0,0,0
210438,25000,250,0,-2,7,3,4,0,0,0,2,2,0,0,0,0,0,0,0,0,0,0,5,1,4,0,0,0,0,0,0,0,0,0
210492,25000,250,0,-2,1,0,1,0,0,0,0,0,0,0,0,0,0,0,0,0,0,0,1,0,1,0,0,0,0,0,0,0,0,0
210571,25000,250,0,-2,2,1,1,0,0,0,0,0,0,0,0,0,2,1,1,0,0,0,0,0,0,0,0,0,0,0,0,0,0,0
210599,25000,250,0,-2,2,1,1,0,0,0,0,0,0,0,0,0,0,0,0,0,0,0,2,1,1,0,0,0,0,0,0,0,0,0
210605,25000,250,0,-2,2,0,2,0,0,0,0,0,0,0,0,0,0,0,0,0,0,0,2,0,2,0,0,0,0,0,0,0,0,0
210669,25000,250,0,-2,5,1,4,0,0,0,0,0,0,0,0,0,1,0,1,0,0,0,4,1,3,0,0,0,0,0,0,0,0,0
210739,25000,250,0,-2,12,3,9,0,0,0,0,0,0,0,0,0,0,0,0,0,0,0,11,3,8,1,0,1,0,0,0,0,0,0
210775,25000,250,0,-2,7,2,5,0,0,0,0,0,0,0,0,0,0,0,0,0,0,0,6,2,4,1,0,1,0,0,0,0,0,0
210809,25000,250,0,-2,11,3,8,0,0,0,0,0,0,3,1,2,0,0,0,0,0,0,7,2,5,0,0,0,1,0,1,0,0,0
211024,25000,250,0,-2,3,1,2,0,0,0,0,0,0,0,0,0,0,0,0,0,0,0,3,1,2,0,0,0,0,0,0,0,0,0
211088,25000,250,0,-2,4,1,3,0,0,0,0,0,0,1,0,1,1,1,0,0,0,0,1,0,1,1,0,1,0,0,0,0,0,0
211130,25000,250,0,-2,1,0,1,0,0,0,0,0,0,0,0,0,0,0,0,0,0,0,1,0,1,0,0,0,0,0,0,0,0,0
211273,25000,250,0,-2,1,0,1,0,0,0,0,0,0,1,0,1,0,0,0,0,0,0,0,0,0,0,0,0,0,0,0,0,0,0
211291,25000,250,0,-2,4,3,1,0,0,0,0,0,0,0,0,0,0,0,0,0,0,0,3,3,0,0,0,0,0,0,0,1,0,1
211307,25000,250,0,-2,1,0,1,0,0,0,0,0,0,0,0,0,0,0,0,0,0,0,1,0,1,0,0,0,0,0,0,0,0,0
211352,25000,250,0,-2,6,1,5,0,0,0,0,0,0,0,0,0,0,0,0,0,0,0,6,1,5,0,0,0,0,0,0,0,0,0
211431,25000,250,0,-2,8,1,7,0,0,0,0,0,0,3,0,3,0,0,0,0,0,0,4,1,3,0,0,0,1,0,1,0,0,0
211440,25000,250,0,-2,15,0,15,0,0,0,0,0,0,0,0,0,0,0,0,0,0,0,14,0,14,1,0,1,0,0,0,0,0,0
211477,25000,250,0,-2,1,0,1,0,0,0,0,0,0,0,0,0,0,0,0,0,0,0,1,0,1,0,0,0,0,0,0,0,0,0
211556,25000,250,0,-2,5,1,4,0,0,0,0,0,0,0,0,0,1,1,0,0,0,0,4,0,4,0,0,0,0,0,0,0,0,0
211583,25000,250,0,-2,5,1,4,0,0,0,0,0,0,2,1,1,0,0,0,0,0,0,3,0,3,0,0,0,0,0,0,0,0,0
211893,25000,250,0,-2,4,0,4,0,0,0,0,0,0,0,0,0,0,0,0,0,0,0,4,0,4,0,0,0,0,0,0,0,0,0
211927,25000,250,0,-2,3,1,2,0,0,0,1,0,1,0,0,0,0,0,0,0,0,0,2,1,1,0,0,0,0,0,0,0,0,0
211981,25000,250,0,-2,8,2,6,0,0,0,0,0,0,1,1,0,0,0,0,0,0,0,7,1,6,0,0,0,0,0,0,0,0,0
212009,25000,250,0,-2,5,0,5,0,0,0,0,0,0,0,0,0,0,0,0,0,0,0,5,0,5,0,0,0,0,0,0,0,0,0
212045,25000,250,0,-2,3,0,3,0,0,0,0,0,0,0,0,0,0,0,0,0,0,0,3,0,3,0,0,0,0,0,0,0,0,0
212054,25000,250,0,-2,23,8,15,0,0,0,0,0,0,6,1,5,0,0,0,0,0,0,15,5,10,0,0,0,2,2,0,0,0,0
212106,25000,250,0,-2,2,1,1,0,0,0,0,0,0,0,0,0,0,0,0,0,0,0,2,1,1,0,0,0,0,0,0,0,0,0
212115,25000,250,0,-2,1,1,0,0,0,0,0,0,0,0,0,0,1,1,0,0,0,0,0,0,0,0,0,0,0,0,0,0,0,0
212133,25000,250,0,-2,7,1,6,0,0,0,0,0,0,0,0,0,0,0,0,0,0,0,6,1,5,0,0,0,1,0,1,0,0,0
212197,25000,250,0,-2,5,0,5,0,0,0,0,0,0,0,0,0,0,0,0,0,0,0,5,0,5,0,0,0,0,0,0,0,0,0
212434,25000,250,0,-2,1,0,1,0,0,0,0,0,0,0,0,0,0,0,0,0,0,0,1,0,1,0,0,0,0,0,0,0,0,0
212577,25000,250,0,-2,20,4,16,0,0,0,2,1,1,0,0,0,5,1,4,0,0,0,11,1,10,0,0,0,2,1,1,0,0,0
212601,25000,250,0,-2,3,2,1,0,0,0,0,0,0,0,0,0,0,0,0,0,0,0,3,2,1,0,0,0,0,0,0,0,0,0
212656,25000,250,0,-2,3,1,2,0,0,0,0,0,0,0,0,0,0,0,0,0,0,0,3,1,2,0,0,0,0,0,0,0,0,0
212674,25000,250,0,-2,10,2,8,0,0,0,0,0,0,2,1,1,0,0,0,0,0,0,8,1,7,0,0,0,0,0,0,0,0,0
212771,25000,250,0,-2,1,1,0,0,0,0,0,0,0,0,0,0,0,0,0,0,0,0,1,1,0,0,0,0,0,0,0,0,0,0
212869,25000,250,0,-2,1,1,0,0,0,0,0,0,0,0,0,0,0,0,0,0,0,0,1,1,0,0,0,0,0,0,0,0,0,0
212911,25000,250,0,-2,2,1,1,0,0,0,0,0,0,1,1,0,0,0,0,0,0,0,0,0,0,1,0,1,0,0,0,0,0,0
212984,25000,250,0,-2,3,0,3,0,0,0,0,0,0,1,0,1,0,0,0,0,0,0,2,0,2,0,0,0,0,0,0,0,0,0
213011,25000,250,0,-2,6,3,3,0,0,0,0,0,0,1,0,1,0,0,0,0,0,0,5,3,2,0,0,0,0,0,0,0,0,0
213233,25000,250,0,-2,8,1,7,0,0,0,0,0,0,0,0,0,2,0,2,0,0,0,6,1,5,0,0,0,0,0,0,0,0,0
213321,25000,250,0,-2,4,1,3,0,0,0,0,0,0,0,0,0,0,0,0,0,0,0,4,1,3,0,0,0,0,0,0,0,0,0
213358,25000,250,0,-2,3,2,1,0,0,0,0,0,0,0,0,0,0,0,0,0,0,0,3,2,1,0,0,0,0,0,0,0,0,0
213367,25000,250,0,-2,20,3,17,0,0,0,1,1,0,4,1,3,2,1,1,0,0,0,13,0,13,0,0,0,0,0,0,0,0,0
213376,25000,250,0,-2,9,1,8,0,0,0,0,0,0,0,0,0,1,0,1,0,0,0,8,1,7,0,0,0,0,0,0,0,0,0
213385,25000,250,0,-2,3,3,0,0,0,0,0,0,0,0,0,0,0,0,0,0,0,0,3,3,0,0,0,0,0,0,0,0,0,0
213446,25000,250,0,-2,1,0,1,0,0,0,0,0,0,1,0,1,0,0,0,0,0,0,0,0,0,0,0,0,0,0,0,0,0,0
213507,25000,250,0,-2,4,1,3,0,0,0,0,0,0,0,0,0,0,0,0,0,0,0,3,0,3,1,1,0,0,0,0,0,0,0
213525,25000,250,0,-2,1,0,1,0,0,0,0,0,0,1,0,1,0,0,0,0,0,0,0,0,0,0,0,0,0,0,0,0,0,0
213543,25000,250,0,-2,14,4,10,0,0,0,0,0,0,0,0,0,0,0,0,0,0,0,14,4,10,0,0,0,0,0,0,0,0,0
213570,25000,250,0,-2,1,1,0,0,0,0,0,0,0,0,0,0,0,0,0,0,0,0,1,1,0,0,0,0,0,0,0,0,0,0
213589,25000,250,0,-2,1,1,0,0,0,0,0,0,0,1,1,0,0,0,0,0,0,0,0,0,0,0,0,0,0,0,0,0,0,0
213598,25000,250,0,-2,1,0,1,0,0,0,0,0,0,0,0,0,0,0,0,0,0,0,1,0,1,0,0,0,0,0,0,0,0,0
213631,25000,250,0,-2,2,1,1,0,0,0,0,0,0,1,1,0,0,0,0,0,0,0,1,0,1,0,0,0,0,0,0,0,0,0
213668,25000,250,0,-2,3,0,3,0,0,0,0,0,0,0,0,0,0,0,0,0,0,0,3,0,3,0,0,0,0,0,0,0,0,0
213774,25000,250,0,-2,4,2,2,0,0,0,0,0,0,0,0,0,0,0,0,0,0,0,4,2,2,0,0,0,0,0,0,0,0,0
213826,25000,250,0,-2,4,1,3,0,0,0,0,0,0,1,0,1,1,1,0,0,0,0,2,0,2,0,0,0,0,0,0,0,0,0
213996,25000,250,0,-2,1,0,1,0,0,0,0,0,0,0,0,0,0,0,0,0,0,0,1,0,1,0,0,0,0,0,0,0,0,0
214069,25000,250,0,-2,2,0,2,0,0,0,0,0,0,0,0,0,0,0,0,0,0,0,2,0,2,0,0,0,0,0,0,0,0,0
214148,25000,250,0,-2,6,1,5,0,0,0,0,0,0,1,0,1,0,0,0,0,0,0,5,1,4,0,0,0,0,0,0,0,0,0
214166,25000,250,0,-2,4,2,2,0,0,0,0,0,0,0,0,0,0,0,0,0,0,0,4,2,2,0,0,0,0,0,0,0,0,0
214175,25000,250,0,-2,4,1,3,0,0,0,0,0,0,1,0,1,0,0,0,0,0,0,3,1,2,0,0,0,0,0,0,0,0,0
214272,25000,250,0,-2,5,0,5,0,0,0,0,0,0,1,0,1,0,0,0,0,0,0,4,0,4,0,0,0,0,0,0,0,0,0
214290,25000,250,0,-2,3,1,2,0,0,0,0,0,0,0,0,0,0,0,0,0,0,0,3,1,2,0,0,0,0,0,0,0,0,0
214379,25000,250,0,-2,3,2,1,0,0,0,0,0,0,1,1,0,0,0,0,0,0,0,2,1,1,0,0,0,0,0,0,0,0,0
214564,25000,250,0,-2,3,1,2,0,0,0,0,0,0,0,0,0,0,0,0,0,0,0,2,1,1,1,0,1,0,0,0,0,0,0
214883,25000,250,0,-2,6,3,3,0,0,0,0,0,0,3,1,2,0,0,0,0,0,0,3,2,1,0,0,0,0,0,0,0,0,0
214892,25000,250,0,-2,1,0,1,0,0,0,0,0,0,0,0,0,0,0,0,0,0,0,1,0,1,0,0,0,0,0,0,0,0,0
214944,25000,250,0,-2,1,1,0,0,0,0,0,0,0,0,0,0,0,0,0,0,0,0,1,1,0,0,0,0,0,0,0,0,0,0
214971,25000,250,0,-2,4,2,2,0,0,0,0,0,0,1,0,1,1,1,0,0,0,0,2,1,1,0,0,0,0,0,0,0,0,0
215053,25000,250,0,-2,5,1,4,0,0,0,0,0,0,0,0,0,0,0,0,0,0,0,5,1,4,0,0,0,0,0,0,0,0,0
215062,25000,250,0,-2,14,2,12,0,0,0,1,0,1,2,0,2,0,0,0,0,0,0,10,2,8,0,0,0,0,0,0,1,0,1
215105,25000,250,0,-2,9,3,6,0,0,0,0,0,0,0,0,0,1,1,0,0,0,0,8,2,6,0,0,0,0,0,0,0,0,0
215123,25000,250,0,-2,8,1,7,0,0,0,0,0,0,2,0,2,2,0,2,0,0,0,4,1,3,0,0,0,0,0,0,0,0,0
215132,25000,250,0,-2,7,4,3,0,0,0,1,0,1,1,1,0,0,0,0,0,0,0,5,3,2,0,0,0,0,0,0,0,0,0
215239,25000,250,0,-2,3,2,1,0,0,0,0,0,0,1,1,0,0,0,0,0,0,0,1,1,0,0,0,0,1,0,1,0,0,0
215293,25000,250,0,-2,22,2,20,0,0,0,0,0,0,3,0,3,1,1,0,0,0,0,15,1,14,1,0,1,2,0,2,0,0,0
215381,25000,250,0,-2,3,0,3,0,0,0,0,0,0,0,0,0,0,0,0,0,0,0,3,0,3,0,0,0,0,0,0,0,0,0
215415,25000,250,0,-2,2,1,1,0,0,0,0,0,0,0,0,0,0,0,0,0,0,0,1,1,0,1,0,1,0,0,0,0,0,0
215424,25000,250,0,-2,1,0,1,0,0,0,0,0,0,0,0,0,0,0,0,0,0,0,1,0,1,0,0,0,0,0,0,0,0,0
215442,25000,250,0,-2,4,2,2,0,0,0,0,0,0,0,0,0,1,1,0,0,0,0,3,1,2,0,0,0,0,0,0,0,0,0
215585,25000,250,0,-2,5,2,3,0,0,0,0,0,0,0,0,0,1,0,1,0,0,0,4,2,2,0,0,0,0,0,0,0,0,0
215655,25000,250,0,-2,14,8,6,0,0,0,0,0,0,0,0,0,0,0,0,0,0,0,11,6,5,0,0,0,0,0,0,3,2,1
215682,25000,250,0,-2,1,0,1,0,0,0,0,0,0,0,0,0,0,0,0,0,0,0,1,0,1,0,0,0,0,0,0,0,0,0
215743,25000,250,0,-2,9,2,7,0,0,0,0,0,0,0,0,0,0,0,0,0,0,0,9,2,7,0,0,0,0,0,0,0,0,0
215770,25000,250,0,-2,8,4,4,0,0,0,1,1,0,0,0,0,0,0,0,0,0,0,7,3,4,0,0,0,0,0,0,0,0,0
215929,25000,250,0,-2,6,2,4,0,0,0,0,0,0,1,0,1,0,0,0,0,0,0,5,2,3,0,0,0,0,0,0,0,0,0
215947,25000,250,0,-2,1,1,0,0,0,0,0,0,0,0,0,0,0,0,0,0,0,0,1,1,0,0,0,0,0,0,0,0,0,0
215992,25000,250,0,-2,1,0,1,0,0,0,0,0,0,0,0,0,0,0,0,0,0,0,1,0,1,0,0,0,0,0,0,0,0,0
216010,25000,250,0,-2,1,1,0,0,0,0,0,0,0,0,0,0,0,0,0,0,0,0,1,1,0,0,0,0,0,0,0,0,0,0
216038,25000,250,0,-2,1,0,1,0,0,0,0,0,0,0,0,0,0,0,0,0,0,0,1,0,1,0,0,0,0,0,0,0,0,0
216278,25000,250,0,-2,3,1,2,0,0,0,0,0,0,0,0,0,0,0,0,0,0,0,2,0,2,1,1,0,0,0,0,0,0,0
216287,25000,250,0,-2,9,2,7,0,0,0,0,0,0,1,0,1,2,1,1,0,0,0,6,1,5,0,0,0,0,0,0,0,0,0
216296,25000,250,0,-2,2,0,2,0,0,0,0,0,0,0,0,0,1,0,1,0,0,0,1,0,1,0,0,0,0,0,0,0,0,0
216339,25000,250,0,-2,13,5,8,0,0,0,0,0,0,4,1,3,0,0,0,0,0,0,8,3,5,1,1,0,0,0,0,0,0,0
216357,25000,250,0,-2,2,0,2,0,0,0,0,0,0,0,0,0,0,0,0,0,0,0,2,0,2,0,0,0,0,0,0,0,0,0
216366,25000,250,0,-2,7,1,6,0,0,0,0,0,0,0,0,0,0,0,0,0,0,0,7,1,6,0,0,0,0,0,0,0,0,0
216445,25000,250,0,-2,2,0,2,0,0,0,0,0,0,0,0,0,0,0,0,0,0,0,2,0,2,0,0,0,0,0,0,0,0,0
216454,25000,250,0,-2,3,0,3,0,0,0,0,0,0,0,0,0,0,0,0,0,0,0,3,0,3,0,0,0,0,0,0,0,0,0
216524,25000,250,0,-2,4,2,2,0,0,0,0,0,0,0,0,0,0,0,0,0,0,0,4,2,2,0,0,0,0,0,0,0,0,0
216597,25000,250,0,-2,8,0,8,0,0,0,0,0,0,1,0,1,0,0,0,0,0,0,7,0,7,0,0,0,0,0,0,0,0,0
216667,25000,250,0,-2,3,1,2,0,0,0,0,0,0,0,0,0,0,0,0,0,0,0,3,1,2,0,0,0,0,0,0,0,0,0
216694,25000,250,0,-2,2,2,0,0,0,0,0,0,0,0,0,0,0,0,0,0,0,0,2,2,0,0,0,0,0,0,0,0,0,0
216764,25000,250,0,-2,2,0,2,0,0,0,0,0,0,0,0,0,0,0,0,0,0,0,2,0,2,0,0,0,0,0,0,0,0,0
216782,25000,250,0,-2,1,1,0,0,0,0,0,0,0,0,0,0,0,0,0,0,0,0,1,1,0,0,0,0,0,0,0,0,0,0
216852,25000,250,0,-2,19,3,16,0,0,0,0,0,0,3,0,3,0,0,0,0,0,0,16,3,13,0,0,0,0,0,0,0,0,0
216931,25000,250,0,-2,12,4,8,0,0,0,0,0,0,0,0,0,0,0,0,0,0,0,11,4,7,0,0,0,1,0,1,0,0,0
217013,25000,250,0,-2,1,0,1,0,0,0,0,0,0,0,0,0,0,0,0,0,0,0,1,0,1,0,0,0,0,0,0,0,0,0
217059,25000,250,0,-2,2,0,2,0,0,0,0,0,0,0,0,0,1,0,1,0,0,0,1,0,1,0,0,0,0,0,0,0,0,0
217077,25000,250,0,-2,2,0,2,0,0,0,0,0,0,0,0,0,0,0,0,0,0,0,2,0,2,0,0,0,0,0,0,0,0,0
217156,25000,250,0,-2,35,9,26,0,0,0,0,0,0,1,0,1,7,1,6,0,0,0,20,5,15,1,0,1,5,2,3,1,1,0
217165,25000,250,0,-2,17,1,16,0,0,0,0,0,0,3,1,2,1,0,1,0,0,0,13,0,13,0,0,0,0,0,0,0,0,0
217235,25000,250,0,-2,11,2,9,0,0,0,0,0,0,2,0,2,0,0,0,0,0,0,9,2,7,0,0,0,0,0,0,0,0,0
217402,25000,250,0,-2,7,4,3,0,0,0,0,0,0,2,1,1,2,2,0,0,0,0,3,1,2,0,0,0,0,0,0,0,0,0
217420,25000,250,0,-2,5,2,3,0,0,0,0,0,0,2,0,2,0,0,0,0,0,0,3,2,1,0,0,0,0,0,0,0,0,0
217484,25000,250,0,-2,24,5,19,0,0,0,1,1,0,1,1,0,3,0,3,0,0,0,18,3,15,0,0,0,0,0,0,1,0,1
217493,25000,250,0,-2,2,0,2,1,0,1,0,0,0,1,0,1,0,0,0,0,0,0,0,0,0,0,0,0,0,0,0,0,0,0
217518,25000,250,0,-2,11,4,7,0,0,0,0,0,0,0,0,0,3,0,3,0,0,0,8,4,4,0,0,0,0,0,0,0,0,0
217536,25000,250,0,-2,3,0,3,0,0,0,0,0,0,0,0,0,0,0,0,0,0,0,3,0,3,0,0,0,0,0,0,0,0,0
217633,25000,250,0,-2,3,1,2,0,0,0,0,0,0,0,0,0,0,0,0,0,0,0,3,1,2,0,0,0,0,0,0,0,0,0
217688,25000,250,0,-2,9,2,7,0,0,0,0,0,0,0,0,0,0,0,0,0,0,0,9,2,7,0,0,0,0,0,0,0,0,0
217712,25000,250,0,-2,1,0,1,0,0,0,0,0,0,0,0,0,0,0,0,0,0,0,1,0,1,0,0,0,0,0,0,0,0,0
217749,25000,250,0,-2,1,0,1,0,0,0,0,0,0,0,0,0,0,0,0,0,0,0,1,0,1,0,0,0,0,0,0,0,0,0
217776,25000,250,0,-2,2,2,0,0,0,0,0,0,0,0,0,0,0,0,0,0,0,0,1,1,0,1,1,0,0,0,0,0,0,0
217819,25000,250,0,-2,5,1,4,0,0,0,0,0,0,0,0,0,0,0,0,0,0,0,4,1,3,1,0,1,0,0,0,0,0,0
217864,25000,250,0,-2,12,9,3,0,0,0,0,0,0,2,2,0,0,0,0,0,0,0,7,5,2,0,0,0,3,2,1,0,0,0
217882,25000,250,0,-2,38,8,30,0,0,0,0,0,0,0,0,0,0,0,0,0,0,0,38,8,30,0,0,0,0,0,0,0,0,0
217891,25000,250,0,-2,5,2,3,0,0,0,0,0,0,5,2,3,0,0,0,0,0,0,0,0,0,0,0,0,0,0,0,0,0,0
217925,25000,250,0,-2,3,1,2,0,0,0,0,0,0,0,0,0,0,0,0,0,0,0,3,1,2,0,0,0,0,0,0,0,0,0
217934,25000,250,0,-2,12,1,11,0,0,0,0,0,0,9,1,8,0,0,0,0,0,0,2,0,2,1,0,1,0,0,0,0,0,0
217998,25000,250,0,-2,1,1,0,0,0,0,0,0,0,0,0,0,0,0,0,0,0,0,1,1,0,0,0,0,0,0,0,0,0,0
218025,25000,250,0,-2,1,0,1,0,0,0,0,0,0,1,0,1,0,0,0,0,0,0,0,0,0,0,0,0,0,0,0,0,0,0
218061,25000,250,0,-2,2,0,2,0,0,0,0,0,0,0,0,0,0,0,0,0,0,0,2,0,2,0,0,0,0,0,0,0,0,0
218070,25000,250,0,-2,1,0,1,0,0,0,0,0,0,0,0,0,1,0,1,0,0,0,0,0,0,0,0,0,0,0,0,0,0,0
218229,25000,250,0,-2,20,11,9,0,0,0,0,0,0,3,3,0,0,0,0,0,0,0,13,6,7,2,1,1,2,1,1,0,0,0
218238,25000,250,0,-2,7,0,7,0,0,0,0,0,0,4,0,4,0,0,0,0,0,0,2,0,2,0,0,0,1,0,1,0,0,0
218353,25000,250,0,-2,1,0,1,0,0,0,0,0,0,0,0,0,0,0,0,0,0,0,1,0,1,0,0,0,0,0,0,0,0,0
218414,25000,250,0,-2,1,1,0,0,0,0,0,0,0,1,1,0,0,0,0,0,0,0,0,0,0,0,0,0,0,0,0,0,0,0
218441,25000,250,0,-2,1,1,0,0,0,0,0,0,0,0,0,0,0,0,0,0,0,0,1,1,0,0,0,0,0,0,0,0,0,0
218487,25000,250,0,-2,9,3,6,0,0,0,0,0,0,6,2,4,0,0,0,0,0,0,3,1,2,0,0,0,0,0,0,0,0,0
218539,25000,250,0,-2,1,0,1,0,0,0,0,0,0,0,0,0,0,0,0,0,0,0,1,0,1,0,0,0,0,0,0,0,0,0
218654,25000,250,0,-2,1,0,1,0,0,0,0,0,0,0,0,0,0,0,0,0,0,0,1,0,1,0,0,0,0,0,0,0,0,0
218663,25000,250,0,-2,7,2,5,0,0,0,0,0,0,1,1,0,0,0,0,0,0,0,3,1,2,3,0,3,0,0,0,0,0,0
218724,25000,250,0,-2,8,4,4,0,0,0,0,0,0,0,0,0,0,0,0,0,0,0,6,4,2,2,0,2,0,0,0,0,0,0
218733,25000,250,0,-2,7,3,4,0,0,0,0,0,0,5,2,3,0,0,0,0,0,0,1,1,0,1,0,1,0,0,0,0,0,0
218742,25000,250,0,-2,1,0,1,0,0,0,0,0,0,0,0,0,0,0,0,0,0,0,1,0,1,0,0,0,0,0,0,0,0,0
218821,25000,250,0,-2,2,0,2,0,0,0,0,0,0,0,0,0,1,0,1,0,0,0,1,0,1,0,0,0,0,0,0,0,0,0
218830,25000,250,0,-2,2,0,2,0,0,0,0,0,0,0,0,0,0,0,0,0,0,0,2,0,2,0,0,0,0,0,0,0,0,0
218885,25000,250,0,-2,1,0,1,0,0,0,0,0,0,0,0,0,0,0,0,0,0,0,1,0,1,0,0,0,0,0,0,0,0,0
218894,25000,250,0,-2,1,0,1,0,0,0,0,0,0,0,0,0,0,0,0,0,0,0,1,0,1,0,0,0,0,0,0,0,0,0
218919,25000,250,0,-2,13,6,7,0,0,0,0,0,0,12,6,6,0,0,0,0,0,0,1,0,1,0,0,0,0,0,0,0,0,0
218955,25000,250,0,-2,1,0,1,0,0,0,0,0,0,1,0,1,0,0,0,0,0,0,0,0,0,0,0,0,0,0,0,0,0,0
218964,25000,250,0,-2,2,0,2,0,0,0,0,0,0,1,0,1,0,0,0,0,0,0,1,0,1,0,0,0,0,0,0,0,0,0
218973,25000,250,0,-2,3,0,3,0,0,0,0,0,0,2,0,2,0,0,0,0,0,0,1,0,1,0,0,0,0,0,0,0,0,0
219000,25000,250,0,-2,2,0,2,0,0,0,0,0,0,0,0,0,0,0,0,0,0,0,2,0,2,0,0,0,0,0,0,0,0,0
219091,25000,250,0,-2,4,1,3,0,0,0,0,0,0,0,0,0,0,0,0,0,0,0,4,1,3,0,0,0,0,0,0,0,0,0
219189,25000,250,0,-2,5,0,5,1,0,1,0,0,0,0,0,0,0,0,0,0,0,0,4,0,4,0,0,0,0,0,0,0,0,0
219198,25000,250,0,-2,4,3,1,0,0,0,0,0,0,0,0,0,0,0,0,0,0,0,3,2,1,0,0,0,0,0,0,1,1,0
219204,25000,250,0,-2,10,2,8,0,0,0,0,0,0,0,0,0,2,1,1,0,0,0,6,1,5,2,0,2,0,0,0,0,0,0
219259,25000,250,0,-2,1,0,1,0,0,0,0,0,0,0,0,0,0,0,0,0,0,0,1,0,1,0,0,0,0,0,0,0,0,0
219277,25000,250,0,-2,6,1,5,6,1,5,0,0,0,0,0,0,0,0,0,0,0,0,0,0,0,0,0,0,0,0,0,0,0,0
219295,25000,250,0,-2,2,2,0,0,0,0,0,0,0,0,0,0,0,0,0,1,1,0,0,0,0,1,1,0,0,0,0,0,0,0
219356,25000,250,0,-2,8,2,6,2,0,2,0,0,0,2,1,1,0,0,0,0,0,0,4,1,3,0,0,0,0,0,0,0,0,0
219374,25000,250,0,-2,2,0,2,2,0,2,0,0,0,0,0,0,0,0,0,0,0,0,0,0,0,0,0,0,0,0,0,0,0,0
219408,25000,250,0,-2,1,0,1,1,0,1,0,0,0,0,0,0,0,0,0,0,0,0,0,0,0,0,0,0,0,0,0,0,0,0
219471,25000,250,0,-2,6,1,5,1,0,1,0,0,0,1,0,1,0,0,0,0,0,0,4,1,3,0,0,0,0,0,0,0,0,0
219480,25000,250,0,-2,7,1,6,0,0,0,0,0,0,0,0,0,0,0,0,0,0,0,7,1,6,0,0,0,0,0,0,0,0,0
219505,25000,250,0,-2,3,0,3,0,0,0,0,0,0,3,0,3,0,0,0,0,0,0,0,0,0,0,0,0,0,0,0,0,0,0
219602,25000,250,0,-2,16,4,12,0,0,0,0,0,0,7,2,5,0,0,0,0,0,0,8,1,7,1,1,0,0,0,0,0,0,0
219709,25000,250,0,-2,7,1,6,0,0,0,0,0,0,1,0,1,0,0,0,0,0,0,6,1,5,0,0,0,0,0,0,0,0,0
219718,25000,250,0,-2,2,0,2,0,0,0,0,0,0,0,0,0,0,0,0,0,0,0,2,0,2,0,0,0,0,0,0,0,0,0
219790,25000,250,0,-2,3,0,3,0,0,0,0,0,0,0,0,0,0,0,0,0,0,0,3,0,3,0,0,0,0,0,0,0,0,0
219824,25000,250,0,-2,5,2,3,0,0,0,0,0,0,1,0,1,1,1,0,0,0,0,3,1,2,0,0,0,0,0,0,0,0,0
219833,25000,250,0,-2,22,12,10,0,0,0,0,0,0,12,7,5,0,0,0,0,0,0,8,4,4,0,0,0,2,1,1,0,0,0
219879,25000,250,0,-2,8,2,6,0,0,0,0,0,0,2,1,1,1,0,1,0,0,0,5,1,4,0,0,0,0,0,0,0,0,0
219888,25000,250,0,-2,1,0,1,0,0,0,0,0,0,0,0,0,0,0,0,0,0,0,1,0,1,0,0,0,0,0,0,0,0,0
219903,25000,250,0,-2,1,1,0,0,0,0,0,0,0,1,1,0,0,0,0,0,0,0,0,0,0,0,0,0,0,0,0,0,0,0
219949,25000,250,0,-2,6,1,5,0,0,0,0,0,0,0,0,0,0,0,0,0,0,0,3,0,3,0,0,0,3,1,2,0,0,0
219976,25000,250,0,-2,10,3,7,0,0,0,0,0,0,1,0,1,0,0,0,0,0,0,8,2,6,0,0,0,1,1,0,0,0,0
220057,25000,250,0,-2,2,1,1,0,0,0,0,0,0,0,0,0,0,0,0,0,0,0,2,1,1,0,0,0,0,0,0,0,0,0
220075,25000,250,0,-2,2,0,2,0,0,0,0,0,0,1,0,1,0,0,0,0,0,0,1,0,1,0,0,0,0,0,0,0,0,0
220118,25000,250,0,-2,2,0,2,0,0,0,0,0,0,0,0,0,0,0,0,0,0,0,2,0,2,0,0,0,0,0,0,0,0,0
220206,25000,250,0,-2,2,1,1,0,0,0,0,0,0,0,0,0,0,0,0,0,0,0,2,1,1,0,0,0,0,0,0,0,0,0
220215,25000,250,0,-2,1,0,1,0,0,0,0,0,0,0,0,0,0,0,0,0,0,0,1,0,1,0,0,0,0,0,0,0,0,0
220473,25000,250,0,-2,3,0,3,0,0,0,0,0,0,0,0,0,0,0,0,0,0,0,3,0,3,0,0,0,0,0,0,0,0,0
220552,25000,250,0,-2,11,5,6,0,0,0,0,0,0,4,3,1,0,0,0,0,0,0,6,2,4,1,0,1,0,0,0,0,0,0
220598,25000,250,0,-2,3,2,1,0,0,0,0,0,0,2,2,0,0,0,0,0,0,0,1,0,1,0,0,0,0,0,0,0,0,0
220604,25000,250,0,-2,5,1,4,0,0,0,0,0,0,4,1,3,0,0,0,0,0,0,1,0,1,0,0,0,0,0,0,0,0,0
220613,25000,250,0,-2,1,1,0,0,0,0,0,0,0,0,0,0,0,0,0,0,0,0,1,1,0,0,0,0,0,0,0,0,0,0
220631,25000,250,0,-2,6,0,6,0,0,0,0,0,0,0,0,0,1,0,1,0,0,0,4,0,4,1,0,1,0,0,0,0,0,0
220710,25000,250,0,-2,4,1,3,0,0,0,0,0,0,0,0,0,0,0,0,0,0,0,4,1,3,0,0,0,0,0,0,0,0,0
220792,25000,250,0,-2,20,11,9,0,0,0,1,1,0,8,3,5,0,0,0,0,0,0,11,7,4,0,0,0,0,0,0,0,0,0
220862,25000,250,0,-2,73,24,49,0,0,0,0,0,0,21,4,17,3,0,3,0,0,0,43,19,24,3,1,2,3,0,3,0,0,0
220978,25000,250,0,-2,1,0,1,0,0,0,0,0,0,0,0,0,0,0,0,0,0,0,1,0,1,0,0,0,0,0,0,0,0,0
220996,25000,250,0,-2,3,0,3,0,0,0,0,0,0,2,0,2,1,0,1,0,0,0,0,0,0,0,0,0,0,0,0,0,0,0
221096,25000,250,0,-2,2,1,1,0,0,0,0,0,0,0,0,0,0,0,0,0,0,0,2,1,1,0,0,0,0,0,0,0,0,0
221148,25000,250,0,-2,3,0,3,0,0,0,0,0,0,0,0,0,0,0,0,0,0,0,3,0,3,0,0,0,0,0,0,0,0,0
221184,25000,250,0,-2,3,0,3,0,0,0,0,0,0,0,0,0,1,0,1,0,0,0,2,0,2,0,0,0,0,0,0,0,0,0
221351,25000,250,0,-2,1,1,0,0,0,0,0,0,0,1,1,0,0,0,0,0,0,0,0,0,0,0,0,0,0,0,0,0,0,0
221397,25000,250,0,-2,8,4,4,0,0,0,0,0,0,0,0,0,0,0,0,0,0,0,8,4,4,0,0,0,0,0,0,0,0,0
221485,25000,250,0,-2,3,0,3,0,0,0,0,0,0,3,0,3,0,0,0,0,0,0,0,0,0,0,0,0,0,0,0,0,0,0
221519,25000,250,0,-2,14,7,7,0,0,0,1,1,0,2,1,1,1,1,0,0,0,0,9,4,5,0,0,0,1,0,1,0,0,0
221661,25000,250,0,-2,1,0,1,0,0,0,0,0,0,0,0,0,0,0,0,0,0,0,1,0,1,0,0,0,0,0,0,0,0,0
221670,25000,250,0,-2,1,0,1,0,0,0,0,0,0,0,0,0,0,0,0,0,0,0,1,0,1,0,0,0,0,0,0,0,0,0
221731,25000,250,0,-2,1,1,0,0,0,0,0,0,0,0,0,0,0,0,0,0,0,0,1,1,0,0,0,0,0,0,0,0,0,0
221740,25000,250,0,-2,3,1,2,0,0,0,0,0,0,0,0,0,0,0,0,0,0,0,2,0,2,0,0,0,1,1,0,0,0,0
221759,25000,250,0,-2,62,18,44,0,0,0,0,0,0,7,0,7,1,0,1,0,0,0,54,18,36,0,0,0,0,0,0,0,0,0
221768,25000,250,0,-2,1,0,1,0,0,0,0,0,0,0,0,0,0,0,0,0,0,0,1,0,1,0,0,0,0,0,0,0,0,0
221838,25000,250,0,-2,2,0,2,0,0,0,0,0,0,2,0,2,0,0,0,0,0,0,0,0,0,0,0,0,0,0,0,0,0,0
221847,25000,250,0,-2,9,1,8,0,0,0,0,0,0,0,0,0,0,0,0,0,0,0,8,1,7,0,0,0,1,0,1,0,0,0
221953,25000,250,0,-2,1,1,0,0,0,0,0,0,0,0,0,0,0,0,0,0,0,0,1,1,0,0,0,0,0,0,0,0,0,0
221971,25000,250,0,-2,9,5,4,0,0,0,0,0,0,1,0,1,0,0,0,0,0,0,7,5,2,0,0,0,1,0,1,0,0,0
221999,25000,250,0,-2,36,5,31,0,0,0,0,0,0,10,0,10,3,1,2,0,0,0,18,3,15,1,0,1,1,0,1,3,1,2
222062,25000,250,0,-2,2,1,1,0,0,0,0,0,0,0,0,0,0,0,0,0,0,0,1,0,1,0,0,0,1,1,0,0,0,0
222178,25000,250,0,-2,1,1,0,0,0,0,0,0,0,0,0,0,0,0,0,0,0,0,1,1,0,0,0,0,0,0,0,0,0,0
222497,25000,250,0,-2,18,6,12,0,0,0,0,0,0,3,1,2,11,4,7,0,0,0,4,1,3,0,0,0,0,0,0,0,0,0
222567,25000,250,0,-2,5,2,3,0,0,0,0,0,0,1,1,0,1,0,1,0,0,0,3,1,2,0,0,0,0,0,0,0,0,0
222576,25000,250,0,-2,3,0,3,0,0,0,0,0,0,0,0,0,0,0,0,0,0,0,3,0,3,0,0,0,0,0,0,0,0,0
222822,25000,250,0,-2,3,1,2,0,0,0,0,0,0,1,1,0,1,0,1,0,0,0,1,0,1,0,0,0,0,0,0,0,0,0
222831,25000,250,0,-2,7,2,5,0,0,0,0,0,0,0,0,0,3,1,2,0,0,0,4,1,3,0,0,0,0,0,0,0,0,0
222992,25000,250,0,-2,30,8,22,0,0,0,0,0,0,5,1,4,10,4,6,0,0,0,11,3,8,0,0,0,4,0,4,0,0,0
223083,25000,250,0,-2,2,0,2,0,0,0,1,0,1,1,0,1,0,0,0,0,0,0,0,0,0,0,0,0,0,0,0,0,0,0
223223,25000,250,0,-2,4,2,2,0,0,0,0,0,0,3,2,1,0,0,0,0,0,0,0,0,0,1,0,1,0,0,0,0,0,0
223232,25000,250,0,-2,40,15,25,0,0,0,1,1,0,2,0,2,4,1,3,0,0,0,31,11,20,0,0,0,1,1,0,1,1,0
223320,25000,250,0,-2,1,1,0,0,0,0,0,0,0,0,0,0,1,1,0,0,0,0,0,0,0,0,0,0,0,0,0,0,0,0
223427,25000,250,0,-2,12,4,8,0,0,0,0,0,0,4,1,3,0,0,0,0,0,0,8,3,5,0,0,0,0,0,0,0,0,0
223506,25000,250,0,-2,3,1,2,0,0,0,0,0,0,1,1,0,0,0,0,0,0,0,2,0,2,0,0,0,0,0,0,0,0,0
223816,25000,250,0,-2,4,1,3,0,0,0,0,0,0,1,0,1,1,0,1,0,0,0,2,1,1,0,0,0,0,0,0,0,0,0
224110,25000,250,0,-2,1,0,1,0,0,0,0,0,0,0,0,0,0,0,0,0,0,0,1,0,1,0,0,0,0,0,0,0,0,0
224147,25000,250,0,-2,4,1,3,0,0,0,0,0,0,0,0,0,2,0,2,0,0,0,1,0,1,0,0,0,0,0,0,1,1,0
224226,25000,250,0,-2,23,11,12,0,0,0,1,1,0,2,1,1,1,1,0,0,0,0,19,8,11,0,0,0,0,0,0,0,0,0
224244,25000,250,0,-2,1,1,0,0,0,0,0,0,0,0,0,0,0,0,0,0,0,0,1,1,0,0,0,0,0,0,0,0,0,0
224305,25000,250,0,-2,1,1,0,0,0,0,0,0,0,0,0,0,0,0,0,0,0,0,1,1,0,0,0,0,0,0,0,0,0,0
224323,25000,250,0,-2,4,3,1,0,0,0,1,0,1,0,0,0,1,1,0,0,0,0,2,2,0,0,0,0,0,0,0,0,0,0
224527,25000,250,0,-2,9,6,3,0,0,0,0,0,0,0,0,0,3,2,1,0,0,0,4,2,2,1,1,0,1,1,0,0,0,0
224554,25000,250,0,-2,7,1,6,0,0,0,0,0,0,2,0,2,0,0,0,0,0,0,5,1,4,0,0,0,0,0,0,0,0,0
224615,25000,250,0,-2,22,8,14,0,0,0,1,0,1,12,2,10,4,3,1,0,0,0,4,3,1,0,0,0,1,0,1,0,0,0
224776,25000,250,0,-2,1,0,1,0,0,0,0,0,0,1,0,1,0,0,0,0,0,0,0,0,0,0,0,0,0,0,0,0,0,0
224961,25000,250,0,-2,3,1,2,0,0,0,0,0,0,0,0,0,0,0,0,0,0,0,3,1,2,0,0,0,0,0,0,0,0,0
225070,25000,250,0,-2,12,4,8,0,0,0,0,0,0,1,0,1,1,0,1,0,0,0,9,3,6,0,0,0,1,1,0,0,0,0
225201,25000,250,0,-2,6,3,3,0,0,0,0,0,0,1,1,0,3,2,1,0,0,0,2,0,2,0,0,0,0,0,0,0,0,0
225247,25000,250,0,-2,2,0,2,0,0,0,0,0,0,0,0,0,0,0,0,0,0,0,2,0,2,0,0,0,0,0,0,0,0,0
225308,25000,250,0,-2,1,0,1,0,0,0,0,0,0,1,0,1,0,0,0,0,0,0,0,0,0,0,0,0,0,0,0,0,0,0
225371,25000,250,0,-2,3,1,2,0,0,0,0,0,0,0,0,0,1,0,1,0,0,0,2,1,1,0,0,0,0,0,0,0,0,0
225399,25000,250,0,-2,10,5,5,0,0,0,0,0,0,1,1,0,3,0,3,0,0,0,6,4,2,0,0,0,0,0,0,0,0,0
225414,25000,250,0,-2,2,0,2,0,0,0,0,0,0,0,0,0,2,0,2,0,0,0,0,0,0,0,0,0,0,0,0,0,0,0
225423,25000,250,0,-2,7,1,6,0,0,0,3,0,3,1,0,1,1,0,1,0,0,0,1,1,0,0,0,0,1,0,1,0,0,0
225502,25000,250,0,-2,2,1,1,0,0,0,0,0,0,0,0,0,0,0,0,0,0,0,2,1,1,0,0,0,0,0,0,0,0,0
225511,25000,250,0,-2,6,0,6,0,0,0,0,0,0,0,0,0,2,0,2,0,0,0,3,0,3,0,0,0,1,0,1,0,0,0
225520,25000,250,0,-2,5,0,5,0,0,0,0,0,0,0,0,0,3,0,3,0,0,0,2,0,2,0,0,0,0,0,0,0,0,0
225575,25000,250,0,-2,4,1,3,0,0,0,0,0,0,4,1,3,0,0,0,0,0,0,0,0,0,0,0,0,0,0,0,0,0,0
225627,25000,250,0,-2,2,0,2,0,0,0,0,0,0,0,0,0,1,0,1,0,0,0,1,0,1,0,0,0,0,0,0,0,0,0
225876,25000,250,0,-2,1,0,1,0,0,0,0,0,0,0,0,0,0,0,0,0,0,0,1,0,1,0,0,0,0,0,0,0,0,0
225885,25000,250,0,-2,12,6,6,0,0,0,0,0,0,9,4,5,1,1,0,0,0,0,2,1,1,0,0,0,0,0,0,0,0,0
226019,25000,250,0,-2,6,1,5,0,0,0,0,0,0,0,0,0,0,0,0,0,0,0,6,1,5,0,0,0,0,0,0,0,0,0
226091,25000,250,0,-2,33,6,27,0,0,0,0,0,0,10,2,8,1,0,1,0,0,0,20,3,17,1,0,1,1,1,0,0,0,0
226134,25000,250,0,-2,7,2,5,0,0,0,0,0,0,0,0,0,7,2,5,0,0,0,0,0,0,0,0,0,0,0,0,0,0,0
226152,25000,250,0,-2,3,1,2,0,0,0,0,0,0,0,0,0,3,1,2,0,0,0,0,0,0,0,0,0,0,0,0,0,0,0
226204,25000,250,0,-2,5,2,3,0,0,0,0,0,0,1,1,0,2,0,2,0,0,0,2,1,1,0,0,0,0,0,0,0,0,0
226277,25000,250,0,-2,3,0,3,0,0,0,0,0,0,0,0,0,1,0,1,0,0,0,1,0,1,1,0,1,0,0,0,0,0,0
226408,25000,250,0,-2,2,1,1,0,0,0,0,0,0,0,0,0,1,1,0,0,0,0,1,0,1,0,0,0,0,0,0,0,0,0
226471,25000,250,0,-2,4,0,4,0,0,0,0,0,0,1,0,1,0,0,0,0,0,0,1,0,1,1,0,1,1,0,1,0,0,0
226578,25000,250,0,-2,4,0,4,0,0,0,0,0,0,1,0,1,0,0,0,0,0,0,3,0,3,0,0,0,0,0,0,0,0,0
226587,25000,250,0,-2,2,1,1,0,0,0,0,0,0,1,0,1,0,0,0,0,0,0,1,1,0,0,0,0,0,0,0,0,0,0
226806,25000,250,0,-2,6,0,6,0,0,0,0,0,0,0,0,0,2,0,2,0,0,0,4,0,4,0,0,0,0,0,0,0,0,0
226833,25000,250,0,-2,6,1,5,0,0,0,0,0,0,1,0,1,1,0,1,0,0,0,3,1,2,0,0,0,0,0,0,1,0,1
226879,25000,250,0,-2,2,0,2,0,0,0,0,0,0,0,0,0,0,0,0,0,0,0,2,0,2,0,0,0,0,0,0,0,0,0
227146,25000,250,0,-2,9,7,2,0,0,0,0,0,0,2,1,1,2,2,0,0,0,0,5,4,1,0,0,0,0,0,0,0,0,0
227182,25000,250,0,-2,1,0,1,0,0,0,0,0,0,0,0,0,1,0,1,0,0,0,0,0,0,0,0,0,0,0,0,0,0,0
227216,25000,250,0,-2,49,18,31,0,0,0,2,1,1,9,5,4,7,3,4,0,0,0,28,7,21,2,1,1,1,1,0,0,0,0
227225,25000,250,0,-2,4,2,2,0,0,0,0,0,0,1,1,0,0,0,0,0,0,0,3,1,2,0,0,0,0,0,0,0,0,0
227304,25000,250,0,-2,12,4,8,0,0,0,0,0,0,2,1,1,4,1,3,0,0,0,6,2,4,0,0,0,0,0,0,0,0,0
227368,25000,250,0,-2,3,2,1,0,0,0,0,0,0,0,0,0,3,2,1,0,0,0,0,0,0,0,0,0,0,0,0,0,0,0
227386,25000,250,0,-2,1,0,1,0,0,0,0,0,0,0,0,0,0,0,0,0,0,0,1,0,1,0,0,0,0,0,0,0,0,0
227401,25000,250,0,-2,9,4,5,0,0,0,0,0,0,3,2,1,2,1,1,0,0,0,4,1,3,0,0,0,0,0,0,0,0,0
227526,25000,250,0,-2,13,4,9,0,0,0,0,0,0,9,3,6,2,0,2,0,0,0,2,1,1,0,0,0,0,0,0,0,0,0
227687,25000,250,0,-2,2,0,2,0,0,0,0,0,0,0,0,0,0,0,0,0,0,0,2,0,2,0,0,0,0,0,0,0,0,0
227757,25000,250,0,-2,36,7,29,1,0,1,3,0,3,9,0,9,10,3,7,0,0,0,12,4,8,1,0,1,0,0,0,0,0,0
227845,25000,250,0,-2,3,0,3,0,0,0,0,0,0,0,0,0,0,0,0,0,0,0,3,0,3,0,0,0,0,0,0,0,0,0
227854,25000,250,0,-2,8,3,5,0,0,0,0,0,0,2,1,1,5,2,3,0,0,0,1,0,1,0,0,0,0,0,0,0,0,0
227863,25000,250,0,-2,1,0,1,0,0,0,0,0,0,0,0,0,1,0,1,0,0,0,0,0,0,0,0,0,0,0,0,0,0,0
227881,25000,250,0,-2,17,4,13,0,0,0,0,0,0,1,1,0,3,1,2,0,0,0,13,2,11,0,0,0,0,0,0,0,0,0
227924,25000,250,0,-2,8,3,5,0,0,0,0,0,0,1,0,1,7,3,4,0,0,0,0,0,0,0,0,0,0,0,0,0,0,0
227979,25000,250,0,-2,17,5,12,0,0,0,1,0,1,4,2,2,8,3,5,0,0,0,3,0,3,0,0,0,0,0,0,1,0,1
228042,25000,250,0,-2,5,3,2,0,0,0,0,0,0,1,1,0,0,0,0,0,0,0,4,2,2,0,0,0,0,0,0,0,0,0
228149,25000,250,0,-2,5,3,2,0,0,0,0,0,0,0,0,0,4,2,2,0,0,0,0,0,0,1,1,0,0,0,0,0,0,0
228158,25000,250,0,-2,6,1,5,0,0,0,0,0,0,0,0,0,0,0,0,0,0,0,6,1,5,0,0,0,0,0,0,0,0,0
228246,25000,250,0,-2,6,0,6,0,0,0,1,0,1,0,0,0,0,0,0,0,0,0,5,0,5,0,0,0,0,0,0,0,0,0
228316,25000,250,0,-2,1,0,1,0,0,0,0,0,0,0,0,0,1,0,1,0,0,0,0,0,0,0,0,0,0,0,0,0,0,0
228325,25000,250,0,-2,5,2,3,0,0,0,0,0,0,0,0,0,2,0,2,0,0,0,3,2,1,0,0,0,0,0,0,0,0,0
228343,25000,250,0,-2,5,3,2,0,0,0,0,0,0,1,1,0,3,2,1,0,0,0,1,0,1,0,0,0,0,0,0,0,0,0
228431,25000,250,0,-2,21,3,18,0,0,0,0,0,0,2,0,2,3,0,3,0,0,0,14,2,12,2,1,1,0,0,0,0,0,0
228459,25000,250,0,-2,6,3,3,0,0,0,0,0,0,0,0,0,1,0,1,0,0,0,3,2,1,1,1,0,1,0,1,0,0,0
228529,25000,250,0,-2,9,3,6,0,0,0,0,0,0,0,0,0,0,0,0,0,0,0,9,3,6,0,0,0,0,0,0,0,0,0
228547,25000,250,0,-2,23,10,13,0,0,0,2,1,1,4,1,3,3,1,2,0,0,0,12,6,6,0,0,0,2,1,1,0,0,0
228644,25000,250,0,-2,5,1,4,0,0,0,0,0,0,1,0,1,0,0,0,0,0,0,3,1,2,0,0,0,1,0,1,0,0,0
228653,25000,250,0,-2,4,3,1,0,0,0,0,0,0,1,0,1,0,0,0,0,0,0,3,3,0,0,0,0,0,0,0,0,0,0
228699,25000,250,0,-2,4,1,3,0,0,0,0,0,0,2,1,1,0,0,0,0,0,0,2,0,2,0,0,0,0,0,0,0,0,0
228723,25000,250,0,-2,20,6,14,0,0,0,2,0,2,2,0,2,4,2,2,0,0,0,11,3,8,0,0,0,1,1,0,0,0,0
228769,25000,250,0,-2,38,10,28,0,0,0,2,2,0,2,0,2,8,1,7,0,0,0,17,3,14,2,2,0,7,2,5,0,0,0
228778,25000,250,0,-2,75,20,55,1,1,0,4,1,3,2,1,1,21,6,15,0,0,0,44,10,34,2,0,2,0,0,0,1,1,0
228787,25000,250,0,-2,10,0,10,0,0,0,0,0,0,1,0,1,3,0,3,0,0,0,5,0,5,1,0,1,0,0,0,0,0,0
228796,25000,250,0,-2,4,1,3,0,0,0,0,0,0,0,0,0,2,0,2,0,0,0,1,0,1,0,0,0,0,0,0,1,1,0
228802,25000,250,0,-2,15,1,14,0,0,0,0,0,0,1,1,0,1,0,1,0,0,0,11,0,11,0,0,0,2,0,2,0,0,0
228866,25000,250,0,-2,4,0,4,0,0,0,0,0,0,0,0,0,1,0,1,0,0,0,3,0,3,0,0,0,0,0,0,0,0,0
228875,25000,250,0,-2,4,1,3,0,0,0,1,1,0,1,0,1,0,0,0,0,0,0,1,0,1,1,0,1,0,0,0,0,0,0
228909,25000,250,0,-2,22,0,22,1,0,1,3,0,3,3,0,3,2,0,2,0,0,0,10,0,10,1,0,1,1,0,1,1,0,1
228981,25000,250,0,-2,1,1,0,0,0,0,0,0,0,0,0,0,1,1,0,0,0,0,0,0,0,0,0,0,0,0,0,0,0,0
229027,25000,250,0,-2,7,2,5,0,0,0,1,0,1,0,0,0,3,1,2,0,0,0,2,1,1,0,0,0,1,0,1,0,0,0
229063,25000,250,0,-2,5,0,5,0,0,0,0,0,0,5,0,5,0,0,0,0,0,0,0,0,0,0,0,0,0,0,0,0,0,0
229115,25000,250,0,-2,10,1,9,0,0,0,0,0,0,0,0,0,3,0,3,0,0,0,6,1,5,1,0,1,0,0,0,0,0,0
229160,25000,250,0,-2,5,1,4,0,0,0,0,0,0,1,0,1,0,0,0,0,0,0,2,0,2,0,0,0,2,1,1,0,0,0
229179,25000,250,0,-2,13,2,11,0,0,0,0,0,0,3,0,3,1,0,1,0,0,0,8,2,6,1,0,1,0,0,0,0,0,0
229267,25000,250,0,-2,8,2,6,0,0,0,0,0,0,1,1,0,3,0,3,0,0,0,4,1,3,0,0,0,0,0,0,0,0,0
229300,25000,250,0,-2,3,0,3,0,0,0,0,0,0,1,0,1,2,0,2,0,0,0,0,0,0,0,0,0,0,0,0,0,0,0
229355,25000,250,0,-2,1,0,1,0,0,0,0,0,0,0,0,0,0,0,0,0,0,0,1,0,1,0,0,0,0,0,0,0,0,0
229780,25000,250,0,-2,1,1,0,0,0,0,0,0,0,0,0,0,0,0,0,0,0,0,1,1,0,0,0,0,0,0,0,0,0,0
229799,25000,250,0,-2,1,0,1,0,0,0,0,0,0,0,0,0,0,0,0,0,0,0,0,0,0,0,0,0,1,0,1,0,0,0
229814,25000,250,0,-2,4,1,3,0,0,0,0,0,0,0,0,0,1,0,1,0,0,0,3,1,2,0,0,0,0,0,0,0,0,0
229832,25000,250,0,-2,2,1,1,0,0,0,0,0,0,0,0,0,1,0,1,0,0,0,1,1,0,0,0,0,0,0,0,0,0,0
229841,25000,250,0,-2,2,0,2,0,0,0,0,0,0,0,0,0,0,0,0,0,0,0,2,0,2,0,0,0,0,0,0,0,0,0
229887,25000,250,0,-2,1,1,0,0,0,0,0,0,0,1,1,0,0,0,0,0,0,0,0,0,0,0,0,0,0,0,0,0,0,0
230038,25000,250,0,-2,11,5,6,0,0,0,0,0,0,0,0,0,1,0,1,0,0,0,9,5,4,0,0,0,0,0,0,1,0,1
230171,25000,250,0,-2,7,5,2,1,0,1,0,0,0,0,0,0,0,0,0,0,0,0,6,5,1,0,0,0,0,0,0,0,0,0
230366,25000,250,0,-2,5,2,3,0,0,0,0,0,0,0,0,0,2,0,2,0,0,0,2,2,0,0,0,0,1,0,1,0,0,0
230418,25000,250,0,-2,3,1,2,0,0,0,0,0,0,0,0,0,0,0,0,0,0,0,3,1,2,0,0,0,0,0,0,0,0,0
230597,25000,250,0,-2,9,3,6,0,0,0,0,0,0,0,0,0,0,0,0,1,0,1,8,3,5,0,0,0,0,0,0,0,0,0
230603,25000,250,0,-2,49,22,27,0,0,0,0,0,0,1,1,0,7,3,4,0,0,0,41,18,23,0,0,0,0,0,0,0,0,0
230728,25000,250,0,-2,27,7,20,0,0,0,0,0,0,0,0,0,3,1,2,0,0,0,23,6,17,1,0,1,0,0,0,0,0,0
230737,25000,250,0,-2,52,15,37,0,0,0,1,0,1,2,1,1,6,2,4,0,0,0,40,10,30,1,0,1,1,1,0,1,1,0
230746,25000,250,0,-2,7,0,7,0,0,0,1,0,1,0,0,0,2,0,2,0,0,0,4,0,4,0,0,0,0,0,0,0,0,0
230764,25000,250,0,-2,83,21,62,1,0,1,4,1,3,1,0,1,15,2,13,0,0,0,48,17,31,1,0,1,7,1,6,6,0,6
230782,25000,250,0,-2,11,6,5,0,0,0,0,0,0,1,1,0,0,0,0,1,1,0,9,4,5,0,0,0,0,0,0,0,0,0
230807,25000,250,0,-2,5,2,3,0,0,0,1,0,1,0,0,0,1,0,1,0,0,0,3,2,1,0,0,0,0,0,0,0,0,0
230816,25000,250,0,-2,3,1,2,0,0,0,0,0,0,0,0,0,2,0,2,0,0,0,1,1,0,0,0,0,0,0,0,0,0,0
230834,25000,250,0,-2,2,0,2,0,0,0,0,0,0,0,0,0,0,0,0,0,0,0,2,0,2,0,0,0,0,0,0,0,0,0
230852,25000,250,0,-2,1,1,0,0,0,0,0,0,0,0,0,0,0,0,0,0,0,0,1,1,0,0,0,0,0,0,0,0,0,0
230861,25000,250,0,-2,3,2,1,0,0,0,0,0,0,1,1,0,0,0,0,0,0,0,2,1,1,0,0,0,0,0,0,0,0,0
230889,25000,250,0,-2,4,0,4,0,0,0,0,0,0,0,0,0,0,0,0,0,0,0,4,0,4,0,0,0,0,0,0,0,0,0
230913,25000,250,0,-2,2,1,1,0,0,0,0,0,0,0,0,0,0,0,0,0,0,0,2,1,1,0,0,0,0,0,0,0,0,0
230959,25000,250,0,-2,4,2,2,0,0,0,0,0,0,0,0,0,1,0,1,0,0,0,2,1,1,0,0,0,1,1,0,0,0,0
230995,25000,250,0,-2,5,2,3,0,0,0,0,0,0,0,0,0,0,0,0,0,0,0,5,2,3,0,0,0,0,0,0,0,0,0
231059,25000,250,0,-2,1,1,0,0,0,0,0,0,0,0,0,0,0,0,0,0,0,0,1,1,0,0,0,0,0,0,0,0,0,0
231068,25000,250,0,-2,7,2,5,0,0,0,0,0,0,1,0,1,0,0,0,0,0,0,6,2,4,0,0,0,0,0,0,0,0,0
231095,25000,250,0,-2,1,0,1,0,0,0,0,0,0,0,0,0,0,0,0,0,0,0,1,0,1,0,0,0,0,0,0,0,0,0
231147,25000,250,0,-2,6,0,6,0,0,0,0,0,0,0,0,0,0,0,0,0,0,0,6,0,6,0,0,0,0,0,0,0,0,0
231174,25000,250,0,-2,55,13,42,0,0,0,0,0,0,5,1,4,5,1,4,0,0,0,37,11,26,1,0,1,6,0,6,1,0,1
231554,25000,250,0,-2,8,3,5,0,0,0,0,0,0,3,1,2,0,0,0,0,0,0,5,2,3,0,0,0,0,0,0,0,0,0
231581,25000,250,0,-2,8,2,6,0,0,0,1,0,1,0,0,0,0,0,0,0,0,0,7,2,5,0,0,0,0,0,0,0,0,0
231624,25000,250,0,-2,26,5,21,0,0,0,1,1,0,6,0,6,1,1,0,0,0,0,17,3,14,0,0,0,0,0,0,1,0,1
231651,25000,250,0,-2,41,12,29,0,0,0,0,0,0,11,1,10,4,2,2,2,0,2,23,9,14,1,0,1,0,0,0,0,0,0
231697,25000,250,0,-2,2,2,0,0,0,0,0,0,0,0,0,0,0,0,0,0,0,0,2,2,0,0,0,0,0,0,0,0,0,0
231785,25000,250,0,-2,3,0,3,0,0,0,1,0,1,0,0,0,0,0,0,0,0,0,2,0,2,0,0,0,0,0,0,0,0,0
231873,25000,250,0,-2,1,0,1,0,0,0,0,0,0,0,0,0,0,0,0,0,0,0,1,0,1,0,0,0,0,0,0,0,0,0
231882,25000,250,0,-2,3,2,1,0,0,0,0,0,0,3,2,1,0,0,0,0,0,0,0,0,0,0,0,0,0,0,0,0,0,0
231970,25000,250,0,-2,6,1,5,0,0,0,0,0,0,1,1,0,1,0,1,0,0,0,3,0,3,1,0,1,0,0,0,0,0,0
232025,25000,250,0,-2,5,0,5,0,0,0,0,0,0,0,0,0,0,0,0,0,0,0,3,0,3,0,0,0,2,0,2,0,0,0
232186,25000,250,0,-2,37,6,31,1,0,1,4,1,3,4,0,4,3,1,2,0,0,0,24,4,20,1,0,1,0,0,0,0,0,0
232195,25000,250,0,-2,2,1,1,0,0,0,0,0,0,1,1,0,0,0,0,0,0,0,1,0,1,0,0,0,0,0,0,0,0,0
232265,25000,250,0,-2,2,0,2,0,0,0,0,0,0,1,0,1,1,0,1,0,0,0,0,0,0,0,0,0,0,0,0,0,0,0
232308,25000,250,0,-2,2,0,2,0,0,0,0,0,0,1,0,1,0,0,0,0,0,0,1,0,1,0,0,0,0,0,0,0,0,0
232414,25000,250,0,-2,7,1,6,0,0,0,0,0,0,2,0,2,0,0,0,0,0,0,4,1,3,1,0,1,0,0,0,0,0,0
232423,25000,250,0,-2,14,4,10,0,0,0,0,0,0,2,1,1,1,0,1,0,0,0,10,2,8,0,0,0,1,1,0,0,0,0
232450,25000,250,0,-2,4,0,4,0,0,0,0,0,0,4,0,4,0,0,0,0,0,0,0,0,0,0,0,0,0,0,0,0,0,0
232557,25000,250,0,-2,14,2,12,0,0,0,0,0,0,1,0,1,1,0,1,0,0,0,12,2,10,0,0,0,0,0,0,0,0,0
232566,25000,250,0,-2,4,0,4,0,0,0,0,0,0,0,0,0,0,0,0,0,0,0,4,0,4,0,0,0,0,0,0,0,0,0
232575,25000,250,0,-2,2,0,2,0,0,0,0,0,0,0,0,0,0,0,0,0,0,0,1,0,1,1,0,1,0,0,0,0,0,0
232609,25000,250,0,-2,4,2,2,0,0,0,0,0,0,1,0,1,0,0,0,0,0,0,1,1,0,0,0,0,2,1,1,0,0,0
232618,25000,250,0,-2,3,0,3,0,0,0,0,0,0,0,0,0,0,0,0,0,0,0,3,0,3,0,0,0,0,0,0,0,0,0
232672,25000,250,0,-2,2,1,1,0,0,0,0,0,0,0,0,0,0,0,0,0,0,0,1,1,0,1,0,1,0,0,0,0,0,0
232681,25000,250,0,-2,6,1,5,0,0,0,0,0,0,1,0,1,0,0,0,0,0,0,4,1,3,0,0,0,1,0,1,0,0,0
232706,25000,250,0,-2,13,5,8,0,0,0,1,1,0,2,1,1,1,0,1,0,0,0,9,3,6,0,0,0,0,0,0,0,0,0
232885,25000,250,0,-2,2,0,2,0,0,0,0,0,0,1,0,1,0,0,0,0,0,0,1,0,1,0,0,0,0,0,0,0,0,0
232946,25000,250,0,-2,5,2,3,0,0,0,2,1,1,0,0,0,0,0,0,0,0,0,1,0,1,1,0,1,1,1,0,0,0,0
232982,25000,250,0,-2,17,5,12,0,0,0,0,0,0,4,2,2,1,0,1,0,0,0,9,1,8,1,1,0,1,0,1,1,1,0
233019,25000,250,0,-2,2,1,1,0,0,0,0,0,0,1,0,1,0,0,0,0,0,0,1,1,0,0,0,0,0,0,0,0,0,0
233037,25000,250,0,-2,1,1,0,0,0,0,0,0,0,1,1,0,0,0,0,0,0,0,0,0,0,0,0,0,0,0,0,0,0,0
233116,25000,250,0,-2,3,0,3,0,0,0,0,0,0,1,0,1,0,0,0,0,0,0,2,0,2,0,0,0,0,0,0,0,0,0
233277,25000,250,0,-2,7,4,3,0,0,0,0,0,0,1,1,0,0,0,0,0,0,0,6,3,3,0,0,0,0,0,0,0,0,0
233295,25000,250,0,-2,14,5,9,0,0,0,0,0,0,5,2,3,0,0,0,0,0,0,8,3,5,1,0,1,0,0,0,0,0,0
233301,25000,250,0,-2,1,1,0,0,0,0,0,0,0,0,0,0,0,0,0,0,0,0,1,1,0,0,0,0,0,0,0,0,0,0
233310,25000,250,0,-2,1,0,1,0,0,0,0,0,0,1,0,1,0,0,0,0,0,0,0,0,0,0,0,0,0,0,0,0,0,0
233329,25000,250,0,-2,1,0,1,0,0,0,0,0,0,0,0,0,1,0,1,0,0,0,0,0,0,0,0,0,0,0,0,0,0,0
233374,25000,250,0,-2,12,4,8,0,0,0,0,0,0,5,3,2,0,0,0,0,0,0,7,1,6,0,0,0,0,0,0,0,0,0
233426,25000,250,0,-2,1,0,1,0,0,0,0,0,0,0,0,0,0,0,0,0,0,0,1,0,1,0,0,0,0,0,0,0,0,0
233541,25000,250,0,-2,4,1,3,0,0,0,0,0,0,0,0,0,0,0,0,1,0,1,3,1,2,0,0,0,0,0,0,0,0,0
233639,25000,250,0,-2,3,0,3,0,0,0,0,0,0,1,0,1,0,0,0,0,0,0,2,0,2,0,0,0,0,0,0,0,0,0
233718,25000,250,0,-2,4,1,3,0,0,0,0,0,0,1,0,1,0,0,0,0,0,0,3,1,2,0,0,0,0,0,0,0,0,0
233754,25000,250,0,-2,3,0,3,0,0,0,0,0,0,3,0,3,0,0,0,0,0,0,0,0,0,0,0,0,0,0,0,0,0,0
233772,25000,250,0,-2,2,0,2,0,0,0,0,0,0,1,0,1,0,0,0,0,0,0,1,0,1,0,0,0,0,0,0,0,0,0
233897,25000,250,0,-2,2,1,1,0,0,0,0,0,0,0,0,0,0,0,0,0,0,0,2,1,1,0,0,0,0,0,0,0,0,0
233903,25000,250,0,-2,2,0,2,0,0,0,0,0,0,0,0,0,0,0,0,0,0,0,2,0,2,0,0,0,0,0,0,0,0,0
233921,25000,250,0,-2,1,0,1,0,0,0,0,0,0,0,0,0,0,0,0,0,0,0,1,0,1,0,0,0,0,0,0,0,0,0
233949,25000,250,0,-2,1,1,0,0,0,0,0,0,0,0,0,0,0,0,0,0,0,0,1,1,0,0,0,0,0,0,0,0,0,0
234030,25000,250,0,-2,47,15,32,0,0,0,2,0,2,9,1,8,3,1,2,0,0,0,33,13,20,0,0,0,0,0,0,0,0,0
234076,25000,250,0,-2,27,4,23,0,0,0,0,0,0,3,0,3,2,0,2,0,0,0,21,4,17,1,0,1,0,0,0,0,0,0
234085,25000,250,0,-2,1,1,0,0,0,0,0,0,0,0,0,0,0,0,0,0,0,0,1,1,0,0,0,0,0,0,0,0,0,0
234155,25000,250,0,-2,4,2,2,0,0,0,0,0,0,3,1,2,1,1,0,0,0,0,0,0,0,0,0,0,0,0,0,0,0,0
234164,25000,250,0,-2,1,0,1,0,0,0,0,0,0,1,0,1,0,0,0,0,0,0,0,0,0,0,0,0,0,0,0,0,0,0
234173,25000,250,0,-2,3,1,2,0,0,0,0,0,0,0,0,0,0,0,0,0,0,0,3,1,2,0,0,0,0,0,0,0,0,0
234669,25000,250,0,-2,4,1,3,0,0,0,1,0,1,1,1,0,0,0,0,0,0,0,2,0,2,0,0,0,0,0,0,0,0,0
234827,25000,250,0,-2,3,0,3,0,0,0,0,0,0,0,0,0,1,0,1,0,0,0,2,0,2,0,0,0,0,0,0,0,0,0
234845,25000,250,0,-2,1,0,1,0,0,0,0,0,0,0,0,0,0,0,0,0,0,0,1,0,1,0,0,0,0,0,0,0,0,0
234915,25000,250,0,-2,4,3,1,0,0,0,0,0,0,0,0,0,0,0,0,0,0,0,4,3,1,0,0,0,0,0,0,0,0,0
234933,25000,250,0,-2,3,2,1,0,0,0,0,0,0,0,0,0,0,0,0,0,0,0,2,1,1,1,1,0,0,0,0,0,0,0
234951,25000,250,0,-2,3,1,2,0,0,0,1,1,0,0,0,0,0,0,0,0,0,0,1,0,1,1,0,1,0,0,0,0,0,0
234979,25000,250,0,-2,1,1,0,0,0,0,0,0,0,0,0,0,0,0,0,0,0,0,1,1,0,0,0,0,0,0,0,0,0,0
235024,25000,250,0,-2,1,1,0,0,0,0,0,0,0,0,0,0,0,0,0,0,0,0,1,1,0,0,0,0,0,0,0,0,0,0
235097,25000,250,0,-2,17,6,11,1,0,1,0,0,0,0,0,0,4,1,3,0,0,0,12,5,7,0,0,0,0,0,0,0,0,0
235103,25000,250,0,-2,2,0,2,0,0,0,0,0,0,0,0,0,1,0,1,0,0,0,1,0,1,0,0,0,0,0,0,0,0,0
235149,25000,250,0,-2,6,0,6,0,0,0,1,0,1,0,0,0,1,0,1,0,0,0,2,0,2,0,0,0,2,0,2,0,0,0
235167,25000,250,0,-2,4,0,4,0,0,0,0,0,0,1,0,1,2,0,2,0,0,0,0,0,0,0,0,0,1,0,1,0,0,0
235316,25000,250,0,-2,1,0,1,0,0,0,0,0,0,0,0,0,0,0,0,0,0,0,0,0,0,0,0,0,1,0,1,0,0,0
235431,25000,250,0,-2,2,1,1,0,0,0,1,0,1,0,0,0,0,0,0,0,0,0,1,1,0,0,0,0,0,0,0,0,0,0
235671,25000,250,0,-2,1,0,1,0,0,0,0,0,0,0,0,0,0,0,0,0,0,0,1,0,1,0,0,0,0,0,0,0,0,0
235699,25000,250,0,-2,5,2,3,0,0,0,0,0,0,0,0,0,1,0,1,0,0,0,3,2,1,1,0,1,0,0,0,0,0,0
235750,25000,250,0,-2,5,1,4,0,0,0,0,0,0,0,0,0,2,0,2,0,0,0,2,1,1,1,0,1,0,0,0,0,0,0
236188,25000,250,0,-2,2,0,2,0,0,0,0,0,0,0,0,0,0,0,0,0,0,0,2,0,2,0,0,0,0,0,0,0,0,0
236212,25000,250,0,-2,1,0,1,0,0,0,0,0,0,0,0,0,1,0,1,0,0,0,0,0,0,0,0,0,0,0,0,0,0,0
236230,25000,250,0,-2,2,0,2,0,0,0,0,0,0,0,0,0,0,0,0,0,0,0,2,0,2,0,0,0,0,0,0,0,0,0
236258,25000,250,0,-2,7,1,6,0,0,0,0,0,0,0,0,0,0,0,0,0,0,0,5,1,4,1,0,1,1,0,1,0,0,0
236328,25000,250,0,-2,2,1,1,0,0,0,0,0,0,0,0,0,0,0,0,0,0,0,2,1,1,0,0,0,0,0,0,0,0,0
236382,25000,250,0,-2,1,1,0,0,0,0,1,1,0,0,0,0,0,0,0,0,0,0,0,0,0,0,0,0,0,0,0,0,0,0
236452,25000,250,0,-2,1,1,0,0,0,0,0,0,0,1,1,0,0,0,0,0,0,0,0,0,0,0,0,0,0,0,0,0,0,0
236513,25000,250,0,-2,3,3,0,0,0,0,0,0,0,0,0,0,0,0,0,0,0,0,0,0,0,0,0,0,3,3,0,0,0,0
236577,25000,250,0,-2,1,0,1,0,0,0,0,0,0,0,0,0,0,0,0,0,0,0,1,0,1,0,0,0,0,0,0,0,0,0
236638,25000,250,0,-2,5,0,5,0,0,0,0,0,0,0,0,0,1,0,1,0,0,0,3,0,3,1,0,1,0,0,0,0,0,0
236656,25000,250,0,-2,1,1,0,0,0,0,0,0,0,0,0,0,0,0,0,0,0,0,1,1,0,0,0,0,0,0,0,0,0,0
236692,25000,250,0,-2,12,4,8,0,0,0,0,0,0,0,0,0,1,0,1,0,0,0,10,3,7,0,0,0,1,1,0,0,0,0
236708,25000,250,0,-2,18,3,15,1,0,1,2,1,1,0,0,0,2,0,2,2,0,2,9,1,8,1,0,1,1,1,0,0,0,0
236753,25000,250,0,-2,4,2,2,0,0,0,0,0,0,1,0,1,1,1,0,0,0,0,2,1,1,0,0,0,0,0,0,0,0,0
236887,25000,250,0,-2,1,0,1,0,0,0,0,0,0,0,0,0,0,0,0,0,0,0,1,0,1,0,0,0,0,0,0,0,0,0
236896,25000,250,0,-2,1,0,1,0,0,0,0,0,0,0,0,0,1,0,1,0,0,0,0,0,0,0,0,0,0,0,0,0,0,0
236939,25000,250,0,-2,23,5,18,0,0,0,0,0,0,0,0,0,5,0,5,0,0,0,10,3,7,1,0,1,6,2,4,1,0,1
236948,25000,250,0,-2,89,18,71,2,1,1,7,1,6,8,0,8,7,1,6,0,0,0,49,10,39,8,3,5,8,2,6,0,0,0
237011,25000,250,0,-2,6,1,5,0,0,0,0,0,0,0,0,0,1,1,0,0,0,0,1,0,1,3,0,3,0,0,0,1,0,1
237066,25000,250,0,-2,1,0,1,0,0,0,0,0,0,0,0,0,0,0,0,0,0,0,1,0,1,0,0,0,0,0,0,0,0,0
237109,25000,250,0,-2,2,1,1,0,0,0,0,0,0,0,0,0,1,1,0,0,0,0,1,0,1,0,0,0,0,0,0,0,0,0
237118,25000,250,0,-2,4,3,1,0,0,0,0,0,0,0,0,0,0,0,0,0,0,0,4,3,1,0,0,0,0,0,0,0,0,0
237181,25000,250,0,-2,3,2,1,0,0,0,0,0,0,0,0,0,0,0,0,0,0,0,3,2,1,0,0,0,0,0,0,0,0,0
237312,25000,250,0,-2,3,3,0,0,0,0,0,0,0,0,0,0,0,0,0,0,0,0,3,3,0,0,0,0,0,0,0,0,0,0
237358,25000,250,0,-2,8,1,7,0,0,0,0,0,0,0,0,0,0,0,0,0,0,0,8,1,7,0,0,0,0,0,0,0,0,0
237367,25000,250,0,-2,1,0,1,0,0,0,0,0,0,0,0,0,0,0,0,0,0,0,1,0,1,0,0,0,0,0,0,0,0,0
237385,25000,250,0,-2,2,1,1,0,0,0,0,0,0,1,0,1,0,0,0,0,0,0,1,1,0,0,0,0,0,0,0,0,0,0
237525,25000,250,0,-2,8,3,5,0,0,0,2,0,2,2,2,0,0,0,0,0,0,0,4,1,3,0,0,0,0,0,0,0,0,0
237686,25000,250,0,-2,3,1,2,0,0,0,0,0,0,0,0,0,0,0,0,0,0,0,3,1,2,0,0,0,0,0,0,0,0,0
237783,25000,250,0,-2,3,2,1,0,0,0,0,0,0,2,1,1,0,0,0,0,0,0,0,0,0,1,1,0,0,0,0,0,0,0
237792,25000,250,0,-2,5,1,4,0,0,0,0,0,0,2,1,1,1,0,1,0,0,0,2,0,2,0,0,0,0,0,0,0,0,0
237817,25000,250,0,-2,1,0,1,0,0,0,0,0,0,0,0,0,0,0,0,0,0,0,1,0,1,0,0,0,0,0,0,0,0,0
237969,25000,250,0,-2,2,0,2,0,0,0,0,0,0,1,0,1,0,0,0,0,0,0,1,0,1,0,0,0,0,0,0,0,0,0
238014,25000,250,0,-2,1,0,1,0,0,0,0,0,0,0,0,0,0,0,0,0,0,0,1,0,1,0,0,0,0,0,0,0,0,0
238032,25000,250,0,-2,4,1,3,0,0,0,0,0,0,0,0,0,0,0,0,0,0,0,4,1,3,0,0,0,0,0,0,0,0,0
238078,25000,250,0,-2,4,2,2,0,0,0,0,0,0,0,0,0,0,0,0,0,0,0,4,2,2,0,0,0,0,0,0,0,0,0
238193,25000,250,0,-2,4,1,3,0,0,0,0,0,0,0,0,0,0,0,0,0,0,0,4,1,3,0,0,0,0,0,0,0,0,0
238324,25000,250,0,-2,3,1,2,0,0,0,0,0,0,0,0,0,0,0,0,0,0,0,3,1,2,0,0,0,0,0,0,0,0,0
238333,25000,250,0,-2,1,0,1,0,0,0,0,0,0,0,0,0,1,0,1,0,0,0,0,0,0,0,0,0,0,0,0,0,0,0
238430,25000,250,0,-2,7,2,5,0,0,0,0,0,0,2,0,2,1,0,1,0,0,0,4,2,2,0,0,0,0,0,0,0,0,0
238458,25000,250,0,-2,3,0,3,0,0,0,0,0,0,0,0,0,1,0,1,0,0,0,2,0,2,0,0,0,0,0,0,0,0,0
238476,25000,250,0,-2,1,0,1,0,0,0,0,0,0,0,0,0,0,0,0,0,0,0,1,0,1,0,0,0,0,0,0,0,0,0
238616,25000,250,0,-2,11,1,10,0,0,0,0,0,0,1,0,1,0,0,0,0,0,0,10,1,9,0,0,0,0,0,0,0,0,0
238661,25000,250,0,-2,9,3,6,0,0,0,0,0,0,0,0,0,1,1,0,0,0,0,8,2,6,0,0,0,0,0,0,0,0,0
238722,25000,250,0,-2,5,2,3,0,0,0,0,0,0,1,1,0,0,0,0,0,0,0,4,1,3,0,0,0,0,0,0,0,0,0
238759,25000,250,0,-2,1,0,1,0,0,0,1,0,1,0,0,0,0,0,0,0,0,0,0,0,0,0,0,0,0,0,0,0,0,0
239220,25000,250,0,-2,5,2,3,0,0,0,0,0,0,0,0,0,0,0,0,0,0,0,5,2,3,0,0,0,0,0,0,0,0,0
239248,25000,250,0,-2,20,7,13,0,0,0,3,1,2,6,2,4,6,1,5,0,0,0,4,2,2,0,0,0,1,1,0,0,0,0
239318,25000,250,0,-2,13,3,10,0,0,0,1,0,1,1,0,1,0,0,0,0,0,0,9,3,6,2,0,2,0,0,0,0,0,0
239372,25000,250,0,-2,2,1,1,0,0,0,0,0,0,0,0,0,0,0,0,0,0,0,2,1,1,0,0,0,0,0,0,0,0,0
239390,25000,250,0,-2,11,1,10,0,0,0,0,0,0,2,0,2,3,1,2,0,0,0,6,0,6,0,0,0,0,0,0,0,0,0
239442,25000,250,0,-2,4,3,1,0,0,0,0,0,0,0,0,0,0,0,0,0,0,0,4,3,1,0,0,0,0,0,0,0,0,0
239460,25000,250,0,-2,5,2,3,0,0,0,0,0,0,0,0,0,0,0,0,0,0,0,5,2,3,0,0,0,0,0,0,0,0,0
239488,25000,250,0,-2,5,2,3,1,0,1,1,1,0,2,1,1,0,0,0,0,0,0,1,0,1,0,0,0,0,0,0,0,0,0
239512,25000,250,0,-2,2,0,2,2,0,2,0,0,0,0,0,0,0,0,0,0,0,0,0,0,0,0,0,0,0,0,0,0,0,0
239628,25000,250,0,-2,1,0,1,0,0,0,0,0,0,0,0,0,0,0,0,0,0,0,1,0,1,0,0,0,0,0,0,0,0,0
239716,25000,250,0,-2,2,1,1,0,0,0,0,0,0,0,0,0,0,0,0,0,0,0,1,1,0,1,0,1,0,0,0,0,0,0
239910,25000,250,0,-2,1,0,1,0,0,0,0,0,0,0,0,0,0,0,0,0,0,0,1,0,1,0,0,0,0,0,0,0,0,0
240116,25000,250,0,-2,2,1,1,0,0,0,1,0,1,0,0,0,0,0,0,0,0,0,1,1,0,0,0,0,0,0,0,0,0,0
240125,25000,250,0,-2,2,0,2,0,0,0,0,0,0,0,0,0,0,0,0,0,0,0,2,0,2,0,0,0,0,0,0,0,0,0
240198,25000,250,0,-2,5,2,3,1,1,0,0,0,0,0,0,0,0,0,0,0,0,0,4,1,3,0,0,0,0,0,0,0,0,0
240268,25000,250,0,-2,4,0,4,0,0,0,0,0,0,0,0,0,0,0,0,0,0,0,3,0,3,0,0,0,1,0,1,0,0,0
240277,25000,250,0,-2,4,2,2,0,0,0,1,1,0,0,0,0,0,0,0,0,0,0,3,1,2,0,0,0,0,0,0,0,0,0
240338,25000,250,0,-2,1,0,1,0,0,0,0,0,0,0,0,0,0,0,0,0,0,0,1,0,1,0,0,0,0,0,0,0,0,0
240365,25000,250,0,-2,4,3,1,0,0,0,0,0,0,0,0,0,0,0,0,0,0,0,3,2,1,0,0,0,1,1,0,0,0,0
240374,25000,250,0,-2,1,1,0,0,0,0,0,0,0,0,0,0,0,0,0,0,0,0,1,1,0,0,0,0,0,0,0,0,0,0
240392,25000,250,0,-2,54,13,41,1,0,1,1,0,1,9,2,7,4,0,4,0,0,0,37,10,27,2,1,1,0,0,0,0,0,0
240417,25000,250,0,-2,1,1,0,0,0,0,0,0,0,0,0,0,0,0,0,0,0,0,1,1,0,0,0,0,0,0,0,0,0,0
240426,25000,250,0,-2,4,1,3,0,0,0,0,0,0,0,0,0,0,0,0,0,0,0,4,1,3,0,0,0,0,0,0,0,0,0
240435,25000,250,0,-2,2,1,1,0,0,0,0,0,0,0,0,0,0,0,0,0,0,0,2,1,1,0,0,0,0,0,0,0,0,0
240444,25000,250,0,-2,13,3,10,0,0,0,1,0,1,3,1,2,1,0,1,0,0,0,8,2,6,0,0,0,0,0,0,0,0,0
240453,25000,250,0,-2,3,2,1,0,0,0,0,0,0,0,0,0,0,0,0,0,0,0,3,2,1,0,0,0,0,0,0,0,0,0
240505,25000,250,0,-2,2,1,1,0,0,0,0,0,0,0,0,0,0,0,0,0,0,0,1,0,1,0,0,0,1,1,0,0,0,0
240514,25000,250,0,-2,3,0,3,0,0,0,0,0,0,0,0,0,0,0,0,0,0,0,3,0,3,0,0,0,0,0,0,0,0,0
240596,25000,250,0,-2,1,1,0,0,0,0,0,0,0,0,0,0,0,0,0,0,0,0,1,1,0,0,0,0,0,0,0,0,0,0
240620,25000,250,0,-2,8,1,7,0,0,0,0,0,0,0,0,0,0,0,0,0,0,0,8,1,7,0,0,0,0,0,0,0,0,0
240666,25000,250,0,-2,8,3,5,0,0,0,0,0,0,0,0,0,1,0,1,0,0,0,7,3,4,0,0,0,0,0,0,0,0,0
240693,25000,250,0,-2,1,0,1,0,0,0,0,0,0,0,0,0,0,0,0,0,0,0,1,0,1,0,0,0,0,0,0,0,0,0
240718,25000,250,0,-2,2,0,2,1,0,1,0,0,0,0,0,0,0,0,0,0,0,0,1,0,1,0,0,0,0,0,0,0,0,0
240727,25000,250,0,-2,43,14,29,0,0,0,1,0,1,1,0,1,3,1,2,0,0,0,28,8,20,0,0,0,10,5,5,0,0,0
240745,25000,250,0,-2,15,9,6,0,0,0,7,4,3,0,0,0,0,0,0,4,3,1,2,1,1,1,1,0,0,0,0,1,0,1
241100,25000,250,0,-2,1,0,1,0,0,0,0,0,0,0,0,0,1,0,1,0,0,0,0,0,0,0,0,0,0,0,0,0,0,0
241216,25000,250,0,-2,1,0,1,0,0,0,0,0,0,0,0,0,1,0,1,0,0,0,0,0,0,0,0,0,0,0,0,0,0,0
241225,25000,250,0,-2,2,0,2,0,0,0,0,0,0,0,0,0,2,0,2,0,0,0,0,0,0,0,0,0,0,0,0,0,0,0
241331,25000,250,0,-2,1,0,1,0,0,0,0,0,0,0,0,0,1,0,1,0,0,0,0,0,0,0,0,0,0,0,0,0,0,0
241395,25000,250,0,-2,2,0,2,0,0,0,0,0,0,0,0,0,2,0,2,0,0,0,0,0,0,0,0,0,0,0,0,0,0,0
241410,25000,250,0,-2,5,2,3,0,0,0,0,0,0,0,0,0,5,2,3,0,0,0,0,0,0,0,0,0,0,0,0,0,0,0
241793,25000,250,0,-2,3,1,2,0,0,0,0,0,0,0,0,0,3,1,2,0,0,0,0,0,0,0,0,0,0,0,0,0,0,0
241836,25000,250,0,-2,3,1,2,0,0,0,0,0,0,0,0,0,3,1,2,0,0,0,0,0,0,0,0,0,0,0,0,0,0,0
242149,25000,250,0,-2,1,1,0,0,0,0,0,0,0,0,0,0,1,1,0,0,0,0,0,0,0,0,0,0,0,0,0,0,0,0
242565,25000,250,0,-2,1,1,0,0,0,0,0,0,0,0,0,0,1,1,0,0,0,0,0,0,0,0,0,0,0,0,0,0,0,0
242617,25000,250,0,-2,7,2,5,0,0,0,0,0,0,0,0,0,7,2,5,0,0,0,0,0,0,0,0,0,0,0,0,0,0,0
242635,25000,250,0,-2,8,1,7,0,0,0,0,0,0,0,0,0,8,1,7,0,0,0,0,0,0,0,0,0,0,0,0,0,0,0
242653,25000,250,0,-2,22,8,14,0,0,0,0,0,0,0,0,0,22,8,14,0,0,0,0,0,0,0,0,0,0,0,0,0,0,0
242662,25000,250,0,-2,14,2,12,0,0,0,0,0,0,0,0,0,14,2,12,0,0,0,0,0,0,0,0,0,0,0,0,0,0,0
242705,25000,250,0,-2,1,0,1,0,0,0,0,0,0,0,0,0,1,0,1,0,0,0,0,0,0,0,0,0,0,0,0,0,0,0
242972,25000,250,0,-2,12,4,8,0,0,0,0,0,0,0,0,0,12,4,8,0,0,0,0,0,0,0,0,0,0,0,0,0,0,0
243081,25000,250,0,-2,12,3,9,0,0,0,0,0,0,0,0,0,12,3,9,0,0,0,0,0,0,0,0,0,0,0,0,0,0,0
243443,25000,250,0,-2,28,9,19,0,0,0,0,0,0,0,0,0,28,9,19,0,0,0,0,0,0,0,0,0,0,0,0,0,0,0
243577,25000,250,0,-2,2,2,0,0,0,0,0,0,0,0,0,0,2,2,0,0,0,0,0,0,0,0,0,0,0,0,0,0,0,0
243638,25000,250,0,-2,3,0,3,0,0,0,0,0,0,0,0,0,0,0,0,3,0,3,0,0,0,0,0,0,0,0,0,0,0,0
243744,25000,250,0,-2,38,9,29,0,0,0,6,1,5,1,0,1,5,0,5,0,0,0,13,5,8,0,0,0,12,3,9,1,0,1
243780,25000,250,0,-2,50,17,33,0,0,0,1,0,1,4,1,3,1,1,0,0,0,0,37,13,24,2,0,2,3,1,2,2,1,1
243823,25000,250,0,-2,2,1,1,0,0,0,0,0,0,1,1,0,0,0,0,0,0,0,1,0,1,0,0,0,0,0,0,0,0,0
243832,25000,250,0,-2,4,1,3,0,0,0,0,0,0,0,0,0,4,1,3,0,0,0,0,0,0,0,0,0,0,0,0,0,0,0
243841,25000,250,0,-2,1,0,1,0,0,0,0,0,0,0,0,0,1,0,1,0,0,0,0,0,0,0,0,0,0,0,0,0,0,0
244446,25000,250,0,-2,13,5,8,0,0,0,1,1,0,11,4,7,0,0,0,0,0,0,1,0,1,0,0,0,0,0,0,0,0,0
245625,25000,250,0,-2,1,1,0,0,0,0,0,0,0,0,0,0,0,0,0,0,0,0,1,1,0,0,0,0,0,0,0,0,0,0
245953,25000,250,0,-2,11,3,8,0,0,0,0,0,0,2,1,1,2,1,1,0,0,0,7,1,6,0,0,0,0,0,0,0,0,0
245962,25000,250,0,-2,1,1,0,0,0,0,0,0,0,1,1,0,0,0,0,0,0,0,0,0,0,0,0,0,0,0,0,0,0,0
246354,25000,250,0,-2,14,5,9,0,0,0,1,1,0,1,0,1,10,3,7,0,0,0,2,1,1,0,0,0,0,0,0,0,0,0
246813,25000,250,0,-2,2,1,1,0,0,0,0,0,0,0,0,0,0,0,0,0,0,0,2,1,1,0,0,0,0,0,0,0,0,0
246974,25000,250,0,-2,2,1,1,0,0,0,0,0,0,1,1,0,0,0,0,0,0,0,0,0,0,0,0,0,1,0,1,0,0,0
247603,25000,250,0,-2,2,2,0,0,0,0,0,0,0,0,0,0,0,0,0,0,0,0,2,2,0,0,0,0,0,0,0,0,0,0
247649,25000,250,0,-2,6,2,4,0,0,0,0,0,0,0,0,0,0,0,0,0,0,0,6,2,4,0,0,0,0,0,0,0,0,0
247834,25000,250,0,-2,54,20,34,0,0,0,1,0,1,11,4,7,6,4,2,0,0,0,33,10,23,0,0,0,3,2,1,0,0,0
247940,25000,250,0,-2,2,1,1,0,0,0,0,0,0,1,1,0,0,0,0,0,0,0,1,0,1,0,0,0,0,0,0,0,0,0
248934,25000,250,0,-2,94,25,69,0,0,0,4,0,4,28,9,19,10,4,6,0,0,0,42,10,32,6,1,5,4,1,3,0,0,0
250027,25000,250,0,-2,1,0,1,0,0,0,0,0,0,0,0,0,0,0,0,0,0,0,1,0,1,0,0,0,0,0,0,0,0,0
251260,25000,250,0,-2,2,1,1,0,0,0,0,0,0,1,1,0,0,0,0,0,0,0,1,0,1,0,0,0,0,0,0,0,0,0
251312,25000,250,0,-2,3,1,2,0,0,0,0,0,0,1,1,0,0,0,0,0,0,0,2,0,2,0,0,0,0,0,0,0,0,0
260372,25000,250,0,-2,5,0,5,2,0,2,0,0,0,0,0,0,0,0,0,0,0,0,3,0,3,0,0,0,0,0,0,0,0,0
260691,25000,250,0,-2,3,1,2,0,0,0,0,0,0,0,0,0,1,0,1,0,0,0,2,1,1,0,0,0,0,0,0,0,0,0
260789,25000,250,0,-2,4,1,3,0,0,0,0,0,0,2,1,1,1,0,1,0,0,0,1,0,1,0,0,0,0,0,0,0,0,0
262031,25000,250,0,-2,4,1,3,0,0,0,0,0,0,1,1,0,0,0,0,0,0,0,3,0,3,0,0,0,0,0,0,0,0,0
262086,25000,250,0,-2,6,3,3,0,0,0,0,0,0,1,1,0,2,1,1,0,0,0,3,1,2,0,0,0,0,0,0,0,0,0
262129,25000,250,0,-2,1,0,1,0,0,0,0,0,0,0,0,0,0,0,0,0,0,0,1,0,1,0,0,0,0,0,0,0,0,0
262457,25000,250,0,-2,1,0,1,0,0,0,0,0,0,0,0,0,1,0,1,0,0,0,0,0,0,0,0,0,0,0,0,0,0,0
363633,25000,250,0,-2,2,0,2,0,0,0,0,0,0,0,0,0,0,0,0,0,0,0,2,0,2,0,0,0,0,0,0,0,0,0
363934,25000,250,0,-2,19,5,14,0,0,0,0,0,0,1,1,0,2,0,2,0,0,0,13,3,10,3,1,2,0,0,0,0,0,0
364016,25000,250,0,-2,2,2,0,0,0,0,0,0,0,0,0,0,0,0,0,0,0,0,2,2,0,0,0,0,0,0,0,0,0,0
364025,25000,250,0,-2,2,1,1,0,0,0,1,1,0,0,0,0,1,0,1,0,0,0,0,0,0,0,0,0,0,0,0,0,0,0
366340,25000,250,0,-2,3,0,3,1,0,1,0,0,0,0,0,0,0,0,0,0,0,0,1,0,1,0,0,0,0,0,0,1,0,1
366395,25000,250,0,-2,2,0,2,0,0,0,1,0,1,0,0,0,0,0,0,0,0,0,1,0,1,0,0,0,0,0,0,0,0,0
366553,25000,250,0,-2,19,8,11,0,0,0,0,0,0,2,2,0,5,3,2,0,0,0,8,1,7,4,2,2,0,0,0,0,0,0
366711,25000,250,0,-2,4,1,3,0,0,0,1,0,1,0,0,0,3,1,2,0,0,0,0,0,0,0,0,0,0,0,0,0,0,0
367459,25000,250,0,-2,20,7,13,1,1,0,0,0,0,0,0,0,1,0,1,0,0,0,17,6,11,0,0,0,1,0,1,0,0,0
367884,25000,250,0,-2,5,2,3,0,0,0,0,0,0,1,0,1,3,1,2,0,0,0,1,1,0,0,0,0,0,0,0,0,0,0
367954,25000,250,0,-2,24,7,17,0,0,0,1,0,1,3,1,2,3,2,1,0,0,0,14,3,11,3,1,2,0,0,0,0,0,0
368629,25000,250,0,-2,1,0,1,0,0,0,0,0,0,0,0,0,0,0,0,0,0,0,1,0,1,0,0,0,0,0,0,0,0,0
368911,25000,250,0,-2,6,0,6,0,0,0,0,0,0,0,0,0,0,0,0,0,0,0,6,0,6,0,0,0,0,0,0,0,0,0
376695,25000,250,0,-2,8,5,3,0,0,0,0,0,0,0,0,0,0,0,0,8,5,3,0,0,0,0,0,0,0,0,0,0,0,0
377555,25000,250,0,-2,8,4,4,0,0,0,0,0,0,1,1,0,1,1,0,0,0,0,3,1,2,1,0,1,2,1,1,0,0,0
377564,25000,250,0,-2,8,1,7,0,0,0,1,0,1,0,0,0,0,0,0,0,0,0,5,1,4,2,0,2,0,0,0,0,0,0
377661,25000,250,0,-2,3,1,2,0,0,0,0,0,0,2,0,2,0,0,0,0,0,0,0,0,0,1,1,0,0,0,0,0,0,0
378576,25000,250,0,-2,4,3,1,0,0,0,0,0,0,0,0,0,0,0,0,0,0,0,0,0,0,0,0,0,4,3,1,0,0,0
379746,25000,250,0,-2,1,0,1,0,0,0,0,0,0,0,0,0,0,0,0,0,0,0,1,0,1,0,0,0,0,0,0,0,0,0
380368,25000,250,0,-2,1,0,1,1,0,1,0,0,0,0,0,0,0,0,0,0,0,0,0,0,0,0,0,0,0,0,0,0,0,0
380377,25000,250,0,-2,4,1,3,3,0,3,0,0,0,0,0,0,0,0,0,0,0,0,1,1,0,0,0,0,0,0,0,0,0,0
383996,25000,250,0,-2,5,0,5,0,0,0,0,0,0,1,0,1,4,0,4,0,0,0,0,0,0,0,0,0,0,0,0,0,0,0
384254,25000,250,0,-2,17,6,11,0,0,0,0,0,0,3,0,3,1,0,1,0,0,0,13,6,7,0,0,0,0,0,0,0,0,0
384333,25000,250,0,-2,1,0,1,0,0,0,0,0,0,0,0,0,1,0,1,0,0,0,0,0,0,0,0,0,0,0,0,0,0,0
384342,25000,250,0,-2,5,0,5,0,0,0,0,0,0,1,0,1,2,0,2,0,0,0,2,0,2,0,0,0,0,0,0,0,0,0
385415,25000,250,0,-2,1,0,1,0,0,0,0,0,0,0,0,0,0,0,0,0,0,0,1,0,1,0,0,0,0,0,0,0,0,0
385619,25000,250,0,-2,3,0,3,0,0,0,0,0,0,0,0,0,1,0,1,0,0,0,2,0,2,0,0,0,0,0,0,0,0,0
386153,25000,250,0,-2,1,0,1,0,0,0,0,0,0,0,0,0,0,0,0,0,0,0,1,0,1,0,0,0,0,0,0,0,0,0
386472,25000,250,0,-2,5,1,4,0,0,0,0,0,0,2,1,1,0,0,0,0,0,0,3,0,3,0,0,0,0,0,0,0,0,0
392257,25000,250,0,-2,25,4,21,0,0,0,0,0,0,14,2,12,5,2,3,0,0,0,5,0,5,1,0,1,0,0,0,0,0,0
395362,25000,250,0,-2,2,1,1,0,0,0,0,0,0,0,0,0,1,0,1,0,0,0,1,1,0,0,0,0,0,0,0,0,0,0
399911,25000,250,0,-2,2,0,2,0,0,0,0,0,0,0,0,0,0,0,0,0,0,0,2,0,2,0,0,0,0,0,0,0,0,0
403478,25000,250,0,-2,1,0,1,0,0,0,0,0,0,0,0,0,0,0,0,0,0,0,1,0,1,0,0,0,0,0,0,0,0,0
404222,25000,250,0,-2,1,1,0,0,0,0,0,0,0,0,0,0,1,1,0,0,0,0,0,0,0,0,0,0,0,0,0,0,0,0
404426,25000,250,0,-2,3,2,1,0,0,0,0,0,0,1,1,0,0,0,0,0,0,0,2,1,1,0,0,0,0,0,0,0,0,0
404912,25000,250,0,-2,2,0,2,0,0,0,0,0,0,0,0,0,0,0,0,0,0,0,2,0,2,0,0,0,0,0,0,0,0,0
405872,25000,250,0,-2,3,1,2,0,0,0,0,0,0,1,0,1,0,0,0,0,0,0,1,1,0,1,0,1,0,0,0,0,0,0
406024,25000,250,0,-2,7,0,7,0,0,0,0,0,0,0,0,0,0,0,0,0,0,0,4,0,4,3,0,3,0,0,0,0,0,0
407629,25000,250,0,-2,3,0,3,0,0,0,0,0,0,1,0,1,0,0,0,0,0,0,2,0,2,0,0,0,0,0,0,0,0,0
409315,25000,250,0,-2,30,11,19,0,0,0,0,0,0,0,0,0,27,10,17,0,0,0,2,1,1,0,0,0,0,0,0,1,0,1
409379,25000,250,0,-2,8,0,8,0,0,0,0,0,0,1,0,1,0,0,0,0,0,0,7,0,7,0,0,0,0,0,0,0,0,0
409616,25000,250,0,-2,2,0,2,0,0,0,1,0,1,0,0,0,0,0,0,0,0,0,1,0,1,0,0,0,0,0,0,0,0,0
413617,25000,250,0,-2,1,0,1,0,0,0,0,0,0,0,0,0,0,0,0,0,0,0,1,0,1,0,0,0,0,0,0,0,0,0
413680,25000,250,0,-2,4,2,2,0,0,0,1,1,0,2,1,1,1,0,1,0,0,0,0,0,0,0,0,0,0,0,0,0,0,0
414461,25000,250,0,-2,20,2,18,0,0,0,0,0,0,0,0,0,20,2,18,0,0,0,0,0,0,0,0,0,0,0,0,0,0,0
414595,25000,250,0,-2,2,0,2,0,0,0,0,0,0,0,0,0,0,0,0,0,0,0,0,0,0,0,0,0,2,0,2,0,0,0
414939,25000,250,0,-2,3,1,2,0,0,0,0,0,0,1,0,1,0,0,0,0,0,0,0,0,0,0,0,0,2,1,1,0,0,0
416458,25000,250,0,-2,3,1,2,0,0,0,3,1,2,0,0,0,0,0,0,0,0,0,0,0,0,0,0,0,0,0,0,0,0,0
418126,25000,250,0,-2,1,0,1,0,0,0,0,0,0,0,0,0,0,0,0,0,0,0,1,0,1,0,0,0,0,0,0,0,0,0
419244,25000,250,0,-2,2,1,1,0,0,0,0,0,0,1,0,1,0,0,0,0,0,0,1,1,0,0,0,0,0,0,0,0,0,0
420246,25000,250,0,-2,2,1,1,0,0,0,0,0,0,0,0,0,2,1,1,0,0,0,0,0,0,0,0,0,0,0,0,0,0,0
420398,25000,250,0,-2,5,0,5,0,0,0,0,0,0,0,0,0,4,0,4,0,0,0,0,0,0,1,0,1,0,0,0,0,0,0
420440,25000,250,0,-2,4,1,3,0,0,0,0,0,0,0,0,0,0,0,0,0,0,0,4,1,3,0,0,0,0,0,0,0,0,0
420538,25000,250,0,-2,1,0,1,0,0,0,0,0,0,0,0,0,0,0,0,0,0,0,1,0,1,0,0,0,0,0,0,0,0,0
420556,25000,250,0,-2,1,0,1,0,0,0,0,0,0,0,0,0,0,0,0,0,0,0,1,0,1,0,0,0,0,0,0,0,0,0
421708,25000,250,0,-2,5,3,2,1,0,1,0,0,0,0,0,0,2,1,1,0,0,0,2,2,0,0,0,0,0,0,0,0,0,0
422020,25000,250,0,-2,2,1,1,0,0,0,0,0,0,2,1,1,0,0,0,0,0,0,0,0,0,0,0,0,0,0,0,0,0,0
423643,25000,250,0,-2,4,1,3,0,0,0,0,0,0,0,0,0,0,0,0,0,0,0,3,1,2,1,0,1,0,0,0,0,0,0
426314,25000,250,0,-2,19,5,14,0,0,0,3,2,1,1,1,0,2,0,2,0,0,0,12,2,10,0,0,0,1,0,1,0,0,0
428392,25000,250,0,-2,20,5,15,0,0,0,0,0,0,1,0,1,8,2,6,0,0,0,11,3,8,0,0,0,0,0,0,0,0,0
429094,25000,250,0,-2,2,0,2,0,0,0,0,0,0,1,0,1,1,0,1,0,0,0,0,0,0,0,0,0,0,0,0,0,0,0
429128,25000,250,0,-2,4,1,3,0,0,0,0,0,0,0,0,0,2,0,2,0,0,0,2,1,1,0,0,0,0,0,0,0,0,0
430704,25000,250,0,-2,1,0,1,0,0,0,0,0,0,0,0,0,0,0,0,0,0,0,1,0,1,0,0,0,0,0,0,0,0,0
431141,25000,250,0,-2,6,1,5,0,0,0,1,0,1,0,0,0,2,0,2,0,0,0,3,1,2,0,0,0,0,0,0,0,0,0
432348,25000,250,0,-2,1,0,1,0,0,0,0,0,0,0,0,0,0,0,0,0,0,0,1,0,1,0,0,0,0,0,0,0,0,0
432384,25000,250,0,-2,2,1,1,0,0,0,1,0,1,0,0,0,1,1,0,0,0,0,0,0,0,0,0,0,0,0,0,0,0,0
432524,25000,250,0,-2,1,0,1,0,0,0,0,0,0,0,0,0,0,0,0,0,0,0,1,0,1,0,0,0,0,0,0,0,0,0
433174,25000,250,0,-2,3,0,3,0,0,0,0,0,0,0,0,0,0,0,0,0,0,0,3,0,3,0,0,0,0,0,0,0,0,0
433387,25000,250,0,-2,105,36,69,0,0,0,3,1,2,13,3,10,10,4,6,1,0,1,73,27,46,3,1,2,2,0,2,0,0,0
433536,25000,250,0,-2,1,0,1,0,0,0,0,0,0,1,0,1,0,0,0,0,0,0,0,0,0,0,0,0,0,0,0,0,0,0
433660,25000,250,0,-2,11,2,9,0,0,0,0,0,0,2,1,1,1,0,1,0,0,0,8,1,7,0,0,0,0,0,0,0,0,0
434016,25000,250,0,-2,3,1,2,2,1,1,0,0,0,0,0,0,0,0,0,0,0,0,1,0,1,0,0,0,0,0,0,0,0,0
434061,25000,250,0,-2,1,0,1,0,0,0,0,0,0,0,0,0,0,0,0,0,0,0,1,0,1,0,0,0,0,0,0,0,0,0
434140,25000,250,0,-2,1,0,1,0,0,0,0,0,0,0,0,0,1,0,1,0,0,0,0,0,0,0,0,0,0,0,0,0,0,0
434584,25000,250,0,-2,4,3,1,0,0,0,0,0,0,0,0,0,1,1,0,1,1,0,2,1,1,0,0,0,0,0,0,0,0,0
434672,25000,250,0,-2,14,7,7,0,0,0,0,0,0,5,4,1,1,0,1,0,0,0,8,3,5,0,0,0,0,0,0,0,0,0
434821,25000,250,0,-2,2,0,2,0,0,0,0,0,0,2,0,2,0,0,0,0,0,0,0,0,0,0,0,0,0,0,0,0,0,0
435000,25000,250,0,-2,10,2,8,0,0,0,0,0,0,1,0,1,0,0,0,0,0,0,8,2,6,1,0,1,0,0,0,0,0,0
436304,25000,250,0,-2,1,0,1,0,0,0,0,0,0,1,0,1,0,0,0,0,0,0,0,0,0,0,0,0,0,0,0,0,0,0
436429,25000,250,0,-2,23,11,12,0,0,0,1,1,0,4,2,2,6,2,4,0,0,0,7,3,4,3,2,1,2,1,1,0,0,0
437635,25000,250,0,-2,9,0,9,0,0,0,1,0,1,4,0,4,3,0,3,0,0,0,1,0,1,0,0,0,0,0,0,0,0,0
437936,25000,250,0,-2,5,0,5,0,0,0,1,0,1,1,0,1,0,0,0,0,0,0,1,0,1,2,0,2,0,0,0,0,0,0
438179,25000,250,0,-2,2,0,2,0,0,0,0,0,0,0,0,0,0,0,0,0,0,0,2,0,2,0,0,0,0,0,0,0,0,0
438258,25000,250,0,-2,2,0,2,0,0,0,0,0,0,1,0,1,0,0,0,0,0,0,1,0,1,0,0,0,0,0,0,0,0,0
438498,25000,250,0,-2,4,2,2,0,0,0,0,0,0,0,0,0,1,0,1,0,0,0,3,2,1,0,0,0,0,0,0,0,0,0
438665,25000,250,0,-2,1,0,1,0,0,0,0,0,0,0,0,0,1,0,1,0,0,0,0,0,0,0,0,0,0,0,0,0,0,0
439118,25000,250,0,-2,5,0,5,0,0,0,0,0,0,0,0,0,1,0,1,0,0,0,4,0,4,0,0,0,0,0,0,0,0,0
439190,25000,250,0,-2,1,1,0,0,0,0,1,1,0,0,0,0,0,0,0,0,0,0,0,0,0,0,0,0,0,0,0,0,0,0
439570,25000,250,0,-2,1,0,1,0,0,0,0,0,0,0,0,0,0,0,0,0,0,0,1,0,1,0,0,0,0,0,0,0,0,0
439701,25000,250,0,-2,1,1,0,0,0,0,0,0,0,0,0,0,0,0,0,0,0,0,1,1,0,0,0,0,0,0,0,0,0,0
440031,25000,250,0,-2,6,1,5,1,0,1,1,0,1,1,0,1,0,0,0,0,0,0,3,1,2,0,0,0,0,0,0,0,0,0
440396,25000,250,0,-2,2,1,1,0,0,0,0,0,0,0,0,0,0,0,0,0,0,0,2,1,1,0,0,0,0,0,0,0,0,0
440651,25000,250,0,-2,3,0,3,0,0,0,0,0,0,0,0,0,3,0,3,0,0,0,0,0,0,0,0,0,0,0,0,0,0,0
440794,25000,250,0,-2,1,0,1,0,0,0,0,0,0,1,0,1,0,0,0,0,0,0,0,0,0,0,0,0,0,0,0,0,0,0
441052,25000,250,0,-2,1,1,0,0,0,0,0,0,0,0,0,0,0,0,0,0,0,0,1,1,0,0,0,0,0,0,0,0,0,0
441104,25000,250,0,-2,2,1,1,0,0,0,0,0,0,0,0,0,0,0,0,0,0,0,2,1,1,0,0,0,0,0,0,0,0,0
441131,25000,250,0,-2,2,0,2,0,0,0,0,0,0,0,0,0,1,0,1,0,0,0,1,0,1,0,0,0,0,0,0,0,0,0
441229,25000,250,0,-2,21,6,15,0,0,0,1,1,0,0,0,0,10,3,7,0,0,0,6,0,6,0,0,0,4,2,2,0,0,0
441371,25000,250,0,-2,177,38,139,1,0,1,4,1,3,57,11,46,35,12,23,0,0,0,60,12,48,11,1,10,9,1,8,0,0,0
441423,25000,250,0,-2,2,0,2,0,0,0,0,0,0,0,0,0,2,0,2,0,0,0,0,0,0,0,0,0,0,0,0,0,0,0
441760,25000,250,0,-2,8,4,4,0,0,0,0,0,0,1,1,0,1,0,1,0,0,0,4,2,2,0,0,0,1,1,0,1,0,1
441937,25000,250,0,-2,5,2,3,0,0,0,0,0,0,1,0,1,2,1,1,0,0,0,2,1,1,0,0,0,0,0,0,0,0,0
441982,25000,250,0,-2,3,0,3,0,0,0,0,0,0,1,0,1,1,0,1,0,0,0,1,0,1,0,0,0,0,0,0,0,0,0
442064,25000,250,0,-2,1,0,1,0,0,0,0,0,0,0,0,0,0,0,0,0,0,0,1,0,1,0,0,0,0,0,0,0,0,0
442295,25000,250,0,-2,4,0,4,0,0,0,0,0,0,0,0,0,0,0,0,0,0,0,4,0,4,0,0,0,0,0,0,0,0,0
442356,25000,250,0,-2,3,1,2,0,0,0,0,0,0,1,0,1,0,0,0,0,0,0,2,1,1,0,0,0,0,0,0,0,0,0
442444,25000,250,0,-2,6,1,5,0,0,0,0,0,0,2,0,2,4,1,3,0,0,0,0,0,0,0,0,0,0,0,0,0,0,0
442569,25000,250,0,-2,27,4,23,0,0,0,1,0,1,6,2,4,3,0,3,0,0,0,14,2,12,2,0,2,1,0,1,0,0,0
442781,25000,250,0,-2,3,1,2,2,0,2,0,0,0,0,0,0,0,0,0,0,0,0,1,1,0,0,0,0,0,0,0,0,0,0
442806,25000,250,0,-2,33,10,23,0,0,0,0,0,0,3,2,1,0,0,0,0,0,0,30,8,22,0,0,0,0,0,0,0,0,0
442842,25000,250,0,-2,1,0,1,0,0,0,0,0,0,0,0,0,0,0,0,0,0,0,0,0,0,0,0,0,1,0,1,0,0,0
443128,25000,250,0,-2,4,2,2,0,0,0,1,1,0,0,0,0,0,0,0,0,0,0,1,1,0,0,0,0,0,0,0,2,0,2
443331,25000,250,0,-2,2,1,1,0,0,0,0,0,0,0,0,0,0,0,0,0,0,0,2,1,1,0,0,0,0,0,0,0,0,0
444130,25000,250,0,-2,14,1,13,0,0,0,1,0,1,0,0,0,0,0,0,0,0,0,13,1,12,0,0,0,0,0,0,0,0,0
444787,25000,250,0,-2,71,11,60,0,0,0,4,1,3,5,1,4,8,1,7,1,0,1,44,5,39,5,2,3,4,1,3,0,0,0
444811,25000,250,0,-2,1,0,1,0,0,0,0,0,0,0,0,0,0,0,0,0,0,0,1,0,1,0,0,0,0,0,0,0,0,0
444954,25000,250,0,-2,5,1,4,0,0,0,1,0,1,0,0,0,0,0,0,0,0,0,4,1,3,0,0,0,0,0,0,0,0,0
445027,25000,250,0,-2,6,2,4,0,0,0,0,0,0,2,1,1,0,0,0,0,0,0,3,1,2,0,0,0,1,0,1,0,0,0
445188,25000,250,0,-2,16,5,11,0,0,0,3,1,2,1,0,1,11,3,8,0,0,0,1,1,0,0,0,0,0,0,0,0,0,0
445461,25000,250,0,-2,1,0,1,0,0,0,0,0,0,0,0,0,0,0,0,0,0,0,0,0,0,1,0,1,0,0,0,0,0,0
445692,25000,250,0,-2,4,2,2,0,0,0,1,1,0,0,0,0,0,0,0,0,0,0,3,1,2,0,0,0,0,0,0,0,0,0
445708,25000,250,0,-2,8,2,6,0,0,0,0,0,0,5,2,3,1,0,1,0,0,0,2,0,2,0,0,0,0,0,0,0,0,0
445735,25000,250,0,-2,4,0,4,0,0,0,1,0,1,0,0,0,2,0,2,0,0,0,0,0,0,1,0,1,0,0,0,0,0,0
446048,25000,250,0,-2,1,0,1,0,0,0,0,0,0,0,0,0,0,0,0,0,0,0,1,0,1,0,0,0,0,0,0,0,0,0
446118,25000,250,0,-2,3,2,1,0,0,0,1,1,0,1,1,0,1,0,1,0,0,0,0,0,0,0,0,0,0,0,0,0,0,0
446127,25000,250,0,-2,1,0,1,0,0,0,0,0,0,0,0,0,0,0,0,0,0,0,1,0,1,0,0,0,0,0,0,0,0,0
446385,25000,250,0,-2,3,2,1,0,0,0,0,0,0,0,0,0,1,1,0,0,0,0,0,0,0,0,0,0,2,1,1,0,0,0
446552,25000,250,0,-2,26,5,21,0,0,0,0,0,0,7,2,5,8,2,6,0,0,0,10,1,9,1,0,1,0,0,0,0,0,0
446561,25000,250,0,-2,6,3,3,0,0,0,2,1,1,0,0,0,2,1,1,0,0,0,2,1,1,0,0,0,0,0,0,0,0,0
446640,25000,250,0,-2,16,6,10,0,0,0,0,0,0,0,0,0,0,0,0,0,0,0,7,3,4,0,0,0,9,3,6,0,0,0
447014,25000,250,0,-2,2,0,2,0,0,0,0,0,0,1,0,1,0,0,0,0,0,0,0,0,0,1,0,1,0,0,0,0,0,0
447050,25000,250,0,-2,15,4,11,0,0,0,1,0,1,1,0,1,3,1,2,0,0,0,9,2,7,1,1,0,0,0,0,0,0,0
447263,25000,250,0,-2,18,3,15,0,0,0,1,0,1,0,0,0,1,0,1,0,0,0,14,3,11,1,0,1,1,0,1,0,0,0
447351,25000,250,0,-2,1,0,1,0,0,0,0,0,0,0,0,0,1,0,1,0,0,0,0,0,0,0,0,0,0,0,0,0,0,0
447591,25000,250,0,-2,4,2,2,0,0,0,0,0,0,3,1,2,1,1,0,0,0,0,0,0,0,0,0,0,0,0,0,0,0,0
447689,25000,250,0,-2,15,5,10,0,0,0,3,0,3,4,2,2,2,1,1,0,0,0,6,2,4,0,0,0,0,0,0,0,0,0
447698,25000,250,0,-2,2,1,1,0,0,0,0,0,0,0,0,0,0,0,0,0,0,0,2,1,1,0,0,0,0,0,0,0,0,0
447777,25000,250,0,-2,2,1,1,0,0,0,1,1,0,0,0,0,0,0,0,0,0,0,1,0,1,0,0,0,0,0,0,0,0,0
447935,25000,250,0,-2,1,0,1,0,0,0,0,0,0,0,0,0,0,0,0,0,0,0,1,0,1,0,0,0,0,0,0,0,0,0
448354,25000,250,0,-2,1,0,1,0,0,0,0,0,0,0,0,0,0,0,0,0,0,0,1,0,1,0,0,0,0,0,0,0,0,0
448381,25000,250,0,-2,3,0,3,0,0,0,0,0,0,0,0,0,1,0,1,0,0,0,2,0,2,0,0,0,0,0,0,0,0,0
448594,25000,250,0,-2,1,1,0,0,0,0,0,0,0,0,0,0,1,1,0,0,0,0,0,0,0,0,0,0,0,0,0,0,0,0
448673,25000,250,0,-2,7,2,5,0,0,0,0,0,0,2,0,2,0,0,0,0,0,0,4,2,2,1,0,1,0,0,0,0,0,0
449074,25000,250,0,-2,2,0,2,0,0,0,0,0,0,1,0,1,0,0,0,0,0,0,1,0,1,0,0,0,0,0,0,0,0,0
449250,25000,250,0,-2,3,1,2,0,0,0,0,0,0,0,0,0,3,1,2,0,0,0,0,0,0,0,0,0,0,0,0,0,0,0
449339,25000,250,0,-2,16,8,8,0,0,0,0,0,0,1,1,0,1,0,1,0,0,0,14,7,7,0,0,0,0,0,0,0,0,0
449384,25000,250,0,-2,1,0,1,0,0,0,0,0,0,0,0,0,1,0,1,0,0,0,0,0,0,0,0,0,0,0,0,0,0,0
449889,25000,250,0,-2,12,3,9,0,0,0,0,0,0,4,0,4,1,1,0,0,0,0,7,2,5,0,0,0,0,0,0,0,0,0
449898,25000,250,0,-2,3,1,2,0,0,0,0,0,0,1,0,1,0,0,0,0,0,0,2,1,1,0,0,0,0,0,0,0,0,0
450128,25000,250,0,-2,4,1,3,0,0,0,0,0,0,1,0,1,0,0,0,0,0,0,3,1,2,0,0,0,0,0,0,0,0,0
450304,25000,250,0,-2,2,0,2,0,0,0,0,0,0,0,0,0,0,0,0,0,0,0,2,0,2,0,0,0,0,0,0,0,0,0
450571,25000,250,0,-2,4,1,3,0,0,0,0,0,0,0,0,0,0,0,0,0,0,0,4,1,3,0,0,0,0,0,0,0,0,0
450696,25000,250,0,-2,4,0,4,0,0,0,1,0,1,0,0,0,2,0,2,0,0,0,1,0,1,0,0,0,0,0,0,0,0,0
450702,25000,250,0,-2,2,0,2,0,0,0,0,0,0,0,0,0,0,0,0,0,0,0,1,0,1,0,0,0,1,0,1,0,0,0
450933,25000,250,0,-2,18,1,17,0,0,0,0,0,0,2,0,2,1,0,1,0,0,0,13,1,12,0,0,0,2,0,2,0,0,0
451103,25000,250,0,-2,10,2,8,0,0,0,0,0,0,1,0,1,9,2,7,0,0,0,0,0,0,0,0,0,0,0,0,0,0,0
451510,25000,250,0,-2,2,0,2,0,0,0,0,0,0,2,0,2,0,0,0,0,0,0,0,0,0,0,0,0,0,0,0,0,0,0
451750,25000,250,0,-2,2,0,2,0,0,0,0,0,0,0,0,0,0,0,0,0,0,0,2,0,2,0,0,0,0,0,0,0,0,0
452124,25000,250,0,-2,1,0,1,0,0,0,0,0,0,0,0,0,0,0,0,0,0,0,1,0,1,0,0,0,0,0,0,0,0,0
452373,25000,250,0,-2,1,0,1,0,0,0,0,0,0,0,0,0,0,0,0,0,0,0,1,0,1,0,0,0,0,0,0,0,0,0
452948,25000,250,0,-2,1,0,1,0,0,0,0,0,0,0,0,0,0,0,0,0,0,0,1,0,1,0,0,0,0,0,0,0,0,0
454218,25000,250,0,-2,242,52,190,0,0,0,13,5,8,47,4,43,32,10,22,0,0,0,112,22,90,9,2,7,29,9,20,0,0,0
454698,25000,250,0,-2,3,0,3,0,0,0,0,0,0,0,0,0,2,0,2,0,0,0,1,0,1,0,0,0,0,0,0,0,0,0
454786,25000,250,0,-2,5,2,3,0,0,0,0,0,0,3,1,2,1,0,1,0,0,0,1,1,0,0,0,0,0,0,0,0,0,0
454810,25000,250,0,-2,60,12,48,1,0,1,1,0,1,15,1,14,5,2,3,0,0,0,33,8,25,4,1,3,1,0,1,0,0,0
454829,25000,250,0,-2,21,10,11,3,1,2,1,1,0,4,2,2,5,1,4,0,0,0,7,4,3,0,0,0,1,1,0,0,0,0
455114,25000,250,0,-2,9,5,4,0,0,0,0,0,0,0,0,0,1,1,0,0,0,0,7,3,4,0,0,0,1,1,0,0,0,0
455196,25000,250,0,-2,15,4,11,0,0,0,0,0,0,6,0,6,0,0,0,0,0,0,8,3,5,1,1,0,0,0,0,0,0,0
455406,25000,250,0,-2,2,0,2,0,0,0,0,0,0,0,0,0,1,0,1,0,0,0,1,0,1,0,0,0,0,0,0,0,0,0
455433,25000,250,0,-2,2,0,2,0,0,0,0,0,0,0,0,0,1,0,1,0,0,0,0,0,0,1,0,1,0,0,0,0,0,0
455664,25000,250,0,-2,21,6,15,0,0,0,2,0,2,6,1,5,2,1,1,0,0,0,8,1,7,3,3,0,0,0,0,0,0,0
455804,25000,250,0,-2,1,0,1,0,0,0,0,0,0,1,0,1,0,0,0,0,0,0,0,0,0,0,0,0,0,0,0,0,0,0
455992,25000,250,0,-2,1,1,0,0,0,0,0,0,0,0,0,0,0,0,0,0,0,0,0,0,0,1,1,0,0,0,0,0,0,0
456205,25000,250,0,-2,1,0,1,0,0,0,0,0,0,1,0,1,0,0,0,0,0,0,0,0,0,0,0,0,0,0,0,0,0,0
456214,25000,250,0,-2,9,3,6,0,0,0,0,0,0,1,0,1,6,2,4,0,0,0,2,1,1,0,0,0,0,0,0,0,0,0
456852,25000,250,0,-2,4,1,3,0,0,0,0,0,0,0,0,0,4,1,3,0,0,0,0,0,0,0,0,0,0,0,0,0,0,0
457101,25000,250,0,-2,4,1,3,0,0,0,0,0,0,2,0,2,1,1,0,0,0,0,1,0,1,0,0,0,0,0,0,0,0,0
457110,25000,250,0,-2,2,1,1,0,0,0,0,0,0,0,0,0,1,1,0,0,0,0,1,0,1,0,0,0,0,0,0,0,0,0
457402,25000,250,0,-2,1,0,1,0,0,0,0,0,0,1,0,1,0,0,0,0,0,0,0,0,0,0,0,0,0,0,0,0,0,0
457536,25000,250,0,-2,5,0,5,0,0,0,0,0,0,3,0,3,1,0,1,0,0,0,0,0,0,1,0,1,0,0,0,0,0,0
458210,25000,250,0,-2,5,2,3,0,0,0,2,1,1,0,0,0,1,1,0,0,0,0,2,0,2,0,0,0,0,0,0,0,0,0
458229,25000,250,0,-2,1,0,1,0,0,0,0,0,0,0,0,0,1,0,1,0,0,0,0,0,0,0,0,0,0,0,0,0,0,0
458441,25000,250,0,-2,2,1,1,0,0,0,0,0,0,2,1,1,0,0,0,0,0,0,0,0,0,0,0,0,0,0,0,0,0,0
459204,25000,250,0,-2,12,3,9,0,0,0,2,0,2,2,0,2,4,0,4,0,0,0,3,3,0,1,0,1,0,0,0,0,0,0
459213,25000,250,0,-2,10,1,9,0,0,0,2,0,2,2,0,2,2,0,2,0,0,0,0,0,0,1,0,1,3,1,2,0,0,0
459259,25000,250,0,-2,3,0,3,0,0,0,0,0,0,1,0,1,0,0,0,0,0,0,2,0,2,0,0,0,0,0,0,0,0,0
459268,25000,250,0,-2,4,0,4,0,0,0,0,0,0,3,0,3,0,0,0,0,0,0,1,0,1,0,0,0,0,0,0,0,0,0
459727,25000,250,0,-2,2,1,1,0,0,0,1,1,0,1,0,1,0,0,0,0,0,0,0,0,0,0,0,0,0,0,0,0,0,0
459736,25000,250,0,-2,3,0,3,0,0,0,1,0,1,0,0,0,0,0,0,1,0,1,1,0,1,0,0,0,0,0,0,0,0,0
459745,25000,250,0,-2,6,0,6,0,0,0,0,0,0,2,0,2,0,0,0,0,0,0,3,0,3,0,0,0,1,0,1,0,0,0
459824,25000,250,0,-2,3,1,2,0,0,0,0,0,0,0,0,0,0,0,0,0,0,0,3,1,2,0,0,0,0,0,0,0,0,0
459842,25000,250,0,-2,4,1,3,0,0,0,0,0,0,0,0,0,0,0,0,0,0,0,3,1,2,0,0,0,1,0,1,0,0,0
459851,25000,250,0,-2,6,2,4,0,0,0,0,0,0,0,0,0,0,0,0,0,0,0,5,2,3,1,0,1,0,0,0,0,0,0
459949,25000,250,0,-2,3,0,3,0,0,0,1,0,1,0,0,0,0,0,0,0,0,0,1,0,1,0,0,0,1,0,1,0,0,0
460136,25000,250,0,-2,4,2,2,0,0,0,0,0,0,1,1,0,3,1,2,0,0,0,0,0,0,0,0,0,0,0,0,0,0,0
460190,25000,250,0,-2,1,0,1,0,0,0,0,0,0,1,0,1,0,0,0,0,0,0,0,0,0,0,0,0,0,0,0,0,0,0
460349,25000,250,0,-2,12,4,8,0,0,0,1,0,1,0,0,0,0,0,0,0,0,0,9,4,5,0,0,0,0,0,0,2,0,2
460756,25000,250,0,-2,1,0,1,0,0,0,0,0,0,0,0,0,0,0,0,0,0,0,0,0,0,1,0,1,0,0,0,0,0,0
460835,25000,250,0,-2,1,0,1,0,0,0,0,0,0,0,0,0,0,0,0,0,0,0,1,0,1,0,0,0,0,0,0,0,0,0
461014,25000,250,0,-2,16,4,12,0,0,0,1,1,0,9,1,8,1,0,1,0,0,0,4,2,2,1,0,1,0,0,0,0,0,0
461528,25000,250,0,-2,2,1,1,0,0,0,0,0,0,0,0,0,1,0,1,0,0,0,1,1,0,0,0,0,0,0,0,0,0,0
461689,25000,250,0,-2,2,0,2,0,0,0,0,0,0,0,0,0,0,0,0,0,0,0,2,0,2,0,0,0,0,0,0,0,0,0
461795,25000,250,0,-2,1,0,1,0,0,0,0,0,0,0,0,0,0,0,0,0,0,0,0,0,0,0,0,0,0,0,0,1,0,1
464226,25000,250,0,-2,2,0,2,0,0,0,0,0,0,0,0,0,0,0,0,0,0,0,2,0,2,0,0,0,0,0,0,0,0,0
475033,25000,250,0,-2,2,1,1,0,0,0,0,0,0,0,0,0,0,0,0,0,0,0,1,0,1,0,0,0,1,1,0,0,0,0
475121,25000,250,0,-2,91,17,74,0,0,0,2,0,2,13,6,7,13,3,10,1,0,1,57,8,49,4,0,4,1,0,1,0,0,0
475176,25000,250,0,-2,5,0,5,0,0,0,0,0,0,0,0,0,2,0,2,1,0,1,2,0,2,0,0,0,0,0,0,0,0,0
475273,25000,250,0,-2,1,0,1,0,0,0,0,0,0,0,0,0,0,0,0,0,0,0,1,0,1,0,0,0,0,0,0,0,0,0
475398,25000,250,0,-2,1,1,0,0,0,0,0,0,0,0,0,0,0,0,0,0,0,0,1,1,0,0,0,0,0,0,0,0,0,0
475495,25000,250,0,-2,11,6,5,0,0,0,0,0,0,0,0,0,0,0,0,0,0,0,11,6,5,0,0,0,0,0,0,0,0,0
475839,25000,250,0,-2,1,1,0,0,0,0,0,0,0,0,0,0,0,0,0,0,0,0,1,1,0,0,0,0,0,0,0,0,0,0
476975,25000,250,0,-2,4,2,2,0,0,0,0,0,0,0,0,0,1,1,0,0,0,0,3,1,2,0,0,0,0,0,0,0,0,0
477039,25000,250,0,-2,2,0,2,0,0,0,1,0,1,0,0,0,0,0,0,0,0,0,1,0,1,0,0,0,0,0,0,0,0,0
480073,25000,250,0,-2,9,1,8,0,0,0,0,0,0,6,1,5,2,0,2,0,0,0,1,0,1,0,0,0,0,0,0,0,0,0
480091,25000,250,0,-2,1,0,1,0,0,0,0,0,0,0,0,0,0,0,0,0,0,0,1,0,1,0,0,0,0,0,0,0,0,0
480204,25000,250,0,-2,5,1,4,0,0,0,0,0,0,0,0,0,4,1,3,0,0,0,1,0,1,0,0,0,0,0,0,0,0,0
480657,25000,250,0,-2,1,0,1,0,0,0,0,0,0,0,0,0,0,0,0,0,0,0,1,0,1,0,0,0,0,0,0,0,0,0
480790,25000,250,0,-2,9,1,8,0,0,0,0,0,0,1,0,1,1,0,1,0,0,0,7,1,6,0,0,0,0,0,0,0,0,0
480824,25000,250,0,-2,2,0,2,0,0,0,0,0,0,1,0,1,0,0,0,0,0,0,1,0,1,0,0,0,0,0,0,0,0,0
480833,25000,250,0,-2,9,3,6,0,0,0,0,0,0,3,1,2,2,2,0,0,0,0,3,0,3,1,0,1,0,0,0,0,0,0
480967,25000,250,0,-2,1,0,1,1,0,1,0,0,0,0,0,0,0,0,0,0,0,0,0,0,0,0,0,0,0,0,0,0,0,0
481094,25000,250,0,-2,5,1,4,0,0,0,0,0,0,0,0,0,1,0,1,0,0,0,2,0,2,0,0,0,2,1,1,0,0,0
481535,25000,250,0,-2,1,0,1,0,0,0,0,0,0,0,0,0,0,0,0,0,0,0,1,0,1,0,0,0,0,0,0,0,0,0
481775,25000,250,0,-2,1,0,1,0,0,0,0,0,0,0,0,0,0,0,0,0,0,0,1,0,1,0,0,0,0,0,0,0,0,0
482149,25000,250,0,-2,12,2,10,0,0,0,1,0,1,4,0,4,0,0,0,0,0,0,6,2,4,1,0,1,0,0,0,0,0,0
482158,25000,250,0,-2,14,2,12,0,0,0,1,1,0,5,1,4,0,0,0,0,0,0,8,0,8,0,0,0,0,0,0,0,0,0
482413,25000,250,0,-2,4,0,4,0,0,0,1,0,1,1,0,1,1,0,1,0,0,0,0,0,0,0,0,0,1,0,1,0,0,0
482422,25000,250,0,-2,4,1,3,0,0,0,0,0,0,1,0,1,0,0,0,0,0,0,2,1,1,0,0,0,1,0,1,0,0,0
482431,25000,250,0,-2,13,2,11,1,0,1,2,0,2,1,0,1,3,2,1,0,0,0,3,0,3,0,0,0,3,0,3,0,0,0
482459,25000,250,0,-2,10,3,7,0,0,0,0,0,0,3,1,2,2,1,1,0,0,0,5,1,4,0,0,0,0,0,0,0,0,0
482468,25000,250,0,-2,13,2,11,0,0,0,0,0,0,11,2,9,0,0,0,1,0,1,1,0,1,0,0,0,0,0,0,0,0,0
482477,25000,250,0,-2,22,4,18,0,0,0,1,0,1,9,1,8,0,0,0,0,0,0,10,2,8,1,1,0,1,0,1,0,0,0
482556,25000,250,0,-2,3,0,3,0,0,0,0,0,0,2,0,2,0,0,0,0,0,0,1,0,1,0,0,0,0,0,0,0,0,0
482574,25000,250,0,-2,4,2,2,0,0,0,0,0,0,2,0,2,0,0,0,0,0,0,2,2,0,0,0,0,0,0,0,0,0,0
482608,25000,250,0,-2,9,0,9,0,0,0,0,0,0,2,0,2,2,0,2,0,0,0,3,0,3,0,0,0,2,0,2,0,0,0
482635,25000,250,0,-2,6,0,6,1,0,1,0,0,0,2,0,2,1,0,1,0,0,0,2,0,2,0,0,0,0,0,0,0,0,0
482653,25000,250,0,-2,2,1,1,0,0,0,0,0,0,1,0,1,0,0,0,0,0,0,1,1,0,0,0,0,0,0,0,0,0,0
482680,25000,250,0,-2,17,3,14,0,0,0,1,1,0,1,0,1,2,0,2,0,0,0,12,2,10,1,0,1,0,0,0,0,0,0
482705,25000,250,0,-2,2,0,2,0,0,0,0,0,0,0,0,0,0,0,0,0,0,0,2,0,2,0,0,0,0,0,0,0,0,0
482936,25000,250,0,-2,6,1,5,0,0,0,0,0,0,0,0,0,1,0,1,0,0,0,5,1,4,0,0,0,0,0,0,0,0,0
482990,25000,250,0,-2,3,3,0,0,0,0,0,0,0,2,2,0,0,0,0,0,0,0,1,1,0,0,0,0,0,0,0,0,0,0
483018,25000,250,0,-2,2,1,1,0,0,0,0,0,0,0,0,0,0,0,0,0,0,0,2,1,1,0,0,0,0,0,0,0,0,0
483045,25000,250,0,-2,8,2,6,0,0,0,0,0,0,5,0,5,0,0,0,0,0,0,3,2,1,0,0,0,0,0,0,0,0,0
483124,25000,250,0,-2,29,9,20,0,0,0,1,1,0,2,2,0,6,2,4,0,0,0,8,3,5,1,0,1,10,1,9,1,0,1
483212,25000,250,0,-2,3,1,2,0,0,0,0,0,0,1,0,1,0,0,0,0,0,0,2,1,1,0,0,0,0,0,0,0,0,0
484066,25000,250,0,-2,20,3,17,0,0,0,0,0,0,4,2,2,0,0,0,0,0,0,16,1,15,0,0,0,0,0,0,0,0,0
484473,25000,250,0,-2,3,0,3,0,0,0,0,0,0,0,0,0,0,0,0,0,0,0,2,0,2,0,0,0,1,0,1,0,0,0
484613,25000,250,0,-2,4,2,2,0,0,0,0,0,0,0,0,0,1,1,0,0,0,0,2,1,1,0,0,0,0,0,0,1,0,1
484905,25000,250,0,-2,4,2,2,0,0,0,0,0,0,3,1,2,0,0,0,0,0,0,1,1,0,0,0,0,0,0,0,0,0,0
485111,25000,250,0,-2,18,6,12,0,0,0,0,0,0,4,1,3,0,0,0,0,0,0,14,5,9,0,0,0,0,0,0,0,0,0
485272,25000,250,0,-2,2,2,0,0,0,0,0,0,0,1,1,0,1,1,0,0,0,0,0,0,0,0,0,0,0,0,0,0,0,0
485458,25000,250,0,-2,3,0,3,0,0,0,0,0,0,0,0,0,0,0,0,0,0,0,3,0,3,0,0,0,0,0,0,0,0,0
485467,25000,250,0,-2,1,0,1,0,0,0,1,0,1,0,0,0,0,0,0,0,0,0,0,0,0,0,0,0,0,0,0,0,0,0
485519,25000,250,0,-2,1,1,0,0,0,0,0,0,0,0,0,0,0,0,0,0,0,0,1,1,0,0,0,0,0,0,0,0,0,0
485546,25000,250,0,-2,3,1,2,0,0,0,0,0,0,0,0,0,1,0,1,0,0,0,2,1,1,0,0,0,0,0,0,0,0,0
485768,25000,250,0,-2,12,4,8,0,0,0,0,0,0,0,0,0,10,4,6,0,0,0,2,0,2,0,0,0,0,0,0,0,0,0
486239,25000,250,0,-2,1,0,1,0,0,0,0,0,0,0,0,0,1,0,1,0,0,0,0,0,0,0,0,0,0,0,0,0,0,0
486284,25000,250,0,-2,1,1,0,0,0,0,0,0,0,0,0,0,0,0,0,0,0,0,1,1,0,0,0,0,0,0,0,0,0,0
486424,25000,250,0,-2,1,0,1,0,0,0,0,0,0,1,0,1,0,0,0,0,0,0,0,0,0,0,0,0,0,0,0,0,0,0
486433,25000,250,0,-2,1,0,1,0,0,0,0,0,0,0,0,0,0,0,0,0,0,0,1,0,1,0,0,0,0,0,0,0,0,0
486813,25000,250,0,-2,2,0,2,0,0,0,0,0,0,0,0,0,2,0,2,0,0,0,0,0,0,0,0,0,0,0,0,0,0,0
486822,25000,250,0,-2,4,0,4,0,0,0,0,0,0,0,0,0,1,0,1,0,0,0,3,0,3,0,0,0,0,0,0,0,0,0
486840,25000,250,0,-2,83,25,58,0,0,0,1,0,1,26,9,17,9,3,6,1,0,1,41,11,30,2,1,1,2,0,2,1,1,0
486901,25000,250,0,-2,1,0,1,0,0,0,0,0,0,0,0,0,0,0,0,0,0,0,1,0,1,0,0,0,0,0,0,0,0,0
487010,25000,250,0,-2,1,0,1,0,0,0,0,0,0,0,0,0,0,0,0,0,0,0,1,0,1,0,0,0,0,0,0,0,0,0
487092,25000,250,0,-2,13,4,9,0,0,0,0,0,0,8,3,5,0,0,0,0,0,0,5,1,4,0,0,0,0,0,0,0,0,0
487162,25000,250,0,-2,8,2,6,0,0,0,0,0,0,1,0,1,0,0,0,0,0,0,7,2,5,0,0,0,0,0,0,0,0,0
487302,25000,250,0,-2,1,0,1,0,0,0,0,0,0,0,0,0,0,0,0,0,0,0,1,0,1,0,0,0,0,0,0,0,0,0
487320,25000,250,0,-2,13,6,7,0,0,0,0,0,0,3,2,1,4,2,2,0,0,0,4,2,2,0,0,0,2,0,2,0,0,0
487375,25000,250,0,-2,1,1,0,0,0,0,0,0,0,0,0,0,0,0,0,0,0,0,1,1,0,0,0,0,0,0,0,0,0,0
487524,25000,250,0,-2,4,1,3,0,0,0,0,0,0,0,0,0,0,0,0,0,0,0,4,1,3,0,0,0,0,0,0,0,0,0
487977,25000,250,0,-2,16,0,16,0,0,0,0,0,0,3,0,3,2,0,2,0,0,0,11,0,11,0,0,0,0,0,0,0,0,0
488077,25000,250,0,-2,25,7,18,0,0,0,0,0,0,3,0,3,2,0,2,0,0,0,7,1,6,1,1,0,12,5,7,0,0,0
488305,25000,250,0,-2,1,0,1,0,0,0,0,0,0,0,0,0,0,0,0,0,0,0,1,0,1,0,0,0,0,0,0,0,0,0
488387,25000,250,0,-2,3,0,3,0,0,0,0,0,0,1,0,1,1,0,1,0,0,0,1,0,1,0,0,0,0,0,0,0,0,0
488527,25000,250,0,-2,5,0,5,0,0,0,0,0,0,0,0,0,1,0,1,0,0,0,4,0,4,0,0,0,0,0,0,0,0,0
488554,25000,250,0,-2,3,0,3,0,0,0,0,0,0,0,0,0,3,0,3,0,0,0,0,0,0,0,0,0,0,0,0,0,0,0
488572,25000,250,0,-2,3,1,2,0,0,0,2,1,1,0,0,0,1,0,1,0,0,0,0,0,0,0,0,0,0,0,0,0,0,0
488730,25000,250,0,-2,8,3,5,0,0,0,0,0,0,0,0,0,6,2,4,0,0,0,2,1,1,0,0,0,0,0,0,0,0,0
489283,25000,250,0,-2,5,1,4,0,0,0,0,0,0,0,0,0,5,1,4,0,0,0,0,0,0,0,0,0,0,0,0,0,0,0
489779,25000,250,0,-2,34,5,29,0,0,0,0,0,0,3,2,1,3,0,3,1,0,1,25,3,22,1,0,1,1,0,1,0,0,0
489937,25000,250,0,-2,3,0,3,0,0,0,0,0,0,1,0,1,1,0,1,0,0,0,1,0,1,0,0,0,0,0,0,0,0,0
490133,25000,250,0,-2,36,16,20,0,0,0,5,1,4,2,1,1,8,6,2,0,0,0,13,4,9,3,2,1,5,2,3,0,0,0
490373,25000,250,0,-2,10,3,7,0,0,0,0,0,0,0,0,0,0,0,0,0,0,0,8,3,5,0,0,0,1,0,1,1,0,1
490559,25000,250,0,-2,3,1,2,0,0,0,0,0,0,2,1,1,1,0,1,0,0,0,0,0,0,0,0,0,0,0,0,0,0,0
490805,25000,250,0,-2,2,1,1,0,0,0,0,0,0,0,0,0,0,0,0,0,0,0,2,1,1,0,0,0,0,0,0,0,0,0
490878,25000,250,0,-2,4,2,2,0,0,0,0,0,0,0,0,0,2,1,1,0,0,0,2,1,1,0,0,0,0,0,0,0,0,0
490975,25000,250,0,-2,1,1,0,0,0,0,0,0,0,0,0,0,1,1,0,0,0,0,0,0,0,0,0,0,0,0,0,0,0,0
491844,25000,250,0,-2,3,2,1,3,2,1,0,0,0,0,0,0,0,0,0,0,0,0,0,0,0,0,0,0,0,0,0,0,0,0
492263,25000,250,0,-2,1,0,1,0,0,0,0,0,0,0,0,0,0,0,0,0,0,0,1,0,1,0,0,0,0,0,0,0,0,0
492449,25000,250,0,-2,2,0,2,0,0,0,0,0,0,0,0,0,0,0,0,0,0,0,1,0,1,1,0,1,0,0,0,0,0,0
492607,25000,250,0,-2,5,2,3,0,0,0,0,0,0,2,1,1,2,1,1,0,0,0,1,0,1,0,0,0,0,0,0,0,0,0
492689,25000,250,0,-2,3,2,1,0,0,0,0,0,0,0,0,0,3,2,1,0,0,0,0,0,0,0,0,0,0,0,0,0,0,0
492722,25000,250,0,-2,2,2,0,0,0,0,0,0,0,0,0,0,2,2,0,0,0,0,0,0,0,0,0,0,0,0,0,0,0,0
492801,25000,250,0,-2,2,0,2,0,0,0,0,0,0,0,0,0,0,0,0,0,0,0,1,0,1,0,0,0,1,0,1,0,0,0
493080,25000,250,0,-2,5,2,3,0,0,0,0,0,0,1,1,0,3,0,3,0,0,0,1,1,0,0,0,0,0,0,0,0,0,0
493895,25000,250,0,-2,3,1,2,0,0,0,0,0,0,1,0,1,0,0,0,0,0,0,2,1,1,0,0,0,0,0,0,0,0,0
494010,25000,250,0,-2,3,0,3,0,0,0,0,0,0,1,0,1,0,0,0,0,0,0,1,0,1,0,0,0,1,0,1,0,0,0
494250,25000,250,0,-2,3,0,3,0,0,0,0,0,0,0,0,0,0,0,0,0,0,0,3,0,3,0,0,0,0,0,0,0,0,0
494287,25000,250,0,-2,2,0,2,0,0,0,0,0,0,0,0,0,2,0,2,0,0,0,0,0,0,0,0,0,0,0,0,0,0,0
494588,25000,250,0,-2,1,0,1,0,0,0,0,0,0,0,0,0,1,0,1,0,0,0,0,0,0,0,0,0,0,0,0,0,0,0
494603,25000,250,0,-2,1,0,1,0,0,0,0,0,0,0,0,0,0,0,0,0,0,0,1,0,1,0,0,0,0,0,0,0,0,0
494852,25000,250,0,-2,1,0,1,0,0,0,0,0,0,0,0,0,0,0,0,0,0,0,1,0,1,0,0,0,0,0,0,0,0,0
494959,25000,250,0,-2,5,1,4,0,0,0,0,0,0,1,1,0,0,0,0,0,0,0,4,0,4,0,0,0,0,0,0,0,0,0
495192,25000,250,0,-2,3,0,3,0,0,0,0,0,0,1,0,1,2,0,2,0,0,0,0,0,0,0,0,0,0,0,0,0,0,0
495314,25000,250,0,-2,10,4,6,0,0,0,0,0,0,2,2,0,2,2,0,0,0,0,3,0,3,0,0,0,3,0,3,0,0,0
495420,25000,250,0,-2,1,0,1,0,0,0,0,0,0,0,0,0,0,0,0,0,0,0,0,0,0,1,0,1,0,0,0,0,0,0
495439,25000,250,0,-2,3,1,2,0,0,0,0,0,0,2,0,2,0,0,0,0,0,0,0,0,0,1,1,0,0,0,0,0,0,0
495448,25000,250,0,-2,4,1,3,0,0,0,0,0,0,0,0,0,2,0,2,0,0,0,2,1,1,0,0,0,0,0,0,0,0,0
495457,25000,250,0,-2,2,1,1,0,0,0,0,0,0,1,1,0,1,0,1,0,0,0,0,0,0,0,0,0,0,0,0,0,0,0
495767,25000,250,0,-2,88,24,64,1,1,0,2,1,1,1,0,1,2,0,2,0,0,0,79,20,59,2,2,0,1,0,1,0,0,0
496043,25000,250,0,-2,5,2,3,0,0,0,2,0,2,0,0,0,1,1,0,0,0,0,2,1,1,0,0,0,0,0,0,0,0,0
496186,25000,250,0,-2,15,5,10,0,0,0,2,0,2,1,0,1,2,0,2,1,1,0,4,1,3,0,0,0,5,3,2,0,0,0
496326,25000,250,0,-2,1,0,1,0,0,0,0,0,0,0,0,0,0,0,0,0,0,0,1,0,1,0,0,0,0,0,0,0,0,0
496991,25000,250,0,-2,2,1,1,0,0,0,1,0,1,0,0,0,0,0,0,0,0,0,1,1,0,0,0,0,0,0,0,0,0,0
497277,25000,250,0,-2,5,1,4,0,0,0,0,0,0,3,1,2,1,0,1,0,0,0,0,0,0,1,0,1,0,0,0,0,0,0
100654,30000,300,0,-2,5,3,2,0,0,0,0,0,0,4,2,2,0,0,0,0,0,0,1,1,0,0,0,0,0,0,0,0,0,0
100663,30000,300,0,-2,19,9,10,0,0,0,0,0,0,4,3,1,0,0,0,0,0,0,12,4,8,0,0,0,3,2,1,0,0,0
100706,30000,300,0,-2,12,9,3,0,0,0,0,0,0,0,0,0,0,0,0,0,0,0,12,9,3,0,0,0,0,0,0,0,0,0
100724,30000,300,0,-2,7,2,5,0,0,0,0,0,0,5,2,3,0,0,0,0,0,0,1,0,1,0,0,0,1,0,1,0,0,0
100733,30000,300,0,-2,1,0,1,0,0,0,0,0,0,0,0,0,0,0,0,0,0,0,1,0,1,0,0,0,0,0,0,0,0,0
100751,30000,300,0,-2,27,9,18,0,0,0,2,1,1,8,1,7,1,0,1,1,0,1,15,7,8,0,0,0,0,0,0,0,0,0
100760,30000,300,0,-2,6,3,3,0,0,0,0,0,0,2,0,2,0,0,0,0,0,0,4,3,1,0,0,0,0,0,0,0,0,0
100812,30000,300,0,-2,8,3,5,0,0,0,0,0,0,0,0,0,0,0,0,0,0,0,8,3,5,0,0,0,0,0,0,0,0,0
100830,30000,300,0,-2,9,3,6,0,0,0,0,0,0,3,1,2,0,0,0,0,0,0,6,2,4,0,0,0,0,0,0,0,0,0
100858,30000,300,0,-2,10,4,6,0,0,0,0,0,0,2,0,2,0,0,0,0,0,0,7,3,4,0,0,0,1,1,0,0,0,0
100937,30000,300,0,-2,6,1,5,0,0,0,0,0,0,0,0,0,1,0,1,0,0,0,4,0,4,0,0,0,1,1,0,0,0,0
101028,30000,300,0,-2,5,1,4,0,0,0,0,0,0,1,0,1,0,0,0,0,0,0,4,1,3,0,0,0,0,0,0,0,0,0
101116,30000,300,0,-2,1,0,1,0,0,0,0,0,0,1,0,1,0,0,0,0,0,0,0,0,0,0,0,0,0,0,0,0,0,0
101161,30000,300,0,-2,2,1,1,0,0,0,0,0,0,0,0,0,0,0,0,0,0,0,2,1,1,0,0,0,0,0,0,0,0,0
101240,30000,300,0,-2,8,1,7,0,0,0,0,0,0,1,0,1,0,0,0,0,0,0,7,1,6,0,0,0,0,0,0,0,0,0
101286,30000,300,0,-2,3,0,3,0,0,0,0,0,0,0,0,0,0,0,0,0,0,0,3,0,3,0,0,0,0,0,0,0,0,0
101295,30000,300,0,-2,2,1,1,0,0,0,0,0,0,0,0,0,0,0,0,0,0,0,2,1,1,0,0,0,0,0,0,0,0,0
101301,30000,300,0,-2,2,0,2,0,0,0,0,0,0,2,0,2,0,0,0,0,0,0,0,0,0,0,0,0,0,0,0,0,0,0
101462,30000,300,0,-2,5,1,4,0,0,0,0,0,0,3,1,2,0,0,0,0,0,0,1,0,1,0,0,0,1,0,1,0,0,0
101471,30000,300,0,-2,3,3,0,0,0,0,0,0,0,2,2,0,0,0,0,0,0,0,1,1,0,0,0,0,0,0,0,0,0,0
101480,30000,300,0,-2,9,2,7,1,1,0,0,0,0,1,0,1,0,0,0,0,0,0,7,1,6,0,0,0,0,0,0,0,0,0
101505,30000,300,0,-2,2,1,1,0,0,0,0,0,0,1,1,0,0,0,0,0,0,0,1,0,1,0,0,0,0,0,0,0,0,0
101514,30000,300,0,-2,1,0,1,0,0,0,0,0,0,0,0,0,0,0,0,0,0,0,1,0,1,0,0,0,0,0,0,0,0,0
101569,30000,300,0,-2,2,0,2,0,0,0,0,0,0,2,0,2,0,0,0,0,0,0,0,0,0,0,0,0,0,0,0,0,0,0
101587,30000,300,0,-2,4,2,2,0,0,0,0,0,0,1,0,1,0,0,0,0,0,0,3,2,1,0,0,0,0,0,0,0,0,0
101602,30000,300,0,-2,2,0,2,0,0,0,0,0,0,1,0,1,0,0,0,0,0,0,1,0,1,0,0,0,0,0,0,0,0,0
101648,30000,300,0,-2,1,0,1,0,0,0,0,0,0,0,0,0,0,0,0,0,0,0,1,0,1,0,0,0,0,0,0,0,0,0
101675,30000,300,0,-2,3,0,3,0,0,0,0,0,0,3,0,3,0,0,0,0,0,0,0,0,0,0,0,0,0,0,0,0,0,0
101736,30000,300,0,-2,3,1,2,0,0,0,0,0,0,0,0,0,0,0,0,0,0,0,2,0,2,0,0,0,1,1,0,0,0,0
101879,30000,300,0,-2,5,5,0,0,0,0,0,0,0,0,0,0,0,0,0,0,0,0,5,5,0,0,0,0,0,0,0,0,0,0
101897,30000,300,0,-2,2,1,1,0,0,0,0,0,0,0,0,0,0,0,0,0,0,0,2,1,1,0,0,0,0,0,0,0,0,0
102030,30000,300,0,-2,4,1,3,0,0,0,0,0,0,2,1,1,0,0,0,0,0,0,2,0,2,0,0,0,0,0,0,0,0,0
102067,30000,300,0,-2,4,3,1,1,1,0,1,1,0,0,0,0,0,0,0,0,0,0,2,1,1,0,0,0,0,0,0,0,0,0
102094,30000,300,0,-2,5,4,1,0,0,0,0,0,0,0,0,0,0,0,0,0,0,0,5,4,1,0,0,0,0,0,0,0,0,0
102234,30000,300,0,-2,6,2,4,0,0,0,0,0,0,3,1,2,0,0,0,0,0,0,3,1,2,0,0,0,0,0,0,0,0,0
102270,30000,300,0,-2,5,3,2,0,0,0,0,0,0,5,3,2,0,0,0,0,0,0,0,0,0,0,0,0,0,0,0,0,0,0
102298,30000,300,0,-2,7,3,4,0,0,0,0,0,0,7,3,4,0,0,0,0,0,0,0,0,0,0,0,0,0,0,0,0,0,0
102313,30000,300,0,-2,2,1,1,0,0,0,0,0,0,1,0,1,0,0,0,0,0,0,1,1,0,0,0,0,0,0,0,0,0,0
102368,30000,300,0,-2,5,1,4,0,0,0,0,0,0,2,0,2,0,0,0,0,0,0,3,1,2,0,0,0,0,0,0,0,0,0
102377,30000,300,0,-2,10,4,6,0,0,0,0,0,0,10,4,6,0,0,0,0,0,0,0,0,0,0,0,0,0,0,0,0,0,0
102395,30000,300,0,-2,1,0,1,0,0,0,0,0,0,1,0,1,0,0,0,0,0,0,0,0,0,0,0,0,0,0,0,0,0,0
102429,30000,300,0,-2,2,2,0,0,0,0,0,0,0,0,0,0,0,0,0,0,0,0,2,2,0,0,0,0,0,0,0,0,0,0
102553,30000,300,0,-2,6,2,4,0,0,0,0,0,0,0,0,0,0,0,0,0,0,0,6,2,4,0,0,0,0,0,0,0,0,0
102614,30000,300,0,-2,4,3,1,0,0,0,0,0,0,0,0,0,0,0,0,0,0,0,4,3,1,0,0,0,0,0,0,0,0,0
102632,30000,300,0,-2,2,0,2,0,0,0,0,0,0,0,0,0,0,0,0,0,0,0,2,0,2,0,0,0,0,0,0,0,0,0
102669,30000,300,0,-2,2,2,0,0,0,0,0,0,0,0,0,0,0,0,0,0,0,0,2,2,0,0,0,0,0,0,0,0,0,0
102845,30000,300,0,-2,2,1,1,0,0,0,0,0,0,2,1,1,0,0,0,0,0,0,0,0,0,0,0,0,0,0,0,0,0,0
103529,30000,300,0,-2,5,4,1,1,0,1,0,0,0,0,0,0,0,0,0,0,0,0,3,3,0,0,0,0,1,1,0,0,0,0
103893,30000,300,0,-2,8,3,5,1,1,0,0,0,0,3,1,2,3,0,3,0,0,0,1,1,0,0,0,0,0,0,0,0,0,0
103909,30000,300,0,-2,5,1,4,0,0,0,0,0,0,1,0,1,2,1,1,0,0,0,2,0,2,0,0,0,0,0,0,0,0,0
103927,30000,300,0,-2,2,0,2,0,0,0,0,0,0,0,0,0,1,0,1,0,0,0,1,0,1,0,0,0,0,0,0,0,0,0
104090,30000,300,0,-2,2,0,2,0,0,0,0,0,0,1,0,1,1,0,1,0,0,0,0,0,0,0,0,0,0,0,0,0,0,0
104151,30000,300,0,-2,120,54,66,1,1,0,8,3,5,14,6,8,11,3,8,0,0,0,39,21,18,6,3,3,39,16,23,2,1,1
104160,30000,300,0,-2,7,2,5,0,0,0,0,0,0,0,0,0,1,1,0,0,0,0,4,0,4,0,0,0,2,1,1,0,0,0
104179,30000,300,0,-2,18,12,6,1,1,0,1,1,0,2,1,1,2,2,0,0,0,0,11,7,4,0,0,0,1,0,1,0,0,0
104346,30000,300,0,-2,1,1,0,0,0,0,0,0,0,1,1,0,0,0,0,0,0,0,0,0,0,0,0,0,0,0,0,0,0,0
104425,30000,300,0,-2,3,2,1,0,0,0,0,0,0,1,1,0,0,0,0,0,0,0,2,1,1,0,0,0,0,0,0,0,0,0
104586,30000,300,0,-2,3,3,0,0,0,0,0,0,0,0,0,0,0,0,0,0,0,0,2,2,0,1,1,0,0,0,0,0,0,0
104708,30000,300,0,-2,1,1,0,0,0,0,0,0,0,0,0,0,0,0,0,0,0,0,1,1,0,0,0,0,0,0,0,0,0,0
104717,30000,300,0,-2,24,15,9,0,0,0,0,0,0,1,1,0,5,4,1,0,0,0,16,9,7,1,1,0,1,0,1,0,0,0
105136,30000,300,0,-2,5,1,4,0,0,0,1,0,1,0,0,0,1,0,1,0,0,0,3,1,2,0,0,0,0,0,0,0,0,0
105145,30000,300,0,-2,4,2,2,0,0,0,0,0,0,1,0,1,1,1,0,0,0,0,2,1,1,0,0,0,0,0,0,0,0,0
105154,30000,300,0,-2,6,1,5,0,0,0,0,0,0,0,0,0,3,0,3,0,0,0,3,1,2,0,0,0,0,0,0,0,0,0
105206,30000,300,0,-2,4,3,1,0,0,0,0,0,0,1,1,0,0,0,0,0,0,0,3,2,1,0,0,0,0,0,0,0,0,0
105297,30000,300,0,-2,1,1,0,0,0,0,0,0,0,0,0,0,0,0,0,0,0,0,0,0,0,0,0,0,1,1,0,0,0,0
105330,30000,300,0,-2,5,4,1,0,0,0,0,0,0,0,0,0,0,0,0,0,0,0,4,3,1,0,0,0,1,1,0,0,0,0
105349,30000,300,0,-2,3,3,0,0,0,0,0,0,0,0,0,0,0,0,0,0,0,0,3,3,0,0,0,0,0,0,0,0,0,0
105428,30000,300,0,-2,5,1,4,0,0,0,1,1,0,0,0,0,1,0,1,0,0,0,3,0,3,0,0,0,0,0,0,0,0,0
105525,30000,300,0,-2,7,4,3,0,0,0,0,0,0,1,0,1,0,0,0,0,0,0,6,4,2,0,0,0,0,0,0,0,0,0
105534,30000,300,0,-2,1,0,1,0,0,0,0,0,0,0,0,0,0,0,0,0,0,0,1,0,1,0,0,0,0,0,0,0,0,0
105589,30000,300,0,-2,9,3,6,1,0,1,0,0,0,1,1,0,0,0,0,0,0,0,5,2,3,0,0,0,2,0,2,0,0,0
105668,30000,300,0,-2,3,1,2,0,0,0,1,1,0,0,0,0,0,0,0,0,0,0,2,0,2,0,0,0,0,0,0,0,0,0
105899,30000,300,0,-2,2,1,1,0,0,0,0,0,0,0,0,0,0,0,0,0,0,0,1,1,0,0,0,0,1,0,1,0,0,0
106148,30000,300,0,-2,9,4,5,0,0,0,0,0,0,0,0,0,0,0,0,0,0,0,8,3,5,0,0,0,1,1,0,0,0,0
106245,30000,300,0,-2,17,11,6,1,0,1,0,0,0,5,3,2,0,0,0,0,0,0,11,8,3,0,0,0,0,0,0,0,0,0
106263,30000,300,0,-2,89,31,58,0,0,0,2,1,1,15,6,9,1,1,0,0,0,0,66,21,45,3,1,2,1,1,0,1,0,1
106397,30000,300,0,-2,40,20,20,2,1,1,1,0,1,8,6,2,2,1,1,0,0,0,26,11,15,1,1,0,0,0,0,0,0,0
106412,30000,300,0,-2,3,3,0,0,0,0,0,0,0,3,3,0,0,0,0,0,0,0,0,0,0,0,0,0,0,0,0,0,0,0
106449,30000,300,0,-2,4,0,4,0,0,0,0,0,0,0,0,0,0,0,0,0,0,0,4,0,4,0,0,0,0,0,0,0,0,0
106458,30000,300,0,-2,23,6,17,0,0,0,1,1,0,4,1,3,1,0,1,0,0,0,16,3,13,0,0,0,1,1,0,0,0,0
106467,30000,300,0,-2,2,0,2,0,0,0,0,0,0,0,0,0,0,0,0,0,0,0,2,0,2,0,0,0,0,0,0,0,0,0
106704,30000,300,0,-2,10,4,6,0,0,0,0,0,0,0,0,0,0,0,0,0,0,0,8,3,5,1,0,1,0,0,0,1,1,0
106980,30000,300,0,-2,1,1,0,0,0,0,0,0,0,0,0,0,0,0,0,0,0,0,1,1,0,0,0,0,0,0,0,0,0,0
107044,30000,300,0,-2,7,1,6,0,0,0,0,0,0,0,0,0,0,0,0,0,0,0,7,1,6,0,0,0,0,0,0,0,0,0
107071,30000,300,0,-2,1,0,1,0,0,0,0,0,0,0,0,0,0,0,0,0,0,0,1,0,1,0,0,0,0,0,0,0,0,0
107141,30000,300,0,-2,1,1,0,0,0,0,0,0,0,0,0,0,0,0,0,0,0,0,1,1,0,0,0,0,0,0,0,0,0,0
107318,30000,300,0,-2,2,0,2,0,0,0,0,0,0,1,0,1,0,0,0,0,0,0,1,0,1,0,0,0,0,0,0,0,0,0
107460,30000,300,0,-2,1,1,0,0,0,0,0,0,0,0,0,0,0,0,0,0,0,0,1,1,0,0,0,0,0,0,0,0,0,0
107521,30000,300,0,-2,2,2,0,0,0,0,0,0,0,1,1,0,0,0,0,0,0,0,1,1,0,0,0,0,0,0,0,0,0,0
107558,30000,300,0,-2,1,0,1,0,0,0,0,0,0,1,0,1,0,0,0,0,0,0,0,0,0,0,0,0,0,0,0,0,0,0
107600,30000,300,0,-2,3,2,1,0,0,0,0,0,0,3,2,1,0,0,0,0,0,0,0,0,0,0,0,0,0,0,0,0,0,0
107637,30000,300,0,-2,1,0,1,0,0,0,0,0,0,0,0,0,0,0,0,0,0,0,1,0,1,0,0,0,0,0,0,0,0,0
107664,30000,300,0,-2,4,2,2,0,0,0,0,0,0,1,1,0,0,0,0,0,0,0,3,1,2,0,0,0,0,0,0,0,0,0
107725,30000,300,0,-2,1,0,1,0,0,0,0,0,0,1,0,1,0,0,0,0,0,0,0,0,0,0,0,0,0,0,0,0,0,0
107743,30000,300,0,-2,2,1,1,0,0,0,0,0,0,0,0,0,0,0,0,0,0,0,2,1,1,0,0,0,0,0,0,0,0,0
107840,30000,300,0,-2,3,1,2,0,0,0,0,0,0,3,1,2,0,0,0,0,0,0,0,0,0,0,0,0,0,0,0,0,0,0
107877,30000,300,0,-2,2,2,0,0,0,0,0,0,0,0,0,0,0,0,0,0,0,0,2,2,0,0,0,0,0,0,0,0,0,0
107974,30000,300,0,-2,1,1,0,0,0,0,0,0,0,0,0,0,0,0,0,0,0,0,1,1,0,0,0,0,0,0,0,0,0,0
107983,30000,300,0,-2,6,4,2,0,0,0,0,0,0,2,2,0,0,0,0,0,0,0,4,2,2,0,0,0,0,0,0,0,0,0
107992,30000,300,0,-2,1,1,0,0,0,0,0,0,0,1,1,0,0,0,0,0,0,0,0,0,0,0,0,0,0,0,0,0,0,0
108056,30000,300,0,-2,1,0,1,0,0,0,0,0,0,0,0,0,0,0,0,0,0,0,0,0,0,0,0,0,1,0,1,0,0,0
108092,30000,300,0,-2,7,2,5,1,0,1,0,0,0,1,0,1,0,0,0,0,0,0,5,2,3,0,0,0,0,0,0,0,0,0
108232,30000,300,0,-2,3,2,1,0,0,0,0,0,0,0,0,0,0,0,0,0,0,0,2,1,1,1,1,0,0,0,0,0,0,0
108667,30000,300,0,-2,2,2,0,0,0,0,0,0,0,2,2,0,0,0,0,0,0,0,0,0,0,0,0,0,0,0,0,0,0,0
108807,30000,300,0,-2,2,1,1,0,0,0,0,0,0,0,0,0,1,1,0,0,0,0,1,0,1,0,0,0,0,0,0,0,0,0
108870,30000,300,0,-2,2,2,0,0,0,0,0,0,0,0,0,0,0,0,0,0,0,0,2,2,0,0,0,0,0,0,0,0,0,0
109040,30000,300,0,-2,4,1,3,0,0,0,0,0,0,1,0,1,1,0,1,0,0,0,1,0,1,0,0,0,1,1,0,0,0,0
109086,30000,300,0,-2,2,1,1,0,0,0,0,0,0,0,0,0,0,0,0,0,0,0,1,1,0,1,0,1,0,0,0,0,0,0
109208,30000,300,0,-2,1,1,0,0,0,0,0,0,0,1,1,0,0,0,0,0,0,0,0,0,0,0,0,0,0,0,0,0,0,0
109350,30000,300,0,-2,2,1,1,0,0,0,1,1,0,0,0,0,0,0,0,0,0,0,0,0,0,1,0,1,0,0,0,0,0,0
109651,30000,300,0,-2,13,2,11,0,0,0,4,1,3,1,0,1,3,0,3,0,0,0,1,0,1,1,0,1,3,1,2,0,0,0
109785,30000,300,0,-2,1,1,0,0,0,0,0,0,0,1,1,0,0,0,0,0,0,0,0,0,0,0,0,0,0,0,0,0,0,0
109819,30000,300,0,-2,4,2,2,0,0,0,0,0,0,0,0,0,2,0,2,0,0,0,1,1,0,1,1,0,0,0,0,0,0,0
110097,30000,300,0,-2,6,1,5,0,0,0,1,0,1,0,0,0,0,0,0,0,0,0,5,1,4,0,0,0,0,0,0,0,0,0
110219,30000,300,0,-2,5,5,0,0,0,0,0,0,0,0,0,0,1,1,0,0,0,0,3,3,0,1,1,0,0,0,0,0,0,0
110246,30000,300,0,-2,6,2,4,0,0,0,1,0,1,1,0,1,0,0,0,0,0,0,4,2,2,0,0,0,0,0,0,0,0,0
110316,30000,300,0,-2,4,1,3,0,0,0,0,0,0,1,0,1,0,0,0,0,0,0,3,1,2,0,0,0,0,0,0,0,0,0
110361,30000,300,0,-2,2,1,1,0,0,0,0,0,0,0,0,0,0,0,0,0,0,0,2,1,1,0,0,0,0,0,0,0,0,0
110370,30000,300,0,-2,7,3,4,0,0,0,1,1,0,0,0,0,0,0,0,0,0,0,6,2,4,0,0,0,0,0,0,0,0,0
110398,30000,300,0,-2,2,1,1,0,0,0,1,0,1,0,0,0,0,0,0,0,0,0,1,1,0,0,0,0,0,0,0,0,0,0
110404,30000,300,0,-2,18,10,8,0,0,0,4,2,2,0,0,0,9,5,4,0,0,0,5,3,2,0,0,0,0,0,0,0,0,0
110413,30000,300,0,-2,10,3,7,0,0,0,1,0,1,2,0,2,2,0,2,0,0,0,3,1,2,1,1,0,1,1,0,0,0,0
110422,30000,300,0,-2,2,2,0,0,0,0,0,0,0,0,0,0,0,0,0,0,0,0,2,2,0,0,0,0,0,0,0,0,0,0
110468,30000,300,0,-2,5,2,3,0,0,0,0,0,0,1,1,0,1,0,1,0,0,0,3,1,2,0,0,0,0,0,0,0,0,0
110486,30000,300,0,-2,2,0,2,0,0,0,0,0,0,0,0,0,1,0,1,0,0,0,1,0,1,0,0,0,0,0,0,0,0,0
110495,30000,300,0,-2,5,2,3,0,0,0,1,0,1,0,0,0,0,0,0,0,0,0,4,2,2,0,0,0,0,0,0,0,0,0
110501,30000,300,0,-2,12,7,5,0,0,0,1,1,0,1,0,1,3,2,1,0,0,0,6,4,2,0,0,0,1,0,1,0,0,0
110510,30000,300,0,-2,3,2,1,0,0,0,1,0,1,0,0,0,0,0,0,0,0,0,2,2,0,0,0,0,0,0,0,0,0,0
110529,30000,300,0,-2,5,3,2,0,0,0,0,0,0,2,2,0,1,0,1,0,0,0,2,1,1,0,0,0,0,0,0,0,0,0
110538,30000,300,0,-2,1,0,1,0,0,0,0,0,0,0,0,0,1,0,1,0,0,0,0,0,0,0,0,0,0,0,0,0,0,0
110547,30000,300,0,-2,9,2,7,0,0,0,2,1,1,3,1,2,0,0,0,0,0,0,4,0,4,0,0,0,0,0,0,0,0,0
110556,30000,300,0,-2,3,2,1,0,0,0,0,0,0,1,1,0,0,0,0,0,0,0,2,1,1,0,0,0,0,0,0,0,0,0
110565,30000,300,0,-2,7,5,2,0,0,0,2,2,0,1,1,0,1,0,1,0,0,0,3,2,1,0,0,0,0,0,0,0,0,0
110574,30000,300,0,-2,5,1,4,0,0,0,0,0,0,1,1,0,1,0,1,0,0,0,0,0,0,0,0,0,3,0,3,0,0,0
110583,30000,300,0,-2,7,3,4,0,0,0,1,0,1,2,1,1,1,1,0,0,0,0,3,1,2,0,0,0,0,0,0,0,0,0
110592,30000,300,0,-2,5,3,2,0,0,0,1,1,0,2,1,1,1,1,0,0,0,0,0,0,0,0,0,0,1,0,1,0,0,0
110608,30000,300,0,-2,6,3,3,0,0,0,0,0,0,0,0,0,1,0,1,0,0,0,3,1,2,0,0,0,2,2,0,0,0,0
110617,30000,300,0,-2,2,1,1,0,0,0,0,0,0,2,1,1,0,0,0,0,0,0,0,0,0,0,0,0,0,0,0,0,0,0
110635,30000,300,0,-2,48,23,25,0,0,0,4,1,3,8,5,3,6,3,3,0,0,0,24,11,13,1,0,1,0,0,0,5,3,2
110644,30000,300,0,-2,36,14,22,0,0,0,2,1,1,4,0,4,3,1,2,0,0,0,26,11,15,0,0,0,1,1,0,0,0,0
110653,30000,300,0,-2,32,16,16,0,0,0,6,5,1,2,1,1,4,2,2,0,0,0,13,4,9,1,0,1,5,3,2,1,1,0
110662,30000,300,0,-2,60,25,35,0,0,0,12,4,8,3,1,2,5,1,4,0,0,0,27,13,14,3,2,1,4,1,3,6,3,3
110671,30000,300,0,-2,17,12,5,0,0,0,1,1,0,0,0,0,2,1,1,0,0,0,11,7,4,1,1,0,1,1,0,1,1,0
110680,30000,300,0,-2,45,23,22,0,0,0,2,1,1,3,2,1,5,5,0,0,0,0,26,11,15,2,1,1,3,3,0,4,0,4
110699,30000,300,0,-2,25,12,13,0,0,0,6,4,2,1,0,1,1,1,0,0,0,0,11,5,6,2,0,2,1,0,1,3,2,1
110705,30000,300,0,-2,25,8,17,0,0,0,1,1,0,0,0,0,6,1,5,0,0,0,10,4,6,3,1,2,2,1,1,3,0,3
110714,30000,300,0,-2,24,13,11,0,0,0,2,0,2,4,4,0,4,2,2,0,0,0,13,6,7,0,0,0,1,1,0,0,0,0
110778,30000,300,0,-2,1,0,1,0,0,0,0,0,0,0,0,0,0,0,0,0,0,0,1,0,1,0,0,0,0,0,0,0,0,0
111081,30000,300,0,-2,11,4,7,0,0,0,2,1,1,2,0,2,2,1,1,0,0,0,5,2,3,0,0,0,0,0,0,0,0,0
111188,30000,300,0,-2,5,2,3,0,0,0,1,0,1,0,0,0,0,0,0,0,0,0,4,2,2,0,0,0,0,0,0,0,0,0
111391,30000,300,0,-2,5,2,3,0,0,0,0,0,0,1,0,1,1,1,0,0,0,0,3,1,2,0,0,0,0,0,0,0,0,0
111461,30000,300,0,-2,6,1,5,0,0,0,0,0,0,0,0,0,0,0,0,0,0,0,6,1,5,0,0,0,0,0,0,0,0,0
111887,30000,300,0,-2,1,0,1,0,0,0,0,0,0,0,0,0,0,0,0,0,0,0,1,0,1,0,0,0,0,0,0,0,0,0
111920,30000,300,0,-2,1,1,0,0,0,0,0,0,0,0,0,0,0,0,0,0,0,0,1,1,0,0,0,0,0,0,0,0,0,0
111939,30000,300,0,-2,1,1,0,0,0,0,0,0,0,0,0,0,1,1,0,0,0,0,0,0,0,0,0,0,0,0,0,0,0,0
111948,30000,300,0,-2,7,4,3,0,0,0,0,0,0,0,0,0,2,0,2,0,0,0,2,2,0,0,0,0,3,2,1,0,0,0
112075,30000,300,0,-2,3,1,2,0,0,0,0,0,0,0,0,0,0,0,0,0,0,0,2,1,1,0,0,0,1,0,1,0,0,0
112172,30000,300,0,-2,4,2,2,0,0,0,0,0,0,0,0,0,0,0,0,0,0,0,4,2,2,0,0,0,0,0,0,0,0,0
112190,30000,300,0,-2,1,1,0,0,0,0,0,0,0,0,0,0,0,0,0,0,0,0,1,1,0,0,0,0,0,0,0,0,0,0
112251,30000,300,0,-2,6,2,4,0,0,0,0,0,0,0,0,0,0,0,0,0,0,0,6,2,4,0,0,0,0,0,0,0,0,0
112260,30000,300,0,-2,3,1,2,0,0,0,0,0,0,2,0,2,0,0,0,0,0,0,1,1,0,0,0,0,0,0,0,0,0,0
112394,30000,300,0,-2,2,2,0,0,0,0,0,0,0,0,0,0,1,1,0,0,0,0,1,1,0,0,0,0,0,0,0,0,0,0
112525,30000,300,0,-2,7,3,4,0,0,0,1,1,0,1,0,1,2,1,1,0,0,0,3,1,2,0,0,0,0,0,0,0,0,0
112561,30000,300,0,-2,7,2,5,0,0,0,0,0,0,0,0,0,0,0,0,0,0,0,7,2,5,0,0,0,0,0,0,0,0,0
112570,30000,300,0,-2,1,1,0,0,0,0,0,0,0,1,1,0,0,0,0,0,0,0,0,0,0,0,0,0,0,0,0,0,0,0
112686,30000,300,0,-2,7,4,3,0,0,0,1,1,0,6,3,3,0,0,0,0,0,0,0,0,0,0,0,0,0,0,0,0,0,0
112817,30000,300,0,-2,3,1,2,0,0,0,0,0,0,1,0,1,2,1,1,0,0,0,0,0,0,0,0,0,0,0,0,0,0,0
112826,30000,300,0,-2,4,1,3,0,0,0,0,0,0,2,0,2,0,0,0,0,0,0,1,1,0,0,0,0,1,0,1,0,0,0
113096,30000,300,0,-2,2,1,1,0,0,0,0,0,0,1,0,1,0,0,0,0,0,0,1,1,0,0,0,0,0,0,0,0,0,0
113193,30000,300,0,-2,1,0,1,0,0,0,0,0,0,0,0,0,0,0,0,0,0,0,1,0,1,0,0,0,0,0,0,0,0,0
113236,30000,300,0,-2,1,0,1,0,0,0,0,0,0,0,0,0,0,0,0,0,0,0,0,0,0,0,0,0,1,0,1,0,0,0
113333,30000,300,0,-2,1,0,1,0,0,0,0,0,0,0,0,0,0,0,0,0,0,0,1,0,1,0,0,0,0,0,0,0,0,0
113634,30000,300,0,-2,3,0,3,0,0,0,0,0,0,1,0,1,0,0,0,0,0,0,2,0,2,0,0,0,0,0,0,0,0,0
113698,30000,300,0,-2,5,2,3,0,0,0,1,0,1,1,0,1,0,0,0,0,0,0,2,1,1,0,0,0,1,1,0,0,0,0
113856,30000,300,0,-2,4,3,1,0,0,0,0,0,0,0,0,0,0,0,0,0,0,0,0,0,0,0,0,0,4,3,1,0,0,0
113980,30000,300,0,-2,11,3,8,0,0,0,2,0,2,4,1,3,2,1,1,0,0,0,3,1,2,0,0,0,0,0,0,0,0,0
114266,30000,300,0,-2,4,3,1,0,0,0,1,1,0,1,1,0,1,1,0,0,0,0,1,0,1,0,0,0,0,0,0,0,0,0
114433,30000,300,0,-2,1,1,0,0,0,0,0,0,0,0,0,0,0,0,0,0,0,0,1,1,0,0,0,0,0,0,0,0,0,0
114549,30000,300,0,-2,4,2,2,0,0,0,0,0,0,0,0,0,0,0,0,0,0,0,2,1,1,2,1,1,0,0,0,0,0,0
114716,30000,300,0,-2,3,3,0,0,0,0,0,0,0,2,2,0,1,1,0,0,0,0,0,0,0,0,0,0,0,0,0,0,0,0
114813,30000,300,0,-2,6,2,4,1,0,1,1,0,1,1,1,0,0,0,0,0,0,0,3,1,2,0,0,0,0,0,0,0,0,0
114831,30000,300,0,-2,1,1,0,0,0,0,0,0,0,0,0,0,0,0,0,0,0,0,1,1,0,0,0,0,0,0,0,0,0,0
114840,30000,300,0,-2,4,1,3,0,0,0,0,0,0,3,0,3,0,0,0,0,0,0,1,1,0,0,0,0,0,0,0,0,0,0
114938,30000,300,0,-2,3,2,1,0,0,0,0,0,0,1,1,0,2,1,1,0,0,0,0,0,0,0,0,0,0,0,0,0,0,0
115083,30000,300,0,-2,14,6,8,0,0,0,3,1,2,2,1,1,1,1,0,0,0,0,8,3,5,0,0,0,0,0,0,0,0,0
115126,30000,300,0,-2,1,0,1,0,0,0,0,0,0,0,0,0,0,0,0,0,0,0,1,0,1,0,0,0,0,0,0,0,0,0
115214,30000,300,0,-2,2,1,1,0,0,0,0,0,0,0,0,0,1,0,1,0,0,0,1,1,0,0,0,0,0,0,0,0,0,0
115287,30000,300,0,-2,1,0,1,0,0,0,0,0,0,0,0,0,0,0,0,0,0,0,1,0,1,0,0,0,0,0,0,0,0,0
115296,30000,300,0,-2,1,0,1,0,0,0,0,0,0,1,0,1,0,0,0,0,0,0,0,0,0,0,0,0,0,0,0,0,0,0
115393,30000,300,0,-2,7,4,3,0,0,0,0,0,0,0,0,0,3,1,2,0,0,0,4,3,1,0,0,0,0,0,0,0,0,0
115409,30000,300,0,-2,2,0,2,0,0,0,0,0,0,0,0,0,0,0,0,0,0,0,2,0,2,0,0,0,0,0,0,0,0,0
115728,30000,300,0,-2,3,1,2,0,0,0,0,0,0,0,0,0,0,0,0,0,0,0,3,1,2,0,0,0,0,0,0,0,0,0
115755,30000,300,0,-2,7,4,3,0,0,0,0,0,0,2,1,1,1,0,1,0,0,0,3,3,0,0,0,0,1,0,1,0,0,0
115861,30000,300,0,-2,12,7,5,0,0,0,0,0,0,0,0,0,9,5,4,0,0,0,3,2,1,0,0,0,0,0,0,0,0,0
115931,30000,300,0,-2,2,0,2,0,0,0,0,0,0,1,0,1,0,0,0,0,0,0,1,0,1,0,0,0,0,0,0,0,0,0
116439,30000,300,0,-2,3,1,2,0,0,0,0,0,0,0,0,0,1,0,1,0,0,0,1,0,1,0,0,0,0,0,0,1,1,0
116846,30000,300,0,-2,3,1,2,0,0,0,0,0,0,0,0,0,0,0,0,0,0,0,3,1,2,0,0,0,0,0,0,0,0,0
117104,30000,300,0,-2,2,1,1,0,0,0,0,0,0,0,0,0,0,0,0,0,0,0,2,1,1,0,0,0,0,0,0,0,0,0
117140,30000,300,0,-2,12,3,9,0,0,0,0,0,0,1,0,1,2,0,2,0,0,0,2,0,2,0,0,0,7,3,4,0,0,0
117168,30000,300,0,-2,1,1,0,0,0,0,0,0,0,0,0,0,0,0,0,0,0,0,1,1,0,0,0,0,0,0,0,0,0,0
117195,30000,300,0,-2,4,2,2,0,0,0,0,0,0,0,0,0,2,1,1,0,0,0,2,1,1,0,0,0,0,0,0,0,0,0
117247,30000,300,0,-2,5,2,3,0,0,0,2,0,2,1,1,0,1,1,0,0,0,0,1,0,1,0,0,0,0,0,0,0,0,0
117274,30000,300,0,-2,2,0,2,1,0,1,0,0,0,0,0,0,0,0,0,0,0,0,1,0,1,0,0,0,0,0,0,0,0,0
117520,30000,300,0,-2,1,0,1,0,0,0,0,0,0,1,0,1,0,0,0,0,0,0,0,0,0,0,0,0,0,0,0,0,0,0
117557,30000,300,0,-2,1,1,0,0,0,0,0,0,0,1,1,0,0,0,0,0,0,0,0,0,0,0,0,0,0,0,0,0,0,0
117636,30000,300,0,-2,8,2,6,0,0,0,1,1,0,0,0,0,2,0,2,0,0,0,4,1,3,1,0,1,0,0,0,0,0,0
117645,30000,300,0,-2,4,2,2,0,0,0,1,1,0,1,1,0,2,0,2,0,0,0,0,0,0,0,0,0,0,0,0,0,0,0
117672,30000,300,0,-2,8,0,8,0,0,0,0,0,0,2,0,2,1,0,1,0,0,0,5,0,5,0,0,0,0,0,0,0,0,0
117681,30000,300,0,-2,11,9,2,0,0,0,1,1,0,2,1,1,2,2,0,0,0,0,0,0,0,0,0,0,6,5,1,0,0,0
117690,30000,300,0,-2,1,0,1,0,0,0,1,0,1,0,0,0,0,0,0,0,0,0,0,0,0,0,0,0,0,0,0,0,0,0
117706,30000,300,0,-2,2,1,1,0,0,0,0,0,0,0,0,0,0,0,0,0,0,0,0,0,0,0,0,0,2,1,1,0,0,0
117715,30000,300,0,-2,4,3,1,0,0,0,1,0,1,0,0,0,0,0,0,0,0,0,1,1,0,0,0,0,2,2,0,0,0,0
117724,30000,300,0,-2,6,2,4,0,0,0,0,0,0,2,1,1,0,0,0,0,0,0,3,1,2,0,0,0,1,0,1,0,0,0
117733,30000,300,0,-2,4,3,1,0,0,0,0,0,0,0,0,0,2,1,1,0,0,0,2,2,0,0,0,0,0,0,0,0,0,0
117788,30000,300,0,-2,3,2,1,0,0,0,1,1,0,1,0,1,0,0,0,0,0,0,0,0,0,0,0,0,1,1,0,0,0,0
117867,30000,300,0,-2,2,2,0,0,0,0,0,0,0,0,0,0,0,0,0,0,0,0,2,2,0,0,0,0,0,0,0,0,0,0
117894,30000,300,0,-2,2,1,1,0,0,0,0,0,0,0,0,0,0,0,0,0,0,0,1,0,1,1,1,0,0,0,0,0,0,0
117900,30000,300,0,-2,5,4,1,0,0,0,2,2,0,2,1,1,1,1,0,0,0,0,0,0,0,0,0,0,0,0,0,0,0,0
117946,30000,300,0,-2,10,7,3,0,0,0,0,0,0,1,1,0,2,2,0,0,0,0,5,3,2,0,0,0,2,1,1,0,0,0
118198,30000,300,0,-2,1,0,1,0,0,0,0,0,0,1,0,1,0,0,0,0,0,0,0,0,0,0,0,0,0,0,0,0,0,0
118541,30000,300,0,-2,1,1,0,0,0,0,0,0,0,0,0,0,0,0,0,0,0,0,1,1,0,0,0,0,0,0,0,0,0,0
118684,30000,300,0,-2,1,0,1,0,0,0,0,0,0,0,0,0,0,0,0,0,0,0,1,0,1,0,0,0,0,0,0,0,0,0
118718,30000,300,0,-2,3,1,2,0,0,0,0,0,0,0,0,0,1,0,1,0,0,0,1,0,1,0,0,0,1,1,0,0,0,0
118888,30000,300,0,-2,7,0,7,0,0,0,0,0,0,1,0,1,2,0,2,0,0,0,2,0,2,1,0,1,1,0,1,0,0,0
118912,30000,300,0,-2,3,2,1,0,0,0,0,0,0,1,1,0,1,1,0,0,0,0,1,0,1,0,0,0,0,0,0,0,0,0
118930,30000,300,0,-2,2,1,1,0,0,0,0,0,0,0,0,0,1,1,0,0,0,0,0,0,0,0,0,0,1,0,1,0,0,0
118976,30000,300,0,-2,7,3,4,0,0,0,1,0,1,1,0,1,3,2,1,0,0,0,2,1,1,0,0,0,0,0,0,0,0,0
119067,30000,300,0,-2,2,1,1,0,0,0,0,0,0,2,1,1,0,0,0,0,0,0,0,0,0,0,0,0,0,0,0,0,0,0
119137,30000,300,0,-2,1,0,1,0,0,0,0,0,0,0,0,0,1,0,1,0,0,0,0,0,0,0,0,0,0,0,0,0,0,0
119164,30000,300,0,-2,9,5,4,0,0,0,1,1,0,0,0,0,4,1,3,0,0,0,1,1,0,0,0,0,3,2,1,0,0,0
119173,30000,300,0,-2,12,1,11,0,0,0,1,0,1,1,0,1,5,0,5,0,0,0,5,1,4,0,0,0,0,0,0,0,0,0
119331,30000,300,0,-2,3,2,1,0,0,0,0,0,0,1,0,1,0,0,0,0,0,0,1,1,0,0,0,0,1,1,0,0,0,0
119605,30000,300,0,-2,19,7,12,0,0,0,2,1,1,0,0,0,3,0,3,0,0,0,13,5,8,0,0,0,1,1,0,0,0,0
119678,30000,300,0,-2,3,2,1,0,0,0,0,0,0,0,0,0,0,0,0,0,0,0,3,2,1,0,0,0,0,0,0,0,0,0
119775,30000,300,0,-2,1,0,1,0,0,0,0,0,0,0,0,0,1,0,1,0,0,0,0,0,0,0,0,0,0,0,0,0,0,0
120184,30000,300,0,-2,4,3,1,0,0,0,0,0,0,0,0,0,2,2,0,0,0,0,2,1,1,0,0,0,0,0,0,0,0,0
120254,30000,300,0,-2,3,2,1,0,0,0,0,0,0,0,0,0,1,1,0,0,0,0,1,1,0,0,0,0,1,0,1,0,0,0
120290,30000,300,0,-2,5,2,3,0,0,0,0,0,0,1,1,0,1,0,1,0,0,0,2,1,1,0,0,0,1,0,1,0,0,0
120342,30000,300,0,-2,1,1,0,0,0,0,0,0,0,0,0,0,0,0,0,0,0,0,1,1,0,0,0,0,0,0,0,0,0,0
120403,30000,300,0,-2,7,2,5,0,0,0,2,1,1,0,0,0,0,0,0,0,0,0,4,0,4,1,1,0,0,0,0,0,0,0
120421,30000,300,0,-2,4,1,3,0,0,0,0,0,0,0,0,0,2,0,2,0,0,0,1,0,1,0,0,0,1,1,0,0,0,0
120661,30000,300,0,-2,4,0,4,0,0,0,1,0,1,0,0,0,1,0,1,0,0,0,0,0,0,1,0,1,1,0,1,0,0,0
120698,30000,300,0,-2,7,3,4,0,0,0,2,2,0,0,0,0,0,0,0,0,0,0,4,1,3,1,0,1,0,0,0,0,0,0
120795,30000,300,0,-2,3,2,1,0,0,0,0,0,0,0,0,0,1,1,0,0,0,0,2,1,1,0,0,0,0,0,0,0,0,0
120865,30000,300,0,-2,6,3,3,0,0,0,0,0,0,0,0,0,0,0,0,0,0,0,4,2,2,0,0,0,2,1,1,0,0,0
120883,30000,300,0,-2,30,11,19,0,0,0,3,0,3,5,1,4,5,1,4,0,0,0,15,8,7,2,1,1,0,0,0,0,0,0
120953,30000,300,0,-2,1,0,1,0,0,0,0,0,0,0,0,0,1,0,1,0,0,0,0,0,0,0,0,0,0,0,0,0,0,0
120971,30000,300,0,-2,5,1,4,1,1,0,0,0,0,0,0,0,2,0,2,1,0,1,1,0,1,0,0,0,0,0,0,0,0,0
121044,30000,300,0,-2,5,2,3,0,0,0,0,0,0,0,0,0,1,0,1,0,0,0,3,2,1,0,0,0,1,0,1,0,0,0
121150,30000,300,0,-2,13,2,11,0,0,0,2,0,2,2,0,2,0,0,0,0,0,0,9,2,7,0,0,0,0,0,0,0,0,0
121178,30000,300,0,-2,2,1,1,0,0,0,0,0,0,1,1,0,0,0,0,0,0,0,1,0,1,0,0,0,0,0,0,0,0,0
121257,30000,300,0,-2,2,1,1,0,0,0,0,0,0,1,0,1,0,0,0,0,0,0,1,1,0,0,0,0,0,0,0,0,0,0
121309,30000,300,0,-2,3,1,2,0,0,0,0,0,0,0,0,0,0,0,0,0,0,0,3,1,2,0,0,0,0,0,0,0,0,0
121345,30000,300,0,-2,16,7,9,0,0,0,3,2,1,4,2,2,4,1,3,0,0,0,4,2,2,0,0,0,1,0,1,0,0,0
121619,30000,300,0,-2,2,2,0,0,0,0,0,0,0,1,1,0,0,0,0,0,0,0,1,1,0,0,0,0,0,0,0,0,0,0
121691,30000,300,0,-2,12,4,8,0,0,0,2,1,1,1,1,0,2,0,2,0,0,0,7,2,5,0,0,0,0,0,0,0,0,0
121707,30000,300,0,-2,4,3,1,0,0,0,0,0,0,0,0,0,0,0,0,0,0,0,4,3,1,0,0,0,0,0,0,0,0,0
121886,30000,300,0,-2,1,1,0,0,0,0,0,0,0,0,0,0,0,0,0,0,0,0,1,1,0,0,0,0,0,0,0,0,0,0
121901,30000,300,0,-2,4,1,3,0,0,0,0,0,0,3,1,2,0,0,0,0,0,0,1,0,1,0,0,0,0,0,0,0,0,0
122180,30000,300,0,-2,2,2,0,0,0,0,0,0,0,1,1,0,0,0,0,0,0,0,0,0,0,0,0,0,1,1,0,0,0,0
122205,30000,300,0,-2,1,1,0,0,0,0,0,0,0,0,0,0,1,1,0,0,0,0,0,0,0,0,0,0,0,0,0,0,0,0
122296,30000,300,0,-2,3,2,1,0,0,0,0,0,0,0,0,0,1,1,0,0,0,0,0,0,0,0,0,0,2,1,1,0,0,0
122409,30000,300,0,-2,5,4,1,0,0,0,0,0,0,2,1,1,0,0,0,0,0,0,2,2,0,0,0,0,1,1,0,0,0,0
122436,30000,300,0,-2,5,1,4,0,0,0,0,0,0,3,0,3,0,0,0,0,0,0,2,1,1,0,0,0,0,0,0,0,0,0
122506,30000,300,0,-2,1,0,1,0,0,0,0,0,0,0,0,0,0,0,0,0,0,0,1,0,1,0,0,0,0,0,0,0,0,0
122597,30000,300,0,-2,7,0,7,0,0,0,1,0,1,2,0,2,2,0,2,0,0,0,2,0,2,0,0,0,0,0,0,0,0,0
122612,30000,300,0,-2,39,7,32,0,0,0,4,0,4,9,2,7,11,1,10,0,0,0,14,4,10,1,0,1,0,0,0,0,0,0
122685,30000,300,0,-2,9,4,5,0,0,0,0,0,0,3,2,1,3,1,2,0,0,0,3,1,2,0,0,0,0,0,0,0,0,0
122694,30000,300,0,-2,2,0,2,0,0,0,0,0,0,0,0,0,2,0,2,0,0,0,0,0,0,0,0,0,0,0,0,0,0,0
122728,30000,300,0,-2,2,2,0,0,0,0,0,0,0,0,0,0,0,0,0,0,0,0,2,2,0,0,0,0,0,0,0,0,0,0
122737,30000,300,0,-2,1,0,1,0,0,0,0,0,0,0,0,0,1,0,1,0,0,0,0,0,0,0,0,0,0,0,0,0,0,0
122746,30000,300,0,-2,8,7,1,0,0,0,1,0,1,1,1,0,5,5,0,0,0,0,0,0,0,0,0,0,1,1,0,0,0,0
122755,30000,300,0,-2,12,7,5,0,0,0,2,1,1,2,0,2,1,0,1,0,0,0,5,5,0,0,0,0,2,1,1,0,0,0
122782,30000,300,0,-2,1,1,0,0,0,0,0,0,0,0,0,0,0,0,0,0,0,0,1,1,0,0,0,0,0,0,0,0,0,0
122791,30000,300,0,-2,1,0,1,0,0,0,0,0,0,0,0,0,0,0,0,0,0,0,1,0,1,0,0,0,0,0,0,0,0,0
122889,30000,300,0,-2,3,1,2,0,0,0,0,0,0,0,0,0,0,0,0,0,0,0,3,1,2,0,0,0,0,0,0,0,0,0
122931,30000,300,0,-2,14,9,5,1,1,0,3,1,2,3,2,1,0,0,0,0,0,0,7,5,2,0,0,0,0,0,0,0,0,0
122977,30000,300,0,-2,1,1,0,0,0,0,0,0,0,0,0,0,0,0,0,0,0,0,1,1,0,0,0,0,0,0,0,0,0,0
123013,30000,300,0,-2,1,1,0,0,0,0,0,0,0,0,0,0,1,1,0,0,0,0,0,0,0,0,0,0,0,0,0,0,0,0
123095,30000,300,0,-2,4,2,2,0,0,0,0,0,0,1,0,1,2,1,1,0,0,0,1,1,0,0,0,0,0,0,0,0,0,0
123165,30000,300,0,-2,2,0,2,0,0,0,0,0,0,2,0,2,0,0,0,0,0,0,0,0,0,0,0,0,0,0,0,0,0,0
123217,30000,300,0,-2,1,0,1,0,0,0,0,0,0,0,0,0,1,0,1,0,0,0,0,0,0,0,0,0,0,0,0,0,0,0
123299,30000,300,0,-2,2,0,2,0,0,0,0,0,0,0,0,0,0,0,0,0,0,0,2,0,2,0,0,0,0,0,0,0,0,0
123341,30000,300,0,-2,3,2,1,0,0,0,0,0,0,0,0,0,0,0,0,0,0,0,2,1,1,0,0,0,1,1,0,0,0,0
123448,30000,300,0,-2,1,0,1,0,0,0,0,0,0,0,0,0,0,0,0,0,0,0,1,0,1,0,0,0,0,0,0,0,0,0
123457,30000,300,0,-2,4,2,2,0,0,0,0,0,0,2,2,0,0,0,0,0,0,0,2,0,2,0,0,0,0,0,0,0,0,0
123484,30000,300,0,-2,1,1,0,0,0,0,0,0,0,0,0,0,0,0,0,0,0,0,1,1,0,0,0,0,0,0,0,0,0,0
123509,30000,300,0,-2,1,1,0,0,0,0,0,0,0,0,0,0,0,0,0,0,0,0,0,0,0,0,0,0,0,0,0,1,1,0
123527,30000,300,0,-2,1,0,1,0,0,0,0,0,0,0,0,0,1,0,1,0,0,0,0,0,0,0,0,0,0,0,0,0,0,0
123554,30000,300,0,-2,7,6,1,0,0,0,1,0,1,1,1,0,0,0,0,0,0,0,3,3,0,1,1,0,1,1,0,0,0,0
123563,30000,300,0,-2,1,0,1,0,0,0,0,0,0,0,0,0,0,0,0,0,0,0,1,0,1,0,0,0,0,0,0,0,0,0
123572,30000,300,0,-2,3,2,1,0,0,0,0,0,0,1,0,1,0,0,0,0,0,0,1,1,0,0,0,0,1,1,0,0,0,0
123633,30000,300,0,-2,1,1,0,0,0,0,0,0,0,0,0,0,0,0,0,0,0,0,1,1,0,0,0,0,0,0,0,0,0,0
123651,30000,300,0,-2,8,3,5,0,0,0,0,0,0,0,0,0,3,1,2,0,0,0,5,2,3,0,0,0,0,0,0,0,0,0
123679,30000,300,0,-2,2,0,2,0,0,0,1,0,1,0,0,0,0,0,0,0,0,0,1,0,1,0,0,0,0,0,0,0,0,0
123800,30000,300,0,-2,5,4,1,0,0,0,0,0,0,3,2,1,2,2,0,0,0,0,0,0,0,0,0,0,0,0,0,0,0,0
123943,30000,300,0,-2,3,0,3,0,0,0,0,0,0,0,0,0,1,0,1,0,0,0,1,0,1,1,0,1,0,0,0,0,0,0
123952,30000,300,0,-2,2,1,1,0,0,0,1,1,0,1,0,1,0,0,0,0,0,0,0,0,0,0,0,0,0,0,0,0,0,0
123961,30000,300,0,-2,161,74,87,0,0,0,27,13,14,25,10,15,40,18,22,0,0,0,59,30,29,8,2,6,1,0,1,1,1,0
123970,30000,300,0,-2,2,1,1,0,0,0,0,0,0,0,0,0,0,0,0,0,0,0,2,1,1,0,0,0,0,0,0,0,0,0
124113,30000,300,0,-2,1,0,1,0,0,0,0,0,0,0,0,0,0,0,0,0,0,0,1,0,1,0,0,0,0,0,0,0,0,0
124283,30000,300,0,-2,1,1,0,0,0,0,0,0,0,0,0,0,0,0,0,0,0,0,0,0,0,0,0,0,1,1,0,0,0,0
124292,30000,300,0,-2,1,1,0,0,0,0,0,0,0,0,0,0,0,0,0,0,0,0,1,1,0,0,0,0,0,0,0,0,0,0
124557,30000,300,0,-2,34,16,18,0,0,0,5,2,3,7,4,3,6,1,5,0,0,0,8,5,3,2,1,1,0,0,0,6,3,3
124706,30000,300,0,-2,2,1,1,0,0,0,0,0,0,1,0,1,1,1,0,0,0,0,0,0,0,0,0,0,0,0,0,0,0,0
124937,30000,300,0,-2,5,2,3,0,0,0,1,1,0,1,0,1,0,0,0,0,0,0,1,1,0,1,0,1,1,0,1,0,0,0
125019,30000,300,0,-2,2,2,0,0,0,0,0,0,0,0,0,0,0,0,0,0,0,0,2,2,0,0,0,0,0,0,0,0,0,0
125028,30000,300,0,-2,4,2,2,0,0,0,0,0,0,0,0,0,2,1,1,0,0,0,0,0,0,0,0,0,2,1,1,0,0,0
125091,30000,300,0,-2,6,1,5,0,0,0,0,0,0,2,0,2,0,0,0,0,0,0,4,1,3,0,0,0,0,0,0,0,0,0
125231,30000,300,0,-2,14,2,12,0,0,0,0,0,0,1,0,1,0,0,0,0,0,0,11,2,9,0,0,0,2,0,2,0,0,0
125462,30000,300,0,-2,4,3,1,1,0,1,0,0,0,0,0,0,2,2,0,0,0,0,1,1,0,0,0,0,0,0,0,0,0,0
125471,30000,300,0,-2,8,4,4,0,0,0,0,0,0,1,1,0,2,0,2,0,0,0,1,1,0,0,0,0,4,2,2,0,0,0
125499,30000,300,0,-2,2,0,2,0,0,0,0,0,0,0,0,0,0,0,0,0,0,0,1,0,1,0,0,0,1,0,1,0,0,0
125532,30000,300,0,-2,22,5,17,0,0,0,2,0,2,3,0,3,6,2,4,0,0,0,8,1,7,1,0,1,2,2,0,0,0,0
125727,30000,300,0,-2,7,5,2,0,0,0,0,0,0,0,0,0,2,0,2,0,0,0,2,2,0,0,0,0,3,3,0,0,0,0
125763,30000,300,0,-2,5,3,2,0,0,0,0,0,0,2,2,0,1,0,1,1,0,1,1,1,0,0,0,0,0,0,0,0,0,0
125897,30000,300,0,-2,1,0,1,0,0,0,0,0,0,0,0,0,1,0,1,0,0,0,0,0,0,0,0,0,0,0,0,0,0,0
126049,30000,300,0,-2,3,1,2,0,0,0,0,0,0,1,0,1,0,0,0,0,0,0,2,1,1,0,0,0,0,0,0,0,0,0
126100,30000,300,0,-2,6,3,3,0,0,0,1,1,0,0,0,0,0,0,0,0,0,0,5,2,3,0,0,0,0,0,0,0,0,0
126182,30000,300,0,-2,4,1,3,0,0,0,0,0,0,1,1,0,1,0,1,0,0,0,2,0,2,0,0,0,0,0,0,0,0,0
126289,30000,300,0,-2,4,3,1,0,0,0,0,0,0,0,0,0,2,2,0,0,0,0,0,0,0,0,0,0,2,1,1,0,0,0
126359,30000,300,0,-2,1,1,0,0,0,0,0,0,0,0,0,0,0,0,0,0,0,0,1,1,0,0,0,0,0,0,0,0,0,0
126562,30000,300,0,-2,110,29,81,0,0,0,7,2,5,9,2,7,10,2,8,0,0,0,72,18,54,1,1,0,11,4,7,0,0,0
126580,30000,300,0,-2,2,1,1,0,0,0,0,0,0,0,0,0,0,0,0,0,0,0,2,1,1,0,0,0,0,0,0,0,0,0
126614,30000,300,0,-2,37,22,15,0,0,0,2,1,1,3,1,2,6,2,4,0,0,0,25,17,8,0,0,0,1,1,0,0,0,0
126669,30000,300,0,-2,5,1,4,0,0,0,0,0,0,0,0,0,0,0,0,0,0,0,5,1,4,0,0,0,0,0,0,0,0,0
126678,30000,300,0,-2,15,7,8,0,0,0,1,1,0,1,1,0,3,2,1,0,0,0,8,3,5,2,0,2,0,0,0,0,0,0
126687,30000,300,0,-2,2,0,2,0,0,0,0,0,0,0,0,0,0,0,0,0,0,0,2,0,2,0,0,0,0,0,0,0,0,0
126711,30000,300,0,-2,9,4,5,0,0,0,0,0,0,0,0,0,2,1,1,0,0,0,5,3,2,0,0,0,2,0,2,0,0,0
126748,30000,300,0,-2,3,1,2,0,0,0,0,0,0,2,1,1,0,0,0,0,0,0,1,0,1,0,0,0,0,0,0,0,0,0
126775,30000,300,0,-2,13,6,7,0,0,0,1,0,1,0,0,0,3,1,2,0,0,0,7,3,4,0,0,0,2,2,0,0,0,0
126818,30000,300,0,-2,4,1,3,0,0,0,0,0,0,2,0,2,0,0,0,0,0,0,1,0,1,0,0,0,1,1,0,0,0,0
126827,30000,300,0,-2,2,1,1,0,0,0,0,0,0,0,0,0,0,0,0,0,0,0,2,1,1,0,0,0,0,0,0,0,0,0
126863,30000,300,0,-2,4,3,1,0,0,0,0,0,0,1,1,0,1,1,0,0,0,0,2,1,1,0,0,0,0,0,0,0,0,0
126942,30000,300,0,-2,7,0,7,0,0,0,0,0,0,0,0,0,0,0,0,0,0,0,6,0,6,1,0,1,0,0,0,0,0,0
126951,30000,300,0,-2,14,4,10,0,0,0,0,0,0,4,1,3,2,2,0,0,0,0,7,1,6,1,0,1,0,0,0,0,0,0
126979,30000,300,0,-2,2,2,0,0,0,0,0,0,0,0,0,0,0,0,0,0,0,0,2,2,0,0,0,0,0,0,0,0,0,0
127060,30000,300,0,-2,63,28,35,8,6,2,2,2,0,4,1,3,4,1,3,0,0,0,30,10,20,12,5,7,3,3,0,0,0,0
127185,30000,300,0,-2,1,0,1,0,0,0,0,0,0,0,0,0,0,0,0,0,0,0,1,0,1,0,0,0,0,0,0,0,0,0
127200,30000,300,0,-2,4,1,3,0,0,0,1,0,1,0,0,0,0,0,0,0,0,0,3,1,2,0,0,0,0,0,0,0,0,0
127389,30000,300,0,-2,1,0,1,0,0,0,0,0,0,0,0,0,0,0,0,0,0,0,1,0,1,0,0,0,0,0,0,0,0,0
127556,30000,300,0,-2,9,3,6,0,0,0,0,0,0,0,0,0,1,1,0,0,0,0,7,2,5,0,0,0,1,0,1,0,0,0
127565,30000,300,0,-2,2,2,0,0,0,0,0,0,0,0,0,0,0,0,0,0,0,0,1,1,0,0,0,0,1,1,0,0,0,0
127617,30000,300,0,-2,4,2,2,0,0,0,0,0,0,0,0,0,0,0,0,0,0,0,4,2,2,0,0,0,0,0,0,0,0,0
127653,30000,300,0,-2,16,3,13,1,0,1,0,0,0,0,0,0,0,0,0,1,0,1,5,2,3,0,0,0,9,1,8,0,0,0
127714,30000,300,0,-2,2,2,0,0,0,0,0,0,0,0,0,0,0,0,0,0,0,0,2,2,0,0,0,0,0,0,0,0,0,0
127732,30000,300,0,-2,1,0,1,0,0,0,0,0,0,0,0,0,0,0,0,0,0,0,1,0,1,0,0,0,0,0,0,0,0,0
127741,30000,300,0,-2,13,5,8,0,0,0,0,0,0,0,0,0,2,1,1,0,0,0,10,3,7,1,1,0,0,0,0,0,0,0
127778,30000,300,0,-2,1,0,1,0,0,0,0,0,0,0,0,0,0,0,0,0,0,0,1,0,1,0,0,0,0,0,0,0,0,0
127820,30000,300,0,-2,8,2,6,0,0,0,0,0,0,2,0,2,0,0,0,0,0,0,6,2,4,0,0,0,0,0,0,0,0,0
127884,30000,300,0,-2,2,2,0,0,0,0,0,0,0,0,0,0,2,2,0,0,0,0,0,0,0,0,0,0,0,0,0,0,0,0
127909,30000,300,0,-2,2,2,0,0,0,0,0,0,0,1,1,0,0,0,0,0,0,0,1,1,0,0,0,0,0,0,0,0,0,0
127918,30000,300,0,-2,10,0,10,0,0,0,0,0,0,0,0,0,2,0,2,0,0,0,7,0,7,0,0,0,1,0,1,0,0,0
127945,30000,300,0,-2,2,2,0,0,0,0,0,0,0,1,1,0,0,0,0,0,0,0,1,1,0,0,0,0,0,0,0,0,0,0
128106,30000,300,0,-2,2,2,0,0,0,0,0,0,0,0,0,0,0,0,0,0,0,0,2,2,0,0,0,0,0,0,0,0,0,0
128300,30000,300,0,-2,3,2,1,0,0,0,1,1,0,0,0,0,0,0,0,0,0,0,2,1,1,0,0,0,0,0,0,0,0,0
128328,30000,300,0,-2,2,0,2,0,0,0,0,0,0,0,0,0,0,0,0,0,0,0,2,0,2,0,0,0,0,0,0,0,0,0
128391,30000,300,0,-2,5,1,4,0,0,0,0,0,0,0,0,0,0,0,0,0,0,0,5,1,4,0,0,0,0,0,0,0,0,0
128498,30000,300,0,-2,5,4,1,0,0,0,0,0,0,0,0,0,0,0,0,0,0,0,5,4,1,0,0,0,0,0,0,0,0,0
128744,30000,300,0,-2,4,3,1,0,0,0,0,0,0,1,1,0,1,1,0,0,0,0,2,1,1,0,0,0,0,0,0,0,0,0
128771,30000,300,0,-2,2,0,2,0,0,0,0,0,0,1,0,1,0,0,0,0,0,0,1,0,1,0,0,0,0,0,0,0,0,0
128780,30000,300,0,-2,1,1,0,0,0,0,0,0,0,0,0,0,0,0,0,0,0,0,1,1,0,0,0,0,0,0,0,0,0,0
128902,30000,300,0,-2,4,1,3,0,0,0,0,0,0,1,0,1,0,0,0,0,0,0,3,1,2,0,0,0,0,0,0,0,0,0
129020,30000,300,0,-2,11,3,8,0,0,0,0,0,0,3,0,3,0,0,0,0,0,0,8,3,5,0,0,0,0,0,0,0,0,0
129154,30000,300,0,-2,1,0,1,0,0,0,0,0,0,1,0,1,0,0,0,0,0,0,0,0,0,0,0,0,0,0,0,0,0,0
129215,30000,300,0,-2,1,1,0,0,0,0,0,0,0,1,1,0,0,0,0,0,0,0,0,0,0,0,0,0,0,0,0,0,0,0
129242,30000,300,0,-2,3,1,2,0,0,0,0,0,0,0,0,0,0,0,0,0,0,0,3,1,2,0,0,0,0,0,0,0,0,0
129428,30000,300,0,-2,1,0,1,0,0,0,0,0,0,0,0,0,0,0,0,0,0,0,1,0,1,0,0,0,0,0,0,0,0,0
129491,30000,300,0,-2,1,0,1,0,0,0,0,0,0,0,0,0,0,0,0,0,0,0,1,0,1,0,0,0,0,0,0,0,0,0
129525,30000,300,0,-2,4,1,3,0,0,0,0,0,0,0,0,0,2,0,2,0,0,0,2,1,1,0,0,0,0,0,0,0,0,0
129695,30000,300,0,-2,1,1,0,0,0,0,0,0,0,0,0,0,0,0,0,0,0,0,1,1,0,0,0,0,0,0,0,0,0,0
129774,30000,300,0,-2,7,3,4,0,0,0,0,0,0,0,0,0,1,0,1,0,0,0,5,2,3,0,0,0,1,1,0,0,0,0
129941,30000,300,0,-2,7,4,3,0,0,0,1,0,1,1,1,0,0,0,0,0,0,0,5,3,2,0,0,0,0,0,0,0,0,0
130110,30000,300,0,-2,1,0,1,0,0,0,0,0,0,0,0,0,0,0,0,0,0,0,1,0,1,0,0,0,0,0,0,0,0,0
130183,30000,300,0,-2,2,0,2,0,0,0,0,0,0,1,0,1,0,0,0,0,0,0,1,0,1,0,0,0,0,0,0,0,0,0
130217,30000,300,0,-2,2,1,1,0,0,0,0,0,0,0,0,0,0,0,0,0,0,0,1,0,1,0,0,0,1,1,0,0,0,0
130226,30000,300,0,-2,36,14,22,0,0,0,3,1,2,12,5,7,8,3,5,0,0,0,13,5,8,0,0,0,0,0,0,0,0,0
130253,30000,300,0,-2,17,7,10,0,0,0,0,0,0,0,0,0,0,0,0,0,0,0,10,3,7,1,0,1,6,4,2,0,0,0
130314,30000,300,0,-2,3,2,1,0,0,0,0,0,0,0,0,0,0,0,0,0,0,0,3,2,1,0,0,0,0,0,0,0,0,0
130396,30000,300,0,-2,1,0,1,0,0,0,0,0,0,1,0,1,0,0,0,0,0,0,0,0,0,0,0,0,0,0,0,0,0,0
130493,30000,300,0,-2,2,0,2,0,0,0,0,0,0,0,0,0,2,0,2,0,0,0,0,0,0,0,0,0,0,0,0,0,0,0
130590,30000,300,0,-2,3,0,3,0,0,0,0,0,0,1,0,1,0,0,0,0,0,0,2,0,2,0,0,0,0,0,0,0,0,0
130606,30000,300,0,-2,1,1,0,0,0,0,0,0,0,0,0,0,0,0,0,0,0,0,1,1,0,0,0,0,0,0,0,0,0,0
130624,30000,300,0,-2,15,9,6,0,0,0,0,0,0,0,0,0,3,1,2,0,0,0,10,7,3,0,0,0,2,1,1,0,0,0
130697,30000,300,0,-2,2,0,2,0,0,0,0,0,0,0,0,0,0,0,0,0,0,0,2,0,2,0,0,0,0,0,0,0,0,0
130776,30000,300,0,-2,1,0,1,0,0,0,0,0,0,0,0,0,0,0,0,0,0,0,1,0,1,0,0,0,0,0,0,0,0,0
130794,30000,300,0,-2,51,12,39,0,0,0,7,1,6,12,1,11,5,3,2,0,0,0,22,5,17,1,0,1,2,1,1,2,1,1
130882,30000,300,0,-2,2,2,0,0,0,0,0,0,0,1,1,0,0,0,0,0,0,0,1,1,0,0,0,0,0,0,0,0,0,0
130934,30000,300,0,-2,6,3,3,0,0,0,0,0,0,5,2,3,0,0,0,0,0,0,0,0,0,1,1,0,0,0,0,0,0,0
130943,30000,300,0,-2,19,6,13,0,0,0,1,0,1,2,0,2,0,0,0,0,0,0,16,6,10,0,0,0,0,0,0,0,0,0
131159,30000,300,0,-2,44,21,23,0,0,0,6,3,3,15,6,9,0,0,0,0,0,0,18,10,8,0,0,0,4,2,2,1,0,1
131283,30000,300,0,-2,12,3,9,0,0,0,0,0,0,2,0,2,0,0,0,0,0,0,10,3,7,0,0,0,0,0,0,0,0,0
131399,30000,300,0,-2,9,5,4,0,0,0,2,2,0,5,2,3,1,1,0,0,0,0,1,0,1,0,0,0,0,0,0,0,0,0
131450,30000,300,0,-2,11,5,6,0,0,0,0,0,0,2,0,2,2,2,0,0,0,0,7,3,4,0,0,0,0,0,0,0,0,0
131469,30000,300,0,-2,18,8,10,0,0,0,2,1,1,4,3,1,1,1,0,0,0,0,9,2,7,0,0,0,2,1,1,0,0,0
131496,30000,300,0,-2,55,22,33,0,0,0,4,0,4,8,3,5,2,1,1,0,0,0,35,17,18,2,1,1,3,0,3,1,0,1
131520,30000,300,0,-2,69,20,49,0,0,0,1,1,0,43,12,31,2,0,2,0,0,0,5,3,2,5,1,4,13,3,10,0,0,0
131803,30000,300,0,-2,5,0,5,0,0,0,0,0,0,0,0,0,0,0,0,0,0,0,5,0,5,0,0,0,0,0,0,0,0,0
131876,30000,300,0,-2,1,0,1,0,0,0,0,0,0,0,0,0,0,0,0,0,0,0,0,0,0,1,0,1,0,0,0,0,0,0
132408,30000,300,0,-2,1,1,0,0,0,0,0,0,0,0,0,0,0,0,0,0,0,0,1,1,0,0,0,0,0,0,0,0,0,0
132471,30000,300,0,-2,25,6,19,0,0,0,0,0,0,9,2,7,8,2,6,0,0,0,5,2,3,0,0,0,3,0,3,0,0,0
132602,30000,300,0,-2,5,5,0,0,0,0,0,0,0,5,5,0,0,0,0,0,0,0,0,0,0,0,0,0,0,0,0,0,0,0
132657,30000,300,0,-2,4,2,2,0,0,0,0,0,0,1,1,0,1,1,0,0,0,0,2,0,2,0,0,0,0,0,0,0,0,0
132709,30000,300,0,-2,8,1,7,0,0,0,0,0,0,3,0,3,1,1,0,0,0,0,4,0,4,0,0,0,0,0,0,0,0,0
132842,30000,300,0,-2,1,0,1,0,0,0,0,0,0,0,0,0,1,0,1,0,0,0,0,0,0,0,0,0,0,0,0,0,0,0
132851,30000,300,0,-2,2,1,1,0,0,0,0,0,0,0,0,0,0,0,0,0,0,0,2,1,1,0,0,0,0,0,0,0,0,0
132903,30000,300,0,-2,2,2,0,0,0,0,0,0,0,1,1,0,0,0,0,0,0,0,1,1,0,0,0,0,0,0,0,0,0,0
133386,30000,300,0,-2,5,2,3,0,0,0,0,0,0,1,0,1,0,0,0,0,0,0,4,2,2,0,0,0,0,0,0,0,0,0
133465,30000,300,0,-2,2,2,0,0,0,0,0,0,0,0,0,0,0,0,0,0,0,0,2,2,0,0,0,0,0,0,0,0,0,0
133492,30000,300,0,-2,10,3,7,0,0,0,0,0,0,2,0,2,0,0,0,0,0,0,7,2,5,1,1,0,0,0,0,0,0,0
133508,30000,300,0,-2,4,3,1,0,0,0,0,0,0,0,0,0,0,0,0,0,0,0,4,3,1,0,0,0,0,0,0,0,0,0
133526,30000,300,0,-2,5,2,3,0,0,0,0,0,0,5,2,3,0,0,0,0,0,0,0,0,0,0,0,0,0,0,0,0,0,0
133553,30000,300,0,-2,17,8,9,0,0,0,0,0,0,0,0,0,1,0,1,0,0,0,15,7,8,1,1,0,0,0,0,0,0,0
133650,30000,300,0,-2,9,6,3,0,0,0,0,0,0,5,3,2,1,1,0,0,0,0,3,2,1,0,0,0,0,0,0,0,0,0
133669,30000,300,0,-2,26,11,15,0,0,0,0,0,0,12,5,7,6,2,4,0,0,0,8,4,4,0,0,0,0,0,0,0,0,0
133702,30000,300,0,-2,9,2,7,0,0,0,0,0,0,3,1,2,1,0,1,0,0,0,5,1,4,0,0,0,0,0,0,0,0,0
133711,30000,300,0,-2,7,6,1,0,0,0,0,0,0,2,1,1,1,1,0,0,0,0,4,4,0,0,0,0,0,0,0,0,0,0
133809,30000,300,0,-2,1,0,1,0,0,0,0,0,0,0,0,0,0,0,0,0,0,0,1,0,1,0,0,0,0,0,0,0,0,0
133845,30000,300,0,-2,3,2,1,0,0,0,1,1,0,0,0,0,0,0,0,0,0,0,2,1,1,0,0,0,0,0,0,0,0,0
133854,30000,300,0,-2,1,0,1,0,0,0,0,0,0,0,0,0,1,0,1,0,0,0,0,0,0,0,0,0,0,0,0,0,0,0
133863,30000,300,0,-2,3,1,2,0,0,0,0,0,0,2,1,1,0,0,0,0,0,0,1,0,1,0,0,0,0,0,0,0,0,0
133881,30000,300,0,-2,7,6,1,0,0,0,0,0,0,0,0,0,1,1,0,0,0,0,6,5,1,0,0,0,0,0,0,0,0,0
133951,30000,300,0,-2,9,3,6,0,0,0,0,0,0,1,0,1,4,1,3,0,0,0,4,2,2,0,0,0,0,0,0,0,0,0
133960,30000,300,0,-2,2,2,0,0,0,0,0,0,0,0,0,0,0,0,0,0,0,0,2,2,0,0,0,0,0,0,0,0,0,0
133979,30000,300,0,-2,2,2,0,0,0,0,0,0,0,2,2,0,0,0,0,0,0,0,0,0,0,0,0,0,0,0,0,0,0,0
134079,30000,300,0,-2,2,1,1,0,0,0,0,0,0,0,0,0,1,1,0,0,0,0,1,0,1,0,0,0,0,0,0,0,0,0
134097,30000,300,0,-2,6,4,2,0,0,0,2,1,1,0,0,0,1,1,0,0,0,0,3,2,1,0,0,0,0,0,0,0,0,0
134130,30000,300,0,-2,38,17,21,0,0,0,0,0,0,6,5,1,2,1,1,0,0,0,25,9,16,0,0,0,4,1,3,1,1,0
134237,30000,300,0,-2,16,6,10,0,0,0,1,1,0,0,0,0,0,0,0,0,0,0,15,5,10,0,0,0,0,0,0,0,0,0
134343,30000,300,0,-2,5,3,2,0,0,0,0,0,0,1,0,1,0,0,0,0,0,0,3,3,0,0,0,0,1,0,1,0,0,0
134495,30000,300,0,-2,7,1,6,0,0,0,1,1,0,0,0,0,0,0,0,0,0,0,6,0,6,0,0,0,0,0,0,0,0,0
134608,30000,300,0,-2,5,5,0,0,0,0,0,0,0,0,0,0,2,2,0,0,0,0,3,3,0,0,0,0,0,0,0,0,0,0
134945,30000,300,0,-2,2,1,1,0,0,0,0,0,0,1,0,1,0,0,0,0,0,0,1,1,0,0,0,0,0,0,0,0,0,0
135081,30000,300,0,-2,9,5,4,0,0,0,0,0,0,3,1,2,0,0,0,0,0,0,4,3,1,2,1,1,0,0,0,0,0,0
135188,30000,300,0,-2,12,4,8,0,0,0,0,0,0,1,0,1,2,1,1,0,0,0,9,3,6,0,0,0,0,0,0,0,0,0
135391,30000,300,0,-2,2,1,1,0,0,0,0,0,0,0,0,0,0,0,0,0,0,0,2,1,1,0,0,0,0,0,0,0,0,0
135717,30000,300,0,-2,5,1,4,0,0,0,0,0,0,1,0,1,1,0,1,0,0,0,3,1,2,0,0,0,0,0,0,0,0,0
135726,30000,300,0,-2,108,52,56,0,0,0,6,2,4,13,6,7,36,16,20,0,0,0,44,24,20,3,2,1,2,1,1,4,1,3
136172,30000,300,0,-2,13,7,6,0,0,0,0,0,0,2,0,2,0,0,0,0,0,0,10,6,4,1,1,0,0,0,0,0,0,0
136215,30000,300,0,-2,38,13,25,0,0,0,2,2,0,7,1,6,4,0,4,0,0,0,21,8,13,1,0,1,3,2,1,0,0,0
136233,30000,300,0,-2,1,0,1,0,0,0,0,0,0,0,0,0,0,0,0,0,0,0,1,0,1,0,0,0,0,0,0,0,0,0
136330,30000,300,0,-2,4,3,1,0,0,0,0,0,0,0,0,0,0,0,0,0,0,0,4,3,1,0,0,0,0,0,0,0,0,0
136358,30000,300,0,-2,2,2,0,0,0,0,0,0,0,1,1,0,0,0,0,0,0,0,1,1,0,0,0,0,0,0,0,0,0,0
136400,30000,300,0,-2,1,0,1,0,0,0,0,0,0,0,0,0,0,0,0,0,0,0,0,0,0,0,0,0,1,0,1,0,0,0
136473,30000,300,0,-2,2,0,2,0,0,0,0,0,0,0,0,0,0,0,0,0,0,0,1,0,1,0,0,0,1,0,1,0,0,0
136516,30000,300,0,-2,3,3,0,0,0,0,0,0,0,0,0,0,0,0,0,0,0,0,3,3,0,0,0,0,0,0,0,0,0,0
136774,30000,300,0,-2,8,5,3,0,0,0,0,0,0,0,0,0,1,1,0,0,0,0,7,4,3,0,0,0,0,0,0,0,0,0
136950,30000,300,0,-2,4,0,4,0,0,0,0,0,0,1,0,1,0,0,0,0,0,0,2,0,2,1,0,1,0,0,0,0,0,0
137032,30000,300,0,-2,15,9,6,0,0,0,0,0,0,0,0,0,3,3,0,0,0,0,10,4,6,0,0,0,2,2,0,0,0,0
137078,30000,300,0,-2,10,6,4,1,0,1,0,0,0,4,1,3,1,1,0,0,0,0,4,4,0,0,0,0,0,0,0,0,0,0
137096,30000,300,0,-2,5,2,3,0,0,0,0,0,0,0,0,0,2,0,2,0,0,0,3,2,1,0,0,0,0,0,0,0,0,0
137209,30000,300,0,-2,3,3,0,0,0,0,0,0,0,0,0,0,0,0,0,0,0,0,3,3,0,0,0,0,0,0,0,0,0,0
137272,30000,300,0,-2,1,1,0,0,0,0,0,0,0,0,0,0,1,1,0,0,0,0,0,0,0,0,0,0,0,0,0,0,0,0
137281,30000,300,0,-2,2,2,0,0,0,0,0,0,0,0,0,0,0,0,0,0,0,0,2,2,0,0,0,0,0,0,0,0,0,0
137315,30000,300,0,-2,3,2,1,0,0,0,0,0,0,0,0,0,0,0,0,0,0,0,3,2,1,0,0,0,0,0,0,0,0,0
137351,30000,300,0,-2,21,8,13,0,0,0,1,1,0,4,2,2,1,0,1,0,0,0,13,5,8,2,0,2,0,0,0,0,0,0
137476,30000,300,0,-2,16,6,10,0,0,0,0,0,0,3,2,1,7,3,4,0,0,0,2,1,1,1,0,1,3,0,3,0,0,0
137546,30000,300,0,-2,11,7,4,0,0,0,0,0,0,0,0,0,3,1,2,0,0,0,8,6,2,0,0,0,0,0,0,0,0,0
137564,30000,300,0,-2,7,4,3,0,0,0,0,0,0,1,0,1,0,0,0,0,0,0,6,4,2,0,0,0,0,0,0,0,0,0
137759,30000,300,0,-2,2,2,0,0,0,0,0,0,0,0,0,0,0,0,0,0,0,0,2,2,0,0,0,0,0,0,0,0,0,0
137801,30000,300,0,-2,4,0,4,0,0,0,0,0,0,0,0,0,0,0,0,0,0,0,3,0,3,1,0,1,0,0,0,0,0,0
137847,30000,300,0,-2,2,0,2,0,0,0,0,0,0,0,0,0,0,0,0,0,0,0,2,0,2,0,0,0,0,0,0,0,0,0
137962,30000,300,0,-2,1,0,1,0,0,0,0,0,0,0,0,0,0,0,0,0,0,0,1,0,1,0,0,0,0,0,0,0,0,0
138187,30000,300,0,-2,2,1,1,0,0,0,0,0,0,0,0,0,0,0,0,0,0,0,2,1,1,0,0,0,0,0,0,0,0,0
138293,30000,300,0,-2,1,1,0,0,0,0,0,0,0,0,0,0,0,0,0,0,0,0,1,1,0,0,0,0,0,0,0,0,0,0
138309,30000,300,0,-2,4,2,2,0,0,0,0,0,0,1,1,0,1,0,1,0,0,0,1,0,1,0,0,0,1,1,0,0,0,0
138354,30000,300,0,-2,11,6,5,0,0,0,0,0,0,2,2,0,0,0,0,0,0,0,9,4,5,0,0,0,0,0,0,0,0,0
138558,30000,300,0,-2,1,0,1,0,0,0,0,0,0,0,0,0,0,0,0,0,0,0,1,0,1,0,0,0,0,0,0,0,0,0
138600,30000,300,0,-2,2,1,1,0,0,0,0,0,0,2,1,1,0,0,0,0,0,0,0,0,0,0,0,0,0,0,0,0,0,0
138716,30000,300,0,-2,7,1,6,0,0,0,0,0,0,3,1,2,0,0,0,0,0,0,4,0,4,0,0,0,0,0,0,0,0,0
138813,30000,300,0,-2,1,1,0,0,0,0,0,0,0,1,1,0,0,0,0,0,0,0,0,0,0,0,0,0,0,0,0,0,0,0
138840,30000,300,0,-2,4,1,3,0,0,0,0,0,0,3,1,2,0,0,0,0,0,0,1,0,1,0,0,0,0,0,0,0,0,0
138868,30000,300,0,-2,2,1,1,0,0,0,0,0,0,2,1,1,0,0,0,0,0,0,0,0,0,0,0,0,0,0,0,0,0,0
138901,30000,300,0,-2,2,1,1,0,0,0,0,0,0,2,1,1,0,0,0,0,0,0,0,0,0,0,0,0,0,0,0,0,0,0
138929,30000,300,0,-2,2,0,2,0,0,0,0,0,0,2,0,2,0,0,0,0,0,0,0,0,0,0,0,0,0,0,0,0,0,0
138947,30000,300,0,-2,3,2,1,0,0,0,0,0,0,2,2,0,0,0,0,0,0,0,0,0,0,0,0,0,1,0,1,0,0,0
138956,30000,300,0,-2,2,1,1,0,0,0,0,0,0,1,1,0,1,0,1,0,0,0,0,0,0,0,0,0,0,0,0,0,0,0
139144,30000,300,0,-2,8,1,7,0,0,0,1,0,1,0,0,0,1,1,0,0,0,0,6,0,6,0,0,0,0,0,0,0,0,0
139199,30000,300,0,-2,1,0,1,0,0,0,0,0,0,0,0,0,0,0,0,0,0,0,1,0,1,0,0,0,0,0,0,0,0,0
139205,30000,300,0,-2,1,1,0,0,0,0,0,0,0,1,1,0,0,0,0,0,0,0,0,0,0,0,0,0,0,0,0,0,0,0
139250,30000,300,0,-2,1,1,0,0,0,0,0,0,0,1,1,0,0,0,0,0,0,0,0,0,0,0,0,0,0,0,0,0,0,0
139278,30000,300,0,-2,1,0,1,0,0,0,0,0,0,0,0,0,0,0,0,0,0,0,1,0,1,0,0,0,0,0,0,0,0,0
139311,30000,300,0,-2,8,2,6,0,0,0,0,0,0,5,1,4,0,0,0,0,0,0,3,1,2,0,0,0,0,0,0,0,0,0
139348,30000,300,0,-2,1,0,1,0,0,0,0,0,0,1,0,1,0,0,0,0,0,0,0,0,0,0,0,0,0,0,0,0,0,0
139357,30000,300,0,-2,2,2,0,0,0,0,0,0,0,0,0,0,0,0,0,0,0,0,2,2,0,0,0,0,0,0,0,0,0,0
139366,30000,300,0,-2,8,5,3,0,0,0,0,0,0,3,1,2,0,0,0,0,0,0,5,4,1,0,0,0,0,0,0,0,0,0
139393,30000,300,0,-2,4,3,1,0,0,0,0,0,0,0,0,0,0,0,0,0,0,0,2,1,1,0,0,0,0,0,0,2,2,0
139463,30000,300,0,-2,2,0,2,0,0,0,0,0,0,0,0,0,0,0,0,0,0,0,2,0,2,0,0,0,0,0,0,0,0,0
139579,30000,300,0,-2,3,2,1,0,0,0,0,0,0,1,1,0,0,0,0,0,0,0,1,1,0,1,0,1,0,0,0,0,0,0
139621,30000,300,0,-2,2,0,2,0,0,0,0,0,0,0,0,0,0,0,0,0,0,0,2,0,2,0,0,0,0,0,0,0,0,0
139630,30000,300,0,-2,2,1,1,0,0,0,0,0,0,1,1,0,0,0,0,0,0,0,1,0,1,0,0,0,0,0,0,0,0,0
139658,30000,300,0,-2,86,29,57,0,0,0,8,3,5,22,8,14,4,2,2,0,0,0,49,15,34,2,0,2,0,0,0,1,1,0
139700,30000,300,0,-2,2,0,2,0,0,0,0,0,0,1,0,1,0,0,0,0,0,0,1,0,1,0,0,0,0,0,0,0,0,0
139719,30000,300,0,-2,10,5,5,0,0,0,0,0,0,7,3,4,0,0,0,0,0,0,2,2,0,0,0,0,1,0,1,0,0,0
139755,30000,300,0,-2,88,35,53,0,0,0,4,0,4,48,20,28,3,0,3,0,0,0,30,14,16,1,0,1,0,0,0,2,1,1
139764,30000,300,0,-2,2,1,1,0,0,0,0,0,0,0,0,0,0,0,0,0,0,0,2,1,1,0,0,0,0,0,0,0,0,0
139861,30000,300,0,-2,6,4,2,0,0,0,0,0,0,1,1,0,0,0,0,0,0,0,5,3,2,0,0,0,0,0,0,0,0,0
139931,30000,300,0,-2,17,8,9,0,0,0,1,0,1,5,2,3,3,1,2,0,0,0,8,5,3,0,0,0,0,0,0,0,0,0
139940,30000,300,0,-2,33,7,26,0,0,0,2,1,1,12,2,10,1,0,1,0,0,0,17,4,13,1,0,1,0,0,0,0,0,0
139959,30000,300,0,-2,30,15,15,0,0,0,0,0,0,7,3,4,4,2,2,0,0,0,18,10,8,0,0,0,1,0,1,0,0,0
139968,30000,300,0,-2,2,2,0,0,0,0,0,0,0,1,1,0,0,0,0,0,0,0,1,1,0,0,0,0,0,0,0,0,0,0
139986,30000,300,0,-2,3,1,2,0,0,0,0,0,0,1,1,0,0,0,0,0,0,0,2,0,2,0,0,0,0,0,0,0,0,0
140012,30000,300,0,-2,2,0,2,0,0,0,0,0,0,1,0,1,0,0,0,0,0,0,1,0,1,0,0,0,0,0,0,0,0,0
140146,30000,300,0,-2,1,0,1,0,0,0,0,0,0,1,0,1,0,0,0,0,0,0,0,0,0,0,0,0,0,0,0,0,0,0
140234,30000,300,0,-2,3,1,2,0,0,0,0,0,0,1,0,1,0,0,0,0,0,0,2,1,1,0,0,0,0,0,0,0,0,0
140252,30000,300,0,-2,13,7,6,0,0,0,2,2,0,5,4,1,0,0,0,0,0,0,5,1,4,1,0,1,0,0,0,0,0,0
140447,30000,300,0,-2,6,4,2,0,0,0,0,0,0,0,0,0,0,0,0,0,0,0,6,4,2,0,0,0,0,0,0,0,0,0
140553,30000,300,0,-2,30,14,16,0,0,0,2,0,2,22,12,10,1,0,1,0,0,0,4,1,3,0,0,0,1,1,0,0,0,0
140562,30000,300,0,-2,37,7,30,0,0,0,0,0,0,30,4,26,2,1,1,0,0,0,5,2,3,0,0,0,0,0,0,0,0,0
140678,30000,300,0,-2,2,1,1,0,0,0,0,0,0,0,0,0,0,0,0,0,0,0,2,1,1,0,0,0,0,0,0,0,0,0
140696,30000,300,0,-2,10,4,6,0,0,0,1,0,1,4,1,3,0,0,0,0,0,0,5,3,2,0,0,0,0,0,0,0,0,0
140720,30000,300,0,-2,1,1,0,0,0,0,0,0,0,1,1,0,0,0,0,0,0,0,0,0,0,0,0,0,0,0,0,0,0,0
140818,30000,300,0,-2,3,2,1,0,0,0,0,0,0,0,0,0,0,0,0,0,0,0,3,2,1,0,0,0,0,0,0,0,0,0
140872,30000,300,0,-2,1,1,0,0,0,0,0,0,0,0,0,0,0,0,0,0,0,0,1,1,0,0,0,0,0,0,0,0,0,0
140942,30000,300,0,-2,1,0,1,0,0,0,0,0,0,1,0,1,0,0,0,0,0,0,0,0,0,0,0,0,0,0,0,0,0,0
140951,30000,300,0,-2,12,2,10,0,0,0,0,0,0,0,0,0,1,0,1,0,0,0,8,2,6,0,0,0,3,0,3,0,0,0
140960,30000,300,0,-2,7,2,5,0,0,0,0,0,0,5,2,3,0,0,0,0,0,0,2,0,2,0,0,0,0,0,0,0,0,0
140988,30000,300,0,-2,3,0,3,0,0,0,0,0,0,0,0,0,0,0,0,0,0,0,3,0,3,0,0,0,0,0,0,0,0,0
141185,30000,300,0,-2,2,2,0,0,0,0,0,0,0,0,0,0,0,0,0,0,0,0,2,2,0,0,0,0,0,0,0,0,0,0
141264,30000,300,0,-2,6,3,3,0,0,0,0,0,0,2,2,0,1,0,1,0,0,0,2,1,1,0,0,0,1,0,1,0,0,0
141334,30000,300,0,-2,11,4,7,0,0,0,0,0,0,3,1,2,1,0,1,0,0,0,6,3,3,1,0,1,0,0,0,0,0,0
141486,30000,300,0,-2,5,2,3,0,0,0,1,0,1,0,0,0,2,1,1,0,0,0,2,1,1,0,0,0,0,0,0,0,0,0
141565,30000,300,0,-2,1,1,0,0,0,0,0,0,0,0,0,0,0,0,0,0,0,0,1,1,0,0,0,0,0,0,0,0,0,0
141574,30000,300,0,-2,2,1,1,0,0,0,0,0,0,0,0,0,0,0,0,0,0,0,1,1,0,1,0,1,0,0,0,0,0,0
141644,30000,300,0,-2,7,3,4,0,0,0,1,0,1,0,0,0,0,0,0,1,0,1,5,3,2,0,0,0,0,0,0,0,0,0
141963,30000,300,0,-2,1,1,0,0,0,0,0,0,0,0,0,0,0,0,0,0,0,0,0,0,0,1,1,0,0,0,0,0,0,0
141981,30000,300,0,-2,1,1,0,0,0,0,0,0,0,0,0,0,0,0,0,0,0,0,1,1,0,0,0,0,0,0,0,0,0,0
142054,30000,300,0,-2,5,3,2,0,0,0,0,0,0,0,0,0,0,0,0,0,0,0,4,3,1,1,0,1,0,0,0,0,0,0
142090,30000,300,0,-2,1,1,0,0,0,0,0,0,0,0,0,0,0,0,0,0,0,0,1,1,0,0,0,0,0,0,0,0,0,0
142115,30000,300,0,-2,6,4,2,0,0,0,1,1,0,0,0,0,0,0,0,0,0,0,4,2,2,0,0,0,1,1,0,0,0,0
142179,30000,300,0,-2,5,4,1,0,0,0,0,0,0,0,0,0,1,1,0,0,0,0,4,3,1,0,0,0,0,0,0,0,0,0
142276,30000,300,0,-2,6,2,4,0,0,0,0,0,0,0,0,0,0,0,0,0,0,0,4,1,3,0,0,0,2,1,1,0,0,0
142285,30000,300,0,-2,5,2,3,0,0,0,0,0,0,0,0,0,1,0,1,0,0,0,4,2,2,0,0,0,0,0,0,0,0,0
142294,30000,300,0,-2,5,2,3,0,0,0,1,0,1,0,0,0,0,0,0,0,0,0,3,2,1,1,0,1,0,0,0,0,0,0
142328,30000,300,0,-2,3,2,1,0,0,0,0,0,0,0,0,0,0,0,0,0,0,0,3,2,1,0,0,0,0,0,0,0,0,0
142443,30000,300,0,-2,3,2,1,0,0,0,1,1,0,0,0,0,1,1,0,0,0,0,1,0,1,0,0,0,0,0,0,0,0,0
142461,30000,300,0,-2,3,1,2,0,0,0,0,0,0,0,0,0,0,0,0,0,0,0,3,1,2,0,0,0,0,0,0,0,0,0
142522,30000,300,0,-2,1,0,1,0,0,0,0,0,0,0,0,0,0,0,0,0,0,0,1,0,1,0,0,0,0,0,0,0,0,0
142559,30000,300,0,-2,9,3,6,0,0,0,0,0,0,0,0,0,2,0,2,0,0,0,6,3,3,1,0,1,0,0,0,0,0,0
142832,30000,300,0,-2,6,4,2,0,0,0,1,1,0,3,1,2,1,1,0,0,0,0,0,0,0,0,0,0,1,1,0,0,0,0
143048,30000,300,0,-2,4,0,4,0,0,0,0,0,0,1,0,1,0,0,0,0,0,0,2,0,2,0,0,0,0,0,0,1,0,1
143084,30000,300,0,-2,14,7,7,0,0,0,0,0,0,2,0,2,1,0,1,0,0,0,11,7,4,0,0,0,0,0,0,0,0,0
143118,30000,300,0,-2,3,2,1,0,0,0,0,0,0,1,0,1,0,0,0,0,0,0,2,2,0,0,0,0,0,0,0,0,0,0
143215,30000,300,0,-2,5,0,5,0,0,0,0,0,0,0,0,0,0,0,0,0,0,0,4,0,4,0,0,0,1,0,1,0,0,0
143288,30000,300,0,-2,8,3,5,0,0,0,0,0,0,3,0,3,0,0,0,0,0,0,5,3,2,0,0,0,0,0,0,0,0,0
143613,30000,300,0,-2,2,2,0,0,0,0,0,0,0,1,1,0,0,0,0,0,0,0,1,1,0,0,0,0,0,0,0,0,0,0
143978,30000,300,0,-2,1,1,0,0,0,0,0,0,0,0,0,0,0,0,0,0,0,0,1,1,0,0,0,0,0,0,0,0,0,0
144005,30000,300,0,-2,13,3,10,0,0,0,0,0,0,4,0,4,1,0,1,0,0,0,2,1,1,0,0,0,6,2,4,0,0,0
144050,30000,300,0,-2,168,80,88,0,0,0,19,8,11,30,6,24,21,13,8,0,0,0,85,46,39,7,3,4,2,1,1,4,3,1
144157,30000,300,0,-2,1,0,1,0,0,0,0,0,0,1,0,1,0,0,0,0,0,0,0,0,0,0,0,0,0,0,0,0,0,0
144166,30000,300,0,-2,3,2,1,0,0,0,0,0,0,1,1,0,0,0,0,0,0,0,2,1,1,0,0,0,0,0,0,0,0,0
144175,30000,300,0,-2,2,0,2,0,0,0,0,0,0,0,0,0,0,0,0,0,0,0,2,0,2,0,0,0,0,0,0,0,0,0
144184,30000,300,0,-2,2,2,0,0,0,0,0,0,0,2,2,0,0,0,0,0,0,0,0,0,0,0,0,0,0,0,0,0,0,0
144209,30000,300,0,-2,4,0,4,0,0,0,0,0,0,1,0,1,0,0,0,0,0,0,2,0,2,1,0,1,0,0,0,0,0,0
144281,30000,300,0,-2,5,3,2,0,0,0,0,0,0,1,1,0,0,0,0,0,0,0,4,2,2,0,0,0,0,0,0,0,0,0
144351,30000,300,0,-2,9,3,6,0,0,0,0,0,0,0,0,0,0,0,0,0,0,0,8,3,5,0,0,0,0,0,0,1,0,1
144485,30000,300,0,-2,1,0,1,0,0,0,0,0,0,0,0,0,0,0,0,0,0,0,1,0,1,0,0,0,0,0,0,0,0,0
144500,30000,300,0,-2,6,5,1,0,0,0,0,0,0,2,2,0,2,1,1,0,0,0,2,2,0,0,0,0,0,0,0,0,0,0
144564,30000,300,0,-2,1,0,1,0,0,0,0,0,0,0,0,0,0,0,0,0,0,0,1,0,1,0,0,0,0,0,0,0,0,0
144740,30000,300,0,-2,14,6,8,0,0,0,1,1,0,0,0,0,1,0,1,0,0,0,12,5,7,0,0,0,0,0,0,0,0,0
144777,30000,300,0,-2,10,6,4,0,0,0,0,0,0,1,0,1,0,0,0,0,0,0,9,6,3,0,0,0,0,0,0,0,0,0
144865,30000,300,0,-2,6,3,3,0,0,0,0,0,0,2,1,1,2,1,1,0,0,0,2,1,1,0,0,0,0,0,0,0,0,0
144944,30000,300,0,-2,6,1,5,0,0,0,1,1,0,1,0,1,1,0,1,0,0,0,3,0,3,0,0,0,0,0,0,0,0,0
144962,30000,300,0,-2,9,1,8,0,0,0,0,0,0,0,0,0,2,0,2,0,0,0,7,1,6,0,0,0,0,0,0,0,0,0
144971,30000,300,0,-2,1,1,0,0,0,0,0,0,0,0,0,0,1,1,0,0,0,0,0,0,0,0,0,0,0,0,0,0,0,0
145275,30000,300,0,-2,2,1,1,0,0,0,0,0,0,1,0,1,0,0,0,0,0,0,1,1,0,0,0,0,0,0,0,0,0,0
145336,30000,300,0,-2,6,3,3,0,0,0,1,0,1,1,1,0,1,0,1,0,0,0,1,1,0,0,0,0,2,1,1,0,0,0
145372,30000,300,0,-2,5,2,3,0,0,0,0,0,0,1,0,1,0,0,0,0,0,0,4,2,2,0,0,0,0,0,0,0,0,0
145521,30000,300,0,-2,3,1,2,0,0,0,0,0,0,0,0,0,0,0,0,0,0,0,3,1,2,0,0,0,0,0,0,0,0,0
145558,30000,300,0,-2,11,6,5,0,0,0,0,0,0,3,2,1,1,1,0,0,0,0,7,3,4,0,0,0,0,0,0,0,0,0
145600,30000,300,0,-2,55,17,38,0,0,0,3,0,3,17,6,11,7,5,2,0,0,0,26,5,21,2,1,1,0,0,0,0,0,0
145628,30000,300,0,-2,1,0,1,0,0,0,0,0,0,0,0,0,0,0,0,0,0,0,1,0,1,0,0,0,0,0,0,0,0,0
145637,30000,300,0,-2,53,23,30,0,0,0,1,1,0,10,4,6,4,2,2,0,0,0,35,14,21,3,2,1,0,0,0,0,0,0
145646,30000,300,0,-2,4,3,1,0,0,0,0,0,0,2,2,0,0,0,0,0,0,0,2,1,1,0,0,0,0,0,0,0,0,0
145682,30000,300,0,-2,2,1,1,0,0,0,0,0,0,0,0,0,0,0,0,0,0,0,2,1,1,0,0,0,0,0,0,0,0,0
145691,30000,300,0,-2,2,0,2,0,0,0,0,0,0,0,0,0,1,0,1,0,0,0,1,0,1,0,0,0,0,0,0,0,0,0
145725,30000,300,0,-2,13,7,6,0,0,0,0,0,0,3,1,2,1,1,0,0,0,0,1,1,0,0,0,0,7,4,3,1,0,1
145813,30000,300,0,-2,10,5,5,0,0,0,0,0,0,0,0,0,0,0,0,0,0,0,10,5,5,0,0,0,0,0,0,0,0,0
145831,30000,300,0,-2,2,2,0,0,0,0,0,0,0,0,0,0,0,0,0,0,0,0,2,2,0,0,0,0,0,0,0,0,0,0
146205,30000,300,0,-2,2,2,0,0,0,0,0,0,0,0,0,0,0,0,0,0,0,0,2,2,0,0,0,0,0,0,0,0,0,0
146296,30000,300,0,-2,3,1,2,0,0,0,0,0,0,2,0,2,0,0,0,0,0,0,1,1,0,0,0,0,0,0,0,0,0,0
146339,30000,300,0,-2,1,0,1,0,0,0,0,0,0,1,0,1,0,0,0,0,0,0,0,0,0,0,0,0,0,0,0,0,0,0
146348,30000,300,0,-2,4,2,2,0,0,0,0,0,0,2,1,1,1,0,1,0,0,0,1,1,0,0,0,0,0,0,0,0,0,0
146366,30000,300,0,-2,2,1,1,0,0,0,0,0,0,0,0,0,0,0,0,0,0,0,2,1,1,0,0,0,0,0,0,0,0,0
146418,30000,300,0,-2,2,0,2,0,0,0,0,0,0,0,0,0,1,0,1,0,0,0,1,0,1,0,0,0,0,0,0,0,0,0
146427,30000,300,0,-2,2,1,1,0,0,0,0,0,0,0,0,0,1,1,0,0,0,0,1,0,1,0,0,0,0,0,0,0,0,0
146472,30000,300,0,-2,2,2,0,0,0,0,0,0,0,0,0,0,0,0,0,0,0,0,2,2,0,0,0,0,0,0,0,0,0,0
146481,30000,300,0,-2,1,1,0,0,0,0,1,1,0,0,0,0,0,0,0,0,0,0,0,0,0,0,0,0,0,0,0,0,0,0
146506,30000,300,0,-2,1,1,0,0,0,0,0,0,0,1,1,0,0,0,0,0,0,0,0,0,0,0,0,0,0,0,0,0,0,0
146603,30000,300,0,-2,5,1,4,0,0,0,0,0,0,2,0,2,0,0,0,0,0,0,2,1,1,0,0,0,1,0,1,0,0,0
146612,30000,300,0,-2,9,3,6,0,0,0,0,0,0,1,0,1,0,0,0,0,0,0,5,1,4,0,0,0,3,2,1,0,0,0
146667,30000,300,0,-2,1,0,1,0,0,0,0,0,0,0,0,0,0,0,0,0,0,0,1,0,1,0,0,0,0,0,0,0,0,0
146676,30000,300,0,-2,2,1,1,0,0,0,0,0,0,1,1,0,0,0,0,0,0,0,1,0,1,0,0,0,0,0,0,0,0,0
146685,30000,300,0,-2,2,2,0,0,0,0,0,0,0,0,0,0,0,0,0,0,0,0,1,1,0,0,0,0,1,1,0,0,0,0
146700,30000,300,0,-2,6,2,4,0,0,0,0,0,0,3,1,2,2,0,2,0,0,0,1,1,0,0,0,0,0,0,0,0,0,0
146719,30000,300,0,-2,25,13,12,0,0,0,0,0,0,5,2,3,0,0,0,0,0,0,20,11,9,0,0,0,0,0,0,0,0,0
146728,30000,300,0,-2,1,1,0,0,0,0,0,0,0,1,1,0,0,0,0,0,0,0,0,0,0,0,0,0,0,0,0,0,0,0
147004,30000,300,0,-2,6,4,2,0,0,0,0,0,0,2,2,0,1,0,1,0,0,0,3,2,1,0,0,0,0,0,0,0,0,0
147013,30000,300,0,-2,3,1,2,0,0,0,0,0,0,1,0,1,1,1,0,0,0,0,1,0,1,0,0,0,0,0,0,0,0,0
147129,30000,300,0,-2,2,1,1,0,0,0,0,0,0,1,0,1,0,0,0,0,0,0,1,1,0,0,0,0,0,0,0,0,0,0
147369,30000,300,0,-2,9,4,5,0,0,0,0,0,0,3,2,1,1,0,1,0,0,0,5,2,3,0,0,0,0,0,0,0,0,0
147378,30000,300,0,-2,3,2,1,0,0,0,0,0,0,0,0,0,1,1,0,0,0,0,2,1,1,0,0,0,0,0,0,0,0,0
147411,30000,300,0,-2,2,2,0,0,0,0,0,0,0,0,0,0,0,0,0,0,0,0,1,1,0,0,0,0,1,1,0,0,0,0
147536,30000,300,0,-2,15,12,3,0,0,0,2,1,1,5,4,1,2,1,1,0,0,0,5,5,0,0,0,0,0,0,0,1,1,0
147590,30000,300,0,-2,1,0,1,0,0,0,0,0,0,0,0,0,0,0,0,0,0,0,1,0,1,0,0,0,0,0,0,0,0,0
147660,30000,300,0,-2,8,3,5,0,0,0,1,0,1,2,1,1,1,1,0,0,0,0,3,1,2,0,0,0,1,0,1,0,0,0
147679,30000,300,0,-2,6,3,3,0,0,0,1,1,0,1,0,1,2,1,1,0,0,0,2,1,1,0,0,0,0,0,0,0,0,0
147697,30000,300,0,-2,2,1,1,0,0,0,0,0,0,0,0,0,0,0,0,0,0,0,2,1,1,0,0,0,0,0,0,0,0,0
147703,30000,300,0,-2,9,4,5,0,0,0,0,0,0,2,0,2,1,0,1,0,0,0,5,3,2,0,0,0,0,0,0,1,1,0
147767,30000,300,0,-2,13,3,10,0,0,0,0,0,0,6,2,4,1,1,0,0,0,0,6,0,6,0,0,0,0,0,0,0,0,0
147776,30000,300,0,-2,4,0,4,0,0,0,1,0,1,1,0,1,1,0,1,0,0,0,0,0,0,0,0,0,1,0,1,0,0,0
147800,30000,300,0,-2,1,1,0,0,0,0,0,0,0,0,0,0,0,0,0,0,0,0,1,1,0,0,0,0,0,0,0,0,0,0
147828,30000,300,0,-2,2,1,1,0,0,0,0,0,0,0,0,0,0,0,0,0,0,0,2,1,1,0,0,0,0,0,0,0,0,0
147916,30000,300,0,-2,2,0,2,0,0,0,0,0,0,0,0,0,0,0,0,0,0,0,1,0,1,0,0,0,1,0,1,0,0,0
148016,30000,300,0,-2,2,0,2,0,0,0,0,0,0,0,0,0,0,0,0,0,0,0,0,0,0,0,0,0,2,0,2,0,0,0
148131,30000,300,0,-2,2,1,1,0,0,0,0,0,0,0,0,0,0,0,0,0,0,0,2,1,1,0,0,0,0,0,0,0,0,0
148256,30000,300,0,-2,1,0,1,0,0,0,0,0,0,0,0,0,0,0,0,0,0,0,1,0,1,0,0,0,0,0,0,0,0,0
148292,30000,300,0,-2,1,0,1,0,0,0,0,0,0,0,0,0,0,0,0,0,0,0,1,0,1,0,0,0,0,0,0,0,0,0
148380,30000,300,0,-2,7,4,3,0,0,0,0,0,0,4,3,1,0,0,0,0,0,0,3,1,2,0,0,0,0,0,0,0,0,0
148405,30000,300,0,-2,3,0,3,0,0,0,0,0,0,0,0,0,0,0,0,0,0,0,3,0,3,0,0,0,0,0,0,0,0,0
148487,30000,300,0,-2,8,2,6,0,0,0,0,0,0,0,0,0,1,0,1,0,0,0,3,1,2,0,0,0,3,1,2,1,0,1
148496,30000,300,0,-2,2,0,2,0,0,0,0,0,0,0,0,0,0,0,0,0,0,0,1,0,1,1,0,1,0,0,0,0,0,0
148511,30000,300,0,-2,20,7,13,0,0,0,2,0,2,8,4,4,0,0,0,0,0,0,9,3,6,1,0,1,0,0,0,0,0,0
148584,30000,300,0,-2,1,0,1,0,0,0,0,0,0,0,0,0,0,0,0,0,0,0,1,0,1,0,0,0,0,0,0,0,0,0
148627,30000,300,0,-2,3,3,0,0,0,0,0,0,0,0,0,0,0,0,0,0,0,0,0,0,0,0,0,0,3,3,0,0,0,0
148654,30000,300,0,-2,8,0,8,0,0,0,0,0,0,0,0,0,0,0,0,0,0,0,6,0,6,2,0,2,0,0,0,0,0,0
148821,30000,300,0,-2,1,0,1,0,0,0,0,0,0,0,0,0,0,0,0,0,0,0,1,0,1,0,0,0,0,0,0,0,0,0
148876,30000,300,0,-2,2,1,1,0,0,0,1,0,1,0,0,0,1,1,0,0,0,0,0,0,0,0,0,0,0,0,0,0,0,0
148885,30000,300,0,-2,4,4,0,0,0,0,1,1,0,0,0,0,1,1,0,0,0,0,2,2,0,0,0,0,0,0,0,0,0,0
148982,30000,300,0,-2,1,0,1,0,0,0,0,0,0,0,0,0,0,0,0,0,0,0,1,0,1,0,0,0,0,0,0,0,0,0
149222,30000,300,0,-2,13,9,4,0,0,0,0,0,0,3,3,0,0,0,0,0,0,0,10,6,4,0,0,0,0,0,0,0,0,0
149231,30000,300,0,-2,1,0,1,0,0,0,0,0,0,1,0,1,0,0,0,0,0,0,0,0,0,0,0,0,0,0,0,0,0,0
149365,30000,300,0,-2,7,3,4,0,0,0,1,1,0,4,1,3,0,0,0,0,0,0,2,1,1,0,0,0,0,0,0,0,0,0
149505,30000,300,0,-2,5,3,2,0,0,0,0,0,0,1,1,0,1,1,0,0,0,0,2,0,2,1,1,0,0,0,0,0,0,0
149514,30000,300,0,-2,2,0,2,1,0,1,0,0,0,0,0,0,0,0,0,0,0,0,1,0,1,0,0,0,0,0,0,0,0,0
149532,30000,300,0,-2,4,1,3,0,0,0,1,1,0,0,0,0,1,0,1,0,0,0,2,0,2,0,0,0,0,0,0,0,0,0
149587,30000,300,0,-2,32,17,15,0,0,0,3,3,0,12,4,8,1,1,0,0,0,0,16,9,7,0,0,0,0,0,0,0,0,0
149727,30000,300,0,-2,7,2,5,0,0,0,2,0,2,0,0,0,2,1,1,0,0,0,3,1,2,0,0,0,0,0,0,0,0,0
149763,30000,300,0,-2,6,3,3,0,0,0,1,1,0,1,1,0,1,0,1,0,0,0,3,1,2,0,0,0,0,0,0,0,0,0
149772,30000,300,0,-2,5,3,2,0,0,0,1,1,0,0,0,0,0,0,0,0,0,0,4,2,2,0,0,0,0,0,0,0,0,0
149781,30000,300,0,-2,3,3,0,0,0,0,0,0,0,0,0,0,0,0,0,0,0,0,3,3,0,0,0,0,0,0,0,0,0,0
149842,30000,300,0,-2,1,0,1,0,0,0,0,0,0,1,0,1,0,0,0,0,0,0,0,0,0,0,0,0,0,0,0,0,0,0
150066,30000,300,0,-2,1,1,0,0,0,0,0,0,0,0,0,0,0,0,0,0,0,0,1,1,0,0,0,0,0,0,0,0,0,0
150145,30000,300,0,-2,1,1,0,0,0,0,0,0,0,0,0,0,0,0,0,0,0,0,1,1,0,0,0,0,0,0,0,0,0,0
150163,30000,300,0,-2,27,13,14,0,0,0,1,1,0,3,1,2,1,0,1,0,0,0,21,10,11,1,1,0,0,0,0,0,0,0
150172,30000,300,0,-2,1,1,0,0,0,0,0,0,0,0,0,0,0,0,0,0,0,0,1,1,0,0,0,0,0,0,0,0,0,0
150288,30000,300,0,-2,1,0,1,0,0,0,0,0,0,0,0,0,1,0,1,0,0,0,0,0,0,0,0,0,0,0,0,0,0,0
150400,30000,300,0,-2,6,2,4,0,0,0,0,0,0,1,1,0,0,0,0,0,0,0,5,1,4,0,0,0,0,0,0,0,0,0
150455,30000,300,0,-2,10,6,4,0,0,0,0,0,0,3,2,1,0,0,0,0,0,0,6,4,2,0,0,0,0,0,0,1,0,1
150534,30000,300,0,-2,1,0,1,0,0,0,0,0,0,0,0,0,0,0,0,0,0,0,1,0,1,0,0,0,0,0,0,0,0,0
150604,30000,300,0,-2,3,3,0,0,0,0,0,0,0,0,0,0,0,0,0,0,0,0,3,3,0,0,0,0,0,0,0,0,0,0
150668,30000,300,0,-2,2,1,1,0,0,0,0,0,0,0,0,0,0,0,0,0,0,0,2,1,1,0,0,0,0,0,0,0,0,0
150756,30000,300,0,-2,2,2,0,0,0,0,0,0,0,0,0,0,0,0,0,0,0,0,2,2,0,0,0,0,0,0,0,0,0,0
150774,30000,300,0,-2,1,0,1,0,0,0,0,0,0,0,0,0,0,0,0,0,0,0,1,0,1,0,0,0,0,0,0,0,0,0
150941,30000,300,0,-2,1,1,0,0,0,0,0,0,0,0,0,0,0,0,0,0,0,0,1,1,0,0,0,0,0,0,0,0,0,0
150987,30000,300,0,-2,34,13,21,0,0,0,2,0,2,6,3,3,2,0,2,0,0,0,24,10,14,0,0,0,0,0,0,0,0,0
151102,30000,300,0,-2,9,6,3,0,0,0,1,1,0,2,1,1,1,0,1,0,0,0,5,4,1,0,0,0,0,0,0,0,0,0
151111,30000,300,0,-2,6,4,2,0,0,0,1,1,0,1,1,0,0,0,0,0,0,0,4,2,2,0,0,0,0,0,0,0,0,0
151263,30000,300,0,-2,4,2,2,0,0,0,0,0,0,0,0,0,0,0,0,0,0,0,4,2,2,0,0,0,0,0,0,0,0,0
151290,30000,300,0,-2,1,0,1,0,0,0,1,0,1,0,0,0,0,0,0,0,0,0,0,0,0,0,0,0,0,0,0,0,0,0
151306,30000,300,0,-2,3,0,3,0,0,0,0,0,0,1,0,1,0,0,0,0,0,0,2,0,2,0,0,0,0,0,0,0,0,0
151324,30000,300,0,-2,8,5,3,0,0,0,0,0,0,0,0,0,1,0,1,0,0,0,6,5,1,1,0,1,0,0,0,0,0,0
151333,30000,300,0,-2,1,1,0,0,0,0,1,1,0,0,0,0,0,0,0,0,0,0,0,0,0,0,0,0,0,0,0,0,0,0
151342,30000,300,0,-2,1,0,1,0,0,0,0,0,0,0,0,0,0,0,0,0,0,0,1,0,1,0,0,0,0,0,0,0,0,0
151351,30000,300,0,-2,2,1,1,0,0,0,0,0,0,0,0,0,0,0,0,0,0,0,2,1,1,0,0,0,0,0,0,0,0,0
151360,30000,300,0,-2,3,2,1,0,0,0,0,0,0,1,1,0,1,0,1,0,0,0,1,1,0,0,0,0,0,0,0,0,0,0
151379,30000,300,0,-2,1,0,1,0,0,0,0,0,0,0,0,0,0,0,0,0,0,0,1,0,1,0,0,0,0,0,0,0,0,0
151661,30000,300,0,-2,15,7,8,0,0,0,0,0,0,1,0,1,0,0,0,0,0,0,14,7,7,0,0,0,0,0,0,0,0,0
151777,30000,300,0,-2,3,1,2,0,0,0,0,0,0,0,0,0,0,0,0,0,0,0,3,1,2,0,0,0,0,0,0,0,0,0
151786,30000,300,0,-2,39,14,25,0,0,0,1,1,0,6,2,4,3,1,2,0,0,0,29,10,19,0,0,0,0,0,0,0,0,0
151801,30000,300,0,-2,18,6,12,0,0,0,0,0,0,5,0,5,0,0,0,0,0,0,12,5,7,0,0,0,1,1,0,0,0,0
151810,30000,300,0,-2,5,2,3,0,0,0,0,0,0,5,2,3,0,0,0,0,0,0,0,0,0,0,0,0,0,0,0,0,0,0
152080,30000,300,0,-2,20,12,8,1,1,0,1,1,0,2,2,0,2,2,0,0,0,0,11,4,7,1,1,0,2,1,1,0,0,0
152318,30000,300,0,-2,5,3,2,0,0,0,0,0,0,0,0,0,0,0,0,0,0,0,5,3,2,0,0,0,0,0,0,0,0,0
152336,30000,300,0,-2,2,1,1,0,0,0,0,0,0,0,0,0,1,0,1,0,0,0,1,1,0,0,0,0,0,0,0,0,0,0
152381,30000,300,0,-2,4,3,1,0,0,0,0,0,0,1,1,0,0,0,0,0,0,0,3,2,1,0,0,0,0,0,0,0,0,0
152390,30000,300,0,-2,7,2,5,0,0,0,0,0,0,0,0,0,1,0,1,0,0,0,3,1,2,0,0,0,1,1,0,2,0,2
152451,30000,300,0,-2,1,1,0,0,0,0,0,0,0,0,0,0,0,0,0,0,0,0,1,1,0,0,0,0,0,0,0,0,0,0
152530,30000,300,0,-2,3,3,0,0,0,0,0,0,0,0,0,0,0,0,0,0,0,0,3,3,0,0,0,0,0,0,0,0,0,0
152567,30000,300,0,-2,3,3,0,0,0,0,0,0,0,0,0,0,0,0,0,0,0,0,2,2,0,1,1,0,0,0,0,0,0,0
152600,30000,300,0,-2,1,0,1,0,0,0,0,0,0,0,0,0,0,0,0,0,0,0,1,0,1,0,0,0,0,0,0,0,0,0
152637,30000,300,0,-2,19,11,8,0,0,0,0,0,0,3,0,3,0,0,0,0,0,0,16,11,5,0,0,0,0,0,0,0,0,0
152673,30000,300,0,-2,1,0,1,0,0,0,0,0,0,0,0,0,0,0,0,0,0,0,1,0,1,0,0,0,0,0,0,0,0,0
152992,30000,300,0,-2,6,2,4,0,0,0,0,0,0,0,0,0,0,0,0,0,0,0,5,2,3,0,0,0,1,0,1,0,0,0
153001,30000,300,0,-2,2,0,2,0,0,0,0,0,0,0,0,0,0,0,0,0,0,0,2,0,2,0,0,0,0,0,0,0,0,0
153126,30000,300,0,-2,3,1,2,0,0,0,0,0,0,0,0,0,0,0,0,0,0,0,3,1,2,0,0,0,0,0,0,0,0,0
153144,30000,300,0,-2,8,5,3,0,0,0,0,0,0,2,1,1,1,0,1,0,0,0,5,4,1,0,0,0,0,0,0,0,0,0
153214,30000,300,0,-2,1,1,0,0,0,0,0,0,0,0,0,0,0,0,0,0,0,0,1,1,0,0,0,0,0,0,0,0,0,0
153269,30000,300,0,-2,4,1,3,0,0,0,0,0,0,3,1,2,0,0,0,0,0,0,1,0,1,0,0,0,0,0,0,0,0,0
153278,30000,300,0,-2,1,0,1,0,0,0,0,0,0,0,0,0,0,0,0,0,0,0,1,0,1,0,0,0,0,0,0,0,0,0
153311,30000,300,0,-2,2,1,1,0,0,0,0,0,0,1,1,0,0,0,0,0,0,0,1,0,1,0,0,0,0,0,0,0,0,0
153366,30000,300,0,-2,2,0,2,0,0,0,0,0,0,0,0,0,0,0,0,0,0,0,2,0,2,0,0,0,0,0,0,0,0,0
153384,30000,300,0,-2,2,0,2,0,0,0,0,0,0,0,0,0,0,0,0,0,0,0,2,0,2,0,0,0,0,0,0,0,0,0
153445,30000,300,0,-2,4,1,3,0,0,0,0,0,0,1,1,0,1,0,1,0,0,0,2,0,2,0,0,0,0,0,0,0,0,0
153472,30000,300,0,-2,2,1,1,0,0,0,0,0,0,0,0,0,0,0,0,0,0,0,2,1,1,0,0,0,0,0,0,0,0,0
153524,30000,300,0,-2,2,1,1,0,0,0,0,0,0,0,0,0,0,0,0,0,0,0,2,1,1,0,0,0,0,0,0,0,0,0
153603,30000,300,0,-2,28,10,18,0,0,0,1,1,0,0,0,0,1,0,1,0,0,0,26,9,17,0,0,0,0,0,0,0,0,0
153630,30000,300,0,-2,9,5,4,0,0,0,0,0,0,0,0,0,0,0,0,0,0,0,9,5,4,0,0,0,0,0,0,0,0,0
153658,30000,300,0,-2,7,4,3,0,0,0,1,1,0,0,0,0,0,0,0,0,0,0,5,2,3,0,0,0,1,1,0,0,0,0
153737,30000,300,0,-2,11,3,8,0,0,0,0,0,0,0,0,0,2,0,2,0,0,0,8,3,5,0,0,0,1,0,1,0,0,0
153825,30000,300,0,-2,4,2,2,0,0,0,0,0,0,0,0,0,0,0,0,0,0,0,4,2,2,0,0,0,0,0,0,0,0,0
153834,30000,300,0,-2,4,1,3,0,0,0,0,0,0,1,0,1,0,0,0,0,0,0,3,1,2,0,0,0,0,0,0,0,0,0
153977,30000,300,0,-2,2,2,0,0,0,0,0,0,0,0,0,0,0,0,0,0,0,0,2,2,0,0,0,0,0,0,0,0,0,0
154004,30000,300,0,-2,3,3,0,0,0,0,0,0,0,0,0,0,0,0,0,0,0,0,3,3,0,0,0,0,0,0,0,0,0,0
154013,30000,300,0,-2,3,3,0,0,0,0,0,0,0,0,0,0,0,0,0,0,0,0,3,3,0,0,0,0,0,0,0,0,0,0
154022,30000,300,0,-2,7,5,2,0,0,0,0,0,0,1,0,1,0,0,0,0,0,0,6,5,1,0,0,0,0,0,0,0,0,0
154059,30000,300,0,-2,5,3,2,0,0,0,0,0,0,0,0,0,0,0,0,0,0,0,5,3,2,0,0,0,0,0,0,0,0,0
154095,30000,300,0,-2,2,2,0,0,0,0,0,0,0,0,0,0,1,1,0,0,0,0,1,1,0,0,0,0,0,0,0,0,0,0
154101,30000,300,0,-2,5,1,4,0,0,0,0,0,0,0,0,0,0,0,0,0,0,0,5,1,4,0,0,0,0,0,0,0,0,0
154110,30000,300,0,-2,3,1,2,0,0,0,0,0,0,0,0,0,0,0,0,0,0,0,3,1,2,0,0,0,0,0,0,0,0,0
154129,30000,300,0,-2,4,2,2,1,0,1,0,0,0,0,0,0,0,0,0,0,0,0,3,2,1,0,0,0,0,0,0,0,0,0
154156,30000,300,0,-2,7,4,3,0,0,0,0,0,0,1,0,1,0,0,0,0,0,0,6,4,2,0,0,0,0,0,0,0,0,0
154174,30000,300,0,-2,4,3,1,0,0,0,0,0,0,0,0,0,0,0,0,0,0,0,4,3,1,0,0,0,0,0,0,0,0,0
154235,30000,300,0,-2,3,2,1,0,0,0,0,0,0,1,1,0,0,0,0,0,0,0,2,1,1,0,0,0,0,0,0,0,0,0
154350,30000,300,0,-2,12,8,4,0,0,0,1,1,0,1,0,1,1,1,0,0,0,0,8,5,3,0,0,0,1,1,0,0,0,0
154378,30000,300,0,-2,5,3,2,0,0,0,0,0,0,0,0,0,0,0,0,0,0,0,5,3,2,0,0,0,0,0,0,0,0,0
154396,30000,300,0,-2,2,0,2,0,0,0,0,0,0,0,0,0,0,0,0,0,0,0,2,0,2,0,0,0,0,0,0,0,0,0
154493,30000,300,0,-2,12,5,7,0,0,0,0,0,0,3,1,2,0,0,0,0,0,0,8,3,5,0,0,0,1,1,0,0,0,0
154518,30000,300,0,-2,2,1,1,0,0,0,0,0,0,2,1,1,0,0,0,0,0,0,0,0,0,0,0,0,0,0,0,0,0,0
154527,30000,300,0,-2,2,1,1,0,0,0,0,0,0,1,0,1,0,0,0,0,0,0,1,1,0,0,0,0,0,0,0,0,0,0
154572,30000,300,0,-2,1,1,0,0,0,0,0,0,0,0,0,0,0,0,0,0,0,0,1,1,0,0,0,0,0,0,0,0,0,0
154642,30000,300,0,-2,1,1,0,0,0,0,0,0,0,0,0,0,0,0,0,0,0,0,1,1,0,0,0,0,0,0,0,0,0,0
154688,30000,300,0,-2,4,0,4,0,0,0,0,0,0,0,0,0,0,0,0,0,0,0,4,0,4,0,0,0,0,0,0,0,0,0
154697,30000,300,0,-2,2,0,2,0,0,0,0,0,0,0,0,0,0,0,0,0,0,0,2,0,2,0,0,0,0,0,0,0,0,0
154721,30000,300,0,-2,2,1,1,0,0,0,0,0,0,0,0,0,0,0,0,0,0,0,2,1,1,0,0,0,0,0,0,0,0,0
154749,30000,300,0,-2,3,1,2,0,0,0,0,0,0,0,0,0,0,0,0,0,0,0,3,1,2,0,0,0,0,0,0,0,0,0
154800,30000,300,0,-2,3,3,0,0,0,0,0,0,0,0,0,0,1,1,0,0,0,0,2,2,0,0,0,0,0,0,0,0,0,0
154907,30000,300,0,-2,5,2,3,0,0,0,0,0,0,0,0,0,1,0,1,0,0,0,4,2,2,0,0,0,0,0,0,0,0,0
154934,30000,300,0,-2,2,1,1,0,0,0,0,0,0,0,0,0,0,0,0,1,0,1,1,1,0,0,0,0,0,0,0,0,0,0
154998,30000,300,0,-2,3,1,2,0,0,0,0,0,0,0,0,0,0,0,0,0,0,0,3,1,2,0,0,0,0,0,0,0,0,0
155025,30000,300,0,-2,10,6,4,0,0,0,0,0,0,0,0,0,1,1,0,0,0,0,7,5,2,0,0,0,2,0,2,0,0,0
155052,30000,300,0,-2,2,0,2,0,0,0,0,0,0,0,0,0,0,0,0,0,0,0,2,0,2,0,0,0,0,0,0,0,0,0
155061,30000,300,0,-2,13,4,9,0,0,0,0,0,0,1,0,1,0,0,0,0,0,0,10,3,7,1,1,0,0,0,0,1,0,1
155089,30000,300,0,-2,3,1,2,0,0,0,0,0,0,1,0,1,0,0,0,0,0,0,2,1,1,0,0,0,0,0,0,0,0,0
155098,30000,300,0,-2,1,1,0,0,0,0,0,0,0,0,0,0,0,0,0,0,0,0,1,1,0,0,0,0,0,0,0,0,0,0
155104,30000,300,0,-2,3,3,0,0,0,0,0,0,0,0,0,0,0,0,0,0,0,0,3,3,0,0,0,0,0,0,0,0,0,0
155177,30000,300,0,-2,1,0,1,0,0,0,0,0,0,0,0,0,0,0,0,0,0,0,1,0,1,0,0,0,0,0,0,0,0,0
155186,30000,300,0,-2,6,2,4,0,0,0,0,0,0,1,0,1,0,0,0,0,0,0,5,2,3,0,0,0,0,0,0,0,0,0
155195,30000,300,0,-2,5,3,2,1,1,0,0,0,0,0,0,0,0,0,0,0,0,0,4,2,2,0,0,0,0,0,0,0,0,0
155201,30000,300,0,-2,2,0,2,0,0,0,0,0,0,0,0,0,0,0,0,0,0,0,2,0,2,0,0,0,0,0,0,0,0,0
155210,30000,300,0,-2,15,3,12,0,0,0,0,0,0,3,2,1,2,0,2,0,0,0,9,1,8,0,0,0,1,0,1,0,0,0
155283,30000,300,0,-2,2,0,2,0,0,0,0,0,0,0,0,0,0,0,0,0,0,0,2,0,2,0,0,0,0,0,0,0,0,0
155292,30000,300,0,-2,4,2,2,0,0,0,0,0,0,0,0,0,2,1,1,0,0,0,2,1,1,0,0,0,0,0,0,0,0,0
155317,30000,300,0,-2,22,9,13,0,0,0,1,0,1,1,0,1,1,1,0,0,0,0,18,8,10,1,0,1,0,0,0,0,0,0
155335,30000,300,0,-2,1,1,0,0,0,0,0,0,0,0,0,0,0,0,0,0,0,0,1,1,0,0,0,0,0,0,0,0,0,0
155399,30000,300,0,-2,23,12,11,0,0,0,1,0,1,2,0,2,1,1,0,0,0,0,16,10,6,0,0,0,3,1,2,0,0,0
155414,30000,300,0,-2,2,0,2,0,0,0,0,0,0,0,0,0,0,0,0,0,0,0,2,0,2,0,0,0,0,0,0,0,0,0
155450,30000,300,0,-2,1,0,1,0,0,0,0,0,0,0,0,0,0,0,0,0,0,0,1,0,1,0,0,0,0,0,0,0,0,0
155511,30000,300,0,-2,1,1,0,0,0,0,0,0,0,0,0,0,0,0,0,0,0,0,1,1,0,0,0,0,0,0,0,0,0,0
155593,30000,300,0,-2,2,0,2,0,0,0,0,0,0,0,0,0,0,0,0,0,0,0,2,0,2,0,0,0,0,0,0,0,0,0
155627,30000,300,0,-2,1,1,0,0,0,0,1,1,0,0,0,0,0,0,0,0,0,0,0,0,0,0,0,0,0,0,0,0,0,0
155681,30000,300,0,-2,1,1,0,0,0,0,0,0,0,0,0,0,0,0,0,0,0,0,1,1,0,0,0,0,0,0,0,0,0,0
155812,30000,300,0,-2,4,4,0,0,0,0,0,0,0,0,0,0,1,1,0,0,0,0,3,3,0,0,0,0,0,0,0,0,0,0
155858,30000,300,0,-2,3,0,3,0,0,0,0,0,0,0,0,0,0,0,0,0,0,0,3,0,3,0,0,0,0,0,0,0,0,0
155900,30000,300,0,-2,2,1,1,0,0,0,0,0,0,1,0,1,0,0,0,0,0,0,1,1,0,0,0,0,0,0,0,0,0,0
155973,30000,300,0,-2,1,1,0,0,0,0,0,0,0,0,0,0,0,0,0,0,0,0,1,1,0,0,0,0,0,0,0,0,0,0
156082,30000,300,0,-2,6,2,4,0,0,0,0,0,0,0,0,0,1,0,1,0,0,0,3,2,1,0,0,0,2,0,2,0,0,0
156107,30000,300,0,-2,6,6,0,0,0,0,0,0,0,0,0,0,0,0,0,0,0,0,6,6,0,0,0,0,0,0,0,0,0,0
156125,30000,300,0,-2,25,13,12,0,0,0,0,0,0,2,0,2,1,1,0,0,0,0,20,12,8,1,0,1,1,0,1,0,0,0
156189,30000,300,0,-2,2,1,1,0,0,0,0,0,0,0,0,0,0,0,0,0,0,0,2,1,1,0,0,0,0,0,0,0,0,0
156213,30000,300,0,-2,2,1,1,0,0,0,1,1,0,0,0,0,0,0,0,0,0,0,1,0,1,0,0,0,0,0,0,0,0,0
156222,30000,300,0,-2,2,2,0,0,0,0,0,0,0,0,0,0,0,0,0,0,0,0,2,2,0,0,0,0,0,0,0,0,0,0
156286,30000,300,0,-2,2,2,0,0,0,0,0,0,0,0,0,0,0,0,0,0,0,0,2,2,0,0,0,0,0,0,0,0,0,0
156295,30000,300,0,-2,5,2,3,0,0,0,0,0,0,1,0,1,0,0,0,0,0,0,4,2,2,0,0,0,0,0,0,0,0,0
156338,30000,300,0,-2,1,0,1,0,0,0,0,0,0,0,0,0,0,0,0,0,0,0,1,0,1,0,0,0,0,0,0,0,0,0
156392,30000,300,0,-2,3,2,1,0,0,0,0,0,0,1,1,0,1,1,0,0,0,0,1,0,1,0,0,0,0,0,0,0,0,0
156408,30000,300,0,-2,6,2,4,0,0,0,0,0,0,0,0,0,0,0,0,0,0,0,6,2,4,0,0,0,0,0,0,0,0,0
156471,30000,300,0,-2,2,1,1,0,0,0,0,0,0,0,0,0,0,0,0,0,0,0,1,0,1,1,1,0,0,0,0,0,0,0
156620,30000,300,0,-2,52,27,25,0,0,0,0,0,0,6,4,2,2,1,1,0,0,0,42,21,21,0,0,0,1,1,0,1,0,1
156648,30000,300,0,-2,1,0,1,0,0,0,0,0,0,0,0,0,0,0,0,0,0,0,1,0,1,0,0,0,0,0,0,0,0,0
156745,30000,300,0,-2,2,1,1,0,0,0,0,0,0,0,0,0,0,0,0,0,0,0,1,0,1,1,1,0,0,0,0,0,0,0
157030,30000,300,0,-2,1,1,0,0,0,0,0,0,0,0,0,0,0,0,0,0,0,0,1,1,0,0,0,0,0,0,0,0,0,0
157058,30000,300,0,-2,7,6,1,0,0,0,0,0,0,3,2,1,0,0,0,0,0,0,0,0,0,0,0,0,4,4,0,0,0,0
157076,30000,300,0,-2,2,1,1,0,0,0,0,0,0,0,0,0,0,0,0,0,0,0,2,1,1,0,0,0,0,0,0,0,0,0
157085,30000,300,0,-2,24,6,18,0,0,0,2,0,2,8,3,5,2,0,2,0,0,0,12,3,9,0,0,0,0,0,0,0,0,0
157216,30000,300,0,-2,1,0,1,0,0,0,0,0,0,0,0,0,0,0,0,0,0,0,1,0,1,0,0,0,0,0,0,0,0,0
157289,30000,300,0,-2,30,6,24,0,0,0,0,0,0,3,1,2,1,1,0,0,0,0,24,3,21,2,1,1,0,0,0,0,0,0
157331,30000,300,0,-2,1,1,0,0,0,0,0,0,0,0,0,0,0,0,0,0,0,0,1,1,0,0,0,0,0,0,0,0,0,0
157386,30000,300,0,-2,2,1,1,0,0,0,0,0,0,1,0,1,0,0,0,0,0,0,1,1,0,0,0,0,0,0,0,0,0,0
157438,30000,300,0,-2,1,1,0,0,0,0,0,0,0,0,0,0,0,0,0,0,0,0,1,1,0,0,0,0,0,0,0,0,0,0
157447,30000,300,0,-2,5,3,2,0,0,0,0,0,0,1,1,0,0,0,0,0,0,0,4,2,2,0,0,0,0,0,0,0,0,0
157535,30000,300,0,-2,4,3,1,0,0,0,0,0,0,1,0,1,0,0,0,0,0,0,3,3,0,0,0,0,0,0,0,0,0,0
157553,30000,300,0,-2,3,1,2,0,0,0,0,0,0,0,0,0,0,0,0,0,0,0,3,1,2,0,0,0,0,0,0,0,0,0
157748,30000,300,0,-2,5,5,0,0,0,0,0,0,0,0,0,0,0,0,0,0,0,0,4,4,0,0,0,0,1,1,0,0,0,0
157757,30000,300,0,-2,1,0,1,0,0,0,0,0,0,0,0,0,0,0,0,0,0,0,1,0,1,0,0,0,0,0,0,0,0,0
157809,30000,300,0,-2,5,2,3,0,0,0,0,0,0,0,0,0,1,0,1,0,0,0,4,2,2,0,0,0,0,0,0,0,0,0
157818,30000,300,0,-2,3,3,0,0,0,0,0,0,0,0,0,0,0,0,0,0,0,0,3,3,0,0,0,0,0,0,0,0,0,0
157854,30000,300,0,-2,3,2,1,0,0,0,0,0,0,1,0,1,0,0,0,0,0,0,0,0,0,0,0,0,2,2,0,0,0,0
157863,30000,300,0,-2,2,0,2,0,0,0,0,0,0,1,0,1,0,0,0,0,0,0,1,0,1,0,0,0,0,0,0,0,0,0
157951,30000,300,0,-2,3,3,0,0,0,0,0,0,0,0,0,0,0,0,0,0,0,0,3,3,0,0,0,0,0,0,0,0,0,0
158088,30000,300,0,-2,2,1,1,1,0,1,0,0,0,0,0,0,0,0,0,0,0,0,1,1,0,0,0,0,0,0,0,0,0,0
158431,30000,300,0,-2,4,2,2,0,0,0,0,0,0,2,0,2,1,1,0,0,0,0,1,1,0,0,0,0,0,0,0,0,0,0
158477,30000,300,0,-2,3,1,2,0,0,0,1,1,0,0,0,0,0,0,0,0,0,0,2,0,2,0,0,0,0,0,0,0,0,0
158662,30000,300,0,-2,9,5,4,0,0,0,0,0,0,4,3,1,1,1,0,0,0,0,4,1,3,0,0,0,0,0,0,0,0,0
158802,30000,300,0,-2,1,1,0,0,0,0,0,0,0,1,1,0,0,0,0,0,0,0,0,0,0,0,0,0,0,0,0,0,0,0
158884,30000,300,0,-2,3,1,2,0,0,0,0,0,0,1,0,1,0,0,0,0,0,0,2,1,1,0,0,0,0,0,0,0,0,0
159373,30000,300,0,-2,20,7,13,0,0,0,1,1,0,6,4,2,0,0,0,0,0,0,13,2,11,0,0,0,0,0,0,0,0,0
159382,30000,300,0,-2,6,2,4,0,0,0,1,0,1,1,0,1,1,0,1,0,0,0,3,2,1,0,0,0,0,0,0,0,0,0
159391,30000,300,0,-2,42,18,24,0,0,0,1,0,1,14,6,8,3,1,2,0,0,0,22,11,11,2,0,2,0,0,0,0,0,0
159407,30000,300,0,-2,3,0,3,0,0,0,0,0,0,1,0,1,0,0,0,0,0,0,2,0,2,0,0,0,0,0,0,0,0,0
159416,30000,300,0,-2,6,1,5,0,0,0,0,0,0,1,0,1,0,0,0,0,0,0,5,1,4,0,0,0,0,0,0,0,0,0
159568,30000,300,0,-2,4,1,3,0,0,0,0,0,0,0,0,0,0,0,0,0,0,0,4,1,3,0,0,0,0,0,0,0,0,0
159647,30000,300,0,-2,6,2,4,0,0,0,0,0,0,2,1,1,0,0,0,0,0,0,4,1,3,0,0,0,0,0,0,0,0,0
159656,30000,300,0,-2,16,6,10,0,0,0,0,0,0,4,0,4,1,1,0,0,0,0,11,5,6,0,0,0,0,0,0,0,0,0
159717,30000,300,0,-2,2,0,2,0,0,0,0,0,0,0,0,0,0,0,0,0,0,0,1,0,1,0,0,0,1,0,1,0,0,0
159939,30000,300,0,-2,5,1,4,0,0,0,0,0,0,2,1,1,0,0,0,0,0,0,3,0,3,0,0,0,0,0,0,0,0,0
159948,30000,300,0,-2,5,3,2,0,0,0,0,0,0,0,0,0,0,0,0,0,0,0,5,3,2,0,0,0,0,0,0,0,0,0
159966,30000,300,0,-2,3,1,2,0,0,0,0,0,0,0,0,0,0,0,0,0,0,0,3,1,2,0,0,0,0,0,0,0,0,0
159993,30000,300,0,-2,2,1,1,0,0,0,0,0,0,1,1,0,0,0,0,0,0,0,1,0,1,0,0,0,0,0,0,0,0,0
160010,30000,300,0,-2,3,1,2,0,0,0,0,0,0,0,0,0,0,0,0,0,0,0,3,1,2,0,0,0,0,0,0,0,0,0
160038,30000,300,0,-2,8,5,3,0,0,0,0,0,0,1,1,0,0,0,0,0,0,0,6,3,3,0,0,0,0,0,0,1,1,0
160065,30000,300,0,-2,1,0,1,0,0,0,0,0,0,0,0,0,0,0,0,0,0,0,1,0,1,0,0,0,0,0,0,0,0,0
160074,30000,300,0,-2,2,0,2,0,0,0,0,0,0,1,0,1,0,0,0,0,0,0,1,0,1,0,0,0,0,0,0,0,0,0
160481,30000,300,0,-2,8,1,7,0,0,0,0,0,0,0,0,0,0,0,0,0,0,0,8,1,7,0,0,0,0,0,0,0,0,0
160533,30000,300,0,-2,1,0,1,0,0,0,0,0,0,1,0,1,0,0,0,0,0,0,0,0,0,0,0,0,0,0,0,0,0,0
160579,30000,300,0,-2,7,3,4,0,0,0,0,0,0,0,0,0,0,0,0,0,0,0,7,3,4,0,0,0,0,0,0,0,0,0
160612,30000,300,0,-2,4,1,3,0,0,0,0,0,0,1,0,1,0,0,0,0,0,0,3,1,2,0,0,0,0,0,0,0,0,0
160621,30000,300,0,-2,3,0,3,0,0,0,0,0,0,3,0,3,0,0,0,0,0,0,0,0,0,0,0,0,0,0,0,0,0,0
160630,30000,300,0,-2,9,3,6,0,0,0,0,0,0,7,3,4,1,0,1,0,0,0,1,0,1,0,0,0,0,0,0,0,0,0
160649,30000,300,0,-2,1,0,1,0,0,0,0,0,0,1,0,1,0,0,0,0,0,0,0,0,0,0,0,0,0,0,0,0,0,0
160658,30000,300,0,-2,17,9,8,0,0,0,0,0,0,1,0,1,2,1,1,0,0,0,14,8,6,0,0,0,0,0,0,0,0,0
160667,30000,300,0,-2,1,0,1,0,0,0,0,0,0,1,0,1,0,0,0,0,0,0,0,0,0,0,0,0,0,0,0,0,0,0
160755,30000,300,0,-2,107,37,70,3,1,2,4,1,3,24,4,20,9,4,5,0,0,0,65,27,38,0,0,0,1,0,1,1,0,1
160904,30000,300,0,-2,5,3,2,0,0,0,0,0,0,4,2,2,0,0,0,0,0,0,1,1,0,0,0,0,0,0,0,0,0,0
160959,30000,300,0,-2,1,1,0,0,0,0,0,0,0,0,0,0,0,0,0,0,0,0,1,1,0,0,0,0,0,0,0,0,0,0
160977,30000,300,0,-2,4,0,4,0,0,0,0,0,0,0,0,0,1,0,1,0,0,0,3,0,3,0,0,0,0,0,0,0,0,0
161004,30000,300,0,-2,11,2,9,0,0,0,0,0,0,2,0,2,1,1,0,0,0,0,8,1,7,0,0,0,0,0,0,0,0,0
161077,30000,300,0,-2,2,0,2,0,0,0,0,0,0,0,0,0,0,0,0,0,0,0,2,0,2,0,0,0,0,0,0,0,0,0
161086,30000,300,0,-2,8,1,7,0,0,0,0,0,0,1,0,1,1,0,1,0,0,0,5,1,4,0,0,0,1,0,1,0,0,0
161138,30000,300,0,-2,2,1,1,0,0,0,0,0,0,1,0,1,0,0,0,0,0,0,1,1,0,0,0,0,0,0,0,0,0,0
161192,30000,300,0,-2,1,0,1,0,0,0,0,0,0,0,0,0,0,0,0,0,0,0,1,0,1,0,0,0,0,0,0,0,0,0
161217,30000,300,0,-2,2,0,2,0,0,0,0,0,0,0,0,0,0,0,0,0,0,0,1,0,1,0,0,0,0,0,0,1,0,1
161226,30000,300,0,-2,1,1,0,0,0,0,0,0,0,0,0,0,0,0,0,0,0,0,1,1,0,0,0,0,0,0,0,0,0,0
161235,30000,300,0,-2,2,1,1,0,0,0,0,0,0,0,0,0,0,0,0,0,0,0,2,1,1,0,0,0,0,0,0,0,0,0
161253,30000,300,0,-2,14,5,9,0,0,0,0,0,0,1,1,0,1,0,1,0,0,0,11,3,8,0,0,0,0,0,0,1,1,0
161280,30000,300,0,-2,3,2,1,0,0,0,0,0,0,1,0,1,0,0,0,0,0,0,1,1,0,0,0,0,1,1,0,0,0,0
161299,30000,300,0,-2,1,0,1,0,0,0,0,0,0,0,0,0,0,0,0,0,0,0,1,0,1,0,0,0,0,0,0,0,0,0
161341,30000,300,0,-2,1,0,1,0,0,0,1,0,1,0,0,0,0,0,0,0,0,0,0,0,0,0,0,0,0,0,0,0,0,0
161457,30000,300,0,-2,1,0,1,0,0,0,0,0,0,0,0,0,0,0,0,0,0,0,1,0,1,0,0,0,0,0,0,0,0,0
161484,30000,300,0,-2,1,1,0,0,0,0,0,0,0,0,0,0,0,0,0,0,0,0,1,1,0,0,0,0,0,0,0,0,0,0
161509,30000,300,0,-2,3,1,2,0,0,0,0,0,0,0,0,0,0,0,0,0,0,0,3,1,2,0,0,0,0,0,0,0,0,0
161554,30000,300,0,-2,2,2,0,0,0,0,0,0,0,0,0,0,1,1,0,0,0,0,1,1,0,0,0,0,0,0,0,0,0,0
161572,30000,300,0,-2,12,4,8,0,0,0,1,0,1,2,1,1,0,0,0,0,0,0,9,3,6,0,0,0,0,0,0,0,0,0
161581,30000,300,0,-2,1,1,0,0,0,0,0,0,0,0,0,0,0,0,0,0,0,0,1,1,0,0,0,0,0,0,0,0,0,0
161767,30000,300,0,-2,5,3,2,0,0,0,0,0,0,2,1,1,0,0,0,0,0,0,3,2,1,0,0,0,0,0,0,0,0,0
161864,30000,300,0,-2,17,8,9,0,0,0,0,0,0,11,4,7,0,0,0,0,0,0,6,4,2,0,0,0,0,0,0,0,0,0
161873,30000,300,0,-2,5,0,5,0,0,0,1,0,1,2,0,2,0,0,0,0,0,0,2,0,2,0,0,0,0,0,0,0,0,0
162007,30000,300,0,-2,12,4,8,0,0,0,0,0,0,11,4,7,0,0,0,0,0,0,0,0,0,0,0,0,1,0,1,0,0,0
162061,30000,300,0,-2,8,2,6,0,0,0,0,0,0,5,1,4,0,0,0,0,0,0,3,1,2,0,0,0,0,0,0,0,0,0
162122,30000,300,0,-2,5,1,4,0,0,0,0,0,0,2,0,2,0,0,0,0,0,0,3,1,2,0,0,0,0,0,0,0,0,0
162168,30000,300,0,-2,2,1,1,0,0,0,0,0,0,0,0,0,0,0,0,0,0,0,2,1,1,0,0,0,0,0,0,0,0,0
162210,30000,300,0,-2,3,1,2,0,0,0,1,1,0,0,0,0,0,0,0,0,0,0,2,0,2,0,0,0,0,0,0,0,0,0
162283,30000,300,0,-2,6,3,3,0,0,0,0,0,0,5,3,2,0,0,0,0,0,0,1,0,1,0,0,0,0,0,0,0,0,0
162557,30000,300,0,-2,7,3,4,0,0,0,0,0,0,1,0,1,1,0,1,0,0,0,4,2,2,0,0,0,1,1,0,0,0,0
162584,30000,300,0,-2,5,3,2,0,0,0,0,0,0,1,1,0,0,0,0,1,1,0,3,1,2,0,0,0,0,0,0,0,0,0
162609,30000,300,0,-2,1,1,0,0,0,0,0,0,0,0,0,0,0,0,0,0,0,0,1,1,0,0,0,0,0,0,0,0,0,0
162654,30000,300,0,-2,4,1,3,0,0,0,0,0,0,2,1,1,0,0,0,0,0,0,2,0,2,0,0,0,0,0,0,0,0,0
162690,30000,300,0,-2,3,0,3,0,0,0,0,0,0,1,0,1,0,0,0,0,0,0,1,0,1,0,0,0,1,0,1,0,0,0
162706,30000,300,0,-2,2,0,2,0,0,0,0,0,0,0,0,0,0,0,0,0,0,0,2,0,2,0,0,0,0,0,0,0,0,0
162760,30000,300,0,-2,5,2,3,0,0,0,1,0,1,2,1,1,0,0,0,0,0,0,2,1,1,0,0,0,0,0,0,0,0,0
162779,30000,300,0,-2,2,0,2,0,0,0,0,0,0,1,0,1,0,0,0,0,0,0,1,0,1,0,0,0,0,0,0,0,0,0
162928,30000,300,0,-2,17,11,6,0,0,0,3,1,2,4,3,1,0,0,0,0,0,0,10,7,3,0,0,0,0,0,0,0,0,0
163028,30000,300,0,-2,5,3,2,0,0,0,0,0,0,2,1,1,0,0,0,0,0,0,3,2,1,0,0,0,0,0,0,0,0,0
163046,30000,300,0,-2,12,7,5,0,0,0,1,1,0,2,1,1,0,0,0,0,0,0,6,4,2,2,1,1,1,0,1,0,0,0
163204,30000,300,0,-2,13,8,5,0,0,0,1,0,1,1,1,0,0,0,0,0,0,0,5,4,1,0,0,0,6,3,3,0,0,0
163259,30000,300,0,-2,45,9,36,0,0,0,1,0,1,17,4,13,6,1,5,1,0,1,19,4,15,1,0,1,0,0,0,0,0,0
163268,30000,300,0,-2,18,5,13,0,0,0,1,0,1,4,1,3,1,0,1,1,0,1,5,1,4,0,0,0,5,3,2,1,0,1
163286,30000,300,0,-2,8,4,4,0,0,0,0,0,0,1,1,0,0,0,0,0,0,0,3,1,2,0,0,0,4,2,2,0,0,0
163295,30000,300,0,-2,19,6,13,0,0,0,1,0,1,10,3,7,2,1,1,0,0,0,2,0,2,2,0,2,2,2,0,0,0,0
163338,30000,300,0,-2,2,2,0,0,0,0,0,0,0,2,2,0,0,0,0,0,0,0,0,0,0,0,0,0,0,0,0,0,0,0
163426,30000,300,0,-2,8,3,5,0,0,0,0,0,0,5,2,3,0,0,0,0,0,0,2,1,1,1,0,1,0,0,0,0,0,0
163453,30000,300,0,-2,15,8,7,0,0,0,0,0,0,10,6,4,2,0,2,0,0,0,1,1,0,0,0,0,2,1,1,0,0,0
163462,30000,300,0,-2,4,3,1,0,0,0,0,0,0,1,0,1,0,0,0,0,0,0,2,2,0,1,1,0,0,0,0,0,0,0
163578,30000,300,0,-2,9,1,8,0,0,0,0,0,0,2,0,2,1,0,1,0,0,0,5,0,5,1,1,0,0,0,0,0,0,0
163657,30000,300,0,-2,4,2,2,0,0,0,0,0,0,3,2,1,0,0,0,0,0,0,1,0,1,0,0,0,0,0,0,0,0,0
163851,30000,300,0,-2,4,2,2,0,0,0,0,0,0,2,1,1,0,0,0,0,0,0,2,1,1,0,0,0,0,0,0,0,0,0
163912,30000,300,0,-2,5,0,5,0,0,0,0,0,0,2,0,2,1,0,1,0,0,0,2,0,2,0,0,0,0,0,0,0,0,0
163976,30000,300,0,-2,1,0,1,0,0,0,0,0,0,0,0,0,0,0,0,0,0,0,1,0,1,0,0,0,0,0,0,0,0,0
164076,30000,300,0,-2,21,10,11,0,0,0,1,1,0,7,2,5,1,0,1,0,0,0,9,5,4,1,0,1,2,2,0,0,0,0
164085,30000,300,0,-2,4,3,1,0,0,0,0,0,0,3,2,1,0,0,0,0,0,0,1,1,0,0,0,0,0,0,0,0,0,0
164155,30000,300,0,-2,1,0,1,0,0,0,0,0,0,0,0,0,0,0,0,0,0,0,1,0,1,0,0,0,0,0,0,0,0,0
164173,30000,300,0,-2,2,0,2,0,0,0,0,0,0,1,0,1,0,0,0,0,0,0,1,0,1,0,0,0,0,0,0,0,0,0
164216,30000,300,0,-2,8,3,5,0,0,0,0,0,0,1,0,1,0,0,0,0,0,0,7,3,4,0,0,0,0,0,0,0,0,0
164270,30000,300,0,-2,8,2,6,0,0,0,0,0,0,4,1,3,1,0,1,0,0,0,3,1,2,0,0,0,0,0,0,0,0,0
164368,30000,300,0,-2,1,0,1,0,0,0,1,0,1,0,0,0,0,0,0,0,0,0,0,0,0,0,0,0,0,0,0,0,0,0
164447,30000,300,0,-2,3,2,1,0,0,0,0,0,0,0,0,0,0,0,0,0,0,0,3,2,1,0,0,0,0,0,0,0,0,0
164465,30000,300,0,-2,9,4,5,0,0,0,1,1,0,2,1,1,1,1,0,0,0,0,4,1,3,0,0,0,1,0,1,0,0,0
164492,30000,300,0,-2,3,3,0,0,0,0,0,0,0,1,1,0,0,0,0,0,0,0,2,2,0,0,0,0,0,0,0,0,0,0
164562,30000,300,0,-2,9,3,6,0,0,0,0,0,0,1,1,0,1,1,0,0,0,0,7,1,6,0,0,0,0,0,0,0,0,0
164580,30000,300,0,-2,3,3,0,0,0,0,1,1,0,1,1,0,0,0,0,0,0,0,1,1,0,0,0,0,0,0,0,0,0,0
164632,30000,300,0,-2,11,3,8,0,0,0,0,0,0,1,0,1,1,1,0,0,0,0,8,2,6,0,0,0,1,0,1,0,0,0
164739,30000,300,0,-2,10,3,7,0,0,0,0,0,0,1,1,0,1,1,0,0,0,0,8,1,7,0,0,0,0,0,0,0,0,0
164748,30000,300,0,-2,16,7,9,0,0,0,1,0,1,5,3,2,1,1,0,0,0,0,6,1,5,0,0,0,2,1,1,1,1,0
164775,30000,300,0,-2,5,2,3,0,0,0,0,0,0,0,0,0,0,0,0,0,0,0,5,2,3,0,0,0,0,0,0,0,0,0
164924,30000,300,0,-2,37,16,21,0,0,0,4,2,2,5,1,4,2,0,2,0,0,0,22,10,12,1,1,0,3,2,1,0,0,0
164988,30000,300,0,-2,63,31,32,1,0,1,7,4,3,8,6,2,7,3,4,0,0,0,30,13,17,2,0,2,8,5,3,0,0,0
165015,30000,300,0,-2,15,5,10,0,0,0,0,0,0,2,0,2,1,0,1,0,0,0,10,3,7,0,0,0,2,2,0,0,0,0
165033,30000,300,0,-2,6,1,5,0,0,0,1,0,1,2,0,2,0,0,0,0,0,0,3,1,2,0,0,0,0,0,0,0,0,0
165112,30000,300,0,-2,6,2,4,0,0,0,1,0,1,1,1,0,1,0,1,0,0,0,3,1,2,0,0,0,0,0,0,0,0,0
165167,30000,300,0,-2,3,3,0,0,0,0,0,0,0,0,0,0,1,1,0,0,0,0,2,2,0,0,0,0,0,0,0,0,0,0
165194,30000,300,0,-2,1,0,1,0,0,0,0,0,0,0,0,0,0,0,0,0,0,0,1,0,1,0,0,0,0,0,0,0,0,0
165264,30000,300,0,-2,3,0,3,0,0,0,0,0,0,1,0,1,1,0,1,0,0,0,1,0,1,0,0,0,0,0,0,0,0,0
165334,30000,300,0,-2,6,5,1,0,0,0,0,0,0,1,1,0,1,1,0,0,0,0,4,3,1,0,0,0,0,0,0,0,0,0
165529,30000,300,0,-2,3,2,1,0,0,0,0,0,0,0,0,0,0,0,0,0,0,0,3,2,1,0,0,0,0,0,0,0,0,0
165662,30000,300,0,-2,8,3,5,1,0,1,0,0,0,1,1,0,0,0,0,0,0,0,6,2,4,0,0,0,0,0,0,0,0,0
165671,30000,300,0,-2,3,2,1,0,0,0,0,0,0,0,0,0,0,0,0,0,0,0,3,2,1,0,0,0,0,0,0,0,0,0
165699,30000,300,0,-2,9,6,3,0,0,0,1,0,1,0,0,0,1,1,0,0,0,0,6,4,2,0,0,0,1,1,0,0,0,0
165802,30000,300,0,-2,1,1,0,0,0,0,0,0,0,0,0,0,0,0,0,0,0,0,1,1,0,0,0,0,0,0,0,0,0,0
165820,30000,300,0,-2,3,2,1,0,0,0,1,1,0,0,0,0,0,0,0,0,0,0,2,1,1,0,0,0,0,0,0,0,0,0
165866,30000,300,0,-2,10,6,4,0,0,0,1,1,0,1,1,0,0,0,0,0,0,0,8,4,4,0,0,0,0,0,0,0,0,0
165884,30000,300,0,-2,1,1,0,0,0,0,0,0,0,0,0,0,0,0,0,0,0,0,1,1,0,0,0,0,0,0,0,0,0,0
165936,30000,300,0,-2,3,1,2,0,0,0,0,0,0,1,0,1,0,0,0,0,0,0,2,1,1,0,0,0,0,0,0,0,0,0
165981,30000,300,0,-2,7,3,4,0,0,0,0,0,0,0,0,0,0,0,0,0,0,0,7,3,4,0,0,0,0,0,0,0,0,0
166018,30000,300,0,-2,4,2,2,0,0,0,0,0,0,0,0,0,1,1,0,0,0,0,3,1,2,0,0,0,0,0,0,0,0,0
166027,30000,300,0,-2,90,33,57,0,0,0,13,2,11,15,8,7,6,3,3,0,0,0,54,19,35,1,0,1,0,0,0,1,1,0
166124,30000,300,0,-2,6,3,3,0,0,0,0,0,0,1,1,0,0,0,0,0,0,0,4,1,3,0,0,0,1,1,0,0,0,0
166133,30000,300,0,-2,4,1,3,0,0,0,1,0,1,2,0,2,1,1,0,0,0,0,0,0,0,0,0,0,0,0,0,0,0,0
166391,30000,300,0,-2,4,3,1,0,0,0,1,1,0,0,0,0,0,0,0,0,0,0,2,1,1,0,0,0,1,1,0,0,0,0
166452,30000,300,0,-2,13,6,7,0,0,0,2,2,0,2,0,2,2,0,2,0,0,0,7,4,3,0,0,0,0,0,0,0,0,0
166489,30000,300,0,-2,1,0,1,0,0,0,0,0,0,0,0,0,0,0,0,0,0,0,1,0,1,0,0,0,0,0,0,0,0,0
166513,30000,300,0,-2,20,12,8,0,0,0,0,0,0,1,1,0,3,2,1,0,0,0,13,8,5,0,0,0,1,0,1,2,1,1
166629,30000,300,0,-2,13,5,8,1,0,1,1,1,0,3,2,1,0,0,0,0,0,0,7,2,5,0,0,0,1,0,1,0,0,0
166638,30000,300,0,-2,5,2,3,0,0,0,0,0,0,1,1,0,1,0,1,0,0,0,1,0,1,0,0,0,2,1,1,0,0,0
166647,30000,300,0,-2,3,1,2,0,0,0,0,0,0,1,0,1,0,0,0,0,0,0,2,1,1,0,0,0,0,0,0,0,0,0
166656,30000,300,0,-2,8,2,6,0,0,0,0,0,0,1,0,1,0,0,0,0,0,0,7,2,5,0,0,0,0,0,0,0,0,0
166665,30000,300,0,-2,4,3,1,0,0,0,0,0,0,0,0,0,0,0,0,0,0,0,4,3,1,0,0,0,0,0,0,0,0,0
166674,30000,300,0,-2,7,2,5,0,0,0,0,0,0,1,1,0,0,0,0,0,0,0,6,1,5,0,0,0,0,0,0,0,0,0
166683,30000,300,0,-2,10,4,6,0,0,0,1,0,1,0,0,0,0,0,0,0,0,0,8,4,4,0,0,0,1,0,1,0,0,0
166692,30000,300,0,-2,2,2,0,0,0,0,0,0,0,0,0,0,0,0,0,0,0,0,2,2,0,0,0,0,0,0,0,0,0,0
166708,30000,300,0,-2,18,7,11,0,0,0,3,2,1,2,1,1,3,2,1,0,0,0,9,1,8,0,0,0,0,0,0,1,1,0
166717,30000,300,0,-2,5,0,5,0,0,0,0,0,0,1,0,1,0,0,0,0,0,0,4,0,4,0,0,0,0,0,0,0,0,0
166823,30000,300,0,-2,3,2,1,0,0,0,0,0,0,1,0,1,0,0,0,0,0,0,2,2,0,0,0,0,0,0,0,0,0,0
166850,30000,300,0,-2,3,1,2,0,0,0,0,0,0,0,0,0,0,0,0,0,0,0,3,1,2,0,0,0,0,0,0,0,0,0
166869,30000,300,0,-2,3,1,2,0,0,0,1,0,1,0,0,0,0,0,0,0,0,0,2,1,1,0,0,0,0,0,0,0,0,0
166887,30000,300,0,-2,2,0,2,0,0,0,0,0,0,0,0,0,1,0,1,0,0,0,1,0,1,0,0,0,0,0,0,0,0,0
166911,30000,300,0,-2,1,0,1,0,0,0,0,0,0,0,0,0,0,0,0,0,0,0,0,0,0,0,0,0,1,0,1,0,0,0
166939,30000,300,0,-2,1,0,1,0,0,0,0,0,0,0,0,0,1,0,1,0,0,0,0,0,0,0,0,0,0,0,0,0,0,0
166957,30000,300,0,-2,3,1,2,0,0,0,0,0,0,0,0,0,0,0,0,0,0,0,3,1,2,0,0,0,0,0,0,0,0,0
167057,30000,300,0,-2,12,3,9,0,0,0,0,0,0,1,0,1,0,0,0,0,0,0,10,3,7,0,0,0,1,0,1,0,0,0
167093,30000,300,0,-2,1,0,1,0,0,0,0,0,0,0,0,0,0,0,0,0,0,0,1,0,1,0,0,0,0,0,0,0,0,0
167215,30000,300,0,-2,4,3,1,0,0,0,1,0,1,0,0,0,0,0,0,0,0,0,3,3,0,0,0,0,0,0,0,0,0,0
167260,30000,300,0,-2,1,1,0,0,0,0,0,0,0,0,0,0,0,0,0,0,0,0,1,1,0,0,0,0,0,0,0,0,0,0
167288,30000,300,0,-2,4,2,2,0,0,0,0,0,0,2,0,2,0,0,0,0,0,0,1,1,0,0,0,0,1,1,0,0,0,0
167312,30000,300,0,-2,4,1,3,0,0,0,1,0,1,0,0,0,0,0,0,0,0,0,3,1,2,0,0,0,0,0,0,0,0,0
167358,30000,300,0,-2,12,5,7,0,0,0,2,1,1,1,1,0,0,0,0,0,0,0,9,3,6,0,0,0,0,0,0,0,0,0
167376,30000,300,0,-2,9,7,2,0,0,0,0,0,0,1,0,1,5,5,0,0,0,0,3,2,1,0,0,0,0,0,0,0,0,0
167525,30000,300,0,-2,2,2,0,0,0,0,0,0,0,0,0,0,0,0,0,0,0,0,2,2,0,0,0,0,0,0,0,0,0,0
167534,30000,300,0,-2,7,2,5,0,0,0,1,1,0,1,0,1,0,0,0,0,0,0,5,1,4,0,0,0,0,0,0,0,0,0
167598,30000,300,0,-2,2,1,1,0,0,0,0,0,0,0,0,0,0,0,0,0,0,0,2,1,1,0,0,0,0,0,0,0,0,0
167631,30000,300,0,-2,1,1,0,0,0,0,0,0,0,0,0,0,1,1,0,0,0,0,0,0,0,0,0,0,0,0,0,0,0,0
167729,30000,300,0,-2,1,1,0,0,0,0,0,0,0,1,1,0,0,0,0,0,0,0,0,0,0,0,0,0,0,0,0,0,0,0
167783,30000,300,0,-2,6,1,5,0,0,0,0,0,0,2,0,2,0,0,0,0,0,0,4,1,3,0,0,0,0,0,0,0,0,0
167792,30000,300,0,-2,2,0,2,0,0,0,0,0,0,1,0,1,1,0,1,0,0,0,0,0,0,0,0,0,0,0,0,0,0,0
167835,30000,300,0,-2,13,2,11,0,0,0,1,1,0,0,0,0,1,0,1,0,0,0,9,0,9,1,0,1,1,1,0,0,0,0
167899,30000,300,0,-2,4,1,3,0,0,0,0,0,0,1,0,1,0,0,0,0,0,0,0,0,0,0,0,0,3,1,2,0,0,0
167905,30000,300,0,-2,9,2,7,0,0,0,1,0,1,1,0,1,2,1,1,0,0,0,4,1,3,0,0,0,1,0,1,0,0,0
167987,30000,300,0,-2,14,6,8,0,0,0,1,1,0,3,0,3,0,0,0,0,0,0,8,4,4,2,1,1,0,0,0,0,0,0
167996,30000,300,0,-2,13,4,9,0,0,0,1,0,1,2,0,2,0,0,0,0,0,0,7,2,5,0,0,0,3,2,1,0,0,0
168005,30000,300,0,-2,4,0,4,0,0,0,0,0,0,1,0,1,0,0,0,0,0,0,3,0,3,0,0,0,0,0,0,0,0,0
168148,30000,300,0,-2,36,6,30,0,0,0,2,0,2,5,0,5,1,0,1,0,0,0,27,6,21,0,0,0,1,0,1,0,0,0
168218,30000,300,0,-2,2,0,2,0,0,0,0,0,0,1,0,1,0,0,0,0,0,0,1,0,1,0,0,0,0,0,0,0,0,0
168227,30000,300,0,-2,16,5,11,0,0,0,0,0,0,2,0,2,1,1,0,0,0,0,11,3,8,0,0,0,2,1,1,0,0,0
168254,30000,300,0,-2,18,6,12,0,0,0,1,0,1,2,1,1,2,0,2,0,0,0,12,4,8,0,0,0,1,1,0,0,0,0
168263,30000,300,0,-2,5,2,3,0,0,0,0,0,0,1,0,1,0,0,0,0,0,0,4,2,2,0,0,0,0,0,0,0,0,0
168281,30000,300,0,-2,5,4,1,0,0,0,0,0,0,1,1,0,0,0,0,0,0,0,4,3,1,0,0,0,0,0,0,0,0,0
168342,30000,300,0,-2,8,3,5,0,0,0,0,0,0,1,1,0,2,0,2,0,0,0,5,2,3,0,0,0,0,0,0,0,0,0
168421,30000,300,0,-2,10,6,4,0,0,0,0,0,0,3,2,1,0,0,0,0,0,0,6,3,3,0,0,0,1,1,0,0,0,0
168430,30000,300,0,-2,7,2,5,0,0,0,0,0,0,1,0,1,0,0,0,0,0,0,6,2,4,0,0,0,0,0,0,0,0,0
168528,30000,300,0,-2,2,1,1,0,0,0,0,0,0,0,0,0,0,0,0,0,0,0,1,1,0,1,0,1,0,0,0,0,0,0
168546,30000,300,0,-2,16,8,8,0,0,0,0,0,0,5,3,2,2,2,0,0,0,0,9,3,6,0,0,0,0,0,0,0,0,0
168591,30000,300,0,-2,3,1,2,0,0,0,0,0,0,1,0,1,0,0,0,0,0,0,2,1,1,0,0,0,0,0,0,0,0,0
168607,30000,300,0,-2,1,0,1,0,0,0,0,0,0,0,0,0,0,0,0,0,0,0,1,0,1,0,0,0,0,0,0,0,0,0
168740,30000,300,0,-2,11,6,5,0,0,0,1,0,1,2,2,0,1,0,1,0,0,0,7,4,3,0,0,0,0,0,0,0,0,0
169080,30000,300,0,-2,3,3,0,0,0,0,0,0,0,0,0,0,0,0,0,0,0,0,3,3,0,0,0,0,0,0,0,0,0,0
169275,30000,300,0,-2,1,0,1,0,0,0,0,0,0,0,0,0,1,0,1,0,0,0,0,0,0,0,0,0,0,0,0,0,0,0
169363,30000,300,0,-2,4,3,1,0,0,0,0,0,0,0,0,0,0,0,0,0,0,0,4,3,1,0,0,0,0,0,0,0,0,0
169442,30000,300,0,-2,1,0,1,0,0,0,0,0,0,0,0,0,0,0,0,0,0,0,0,0,0,1,0,1,0,0,0,0,0,0
169479,30000,300,0,-2,6,1,5,0,0,0,0,0,0,1,0,1,0,0,0,0,0,0,5,1,4,0,0,0,0,0,0,0,0,0
169521,30000,300,0,-2,4,2,2,0,0,0,0,0,0,0,0,0,0,0,0,0,0,0,4,2,2,0,0,0,0,0,0,0,0,0
169716,30000,300,0,-2,1,1,0,0,0,0,1,1,0,0,0,0,0,0,0,0,0,0,0,0,0,0,0,0,0,0,0,0,0,0
169798,30000,300,0,-2,18,6,12,0,0,0,0,0,0,2,0,2,0,0,0,0,0,0,9,4,5,0,0,0,7,2,5,0,0,0
169910,30000,300,0,-2,10,6,4,0,0,0,0,0,0,1,0,1,0,0,0,0,0,0,9,6,3,0,0,0,0,0,0,0,0,0
169974,30000,300,0,-2,2,1,1,0,0,0,0,0,0,0,0,0,0,0,0,0,0,0,2,1,1,0,0,0,0,0,0,0,0,0
169983,30000,300,0,-2,3,2,1,0,0,0,0,0,0,2,1,1,0,0,0,0,0,0,1,1,0,0,0,0,0,0,0,0,0,0
170037,30000,300,0,-2,3,1,2,0,0,0,0,0,0,0,0,0,1,1,0,0,0,0,2,0,2,0,0,0,0,0,0,0,0,0
170055,30000,300,0,-2,3,1,2,0,0,0,0,0,0,0,0,0,0,0,0,0,0,0,3,1,2,0,0,0,0,0,0,0,0,0
170082,30000,300,0,-2,4,1,3,0,0,0,0,0,0,0,0,0,2,1,1,0,0,0,2,0,2,0,0,0,0,0,0,0,0,0
170240,30000,300,0,-2,2,1,1,0,0,0,0,0,0,1,0,1,0,0,0,0,0,0,1,1,0,0,0,0,0,0,0,0,0,0
170286,30000,300,0,-2,5,4,1,0,0,0,0,0,0,0,0,0,0,0,0,0,0,0,0,0,0,0,0,0,5,4,1,0,0,0
170301,30000,300,0,-2,1,1,0,0,0,0,0,0,0,0,0,0,0,0,0,0,0,0,1,1,0,0,0,0,0,0,0,0,0,0
170444,30000,300,0,-2,2,1,1,0,0,0,0,0,0,0,0,0,0,0,0,0,0,0,2,1,1,0,0,0,0,0,0,0,0,0
170532,30000,300,0,-2,6,3,3,0,0,0,0,0,0,1,1,0,1,0,1,0,0,0,4,2,2,0,0,0,0,0,0,0,0,0
170541,30000,300,0,-2,1,0,1,0,0,0,0,0,0,1,0,1,0,0,0,0,0,0,0,0,0,0,0,0,0,0,0,0,0,0
170550,30000,300,0,-2,9,6,3,0,0,0,1,1,0,1,0,1,0,0,0,0,0,0,6,5,1,0,0,0,1,0,1,0,0,0
170620,30000,300,0,-2,3,1,2,0,0,0,0,0,0,2,1,1,0,0,0,0,0,0,1,0,1,0,0,0,0,0,0,0,0,0
170639,30000,300,0,-2,5,5,0,0,0,0,0,0,0,0,0,0,0,0,0,0,0,0,5,5,0,0,0,0,0,0,0,0,0,0
170657,30000,300,0,-2,18,8,10,0,0,0,0,0,0,5,2,3,2,1,1,0,0,0,9,4,5,1,0,1,1,1,0,0,0,0
170675,30000,300,0,-2,15,7,8,0,0,0,0,0,0,3,0,3,0,0,0,0,0,0,11,7,4,0,0,0,1,0,1,0,0,0
170790,30000,300,0,-2,2,0,2,0,0,0,0,0,0,0,0,0,0,0,0,0,0,0,1,0,1,0,0,0,1,0,1,0,0,0
170806,30000,300,0,-2,3,0,3,0,0,0,0,0,0,0,0,0,0,0,0,0,0,0,2,0,2,1,0,1,0,0,0,0,0,0
170967,30000,300,0,-2,1,0,1,0,0,0,0,0,0,1,0,1,0,0,0,0,0,0,0,0,0,0,0,0,0,0,0,0,0,0
170976,30000,300,0,-2,51,20,31,0,0,0,2,1,1,15,4,11,1,0,1,0,0,0,31,14,17,2,1,1,0,0,0,0,0,0
171100,30000,300,0,-2,87,42,45,0,0,0,4,0,4,15,10,5,2,0,2,0,0,0,64,31,33,1,1,0,0,0,0,1,0,1
171128,30000,300,0,-2,3,3,0,0,0,0,0,0,0,1,1,0,1,1,0,0,0,0,0,0,0,0,0,0,1,1,0,0,0,0
171137,30000,300,0,-2,5,2,3,0,0,0,1,0,1,0,0,0,0,0,0,0,0,0,4,2,2,0,0,0,0,0,0,0,0,0
171146,30000,300,0,-2,6,2,4,0,0,0,0,0,0,1,0,1,0,0,0,0,0,0,5,2,3,0,0,0,0,0,0,0,0,0
171155,30000,300,0,-2,2,1,1,0,0,0,0,0,0,0,0,0,0,0,0,0,0,0,2,1,1,0,0,0,0,0,0,0,0,0
171225,30000,300,0,-2,3,2,1,0,0,0,0,0,0,0,0,0,0,0,0,0,0,0,3,2,1,0,0,0,0,0,0,0,0,0
171234,30000,300,0,-2,1,1,0,0,0,0,0,0,0,0,0,0,1,1,0,0,0,0,0,0,0,0,0,0,0,0,0,0,0,0
171304,30000,300,0,-2,3,1,2,0,0,0,0,0,0,1,1,0,0,0,0,0,0,0,2,0,2,0,0,0,0,0,0,0,0,0
171395,30000,300,0,-2,4,2,2,0,0,0,0,0,0,0,0,0,0,0,0,0,0,0,4,2,2,0,0,0,0,0,0,0,0,0
171456,30000,300,0,-2,4,3,1,1,0,1,0,0,0,0,0,0,0,0,0,0,0,0,3,3,0,0,0,0,0,0,0,0,0,0
171535,30000,300,0,-2,16,3,13,0,0,0,1,1,0,6,1,5,0,0,0,0,0,0,8,1,7,0,0,0,1,0,1,0,0,0
171571,30000,300,0,-2,4,2,2,0,0,0,1,0,1,3,2,1,0,0,0,0,0,0,0,0,0,0,0,0,0,0,0,0,0,0
171599,30000,300,0,-2,5,1,4,0,0,0,0,0,0,0,0,0,0,0,0,0,0,0,5,1,4,0,0,0,0,0,0,0,0,0
171881,30000,300,0,-2,2,1,1,0,0,0,0,0,0,0,0,0,0,0,0,0,0,0,2,1,1,0,0,0,0,0,0,0,0,0
172033,30000,300,0,-2,1,1,0,0,0,0,0,0,0,0,0,0,0,0,0,0,0,0,1,1,0,0,0,0,0,0,0,0,0,0
172051,30000,300,0,-2,16,6,10,0,0,0,1,0,1,2,0,2,0,0,0,0,0,0,13,6,7,0,0,0,0,0,0,0,0,0
172200,30000,300,0,-2,2,1,1,0,0,0,0,0,0,0,0,0,0,0,0,0,0,0,2,1,1,0,0,0,0,0,0,0,0,0
172264,30000,300,0,-2,4,2,2,0,0,0,0,0,0,1,1,0,0,0,0,0,0,0,3,1,2,0,0,0,0,0,0,0,0,0
172291,30000,300,0,-2,4,2,2,0,0,0,0,0,0,0,0,0,0,0,0,0,0,0,3,1,2,0,0,0,1,1,0,0,0,0
172307,30000,300,0,-2,2,1,1,0,0,0,0,0,0,1,1,0,0,0,0,0,0,0,1,0,1,0,0,0,0,0,0,0,0,0
172334,30000,300,0,-2,5,3,2,0,0,0,0,0,0,0,0,0,0,0,0,0,0,0,5,3,2,0,0,0,0,0,0,0,0,0
172440,30000,300,0,-2,3,2,1,0,0,0,0,0,0,0,0,0,0,0,0,0,0,0,3,2,1,0,0,0,0,0,0,0,0,0
172608,30000,300,0,-2,3,1,2,0,0,0,0,0,0,0,0,0,0,0,0,0,0,0,3,1,2,0,0,0,0,0,0,0,0,0
172617,30000,300,0,-2,13,4,9,0,0,0,1,0,1,3,2,1,1,0,1,0,0,0,8,2,6,0,0,0,0,0,0,0,0,0
172644,30000,300,0,-2,21,9,12,0,0,0,2,0,2,5,2,3,0,0,0,0,0,0,14,7,7,0,0,0,0,0,0,0,0,0
172671,30000,300,0,-2,4,2,2,0,0,0,0,0,0,0,0,0,0,0,0,0,0,0,4,2,2,0,0,0,0,0,0,0,0,0
172699,30000,300,0,-2,3,2,1,0,0,0,1,0,1,0,0,0,0,0,0,0,0,0,2,2,0,0,0,0,0,0,0,0,0,0
172963,30000,300,0,-2,2,1,1,0,0,0,0,0,0,2,1,1,0,0,0,0,0,0,0,0,0,0,0,0,0,0,0,0,0,0
173045,30000,300,0,-2,7,0,7,0,0,0,2,0,2,0,0,0,0,0,0,0,0,0,5,0,5,0,0,0,0,0,0,0,0,0
173124,30000,300,0,-2,1,1,0,0,0,0,0,0,0,1,1,0,0,0,0,0,0,0,0,0,0,0,0,0,0,0,0,0,0,0
173160,30000,300,0,-2,6,1,5,0,0,0,0,0,0,0,0,0,0,0,0,0,0,0,3,0,3,0,0,0,3,1,2,0,0,0
173258,30000,300,0,-2,11,3,8,0,0,0,0,0,0,3,0,3,1,0,1,0,0,0,6,3,3,0,0,0,1,0,1,0,0,0
173328,30000,300,0,-2,1,1,0,0,0,0,0,0,0,0,0,0,0,0,0,0,0,0,0,0,0,1,1,0,0,0,0,0,0,0
173559,30000,300,0,-2,2,1,1,0,0,0,0,0,0,0,0,0,0,0,0,0,0,0,2,1,1,0,0,0,0,0,0,0,0,0
173896,30000,300,0,-2,1,1,0,0,0,0,0,0,0,0,0,0,0,0,0,0,0,0,1,1,0,0,0,0,0,0,0,0,0,0
173902,30000,300,0,-2,2,1,1,0,0,0,1,1,0,1,0,1,0,0,0,0,0,0,0,0,0,0,0,0,0,0,0,0,0,0
173911,30000,300,0,-2,1,0,1,0,0,0,0,0,0,0,0,0,0,0,0,0,0,0,1,0,1,0,0,0,0,0,0,0,0,0
173920,30000,300,0,-2,1,1,0,0,0,0,0,0,0,0,0,0,0,0,0,0,0,0,0,0,0,0,0,0,1,1,0,0,0,0
173957,30000,300,0,-2,7,3,4,0,0,0,0,0,0,1,1,0,1,0,1,0,0,0,5,2,3,0,0,0,0,0,0,0,0,0
174020,30000,300,0,-2,2,0,2,0,0,0,1,0,1,0,0,0,0,0,0,0,0,0,1,0,1,0,0,0,0,0,0,0,0,0
174066,30000,300,0,-2,51,22,29,1,0,1,4,2,2,6,4,2,1,0,1,1,1,0,33,12,21,4,3,1,0,0,0,1,0,1
174127,30000,300,0,-2,10,5,5,0,0,0,0,0,0,3,1,2,0,0,0,0,0,0,6,3,3,0,0,0,1,1,0,0,0,0
174136,30000,300,0,-2,1,1,0,0,0,0,0,0,0,1,1,0,0,0,0,0,0,0,0,0,0,0,0,0,0,0,0,0,0,0
174233,30000,300,0,-2,5,3,2,0,0,0,0,0,0,0,0,0,0,0,0,0,0,0,5,3,2,0,0,0,0,0,0,0,0,0
174358,30000,300,0,-2,1,1,0,0,0,0,0,0,0,0,0,0,1,1,0,0,0,0,0,0,0,0,0,0,0,0,0,0,0,0
174428,30000,300,0,-2,1,0,1,0,0,0,0,0,0,0,0,0,0,0,0,0,0,0,1,0,1,0,0,0,0,0,0,0,0,0
174437,30000,300,0,-2,2,2,0,0,0,0,0,0,0,0,0,0,0,0,0,0,0,0,2,2,0,0,0,0,0,0,0,0,0,0
174473,30000,300,0,-2,2,1,1,0,0,0,0,0,0,0,0,0,0,0,0,0,0,0,1,0,1,0,0,0,0,0,0,1,1,0
174491,30000,300,0,-2,3,2,1,0,0,0,0,0,0,1,1,0,0,0,0,0,0,0,1,1,0,0,0,0,1,0,1,0,0,0
174507,30000,300,0,-2,4,2,2,0,0,0,0,0,0,0,0,0,1,1,0,0,0,0,3,1,2,0,0,0,0,0,0,0,0,0
174525,30000,300,0,-2,1,1,0,0,0,0,0,0,0,0,0,0,0,0,0,0,0,0,1,1,0,0,0,0,0,0,0,0,0,0
174747,30000,300,0,-2,3,0,3,0,0,0,0,0,0,0,0,0,0,0,0,0,0,0,2,0,2,1,0,1,0,0,0,0,0,0
174756,30000,300,0,-2,1,1,0,0,0,0,0,0,0,1,1,0,0,0,0,0,0,0,0,0,0,0,0,0,0,0,0,0,0,0
174783,30000,300,0,-2,2,0,2,0,0,0,0,0,0,1,0,1,0,0,0,0,0,0,0,0,0,0,0,0,1,0,1,0,0,0
174792,30000,300,0,-2,2,1,1,0,0,0,0,0,0,0,0,0,0,0,0,0,0,0,1,0,1,0,0,0,1,1,0,0,0,0
174817,30000,300,0,-2,18,6,12,0,0,0,2,1,1,1,0,1,0,0,0,0,0,0,12,3,9,0,0,0,3,2,1,0,0,0
174862,30000,300,0,-2,3,1,2,0,0,0,0,0,0,0,0,0,0,0,0,0,0,0,2,1,1,1,0,1,0,0,0,0,0,0
174914,30000,300,0,-2,13,7,6,0,0,0,1,0,1,1,1,0,1,1,0,0,0,0,9,4,5,1,1,0,0,0,0,0,0,0
175005,30000,300,0,-2,10,2,8,0,0,0,1,0,1,1,0,1,0,0,0,0,0,0,8,2,6,0,0,0,0,0,0,0,0,0
175014,30000,300,0,-2,1,0,1,0,0,0,1,0,1,0,0,0,0,0,0,0,0,0,0,0,0,0,0,0,0,0,0,0,0,0
175078,30000,300,0,-2,1,1,0,0,0,0,0,0,0,0,0,0,0,0,0,0,0,0,1,1,0,0,0,0,0,0,0,0,0,0
175263,30000,300,0,-2,3,0,3,0,0,0,0,0,0,0,0,0,0,0,0,0,0,0,3,0,3,0,0,0,0,0,0,0,0,0
175272,30000,300,0,-2,1,1,0,0,0,0,0,0,0,0,0,0,0,0,0,0,0,0,1,1,0,0,0,0,0,0,0,0,0,0
175281,30000,300,0,-2,31,15,16,0,0,0,3,1,2,4,2,2,0,0,0,0,0,0,19,9,10,2,1,1,3,2,1,0,0,0
175342,30000,300,0,-2,6,0,6,0,0,0,0,0,0,5,0,5,1,0,1,0,0,0,0,0,0,0,0,0,0,0,0,0,0,0
175421,30000,300,0,-2,4,0,4,0,0,0,0,0,0,0,0,0,0,0,0,0,0,0,4,0,4,0,0,0,0,0,0,0,0,0
175430,30000,300,0,-2,2,2,0,0,0,0,0,0,0,0,0,0,0,0,0,0,0,0,2,2,0,0,0,0,0,0,0,0,0,0
175616,30000,300,0,-2,3,3,0,0,0,0,0,0,0,1,1,0,0,0,0,0,0,0,2,2,0,0,0,0,0,0,0,0,0,0
175786,30000,300,0,-2,12,5,7,0,0,0,0,0,0,6,1,5,0,0,0,0,0,0,6,4,2,0,0,0,0,0,0,0,0,0
175829,30000,300,0,-2,4,1,3,0,0,0,0,0,0,1,0,1,0,0,0,0,0,0,3,1,2,0,0,0,0,0,0,0,0,0
175856,30000,300,0,-2,23,14,9,0,0,0,0,0,0,19,11,8,0,0,0,0,0,0,4,3,1,0,0,0,0,0,0,0,0,0
175935,30000,300,0,-2,1,1,0,0,0,0,0,0,0,1,1,0,0,0,0,0,0,0,0,0,0,0,0,0,0,0,0,0,0,0
175980,30000,300,0,-2,2,1,1,0,0,0,0,0,0,0,0,0,0,0,0,0,0,0,1,0,1,1,1,0,0,0,0,0,0,0
175999,30000,300,0,-2,1,0,1,0,0,0,0,0,0,0,0,0,0,0,0,0,0,0,1,0,1,0,0,0,0,0,0,0,0,0
176017,30000,300,0,-2,38,13,25,0,0,0,0,0,0,8,0,8,1,1,0,0,0,0,29,12,17,0,0,0,0,0,0,0,0,0
176035,30000,300,0,-2,2,0,2,0,0,0,0,0,0,0,0,0,0,0,0,0,0,0,2,0,2,0,0,0,0,0,0,0,0,0
176044,30000,300,0,-2,2,1,1,0,0,0,0,0,0,1,1,0,0,0,0,0,0,0,1,0,1,0,0,0,0,0,0,0,0,0
176053,30000,300,0,-2,2,1,1,0,0,0,0,0,0,1,0,1,0,0,0,0,0,0,0,0,0,0,0,0,1,1,0,0,0,0
176071,30000,300,0,-2,4,0,4,0,0,0,0,0,0,1,0,1,0,0,0,0,0,0,3,0,3,0,0,0,0,0,0,0,0,0
176080,30000,300,0,-2,8,6,2,0,0,0,0,0,0,1,1,0,0,0,0,0,0,0,7,5,2,0,0,0,0,0,0,0,0,0
176169,30000,300,0,-2,1,0,1,0,0,0,0,0,0,0,0,0,0,0,0,0,0,0,0,0,0,0,0,0,1,0,1,0,0,0
176178,30000,300,0,-2,2,2,0,0,0,0,0,0,0,0,0,0,0,0,0,0,0,0,2,2,0,0,0,0,0,0,0,0,0,0
176239,30000,300,0,-2,1,0,1,0,0,0,0,0,0,0,0,0,0,0,0,0,0,0,1,0,1,0,0,0,0,0,0,0,0,0
176318,30000,300,0,-2,9,4,5,0,0,0,0,0,0,7,4,3,1,0,1,0,0,0,0,0,0,0,0,0,1,0,1,0,0,0
176406,30000,300,0,-2,5,1,4,0,0,0,0,0,0,5,1,4,0,0,0,0,0,0,0,0,0,0,0,0,0,0,0,0,0,0
176451,30000,300,0,-2,1,1,0,0,0,0,0,0,0,0,0,0,0,0,0,0,0,0,1,1,0,0,0,0,0,0,0,0,0,0
176479,30000,300,0,-2,1,1,0,0,0,0,0,0,0,0,0,0,0,0,0,0,0,0,1,1,0,0,0,0,0,0,0,0,0,0
176628,30000,300,0,-2,2,1,1,0,0,0,0,0,0,0,0,0,0,0,0,0,0,0,2,1,1,0,0,0,0,0,0,0,0,0
176664,30000,300,0,-2,1,0,1,0,0,0,0,0,0,1,0,1,0,0,0,0,0,0,0,0,0,0,0,0,0,0,0,0,0,0
176789,30000,300,0,-2,2,2,0,0,0,0,0,0,0,0,0,0,1,1,0,0,0,0,1,1,0,0,0,0,0,0,0,0,0,0
176910,30000,300,0,-2,4,4,0,0,0,0,0,0,0,0,0,0,0,0,0,0,0,0,4,4,0,0,0,0,0,0,0,0,0,0
176965,30000,300,0,-2,9,5,4,0,0,0,1,0,1,0,0,0,0,0,0,0,0,0,6,4,2,2,1,1,0,0,0,0,0,0
177038,30000,300,0,-2,1,0,1,0,0,0,0,0,0,0,0,0,1,0,1,0,0,0,0,0,0,0,0,0,0,0,0,0,0,0
177065,30000,300,0,-2,19,3,16,0,0,0,0,0,0,2,1,1,1,0,1,0,0,0,12,2,10,1,0,1,2,0,2,1,0,1
177092,30000,300,0,-2,1,1,0,0,0,0,0,0,0,0,0,0,0,0,0,0,0,0,1,1,0,0,0,0,0,0,0,0,0,0
177117,30000,300,0,-2,2,0,2,0,0,0,0,0,0,0,0,0,0,0,0,0,0,0,2,0,2,0,0,0,0,0,0,0,0,0
177126,30000,300,0,-2,1,1,0,0,0,0,0,0,0,0,0,0,0,0,0,0,0,0,1,1,0,0,0,0,0,0,0,0,0,0
177144,30000,300,0,-2,1,0,1,0,0,0,0,0,0,0,0,0,0,0,0,0,0,0,1,0,1,0,0,0,0,0,0,0,0,0
177214,30000,300,0,-2,1,0,1,0,0,0,0,0,0,0,0,0,0,0,0,0,0,0,0,0,0,0,0,0,1,0,1,0,0,0
177250,30000,300,0,-2,3,0,3,0,0,0,0,0,0,0,0,0,0,0,0,0,0,0,3,0,3,0,0,0,0,0,0,0,0,0
177302,30000,300,0,-2,1,1,0,0,0,0,0,0,0,0,0,0,0,0,0,0,0,0,1,1,0,0,0,0,0,0,0,0,0,0
177339,30000,300,0,-2,2,2,0,0,0,0,0,0,0,0,0,0,0,0,0,0,0,0,2,2,0,0,0,0,0,0,0,0,0,0
177418,30000,300,0,-2,9,3,6,0,0,0,0,0,0,3,2,1,0,0,0,0,0,0,6,1,5,0,0,0,0,0,0,0,0,0
177472,30000,300,0,-2,8,2,6,0,0,0,0,0,0,1,1,0,0,0,0,0,0,0,5,1,4,1,0,1,1,0,1,0,0,0
177542,30000,300,0,-2,3,1,2,0,0,0,0,0,0,1,1,0,0,0,0,0,0,0,2,0,2,0,0,0,0,0,0,0,0,0
177551,30000,300,0,-2,11,6,5,0,0,0,0,0,0,6,3,3,0,0,0,0,0,0,5,3,2,0,0,0,0,0,0,0,0,0
177676,30000,300,0,-2,2,2,0,0,0,0,0,0,0,0,0,0,0,0,0,0,0,0,2,2,0,0,0,0,0,0,0,0,0,0
177940,30000,300,0,-2,3,3,0,0,0,0,0,0,0,2,2,0,0,0,0,0,0,0,1,1,0,0,0,0,0,0,0,0,0,0
177968,30000,300,0,-2,13,6,7,0,0,0,0,0,0,3,1,2,1,1,0,0,0,0,9,4,5,0,0,0,0,0,0,0,0,0
177977,30000,300,0,-2,1,0,1,0,0,0,0,0,0,0,0,0,0,0,0,0,0,0,1,0,1,0,0,0,0,0,0,0,0,0
177986,30000,300,0,-2,2,2,0,0,0,0,0,0,0,0,0,0,0,0,0,0,0,0,2,2,0,0,0,0,0,0,0,0,0,0
177995,30000,300,0,-2,5,2,3,0,0,0,0,0,0,1,0,1,0,0,0,0,0,0,3,2,1,0,0,0,1,0,1,0,0,0
178059,30000,300,0,-2,4,1,3,0,0,0,0,0,0,0,0,0,0,0,0,0,0,0,4,1,3,0,0,0,0,0,0,0,0,0
178208,30000,300,0,-2,1,1,0,0,0,0,0,0,0,0,0,0,0,0,0,0,0,0,1,1,0,0,0,0,0,0,0,0,0,0
178244,30000,300,0,-2,1,1,0,0,0,0,0,0,0,0,0,0,0,0,0,0,0,0,1,1,0,0,0,0,0,0,0,0,0,0
178341,30000,300,0,-2,2,1,1,0,0,0,0,0,0,0,0,0,0,0,0,0,0,0,2,1,1,0,0,0,0,0,0,0,0,0
178369,30000,300,0,-2,1,0,1,0,0,0,0,0,0,0,0,0,0,0,0,0,0,0,1,0,1,0,0,0,0,0,0,0,0,0
178387,30000,300,0,-2,7,3,4,0,0,0,0,0,0,0,0,0,0,0,0,0,0,0,2,1,1,0,0,0,5,2,3,0,0,0
178396,30000,300,0,-2,52,28,24,0,0,0,2,2,0,6,4,2,4,2,2,0,0,0,33,18,15,2,0,2,5,2,3,0,0,0
178402,30000,300,0,-2,19,10,9,0,0,0,0,0,0,4,2,2,0,0,0,0,0,0,9,5,4,1,0,1,3,1,2,2,2,0
178411,30000,300,0,-2,12,7,5,0,0,0,2,1,1,0,0,0,0,0,0,0,0,0,9,6,3,1,0,1,0,0,0,0,0,0
178420,30000,300,0,-2,14,4,10,0,0,0,0,0,0,4,1,3,0,0,0,0,0,0,10,3,7,0,0,0,0,0,0,0,0,0
178439,30000,300,0,-2,7,3,4,0,0,0,0,0,0,0,0,0,0,0,0,0,0,0,7,3,4,0,0,0,0,0,0,0,0,0
178448,30000,300,0,-2,1,0,1,0,0,0,0,0,0,0,0,0,0,0,0,0,0,0,1,0,1,0,0,0,0,0,0,0,0,0
178615,30000,300,0,-2,1,1,0,0,0,0,0,0,0,0,0,0,0,0,0,0,0,0,1,1,0,0,0,0,0,0,0,0,0,0
178624,30000,300,0,-2,1,1,0,0,0,0,0,0,0,0,0,0,0,0,0,0,0,0,0,0,0,0,0,0,0,0,0,1,1,0
178679,30000,300,0,-2,1,1,0,0,0,0,0,0,0,0,0,0,0,0,0,0,0,0,1,1,0,0,0,0,0,0,0,0,0,0
178697,30000,300,0,-2,1,0,1,0,0,0,0,0,0,0,0,0,0,0,0,0,0,0,1,0,1,0,0,0,0,0,0,0,0,0
178721,30000,300,0,-2,3,3,0,0,0,0,0,0,0,1,1,0,0,0,0,0,0,0,2,2,0,0,0,0,0,0,0,0,0,0
179043,30000,300,0,-2,3,1,2,0,0,0,0,0,0,1,0,1,0,0,0,0,0,0,2,1,1,0,0,0,0,0,0,0,0,0
179159,30000,300,0,-2,42,15,27,0,0,0,1,0,1,6,3,3,2,0,2,0,0,0,29,12,17,4,0,4,0,0,0,0,0,0
179308,30000,300,0,-2,15,6,9,0,0,0,1,0,1,5,3,2,1,1,0,0,0,0,6,1,5,0,0,0,2,1,1,0,0,0
179326,30000,300,0,-2,1,1,0,0,0,0,0,0,0,0,0,0,0,0,0,0,0,0,1,1,0,0,0,0,0,0,0,0,0,0
179344,30000,300,0,-2,2,2,0,0,0,0,0,0,0,1,1,0,1,1,0,0,0,0,0,0,0,0,0,0,0,0,0,0,0,0
179539,30000,300,0,-2,3,1,2,0,0,0,0,0,0,0,0,0,0,0,0,0,0,0,2,0,2,0,0,0,1,1,0,0,0,0
179548,30000,300,0,-2,5,2,3,0,0,0,0,0,0,1,1,0,0,0,0,0,0,0,4,1,3,0,0,0,0,0,0,0,0,0
179557,30000,300,0,-2,1,0,1,0,0,0,0,0,0,0,0,0,0,0,0,0,0,0,1,0,1,0,0,0,0,0,0,0,0,0
179566,30000,300,0,-2,2,1,1,0,0,0,0,0,0,0,0,0,0,0,0,0,0,0,2,1,1,0,0,0,0,0,0,0,0,0
179645,30000,300,0,-2,1,0,1,0,0,0,0,0,0,0,0,0,0,0,0,0,0,0,1,0,1,0,0,0,0,0,0,0,0,0
179867,30000,300,0,-2,83,26,57,1,1,0,3,1,2,15,4,11,2,0,2,0,0,0,58,18,40,4,2,2,0,0,0,0,0,0
179894,30000,300,0,-2,9,3,6,0,0,0,2,1,1,0,0,0,1,0,1,0,0,0,6,2,4,0,0,0,0,0,0,0,0,0
179946,30000,300,0,-2,3,1,2,0,0,0,0,0,0,1,0,1,0,0,0,0,0,0,2,1,1,0,0,0,0,0,0,0,0,0
179955,30000,300,0,-2,5,2,3,0,0,0,0,0,0,0,0,0,0,0,0,0,0,0,5,2,3,0,0,0,0,0,0,0,0,0
179964,30000,300,0,-2,5,1,4,0,0,0,0,0,0,0,0,0,0,0,0,0,0,0,3,1,2,0,0,0,2,0,2,0,0,0
180106,30000,300,0,-2,13,4,9,0,0,0,0,0,0,0,0,0,0,0,0,0,0,0,8,2,6,0,0,0,5,2,3,0,0,0
180151,30000,300,0,-2,2,1,1,0,0,0,0,0,0,0,0,0,0,0,0,0,0,0,2,1,1,0,0,0,0,0,0,0,0,0
180179,30000,300,0,-2,23,6,17,2,2,0,2,0,2,2,1,1,0,0,0,0,0,0,17,3,14,0,0,0,0,0,0,0,0,0
180197,30000,300,0,-2,3,1,2,0,0,0,0,0,0,0,0,0,0,0,0,0,0,0,2,1,1,0,0,0,1,0,1,0,0,0
180249,30000,300,0,-2,1,0,1,0,0,0,0,0,0,0,0,0,0,0,0,0,0,0,1,0,1,0,0,0,0,0,0,0,0,0
180258,30000,300,0,-2,1,0,1,0,0,0,0,0,0,0,0,0,0,0,0,0,0,0,1,0,1,0,0,0,0,0,0,0,0,0
180276,30000,300,0,-2,2,0,2,0,0,0,0,0,0,0,0,0,0,0,0,0,0,0,2,0,2,0,0,0,0,0,0,0,0,0
180328,30000,300,0,-2,1,1,0,1,1,0,0,0,0,0,0,0,0,0,0,0,0,0,0,0,0,0,0,0,0,0,0,0,0,0
180373,30000,300,0,-2,1,0,1,0,0,0,0,0,0,0,0,0,0,0,0,0,0,0,1,0,1,0,0,0,0,0,0,0,0,0
180416,30000,300,0,-2,4,1,3,0,0,0,0,0,0,0,0,0,0,0,0,0,0,0,4,1,3,0,0,0,0,0,0,0,0,0
180461,30000,300,0,-2,29,13,16,1,1,0,0,0,0,0,0,0,0,0,0,0,0,0,27,12,15,1,0,1,0,0,0,0,0,0
180489,30000,300,0,-2,35,12,23,1,0,1,0,0,0,0,0,0,1,1,0,0,0,0,32,11,21,1,0,1,0,0,0,0,0,0
180522,30000,300,0,-2,2,0,2,0,0,0,0,0,0,1,0,1,0,0,0,0,0,0,1,0,1,0,0,0,0,0,0,0,0,0
180595,30000,300,0,-2,1,1,0,0,0,0,0,0,0,0,0,0,0,0,0,0,0,0,1,1,0,0,0,0,0,0,0,0,0,0
180647,30000,300,0,-2,1,1,0,1,1,0,0,0,0,0,0,0,0,0,0,0,0,0,0,0,0,0,0,0,0,0,0,0,0,0
180692,30000,300,0,-2,5,2,3,0,0,0,0,0,0,0,0,0,0,0,0,0,0,0,3,2,1,0,0,0,2,0,2,0,0,0
180902,30000,300,0,-2,3,1,2,0,0,0,0,0,0,0,0,0,0,0,0,0,0,0,3,1,2,0,0,0,0,0,0,0,0,0
180948,30000,300,0,-2,2,1,1,0,0,0,0,0,0,0,0,0,0,0,0,0,0,0,2,1,1,0,0,0,0,0,0,0,0,0
180984,30000,300,0,-2,4,2,2,0,0,0,0,0,0,1,0,1,0,0,0,0,0,0,3,2,1,0,0,0,0,0,0,0,0,0
181002,30000,300,0,-2,16,5,11,0,0,0,0,0,0,1,0,1,0,0,0,0,0,0,14,4,10,0,0,0,1,1,0,0,0,0
181020,30000,300,0,-2,7,5,2,0,0,0,0,0,0,0,0,0,1,1,0,0,0,0,6,4,2,0,0,0,0,0,0,0,0,0
181127,30000,300,0,-2,1,0,1,0,0,0,0,0,0,0,0,0,0,0,0,0,0,0,1,0,1,0,0,0,0,0,0,0,0,0
181215,30000,300,0,-2,5,2,3,0,0,0,0,0,0,0,0,0,0,0,0,0,0,0,5,2,3,0,0,0,0,0,0,0,0,0
181303,30000,300,0,-2,9,3,6,0,0,0,0,0,0,1,1,0,1,0,1,0,0,0,7,2,5,0,0,0,0,0,0,0,0,0
181312,30000,300,0,-2,2,1,1,0,0,0,0,0,0,0,0,0,0,0,0,0,0,0,2,1,1,0,0,0,0,0,0,0,0,0
181330,30000,300,0,-2,3,1,2,0,0,0,0,0,0,0,0,0,0,0,0,0,0,0,3,1,2,0,0,0,0,0,0,0,0,0
181394,30000,300,0,-2,3,1,2,0,0,0,0,0,0,0,0,0,2,1,1,0,0,0,1,0,1,0,0,0,0,0,0,0,0,0
181419,30000,300,0,-2,1,0,1,0,0,0,0,0,0,0,0,0,0,0,0,0,0,0,1,0,1,0,0,0,0,0,0,0,0,0
181428,30000,300,0,-2,13,3,10,0,0,0,0,0,0,1,1,0,1,0,1,0,0,0,9,1,8,0,0,0,0,0,0,2,1,1
181446,30000,300,0,-2,3,3,0,0,0,0,1,1,0,0,0,0,0,0,0,0,0,0,2,2,0,0,0,0,0,0,0,0,0,0
181464,30000,300,0,-2,19,10,9,1,0,1,0,0,0,2,2,0,0,0,0,0,0,0,16,8,8,0,0,0,0,0,0,0,0,0
181491,30000,300,0,-2,2,0,2,0,0,0,0,0,0,0,0,0,0,0,0,0,0,0,2,0,2,0,0,0,0,0,0,0,0,0
181534,30000,300,0,-2,3,2,1,0,0,0,0,0,0,1,1,0,0,0,0,0,0,0,2,1,1,0,0,0,0,0,0,0,0,0
181604,30000,300,0,-2,5,4,1,0,0,0,0,0,0,2,2,0,0,0,0,0,0,0,3,2,1,0,0,0,0,0,0,0,0,0
181640,30000,300,0,-2,3,2,1,0,0,0,0,0,0,0,0,0,0,0,0,0,0,0,3,2,1,0,0,0,0,0,0,0,0,0
181747,30000,300,0,-2,8,6,2,0,0,0,0,0,0,1,1,0,1,0,1,0,0,0,6,5,1,0,0,0,0,0,0,0,0,0
181783,30000,300,0,-2,4,1,3,0,0,0,0,0,0,1,1,0,0,0,0,0,0,0,3,0,3,0,0,0,0,0,0,0,0,0
181817,30000,300,0,-2,4,1,3,0,0,0,0,0,0,0,0,0,0,0,0,0,0,0,4,1,3,0,0,0,0,0,0,0,0,0
181853,30000,300,0,-2,1,1,0,0,0,0,0,0,0,0,0,0,0,0,0,0,0,0,1,1,0,0,0,0,0,0,0,0,0,0
182005,30000,300,0,-2,7,4,3,0,0,0,0,0,0,2,2,0,3,1,2,0,0,0,1,1,0,1,0,1,0,0,0,0,0,0
182148,30000,300,0,-2,1,1,0,0,0,0,0,0,0,0,0,0,0,0,0,0,0,0,1,1,0,0,0,0,0,0,0,0,0,0
182281,30000,300,0,-2,13,7,6,0,0,0,0,0,0,2,0,2,1,1,0,0,0,0,9,5,4,0,0,0,0,0,0,1,1,0
182290,30000,300,0,-2,10,6,4,1,1,0,0,0,0,1,1,0,3,2,1,0,0,0,4,2,2,1,0,1,0,0,0,0,0,0
182306,30000,300,0,-2,1,0,1,0,0,0,0,0,0,0,0,0,0,0,0,0,0,0,1,0,1,0,0,0,0,0,0,0,0,0
182500,30000,300,0,-2,2,1,1,0,0,0,0,0,0,0,0,0,0,0,0,0,0,0,1,1,0,1,0,1,0,0,0,0,0,0
182564,30000,300,0,-2,1,0,1,0,0,0,0,0,0,0,0,0,0,0,0,0,0,0,1,0,1,0,0,0,0,0,0,0,0,0
182634,30000,300,0,-2,2,1,1,0,0,0,0,0,0,1,0,1,0,0,0,0,0,0,1,1,0,0,0,0,0,0,0,0,0,0
182670,30000,300,0,-2,42,11,31,0,0,0,0,0,0,3,1,2,0,0,0,0,0,0,39,10,29,0,0,0,0,0,0,0,0,0
182795,30000,300,0,-2,3,0,3,0,0,0,0,0,0,0,0,0,0,0,0,0,0,0,3,0,3,0,0,0,0,0,0,0,0,0
182829,30000,300,0,-2,3,2,1,0,0,0,0,0,0,0,0,0,0,0,0,0,0,0,1,0,1,1,1,0,1,1,0,0,0,0
182980,30000,300,0,-2,7,6,1,0,0,0,0,0,0,1,1,0,0,0,0,0,0,0,6,5,1,0,0,0,0,0,0,0,0,0
183026,30000,300,0,-2,64,27,37,0,0,0,6,2,4,8,3,5,2,1,1,0,0,0,42,18,24,2,0,2,4,3,1,0,0,0
183044,30000,300,0,-2,46,18,28,1,0,1,2,1,1,3,1,2,0,0,0,0,0,0,38,15,23,1,0,1,1,1,0,0,0,0
183062,30000,300,0,-2,8,4,4,0,0,0,0,0,0,0,0,0,0,0,0,0,0,0,7,4,3,0,0,0,1,0,1,0,0,0
183080,30000,300,0,-2,2,2,0,0,0,0,0,0,0,0,0,0,0,0,0,0,0,0,2,2,0,0,0,0,0,0,0,0,0,0
183132,30000,300,0,-2,1,0,1,0,0,0,0,0,0,1,0,1,0,0,0,0,0,0,0,0,0,0,0,0,0,0,0,0,0,0
183211,30000,300,0,-2,3,2,1,0,0,0,0,0,0,0,0,0,0,0,0,0,0,0,3,2,1,0,0,0,0,0,0,0,0,0
183239,30000,300,0,-2,3,2,1,0,0,0,0,0,0,0,0,0,0,0,0,0,0,0,3,2,1,0,0,0,0,0,0,0,0,0
183257,30000,300,0,-2,3,1,2,0,0,0,0,0,0,0,0,0,0,0,0,0,0,0,2,1,1,0,0,0,1,0,1,0,0,0
183327,30000,300,0,-2,2,1,1,0,0,0,0,0,0,0,0,0,0,0,0,0,0,0,1,0,1,0,0,0,1,1,0,0,0,0
183655,30000,300,0,-2,4,3,1,0,0,0,1,1,0,0,0,0,1,0,1,0,0,0,2,2,0,0,0,0,0,0,0,0,0,0
183743,30000,300,0,-2,4,4,0,0,0,0,0,0,0,0,0,0,0,0,0,0,0,0,4,4,0,0,0,0,0,0,0,0,0,0
183789,30000,300,0,-2,3,0,3,0,0,0,0,0,0,1,0,1,1,0,1,0,0,0,0,0,0,0,0,0,1,0,1,0,0,0
183822,30000,300,0,-2,6,5,1,0,0,0,0,0,0,4,4,0,0,0,0,0,0,0,2,1,1,0,0,0,0,0,0,0,0,0
183859,30000,300,0,-2,2,0,2,0,0,0,0,0,0,0,0,0,0,0,0,0,0,0,2,0,2,0,0,0,0,0,0,0,0,0
183910,30000,300,0,-2,3,2,1,0,0,0,0,0,0,0,0,0,1,1,0,0,0,0,2,1,1,0,0,0,0,0,0,0,0,0
183938,30000,300,0,-2,3,2,1,0,0,0,0,0,0,2,1,1,0,0,0,0,0,0,1,1,0,0,0,0,0,0,0,0,0,0
184205,30000,300,0,-2,1,0,1,0,0,0,0,0,0,0,0,0,0,0,0,0,0,0,1,0,1,0,0,0,0,0,0,0,0,0
184348,30000,300,0,-2,4,1,3,0,0,0,0,0,0,2,0,2,0,0,0,0,0,0,2,1,1,0,0,0,0,0,0,0,0,0
184481,30000,300,0,-2,6,2,4,0,0,0,0,0,0,3,1,2,1,0,1,0,0,0,2,1,1,0,0,0,0,0,0,0,0,0
184603,30000,300,0,-2,15,7,8,0,0,0,0,0,0,2,0,2,2,1,1,0,0,0,7,5,2,3,1,2,1,0,1,0,0,0
184612,30000,300,0,-2,3,1,2,0,0,0,0,0,0,1,0,1,0,0,0,0,0,0,2,1,1,0,0,0,0,0,0,0,0,0
184694,30000,300,0,-2,9,3,6,0,0,0,0,0,0,1,0,1,1,0,1,0,0,0,6,3,3,0,0,0,1,0,1,0,0,0
184782,30000,300,0,-2,27,14,13,0,0,0,2,2,0,3,2,1,1,0,1,0,0,0,19,9,10,1,1,0,0,0,0,1,0,1
184995,30000,300,0,-2,6,2,4,0,0,0,0,0,0,2,1,1,3,0,3,0,0,0,1,1,0,0,0,0,0,0,0,0,0,0
185129,30000,300,0,-2,19,9,10,0,0,0,3,1,2,3,2,1,6,4,2,0,0,0,6,2,4,0,0,0,1,0,1,0,0,0
185262,30000,300,0,-2,46,15,31,0,0,0,2,0,2,19,6,13,10,2,8,0,0,0,12,6,6,0,0,0,3,1,2,0,0,0
185509,30000,300,0,-2,7,3,4,0,0,0,1,1,0,2,2,0,1,0,1,0,0,0,3,0,3,0,0,0,0,0,0,0,0,0
185536,30000,300,0,-2,1,0,1,0,0,0,0,0,0,0,0,0,0,0,0,0,0,0,1,0,1,0,0,0,0,0,0,0,0,0
185572,30000,300,0,-2,4,1,3,0,0,0,2,1,1,1,0,1,0,0,0,0,0,0,1,0,1,0,0,0,0,0,0,0,0,0
185590,30000,300,0,-2,4,1,3,0,0,0,0,0,0,0,0,0,2,0,2,0,0,0,1,0,1,0,0,0,1,1,0,0,0,0
185828,30000,300,0,-2,7,3,4,0,0,0,0,0,0,0,0,0,0,0,0,0,0,0,6,3,3,0,0,0,1,0,1,0,0,0
186034,30000,300,0,-2,6,1,5,0,0,0,0,0,0,2,0,2,2,1,1,0,0,0,2,0,2,0,0,0,0,0,0,0,0,0
186122,30000,300,0,-2,2,2,0,0,0,0,0,0,0,0,0,0,1,1,0,0,0,0,1,1,0,0,0,0,0,0,0,0,0,0
186131,30000,300,0,-2,22,13,9,0,0,0,2,2,0,3,2,1,2,2,0,0,0,0,12,5,7,0,0,0,2,1,1,1,1,0
186201,30000,300,0,-2,1,0,1,0,0,0,0,0,0,0,0,0,0,0,0,0,0,0,1,0,1,0,0,0,0,0,0,0,0,0
186283,30000,300,0,-2,4,1,3,0,0,0,0,0,0,2,1,1,1,0,1,0,0,0,1,0,1,0,0,0,0,0,0,0,0,0
186371,30000,300,0,-2,3,2,1,0,0,0,0,0,0,0,0,0,0,0,0,0,0,0,0,0,0,0,0,0,3,2,1,0,0,0
186380,30000,300,0,-2,13,6,7,0,0,0,0,0,0,1,1,0,0,0,0,0,0,0,0,0,0,0,0,0,12,5,7,0,0,0
186399,30000,300,0,-2,1,0,1,0,0,0,0,0,0,0,0,0,0,0,0,0,0,0,0,0,0,0,0,0,1,0,1,0,0,0
186432,30000,300,0,-2,4,1,3,0,0,0,0,0,0,1,0,1,0,0,0,0,0,0,3,1,2,0,0,0,0,0,0,0,0,0
186584,30000,300,0,-2,9,5,4,0,0,0,0,0,0,3,2,1,1,0,1,0,0,0,4,3,1,0,0,0,1,0,1,0,0,0
186618,30000,300,0,-2,4,2,2,0,0,0,0,0,0,1,1,0,0,0,0,0,0,0,2,0,2,0,0,0,1,1,0,0,0,0
186645,30000,300,0,-2,2,1,1,0,0,0,0,0,0,1,0,1,0,0,0,0,0,0,1,1,0,0,0,0,0,0,0,0,0,0
186867,30000,300,0,-2,24,8,16,0,0,0,2,1,1,2,0,2,1,1,0,0,0,0,15,5,10,0,0,0,3,1,2,1,0,1
186876,30000,300,0,-2,9,6,3,0,0,0,1,0,1,1,0,1,1,1,0,0,0,0,6,5,1,0,0,0,0,0,0,0,0,0
187046,30000,300,0,-2,7,3,4,0,0,0,0,0,0,2,2,0,2,1,1,0,0,0,3,0,3,0,0,0,0,0,0,0,0,0
187134,30000,300,0,-2,6,4,2,0,0,0,1,1,0,2,0,2,1,1,0,0,0,0,2,2,0,0,0,0,0,0,0,0,0,0
187198,30000,300,0,-2,3,1,2,0,0,0,1,0,1,0,0,0,0,0,0,0,0,0,2,1,1,0,0,0,0,0,0,0,0,0
187444,30000,300,0,-2,2,1,1,0,0,0,0,0,0,0,0,0,1,1,0,0,0,0,1,0,1,0,0,0,0,0,0,0,0,0
187532,30000,300,0,-2,13,4,9,0,0,0,0,0,0,1,0,1,4,1,3,0,0,0,8,3,5,0,0,0,0,0,0,0,0,0
187639,30000,300,0,-2,2,2,0,0,0,0,0,0,0,0,0,0,0,0,0,0,0,0,2,2,0,0,0,0,0,0,0,0,0,0
187648,30000,300,0,-2,2,1,1,0,0,0,0,0,0,0,0,0,1,1,0,0,0,0,1,0,1,0,0,0,0,0,0,0,0,0
187666,30000,300,0,-2,2,2,0,0,0,0,0,0,0,0,0,0,1,1,0,0,0,0,1,1,0,0,0,0,0,0,0,0,0,0
187745,30000,300,0,-2,1,0,1,0,0,0,0,0,0,0,0,0,1,0,1,0,0,0,0,0,0,0,0,0,0,0,0,0,0,0
187897,30000,300,0,-2,4,0,4,0,0,0,1,0,1,0,0,0,0,0,0,0,0,0,2,0,2,0,0,0,1,0,1,0,0,0
187912,30000,300,0,-2,2,2,0,0,0,0,0,0,0,0,0,0,1,1,0,0,0,0,1,1,0,0,0,0,0,0,0,0,0,0
187967,30000,300,0,-2,5,3,2,0,0,0,0,0,0,1,0,1,0,0,0,0,0,0,4,3,1,0,0,0,0,0,0,0,0,0
187976,30000,300,0,-2,1,1,0,0,0,0,0,0,0,0,0,0,0,0,0,0,0,0,1,1,0,0,0,0,0,0,0,0,0,0
187985,30000,300,0,-2,21,5,16,0,0,0,2,2,0,0,0,0,8,0,8,0,0,0,8,2,6,2,1,1,1,0,1,0,0,0
188030,30000,300,0,-2,6,3,3,0,0,0,0,0,0,0,0,0,2,1,1,0,0,0,4,2,2,0,0,0,0,0,0,0,0,0
188100,30000,300,0,-2,3,2,1,0,0,0,0,0,0,0,0,0,1,1,0,0,0,0,2,1,1,0,0,0,0,0,0,0,0,0
188137,30000,300,0,-2,9,2,7,0,0,0,0,0,0,0,0,0,5,1,4,0,0,0,3,0,3,0,0,0,1,1,0,0,0,0
188182,30000,300,0,-2,1,0,1,0,0,0,0,0,0,0,0,0,0,0,0,0,0,0,0,0,0,0,0,0,1,0,1,0,0,0
188225,30000,300,0,-2,1,0,1,0,0,0,0,0,0,0,0,0,0,0,0,0,0,0,1,0,1,0,0,0,0,0,0,0,0,0
188304,30000,300,0,-2,1,0,1,0,0,0,0,0,0,0,0,0,0,0,0,0,0,0,1,0,1,0,0,0,0,0,0,0,0,0
188340,30000,300,0,-2,2,2,0,0,0,0,0,0,0,0,0,0,0,0,0,1,1,0,1,1,0,0,0,0,0,0,0,0,0,0
188429,30000,300,0,-2,11,1,10,0,0,0,0,0,0,1,0,1,2,1,1,0,0,0,8,0,8,0,0,0,0,0,0,0,0,0
188438,30000,300,0,-2,1,0,1,0,0,0,0,0,0,0,0,0,0,0,0,0,0,0,1,0,1,0,0,0,0,0,0,0,0,0
188517,30000,300,0,-2,4,4,0,0,0,0,0,0,0,0,0,0,1,1,0,0,0,0,3,3,0,0,0,0,0,0,0,0,0,0
188526,30000,300,0,-2,2,2,0,0,0,0,0,0,0,1,1,0,0,0,0,0,0,0,1,1,0,0,0,0,0,0,0,0,0,0
188535,30000,300,0,-2,2,2,0,0,0,0,0,0,0,0,0,0,0,0,0,0,0,0,1,1,0,1,1,0,0,0,0,0,0,0
188580,30000,300,0,-2,15,2,13,0,0,0,1,0,1,2,0,2,0,0,0,0,0,0,7,0,7,2,1,1,3,1,2,0,0,0
188641,30000,300,0,-2,1,1,0,0,0,0,0,0,0,0,0,0,0,0,0,0,0,0,1,1,0,0,0,0,0,0,0,0,0,0
188854,30000,300,0,-2,6,4,2,0,0,0,0,0,0,1,0,1,0,0,0,0,0,0,4,3,1,1,1,0,0,0,0,0,0,0
189088,30000,300,0,-2,2,1,1,0,0,0,0,0,0,0,0,0,0,0,0,0,0,0,2,1,1,0,0,0,0,0,0,0,0,0
189097,30000,300,0,-2,22,5,17,0,0,0,5,1,4,3,1,2,2,0,2,0,0,0,9,2,7,0,0,0,3,1,2,0,0,0
189228,30000,300,0,-2,2,0,2,0,0,0,0,0,0,0,0,0,1,0,1,0,0,0,1,0,1,0,0,0,0,0,0,0,0,0
189501,30000,300,0,-2,1,0,1,0,0,0,0,0,0,0,0,0,0,0,0,0,0,0,1,0,1,0,0,0,0,0,0,0,0,0
189547,30000,300,0,-2,4,2,2,0,0,0,0,0,0,0,0,0,0,0,0,0,0,0,4,2,2,0,0,0,0,0,0,0,0,0
189705,30000,300,0,-2,1,1,0,0,0,0,0,0,0,0,0,0,0,0,0,0,0,0,1,1,0,0,0,0,0,0,0,0,0,0
189811,30000,300,0,-2,1,0,1,1,0,1,0,0,0,0,0,0,0,0,0,0,0,0,0,0,0,0,0,0,0,0,0,0,0,0
189848,30000,300,0,-2,1,1,0,0,0,0,0,0,0,0,0,0,0,0,0,0,0,0,1,1,0,0,0,0,0,0,0,0,0,0
190035,30000,300,0,-2,20,10,10,0,0,0,0,0,0,5,3,2,1,1,0,0,0,0,14,6,8,0,0,0,0,0,0,0,0,0
190044,30000,300,0,-2,6,2,4,0,0,0,0,0,0,1,1,0,1,0,1,0,0,0,4,1,3,0,0,0,0,0,0,0,0,0
190053,30000,300,0,-2,1,1,0,0,0,0,0,0,0,0,0,0,0,0,0,0,0,0,1,1,0,0,0,0,0,0,0,0,0,0
190099,30000,300,0,-2,6,3,3,0,0,0,1,1,0,1,0,1,0,0,0,0,0,0,4,2,2,0,0,0,0,0,0,0,0,0
190114,30000,300,0,-2,7,3,4,0,0,0,1,0,1,4,2,2,0,0,0,0,0,0,2,1,1,0,0,0,0,0,0,0,0,0
190150,30000,300,0,-2,238,69,169,0,0,0,35,7,28,44,14,30,32,8,24,1,1,0,104,32,72,4,4,0,16,3,13,2,0,2
190169,30000,300,0,-2,5,2,3,0,0,0,2,1,1,0,0,0,0,0,0,0,0,0,3,1,2,0,0,0,0,0,0,0,0,0
190415,30000,300,0,-2,40,14,26,0,0,0,5,3,2,4,0,4,1,0,1,0,0,0,29,10,19,0,0,0,0,0,0,1,1,0
190424,30000,300,0,-2,30,12,18,0,0,0,6,3,3,3,0,3,5,2,3,0,0,0,16,7,9,0,0,0,0,0,0,0,0,0
190442,30000,300,0,-2,6,1,5,0,0,0,0,0,0,0,0,0,0,0,0,0,0,0,5,1,4,0,0,0,1,0,1,0,0,0
190503,30000,300,0,-2,31,15,16,0,0,0,0,0,0,3,2,1,1,0,1,1,1,0,25,11,14,0,0,0,1,1,0,0,0,0
190512,30000,300,0,-2,13,3,10,0,0,0,0,0,0,3,2,1,1,0,1,0,0,0,7,0,7,2,1,1,0,0,0,0,0,0
190521,30000,300,0,-2,6,4,2,0,0,0,1,0,1,1,1,0,2,1,1,0,0,0,2,2,0,0,0,0,0,0,0,0,0,0
190530,30000,300,0,-2,3,2,1,0,0,0,0,0,0,1,1,0,2,1,1,0,0,0,0,0,0,0,0,0,0,0,0,0,0,0
190549,30000,300,0,-2,3,1,2,0,0,0,0,0,0,2,1,1,1,0,1,0,0,0,0,0,0,0,0,0,0,0,0,0,0,0
190558,30000,300,0,-2,5,2,3,0,0,0,1,1,0,2,1,1,1,0,1,0,0,0,1,0,1,0,0,0,0,0,0,0,0,0
190567,30000,300,0,-2,11,4,7,0,0,0,1,1,0,3,1,2,4,1,3,0,0,0,3,1,2,0,0,0,0,0,0,0,0,0
190576,30000,300,0,-2,15,5,10,0,0,0,2,0,2,3,0,3,2,1,1,0,0,0,7,4,3,1,0,1,0,0,0,0,0,0
190585,30000,300,0,-2,5,1,4,0,0,0,0,0,0,2,0,2,1,0,1,0,0,0,2,1,1,0,0,0,0,0,0,0,0,0
190594,30000,300,0,-2,7,1,6,0,0,0,1,1,0,1,0,1,0,0,0,0,0,0,5,0,5,0,0,0,0,0,0,0,0,0
190600,30000,300,0,-2,6,2,4,0,0,0,0,0,0,1,1,0,2,0,2,0,0,0,1,0,1,1,0,1,0,0,0,1,1,0
190619,30000,300,0,-2,7,1,6,0,0,0,0,0,0,2,0,2,2,0,2,0,0,0,2,0,2,0,0,0,0,0,0,1,1,0
190628,30000,300,0,-2,10,3,7,0,0,0,1,1,0,6,1,5,0,0,0,0,0,0,3,1,2,0,0,0,0,0,0,0,0,0
190637,30000,300,0,-2,10,3,7,1,0,1,1,0,1,2,1,1,3,2,1,0,0,0,2,0,2,0,0,0,0,0,0,1,0,1
190646,30000,300,0,-2,5,3,2,0,0,0,0,0,0,4,2,2,0,0,0,0,0,0,0,0,0,1,1,0,0,0,0,0,0,0
190655,30000,300,0,-2,3,3,0,0,0,0,0,0,0,1,1,0,0,0,0,0,0,0,1,1,0,0,0,0,0,0,0,1,1,0
190664,30000,300,0,-2,6,1,5,0,0,0,0,0,0,1,0,1,1,1,0,0,0,0,4,0,4,0,0,0,0,0,0,0,0,0
190673,30000,300,0,-2,5,3,2,0,0,0,1,1,0,0,0,0,0,0,0,0,0,0,4,2,2,0,0,0,0,0,0,0,0,0
190682,30000,300,0,-2,3,2,1,0,0,0,1,1,0,1,1,0,0,0,0,0,0,0,1,0,1,0,0,0,0,0,0,0,0,0
190691,30000,300,0,-2,7,2,5,0,0,0,0,0,0,5,1,4,0,0,0,0,0,0,2,1,1,0,0,0,0,0,0,0,0,0
190716,30000,300,0,-2,4,2,2,0,0,0,0,0,0,0,0,0,1,1,0,0,0,0,3,1,2,0,0,0,0,0,0,0,0,0
190725,30000,300,0,-2,4,1,3,0,0,0,0,0,0,1,0,1,0,0,0,0,0,0,3,1,2,0,0,0,0,0,0,0,0,0
190761,30000,300,0,-2,5,1,4,0,0,0,0,0,0,0,0,0,0,0,0,0,0,0,5,1,4,0,0,0,0,0,0,0,0,0
190840,30000,300,0,-2,2,1,1,0,0,0,0,0,0,0,0,0,0,0,0,0,0,0,0,0,0,0,0,0,2,1,1,0,0,0
190956,30000,300,0,-2,1,0,1,0,0,0,0,0,0,0,0,0,0,0,0,0,0,0,1,0,1,0,0,0,0,0,0,0,0,0
190983,30000,300,0,-2,6,3,3,0,0,0,0,0,0,0,0,0,0,0,0,0,0,0,6,3,3,0,0,0,0,0,0,0,0,0
191083,30000,300,0,-2,1,0,1,0,0,0,0,0,0,0,0,0,0,0,0,0,0,0,1,0,1,0,0,0,0,0,0,0,0,0
191126,30000,300,0,-2,1,0,1,0,0,0,0,0,0,0,0,0,0,0,0,0,0,0,0,0,0,0,0,0,1,0,1,0,0,0
191241,30000,300,0,-2,25,9,16,0,0,0,2,0,2,5,2,3,4,2,2,0,0,0,14,5,9,0,0,0,0,0,0,0,0,0
191320,30000,300,0,-2,1,0,1,0,0,0,0,0,0,0,0,0,0,0,0,0,0,0,1,0,1,0,0,0,0,0,0,0,0,0
191339,30000,300,0,-2,2,1,1,0,0,0,0,0,0,0,0,0,0,0,0,0,0,0,2,1,1,0,0,0,0,0,0,0,0,0
191515,30000,300,0,-2,4,2,2,0,0,0,0,0,0,0,0,0,0,0,0,0,0,0,4,2,2,0,0,0,0,0,0,0,0,0
191533,30000,300,0,-2,7,3,4,0,0,0,0,0,0,2,2,0,0,0,0,0,0,0,5,1,4,0,0,0,0,0,0,0,0,0
191597,30000,300,0,-2,3,0,3,0,0,0,0,0,0,2,0,2,1,0,1,0,0,0,0,0,0,0,0,0,0,0,0,0,0,0
191612,30000,300,0,-2,1,0,1,0,0,0,0,0,0,0,0,0,0,0,0,0,0,0,1,0,1,0,0,0,0,0,0,0,0,0
191621,30000,300,0,-2,5,1,4,0,0,0,0,0,0,1,0,1,0,0,0,0,0,0,4,1,3,0,0,0,0,0,0,0,0,0
191630,30000,300,0,-2,3,0,3,0,0,0,0,0,0,0,0,0,0,0,0,0,0,0,3,0,3,0,0,0,0,0,0,0,0,0
191649,30000,300,0,-2,17,8,9,0,0,0,1,1,0,2,0,2,0,0,0,0,0,0,14,7,7,0,0,0,0,0,0,0,0,0
191676,30000,300,0,-2,3,1,2,0,0,0,0,0,0,1,1,0,0,0,0,0,0,0,2,0,2,0,0,0,0,0,0,0,0,0
191931,30000,300,0,-2,10,2,8,0,0,0,1,0,1,1,0,1,1,0,1,0,0,0,7,2,5,0,0,0,0,0,0,0,0,0
191968,30000,300,0,-2,7,4,3,0,0,0,0,0,0,0,0,0,0,0,0,0,0,0,0,0,0,0,0,0,7,4,3,0,0,0
191986,30000,300,0,-2,2,0,2,0,0,0,0,0,0,0,0,0,0,0,0,0,0,0,2,0,2,0,0,0,0,0,0,0,0,0
192022,30000,300,0,-2,1,1,0,0,0,0,0,0,0,0,0,0,0,0,0,0,0,0,1,1,0,0,0,0,0,0,0,0,0,0
192110,30000,300,0,-2,19,5,14,0,0,0,3,1,2,2,2,0,2,0,2,0,0,0,11,2,9,0,0,0,1,0,1,0,0,0
192192,30000,300,0,-2,5,1,4,0,0,0,0,0,0,0,0,0,0,0,0,0,0,0,5,1,4,0,0,0,0,0,0,0,0,0
192271,30000,300,0,-2,2,2,0,0,0,0,0,0,0,0,0,0,0,0,0,0,0,0,2,2,0,0,0,0,0,0,0,0,0,0
192323,30000,300,0,-2,6,4,2,0,0,0,0,0,0,0,0,0,1,1,0,0,0,0,5,3,2,0,0,0,0,0,0,0,0,0
192448,30000,300,0,-2,54,20,34,0,0,0,3,2,1,6,2,4,3,0,3,0,0,0,34,14,20,0,0,0,7,2,5,1,0,1
192703,30000,300,0,-2,18,7,11,0,0,0,0,0,0,2,1,1,5,1,4,0,0,0,11,5,6,0,0,0,0,0,0,0,0,0
192712,30000,300,0,-2,4,2,2,0,0,0,0,0,0,1,0,1,1,1,0,0,0,0,2,1,1,0,0,0,0,0,0,0,0,0
192749,30000,300,0,-2,12,8,4,0,0,0,0,0,0,1,1,0,3,1,2,0,0,0,7,5,2,0,0,0,1,1,0,0,0,0
192785,30000,300,0,-2,5,0,5,0,0,0,0,0,0,0,0,0,0,0,0,0,0,0,5,0,5,0,0,0,0,0,0,0,0,0
192819,30000,300,0,-2,12,4,8,0,0,0,0,0,0,1,1,0,3,1,2,0,0,0,8,2,6,0,0,0,0,0,0,0,0,0
192864,30000,300,0,-2,9,3,6,0,0,0,0,0,0,1,0,1,0,0,0,0,0,0,2,0,2,0,0,0,6,3,3,0,0,0
192925,30000,300,0,-2,5,1,4,0,0,0,0,0,0,1,0,1,0,0,0,0,0,0,4,1,3,0,0,0,0,0,0,0,0,0
193016,30000,300,0,-2,20,10,10,0,0,0,1,1,0,5,5,0,3,1,2,0,0,0,9,2,7,0,0,0,1,1,0,1,0,1
193283,30000,300,0,-2,3,1,2,0,0,0,0,0,0,0,0,0,0,0,0,0,0,0,3,1,2,0,0,0,0,0,0,0,0,0
193292,30000,300,0,-2,4,1,3,0,0,0,0,0,0,0,0,0,0,0,0,0,0,0,4,1,3,0,0,0,0,0,0,0,0,0
193308,30000,300,0,-2,1,0,1,0,0,0,0,0,0,1,0,1,0,0,0,0,0,0,0,0,0,0,0,0,0,0,0,0,0,0
193326,30000,300,0,-2,2,1,1,0,0,0,0,0,0,1,0,1,1,1,0,0,0,0,0,0,0,0,0,0,0,0,0,0,0,0
193353,30000,300,0,-2,2,1,1,0,0,0,0,0,0,0,0,0,0,0,0,0,0,0,2,1,1,0,0,0,0,0,0,0,0,0
193399,30000,300,0,-2,1,1,0,0,0,0,0,0,0,0,0,0,0,0,0,0,0,0,1,1,0,0,0,0,0,0,0,0,0,0
193405,30000,300,0,-2,107,23,84,0,0,0,9,2,7,8,0,8,14,3,11,0,0,0,16,6,10,1,0,1,54,11,43,5,1,4
193584,30000,300,0,-2,3,2,1,0,0,0,0,0,0,2,2,0,0,0,0,0,0,0,1,0,1,0,0,0,0,0,0,0,0,0
193654,30000,300,0,-2,24,9,15,0,0,0,2,1,1,7,3,4,3,1,2,0,0,0,9,3,6,0,0,0,2,0,2,1,1,0
193821,30000,300,0,-2,1,1,0,0,0,0,0,0,0,0,0,0,1,1,0,0,0,0,0,0,0,0,0,0,0,0,0,0,0,0
193894,30000,300,0,-2,1,0,1,0,0,0,0,0,0,1,0,1,0,0,0,0,0,0,0,0,0,0,0,0,0,0,0,0,0,0
193900,30000,300,0,-2,110,37,73,0,0,0,18,8,10,14,5,9,13,4,9,0,0,0,59,18,41,1,0,1,2,0,2,3,2,1
193946,30000,300,0,-2,2,1,1,0,0,0,0,0,0,0,0,0,0,0,0,0,0,0,1,1,0,1,0,1,0,0,0,0,0,0
193973,30000,300,0,-2,17,5,12,0,0,0,0,0,0,5,3,2,0,0,0,0,0,0,12,2,10,0,0,0,0,0,0,0,0,0
194028,30000,300,0,-2,1,0,1,0,0,0,0,0,0,0,0,0,0,0,0,0,0,0,1,0,1,0,0,0,0,0,0,0,0,0
194091,30000,300,0,-2,23,7,16,0,0,0,1,0,1,4,2,2,5,2,3,0,0,0,12,2,10,0,0,0,0,0,0,1,1,0
194116,30000,300,0,-2,1,0,1,0,0,0,0,0,0,0,0,0,0,0,0,0,0,0,1,0,1,0,0,0,0,0,0,0,0,0
194161,30000,300,0,-2,2,2,0,0,0,0,1,1,0,0,0,0,0,0,0,0,0,0,1,1,0,0,0,0,0,0,0,0,0,0
194222,30000,300,0,-2,6,5,1,0,0,0,0,0,0,1,0,1,0,0,0,0,0,0,5,5,0,0,0,0,0,0,0,0,0,0
194240,30000,300,0,-2,4,1,3,0,0,0,0,0,0,2,1,1,1,0,1,0,0,0,1,0,1,0,0,0,0,0,0,0,0,0
194310,30000,300,0,-2,20,8,12,0,0,0,1,0,1,3,3,0,6,2,4,0,0,0,9,3,6,0,0,0,0,0,0,1,0,1
194392,30000,300,0,-2,6,3,3,0,0,0,0,0,0,0,0,0,0,0,0,0,0,0,6,3,3,0,0,0,0,0,0,0,0,0
194578,30000,300,0,-2,3,1,2,0,0,0,0,0,0,0,0,0,1,0,1,0,0,0,1,1,0,0,0,0,1,0,1,0,0,0
194824,30000,300,0,-2,3,1,2,0,0,0,0,0,0,0,0,0,0,0,0,0,0,0,3,1,2,0,0,0,0,0,0,0,0,0
194958,30000,300,0,-2,2,1,1,0,0,0,0,0,0,0,0,0,0,0,0,0,0,0,2,1,1,0,0,0,0,0,0,0,0,0
195003,30000,300,0,-2,22,9,13,0,0,0,1,1,0,2,0,2,2,0,2,0,0,0,16,8,8,0,0,0,1,0,1,0,0,0
195030,30000,300,0,-2,65,24,41,0,0,0,4,3,1,10,5,5,3,3,0,0,0,0,47,13,34,1,0,1,0,0,0,0,0,0
195049,30000,300,0,-2,4,0,4,0,0,0,0,0,0,2,0,2,0,0,0,0,0,0,1,0,1,0,0,0,0,0,0,1,0,1
195058,30000,300,0,-2,6,3,3,0,0,0,0,0,0,1,1,0,2,0,2,0,0,0,3,2,1,0,0,0,0,0,0,0,0,0
195128,30000,300,0,-2,2,2,0,0,0,0,0,0,0,0,0,0,1,1,0,0,0,0,1,1,0,0,0,0,0,0,0,0,0,0
195164,30000,300,0,-2,4,2,2,0,0,0,0,0,0,1,1,0,0,0,0,0,0,0,3,1,2,0,0,0,0,0,0,0,0,0
195173,30000,300,0,-2,6,3,3,0,0,0,0,0,0,2,1,1,1,1,0,0,0,0,3,1,2,0,0,0,0,0,0,0,0,0
195191,30000,300,0,-2,1,0,1,0,0,0,0,0,0,0,0,0,0,0,0,0,0,0,1,0,1,0,0,0,0,0,0,0,0,0
195216,30000,300,0,-2,6,4,2,0,0,0,0,0,0,0,0,0,1,1,0,0,0,0,5,3,2,0,0,0,0,0,0,0,0,0
195234,30000,300,0,-2,2,1,1,0,0,0,0,0,0,0,0,0,1,1,0,0,0,0,1,0,1,0,0,0,0,0,0,0,0,0
195243,30000,300,0,-2,11,3,8,0,0,0,0,0,0,5,2,3,1,0,1,0,0,0,4,1,3,1,0,1,0,0,0,0,0,0
195304,30000,300,0,-2,12,1,11,0,0,0,1,0,1,2,0,2,3,1,2,0,0,0,6,0,6,0,0,0,0,0,0,0,0,0
195322,30000,300,0,-2,6,4,2,0,0,0,0,0,0,3,1,2,0,0,0,0,0,0,3,3,0,0,0,0,0,0,0,0,0,0
195474,30000,300,0,-2,2,0,2,0,0,0,1,0,1,0,0,0,0,0,0,0,0,0,1,0,1,0,0,0,0,0,0,0,0,0
195526,30000,300,0,-2,6,3,3,0,0,0,0,0,0,1,0,1,2,2,0,0,0,0,3,1,2,0,0,0,0,0,0,0,0,0
195720,30000,300,0,-2,8,3,5,0,0,0,0,0,0,1,1,0,1,1,0,0,0,0,6,1,5,0,0,0,0,0,0,0,0,0
195784,30000,300,0,-2,1,1,0,0,0,0,0,0,0,1,1,0,0,0,0,0,0,0,0,0,0,0,0,0,0,0,0,0,0,0
195809,30000,300,0,-2,1,1,0,0,0,0,0,0,0,0,0,0,0,0,0,0,0,0,1,1,0,0,0,0,0,0,0,0,0,0
195827,30000,300,0,-2,14,1,13,1,0,1,0,0,0,2,1,1,3,0,3,0,0,0,8,0,8,0,0,0,0,0,0,0,0,0
195988,30000,300,0,-2,1,0,1,0,0,0,0,0,0,0,0,0,0,0,0,0,0,0,1,0,1,0,0,0,0,0,0,0,0,0
196006,30000,300,0,-2,2,0,2,0,0,0,0,0,0,0,0,0,1,0,1,0,0,0,1,0,1,0,0,0,0,0,0,0,0,0
196024,30000,300,0,-2,1,1,0,0,0,0,0,0,0,0,0,0,1,1,0,0,0,0,0,0,0,0,0,0,0,0,0,0,0,0
196042,30000,300,0,-2,2,2,0,0,0,0,1,1,0,0,0,0,0,0,0,0,0,0,1,1,0,0,0,0,0,0,0,0,0,0
196051,30000,300,0,-2,2,2,0,0,0,0,0,0,0,0,0,0,0,0,0,0,0,0,2,2,0,0,0,0,0,0,0,0,0,0
196060,30000,300,0,-2,4,3,1,0,0,0,0,0,0,1,0,1,0,0,0,0,0,0,2,2,0,1,1,0,0,0,0,0,0,0
196079,30000,300,0,-2,3,2,1,0,0,0,2,1,1,0,0,0,0,0,0,0,0,0,1,1,0,0,0,0,0,0,0,0,0,0
196088,30000,300,0,-2,8,7,1,0,0,0,1,1,0,1,1,0,0,0,0,0,0,0,5,4,1,1,1,0,0,0,0,0,0,0
196097,30000,300,0,-2,11,7,4,0,0,0,0,0,0,1,1,0,0,0,0,0,0,0,9,6,3,1,0,1,0,0,0,0,0,0
196103,30000,300,0,-2,2,1,1,0,0,0,0,0,0,1,1,0,0,0,0,0,0,0,1,0,1,0,0,0,0,0,0,0,0,0
196112,30000,300,0,-2,5,2,3,0,0,0,0,0,0,0,0,0,1,0,1,0,0,0,4,2,2,0,0,0,0,0,0,0,0,0
196121,30000,300,0,-2,3,0,3,0,0,0,0,0,0,1,0,1,1,0,1,0,0,0,1,0,1,0,0,0,0,0,0,0,0,0
196130,30000,300,0,-2,3,1,2,0,0,0,0,0,0,0,0,0,0,0,0,0,0,0,3,1,2,0,0,0,0,0,0,0,0,0
196149,30000,300,0,-2,1,0,1,0,0,0,0,0,0,0,0,0,0,0,0,0,0,0,1,0,1,0,0,0,0,0,0,0,0,0
196158,30000,300,0,-2,5,2,3,0,0,0,0,0,0,0,0,0,0,0,0,0,0,0,5,2,3,0,0,0,0,0,0,0,0,0
196167,30000,300,0,-2,7,2,5,0,0,0,0,0,0,0,0,0,0,0,0,0,0,0,7,2,5,0,0,0,0,0,0,0,0,0
196176,30000,300,0,-2,4,3,1,0,0,0,0,0,0,2,1,1,0,0,0,0,0,0,2,2,0,0,0,0,0,0,0,0,0,0
196185,30000,300,0,-2,2,1,1,0,0,0,0,0,0,0,0,0,1,1,0,0,0,0,1,0,1,0,0,0,0,0,0,0,0,0
196194,30000,300,0,-2,5,2,3,0,0,0,0,0,0,0,0,0,0,0,0,0,0,0,5,2,3,0,0,0,0,0,0,0,0,0
196200,30000,300,0,-2,3,2,1,0,0,0,0,0,0,1,1,0,0,0,0,0,0,0,2,1,1,0,0,0,0,0,0,0,0,0
196219,30000,300,0,-2,3,1,2,0,0,0,0,0,0,0,0,0,0,0,0,0,0,0,3,1,2,0,0,0,0,0,0,0,0,0
196237,30000,300,0,-2,7,2,5,0,0,0,0,0,0,4,1,3,1,0,1,0,0,0,2,1,1,0,0,0,0,0,0,0,0,0
196246,30000,300,0,-2,2,0,2,0,0,0,0,0,0,0,0,0,0,0,0,0,0,0,2,0,2,0,0,0,0,0,0,0,0,0
196255,30000,300,0,-2,4,2,2,0,0,0,0,0,0,1,0,1,0,0,0,0,0,0,3,2,1,0,0,0,0,0,0,0,0,0
196264,30000,300,0,-2,5,2,3,0,0,0,1,0,1,1,0,1,1,0,1,0,0,0,2,2,0,0,0,0,0,0,0,0,0,0
196291,30000,300,0,-2,1,1,0,0,0,0,0,0,0,0,0,0,0,0,0,0,0,0,1,1,0,0,0,0,0,0,0,0,0,0
196307,30000,300,0,-2,3,3,0,0,0,0,0,0,0,0,0,0,0,0,0,0,0,0,3,3,0,0,0,0,0,0,0,0,0,0
196389,30000,300,0,-2,1,1,0,0,0,0,0,0,0,0,0,0,0,0,0,0,0,0,1,1,0,0,0,0,0,0,0,0,0,0
196413,30000,300,0,-2,22,9,13,0,0,0,0,0,0,2,0,2,0,0,0,0,0,0,15,9,6,5,0,5,0,0,0,0,0,0
196468,30000,300,0,-2,5,2,3,0,0,0,1,0,1,1,0,1,1,0,1,0,0,0,2,2,0,0,0,0,0,0,0,0,0,0
196565,30000,300,0,-2,2,2,0,0,0,0,0,0,0,1,1,0,0,0,0,0,0,0,1,1,0,0,0,0,0,0,0,0,0,0
196592,30000,300,0,-2,4,1,3,0,0,0,1,0,1,0,0,0,1,1,0,0,0,0,2,0,2,0,0,0,0,0,0,0,0,0
196653,30000,300,0,-2,2,1,1,0,0,0,1,1,0,0,0,0,0,0,0,0,0,0,1,0,1,0,0,0,0,0,0,0,0,0
196680,30000,300,0,-2,1,0,1,0,0,0,0,0,0,0,0,0,0,0,0,0,0,0,1,0,1,0,0,0,0,0,0,0,0,0
196699,30000,300,0,-2,1,1,0,0,0,0,0,0,0,0,0,0,0,0,0,0,0,0,1,1,0,0,0,0,0,0,0,0,0,0
196866,30000,300,0,-2,9,6,3,0,0,0,0,0,0,0,0,0,0,0,0,0,0,0,9,6,3,0,0,0,0,0,0,0,0,0
196884,30000,300,0,-2,3,2,1,0,0,0,1,0,1,0,0,0,0,0,0,0,0,0,2,2,0,0,0,0,0,0,0,0,0,0
197027,30000,300,0,-2,2,2,0,0,0,0,0,0,0,0,0,0,0,0,0,0,0,0,2,2,0,0,0,0,0,0,0,0,0,0
197036,30000,300,0,-2,11,7,4,0,0,0,0,0,0,0,0,0,1,1,0,0,0,0,10,6,4,0,0,0,0,0,0,0,0,0
197133,30000,300,0,-2,8,2,6,0,0,0,0,0,0,0,0,0,2,1,1,0,0,0,5,1,4,0,0,0,1,0,1,0,0,0
197151,30000,300,0,-2,2,2,0,0,0,0,0,0,0,1,1,0,0,0,0,0,0,0,1,1,0,0,0,0,0,0,0,0,0,0
197197,30000,300,0,-2,1,0,1,0,0,0,0,0,0,0,0,0,0,0,0,0,0,0,1,0,1,0,0,0,0,0,0,0,0,0
197230,30000,300,0,-2,1,0,1,0,0,0,0,0,0,0,0,0,0,0,0,0,0,0,1,0,1,0,0,0,0,0,0,0,0,0
197285,30000,300,0,-2,2,1,1,0,0,0,0,0,0,1,1,0,0,0,0,0,0,0,1,0,1,0,0,0,0,0,0,0,0,0
197294,30000,300,0,-2,2,0,2,0,0,0,0,0,0,0,0,0,0,0,0,0,0,0,2,0,2,0,0,0,0,0,0,0,0,0
197708,30000,300,0,-2,5,1,4,0,0,0,0,0,0,0,0,0,0,0,0,0,0,0,5,1,4,0,0,0,0,0,0,0,0,0
197850,30000,300,0,-2,9,2,7,0,0,0,0,0,0,1,0,1,1,0,1,0,0,0,7,2,5,0,0,0,0,0,0,0,0,0
197869,30000,300,0,-2,7,1,6,0,0,0,0,0,0,1,0,1,0,0,0,0,0,0,6,1,5,0,0,0,0,0,0,0,0,0
197887,30000,300,0,-2,3,0,3,0,0,0,0,0,0,0,0,0,1,0,1,0,0,0,2,0,2,0,0,0,0,0,0,0,0,0
197911,30000,300,0,-2,6,3,3,0,0,0,1,0,1,2,1,1,0,0,0,0,0,0,3,2,1,0,0,0,0,0,0,0,0,0
197966,30000,300,0,-2,2,1,1,0,0,0,0,0,0,1,0,1,0,0,0,0,0,0,1,1,0,0,0,0,0,0,0,0,0,0
197993,30000,300,0,-2,6,5,1,0,0,0,0,0,0,4,3,1,0,0,0,0,0,0,2,2,0,0,0,0,0,0,0,0,0,0
198011,30000,300,0,-2,2,2,0,0,0,0,0,0,0,0,0,0,0,0,0,0,0,0,2,2,0,0,0,0,0,0,0,0,0,0
198039,30000,300,0,-2,4,1,3,0,0,0,0,0,0,0,0,0,0,0,0,0,0,0,4,1,3,0,0,0,0,0,0,0,0,0
198066,30000,300,0,-2,1,1,0,0,0,0,0,0,0,0,0,0,0,0,0,0,0,0,1,1,0,0,0,0,0,0,0,0,0,0
198084,30000,300,0,-2,5,1,4,0,0,0,0,0,0,1,0,1,0,0,0,0,0,0,4,1,3,0,0,0,0,0,0,0,0,0
198118,30000,300,0,-2,1,1,0,0,0,0,0,0,0,0,0,0,0,0,0,0,0,0,1,1,0,0,0,0,0,0,0,0,0,0
198136,30000,300,0,-2,5,2,3,0,0,0,0,0,0,2,0,2,0,0,0,0,0,0,3,2,1,0,0,0,0,0,0,0,0,0
198154,30000,300,0,-2,2,1,1,0,0,0,0,0,0,0,0,0,1,1,0,0,0,0,1,0,1,0,0,0,0,0,0,0,0,0
198206,30000,300,0,-2,2,2,0,0,0,0,0,0,0,0,0,0,0,0,0,0,0,0,2,2,0,0,0,0,0,0,0,0,0,0
198215,30000,300,0,-2,2,0,2,0,0,0,0,0,0,0,0,0,0,0,0,0,0,0,2,0,2,0,0,0,0,0,0,0,0,0
198233,30000,300,0,-2,5,1,4,0,0,0,0,0,0,1,0,1,0,0,0,0,0,0,4,1,3,0,0,0,0,0,0,0,0,0
198251,30000,300,0,-2,9,2,7,0,0,0,0,0,0,2,0,2,0,0,0,0,0,0,7,2,5,0,0,0,0,0,0,0,0,0
198260,30000,300,0,-2,4,1,3,0,0,0,0,0,0,3,1,2,1,0,1,0,0,0,0,0,0,0,0,0,0,0,0,0,0,0
198303,30000,300,0,-2,1,1,0,0,0,0,0,0,0,0,0,0,0,0,0,0,0,0,1,1,0,0,0,0,0,0,0,0,0,0
198321,30000,300,0,-2,1,1,0,0,0,0,0,0,0,0,0,0,0,0,0,0,0,0,1,1,0,0,0,0,0,0,0,0,0,0
198330,30000,300,0,-2,1,0,1,0,0,0,0,0,0,1,0,1,0,0,0,0,0,0,0,0,0,0,0,0,0,0,0,0,0,0
198367,30000,300,0,-2,6,1,5,0,0,0,0,0,0,2,0,2,0,0,0,0,0,0,4,1,3,0,0,0,0,0,0,0,0,0
198376,30000,300,0,-2,7,4,3,0,0,0,0,0,0,1,0,1,0,0,0,0,0,0,5,3,2,0,0,0,1,1,0,0,0,0
198419,30000,300,0,-2,48,13,35,0,0,0,0,0,0,10,2,8,2,2,0,0,0,0,31,8,23,4,1,3,0,0,0,1,0,1
198455,30000,300,0,-2,6,3,3,0,0,0,0,0,0,5,2,3,0,0,0,0,0,0,1,1,0,0,0,0,0,0,0,0,0,0
198464,30000,300,0,-2,8,4,4,0,0,0,1,0,1,0,0,0,0,0,0,0,0,0,4,2,2,0,0,0,3,2,1,0,0,0
198491,30000,300,0,-2,1,0,1,0,0,0,0,0,0,0,0,0,0,0,0,0,0,0,1,0,1,0,0,0,0,0,0,0,0,0
198507,30000,300,0,-2,5,2,3,0,0,0,0,0,0,4,1,3,0,0,0,0,0,0,1,1,0,0,0,0,0,0,0,0,0,0
198516,30000,300,0,-2,4,2,2,0,0,0,0,0,0,2,0,2,0,0,0,0,0,0,2,2,0,0,0,0,0,0,0,0,0,0
198534,30000,300,0,-2,11,3,8,0,0,0,0,0,0,5,1,4,0,0,0,0,0,0,6,2,4,0,0,0,0,0,0,0,0,0
198543,30000,300,0,-2,9,4,5,1,0,1,0,0,0,5,2,3,0,0,0,0,0,0,3,2,1,0,0,0,0,0,0,0,0,0
198552,30000,300,0,-2,16,7,9,0,0,0,1,0,1,5,3,2,2,0,2,0,0,0,8,4,4,0,0,0,0,0,0,0,0,0
198561,30000,300,0,-2,5,4,1,0,0,0,0,0,0,0,0,0,0,0,0,0,0,0,5,4,1,0,0,0,0,0,0,0,0,0
198570,30000,300,0,-2,1,1,0,0,0,0,0,0,0,1,1,0,0,0,0,0,0,0,0,0,0,0,0,0,0,0,0,0,0,0
198613,30000,300,0,-2,5,3,2,0,0,0,0,0,0,1,0,1,0,0,0,0,0,0,4,3,1,0,0,0,0,0,0,0,0,0
198622,30000,300,0,-2,7,5,2,0,0,0,1,1,0,4,3,1,0,0,0,0,0,0,2,1,1,0,0,0,0,0,0,0,0,0
198668,30000,300,0,-2,3,1,2,0,0,0,0,0,0,0,0,0,0,0,0,0,0,0,3,1,2,0,0,0,0,0,0,0,0,0
198695,30000,300,0,-2,27,12,15,0,0,0,0,0,0,3,3,0,2,1,1,0,0,0,22,8,14,0,0,0,0,0,0,0,0,0
198710,30000,300,0,-2,1,0,1,0,0,0,0,0,0,0,0,0,0,0,0,0,0,0,1,0,1,0,0,0,0,0,0,0,0,0
198729,30000,300,0,-2,5,1,4,0,0,0,0,0,0,1,0,1,0,0,0,0,0,0,4,1,3,0,0,0,0,0,0,0,0,0
198756,30000,300,0,-2,6,2,4,0,0,0,0,0,0,4,2,2,0,0,0,0,0,0,1,0,1,0,0,0,1,0,1,0,0,0
198774,30000,300,0,-2,4,1,3,0,0,0,0,0,0,0,0,0,0,0,0,0,0,0,4,1,3,0,0,0,0,0,0,0,0,0
198808,30000,300,0,-2,3,0,3,0,0,0,0,0,0,0,0,0,0,0,0,0,0,0,3,0,3,0,0,0,0,0,0,0,0,0
198817,30000,300,0,-2,1,1,0,0,0,0,0,0,0,1,1,0,0,0,0,0,0,0,0,0,0,0,0,0,0,0,0,0,0,0
198835,30000,300,0,-2,5,4,1,0,0,0,0,0,0,2,2,0,0,0,0,0,0,0,3,2,1,0,0,0,0,0,0,0,0,0
198862,30000,300,0,-2,1,0,1,0,0,0,0,0,0,1,0,1,0,0,0,0,0,0,0,0,0,0,0,0,0,0,0,0,0,0
198871,30000,300,0,-2,3,1,2,0,0,0,0,0,0,1,0,1,0,0,0,0,0,0,2,1,1,0,0,0,0,0,0,0,0,0
198899,30000,300,0,-2,1,0,1,0,0,0,0,0,0,0,0,0,0,0,0,0,0,0,1,0,1,0,0,0,0,0,0,0,0,0
198905,30000,300,0,-2,3,2,1,0,0,0,0,0,0,0,0,0,0,0,0,0,0,0,3,2,1,0,0,0,0,0,0,0,0,0
198914,30000,300,0,-2,2,0,2,0,0,0,0,0,0,0,0,0,0,0,0,0,0,0,2,0,2,0,0,0,0,0,0,0,0,0
198950,30000,300,0,-2,3,0,3,0,0,0,0,0,0,1,0,1,0,0,0,0,0,0,2,0,2,0,0,0,0,0,0,0,0,0
198969,30000,300,0,-2,2,1,1,0,0,0,0,0,0,1,0,1,0,0,0,0,0,0,1,1,0,0,0,0,0,0,0,0,0,0
198978,30000,300,0,-2,2,1,1,0,0,0,0,0,0,0,0,0,0,0,0,0,0,0,2,1,1,0,0,0,0,0,0,0,0,0
198987,30000,300,0,-2,2,1,1,0,0,0,0,0,0,1,1,0,0,0,0,0,0,0,1,0,1,0,0,0,0,0,0,0,0,0
199023,30000,300,0,-2,1,0,1,0,0,0,0,0,0,0,0,0,0,0,0,0,0,0,1,0,1,0,0,0,0,0,0,0,0,0
199032,30000,300,0,-2,1,1,0,0,0,0,0,0,0,0,0,0,0,0,0,0,0,0,1,1,0,0,0,0,0,0,0,0,0,0
199069,30000,300,0,-2,6,4,2,0,0,0,0,0,0,2,2,0,0,0,0,0,0,0,4,2,2,0,0,0,0,0,0,0,0,0
199087,30000,300,0,-2,1,0,1,0,0,0,0,0,0,0,0,0,0,0,0,0,0,0,1,0,1,0,0,0,0,0,0,0,0,0
199102,30000,300,0,-2,10,6,4,0,0,0,0,0,0,7,4,3,0,0,0,0,0,0,1,1,0,0,0,0,2,1,1,0,0,0
199111,30000,300,0,-2,5,1,4,0,0,0,0,0,0,1,0,1,0,0,0,0,0,0,4,1,3,0,0,0,0,0,0,0,0,0
199120,30000,300,0,-2,10,5,5,0,0,0,1,0,1,5,2,3,0,0,0,0,0,0,2,2,0,0,0,0,1,0,1,1,1,0
199139,30000,300,0,-2,9,5,4,0,0,0,0,0,0,3,1,2,0,0,0,0,0,0,6,4,2,0,0,0,0,0,0,0,0,0
199148,30000,300,0,-2,9,6,3,0,0,0,0,0,0,2,1,1,2,2,0,0,0,0,3,2,1,1,0,1,1,1,0,0,0,0
199157,30000,300,0,-2,14,4,10,0,0,0,0,0,0,3,2,1,0,0,0,0,0,0,2,1,1,0,0,0,9,1,8,0,0,0
199175,30000,300,0,-2,13,5,8,0,0,0,0,0,0,4,3,1,0,0,0,0,0,0,9,2,7,0,0,0,0,0,0,0,0,0
199184,30000,300,0,-2,8,2,6,0,0,0,0,0,0,2,0,2,0,0,0,0,0,0,5,2,3,0,0,0,1,0,1,0,0,0
199193,30000,300,0,-2,12,9,3,0,0,0,3,3,0,3,1,2,0,0,0,0,0,0,6,5,1,0,0,0,0,0,0,0,0,0
199209,30000,300,0,-2,2,1,1,0,0,0,0,0,0,1,1,0,0,0,0,0,0,0,1,0,1,0,0,0,0,0,0,0,0,0
199218,30000,300,0,-2,7,5,2,0,0,0,1,1,0,1,1,0,0,0,0,0,0,0,3,2,1,0,0,0,2,1,1,0,0,0
199281,30000,300,0,-2,5,2,3,2,0,2,0,0,0,0,0,0,0,0,0,0,0,0,3,2,1,0,0,0,0,0,0,0,0,0
199306,30000,300,0,-2,1,1,0,0,0,0,0,0,0,0,0,0,0,0,0,0,0,0,1,1,0,0,0,0,0,0,0,0,0,0
199324,30000,300,0,-2,5,3,2,0,0,0,0,0,0,0,0,0,1,0,1,0,0,0,4,3,1,0,0,0,0,0,0,0,0,0
199333,30000,300,0,-2,6,2,4,0,0,0,0,0,0,2,0,2,0,0,0,0,0,0,4,2,2,0,0,0,0,0,0,0,0,0
199412,30000,300,0,-2,5,2,3,0,0,0,0,0,0,0,0,0,0,0,0,0,0,0,3,2,1,2,0,2,0,0,0,0,0,0
199421,30000,300,0,-2,3,1,2,0,0,0,0,0,0,0,0,0,0,0,0,0,0,0,0,0,0,0,0,0,3,1,2,0,0,0
199449,30000,300,0,-2,4,0,4,0,0,0,0,0,0,1,0,1,0,0,0,0,0,0,3,0,3,0,0,0,0,0,0,0,0,0
199467,30000,300,0,-2,5,1,4,0,0,0,0,0,0,4,1,3,0,0,0,0,0,0,1,0,1,0,0,0,0,0,0,0,0,0
199476,30000,300,0,-2,3,1,2,1,0,1,0,0,0,1,0,1,0,0,0,0,0,0,1,1,0,0,0,0,0,0,0,0,0,0
199494,30000,300,0,-2,7,3,4,0,0,0,0,0,0,1,0,1,0,0,0,0,0,0,6,3,3,0,0,0,0,0,0,0,0,0
199582,30000,300,0,-2,17,7,10,0,0,0,0,0,0,0,0,0,0,0,0,0,0,0,0,0,0,0,0,0,17,7,10,0,0,0
199607,30000,300,0,-2,9,3,6,0,0,0,0,0,0,0,0,0,2,0,2,0,0,0,7,3,4,0,0,0,0,0,0,0,0,0
199625,30000,300,0,-2,2,1,1,0,0,0,0,0,0,0,0,0,1,1,0,0,0,0,1,0,1,0,0,0,0,0,0,0,0,0
199634,30000,300,0,-2,3,2,1,0,0,0,0,0,0,1,1,0,0,0,0,0,0,0,2,1,1,0,0,0,0,0,0,0,0,0
199643,30000,300,0,-2,10,8,2,0,0,0,0,0,0,9,7,2,0,0,0,0,0,0,1,1,0,0,0,0,0,0,0,0,0,0
199698,30000,300,0,-2,3,0,3,0,0,0,0,0,0,3,0,3,0,0,0,0,0,0,0,0,0,0,0,0,0,0,0,0,0,0
199722,30000,300,0,-2,4,2,2,1,1,0,0,0,0,1,1,0,0,0,0,0,0,0,2,0,2,0,0,0,0,0,0,0,0,0
199731,30000,300,0,-2,1,0,1,0,0,0,0,0,0,0,0,0,1,0,1,0,0,0,0,0,0,0,0,0,0,0,0,0,0,0
199740,30000,300,0,-2,2,0,2,0,0,0,0,0,0,0,0,0,0,0,0,0,0,0,2,0,2,0,0,0,0,0,0,0,0,0
199768,30000,300,0,-2,2,0,2,0,0,0,0,0,0,0,0,0,0,0,0,0,0,0,2,0,2,0,0,0,0,0,0,0,0,0
199786,30000,300,0,-2,5,2,3,0,0,0,0,0,0,1,1,0,0,0,0,0,0,0,4,1,3,0,0,0,0,0,0,0,0,0
199795,30000,300,0,-2,2,2,0,0,0,0,0,0,0,0,0,0,0,0,0,0,0,0,2,2,0,0,0,0,0,0,0,0,0,0
199838,30000,300,0,-2,5,3,2,0,0,0,0,0,0,1,1,0,1,0,1,0,0,0,3,2,1,0,0,0,0,0,0,0,0,0
199847,30000,300,0,-2,80,31,49,0,0,0,1,1,0,19,6,13,3,1,2,0,0,0,48,19,29,6,3,3,2,0,2,1,1,0
199856,30000,300,0,-2,15,5,10,0,0,0,0,0,0,3,0,3,0,0,0,0,0,0,11,4,7,0,0,0,1,1,0,0,0,0
199865,30000,300,0,-2,7,4,3,0,0,0,0,0,0,3,1,2,1,1,0,0,0,0,1,1,0,0,0,0,2,1,1,0,0,0
199892,30000,300,0,-2,2,1,1,0,0,0,0,0,0,0,0,0,0,0,0,0,0,0,2,1,1,0,0,0,0,0,0,0,0,0
199908,30000,300,0,-2,3,0,3,0,0,0,0,0,0,1,0,1,0,0,0,0,0,0,2,0,2,0,0,0,0,0,0,0,0,0
199926,30000,300,0,-2,4,0,4,0,0,0,0,0,0,0,0,0,1,0,1,0,0,0,3,0,3,0,0,0,0,0,0,0,0,0
199953,30000,300,0,-2,1,0,1,0,0,0,0,0,0,0,0,0,0,0,0,0,0,0,1,0,1,0,0,0,0,0,0,0,0,0
199962,30000,300,0,-2,8,1,7,0,0,0,0,0,0,0,0,0,1,0,1,0,0,0,7,1,6,0,0,0,0,0,0,0,0,0
199999,30000,300,0,-2,4,2,2,0,0,0,0,0,0,2,1,1,0,0,0,0,0,0,0,0,0,0,0,0,2,1,1,0,0,0
200004,30000,300,0,-2,5,5,0,0,0,0,0,0,0,1,1,0,0,0,0,0,0,0,4,4,0,0,0,0,0,0,0,0,0,0
200022,30000,300,0,-2,4,2,2,0,0,0,0,0,0,0,0,0,0,0,0,0,0,0,4,2,2,0,0,0,0,0,0,0,0,0
200156,30000,300,0,-2,2,1,1,0,0,0,0,0,0,0,0,0,0,0,0,0,0,0,2,1,1,0,0,0,0,0,0,0,0,0
200208,30000,300,0,-2,3,0,3,2,0,2,0,0,0,0,0,0,0,0,0,0,0,0,1,0,1,0,0,0,0,0,0,0,0,0
200226,30000,300,0,-2,1,0,1,0,0,0,0,0,0,0,0,0,0,0,0,0,0,0,1,0,1,0,0,0,0,0,0,0,0,0
200280,30000,300,0,-2,12,9,3,0,0,0,0,0,0,0,0,0,0,0,0,0,0,0,10,8,2,1,1,0,0,0,0,1,0,1
200305,30000,300,0,-2,3,1,2,0,0,0,0,0,0,0,0,0,0,0,0,0,0,0,3,1,2,0,0,0,0,0,0,0,0,0
200332,30000,300,0,-2,8,4,4,0,0,0,0,0,0,1,0,1,1,1,0,0,0,0,6,3,3,0,0,0,0,0,0,0,0,0
200484,30000,300,0,-2,1,1,0,0,0,0,0,0,0,0,0,0,0,0,0,0,0,0,1,1,0,0,0,0,0,0,0,0,0,0
200527,30000,300,0,-2,3,1,2,3,1,2,0,0,0,0,0,0,0,0,0,0,0,0,0,0,0,0,0,0,0,0,0,0,0,0
200572,30000,300,0,-2,2,0,2,0,0,0,0,0,0,0,0,0,0,0,0,0,0,0,2,0,2,0,0,0,0,0,0,0,0,0
200800,30000,300,0,-2,8,5,3,0,0,0,1,0,1,3,3,0,0,0,0,0,0,0,4,2,2,0,0,0,0,0,0,0,0,0
201061,30000,300,0,-2,3,0,3,0,0,0,0,0,0,2,0,2,0,0,0,0,0,0,1,0,1,0,0,0,0,0,0,0,0,0
201104,30000,300,0,-2,6,5,1,0,0,0,0,0,0,0,0,0,0,0,0,0,0,0,6,5,1,0,0,0,0,0,0,0,0,0
201177,30000,300,0,-2,1,0,1,0,0,0,0,0,0,0,0,0,0,0,0,0,0,0,1,0,1,0,0,0,0,0,0,0,0,0
201195,30000,300,0,-2,6,3,3,0,0,0,0,0,0,1,0,1,1,0,1,0,0,0,3,2,1,1,1,0,0,0,0,0,0,0
201283,30000,300,0,-2,4,2,2,0,0,0,0,0,0,0,0,0,0,0,0,0,0,0,4,2,2,0,0,0,0,0,0,0,0,0
201371,30000,300,0,-2,3,1,2,0,0,0,0,0,0,0,0,0,0,0,0,0,0,0,3,1,2,0,0,0,0,0,0,0,0,0
201441,30000,300,0,-2,12,6,6,0,0,0,0,0,0,0,0,0,0,0,0,0,0,0,12,6,6,0,0,0,0,0,0,0,0,0
201548,30000,300,0,-2,3,0,3,0,0,0,0,0,0,1,0,1,0,0,0,0,0,0,2,0,2,0,0,0,0,0,0,0,0,0
201645,30000,300,0,-2,7,5,2,0,0,0,0,0,0,2,2,0,0,0,0,0,0,0,5,3,2,0,0,0,0,0,0,0,0,0
201654,30000,300,0,-2,2,2,0,0,0,0,0,0,0,0,0,0,0,0,0,0,0,0,2,2,0,0,0,0,0,0,0,0,0,0
201672,30000,300,0,-2,1,0,1,0,0,0,0,0,0,0,0,0,0,0,0,0,0,0,1,0,1,0,0,0,0,0,0,0,0,0
201690,30000,300,0,-2,7,2,5,0,0,0,1,1,0,5,1,4,0,0,0,0,0,0,1,0,1,0,0,0,0,0,0,0,0,0
201751,30000,300,0,-2,1,0,1,0,0,0,0,0,0,1,0,1,0,0,0,0,0,0,0,0,0,0,0,0,0,0,0,0,0,0
201885,30000,300,0,-2,70,25,45,0,0,0,0,0,0,9,0,9,3,2,1,0,0,0,55,23,32,2,0,2,1,0,1,0,0,0
201928,30000,300,0,-2,4,0,4,0,0,0,0,0,0,2,0,2,0,0,0,0,0,0,2,0,2,0,0,0,0,0,0,0,0,0
201946,30000,300,0,-2,1,0,1,0,0,0,0,0,0,0,0,0,0,0,0,0,0,0,1,0,1,0,0,0,0,0,0,0,0,0
201964,30000,300,0,-2,3,3,0,0,0,0,0,0,0,1,1,0,0,0,0,0,0,0,2,2,0,0,0,0,0,0,0,0,0,0
201973,30000,300,0,-2,5,3,2,0,0,0,0,0,0,3,2,1,0,0,0,0,0,0,1,1,0,0,0,0,1,0,1,0,0,0
202046,30000,300,0,-2,2,1,1,0,0,0,0,0,0,2,1,1,0,0,0,0,0,0,0,0,0,0,0,0,0,0,0,0,0,0
202073,30000,300,0,-2,4,1,3,0,0,0,0,0,0,0,0,0,0,0,0,0,0,0,4,1,3,0,0,0,0,0,0,0,0,0
202134,30000,300,0,-2,11,5,6,0,0,0,0,0,0,2,2,0,0,0,0,0,0,0,9,3,6,0,0,0,0,0,0,0,0,0
202170,30000,300,0,-2,5,2,3,0,0,0,0,0,0,1,1,0,0,0,0,0,0,0,3,1,2,1,0,1,0,0,0,0,0,0
202222,30000,300,0,-2,17,5,12,0,0,0,0,0,0,6,3,3,0,0,0,0,0,0,11,2,9,0,0,0,0,0,0,0,0,0
202356,30000,300,0,-2,9,6,3,0,0,0,0,0,0,5,3,2,0,0,0,0,0,0,4,3,1,0,0,0,0,0,0,0,0,0
202480,30000,300,0,-2,18,9,9,0,0,0,0,0,0,2,1,1,0,0,0,0,0,0,15,8,7,0,0,0,1,0,1,0,0,0
202514,30000,300,0,-2,2,0,2,0,0,0,0,0,0,0,0,0,0,0,0,0,0,0,2,0,2,0,0,0,0,0,0,0,0,0
202523,30000,300,0,-2,25,12,13,0,0,0,0,0,0,3,1,2,0,0,0,0,0,0,19,9,10,3,2,1,0,0,0,0,0,0
202648,30000,300,0,-2,2,2,0,0,0,0,0,0,0,0,0,0,0,0,0,0,0,0,1,1,0,0,0,0,1,1,0,0,0,0
202763,30000,300,0,-2,3,0,3,0,0,0,0,0,0,0,0,0,0,0,0,0,0,0,3,0,3,0,0,0,0,0,0,0,0,0
202806,30000,300,0,-2,3,1,2,0,0,0,0,0,0,0,0,0,0,0,0,0,0,0,3,1,2,0,0,0,0,0,0,0,0,0
203067,30000,300,0,-2,8,3,5,0,0,0,2,2,0,2,0,2,0,0,0,0,0,0,4,1,3,0,0,0,0,0,0,0,0,0
203085,30000,300,0,-2,3,0,3,0,0,0,0,0,0,0,0,0,0,0,0,0,0,0,3,0,3,0,0,0,0,0,0,0,0,0
203128,30000,300,0,-2,1,0,1,0,0,0,0,0,0,0,0,0,0,0,0,0,0,0,1,0,1,0,0,0,0,0,0,0,0,0
203155,30000,300,0,-2,13,9,4,0,0,0,1,1,0,0,0,0,0,0,0,0,0,0,12,8,4,0,0,0,0,0,0,0,0,0
203368,30000,300,0,-2,2,2,0,0,0,0,0,0,0,0,0,0,0,0,0,0,0,0,2,2,0,0,0,0,0,0,0,0,0,0
203386,30000,300,0,-2,2,2,0,0,0,0,0,0,0,0,0,0,0,0,0,0,0,0,2,2,0,0,0,0,0,0,0,0,0,0
203447,30000,300,0,-2,1,0,1,0,0,0,0,0,0,0,0,0,0,0,0,0,0,0,1,0,1,0,0,0,0,0,0,0,0,0
203517,30000,300,0,-2,43,17,26,0,0,0,0,0,0,6,2,4,2,1,1,0,0,0,32,12,20,0,0,0,3,2,1,0,0,0
203535,30000,300,0,-2,11,3,8,0,0,0,0,0,0,0,0,0,1,1,0,0,0,0,4,2,2,0,0,0,5,0,5,1,0,1
203544,30000,300,0,-2,3,0,3,0,0,0,0,0,0,0,0,0,0,0,0,0,0,0,2,0,2,0,0,0,0,0,0,1,0,1
203580,30000,300,0,-2,3,0,3,0,0,0,0,0,0,1,0,1,0,0,0,0,0,0,2,0,2,0,0,0,0,0,0,0,0,0
203678,30000,300,0,-2,1,0,1,0,0,0,0,0,0,1,0,1,0,0,0,0,0,0,0,0,0,0,0,0,0,0,0,0,0,0
203748,30000,300,0,-2,1,0,1,0,0,0,0,0,0,0,0,0,0,0,0,0,0,0,1,0,1,0,0,0,0,0,0,0,0,0
203757,30000,300,0,-2,5,4,1,0,0,0,0,0,0,1,0,1,0,0,0,0,0,0,4,4,0,0,0,0,0,0,0,0,0,0
203775,30000,300,0,-2,2,0,2,0,0,0,0,0,0,1,0,1,0,0,0,0,0,0,1,0,1,0,0,0,0,0,0,0,0,0
203845,30000,300,0,-2,3,1,2,0,0,0,0,0,0,0,0,0,0,0,0,0,0,0,3,1,2,0,0,0,0,0,0,0,0,0
203881,30000,300,0,-2,1,1,0,0,0,0,0,0,0,0,0,0,0,0,0,0,0,0,1,1,0,0,0,0,0,0,0,0,0,0
203960,30000,300,0,-2,4,3,1,0,0,0,0,0,0,1,1,0,0,0,0,0,0,0,2,1,1,0,0,0,1,1,0,0,0,0
204006,30000,300,0,-2,1,1,0,0,0,0,0,0,0,1,1,0,0,0,0,0,0,0,0,0,0,0,0,0,0,0,0,0,0,0
204024,30000,300,0,-2,17,6,11,0,0,0,0,0,0,2,0,2,3,1,2,0,0,0,12,5,7,0,0,0,0,0,0,0,0,0
204176,30000,300,0,-2,1,0,1,0,0,0,0,0,0,0,0,0,0,0,0,0,0,0,1,0,1,0,0,0,0,0,0,0,0,0
204185,30000,300,0,-2,1,1,0,0,0,0,0,0,0,1,1,0,0,0,0,0,0,0,0,0,0,0,0,0,0,0,0,0,0,0
204194,30000,300,0,-2,5,1,4,0,0,0,0,0,0,1,0,1,0,0,0,0,0,0,3,1,2,0,0,0,1,0,1,0,0,0
204200,30000,300,0,-2,4,3,1,0,0,0,0,0,0,0,0,0,0,0,0,0,0,0,4,3,1,0,0,0,0,0,0,0,0,0
204264,30000,300,0,-2,5,3,2,0,0,0,0,0,0,0,0,0,0,0,0,0,0,0,5,3,2,0,0,0,0,0,0,0,0,0
204422,30000,300,0,-2,4,3,1,0,0,0,0,0,0,0,0,0,0,0,0,0,0,0,4,3,1,0,0,0,0,0,0,0,0,0
204440,30000,300,0,-2,3,2,1,0,0,0,0,0,0,0,0,0,0,0,0,0,0,0,3,2,1,0,0,0,0,0,0,0,0,0
204468,30000,300,0,-2,1,0,1,0,0,0,0,0,0,0,0,0,0,0,0,0,0,0,1,0,1,0,0,0,0,0,0,0,0,0
204477,30000,300,0,-2,8,1,7,0,0,0,0,0,0,0,0,0,1,0,1,0,0,0,5,1,4,0,0,0,2,0,2,0,0,0
204501,30000,300,0,-2,22,6,16,0,0,0,1,1,0,2,0,2,4,2,2,0,0,0,14,2,12,0,0,0,0,0,0,1,1,0
204608,30000,300,0,-2,1,1,0,0,0,0,0,0,0,0,0,0,0,0,0,0,0,0,1,1,0,0,0,0,0,0,0,0,0,0
204617,30000,300,0,-2,2,1,1,0,0,0,0,0,0,0,0,0,0,0,0,0,0,0,2,1,1,0,0,0,0,0,0,0,0,0
204635,30000,300,0,-2,3,2,1,0,0,0,0,0,0,0,0,0,0,0,0,0,0,0,3,2,1,0,0,0,0,0,0,0,0,0
204671,30000,300,0,-2,2,1,1,0,0,0,0,0,0,1,0,1,0,0,0,0,0,0,1,1,0,0,0,0,0,0,0,0,0,0
204796,30000,300,0,-2,156,69,87,0,0,0,8,5,3,30,14,16,5,2,3,0,0,0,104,45,59,3,1,2,4,1,3,2,1,1
204857,30000,300,0,-2,21,11,10,0,0,0,0,0,0,0,0,0,1,1,0,0,0,0,19,9,10,0,0,0,1,1,0,0,0,0
204884,30000,300,0,-2,1,0,1,0,0,0,0,0,0,0,0,0,0,0,0,0,0,0,1,0,1,0,0,0,0,0,0,0,0,0
204909,30000,300,0,-2,3,0,3,0,0,0,0,0,0,3,0,3,0,0,0,0,0,0,0,0,0,0,0,0,0,0,0,0,0,0
204936,30000,300,0,-2,2,1,1,0,0,0,0,0,0,0,0,0,0,0,0,0,0,0,1,0,1,0,0,0,0,0,0,1,1,0
204945,30000,300,0,-2,9,2,7,0,0,0,0,0,0,2,0,2,0,0,0,0,0,0,7,2,5,0,0,0,0,0,0,0,0,0
204990,30000,300,0,-2,1,1,0,0,0,0,0,0,0,1,1,0,0,0,0,0,0,0,0,0,0,0,0,0,0,0,0,0,0,0
205054,30000,300,0,-2,1,0,1,0,0,0,0,0,0,0,0,0,1,0,1,0,0,0,0,0,0,0,0,0,0,0,0,0,0,0
205179,30000,300,0,-2,1,0,1,0,0,0,0,0,0,0,0,0,0,0,0,0,0,0,0,0,0,1,0,1,0,0,0,0,0,0
205203,30000,300,0,-2,3,1,2,0,0,0,0,0,0,1,1,0,0,0,0,0,0,0,2,0,2,0,0,0,0,0,0,0,0,0
205443,30000,300,0,-2,1,1,0,0,0,0,0,0,0,0,0,0,0,0,0,0,0,0,1,1,0,0,0,0,0,0,0,0,0,0
205887,30000,300,0,-2,3,2,1,0,0,0,0,0,0,0,0,0,0,0,0,0,0,0,3,2,1,0,0,0,0,0,0,0,0,0
205957,30000,300,0,-2,4,4,0,0,0,0,0,0,0,0,0,0,0,0,0,0,0,0,4,4,0,0,0,0,0,0,0,0,0,0
205966,30000,300,0,-2,2,1,1,0,0,0,0,0,0,0,0,0,0,0,0,0,0,0,2,1,1,0,0,0,0,0,0,0,0,0
206011,30000,300,0,-2,1,0,1,0,0,0,0,0,0,0,0,0,1,0,1,0,0,0,0,0,0,0,0,0,0,0,0,0,0,0
206048,30000,300,0,-2,1,1,0,0,0,0,0,0,0,0,0,0,0,0,0,0,0,0,1,1,0,0,0,0,0,0,0,0,0,0
206084,30000,300,0,-2,16,9,7,0,0,0,2,1,1,2,0,2,0,0,0,0,0,0,12,8,4,0,0,0,0,0,0,0,0,0
206279,30000,300,0,-2,1,0,1,0,0,0,0,0,0,0,0,0,0,0,0,0,0,0,1,0,1,0,0,0,0,0,0,0,0,0
206437,30000,300,0,-2,1,0,1,0,0,0,0,0,0,1,0,1,0,0,0,0,0,0,0,0,0,0,0,0,0,0,0,0,0,0
206446,30000,300,0,-2,6,2,4,0,0,0,0,0,0,0,0,0,0,0,0,0,0,0,6,2,4,0,0,0,0,0,0,0,0,0
206507,30000,300,0,-2,4,3,1,0,0,0,0,0,0,1,1,0,0,0,0,0,0,0,2,2,0,1,0,1,0,0,0,0,0,0
206525,30000,300,0,-2,4,4,0,0,0,0,0,0,0,0,0,0,0,0,0,0,0,0,4,4,0,0,0,0,0,0,0,0,0,0
206589,30000,300,0,-2,8,3,5,0,0,0,0,0,0,2,1,1,2,0,2,0,0,0,4,2,2,0,0,0,0,0,0,0,0,0
206604,30000,300,0,-2,11,6,5,0,0,0,1,1,0,1,1,0,0,0,0,0,0,0,9,4,5,0,0,0,0,0,0,0,0,0
206622,30000,300,0,-2,4,1,3,0,0,0,0,0,0,2,1,1,0,0,0,0,0,0,2,0,2,0,0,0,0,0,0,0,0,0
206695,30000,300,0,-2,5,3,2,0,0,0,0,0,0,0,0,0,0,0,0,0,0,0,5,3,2,0,0,0,0,0,0,0,0,0
206835,30000,300,0,-2,1,1,0,0,0,0,0,0,0,0,0,0,0,0,0,0,0,0,1,1,0,0,0,0,0,0,0,0,0,0
206862,30000,300,0,-2,1,0,1,0,0,0,0,0,0,0,0,0,0,0,0,0,0,0,1,0,1,0,0,0,0,0,0,0,0,0
206914,30000,300,0,-2,5,1,4,0,0,0,0,0,0,1,0,1,0,0,0,0,0,0,4,1,3,0,0,0,0,0,0,0,0,0
206941,30000,300,0,-2,14,8,6,0,0,0,0,0,0,0,0,0,0,0,0,0,0,0,10,5,5,0,0,0,4,3,1,0,0,0
206996,30000,300,0,-2,3,0,3,0,0,0,0,0,0,0,0,0,0,0,0,0,0,0,3,0,3,0,0,0,0,0,0,0,0,0
207041,30000,300,0,-2,1,0,1,0,0,0,0,0,0,0,0,0,0,0,0,0,0,0,1,0,1,0,0,0,0,0,0,0,0,0
207050,30000,300,0,-2,1,0,1,0,0,0,0,0,0,0,0,0,0,0,0,0,0,0,0,0,0,0,0,0,1,0,1,0,0,0
207069,30000,300,0,-2,3,2,1,0,0,0,0,0,0,0,0,0,1,0,1,0,0,0,2,2,0,0,0,0,0,0,0,0,0,0
207209,30000,300,0,-2,11,6,5,0,0,0,0,0,0,9,6,3,0,0,0,0,0,0,2,0,2,0,0,0,0,0,0,0,0,0
207254,30000,300,0,-2,3,2,1,0,0,0,0,0,0,1,0,1,0,0,0,0,0,0,2,2,0,0,0,0,0,0,0,0,0,0
207263,30000,300,0,-2,3,2,1,1,1,0,0,0,0,0,0,0,0,0,0,0,0,0,1,0,1,1,1,0,0,0,0,0,0,0
207281,30000,300,0,-2,4,2,2,0,0,0,0,0,0,0,0,0,0,0,0,0,0,0,4,2,2,0,0,0,0,0,0,0,0,0
207290,30000,300,0,-2,2,1,1,0,0,0,0,0,0,0,0,0,0,0,0,0,0,0,2,1,1,0,0,0,0,0,0,0,0,0
207315,30000,300,0,-2,7,6,1,0,0,0,1,1,0,0,0,0,1,0,1,0,0,0,5,5,0,0,0,0,0,0,0,0,0,0
207324,30000,300,0,-2,1,0,1,0,0,0,0,0,0,0,0,0,1,0,1,0,0,0,0,0,0,0,0,0,0,0,0,0,0,0
207342,30000,300,0,-2,16,4,12,0,0,0,0,0,0,2,0,2,1,0,1,0,0,0,11,3,8,2,1,1,0,0,0,0,0,0
207351,30000,300,0,-2,2,1,1,0,0,0,1,1,0,0,0,0,1,0,1,0,0,0,0,0,0,0,0,0,0,0,0,0,0,0
207388,30000,300,0,-2,23,17,6,0,0,0,2,2,0,3,2,1,2,2,0,0,0,0,16,11,5,0,0,0,0,0,0,0,0,0
207397,30000,300,0,-2,5,4,1,0,0,0,0,0,0,0,0,0,0,0,0,0,0,0,3,2,1,2,2,0,0,0,0,0,0,0
207403,30000,300,0,-2,6,3,3,0,0,0,0,0,0,0,0,0,0,0,0,0,0,0,6,3,3,0,0,0,0,0,0,0,0,0
207449,30000,300,0,-2,13,5,8,0,0,0,0,0,0,1,0,1,3,1,2,0,0,0,9,4,5,0,0,0,0,0,0,0,0,0
207458,30000,300,0,-2,7,4,3,0,0,0,0,0,0,0,0,0,0,0,0,0,0,0,6,3,3,0,0,0,0,0,0,1,1,0
207500,30000,300,0,-2,20,11,9,2,0,2,1,0,1,3,1,2,1,1,0,0,0,0,9,7,2,3,1,2,0,0,0,1,1,0
207564,30000,300,0,-2,1,1,0,0,0,0,0,0,0,0,0,0,0,0,0,0,0,0,1,1,0,0,0,0,0,0,0,0,0,0
207582,30000,300,0,-2,7,3,4,0,0,0,0,0,0,1,0,1,0,0,0,0,0,0,5,3,2,0,0,0,0,0,0,1,0,1
207661,30000,300,0,-2,4,2,2,1,0,1,0,0,0,0,0,0,0,0,0,0,0,0,3,2,1,0,0,0,0,0,0,0,0,0
207670,30000,300,0,-2,6,3,3,0,0,0,0,0,0,1,1,0,0,0,0,0,0,0,5,2,3,0,0,0,0,0,0,0,0,0
207722,30000,300,0,-2,1,0,1,0,0,0,0,0,0,0,0,0,0,0,0,0,0,0,1,0,1,0,0,0,0,0,0,0,0,0
207740,30000,300,0,-2,1,0,1,0,0,0,0,0,0,0,0,0,0,0,0,0,0,0,1,0,1,0,0,0,0,0,0,0,0,0
207847,30000,300,0,-2,1,0,1,0,0,0,0,0,0,0,0,0,0,0,0,0,0,0,1,0,1,0,0,0,0,0,0,0,0,0
207865,30000,300,0,-2,2,0,2,0,0,0,0,0,0,0,0,0,0,0,0,0,0,0,2,0,2,0,0,0,0,0,0,0,0,0
207935,30000,300,0,-2,3,1,2,0,0,0,0,0,0,1,0,1,0,0,0,0,0,0,2,1,1,0,0,0,0,0,0,0,0,0
207962,30000,300,0,-2,1,0,1,0,0,0,0,0,0,1,0,1,0,0,0,0,0,0,0,0,0,0,0,0,0,0,0,0,0,0
207971,30000,300,0,-2,12,5,7,1,1,0,0,0,0,0,0,0,0,0,0,0,0,0,8,2,6,1,0,1,2,2,0,0,0,0
208035,30000,300,0,-2,1,1,0,0,0,0,0,0,0,0,0,0,0,0,0,0,0,0,1,1,0,0,0,0,0,0,0,0,0,0
208318,30000,300,0,-2,1,0,1,0,0,0,0,0,0,0,0,0,0,0,0,0,0,0,1,0,1,0,0,0,0,0,0,0,0,0
208390,30000,300,0,-2,16,11,5,0,0,0,0,0,0,0,0,0,3,2,1,0,0,0,10,7,3,0,0,0,3,2,1,0,0,0
208406,30000,300,0,-2,4,0,4,0,0,0,0,0,0,1,0,1,0,0,0,0,0,0,3,0,3,0,0,0,0,0,0,0,0,0
208415,30000,300,0,-2,1,0,1,0,0,0,0,0,0,0,0,0,0,0,0,0,0,0,1,0,1,0,0,0,0,0,0,0,0,0
208479,30000,300,0,-2,5,1,4,0,0,0,1,1,0,0,0,0,1,0,1,0,0,0,1,0,1,0,0,0,2,0,2,0,0,0
208646,30000,300,0,-2,3,0,3,0,0,0,0,0,0,0,0,0,0,0,0,0,0,0,3,0,3,0,0,0,0,0,0,0,0,0
208822,30000,300,0,-2,3,2,1,0,0,0,0,0,0,1,0,1,0,0,0,0,0,0,2,2,0,0,0,0,0,0,0,0,0,0
209038,30000,300,0,-2,4,1,3,0,0,0,0,0,0,0,0,0,0,0,0,0,0,0,3,0,3,0,0,0,1,1,0,0,0,0
209056,30000,300,0,-2,12,9,3,0,0,0,2,1,1,0,0,0,2,2,0,0,0,0,8,6,2,0,0,0,0,0,0,0,0,0
209065,30000,300,0,-2,5,3,2,0,0,0,0,0,0,0,0,0,0,0,0,0,0,0,5,3,2,0,0,0,0,0,0,0,0,0
209074,30000,300,0,-2,5,1,4,0,0,0,0,0,0,0,0,0,0,0,0,0,0,0,2,1,1,0,0,0,3,0,3,0,0,0
209250,30000,300,0,-2,6,0,6,0,0,0,0,0,0,0,0,0,0,0,0,0,0,0,3,0,3,2,0,2,1,0,1,0,0,0
209287,30000,300,0,-2,1,0,1,0,0,0,0,0,0,0,0,0,0,0,0,0,0,0,1,0,1,0,0,0,0,0,0,0,0,0
209409,30000,300,0,-2,4,3,1,0,0,0,0,0,0,0,0,0,0,0,0,0,0,0,4,3,1,0,0,0,0,0,0,0,0,0
209490,30000,300,0,-2,41,13,28,1,0,1,4,1,3,4,1,3,3,2,1,0,0,0,25,8,17,3,1,2,1,0,1,0,0,0
209506,30000,300,0,-2,8,4,4,0,0,0,0,0,0,0,0,0,1,1,0,0,0,0,7,3,4,0,0,0,0,0,0,0,0,0
209542,30000,300,0,-2,6,4,2,0,0,0,0,0,0,1,1,0,0,0,0,0,0,0,3,1,2,0,0,0,2,2,0,0,0,0
209551,30000,300,0,-2,25,10,15,0,0,0,0,0,0,3,0,3,3,3,0,0,0,0,17,7,10,2,0,2,0,0,0,0,0,0
209612,30000,300,0,-2,2,1,1,0,0,0,0,0,0,1,0,1,0,0,0,0,0,0,1,1,0,0,0,0,0,0,0,0,0,0
209746,30000,300,0,-2,6,1,5,0,0,0,2,1,1,0,0,0,0,0,0,0,0,0,3,0,3,0,0,0,1,0,1,0,0,0
209807,30000,300,0,-2,6,2,4,0,0,0,2,1,1,0,0,0,1,0,1,0,0,0,3,1,2,0,0,0,0,0,0,0,0,0
209825,30000,300,0,-2,12,8,4,0,0,0,0,0,0,2,1,1,1,1,0,0,0,0,7,4,3,1,1,0,1,1,0,0,0,0
209922,30000,300,0,-2,6,2,4,0,0,0,0,0,0,1,0,1,0,0,0,0,0,0,5,2,3,0,0,0,0,0,0,0,0,0
210270,30000,300,0,-2,9,1,8,0,0,0,0,0,0,0,0,0,0,0,0,0,0,0,4,1,3,2,0,2,3,0,3,0,0,0
210304,30000,300,0,-2,4,1,3,0,0,0,1,1,0,1,0,1,0,0,0,0,0,0,2,0,2,0,0,0,0,0,0,0,0,0
210331,30000,300,0,-2,4,1,3,0,0,0,0,0,0,0,0,0,0,0,0,0,0,0,4,1,3,0,0,0,0,0,0,0,0,0
210368,30000,300,0,-2,3,0,3,0,0,0,0,0,0,0,0,0,0,0,0,0,0,0,3,0,3,0,0,0,0,0,0,0,0,0
210401,30000,300,0,-2,20,8,12,0,0,0,0,0,0,1,1,0,3,2,1,0,0,0,15,5,10,1,0,1,0,0,0,0,0,0
210429,30000,300,0,-2,2,2,0,0,0,0,0,0,0,0,0,0,0,0,0,0,0,0,1,1,0,0,0,0,1,1,0,0,0,0
210438,30000,300,0,-2,3,1,2,0,0,0,0,0,0,0,0,0,0,0,0,0,0,0,3,1,2,0,0,0,0,0,0,0,0,0
210492,30000,300,0,-2,1,0,1,0,0,0,0,0,0,0,0,0,0,0,0,0,0,0,1,0,1,0,0,0,0,0,0,0,0,0
210571,30000,300,0,-2,4,2,2,0,0,0,0,0,0,1,0,1,0,0,0,0,0,0,3,2,1,0,0,0,0,0,0,0,0,0
210599,30000,300,0,-2,3,1,2,0,0,0,0,0,0,0,0,0,0,0,0,0,0,0,3,1,2,0,0,0,0,0,0,0,0,0
210605,30000,300,0,-2,16,9,7,0,0,0,0,0,0,2,1,1,3,2,1,0,0,0,11,6,5,0,0,0,0,0,0,0,0,0
210669,30000,300,0,-2,14,9,5,1,0,1,0,0,0,2,2,0,0,0,0,0,0,0,11,7,4,0,0,0,0,0,0,0,0,0
210775,30000,300,0,-2,3,3,0,0,0,0,0,0,0,0,0,0,1,1,0,0,0,0,2,2,0,0,0,0,0,0,0,0,0,0
210809,30000,300,0,-2,1,1,0,0,0,0,0,0,0,0,0,0,0,0,0,0,0,0,1,1,0,0,0,0,0,0,0,0,0,0
211079,30000,300,0,-2,4,3,1,0,0,0,0,0,0,0,0,0,0,0,0,0,0,0,4,3,1,0,0,0,0,0,0,0,0,0
211088,30000,300,0,-2,7,2,5,0,0,0,0,0,0,1,0,1,0,0,0,0,0,0,5,2,3,1,0,1,0,0,0,0,0,0
211158,30000,300,0,-2,1,1,0,0,0,0,0,0,0,1,1,0,0,0,0,0,0,0,0,0,0,0,0,0,0,0,0,0,0,0
211273,30000,300,0,-2,9,3,6,0,0,0,3,2,1,1,1,0,0,0,0,0,0,0,3,0,3,1,0,1,1,0,1,0,0,0
211291,30000,300,0,-2,2,0,2,0,0,0,0,0,0,1,0,1,0,0,0,0,0,0,1,0,1,0,0,0,0,0,0,0,0,0
211307,30000,300,0,-2,6,1,5,0,0,0,0,0,0,2,0,2,0,0,0,0,0,0,4,1,3,0,0,0,0,0,0,0,0,0
211343,30000,300,0,-2,1,0,1,0,0,0,0,0,0,0,0,0,0,0,0,0,0,0,1,0,1,0,0,0,0,0,0,0,0,0
211352,30000,300,0,-2,3,1,2,0,0,0,0,0,0,1,0,1,0,0,0,0,0,0,2,1,1,0,0,0,0,0,0,0,0,0
211431,30000,300,0,-2,12,1,11,0,0,0,0,0,0,1,0,1,0,0,0,0,0,0,10,1,9,1,0,1,0,0,0,0,0,0
211440,30000,300,0,-2,18,11,7,0,0,0,1,1,0,2,0,2,1,0,1,0,0,0,12,9,3,0,0,0,1,1,0,1,0,1
211468,30000,300,0,-2,4,2,2,0,0,0,0,0,0,0,0,0,0,0,0,0,0,0,3,1,2,1,1,0,0,0,0,0,0,0
211477,30000,300,0,-2,2,2,0,0,0,0,0,0,0,0,0,0,0,0,0,0,0,0,2,2,0,0,0,0,0,0,0,0,0,0
211556,30000,300,0,-2,4,3,1,0,0,0,0,0,0,0,0,0,1,1,0,0,0,0,3,2,1,0,0,0,0,0,0,0,0,0
211583,30000,300,0,-2,7,4,3,0,0,0,0,0,0,1,1,0,0,0,0,0,0,0,6,3,3,0,0,0,0,0,0,0,0,0
211893,30000,300,0,-2,1,1,0,0,0,0,0,0,0,0,0,0,0,0,0,0,0,0,1,1,0,0,0,0,0,0,0,0,0,0
211927,30000,300,0,-2,6,2,4,0,0,0,0,0,0,2,0,2,0,0,0,0,0,0,4,2,2,0,0,0,0,0,0,0,0,0
211981,30000,300,0,-2,1,1,0,0,0,0,0,0,0,0,0,0,0,0,0,0,0,0,1,1,0,0,0,0,0,0,0,0,0,0
212009,30000,300,0,-2,8,2,6,0,0,0,0,0,0,1,0,1,0,0,0,0,0,0,7,2,5,0,0,0,0,0,0,0,0,0
212054,30000,300,0,-2,8,1,7,0,0,0,0,0,0,2,0,2,1,0,1,0,0,0,5,1,4,0,0,0,0,0,0,0,0,0
212106,30000,300,0,-2,3,1,2,0,0,0,0,0,0,0,0,0,0,0,0,0,0,0,3,1,2,0,0,0,0,0,0,0,0,0
212115,30000,300,0,-2,8,5,3,0,0,0,0,0,0,0,0,0,2,1,1,0,0,0,5,4,1,1,0,1,0,0,0,0,0,0
212133,30000,300,0,-2,18,4,14,0,0,0,1,0,1,5,3,2,0,0,0,0,0,0,9,0,9,2,0,2,0,0,0,1,1,0
212160,30000,300,0,-2,1,1,0,0,0,0,0,0,0,0,0,0,0,0,0,0,0,0,1,1,0,0,0,0,0,0,0,0,0,0
212197,30000,300,0,-2,2,0,2,0,0,0,0,0,0,0,0,0,0,0,0,0,0,0,2,0,2,0,0,0,0,0,0,0,0,0
212577,30000,300,0,-2,3,1,2,0,0,0,0,0,0,1,1,0,0,0,0,0,0,0,2,0,2,0,0,0,0,0,0,0,0,0
212601,30000,300,0,-2,11,6,5,0,0,0,0,0,0,0,0,0,0,0,0,0,0,0,10,5,5,0,0,0,1,1,0,0,0,0
212656,30000,300,0,-2,2,1,1,0,0,0,0,0,0,0,0,0,0,0,0,0,0,0,2,1,1,0,0,0,0,0,0,0,0,0
212674,30000,300,0,-2,4,1,3,0,0,0,0,0,0,1,0,1,0,0,0,0,0,0,3,1,2,0,0,0,0,0,0,0,0,0
212832,30000,300,0,-2,6,3,3,0,0,0,0,0,0,1,0,1,0,0,0,0,0,0,5,3,2,0,0,0,0,0,0,0,0,0
212878,30000,300,0,-2,1,1,0,0,0,0,0,0,0,1,1,0,0,0,0,0,0,0,0,0,0,0,0,0,0,0,0,0,0,0
212911,30000,300,0,-2,3,3,0,0,0,0,0,0,0,1,1,0,0,0,0,0,0,0,1,1,0,0,0,0,1,1,0,0,0,0
212984,30000,300,0,-2,5,1,4,0,0,0,0,0,0,1,1,0,0,0,0,0,0,0,4,0,4,0,0,0,0,0,0,0,0,0
213020,30000,300,0,-2,3,2,1,0,0,0,0,0,0,0,0,0,0,0,0,0,0,0,3,2,1,0,0,0,0,0,0,0,0,0
213233,30000,300,0,-2,1,1,0,0,0,0,0,0,0,0,0,0,0,0,0,0,0,0,1,1,0,0,0,0,0,0,0,0,0,0
213251,30000,300,0,-2,1,0,1,0,0,0,0,0,0,1,0,1,0,0,0,0,0,0,0,0,0,0,0,0,0,0,0,0,0,0
213303,30000,300,0,-2,1,0,1,0,0,0,0,0,0,0,0,0,0,0,0,0,0,0,1,0,1,0,0,0,0,0,0,0,0,0
213321,30000,300,0,-2,2,0,2,0,0,0,0,0,0,1,0,1,0,0,0,0,0,0,1,0,1,0,0,0,0,0,0,0,0,0
213349,30000,300,0,-2,1,0,1,0,0,0,0,0,0,0,0,0,0,0,0,0,0,0,1,0,1,0,0,0,0,0,0,0,0,0
213358,30000,300,0,-2,5,2,3,0,0,0,0,0,0,0,0,0,0,0,0,0,0,0,5,2,3,0,0,0,0,0,0,0,0,0
213367,30000,300,0,-2,18,7,11,0,0,0,1,0,1,4,1,3,2,1,1,0,0,0,11,5,6,0,0,0,0,0,0,0,0,0
213376,30000,300,0,-2,2,1,1,0,0,0,1,0,1,0,0,0,0,0,0,0,0,0,1,1,0,0,0,0,0,0,0,0,0,0
213385,30000,300,0,-2,1,0,1,0,0,0,1,0,1,0,0,0,0,0,0,0,0,0,0,0,0,0,0,0,0,0,0,0,0,0
213400,30000,300,0,-2,10,4,6,0,0,0,1,0,1,1,0,1,0,0,0,0,0,0,8,4,4,0,0,0,0,0,0,0,0,0
213507,30000,300,0,-2,3,1,2,0,0,0,0,0,0,1,0,1,0,0,0,0,0,0,2,1,1,0,0,0,0,0,0,0,0,0
213525,30000,300,0,-2,5,2,3,0,0,0,0,0,0,0,0,0,0,0,0,0,0,0,5,2,3,0,0,0,0,0,0,0,0,0
213543,30000,300,0,-2,9,3,6,0,0,0,0,0,0,6,0,6,0,0,0,0,0,0,3,3,0,0,0,0,0,0,0,0,0,0
213570,30000,300,0,-2,2,1,1,0,0,0,0,0,0,1,0,1,0,0,0,0,0,0,1,1,0,0,0,0,0,0,0,0,0,0
213589,30000,300,0,-2,3,2,1,0,0,0,0,0,0,0,0,0,0,0,0,0,0,0,3,2,1,0,0,0,0,0,0,0,0,0
213598,30000,300,0,-2,1,0,1,0,0,0,0,0,0,0,0,0,0,0,0,0,0,0,1,0,1,0,0,0,0,0,0,0,0,0
213631,30000,300,0,-2,1,1,0,0,0,0,0,0,0,0,0,0,0,0,0,0,0,0,1,1,0,0,0,0,0,0,0,0,0,0
213668,30000,300,0,-2,2,1,1,0,0,0,0,0,0,0,0,0,0,0,0,0,0,0,2,1,1,0,0,0,0,0,0,0,0,0
213774,30000,300,0,-2,1,1,0,0,0,0,0,0,0,0,0,0,0,0,0,0,0,0,1,1,0,0,0,0,0,0,0,0,0,0
213826,30000,300,0,-2,7,3,4,0,0,0,1,1,0,0,0,0,0,0,0,0,0,0,5,2,3,0,0,0,1,0,1,0,0,0
213987,30000,300,0,-2,4,1,3,0,0,0,0,0,0,1,1,0,0,0,0,0,0,0,1,0,1,1,0,1,1,0,1,0,0,0
214041,30000,300,0,-2,2,1,1,0,0,0,0,0,0,0,0,0,0,0,0,0,0,0,2,1,1,0,0,0,0,0,0,0,0,0
214069,30000,300,0,-2,5,3,2,0,0,0,0,0,0,1,0,1,0,0,0,0,0,0,4,3,1,0,0,0,0,0,0,0,0,0
214111,30000,300,0,-2,15,8,7,0,0,0,1,1,0,2,2,0,0,0,0,0,0,0,11,5,6,0,0,0,1,0,1,0,0,0
214148,30000,300,0,-2,1,0,1,0,0,0,0,0,0,0,0,0,0,0,0,0,0,0,1,0,1,0,0,0,0,0,0,0,0,0
214157,30000,300,0,-2,3,0,3,0,0,0,1,0,1,1,0,1,0,0,0,0,0,0,1,0,1,0,0,0,0,0,0,0,0,0
214166,30000,300,0,-2,2,2,0,0,0,0,0,0,0,0,0,0,0,0,0,0,0,0,2,2,0,0,0,0,0,0,0,0,0,0
214175,30000,300,0,-2,3,1,2,0,0,0,0,0,0,1,0,1,0,0,0,0,0,0,2,1,1,0,0,0,0,0,0,0,0,0
214272,30000,300,0,-2,6,2,4,0,0,0,0,0,0,2,0,2,0,0,0,0,0,0,4,2,2,0,0,0,0,0,0,0,0,0
214290,30000,300,0,-2,2,1,1,0,0,0,0,0,0,0,0,0,0,0,0,0,0,0,2,1,1,0,0,0,0,0,0,0,0,0
214379,30000,300,0,-2,8,4,4,0,0,0,0,0,0,1,1,0,1,0,1,0,0,0,5,3,2,1,0,1,0,0,0,0,0,0
214564,30000,300,0,-2,2,2,0,0,0,0,0,0,0,1,1,0,0,0,0,0,0,0,0,0,0,1,1,0,0,0,0,0,0,0
214661,30000,300,0,-2,1,1,0,0,0,0,0,0,0,0,0,0,0,0,0,0,0,0,1,1,0,0,0,0,0,0,0,0,0,0
214883,30000,300,0,-2,2,0,2,0,0,0,0,0,0,2,0,2,0,0,0,0,0,0,0,0,0,0,0,0,0,0,0,0,0,0
214971,30000,300,0,-2,3,0,3,0,0,0,0,0,0,0,0,0,0,0,0,0,0,0,3,0,3,0,0,0,0,0,0,0,0,0
215053,30000,300,0,-2,2,0,2,0,0,0,0,0,0,0,0,0,0,0,0,0,0,0,2,0,2,0,0,0,0,0,0,0,0,0
215062,30000,300,0,-2,157,63,94,1,0,1,10,4,6,33,13,20,9,2,7,0,0,0,95,39,56,4,1,3,3,2,1,2,2,0
215105,30000,300,0,-2,4,1,3,0,0,0,0,0,0,1,0,1,0,0,0,0,0,0,2,1,1,1,0,1,0,0,0,0,0,0
215123,30000,300,0,-2,1,1,0,0,0,0,0,0,0,1,1,0,0,0,0,0,0,0,0,0,0,0,0,0,0,0,0,0,0,0
215239,30000,300,0,-2,9,6,3,0,0,0,2,2,0,5,3,2,0,0,0,0,0,0,2,1,1,0,0,0,0,0,0,0,0,0
215266,30000,300,0,-2,3,2,1,1,1,0,0,0,0,0,0,0,0,0,0,0,0,0,1,1,0,0,0,0,1,0,1,0,0,0
215275,30000,300,0,-2,1,1,0,0,0,0,0,0,0,0,0,0,0,0,0,0,0,0,1,1,0,0,0,0,0,0,0,0,0,0
215293,30000,300,0,-2,79,34,45,0,0,0,2,1,1,16,5,11,3,0,3,0,0,0,47,24,23,2,0,2,8,4,4,1,0,1
215381,30000,300,0,-2,1,1,0,0,0,0,0,0,0,0,0,0,0,0,0,0,0,0,1,1,0,0,0,0,0,0,0,0,0,0
215415,30000,300,0,-2,5,2,3,0,0,0,1,1,0,2,1,1,0,0,0,0,0,0,2,0,2,0,0,0,0,0,0,0,0,0
215424,30000,300,0,-2,1,1,0,0,0,0,0,0,0,1,1,0,0,0,0,0,0,0,0,0,0,0,0,0,0,0,0,0,0,0
215442,30000,300,0,-2,2,2,0,0,0,0,0,0,0,0,0,0,0,0,0,0,0,0,1,1,0,1,1,0,0,0,0,0,0,0
215585,30000,300,0,-2,3,3,0,0,0,0,0,0,0,1,1,0,0,0,0,0,0,0,2,2,0,0,0,0,0,0,0,0,0,0
215619,30000,300,0,-2,1,0,1,0,0,0,0,0,0,1,0,1,0,0,0,0,0,0,0,0,0,0,0,0,0,0,0,0,0,0
215655,30000,300,0,-2,6,5,1,0,0,0,0,0,0,0,0,0,1,1,0,0,0,0,5,4,1,0,0,0,0,0,0,0,0,0
215691,30000,300,0,-2,11,4,7,0,0,0,0,0,0,3,1,2,1,1,0,0,0,0,7,2,5,0,0,0,0,0,0,0,0,0
215770,30000,300,0,-2,6,2,4,0,0,0,0,0,0,1,0,1,1,0,1,0,0,0,4,2,2,0,0,0,0,0,0,0,0,0
215798,30000,300,0,-2,2,2,0,0,0,0,0,0,0,0,0,0,0,0,0,0,0,0,2,2,0,0,0,0,0,0,0,0,0,0
215929,30000,300,0,-2,1,1,0,0,0,0,0,0,0,0,0,0,0,0,0,0,0,0,1,1,0,0,0,0,0,0,0,0,0,0
215947,30000,300,0,-2,1,1,0,0,0,0,0,0,0,1,1,0,0,0,0,0,0,0,0,0,0,0,0,0,0,0,0,0,0,0
215992,30000,300,0,-2,1,1,0,0,0,0,0,0,0,0,0,0,0,0,0,0,0,0,1,1,0,0,0,0,0,0,0,0,0,0
216010,30000,300,0,-2,2,0,2,0,0,0,0,0,0,0,0,0,0,0,0,0,0,0,2,0,2,0,0,0,0,0,0,0,0,0
216038,30000,300,0,-2,1,1,0,0,0,0,0,0,0,0,0,0,0,0,0,0,0,0,1,1,0,0,0,0,0,0,0,0,0,0
216278,30000,300,0,-2,5,0,5,0,0,0,0,0,0,0,0,0,0,0,0,0,0,0,4,0,4,1,0,1,0,0,0,0,0,0
216287,30000,300,0,-2,5,1,4,0,0,0,0,0,0,1,0,1,0,0,0,0,0,0,4,1,3,0,0,0,0,0,0,0,0,0
216296,30000,300,0,-2,6,2,4,0,0,0,0,0,0,3,1,2,0,0,0,0,0,0,3,1,2,0,0,0,0,0,0,0,0,0
216339,30000,300,0,-2,74,29,45,0,0,0,5,1,4,14,7,7,5,2,3,0,0,0,43,15,28,3,1,2,4,3,1,0,0,0
216357,30000,300,0,-2,1,0,1,0,0,0,0,0,0,0,0,0,0,0,0,0,0,0,1,0,1,0,0,0,0,0,0,0,0,0
216366,30000,300,0,-2,78,40,38,0,0,0,4,3,1,14,7,7,0,0,0,0,0,0,51,27,24,8,2,6,1,1,0,0,0,0
216454,30000,300,0,-2,2,1,1,0,0,0,0,0,0,0,0,0,0,0,0,0,0,0,2,1,1,0,0,0,0,0,0,0,0,0
216463,30000,300,0,-2,1,0,1,0,0,0,0,0,0,0,0,0,0,0,0,0,0,0,1,0,1,0,0,0,0,0,0,0,0,0
216524,30000,300,0,-2,2,0,2,0,0,0,0,0,0,1,0,1,0,0,0,0,0,0,1,0,1,0,0,0,0,0,0,0,0,0
216542,30000,300,0,-2,9,3,6,0,0,0,0,0,0,1,1,0,1,1,0,0,0,0,7,1,6,0,0,0,0,0,0,0,0,0
216597,30000,300,0,-2,47,11,36,0,0,0,2,1,1,6,2,4,4,0,4,0,0,0,33,7,26,2,1,1,0,0,0,0,0,0
216694,30000,300,0,-2,1,0,1,0,0,0,0,0,0,0,0,0,0,0,0,0,0,0,1,0,1,0,0,0,0,0,0,0,0,0
216764,30000,300,0,-2,3,2,1,0,0,0,0,0,0,1,1,0,1,1,0,0,0,0,1,0,1,0,0,0,0,0,0,0,0,0
216807,30000,300,0,-2,12,7,5,0,0,0,0,0,0,0,0,0,0,0,0,0,0,0,12,7,5,0,0,0,0,0,0,0,0,0
216825,30000,300,0,-2,3,1,2,0,0,0,0,0,0,0,0,0,0,0,0,0,0,0,3,1,2,0,0,0,0,0,0,0,0,0
216852,30000,300,0,-2,12,6,6,0,0,0,0,0,0,5,1,4,1,1,0,0,0,0,6,4,2,0,0,0,0,0,0,0,0,0
216931,30000,300,0,-2,2,2,0,0,0,0,0,0,0,0,0,0,0,0,0,0,0,0,2,2,0,0,0,0,0,0,0,0,0,0
216940,30000,300,0,-2,1,1,0,0,0,0,0,0,0,0,0,0,0,0,0,0,0,0,1,1,0,0,0,0,0,0,0,0,0,0
217013,30000,300,0,-2,2,0,2,0,0,0,0,0,0,0,0,0,0,0,0,0,0,0,2,0,2,0,0,0,0,0,0,0,0,0
217059,30000,300,0,-2,4,4,0,0,0,0,1,1,0,0,0,0,0,0,0,0,0,0,3,3,0,0,0,0,0,0,0,0,0,0
217077,30000,300,0,-2,1,0,1,0,0,0,0,0,0,0,0,0,0,0,0,0,0,0,1,0,1,0,0,0,0,0,0,0,0,0
217156,30000,300,0,-2,57,22,35,0,0,0,4,1,3,13,6,7,4,1,3,0,0,0,29,12,17,5,2,3,2,0,2,0,0,0
217235,30000,300,0,-2,9,5,4,0,0,0,0,0,0,0,0,0,0,0,0,0,0,0,8,4,4,0,0,0,1,1,0,0,0,0
217402,30000,300,0,-2,7,4,3,0,0,0,2,1,1,2,1,1,0,0,0,0,0,0,3,2,1,0,0,0,0,0,0,0,0,0
217420,30000,300,0,-2,2,2,0,0,0,0,0,0,0,0,0,0,1,1,0,0,0,0,1,1,0,0,0,0,0,0,0,0,0,0
217475,30000,300,0,-2,3,0,3,0,0,0,0,0,0,1,0,1,0,0,0,0,0,0,2,0,2,0,0,0,0,0,0,0,0,0
217484,30000,300,0,-2,3,2,1,0,0,0,1,1,0,0,0,0,0,0,0,0,0,0,2,1,1,0,0,0,0,0,0,0,0,0
217493,30000,300,0,-2,17,3,14,0,0,0,0,0,0,2,0,2,2,0,2,0,0,0,12,3,9,0,0,0,0,0,0,1,0,1
217518,30000,300,0,-2,9,5,4,0,0,0,0,0,0,2,1,1,1,0,1,0,0,0,6,4,2,0,0,0,0,0,0,0,0,0
217536,30000,300,0,-2,5,0,5,0,0,0,0,0,0,0,0,0,1,0,1,0,0,0,4,0,4,0,0,0,0,0,0,0,0,0
217624,30000,300,0,-2,8,6,2,0,0,0,0,0,0,8,6,2,0,0,0,0,0,0,0,0,0,0,0,0,0,0,0,0,0,0
217633,30000,300,0,-2,2,2,0,0,0,0,0,0,0,0,0,0,0,0,0,0,0,0,2,2,0,0,0,0,0,0,0,0,0,0
217688,30000,300,0,-2,3,2,1,0,0,0,0,0,0,1,1,0,0,0,0,1,1,0,1,0,1,0,0,0,0,0,0,0,0,0
217712,30000,300,0,-2,5,1,4,0,0,0,0,0,0,0,0,0,0,0,0,0,0,0,5,1,4,0,0,0,0,0,0,0,0,0
217721,30000,300,0,-2,4,0,4,0,0,0,0,0,0,4,0,4,0,0,0,0,0,0,0,0,0,0,0,0,0,0,0,0,0,0
217819,30000,300,0,-2,10,1,9,0,0,0,0,0,0,1,0,1,0,0,0,0,0,0,9,1,8,0,0,0,0,0,0,0,0,0
217837,30000,300,0,-2,4,2,2,0,0,0,0,0,0,1,0,1,0,0,0,0,0,0,3,2,1,0,0,0,0,0,0,0,0,0
217864,30000,300,0,-2,25,11,14,0,0,0,0,0,0,2,1,1,2,0,2,0,0,0,11,6,5,0,0,0,10,4,6,0,0,0
217873,30000,300,0,-2,5,2,3,0,0,0,0,0,0,5,2,3,0,0,0,0,0,0,0,0,0,0,0,0,0,0,0,0,0,0
217882,30000,300,0,-2,6,1,5,0,0,0,0,0,0,0,0,0,0,0,0,0,0,0,6,1,5,0,0,0,0,0,0,0,0,0
217891,30000,300,0,-2,3,0,3,0,0,0,0,0,0,3,0,3,0,0,0,0,0,0,0,0,0,0,0,0,0,0,0,0,0,0
217907,30000,300,0,-2,5,3,2,0,0,0,0,0,0,1,1,0,0,0,0,0,0,0,4,2,2,0,0,0,0,0,0,0,0,0
217925,30000,300,0,-2,1,1,0,0,0,0,0,0,0,0,0,0,0,0,0,0,0,0,1,1,0,0,0,0,0,0,0,0,0,0
217934,30000,300,0,-2,7,1,6,0,0,0,0,0,0,3,0,3,0,0,0,0,0,0,4,1,3,0,0,0,0,0,0,0,0,0
217961,30000,300,0,-2,4,2,2,0,0,0,0,0,0,0,0,0,0,0,0,0,0,0,4,2,2,0,0,0,0,0,0,0,0,0
218025,30000,300,0,-2,1,1,0,0,0,0,0,0,0,1,1,0,0,0,0,0,0,0,0,0,0,0,0,0,0,0,0,0,0,0
218061,30000,300,0,-2,5,4,1,0,0,0,0,0,0,0,0,0,0,0,0,0,0,0,5,4,1,0,0,0,0,0,0,0,0,0
218070,30000,300,0,-2,3,2,1,0,0,0,0,0,0,1,1,0,0,0,0,0,0,0,2,1,1,0,0,0,0,0,0,0,0,0
218113,30000,300,0,-2,3,0,3,0,0,0,0,0,0,2,0,2,0,0,0,0,0,0,1,0,1,0,0,0,0,0,0,0,0,0
218140,30000,300,0,-2,2,1,1,0,0,0,0,0,0,0,0,0,0,0,0,0,0,0,2,1,1,0,0,0,0,0,0,0,0,0
218229,30000,300,0,-2,3,1,2,0,0,0,0,0,0,0,0,0,0,0,0,0,0,0,3,1,2,0,0,0,0,0,0,0,0,0
218238,30000,300,0,-2,1,0,1,0,0,0,0,0,0,0,0,0,0,0,0,0,0,0,1,0,1,0,0,0,0,0,0,0,0,0
218335,30000,300,0,-2,11,2,9,0,0,0,0,0,0,2,0,2,1,1,0,0,0,0,8,1,7,0,0,0,0,0,0,0,0,0
218399,30000,300,0,-2,4,1,3,0,0,0,0,0,0,4,1,3,0,0,0,0,0,0,0,0,0,0,0,0,0,0,0,0,0,0
218441,30000,300,0,-2,1,1,0,0,0,0,0,0,0,0,0,0,0,0,0,0,0,0,1,1,0,0,0,0,0,0,0,0,0,0
218520,30000,300,0,-2,1,0,1,0,0,0,0,0,0,1,0,1,0,0,0,0,0,0,0,0,0,0,0,0,0,0,0,0,0,0
218539,30000,300,0,-2,8,3,5,0,0,0,0,0,0,1,0,1,0,0,0,0,0,0,7,3,4,0,0,0,0,0,0,0,0,0
218645,30000,300,0,-2,5,3,2,0,0,0,0,0,0,1,1,0,0,0,0,0,0,0,4,2,2,0,0,0,0,0,0,0,0,0
218654,30000,300,0,-2,1,0,1,0,0,0,0,0,0,1,0,1,0,0,0,0,0,0,0,0,0,0,0,0,0,0,0,0,0,0
218663,30000,300,0,-2,106,50,56,0,0,0,2,1,1,36,15,21,4,1,3,0,0,0,62,32,30,1,0,1,0,0,0,1,1,0
218681,30000,300,0,-2,4,1,3,0,0,0,0,0,0,2,0,2,0,0,0,0,0,0,2,1,1,0,0,0,0,0,0,0,0,0
218690,30000,300,0,-2,1,0,1,0,0,0,0,0,0,1,0,1,0,0,0,0,0,0,0,0,0,0,0,0,0,0,0,0,0,0
218724,30000,300,0,-2,11,8,3,0,0,0,0,0,0,2,1,1,0,0,0,0,0,0,9,7,2,0,0,0,0,0,0,0,0,0
218733,30000,300,0,-2,1,1,0,0,0,0,0,0,0,1,1,0,0,0,0,0,0,0,0,0,0,0,0,0,0,0,0,0,0,0
218742,30000,300,0,-2,8,5,3,0,0,0,0,0,0,2,2,0,0,0,0,0,0,0,6,3,3,0,0,0,0,0,0,0,0,0
218821,30000,300,0,-2,1,0,1,0,0,0,0,0,0,1,0,1,0,0,0,0,0,0,0,0,0,0,0,0,0,0,0,0,0,0
218830,30000,300,0,-2,5,1,4,0,0,0,0,0,0,0,0,0,0,0,0,0,0,0,5,1,4,0,0,0,0,0,0,0,0,0
218858,30000,300,0,-2,4,2,2,0,0,0,0,0,0,1,0,1,0,0,0,0,0,0,3,2,1,0,0,0,0,0,0,0,0,0
218885,30000,300,0,-2,4,3,1,0,0,0,0,0,0,2,1,1,0,0,0,0,0,0,2,2,0,0,0,0,0,0,0,0,0,0
218919,30000,300,0,-2,4,1,3,0,0,0,0,0,0,4,1,3,0,0,0,0,0,0,0,0,0,0,0,0,0,0,0,0,0,0
218955,30000,300,0,-2,2,0,2,0,0,0,0,0,0,1,0,1,0,0,0,0,0,0,1,0,1,0,0,0,0,0,0,0,0,0
218964,30000,300,0,-2,9,5,4,0,0,0,0,0,0,2,2,0,0,0,0,0,0,0,7,3,4,0,0,0,0,0,0,0,0,0
218973,30000,300,0,-2,4,1,3,0,0,0,0,0,0,1,1,0,1,0,1,0,0,0,2,0,2,0,0,0,0,0,0,0,0,0
219000,30000,300,0,-2,10,3,7,0,0,0,0,0,0,2,1,1,0,0,0,0,0,0,8,2,6,0,0,0,0,0,0,0,0,0
219046,30000,300,0,-2,3,1,2,1,0,1,0,0,0,0,0,0,0,0,0,0,0,0,2,1,1,0,0,0,0,0,0,0,0,0
219091,30000,300,0,-2,2,1,1,0,0,0,0,0,0,0,0,0,0,0,0,0,0,0,2,1,1,0,0,0,0,0,0,0,0,0
219189,30000,300,0,-2,1,1,0,0,0,0,0,0,0,0,0,0,0,0,0,0,0,0,1,1,0,0,0,0,0,0,0,0,0,0
219198,30000,300,0,-2,1,1,0,0,0,0,0,0,0,0,0,0,0,0,0,0,0,0,1,1,0,0,0,0,0,0,0,0,0,0
219259,30000,300,0,-2,2,1,1,0,0,0,0,0,0,0,0,0,0,0,0,0,0,0,2,1,1,0,0,0,0,0,0,0,0,0
219347,30000,300,0,-2,6,4,2,0,0,0,0,0,0,1,1,0,0,0,0,0,0,0,5,3,2,0,0,0,0,0,0,0,0,0
219356,30000,300,0,-2,10,7,3,0,0,0,1,0,1,0,0,0,0,0,0,0,0,0,7,5,2,0,0,0,2,2,0,0,0,0
219383,30000,300,0,-2,2,2,0,0,0,0,0,0,0,0,0,0,0,0,0,0,0,0,2,2,0,0,0,0,0,0,0,0,0,0
219426,30000,300,0,-2,2,1,1,0,0,0,0,0,0,0,0,0,1,0,1,0,0,0,1,1,0,0,0,0,0,0,0,0,0,0
219471,30000,300,0,-2,21,6,15,1,0,1,0,0,0,2,0,2,1,1,0,0,0,0,16,4,12,1,1,0,0,0,0,0,0,0
219480,30000,300,0,-2,1,0,1,0,0,0,0,0,0,0,0,0,0,0,0,0,0,0,1,0,1,0,0,0,0,0,0,0,0,0
219602,30000,300,0,-2,3,2,1,0,0,0,0,0,0,1,0,1,0,0,0,0,0,0,1,1,0,0,0,0,1,1,0,0,0,0
219639,30000,300,0,-2,1,0,1,0,0,0,0,0,0,1,0,1,0,0,0,0,0,0,0,0,0,0,0,0,0,0,0,0,0,0
219709,30000,300,0,-2,5,2,3,0,0,0,0,0,0,3,1,2,0,0,0,0,0,0,2,1,1,0,0,0,0,0,0,0,0,0
219718,30000,300,0,-2,4,3,1,0,0,0,0,0,0,1,0,1,0,0,0,0,0,0,3,3,0,0,0,0,0,0,0,0,0,0
219806,30000,300,0,-2,2,1,1,0,0,0,0,0,0,0,0,0,0,0,0,0,0,0,2,1,1,0,0,0,0,0,0,0,0,0
219824,30000,300,0,-2,1,1,0,0,0,0,0,0,0,0,0,0,0,0,0,0,0,0,1,1,0,0,0,0,0,0,0,0,0,0
219833,30000,300,0,-2,1,1,0,0,0,0,0,0,0,0,0,0,0,0,0,0,0,0,1,1,0,0,0,0,0,0,0,0,0,0
219879,30000,300,0,-2,4,2,2,0,0,0,0,0,0,0,0,0,0,0,0,0,0,0,4,2,2,0,0,0,0,0,0,0,0,0
219888,30000,300,0,-2,1,0,1,0,0,0,0,0,0,0,0,0,0,0,0,0,0,0,1,0,1,0,0,0,0,0,0,0,0,0
219903,30000,300,0,-2,7,1,6,0,0,0,0,0,0,4,1,3,0,0,0,0,0,0,3,0,3,0,0,0,0,0,0,0,0,0
219949,30000,300,0,-2,2,1,1,0,0,0,0,0,0,1,1,0,0,0,0,0,0,0,1,0,1,0,0,0,0,0,0,0,0,0
219976,30000,300,0,-2,4,2,2,0,0,0,0,0,0,0,0,0,0,0,0,0,0,0,4,2,2,0,0,0,0,0,0,0,0,0
220057,30000,300,0,-2,1,0,1,0,0,0,0,0,0,0,0,0,0,0,0,0,0,0,1,0,1,0,0,0,0,0,0,0,0,0
220075,30000,300,0,-2,115,36,79,1,1,0,1,1,0,4,1,3,1,1,0,0,0,0,105,32,73,2,0,2,1,0,1,0,0,0
220181,30000,300,0,-2,1,1,0,0,0,0,0,0,0,1,1,0,0,0,0,0,0,0,0,0,0,0,0,0,0,0,0,0,0,0
220206,30000,300,0,-2,1,1,0,0,0,0,0,0,0,0,0,0,0,0,0,0,0,0,1,1,0,0,0,0,0,0,0,0,0,0
220215,30000,300,0,-2,2,1,1,0,0,0,0,0,0,1,0,1,0,0,0,0,0,0,1,1,0,0,0,0,0,0,0,0,0,0
220400,30000,300,0,-2,2,2,0,0,0,0,0,0,0,0,0,0,0,0,0,0,0,0,2,2,0,0,0,0,0,0,0,0,0,0
220473,30000,300,0,-2,1,1,0,0,0,0,0,0,0,0,0,0,0,0,0,0,0,0,1,1,0,0,0,0,0,0,0,0,0,0
220552,30000,300,0,-2,6,4,2,0,0,0,0,0,0,1,1,0,1,0,1,0,0,0,4,3,1,0,0,0,0,0,0,0,0,0
220604,30000,300,0,-2,6,2,4,0,0,0,0,0,0,6,2,4,0,0,0,0,0,0,0,0,0,0,0,0,0,0,0,0,0,0
220613,30000,300,0,-2,3,0,3,0,0,0,1,0,1,0,0,0,0,0,0,0,0,0,2,0,2,0,0,0,0,0,0,0,0,0
220631,30000,300,0,-2,31,17,14,0,0,0,0,0,0,0,0,0,0,0,0,0,0,0,31,17,14,0,0,0,0,0,0,0,0,0
220792,30000,300,0,-2,6,0,6,0,0,0,1,0,1,5,0,5,0,0,0,0,0,0,0,0,0,0,0,0,0,0,0,0,0,0
220862,30000,300,0,-2,5,3,2,0,0,0,0,0,0,2,1,1,0,0,0,0,0,0,3,2,1,0,0,0,0,0,0,0,0,0
220978,30000,300,0,-2,7,2,5,0,0,0,0,0,0,2,1,1,0,0,0,0,0,0,4,0,4,0,0,0,1,1,0,0,0,0
221096,30000,300,0,-2,6,3,3,0,0,0,0,0,0,0,0,0,1,1,0,0,0,0,5,2,3,0,0,0,0,0,0,0,0,0
221148,30000,300,0,-2,14,8,6,0,0,0,0,0,0,1,0,1,0,0,0,0,0,0,13,8,5,0,0,0,0,0,0,0,0,0
221184,30000,300,0,-2,15,6,9,0,0,0,0,0,0,5,1,4,0,0,0,0,0,0,7,3,4,0,0,0,3,2,1,0,0,0
221351,30000,300,0,-2,7,2,5,0,0,0,0,0,0,2,1,1,1,0,1,0,0,0,4,1,3,0,0,0,0,0,0,0,0,0
221485,30000,300,0,-2,4,1,3,0,0,0,0,0,0,2,1,1,1,0,1,0,0,0,1,0,1,0,0,0,0,0,0,0,0,0
221519,30000,300,0,-2,9,4,5,0,0,0,0,0,0,2,0,2,0,0,0,0,0,0,6,3,3,0,0,0,1,1,0,0,0,0
221661,30000,300,0,-2,5,3,2,0,0,0,1,0,1,1,1,0,1,1,0,0,0,0,2,1,1,0,0,0,0,0,0,0,0,0
221670,30000,300,0,-2,1,0,1,0,0,0,0,0,0,0,0,0,0,0,0,0,0,0,1,0,1,0,0,0,0,0,0,0,0,0
221740,30000,300,0,-2,13,6,7,1,0,1,0,0,0,3,1,2,1,1,0,0,0,0,8,4,4,0,0,0,0,0,0,0,0,0
221759,30000,300,0,-2,56,34,22,0,0,0,0,0,0,12,10,2,1,0,1,0,0,0,43,24,19,0,0,0,0,0,0,0,0,0
221768,30000,300,0,-2,3,2,1,0,0,0,0,0,0,0,0,0,0,0,0,0,0,0,3,2,1,0,0,0,0,0,0,0,0,0
221838,30000,300,0,-2,11,6,5,0,0,0,0,0,0,6,3,3,0,0,0,0,0,0,4,2,2,0,0,0,0,0,0,1,1,0
221847,30000,300,0,-2,6,3,3,0,0,0,1,1,0,1,0,1,0,0,0,0,0,0,4,2,2,0,0,0,0,0,0,0,0,0
221892,30000,300,0,-2,7,6,1,0,0,0,0,0,0,2,2,0,0,0,0,0,0,0,5,4,1,0,0,0,0,0,0,0,0,0
221908,30000,300,0,-2,2,0,2,0,0,0,0,0,0,0,0,0,0,0,0,0,0,0,2,0,2,0,0,0,0,0,0,0,0,0
221953,30000,300,0,-2,4,1,3,0,0,0,0,0,0,0,0,0,0,0,0,0,0,0,4,1,3,0,0,0,0,0,0,0,0,0
221971,30000,300,0,-2,4,1,3,0,0,0,0,0,0,0,0,0,0,0,0,0,0,0,4,1,3,0,0,0,0,0,0,0,0,0
221999,30000,300,0,-2,50,21,29,0,0,0,3,0,3,10,4,6,2,1,1,1,0,1,31,16,15,1,0,1,2,0,2,0,0,0
222053,30000,300,0,-2,1,0,1,0,0,0,0,0,0,0,0,0,0,0,0,0,0,0,0,0,0,0,0,0,1,0,1,0,0,0
222178,30000,300,0,-2,5,3,2,0,0,0,0,0,0,2,0,2,0,0,0,0,0,0,3,3,0,0,0,0,0,0,0,0,0,0
222497,30000,300,0,-2,8,3,5,0,0,0,0,0,0,0,0,0,4,1,3,0,0,0,4,2,2,0,0,0,0,0,0,0,0,0
222567,30000,300,0,-2,7,5,2,0,0,0,0,0,0,0,0,0,0,0,0,0,0,0,6,4,2,0,0,0,1,1,0,0,0,0
222576,30000,300,0,-2,2,1,1,0,0,0,0,0,0,1,0,1,0,0,0,0,0,0,1,1,0,0,0,0,0,0,0,0,0,0
222822,30000,300,0,-2,3,0,3,0,0,0,0,0,0,0,0,0,1,0,1,0,0,0,2,0,2,0,0,0,0,0,0,0,0,0
222938,30000,300,0,-2,2,1,1,0,0,0,0,0,0,0,0,0,1,1,0,0,0,0,1,0,1,0,0,0,0,0,0,0,0,0
222983,30000,300,0,-2,3,1,2,0,0,0,0,0,0,1,1,0,0,0,0,0,0,0,2,0,2,0,0,0,0,0,0,0,0,0
222992,30000,300,0,-2,6,4,2,0,0,0,0,0,0,3,3,0,0,0,0,0,0,0,3,1,2,0,0,0,0,0,0,0,0,0
223223,30000,300,0,-2,13,4,9,0,0,0,1,0,1,3,0,3,0,0,0,0,0,0,4,1,3,2,1,1,3,2,1,0,0,0
223232,30000,300,0,-2,64,30,34,0,0,0,0,0,0,5,2,3,4,0,4,0,0,0,48,24,24,5,2,3,2,2,0,0,0,0
223320,30000,300,0,-2,4,1,3,0,0,0,0,0,0,0,0,0,2,0,2,0,0,0,2,1,1,0,0,0,0,0,0,0,0,0
223427,30000,300,0,-2,4,1,3,0,0,0,0,0,0,1,0,1,0,0,0,0,0,0,3,1,2,0,0,0,0,0,0,0,0,0
223463,30000,300,0,-2,4,0,4,0,0,0,0,0,0,2,0,2,1,0,1,0,0,0,1,0,1,0,0,0,0,0,0,0,0,0
223506,30000,300,0,-2,3,2,1,0,0,0,0,0,0,0,0,0,0,0,0,0,0,0,3,2,1,0,0,0,0,0,0,0,0,0
223816,30000,300,0,-2,7,3,4,0,0,0,1,0,1,1,1,0,2,0,2,0,0,0,3,2,1,0,0,0,0,0,0,0,0,0
223898,30000,300,0,-2,1,1,0,0,0,0,0,0,0,0,0,0,0,0,0,0,0,0,1,1,0,0,0,0,0,0,0,0,0,0
224004,30000,300,0,-2,3,1,2,0,0,0,0,0,0,2,0,2,1,1,0,0,0,0,0,0,0,0,0,0,0,0,0,0,0,0
224110,30000,300,0,-2,2,2,0,0,0,0,0,0,0,0,0,0,0,0,0,0,0,0,2,2,0,0,0,0,0,0,0,0,0,0
224147,30000,300,0,-2,20,11,9,0,0,0,0,0,0,2,1,1,7,3,4,1,0,1,10,7,3,0,0,0,0,0,0,0,0,0
224305,30000,300,0,-2,10,4,6,0,0,0,0,0,0,4,2,2,0,0,0,0,0,0,6,2,4,0,0,0,0,0,0,0,0,0
224323,30000,300,0,-2,7,5,2,0,0,0,1,1,0,0,0,0,1,1,0,0,0,0,5,3,2,0,0,0,0,0,0,0,0,0
224350,30000,300,0,-2,4,2,2,0,0,0,0,0,0,1,1,0,2,1,1,0,0,0,1,0,1,0,0,0,0,0,0,0,0,0
224527,30000,300,0,-2,2,1,1,0,0,0,0,0,0,0,0,0,0,0,0,0,0,0,2,1,1,0,0,0,0,0,0,0,0,0
224545,30000,300,0,-2,2,1,1,0,0,0,1,1,0,0,0,0,0,0,0,0,0,0,1,0,1,0,0,0,0,0,0,0,0,0
224554,30000,300,0,-2,10,3,7,0,0,0,2,1,1,3,1,2,1,0,1,0,0,0,4,1,3,0,0,0,0,0,0,0,0,0
224615,30000,300,0,-2,171,72,99,1,1,0,3,0,3,83,29,54,27,15,12,0,0,0,45,21,24,2,1,1,10,5,5,0,0,0
224642,30000,300,0,-2,5,2,3,0,0,0,0,0,0,0,0,0,3,1,2,0,0,0,2,1,1,0,0,0,0,0,0,0,0,0
224891,30000,300,0,-2,1,1,0,0,0,0,0,0,0,0,0,0,0,0,0,0,0,0,1,1,0,0,0,0,0,0,0,0,0,0
224961,30000,300,0,-2,1,0,1,0,0,0,0,0,0,0,0,0,0,0,0,0,0,0,1,0,1,0,0,0,0,0,0,0,0,0
225070,30000,300,0,-2,3,1,2,0,0,0,0,0,0,0,0,0,0,0,0,0,0,0,3,1,2,0,0,0,0,0,0,0,0,0
225201,30000,300,0,-2,3,1,2,0,0,0,0,0,0,0,0,0,1,0,1,0,0,0,2,1,1,0,0,0,0,0,0,0,0,0
225247,30000,300,0,-2,1,0,1,0,0,0,0,0,0,0,0,0,0,0,0,0,0,0,1,0,1,0,0,0,0,0,0,0,0,0
225308,30000,300,0,-2,3,2,1,0,0,0,0,0,0,1,1,0,0,0,0,0,0,0,2,1,1,0,0,0,0,0,0,0,0,0
225371,30000,300,0,-2,3,1,2,0,0,0,0,0,0,0,0,0,0,0,0,0,0,0,3,1,2,0,0,0,0,0,0,0,0,0
225399,30000,300,0,-2,3,2,1,0,0,0,0,0,0,0,0,0,0,0,0,0,0,0,3,2,1,0,0,0,0,0,0,0,0,0
225414,30000,300,0,-2,3,2,1,0,0,0,0,0,0,0,0,0,0,0,0,0,0,0,3,2,1,0,0,0,0,0,0,0,0,0
225423,30000,300,0,-2,10,5,5,0,0,0,1,0,1,3,1,2,2,1,1,0,0,0,4,3,1,0,0,0,0,0,0,0,0,0
225432,30000,300,0,-2,7,5,2,0,0,0,0,0,0,4,3,1,1,1,0,0,0,0,2,1,1,0,0,0,0,0,0,0,0,0
225502,30000,300,0,-2,2,0,2,0,0,0,1,0,1,0,0,0,0,0,0,0,0,0,1,0,1,0,0,0,0,0,0,0,0,0
225511,30000,300,0,-2,77,39,38,0,0,0,6,1,5,19,7,12,14,7,7,1,1,0,31,21,10,2,0,2,3,1,2,1,1,0
225548,30000,300,0,-2,4,1,3,0,0,0,0,0,0,0,0,0,0,0,0,0,0,0,4,1,3,0,0,0,0,0,0,0,0,0
225575,30000,300,0,-2,7,3,4,0,0,0,0,0,0,7,3,4,0,0,0,0,0,0,0,0,0,0,0,0,0,0,0,0,0,0
225627,30000,300,0,-2,26,9,17,0,0,0,1,0,1,3,0,3,12,5,7,0,0,0,9,4,5,0,0,0,1,0,1,0,0,0
225876,30000,300,0,-2,3,3,0,0,0,0,0,0,0,0,0,0,0,0,0,0,0,0,3,3,0,0,0,0,0,0,0,0,0,0
225885,30000,300,0,-2,1,0,1,0,0,0,0,0,0,1,0,1,0,0,0,0,0,0,0,0,0,0,0,0,0,0,0,0,0,0
226019,30000,300,0,-2,4,4,0,0,0,0,0,0,0,0,0,0,1,1,0,0,0,0,3,3,0,0,0,0,0,0,0,0,0,0
226091,30000,300,0,-2,7,3,4,0,0,0,1,0,1,1,1,0,0,0,0,0,0,0,5,2,3,0,0,0,0,0,0,0,0,0
226116,30000,300,0,-2,12,2,10,1,0,1,0,0,0,5,0,5,1,0,1,0,0,0,5,2,3,0,0,0,0,0,0,0,0,0
226134,30000,300,0,-2,2,1,1,0,0,0,0,0,0,0,0,0,2,1,1,0,0,0,0,0,0,0,0,0,0,0,0,0,0,0
226152,30000,300,0,-2,6,3,3,0,0,0,1,0,1,0,0,0,4,2,2,0,0,0,1,1,0,0,0,0,0,0,0,0,0,0
226204,30000,300,0,-2,6,2,4,0,0,0,0,0,0,2,1,1,0,0,0,0,0,0,4,1,3,0,0,0,0,0,0,0,0,0
226231,30000,300,0,-2,1,0,1,0,0,0,0,0,0,0,0,0,0,0,0,0,0,0,1,0,1,0,0,0,0,0,0,0,0,0
226277,30000,300,0,-2,13,4,9,0,0,0,0,0,0,1,0,1,5,3,2,0,0,0,7,1,6,0,0,0,0,0,0,0,0,0
226383,30000,300,0,-2,4,2,2,0,0,0,0,0,0,0,0,0,1,1,0,0,0,0,3,1,2,0,0,0,0,0,0,0,0,0
226408,30000,300,0,-2,1,0,1,0,0,0,0,0,0,0,0,0,1,0,1,0,0,0,0,0,0,0,0,0,0,0,0,0,0,0
226471,30000,300,0,-2,4,1,3,0,0,0,0,0,0,0,0,0,0,0,0,0,0,0,4,1,3,0,0,0,0,0,0,0,0,0
226587,30000,300,0,-2,3,2,1,0,0,0,0,0,0,1,1,0,0,0,0,0,0,0,2,1,1,0,0,0,0,0,0,0,0,0
226806,30000,300,0,-2,5,1,4,0,0,0,0,0,0,0,0,0,2,0,2,0,0,0,3,1,2,0,0,0,0,0,0,0,0,0
226833,30000,300,0,-2,1,0,1,0,0,0,0,0,0,0,0,0,0,0,0,0,0,0,1,0,1,0,0,0,0,0,0,0,0,0
226903,30000,300,0,-2,15,8,7,0,0,0,1,1,0,1,0,1,4,1,3,0,0,0,8,5,3,1,1,0,0,0,0,0,0,0
227146,30000,300,0,-2,1,0,1,0,0,0,0,0,0,1,0,1,0,0,0,0,0,0,0,0,0,0,0,0,0,0,0,0,0,0
227182,30000,300,0,-2,11,3,8,0,0,0,1,1,0,1,0,1,2,0,2,0,0,0,7,2,5,0,0,0,0,0,0,0,0,0
227216,30000,300,0,-2,49,18,31,0,0,0,2,1,1,9,5,4,7,3,4,0,0,0,28,7,21,2,1,1,1,1,0,0,0,0
227225,30000,300,0,-2,1,1,0,0,0,0,0,0,0,0,0,0,0,0,0,0,0,0,1,1,0,0,0,0,0,0,0,0,0,0
227304,30000,300,0,-2,2,0,2,0,0,0,0,0,0,1,0,1,0,0,0,0,0,0,1,0,1,0,0,0,0,0,0,0,0,0
227331,30000,300,0,-2,1,0,1,0,0,0,0,0,0,1,0,1,0,0,0,0,0,0,0,0,0,0,0,0,0,0,0,0,0,0
227368,30000,300,0,-2,20,8,12,0,0,0,0,0,0,4,2,2,6,1,5,0,0,0,9,5,4,1,0,1,0,0,0,0,0,0
227377,30000,300,0,-2,5,3,2,0,0,0,0,0,0,0,0,0,3,2,1,0,0,0,0,0,0,0,0,0,1,0,1,1,1,0
227526,30000,300,0,-2,8,4,4,0,0,0,0,0,0,7,3,4,0,0,0,0,0,0,1,1,0,0,0,0,0,0,0,0,0,0
227687,30000,300,0,-2,3,2,1,0,0,0,1,1,0,0,0,0,0,0,0,0,0,0,2,1,1,0,0,0,0,0,0,0,0,0
227757,30000,300,0,-2,8,4,4,0,0,0,0,0,0,0,0,0,1,0,1,0,0,0,6,4,2,0,0,0,1,0,1,0,0,0
227845,30000,300,0,-2,22,6,16,0,0,0,1,0,1,2,0,2,6,1,5,0,0,0,11,4,7,1,0,1,1,1,0,0,0,0
227863,30000,300,0,-2,3,1,2,0,0,0,0,0,0,1,0,1,1,1,0,0,0,0,1,0,1,0,0,0,0,0,0,0,0,0
227881,30000,300,0,-2,18,14,4,0,0,0,1,1,0,2,1,1,1,1,0,0,0,0,14,11,3,0,0,0,0,0,0,0,0,0
227924,30000,300,0,-2,1,1,0,0,0,0,0,0,0,0,0,0,1,1,0,0,0,0,0,0,0,0,0,0,0,0,0,0,0,0
227979,30000,300,0,-2,14,2,12,0,0,0,1,0,1,4,0,4,4,1,3,0,0,0,4,0,4,1,1,0,0,0,0,0,0,0
228042,30000,300,0,-2,1,0,1,0,0,0,0,0,0,0,0,0,0,0,0,0,0,0,1,0,1,0,0,0,0,0,0,0,0,0
228149,30000,300,0,-2,33,15,18,1,0,1,0,0,0,0,0,0,22,8,14,0,0,0,8,5,3,0,0,0,2,2,0,0,0,0
228158,30000,300,0,-2,2,1,1,0,0,0,0,0,0,0,0,0,1,1,0,0,0,0,1,0,1,0,0,0,0,0,0,0,0,0
228194,30000,300,0,-2,9,1,8,0,0,0,0,0,0,3,1,2,0,0,0,0,0,0,5,0,5,0,0,0,1,0,1,0,0,0
228246,30000,300,0,-2,59,29,30,1,1,0,3,0,3,12,5,7,5,2,3,1,0,1,36,21,15,1,0,1,0,0,0,0,0,0
228316,30000,300,0,-2,2,2,0,0,0,0,0,0,0,0,0,0,1,1,0,0,0,0,1,1,0,0,0,0,0,0,0,0,0,0
228325,30000,300,0,-2,5,5,0,1,1,0,0,0,0,0,0,0,1,1,0,0,0,0,3,3,0,0,0,0,0,0,0,0,0,0
228343,30000,300,0,-2,2,1,1,0,0,0,0,0,0,0,0,0,0,0,0,0,0,0,2,1,1,0,0,0,0,0,0,0,0,0
228431,30000,300,0,-2,9,7,2,0,0,0,0,0,0,2,1,1,0,0,0,0,0,0,7,6,1,0,0,0,0,0,0,0,0,0
228459,30000,300,0,-2,15,6,9,0,0,0,0,0,0,1,0,1,3,0,3,0,0,0,9,6,3,0,0,0,2,0,2,0,0,0
228468,30000,300,0,-2,1,1,0,0,0,0,0,0,0,0,0,0,1,1,0,0,0,0,0,0,0,0,0,0,0,0,0,0,0,0
228501,30000,300,0,-2,7,1,6,0,0,0,0,0,0,0,0,0,0,0,0,0,0,0,7,1,6,0,0,0,0,0,0,0,0,0
228529,30000,300,0,-2,23,13,10,0,0,0,1,0,1,1,0,1,3,3,0,0,0,0,18,10,8,0,0,0,0,0,0,0,0,0
228547,30000,300,0,-2,19,9,10,0,0,0,0,0,0,7,2,5,3,1,2,0,0,0,8,6,2,0,0,0,1,0,1,0,0,0
228608,30000,300,0,-2,1,0,1,0,0,0,0,0,0,0,0,0,0,0,0,0,0,0,1,0,1,0,0,0,0,0,0,0,0,0
228635,30000,300,0,-2,50,24,26,0,0,0,5,3,2,11,3,8,4,2,2,0,0,0,26,14,12,2,1,1,0,0,0,2,1,1
228644,30000,300,0,-2,53,15,38,0,0,0,3,1,2,1,0,1,21,4,17,0,0,0,16,5,11,1,1,0,11,4,7,0,0,0
228653,30000,300,0,-2,12,4,8,0,0,0,2,2,0,2,0,2,3,0,3,0,0,0,5,2,3,0,0,0,0,0,0,0,0,0
228705,30000,300,0,-2,12,7,5,0,0,0,1,1,0,0,0,0,8,5,3,0,0,0,3,1,2,0,0,0,0,0,0,0,0,0
228723,30000,300,0,-2,52,27,25,0,0,0,1,0,1,3,0,3,6,4,2,0,0,0,38,19,19,1,1,0,3,3,0,0,0,0
228732,30000,300,0,-2,3,1,2,0,0,0,0,0,0,2,0,2,0,0,0,0,0,0,1,1,0,0,0,0,0,0,0,0,0,0
228769,30000,300,0,-2,52,26,26,0,0,0,1,0,1,8,2,6,6,4,2,0,0,0,21,13,8,5,2,3,11,5,6,0,0,0
228778,30000,300,0,-2,141,55,86,0,0,0,7,0,7,15,4,11,19,7,12,0,0,0,95,43,52,5,1,4,0,0,0,0,0,0
228787,30000,300,0,-2,18,11,7,0,0,0,2,1,1,4,2,2,2,1,1,0,0,0,8,5,3,0,0,0,2,2,0,0,0,0
228796,30000,300,0,-2,42,20,22,0,0,0,0,0,0,1,1,0,27,11,16,0,0,0,11,7,4,2,1,1,1,0,1,0,0,0
228802,30000,300,0,-2,16,8,8,0,0,0,0,0,0,2,1,1,2,0,2,0,0,0,12,7,5,0,0,0,0,0,0,0,0,0
228875,30000,300,0,-2,22,10,12,0,0,0,1,0,1,4,2,2,6,2,4,0,0,0,9,6,3,1,0,1,1,0,1,0,0,0
228884,30000,300,0,-2,1,0,1,0,0,0,0,0,0,1,0,1,0,0,0,0,0,0,0,0,0,0,0,0,0,0,0,0,0,0
228909,30000,300,0,-2,10,3,7,0,0,0,0,0,0,0,0,0,2,1,1,0,0,0,6,2,4,1,0,1,0,0,0,1,0,1
228981,30000,300,0,-2,12,6,6,0,0,0,0,0,0,3,2,1,5,2,3,0,0,0,4,2,2,0,0,0,0,0,0,0,0,0
229018,30000,300,0,-2,2,1,1,1,1,0,0,0,0,1,0,1,0,0,0,0,0,0,0,0,0,0,0,0,0,0,0,0,0,0
229027,30000,300,0,-2,44,20,24,1,0,1,0,0,0,5,2,3,14,4,10,0,0,0,17,11,6,2,1,1,5,2,3,0,0,0
229063,30000,300,0,-2,16,4,12,0,0,0,1,0,1,10,3,7,1,0,1,0,0,0,4,1,3,0,0,0,0,0,0,0,0,0
229090,30000,300,0,-2,7,4,3,0,0,0,0,0,0,2,1,1,2,1,1,0,0,0,3,2,1,0,0,0,0,0,0,0,0,0
229115,30000,300,0,-2,34,15,19,0,0,0,0,0,0,8,3,5,3,1,2,0,0,0,22,11,11,1,0,1,0,0,0,0,0,0
229160,30000,300,0,-2,6,2,4,0,0,0,0,0,0,0,0,0,1,0,1,0,0,0,5,2,3,0,0,0,0,0,0,0,0,0
229179,30000,300,0,-2,7,2,5,0,0,0,1,0,1,3,1,2,1,0,1,0,0,0,2,1,1,0,0,0,0,0,0,0,0,0
229267,30000,300,0,-2,7,3,4,0,0,0,0,0,0,1,1,0,4,1,3,0,0,0,2,1,1,0,0,0,0,0,0,0,0,0
229300,30000,300,0,-2,70,17,53,0,0,0,5,1,4,23,1,22,16,5,11,0,0,0,21,9,12,2,1,1,3,0,3,0,0,0
229337,30000,300,0,-2,10,5,5,0,0,0,0,0,0,0,0,0,2,1,1,0,0,0,8,4,4,0,0,0,0,0,0,0,0,0
229355,30000,300,0,-2,3,3,0,0,0,0,0,0,0,2,2,0,0,0,0,0,0,0,1,1,0,0,0,0,0,0,0,0,0,0
229504,30000,300,0,-2,1,0,1,0,0,0,0,0,0,1,0,1,0,0,0,0,0,0,0,0,0,0,0,0,0,0,0,0,0,0
229780,30000,300,0,-2,2,1,1,0,0,0,0,0,0,0,0,0,1,0,1,0,0,0,1,1,0,0,0,0,0,0,0,0,0,0
229799,30000,300,0,-2,4,3,1,0,0,0,0,0,0,0,0,0,0,0,0,0,0,0,2,2,0,0,0,0,2,1,1,0,0,0
229814,30000,300,0,-2,6,4,2,0,0,0,0,0,0,1,1,0,0,0,0,0,0,0,5,3,2,0,0,0,0,0,0,0,0,0
229841,30000,300,0,-2,4,3,1,0,0,0,0,0,0,0,0,0,0,0,0,0,0,0,4,3,1,0,0,0,0,0,0,0,0,0
229887,30000,300,0,-2,10,8,2,0,0,0,0,0,0,9,7,2,0,0,0,0,0,0,1,1,0,0,0,0,0,0,0,0,0,0
230038,30000,300,0,-2,3,3,0,0,0,0,0,0,0,0,0,0,1,1,0,0,0,0,2,2,0,0,0,0,0,0,0,0,0,0
230047,30000,300,0,-2,4,3,1,0,0,0,0,0,0,0,0,0,0,0,0,3,2,1,0,0,0,1,1,0,0,0,0,0,0,0
230171,30000,300,0,-2,4,3,1,0,0,0,1,1,0,0,0,0,0,0,0,0,0,0,3,2,1,0,0,0,0,0,0,0,0,0
230366,30000,300,0,-2,2,1,1,0,0,0,0,0,0,0,0,0,0,0,0,0,0,0,2,1,1,0,0,0,0,0,0,0,0,0
230418,30000,300,0,-2,4,1,3,0,0,0,0,0,0,0,0,0,0,0,0,0,0,0,4,1,3,0,0,0,0,0,0,0,0,0
230597,30000,300,0,-2,2,2,0,0,0,0,0,0,0,0,0,0,0,0,0,0,0,0,2,2,0,0,0,0,0,0,0,0,0,0
230603,30000,300,0,-2,3,1,2,0,0,0,0,0,0,1,0,1,0,0,0,0,0,0,2,1,1,0,0,0,0,0,0,0,0,0
230728,30000,300,0,-2,12,6,6,0,0,0,0,0,0,1,1,0,0,0,0,0,0,0,10,5,5,1,0,1,0,0,0,0,0,0
230737,30000,300,0,-2,40,12,28,0,0,0,0,0,0,1,0,1,3,1,2,1,0,1,33,11,22,0,0,0,2,0,2,0,0,0
230746,30000,300,0,-2,7,7,0,0,0,0,0,0,0,0,0,0,1,1,0,0,0,0,6,6,0,0,0,0,0,0,0,0,0,0
230764,30000,300,0,-2,99,40,59,0,0,0,5,3,2,7,2,5,12,4,8,0,0,0,67,27,40,4,2,2,4,2,2,0,0,0
230782,30000,300,0,-2,16,9,7,0,0,0,0,0,0,0,0,0,1,0,1,0,0,0,13,9,4,2,0,2,0,0,0,0,0,0
230807,30000,300,0,-2,10,3,7,0,0,0,1,0,1,0,0,0,3,2,1,0,0,0,5,1,4,0,0,0,1,0,1,0,0,0
230816,30000,300,0,-2,4,2,2,0,0,0,1,0,1,1,1,0,1,1,0,0,0,0,1,0,1,0,0,0,0,0,0,0,0,0
230834,30000,300,0,-2,2,0,2,0,0,0,0,0,0,0,0,0,0,0,0,0,0,0,1,0,1,0,0,0,1,0,1,0,0,0
230852,30000,300,0,-2,12,4,8,0,0,0,0,0,0,0,0,0,0,0,0,0,0,0,9,3,6,1,0,1,2,1,1,0,0,0
230861,30000,300,0,-2,1,0,1,0,0,0,1,0,1,0,0,0,0,0,0,0,0,0,0,0,0,0,0,0,0,0,0,0,0,0
230889,30000,300,0,-2,1,1,0,0,0,0,0,0,0,0,0,0,0,0,0,0,0,0,0,0,0,1,1,0,0,0,0,0,0,0
230913,30000,300,0,-2,8,4,4,0,0,0,0,0,0,0,0,0,0,0,0,0,0,0,6,4,2,0,0,0,2,0,2,0,0,0
230959,30000,300,0,-2,9,2,7,0,0,0,1,0,1,1,0,1,0,0,0,0,0,0,6,2,4,1,0,1,0,0,0,0,0,0
230995,30000,300,0,-2,8,6,2,0,0,0,0,0,0,0,0,0,1,0,1,0,0,0,7,6,1,0,0,0,0,0,0,0,0,0
231059,30000,300,0,-2,5,3,2,0,0,0,0,0,0,1,1,0,0,0,0,0,0,0,3,2,1,0,0,0,1,0,1,0,0,0
231147,30000,300,0,-2,2,2,0,0,0,0,0,0,0,0,0,0,0,0,0,0,0,0,2,2,0,0,0,0,0,0,0,0,0,0
231156,30000,300,0,-2,2,1,1,0,0,0,0,0,0,0,0,0,0,0,0,0,0,0,2,1,1,0,0,0,0,0,0,0,0,0
231165,30000,300,0,-2,7,5,2,0,0,0,0,0,0,0,0,0,0,0,0,0,0,0,6,4,2,0,0,0,1,1,0,0,0,0
231174,30000,300,0,-2,8,6,2,0,0,0,0,0,0,2,1,1,1,1,0,0,0,0,5,4,1,0,0,0,0,0,0,0,0,0
231420,30000,300,0,-2,7,1,6,0,0,0,0,0,0,1,0,1,0,0,0,0,0,0,6,1,5,0,0,0,0,0,0,0,0,0
231536,30000,300,0,-2,6,1,5,0,0,0,0,0,0,1,0,1,0,0,0,0,0,0,4,1,3,0,0,0,1,0,1,0,0,0
231581,30000,300,0,-2,3,3,0,0,0,0,0,0,0,1,1,0,0,0,0,0,0,0,2,2,0,0,0,0,0,0,0,0,0,0
231624,30000,300,0,-2,7,4,3,0,0,0,0,0,0,0,0,0,0,0,0,0,0,0,7,4,3,0,0,0,0,0,0,0,0,0
231651,30000,300,0,-2,2,1,1,0,0,0,0,0,0,1,1,0,0,0,0,0,0,0,1,0,1,0,0,0,0,0,0,0,0,0
231697,30000,300,0,-2,5,2,3,0,0,0,0,0,0,3,0,3,0,0,0,0,0,0,2,2,0,0,0,0,0,0,0,0,0,0
231785,30000,300,0,-2,1,1,0,0,0,0,0,0,0,0,0,0,0,0,0,0,0,0,1,1,0,0,0,0,0,0,0,0,0,0
231873,30000,300,0,-2,2,1,1,0,0,0,0,0,0,0,0,0,0,0,0,0,0,0,2,1,1,0,0,0,0,0,0,0,0,0
231882,30000,300,0,-2,6,6,0,0,0,0,0,0,0,3,3,0,0,0,0,0,0,0,2,2,0,0,0,0,1,1,0,0,0,0
231970,30000,300,0,-2,7,3,4,0,0,0,1,0,1,1,1,0,0,0,0,0,0,0,4,2,2,1,0,1,0,0,0,0,0,0
232016,30000,300,0,-2,2,2,0,0,0,0,0,0,0,1,1,0,0,0,0,0,0,0,1,1,0,0,0,0,0,0,0,0,0,0
232025,30000,300,0,-2,3,1,2,0,0,0,0,0,0,1,0,1,0,0,0,0,0,0,1,0,1,0,0,0,1,1,0,0,0,0
232043,30000,300,0,-2,1,0,1,0,0,0,0,0,0,0,0,0,1,0,1,0,0,0,0,0,0,0,0,0,0,0,0,0,0,0
232052,30000,300,0,-2,4,1,3,0,0,0,0,0,0,2,0,2,0,0,0,0,0,0,2,1,1,0,0,0,0,0,0,0,0,0
232089,30000,300,0,-2,3,1,2,0,0,0,0,0,0,0,0,0,1,1,0,0,0,0,2,0,2,0,0,0,0,0,0,0,0,0
232186,30000,300,0,-2,31,21,10,0,0,0,2,2,0,9,3,6,3,3,0,0,0,0,15,11,4,2,2,0,0,0,0,0,0,0
232195,30000,300,0,-2,11,1,10,0,0,0,0,0,0,2,0,2,0,0,0,0,0,0,9,1,8,0,0,0,0,0,0,0,0,0
232256,30000,300,0,-2,10,6,4,0,0,0,0,0,0,1,1,0,0,0,0,0,0,0,8,5,3,1,0,1,0,0,0,0,0,0
232265,30000,300,0,-2,4,0,4,0,0,0,1,0,1,3,0,3,0,0,0,0,0,0,0,0,0,0,0,0,0,0,0,0,0,0
232308,30000,300,0,-2,8,2,6,0,0,0,1,0,1,1,0,1,0,0,0,0,0,0,6,2,4,0,0,0,0,0,0,0,0,0
232414,30000,300,0,-2,9,2,7,0,0,0,0,0,0,3,1,2,0,0,0,0,0,0,6,1,5,0,0,0,0,0,0,0,0,0
232423,30000,300,0,-2,19,8,11,0,0,0,0,0,0,2,1,1,1,1,0,0,0,0,14,6,8,2,0,2,0,0,0,0,0,0
232450,30000,300,0,-2,4,2,2,0,0,0,0,0,0,2,1,1,0,0,0,0,0,0,2,1,1,0,0,0,0,0,0,0,0,0
232557,30000,300,0,-2,48,24,24,0,0,0,0,0,0,2,1,1,1,0,1,0,0,0,41,21,20,0,0,0,4,2,2,0,0,0
232566,30000,300,0,-2,3,0,3,0,0,0,0,0,0,0,0,0,0,0,0,0,0,0,3,0,3,0,0,0,0,0,0,0,0,0
232575,30000,300,0,-2,10,5,5,0,0,0,0,0,0,2,2,0,0,0,0,0,0,0,8,3,5,0,0,0,0,0,0,0,0,0
232609,30000,300,0,-2,5,4,1,0,0,0,1,1,0,1,0,1,0,0,0,0,0,0,2,2,0,0,0,0,1,1,0,0,0,0
232618,30000,300,0,-2,1,0,1,0,0,0,0,0,0,0,0,0,0,0,0,0,0,0,1,0,1,0,0,0,0,0,0,0,0,0
232672,30000,300,0,-2,2,1,1,0,0,0,0,0,0,1,1,0,0,0,0,0,0,0,1,0,1,0,0,0,0,0,0,0,0,0
232681,30000,300,0,-2,2,1,1,0,0,0,0,0,0,2,1,1,0,0,0,0,0,0,0,0,0,0,0,0,0,0,0,0,0,0
232706,30000,300,0,-2,8,5,3,0,0,0,0,0,0,0,0,0,1,1,0,0,0,0,6,3,3,0,0,0,1,1,0,0,0,0
232788,30000,300,0,-2,8,3,5,0,0,0,0,0,0,0,0,0,0,0,0,0,0,0,8,3,5,0,0,0,0,0,0,0,0,0
232797,30000,300,0,-2,2,0,2,0,0,0,0,0,0,1,0,1,0,0,0,0,0,0,1,0,1,0,0,0,0,0,0,0,0,0
232867,30000,300,0,-2,2,0,2,0,0,0,0,0,0,1,0,1,0,0,0,0,0,0,1,0,1,0,0,0,0,0,0,0,0,0
232885,30000,300,0,-2,1,1,0,0,0,0,0,0,0,0,0,0,0,0,0,0,0,0,1,1,0,0,0,0,0,0,0,0,0,0
232946,30000,300,0,-2,22,6,16,0,0,0,2,1,1,12,3,9,0,0,0,0,0,0,7,2,5,1,0,1,0,0,0,0,0,0
232982,30000,300,0,-2,12,4,8,0,0,0,0,0,0,4,1,3,0,0,0,0,0,0,8,3,5,0,0,0,0,0,0,0,0,0
233019,30000,300,0,-2,6,3,3,0,0,0,0,0,0,2,1,1,0,0,0,0,0,0,4,2,2,0,0,0,0,0,0,0,0,0
233037,30000,300,0,-2,2,1,1,0,0,0,0,0,0,2,1,1,0,0,0,0,0,0,0,0,0,0,0,0,0,0,0,0,0,0
233116,30000,300,0,-2,11,1,10,0,0,0,0,0,0,4,1,3,0,0,0,0,0,0,6,0,6,0,0,0,1,0,1,0,0,0
233277,30000,300,0,-2,17,4,13,0,0,0,0,0,0,1,0,1,1,0,1,1,1,0,13,3,10,1,0,1,0,0,0,0,0,0
233295,30000,300,0,-2,2,1,1,0,0,0,0,0,0,0,0,0,0,0,0,0,0,0,2,1,1,0,0,0,0,0,0,0,0,0
233301,30000,300,0,-2,4,2,2,0,0,0,0,0,0,1,1,0,0,0,0,0,0,0,1,1,0,2,0,2,0,0,0,0,0,0
233310,30000,300,0,-2,10,2,8,0,0,0,0,0,0,3,1,2,0,0,0,0,0,0,7,1,6,0,0,0,0,0,0,0,0,0
233329,30000,300,0,-2,3,2,1,0,0,0,0,0,0,1,1,0,1,0,1,0,0,0,1,1,0,0,0,0,0,0,0,0,0,0
233338,30000,300,0,-2,4,3,1,0,0,0,0,0,0,1,1,0,0,0,0,0,0,0,3,2,1,0,0,0,0,0,0,0,0,0
233374,30000,300,0,-2,9,5,4,0,0,0,0,0,0,1,1,0,0,0,0,0,0,0,8,4,4,0,0,0,0,0,0,0,0,0
233408,30000,300,0,-2,2,0,2,1,0,1,0,0,0,0,0,0,0,0,0,0,0,0,1,0,1,0,0,0,0,0,0,0,0,0
233426,30000,300,0,-2,4,1,3,0,0,0,0,0,0,1,0,1,0,0,0,0,0,0,3,1,2,0,0,0,0,0,0,0,0,0
233541,30000,300,0,-2,6,4,2,0,0,0,0,0,0,2,2,0,0,0,0,0,0,0,4,2,2,0,0,0,0,0,0,0,0,0
233639,30000,300,0,-2,4,0,4,0,0,0,0,0,0,2,0,2,0,0,0,0,0,0,2,0,2,0,0,0,0,0,0,0,0,0
233648,30000,300,0,-2,3,1,2,0,0,0,0,0,0,1,0,1,0,0,0,0,0,0,2,1,1,0,0,0,0,0,0,0,0,0
233718,30000,300,0,-2,3,1,2,0,0,0,0,0,0,0,0,0,0,0,0,0,0,0,3,1,2,0,0,0,0,0,0,0,0,0
233754,30000,300,0,-2,8,2,6,0,0,0,0,0,0,6,1,5,0,0,0,0,0,0,2,1,1,0,0,0,0,0,0,0,0,0
233772,30000,300,0,-2,14,6,8,0,0,0,0,0,0,8,2,6,1,0,1,0,0,0,5,4,1,0,0,0,0,0,0,0,0,0
233842,30000,300,0,-2,1,0,1,0,0,0,0,0,0,0,0,0,0,0,0,0,0,0,1,0,1,0,0,0,0,0,0,0,0,0
233897,30000,300,0,-2,3,0,3,0,0,0,0,0,0,0,0,0,0,0,0,0,0,0,3,0,3,0,0,0,0,0,0,0,0,0
233903,30000,300,0,-2,3,1,2,0,0,0,0,0,0,0,0,0,0,0,0,0,0,0,3,1,2,0,0,0,0,0,0,0,0,0
233921,30000,300,0,-2,13,3,10,0,0,0,1,1,0,1,1,0,0,0,0,0,0,0,11,1,10,0,0,0,0,0,0,0,0,0
233949,30000,300,0,-2,14,4,10,0,0,0,0,0,0,3,1,2,0,0,0,0,0,0,9,3,6,2,0,2,0,0,0,0,0,0
234030,30000,300,0,-2,39,14,25,0,0,0,1,0,1,13,4,9,2,0,2,0,0,0,20,7,13,1,1,0,1,1,0,1,1,0
234076,30000,300,0,-2,99,33,66,0,0,0,3,0,3,15,7,8,2,1,1,0,0,0,64,21,43,7,3,4,5,0,5,3,1,2
234085,30000,300,0,-2,10,5,5,0,0,0,1,0,1,3,2,1,0,0,0,0,0,0,6,3,3,0,0,0,0,0,0,0,0,0
234155,30000,300,0,-2,16,5,11,0,0,0,0,0,0,14,4,10,1,0,1,0,0,0,1,1,0,0,0,0,0,0,0,0,0,0
234164,30000,300,0,-2,1,0,1,0,0,0,0,0,0,1,0,1,0,0,0,0,0,0,0,0,0,0,0,0,0,0,0,0,0,0
234173,30000,300,0,-2,3,1,2,0,0,0,0,0,0,0,0,0,0,0,0,0,0,0,3,1,2,0,0,0,0,0,0,0,0,0
234207,30000,300,0,-2,5,1,4,0,0,0,0,0,0,1,0,1,0,0,0,0,0,0,3,1,2,0,0,0,1,0,1,0,0,0
234377,30000,300,0,-2,10,2,8,0,0,0,0,0,0,1,0,1,0,0,0,0,0,0,9,2,7,0,0,0,0,0,0,0,0,0
234669,30000,300,0,-2,18,7,11,0,0,0,4,2,2,2,0,2,2,0,2,0,0,0,8,4,4,2,1,1,0,0,0,0,0,0
234711,30000,300,0,-2,1,1,0,0,0,0,0,0,0,0,0,0,0,0,0,0,0,0,1,1,0,0,0,0,0,0,0,0,0,0
234827,30000,300,0,-2,12,6,6,0,0,0,1,0,1,1,0,1,1,1,0,0,0,0,9,5,4,0,0,0,0,0,0,0,0,0
234845,30000,300,0,-2,3,0,3,0,0,0,0,0,0,2,0,2,0,0,0,0,0,0,1,0,1,0,0,0,0,0,0,0,0,0
234933,30000,300,0,-2,6,4,2,0,0,0,1,1,0,0,0,0,0,0,0,0,0,0,4,3,1,0,0,0,1,0,1,0,0,0
234951,30000,300,0,-2,5,3,2,0,0,0,0,0,0,2,1,1,0,0,0,0,0,0,3,2,1,0,0,0,0,0,0,0,0,0
234979,30000,300,0,-2,6,3,3,0,0,0,0,0,0,0,0,0,1,1,0,2,1,1,3,1,2,0,0,0,0,0,0,0,0,0
235097,30000,300,0,-2,12,3,9,1,0,1,0,0,0,0,0,0,1,0,1,0,0,0,10,3,7,0,0,0,0,0,0,0,0,0
235103,30000,300,0,-2,7,2,5,0,0,0,3,1,2,0,0,0,0,0,0,0,0,0,3,0,3,0,0,0,1,1,0,0,0,0
235149,30000,300,0,-2,4,0,4,0,0,0,1,0,1,0,0,0,0,0,0,0,0,0,1,0,1,1,0,1,1,0,1,0,0,0
235167,30000,300,0,-2,4,3,1,0,0,0,0,0,0,0,0,0,0,0,0,0,0,0,0,0,0,0,0,0,4,3,1,0,0,0
235237,30000,300,0,-2,6,6,0,0,0,0,1,1,0,0,0,0,1,1,0,0,0,0,1,1,0,0,0,0,3,3,0,0,0,0
235316,30000,300,0,-2,22,7,15,0,0,0,0,0,0,3,3,0,3,0,3,1,1,0,9,1,8,0,0,0,6,2,4,0,0,0
235334,30000,300,0,-2,3,1,2,0,0,0,0,0,0,0,0,0,0,0,0,0,0,0,3,1,2,0,0,0,0,0,0,0,0,0
235343,30000,300,0,-2,19,10,9,0,0,0,2,0,2,5,3,2,3,2,1,0,0,0,7,4,3,1,1,0,1,0,1,0,0,0
235422,30000,300,0,-2,2,0,2,0,0,0,0,0,0,0,0,0,1,0,1,0,0,0,1,0,1,0,0,0,0,0,0,0,0,0
235431,30000,300,0,-2,11,4,7,0,0,0,2,1,1,2,0,2,1,0,1,1,1,0,3,1,2,0,0,0,2,1,1,0,0,0
235547,30000,300,0,-2,2,1,1,0,0,0,0,0,0,1,1,0,0,0,0,0,0,0,0,0,0,1,0,1,0,0,0,0,0,0
235671,30000,300,0,-2,4,3,1,0,0,0,1,1,0,1,1,0,1,0,1,0,0,0,1,1,0,0,0,0,0,0,0,0,0,0
235699,30000,300,0,-2,3,1,2,0,0,0,1,0,1,0,0,0,0,0,0,0,0,0,2,1,1,0,0,0,0,0,0,0,0,0
235750,30000,300,0,-2,2,0,2,0,0,0,0,0,0,0,0,0,0,0,0,0,0,0,2,0,2,0,0,0,0,0,0,0,0,0
236072,30000,300,0,-2,6,4,2,0,0,0,0,0,0,2,1,1,0,0,0,0,0,0,0,0,0,1,0,1,3,3,0,0,0,0
236188,30000,300,0,-2,4,4,0,0,0,0,0,0,0,0,0,0,0,0,0,0,0,0,3,3,0,1,1,0,0,0,0,0,0,0
236230,30000,300,0,-2,4,3,1,0,0,0,0,0,0,1,1,0,0,0,0,0,0,0,3,2,1,0,0,0,0,0,0,0,0,0
236258,30000,300,0,-2,7,2,5,0,0,0,0,0,0,1,0,1,0,0,0,0,0,0,5,1,4,0,0,0,1,1,0,0,0,0
236328,30000,300,0,-2,6,2,4,0,0,0,0,0,0,0,0,0,1,0,1,0,0,0,3,1,2,1,0,1,1,1,0,0,0,0
236382,30000,300,0,-2,7,3,4,0,0,0,1,1,0,0,0,0,0,0,0,0,0,0,4,2,2,2,0,2,0,0,0,0,0,0
236452,30000,300,0,-2,4,3,1,0,0,0,0,0,0,1,1,0,0,0,0,0,0,0,3,2,1,0,0,0,0,0,0,0,0,0
236504,30000,300,0,-2,2,1,1,0,0,0,1,1,0,0,0,0,0,0,0,0,0,0,1,0,1,0,0,0,0,0,0,0,0,0
236513,30000,300,0,-2,4,0,4,0,0,0,2,0,2,2,0,2,0,0,0,0,0,0,0,0,0,0,0,0,0,0,0,0,0,0
236577,30000,300,0,-2,8,3,5,0,0,0,1,0,1,1,0,1,2,2,0,0,0,0,3,1,2,0,0,0,1,0,1,0,0,0
236595,30000,300,0,-2,16,8,8,0,0,0,2,1,1,2,0,2,2,2,0,0,0,0,8,3,5,1,1,0,1,1,0,0,0,0
236610,30000,300,0,-2,8,5,3,0,0,0,1,1,0,1,1,0,0,0,0,0,0,0,4,3,1,1,0,1,1,0,1,0,0,0
236638,30000,300,0,-2,6,4,2,0,0,0,0,0,0,0,0,0,0,0,0,0,0,0,3,2,1,3,2,1,0,0,0,0,0,0
236656,30000,300,0,-2,8,2,6,0,0,0,2,1,1,1,0,1,0,0,0,0,0,0,4,1,3,1,0,1,0,0,0,0,0,0
236692,30000,300,0,-2,9,5,4,0,0,0,2,1,1,0,0,0,1,1,0,0,0,0,4,2,2,1,1,0,1,0,1,0,0,0
236708,30000,300,0,-2,4,1,3,0,0,0,0,0,0,0,0,0,0,0,0,0,0,0,4,1,3,0,0,0,0,0,0,0,0,0
236753,30000,300,0,-2,5,4,1,0,0,0,0,0,0,1,1,0,0,0,0,0,0,0,3,3,0,1,0,1,0,0,0,0,0,0
236887,30000,300,0,-2,5,3,2,0,0,0,0,0,0,0,0,0,0,0,0,0,0,0,5,3,2,0,0,0,0,0,0,0,0,0
236939,30000,300,0,-2,26,15,11,1,0,1,2,1,1,0,0,0,1,1,0,0,0,0,15,8,7,1,0,1,6,5,1,0,0,0
236948,30000,300,0,-2,30,18,12,0,0,0,1,1,0,8,5,3,0,0,0,1,0,1,18,10,8,0,0,0,2,2,0,0,0,0
236975,30000,300,0,-2,4,0,4,1,0,1,0,0,0,0,0,0,1,0,1,0,0,0,2,0,2,0,0,0,0,0,0,0,0,0
237011,30000,300,0,-2,3,1,2,0,0,0,0,0,0,0,0,0,1,0,1,0,0,0,1,0,1,1,1,0,0,0,0,0,0,0
237039,30000,300,0,-2,5,0,5,0,0,0,2,0,2,0,0,0,0,0,0,0,0,0,2,0,2,1,0,1,0,0,0,0,0,0
237057,30000,300,0,-2,6,1,5,0,0,0,1,0,1,1,1,0,0,0,0,0,0,0,4,0,4,0,0,0,0,0,0,0,0,0
237066,30000,300,0,-2,4,2,2,0,0,0,0,0,0,0,0,0,0,0,0,0,0,0,4,2,2,0,0,0,0,0,0,0,0,0
237109,30000,300,0,-2,4,2,2,0,0,0,0,0,0,1,0,1,1,1,0,0,0,0,2,1,1,0,0,0,0,0,0,0,0,0
237118,30000,300,0,-2,2,1,1,0,0,0,0,0,0,0,0,0,0,0,0,0,0,0,2,1,1,0,0,0,0,0,0,0,0,0
237181,30000,300,0,-2,1,1,0,0,0,0,0,0,0,0,0,0,0,0,0,0,0,0,1,1,0,0,0,0,0,0,0,0,0,0
237312,30000,300,0,-2,5,1,4,0,0,0,0,0,0,0,0,0,0,0,0,0,0,0,4,1,3,0,0,0,1,0,1,0,0,0
237330,30000,300,0,-2,3,2,1,0,0,0,0,0,0,0,0,0,0,0,0,0,0,0,3,2,1,0,0,0,0,0,0,0,0,0
237367,30000,300,0,-2,4,2,2,0,0,0,0,0,0,0,0,0,0,0,0,0,0,0,4,2,2,0,0,0,0,0,0,0,0,0
237525,30000,300,0,-2,7,7,0,0,0,0,0,0,0,3,3,0,0,0,0,0,0,0,4,4,0,0,0,0,0,0,0,0,0,0
237686,30000,300,0,-2,1,0,1,0,0,0,0,0,0,0,0,0,0,0,0,0,0,0,1,0,1,0,0,0,0,0,0,0,0,0
237701,30000,300,0,-2,1,0,1,0,0,0,0,0,0,0,0,0,0,0,0,0,0,0,1,0,1,0,0,0,0,0,0,0,0,0
237783,30000,300,0,-2,2,1,1,0,0,0,0,0,0,1,0,1,0,0,0,0,0,0,1,1,0,0,0,0,0,0,0,0,0,0
237792,30000,300,0,-2,7,3,4,0,0,0,0,0,0,0,0,0,0,0,0,0,0,0,7,3,4,0,0,0,0,0,0,0,0,0
237817,30000,300,0,-2,7,4,3,0,0,0,0,0,0,0,0,0,0,0,0,0,0,0,7,4,3,0,0,0,0,0,0,0,0,0
237880,30000,300,0,-2,2,2,0,0,0,0,0,0,0,0,0,0,0,0,0,0,0,0,2,2,0,0,0,0,0,0,0,0,0,0
237899,30000,300,0,-2,10,7,3,0,0,0,1,1,0,6,3,3,0,0,0,0,0,0,3,3,0,0,0,0,0,0,0,0,0,0
237932,30000,300,0,-2,2,1,1,0,0,0,0,0,0,1,1,0,0,0,0,0,0,0,1,0,1,0,0,0,0,0,0,0,0,0
237950,30000,300,0,-2,3,1,2,0,0,0,0,0,0,0,0,0,0,0,0,0,0,0,3,1,2,0,0,0,0,0,0,0,0,0
237969,30000,300,0,-2,3,2,1,0,0,0,0,0,0,0,0,0,0,0,0,0,0,0,3,2,1,0,0,0,0,0,0,0,0,0
237996,30000,300,0,-2,1,0,1,0,0,0,0,0,0,0,0,0,0,0,0,0,0,0,1,0,1,0,0,0,0,0,0,0,0,0
238014,30000,300,0,-2,3,1,2,0,0,0,0,0,0,0,0,0,0,0,0,0,0,0,3,1,2,0,0,0,0,0,0,0,0,0
238032,30000,300,0,-2,72,28,44,0,0,0,3,0,3,6,3,3,1,1,0,0,0,0,55,22,33,0,0,0,6,1,5,1,1,0
238193,30000,300,0,-2,9,2,7,0,0,0,0,0,0,2,1,1,3,1,2,0,0,0,4,0,4,0,0,0,0,0,0,0,0,0
238263,30000,300,0,-2,5,2,3,0,0,0,1,1,0,1,0,1,0,0,0,0,0,0,3,1,2,0,0,0,0,0,0,0,0,0
238324,30000,300,0,-2,1,1,0,0,0,0,0,0,0,0,0,0,0,0,0,0,0,0,1,1,0,0,0,0,0,0,0,0,0,0
238333,30000,300,0,-2,9,4,5,0,0,0,0,0,0,1,0,1,0,0,0,0,0,0,8,4,4,0,0,0,0,0,0,0,0,0
238397,30000,300,0,-2,3,0,3,0,0,0,0,0,0,0,0,0,0,0,0,0,0,0,3,0,3,0,0,0,0,0,0,0,0,0
238430,30000,300,0,-2,1,1,0,0,0,0,0,0,0,0,0,0,0,0,0,0,0,0,1,1,0,0,0,0,0,0,0,0,0,0
238458,30000,300,0,-2,12,10,2,0,0,0,0,0,0,2,1,1,0,0,0,0,0,0,9,8,1,0,0,0,1,1,0,0,0,0
238476,30000,300,0,-2,3,1,2,0,0,0,0,0,0,2,1,1,0,0,0,0,0,0,1,0,1,0,0,0,0,0,0,0,0,0
238616,30000,300,0,-2,6,5,1,0,0,0,0,0,0,0,0,0,0,0,0,0,0,0,6,5,1,0,0,0,0,0,0,0,0,0
238661,30000,300,0,-2,3,1,2,0,0,0,0,0,0,0,0,0,2,1,1,0,0,0,1,0,1,0,0,0,0,0,0,0,0,0
238722,30000,300,0,-2,7,4,3,0,0,0,0,0,0,1,1,0,1,1,0,0,0,0,5,2,3,0,0,0,0,0,0,0,0,0
238759,30000,300,0,-2,2,1,1,0,0,0,0,0,0,0,0,0,0,0,0,0,0,0,2,1,1,0,0,0,0,0,0,0,0,0
239008,30000,300,0,-2,7,4,3,0,0,0,1,1,0,0,0,0,1,1,0,0,0,0,5,2,3,0,0,0,0,0,0,0,0,0
239017,30000,300,0,-2,4,1,3,0,0,0,0,0,0,0,0,0,1,0,1,0,0,0,3,1,2,0,0,0,0,0,0,0,0,0
239071,30000,300,0,-2,1,1,0,0,0,0,0,0,0,0,0,0,0,0,0,0,0,0,1,1,0,0,0,0,0,0,0,0,0,0
239080,30000,300,0,-2,5,2,3,0,0,0,0,0,0,0,0,0,0,0,0,0,0,0,4,2,2,0,0,0,1,0,1,0,0,0
239105,30000,300,0,-2,2,1,1,0,0,0,0,0,0,1,0,1,0,0,0,0,0,0,1,1,0,0,0,0,0,0,0,0,0,0
239169,30000,300,0,-2,20,8,12,0,0,0,2,2,0,3,3,0,2,2,0,0,0,0,11,1,10,2,0,2,0,0,0,0,0,0
239220,30000,300,0,-2,3,2,1,0,0,0,0,0,0,0,0,0,0,0,0,0,0,0,3,2,1,0,0,0,0,0,0,0,0,0
239248,30000,300,0,-2,5,1,4,0,0,0,0,0,0,1,0,1,2,0,2,0,0,0,2,1,1,0,0,0,0,0,0,0,0,0
239309,30000,300,0,-2,3,1,2,0,0,0,0,0,0,0,0,0,0,0,0,0,0,0,3,1,2,0,0,0,0,0,0,0,0,0
239390,30000,300,0,-2,7,1,6,0,0,0,0,0,0,1,0,1,0,0,0,0,0,0,5,1,4,0,0,0,1,0,1,0,0,0
239424,30000,300,0,-2,2,1,1,0,0,0,0,0,0,0,0,0,0,0,0,0,0,0,2,1,1,0,0,0,0,0,0,0,0,0
239460,30000,300,0,-2,1,1,0,0,0,0,0,0,0,0,0,0,0,0,0,0,0,0,1,1,0,0,0,0,0,0,0,0,0,0
239488,30000,300,0,-2,2,1,1,0,0,0,0,0,0,0,0,0,1,0,1,0,0,0,1,1,0,0,0,0,0,0,0,0,0,0
239628,30000,300,0,-2,5,3,2,0,0,0,0,0,0,0,0,0,0,0,0,0,0,0,5,3,2,0,0,0,0,0,0,0,0,0
239637,30000,300,0,-2,1,1,0,0,0,0,0,0,0,0,0,0,0,0,0,0,0,0,1,1,0,0,0,0,0,0,0,0,0,0
239716,30000,300,0,-2,10,7,3,0,0,0,0,0,0,2,2,0,0,0,0,0,0,0,8,5,3,0,0,0,0,0,0,0,0,0
240107,30000,300,0,-2,8,3,5,0,0,0,0,0,0,1,0,1,1,0,1,0,0,0,4,2,2,1,0,1,1,1,0,0,0,0
240116,30000,300,0,-2,5,1,4,0,0,0,0,0,0,0,0,0,1,0,1,0,0,0,4,1,3,0,0,0,0,0,0,0,0,0
240125,30000,300,0,-2,9,5,4,0,0,0,1,1,0,0,0,0,0,0,0,0,0,0,8,4,4,0,0,0,0,0,0,0,0,0
240189,30000,300,0,-2,3,2,1,0,0,0,0,0,0,1,0,1,0,0,0,0,0,0,2,2,0,0,0,0,0,0,0,0,0,0
240198,30000,300,0,-2,4,0,4,0,0,0,0,0,0,0,0,0,0,0,0,0,0,0,4,0,4,0,0,0,0,0,0,0,0,0
240268,30000,300,0,-2,2,1,1,0,0,0,0,0,0,0,0,0,1,0,1,0,0,0,1,1,0,0,0,0,0,0,0,0,0,0
240277,30000,300,0,-2,7,4,3,0,0,0,0,0,0,0,0,0,0,0,0,0,0,0,7,4,3,0,0,0,0,0,0,0,0,0
240329,30000,300,0,-2,4,2,2,1,0,1,0,0,0,0,0,0,0,0,0,0,0,0,1,1,0,1,0,1,1,1,0,0,0,0
240338,30000,300,0,-2,1,0,1,0,0,0,0,0,0,0,0,0,0,0,0,0,0,0,1,0,1,0,0,0,0,0,0,0,0,0
240365,30000,300,0,-2,4,2,2,0,0,0,1,0,1,0,0,0,0,0,0,0,0,0,3,2,1,0,0,0,0,0,0,0,0,0
240374,30000,300,0,-2,8,5,3,0,0,0,1,1,0,1,1,0,0,0,0,0,0,0,6,3,3,0,0,0,0,0,0,0,0,0
240392,30000,300,0,-2,2,1,1,0,0,0,0,0,0,1,0,1,0,0,0,0,0,0,1,1,0,0,0,0,0,0,0,0,0,0
240417,30000,300,0,-2,6,3,3,0,0,0,1,0,1,0,0,0,0,0,0,0,0,0,5,3,2,0,0,0,0,0,0,0,0,0
240426,30000,300,0,-2,3,2,1,0,0,0,0,0,0,0,0,0,0,0,0,0,0,0,3,2,1,0,0,0,0,0,0,0,0,0
240435,30000,300,0,-2,96,42,54,1,0,1,3,0,3,3,1,2,2,1,1,0,0,0,73,33,40,4,3,1,9,4,5,1,0,1
240444,30000,300,0,-2,29,13,16,0,0,0,4,0,4,2,2,0,1,1,0,0,0,0,21,10,11,0,0,0,1,0,1,0,0,0
240453,30000,300,0,-2,7,4,3,0,0,0,0,0,0,1,1,0,1,1,0,0,0,0,5,2,3,0,0,0,0,0,0,0,0,0
240462,30000,300,0,-2,3,1,2,0,0,0,0,0,0,0,0,0,0,0,0,0,0,0,2,1,1,1,0,1,0,0,0,0,0,0
240471,30000,300,0,-2,7,3,4,0,0,0,1,0,1,0,0,0,0,0,0,0,0,0,5,2,3,0,0,0,1,1,0,0,0,0
240480,30000,300,0,-2,1,1,0,0,0,0,0,0,0,1,1,0,0,0,0,0,0,0,0,0,0,0,0,0,0,0,0,0,0,0
240505,30000,300,0,-2,2,2,0,0,0,0,0,0,0,0,0,0,0,0,0,0,0,0,2,2,0,0,0,0,0,0,0,0,0,0
240514,30000,300,0,-2,1,0,1,0,0,0,0,0,0,0,0,0,0,0,0,0,0,0,1,0,1,0,0,0,0,0,0,0,0,0
240620,30000,300,0,-2,5,2,3,0,0,0,0,0,0,0,0,0,1,0,1,0,0,0,4,2,2,0,0,0,0,0,0,0,0,0
240666,30000,300,0,-2,2,1,1,0,0,0,0,0,0,0,0,0,0,0,0,0,0,0,2,1,1,0,0,0,0,0,0,0,0,0
240693,30000,300,0,-2,1,0,1,0,0,0,0,0,0,0,0,0,0,0,0,0,0,0,0,0,0,1,0,1,0,0,0,0,0,0
240718,30000,300,0,-2,1,0,1,0,0,0,0,0,0,0,0,0,0,0,0,0,0,0,1,0,1,0,0,0,0,0,0,0,0,0
240727,30000,300,0,-2,7,5,2,0,0,0,1,1,0,1,0,1,0,0,0,0,0,0,3,2,1,0,0,0,2,2,0,0,0,0
240745,30000,300,0,-2,8,4,4,0,0,0,2,0,2,0,0,0,0,0,0,5,3,2,1,1,0,0,0,0,0,0,0,0,0,0
240754,30000,300,0,-2,2,0,2,0,0,0,2,0,2,0,0,0,0,0,0,0,0,0,0,0,0,0,0,0,0,0,0,0,0,0
240790,30000,300,0,-2,10,5,5,0,0,0,1,0,1,0,0,0,1,0,1,6,4,2,1,1,0,0,0,0,0,0,0,1,0,1
241100,30000,300,0,-2,1,0,1,0,0,0,0,0,0,0,0,0,1,0,1,0,0,0,0,0,0,0,0,0,0,0,0,0,0,0
241191,30000,300,0,-2,2,2,0,0,0,0,0,0,0,0,0,0,2,2,0,0,0,0,0,0,0,0,0,0,0,0,0,0,0,0
241225,30000,300,0,-2,5,2,3,0,0,0,0,0,0,0,0,0,5,2,3,0,0,0,0,0,0,0,0,0,0,0,0,0,0,0
241304,30000,300,0,-2,5,2,3,0,0,0,0,0,0,0,0,0,5,2,3,0,0,0,0,0,0,0,0,0,0,0,0,0,0,0
241331,30000,300,0,-2,5,1,4,0,0,0,0,0,0,0,0,0,5,1,4,0,0,0,0,0,0,0,0,0,0,0,0,0,0,0
241410,30000,300,0,-2,1,0,1,0,0,0,0,0,0,0,0,0,1,0,1,0,0,0,0,0,0,0,0,0,0,0,0,0,0,0
241739,30000,300,0,-2,2,1,1,0,0,0,0,0,0,0,0,0,2,1,1,0,0,0,0,0,0,0,0,0,0,0,0,0,0,0
241793,30000,300,0,-2,2,1,1,0,0,0,0,0,0,0,0,0,2,1,1,0,0,0,0,0,0,0,0,0,0,0,0,0,0,0
241951,30000,300,0,-2,2,0,2,0,0,0,0,0,0,0,0,0,2,0,2,0,0,0,0,0,0,0,0,0,0,0,0,0,0,0
242060,30000,300,0,-2,3,3,0,0,0,0,0,0,0,0,0,0,3,3,0,0,0,0,0,0,0,0,0,0,0,0,0,0,0,0
242112,30000,300,0,-2,2,0,2,0,0,0,0,0,0,0,0,0,2,0,2,0,0,0,0,0,0,0,0,0,0,0,0,0,0,0
242565,30000,300,0,-2,9,2,7,0,0,0,0,0,0,0,0,0,9,2,7,0,0,0,0,0,0,0,0,0,0,0,0,0,0,0
242617,30000,300,0,-2,1,0,1,0,0,0,0,0,0,0,0,0,1,0,1,0,0,0,0,0,0,0,0,0,0,0,0,0,0,0
242644,30000,300,0,-2,3,1,2,0,0,0,0,0,0,0,0,0,3,1,2,0,0,0,0,0,0,0,0,0,0,0,0,0,0,0
242653,30000,300,0,-2,3,0,3,0,0,0,0,0,0,0,0,0,3,0,3,0,0,0,0,0,0,0,0,0,0,0,0,0,0,0
242671,30000,300,0,-2,4,0,4,0,0,0,0,0,0,0,0,0,4,0,4,0,0,0,0,0,0,0,0,0,0,0,0,0,0,0
242680,30000,300,0,-2,1,0,1,0,0,0,0,0,0,0,0,0,1,0,1,0,0,0,0,0,0,0,0,0,0,0,0,0,0,0
242699,30000,300,0,-2,4,2,2,0,0,0,0,0,0,0,0,0,4,2,2,0,0,0,0,0,0,0,0,0,0,0,0,0,0,0
242723,30000,300,0,-2,3,2,1,0,0,0,0,0,0,0,0,0,3,2,1,0,0,0,0,0,0,0,0,0,0,0,0,0,0,0
242972,30000,300,0,-2,34,16,18,0,0,0,1,1,0,2,2,0,24,10,14,0,0,0,7,3,4,0,0,0,0,0,0,0,0,0
243160,30000,300,0,-2,5,3,2,0,0,0,0,0,0,0,0,0,3,2,1,0,0,0,0,0,0,0,0,0,2,1,1,0,0,0
243197,30000,300,0,-2,1,1,0,0,0,0,0,0,0,0,0,0,0,0,0,0,0,0,0,0,0,0,0,0,1,1,0,0,0,0
243443,30000,300,0,-2,25,8,17,0,0,0,0,0,0,0,0,0,25,8,17,0,0,0,0,0,0,0,0,0,0,0,0,0,0,0
243568,30000,300,0,-2,4,2,2,0,0,0,0,0,0,0,0,0,4,2,2,0,0,0,0,0,0,0,0,0,0,0,0,0,0,0
243577,30000,300,0,-2,1,0,1,0,0,0,0,0,0,0,0,0,1,0,1,0,0,0,0,0,0,0,0,0,0,0,0,0,0,0
243601,30000,300,0,-2,7,3,4,0,0,0,0,0,0,0,0,0,7,3,4,0,0,0,0,0,0,0,0,0,0,0,0,0,0,0
243638,30000,300,0,-2,1,0,1,0,0,0,0,0,0,0,0,0,0,0,0,1,0,1,0,0,0,0,0,0,0,0,0,0,0,0
243744,30000,300,0,-2,83,38,45,0,0,0,10,2,8,5,3,2,7,5,2,0,0,0,26,7,19,2,0,2,31,19,12,2,2,0
243780,30000,300,0,-2,35,23,12,0,0,0,1,1,0,1,1,0,2,1,1,0,0,0,29,18,11,0,0,0,2,2,0,0,0,0
243823,30000,300,0,-2,4,2,2,0,0,0,0,0,0,1,1,0,1,0,1,0,0,0,1,1,0,0,0,0,1,0,1,0,0,0
243832,30000,300,0,-2,2,0,2,0,0,0,0,0,0,0,0,0,2,0,2,0,0,0,0,0,0,0,0,0,0,0,0,0,0,0
244446,30000,300,0,-2,6,2,4,0,0,0,0,0,0,3,1,2,0,0,0,0,0,0,3,1,2,0,0,0,0,0,0,0,0,0
245652,30000,300,0,-2,2,2,0,0,0,0,0,0,0,0,0,0,1,1,0,0,0,0,1,1,0,0,0,0,0,0,0,0,0,0
245953,30000,300,0,-2,4,0,4,0,0,0,0,0,0,1,0,1,0,0,0,0,0,0,3,0,3,0,0,0,0,0,0,0,0,0
246354,30000,300,0,-2,1,0,1,0,0,0,0,0,0,0,0,0,0,0,0,0,0,0,1,0,1,0,0,0,0,0,0,0,0,0
246813,30000,300,0,-2,2,1,1,0,0,0,0,0,0,0,0,0,0,0,0,0,0,0,2,1,1,0,0,0,0,0,0,0,0,0
246974,30000,300,0,-2,7,1,6,0,0,0,1,0,1,1,1,0,2,0,2,0,0,0,1,0,1,2,0,2,0,0,0,0,0,0
247083,30000,300,0,-2,1,0,1,0,0,0,0,0,0,0,0,0,0,0,0,0,0,0,1,0,1,0,0,0,0,0,0,0,0,0
247649,30000,300,0,-2,7,4,3,0,0,0,0,0,0,0,0,0,1,0,1,0,0,0,6,4,2,0,0,0,0,0,0,0,0,0
247834,30000,300,0,-2,6,1,5,1,0,1,0,0,0,0,0,0,0,0,0,0,0,0,5,1,4,0,0,0,0,0,0,0,0,0
248934,30000,300,0,-2,8,4,4,0,0,0,0,0,0,2,1,1,0,0,0,0,0,0,6,3,3,0,0,0,0,0,0,0,0,0
251312,30000,300,0,-2,3,1,2,0,0,0,0,0,0,2,0,2,0,0,0,0,0,0,1,1,0,0,0,0,0,0,0,0,0,0
260372,30000,300,0,-2,1,1,0,1,1,0,0,0,0,0,0,0,0,0,0,0,0,0,0,0,0,0,0,0,0,0,0,0,0,0
260789,30000,300,0,-2,5,1,4,0,0,0,2,0,2,0,0,0,0,0,0,0,0,0,3,1,2,0,0,0,0,0,0,0,0,0
260813,30000,300,0,-2,1,0,1,0,0,0,0,0,0,0,0,0,0,0,0,0,0,0,1,0,1,0,0,0,0,0,0,0,0,0
260992,30000,300,0,-2,1,0,1,0,0,0,0,0,0,0,0,0,0,0,0,0,0,0,1,0,1,0,0,0,0,0,0,0,0,0
262031,30000,300,0,-2,7,4,3,0,0,0,1,0,1,1,1,0,0,0,0,0,0,0,5,3,2,0,0,0,0,0,0,0,0,0
262086,30000,300,0,-2,9,5,4,0,0,0,1,1,0,1,0,1,0,0,0,0,0,0,7,4,3,0,0,0,0,0,0,0,0,0
262129,30000,300,0,-2,4,0,4,0,0,0,0,0,0,2,0,2,0,0,0,0,0,0,2,0,2,0,0,0,0,0,0,0,0,0
262457,30000,300,0,-2,5,0,5,0,0,0,0,0,0,1,0,1,3,0,3,0,0,0,1,0,1,0,0,0,0,0,0,0,0,0
363633,30000,300,0,-2,1,1,0,0,0,0,0,0,0,0,0,0,1,1,0,0,0,0,0,0,0,0,0,0,0,0,0,0,0,0
364016,30000,300,0,-2,3,2,1,0,0,0,0,0,0,0,0,0,0,0,0,0,0,0,3,2,1,0,0,0,0,0,0,0,0,0
364025,30000,300,0,-2,2,1,1,0,0,0,1,1,0,0,0,0,0,0,0,0,0,0,0,0,0,0,0,0,1,0,1,0,0,0
366252,30000,300,0,-2,12,5,7,0,0,0,0,0,0,0,0,0,1,0,1,0,0,0,11,5,6,0,0,0,0,0,0,0,0,0
366340,30000,300,0,-2,1,0,1,1,0,1,0,0,0,0,0,0,0,0,0,0,0,0,0,0,0,0,0,0,0,0,0,0,0,0
366395,30000,300,0,-2,1,1,0,0,0,0,0,0,0,0,0,0,0,0,0,0,0,0,1,1,0,0,0,0,0,0,0,0,0,0
366401,30000,300,0,-2,1,1,0,0,0,0,0,0,0,0,0,0,0,0,0,0,0,0,1,1,0,0,0,0,0,0,0,0,0,0
366553,30000,300,0,-2,3,0,3,0,0,0,0,0,0,1,0,1,0,0,0,0,0,0,2,0,2,0,0,0,0,0,0,0,0,0
366711,30000,300,0,-2,8,3,5,0,0,0,0,0,0,5,3,2,0,0,0,0,0,0,3,0,3,0,0,0,0,0,0,0,0,0
367459,30000,300,0,-2,4,0,4,0,0,0,1,0,1,0,0,0,1,0,1,0,0,0,2,0,2,0,0,0,0,0,0,0,0,0
367884,30000,300,0,-2,9,4,5,0,0,0,0,0,0,1,0,1,2,1,1,0,0,0,5,3,2,0,0,0,1,0,1,0,0,0
367954,30000,300,0,-2,23,10,13,1,0,1,1,1,0,2,2,0,2,1,1,0,0,0,16,5,11,0,0,0,1,1,0,0,0,0
368911,30000,300,0,-2,1,0,1,0,0,0,0,0,0,0,0,0,0,0,0,0,0,0,1,0,1,0,0,0,0,0,0,0,0,0
369400,30000,300,0,-2,1,1,0,0,0,0,0,0,0,0,0,0,1,1,0,0,0,0,0,0,0,0,0,0,0,0,0,0,0,0
376695,30000,300,0,-2,1,0,1,0,0,0,0,0,0,1,0,1,0,0,0,0,0,0,0,0,0,0,0,0,0,0,0,0,0,0
377111,30000,300,0,-2,1,1,0,0,0,0,0,0,0,0,0,0,1,1,0,0,0,0,0,0,0,0,0,0,0,0,0,0,0,0
377449,30000,300,0,-2,1,1,0,0,0,0,0,0,0,1,1,0,0,0,0,0,0,0,0,0,0,0,0,0,0,0,0,0,0,0
377458,30000,300,0,-2,5,2,3,0,0,0,0,0,0,2,0,2,0,0,0,0,0,0,3,2,1,0,0,0,0,0,0,0,0,0
377555,30000,300,0,-2,2,0,2,0,0,0,0,0,0,0,0,0,0,0,0,0,0,0,1,0,1,0,0,0,1,0,1,0,0,0
377564,30000,300,0,-2,2,1,1,0,0,0,0,0,0,1,0,1,0,0,0,0,0,0,0,0,0,1,1,0,0,0,0,0,0,0
378105,30000,300,0,-2,2,0,2,0,0,0,0,0,0,1,0,1,1,0,1,0,0,0,0,0,0,0,0,0,0,0,0,0,0,0
378576,30000,300,0,-2,5,4,1,0,0,0,0,0,0,0,0,0,0,0,0,0,0,0,0,0,0,0,0,0,5,4,1,0,0,0
379746,30000,300,0,-2,1,0,1,0,0,0,0,0,0,0,0,0,1,0,1,0,0,0,0,0,0,0,0,0,0,0,0,0,0,0
380368,30000,300,0,-2,1,0,1,1,0,1,0,0,0,0,0,0,0,0,0,0,0,0,0,0,0,0,0,0,0,0,0,0,0,0
380377,30000,300,0,-2,3,1,2,2,1,1,0,0,0,0,0,0,0,0,0,0,0,0,1,0,1,0,0,0,0,0,0,0,0,0
380438,30000,300,0,-2,2,0,2,0,0,0,0,0,0,0,0,0,0,0,0,0,0,0,2,0,2,0,0,0,0,0,0,0,0,0
382957,30000,300,0,-2,2,2,0,0,0,0,0,0,0,0,0,0,0,0,0,0,0,0,1,1,0,1,1,0,0,0,0,0,0,0
384254,30000,300,0,-2,7,2,5,0,0,0,0,0,0,2,0,2,0,0,0,0,0,0,5,2,3,0,0,0,0,0,0,0,0,0
384342,30000,300,0,-2,6,2,4,0,0,0,0,0,0,1,0,1,0,0,0,0,0,0,4,2,2,0,0,0,1,0,1,0,0,0
385415,30000,300,0,-2,6,4,2,0,0,0,1,1,0,1,0,1,0,0,0,0,0,0,4,3,1,0,0,0,0,0,0,0,0,0
385619,30000,300,0,-2,14,9,5,0,0,0,1,1,0,5,2,3,2,1,1,0,0,0,6,5,1,0,0,0,0,0,0,0,0,0
386472,30000,300,0,-2,1,0,1,0,0,0,0,0,0,0,0,0,0,0,0,0,0,0,1,0,1,0,0,0,0,0,0,0,0,0
388520,30000,300,0,-2,3,1,2,0,0,0,0,0,0,1,0,1,0,0,0,0,0,0,1,1,0,1,0,1,0,0,0,0,0,0
392257,30000,300,0,-2,1,0,1,0,0,0,0,0,0,1,0,1,0,0,0,0,0,0,0,0,0,0,0,0,0,0,0,0,0,0
399212,30000,300,0,-2,1,0,1,0,0,0,0,0,0,0,0,0,0,0,0,0,0,0,1,0,1,0,0,0,0,0,0,0,0,0
399869,30000,300,0,-2,1,0,1,0,0,0,0,0,0,0,0,0,0,0,0,0,0,0,1,0,1,0,0,0,0,0,0,0,0,0
403469,30000,300,0,-2,1,0,1,0,0,0,0,0,0,0,0,0,0,0,0,0,0,0,1,0,1,0,0,0,0,0,0,0,0,0
403478,30000,300,0,-2,1,1,0,0,0,0,0,0,0,0,0,0,0,0,0,0,0,0,1,1,0,0,0,0,0,0,0,0,0,0
404055,30000,300,0,-2,3,1,2,0,0,0,0,0,0,0,0,0,1,0,1,0,0,0,2,1,1,0,0,0,0,0,0,0,0,0
404426,30000,300,0,-2,2,0,2,0,0,0,0,0,0,0,0,0,0,0,0,0,0,0,2,0,2,0,0,0,0,0,0,0,0,0
405872,30000,300,0,-2,1,1,0,0,0,0,0,0,0,1,1,0,0,0,0,0,0,0,0,0,0,0,0,0,0,0,0,0,0,0
406033,30000,300,0,-2,3,0,3,0,0,0,0,0,0,2,0,2,0,0,0,0,0,0,1,0,1,0,0,0,0,0,0,0,0,0
408844,30000,300,0,-2,9,8,1,0,0,0,1,1,0,1,1,0,7,6,1,0,0,0,0,0,0,0,0,0,0,0,0,0,0,0
409254,30000,300,0,-2,2,0,2,0,0,0,0,0,0,0,0,0,2,0,2,0,0,0,0,0,0,0,0,0,0,0,0,0,0,0
409315,30000,300,0,-2,22,9,13,0,0,0,0,0,0,0,0,0,18,8,10,0,0,0,2,0,2,0,0,0,0,0,0,2,1,1
409379,30000,300,0,-2,4,3,1,0,0,0,0,0,0,1,0,1,0,0,0,0,0,0,3,3,0,0,0,0,0,0,0,0,0,0
409698,30000,300,0,-2,7,4,3,0,0,0,0,0,0,0,0,0,0,0,0,0,0,0,4,2,2,0,0,0,3,2,1,0,0,0
412599,30000,300,0,-2,4,1,3,0,0,0,0,0,0,3,0,3,0,0,0,0,0,0,1,1,0,0,0,0,0,0,0,0,0,0
413413,30000,300,0,-2,2,1,1,0,0,0,0,0,0,1,0,1,0,0,0,0,0,0,1,1,0,0,0,0,0,0,0,0,0,0
413617,30000,300,0,-2,2,0,2,2,0,2,0,0,0,0,0,0,0,0,0,0,0,0,0,0,0,0,0,0,0,0,0,0,0,0
414911,30000,300,0,-2,2,0,2,0,0,0,0,0,0,0,0,0,0,0,0,0,0,0,2,0,2,0,0,0,0,0,0,0,0,0
418533,30000,300,0,-2,1,0,1,0,0,0,0,0,0,0,0,0,0,0,0,0,0,0,1,0,1,0,0,0,0,0,0,0,0,0
420024,30000,300,0,-2,6,0,6,0,0,0,0,0,0,3,0,3,0,0,0,0,0,0,2,0,2,1,0,1,0,0,0,0,0,0
420246,30000,300,0,-2,4,1,3,0,0,0,1,0,1,0,0,0,1,1,0,0,0,0,2,0,2,0,0,0,0,0,0,0,0,0
420440,30000,300,0,-2,2,1,1,0,0,0,0,0,0,0,0,0,0,0,0,0,0,0,2,1,1,0,0,0,0,0,0,0,0,0
420538,30000,300,0,-2,1,1,0,0,0,0,0,0,0,0,0,0,0,0,0,0,0,0,1,1,0,0,0,0,0,0,0,0,0,0
420556,30000,300,0,-2,5,2,3,0,0,0,0,0,0,0,0,0,1,1,0,0,0,0,4,1,3,0,0,0,0,0,0,0,0,0
421708,30000,300,0,-2,6,2,4,0,0,0,0,0,0,2,0,2,0,0,0,0,0,0,3,2,1,0,0,0,1,0,1,0,0,0
422020,30000,300,0,-2,1,1,0,0,0,0,0,0,0,0,0,0,0,0,0,0,0,0,1,1,0,0,0,0,0,0,0,0,0,0
422695,30000,300,0,-2,3,1,2,0,0,0,1,0,1,0,0,0,1,0,1,0,0,0,1,1,0,0,0,0,0,0,0,0,0,0
423643,30000,300,0,-2,7,3,4,0,0,0,0,0,0,1,1,0,1,0,1,0,0,0,5,2,3,0,0,0,0,0,0,0,0,0
423652,30000,300,0,-2,2,1,1,0,0,0,0,0,0,0,0,0,1,1,0,0,0,0,1,0,1,0,0,0,0,0,0,0,0,0
426314,30000,300,0,-2,16,7,9,0,0,0,0,0,0,2,2,0,2,1,1,0,0,0,11,3,8,1,1,0,0,0,0,0,0,0
427982,30000,300,0,-2,3,3,0,0,0,0,0,0,0,1,1,0,0,0,0,0,0,0,2,2,0,0,0,0,0,0,0,0,0,0
428170,30000,300,0,-2,3,2,1,0,0,0,0,0,0,0,0,0,2,1,1,0,0,0,1,1,0,0,0,0,0,0,0,0,0,0
428392,30000,300,0,-2,2,0,2,0,0,0,0,0,0,0,0,0,1,0,1,0,0,0,1,0,1,0,0,0,0,0,0,0,0,0
428453,30000,300,0,-2,1,0,1,0,0,0,0,0,0,0,0,0,0,0,0,0,0,0,1,0,1,0,0,0,0,0,0,0,0,0
429094,30000,300,0,-2,1,0,1,0,0,0,0,0,0,0,0,0,0,0,0,0,0,0,1,0,1,0,0,0,0,0,0,0,0,0
429128,30000,300,0,-2,2,1,1,0,0,0,0,0,0,1,1,0,0,0,0,0,0,0,1,0,1,0,0,0,0,0,0,0,0,0
431141,30000,300,0,-2,1,0,1,0,0,0,0,0,0,0,0,0,0,0,0,0,0,0,1,0,1,0,0,0,0,0,0,0,0,0
432144,30000,300,0,-2,4,1,3,0,0,0,0,0,0,0,0,0,0,0,0,0,0,0,3,1,2,1,0,1,0,0,0,0,0,0
432384,30000,300,0,-2,1,1,0,0,0,0,0,0,0,0,0,0,0,0,0,0,0,0,1,1,0,0,0,0,0,0,0,0,0,0
432524,30000,300,0,-2,1,1,0,0,0,0,0,0,0,0,0,0,0,0,0,0,0,0,1,1,0,0,0,0,0,0,0,0,0,0
433174,30000,300,0,-2,1,1,0,0,0,0,0,0,0,1,1,0,0,0,0,0,0,0,0,0,0,0,0,0,0,0,0,0,0,0
433387,30000,300,0,-2,64,38,26,0,0,0,5,3,2,9,5,4,4,4,0,0,0,0,36,21,15,5,2,3,5,3,2,0,0,0
433420,30000,300,0,-2,2,0,2,0,0,0,0,0,0,0,0,0,0,0,0,0,0,0,1,0,1,1,0,1,0,0,0,0,0,0
433660,30000,300,0,-2,29,10,19,0,0,0,1,0,1,5,3,2,2,0,2,0,0,0,21,7,14,0,0,0,0,0,0,0,0,0
434061,30000,300,0,-2,13,5,8,0,0,0,0,0,0,6,2,4,1,0,1,0,0,0,6,3,3,0,0,0,0,0,0,0,0,0
434140,30000,300,0,-2,1,0,1,0,0,0,0,0,0,0,0,0,0,0,0,0,0,0,0,0,0,1,0,1,0,0,0,0,0,0
434159,30000,300,0,-2,5,2,3,0,0,0,0,0,0,4,1,3,1,1,0,0,0,0,0,0,0,0,0,0,0,0,0,0,0,0
434584,30000,300,0,-2,6,3,3,2,1,1,1,1,0,0,0,0,0,0,0,0,0,0,3,1,2,0,0,0,0,0,0,0,0,0
434672,30000,300,0,-2,1,0,1,0,0,0,0,0,0,0,0,0,0,0,0,0,0,0,1,0,1,0,0,0,0,0,0,0,0,0
434821,30000,300,0,-2,2,0,2,0,0,0,0,0,0,2,0,2,0,0,0,0,0,0,0,0,0,0,0,0,0,0,0,0,0,0
435000,30000,300,0,-2,38,13,25,1,0,1,2,2,0,7,2,5,1,1,0,0,0,0,26,8,18,0,0,0,0,0,0,1,0,1
436304,30000,300,0,-2,9,2,7,0,0,0,0,0,0,3,0,3,1,0,1,0,0,0,5,2,3,0,0,0,0,0,0,0,0,0
436429,30000,300,0,-2,1,0,1,0,0,0,0,0,0,0,0,0,0,0,0,0,0,0,1,0,1,0,0,0,0,0,0,0,0,0
437103,30000,300,0,-2,6,2,4,0,0,0,0,0,0,4,1,3,0,0,0,0,0,0,2,1,1,0,0,0,0,0,0,0,0,0
437635,30000,300,0,-2,2,1,1,0,0,0,0,0,0,0,0,0,1,0,1,0,0,0,1,1,0,0,0,0,0,0,0,0,0,0
437936,30000,300,0,-2,9,2,7,0,0,0,1,0,1,1,0,1,4,1,3,1,1,0,2,0,2,0,0,0,0,0,0,0,0,0
438179,30000,300,0,-2,3,0,3,0,0,0,0,0,0,0,0,0,0,0,0,0,0,0,3,0,3,0,0,0,0,0,0,0,0,0
438258,30000,300,0,-2,6,2,4,0,0,0,0,0,0,0,0,0,1,0,1,0,0,0,3,1,2,0,0,0,2,1,1,0,0,0
438504,30000,300,0,-2,2,1,1,0,0,0,0,0,0,1,1,0,0,0,0,0,0,0,1,0,1,0,0,0,0,0,0,0,0,0
438665,30000,300,0,-2,2,1,1,0,0,0,0,0,0,1,0,1,1,1,0,0,0,0,0,0,0,0,0,0,0,0,0,0,0,0
438708,30000,300,0,-2,2,2,0,0,0,0,0,0,0,0,0,0,0,0,0,0,0,0,2,2,0,0,0,0,0,0,0,0,0,0
439118,30000,300,0,-2,5,1,4,0,0,0,0,0,0,0,0,0,1,1,0,1,0,1,3,0,3,0,0,0,0,0,0,0,0,0
439154,30000,300,0,-2,1,0,1,0,0,0,0,0,0,0,0,0,0,0,0,0,0,0,1,0,1,0,0,0,0,0,0,0,0,0
439190,30000,300,0,-2,1,0,1,0,0,0,0,0,0,1,0,1,0,0,0,0,0,0,0,0,0,0,0,0,0,0,0,0,0,0
439367,30000,300,0,-2,4,1,3,0,0,0,0,0,0,0,0,0,0,0,0,0,0,0,4,1,3,0,0,0,0,0,0,0,0,0
439570,30000,300,0,-2,1,0,1,0,0,0,0,0,0,0,0,0,0,0,0,0,0,0,1,0,1,0,0,0,0,0,0,0,0,0
439701,30000,300,0,-2,1,0,1,0,0,0,0,0,0,1,0,1,0,0,0,0,0,0,0,0,0,0,0,0,0,0,0,0,0,0
439792,30000,300,0,-2,1,0,1,0,0,0,0,0,0,0,0,0,0,0,0,0,0,0,1,0,1,0,0,0,0,0,0,0,0,0
440059,30000,300,0,-2,2,1,1,0,0,0,0,0,0,0,0,0,0,0,0,0,0,0,1,1,0,0,0,0,1,0,1,0,0,0
440396,30000,300,0,-2,1,1,0,0,0,0,0,0,0,0,0,0,0,0,0,0,0,0,1,1,0,0,0,0,0,0,0,0,0,0
440402,30000,300,0,-2,1,1,0,0,0,0,0,0,0,1,1,0,0,0,0,0,0,0,0,0,0,0,0,0,0,0,0,0,0,0
440651,30000,300,0,-2,3,0,3,0,0,0,0,0,0,0,0,0,3,0,3,0,0,0,0,0,0,0,0,0,0,0,0,0,0,0
440794,30000,300,0,-2,1,1,0,0,0,0,0,0,0,0,0,0,0,0,0,0,0,0,1,1,0,0,0,0,0,0,0,0,0,0
441025,30000,300,0,-2,1,1,0,0,0,0,0,0,0,0,0,0,1,1,0,0,0,0,0,0,0,0,0,0,0,0,0,0,0,0
441052,30000,300,0,-2,6,2,4,0,0,0,1,1,0,0,0,0,2,1,1,0,0,0,3,0,3,0,0,0,0,0,0,0,0,0
441229,30000,300,0,-2,14,5,9,0,0,0,1,0,1,2,1,1,1,1,0,0,0,0,8,1,7,1,1,0,1,1,0,0,0,0
441371,30000,300,0,-2,11,5,6,0,0,0,2,2,0,1,0,1,0,0,0,0,0,0,7,3,4,1,0,1,0,0,0,0,0,0
441423,30000,300,0,-2,1,1,0,0,0,0,0,0,0,0,0,0,1,1,0,0,0,0,0,0,0,0,0,0,0,0,0,0,0,0
441742,30000,300,0,-2,4,1,3,0,0,0,0,0,0,3,0,3,0,0,0,0,0,0,1,1,0,0,0,0,0,0,0,0,0,0
441760,30000,300,0,-2,11,4,7,0,0,0,1,0,1,1,0,1,2,1,1,0,0,0,5,2,3,0,0,0,2,1,1,0,0,0
441858,30000,300,0,-2,2,0,2,0,0,0,0,0,0,0,0,0,0,0,0,0,0,0,2,0,2,0,0,0,0,0,0,0,0,0
441900,30000,300,0,-2,4,1,3,0,0,0,0,0,0,1,0,1,1,1,0,0,0,0,2,0,2,0,0,0,0,0,0,0,0,0
441937,30000,300,0,-2,2,1,1,0,0,0,0,0,0,1,0,1,1,1,0,0,0,0,0,0,0,0,0,0,0,0,0,0,0,0
442064,30000,300,0,-2,1,1,0,0,0,0,0,0,0,0,0,0,0,0,0,0,0,0,1,1,0,0,0,0,0,0,0,0,0,0
442134,30000,300,0,-2,1,1,0,0,0,0,0,0,0,0,0,0,1,1,0,0,0,0,0,0,0,0,0,0,0,0,0,0,0,0
442295,30000,300,0,-2,2,1,1,0,0,0,0,0,0,0,0,0,0,0,0,0,0,0,2,1,1,0,0,0,0,0,0,0,0,0
442426,30000,300,0,-2,1,0,1,0,0,0,0,0,0,0,0,0,0,0,0,0,0,0,1,0,1,0,0,0,0,0,0,0,0,0
442444,30000,300,0,-2,8,1,7,0,0,0,0,0,0,1,1,0,6,0,6,0,0,0,1,0,1,0,0,0,0,0,0,0,0,0
442569,30000,300,0,-2,4,1,3,0,0,0,0,0,0,2,0,2,0,0,0,0,0,0,2,1,1,0,0,0,0,0,0,0,0,0
442602,30000,300,0,-2,2,1,1,1,0,1,0,0,0,0,0,0,1,1,0,0,0,0,0,0,0,0,0,0,0,0,0,0,0,0
442781,30000,300,0,-2,2,1,1,1,0,1,0,0,0,1,1,0,0,0,0,0,0,0,0,0,0,0,0,0,0,0,0,0,0,0
442806,30000,300,0,-2,1,1,0,0,0,0,0,0,0,0,0,0,0,0,0,0,0,0,1,1,0,0,0,0,0,0,0,0,0,0
442930,30000,300,0,-2,2,0,2,0,0,0,0,0,0,0,0,0,2,0,2,0,0,0,0,0,0,0,0,0,0,0,0,0,0,0
443331,30000,300,0,-2,1,0,1,0,0,0,0,0,0,0,0,0,0,0,0,0,0,0,0,0,0,0,0,0,1,0,1,0,0,0
443368,30000,300,0,-2,1,0,1,0,0,0,0,0,0,0,0,0,0,0,0,0,0,0,1,0,1,0,0,0,0,0,0,0,0,0
443410,30000,300,0,-2,1,0,1,0,0,0,0,0,0,0,0,0,0,0,0,0,0,0,1,0,1,0,0,0,0,0,0,0,0,0
443599,30000,300,0,-2,1,0,1,0,0,0,0,0,0,0,0,0,1,0,1,0,0,0,0,0,0,0,0,0,0,0,0,0,0,0
443711,30000,300,0,-2,8,2,6,0,0,0,0,0,0,5,1,4,0,0,0,0,0,0,3,1,2,0,0,0,0,0,0,0,0,0
443748,30000,300,0,-2,6,2,4,0,0,0,0,0,0,3,1,2,1,1,0,0,0,0,1,0,1,1,0,1,0,0,0,0,0,0
444088,30000,300,0,-2,5,0,5,0,0,0,1,0,1,0,0,0,2,0,2,0,0,0,2,0,2,0,0,0,0,0,0,0,0,0
444130,30000,300,0,-2,3,2,1,0,0,0,0,0,0,1,1,0,0,0,0,0,0,0,2,1,1,0,0,0,0,0,0,0,0,0
444787,30000,300,0,-2,13,4,9,0,0,0,0,0,0,2,0,2,1,0,1,0,0,0,10,4,6,0,0,0,0,0,0,0,0,0
444954,30000,300,0,-2,1,1,0,0,0,0,0,0,0,0,0,0,0,0,0,0,0,0,1,1,0,0,0,0,0,0,0,0,0,0
445188,30000,300,0,-2,13,6,7,0,0,0,1,0,1,3,2,1,1,0,1,0,0,0,7,4,3,0,0,0,1,0,1,0,0,0
445461,30000,300,0,-2,5,1,4,0,0,0,0,0,0,4,1,3,1,0,1,0,0,0,0,0,0,0,0,0,0,0,0,0,0,0
445708,30000,300,0,-2,3,3,0,0,0,0,0,0,0,2,2,0,0,0,0,0,0,0,1,1,0,0,0,0,0,0,0,0,0,0
445735,30000,300,0,-2,6,3,3,0,0,0,1,0,1,0,0,0,0,0,0,0,0,0,5,3,2,0,0,0,0,0,0,0,0,0
445869,30000,300,0,-2,1,0,1,0,0,0,0,0,0,0,0,0,0,0,0,0,0,0,0,0,0,1,0,1,0,0,0,0,0,0
446048,30000,300,0,-2,3,1,2,0,0,0,0,0,0,0,0,0,0,0,0,0,0,0,3,1,2,0,0,0,0,0,0,0,0,0
446118,30000,300,0,-2,1,0,1,0,0,0,0,0,0,0,0,0,1,0,1,0,0,0,0,0,0,0,0,0,0,0,0,0,0,0
446552,30000,300,0,-2,3,2,1,0,0,0,0,0,0,0,0,0,1,1,0,0,0,0,2,1,1,0,0,0,0,0,0,0,0,0
446561,30000,300,0,-2,2,1,1,0,0,0,0,0,0,0,0,0,0,0,0,0,0,0,2,1,1,0,0,0,0,0,0,0,0,0
446640,30000,300,0,-2,2,1,1,0,0,0,0,0,0,1,1,0,0,0,0,0,0,0,0,0,0,0,0,0,1,0,1,0,0,0
447050,30000,300,0,-2,4,2,2,0,0,0,0,0,0,0,0,0,0,0,0,0,0,0,1,1,0,0,0,0,3,1,2,0,0,0
447263,30000,300,0,-2,2,1,1,0,0,0,0,0,0,0,0,0,0,0,0,0,0,0,1,0,1,0,0,0,1,1,0,0,0,0
447351,30000,300,0,-2,4,2,2,0,0,0,0,0,0,0,0,0,1,0,1,0,0,0,3,2,1,0,0,0,0,0,0,0,0,0
447421,30000,300,0,-2,1,0,1,0,0,0,0,0,0,0,0,0,0,0,0,0,0,0,1,0,1,0,0,0,0,0,0,0,0,0
447591,30000,300,0,-2,4,3,1,0,0,0,0,0,0,3,2,1,0,0,0,0,0,0,1,1,0,0,0,0,0,0,0,0,0,0
447689,30000,300,0,-2,11,4,7,0,0,0,0,0,0,7,2,5,0,0,0,0,0,0,3,1,2,1,1,0,0,0,0,0,0,0
447698,30000,300,0,-2,1,0,1,0,0,0,0,0,0,0,0,0,0,0,0,0,0,0,1,0,1,0,0,0,0,0,0,0,0,0
447768,30000,300,0,-2,5,1,4,0,0,0,1,1,0,1,0,1,2,0,2,0,0,0,1,0,1,0,0,0,0,0,0,0,0,0
447953,30000,300,0,-2,3,1,2,0,0,0,0,0,0,0,0,0,1,0,1,0,0,0,2,1,1,0,0,0,0,0,0,0,0,0
448354,30000,300,0,-2,1,0,1,0,0,0,0,0,0,0,0,0,1,0,1,0,0,0,0,0,0,0,0,0,0,0,0,0,0,0
448381,30000,300,0,-2,4,1,3,0,0,0,0,0,0,2,0,2,1,1,0,0,0,0,0,0,0,0,0,0,1,0,1,0,0,0
448594,30000,300,0,-2,1,0,1,0,0,0,0,0,0,1,0,1,0,0,0,0,0,0,0,0,0,0,0,0,0,0,0,0,0,0
448600,30000,300,0,-2,2,1,1,0,0,0,0,0,0,1,0,1,0,0,0,0,0,0,1,1,0,0,0,0,0,0,0,0,0,0
448637,30000,300,0,-2,1,1,0,0,0,0,0,0,0,0,0,0,1,1,0,0,0,0,0,0,0,0,0,0,0,0,0,0,0,0
448673,30000,300,0,-2,4,2,2,0,0,0,0,0,0,1,0,1,1,0,1,0,0,0,2,2,0,0,0,0,0,0,0,0,0,0
449074,30000,300,0,-2,1,1,0,0,0,0,0,0,0,0,0,0,0,0,0,0,0,0,1,1,0,0,0,0,0,0,0,0,0,0
449250,30000,300,0,-2,3,0,3,0,0,0,0,0,0,0,0,0,3,0,3,0,0,0,0,0,0,0,0,0,0,0,0,0,0,0
449339,30000,300,0,-2,5,5,0,0,0,0,0,0,0,2,2,0,0,0,0,0,0,0,3,3,0,0,0,0,0,0,0,0,0,0
449889,30000,300,0,-2,6,4,2,0,0,0,0,0,0,1,1,0,0,0,0,0,0,0,5,3,2,0,0,0,0,0,0,0,0,0
449898,30000,300,0,-2,1,1,0,0,0,0,0,0,0,0,0,0,0,0,0,0,0,0,1,1,0,0,0,0,0,0,0,0,0,0
450058,30000,300,0,-2,4,1,3,0,0,0,1,1,0,0,0,0,0,0,0,0,0,0,3,0,3,0,0,0,0,0,0,0,0,0
450067,30000,300,0,-2,1,0,1,0,0,0,0,0,0,0,0,0,0,0,0,0,0,0,1,0,1,0,0,0,0,0,0,0,0,0
450128,30000,300,0,-2,2,0,2,0,0,0,0,0,0,0,0,0,0,0,0,0,0,0,2,0,2,0,0,0,0,0,0,0,0,0
450304,30000,300,0,-2,1,1,0,0,0,0,0,0,0,0,0,0,0,0,0,0,0,0,1,1,0,0,0,0,0,0,0,0,0,0
450696,30000,300,0,-2,4,1,3,0,0,0,1,0,1,1,0,1,2,1,1,0,0,0,0,0,0,0,0,0,0,0,0,0,0,0
450702,30000,300,0,-2,3,3,0,0,0,0,0,0,0,1,1,0,2,2,0,0,0,0,0,0,0,0,0,0,0,0,0,0,0,0
450933,30000,300,0,-2,1,0,1,0,0,0,0,0,0,0,0,0,0,0,0,0,0,0,1,0,1,0,0,0,0,0,0,0,0,0
451103,30000,300,0,-2,6,2,4,0,0,0,0,0,0,1,0,1,5,2,3,0,0,0,0,0,0,0,0,0,0,0,0,0,0,0
451477,30000,300,0,-2,2,2,0,0,0,0,0,0,0,0,0,0,1,1,0,0,0,0,1,1,0,0,0,0,0,0,0,0,0,0
451510,30000,300,0,-2,1,1,0,0,0,0,0,0,0,0,0,0,0,0,0,0,0,0,1,1,0,0,0,0,0,0,0,0,0,0
451750,30000,300,0,-2,1,0,1,0,0,0,0,0,0,0,0,0,0,0,0,0,0,0,1,0,1,0,0,0,0,0,0,0,0,0
451866,30000,300,0,-2,1,1,0,0,0,0,0,0,0,1,1,0,0,0,0,0,0,0,0,0,0,0,0,0,0,0,0,0,0,0
452124,30000,300,0,-2,2,0,2,0,0,0,0,0,0,1,0,1,0,0,0,0,0,0,1,0,1,0,0,0,0,0,0,0,0,0
454218,30000,300,0,-2,11,3,8,0,0,0,2,0,2,2,0,2,1,0,1,0,0,0,3,2,1,0,0,0,3,1,2,0,0,0
454810,30000,300,0,-2,5,3,2,0,0,0,0,0,0,1,0,1,0,0,0,0,0,0,3,2,1,0,0,0,1,1,0,0,0,0
454829,30000,300,0,-2,7,1,6,0,0,0,0,0,0,1,0,1,1,1,0,0,0,0,4,0,4,1,0,1,0,0,0,0,0,0
454856,30000,300,0,-2,2,0,2,0,0,0,0,0,0,0,0,0,1,0,1,0,0,0,1,0,1,0,0,0,0,0,0,0,0,0
455114,30000,300,0,-2,2,1,1,0,0,0,0,0,0,0,0,0,0,0,0,0,0,0,2,1,1,0,0,0,0,0,0,0,0,0
455196,30000,300,0,-2,2,0,2,0,0,0,0,0,0,1,0,1,0,0,0,0,0,0,1,0,1,0,0,0,0,0,0,0,0,0
455257,30000,300,0,-2,1,1,0,0,0,0,0,0,0,0,0,0,0,0,0,0,0,0,1,1,0,0,0,0,0,0,0,0,0,0
455406,30000,300,0,-2,5,1,4,0,0,0,1,0,1,0,0,0,1,0,1,0,0,0,3,1,2,0,0,0,0,0,0,0,0,0
455433,30000,300,0,-2,1,0,1,0,0,0,0,0,0,0,0,0,0,0,0,0,0,0,1,0,1,0,0,0,0,0,0,0,0,0
455628,30000,300,0,-2,1,1,0,0,0,0,0,0,0,1,1,0,0,0,0,0,0,0,0,0,0,0,0,0,0,0,0,0,0,0
455664,30000,300,0,-2,4,2,2,0,0,0,0,0,0,0,0,0,1,0,1,0,0,0,3,2,1,0,0,0,0,0,0,0,0,0
455804,30000,300,0,-2,1,1,0,0,0,0,0,0,0,0,0,0,0,0,0,0,0,0,1,1,0,0,0,0,0,0,0,0,0,0
455992,30000,300,0,-2,3,3,0,0,0,0,1,1,0,1,1,0,0,0,0,0,0,0,1,1,0,0,0,0,0,0,0,0,0,0
456205,30000,300,0,-2,2,0,2,0,0,0,0,0,0,1,0,1,1,0,1,0,0,0,0,0,0,0,0,0,0,0,0,0,0,0
456852,30000,300,0,-2,3,1,2,0,0,0,0,0,0,2,0,2,0,0,0,0,0,0,0,0,0,1,1,0,0,0,0,0,0,0
456959,30000,300,0,-2,1,1,0,0,0,0,0,0,0,0,0,0,1,1,0,0,0,0,0,0,0,0,0,0,0,0,0,0,0,0
457101,30000,300,0,-2,7,3,4,0,0,0,0,0,0,1,1,0,3,1,2,0,0,0,2,0,2,1,1,0,0,0,0,0,0,0
457110,30000,300,0,-2,6,2,4,0,0,0,0,0,0,0,0,0,0,0,0,0,0,0,5,1,4,0,0,0,1,1,0,0,0,0
458210,30000,300,0,-2,8,1,7,0,0,0,1,0,1,1,0,1,2,0,2,0,0,0,4,1,3,0,0,0,0,0,0,0,0,0
458229,30000,300,0,-2,3,1,2,0,0,0,0,0,0,0,0,0,1,1,0,0,0,0,2,0,2,0,0,0,0,0,0,0,0,0
458405,30000,300,0,-2,1,1,0,0,0,0,0,0,0,0,0,0,1,1,0,0,0,0,0,0,0,0,0,0,0,0,0,0,0,0
458681,30000,300,0,-2,1,0,1,0,0,0,0,0,0,0,0,0,0,0,0,0,0,0,1,0,1,0,0,0,0,0,0,0,0,0
459204,30000,300,0,-2,4,2,2,0,0,0,2,2,0,0,0,0,1,0,1,0,0,0,1,0,1,0,0,0,0,0,0,0,0,0
459213,30000,300,0,-2,16,5,11,0,0,0,2,2,0,4,0,4,0,0,0,0,0,0,9,2,7,0,0,0,1,1,0,0,0,0
459268,30000,300,0,-2,1,0,1,0,0,0,0,0,0,0,0,0,0,0,0,0,0,0,1,0,1,0,0,0,0,0,0,0,0,0
459736,30000,300,0,-2,4,3,1,0,0,0,0,0,0,0,0,0,0,0,0,0,0,0,4,3,1,0,0,0,0,0,0,0,0,0
459824,30000,300,0,-2,4,1,3,0,0,0,0,0,0,0,0,0,0,0,0,1,0,1,2,1,1,1,0,1,0,0,0,0,0,0
459949,30000,300,0,-2,22,11,11,0,0,0,2,1,1,3,2,1,7,4,3,0,0,0,7,4,3,1,0,1,2,0,2,0,0,0
459958,30000,300,0,-2,1,0,1,0,0,0,0,0,0,1,0,1,0,0,0,0,0,0,0,0,0,0,0,0,0,0,0,0,0,0
460020,30000,300,0,-2,1,1,0,0,0,0,0,0,0,0,0,0,0,0,0,0,0,0,1,1,0,0,0,0,0,0,0,0,0,0
460181,30000,300,0,-2,4,1,3,0,0,0,0,0,0,1,0,1,1,1,0,0,0,0,2,0,2,0,0,0,0,0,0,0,0,0
460190,30000,300,0,-2,1,1,0,0,0,0,0,0,0,0,0,0,0,0,0,0,0,0,1,1,0,0,0,0,0,0,0,0,0,0
460206,30000,300,0,-2,3,0,3,0,0,0,0,0,0,0,0,0,1,0,1,0,0,0,2,0,2,0,0,0,0,0,0,0,0,0
460349,30000,300,0,-2,1,1,0,0,0,0,0,0,0,0,0,0,0,0,0,0,0,0,1,1,0,0,0,0,0,0,0,0,0,0
460394,30000,300,0,-2,7,3,4,0,0,0,0,0,0,2,0,2,3,1,2,0,0,0,2,2,0,0,0,0,0,0,0,0,0,0
460464,30000,300,0,-2,1,1,0,0,0,0,0,0,0,0,0,0,1,1,0,0,0,0,0,0,0,0,0,0,0,0,0,0,0,0
460738,30000,300,0,-2,1,0,1,0,0,0,0,0,0,0,0,0,0,0,0,0,0,0,1,0,1,0,0,0,0,0,0,0,0,0
460756,30000,300,0,-2,2,2,0,0,0,0,0,0,0,0,0,0,0,0,0,0,0,0,1,1,0,1,1,0,0,0,0,0,0,0
460817,30000,300,0,-2,3,1,2,0,0,0,0,0,0,0,0,0,0,0,0,0,0,0,2,0,2,1,1,0,0,0,0,0,0,0
460826,30000,300,0,-2,1,1,0,0,0,0,0,0,0,1,1,0,0,0,0,0,0,0,0,0,0,0,0,0,0,0,0,0,0,0
461148,30000,300,0,-2,5,3,2,0,0,0,1,0,1,3,2,1,1,1,0,0,0,0,0,0,0,0,0,0,0,0,0,0,0,0
461528,30000,300,0,-2,1,0,1,0,0,0,0,0,0,0,0,0,0,0,0,0,0,0,0,0,0,1,0,1,0,0,0,0,0,0
462354,30000,300,0,-2,6,5,1,0,0,0,0,0,0,0,0,0,3,2,1,0,0,0,3,3,0,0,0,0,0,0,0,0,0,0
475033,30000,300,0,-2,1,0,1,0,0,0,0,0,0,0,0,0,1,0,1,0,0,0,0,0,0,0,0,0,0,0,0,0,0,0
475121,30000,300,0,-2,2,0,2,0,0,0,0,0,0,0,0,0,0,0,0,0,0,0,2,0,2,0,0,0,0,0,0,0,0,0
475176,30000,300,0,-2,4,2,2,0,0,0,1,1,0,0,0,0,2,1,1,0,0,0,1,0,1,0,0,0,0,0,0,0,0,0
475565,30000,300,0,-2,5,3,2,0,0,0,0,0,0,2,2,0,2,0,2,0,0,0,1,1,0,0,0,0,0,0,0,0,0,0
476717,30000,300,0,-2,1,1,0,0,0,0,0,0,0,0,0,0,0,0,0,0,0,0,1,1,0,0,0,0,0,0,0,0,0,0
476726,30000,300,0,-2,1,0,1,0,0,0,0,0,0,1,0,1,0,0,0,0,0,0,0,0,0,0,0,0,0,0,0,0,0,0
476975,30000,300,0,-2,13,3,10,0,0,0,0,0,0,1,0,1,0,0,0,0,0,0,12,3,9,0,0,0,0,0,0,0,0,0
477039,30000,300,0,-2,3,1,2,0,0,0,0,0,0,2,0,2,0,0,0,0,0,0,1,1,0,0,0,0,0,0,0,0,0,0
480073,30000,300,0,-2,2,1,1,0,0,0,0,0,0,1,1,0,0,0,0,0,0,0,1,0,1,0,0,0,0,0,0,0,0,0
480091,30000,300,0,-2,1,0,1,0,0,0,0,0,0,1,0,1,0,0,0,0,0,0,0,0,0,0,0,0,0,0,0,0,0,0
480204,30000,300,0,-2,4,1,3,0,0,0,1,1,0,1,0,1,1,0,1,0,0,0,1,0,1,0,0,0,0,0,0,0,0,0
480657,30000,300,0,-2,1,0,1,0,0,0,0,0,0,0,0,0,0,0,0,0,0,0,1,0,1,0,0,0,0,0,0,0,0,0
480790,30000,300,0,-2,6,2,4,0,0,0,1,1,0,1,0,1,0,0,0,0,0,0,4,1,3,0,0,0,0,0,0,0,0,0
481094,30000,300,0,-2,1,0,1,0,0,0,0,0,0,0,0,0,0,0,0,0,0,0,1,0,1,0,0,0,0,0,0,0,0,0
481535,30000,300,0,-2,8,4,4,0,0,0,2,1,1,1,1,0,2,0,2,0,0,0,3,2,1,0,0,0,0,0,0,0,0,0
481775,30000,300,0,-2,4,1,3,0,0,0,1,1,0,0,0,0,3,0,3,0,0,0,0,0,0,0,0,0,0,0,0,0,0,0
482149,30000,300,0,-2,13,6,7,0,0,0,0,0,0,3,0,3,0,0,0,0,0,0,9,5,4,1,1,0,0,0,0,0,0,0
482158,30000,300,0,-2,6,1,5,0,0,0,0,0,0,1,0,1,0,0,0,0,0,0,5,1,4,0,0,0,0,0,0,0,0,0
482477,30000,300,0,-2,1,0,1,0,0,0,0,0,0,0,0,0,1,0,1,0,0,0,0,0,0,0,0,0,0,0,0,0,0,0
482680,30000,300,0,-2,8,3,5,0,0,0,0,0,0,5,1,4,0,0,0,0,0,0,3,2,1,0,0,0,0,0,0,0,0,0
482936,30000,300,0,-2,3,1,2,0,0,0,0,0,0,0,0,0,0,0,0,0,0,0,3,1,2,0,0,0,0,0,0,0,0,0
482990,30000,300,0,-2,1,0,1,0,0,0,0,0,0,0,0,0,0,0,0,0,0,0,1,0,1,0,0,0,0,0,0,0,0,0
483018,30000,300,0,-2,2,1,1,0,0,0,0,0,0,0,0,0,0,0,0,0,0,0,2,1,1,0,0,0,0,0,0,0,0,0
483036,30000,300,0,-2,2,0,2,0,0,0,0,0,0,0,0,0,1,0,1,1,0,1,0,0,0,0,0,0,0,0,0,0,0,0
483124,30000,300,0,-2,8,3,5,0,0,0,0,0,0,0,0,0,0,0,0,0,0,0,4,1,3,0,0,0,4,2,2,0,0,0
483212,30000,300,0,-2,10,6,4,0,0,0,0,0,0,2,2,0,1,0,1,0,0,0,7,4,3,0,0,0,0,0,0,0,0,0
483647,30000,300,0,-2,2,1,1,0,0,0,0,0,0,0,0,0,0,0,0,0,0,0,2,1,1,0,0,0,0,0,0,0,0,0
484002,30000,300,0,-2,3,0,3,0,0,0,0,0,0,0,0,0,0,0,0,1,0,1,1,0,1,1,0,1,0,0,0,0,0,0
484473,30000,300,0,-2,1,1,0,0,0,0,0,0,0,0,0,0,0,0,0,0,0,0,1,1,0,0,0,0,0,0,0,0,0,0
484613,30000,300,0,-2,19,7,12,0,0,0,0,0,0,1,1,0,0,0,0,0,0,0,15,4,11,1,0,1,2,2,0,0,0,0
484844,30000,300,0,-2,6,3,3,0,0,0,0,0,0,0,0,0,0,0,0,0,0,0,3,1,2,0,0,0,0,0,0,3,2,1
484905,30000,300,0,-2,8,2,6,0,0,0,0,0,0,0,0,0,2,2,0,0,0,0,5,0,5,0,0,0,1,0,1,0,0,0
485111,30000,300,0,-2,4,1,3,0,0,0,0,0,0,1,0,1,0,0,0,0,0,0,2,1,1,0,0,0,1,0,1,0,0,0
485272,30000,300,0,-2,1,1,0,0,0,0,0,0,0,0,0,0,1,1,0,0,0,0,0,0,0,0,0,0,0,0,0,0,0,0
485467,30000,300,0,-2,4,1,3,0,0,0,0,0,0,0,0,0,1,0,1,0,0,0,2,0,2,1,1,0,0,0,0,0,0,0
485546,30000,300,0,-2,2,1,1,0,0,0,0,0,0,0,0,0,0,0,0,0,0,0,2,1,1,0,0,0,0,0,0,0,0,0
486284,30000,300,0,-2,8,3,5,0,0,0,0,0,0,1,0,1,0,0,0,0,0,0,7,3,4,0,0,0,0,0,0,0,0,0
486840,30000,300,0,-2,40,21,19,0,0,0,3,1,2,9,2,7,2,1,1,0,0,0,26,17,9,0,0,0,0,0,0,0,0,0
486901,30000,300,0,-2,2,2,0,0,0,0,0,0,0,0,0,0,0,0,0,0,0,0,2,2,0,0,0,0,0,0,0,0,0,0
487010,30000,300,0,-2,16,3,13,0,0,0,0,0,0,7,2,5,1,0,1,0,0,0,7,1,6,0,0,0,0,0,0,1,0,1
487162,30000,300,0,-2,1,0,1,0,0,0,0,0,0,1,0,1,0,0,0,0,0,0,0,0,0,0,0,0,0,0,0,0,0,0
487302,30000,300,0,-2,2,0,2,0,0,0,0,0,0,1,0,1,0,0,0,0,0,0,1,0,1,0,0,0,0,0,0,0,0,0
487320,30000,300,0,-2,13,5,8,0,0,0,0,0,0,0,0,0,4,1,3,0,0,0,9,4,5,0,0,0,0,0,0,0,0,0
487375,30000,300,0,-2,2,0,2,0,0,0,0,0,0,0,0,0,0,0,0,0,0,0,2,0,2,0,0,0,0,0,0,0,0,0
487384,30000,300,0,-2,1,0,1,0,0,0,0,0,0,0,0,0,0,0,0,0,0,0,0,0,0,0,0,0,1,0,1,0,0,0
487393,30000,300,0,-2,1,0,1,0,0,0,0,0,0,0,0,0,0,0,0,0,0,0,1,0,1,0,0,0,0,0,0,0,0,0
487409,30000,300,0,-2,3,2,1,0,0,0,0,0,0,1,1,0,0,0,0,0,0,0,2,1,1,0,0,0,0,0,0,0,0,0
487418,30000,300,0,-2,1,0,1,0,0,0,0,0,0,0,0,0,1,0,1,0,0,0,0,0,0,0,0,0,0,0,0,0,0,0
487427,30000,300,0,-2,2,1,1,0,0,0,0,0,0,0,0,0,0,0,0,0,0,0,2,1,1,0,0,0,0,0,0,0,0,0
487445,30000,300,0,-2,1,1,0,0,0,0,0,0,0,0,0,0,0,0,0,0,0,0,1,1,0,0,0,0,0,0,0,0,0,0
487454,30000,300,0,-2,2,0,2,0,0,0,0,0,0,0,0,0,1,0,1,0,0,0,0,0,0,1,0,1,0,0,0,0,0,0
487472,30000,300,0,-2,3,3,0,0,0,0,0,0,0,2,2,0,0,0,0,0,0,0,1,1,0,0,0,0,0,0,0,0,0,0
487524,30000,300,0,-2,12,6,6,0,0,0,0,0,0,0,0,0,0,0,0,0,0,0,12,6,6,0,0,0,0,0,0,0,0,0
487588,30000,300,0,-2,1,1,0,0,0,0,0,0,0,1,1,0,0,0,0,0,0,0,0,0,0,0,0,0,0,0,0,0,0,0
487597,30000,300,0,-2,1,0,1,0,0,0,0,0,0,0,0,0,0,0,0,0,0,0,1,0,1,0,0,0,0,0,0,0,0,0
487603,30000,300,0,-2,1,1,0,0,0,0,0,0,0,0,0,0,0,0,0,0,0,0,1,1,0,0,0,0,0,0,0,0,0,0
487649,30000,300,0,-2,4,1,3,0,0,0,0,0,0,0,0,0,3,1,2,0,0,0,1,0,1,0,0,0,0,0,0,0,0,0
487977,30000,300,0,-2,1,1,0,0,0,0,0,0,0,0,0,0,0,0,0,0,0,0,1,1,0,0,0,0,0,0,0,0,0,0
488077,30000,300,0,-2,25,15,10,0,0,0,0,0,0,0,0,0,1,1,0,0,0,0,8,5,3,1,1,0,15,8,7,0,0,0
488305,30000,300,0,-2,1,1,0,0,0,0,0,0,0,0,0,0,0,0,0,0,0,0,1,1,0,0,0,0,0,0,0,0,0,0
488527,30000,300,0,-2,3,1,2,0,0,0,0,0,0,0,0,0,0,0,0,0,0,0,3,1,2,0,0,0,0,0,0,0,0,0
488554,30000,300,0,-2,4,2,2,0,0,0,0,0,0,0,0,0,1,1,0,0,0,0,3,1,2,0,0,0,0,0,0,0,0,0
488572,30000,300,0,-2,2,2,0,0,0,0,1,1,0,0,0,0,0,0,0,0,0,0,1,1,0,0,0,0,0,0,0,0,0,0
488846,30000,300,0,-2,4,3,1,0,0,0,0,0,0,0,0,0,0,0,0,0,0,0,0,0,0,0,0,0,4,3,1,0,0,0
489201,30000,300,0,-2,1,1,0,0,0,0,0,0,0,0,0,0,0,0,0,0,0,0,1,1,0,0,0,0,0,0,0,0,0,0
489283,30000,300,0,-2,1,0,1,0,0,0,0,0,0,0,0,0,1,0,1,0,0,0,0,0,0,0,0,0,0,0,0,0,0,0
489779,30000,300,0,-2,5,3,2,0,0,0,0,0,0,1,0,1,1,1,0,0,0,0,3,2,1,0,0,0,0,0,0,0,0,0
489858,30000,300,0,-2,2,1,1,0,0,0,1,0,1,0,0,0,0,0,0,0,0,0,1,1,0,0,0,0,0,0,0,0,0,0
489937,30000,300,0,-2,1,0,1,0,0,0,0,0,0,0,0,0,0,0,0,0,0,0,1,0,1,0,0,0,0,0,0,0,0,0
490133,30000,300,0,-2,4,2,2,0,0,0,1,0,1,0,0,0,0,0,0,0,0,0,1,0,1,2,2,0,0,0,0,0,0,0
490373,30000,300,0,-2,3,0,3,0,0,0,0,0,0,1,0,1,0,0,0,0,0,0,2,0,2,0,0,0,0,0,0,0,0,0
490805,30000,300,0,-2,1,1,0,0,0,0,0,0,0,1,1,0,0,0,0,0,0,0,0,0,0,0,0,0,0,0,0,0,0,0
490878,30000,300,0,-2,2,0,2,0,0,0,0,0,0,0,0,0,0,0,0,0,0,0,2,0,2,0,0,0,0,0,0,0,0,0
490975,30000,300,0,-2,1,0,1,0,0,0,1,0,1,0,0,0,0,0,0,0,0,0,0,0,0,0,0,0,0,0,0,0,0,0
491844,30000,300,0,-2,1,1,0,1,1,0,0,0,0,0,0,0,0,0,0,0,0,0,0,0,0,0,0,0,0,0,0,0,0,0
492263,30000,300,0,-2,7,5,2,0,0,0,0,0,0,0,0,0,1,1,0,0,0,0,6,4,2,0,0,0,0,0,0,0,0,0
492607,30000,300,0,-2,1,0,1,0,0,0,0,0,0,1,0,1,0,0,0,0,0,0,0,0,0,0,0,0,0,0,0,0,0,0
492689,30000,300,0,-2,9,2,7,0,0,0,0,0,0,0,0,0,6,2,4,0,0,0,2,0,2,0,0,0,0,0,0,1,0,1
493080,30000,300,0,-2,1,1,0,0,0,0,0,0,0,0,0,0,0,0,0,0,0,0,1,1,0,0,0,0,0,0,0,0,0,0
493822,30000,300,0,-2,3,2,1,0,0,0,0,0,0,1,0,1,0,0,0,0,0,0,2,2,0,0,0,0,0,0,0,0,0,0
494010,30000,300,0,-2,1,0,1,0,0,0,0,0,0,0,0,0,0,0,0,0,0,0,1,0,1,0,0,0,0,0,0,0,0,0
494162,30000,300,0,-2,3,0,3,0,0,0,0,0,0,0,0,0,0,0,0,0,0,0,3,0,3,0,0,0,0,0,0,0,0,0
494588,30000,300,0,-2,1,0,1,0,0,0,0,0,0,0,0,0,1,0,1,0,0,0,0,0,0,0,0,0,0,0,0,0,0,0
494603,30000,300,0,-2,6,5,1,0,0,0,0,0,0,0,0,0,1,1,0,0,0,0,4,3,1,0,0,0,1,1,0,0,0,0
494755,30000,300,0,-2,1,0,1,0,0,0,0,0,0,0,0,0,0,0,0,0,0,0,1,0,1,0,0,0,0,0,0,0,0,0
494843,30000,300,0,-2,1,1,0,0,0,0,0,0,0,0,0,0,0,0,0,0,0,0,0,0,0,0,0,0,1,1,0,0,0,0
494852,30000,300,0,-2,4,2,2,0,0,0,1,0,1,1,1,0,0,0,0,0,0,0,2,1,1,0,0,0,0,0,0,0,0,0
494959,30000,300,0,-2,1,0,1,0,0,0,0,0,0,0,0,0,0,0,0,0,0,0,1,0,1,0,0,0,0,0,0,0,0,0
495314,30000,300,0,-2,3,3,0,0,0,0,0,0,0,2,2,0,0,0,0,0,0,0,1,1,0,0,0,0,0,0,0,0,0,0
495420,30000,300,0,-2,2,0,2,0,0,0,0,0,0,0,0,0,0,0,0,0,0,0,2,0,2,0,0,0,0,0,0,0,0,0
495439,30000,300,0,-2,2,0,2,0,0,0,0,0,0,0,0,0,0,0,0,0,0,0,1,0,1,1,0,1,0,0,0,0,0,0
495448,30000,300,0,-2,2,1,1,0,0,0,0,0,0,0,0,0,0,0,0,0,0,0,2,1,1,0,0,0,0,0,0,0,0,0
495457,30000,300,0,-2,3,1,2,0,0,0,1,1,0,0,0,0,0,0,0,0,0,0,1,0,1,0,0,0,1,0,1,0,0,0
495767,30000,300,0,-2,76,33,43,0,0,0,3,2,1,8,4,4,7,4,3,0,0,0,55,22,33,1,1,0,2,0,2,0,0,0
496043,30000,300,0,-2,4,2,2,0,0,0,1,0,1,0,0,0,2,1,1,0,0,0,1,1,0,0,0,0,0,0,0,0,0,0
496186,30000,300,0,-2,1,0,1,0,0,0,1,0,1,0,0,0,0,0,0,0,0,0,0,0,0,0,0,0,0,0,0,0,0,0
496283,30000,300,0,-2,1,0,1,0,0,0,0,0,0,0,0,0,0,0,0,0,0,0,1,0,1,0,0,0,0,0,0,0,0,0
496991,30000,300,0,-2,3,0,3,0,0,0,0,0,0,1,0,1,1,0,1,0,0,0,1,0,1,0,0,0,0,0,0,0,0,0
497000,30000,300,0,-2,3,2,1,0,0,0,0,0,0,0,0,0,0,0,0,0,0,0,3,2,1,0,0,0,0,0,0,0,0,0
497277,30000,300,0,-2,1,0,1,0,0,0,0,0,0,0,0,0,0,0,0,0,0,0,1,0,1,0,0,0,0,0,0,0,0,0
497286,30000,300,0,-2,4,2,2,0,0,0,0,0,0,0,0,0,1,0,1,0,0,0,2,2,0,1,0,1,0,0,0,0,0,0
100654,31000,310,0,-2,4,1,3,0,0,0,0,0,0,4,1,3,0,0,0,0,0,0,0,0,0,0,0,0,0,0,0,0,0,0
100663,31000,310,0,-2,128,36,92,0,0,0,3,1,2,47,13,34,2,2,0,0,0,0,70,19,51,4,1,3,2,0,2,0,0,0
100706,31000,310,0,-2,11,4,7,0,0,0,1,0,1,3,1,2,0,0,0,0,0,0,6,2,4,0,0,0,0,0,0,1,1,0
100724,31000,310,0,-2,2,0,2,0,0,0,0,0,0,1,0,1,0,0,0,0,0,0,0,0,0,0,0,0,1,0,1,0,0,0
100733,31000,310,0,-2,1,1,0,0,0,0,0,0,0,0,0,0,0,0,0,0,0,0,1,1,0,0,0,0,0,0,0,0,0,0
100751,31000,310,0,-2,83,31,52,0,0,0,1,1,0,18,4,14,5,2,3,0,0,0,58,23,35,0,0,0,0,0,0,1,1,0
100760,31000,310,0,-2,2,0,2,0,0,0,0,0,0,0,0,0,0,0,0,0,0,0,2,0,2,0,0,0,0,0,0,0,0,0
100812,31000,310,0,-2,4,1,3,0,0,0,0,0,0,1,0,1,0,0,0,0,0,0,3,1,2,0,0,0,0,0,0,0,0,0
100830,31000,310,0,-2,2,0,2,0,0,0,0,0,0,1,0,1,0,0,0,0,0,0,1,0,1,0,0,0,0,0,0,0,0,0
100858,31000,310,0,-2,17,8,9,0,0,0,1,0,1,1,1,0,1,1,0,0,0,0,14,6,8,0,0,0,0,0,0,0,0,0
100937,31000,310,0,-2,2,0,2,0,0,0,0,0,0,0,0,0,0,0,0,0,0,0,2,0,2,0,0,0,0,0,0,0,0,0
101116,31000,310,0,-2,1,1,0,0,0,0,0,0,0,1,1,0,0,0,0,0,0,0,0,0,0,0,0,0,0,0,0,0,0,0
101161,31000,310,0,-2,6,1,5,0,0,0,0,0,0,1,0,1,1,1,0,0,0,0,4,0,4,0,0,0,0,0,0,0,0,0
101189,31000,310,0,-2,1,0,1,0,0,0,0,0,0,0,0,0,0,0,0,0,0,0,1,0,1,0,0,0,0,0,0,0,0,0
101240,31000,310,0,-2,3,0,3,0,0,0,0,0,0,0,0,0,0,0,0,0,0,0,3,0,3,0,0,0,0,0,0,0,0,0
101295,31000,310,0,-2,1,0,1,0,0,0,0,0,0,0,0,0,0,0,0,0,0,0,1,0,1,0,0,0,0,0,0,0,0,0
101480,31000,310,0,-2,6,5,1,0,0,0,0,0,0,2,2,0,0,0,0,0,0,0,4,3,1,0,0,0,0,0,0,0,0,0
101505,31000,310,0,-2,1,0,1,0,0,0,0,0,0,0,0,0,0,0,0,0,0,0,1,0,1,0,0,0,0,0,0,0,0,0
101569,31000,310,0,-2,3,0,3,0,0,0,0,0,0,3,0,3,0,0,0,0,0,0,0,0,0,0,0,0,0,0,0,0,0,0
101587,31000,310,0,-2,1,0,1,0,0,0,0,0,0,0,0,0,0,0,0,0,0,0,0,0,0,0,0,0,1,0,1,0,0,0
101648,31000,310,0,-2,1,1,0,0,0,0,0,0,0,0,0,0,0,0,0,0,0,0,1,1,0,0,0,0,0,0,0,0,0,0
101709,31000,310,0,-2,1,0,1,0,0,0,0,0,0,1,0,1,0,0,0,0,0,0,0,0,0,0,0,0,0,0,0,0,0,0
101736,31000,310,0,-2,7,1,6,0,0,0,0,0,0,0,0,0,0,0,0,0,0,0,7,1,6,0,0,0,0,0,0,0,0,0
101879,31000,310,0,-2,3,1,2,0,0,0,0,0,0,0,0,0,0,0,0,0,0,0,3,1,2,0,0,0,0,0,0,0,0,0
101994,31000,310,0,-2,2,2,0,0,0,0,0,0,0,0,0,0,0,0,0,0,0,0,2,2,0,0,0,0,0,0,0,0,0,0
102030,31000,310,0,-2,3,0,3,0,0,0,0,0,0,3,0,3,0,0,0,0,0,0,0,0,0,0,0,0,0,0,0,0,0,0
102049,31000,310,0,-2,1,0,1,0,0,0,0,0,0,0,0,0,0,0,0,0,0,0,1,0,1,0,0,0,0,0,0,0,0,0
102076,31000,310,0,-2,1,0,1,0,0,0,0,0,0,0,0,0,0,0,0,0,0,0,1,0,1,0,0,0,0,0,0,0,0,0
102094,31000,310,0,-2,15,7,8,0,0,0,1,0,1,2,2,0,0,0,0,0,0,0,12,5,7,0,0,0,0,0,0,0,0,0
102270,31000,310,0,-2,1,0,1,0,0,0,0,0,0,0,0,0,0,0,0,0,0,0,1,0,1,0,0,0,0,0,0,0,0,0
102313,31000,310,0,-2,2,0,2,0,0,0,0,0,0,0,0,0,0,0,0,0,0,0,2,0,2,0,0,0,0,0,0,0,0,0
102368,31000,310,0,-2,2,0,2,0,0,0,0,0,0,0,0,0,0,0,0,0,0,0,2,0,2,0,0,0,0,0,0,0,0,0
102429,31000,310,0,-2,1,0,1,0,0,0,0,0,0,1,0,1,0,0,0,0,0,0,0,0,0,0,0,0,0,0,0,0,0,0
102553,31000,310,0,-2,13,7,6,0,0,0,0,0,0,1,0,1,0,0,0,0,0,0,10,5,5,1,1,0,1,1,0,0,0,0
102614,31000,310,0,-2,11,5,6,1,0,1,1,0,1,0,0,0,0,0,0,0,0,0,8,4,4,0,0,0,1,1,0,0,0,0
102632,31000,310,0,-2,4,2,2,0,0,0,0,0,0,0,0,0,0,0,0,0,0,0,4,2,2,0,0,0,0,0,0,0,0,0
102669,31000,310,0,-2,2,0,2,1,0,1,0,0,0,0,0,0,0,0,0,0,0,0,1,0,1,0,0,0,0,0,0,0,0,0
102845,31000,310,0,-2,4,1,3,0,0,0,0,0,0,0,0,0,2,1,1,0,0,0,2,0,2,0,0,0,0,0,0,0,0,0
104151,31000,310,0,-2,247,74,173,6,1,5,7,1,6,7,1,6,43,11,32,2,0,2,117,32,85,4,3,1,53,22,31,8,3,5
104160,31000,310,0,-2,2,0,2,0,0,0,0,0,0,0,0,0,2,0,2,0,0,0,0,0,0,0,0,0,0,0,0,0,0,0
104179,31000,310,0,-2,30,9,21,0,0,0,2,0,2,1,0,1,7,3,4,0,0,0,15,4,11,2,1,1,2,1,1,1,0,1
104346,31000,310,0,-2,2,0,2,0,0,0,0,0,0,0,0,0,1,0,1,0,0,0,1,0,1,0,0,0,0,0,0,0,0,0
104425,31000,310,0,-2,3,0,3,0,0,0,0,0,0,0,0,0,0,0,0,0,0,0,2,0,2,0,0,0,0,0,0,1,0,1
104577,31000,310,0,-2,4,2,2,0,0,0,0,0,0,0,0,0,1,0,1,0,0,0,3,2,1,0,0,0,0,0,0,0,0,0
104586,31000,310,0,-2,2,0,2,0,0,0,0,0,0,0,0,0,0,0,0,0,0,0,2,0,2,0,0,0,0,0,0,0,0,0
104708,31000,310,0,-2,11,1,10,0,0,0,0,0,0,0,0,0,5,0,5,0,0,0,4,1,3,0,0,0,2,0,2,0,0,0
104717,31000,310,0,-2,11,4,7,0,0,0,0,0,0,0,0,0,1,1,0,0,0,0,10,3,7,0,0,0,0,0,0,0,0,0
105136,31000,310,0,-2,26,9,17,1,0,1,4,2,2,4,2,2,7,2,5,0,0,0,7,1,6,0,0,0,3,2,1,0,0,0
105145,31000,310,0,-2,5,3,2,0,0,0,0,0,0,1,0,1,2,2,0,0,0,0,2,1,1,0,0,0,0,0,0,0,0,0
105154,31000,310,0,-2,11,4,7,0,0,0,1,0,1,0,0,0,4,3,1,1,0,1,4,1,3,0,0,0,1,0,1,0,0,0
105215,31000,310,0,-2,4,1,3,0,0,0,0,0,0,0,0,0,1,1,0,0,0,0,3,0,3,0,0,0,0,0,0,0,0,0
105297,31000,310,0,-2,2,1,1,2,1,1,0,0,0,0,0,0,0,0,0,0,0,0,0,0,0,0,0,0,0,0,0,0,0,0
105330,31000,310,0,-2,61,20,41,5,0,5,1,0,1,1,0,1,5,2,3,0,0,0,46,17,29,0,0,0,1,1,0,2,0,2
105349,31000,310,0,-2,4,3,1,0,0,0,0,0,0,0,0,0,1,1,0,0,0,0,2,1,1,0,0,0,1,1,0,0,0,0
105428,31000,310,0,-2,7,2,5,0,0,0,1,1,0,0,0,0,6,1,5,0,0,0,0,0,0,0,0,0,0,0,0,0,0,0
105525,31000,310,0,-2,6,3,3,0,0,0,0,0,0,0,0,0,2,0,2,0,0,0,4,3,1,0,0,0,0,0,0,0,0,0
105668,31000,310,0,-2,19,4,15,0,0,0,2,0,2,1,0,1,4,2,2,0,0,0,12,2,10,0,0,0,0,0,0,0,0,0
105747,31000,310,0,-2,12,3,9,0,0,0,0,0,0,1,1,0,6,2,4,0,0,0,5,0,5,0,0,0,0,0,0,0,0,0
105792,31000,310,0,-2,5,4,1,1,0,1,0,0,0,0,0,0,3,3,0,0,0,0,1,1,0,0,0,0,0,0,0,0,0,0
106041,31000,310,0,-2,12,4,8,0,0,0,0,0,0,0,0,0,7,3,4,0,0,0,5,1,4,0,0,0,0,0,0,0,0,0
106148,31000,310,0,-2,4,1,3,0,0,0,0,0,0,0,0,0,1,0,1,0,0,0,3,1,2,0,0,0,0,0,0,0,0,0
106245,31000,310,0,-2,7,2,5,0,0,0,0,0,0,2,0,2,2,0,2,0,0,0,3,2,1,0,0,0,0,0,0,0,0,0
106263,31000,310,0,-2,46,16,30,0,0,0,3,0,3,9,1,8,5,1,4,0,0,0,26,13,13,3,1,2,0,0,0,0,0,0
106306,31000,310,0,-2,2,0,2,0,0,0,0,0,0,2,0,2,0,0,0,0,0,0,0,0,0,0,0,0,0,0,0,0,0,0
106397,31000,310,0,-2,81,36,45,1,1,0,2,0,2,18,9,9,4,0,4,0,0,0,52,26,26,1,0,1,2,0,2,1,0,1
106412,31000,310,0,-2,5,0,5,0,0,0,0,0,0,5,0,5,0,0,0,0,0,0,0,0,0,0,0,0,0,0,0,0,0,0
106449,31000,310,0,-2,4,2,2,0,0,0,0,0,0,0,0,0,0,0,0,0,0,0,4,2,2,0,0,0,0,0,0,0,0,0
106458,31000,310,0,-2,37,17,20,0,0,0,0,0,0,3,2,1,5,1,4,0,0,0,24,11,13,1,0,1,1,1,0,3,2,1
106467,31000,310,0,-2,3,0,3,0,0,0,0,0,0,0,0,0,0,0,0,0,0,0,3,0,3,0,0,0,0,0,0,0,0,0
106704,31000,310,0,-2,10,5,5,0,0,0,0,0,0,3,0,3,0,0,0,0,0,0,7,5,2,0,0,0,0,0,0,0,0,0
106713,31000,310,0,-2,1,0,1,0,0,0,0,0,0,0,0,0,0,0,0,0,0,0,1,0,1,0,0,0,0,0,0,0,0,0
106795,31000,310,0,-2,1,0,1,0,0,0,0,0,0,0,0,0,0,0,0,0,0,0,1,0,1,0,0,0,0,0,0,0,0,0
106883,31000,310,0,-2,1,0,1,0,0,0,0,0,0,0,0,0,0,0,0,0,0,0,1,0,1,0,0,0,0,0,0,0,0,0
106980,31000,310,0,-2,2,0,2,0,0,0,0,0,0,0,0,0,0,0,0,0,0,0,2,0,2,0,0,0,0,0,0,0,0,0
107044,31000,310,0,-2,6,5,1,0,0,0,0,0,0,1,0,1,0,0,0,0,0,0,5,5,0,0,0,0,0,0,0,0,0,0
107071,31000,310,0,-2,1,0,1,0,0,0,0,0,0,0,0,0,0,0,0,0,0,0,1,0,1,0,0,0,0,0,0,0,0,0
107080,31000,310,0,-2,1,0,1,0,0,0,0,0,0,0,0,0,0,0,0,0,0,0,1,0,1,0,0,0,0,0,0,0,0,0
107141,31000,310,0,-2,1,0,1,0,0,0,0,0,0,0,0,0,1,0,1,0,0,0,0,0,0,0,0,0,0,0,0,0,0,0
107512,31000,310,0,-2,3,0,3,0,0,0,0,0,0,0,0,0,0,0,0,0,0,0,3,0,3,0,0,0,0,0,0,0,0,0
107521,31000,310,0,-2,1,0,1,0,0,0,0,0,0,0,0,0,0,0,0,0,0,0,1,0,1,0,0,0,0,0,0,0,0,0
107549,31000,310,0,-2,1,0,1,0,0,0,0,0,0,0,0,0,0,0,0,0,0,0,1,0,1,0,0,0,0,0,0,0,0,0
107600,31000,310,0,-2,1,1,0,0,0,0,0,0,0,0,0,0,0,0,0,0,0,0,1,1,0,0,0,0,0,0,0,0,0,0
107637,31000,310,0,-2,1,1,0,0,0,0,0,0,0,1,1,0,0,0,0,0,0,0,0,0,0,0,0,0,0,0,0,0,0,0
107664,31000,310,0,-2,3,0,3,0,0,0,0,0,0,2,0,2,0,0,0,0,0,0,1,0,1,0,0,0,0,0,0,0,0,0
107743,31000,310,0,-2,1,0,1,0,0,0,0,0,0,0,0,0,0,0,0,0,0,0,1,0,1,0,0,0,0,0,0,0,0,0
107877,31000,310,0,-2,1,0,1,0,0,0,0,0,0,0,0,0,0,0,0,0,0,0,1,0,1,0,0,0,0,0,0,0,0,0
107974,31000,310,0,-2,1,0,1,0,0,0,0,0,0,0,0,0,0,0,0,0,0,0,1,0,1,0,0,0,0,0,0,0,0,0
107983,31000,310,0,-2,1,1,0,0,0,0,0,0,0,0,0,0,0,0,0,0,0,0,1,1,0,0,0,0,0,0,0,0,0,0
108056,31000,310,0,-2,5,3,2,1,0,1,0,0,0,1,1,0,0,0,0,0,0,0,3,2,1,0,0,0,0,0,0,0,0,0
108092,31000,310,0,-2,4,3,1,1,1,0,0,0,0,0,0,0,0,0,0,0,0,0,3,2,1,0,0,0,0,0,0,0,0,0
108232,31000,310,0,-2,8,3,5,0,0,0,3,2,1,1,0,1,0,0,0,0,0,0,4,1,3,0,0,0,0,0,0,0,0,0
108807,31000,310,0,-2,1,0,1,0,0,0,0,0,0,0,0,0,1,0,1,0,0,0,0,0,0,0,0,0,0,0,0,0,0,0
108870,31000,310,0,-2,4,1,3,0,0,0,0,0,0,1,0,1,1,1,0,0,0,0,2,0,2,0,0,0,0,0,0,0,0,0
109040,31000,310,0,-2,3,0,3,0,0,0,0,0,0,0,0,0,3,0,3,0,0,0,0,0,0,0,0,0,0,0,0,0,0,0
109086,31000,310,0,-2,3,1,2,0,0,0,3,1,2,0,0,0,0,0,0,0,0,0,0,0,0,0,0,0,0,0,0,0,0,0
109350,31000,310,0,-2,1,0,1,0,0,0,0,0,0,0,0,0,0,0,0,0,0,0,0,0,0,1,0,1,0,0,0,0,0,0
109651,31000,310,0,-2,2,0,2,0,0,0,1,0,1,0,0,0,0,0,0,0,0,0,1,0,1,0,0,0,0,0,0,0,0,0
109785,31000,310,0,-2,2,1,1,0,0,0,1,0,1,0,0,0,1,1,0,0,0,0,0,0,0,0,0,0,0,0,0,0,0,0
109819,31000,310,0,-2,4,3,1,0,0,0,1,1,0,1,0,1,1,1,0,0,0,0,0,0,0,0,0,0,0,0,0,1,1,0
110097,31000,310,0,-2,4,2,2,0,0,0,0,0,0,0,0,0,1,1,0,0,0,0,2,1,1,0,0,0,1,0,1,0,0,0
110219,31000,310,0,-2,2,1,1,0,0,0,0,0,0,1,0,1,0,0,0,0,0,0,1,1,0,0,0,0,0,0,0,0,0,0
110246,31000,310,0,-2,2,2,0,0,0,0,0,0,0,1,1,0,1,1,0,0,0,0,0,0,0,0,0,0,0,0,0,0,0,0
110316,31000,310,0,-2,1,1,0,0,0,0,0,0,0,0,0,0,0,0,0,0,0,0,1,1,0,0,0,0,0,0,0,0,0,0
110334,31000,310,0,-2,2,0,2,0,0,0,0,0,0,0,0,0,2,0,2,0,0,0,0,0,0,0,0,0,0,0,0,0,0,0
110361,31000,310,0,-2,10,2,8,0,0,0,0,0,0,1,0,1,6,0,6,0,0,0,3,2,1,0,0,0,0,0,0,0,0,0
110370,31000,310,0,-2,4,1,3,0,0,0,2,1,1,0,0,0,1,0,1,0,0,0,0,0,0,1,0,1,0,0,0,0,0,0
110398,31000,310,0,-2,9,5,4,0,0,0,2,1,1,0,0,0,4,2,2,0,0,0,0,0,0,2,2,0,1,0,1,0,0,0
110404,31000,310,0,-2,17,9,8,0,0,0,3,1,2,1,1,0,1,1,0,0,0,0,8,5,3,1,0,1,2,1,1,1,0,1
110413,31000,310,0,-2,3,0,3,0,0,0,1,0,1,0,0,0,2,0,2,0,0,0,0,0,0,0,0,0,0,0,0,0,0,0
110422,31000,310,0,-2,7,5,2,0,0,0,0,0,0,0,0,0,1,1,0,0,0,0,6,4,2,0,0,0,0,0,0,0,0,0
110468,31000,310,0,-2,4,2,2,0,0,0,0,0,0,0,0,0,2,0,2,0,0,0,2,2,0,0,0,0,0,0,0,0,0,0
110486,31000,310,0,-2,11,1,10,0,0,0,0,0,0,1,0,1,5,1,4,0,0,0,4,0,4,0,0,0,1,0,1,0,0,0
110495,31000,310,0,-2,9,1,8,0,0,0,1,0,1,0,0,0,1,0,1,0,0,0,6,1,5,1,0,1,0,0,0,0,0,0
110501,31000,310,0,-2,25,11,14,0,0,0,8,4,4,4,2,2,6,2,4,0,0,0,7,3,4,0,0,0,0,0,0,0,0,0
110510,31000,310,0,-2,16,5,11,0,0,0,1,0,1,2,0,2,5,4,1,0,0,0,7,1,6,0,0,0,1,0,1,0,0,0
110529,31000,310,0,-2,17,6,11,0,0,0,5,3,2,1,0,1,7,2,5,0,0,0,4,1,3,0,0,0,0,0,0,0,0,0
110538,31000,310,0,-2,10,8,2,0,0,0,1,1,0,0,0,0,3,2,1,0,0,0,5,4,1,0,0,0,1,1,0,0,0,0
110547,31000,310,0,-2,13,4,9,0,0,0,3,1,2,5,2,3,4,1,3,0,0,0,1,0,1,0,0,0,0,0,0,0,0,0
110556,31000,310,0,-2,7,2,5,0,0,0,0,0,0,2,0,2,2,0,2,0,0,0,3,2,1,0,0,0,0,0,0,0,0,0
110565,31000,310,0,-2,16,4,12,0,0,0,3,0,3,1,0,1,4,1,3,0,0,0,7,2,5,0,0,0,1,1,0,0,0,0
110574,31000,310,0,-2,8,3,5,0,0,0,6,3,3,0,0,0,0,0,0,0,0,0,1,0,1,0,0,0,1,0,1,0,0,0
110583,31000,310,0,-2,22,6,16,0,0,0,0,0,0,2,0,2,7,1,6,0,0,0,11,4,7,1,0,1,0,0,0,1,1,0
110592,31000,310,0,-2,11,1,10,0,0,0,1,0,1,3,0,3,4,0,4,0,0,0,1,1,0,0,0,0,2,0,2,0,0,0
110608,31000,310,0,-2,25,8,17,0,0,0,2,1,1,3,1,2,4,1,3,0,0,0,12,4,8,0,0,0,4,1,3,0,0,0
110617,31000,310,0,-2,11,3,8,0,0,0,2,1,1,2,2,0,2,0,2,0,0,0,3,0,3,0,0,0,2,0,2,0,0,0
110635,31000,310,0,-2,180,50,130,0,0,0,34,11,23,15,3,12,24,9,15,0,0,0,75,20,55,9,3,6,8,1,7,15,3,12
110644,31000,310,0,-2,125,37,88,0,0,0,21,5,16,10,3,7,15,2,13,0,0,0,60,19,41,3,3,0,12,4,8,4,1,3
110653,31000,310,0,-2,101,24,77,0,0,0,26,9,17,4,1,3,29,5,24,0,0,0,29,7,22,2,0,2,7,1,6,4,1,3
110662,31000,310,0,-2,461,139,322,2,0,2,92,29,63,47,12,35,120,37,83,1,0,1,121,41,80,16,5,11,25,4,21,37,11,26
110671,31000,310,0,-2,52,17,35,0,0,0,11,3,8,4,2,2,15,4,11,0,0,0,18,7,11,2,1,1,0,0,0,2,0,2
110680,31000,310,0,-2,295,87,208,1,0,1,60,16,44,12,1,11,48,14,34,1,0,1,135,42,93,12,1,11,11,6,5,15,7,8
110699,31000,310,0,-2,213,61,152,1,0,1,61,15,46,16,6,10,29,10,19,1,0,1,75,23,52,8,1,7,12,6,6,10,0,10
110705,31000,310,0,-2,27,14,13,0,0,0,1,0,1,0,0,0,6,4,2,0,0,0,16,8,8,2,2,0,2,0,2,0,0,0
110714,31000,310,0,-2,56,17,39,0,0,0,10,3,7,1,0,1,6,2,4,0,0,0,28,10,18,5,0,5,4,2,2,2,0,2
111081,31000,310,0,-2,8,1,7,0,0,0,1,0,1,1,1,0,2,0,2,0,0,0,4,0,4,0,0,0,0,0,0,0,0,0
111188,31000,310,0,-2,6,2,4,0,0,0,2,1,1,1,0,1,1,0,1,0,0,0,1,1,0,1,0,1,0,0,0,0,0,0
111391,31000,310,0,-2,3,0,3,0,0,0,2,0,2,0,0,0,0,0,0,0,0,0,1,0,1,0,0,0,0,0,0,0,0,0
111434,31000,310,0,-2,1,1,0,0,0,0,0,0,0,0,0,0,1,1,0,0,0,0,0,0,0,0,0,0,0,0,0,0,0,0
111461,31000,310,0,-2,4,0,4,0,0,0,0,0,0,1,0,1,0,0,0,0,0,0,3,0,3,0,0,0,0,0,0,0,0,0
111887,31000,310,0,-2,1,0,1,0,0,0,0,0,0,0,0,0,1,0,1,0,0,0,0,0,0,0,0,0,0,0,0,0,0,0
111939,31000,310,0,-2,1,0,1,0,0,0,0,0,0,0,0,0,1,0,1,0,0,0,0,0,0,0,0,0,0,0,0,0,0,0
111948,31000,310,0,-2,8,3,5,0,0,0,1,1,0,0,0,0,2,0,2,0,0,0,0,0,0,0,0,0,5,2,3,0,0,0
111966,31000,310,0,-2,7,3,4,0,0,0,0,0,0,2,1,1,2,1,1,0,0,0,1,0,1,0,0,0,2,1,1,0,0,0
112127,31000,310,0,-2,1,0,1,0,0,0,0,0,0,0,0,0,1,0,1,0,0,0,0,0,0,0,0,0,0,0,0,0,0,0
112172,31000,310,0,-2,1,0,1,0,0,0,0,0,0,0,0,0,0,0,0,0,0,0,1,0,1,0,0,0,0,0,0,0,0,0
112251,31000,310,0,-2,1,1,0,0,0,0,0,0,0,0,0,0,1,1,0,0,0,0,0,0,0,0,0,0,0,0,0,0,0,0
112260,31000,310,0,-2,7,1,6,0,0,0,1,0,1,0,0,0,2,0,2,1,0,1,2,1,1,0,0,0,1,0,1,0,0,0
112394,31000,310,0,-2,1,1,0,0,0,0,0,0,0,0,0,0,0,0,0,0,0,0,1,1,0,0,0,0,0,0,0,0,0,0
112525,31000,310,0,-2,2,2,0,0,0,0,1,1,0,0,0,0,0,0,0,0,0,0,1,1,0,0,0,0,0,0,0,0,0,0
112686,31000,310,0,-2,1,0,1,0,0,0,0,0,0,0,0,0,1,0,1,0,0,0,0,0,0,0,0,0,0,0,0,0,0,0
113856,31000,310,0,-2,4,2,2,0,0,0,1,0,1,0,0,0,0,0,0,0,0,0,1,0,1,0,0,0,2,2,0,0,0,0
113980,31000,310,0,-2,5,4,1,0,0,0,1,1,0,2,1,1,2,2,0,0,0,0,0,0,0,0,0,0,0,0,0,0,0,0
114266,31000,310,0,-2,1,1,0,0,0,0,1,1,0,0,0,0,0,0,0,0,0,0,0,0,0,0,0,0,0,0,0,0,0,0
114433,31000,310,0,-2,1,0,1,0,0,0,0,0,0,0,0,0,0,0,0,0,0,0,1,0,1,0,0,0,0,0,0,0,0,0
114789,31000,310,0,-2,3,2,1,0,0,0,1,0,1,0,0,0,2,2,0,0,0,0,0,0,0,0,0,0,0,0,0,0,0,0
114813,31000,310,0,-2,5,1,4,0,0,0,1,0,1,0,0,0,2,0,2,0,0,0,2,1,1,0,0,0,0,0,0,0,0,0
114840,31000,310,0,-2,3,0,3,0,0,0,2,0,2,1,0,1,0,0,0,0,0,0,0,0,0,0,0,0,0,0,0,0,0,0
115010,31000,310,0,-2,4,0,4,0,0,0,0,0,0,0,0,0,1,0,1,0,0,0,0,0,0,0,0,0,3,0,3,0,0,0
115083,31000,310,0,-2,1,1,0,0,0,0,0,0,0,0,0,0,0,0,0,0,0,0,1,1,0,0,0,0,0,0,0,0,0,0
115214,31000,310,0,-2,3,0,3,0,0,0,1,0,1,0,0,0,0,0,0,0,0,0,1,0,1,1,0,1,0,0,0,0,0,0
115287,31000,310,0,-2,1,0,1,0,0,0,0,0,0,0,0,0,0,0,0,0,0,0,1,0,1,0,0,0,0,0,0,0,0,0
115393,31000,310,0,-2,1,0,1,0,0,0,0,0,0,0,0,0,0,0,0,0,0,0,1,0,1,0,0,0,0,0,0,0,0,0
115409,31000,310,0,-2,7,2,5,0,0,0,4,1,3,0,0,0,1,1,0,0,0,0,1,0,1,0,0,0,1,0,1,0,0,0
115728,31000,310,0,-2,1,1,0,0,0,0,0,0,0,0,0,0,1,1,0,0,0,0,0,0,0,0,0,0,0,0,0,0,0,0
115755,31000,310,0,-2,9,1,8,0,0,0,0,0,0,0,0,0,1,0,1,0,0,0,8,1,7,0,0,0,0,0,0,0,0,0
115931,31000,310,0,-2,1,0,1,0,0,0,1,0,1,0,0,0,0,0,0,0,0,0,0,0,0,0,0,0,0,0,0,0,0,0
116439,31000,310,0,-2,2,1,1,0,0,0,1,0,1,0,0,0,1,1,0,0,0,0,0,0,0,0,0,0,0,0,0,0,0,0
116846,31000,310,0,-2,1,0,1,0,0,0,0,0,0,0,0,0,0,0,0,0,0,0,1,0,1,0,0,0,0,0,0,0,0,0
117140,31000,310,0,-2,9,4,5,0,0,0,0,0,0,0,0,0,5,3,2,0,0,0,1,1,0,1,0,1,2,0,2,0,0,0
117168,31000,310,0,-2,3,0,3,0,0,0,2,0,2,0,0,0,0,0,0,0,0,0,1,0,1,0,0,0,0,0,0,0,0,0
117195,31000,310,0,-2,1,0,1,0,0,0,0,0,0,0,0,0,0,0,0,0,0,0,1,0,1,0,0,0,0,0,0,0,0,0
117274,31000,310,0,-2,2,0,2,0,0,0,0,0,0,0,0,0,0,0,0,0,0,0,2,0,2,0,0,0,0,0,0,0,0,0
117520,31000,310,0,-2,1,1,0,0,0,0,0,0,0,1,1,0,0,0,0,0,0,0,0,0,0,0,0,0,0,0,0,0,0,0
117627,31000,310,0,-2,3,3,0,0,0,0,0,0,0,0,0,0,1,1,0,1,1,0,0,0,0,0,0,0,0,0,0,1,1,0
117636,31000,310,0,-2,3,0,3,0,0,0,0,0,0,0,0,0,3,0,3,0,0,0,0,0,0,0,0,0,0,0,0,0,0,0
117645,31000,310,0,-2,3,2,1,0,0,0,0,0,0,1,1,0,1,1,0,0,0,0,1,0,1,0,0,0,0,0,0,0,0,0
117672,31000,310,0,-2,5,2,3,0,0,0,0,0,0,0,0,0,2,2,0,0,0,0,3,0,3,0,0,0,0,0,0,0,0,0
117681,31000,310,0,-2,23,10,13,0,0,0,2,1,1,3,0,3,3,1,2,0,0,0,1,0,1,0,0,0,14,8,6,0,0,0
117690,31000,310,0,-2,2,1,1,0,0,0,0,0,0,1,1,0,0,0,0,0,0,0,0,0,0,0,0,0,1,0,1,0,0,0
117706,31000,310,0,-2,1,0,1,0,0,0,0,0,0,0,0,0,0,0,0,0,0,0,1,0,1,0,0,0,0,0,0,0,0,0
117733,31000,310,0,-2,4,2,2,0,0,0,1,0,1,0,0,0,1,1,0,0,0,0,1,0,1,0,0,0,1,1,0,0,0,0
117788,31000,310,0,-2,2,1,1,0,0,0,0,0,0,1,1,0,0,0,0,0,0,0,0,0,0,0,0,0,1,0,1,0,0,0
117867,31000,310,0,-2,1,1,0,0,0,0,0,0,0,0,0,0,0,0,0,0,0,0,1,1,0,0,0,0,0,0,0,0,0,0
117900,31000,310,0,-2,2,1,1,0,0,0,0,0,0,0,0,0,2,1,1,0,0,0,0,0,0,0,0,0,0,0,0,0,0,0
117946,31000,310,0,-2,36,10,26,0,0,0,1,0,1,9,5,4,8,0,8,0,0,0,11,4,7,0,0,0,7,1,6,0,0,0
118347,31000,310,0,-2,1,0,1,0,0,0,0,0,0,0,0,0,0,0,0,0,0,0,0,0,0,0,0,0,1,0,1,0,0,0
118693,31000,310,0,-2,3,1,2,0,0,0,2,0,2,0,0,0,1,1,0,0,0,0,0,0,0,0,0,0,0,0,0,0,0,0
118718,31000,310,0,-2,1,0,1,0,0,0,1,0,1,0,0,0,0,0,0,0,0,0,0,0,0,0,0,0,0,0,0,0,0,0
118888,31000,310,0,-2,6,1,5,0,0,0,3,0,3,2,1,1,0,0,0,0,0,0,0,0,0,1,0,1,0,0,0,0,0,0
118912,31000,310,0,-2,1,0,1,0,0,0,0,0,0,0,0,0,0,0,0,0,0,0,1,0,1,0,0,0,0,0,0,0,0,0
118976,31000,310,0,-2,8,5,3,0,0,0,0,0,0,0,0,0,1,1,0,1,1,0,6,3,3,0,0,0,0,0,0,0,0,0
119058,31000,310,0,-2,2,0,2,0,0,0,1,0,1,0,0,0,0,0,0,0,0,0,1,0,1,0,0,0,0,0,0,0,0,0
119067,31000,310,0,-2,3,2,1,0,0,0,0,0,0,0,0,0,3,2,1,0,0,0,0,0,0,0,0,0,0,0,0,0,0,0
119137,31000,310,0,-2,2,1,1,0,0,0,0,0,0,0,0,0,1,0,1,0,0,0,1,1,0,0,0,0,0,0,0,0,0,0
119164,31000,310,0,-2,5,3,2,1,0,1,1,0,1,0,0,0,0,0,0,0,0,0,2,2,0,0,0,0,1,1,0,0,0,0
119173,31000,310,0,-2,1,0,1,0,0,0,0,0,0,0,0,0,1,0,1,0,0,0,0,0,0,0,0,0,0,0,0,0,0,0
119216,31000,310,0,-2,3,0,3,1,0,1,1,0,1,1,0,1,0,0,0,0,0,0,0,0,0,0,0,0,0,0,0,0,0,0
119331,31000,310,0,-2,2,1,1,0,0,0,0,0,0,0,0,0,1,0,1,0,0,0,1,1,0,0,0,0,0,0,0,0,0,0
119605,31000,310,0,-2,26,9,17,0,0,0,2,1,1,0,0,0,3,1,2,0,0,0,15,6,9,2,0,2,4,1,3,0,0,0
119678,31000,310,0,-2,17,6,11,0,0,0,2,1,1,2,1,1,3,1,2,1,1,0,9,2,7,0,0,0,0,0,0,0,0,0
120078,31000,310,0,-2,5,0,5,0,0,0,1,0,1,0,0,0,2,0,2,0,0,0,0,0,0,0,0,0,2,0,2,0,0,0
120166,31000,310,0,-2,1,1,0,0,0,0,1,1,0,0,0,0,0,0,0,0,0,0,0,0,0,0,0,0,0,0,0,0,0,0
120184,31000,310,0,-2,1,1,0,0,0,0,0,0,0,0,0,0,0,0,0,0,0,0,1,1,0,0,0,0,0,0,0,0,0,0
120254,31000,310,0,-2,4,3,1,0,0,0,1,1,0,0,0,0,1,1,0,0,0,0,1,1,0,0,0,0,0,0,0,1,0,1
120342,31000,310,0,-2,1,1,0,0,0,0,0,0,0,0,0,0,1,1,0,0,0,0,0,0,0,0,0,0,0,0,0,0,0,0
120403,31000,310,0,-2,3,3,0,0,0,0,1,1,0,0,0,0,0,0,0,0,0,0,0,0,0,2,2,0,0,0,0,0,0,0
120537,31000,310,0,-2,1,0,1,0,0,0,0,0,0,0,0,0,0,0,0,0,0,0,1,0,1,0,0,0,0,0,0,0,0,0
120698,31000,310,0,-2,1,0,1,0,0,0,0,0,0,0,0,0,1,0,1,0,0,0,0,0,0,0,0,0,0,0,0,0,0,0
120865,31000,310,0,-2,1,0,1,0,0,0,0,0,0,0,0,0,0,0,0,0,0,0,1,0,1,0,0,0,0,0,0,0,0,0
120883,31000,310,0,-2,2,2,0,0,0,0,0,0,0,0,0,0,0,0,0,0,0,0,2,2,0,0,0,0,0,0,0,0,0,0
121044,31000,310,0,-2,1,0,1,0,0,0,0,0,0,0,0,0,0,0,0,0,0,0,0,0,0,1,0,1,0,0,0,0,0,0
121150,31000,310,0,-2,11,2,9,0,0,0,0,0,0,2,1,1,0,0,0,0,0,0,8,1,7,0,0,0,1,0,1,0,0,0
121178,31000,310,0,-2,1,0,1,0,0,0,0,0,0,0,0,0,1,0,1,0,0,0,0,0,0,0,0,0,0,0,0,0,0,0
121257,31000,310,0,-2,10,2,8,0,0,0,1,1,0,0,0,0,4,0,4,0,0,0,2,0,2,1,0,1,2,1,1,0,0,0
121345,31000,310,0,-2,6,1,5,0,0,0,1,0,1,0,0,0,2,0,2,0,0,0,1,0,1,0,0,0,2,1,1,0,0,0
121363,31000,310,0,-2,1,1,0,0,0,0,0,0,0,0,0,0,1,1,0,0,0,0,0,0,0,0,0,0,0,0,0,0,0,0
121691,31000,310,0,-2,3,1,2,0,0,0,0,0,0,0,0,0,2,0,2,0,0,0,1,1,0,0,0,0,0,0,0,0,0,0
121707,31000,310,0,-2,1,0,1,0,0,0,0,0,0,0,0,0,0,0,0,0,0,0,1,0,1,0,0,0,0,0,0,0,0,0
121886,31000,310,0,-2,2,0,2,0,0,0,2,0,2,0,0,0,0,0,0,0,0,0,0,0,0,0,0,0,0,0,0,0,0,0
122205,31000,310,0,-2,1,1,0,0,0,0,0,0,0,0,0,0,0,0,0,0,0,0,1,1,0,0,0,0,0,0,0,0,0,0
122296,31000,310,0,-2,3,1,2,0,0,0,0,0,0,0,0,0,1,0,1,0,0,0,0,0,0,0,0,0,2,1,1,0,0,0
122320,31000,310,0,-2,1,0,1,0,0,0,1,0,1,0,0,0,0,0,0,0,0,0,0,0,0,0,0,0,0,0,0,0,0,0
122409,31000,310,0,-2,30,13,17,1,0,1,0,0,0,4,2,2,12,4,8,0,0,0,11,5,6,1,1,0,1,1,0,0,0,0
122436,31000,310,0,-2,16,8,8,0,0,0,1,1,0,3,1,2,4,1,3,1,1,0,5,3,2,0,0,0,2,1,1,0,0,0
122506,31000,310,0,-2,3,0,3,0,0,0,0,0,0,0,0,0,0,0,0,0,0,0,3,0,3,0,0,0,0,0,0,0,0,0
122597,31000,310,0,-2,29,15,14,0,0,0,5,2,3,3,1,2,8,3,5,0,0,0,11,7,4,0,0,0,2,2,0,0,0,0
122612,31000,310,0,-2,14,4,10,0,0,0,2,0,2,1,0,1,2,0,2,0,0,0,7,2,5,1,1,0,1,1,0,0,0,0
122728,31000,310,0,-2,4,2,2,0,0,0,1,0,1,0,0,0,0,0,0,0,0,0,3,2,1,0,0,0,0,0,0,0,0,0
122737,31000,310,0,-2,2,1,1,0,0,0,0,0,0,0,0,0,2,1,1,0,0,0,0,0,0,0,0,0,0,0,0,0,0,0
122755,31000,310,0,-2,39,12,27,0,0,0,10,2,8,0,0,0,10,1,9,0,0,0,14,7,7,2,0,2,3,2,1,0,0,0
122782,31000,310,0,-2,3,1,2,0,0,0,2,1,1,0,0,0,1,0,1,0,0,0,0,0,0,0,0,0,0,0,0,0,0,0
122889,31000,310,0,-2,2,1,1,0,0,0,1,1,0,0,0,0,1,0,1,0,0,0,0,0,0,0,0,0,0,0,0,0,0,0
122931,31000,310,0,-2,7,1,6,0,0,0,3,1,2,0,0,0,0,0,0,0,0,0,4,0,4,0,0,0,0,0,0,0,0,0
123165,31000,310,0,-2,2,1,1,0,0,0,0,0,0,0,0,0,1,1,0,0,0,0,1,0,1,0,0,0,0,0,0,0,0,0
123457,31000,310,0,-2,2,1,1,0,0,0,0,0,0,0,0,0,0,0,0,0,0,0,2,1,1,0,0,0,0,0,0,0,0,0
123484,31000,310,0,-2,1,1,0,0,0,0,0,0,0,0,0,0,0,0,0,0,0,0,1,1,0,0,0,0,0,0,0,0,0,0
123509,31000,310,0,-2,1,0,1,0,0,0,0,0,0,0,0,0,0,0,0,0,0,0,1,0,1,0,0,0,0,0,0,0,0,0
123554,31000,310,0,-2,7,3,4,0,0,0,0,0,0,1,0,1,1,0,1,0,0,0,1,1,0,1,1,0,3,1,2,0,0,0
123563,31000,310,0,-2,4,1,3,0,0,0,0,0,0,1,0,1,1,1,0,0,0,0,2,0,2,0,0,0,0,0,0,0,0,0
123572,31000,310,0,-2,5,1,4,0,0,0,1,1,0,0,0,0,0,0,0,0,0,0,4,0,4,0,0,0,0,0,0,0,0,0
123651,31000,310,0,-2,4,1,3,0,0,0,0,0,0,0,0,0,1,0,1,0,0,0,3,1,2,0,0,0,0,0,0,0,0,0
123800,31000,310,0,-2,6,3,3,0,0,0,1,1,0,1,1,0,2,1,1,0,0,0,1,0,1,0,0,0,1,0,1,0,0,0
123943,31000,310,0,-2,3,0,3,0,0,0,1,0,1,0,0,0,1,0,1,0,0,0,1,0,1,0,0,0,0,0,0,0,0,0
123961,31000,310,0,-2,223,71,152,1,0,1,36,9,27,25,11,14,69,23,46,0,0,0,71,22,49,13,3,10,3,0,3,5,3,2
124292,31000,310,0,-2,2,1,1,0,0,0,0,0,0,0,0,0,0,0,0,0,0,0,2,1,1,0,0,0,0,0,0,0,0,0
124557,31000,310,0,-2,48,14,34,0,0,0,9,3,6,4,0,4,9,4,5,0,0,0,22,7,15,0,0,0,1,0,1,3,0,3
125019,31000,310,0,-2,1,0,1,0,0,0,0,0,0,0,0,0,1,0,1,0,0,0,0,0,0,0,0,0,0,0,0,0,0,0
125170,31000,310,0,-2,1,1,0,0,0,0,0,0,0,0,0,0,0,0,0,0,0,0,1,1,0,0,0,0,0,0,0,0,0,0
125231,31000,310,0,-2,22,7,15,0,0,0,0,0,0,5,1,4,1,1,0,0,0,0,12,5,7,2,0,2,2,0,2,0,0,0
125471,31000,310,0,-2,1,0,1,0,0,0,1,0,1,0,0,0,0,0,0,0,0,0,0,0,0,0,0,0,0,0,0,0,0,0
125499,31000,310,0,-2,1,0,1,0,0,0,1,0,1,0,0,0,0,0,0,0,0,0,0,0,0,0,0,0,0,0,0,0,0,0
125727,31000,310,0,-2,2,1,1,0,0,0,0,0,0,0,0,0,1,0,1,0,0,0,0,0,0,0,0,0,1,1,0,0,0,0
125763,31000,310,0,-2,5,1,4,0,0,0,0,0,0,0,0,0,3,0,3,0,0,0,2,1,1,0,0,0,0,0,0,0,0,0
126049,31000,310,0,-2,1,0,1,0,0,0,0,0,0,0,0,0,0,0,0,0,0,0,1,0,1,0,0,0,0,0,0,0,0,0
126100,31000,310,0,-2,5,3,2,0,0,0,0,0,0,0,0,0,3,2,1,0,0,0,2,1,1,0,0,0,0,0,0,0,0,0
126182,31000,310,0,-2,3,1,2,0,0,0,0,0,0,0,0,0,1,0,1,0,0,0,2,1,1,0,0,0,0,0,0,0,0,0
126207,31000,310,0,-2,4,0,4,0,0,0,0,0,0,0,0,0,0,0,0,0,0,0,3,0,3,1,0,1,0,0,0,0,0,0
126289,31000,310,0,-2,3,0,3,0,0,0,1,0,1,0,0,0,1,0,1,0,0,0,1,0,1,0,0,0,0,0,0,0,0,0
126562,31000,310,0,-2,160,40,120,0,0,0,11,2,9,12,2,10,19,2,17,0,0,0,105,32,73,0,0,0,11,2,9,2,0,2
126580,31000,310,0,-2,18,4,14,0,0,0,0,0,0,1,0,1,5,1,4,0,0,0,9,2,7,2,1,1,1,0,1,0,0,0
126614,31000,310,0,-2,43,12,31,1,0,1,1,0,1,4,1,3,2,0,2,0,0,0,32,8,24,1,1,0,1,1,0,1,1,0
126669,31000,310,0,-2,2,1,1,0,0,0,0,0,0,0,0,0,0,0,0,0,0,0,2,1,1,0,0,0,0,0,0,0,0,0
126678,31000,310,0,-2,3,0,3,0,0,0,1,0,1,0,0,0,0,0,0,0,0,0,2,0,2,0,0,0,0,0,0,0,0,0
126711,31000,310,0,-2,5,3,2,0,0,0,0,0,0,0,0,0,0,0,0,0,0,0,3,2,1,0,0,0,1,1,0,1,0,1
126748,31000,310,0,-2,2,0,2,0,0,0,0,0,0,0,0,0,0,0,0,0,0,0,2,0,2,0,0,0,0,0,0,0,0,0
126775,31000,310,0,-2,29,11,18,0,0,0,1,1,0,1,0,1,4,2,2,0,0,0,21,6,15,1,1,0,1,1,0,0,0,0
126818,31000,310,0,-2,38,7,31,0,0,0,1,0,1,0,0,0,7,2,5,0,0,0,28,5,23,1,0,1,1,0,1,0,0,0
126827,31000,310,0,-2,3,1,2,0,0,0,0,0,0,0,0,0,0,0,0,0,0,0,2,1,1,0,0,0,1,0,1,0,0,0
126863,31000,310,0,-2,3,1,2,0,0,0,2,1,1,0,0,0,0,0,0,0,0,0,1,0,1,0,0,0,0,0,0,0,0,0
126942,31000,310,0,-2,6,2,4,0,0,0,1,0,1,1,0,1,0,0,0,0,0,0,4,2,2,0,0,0,0,0,0,0,0,0
127060,31000,310,0,-2,106,32,74,10,0,10,5,0,5,3,0,3,15,7,8,0,0,0,36,11,25,35,14,21,2,0,2,0,0,0
127185,31000,310,0,-2,4,2,2,1,0,1,0,0,0,0,0,0,0,0,0,0,0,0,3,2,1,0,0,0,0,0,0,0,0,0
127200,31000,310,0,-2,7,2,5,0,0,0,1,0,1,0,0,0,1,0,1,0,0,0,4,2,2,0,0,0,1,0,1,0,0,0
127273,31000,310,0,-2,3,0,3,0,0,0,0,0,0,0,0,0,0,0,0,0,0,0,3,0,3,0,0,0,0,0,0,0,0,0
127556,31000,310,0,-2,3,1,2,0,0,0,0,0,0,0,0,0,0,0,0,0,0,0,3,1,2,0,0,0,0,0,0,0,0,0
127565,31000,310,0,-2,10,4,6,0,0,0,0,0,0,3,2,1,1,0,1,0,0,0,4,1,3,2,1,1,0,0,0,0,0,0
127653,31000,310,0,-2,4,0,4,0,0,0,0,0,0,0,0,0,1,0,1,0,0,0,1,0,1,0,0,0,2,0,2,0,0,0
127732,31000,310,0,-2,3,1,2,0,0,0,0,0,0,0,0,0,1,1,0,0,0,0,2,0,2,0,0,0,0,0,0,0,0,0
127741,31000,310,0,-2,32,12,20,0,0,0,1,1,0,1,0,1,5,2,3,0,0,0,24,9,15,1,0,1,0,0,0,0,0,0
127778,31000,310,0,-2,3,0,3,0,0,0,0,0,0,0,0,0,1,0,1,0,0,0,2,0,2,0,0,0,0,0,0,0,0,0
127820,31000,310,0,-2,3,2,1,0,0,0,0,0,0,0,0,0,0,0,0,0,0,0,3,2,1,0,0,0,0,0,0,0,0,0
127884,31000,310,0,-2,1,0,1,0,0,0,0,0,0,0,0,0,1,0,1,0,0,0,0,0,0,0,0,0,0,0,0,0,0,0
127909,31000,310,0,-2,5,0,5,0,0,0,1,0,1,0,0,0,0,0,0,0,0,0,4,0,4,0,0,0,0,0,0,0,0,0
127918,31000,310,0,-2,3,1,2,0,0,0,0,0,0,0,0,0,0,0,0,0,0,0,2,1,1,1,0,1,0,0,0,0,0,0
127945,31000,310,0,-2,7,3,4,0,0,0,0,0,0,0,0,0,0,0,0,1,1,0,5,1,4,0,0,0,1,1,0,0,0,0
128106,31000,310,0,-2,7,2,5,0,0,0,0,0,0,0,0,0,1,0,1,0,0,0,5,2,3,0,0,0,1,0,1,0,0,0
128179,31000,310,0,-2,3,0,3,0,0,0,0,0,0,0,0,0,1,0,1,0,0,0,2,0,2,0,0,0,0,0,0,0,0,0
128188,31000,310,0,-2,3,0,3,0,0,0,0,0,0,0,0,0,0,0,0,0,0,0,3,0,3,0,0,0,0,0,0,0,0,0
128300,31000,310,0,-2,19,5,14,1,0,1,0,0,0,0,0,0,2,0,2,0,0,0,16,5,11,0,0,0,0,0,0,0,0,0
128328,31000,310,0,-2,1,0,1,0,0,0,0,0,0,0,0,0,0,0,0,0,0,0,1,0,1,0,0,0,0,0,0,0,0,0
128391,31000,310,0,-2,6,2,4,0,0,0,0,0,0,0,0,0,1,1,0,0,0,0,5,1,4,0,0,0,0,0,0,0,0,0
128498,31000,310,0,-2,4,1,3,0,0,0,0,0,0,0,0,0,0,0,0,0,0,0,3,1,2,0,0,0,1,0,1,0,0,0
128744,31000,310,0,-2,14,4,10,0,0,0,1,1,0,3,1,2,1,0,1,0,0,0,8,2,6,0,0,0,1,0,1,0,0,0
128771,31000,310,0,-2,3,1,2,0,0,0,0,0,0,0,0,0,0,0,0,0,0,0,3,1,2,0,0,0,0,0,0,0,0,0
129020,31000,310,0,-2,31,7,24,0,0,0,1,0,1,6,2,4,2,0,2,0,0,0,17,3,14,1,0,1,4,2,2,0,0,0
129154,31000,310,0,-2,4,2,2,0,0,0,0,0,0,1,0,1,0,0,0,0,0,0,3,2,1,0,0,0,0,0,0,0,0,0
129215,31000,310,0,-2,2,0,2,0,0,0,0,0,0,0,0,0,0,0,0,0,0,0,2,0,2,0,0,0,0,0,0,0,0,0
129242,31000,310,0,-2,1,0,1,0,0,0,1,0,1,0,0,0,0,0,0,0,0,0,0,0,0,0,0,0,0,0,0,0,0,0
129525,31000,310,0,-2,42,13,29,0,0,0,0,0,0,10,5,5,2,0,2,0,0,0,29,8,21,1,0,1,0,0,0,0,0,0
129695,31000,310,0,-2,1,0,1,0,0,0,0,0,0,0,0,0,0,0,0,0,0,0,1,0,1,0,0,0,0,0,0,0,0,0
129941,31000,310,0,-2,4,2,2,0,0,0,0,0,0,1,0,1,0,0,0,0,0,0,3,2,1,0,0,0,0,0,0,0,0,0
130110,31000,310,0,-2,3,0,3,0,0,0,0,0,0,1,0,1,0,0,0,0,0,0,2,0,2,0,0,0,0,0,0,0,0,0
130183,31000,310,0,-2,25,8,17,0,0,0,1,1,0,4,1,3,10,3,7,0,0,0,10,3,7,0,0,0,0,0,0,0,0,0
130253,31000,310,0,-2,7,2,5,0,0,0,0,0,0,0,0,0,2,0,2,0,0,0,1,0,1,0,0,0,4,2,2,0,0,0
130314,31000,310,0,-2,3,0,3,0,0,0,0,0,0,2,0,2,0,0,0,0,0,0,1,0,1,0,0,0,0,0,0,0,0,0
130396,31000,310,0,-2,1,0,1,0,0,0,0,0,0,0,0,0,0,0,0,0,0,0,1,0,1,0,0,0,0,0,0,0,0,0
130493,31000,310,0,-2,3,2,1,0,0,0,0,0,0,0,0,0,0,0,0,0,0,0,3,2,1,0,0,0,0,0,0,0,0,0
130590,31000,310,0,-2,1,0,1,0,0,0,0,0,0,0,0,0,0,0,0,0,0,0,1,0,1,0,0,0,0,0,0,0,0,0
130624,31000,310,0,-2,36,27,9,0,0,0,3,3,0,2,2,0,0,0,0,0,0,0,13,9,4,1,0,1,17,13,4,0,0,0
130697,31000,310,0,-2,5,4,1,0,0,0,0,0,0,0,0,0,0,0,0,0,0,0,3,3,0,0,0,0,1,0,1,1,1,0
130776,31000,310,0,-2,2,1,1,0,0,0,1,1,0,0,0,0,0,0,0,0,0,0,1,0,1,0,0,0,0,0,0,0,0,0
130794,31000,310,0,-2,28,9,19,0,0,0,1,1,0,3,1,2,5,3,2,0,0,0,16,4,12,2,0,2,1,0,1,0,0,0
130882,31000,310,0,-2,2,0,2,0,0,0,0,0,0,2,0,2,0,0,0,0,0,0,0,0,0,0,0,0,0,0,0,0,0,0
130907,31000,310,0,-2,3,2,1,0,0,0,0,0,0,1,0,1,0,0,0,0,0,0,2,2,0,0,0,0,0,0,0,0,0,0
130934,31000,310,0,-2,22,7,15,0,0,0,0,0,0,12,4,8,0,0,0,0,0,0,10,3,7,0,0,0,0,0,0,0,0,0
130943,31000,310,0,-2,41,5,36,0,0,0,0,0,0,7,1,6,1,1,0,0,0,0,33,3,30,0,0,0,0,0,0,0,0,0
131113,31000,310,0,-2,1,0,1,0,0,0,0,0,0,0,0,0,0,0,0,0,0,0,1,0,1,0,0,0,0,0,0,0,0,0
131159,31000,310,0,-2,39,10,29,1,1,0,2,0,2,10,2,8,1,1,0,0,0,0,22,5,17,0,0,0,1,0,1,2,1,1
131283,31000,310,0,-2,8,4,4,0,0,0,1,1,0,0,0,0,1,1,0,0,0,0,6,2,4,0,0,0,0,0,0,0,0,0
131399,31000,310,0,-2,3,2,1,0,0,0,0,0,0,3,2,1,0,0,0,0,0,0,0,0,0,0,0,0,0,0,0,0,0,0
131450,31000,310,0,-2,12,6,6,0,0,0,3,2,1,1,0,1,2,1,1,0,0,0,5,3,2,1,0,1,0,0,0,0,0,0
131469,31000,310,0,-2,26,9,17,0,0,0,7,3,4,4,1,3,3,2,1,0,0,0,12,3,9,0,0,0,0,0,0,0,0,0
131496,31000,310,0,-2,14,4,10,0,0,0,2,1,1,1,0,1,1,0,1,0,0,0,8,3,5,1,0,1,0,0,0,1,0,1
131520,31000,310,0,-2,1,0,1,0,0,0,0,0,0,1,0,1,0,0,0,0,0,0,0,0,0,0,0,0,0,0,0,0,0,0
131803,31000,310,0,-2,17,3,14,0,0,0,2,0,2,3,0,3,1,0,1,0,0,0,7,2,5,1,1,0,3,0,3,0,0,0
131876,31000,310,0,-2,2,0,2,0,0,0,0,0,0,2,0,2,0,0,0,0,0,0,0,0,0,0,0,0,0,0,0,0,0,0
131973,31000,310,0,-2,3,0,3,0,0,0,1,0,1,1,0,1,0,0,0,0,0,0,1,0,1,0,0,0,0,0,0,0,0,0
132602,31000,310,0,-2,6,2,4,0,0,0,0,0,0,4,0,4,0,0,0,0,0,0,2,2,0,0,0,0,0,0,0,0,0,0
132657,31000,310,0,-2,8,2,6,0,0,0,0,0,0,1,0,1,1,0,1,0,0,0,4,2,2,0,0,0,2,0,2,0,0,0
132709,31000,310,0,-2,4,1,3,0,0,0,0,0,0,0,0,0,2,0,2,0,0,0,1,1,0,0,0,0,1,0,1,0,0,0
132851,31000,310,0,-2,8,2,6,0,0,0,0,0,0,0,0,0,3,1,2,0,0,0,5,1,4,0,0,0,0,0,0,0,0,0
132903,31000,310,0,-2,8,0,8,0,0,0,0,0,0,0,0,0,4,0,4,0,0,0,4,0,4,0,0,0,0,0,0,0,0,0
133386,31000,310,0,-2,8,1,7,0,0,0,0,0,0,1,0,1,0,0,0,0,0,0,7,1,6,0,0,0,0,0,0,0,0,0
133465,31000,310,0,-2,1,0,1,0,0,0,0,0,0,0,0,0,0,0,0,0,0,0,1,0,1,0,0,0,0,0,0,0,0,0
133492,31000,310,0,-2,5,1,4,0,0,0,0,0,0,2,0,2,0,0,0,0,0,0,3,1,2,0,0,0,0,0,0,0,0,0
133508,31000,310,0,-2,6,1,5,0,0,0,0,0,0,1,0,1,0,0,0,0,0,0,4,0,4,0,0,0,1,1,0,0,0,0
133526,31000,310,0,-2,2,0,2,0,0,0,0,0,0,2,0,2,0,0,0,0,0,0,0,0,0,0,0,0,0,0,0,0,0,0
133553,31000,310,0,-2,18,3,15,0,0,0,0,0,0,1,1,0,5,0,5,0,0,0,12,2,10,0,0,0,0,0,0,0,0,0
133650,31000,310,0,-2,7,2,5,0,0,0,0,0,0,6,1,5,0,0,0,0,0,0,1,1,0,0,0,0,0,0,0,0,0,0
133669,31000,310,0,-2,47,14,33,0,0,0,2,1,1,16,6,10,10,2,8,0,0,0,15,3,12,2,1,1,0,0,0,2,1,1
133702,31000,310,0,-2,7,2,5,0,0,0,0,0,0,2,0,2,0,0,0,0,0,0,3,0,3,1,1,0,0,0,0,1,1,0
133711,31000,310,0,-2,5,2,3,0,0,0,0,0,0,1,1,0,0,0,0,0,0,0,4,1,3,0,0,0,0,0,0,0,0,0
133809,31000,310,0,-2,3,0,3,0,0,0,0,0,0,0,0,0,0,0,0,0,0,0,3,0,3,0,0,0,0,0,0,0,0,0
133872,31000,310,0,-2,3,1,2,0,0,0,0,0,0,0,0,0,1,0,1,0,0,0,2,1,1,0,0,0,0,0,0,0,0,0
133881,31000,310,0,-2,10,3,7,0,0,0,1,0,1,2,1,1,1,0,1,0,0,0,5,2,3,1,0,1,0,0,0,0,0,0
134079,31000,310,0,-2,4,3,1,0,0,0,0,0,0,0,0,0,0,0,0,0,0,0,4,3,1,0,0,0,0,0,0,0,0,0
134097,31000,310,0,-2,54,11,43,0,0,0,1,0,1,9,2,7,8,1,7,0,0,0,34,8,26,2,0,2,0,0,0,0,0,0
134130,31000,310,0,-2,57,22,35,0,0,0,2,1,1,6,1,5,8,3,5,1,0,1,39,16,23,0,0,0,1,1,0,0,0,0
134237,31000,310,0,-2,3,2,1,0,0,0,0,0,0,0,0,0,0,0,0,0,0,0,3,2,1,0,0,0,0,0,0,0,0,0
134343,31000,310,0,-2,2,1,1,0,0,0,0,0,0,0,0,0,1,0,1,0,0,0,1,1,0,0,0,0,0,0,0,0,0,0
134495,31000,310,0,-2,2,0,2,0,0,0,0,0,0,2,0,2,0,0,0,0,0,0,0,0,0,0,0,0,0,0,0,0,0,0
134945,31000,310,0,-2,2,0,2,0,0,0,0,0,0,0,0,0,1,0,1,0,0,0,1,0,1,0,0,0,0,0,0,0,0,0
135081,31000,310,0,-2,19,7,12,0,0,0,2,1,1,4,1,3,4,2,2,1,0,1,6,2,4,2,1,1,0,0,0,0,0,0
135160,31000,310,0,-2,3,0,3,0,0,0,0,0,0,1,0,1,0,0,0,0,0,0,2,0,2,0,0,0,0,0,0,0,0,0
135188,31000,310,0,-2,5,1,4,0,0,0,0,0,0,2,1,1,1,0,1,0,0,0,1,0,1,0,0,0,1,0,1,0,0,0
135391,31000,310,0,-2,10,3,7,0,0,0,0,0,0,2,0,2,3,1,2,0,0,0,5,2,3,0,0,0,0,0,0,0,0,0
135717,31000,310,0,-2,5,0,5,0,0,0,0,0,0,0,0,0,4,0,4,0,0,0,0,0,0,1,0,1,0,0,0,0,0,0
135726,31000,310,0,-2,90,32,58,0,0,0,2,0,2,13,3,10,50,23,27,0,0,0,19,5,14,2,1,1,1,0,1,3,0,3
136172,31000,310,0,-2,14,6,8,0,0,0,0,0,0,1,0,1,0,0,0,0,0,0,12,6,6,1,0,1,0,0,0,0,0,0
136215,31000,310,0,-2,67,22,45,0,0,0,5,2,3,14,3,11,19,7,12,0,0,0,24,9,15,1,0,1,1,0,1,3,1,2
136233,31000,310,0,-2,2,1,1,0,0,0,0,0,0,0,0,0,0,0,0,0,0,0,2,1,1,0,0,0,0,0,0,0,0,0
136358,31000,310,0,-2,6,1,5,0,0,0,1,0,1,1,0,1,2,1,1,0,0,0,2,0,2,0,0,0,0,0,0,0,0,0
136400,31000,310,0,-2,1,0,1,0,0,0,0,0,0,0,0,0,0,0,0,0,0,0,1,0,1,0,0,0,0,0,0,0,0,0
136473,31000,310,0,-2,6,2,4,0,0,0,0,0,0,2,0,2,0,0,0,0,0,0,4,2,2,0,0,0,0,0,0,0,0,0
136701,31000,310,0,-2,1,0,1,0,0,0,0,0,0,0,0,0,0,0,0,0,0,0,1,0,1,0,0,0,0,0,0,0,0,0
136774,31000,310,0,-2,2,1,1,0,0,0,0,0,0,0,0,0,0,0,0,0,0,0,2,1,1,0,0,0,0,0,0,0,0,0
136950,31000,310,0,-2,11,5,6,0,0,0,0,0,0,1,0,1,2,1,1,1,0,1,7,4,3,0,0,0,0,0,0,0,0,0
137032,31000,310,0,-2,11,3,8,0,0,0,0,0,0,1,0,1,1,0,1,0,0,0,7,2,5,0,0,0,2,1,1,0,0,0
137078,31000,310,0,-2,4,1,3,0,0,0,0,0,0,0,0,0,0,0,0,0,0,0,3,1,2,0,0,0,1,0,1,0,0,0
137096,31000,310,0,-2,3,2,1,0,0,0,0,0,0,0,0,0,0,0,0,0,0,0,3,2,1,0,0,0,0,0,0,0,0,0
137209,31000,310,0,-2,3,0,3,0,0,0,0,0,0,0,0,0,1,0,1,0,0,0,2,0,2,0,0,0,0,0,0,0,0,0
137281,31000,310,0,-2,1,0,1,0,0,0,0,0,0,0,0,0,0,0,0,0,0,0,1,0,1,0,0,0,0,0,0,0,0,0
137351,31000,310,0,-2,94,27,67,0,0,0,5,2,3,15,5,10,4,1,3,0,0,0,53,17,36,13,2,11,0,0,0,4,0,4
137476,31000,310,0,-2,4,2,2,0,0,0,0,0,0,2,1,1,0,0,0,0,0,0,0,0,0,0,0,0,2,1,1,0,0,0
137546,31000,310,0,-2,18,5,13,0,0,0,1,0,1,3,0,3,4,2,2,0,0,0,9,3,6,0,0,0,1,0,1,0,0,0
137564,31000,310,0,-2,2,0,2,0,0,0,0,0,0,0,0,0,0,0,0,0,0,0,2,0,2,0,0,0,0,0,0,0,0,0
137759,31000,310,0,-2,8,3,5,0,0,0,0,0,0,4,2,2,1,0,1,0,0,0,2,1,1,0,0,0,0,0,0,1,0,1
137847,31000,310,0,-2,7,1,6,0,0,0,1,0,1,1,0,1,2,0,2,0,0,0,3,1,2,0,0,0,0,0,0,0,0,0
137962,31000,310,0,-2,1,1,0,0,0,0,0,0,0,0,0,0,0,0,0,0,0,0,1,1,0,0,0,0,0,0,0,0,0,0
138187,31000,310,0,-2,27,12,15,0,0,0,1,0,1,6,2,4,7,2,5,0,0,0,10,6,4,0,0,0,3,2,1,0,0,0
138275,31000,310,0,-2,1,0,1,0,0,0,0,0,0,0,0,0,0,0,0,0,0,0,1,0,1,0,0,0,0,0,0,0,0,0
138293,31000,310,0,-2,1,0,1,0,0,0,0,0,0,0,0,0,0,0,0,0,0,0,1,0,1,0,0,0,0,0,0,0,0,0
138309,31000,310,0,-2,1,1,0,0,0,0,0,0,0,0,0,0,0,0,0,0,0,0,1,1,0,0,0,0,0,0,0,0,0,0
138354,31000,310,0,-2,27,5,22,0,0,0,2,0,2,2,1,1,3,0,3,0,0,0,18,4,14,2,0,2,0,0,0,0,0,0
138600,31000,310,0,-2,3,0,3,0,0,0,0,0,0,2,0,2,0,0,0,0,0,0,0,0,0,0,0,0,1,0,1,0,0,0
138655,31000,310,0,-2,3,0,3,0,0,0,0,0,0,0,0,0,1,0,1,0,0,0,2,0,2,0,0,0,0,0,0,0,0,0
138682,31000,310,0,-2,3,0,3,0,0,0,0,0,0,2,0,2,0,0,0,0,0,0,1,0,1,0,0,0,0,0,0,0,0,0
138716,31000,310,0,-2,1,1,0,0,0,0,0,0,0,1,1,0,0,0,0,0,0,0,0,0,0,0,0,0,0,0,0,0,0,0
138840,31000,310,0,-2,4,0,4,0,0,0,0,0,0,4,0,4,0,0,0,0,0,0,0,0,0,0,0,0,0,0,0,0,0,0
138868,31000,310,0,-2,3,2,1,0,0,0,0,0,0,2,2,0,0,0,0,0,0,0,1,0,1,0,0,0,0,0,0,0,0,0
138901,31000,310,0,-2,1,1,0,0,0,0,0,0,0,1,1,0,0,0,0,0,0,0,0,0,0,0,0,0,0,0,0,0,0,0
138947,31000,310,0,-2,5,2,3,0,0,0,0,0,0,2,1,1,1,1,0,0,0,0,0,0,0,0,0,0,2,0,2,0,0,0
138956,31000,310,0,-2,1,0,1,0,0,0,0,0,0,1,0,1,0,0,0,0,0,0,0,0,0,0,0,0,0,0,0,0,0,0
139278,31000,310,0,-2,3,0,3,0,0,0,0,0,0,0,0,0,0,0,0,0,0,0,3,0,3,0,0,0,0,0,0,0,0,0
139311,31000,310,0,-2,1,0,1,0,0,0,0,0,0,1,0,1,0,0,0,0,0,0,0,0,0,0,0,0,0,0,0,0,0,0
139357,31000,310,0,-2,1,0,1,0,0,0,0,0,0,1,0,1,0,0,0,0,0,0,0,0,0,0,0,0,0,0,0,0,0,0
139366,31000,310,0,-2,1,0,1,0,0,0,0,0,0,0,0,0,0,0,0,0,0,0,1,0,1,0,0,0,0,0,0,0,0,0
139393,31000,310,0,-2,1,0,1,0,0,0,0,0,0,0,0,0,0,0,0,0,0,0,1,0,1,0,0,0,0,0,0,0,0,0
139579,31000,310,0,-2,1,0,1,0,0,0,0,0,0,1,0,1,0,0,0,0,0,0,0,0,0,0,0,0,0,0,0,0,0,0
139630,31000,310,0,-2,1,0,1,0,0,0,0,0,0,1,0,1,0,0,0,0,0,0,0,0,0,0,0,0,0,0,0,0,0,0
139658,31000,310,0,-2,153,33,120,0,0,0,14,3,11,81,20,61,7,1,6,0,0,0,42,8,34,2,1,1,0,0,0,7,0,7
139700,31000,310,0,-2,1,1,0,0,0,0,0,0,0,0,0,0,0,0,0,0,0,0,1,1,0,0,0,0,0,0,0,0,0,0
139719,31000,310,0,-2,2,0,2,0,0,0,0,0,0,1,0,1,0,0,0,0,0,0,1,0,1,0,0,0,0,0,0,0,0,0
139755,31000,310,0,-2,70,23,47,0,0,0,6,5,1,33,5,28,7,2,5,0,0,0,20,8,12,1,1,0,2,1,1,1,1,0
139764,31000,310,0,-2,2,1,1,0,0,0,0,0,0,0,0,0,0,0,0,0,0,0,2,1,1,0,0,0,0,0,0,0,0,0
139931,31000,310,0,-2,7,5,2,0,0,0,0,0,0,2,1,1,0,0,0,0,0,0,5,4,1,0,0,0,0,0,0,0,0,0
139940,31000,310,0,-2,7,2,5,0,0,0,1,1,0,4,1,3,0,0,0,0,0,0,2,0,2,0,0,0,0,0,0,0,0,0
139959,31000,310,0,-2,24,5,19,0,0,0,1,0,1,1,1,0,0,0,0,0,0,0,22,4,18,0,0,0,0,0,0,0,0,0
139986,31000,310,0,-2,16,0,16,0,0,0,0,0,0,7,0,7,1,0,1,0,0,0,8,0,8,0,0,0,0,0,0,0,0,0
140012,31000,310,0,-2,2,0,2,0,0,0,0,0,0,0,0,0,1,0,1,0,0,0,1,0,1,0,0,0,0,0,0,0,0,0
140146,31000,310,0,-2,5,0,5,0,0,0,0,0,0,5,0,5,0,0,0,0,0,0,0,0,0,0,0,0,0,0,0,0,0,0
140234,31000,310,0,-2,1,0,1,0,0,0,0,0,0,0,0,0,0,0,0,0,0,0,1,0,1,0,0,0,0,0,0,0,0,0
140243,31000,310,0,-2,2,0,2,0,0,0,0,0,0,1,0,1,0,0,0,0,0,0,1,0,1,0,0,0,0,0,0,0,0,0
140331,31000,310,0,-2,4,1,3,0,0,0,0,0,0,1,1,0,1,0,1,0,0,0,2,0,2,0,0,0,0,0,0,0,0,0
140447,31000,310,0,-2,3,2,1,0,0,0,0,0,0,1,0,1,0,0,0,0,0,0,2,2,0,0,0,0,0,0,0,0,0,0
140553,31000,310,0,-2,1,0,1,0,0,0,0,0,0,1,0,1,0,0,0,0,0,0,0,0,0,0,0,0,0,0,0,0,0,0
140562,31000,310,0,-2,27,11,16,0,0,0,0,0,0,27,11,16,0,0,0,0,0,0,0,0,0,0,0,0,0,0,0,0,0,0
140678,31000,310,0,-2,1,0,1,0,0,0,0,0,0,0,0,0,0,0,0,0,0,0,1,0,1,0,0,0,0,0,0,0,0,0
140696,31000,310,0,-2,1,0,1,0,0,0,0,0,0,0,0,0,1,0,1,0,0,0,0,0,0,0,0,0,0,0,0,0,0,0
140720,31000,310,0,-2,1,0,1,0,0,0,0,0,0,0,0,0,0,0,0,0,0,0,1,0,1,0,0,0,0,0,0,0,0,0
140818,31000,310,0,-2,1,1,0,0,0,0,0,0,0,0,0,0,0,0,0,0,0,0,1,1,0,0,0,0,0,0,0,0,0,0
140872,31000,310,0,-2,5,0,5,0,0,0,0,0,0,0,0,0,0,0,0,0,0,0,5,0,5,0,0,0,0,0,0,0,0,0
140951,31000,310,0,-2,11,4,7,0,0,0,0,0,0,0,0,0,0,0,0,0,0,0,10,4,6,0,0,0,1,0,1,0,0,0
140960,31000,310,0,-2,3,0,3,0,0,0,0,0,0,3,0,3,0,0,0,0,0,0,0,0,0,0,0,0,0,0,0,0,0,0
140988,31000,310,0,-2,6,1,5,0,0,0,0,0,0,1,1,0,0,0,0,0,0,0,5,0,5,0,0,0,0,0,0,0,0,0
141264,31000,310,0,-2,2,1,1,0,0,0,0,0,0,0,0,0,0,0,0,0,0,0,2,1,1,0,0,0,0,0,0,0,0,0
141325,31000,310,0,-2,1,0,1,0,0,0,0,0,0,0,0,0,0,0,0,0,0,0,1,0,1,0,0,0,0,0,0,0,0,0
141334,31000,310,0,-2,5,1,4,0,0,0,0,0,0,0,0,0,0,0,0,0,0,0,5,1,4,0,0,0,0,0,0,0,0,0
141361,31000,310,0,-2,3,0,3,0,0,0,0,0,0,0,0,0,0,0,0,0,0,0,3,0,3,0,0,0,0,0,0,0,0,0
141486,31000,310,0,-2,4,0,4,0,0,0,0,0,0,0,0,0,1,0,1,0,0,0,1,0,1,2,0,2,0,0,0,0,0,0
141574,31000,310,0,-2,11,0,11,0,0,0,5,0,5,0,0,0,1,0,1,3,0,3,2,0,2,0,0,0,0,0,0,0,0,0
141644,31000,310,0,-2,11,5,6,0,0,0,5,1,4,2,2,0,1,1,0,0,0,0,3,1,2,0,0,0,0,0,0,0,0,0
141802,31000,310,0,-2,1,1,0,0,0,0,0,0,0,0,0,0,0,0,0,1,1,0,0,0,0,0,0,0,0,0,0,0,0,0
141963,31000,310,0,-2,8,3,5,0,0,0,4,1,3,0,0,0,0,0,0,0,0,0,2,1,1,2,1,1,0,0,0,0,0,0
142115,31000,310,0,-2,48,19,29,0,0,0,0,0,0,1,1,0,4,0,4,0,0,0,38,17,21,2,0,2,1,1,0,2,0,2
142179,31000,310,0,-2,3,3,0,0,0,0,0,0,0,0,0,0,0,0,0,0,0,0,3,3,0,0,0,0,0,0,0,0,0,0
142276,31000,310,0,-2,3,2,1,0,0,0,0,0,0,0,0,0,0,0,0,0,0,0,3,2,1,0,0,0,0,0,0,0,0,0
142285,31000,310,0,-2,16,5,11,0,0,0,0,0,0,0,0,0,0,0,0,0,0,0,14,5,9,1,0,1,1,0,1,0,0,0
142294,31000,310,0,-2,2,0,2,0,0,0,0,0,0,0,0,0,0,0,0,0,0,0,2,0,2,0,0,0,0,0,0,0,0,0
142328,31000,310,0,-2,7,4,3,0,0,0,0,0,0,0,0,0,1,1,0,0,0,0,6,3,3,0,0,0,0,0,0,0,0,0
142443,31000,310,0,-2,7,2,5,0,0,0,0,0,0,0,0,0,1,0,1,0,0,0,5,2,3,0,0,0,0,0,0,1,0,1
142461,31000,310,0,-2,3,1,2,0,0,0,0,0,0,0,0,0,0,0,0,0,0,0,3,1,2,0,0,0,0,0,0,0,0,0
142522,31000,310,0,-2,3,2,1,0,0,0,0,0,0,0,0,0,0,0,0,0,0,0,2,2,0,0,0,0,1,0,1,0,0,0
142559,31000,310,0,-2,5,3,2,0,0,0,0,0,0,0,0,0,1,1,0,0,0,0,3,1,2,0,0,0,1,1,0,0,0,0
142832,31000,310,0,-2,5,0,5,0,0,0,1,0,1,2,0,2,0,0,0,0,0,0,1,0,1,0,0,0,1,0,1,0,0,0
143048,31000,310,0,-2,12,4,8,0,0,0,0,0,0,1,1,0,2,2,0,0,0,0,9,1,8,0,0,0,0,0,0,0,0,0
143084,31000,310,0,-2,2,1,1,0,0,0,0,0,0,0,0,0,0,0,0,0,0,0,2,1,1,0,0,0,0,0,0,0,0,0
143118,31000,310,0,-2,5,0,5,0,0,0,0,0,0,1,0,1,0,0,0,0,0,0,3,0,3,0,0,0,1,0,1,0,0,0
143215,31000,310,0,-2,4,2,2,0,0,0,0,0,0,1,0,1,0,0,0,0,0,0,3,2,1,0,0,0,0,0,0,0,0,0
143279,31000,310,0,-2,1,1,0,0,0,0,0,0,0,0,0,0,0,0,0,0,0,0,1,1,0,0,0,0,0,0,0,0,0,0
143288,31000,310,0,-2,1,0,1,0,0,0,0,0,0,0,0,0,0,0,0,0,0,0,1,0,1,0,0,0,0,0,0,0,0,0
143358,31000,310,0,-2,19,7,12,0,0,0,1,0,1,1,0,1,0,0,0,0,0,0,17,7,10,0,0,0,0,0,0,0,0,0
143659,31000,310,0,-2,1,0,1,0,0,0,0,0,0,0,0,0,0,0,0,0,0,0,1,0,1,0,0,0,0,0,0,0,0,0
144005,31000,310,0,-2,3,1,2,0,0,0,1,0,1,2,1,1,0,0,0,0,0,0,0,0,0,0,0,0,0,0,0,0,0,0
144050,31000,310,0,-2,109,30,79,0,0,0,10,4,6,18,4,14,12,1,11,0,0,0,63,19,44,1,0,1,3,0,3,2,2,0
144175,31000,310,0,-2,1,0,1,0,0,0,0,0,0,0,0,0,0,0,0,0,0,0,1,0,1,0,0,0,0,0,0,0,0,0
144184,31000,310,0,-2,3,0,3,0,0,0,0,0,0,1,0,1,2,0,2,0,0,0,0,0,0,0,0,0,0,0,0,0,0,0
144209,31000,310,0,-2,1,0,1,0,0,0,0,0,0,1,0,1,0,0,0,0,0,0,0,0,0,0,0,0,0,0,0,0,0,0
144281,31000,310,0,-2,2,1,1,0,0,0,0,0,0,0,0,0,0,0,0,0,0,0,1,1,0,0,0,0,1,0,1,0,0,0
144351,31000,310,0,-2,2,0,2,0,0,0,0,0,0,0,0,0,0,0,0,0,0,0,2,0,2,0,0,0,0,0,0,0,0,0
144500,31000,310,0,-2,6,3,3,0,0,0,1,1,0,4,1,3,0,0,0,0,0,0,1,1,0,0,0,0,0,0,0,0,0,0
144564,31000,310,0,-2,2,0,2,0,0,0,0,0,0,0,0,0,0,0,0,0,0,0,1,0,1,1,0,1,0,0,0,0,0,0
144740,31000,310,0,-2,14,5,9,0,0,0,2,1,1,2,1,1,2,0,2,0,0,0,7,2,5,0,0,0,1,1,0,0,0,0
144777,31000,310,0,-2,13,1,12,0,0,0,1,0,1,2,0,2,0,0,0,0,0,0,10,1,9,0,0,0,0,0,0,0,0,0
144865,31000,310,0,-2,5,1,4,0,0,0,0,0,0,1,0,1,3,1,2,0,0,0,1,0,1,0,0,0,0,0,0,0,0,0
144892,31000,310,0,-2,4,1,3,0,0,0,0,0,0,0,0,0,0,0,0,0,0,0,4,1,3,0,0,0,0,0,0,0,0,0
144944,31000,310,0,-2,2,2,0,0,0,0,0,0,0,0,0,0,0,0,0,0,0,0,2,2,0,0,0,0,0,0,0,0,0,0
144962,31000,310,0,-2,3,1,2,0,0,0,0,0,0,0,0,0,0,0,0,0,0,0,2,1,1,0,0,0,1,0,1,0,0,0
144971,31000,310,0,-2,3,0,3,0,0,0,0,0,0,0,0,0,0,0,0,0,0,0,3,0,3,0,0,0,0,0,0,0,0,0
145275,31000,310,0,-2,3,0,3,0,0,0,0,0,0,3,0,3,0,0,0,0,0,0,0,0,0,0,0,0,0,0,0,0,0,0
145336,31000,310,0,-2,9,1,8,0,0,0,0,0,0,4,1,3,1,0,1,0,0,0,3,0,3,0,0,0,1,0,1,0,0,0
145372,31000,310,0,-2,4,1,3,0,0,0,1,0,1,1,0,1,0,0,0,0,0,0,2,1,1,0,0,0,0,0,0,0,0,0
145497,31000,310,0,-2,1,0,1,0,0,0,0,0,0,0,0,0,0,0,0,0,0,0,1,0,1,0,0,0,0,0,0,0,0,0
145558,31000,310,0,-2,3,2,1,0,0,0,1,1,0,0,0,0,0,0,0,0,0,0,2,1,1,0,0,0,0,0,0,0,0,0
145600,31000,310,0,-2,55,17,38,0,0,0,3,0,3,8,4,4,11,1,10,0,0,0,24,8,16,3,1,2,2,2,0,4,1,3
145619,31000,310,0,-2,2,1,1,0,0,0,0,0,0,0,0,0,0,0,0,0,0,0,2,1,1,0,0,0,0,0,0,0,0,0
145628,31000,310,0,-2,2,0,2,0,0,0,0,0,0,1,0,1,0,0,0,0,0,0,1,0,1,0,0,0,0,0,0,0,0,0
145637,31000,310,0,-2,33,8,25,0,0,0,3,0,3,2,1,1,2,0,2,0,0,0,23,6,17,0,0,0,0,0,0,3,1,2
145646,31000,310,0,-2,2,0,2,0,0,0,0,0,0,0,0,0,0,0,0,0,0,0,2,0,2,0,0,0,0,0,0,0,0,0
145682,31000,310,0,-2,5,0,5,0,0,0,0,0,0,0,0,0,0,0,0,0,0,0,5,0,5,0,0,0,0,0,0,0,0,0
145691,31000,310,0,-2,6,2,4,0,0,0,0,0,0,1,0,1,0,0,0,0,0,0,5,2,3,0,0,0,0,0,0,0,0,0
145725,31000,310,0,-2,17,6,11,0,0,0,2,0,2,2,1,1,0,0,0,0,0,0,3,2,1,1,0,1,8,3,5,1,0,1
145813,31000,310,0,-2,6,3,3,0,0,0,0,0,0,0,0,0,0,0,0,0,0,0,3,1,2,0,0,0,3,2,1,0,0,0
145831,31000,310,0,-2,1,1,0,0,0,0,0,0,0,0,0,0,1,1,0,0,0,0,0,0,0,0,0,0,0,0,0,0,0,0
146205,31000,310,0,-2,1,0,1,0,0,0,0,0,0,0,0,0,0,0,0,0,0,0,1,0,1,0,0,0,0,0,0,0,0,0
146278,31000,310,0,-2,2,0,2,0,0,0,0,0,0,0,0,0,0,0,0,0,0,0,2,0,2,0,0,0,0,0,0,0,0,0
146296,31000,310,0,-2,3,1,2,0,0,0,0,0,0,0,0,0,1,0,1,0,0,0,2,1,1,0,0,0,0,0,0,0,0,0
146339,31000,310,0,-2,1,1,0,0,0,0,0,0,0,0,0,0,0,0,0,0,0,0,1,1,0,0,0,0,0,0,0,0,0,0
146348,31000,310,0,-2,3,1,2,0,0,0,0,0,0,1,0,1,1,1,0,0,0,0,1,0,1,0,0,0,0,0,0,0,0,0
146366,31000,310,0,-2,3,0,3,0,0,0,0,0,0,0,0,0,0,0,0,0,0,0,2,0,2,1,0,1,0,0,0,0,0,0
146427,31000,310,0,-2,4,1,3,0,0,0,0,0,0,1,1,0,0,0,0,0,0,0,3,0,3,0,0,0,0,0,0,0,0,0
146472,31000,310,0,-2,6,1,5,0,0,0,0,0,0,1,0,1,2,1,1,0,0,0,3,0,3,0,0,0,0,0,0,0,0,0
146490,31000,310,0,-2,5,1,4,0,0,0,0,0,0,1,0,1,0,0,0,0,0,0,4,1,3,0,0,0,0,0,0,0,0,0
146506,31000,310,0,-2,4,1,3,0,0,0,0,0,0,0,0,0,0,0,0,0,0,0,4,1,3,0,0,0,0,0,0,0,0,0
146603,31000,310,0,-2,4,0,4,0,0,0,0,0,0,0,0,0,1,0,1,0,0,0,3,0,3,0,0,0,0,0,0,0,0,0
146612,31000,310,0,-2,3,2,1,0,0,0,0,0,0,0,0,0,0,0,0,0,0,0,2,1,1,0,0,0,1,1,0,0,0,0
146667,31000,310,0,-2,1,1,0,0,0,0,0,0,0,0,0,0,0,0,0,0,0,0,1,1,0,0,0,0,0,0,0,0,0,0
146676,31000,310,0,-2,1,0,1,0,0,0,0,0,0,0,0,0,0,0,0,0,0,0,1,0,1,0,0,0,0,0,0,0,0,0
146685,31000,310,0,-2,2,1,1,0,0,0,0,0,0,0,0,0,0,0,0,0,0,0,2,1,1,0,0,0,0,0,0,0,0,0
146719,31000,310,0,-2,22,6,16,0,0,0,4,2,2,0,0,0,3,1,2,0,0,0,13,3,10,0,0,0,1,0,1,1,0,1
146728,31000,310,0,-2,2,1,1,0,0,0,0,0,0,1,0,1,0,0,0,0,0,0,1,1,0,0,0,0,0,0,0,0,0,0
147004,31000,310,0,-2,1,0,1,0,0,0,0,0,0,0,0,0,0,0,0,0,0,0,1,0,1,0,0,0,0,0,0,0,0,0
147244,31000,310,0,-2,4,1,3,0,0,0,0,0,0,0,0,0,0,0,0,0,0,0,4,1,3,0,0,0,0,0,0,0,0,0
147369,31000,310,0,-2,2,1,1,0,0,0,0,0,0,0,0,0,0,0,0,0,0,0,2,1,1,0,0,0,0,0,0,0,0,0
147378,31000,310,0,-2,2,1,1,0,0,0,0,0,0,1,1,0,0,0,0,0,0,0,1,0,1,0,0,0,0,0,0,0,0,0
147536,31000,310,0,-2,2,0,2,0,0,0,0,0,0,0,0,0,0,0,0,0,0,0,2,0,2,0,0,0,0,0,0,0,0,0
147590,31000,310,0,-2,1,0,1,0,0,0,0,0,0,0,0,0,0,0,0,0,0,0,1,0,1,0,0,0,0,0,0,0,0,0
147697,31000,310,0,-2,1,1,0,0,0,0,0,0,0,0,0,0,0,0,0,0,0,0,1,1,0,0,0,0,0,0,0,0,0,0
147703,31000,310,0,-2,14,10,4,0,0,0,0,0,0,0,0,0,2,0,2,0,0,0,9,7,2,0,0,0,1,1,0,2,2,0
147767,31000,310,0,-2,179,58,121,0,0,0,21,7,14,28,10,18,15,5,10,0,0,0,101,31,70,5,1,4,3,1,2,6,3,3
147776,31000,310,0,-2,1,1,0,0,0,0,0,0,0,0,0,0,0,0,0,0,0,0,1,1,0,0,0,0,0,0,0,0,0,0
147800,31000,310,0,-2,4,1,3,0,0,0,0,0,0,0,0,0,0,0,0,0,0,0,3,0,3,0,0,0,1,1,0,0,0,0
147828,31000,310,0,-2,1,0,1,0,0,0,0,0,0,0,0,0,0,0,0,0,0,0,1,0,1,0,0,0,0,0,0,0,0,0
147916,31000,310,0,-2,2,0,2,0,0,0,0,0,0,0,0,0,0,0,0,0,0,0,2,0,2,0,0,0,0,0,0,0,0,0
148256,31000,310,0,-2,3,0,3,0,0,0,0,0,0,0,0,0,0,0,0,0,0,0,3,0,3,0,0,0,0,0,0,0,0,0
148292,31000,310,0,-2,2,0,2,0,0,0,0,0,0,0,0,0,0,0,0,0,0,0,2,0,2,0,0,0,0,0,0,0,0,0
148405,31000,310,0,-2,4,0,4,0,0,0,0,0,0,0,0,0,0,0,0,0,0,0,3,0,3,1,0,1,0,0,0,0,0,0
148487,31000,310,0,-2,2,1,1,0,0,0,0,0,0,0,0,0,0,0,0,0,0,0,0,0,0,0,0,0,2,1,1,0,0,0
148496,31000,310,0,-2,3,0,3,0,0,0,0,0,0,0,0,0,1,0,1,0,0,0,2,0,2,0,0,0,0,0,0,0,0,0
148511,31000,310,0,-2,10,1,9,0,0,0,2,0,2,2,0,2,2,0,2,0,0,0,3,1,2,0,0,0,1,0,1,0,0,0
148575,31000,310,0,-2,3,1,2,0,0,0,0,0,0,0,0,0,0,0,0,0,0,0,3,1,2,0,0,0,0,0,0,0,0,0
148584,31000,310,0,-2,1,0,1,0,0,0,0,0,0,0,0,0,0,0,0,0,0,0,1,0,1,0,0,0,0,0,0,0,0,0
148654,31000,310,0,-2,5,0,5,0,0,0,0,0,0,0,0,0,0,0,0,0,0,0,5,0,5,0,0,0,0,0,0,0,0,0
148672,31000,310,0,-2,1,0,1,0,0,0,0,0,0,0,0,0,0,0,0,0,0,0,1,0,1,0,0,0,0,0,0,0,0,0
148876,31000,310,0,-2,2,0,2,0,0,0,0,0,0,0,0,0,1,0,1,0,0,0,1,0,1,0,0,0,0,0,0,0,0,0
148885,31000,310,0,-2,2,0,2,0,0,0,0,0,0,0,0,0,1,0,1,0,0,0,1,0,1,0,0,0,0,0,0,0,0,0
148991,31000,310,0,-2,1,0,1,0,0,0,0,0,0,0,0,0,0,0,0,0,0,0,1,0,1,0,0,0,0,0,0,0,0,0
149222,31000,310,0,-2,20,8,12,0,0,0,2,0,2,2,2,0,0,0,0,0,0,0,15,5,10,1,1,0,0,0,0,0,0,0
149231,31000,310,0,-2,5,1,4,0,0,0,0,0,0,2,0,2,0,0,0,0,0,0,3,1,2,0,0,0,0,0,0,0,0,0
149240,31000,310,0,-2,1,0,1,0,0,0,0,0,0,1,0,1,0,0,0,0,0,0,0,0,0,0,0,0,0,0,0,0,0,0
149329,31000,310,0,-2,1,1,0,0,0,0,0,0,0,0,0,0,0,0,0,0,0,0,1,1,0,0,0,0,0,0,0,0,0,0
149365,31000,310,0,-2,8,0,8,0,0,0,0,0,0,5,0,5,1,0,1,0,0,0,2,0,2,0,0,0,0,0,0,0,0,0
149505,31000,310,0,-2,1,0,1,0,0,0,0,0,0,0,0,0,0,0,0,0,0,0,1,0,1,0,0,0,0,0,0,0,0,0
149514,31000,310,0,-2,4,1,3,0,0,0,0,0,0,0,0,0,0,0,0,0,0,0,4,1,3,0,0,0,0,0,0,0,0,0
149532,31000,310,0,-2,2,1,1,0,0,0,0,0,0,0,0,0,1,0,1,0,0,0,0,0,0,0,0,0,1,1,0,0,0,0
149587,31000,310,0,-2,29,14,15,0,0,0,1,1,0,5,2,3,3,2,1,0,0,0,17,8,9,2,1,1,0,0,0,1,0,1
149639,31000,310,0,-2,1,1,0,0,0,0,0,0,0,0,0,0,0,0,0,0,0,0,1,1,0,0,0,0,0,0,0,0,0,0
149727,31000,310,0,-2,1,1,0,0,0,0,0,0,0,0,0,0,0,0,0,0,0,0,1,1,0,0,0,0,0,0,0,0,0,0
149772,31000,310,0,-2,4,2,2,0,0,0,0,0,0,0,0,0,0,0,0,0,0,0,4,2,2,0,0,0,0,0,0,0,0,0
149781,31000,310,0,-2,9,2,7,0,0,0,2,1,1,2,1,1,1,0,1,0,0,0,3,0,3,0,0,0,1,0,1,0,0,0
149842,31000,310,0,-2,7,2,5,0,0,0,1,1,0,1,0,1,1,0,1,0,0,0,4,1,3,0,0,0,0,0,0,0,0,0
150066,31000,310,0,-2,3,3,0,0,0,0,0,0,0,0,0,0,1,1,0,0,0,0,2,2,0,0,0,0,0,0,0,0,0,0
150145,31000,310,0,-2,1,1,0,0,0,0,0,0,0,0,0,0,0,0,0,0,0,0,1,1,0,0,0,0,0,0,0,0,0,0
150163,31000,310,0,-2,6,1,5,0,0,0,0,0,0,0,0,0,1,0,1,0,0,0,4,1,3,0,0,0,1,0,1,0,0,0
150400,31000,310,0,-2,9,4,5,0,0,0,1,0,1,1,1,0,1,1,0,0,0,0,6,2,4,0,0,0,0,0,0,0,0,0
150455,31000,310,0,-2,8,4,4,0,0,0,0,0,0,0,0,0,1,1,0,0,0,0,7,3,4,0,0,0,0,0,0,0,0,0
150604,31000,310,0,-2,4,1,3,0,0,0,0,0,0,0,0,0,0,0,0,0,0,0,4,1,3,0,0,0,0,0,0,0,0,0
150668,31000,310,0,-2,2,1,1,0,0,0,0,0,0,0,0,0,0,0,0,0,0,0,2,1,1,0,0,0,0,0,0,0,0,0
150774,31000,310,0,-2,2,1,1,0,0,0,0,0,0,0,0,0,0,0,0,0,0,0,2,1,1,0,0,0,0,0,0,0,0,0
150987,31000,310,0,-2,42,10,32,0,0,0,0,0,0,11,2,9,0,0,0,0,0,0,31,8,23,0,0,0,0,0,0,0,0,0
151102,31000,310,0,-2,11,4,7,0,0,0,0,0,0,2,1,1,0,0,0,0,0,0,9,3,6,0,0,0,0,0,0,0,0,0
151111,31000,310,0,-2,38,7,31,0,0,0,2,0,2,4,1,3,2,1,1,0,0,0,29,5,24,0,0,0,0,0,0,1,0,1
151263,31000,310,0,-2,6,1,5,0,0,0,1,0,1,0,0,0,0,0,0,0,0,0,5,1,4,0,0,0,0,0,0,0,0,0
151290,31000,310,0,-2,3,1,2,0,0,0,0,0,0,0,0,0,0,0,0,0,0,0,3,1,2,0,0,0,0,0,0,0,0,0
151306,31000,310,0,-2,4,1,3,0,0,0,0,0,0,0,0,0,0,0,0,0,0,0,4,1,3,0,0,0,0,0,0,0,0,0
151324,31000,310,0,-2,6,3,3,0,0,0,0,0,0,0,0,0,0,0,0,0,0,0,6,3,3,0,0,0,0,0,0,0,0,0
151342,31000,310,0,-2,2,0,2,0,0,0,0,0,0,0,0,0,0,0,0,0,0,0,2,0,2,0,0,0,0,0,0,0,0,0
151351,31000,310,0,-2,35,15,20,0,0,0,1,0,1,1,0,1,3,2,1,0,0,0,30,13,17,0,0,0,0,0,0,0,0,0
151360,31000,310,0,-2,1,0,1,0,0,0,0,0,0,0,0,0,0,0,0,0,0,0,1,0,1,0,0,0,0,0,0,0,0,0
151379,31000,310,0,-2,2,1,1,0,0,0,0,0,0,0,0,0,0,0,0,0,0,0,2,1,1,0,0,0,0,0,0,0,0,0
151777,31000,310,0,-2,2,1,1,0,0,0,0,0,0,0,0,0,1,0,1,0,0,0,1,1,0,0,0,0,0,0,0,0,0,0
151786,31000,310,0,-2,7,0,7,0,0,0,0,0,0,2,0,2,1,0,1,0,0,0,4,0,4,0,0,0,0,0,0,0,0,0
151801,31000,310,0,-2,3,0,3,0,0,0,0,0,0,0,0,0,0,0,0,0,0,0,3,0,3,0,0,0,0,0,0,0,0,0
151810,31000,310,0,-2,2,0,2,0,0,0,0,0,0,2,0,2,0,0,0,0,0,0,0,0,0,0,0,0,0,0,0,0,0,0
151865,31000,310,0,-2,2,1,1,0,0,0,0,0,0,0,0,0,0,0,0,0,0,0,2,1,1,0,0,0,0,0,0,0,0,0
152080,31000,310,0,-2,94,31,63,0,0,0,2,0,2,5,3,2,7,1,6,0,0,0,64,23,41,4,0,4,5,2,3,7,2,5
152336,31000,310,0,-2,4,2,2,0,0,0,0,0,0,0,0,0,1,1,0,0,0,0,3,1,2,0,0,0,0,0,0,0,0,0
152381,31000,310,0,-2,1,0,1,0,0,0,0,0,0,0,0,0,0,0,0,0,0,0,1,0,1,0,0,0,0,0,0,0,0,0
152390,31000,310,0,-2,14,3,11,0,0,0,0,0,0,0,0,0,0,0,0,0,0,0,13,2,11,0,0,0,1,1,0,0,0,0
152530,31000,310,0,-2,5,2,3,0,0,0,0,0,0,0,0,0,0,0,0,0,0,0,4,1,3,1,1,0,0,0,0,0,0,0
152567,31000,310,0,-2,1,1,0,0,0,0,0,0,0,0,0,0,0,0,0,0,0,0,1,1,0,0,0,0,0,0,0,0,0,0
152600,31000,310,0,-2,1,0,1,0,0,0,0,0,0,0,0,0,0,0,0,0,0,0,0,0,0,0,0,0,1,0,1,0,0,0
152637,31000,310,0,-2,2,0,2,0,0,0,0,0,0,0,0,0,0,0,0,0,0,0,2,0,2,0,0,0,0,0,0,0,0,0
152673,31000,310,0,-2,3,3,0,0,0,0,0,0,0,1,1,0,0,0,0,0,0,0,2,2,0,0,0,0,0,0,0,0,0,0
152992,31000,310,0,-2,1,1,0,0,0,0,0,0,0,0,0,0,0,0,0,0,0,0,0,0,0,0,0,0,1,1,0,0,0,0
153001,31000,310,0,-2,1,0,1,0,0,0,0,0,0,0,0,0,0,0,0,0,0,0,1,0,1,0,0,0,0,0,0,0,0,0
153108,31000,310,0,-2,3,1,2,0,0,0,0,0,0,0,0,0,0,0,0,0,0,0,3,1,2,0,0,0,0,0,0,0,0,0
153162,31000,310,0,-2,8,3,5,0,0,0,0,0,0,0,0,0,0,0,0,0,0,0,7,3,4,0,0,0,0,0,0,1,0,1
153214,31000,310,0,-2,2,0,2,0,0,0,0,0,0,0,0,0,0,0,0,0,0,0,2,0,2,0,0,0,0,0,0,0,0,0
153269,31000,310,0,-2,7,6,1,0,0,0,0,0,0,1,1,0,0,0,0,0,0,0,6,5,1,0,0,0,0,0,0,0,0,0
153366,31000,310,0,-2,3,0,3,0,0,0,0,0,0,0,0,0,0,0,0,0,0,0,3,0,3,0,0,0,0,0,0,0,0,0
153375,31000,310,0,-2,4,1,3,0,0,0,0,0,0,0,0,0,0,0,0,0,0,0,4,1,3,0,0,0,0,0,0,0,0,0
153384,31000,310,0,-2,4,1,3,0,0,0,0,0,0,0,0,0,0,0,0,0,0,0,4,1,3,0,0,0,0,0,0,0,0,0
153445,31000,310,0,-2,2,0,2,0,0,0,0,0,0,0,0,0,0,0,0,0,0,0,2,0,2,0,0,0,0,0,0,0,0,0
153472,31000,310,0,-2,3,0,3,0,0,0,0,0,0,0,0,0,1,0,1,0,0,0,2,0,2,0,0,0,0,0,0,0,0,0
153524,31000,310,0,-2,3,1,2,0,0,0,0,0,0,0,0,0,1,1,0,0,0,0,2,0,2,0,0,0,0,0,0,0,0,0
153603,31000,310,0,-2,114,33,81,0,0,0,4,2,2,4,2,2,1,0,1,0,0,0,99,28,71,4,1,3,0,0,0,2,0,2
153621,31000,310,0,-2,3,1,2,0,0,0,0,0,0,0,0,0,0,0,0,0,0,0,3,1,2,0,0,0,0,0,0,0,0,0
153630,31000,310,0,-2,1,0,1,0,0,0,1,0,1,0,0,0,0,0,0,0,0,0,0,0,0,0,0,0,0,0,0,0,0,0
153658,31000,310,0,-2,98,32,66,1,0,1,3,1,2,1,1,0,6,0,6,1,0,1,76,27,49,1,0,1,6,3,3,3,0,3
153737,31000,310,0,-2,8,3,5,0,0,0,1,0,1,1,1,0,0,0,0,0,0,0,6,2,4,0,0,0,0,0,0,0,0,0
153825,31000,310,0,-2,3,2,1,0,0,0,0,0,0,1,1,0,0,0,0,0,0,0,2,1,1,0,0,0,0,0,0,0,0,0
153834,31000,310,0,-2,4,0,4,0,0,0,0,0,0,0,0,0,0,0,0,0,0,0,4,0,4,0,0,0,0,0,0,0,0,0
153861,31000,310,0,-2,5,2,3,0,0,0,0,0,0,0,0,0,1,0,1,0,0,0,3,2,1,0,0,0,1,0,1,0,0,0
154004,31000,310,0,-2,1,0,1,0,0,0,0,0,0,0,0,0,0,0,0,0,0,0,1,0,1,0,0,0,0,0,0,0,0,0
154013,31000,310,0,-2,5,1,4,0,0,0,0,0,0,0,0,0,0,0,0,0,0,0,5,1,4,0,0,0,0,0,0,0,0,0
154022,31000,310,0,-2,6,1,5,0,0,0,0,0,0,2,0,2,0,0,0,0,0,0,2,1,1,0,0,0,2,0,2,0,0,0
154059,31000,310,0,-2,3,1,2,0,0,0,0,0,0,0,0,0,0,0,0,0,0,0,3,1,2,0,0,0,0,0,0,0,0,0
154095,31000,310,0,-2,11,4,7,0,0,0,0,0,0,0,0,0,0,0,0,0,0,0,11,4,7,0,0,0,0,0,0,0,0,0
154110,31000,310,0,-2,1,1,0,0,0,0,0,0,0,0,0,0,0,0,0,0,0,0,1,1,0,0,0,0,0,0,0,0,0,0
154156,31000,310,0,-2,1,0,1,0,0,0,0,0,0,0,0,0,0,0,0,0,0,0,0,0,0,1,0,1,0,0,0,0,0,0
154174,31000,310,0,-2,5,0,5,0,0,0,0,0,0,0,0,0,0,0,0,0,0,0,5,0,5,0,0,0,0,0,0,0,0,0
154235,31000,310,0,-2,4,2,2,0,0,0,0,0,0,0,0,0,0,0,0,0,0,0,4,2,2,0,0,0,0,0,0,0,0,0
154350,31000,310,0,-2,1,0,1,0,0,0,0,0,0,0,0,0,0,0,0,0,0,0,1,0,1,0,0,0,0,0,0,0,0,0
154378,31000,310,0,-2,2,0,2,0,0,0,0,0,0,0,0,0,0,0,0,0,0,0,2,0,2,0,0,0,0,0,0,0,0,0
154396,31000,310,0,-2,3,0,3,0,0,0,0,0,0,0,0,0,0,0,0,0,0,0,3,0,3,0,0,0,0,0,0,0,0,0
154518,31000,310,0,-2,3,0,3,0,0,0,0,0,0,0,0,0,0,0,0,0,0,0,2,0,2,1,0,1,0,0,0,0,0,0
154527,31000,310,0,-2,3,1,2,0,0,0,0,0,0,0,0,0,0,0,0,0,0,0,3,1,2,0,0,0,0,0,0,0,0,0
154536,31000,310,0,-2,1,0,1,0,0,0,0,0,0,0,0,0,0,0,0,0,0,0,1,0,1,0,0,0,0,0,0,0,0,0
154572,31000,310,0,-2,3,2,1,0,0,0,0,0,0,0,0,0,0,0,0,0,0,0,2,1,1,0,0,0,1,1,0,0,0,0
154697,31000,310,0,-2,1,0,1,0,0,0,0,0,0,0,0,0,0,0,0,0,0,0,1,0,1,0,0,0,0,0,0,0,0,0
154721,31000,310,0,-2,3,1,2,0,0,0,0,0,0,0,0,0,0,0,0,0,0,0,3,1,2,0,0,0,0,0,0,0,0,0
154800,31000,310,0,-2,2,0,2,0,0,0,0,0,0,0,0,0,0,0,0,0,0,0,2,0,2,0,0,0,0,0,0,0,0,0
154855,31000,310,0,-2,1,0,1,0,0,0,0,0,0,0,0,0,0,0,0,0,0,0,1,0,1,0,0,0,0,0,0,0,0,0
155007,31000,310,0,-2,3,1,2,0,0,0,0,0,0,0,0,0,1,1,0,0,0,0,2,0,2,0,0,0,0,0,0,0,0,0
155025,31000,310,0,-2,1,0,1,0,0,0,0,0,0,1,0,1,0,0,0,0,0,0,0,0,0,0,0,0,0,0,0,0,0,0
155061,31000,310,0,-2,2,1,1,0,0,0,0,0,0,0,0,0,0,0,0,0,0,0,2,1,1,0,0,0,0,0,0,0,0,0
155089,31000,310,0,-2,2,1,1,0,0,0,0,0,0,0,0,0,0,0,0,0,0,0,2,1,1,0,0,0,0,0,0,0,0,0
155098,31000,310,0,-2,12,5,7,0,0,0,0,0,0,0,0,0,8,4,4,0,0,0,4,1,3,0,0,0,0,0,0,0,0,0
155201,31000,310,0,-2,3,2,1,0,0,0,0,0,0,0,0,0,0,0,0,0,0,0,3,2,1,0,0,0,0,0,0,0,0,0
155210,31000,310,0,-2,4,0,4,0,0,0,0,0,0,0,0,0,0,0,0,0,0,0,4,0,4,0,0,0,0,0,0,0,0,0
155292,31000,310,0,-2,1,0,1,0,0,0,0,0,0,0,0,0,0,0,0,0,0,0,1,0,1,0,0,0,0,0,0,0,0,0
155317,31000,310,0,-2,63,18,45,0,0,0,3,1,2,7,0,7,2,2,0,0,0,0,44,14,30,4,1,3,3,0,3,0,0,0
155399,31000,310,0,-2,52,18,34,0,0,0,2,0,2,3,2,1,3,1,2,1,0,1,42,14,28,1,1,0,0,0,0,0,0,0
155511,31000,310,0,-2,4,1,3,0,0,0,0,0,0,0,0,0,0,0,0,0,0,0,4,1,3,0,0,0,0,0,0,0,0,0
155627,31000,310,0,-2,2,0,2,0,0,0,0,0,0,0,0,0,0,0,0,0,0,0,2,0,2,0,0,0,0,0,0,0,0,0
155681,31000,310,0,-2,5,1,4,0,0,0,1,1,0,1,0,1,0,0,0,0,0,0,3,0,3,0,0,0,0,0,0,0,0,0
155715,31000,310,0,-2,2,0,2,0,0,0,0,0,0,0,0,0,0,0,0,0,0,0,2,0,2,0,0,0,0,0,0,0,0,0
155812,31000,310,0,-2,1,0,1,0,0,0,0,0,0,0,0,0,0,0,0,0,0,0,1,0,1,0,0,0,0,0,0,0,0,0
155973,31000,310,0,-2,1,0,1,0,0,0,0,0,0,0,0,0,0,0,0,0,0,0,1,0,1,0,0,0,0,0,0,0,0,0
156082,31000,310,0,-2,4,1,3,0,0,0,0,0,0,0,0,0,0,0,0,0,0,0,1,0,1,0,0,0,3,1,2,0,0,0
156107,31000,310,0,-2,8,3,5,0,0,0,1,1,0,2,0,2,0,0,0,0,0,0,5,2,3,0,0,0,0,0,0,0,0,0
156125,31000,310,0,-2,20,9,11,0,0,0,0,0,0,3,0,3,3,2,1,0,0,0,13,6,7,0,0,0,1,1,0,0,0,0
156286,31000,310,0,-2,4,1,3,0,0,0,0,0,0,1,1,0,0,0,0,0,0,0,3,0,3,0,0,0,0,0,0,0,0,0
156295,31000,310,0,-2,18,2,16,0,0,0,2,0,2,2,0,2,1,0,1,0,0,0,12,2,10,1,0,1,0,0,0,0,0,0
156356,31000,310,0,-2,1,0,1,0,0,0,0,0,0,0,0,0,0,0,0,0,0,0,1,0,1,0,0,0,0,0,0,0,0,0
156365,31000,310,0,-2,7,0,7,0,0,0,0,0,0,0,0,0,0,0,0,0,0,0,7,0,7,0,0,0,0,0,0,0,0,0
156392,31000,310,0,-2,2,1,1,0,0,0,0,0,0,0,0,0,1,0,1,0,0,0,1,1,0,0,0,0,0,0,0,0,0,0
156408,31000,310,0,-2,4,2,2,0,0,0,0,0,0,0,0,0,0,0,0,0,0,0,4,2,2,0,0,0,0,0,0,0,0,0
156541,31000,310,0,-2,7,2,5,0,0,0,0,0,0,0,0,0,0,0,0,0,0,0,7,2,5,0,0,0,0,0,0,0,0,0
156620,31000,310,0,-2,49,14,35,0,0,0,0,0,0,3,0,3,2,0,2,0,0,0,39,12,27,4,2,2,0,0,0,1,0,1
156727,31000,310,0,-2,1,0,1,0,0,0,0,0,0,0,0,0,0,0,0,0,0,0,1,0,1,0,0,0,0,0,0,0,0,0
156921,31000,310,0,-2,1,0,1,0,0,0,0,0,0,0,0,0,0,0,0,0,0,0,1,0,1,0,0,0,0,0,0,0,0,0
157058,31000,310,0,-2,2,0,2,0,0,0,0,0,0,1,0,1,0,0,0,0,0,0,0,0,0,0,0,0,1,0,1,0,0,0
157076,31000,310,0,-2,2,0,2,0,0,0,0,0,0,1,0,1,0,0,0,0,0,0,1,0,1,0,0,0,0,0,0,0,0,0
157085,31000,310,0,-2,74,26,48,0,0,0,0,0,0,7,0,7,2,2,0,0,0,0,63,22,41,0,0,0,1,1,0,1,1,0
157100,31000,310,0,-2,3,0,3,0,0,0,0,0,0,0,0,0,0,0,0,0,0,0,3,0,3,0,0,0,0,0,0,0,0,0
157289,31000,310,0,-2,34,12,22,0,0,0,0,0,0,9,2,7,2,2,0,0,0,0,23,8,15,0,0,0,0,0,0,0,0,0
157377,31000,310,0,-2,2,0,2,0,0,0,0,0,0,0,0,0,0,0,0,0,0,0,2,0,2,0,0,0,0,0,0,0,0,0
157386,31000,310,0,-2,1,0,1,0,0,0,0,0,0,0,0,0,0,0,0,0,0,0,1,0,1,0,0,0,0,0,0,0,0,0
157447,31000,310,0,-2,16,4,12,0,0,0,0,0,0,1,0,1,0,0,0,0,0,0,15,4,11,0,0,0,0,0,0,0,0,0
157748,31000,310,0,-2,7,3,4,0,0,0,0,0,0,0,0,0,0,0,0,0,0,0,4,3,1,0,0,0,3,0,3,0,0,0
157757,31000,310,0,-2,1,0,1,0,0,0,0,0,0,0,0,0,0,0,0,0,0,0,1,0,1,0,0,0,0,0,0,0,0,0
157809,31000,310,0,-2,3,2,1,0,0,0,0,0,0,0,0,0,0,0,0,0,0,0,3,2,1,0,0,0,0,0,0,0,0,0
157854,31000,310,0,-2,2,1,1,0,0,0,0,0,0,0,0,0,0,0,0,0,0,0,0,0,0,0,0,0,2,1,1,0,0,0
157863,31000,310,0,-2,6,3,3,0,0,0,0,0,0,0,0,0,0,0,0,0,0,0,6,3,3,0,0,0,0,0,0,0,0,0
158088,31000,310,0,-2,9,1,8,1,0,1,0,0,0,1,0,1,1,0,1,0,0,0,6,1,5,0,0,0,0,0,0,0,0,0
158431,31000,310,0,-2,16,7,9,0,0,0,0,0,0,8,2,6,1,0,1,0,0,0,7,5,2,0,0,0,0,0,0,0,0,0
158477,31000,310,0,-2,2,1,1,0,0,0,0,0,0,0,0,0,0,0,0,0,0,0,2,1,1,0,0,0,0,0,0,0,0,0
158662,31000,310,0,-2,27,9,18,0,0,0,2,0,2,16,5,11,2,2,0,0,0,0,5,1,4,0,0,0,0,0,0,2,1,1
158802,31000,310,0,-2,1,1,0,0,0,0,0,0,0,1,1,0,0,0,0,0,0,0,0,0,0,0,0,0,0,0,0,0,0,0
158884,31000,310,0,-2,1,0,1,0,0,0,0,0,0,1,0,1,0,0,0,0,0,0,0,0,0,0,0,0,0,0,0,0,0,0
159009,31000,310,0,-2,12,3,9,0,0,0,0,0,0,11,3,8,0,0,0,0,0,0,1,0,1,0,0,0,0,0,0,0,0,0
159373,31000,310,0,-2,49,10,39,1,0,1,2,0,2,17,1,16,1,0,1,0,0,0,28,9,19,0,0,0,0,0,0,0,0,0
159382,31000,310,0,-2,4,2,2,0,0,0,0,0,0,0,0,0,0,0,0,0,0,0,4,2,2,0,0,0,0,0,0,0,0,0
159391,31000,310,0,-2,70,23,47,0,0,0,1,0,1,20,5,15,3,2,1,0,0,0,43,15,28,1,0,1,1,0,1,1,1,0
159407,31000,310,0,-2,1,0,1,0,0,0,0,0,0,0,0,0,0,0,0,0,0,0,1,0,1,0,0,0,0,0,0,0,0,0
159416,31000,310,0,-2,4,0,4,0,0,0,0,0,0,2,0,2,0,0,0,0,0,0,1,0,1,0,0,0,0,0,0,1,0,1
159647,31000,310,0,-2,4,2,2,0,0,0,0,0,0,2,1,1,0,0,0,0,0,0,2,1,1,0,0,0,0,0,0,0,0,0
159656,31000,310,0,-2,8,2,6,0,0,0,0,0,0,0,0,0,0,0,0,0,0,0,8,2,6,0,0,0,0,0,0,0,0,0
159717,31000,310,0,-2,3,1,2,0,0,0,0,0,0,0,0,0,0,0,0,0,0,0,3,1,2,0,0,0,0,0,0,0,0,0
159939,31000,310,0,-2,5,1,4,0,0,0,0,0,0,3,0,3,0,0,0,0,0,0,2,1,1,0,0,0,0,0,0,0,0,0
159948,31000,310,0,-2,2,0,2,0,0,0,0,0,0,0,0,0,0,0,0,0,0,0,2,0,2,0,0,0,0,0,0,0,0,0
159966,31000,310,0,-2,3,1,2,0,0,0,0,0,0,0,0,0,0,0,0,0,0,0,3,1,2,0,0,0,0,0,0,0,0,0
159993,31000,310,0,-2,2,0,2,0,0,0,0,0,0,0,0,0,0,0,0,0,0,0,2,0,2,0,0,0,0,0,0,0,0,0
160010,31000,310,0,-2,5,3,2,0,0,0,0,0,0,1,1,0,1,1,0,0,0,0,3,1,2,0,0,0,0,0,0,0,0,0
160038,31000,310,0,-2,8,2,6,0,0,0,0,0,0,0,0,0,0,0,0,0,0,0,7,2,5,0,0,0,1,0,1,0,0,0
160074,31000,310,0,-2,1,0,1,0,0,0,0,0,0,0,0,0,0,0,0,0,0,0,1,0,1,0,0,0,0,0,0,0,0,0
160481,31000,310,0,-2,11,2,9,0,0,0,0,0,0,1,0,1,0,0,0,0,0,0,9,2,7,1,0,1,0,0,0,0,0,0
160524,31000,310,0,-2,3,0,3,0,0,0,0,0,0,3,0,3,0,0,0,0,0,0,0,0,0,0,0,0,0,0,0,0,0,0
160533,31000,310,0,-2,1,0,1,0,0,0,0,0,0,1,0,1,0,0,0,0,0,0,0,0,0,0,0,0,0,0,0,0,0,0
160579,31000,310,0,-2,8,1,7,0,0,0,0,0,0,1,0,1,1,0,1,0,0,0,6,1,5,0,0,0,0,0,0,0,0,0
160612,31000,310,0,-2,10,4,6,0,0,0,0,0,0,1,0,1,0,0,0,0,0,0,9,4,5,0,0,0,0,0,0,0,0,0
160621,31000,310,0,-2,4,1,3,0,0,0,0,0,0,4,1,3,0,0,0,0,0,0,0,0,0,0,0,0,0,0,0,0,0,0
160630,31000,310,0,-2,3,1,2,0,0,0,0,0,0,3,1,2,0,0,0,0,0,0,0,0,0,0,0,0,0,0,0,0,0,0
160649,31000,310,0,-2,1,0,1,0,0,0,0,0,0,1,0,1,0,0,0,0,0,0,0,0,0,0,0,0,0,0,0,0,0,0
160658,31000,310,0,-2,5,2,3,0,0,0,1,1,0,0,0,0,0,0,0,0,0,0,4,1,3,0,0,0,0,0,0,0,0,0
160667,31000,310,0,-2,2,0,2,0,0,0,0,0,0,1,0,1,0,0,0,0,0,0,1,0,1,0,0,0,0,0,0,0,0,0
160755,31000,310,0,-2,36,8,28,1,0,1,3,2,1,14,0,14,4,1,3,0,0,0,13,4,9,1,1,0,0,0,0,0,0,0
160904,31000,310,0,-2,2,0,2,0,0,0,0,0,0,2,0,2,0,0,0,0,0,0,0,0,0,0,0,0,0,0,0,0,0,0
160977,31000,310,0,-2,4,2,2,0,0,0,0,0,0,0,0,0,0,0,0,0,0,0,4,2,2,0,0,0,0,0,0,0,0,0
160995,31000,310,0,-2,2,1,1,0,0,0,0,0,0,0,0,0,0,0,0,0,0,0,2,1,1,0,0,0,0,0,0,0,0,0
161004,31000,310,0,-2,8,1,7,0,0,0,0,0,0,0,0,0,1,0,1,0,0,0,7,1,6,0,0,0,0,0,0,0,0,0
161077,31000,310,0,-2,1,1,0,0,0,0,0,0,0,0,0,0,0,0,0,0,0,0,1,1,0,0,0,0,0,0,0,0,0,0
161086,31000,310,0,-2,8,3,5,0,0,0,0,0,0,0,0,0,0,0,0,0,0,0,7,3,4,0,0,0,1,0,1,0,0,0
161138,31000,310,0,-2,1,1,0,0,0,0,0,0,0,0,0,0,0,0,0,0,0,0,1,1,0,0,0,0,0,0,0,0,0,0
161208,31000,310,0,-2,1,0,1,0,0,0,0,0,0,0,0,0,0,0,0,0,0,0,1,0,1,0,0,0,0,0,0,0,0,0
161217,31000,310,0,-2,3,1,2,0,0,0,0,0,0,0,0,0,0,0,0,0,0,0,2,0,2,0,0,0,1,1,0,0,0,0
161253,31000,310,0,-2,50,15,35,0,0,0,3,0,3,1,0,1,0,0,0,0,0,0,42,13,29,0,0,0,1,0,1,3,2,1
161280,31000,310,0,-2,8,4,4,0,0,0,0,0,0,0,0,0,0,0,0,0,0,0,7,4,3,1,0,1,0,0,0,0,0,0
161341,31000,310,0,-2,1,0,1,0,0,0,0,0,0,0,0,0,0,0,0,0,0,0,1,0,1,0,0,0,0,0,0,0,0,0
161457,31000,310,0,-2,8,2,6,0,0,0,0,0,0,0,0,0,0,0,0,0,0,0,7,2,5,0,0,0,1,0,1,0,0,0
161484,31000,310,0,-2,1,0,1,0,0,0,0,0,0,0,0,0,0,0,0,0,0,0,1,0,1,0,0,0,0,0,0,0,0,0
161518,31000,310,0,-2,1,0,1,0,0,0,0,0,0,0,0,0,0,0,0,0,0,0,1,0,1,0,0,0,0,0,0,0,0,0
161545,31000,310,0,-2,1,0,1,0,0,0,0,0,0,0,0,0,0,0,0,0,0,0,1,0,1,0,0,0,0,0,0,0,0,0
161554,31000,310,0,-2,22,3,19,0,0,0,1,0,1,0,0,0,0,0,0,0,0,0,20,2,18,0,0,0,1,1,0,0,0,0
161572,31000,310,0,-2,2,1,1,0,0,0,0,0,0,0,0,0,0,0,0,0,0,0,2,1,1,0,0,0,0,0,0,0,0,0
161688,31000,310,0,-2,1,0,1,0,0,0,0,0,0,0,0,0,0,0,0,0,0,0,1,0,1,0,0,0,0,0,0,0,0,0
161864,31000,310,0,-2,2,1,1,0,0,0,0,0,0,2,1,1,0,0,0,0,0,0,0,0,0,0,0,0,0,0,0,0,0,0
161873,31000,310,0,-2,14,4,10,0,0,0,0,0,0,4,1,3,2,0,2,0,0,0,8,3,5,0,0,0,0,0,0,0,0,0
162007,31000,310,0,-2,22,4,18,0,0,0,0,0,0,16,1,15,0,0,0,0,0,0,2,1,1,0,0,0,2,0,2,2,2,0
162104,31000,310,0,-2,1,1,0,0,0,0,0,0,0,0,0,0,0,0,0,0,0,0,1,1,0,0,0,0,0,0,0,0,0,0
162210,31000,310,0,-2,2,0,2,0,0,0,0,0,0,2,0,2,0,0,0,0,0,0,0,0,0,0,0,0,0,0,0,0,0,0
162283,31000,310,0,-2,11,5,6,0,0,0,1,1,0,7,2,5,0,0,0,0,0,0,3,2,1,0,0,0,0,0,0,0,0,0
162557,31000,310,0,-2,2,0,2,0,0,0,0,0,0,0,0,0,0,0,0,0,0,0,1,0,1,0,0,0,1,0,1,0,0,0
162609,31000,310,0,-2,1,0,1,0,0,0,0,0,0,0,0,0,0,0,0,0,0,0,1,0,1,0,0,0,0,0,0,0,0,0
162654,31000,310,0,-2,8,4,4,0,0,0,0,0,0,4,1,3,0,0,0,0,0,0,3,3,0,0,0,0,1,0,1,0,0,0
162706,31000,310,0,-2,5,1,4,0,0,0,0,0,0,1,0,1,0,0,0,0,0,0,4,1,3,0,0,0,0,0,0,0,0,0
162760,31000,310,0,-2,6,3,3,0,0,0,0,0,0,1,0,1,0,0,0,0,0,0,4,2,2,0,0,0,1,1,0,0,0,0
162779,31000,310,0,-2,6,0,6,0,0,0,0,0,0,1,0,1,0,0,0,0,0,0,5,0,5,0,0,0,0,0,0,0,0,0
162928,31000,310,0,-2,300,94,206,1,0,1,17,4,13,72,22,50,15,3,12,1,1,0,163,55,108,11,3,8,3,1,2,17,5,12
163046,31000,310,0,-2,2,2,0,0,0,0,0,0,0,0,0,0,0,0,0,0,0,0,2,2,0,0,0,0,0,0,0,0,0,0
163204,31000,310,0,-2,23,5,18,0,0,0,3,0,3,2,0,2,0,0,0,0,0,0,8,2,6,0,0,0,10,3,7,0,0,0
163259,31000,310,0,-2,89,18,71,0,0,0,6,2,4,35,6,29,8,1,7,0,0,0,35,8,27,4,1,3,0,0,0,1,0,1
163268,31000,310,0,-2,29,7,22,0,0,0,3,1,2,6,3,3,1,0,1,0,0,0,12,1,11,2,1,1,5,1,4,0,0,0
163286,31000,310,0,-2,117,40,77,0,0,0,1,0,1,25,12,13,7,4,3,0,0,0,59,20,39,2,0,2,23,4,19,0,0,0
163295,31000,310,0,-2,1,0,1,0,0,0,0,0,0,1,0,1,0,0,0,0,0,0,0,0,0,0,0,0,0,0,0,0,0,0
163426,31000,310,0,-2,7,2,5,0,0,0,0,0,0,3,1,2,0,0,0,0,0,0,4,1,3,0,0,0,0,0,0,0,0,0
163453,31000,310,0,-2,14,4,10,0,0,0,0,0,0,10,1,9,0,0,0,0,0,0,3,3,0,0,0,0,1,0,1,0,0,0
163462,31000,310,0,-2,4,1,3,0,0,0,0,0,0,0,0,0,0,0,0,0,0,0,4,1,3,0,0,0,0,0,0,0,0,0
163578,31000,310,0,-2,2,0,2,0,0,0,0,0,0,1,0,1,1,0,1,0,0,0,0,0,0,0,0,0,0,0,0,0,0,0
163657,31000,310,0,-2,3,1,2,0,0,0,0,0,0,2,0,2,0,0,0,0,0,0,0,0,0,0,0,0,1,1,0,0,0,0
163851,31000,310,0,-2,4,2,2,0,0,0,0,0,0,0,0,0,0,0,0,0,0,0,4,2,2,0,0,0,0,0,0,0,0,0
163912,31000,310,0,-2,5,1,4,0,0,0,0,0,0,3,1,2,0,0,0,0,0,0,2,0,2,0,0,0,0,0,0,0,0,0
164076,31000,310,0,-2,54,15,39,0,0,0,2,0,2,16,4,12,2,0,2,0,0,0,30,9,21,1,0,1,3,2,1,0,0,0
164146,31000,310,0,-2,1,1,0,0,0,0,0,0,0,0,0,0,0,0,0,0,0,0,1,1,0,0,0,0,0,0,0,0,0,0
164155,31000,310,0,-2,11,5,6,0,0,0,0,0,0,1,0,1,1,1,0,0,0,0,9,4,5,0,0,0,0,0,0,0,0,0
164173,31000,310,0,-2,3,0,3,0,0,0,0,0,0,0,0,0,0,0,0,0,0,0,3,0,3,0,0,0,0,0,0,0,0,0
164270,31000,310,0,-2,5,3,2,0,0,0,0,0,0,0,0,0,0,0,0,0,0,0,5,3,2,0,0,0,0,0,0,0,0,0
164313,31000,310,0,-2,1,0,1,0,0,0,0,0,0,0,0,0,0,0,0,0,0,0,1,0,1,0,0,0,0,0,0,0,0,0
164368,31000,310,0,-2,5,4,1,0,0,0,0,0,0,1,1,0,0,0,0,0,0,0,4,3,1,0,0,0,0,0,0,0,0,0
164447,31000,310,0,-2,2,2,0,0,0,0,0,0,0,0,0,0,0,0,0,0,0,0,2,2,0,0,0,0,0,0,0,0,0,0
164465,31000,310,0,-2,6,1,5,0,0,0,1,1,0,2,0,2,0,0,0,0,0,0,3,0,3,0,0,0,0,0,0,0,0,0
164492,31000,310,0,-2,4,1,3,0,0,0,0,0,0,0,0,0,0,0,0,0,0,0,4,1,3,0,0,0,0,0,0,0,0,0
164580,31000,310,0,-2,5,1,4,0,0,0,0,0,0,1,1,0,1,0,1,0,0,0,2,0,2,1,0,1,0,0,0,0,0,0
164632,31000,310,0,-2,1,0,1,0,0,0,0,0,0,0,0,0,0,0,0,0,0,0,0,0,0,0,0,0,1,0,1,0,0,0
164739,31000,310,0,-2,4,1,3,0,0,0,0,0,0,0,0,0,0,0,0,0,0,0,4,1,3,0,0,0,0,0,0,0,0,0
164748,31000,310,0,-2,3,0,3,0,0,0,1,0,1,0,0,0,0,0,0,0,0,0,1,0,1,1,0,1,0,0,0,0,0,0
164872,31000,310,0,-2,5,3,2,0,0,0,0,0,0,0,0,0,3,2,1,0,0,0,2,1,1,0,0,0,0,0,0,0,0,0
164924,31000,310,0,-2,24,15,9,0,0,0,0,0,0,6,4,2,0,0,0,0,0,0,17,11,6,1,0,1,0,0,0,0,0,0
164988,31000,310,0,-2,101,15,86,1,1,0,15,3,12,8,1,7,11,1,10,0,0,0,54,5,49,0,0,0,7,3,4,5,1,4
165015,31000,310,0,-2,15,4,11,0,0,0,1,1,0,1,0,1,0,0,0,0,0,0,12,3,9,0,0,0,1,0,1,0,0,0
165024,31000,310,0,-2,9,2,7,0,0,0,1,0,1,0,0,0,0,0,0,0,0,0,7,2,5,1,0,1,0,0,0,0,0,0
165033,31000,310,0,-2,4,2,2,0,0,0,0,0,0,0,0,0,0,0,0,0,0,0,4,2,2,0,0,0,0,0,0,0,0,0
165264,31000,310,0,-2,1,0,1,0,0,0,0,0,0,0,0,0,0,0,0,0,0,0,1,0,1,0,0,0,0,0,0,0,0,0
165334,31000,310,0,-2,6,2,4,0,0,0,1,0,1,0,0,0,0,0,0,0,0,0,5,2,3,0,0,0,0,0,0,0,0,0
165529,31000,310,0,-2,5,2,3,0,0,0,0,0,0,0,0,0,0,0,0,0,0,0,5,2,3,0,0,0,0,0,0,0,0,0
165574,31000,310,0,-2,7,2,5,0,0,0,0,0,0,0,0,0,0,0,0,0,0,0,7,2,5,0,0,0,0,0,0,0,0,0
165662,31000,310,0,-2,3,1,2,0,0,0,0,0,0,0,0,0,0,0,0,0,0,0,3,1,2,0,0,0,0,0,0,0,0,0
165671,31000,310,0,-2,3,0,3,0,0,0,1,0,1,0,0,0,0,0,0,0,0,0,2,0,2,0,0,0,0,0,0,0,0,0
165699,31000,310,0,-2,3,2,1,0,0,0,0,0,0,0,0,0,0,0,0,0,0,0,3,2,1,0,0,0,0,0,0,0,0,0
165802,31000,310,0,-2,1,0,1,0,0,0,0,0,0,1,0,1,0,0,0,0,0,0,0,0,0,0,0,0,0,0,0,0,0,0
165884,31000,310,0,-2,2,0,2,0,0,0,0,0,0,0,0,0,0,0,0,0,0,0,2,0,2,0,0,0,0,0,0,0,0,0
165936,31000,310,0,-2,2,0,2,0,0,0,0,0,0,0,0,0,0,0,0,0,0,0,1,0,1,0,0,0,1,0,1,0,0,0
165945,31000,310,0,-2,1,1,0,0,0,0,0,0,0,0,0,0,0,0,0,0,0,0,1,1,0,0,0,0,0,0,0,0,0,0
165981,31000,310,0,-2,3,0,3,0,0,0,0,0,0,0,0,0,0,0,0,0,0,0,3,0,3,0,0,0,0,0,0,0,0,0
166018,31000,310,0,-2,1,0,1,0,0,0,0,0,0,0,0,0,0,0,0,0,0,0,1,0,1,0,0,0,0,0,0,0,0,0
166027,31000,310,0,-2,239,65,174,0,0,0,35,9,26,29,8,21,25,5,20,0,0,0,136,39,97,13,3,10,0,0,0,1,1,0
166045,31000,310,0,-2,1,0,1,0,0,0,0,0,0,1,0,1,0,0,0,0,0,0,0,0,0,0,0,0,0,0,0,0,0,0
166054,31000,310,0,-2,2,2,0,0,0,0,0,0,0,0,0,0,0,0,0,0,0,0,2,2,0,0,0,0,0,0,0,0,0,0
166124,31000,310,0,-2,11,2,9,0,0,0,0,0,0,1,0,1,1,0,1,0,0,0,8,2,6,0,0,0,1,0,1,0,0,0
166391,31000,310,0,-2,3,0,3,0,0,0,0,0,0,0,0,0,0,0,0,0,0,0,3,0,3,0,0,0,0,0,0,0,0,0
166452,31000,310,0,-2,1,1,0,0,0,0,0,0,0,1,1,0,0,0,0,0,0,0,0,0,0,0,0,0,0,0,0,0,0,0
166513,31000,310,0,-2,15,2,13,0,0,0,2,0,2,2,1,1,0,0,0,0,0,0,8,1,7,0,0,0,3,0,3,0,0,0
166629,31000,310,0,-2,45,11,34,0,0,0,1,0,1,3,1,2,4,1,3,0,0,0,36,8,28,0,0,0,1,1,0,0,0,0
166638,31000,310,0,-2,18,7,11,0,0,0,2,1,1,2,0,2,1,0,1,0,0,0,12,5,7,0,0,0,1,1,0,0,0,0
166647,31000,310,0,-2,1,0,1,0,0,0,0,0,0,0,0,0,0,0,0,0,0,0,1,0,1,0,0,0,0,0,0,0,0,0
166656,31000,310,0,-2,1,0,1,0,0,0,1,0,1,0,0,0,0,0,0,0,0,0,0,0,0,0,0,0,0,0,0,0,0,0
166665,31000,310,0,-2,18,5,13,0,0,0,1,0,1,4,2,2,1,0,1,0,0,0,10,2,8,1,0,1,0,0,0,1,1,0
166674,31000,310,0,-2,1,1,0,0,0,0,0,0,0,1,1,0,0,0,0,0,0,0,0,0,0,0,0,0,0,0,0,0,0,0
166683,31000,310,0,-2,202,77,125,1,1,0,23,8,15,14,5,9,18,7,11,0,0,0,113,41,72,9,6,3,7,1,6,17,8,9
166692,31000,310,0,-2,4,1,3,0,0,0,0,0,0,0,0,0,0,0,0,0,0,0,4,1,3,0,0,0,0,0,0,0,0,0
166708,31000,310,0,-2,181,56,125,0,0,0,10,2,8,13,3,10,15,4,11,0,0,0,131,44,87,0,0,0,7,1,6,5,2,3
166823,31000,310,0,-2,1,1,0,0,0,0,1,1,0,0,0,0,0,0,0,0,0,0,0,0,0,0,0,0,0,0,0,0,0,0
166850,31000,310,0,-2,4,1,3,0,0,0,0,0,0,0,0,0,0,0,0,0,0,0,4,1,3,0,0,0,0,0,0,0,0,0
166869,31000,310,0,-2,2,0,2,0,0,0,0,0,0,0,0,0,1,0,1,0,0,0,1,0,1,0,0,0,0,0,0,0,0,0
166887,31000,310,0,-2,2,1,1,0,0,0,0,0,0,1,1,0,0,0,0,0,0,0,1,0,1,0,0,0,0,0,0,0,0,0
166911,31000,310,0,-2,3,2,1,0,0,0,0,0,0,0,0,0,0,0,0,0,0,0,0,0,0,0,0,0,3,2,1,0,0,0
166939,31000,310,0,-2,2,0,2,0,0,0,0,0,0,0,0,0,0,0,0,0,0,0,1,0,1,0,0,0,1,0,1,0,0,0
167057,31000,310,0,-2,6,2,4,0,0,0,0,0,0,0,0,0,0,0,0,0,0,0,6,2,4,0,0,0,0,0,0,0,0,0
167093,31000,310,0,-2,1,0,1,0,0,0,0,0,0,0,0,0,0,0,0,0,0,0,1,0,1,0,0,0,0,0,0,0,0,0
167288,31000,310,0,-2,1,0,1,0,0,0,0,0,0,0,0,0,0,0,0,0,0,0,1,0,1,0,0,0,0,0,0,0,0,0
167312,31000,310,0,-2,1,0,1,0,0,0,0,0,0,0,0,0,0,0,0,0,0,0,1,0,1,0,0,0,0,0,0,0,0,0
167358,31000,310,0,-2,64,25,39,0,0,0,7,0,7,6,3,3,3,1,2,0,0,0,37,20,17,1,0,1,10,1,9,0,0,0
167376,31000,310,0,-2,3,1,2,0,0,0,1,0,1,0,0,0,0,0,0,0,0,0,1,1,0,0,0,0,1,0,1,0,0,0
167394,31000,310,0,-2,3,1,2,0,0,0,1,0,1,0,0,0,1,1,0,0,0,0,1,0,1,0,0,0,0,0,0,0,0,0
167534,31000,310,0,-2,3,1,2,0,0,0,0,0,0,2,1,1,0,0,0,0,0,0,1,0,1,0,0,0,0,0,0,0,0,0
167631,31000,310,0,-2,1,1,0,0,0,0,0,0,0,1,1,0,0,0,0,0,0,0,0,0,0,0,0,0,0,0,0,0,0,0
167677,31000,310,0,-2,1,1,0,0,0,0,0,0,0,0,0,0,0,0,0,0,0,0,1,1,0,0,0,0,0,0,0,0,0,0
167729,31000,310,0,-2,2,0,2,0,0,0,0,0,0,0,0,0,0,0,0,0,0,0,1,0,1,0,0,0,1,0,1,0,0,0
167783,31000,310,0,-2,9,2,7,0,0,0,0,0,0,0,0,0,0,0,0,0,0,0,8,2,6,0,0,0,1,0,1,0,0,0
167835,31000,310,0,-2,15,3,12,0,0,0,2,0,2,1,1,0,1,0,1,0,0,0,10,2,8,1,0,1,0,0,0,0,0,0
167899,31000,310,0,-2,6,1,5,0,0,0,1,0,1,2,0,2,0,0,0,0,0,0,3,1,2,0,0,0,0,0,0,0,0,0
167905,31000,310,0,-2,2,1,1,0,0,0,0,0,0,1,0,1,0,0,0,0,0,0,1,1,0,0,0,0,0,0,0,0,0,0
167987,31000,310,0,-2,4,0,4,0,0,0,0,0,0,0,0,0,0,0,0,0,0,0,4,0,4,0,0,0,0,0,0,0,0,0
168005,31000,310,0,-2,47,15,32,0,0,0,0,0,0,6,2,4,4,2,2,0,0,0,37,11,26,0,0,0,0,0,0,0,0,0
168148,31000,310,0,-2,58,14,44,0,0,0,2,0,2,3,1,2,6,1,5,0,0,0,37,11,26,2,0,2,7,0,7,1,1,0
168218,31000,310,0,-2,9,3,6,0,0,0,1,0,1,2,2,0,0,0,0,0,0,0,6,1,5,0,0,0,0,0,0,0,0,0
168227,31000,310,0,-2,6,2,4,0,0,0,1,0,1,1,1,0,0,0,0,0,0,0,3,0,3,0,0,0,1,1,0,0,0,0
168254,31000,310,0,-2,6,0,6,0,0,0,0,0,0,0,0,0,1,0,1,0,0,0,3,0,3,0,0,0,2,0,2,0,0,0
168263,31000,310,0,-2,3,1,2,0,0,0,0,0,0,0,0,0,0,0,0,0,0,0,3,1,2,0,0,0,0,0,0,0,0,0
168281,31000,310,0,-2,3,1,2,0,0,0,0,0,0,0,0,0,0,0,0,0,0,0,3,1,2,0,0,0,0,0,0,0,0,0
168342,31000,310,0,-2,1,1,0,0,0,0,0,0,0,0,0,0,1,1,0,0,0,0,0,0,0,0,0,0,0,0,0,0,0,0
168421,31000,310,0,-2,9,5,4,0,0,0,0,0,0,0,0,0,1,1,0,0,0,0,7,4,3,0,0,0,1,0,1,0,0,0
168430,31000,310,0,-2,4,1,3,0,0,0,0,0,0,0,0,0,0,0,0,0,0,0,4,1,3,0,0,0,0,0,0,0,0,0
168528,31000,310,0,-2,3,2,1,0,0,0,0,0,0,0,0,0,0,0,0,0,0,0,3,2,1,0,0,0,0,0,0,0,0,0
168546,31000,310,0,-2,6,3,3,0,0,0,0,0,0,4,3,1,0,0,0,0,0,0,2,0,2,0,0,0,0,0,0,0,0,0
168591,31000,310,0,-2,2,1,1,0,0,0,0,0,0,1,1,0,0,0,0,0,0,0,1,0,1,0,0,0,0,0,0,0,0,0
168740,31000,310,0,-2,9,3,6,0,0,0,1,1,0,2,0,2,2,1,1,0,0,0,3,0,3,0,0,0,1,1,0,0,0,0
168786,31000,310,0,-2,3,0,3,0,0,0,0,0,0,0,0,0,0,0,0,0,0,0,2,0,2,0,0,0,1,0,1,0,0,0
169080,31000,310,0,-2,8,3,5,0,0,0,0,0,0,0,0,0,0,0,0,0,0,0,8,3,5,0,0,0,0,0,0,0,0,0
169275,31000,310,0,-2,1,0,1,0,0,0,0,0,0,0,0,0,0,0,0,0,0,0,1,0,1,0,0,0,0,0,0,0,0,0
169327,31000,310,0,-2,1,0,1,0,0,0,0,0,0,0,0,0,0,0,0,0,0,0,1,0,1,0,0,0,0,0,0,0,0,0
169442,31000,310,0,-2,3,0,3,0,0,0,0,0,0,0,0,0,0,0,0,0,0,0,3,0,3,0,0,0,0,0,0,0,0,0
169479,31000,310,0,-2,7,1,6,0,0,0,1,0,1,1,1,0,1,0,1,0,0,0,4,0,4,0,0,0,0,0,0,0,0,0
169716,31000,310,0,-2,3,1,2,0,0,0,0,0,0,0,0,0,0,0,0,0,0,0,3,1,2,0,0,0,0,0,0,0,0,0
169798,31000,310,0,-2,2,0,2,0,0,0,0,0,0,0,0,0,0,0,0,0,0,0,0,0,0,0,0,0,2,0,2,0,0,0
169910,31000,310,0,-2,5,1,4,0,0,0,0,0,0,1,0,1,0,0,0,0,0,0,4,1,3,0,0,0,0,0,0,0,0,0
169983,31000,310,0,-2,6,0,6,0,0,0,0,0,0,0,0,0,0,0,0,0,0,0,5,0,5,1,0,1,0,0,0,0,0,0
170000,31000,310,0,-2,3,0,3,0,0,0,0,0,0,0,0,0,0,0,0,0,0,0,2,0,2,1,0,1,0,0,0,0,0,0
170055,31000,310,0,-2,3,1,2,1,1,0,0,0,0,0,0,0,0,0,0,0,0,0,2,0,2,0,0,0,0,0,0,0,0,0
170082,31000,310,0,-2,10,2,8,0,0,0,0,0,0,2,0,2,0,0,0,0,0,0,8,2,6,0,0,0,0,0,0,0,0,0
170240,31000,310,0,-2,1,0,1,0,0,0,0,0,0,0,0,0,0,0,0,0,0,0,1,0,1,0,0,0,0,0,0,0,0,0
170286,31000,310,0,-2,4,2,2,0,0,0,0,0,0,0,0,0,0,0,0,0,0,0,0,0,0,0,0,0,4,2,2,0,0,0
170301,31000,310,0,-2,6,1,5,0,0,0,0,0,0,2,1,1,0,0,0,0,0,0,4,0,4,0,0,0,0,0,0,0,0,0
170444,31000,310,0,-2,2,0,2,0,0,0,0,0,0,0,0,0,0,0,0,0,0,0,1,0,1,0,0,0,0,0,0,1,0,1
170532,31000,310,0,-2,1,0,1,0,0,0,0,0,0,0,0,0,0,0,0,0,0,0,1,0,1,0,0,0,0,0,0,0,0,0
170541,31000,310,0,-2,9,3,6,0,0,0,0,0,0,2,1,1,0,0,0,0,0,0,4,2,2,0,0,0,2,0,2,1,0,1
170620,31000,310,0,-2,1,0,1,0,0,0,0,0,0,0,0,0,0,0,0,0,0,0,1,0,1,0,0,0,0,0,0,0,0,0
170639,31000,310,0,-2,13,3,10,0,0,0,0,0,0,0,0,0,0,0,0,0,0,0,11,2,9,0,0,0,2,1,1,0,0,0
170675,31000,310,0,-2,1,0,1,0,0,0,0,0,0,0,0,0,0,0,0,0,0,0,1,0,1,0,0,0,0,0,0,0,0,0
170806,31000,310,0,-2,3,1,2,0,0,0,0,0,0,1,1,0,0,0,0,0,0,0,2,0,2,0,0,0,0,0,0,0,0,0
170976,31000,310,0,-2,203,55,148,1,0,1,9,2,7,26,8,18,7,1,6,0,0,0,150,43,107,6,1,5,1,0,1,3,0,3
171100,31000,310,0,-2,28,13,15,2,2,0,1,0,1,2,1,1,2,1,1,0,0,0,19,8,11,0,0,0,0,0,0,2,1,1
171128,31000,310,0,-2,10,7,3,0,0,0,0,0,0,0,0,0,1,1,0,0,0,0,6,3,3,0,0,0,3,3,0,0,0,0
171137,31000,310,0,-2,7,3,4,0,0,0,0,0,0,1,0,1,0,0,0,0,0,0,5,3,2,1,0,1,0,0,0,0,0,0
171146,31000,310,0,-2,16,2,14,0,0,0,0,0,0,3,1,2,0,0,0,0,0,0,11,1,10,0,0,0,1,0,1,1,0,1
171304,31000,310,0,-2,1,0,1,0,0,0,1,0,1,0,0,0,0,0,0,0,0,0,0,0,0,0,0,0,0,0,0,0,0,0
171456,31000,310,0,-2,2,0,2,0,0,0,0,0,0,0,0,0,1,0,1,0,0,0,1,0,1,0,0,0,0,0,0,0,0,0
171483,31000,310,0,-2,1,0,1,0,0,0,0,0,0,0,0,0,0,0,0,0,0,0,1,0,1,0,0,0,0,0,0,0,0,0
171492,31000,310,0,-2,2,0,2,0,0,0,0,0,0,0,0,0,0,0,0,0,0,0,2,0,2,0,0,0,0,0,0,0,0,0
171535,31000,310,0,-2,2,1,1,0,0,0,0,0,0,0,0,0,0,0,0,0,0,0,2,1,1,0,0,0,0,0,0,0,0,0
171571,31000,310,0,-2,9,6,3,0,0,0,0,0,0,1,0,1,0,0,0,0,0,0,7,5,2,1,1,0,0,0,0,0,0,0
171599,31000,310,0,-2,1,0,1,0,0,0,0,0,0,0,0,0,0,0,0,0,0,0,1,0,1,0,0,0,0,0,0,0,0,0
172051,31000,310,0,-2,4,0,4,0,0,0,0,0,0,1,0,1,0,0,0,0,0,0,3,0,3,0,0,0,0,0,0,0,0,0
172200,31000,310,0,-2,4,2,2,0,0,0,0,0,0,0,0,0,0,0,0,0,0,0,4,2,2,0,0,0,0,0,0,0,0,0
172264,31000,310,0,-2,2,0,2,0,0,0,0,0,0,0,0,0,0,0,0,0,0,0,2,0,2,0,0,0,0,0,0,0,0,0
172291,31000,310,0,-2,2,0,2,0,0,0,0,0,0,1,0,1,0,0,0,0,0,0,1,0,1,0,0,0,0,0,0,0,0,0
172307,31000,310,0,-2,1,1,0,0,0,0,0,0,0,0,0,0,0,0,0,0,0,0,0,0,0,1,1,0,0,0,0,0,0,0
172334,31000,310,0,-2,2,0,2,0,0,0,0,0,0,0,0,0,0,0,0,0,0,0,2,0,2,0,0,0,0,0,0,0,0,0
172440,31000,310,0,-2,1,0,1,0,0,0,0,0,0,0,0,0,0,0,0,0,0,0,1,0,1,0,0,0,0,0,0,0,0,0
172477,31000,310,0,-2,1,0,1,0,0,0,0,0,0,0,0,0,0,0,0,0,0,0,1,0,1,0,0,0,0,0,0,0,0,0
172608,31000,310,0,-2,1,1,0,0,0,0,0,0,0,0,0,0,0,0,0,0,0,0,1,1,0,0,0,0,0,0,0,0,0,0
172617,31000,310,0,-2,2,1,1,0,0,0,0,0,0,0,0,0,1,1,0,0,0,0,1,0,1,0,0,0,0,0,0,0,0,0
172644,31000,310,0,-2,56,15,41,0,0,0,2,0,2,26,4,22,1,0,1,0,0,0,24,9,15,1,1,0,1,1,0,1,0,1
172671,31000,310,0,-2,1,0,1,0,0,0,0,0,0,0,0,0,0,0,0,0,0,0,1,0,1,0,0,0,0,0,0,0,0,0
172699,31000,310,0,-2,5,2,3,1,0,1,0,0,0,0,0,0,0,0,0,0,0,0,4,2,2,0,0,0,0,0,0,0,0,0
173045,31000,310,0,-2,7,2,5,0,0,0,1,0,1,0,0,0,0,0,0,0,0,0,6,2,4,0,0,0,0,0,0,0,0,0
173063,31000,310,0,-2,1,0,1,0,0,0,0,0,0,0,0,0,0,0,0,0,0,0,1,0,1,0,0,0,0,0,0,0,0,0
173160,31000,310,0,-2,1,0,1,0,0,0,0,0,0,0,0,0,0,0,0,0,0,0,1,0,1,0,0,0,0,0,0,0,0,0
173258,31000,310,0,-2,4,1,3,0,0,0,1,0,1,0,0,0,0,0,0,0,0,0,2,0,2,0,0,0,0,0,0,1,1,0
173300,31000,310,0,-2,3,2,1,0,0,0,0,0,0,0,0,0,0,0,0,0,0,0,2,2,0,1,0,1,0,0,0,0,0,0
173328,31000,310,0,-2,1,0,1,0,0,0,0,0,0,0,0,0,0,0,0,0,0,0,1,0,1,0,0,0,0,0,0,0,0,0
173416,31000,310,0,-2,1,1,0,1,1,0,0,0,0,0,0,0,0,0,0,0,0,0,0,0,0,0,0,0,0,0,0,0,0,0
173665,31000,310,0,-2,6,0,6,0,0,0,1,0,1,0,0,0,0,0,0,0,0,0,5,0,5,0,0,0,0,0,0,0,0,0
173708,31000,310,0,-2,4,1,3,0,0,0,1,0,1,0,0,0,0,0,0,0,0,0,3,1,2,0,0,0,0,0,0,0,0,0
173902,31000,310,0,-2,9,1,8,0,0,0,1,0,1,2,0,2,1,0,1,0,0,0,4,0,4,1,1,0,0,0,0,0,0,0
173911,31000,310,0,-2,2,1,1,0,0,0,0,0,0,0,0,0,0,0,0,0,0,0,2,1,1,0,0,0,0,0,0,0,0,0
173920,31000,310,0,-2,1,0,1,0,0,0,0,0,0,0,0,0,0,0,0,0,0,0,1,0,1,0,0,0,0,0,0,0,0,0
173957,31000,310,0,-2,2,1,1,0,0,0,1,0,1,0,0,0,0,0,0,0,0,0,1,1,0,0,0,0,0,0,0,0,0,0
174020,31000,310,0,-2,1,0,1,0,0,0,1,0,1,0,0,0,0,0,0,0,0,0,0,0,0,0,0,0,0,0,0,0,0,0
174066,31000,310,0,-2,197,55,142,0,0,0,23,5,18,17,8,9,12,2,10,0,0,0,127,36,91,7,0,7,7,3,4,4,1,3
174075,31000,310,0,-2,7,4,3,0,0,0,1,1,0,0,0,0,2,0,2,0,0,0,4,3,1,0,0,0,0,0,0,0,0,0
174127,31000,310,0,-2,3,2,1,0,0,0,0,0,0,0,0,0,0,0,0,0,0,0,0,0,0,2,1,1,1,1,0,0,0,0
174233,31000,310,0,-2,7,3,4,1,0,1,1,0,1,0,0,0,0,0,0,0,0,0,5,3,2,0,0,0,0,0,0,0,0,0
174251,31000,310,0,-2,8,3,5,1,0,1,1,0,1,2,1,1,0,0,0,0,0,0,3,2,1,1,0,1,0,0,0,0,0,0
174358,31000,310,0,-2,1,0,1,0,0,0,0,0,0,0,0,0,0,0,0,0,0,0,1,0,1,0,0,0,0,0,0,0,0,0
174376,31000,310,0,-2,3,1,2,0,0,0,1,0,1,0,0,0,0,0,0,0,0,0,1,0,1,1,1,0,0,0,0,0,0,0
174428,31000,310,0,-2,3,1,2,0,0,0,0,0,0,1,1,0,0,0,0,0,0,0,1,0,1,0,0,0,1,0,1,0,0,0
174437,31000,310,0,-2,1,0,1,0,0,0,0,0,0,0,0,0,0,0,0,0,0,0,1,0,1,0,0,0,0,0,0,0,0,0
174491,31000,310,0,-2,1,1,0,0,0,0,0,0,0,0,0,0,0,0,0,0,0,0,1,1,0,0,0,0,0,0,0,0,0,0
174507,31000,310,0,-2,1,0,1,0,0,0,0,0,0,0,0,0,0,0,0,0,0,0,1,0,1,0,0,0,0,0,0,0,0,0
174570,31000,310,0,-2,1,1,0,0,0,0,0,0,0,0,0,0,0,0,0,0,0,0,1,1,0,0,0,0,0,0,0,0,0,0
174738,31000,310,0,-2,1,0,1,0,0,0,0,0,0,0,0,0,0,0,0,0,0,0,1,0,1,0,0,0,0,0,0,0,0,0
174747,31000,310,0,-2,1,0,1,0,0,0,0,0,0,0,0,0,0,0,0,0,0,0,1,0,1,0,0,0,0,0,0,0,0,0
174756,31000,310,0,-2,1,0,1,0,0,0,0,0,0,0,0,0,0,0,0,0,0,0,1,0,1,0,0,0,0,0,0,0,0,0
174783,31000,310,0,-2,2,2,0,0,0,0,0,0,0,0,0,0,0,0,0,0,0,0,2,2,0,0,0,0,0,0,0,0,0,0
174792,31000,310,0,-2,8,4,4,0,0,0,0,0,0,0,0,0,0,0,0,0,0,0,8,4,4,0,0,0,0,0,0,0,0,0
174817,31000,310,0,-2,5,1,4,0,0,0,0,0,0,0,0,0,0,0,0,0,0,0,4,1,3,0,0,0,1,0,1,0,0,0
174844,31000,310,0,-2,5,0,5,0,0,0,0,0,0,0,0,0,0,0,0,0,0,0,5,0,5,0,0,0,0,0,0,0,0,0
174914,31000,310,0,-2,12,3,9,0,0,0,2,1,1,0,0,0,3,0,3,0,0,0,7,2,5,0,0,0,0,0,0,0,0,0
175005,31000,310,0,-2,6,3,3,0,0,0,0,0,0,0,0,0,0,0,0,0,0,0,6,3,3,0,0,0,0,0,0,0,0,0
175014,31000,310,0,-2,2,0,2,0,0,0,0,0,0,0,0,0,0,0,0,0,0,0,2,0,2,0,0,0,0,0,0,0,0,0
175227,31000,310,0,-2,2,0,2,0,0,0,0,0,0,0,0,0,1,0,1,0,0,0,1,0,1,0,0,0,0,0,0,0,0,0
175272,31000,310,0,-2,2,0,2,0,0,0,0,0,0,0,0,0,0,0,0,0,0,0,2,0,2,0,0,0,0,0,0,0,0,0
175281,31000,310,0,-2,11,3,8,0,0,0,1,1,0,1,1,0,0,0,0,0,0,0,7,1,6,0,0,0,2,0,2,0,0,0
175643,31000,310,0,-2,1,1,0,0,0,0,0,0,0,0,0,0,0,0,0,0,0,0,1,1,0,0,0,0,0,0,0,0,0,0
175652,31000,310,0,-2,1,0,1,0,0,0,0,0,0,1,0,1,0,0,0,0,0,0,0,0,0,0,0,0,0,0,0,0,0,0
175786,31000,310,0,-2,4,1,3,0,0,0,0,0,0,3,0,3,0,0,0,0,0,0,1,1,0,0,0,0,0,0,0,0,0,0
175829,31000,310,0,-2,1,0,1,0,0,0,0,0,0,0,0,0,0,0,0,0,0,0,1,0,1,0,0,0,0,0,0,0,0,0
175856,31000,310,0,-2,2,0,2,0,0,0,0,0,0,2,0,2,0,0,0,0,0,0,0,0,0,0,0,0,0,0,0,0,0,0
175935,31000,310,0,-2,4,0,4,0,0,0,0,0,0,0,0,0,0,0,0,0,0,0,4,0,4,0,0,0,0,0,0,0,0,0
176008,31000,310,0,-2,5,0,5,0,0,0,0,0,0,2,0,2,0,0,0,0,0,0,3,0,3,0,0,0,0,0,0,0,0,0
176017,31000,310,0,-2,107,29,78,0,0,0,0,0,0,37,5,32,4,1,3,0,0,0,60,18,42,3,2,1,1,1,0,2,2,0
176044,31000,310,0,-2,5,2,3,0,0,0,0,0,0,5,2,3,0,0,0,0,0,0,0,0,0,0,0,0,0,0,0,0,0,0
176053,31000,310,0,-2,9,2,7,0,0,0,0,0,0,0,0,0,0,0,0,0,0,0,5,1,4,0,0,0,4,1,3,0,0,0
176071,31000,310,0,-2,6,0,6,0,0,0,0,0,0,1,0,1,0,0,0,0,0,0,5,0,5,0,0,0,0,0,0,0,0,0
176080,31000,310,0,-2,59,21,38,0,0,0,0,0,0,9,1,8,0,0,0,0,0,0,48,20,28,0,0,0,1,0,1,1,0,1
176169,31000,310,0,-2,1,0,1,0,0,0,0,0,0,0,0,0,0,0,0,0,0,0,1,0,1,0,0,0,0,0,0,0,0,0
176178,31000,310,0,-2,3,1,2,0,0,0,0,0,0,1,0,1,0,0,0,0,0,0,2,1,1,0,0,0,0,0,0,0,0,0
176318,31000,310,0,-2,2,0,2,0,0,0,0,0,0,2,0,2,0,0,0,0,0,0,0,0,0,0,0,0,0,0,0,0,0,0
176406,31000,310,0,-2,3,1,2,0,0,0,0,0,0,3,1,2,0,0,0,0,0,0,0,0,0,0,0,0,0,0,0,0,0,0
176479,31000,310,0,-2,1,1,0,0,0,0,0,0,0,0,0,0,0,0,0,0,0,0,1,1,0,0,0,0,0,0,0,0,0,0
176628,31000,310,0,-2,4,0,4,0,0,0,0,0,0,1,0,1,0,0,0,0,0,0,3,0,3,0,0,0,0,0,0,0,0,0
176789,31000,310,0,-2,1,0,1,0,0,0,0,0,0,0,0,0,0,0,0,0,0,0,1,0,1,0,0,0,0,0,0,0,0,0
176947,31000,310,0,-2,2,1,1,0,0,0,0,0,0,0,0,0,0,0,0,0,0,0,2,1,1,0,0,0,0,0,0,0,0,0
176965,31000,310,0,-2,17,6,11,0,0,0,1,0,1,1,1,0,0,0,0,0,0,0,14,4,10,0,0,0,0,0,0,1,1,0
177038,31000,310,0,-2,1,1,0,0,0,0,0,0,0,0,0,0,0,0,0,0,0,0,1,1,0,0,0,0,0,0,0,0,0,0
177065,31000,310,0,-2,5,3,2,0,0,0,1,1,0,0,0,0,0,0,0,0,0,0,3,2,1,0,0,0,1,0,1,0,0,0
177092,31000,310,0,-2,2,1,1,0,0,0,0,0,0,0,0,0,0,0,0,0,0,0,2,1,1,0,0,0,0,0,0,0,0,0
177126,31000,310,0,-2,1,1,0,0,0,0,0,0,0,0,0,0,0,0,0,0,0,0,1,1,0,0,0,0,0,0,0,0,0,0
177214,31000,310,0,-2,2,0,2,0,0,0,0,0,0,0,0,0,0,0,0,0,0,0,0,0,0,0,0,0,2,0,2,0,0,0
177250,31000,310,0,-2,1,0,1,0,0,0,0,0,0,0,0,0,0,0,0,0,0,0,1,0,1,0,0,0,0,0,0,0,0,0
177302,31000,310,0,-2,4,1,3,0,0,0,0,0,0,2,0,2,0,0,0,0,0,0,1,0,1,1,1,0,0,0,0,0,0,0
177472,31000,310,0,-2,2,2,0,0,0,0,0,0,0,0,0,0,0,0,0,0,0,0,2,2,0,0,0,0,0,0,0,0,0,0
177551,31000,310,0,-2,1,0,1,0,0,0,0,0,0,0,0,0,0,0,0,0,0,0,1,0,1,0,0,0,0,0,0,0,0,0
177676,31000,310,0,-2,1,0,1,0,0,0,0,0,0,0,0,0,0,0,0,0,0,0,1,0,1,0,0,0,0,0,0,0,0,0
177746,31000,310,0,-2,1,0,1,0,0,0,0,0,0,0,0,0,1,0,1,0,0,0,0,0,0,0,0,0,0,0,0,0,0,0
177940,31000,310,0,-2,1,0,1,0,0,0,0,0,0,1,0,1,0,0,0,0,0,0,0,0,0,0,0,0,0,0,0,0,0,0
177968,31000,310,0,-2,9,2,7,0,0,0,0,0,0,3,1,2,0,0,0,0,0,0,4,1,3,2,0,2,0,0,0,0,0,0
177977,31000,310,0,-2,2,1,1,0,0,0,1,1,0,0,0,0,0,0,0,0,0,0,1,0,1,0,0,0,0,0,0,0,0,0
177986,31000,310,0,-2,2,0,2,0,0,0,1,0,1,0,0,0,0,0,0,0,0,0,1,0,1,0,0,0,0,0,0,0,0,0
177995,31000,310,0,-2,3,2,1,0,0,0,0,0,0,0,0,0,0,0,0,0,0,0,3,2,1,0,0,0,0,0,0,0,0,0
178059,31000,310,0,-2,2,1,1,0,0,0,0,0,0,1,1,0,0,0,0,0,0,0,1,0,1,0,0,0,0,0,0,0,0,0
178217,31000,310,0,-2,1,0,1,0,0,0,0,0,0,0,0,0,0,0,0,0,0,0,1,0,1,0,0,0,0,0,0,0,0,0
178244,31000,310,0,-2,2,1,1,0,0,0,0,0,0,0,0,0,0,0,0,0,0,0,2,1,1,0,0,0,0,0,0,0,0,0
178341,31000,310,0,-2,1,0,1,0,0,0,0,0,0,0,0,0,0,0,0,0,0,0,1,0,1,0,0,0,0,0,0,0,0,0
178369,31000,310,0,-2,1,0,1,0,0,0,0,0,0,0,0,0,0,0,0,0,0,0,1,0,1,0,0,0,0,0,0,0,0,0
178387,31000,310,0,-2,2,1,1,0,0,0,0,0,0,0,0,0,0,0,0,0,0,0,2,1,1,0,0,0,0,0,0,0,0,0
178396,31000,310,0,-2,76,19,57,1,0,1,4,1,3,9,5,4,2,0,2,1,0,1,54,12,42,1,1,0,3,0,3,1,0,1
178402,31000,310,0,-2,35,8,27,0,0,0,0,0,0,3,1,2,2,0,2,0,0,0,25,7,18,2,0,2,1,0,1,2,0,2
178411,31000,310,0,-2,9,1,8,0,0,0,1,0,1,1,0,1,0,0,0,0,0,0,7,1,6,0,0,0,0,0,0,0,0,0
178420,31000,310,0,-2,22,7,15,0,0,0,1,1,0,3,1,2,1,1,0,0,0,0,16,4,12,1,0,1,0,0,0,0,0,0
178439,31000,310,0,-2,19,6,13,0,0,0,0,0,0,2,0,2,1,1,0,0,0,0,15,4,11,0,0,0,1,1,0,0,0,0
178448,31000,310,0,-2,3,1,2,0,0,0,0,0,0,0,0,0,0,0,0,0,0,0,3,1,2,0,0,0,0,0,0,0,0,0
178615,31000,310,0,-2,5,3,2,0,0,0,0,0,0,0,0,0,0,0,0,0,0,0,5,3,2,0,0,0,0,0,0,0,0,0
178624,31000,310,0,-2,17,5,12,0,0,0,0,0,0,1,0,1,0,0,0,0,0,0,15,5,10,1,0,1,0,0,0,0,0,0
178721,31000,310,0,-2,5,1,4,0,0,0,0,0,0,0,0,0,1,1,0,0,0,0,3,0,3,0,0,0,1,0,1,0,0,0
178891,31000,310,0,-2,4,2,2,0,0,0,0,0,0,4,2,2,0,0,0,0,0,0,0,0,0,0,0,0,0,0,0,0,0,0
179043,31000,310,0,-2,5,0,5,0,0,0,0,0,0,0,0,0,0,0,0,0,0,0,5,0,5,0,0,0,0,0,0,0,0,0
179159,31000,310,0,-2,48,20,28,0,0,0,2,0,2,2,0,2,1,0,1,0,0,0,41,19,22,1,1,0,0,0,0,1,0,1
179308,31000,310,0,-2,51,9,42,0,0,0,1,0,1,19,4,15,4,3,1,0,0,0,22,2,20,1,0,1,3,0,3,1,0,1
179326,31000,310,0,-2,2,0,2,0,0,0,0,0,0,0,0,0,0,0,0,0,0,0,2,0,2,0,0,0,0,0,0,0,0,0
179344,31000,310,0,-2,2,1,1,0,0,0,0,0,0,0,0,0,0,0,0,0,0,0,2,1,1,0,0,0,0,0,0,0,0,0
179548,31000,310,0,-2,3,1,2,0,0,0,0,0,0,0,0,0,0,0,0,0,0,0,3,1,2,0,0,0,0,0,0,0,0,0
179557,31000,310,0,-2,16,5,11,0,0,0,0,0,0,1,0,1,1,0,1,0,0,0,14,5,9,0,0,0,0,0,0,0,0,0
179566,31000,310,0,-2,20,6,14,0,0,0,1,0,1,3,1,2,0,0,0,0,0,0,15,5,10,0,0,0,0,0,0,1,0,1
179645,31000,310,0,-2,1,0,1,0,0,0,0,0,0,0,0,0,0,0,0,0,0,0,1,0,1,0,0,0,0,0,0,0,0,0
179715,31000,310,0,-2,1,0,1,0,0,0,0,0,0,0,0,0,0,0,0,0,0,0,1,0,1,0,0,0,0,0,0,0,0,0
179812,31000,310,0,-2,2,0,2,0,0,0,0,0,0,0,0,0,0,0,0,0,0,0,2,0,2,0,0,0,0,0,0,0,0,0
179867,31000,310,0,-2,182,48,134,1,0,1,6,1,5,29,5,24,4,1,3,0,0,0,135,38,97,5,1,4,2,2,0,0,0,0
179894,31000,310,0,-2,4,1,3,0,0,0,0,0,0,3,1,2,0,0,0,0,0,0,1,0,1,0,0,0,0,0,0,0,0,0
179946,31000,310,0,-2,1,0,1,0,0,0,0,0,0,0,0,0,0,0,0,0,0,0,1,0,1,0,0,0,0,0,0,0,0,0
179955,31000,310,0,-2,2,1,1,0,0,0,0,0,0,1,1,0,0,0,0,0,0,0,1,0,1,0,0,0,0,0,0,0,0,0
179964,31000,310,0,-2,2,1,1,0,0,0,0,0,0,0,0,0,0,0,0,0,0,0,2,1,1,0,0,0,0,0,0,0,0,0
180054,31000,310,0,-2,2,0,2,2,0,2,0,0,0,0,0,0,0,0,0,0,0,0,0,0,0,0,0,0,0,0,0,0,0,0
180106,31000,310,0,-2,6,0,6,0,0,0,0,0,0,0,0,0,0,0,0,0,0,0,2,0,2,0,0,0,4,0,4,0,0,0
180179,31000,310,0,-2,7,0,7,0,0,0,0,0,0,0,0,0,0,0,0,0,0,0,7,0,7,0,0,0,0,0,0,0,0,0
180197,31000,310,0,-2,2,1,1,0,0,0,0,0,0,0,0,0,1,1,0,0,0,0,1,0,1,0,0,0,0,0,0,0,0,0
180258,31000,310,0,-2,1,0,1,0,0,0,0,0,0,0,0,0,0,0,0,0,0,0,1,0,1,0,0,0,0,0,0,0,0,0
180276,31000,310,0,-2,1,0,1,0,0,0,0,0,0,0,0,0,0,0,0,0,0,0,1,0,1,0,0,0,0,0,0,0,0,0
180328,31000,310,0,-2,1,0,1,0,0,0,0,0,0,0,0,0,0,0,0,0,0,0,0,0,0,1,0,1,0,0,0,0,0,0
180416,31000,310,0,-2,3,0,3,0,0,0,0,0,0,0,0,0,0,0,0,0,0,0,3,0,3,0,0,0,0,0,0,0,0,0
180461,31000,310,0,-2,43,12,31,1,0,1,0,0,0,0,0,0,2,0,2,0,0,0,37,9,28,0,0,0,3,3,0,0,0,0
180489,31000,310,0,-2,22,3,19,1,0,1,1,0,1,0,0,0,1,1,0,0,0,0,18,2,16,0,0,0,1,0,1,0,0,0
180522,31000,310,0,-2,1,0,1,0,0,0,0,0,0,0,0,0,0,0,0,0,0,0,1,0,1,0,0,0,0,0,0,0,0,0
180647,31000,310,0,-2,4,0,4,2,0,2,0,0,0,0,0,0,0,0,0,0,0,0,2,0,2,0,0,0,0,0,0,0,0,0
180692,31000,310,0,-2,1,0,1,0,0,0,0,0,0,0,0,0,0,0,0,0,0,0,0,0,0,0,0,0,1,0,1,0,0,0
180814,31000,310,0,-2,9,2,7,0,0,0,0,0,0,0,0,0,0,0,0,0,0,0,8,2,6,1,0,1,0,0,0,0,0,0
180832,31000,310,0,-2,3,0,3,0,0,0,0,0,0,0,0,0,0,0,0,0,0,0,3,0,3,0,0,0,0,0,0,0,0,0
180878,31000,310,0,-2,1,0,1,0,0,0,0,0,0,0,0,0,0,0,0,0,0,0,1,0,1,0,0,0,0,0,0,0,0,0
180902,31000,310,0,-2,1,0,1,0,0,0,0,0,0,0,0,0,0,0,0,0,0,0,1,0,1,0,0,0,0,0,0,0,0,0
180948,31000,310,0,-2,1,0,1,0,0,0,0,0,0,0,0,0,0,0,0,0,0,0,1,0,1,0,0,0,0,0,0,0,0,0
180984,31000,310,0,-2,2,0,2,0,0,0,0,0,0,0,0,0,0,0,0,0,0,0,2,0,2,0,0,0,0,0,0,0,0,0
181002,31000,310,0,-2,62,24,38,0,0,0,4,1,3,2,0,2,7,4,3,0,0,0,35,13,22,1,1,0,13,5,8,0,0,0
181020,31000,310,0,-2,2,1,1,0,0,0,0,0,0,0,0,0,0,0,0,0,0,0,2,1,1,0,0,0,0,0,0,0,0,0
181127,31000,310,0,-2,4,1,3,0,0,0,0,0,0,0,0,0,0,0,0,0,0,0,4,1,3,0,0,0,0,0,0,0,0,0
181215,31000,310,0,-2,1,0,1,0,0,0,0,0,0,0,0,0,1,0,1,0,0,0,0,0,0,0,0,0,0,0,0,0,0,0
181303,31000,310,0,-2,7,3,4,0,0,0,2,0,2,0,0,0,0,0,0,0,0,0,5,3,2,0,0,0,0,0,0,0,0,0
181330,31000,310,0,-2,3,1,2,0,0,0,0,0,0,0,0,0,1,0,1,0,0,0,2,1,1,0,0,0,0,0,0,0,0,0
181394,31000,310,0,-2,2,0,2,0,0,0,0,0,0,0,0,0,2,0,2,0,0,0,0,0,0,0,0,0,0,0,0,0,0,0
181419,31000,310,0,-2,3,0,3,2,0,2,0,0,0,0,0,0,0,0,0,0,0,0,1,0,1,0,0,0,0,0,0,0,0,0
181428,31000,310,0,-2,21,8,13,0,0,0,0,0,0,2,0,2,3,3,0,0,0,0,15,4,11,1,1,0,0,0,0,0,0,0
181446,31000,310,0,-2,1,0,1,0,0,0,0,0,0,0,0,0,0,0,0,0,0,0,1,0,1,0,0,0,0,0,0,0,0,0
181464,31000,310,0,-2,43,19,24,0,0,0,2,0,2,1,0,1,2,1,1,0,0,0,34,17,17,0,0,0,1,1,0,3,0,3
181491,31000,310,0,-2,1,0,1,0,0,0,0,0,0,0,0,0,0,0,0,0,0,0,1,0,1,0,0,0,0,0,0,0,0,0
181534,31000,310,0,-2,1,1,0,0,0,0,0,0,0,0,0,0,0,0,0,0,0,0,1,1,0,0,0,0,0,0,0,0,0,0
181604,31000,310,0,-2,2,0,2,0,0,0,0,0,0,2,0,2,0,0,0,0,0,0,0,0,0,0,0,0,0,0,0,0,0,0
181640,31000,310,0,-2,1,0,1,0,0,0,0,0,0,0,0,0,0,0,0,0,0,0,1,0,1,0,0,0,0,0,0,0,0,0
181738,31000,310,0,-2,3,0,3,0,0,0,0,0,0,1,0,1,0,0,0,0,0,0,2,0,2,0,0,0,0,0,0,0,0,0
181747,31000,310,0,-2,5,2,3,0,0,0,0,0,0,1,0,1,0,0,0,0,0,0,4,2,2,0,0,0,0,0,0,0,0,0
181783,31000,310,0,-2,4,2,2,0,0,0,0,0,0,1,1,0,0,0,0,0,0,0,3,1,2,0,0,0,0,0,0,0,0,0
181817,31000,310,0,-2,2,2,0,0,0,0,0,0,0,0,0,0,0,0,0,0,0,0,2,2,0,0,0,0,0,0,0,0,0,0
182005,31000,310,0,-2,10,4,6,0,0,0,0,0,0,0,0,0,2,1,1,0,0,0,7,3,4,1,0,1,0,0,0,0,0,0
182148,31000,310,0,-2,1,0,1,0,0,0,0,0,0,1,0,1,0,0,0,0,0,0,0,0,0,0,0,0,0,0,0,0,0,0
182281,31000,310,0,-2,38,14,24,1,1,0,7,2,5,4,1,3,7,4,3,1,0,1,15,4,11,2,2,0,0,0,0,1,0,1
182290,31000,310,0,-2,45,19,26,0,0,0,1,0,1,2,1,1,9,3,6,0,0,0,30,15,15,3,0,3,0,0,0,0,0,0
182306,31000,310,0,-2,4,3,1,0,0,0,0,0,0,0,0,0,1,1,0,0,0,0,2,1,1,1,1,0,0,0,0,0,0,0
182458,31000,310,0,-2,1,0,1,0,0,0,0,0,0,0,0,0,0,0,0,1,0,1,0,0,0,0,0,0,0,0,0,0,0,0
182500,31000,310,0,-2,7,1,6,0,0,0,0,0,0,0,0,0,4,1,3,0,0,0,2,0,2,1,0,1,0,0,0,0,0,0
182519,31000,310,0,-2,5,4,1,0,0,0,0,0,0,1,1,0,2,2,0,0,0,0,2,1,1,0,0,0,0,0,0,0,0,0
182564,31000,310,0,-2,1,0,1,0,0,0,0,0,0,0,0,0,0,0,0,0,0,0,1,0,1,0,0,0,0,0,0,0,0,0
182634,31000,310,0,-2,3,0,3,0,0,0,0,0,0,0,0,0,0,0,0,0,0,0,3,0,3,0,0,0,0,0,0,0,0,0
182670,31000,310,0,-2,18,5,13,0,0,0,0,0,0,1,0,1,0,0,0,0,0,0,16,5,11,1,0,1,0,0,0,0,0,0
182795,31000,310,0,-2,2,0,2,0,0,0,0,0,0,0,0,0,0,0,0,0,0,0,2,0,2,0,0,0,0,0,0,0,0,0
182829,31000,310,0,-2,1,1,0,0,0,0,0,0,0,0,0,0,0,0,0,0,0,0,1,1,0,0,0,0,0,0,0,0,0,0
183026,31000,310,0,-2,208,89,119,0,0,0,6,1,5,26,7,19,4,1,3,0,0,0,136,62,74,7,5,2,29,13,16,0,0,0
183044,31000,310,0,-2,22,8,14,0,0,0,0,0,0,1,1,0,1,0,1,0,0,0,19,7,12,1,0,1,0,0,0,0,0,0
183062,31000,310,0,-2,2,0,2,0,0,0,0,0,0,0,0,0,0,0,0,0,0,0,2,0,2,0,0,0,0,0,0,0,0,0
183080,31000,310,0,-2,3,0,3,0,0,0,0,0,0,0,0,0,0,0,0,0,0,0,2,0,2,0,0,0,1,0,1,0,0,0
183114,31000,310,0,-2,1,0,1,0,0,0,0,0,0,0,0,0,0,0,0,0,0,0,1,0,1,0,0,0,0,0,0,0,0,0
183123,31000,310,0,-2,1,0,1,0,0,0,0,0,0,0,0,0,0,0,0,0,0,0,0,0,0,0,0,0,1,0,1,0,0,0
183211,31000,310,0,-2,4,0,4,0,0,0,0,0,0,0,0,0,0,0,0,0,0,0,4,0,4,0,0,0,0,0,0,0,0,0
183239,31000,310,0,-2,4,2,2,0,0,0,0,0,0,0,0,0,0,0,0,0,0,0,3,1,2,0,0,0,1,1,0,0,0,0
183257,31000,310,0,-2,1,0,1,0,0,0,0,0,0,0,0,0,0,0,0,0,0,0,1,0,1,0,0,0,0,0,0,0,0,0
183327,31000,310,0,-2,9,2,7,0,0,0,1,0,1,0,0,0,1,0,1,0,0,0,5,2,3,1,0,1,1,0,1,0,0,0
183655,31000,310,0,-2,1,0,1,0,0,0,0,0,0,0,0,0,0,0,0,0,0,0,1,0,1,0,0,0,0,0,0,0,0,0
183743,31000,310,0,-2,4,1,3,0,0,0,0,0,0,2,0,2,0,0,0,0,0,0,2,1,1,0,0,0,0,0,0,0,0,0
183859,31000,310,0,-2,3,2,1,0,0,0,0,0,0,0,0,0,0,0,0,0,0,0,3,2,1,0,0,0,0,0,0,0,0,0
183910,31000,310,0,-2,1,1,0,0,0,0,0,0,0,0,0,0,0,0,0,0,0,0,1,1,0,0,0,0,0,0,0,0,0,0
183974,31000,310,0,-2,1,0,1,0,0,0,0,0,0,0,0,0,1,0,1,0,0,0,0,0,0,0,0,0,0,0,0,0,0,0
184180,31000,310,0,-2,1,0,1,0,0,0,0,0,0,0,0,0,1,0,1,0,0,0,0,0,0,0,0,0,0,0,0,0,0,0
184205,31000,310,0,-2,3,0,3,0,0,0,0,0,0,0,0,0,0,0,0,0,0,0,3,0,3,0,0,0,0,0,0,0,0,0
184348,31000,310,0,-2,5,1,4,0,0,0,0,0,0,0,0,0,0,0,0,0,0,0,5,1,4,0,0,0,0,0,0,0,0,0
184603,31000,310,0,-2,4,1,3,0,0,0,0,0,0,0,0,0,0,0,0,0,0,0,3,0,3,1,1,0,0,0,0,0,0,0
184612,31000,310,0,-2,2,0,2,0,0,0,0,0,0,1,0,1,0,0,0,0,0,0,1,0,1,0,0,0,0,0,0,0,0,0
184694,31000,310,0,-2,1,1,0,0,0,0,0,0,0,1,1,0,0,0,0,0,0,0,0,0,0,0,0,0,0,0,0,0,0,0
184773,31000,310,0,-2,5,3,2,0,0,0,0,0,0,0,0,0,1,1,0,0,0,0,4,2,2,0,0,0,0,0,0,0,0,0
184782,31000,310,0,-2,52,17,35,0,0,0,0,0,0,10,4,6,1,0,1,0,0,0,34,10,24,2,0,2,0,0,0,5,3,2
184791,31000,310,0,-2,6,2,4,0,0,0,0,0,0,3,1,2,0,0,0,0,0,0,2,1,1,0,0,0,1,0,1,0,0,0
184995,31000,310,0,-2,2,1,1,0,0,0,1,1,0,1,0,1,0,0,0,0,0,0,0,0,0,0,0,0,0,0,0,0,0,0
185509,31000,310,0,-2,3,2,1,0,0,0,0,0,0,0,0,0,0,0,0,0,0,0,3,2,1,0,0,0,0,0,0,0,0,0
185572,31000,310,0,-2,1,1,0,0,0,0,0,0,0,0,0,0,0,0,0,0,0,0,1,1,0,0,0,0,0,0,0,0,0,0
185590,31000,310,0,-2,27,7,20,0,0,0,2,0,2,5,1,4,5,2,3,0,0,0,8,3,5,1,0,1,5,1,4,1,0,1
185828,31000,310,0,-2,24,11,13,0,0,0,5,1,4,3,2,1,1,0,1,0,0,0,14,8,6,0,0,0,1,0,1,0,0,0
185873,31000,310,0,-2,6,2,4,0,0,0,1,1,0,0,0,0,0,0,0,0,0,0,5,1,4,0,0,0,0,0,0,0,0,0
186034,31000,310,0,-2,2,1,1,0,0,0,0,0,0,0,0,0,1,1,0,0,0,0,1,0,1,0,0,0,0,0,0,0,0,0
186122,31000,310,0,-2,1,0,1,0,0,0,0,0,0,0,0,0,0,0,0,0,0,0,1,0,1,0,0,0,0,0,0,0,0,0
186131,31000,310,0,-2,22,8,14,1,0,1,3,1,2,3,2,1,1,1,0,0,0,0,10,3,7,2,0,2,2,1,1,0,0,0
186201,31000,310,0,-2,2,0,2,0,0,0,0,0,0,1,0,1,0,0,0,0,0,0,1,0,1,0,0,0,0,0,0,0,0,0
186283,31000,310,0,-2,3,3,0,0,0,0,0,0,0,0,0,0,1,1,0,0,0,0,2,2,0,0,0,0,0,0,0,0,0,0
186371,31000,310,0,-2,13,6,7,0,0,0,0,0,0,1,0,1,1,1,0,0,0,0,4,2,2,0,0,0,7,3,4,0,0,0
186380,31000,310,0,-2,167,58,109,0,0,0,8,1,7,16,4,12,9,4,5,0,0,0,26,11,15,1,0,1,103,35,68,4,3,1
186399,31000,310,0,-2,21,6,15,0,0,0,0,0,0,1,0,1,1,0,1,0,0,0,2,0,2,0,0,0,16,5,11,1,1,0
186432,31000,310,0,-2,5,1,4,0,0,0,2,1,1,1,0,1,0,0,0,0,0,0,2,0,2,0,0,0,0,0,0,0,0,0
186469,31000,310,0,-2,2,1,1,0,0,0,0,0,0,0,0,0,0,0,0,0,0,0,2,1,1,0,0,0,0,0,0,0,0,0
186584,31000,310,0,-2,10,4,6,0,0,0,1,0,1,2,0,2,2,0,2,0,0,0,4,4,0,0,0,0,0,0,0,1,0,1
186618,31000,310,0,-2,5,0,5,0,0,0,1,0,1,0,0,0,1,0,1,0,0,0,3,0,3,0,0,0,0,0,0,0,0,0
186645,31000,310,0,-2,1,0,1,0,0,0,0,0,0,0,0,0,0,0,0,0,0,0,1,0,1,0,0,0,0,0,0,0,0,0
186867,31000,310,0,-2,10,3,7,0,0,0,0,0,0,2,0,2,0,0,0,0,0,0,4,1,3,1,0,1,2,1,1,1,1,0
186876,31000,310,0,-2,3,0,3,0,0,0,0,0,0,0,0,0,1,0,1,0,0,0,2,0,2,0,0,0,0,0,0,0,0,0
187046,31000,310,0,-2,3,1,2,0,0,0,1,0,1,0,0,0,1,0,1,0,0,0,1,1,0,0,0,0,0,0,0,0,0,0
187134,31000,310,0,-2,6,1,5,0,0,0,0,0,0,0,0,0,1,1,0,0,0,0,5,0,5,0,0,0,0,0,0,0,0,0
187444,31000,310,0,-2,2,0,2,0,0,0,0,0,0,0,0,0,0,0,0,0,0,0,1,0,1,0,0,0,1,0,1,0,0,0
187532,31000,310,0,-2,8,5,3,0,0,0,0,0,0,1,1,0,4,1,3,0,0,0,3,3,0,0,0,0,0,0,0,0,0,0
187596,31000,310,0,-2,4,2,2,4,2,2,0,0,0,0,0,0,0,0,0,0,0,0,0,0,0,0,0,0,0,0,0,0,0,0
187620,31000,310,0,-2,2,1,1,0,0,0,0,0,0,0,0,0,2,1,1,0,0,0,0,0,0,0,0,0,0,0,0,0,0,0
187648,31000,310,0,-2,3,1,2,0,0,0,0,0,0,0,0,0,1,1,0,0,0,0,2,0,2,0,0,0,0,0,0,0,0,0
187666,31000,310,0,-2,1,0,1,0,0,0,0,0,0,0,0,0,0,0,0,0,0,0,1,0,1,0,0,0,0,0,0,0,0,0
187897,31000,310,0,-2,1,0,1,0,0,0,0,0,0,0,0,0,1,0,1,0,0,0,0,0,0,0,0,0,0,0,0,0,0,0
187903,31000,310,0,-2,1,0,1,0,0,0,0,0,0,0,0,0,1,0,1,0,0,0,0,0,0,0,0,0,0,0,0,0,0,0
187912,31000,310,0,-2,1,1,0,0,0,0,0,0,0,0,0,0,0,0,0,0,0,0,1,1,0,0,0,0,0,0,0,0,0,0
187967,31000,310,0,-2,4,2,2,1,0,1,0,0,0,0,0,0,1,1,0,0,0,0,2,1,1,0,0,0,0,0,0,0,0,0
187976,31000,310,0,-2,1,0,1,0,0,0,0,0,0,0,0,0,0,0,0,0,0,0,1,0,1,0,0,0,0,0,0,0,0,0
187985,31000,310,0,-2,55,9,46,1,0,1,5,1,4,4,0,4,24,4,20,0,0,0,17,3,14,2,1,1,1,0,1,1,0,1
187994,31000,310,0,-2,2,0,2,0,0,0,0,0,0,0,0,0,1,0,1,0,0,0,1,0,1,0,0,0,0,0,0,0,0,0
188003,31000,310,0,-2,1,0,1,0,0,0,0,0,0,0,0,0,0,0,0,0,0,0,1,0,1,0,0,0,0,0,0,0,0,0
188030,31000,310,0,-2,19,8,11,0,0,0,0,0,0,1,0,1,8,3,5,0,0,0,10,5,5,0,0,0,0,0,0,0,0,0
188049,31000,310,0,-2,1,1,0,0,0,0,0,0,0,0,0,0,1,1,0,0,0,0,0,0,0,0,0,0,0,0,0,0,0,0
188058,31000,310,0,-2,1,0,1,0,0,0,0,0,0,0,0,0,0,0,0,0,0,0,0,0,0,0,0,0,1,0,1,0,0,0
188137,31000,310,0,-2,5,1,4,0,0,0,0,0,0,0,0,0,3,1,2,0,0,0,0,0,0,0,0,0,1,0,1,1,0,1
188182,31000,310,0,-2,2,0,2,0,0,0,0,0,0,0,0,0,0,0,0,0,0,0,0,0,0,0,0,0,2,0,2,0,0,0
188304,31000,310,0,-2,12,1,11,0,0,0,0,0,0,0,0,0,9,1,8,0,0,0,3,0,3,0,0,0,0,0,0,0,0,0
188429,31000,310,0,-2,7,0,7,0,0,0,2,0,2,2,0,2,0,0,0,0,0,0,3,0,3,0,0,0,0,0,0,0,0,0
188438,31000,310,0,-2,13,2,11,0,0,0,0,0,0,1,0,1,0,0,0,0,0,0,12,2,10,0,0,0,0,0,0,0,0,0
188526,31000,310,0,-2,3,0,3,0,0,0,0,0,0,1,0,1,0,0,0,0,0,0,2,0,2,0,0,0,0,0,0,0,0,0
188535,31000,310,0,-2,2,1,1,0,0,0,0,0,0,0,0,0,0,0,0,0,0,0,2,1,1,0,0,0,0,0,0,0,0,0
188580,31000,310,0,-2,1,0,1,0,0,0,0,0,0,0,0,0,0,0,0,0,0,0,1,0,1,0,0,0,0,0,0,0,0,0
188641,31000,310,0,-2,3,0,3,0,0,0,0,0,0,0,0,0,0,0,0,0,0,0,3,0,3,0,0,0,0,0,0,0,0,0
188854,31000,310,0,-2,1,0,1,0,0,0,0,0,0,0,0,0,0,0,0,0,0,0,1,0,1,0,0,0,0,0,0,0,0,0
189015,31000,310,0,-2,5,1,4,0,0,0,0,0,0,1,0,1,0,0,0,1,1,0,3,0,3,0,0,0,0,0,0,0,0,0
189088,31000,310,0,-2,11,4,7,0,0,0,1,0,1,2,1,1,0,0,0,0,0,0,8,3,5,0,0,0,0,0,0,0,0,0
189097,31000,310,0,-2,5,1,4,1,0,1,0,0,0,0,0,0,1,1,0,0,0,0,3,0,3,0,0,0,0,0,0,0,0,0
189501,31000,310,0,-2,1,0,1,0,0,0,0,0,0,1,0,1,0,0,0,0,0,0,0,0,0,0,0,0,0,0,0,0,0,0
189547,31000,310,0,-2,2,0,2,0,0,0,0,0,0,0,0,0,0,0,0,0,0,0,2,0,2,0,0,0,0,0,0,0,0,0
189811,31000,310,0,-2,1,0,1,0,0,0,1,0,1,0,0,0,0,0,0,0,0,0,0,0,0,0,0,0,0,0,0,0,0,0
189839,31000,310,0,-2,1,0,1,0,0,0,0,0,0,0,0,0,0,0,0,0,0,0,1,0,1,0,0,0,0,0,0,0,0,0
189848,31000,310,0,-2,1,0,1,0,0,0,0,0,0,0,0,0,0,0,0,0,0,0,1,0,1,0,0,0,0,0,0,0,0,0
190035,31000,310,0,-2,9,5,4,0,0,0,3,2,1,1,1,0,3,1,2,0,0,0,2,1,1,0,0,0,0,0,0,0,0,0
190044,31000,310,0,-2,1,0,1,0,0,0,0,0,0,0,0,0,0,0,0,0,0,0,1,0,1,0,0,0,0,0,0,0,0,0
190053,31000,310,0,-2,1,0,1,0,0,0,0,0,0,0,0,0,0,0,0,0,0,0,1,0,1,0,0,0,0,0,0,0,0,0
190080,31000,310,0,-2,1,0,1,0,0,0,0,0,0,0,0,0,0,0,0,0,0,0,1,0,1,0,0,0,0,0,0,0,0,0
190099,31000,310,0,-2,5,1,4,0,0,0,0,0,0,0,0,0,0,0,0,0,0,0,5,1,4,0,0,0,0,0,0,0,0,0
190150,31000,310,0,-2,32,9,23,0,0,0,7,3,4,5,2,3,9,2,7,0,0,0,8,1,7,0,0,0,0,0,0,3,1,2
190169,31000,310,0,-2,1,0,1,0,0,0,0,0,0,0,0,0,0,0,0,0,0,0,1,0,1,0,0,0,0,0,0,0,0,0
190372,31000,310,0,-2,1,1,0,0,0,0,1,1,0,0,0,0,0,0,0,0,0,0,0,0,0,0,0,0,0,0,0,0,0,0
190415,31000,310,0,-2,76,20,56,0,0,0,7,3,4,10,2,8,11,2,9,0,0,0,45,11,34,2,1,1,0,0,0,1,1,0
190424,31000,310,0,-2,72,24,48,0,0,0,22,7,15,8,2,6,11,4,7,0,0,0,28,8,20,1,1,0,0,0,0,2,2,0
190503,31000,310,0,-2,22,10,12,0,0,0,1,0,1,2,2,0,2,0,2,1,1,0,15,6,9,0,0,0,1,1,0,0,0,0
190512,31000,310,0,-2,1,1,0,0,0,0,1,1,0,0,0,0,0,0,0,0,0,0,0,0,0,0,0,0,0,0,0,0,0,0
190521,31000,310,0,-2,6,0,6,0,0,0,0,0,0,1,0,1,2,0,2,0,0,0,2,0,2,1,0,1,0,0,0,0,0,0
190530,31000,310,0,-2,2,0,2,0,0,0,0,0,0,0,0,0,2,0,2,0,0,0,0,0,0,0,0,0,0,0,0,0,0,0
190558,31000,310,0,-2,1,0,1,0,0,0,0,0,0,0,0,0,0,0,0,0,0,0,1,0,1,0,0,0,0,0,0,0,0,0
190567,31000,310,0,-2,2,2,0,0,0,0,0,0,0,0,0,0,1,1,0,0,0,0,1,1,0,0,0,0,0,0,0,0,0,0
190576,31000,310,0,-2,4,0,4,0,0,0,0,0,0,3,0,3,1,0,1,0,0,0,0,0,0,0,0,0,0,0,0,0,0,0
190585,31000,310,0,-2,3,0,3,0,0,0,1,0,1,0,0,0,1,0,1,0,0,0,0,0,0,1,0,1,0,0,0,0,0,0
190594,31000,310,0,-2,1,1,0,0,0,0,0,0,0,0,0,0,0,0,0,0,0,0,1,1,0,0,0,0,0,0,0,0,0,0
190600,31000,310,0,-2,2,0,2,0,0,0,0,0,0,0,0,0,1,0,1,0,0,0,0,0,0,0,0,0,0,0,0,1,0,1
190619,31000,310,0,-2,1,1,0,0,0,0,0,0,0,0,0,0,0,0,0,0,0,0,1,1,0,0,0,0,0,0,0,0,0,0
190628,31000,310,0,-2,6,1,5,0,0,0,2,1,1,1,0,1,1,0,1,0,0,0,2,0,2,0,0,0,0,0,0,0,0,0
190664,31000,310,0,-2,2,1,1,0,0,0,1,1,0,0,0,0,0,0,0,0,0,0,1,0,1,0,0,0,0,0,0,0,0,0
190682,31000,310,0,-2,2,1,1,0,0,0,0,0,0,1,0,1,0,0,0,0,0,0,1,1,0,0,0,0,0,0,0,0,0,0
190716,31000,310,0,-2,14,5,9,1,1,0,1,0,1,0,0,0,0,0,0,0,0,0,12,4,8,0,0,0,0,0,0,0,0,0
190725,31000,310,0,-2,1,0,1,0,0,0,0,0,0,0,0,0,0,0,0,0,0,0,1,0,1,0,0,0,0,0,0,0,0,0
190761,31000,310,0,-2,1,0,1,0,0,0,0,0,0,0,0,0,0,0,0,0,0,0,1,0,1,0,0,0,0,0,0,0,0,0
190840,31000,310,0,-2,1,0,1,0,0,0,0,0,0,0,0,0,1,0,1,0,0,0,0,0,0,0,0,0,0,0,0,0,0,0
191126,31000,310,0,-2,5,1,4,0,0,0,1,1,0,1,0,1,0,0,0,0,0,0,1,0,1,0,0,0,1,0,1,1,0,1
191205,31000,310,0,-2,1,1,0,0,0,0,0,0,0,0,0,0,0,0,0,0,0,0,1,1,0,0,0,0,0,0,0,0,0,0
191302,31000,310,0,-2,1,0,1,0,0,0,0,0,0,0,0,0,0,0,0,0,0,0,1,0,1,0,0,0,0,0,0,0,0,0
191320,31000,310,0,-2,1,1,0,0,0,0,0,0,0,1,1,0,0,0,0,0,0,0,0,0,0,0,0,0,0,0,0,0,0,0
191339,31000,310,0,-2,3,1,2,0,0,0,0,0,0,0,0,0,0,0,0,0,0,0,3,1,2,0,0,0,0,0,0,0,0,0
191515,31000,310,0,-2,6,1,5,0,0,0,1,0,1,0,0,0,0,0,0,0,0,0,5,1,4,0,0,0,0,0,0,0,0,0
191533,31000,310,0,-2,8,4,4,0,0,0,0,0,0,1,1,0,0,0,0,0,0,0,6,2,4,0,0,0,1,1,0,0,0,0
191597,31000,310,0,-2,2,2,0,0,0,0,1,1,0,1,1,0,0,0,0,0,0,0,0,0,0,0,0,0,0,0,0,0,0,0
191621,31000,310,0,-2,2,0,2,0,0,0,0,0,0,0,0,0,0,0,0,0,0,0,2,0,2,0,0,0,0,0,0,0,0,0
191630,31000,310,0,-2,3,1,2,0,0,0,0,0,0,1,0,1,0,0,0,0,0,0,2,1,1,0,0,0,0,0,0,0,0,0
191649,31000,310,0,-2,15,4,11,0,0,0,2,1,1,2,0,2,4,2,2,0,0,0,7,1,6,0,0,0,0,0,0,0,0,0
191676,31000,310,0,-2,1,1,0,0,0,0,0,0,0,0,0,0,0,0,0,0,0,0,1,1,0,0,0,0,0,0,0,0,0,0
191719,31000,310,0,-2,3,2,1,0,0,0,1,1,0,0,0,0,0,0,0,0,0,0,2,1,1,0,0,0,0,0,0,0,0,0
191931,31000,310,0,-2,10,3,7,0,0,0,0,0,0,3,0,3,1,0,1,0,0,0,6,3,3,0,0,0,0,0,0,0,0,0
191968,31000,310,0,-2,10,3,7,0,0,0,0,0,0,0,0,0,0,0,0,0,0,0,4,1,3,0,0,0,6,2,4,0,0,0
191986,31000,310,0,-2,2,1,1,0,0,0,0,0,0,0,0,0,0,0,0,0,0,0,2,1,1,0,0,0,0,0,0,0,0,0
192022,31000,310,0,-2,1,0,1,0,0,0,0,0,0,0,0,0,1,0,1,0,0,0,0,0,0,0,0,0,0,0,0,0,0,0
192040,31000,310,0,-2,2,0,2,0,0,0,0,0,0,0,0,0,0,0,0,0,0,0,2,0,2,0,0,0,0,0,0,0,0,0
192110,31000,310,0,-2,3,0,3,0,0,0,1,0,1,2,0,2,0,0,0,0,0,0,0,0,0,0,0,0,0,0,0,0,0,0
192192,31000,310,0,-2,1,1,0,0,0,0,0,0,0,1,1,0,0,0,0,0,0,0,0,0,0,0,0,0,0,0,0,0,0,0
192323,31000,310,0,-2,2,1,1,0,0,0,0,0,0,0,0,0,0,0,0,0,0,0,2,1,1,0,0,0,0,0,0,0,0,0
192785,31000,310,0,-2,2,1,1,0,0,0,0,0,0,0,0,0,0,0,0,0,0,0,2,1,1,0,0,0,0,0,0,0,0,0
192819,31000,310,0,-2,3,1,2,0,0,0,0,0,0,1,1,0,0,0,0,0,0,0,2,0,2,0,0,0,0,0,0,0,0,0
192864,31000,310,0,-2,5,4,1,0,0,0,1,1,0,0,0,0,0,0,0,0,0,0,1,0,1,0,0,0,3,3,0,0,0,0
192925,31000,310,0,-2,2,0,2,0,0,0,0,0,0,0,0,0,0,0,0,0,0,0,2,0,2,0,0,0,0,0,0,0,0,0
193016,31000,310,0,-2,16,4,12,0,0,0,1,0,1,3,2,1,3,1,2,0,0,0,7,0,7,0,0,0,0,0,0,2,1,1
193283,31000,310,0,-2,1,1,0,0,0,0,0,0,0,0,0,0,0,0,0,0,0,0,1,1,0,0,0,0,0,0,0,0,0,0
193292,31000,310,0,-2,5,0,5,0,0,0,0,0,0,2,0,2,0,0,0,0,0,0,3,0,3,0,0,0,0,0,0,0,0,0
193326,31000,310,0,-2,1,0,1,0,0,0,0,0,0,0,0,0,0,0,0,0,0,0,1,0,1,0,0,0,0,0,0,0,0,0
193399,31000,310,0,-2,2,1,1,0,0,0,0,0,0,0,0,0,1,0,1,0,0,0,1,1,0,0,0,0,0,0,0,0,0,0
193405,31000,310,0,-2,89,21,68,0,0,0,5,1,4,5,2,3,17,3,14,0,0,0,11,2,9,2,0,2,47,11,36,2,2,0
193584,31000,310,0,-2,1,0,1,0,0,0,0,0,0,0,0,0,0,0,0,0,0,0,1,0,1,0,0,0,0,0,0,0,0,0
193654,31000,310,0,-2,6,1,5,0,0,0,2,0,2,2,0,2,0,0,0,0,0,0,1,1,0,1,0,1,0,0,0,0,0,0
193751,31000,310,0,-2,2,0,2,0,0,0,0,0,0,0,0,0,0,0,0,0,0,0,2,0,2,0,0,0,0,0,0,0,0,0
193821,31000,310,0,-2,2,1,1,0,0,0,1,1,0,0,0,0,0,0,0,0,0,0,1,0,1,0,0,0,0,0,0,0,0,0
193830,31000,310,0,-2,6,5,1,0,0,0,1,1,0,3,2,1,1,1,0,0,0,0,1,1,0,0,0,0,0,0,0,0,0,0
193900,31000,310,0,-2,207,50,157,0,0,0,46,11,35,27,3,24,33,6,27,1,1,0,86,25,61,6,1,5,3,2,1,5,1,4
193973,31000,310,0,-2,6,0,6,1,0,1,0,0,0,0,0,0,0,0,0,0,0,0,5,0,5,0,0,0,0,0,0,0,0,0
194028,31000,310,0,-2,1,1,0,0,0,0,0,0,0,0,0,0,0,0,0,0,0,0,1,1,0,0,0,0,0,0,0,0,0,0
194091,31000,310,0,-2,3,1,2,0,0,0,0,0,0,0,0,0,1,1,0,0,0,0,2,0,2,0,0,0,0,0,0,0,0,0
194222,31000,310,0,-2,1,0,1,0,0,0,0,0,0,0,0,0,0,0,0,0,0,0,1,0,1,0,0,0,0,0,0,0,0,0
194240,31000,310,0,-2,2,0,2,0,0,0,0,0,0,0,0,0,1,0,1,0,0,0,1,0,1,0,0,0,0,0,0,0,0,0
194310,31000,310,0,-2,8,3,5,0,0,0,0,0,0,1,1,0,3,2,1,0,0,0,3,0,3,0,0,0,1,0,1,0,0,0
194392,31000,310,0,-2,1,0,1,0,0,0,0,0,0,0,0,0,0,0,0,0,0,0,1,0,1,0,0,0,0,0,0,0,0,0
194578,31000,310,0,-2,6,3,3,0,0,0,0,0,0,2,2,0,1,0,1,1,1,0,2,0,2,0,0,0,0,0,0,0,0,0
194824,31000,310,0,-2,1,1,0,0,0,0,0,0,0,0,0,0,0,0,0,0,0,0,1,1,0,0,0,0,0,0,0,0,0,0
194958,31000,310,0,-2,1,0,1,0,0,0,0,0,0,0,0,0,0,0,0,0,0,0,1,0,1,0,0,0,0,0,0,0,0,0
195003,31000,310,0,-2,29,9,20,0,0,0,1,0,1,4,2,2,4,0,4,0,0,0,18,7,11,1,0,1,0,0,0,1,0,1
195030,31000,310,0,-2,30,11,19,0,0,0,2,0,2,2,1,1,2,1,1,0,0,0,23,9,14,1,0,1,0,0,0,0,0,0
195049,31000,310,0,-2,5,0,5,0,0,0,2,0,2,0,0,0,0,0,0,0,0,0,2,0,2,0,0,0,0,0,0,1,0,1
195058,31000,310,0,-2,2,2,0,0,0,0,0,0,0,0,0,0,0,0,0,0,0,0,2,2,0,0,0,0,0,0,0,0,0,0
195164,31000,310,0,-2,10,2,8,0,0,0,0,0,0,0,0,0,0,0,0,0,0,0,10,2,8,0,0,0,0,0,0,0,0,0
195173,31000,310,0,-2,4,0,4,0,0,0,1,0,1,0,0,0,0,0,0,1,0,1,2,0,2,0,0,0,0,0,0,0,0,0
195216,31000,310,0,-2,3,0,3,0,0,0,0,0,0,0,0,0,0,0,0,0,0,0,3,0,3,0,0,0,0,0,0,0,0,0
195234,31000,310,0,-2,2,0,2,0,0,0,0,0,0,0,0,0,0,0,0,0,0,0,1,0,1,1,0,1,0,0,0,0,0,0
195243,31000,310,0,-2,1,0,1,0,0,0,1,0,1,0,0,0,0,0,0,0,0,0,0,0,0,0,0,0,0,0,0,0,0,0
195474,31000,310,0,-2,6,1,5,0,0,0,1,1,0,0,0,0,0,0,0,0,0,0,5,0,5,0,0,0,0,0,0,0,0,0
195526,31000,310,0,-2,1,0,1,0,0,0,0,0,0,1,0,1,0,0,0,0,0,0,0,0,0,0,0,0,0,0,0,0,0,0
195544,31000,310,0,-2,8,2,6,0,0,0,0,0,0,1,1,0,1,0,1,0,0,0,4,1,3,0,0,0,2,0,2,0,0,0
195720,31000,310,0,-2,1,0,1,0,0,0,0,0,0,0,0,0,0,0,0,0,0,0,1,0,1,0,0,0,0,0,0,0,0,0
195809,31000,310,0,-2,7,4,3,0,0,0,4,3,1,0,0,0,1,0,1,0,0,0,2,1,1,0,0,0,0,0,0,0,0,0
195827,31000,310,0,-2,7,4,3,0,0,0,1,1,0,2,2,0,1,1,0,0,0,0,3,0,3,0,0,0,0,0,0,0,0,0
195988,31000,310,0,-2,1,1,0,0,0,0,0,0,0,0,0,0,0,0,0,0,0,0,1,1,0,0,0,0,0,0,0,0,0,0
196006,31000,310,0,-2,2,0,2,0,0,0,0,0,0,0,0,0,0,0,0,0,0,0,2,0,2,0,0,0,0,0,0,0,0,0
196024,31000,310,0,-2,1,0,1,0,0,0,0,0,0,0,0,0,0,0,0,0,0,0,1,0,1,0,0,0,0,0,0,0,0,0
196033,31000,310,0,-2,2,1,1,0,0,0,0,0,0,0,0,0,0,0,0,0,0,0,2,1,1,0,0,0,0,0,0,0,0,0
196042,31000,310,0,-2,9,4,5,0,0,0,0,0,0,3,1,2,1,0,1,0,0,0,5,3,2,0,0,0,0,0,0,0,0,0
196051,31000,310,0,-2,1,0,1,0,0,0,0,0,0,0,0,0,0,0,0,0,0,0,1,0,1,0,0,0,0,0,0,0,0,0
196060,31000,310,0,-2,6,3,3,0,0,0,0,0,0,1,1,0,0,0,0,0,0,0,5,2,3,0,0,0,0,0,0,0,0,0
196079,31000,310,0,-2,23,6,17,0,0,0,0,0,0,3,0,3,0,0,0,0,0,0,20,6,14,0,0,0,0,0,0,0,0,0
196088,31000,310,0,-2,30,11,19,0,0,0,1,0,1,3,0,3,0,0,0,0,0,0,26,11,15,0,0,0,0,0,0,0,0,0
196097,31000,310,0,-2,25,12,13,0,0,0,1,1,0,1,1,0,2,1,1,0,0,0,20,9,11,0,0,0,1,0,1,0,0,0
196103,31000,310,0,-2,10,7,3,0,0,0,2,2,0,0,0,0,0,0,0,0,0,0,8,5,3,0,0,0,0,0,0,0,0,0
196112,31000,310,0,-2,15,10,5,0,0,0,2,1,1,0,0,0,2,1,1,0,0,0,9,6,3,1,1,0,0,0,0,1,1,0
196121,31000,310,0,-2,5,2,3,0,0,0,0,0,0,0,0,0,0,0,0,0,0,0,5,2,3,0,0,0,0,0,0,0,0,0
196130,31000,310,0,-2,8,4,4,0,0,0,0,0,0,1,1,0,0,0,0,0,0,0,7,3,4,0,0,0,0,0,0,0,0,0
196149,31000,310,0,-2,2,2,0,0,0,0,0,0,0,0,0,0,0,0,0,0,0,0,2,2,0,0,0,0,0,0,0,0,0,0
196167,31000,310,0,-2,7,2,5,0,0,0,0,0,0,0,0,0,0,0,0,0,0,0,7,2,5,0,0,0,0,0,0,0,0,0
196176,31000,310,0,-2,5,1,4,0,0,0,2,1,1,0,0,0,0,0,0,0,0,0,3,0,3,0,0,0,0,0,0,0,0,0
196185,31000,310,0,-2,13,5,8,0,0,0,0,0,0,1,1,0,0,0,0,0,0,0,12,4,8,0,0,0,0,0,0,0,0,0
196194,31000,310,0,-2,3,1,2,0,0,0,0,0,0,0,0,0,0,0,0,0,0,0,3,1,2,0,0,0,0,0,0,0,0,0
196200,31000,310,0,-2,5,0,5,0,0,0,0,0,0,0,0,0,0,0,0,0,0,0,5,0,5,0,0,0,0,0,0,0,0,0
196228,31000,310,0,-2,8,0,8,0,0,0,0,0,0,4,0,4,3,0,3,0,0,0,1,0,1,0,0,0,0,0,0,0,0,0
196237,31000,310,0,-2,1,0,1,0,0,0,0,0,0,0,0,0,1,0,1,0,0,0,0,0,0,0,0,0,0,0,0,0,0,0
196246,31000,310,0,-2,2,1,1,0,0,0,0,0,0,0,0,0,0,0,0,0,0,0,1,0,1,1,1,0,0,0,0,0,0,0
196255,31000,310,0,-2,8,3,5,0,0,0,2,2,0,4,0,4,1,1,0,0,0,0,0,0,0,1,0,1,0,0,0,0,0,0
196264,31000,310,0,-2,9,5,4,0,0,0,0,0,0,1,0,1,1,1,0,0,0,0,7,4,3,0,0,0,0,0,0,0,0,0
196291,31000,310,0,-2,1,0,1,0,0,0,0,0,0,0,0,0,0,0,0,0,0,0,1,0,1,0,0,0,0,0,0,0,0,0
196307,31000,310,0,-2,16,5,11,0,0,0,0,0,0,0,0,0,0,0,0,0,0,0,16,5,11,0,0,0,0,0,0,0,0,0
196413,31000,310,0,-2,39,14,25,0,0,0,4,2,2,8,5,3,2,0,2,0,0,0,23,7,16,0,0,0,2,0,2,0,0,0
196468,31000,310,0,-2,13,3,10,0,0,0,1,0,1,2,0,2,4,1,3,0,0,0,5,2,3,1,0,1,0,0,0,0,0,0
196565,31000,310,0,-2,1,0,1,0,0,0,0,0,0,0,0,0,0,0,0,0,0,0,1,0,1,0,0,0,0,0,0,0,0,0
196592,31000,310,0,-2,10,3,7,0,0,0,2,1,1,0,0,0,1,0,1,0,0,0,7,2,5,0,0,0,0,0,0,0,0,0
196653,31000,310,0,-2,4,1,3,0,0,0,0,0,0,0,0,0,0,0,0,0,0,0,4,1,3,0,0,0,0,0,0,0,0,0
196680,31000,310,0,-2,2,2,0,0,0,0,0,0,0,1,1,0,0,0,0,0,0,0,1,1,0,0,0,0,0,0,0,0,0,0
196866,31000,310,0,-2,11,1,10,0,0,0,0,0,0,0,0,0,0,0,0,0,0,0,11,1,10,0,0,0,0,0,0,0,0,0
197027,31000,310,0,-2,3,0,3,0,0,0,0,0,0,2,0,2,0,0,0,0,0,0,0,0,0,0,0,0,1,0,1,0,0,0
197036,31000,310,0,-2,23,14,9,1,1,0,2,1,1,4,2,2,2,1,1,0,0,0,14,9,5,0,0,0,0,0,0,0,0,0
197045,31000,310,0,-2,5,1,4,0,0,0,1,0,1,1,0,1,0,0,0,0,0,0,3,1,2,0,0,0,0,0,0,0,0,0
197133,31000,310,0,-2,9,3,6,0,0,0,1,0,1,1,0,1,0,0,0,0,0,0,2,0,2,1,1,0,3,1,2,1,1,0
197151,31000,310,0,-2,1,0,1,0,0,0,0,0,0,0,0,0,1,0,1,0,0,0,0,0,0,0,0,0,0,0,0,0,0,0
197294,31000,310,0,-2,1,1,0,0,0,0,0,0,0,1,1,0,0,0,0,0,0,0,0,0,0,0,0,0,0,0,0,0,0,0
197708,31000,310,0,-2,9,3,6,0,0,0,3,2,1,0,0,0,0,0,0,0,0,0,6,1,5,0,0,0,0,0,0,0,0,0
197814,31000,310,0,-2,1,0,1,0,0,0,0,0,0,1,0,1,0,0,0,0,0,0,0,0,0,0,0,0,0,0,0,0,0,0
197869,31000,310,0,-2,19,7,12,0,0,0,0,0,0,0,0,0,0,0,0,0,0,0,18,6,12,0,0,0,1,1,0,0,0,0
197887,31000,310,0,-2,3,1,2,0,0,0,0,0,0,0,0,0,0,0,0,0,0,0,3,1,2,0,0,0,0,0,0,0,0,0
197911,31000,310,0,-2,3,1,2,0,0,0,0,0,0,1,1,0,0,0,0,0,0,0,2,0,2,0,0,0,0,0,0,0,0,0
197993,31000,310,0,-2,2,1,1,0,0,0,0,0,0,1,1,0,0,0,0,0,0,0,1,0,1,0,0,0,0,0,0,0,0,0
198084,31000,310,0,-2,1,0,1,0,0,0,0,0,0,0,0,0,0,0,0,0,0,0,1,0,1,0,0,0,0,0,0,0,0,0
198118,31000,310,0,-2,1,0,1,0,0,0,0,0,0,0,0,0,0,0,0,0,0,0,1,0,1,0,0,0,0,0,0,0,0,0
198136,31000,310,0,-2,8,2,6,0,0,0,0,0,0,1,0,1,0,0,0,0,0,0,7,2,5,0,0,0,0,0,0,0,0,0
198154,31000,310,0,-2,4,0,4,0,0,0,0,0,0,0,0,0,0,0,0,0,0,0,4,0,4,0,0,0,0,0,0,0,0,0
198215,31000,310,0,-2,1,1,0,0,0,0,0,0,0,1,1,0,0,0,0,0,0,0,0,0,0,0,0,0,0,0,0,0,0,0
198251,31000,310,0,-2,2,1,1,0,0,0,0,0,0,0,0,0,0,0,0,0,0,0,2,1,1,0,0,0,0,0,0,0,0,0
198260,31000,310,0,-2,7,2,5,0,0,0,1,0,1,4,1,3,0,0,0,0,0,0,2,1,1,0,0,0,0,0,0,0,0,0
198303,31000,310,0,-2,2,0,2,0,0,0,0,0,0,0,0,0,1,0,1,0,0,0,0,0,0,0,0,0,1,0,1,0,0,0
198321,31000,310,0,-2,1,1,0,0,0,0,0,0,0,0,0,0,0,0,0,0,0,0,1,1,0,0,0,0,0,0,0,0,0,0
198385,31000,310,0,-2,10,2,8,0,0,0,0,0,0,2,0,2,1,0,1,0,0,0,6,2,4,0,0,0,1,0,1,0,0,0
198419,31000,310,0,-2,84,18,66,0,0,0,10,1,9,14,1,13,7,1,6,0,0,0,49,12,37,4,3,1,0,0,0,0,0,0
198455,31000,310,0,-2,1,0,1,0,0,0,0,0,0,1,0,1,0,0,0,0,0,0,0,0,0,0,0,0,0,0,0,0,0,0
198464,31000,310,0,-2,16,7,9,0,0,0,0,0,0,0,0,0,4,1,3,0,0,0,11,5,6,0,0,0,0,0,0,1,1,0
198491,31000,310,0,-2,1,0,1,0,0,0,0,0,0,1,0,1,0,0,0,0,0,0,0,0,0,0,0,0,0,0,0,0,0,0
198507,31000,310,0,-2,3,0,3,0,0,0,0,0,0,1,0,1,0,0,0,0,0,0,1,0,1,0,0,0,1,0,1,0,0,0
198516,31000,310,0,-2,17,5,12,0,0,0,0,0,0,1,0,1,2,1,1,0,0,0,11,3,8,1,0,1,2,1,1,0,0,0
198534,31000,310,0,-2,1,1,0,0,0,0,0,0,0,0,0,0,0,0,0,0,0,0,1,1,0,0,0,0,0,0,0,0,0,0
198543,31000,310,0,-2,2,0,2,0,0,0,0,0,0,0,0,0,0,0,0,0,0,0,1,0,1,0,0,0,0,0,0,1,0,1
198552,31000,310,0,-2,3,0,3,0,0,0,0,0,0,0,0,0,1,0,1,0,0,0,2,0,2,0,0,0,0,0,0,0,0,0
198561,31000,310,0,-2,2,1,1,0,0,0,0,0,0,0,0,0,0,0,0,0,0,0,2,1,1,0,0,0,0,0,0,0,0,0
198570,31000,310,0,-2,1,1,0,0,0,0,0,0,0,0,0,0,0,0,0,0,0,0,1,1,0,0,0,0,0,0,0,0,0,0
198613,31000,310,0,-2,9,2,7,0,0,0,1,0,1,5,1,4,0,0,0,0,0,0,3,1,2,0,0,0,0,0,0,0,0,0
198622,31000,310,0,-2,1,0,1,0,0,0,0,0,0,0,0,0,0,0,0,0,0,0,1,0,1,0,0,0,0,0,0,0,0,0
198668,31000,310,0,-2,1,0,1,0,0,0,0,0,0,0,0,0,0,0,0,0,0,0,1,0,1,0,0,0,0,0,0,0,0,0
198695,31000,310,0,-2,13,5,8,0,0,0,0,0,0,2,0,2,0,0,0,0,0,0,11,5,6,0,0,0,0,0,0,0,0,0
198729,31000,310,0,-2,1,0,1,0,0,0,0,0,0,0,0,0,0,0,0,0,0,0,1,0,1,0,0,0,0,0,0,0,0,0
198756,31000,310,0,-2,1,1,0,0,0,0,0,0,0,1,1,0,0,0,0,0,0,0,0,0,0,0,0,0,0,0,0,0,0,0
198774,31000,310,0,-2,2,1,1,0,0,0,1,1,0,0,0,0,0,0,0,0,0,0,1,0,1,0,0,0,0,0,0,0,0,0
198808,31000,310,0,-2,2,1,1,0,0,0,0,0,0,0,0,0,0,0,0,0,0,0,2,1,1,0,0,0,0,0,0,0,0,0
198862,31000,310,0,-2,3,0,3,0,0,0,0,0,0,3,0,3,0,0,0,0,0,0,0,0,0,0,0,0,0,0,0,0,0,0
198871,31000,310,0,-2,3,1,2,0,0,0,0,0,0,1,0,1,0,0,0,0,0,0,2,1,1,0,0,0,0,0,0,0,0,0
198914,31000,310,0,-2,1,0,1,0,0,0,0,0,0,0,0,0,0,0,0,0,0,0,1,0,1,0,0,0,0,0,0,0,0,0
198923,31000,310,0,-2,1,0,1,0,0,0,0,0,0,0,0,0,1,0,1,0,0,0,0,0,0,0,0,0,0,0,0,0,0,0
198950,31000,310,0,-2,4,0,4,0,0,0,0,0,0,2,0,2,0,0,0,0,0,0,2,0,2,0,0,0,0,0,0,0,0,0
198969,31000,310,0,-2,1,0,1,0,0,0,0,0,0,0,0,0,0,0,0,0,0,0,1,0,1,0,0,0,0,0,0,0,0,0
198978,31000,310,0,-2,3,0,3,0,0,0,0,0,0,2,0,2,0,0,0,0,0,0,1,0,1,0,0,0,0,0,0,0,0,0
198987,31000,310,0,-2,2,0,2,0,0,0,0,0,0,0,0,0,0,0,0,0,0,0,2,0,2,0,0,0,0,0,0,0,0,0
199023,31000,310,0,-2,1,0,1,0,0,0,0,0,0,0,0,0,0,0,0,0,0,0,1,0,1,0,0,0,0,0,0,0,0,0
199032,31000,310,0,-2,1,0,1,0,0,0,0,0,0,0,0,0,0,0,0,0,0,0,1,0,1,0,0,0,0,0,0,0,0,0
199087,31000,310,0,-2,1,0,1,0,0,0,0,0,0,1,0,1,0,0,0,0,0,0,0,0,0,0,0,0,0,0,0,0,0,0
199102,31000,310,0,-2,15,2,13,0,0,0,0,0,0,10,1,9,0,0,0,0,0,0,0,0,0,0,0,0,5,1,4,0,0,0
199111,31000,310,0,-2,4,1,3,0,0,0,0,0,0,0,0,0,1,0,1,0,0,0,3,1,2,0,0,0,0,0,0,0,0,0
199120,31000,310,0,-2,92,30,62,1,0,1,3,0,3,8,2,6,6,2,4,0,0,0,48,19,29,1,0,1,23,6,17,2,1,1
199139,31000,310,0,-2,15,2,13,1,0,1,0,0,0,6,0,6,0,0,0,0,0,0,8,2,6,0,0,0,0,0,0,0,0,0
199148,31000,310,0,-2,25,3,22,0,0,0,2,0,2,7,1,6,1,0,1,0,0,0,10,2,8,4,0,4,1,0,1,0,0,0
199157,31000,310,0,-2,12,5,7,0,0,0,2,0,2,4,3,1,1,1,0,0,0,0,1,1,0,0,0,0,4,0,4,0,0,0
199175,31000,310,0,-2,12,4,8,0,0,0,0,0,0,3,0,3,0,0,0,0,0,0,8,4,4,0,0,0,1,0,1,0,0,0
199184,31000,310,0,-2,5,1,4,0,0,0,0,0,0,1,0,1,0,0,0,1,0,1,3,1,2,0,0,0,0,0,0,0,0,0
199193,31000,310,0,-2,59,17,42,1,0,1,3,1,2,10,2,8,0,0,0,0,0,0,43,13,30,2,1,1,0,0,0,0,0,0
199209,31000,310,0,-2,2,1,1,0,0,0,0,0,0,0,0,0,0,0,0,0,0,0,2,1,1,0,0,0,0,0,0,0,0,0
199218,31000,310,0,-2,32,7,25,1,0,1,0,0,0,2,1,1,0,0,0,0,0,0,26,5,21,0,0,0,3,1,2,0,0,0
199272,31000,310,0,-2,2,0,2,0,0,0,0,0,0,1,0,1,0,0,0,0,0,0,1,0,1,0,0,0,0,0,0,0,0,0
199281,31000,310,0,-2,8,2,6,2,1,1,0,0,0,2,1,1,0,0,0,0,0,0,3,0,3,0,0,0,1,0,1,0,0,0
199324,31000,310,0,-2,3,0,3,0,0,0,0,0,0,1,0,1,0,0,0,0,0,0,2,0,2,0,0,0,0,0,0,0,0,0
199333,31000,310,0,-2,1,0,1,0,0,0,0,0,0,0,0,0,0,0,0,0,0,0,1,0,1,0,0,0,0,0,0,0,0,0
199412,31000,310,0,-2,3,1,2,0,0,0,0,0,0,0,0,0,0,0,0,0,0,0,3,1,2,0,0,0,0,0,0,0,0,0
199449,31000,310,0,-2,2,0,2,0,0,0,0,0,0,0,0,0,0,0,0,0,0,0,2,0,2,0,0,0,0,0,0,0,0,0
199458,31000,310,0,-2,1,1,0,0,0,0,0,0,0,0,0,0,0,0,0,0,0,0,1,1,0,0,0,0,0,0,0,0,0,0
199467,31000,310,0,-2,2,1,1,0,0,0,0,0,0,2,1,1,0,0,0,0,0,0,0,0,0,0,0,0,0,0,0,0,0,0
199494,31000,310,0,-2,4,1,3,0,0,0,0,0,0,2,1,1,0,0,0,0,0,0,2,0,2,0,0,0,0,0,0,0,0,0
199582,31000,310,0,-2,6,2,4,0,0,0,0,0,0,0,0,0,0,0,0,0,0,0,0,0,0,0,0,0,6,2,4,0,0,0
199643,31000,310,0,-2,3,0,3,0,0,0,0,0,0,3,0,3,0,0,0,0,0,0,0,0,0,0,0,0,0,0,0,0,0,0
199698,31000,310,0,-2,3,0,3,0,0,0,0,0,0,1,0,1,2,0,2,0,0,0,0,0,0,0,0,0,0,0,0,0,0,0
199722,31000,310,0,-2,1,0,1,1,0,1,0,0,0,0,0,0,0,0,0,0,0,0,0,0,0,0,0,0,0,0,0,0,0,0
199759,31000,310,0,-2,1,1,0,0,0,0,0,0,0,0,0,0,0,0,0,0,0,0,1,1,0,0,0,0,0,0,0,0,0,0
199768,31000,310,0,-2,2,1,1,0,0,0,0,0,0,0,0,0,0,0,0,0,0,0,2,1,1,0,0,0,0,0,0,0,0,0
199838,31000,310,0,-2,4,0,4,0,0,0,0,0,0,0,0,0,0,0,0,0,0,0,4,0,4,0,0,0,0,0,0,0,0,0
199847,31000,310,0,-2,76,27,49,0,0,0,4,2,2,9,3,6,2,2,0,0,0,0,56,18,38,3,1,2,0,0,0,2,1,1
199856,31000,310,0,-2,5,1,4,0,0,0,1,0,1,1,0,1,0,0,0,0,0,0,0,0,0,0,0,0,3,1,2,0,0,0
199883,31000,310,0,-2,1,0,1,0,0,0,0,0,0,1,0,1,0,0,0,0,0,0,0,0,0,0,0,0,0,0,0,0,0,0
199908,31000,310,0,-2,1,0,1,0,0,0,0,0,0,0,0,0,0,0,0,0,0,0,1,0,1,0,0,0,0,0,0,0,0,0
199926,31000,310,0,-2,1,1,0,0,0,0,0,0,0,0,0,0,0,0,0,0,0,0,1,1,0,0,0,0,0,0,0,0,0,0
199953,31000,310,0,-2,1,0,1,0,0,0,0,0,0,1,0,1,0,0,0,0,0,0,0,0,0,0,0,0,0,0,0,0,0,0
199962,31000,310,0,-2,3,2,1,0,0,0,1,1,0,0,0,0,1,1,0,0,0,0,1,0,1,0,0,0,0,0,0,0,0,0
199999,31000,310,0,-2,7,1,6,0,0,0,0,0,0,2,0,2,1,0,1,0,0,0,1,1,0,0,0,0,3,0,3,0,0,0
200004,31000,310,0,-2,9,6,3,0,0,0,0,0,0,0,0,0,1,1,0,0,0,0,8,5,3,0,0,0,0,0,0,0,0,0
200022,31000,310,0,-2,4,1,3,0,0,0,0,0,0,0,0,0,0,0,0,0,0,0,2,0,2,1,0,1,0,0,0,1,1,0
200086,31000,310,0,-2,2,0,2,0,0,0,0,0,0,0,0,0,0,0,0,0,0,0,2,0,2,0,0,0,0,0,0,0,0,0
200192,31000,310,0,-2,1,0,1,0,0,0,0,0,0,0,0,0,0,0,0,0,0,0,1,0,1,0,0,0,0,0,0,0,0,0
200217,31000,310,0,-2,3,3,0,0,0,0,0,0,0,0,0,0,0,0,0,0,0,0,3,3,0,0,0,0,0,0,0,0,0,0
200226,31000,310,0,-2,3,1,2,0,0,0,0,0,0,0,0,0,1,0,1,0,0,0,2,1,1,0,0,0,0,0,0,0,0,0
200280,31000,310,0,-2,20,8,12,1,0,1,0,0,0,0,0,0,1,1,0,0,0,0,17,6,11,1,1,0,0,0,0,0,0,0
200305,31000,310,0,-2,1,0,1,0,0,0,0,0,0,0,0,0,0,0,0,0,0,0,1,0,1,0,0,0,0,0,0,0,0,0
200332,31000,310,0,-2,9,5,4,0,0,0,0,0,0,0,0,0,0,0,0,0,0,0,8,5,3,1,0,1,0,0,0,0,0,0
200341,31000,310,0,-2,1,0,1,0,0,0,0,0,0,0,0,0,0,0,0,0,0,0,1,0,1,0,0,0,0,0,0,0,0,0
200484,31000,310,0,-2,1,1,0,0,0,0,0,0,0,0,0,0,0,0,0,0,0,0,1,1,0,0,0,0,0,0,0,0,0,0
200800,31000,310,0,-2,13,3,10,0,0,0,1,0,1,0,0,0,0,0,0,0,0,0,12,3,9,0,0,0,0,0,0,0,0,0
201104,31000,310,0,-2,4,3,1,0,0,0,0,0,0,0,0,0,0,0,0,0,0,0,4,3,1,0,0,0,0,0,0,0,0,0
201177,31000,310,0,-2,2,0,2,0,0,0,0,0,0,0,0,0,0,0,0,0,0,0,2,0,2,0,0,0,0,0,0,0,0,0
201195,31000,310,0,-2,2,0,2,0,0,0,0,0,0,0,0,0,0,0,0,0,0,0,2,0,2,0,0,0,0,0,0,0,0,0
201371,31000,310,0,-2,1,0,1,0,0,0,0,0,0,0,0,0,0,0,0,0,0,0,1,0,1,0,0,0,0,0,0,0,0,0
201441,31000,310,0,-2,11,6,5,0,0,0,1,0,1,0,0,0,0,0,0,0,0,0,10,6,4,0,0,0,0,0,0,0,0,0
201469,31000,310,0,-2,1,0,1,0,0,0,0,0,0,0,0,0,0,0,0,0,0,0,1,0,1,0,0,0,0,0,0,0,0,0
201548,31000,310,0,-2,1,0,1,0,0,0,0,0,0,0,0,0,0,0,0,0,0,0,1,0,1,0,0,0,0,0,0,0,0,0
201645,31000,310,0,-2,38,11,27,0,0,0,1,0,1,4,1,3,1,0,1,0,0,0,29,9,20,0,0,0,3,1,2,0,0,0
201654,31000,310,0,-2,5,3,2,0,0,0,0,0,0,1,1,0,0,0,0,0,0,0,4,2,2,0,0,0,0,0,0,0,0,0
201672,31000,310,0,-2,1,0,1,0,0,0,0,0,0,0,0,0,0,0,0,0,0,0,1,0,1,0,0,0,0,0,0,0,0,0
201690,31000,310,0,-2,12,3,9,0,0,0,0,0,0,8,2,6,0,0,0,0,0,0,3,1,2,0,0,0,1,0,1,0,0,0
201885,31000,310,0,-2,155,41,114,0,0,0,4,1,3,18,5,13,14,7,7,0,0,0,105,24,81,8,3,5,4,1,3,2,0,2
201928,31000,310,0,-2,3,0,3,1,0,1,0,0,0,0,0,0,0,0,0,0,0,0,2,0,2,0,0,0,0,0,0,0,0,0
201946,31000,310,0,-2,1,0,1,0,0,0,0,0,0,1,0,1,0,0,0,0,0,0,0,0,0,0,0,0,0,0,0,0,0,0
201955,31000,310,0,-2,2,0,2,0,0,0,0,0,0,0,0,0,0,0,0,0,0,0,2,0,2,0,0,0,0,0,0,0,0,0
201973,31000,310,0,-2,3,0,3,0,0,0,0,0,0,0,0,0,0,0,0,0,0,0,3,0,3,0,0,0,0,0,0,0,0,0
202046,31000,310,0,-2,2,1,1,0,0,0,0,0,0,0,0,0,0,0,0,0,0,0,2,1,1,0,0,0,0,0,0,0,0,0
202073,31000,310,0,-2,2,0,2,0,0,0,0,0,0,1,0,1,0,0,0,0,0,0,1,0,1,0,0,0,0,0,0,0,0,0
202134,31000,310,0,-2,8,5,3,0,0,0,0,0,0,2,1,1,1,1,0,0,0,0,5,3,2,0,0,0,0,0,0,0,0,0
202170,31000,310,0,-2,1,0,1,0,0,0,0,0,0,0,0,0,0,0,0,0,0,0,1,0,1,0,0,0,0,0,0,0,0,0
202222,31000,310,0,-2,14,6,8,0,0,0,1,1,0,1,0,1,0,0,0,1,0,1,10,4,6,0,0,0,1,1,0,0,0,0
202356,31000,310,0,-2,15,4,11,0,0,0,0,0,0,3,0,3,1,1,0,0,0,0,11,3,8,0,0,0,0,0,0,0,0,0
202480,31000,310,0,-2,34,17,17,0,0,0,0,0,0,1,1,0,1,1,0,0,0,0,31,14,17,0,0,0,1,1,0,0,0,0
202514,31000,310,0,-2,1,0,1,0,0,0,0,0,0,0,0,0,0,0,0,0,0,0,1,0,1,0,0,0,0,0,0,0,0,0
202523,31000,310,0,-2,13,4,9,0,0,0,1,0,1,0,0,0,1,1,0,0,0,0,11,3,8,0,0,0,0,0,0,0,0,0
202648,31000,310,0,-2,2,0,2,0,0,0,0,0,0,0,0,0,0,0,0,0,0,0,2,0,2,0,0,0,0,0,0,0,0,0
202806,31000,310,0,-2,2,0,2,0,0,0,0,0,0,0,0,0,0,0,0,0,0,0,2,0,2,0,0,0,0,0,0,0,0,0
202912,31000,310,0,-2,1,0,1,0,0,0,0,0,0,1,0,1,0,0,0,0,0,0,0,0,0,0,0,0,0,0,0,0,0,0
203128,31000,310,0,-2,4,0,4,0,0,0,0,0,0,0,0,0,0,0,0,0,0,0,4,0,4,0,0,0,0,0,0,0,0,0
203155,31000,310,0,-2,5,1,4,0,0,0,0,0,0,1,1,0,0,0,0,0,0,0,4,0,4,0,0,0,0,0,0,0,0,0
203331,31000,310,0,-2,4,1,3,0,0,0,0,0,0,0,0,0,0,0,0,0,0,0,4,1,3,0,0,0,0,0,0,0,0,0
203368,31000,310,0,-2,17,5,12,0,0,0,0,0,0,2,0,2,0,0,0,0,0,0,15,5,10,0,0,0,0,0,0,0,0,0
203386,31000,310,0,-2,9,4,5,0,0,0,0,0,0,0,0,0,0,0,0,0,0,0,9,4,5,0,0,0,0,0,0,0,0,0
203465,31000,310,0,-2,3,0,3,0,0,0,0,0,0,0,0,0,0,0,0,0,0,0,3,0,3,0,0,0,0,0,0,0,0,0
203517,31000,310,0,-2,43,19,24,0,0,0,1,0,1,8,7,1,2,1,1,0,0,0,26,11,15,0,0,0,1,0,1,5,0,5
203526,31000,310,0,-2,1,1,0,0,0,0,0,0,0,1,1,0,0,0,0,0,0,0,0,0,0,0,0,0,0,0,0,0,0,0
203535,31000,310,0,-2,10,4,6,0,0,0,0,0,0,0,0,0,1,1,0,0,0,0,3,1,2,0,0,0,6,2,4,0,0,0
203599,31000,310,0,-2,1,0,1,0,0,0,0,0,0,0,0,0,0,0,0,0,0,0,0,0,0,1,0,1,0,0,0,0,0,0
203748,31000,310,0,-2,1,0,1,0,0,0,0,0,0,0,0,0,1,0,1,0,0,0,0,0,0,0,0,0,0,0,0,0,0,0
203775,31000,310,0,-2,5,2,3,0,0,0,0,0,0,1,0,1,0,0,0,0,0,0,4,2,2,0,0,0,0,0,0,0,0,0
203845,31000,310,0,-2,3,1,2,0,0,0,0,0,0,0,0,0,0,0,0,0,0,0,2,0,2,0,0,0,1,1,0,0,0,0
204015,31000,310,0,-2,1,1,0,0,0,0,0,0,0,0,0,0,0,0,0,0,0,0,1,1,0,0,0,0,0,0,0,0,0,0
204024,31000,310,0,-2,15,6,9,0,0,0,0,0,0,3,1,2,0,0,0,0,0,0,12,5,7,0,0,0,0,0,0,0,0,0
204176,31000,310,0,-2,1,0,1,0,0,0,0,0,0,0,0,0,0,0,0,0,0,0,1,0,1,0,0,0,0,0,0,0,0,0
204185,31000,310,0,-2,1,1,0,0,0,0,0,0,0,0,0,0,0,0,0,0,0,0,1,1,0,0,0,0,0,0,0,0,0,0
204194,31000,310,0,-2,5,2,3,0,0,0,0,0,0,0,0,0,0,0,0,0,0,0,5,2,3,0,0,0,0,0,0,0,0,0
204264,31000,310,0,-2,2,0,2,0,0,0,0,0,0,0,0,0,0,0,0,0,0,0,2,0,2,0,0,0,0,0,0,0,0,0
204468,31000,310,0,-2,7,4,3,0,0,0,0,0,0,1,0,1,0,0,0,0,0,0,6,4,2,0,0,0,0,0,0,0,0,0
204477,31000,310,0,-2,6,0,6,0,0,0,0,0,0,0,0,0,1,0,1,0,0,0,5,0,5,0,0,0,0,0,0,0,0,0
204486,31000,310,0,-2,5,2,3,0,0,0,0,0,0,0,0,0,0,0,0,0,0,0,5,2,3,0,0,0,0,0,0,0,0,0
204501,31000,310,0,-2,9,3,6,0,0,0,0,0,0,1,1,0,0,0,0,0,0,0,8,2,6,0,0,0,0,0,0,0,0,0
204608,31000,310,0,-2,4,3,1,0,0,0,0,0,0,0,0,0,0,0,0,0,0,0,3,2,1,0,0,0,1,1,0,0,0,0
204635,31000,310,0,-2,21,6,15,0,0,0,0,0,0,0,0,0,0,0,0,0,0,0,21,6,15,0,0,0,0,0,0,0,0,0
204699,31000,310,0,-2,1,0,1,0,0,0,0,0,0,0,0,0,0,0,0,0,0,0,1,0,1,0,0,0,0,0,0,0,0,0
204705,31000,310,0,-2,3,0,3,0,0,0,0,0,0,0,0,0,0,0,0,0,0,0,3,0,3,0,0,0,0,0,0,0,0,0
204796,31000,310,0,-2,208,74,134,1,0,1,9,3,6,31,10,21,11,4,7,0,0,0,143,52,91,3,2,1,9,3,6,1,0,1
204857,31000,310,0,-2,9,3,6,0,0,0,0,0,0,1,0,1,2,2,0,0,0,0,4,0,4,1,0,1,1,1,0,0,0,0
204884,31000,310,0,-2,1,1,0,0,0,0,0,0,0,0,0,0,0,0,0,0,0,0,1,1,0,0,0,0,0,0,0,0,0,0
204909,31000,310,0,-2,6,1,5,0,0,0,0,0,0,0,0,0,1,0,1,0,0,0,5,1,4,0,0,0,0,0,0,0,0,0
204936,31000,310,0,-2,1,1,0,0,0,0,0,0,0,0,0,0,0,0,0,0,0,0,1,1,0,0,0,0,0,0,0,0,0,0
204945,31000,310,0,-2,9,2,7,0,0,0,1,0,1,0,0,0,1,0,1,0,0,0,7,2,5,0,0,0,0,0,0,0,0,0
205027,31000,310,0,-2,2,1,1,0,0,0,0,0,0,0,0,0,0,0,0,0,0,0,2,1,1,0,0,0,0,0,0,0,0,0
205054,31000,310,0,-2,2,1,1,0,0,0,0,0,0,0,0,0,0,0,0,0,0,0,2,1,1,0,0,0,0,0,0,0,0,0
205179,31000,310,0,-2,1,1,0,0,0,0,0,0,0,0,0,0,0,0,0,0,0,0,1,1,0,0,0,0,0,0,0,0,0,0
205203,31000,310,0,-2,3,0,3,0,0,0,0,0,0,0,0,0,0,0,0,0,0,0,3,0,3,0,0,0,0,0,0,0,0,0
205443,31000,310,0,-2,1,1,0,0,0,0,0,0,0,0,0,0,0,0,0,0,0,0,1,1,0,0,0,0,0,0,0,0,0,0
205470,31000,310,0,-2,9,4,5,1,1,0,0,0,0,0,0,0,0,0,0,0,0,0,8,3,5,0,0,0,0,0,0,0,0,0
205957,31000,310,0,-2,2,2,0,0,0,0,0,0,0,0,0,0,0,0,0,0,0,0,2,2,0,0,0,0,0,0,0,0,0,0
206011,31000,310,0,-2,1,0,1,0,0,0,0,0,0,0,0,0,0,0,0,0,0,0,1,0,1,0,0,0,0,0,0,0,0,0
206048,31000,310,0,-2,6,1,5,0,0,0,1,0,1,1,0,1,0,0,0,0,0,0,4,1,3,0,0,0,0,0,0,0,0,0
206084,31000,310,0,-2,30,11,19,0,0,0,1,1,0,5,2,3,1,0,1,0,0,0,23,8,15,0,0,0,0,0,0,0,0,0
206288,31000,310,0,-2,2,1,1,0,0,0,0,0,0,1,0,1,1,1,0,0,0,0,0,0,0,0,0,0,0,0,0,0,0,0
206349,31000,310,0,-2,2,0,2,0,0,0,0,0,0,0,0,0,0,0,0,0,0,0,1,0,1,1,0,1,0,0,0,0,0,0
206437,31000,310,0,-2,1,0,1,0,0,0,0,0,0,0,0,0,0,0,0,0,0,0,1,0,1,0,0,0,0,0,0,0,0,0
206446,31000,310,0,-2,2,1,1,0,0,0,0,0,0,0,0,0,0,0,0,0,0,0,2,1,1,0,0,0,0,0,0,0,0,0
206507,31000,310,0,-2,2,1,1,0,0,0,0,0,0,0,0,0,0,0,0,0,0,0,2,1,1,0,0,0,0,0,0,0,0,0
206525,31000,310,0,-2,2,1,1,0,0,0,0,0,0,0,0,0,1,1,0,0,0,0,1,0,1,0,0,0,0,0,0,0,0,0
206589,31000,310,0,-2,3,2,1,0,0,0,0,0,0,0,0,0,0,0,0,0,0,0,3,2,1,0,0,0,0,0,0,0,0,0
206604,31000,310,0,-2,8,4,4,0,0,0,0,0,0,1,0,1,0,0,0,0,0,0,7,4,3,0,0,0,0,0,0,0,0,0
206622,31000,310,0,-2,9,3,6,0,0,0,0,0,0,2,1,1,0,0,0,0,0,0,4,2,2,1,0,1,0,0,0,2,0,2
206695,31000,310,0,-2,9,4,5,0,0,0,0,0,0,0,0,0,0,0,0,0,0,0,7,3,4,1,0,1,1,1,0,0,0,0
206835,31000,310,0,-2,1,0,1,0,0,0,0,0,0,0,0,0,0,0,0,0,0,0,1,0,1,0,0,0,0,0,0,0,0,0
206862,31000,310,0,-2,8,3,5,0,0,0,0,0,0,1,0,1,2,1,1,0,0,0,5,2,3,0,0,0,0,0,0,0,0,0
206914,31000,310,0,-2,1,1,0,0,0,0,0,0,0,0,0,0,0,0,0,0,0,0,1,1,0,0,0,0,0,0,0,0,0,0
206941,31000,310,0,-2,7,3,4,0,0,0,0,0,0,0,0,0,0,0,0,0,0,0,4,1,3,0,0,0,3,2,1,0,0,0
206996,31000,310,0,-2,2,0,2,0,0,0,0,0,0,0,0,0,0,0,0,0,0,0,2,0,2,0,0,0,0,0,0,0,0,0
207041,31000,310,0,-2,2,0,2,1,0,1,0,0,0,0,0,0,0,0,0,0,0,0,1,0,1,0,0,0,0,0,0,0,0,0
207050,31000,310,0,-2,3,1,2,0,0,0,0,0,0,0,0,0,0,0,0,0,0,0,3,1,2,0,0,0,0,0,0,0,0,0
207209,31000,310,0,-2,1,0,1,0,0,0,0,0,0,1,0,1,0,0,0,0,0,0,0,0,0,0,0,0,0,0,0,0,0,0
207263,31000,310,0,-2,3,1,2,0,0,0,0,0,0,0,0,0,0,0,0,0,0,0,3,1,2,0,0,0,0,0,0,0,0,0
207290,31000,310,0,-2,4,0,4,1,0,1,0,0,0,0,0,0,1,0,1,0,0,0,2,0,2,0,0,0,0,0,0,0,0,0
207306,31000,310,0,-2,1,0,1,0,0,0,0,0,0,0,0,0,0,0,0,0,0,0,1,0,1,0,0,0,0,0,0,0,0,0
207315,31000,310,0,-2,9,2,7,1,0,1,0,0,0,0,0,0,1,0,1,0,0,0,6,2,4,1,0,1,0,0,0,0,0,0
207342,31000,310,0,-2,30,7,23,0,0,0,2,1,1,2,0,2,3,1,2,0,0,0,21,5,16,1,0,1,0,0,0,1,0,1
207388,31000,310,0,-2,57,23,34,1,0,1,0,0,0,7,5,2,1,0,1,0,0,0,39,15,24,7,2,5,1,1,0,1,0,1
207397,31000,310,0,-2,2,0,2,0,0,0,0,0,0,1,0,1,0,0,0,0,0,0,1,0,1,0,0,0,0,0,0,0,0,0
207403,31000,310,0,-2,1,0,1,0,0,0,0,0,0,1,0,1,0,0,0,0,0,0,0,0,0,0,0,0,0,0,0,0,0,0
207449,31000,310,0,-2,6,1,5,0,0,0,1,0,1,1,0,1,0,0,0,0,0,0,3,1,2,0,0,0,1,0,1,0,0,0
207458,31000,310,0,-2,6,1,5,0,0,0,0,0,0,0,0,0,0,0,0,0,0,0,5,1,4,0,0,0,0,0,0,1,0,1
207500,31000,310,0,-2,40,18,22,0,0,0,2,2,0,5,2,3,2,2,0,0,0,0,27,11,16,3,1,2,1,0,1,0,0,0
207582,31000,310,0,-2,5,4,1,0,0,0,0,0,0,0,0,0,1,1,0,0,0,0,4,3,1,0,0,0,0,0,0,0,0,0
207661,31000,310,0,-2,1,1,0,0,0,0,0,0,0,0,0,0,0,0,0,0,0,0,1,1,0,0,0,0,0,0,0,0,0,0
207670,31000,310,0,-2,1,0,1,0,0,0,0,0,0,0,0,0,0,0,0,0,0,0,1,0,1,0,0,0,0,0,0,0,0,0
207847,31000,310,0,-2,6,2,4,0,0,0,0,0,0,1,1,0,0,0,0,0,0,0,5,1,4,0,0,0,0,0,0,0,0,0
207856,31000,310,0,-2,1,0,1,0,0,0,0,0,0,0,0,0,0,0,0,0,0,0,0,0,0,0,0,0,0,0,0,1,0,1
207865,31000,310,0,-2,1,0,1,0,0,0,0,0,0,0,0,0,0,0,0,0,0,0,1,0,1,0,0,0,0,0,0,0,0,0
207935,31000,310,0,-2,3,1,2,0,0,0,0,0,0,0,0,0,0,0,0,0,0,0,3,1,2,0,0,0,0,0,0,0,0,0
207971,31000,310,0,-2,3,2,1,0,0,0,0,0,0,0,0,0,0,0,0,0,0,0,2,1,1,0,0,0,1,1,0,0,0,0
208035,31000,310,0,-2,1,1,0,0,0,0,0,0,0,0,0,0,0,0,0,0,0,0,1,1,0,0,0,0,0,0,0,0,0,0
208318,31000,310,0,-2,2,2,0,0,0,0,0,0,0,0,0,0,0,0,0,0,0,0,2,2,0,0,0,0,0,0,0,0,0,0
208415,31000,310,0,-2,1,0,1,0,0,0,0,0,0,0,0,0,0,0,0,0,0,0,1,0,1,0,0,0,0,0,0,0,0,0
208646,31000,310,0,-2,5,3,2,0,0,0,0,0,0,0,0,0,0,0,0,0,0,0,5,3,2,0,0,0,0,0,0,0,0,0
208822,31000,310,0,-2,6,4,2,0,0,0,0,0,0,0,0,0,0,0,0,0,0,0,6,4,2,0,0,0,0,0,0,0,0,0
209038,31000,310,0,-2,6,3,3,0,0,0,0,0,0,0,0,0,0,0,0,0,0,0,4,2,2,1,1,0,0,0,0,1,0,1
209056,31000,310,0,-2,1,1,0,0,0,0,0,0,0,0,0,0,0,0,0,0,0,0,1,1,0,0,0,0,0,0,0,0,0,0
209065,31000,310,0,-2,4,0,4,0,0,0,0,0,0,1,0,1,0,0,0,0,0,0,3,0,3,0,0,0,0,0,0,0,0,0
209074,31000,310,0,-2,5,1,4,0,0,0,0,0,0,0,0,0,0,0,0,0,0,0,3,0,3,0,0,0,2,1,1,0,0,0
209250,31000,310,0,-2,1,0,1,0,0,0,0,0,0,0,0,0,1,0,1,0,0,0,0,0,0,0,0,0,0,0,0,0,0,0
209490,31000,310,0,-2,36,17,19,0,0,0,6,2,4,1,1,0,4,1,3,0,0,0,23,12,11,1,0,1,0,0,0,1,1,0
209506,31000,310,0,-2,12,6,6,0,0,0,1,1,0,0,0,0,2,1,1,0,0,0,9,4,5,0,0,0,0,0,0,0,0,0
209542,31000,310,0,-2,33,7,26,0,0,0,0,0,0,1,0,1,2,0,2,0,0,0,18,3,15,0,0,0,12,4,8,0,0,0
209551,31000,310,0,-2,92,30,62,2,1,1,2,1,1,5,3,2,5,1,4,0,0,0,67,21,46,1,0,1,10,3,7,0,0,0
209746,31000,310,0,-2,7,2,5,0,0,0,1,0,1,1,1,0,1,0,1,0,0,0,4,1,3,0,0,0,0,0,0,0,0,0
209807,31000,310,0,-2,30,13,17,0,0,0,3,2,1,3,2,1,1,0,1,1,1,0,19,7,12,1,0,1,0,0,0,2,1,1
209825,31000,310,0,-2,20,11,9,0,0,0,2,1,1,1,0,1,5,2,3,0,0,0,8,5,3,0,0,0,3,3,0,1,0,1
209922,31000,310,0,-2,2,1,1,0,0,0,0,0,0,0,0,0,0,0,0,0,0,0,2,1,1,0,0,0,0,0,0,0,0,0
210146,31000,310,0,-2,23,11,12,1,0,1,1,0,1,0,0,0,1,1,0,0,0,0,20,10,10,0,0,0,0,0,0,0,0,0
210234,31000,310,0,-2,1,0,1,0,0,0,0,0,0,0,0,0,0,0,0,0,0,0,0,0,0,0,0,0,1,0,1,0,0,0
210304,31000,310,0,-2,1,0,1,1,0,1,0,0,0,0,0,0,0,0,0,0,0,0,0,0,0,0,0,0,0,0,0,0,0,0
210331,31000,310,0,-2,3,3,0,0,0,0,0,0,0,0,0,0,0,0,0,0,0,0,3,3,0,0,0,0,0,0,0,0,0,0
210401,31000,310,0,-2,1,0,1,0,0,0,0,0,0,0,0,0,0,0,0,0,0,0,1,0,1,0,0,0,0,0,0,0,0,0
210429,31000,310,0,-2,21,7,14,1,1,0,1,0,1,0,0,0,6,2,4,1,0,1,9,3,6,1,0,1,1,1,0,1,0,1
210438,31000,310,0,-2,5,0,5,0,0,0,0,0,0,0,0,0,3,0,3,0,0,0,1,0,1,0,0,0,1,0,1,0,0,0
210492,31000,310,0,-2,1,0,1,0,0,0,0,0,0,0,0,0,0,0,0,0,0,0,1,0,1,0,0,0,0,0,0,0,0,0
210571,31000,310,0,-2,8,3,5,0,0,0,0,0,0,1,1,0,0,0,0,0,0,0,5,1,4,0,0,0,2,1,1,0,0,0
210599,31000,310,0,-2,2,1,1,0,0,0,0,0,0,1,0,1,0,0,0,0,0,0,1,1,0,0,0,0,0,0,0,0,0,0
210605,31000,310,0,-2,1,0,1,0,0,0,0,0,0,0,0,0,0,0,0,0,0,0,1,0,1,0,0,0,0,0,0,0,0,0
210669,31000,310,0,-2,3,1,2,0,0,0,0,0,0,1,1,0,0,0,0,0,0,0,2,0,2,0,0,0,0,0,0,0,0,0
210739,31000,310,0,-2,5,2,3,0,0,0,0,0,0,0,0,0,0,0,0,0,0,0,5,2,3,0,0,0,0,0,0,0,0,0
210775,31000,310,0,-2,3,0,3,0,0,0,0,0,0,0,0,0,0,0,0,0,0,0,3,0,3,0,0,0,0,0,0,0,0,0
210809,31000,310,0,-2,1,1,0,0,0,0,0,0,0,1,1,0,0,0,0,0,0,0,0,0,0,0,0,0,0,0,0,0,0,0
211079,31000,310,0,-2,1,0,1,0,0,0,0,0,0,0,0,0,0,0,0,0,0,0,1,0,1,0,0,0,0,0,0,0,0,0
211088,31000,310,0,-2,9,3,6,0,0,0,0,0,0,4,2,2,0,0,0,0,0,0,5,1,4,0,0,0,0,0,0,0,0,0
211158,31000,310,0,-2,4,2,2,0,0,0,0,0,0,0,0,0,0,0,0,0,0,0,4,2,2,0,0,0,0,0,0,0,0,0
211291,31000,310,0,-2,5,2,3,0,0,0,0,0,0,0,0,0,0,0,0,0,0,0,5,2,3,0,0,0,0,0,0,0,0,0
211307,31000,310,0,-2,5,1,4,0,0,0,0,0,0,0,0,0,0,0,0,0,0,0,5,1,4,0,0,0,0,0,0,0,0,0
211343,31000,310,0,-2,5,2,3,0,0,0,0,0,0,0,0,0,0,0,0,0,0,0,5,2,3,0,0,0,0,0,0,0,0,0
211352,31000,310,0,-2,5,1,4,0,0,0,0,0,0,1,1,0,1,0,1,0,0,0,2,0,2,0,0,0,1,0,1,0,0,0
211361,31000,310,0,-2,4,2,2,0,0,0,0,0,0,1,0,1,0,0,0,0,0,0,3,2,1,0,0,0,0,0,0,0,0,0
211440,31000,310,0,-2,71,20,51,0,0,0,3,0,3,5,0,5,4,2,2,0,0,0,52,16,36,2,0,2,3,1,2,2,1,1
211477,31000,310,0,-2,2,0,2,0,0,0,0,0,0,0,0,0,0,0,0,0,0,0,2,0,2,0,0,0,0,0,0,0,0,0
211556,31000,310,0,-2,3,0,3,0,0,0,0,0,0,0,0,0,0,0,0,0,0,0,3,0,3,0,0,0,0,0,0,0,0,0
211583,31000,310,0,-2,1,1,0,0,0,0,0,0,0,0,0,0,0,0,0,0,0,0,1,1,0,0,0,0,0,0,0,0,0,0
211608,31000,310,0,-2,6,2,4,0,0,0,0,0,0,6,2,4,0,0,0,0,0,0,0,0,0,0,0,0,0,0,0,0,0,0
211644,31000,310,0,-2,2,1,1,0,0,0,0,0,0,0,0,0,0,0,0,0,0,0,2,1,1,0,0,0,0,0,0,0,0,0
211893,31000,310,0,-2,4,1,3,0,0,0,0,0,0,0,0,0,0,0,0,0,0,0,4,1,3,0,0,0,0,0,0,0,0,0
211927,31000,310,0,-2,5,3,2,0,0,0,0,0,0,1,0,1,0,0,0,0,0,0,3,2,1,1,1,0,0,0,0,0,0,0
211981,31000,310,0,-2,3,1,2,0,0,0,0,0,0,0,0,0,0,0,0,0,0,0,3,1,2,0,0,0,0,0,0,0,0,0
212009,31000,310,0,-2,5,3,2,0,0,0,1,0,1,0,0,0,0,0,0,0,0,0,4,3,1,0,0,0,0,0,0,0,0,0
212054,31000,310,0,-2,34,10,24,0,0,0,0,0,0,6,1,5,0,0,0,0,0,0,22,8,14,1,0,1,0,0,0,5,1,4
212106,31000,310,0,-2,40,9,31,0,0,0,0,0,0,5,0,5,2,2,0,0,0,0,32,6,26,0,0,0,0,0,0,1,1,0
212115,31000,310,0,-2,10,7,3,0,0,0,0,0,0,2,2,0,1,1,0,0,0,0,6,4,2,1,0,1,0,0,0,0,0,0
212133,31000,310,0,-2,1,0,1,0,0,0,0,0,0,0,0,0,0,0,0,0,0,0,1,0,1,0,0,0,0,0,0,0,0,0
212160,31000,310,0,-2,10,2,8,0,0,0,0,0,0,1,0,1,0,0,0,0,0,0,8,2,6,1,0,1,0,0,0,0,0,0
212197,31000,310,0,-2,6,3,3,0,0,0,0,0,0,0,0,0,0,0,0,0,0,0,6,3,3,0,0,0,0,0,0,0,0,0
212577,31000,310,0,-2,17,5,12,0,0,0,2,1,1,1,1,0,0,0,0,0,0,0,12,3,9,1,0,1,1,0,1,0,0,0
212601,31000,310,0,-2,7,5,2,0,0,0,0,0,0,0,0,0,1,1,0,0,0,0,6,4,2,0,0,0,0,0,0,0,0,0
212674,31000,310,0,-2,6,2,4,0,0,0,1,0,1,0,0,0,0,0,0,0,0,0,4,2,2,0,0,0,0,0,0,1,0,1
212832,31000,310,0,-2,1,0,1,0,0,0,0,0,0,0,0,0,0,0,0,0,0,0,1,0,1,0,0,0,0,0,0,0,0,0
212869,31000,310,0,-2,1,1,0,0,0,0,0,0,0,0,0,0,0,0,0,0,0,0,1,1,0,0,0,0,0,0,0,0,0,0
212911,31000,310,0,-2,7,0,7,0,0,0,0,0,0,1,0,1,1,0,1,0,0,0,4,0,4,0,0,0,0,0,0,1,0,1
212984,31000,310,0,-2,1,0,1,0,0,0,0,0,0,1,0,1,0,0,0,0,0,0,0,0,0,0,0,0,0,0,0,0,0,0
213011,31000,310,0,-2,2,0,2,0,0,0,0,0,0,0,0,0,0,0,0,0,0,0,2,0,2,0,0,0,0,0,0,0,0,0
213020,31000,310,0,-2,6,3,3,0,0,0,0,0,0,0,0,0,0,0,0,0,0,0,5,3,2,0,0,0,1,0,1,0,0,0
213251,31000,310,0,-2,3,1,2,0,0,0,0,0,0,0,0,0,0,0,0,0,0,0,3,1,2,0,0,0,0,0,0,0,0,0
213303,31000,310,0,-2,1,0,1,0,0,0,0,0,0,0,0,0,0,0,0,0,0,0,1,0,1,0,0,0,0,0,0,0,0,0
213321,31000,310,0,-2,2,0,2,0,0,0,0,0,0,0,0,0,0,0,0,0,0,0,2,0,2,0,0,0,0,0,0,0,0,0
213349,31000,310,0,-2,15,10,5,0,0,0,0,0,0,0,0,0,2,1,1,0,0,0,11,9,2,1,0,1,1,0,1,0,0,0
213358,31000,310,0,-2,3,1,2,0,0,0,0,0,0,0,0,0,0,0,0,0,0,0,3,1,2,0,0,0,0,0,0,0,0,0
213367,31000,310,0,-2,6,3,3,0,0,0,0,0,0,3,2,1,0,0,0,0,0,0,3,1,2,0,0,0,0,0,0,0,0,0
213376,31000,310,0,-2,1,0,1,0,0,0,0,0,0,0,0,0,0,0,0,0,0,0,1,0,1,0,0,0,0,0,0,0,0,0
213385,31000,310,0,-2,3,1,2,0,0,0,0,0,0,1,1,0,0,0,0,0,0,0,2,0,2,0,0,0,0,0,0,0,0,0
213400,31000,310,0,-2,2,1,1,0,0,0,0,0,0,1,1,0,0,0,0,0,0,0,1,0,1,0,0,0,0,0,0,0,0,0
213507,31000,310,0,-2,1,0,1,0,0,0,0,0,0,0,0,0,0,0,0,0,0,0,1,0,1,0,0,0,0,0,0,0,0,0
213525,31000,310,0,-2,1,0,1,0,0,0,1,0,1,0,0,0,0,0,0,0,0,0,0,0,0,0,0,0,0,0,0,0,0,0
213543,31000,310,0,-2,18,7,11,0,0,0,0,0,0,0,0,0,0,0,0,0,0,0,15,4,11,0,0,0,1,1,0,2,2,0
213598,31000,310,0,-2,2,1,1,0,0,0,0,0,0,1,1,0,0,0,0,0,0,0,1,0,1,0,0,0,0,0,0,0,0,0
213613,31000,310,0,-2,4,2,2,0,0,0,0,0,0,0,0,0,0,0,0,0,0,0,4,2,2,0,0,0,0,0,0,0,0,0
213631,31000,310,0,-2,2,0,2,0,0,0,0,0,0,0,0,0,0,0,0,0,0,0,2,0,2,0,0,0,0,0,0,0,0,0
213668,31000,310,0,-2,2,0,2,0,0,0,0,0,0,0,0,0,0,0,0,0,0,0,2,0,2,0,0,0,0,0,0,0,0,0
213826,31000,310,0,-2,4,0,4,0,0,0,0,0,0,0,0,0,0,0,0,0,0,0,4,0,4,0,0,0,0,0,0,0,0,0
213987,31000,310,0,-2,1,0,1,0,0,0,0,0,0,0,0,0,0,0,0,0,0,0,1,0,1,0,0,0,0,0,0,0,0,0
213996,31000,310,0,-2,1,1,0,0,0,0,0,0,0,0,0,0,0,0,0,0,0,0,1,1,0,0,0,0,0,0,0,0,0,0
214041,31000,310,0,-2,9,2,7,0,0,0,0,0,0,1,0,1,0,0,0,0,0,0,8,2,6,0,0,0,0,0,0,0,0,0
214069,31000,310,0,-2,1,0,1,0,0,0,0,0,0,0,0,0,0,0,0,0,0,0,1,0,1,0,0,0,0,0,0,0,0,0
214111,31000,310,0,-2,2,0,2,0,0,0,0,0,0,1,0,1,0,0,0,0,0,0,1,0,1,0,0,0,0,0,0,0,0,0
214148,31000,310,0,-2,2,0,2,0,0,0,0,0,0,1,0,1,0,0,0,0,0,0,1,0,1,0,0,0,0,0,0,0,0,0
214157,31000,310,0,-2,1,0,1,0,0,0,0,0,0,0,0,0,0,0,0,0,0,0,1,0,1,0,0,0,0,0,0,0,0,0
214175,31000,310,0,-2,5,1,4,0,0,0,0,0,0,1,0,1,0,0,0,0,0,0,4,1,3,0,0,0,0,0,0,0,0,0
214379,31000,310,0,-2,1,0,1,0,0,0,0,0,0,0,0,0,0,0,0,0,0,0,1,0,1,0,0,0,0,0,0,0,0,0
214564,31000,310,0,-2,4,0,4,0,0,0,0,0,0,2,0,2,0,0,0,0,0,0,1,0,1,1,0,1,0,0,0,0,0,0
214661,31000,310,0,-2,7,3,4,0,0,0,0,0,0,0,0,0,0,0,0,0,0,0,7,3,4,0,0,0,0,0,0,0,0,0
214883,31000,310,0,-2,2,1,1,0,0,0,0,0,0,2,1,1,0,0,0,0,0,0,0,0,0,0,0,0,0,0,0,0,0,0
214971,31000,310,0,-2,4,1,3,0,0,0,1,1,0,0,0,0,0,0,0,0,0,0,3,0,3,0,0,0,0,0,0,0,0,0
215053,31000,310,0,-2,1,0,1,0,0,0,0,0,0,0,0,0,1,0,1,0,0,0,0,0,0,0,0,0,0,0,0,0,0,0
215062,31000,310,0,-2,165,49,116,1,1,0,15,4,11,34,9,25,13,4,9,0,0,0,92,27,65,5,2,3,2,1,1,3,1,2
215105,31000,310,0,-2,5,2,3,0,0,0,2,1,1,0,0,0,0,0,0,0,0,0,3,1,2,0,0,0,0,0,0,0,0,0
215123,31000,310,0,-2,6,4,2,0,0,0,0,0,0,3,2,1,0,0,0,0,0,0,3,2,1,0,0,0,0,0,0,0,0,0
215132,31000,310,0,-2,5,1,4,0,0,0,0,0,0,1,1,0,0,0,0,0,0,0,4,0,4,0,0,0,0,0,0,0,0,0
215239,31000,310,0,-2,18,9,9,0,0,0,4,2,2,7,4,3,1,0,1,0,0,0,6,3,3,0,0,0,0,0,0,0,0,0
215284,31000,310,0,-2,2,0,2,0,0,0,0,0,0,0,0,0,0,0,0,0,0,0,2,0,2,0,0,0,0,0,0,0,0,0
215293,31000,310,0,-2,43,19,24,0,0,0,2,0,2,2,2,0,1,1,0,0,0,0,31,14,17,0,0,0,7,2,5,0,0,0
215415,31000,310,0,-2,1,0,1,0,0,0,0,0,0,0,0,0,0,0,0,0,0,0,1,0,1,0,0,0,0,0,0,0,0,0
215424,31000,310,0,-2,1,0,1,0,0,0,0,0,0,0,0,0,0,0,0,0,0,0,1,0,1,0,0,0,0,0,0,0,0,0
215442,31000,310,0,-2,2,0,2,0,0,0,0,0,0,0,0,0,0,0,0,0,0,0,2,0,2,0,0,0,0,0,0,0,0,0
215585,31000,310,0,-2,2,0,2,0,0,0,0,0,0,1,0,1,0,0,0,0,0,0,1,0,1,0,0,0,0,0,0,0,0,0
215691,31000,310,0,-2,4,0,4,0,0,0,0,0,0,0,0,0,0,0,0,0,0,0,4,0,4,0,0,0,0,0,0,0,0,0
215743,31000,310,0,-2,5,3,2,0,0,0,0,0,0,0,0,0,0,0,0,0,0,0,5,3,2,0,0,0,0,0,0,0,0,0
215770,31000,310,0,-2,15,7,8,0,0,0,0,0,0,2,0,2,1,1,0,0,0,0,12,6,6,0,0,0,0,0,0,0,0,0
215798,31000,310,0,-2,2,0,2,0,0,0,0,0,0,0,0,0,0,0,0,0,0,0,2,0,2,0,0,0,0,0,0,0,0,0
215929,31000,310,0,-2,1,0,1,0,0,0,0,0,0,0,0,0,0,0,0,0,0,0,1,0,1,0,0,0,0,0,0,0,0,0
215947,31000,310,0,-2,2,1,1,0,0,0,0,0,0,0,0,0,0,0,0,0,0,0,2,1,1,0,0,0,0,0,0,0,0,0
216010,31000,310,0,-2,10,6,4,0,0,0,1,1,0,1,1,0,1,1,0,0,0,0,7,3,4,0,0,0,0,0,0,0,0,0
216038,31000,310,0,-2,6,1,5,0,0,0,0,0,0,0,0,0,0,0,0,1,1,0,4,0,4,1,0,1,0,0,0,0,0,0
216278,31000,310,0,-2,2,2,0,0,0,0,0,0,0,0,0,0,0,0,0,0,0,0,2,2,0,0,0,0,0,0,0,0,0,0
216287,31000,310,0,-2,2,0,2,0,0,0,0,0,0,0,0,0,0,0,0,0,0,0,2,0,2,0,0,0,0,0,0,0,0,0
216339,31000,310,0,-2,7,3,4,0,0,0,0,0,0,1,0,1,0,0,0,0,0,0,5,2,3,0,0,0,1,1,0,0,0,0
216357,31000,310,0,-2,1,0,1,0,0,0,0,0,0,0,0,0,0,0,0,0,0,0,1,0,1,0,0,0,0,0,0,0,0,0
216366,31000,310,0,-2,33,14,19,0,0,0,1,0,1,7,3,4,0,0,0,0,0,0,21,10,11,4,1,3,0,0,0,0,0,0
216524,31000,310,0,-2,8,4,4,0,0,0,1,0,1,0,0,0,1,1,0,0,0,0,5,3,2,0,0,0,1,0,1,0,0,0
216597,31000,310,0,-2,16,4,12,0,0,0,0,0,0,2,0,2,1,0,1,0,0,0,13,4,9,0,0,0,0,0,0,0,0,0
216667,31000,310,0,-2,6,2,4,0,0,0,0,0,0,1,0,1,0,0,0,0,0,0,5,2,3,0,0,0,0,0,0,0,0,0
216764,31000,310,0,-2,40,20,20,0,0,0,0,0,0,6,4,2,1,1,0,0,0,0,33,15,18,0,0,0,0,0,0,0,0,0
216782,31000,310,0,-2,1,0,1,0,0,0,0,0,0,1,0,1,0,0,0,0,0,0,0,0,0,0,0,0,0,0,0,0,0,0
216816,31000,310,0,-2,2,0,2,0,0,0,1,0,1,0,0,0,0,0,0,0,0,0,1,0,1,0,0,0,0,0,0,0,0,0
216852,31000,310,0,-2,2,0,2,0,0,0,0,0,0,0,0,0,1,0,1,0,0,0,1,0,1,0,0,0,0,0,0,0,0,0
216931,31000,310,0,-2,3,0,3,0,0,0,1,0,1,0,0,0,0,0,0,0,0,0,2,0,2,0,0,0,0,0,0,0,0,0
216940,31000,310,0,-2,4,0,4,0,0,0,0,0,0,0,0,0,0,0,0,0,0,0,4,0,4,0,0,0,0,0,0,0,0,0
217013,31000,310,0,-2,2,0,2,0,0,0,0,0,0,0,0,0,0,0,0,0,0,0,2,0,2,0,0,0,0,0,0,0,0,0
217059,31000,310,0,-2,2,0,2,0,0,0,0,0,0,0,0,0,0,0,0,0,0,0,2,0,2,0,0,0,0,0,0,0,0,0
217156,31000,310,0,-2,42,13,29,0,0,0,6,0,6,5,2,3,3,1,2,0,0,0,25,9,16,3,1,2,0,0,0,0,0,0
217165,31000,310,0,-2,3,1,2,0,0,0,0,0,0,0,0,0,0,0,0,0,0,0,2,0,2,0,0,0,1,1,0,0,0,0
217235,31000,310,0,-2,2,1,1,0,0,0,0,0,0,0,0,0,0,0,0,0,0,0,2,1,1,0,0,0,0,0,0,0,0,0
217402,31000,310,0,-2,6,1,5,0,0,0,0,0,0,0,0,0,3,0,3,0,0,0,3,1,2,0,0,0,0,0,0,0,0,0
217420,31000,310,0,-2,1,0,1,0,0,0,0,0,0,0,0,0,1,0,1,0,0,0,0,0,0,0,0,0,0,0,0,0,0,0
217475,31000,310,0,-2,22,4,18,0,0,0,0,0,0,2,0,2,4,0,4,0,0,0,14,4,10,2,0,2,0,0,0,0,0,0
217484,31000,310,0,-2,10,4,6,0,0,0,0,0,0,0,0,0,0,0,0,0,0,0,10,4,6,0,0,0,0,0,0,0,0,0
217493,31000,310,0,-2,11,2,9,0,0,0,0,0,0,1,0,1,1,1,0,0,0,0,7,1,6,0,0,0,2,0,2,0,0,0
217518,31000,310,0,-2,7,1,6,0,0,0,0,0,0,0,0,0,1,1,0,0,0,0,6,0,6,0,0,0,0,0,0,0,0,0
217536,31000,310,0,-2,1,0,1,0,0,0,0,0,0,0,0,0,0,0,0,0,0,0,1,0,1,0,0,0,0,0,0,0,0,0
217615,31000,310,0,-2,1,0,1,0,0,0,0,0,0,0,0,0,0,0,0,0,0,0,1,0,1,0,0,0,0,0,0,0,0,0
217688,31000,310,0,-2,4,1,3,1,1,0,0,0,0,1,0,1,0,0,0,0,0,0,2,0,2,0,0,0,0,0,0,0,0,0
217712,31000,310,0,-2,2,0,2,0,0,0,0,0,0,1,0,1,0,0,0,0,0,0,1,0,1,0,0,0,0,0,0,0,0,0
217749,31000,310,0,-2,2,1,1,0,0,0,0,0,0,0,0,0,0,0,0,0,0,0,2,1,1,0,0,0,0,0,0,0,0,0
217819,31000,310,0,-2,7,3,4,0,0,0,1,0,1,1,0,1,0,0,0,0,0,0,5,3,2,0,0,0,0,0,0,0,0,0
217837,31000,310,0,-2,3,2,1,0,0,0,0,0,0,2,1,1,0,0,0,0,0,0,1,1,0,0,0,0,0,0,0,0,0,0
217864,31000,310,0,-2,2,1,1,0,0,0,0,0,0,0,0,0,0,0,0,0,0,0,1,0,1,0,0,0,1,1,0,0,0,0
217882,31000,310,0,-2,34,11,23,0,0,0,1,0,1,0,0,0,0,0,0,0,0,0,33,11,22,0,0,0,0,0,0,0,0,0
217907,31000,310,0,-2,1,0,1,0,0,0,0,0,0,1,0,1,0,0,0,0,0,0,0,0,0,0,0,0,0,0,0,0,0,0
217925,31000,310,0,-2,2,1,1,0,0,0,0,0,0,0,0,0,0,0,0,0,0,0,2,1,1,0,0,0,0,0,0,0,0,0
217934,31000,310,0,-2,5,1,4,0,0,0,0,0,0,4,1,3,0,0,0,0,0,0,1,0,1,0,0,0,0,0,0,0,0,0
217961,31000,310,0,-2,2,0,2,0,0,0,0,0,0,0,0,0,0,0,0,0,0,0,2,0,2,0,0,0,0,0,0,0,0,0
217998,31000,310,0,-2,3,1,2,0,0,0,0,0,0,1,1,0,0,0,0,0,0,0,2,0,2,0,0,0,0,0,0,0,0,0
218070,31000,310,0,-2,11,2,9,0,0,0,0,0,0,1,0,1,1,0,1,0,0,0,9,2,7,0,0,0,0,0,0,0,0,0
218113,31000,310,0,-2,3,1,2,0,0,0,0,0,0,0,0,0,1,0,1,0,0,0,2,1,1,0,0,0,0,0,0,0,0,0
218140,31000,310,0,-2,1,0,1,0,0,0,0,0,0,1,0,1,0,0,0,0,0,0,0,0,0,0,0,0,0,0,0,0,0,0
218229,31000,310,0,-2,11,6,5,0,0,0,0,0,0,3,1,2,0,0,0,0,0,0,8,5,3,0,0,0,0,0,0,0,0,0
218238,31000,310,0,-2,1,0,1,0,0,0,0,0,0,1,0,1,0,0,0,0,0,0,0,0,0,0,0,0,0,0,0,0,0,0
218414,31000,310,0,-2,3,1,2,0,0,0,0,0,0,2,0,2,0,0,0,0,0,0,1,1,0,0,0,0,0,0,0,0,0,0
218487,31000,310,0,-2,2,0,2,0,0,0,0,0,0,1,0,1,0,0,0,0,0,0,1,0,1,0,0,0,0,0,0,0,0,0
218520,31000,310,0,-2,2,0,2,0,0,0,0,0,0,0,0,0,0,0,0,0,0,0,2,0,2,0,0,0,0,0,0,0,0,0
218539,31000,310,0,-2,1,1,0,0,0,0,0,0,0,0,0,0,0,0,0,0,0,0,1,1,0,0,0,0,0,0,0,0,0,0
218645,31000,310,0,-2,1,0,1,0,0,0,0,0,0,1,0,1,0,0,0,0,0,0,0,0,0,0,0,0,0,0,0,0,0,0
218654,31000,310,0,-2,1,1,0,0,0,0,0,0,0,0,0,0,0,0,0,0,0,0,1,1,0,0,0,0,0,0,0,0,0,0
218663,31000,310,0,-2,12,2,10,0,0,0,0,0,0,5,1,4,0,0,0,0,0,0,7,1,6,0,0,0,0,0,0,0,0,0
218724,31000,310,0,-2,6,3,3,0,0,0,0,0,0,0,0,0,0,0,0,0,0,0,4,1,3,1,1,0,1,1,0,0,0,0
218733,31000,310,0,-2,1,0,1,0,0,0,0,0,0,1,0,1,0,0,0,0,0,0,0,0,0,0,0,0,0,0,0,0,0,0
218742,31000,310,0,-2,2,0,2,0,0,0,0,0,0,0,0,0,0,0,0,0,0,0,1,0,1,1,0,1,0,0,0,0,0,0
218751,31000,310,0,-2,1,1,0,0,0,0,0,0,0,0,0,0,0,0,0,0,0,0,1,1,0,0,0,0,0,0,0,0,0,0
218821,31000,310,0,-2,4,1,3,0,0,0,0,0,0,1,0,1,0,0,0,0,0,0,3,1,2,0,0,0,0,0,0,0,0,0
218830,31000,310,0,-2,1,0,1,0,0,0,0,0,0,0,0,0,0,0,0,0,0,0,1,0,1,0,0,0,0,0,0,0,0,0
218858,31000,310,0,-2,6,1,5,0,0,0,0,0,0,3,0,3,0,0,0,0,0,0,3,1,2,0,0,0,0,0,0,0,0,0
218885,31000,310,0,-2,2,0,2,0,0,0,1,0,1,0,0,0,0,0,0,0,0,0,1,0,1,0,0,0,0,0,0,0,0,0
218894,31000,310,0,-2,4,0,4,0,0,0,0,0,0,2,0,2,0,0,0,0,0,0,2,0,2,0,0,0,0,0,0,0,0,0
218955,31000,310,0,-2,1,0,1,0,0,0,0,0,0,0,0,0,0,0,0,0,0,0,1,0,1,0,0,0,0,0,0,0,0,0
218964,31000,310,0,-2,9,4,5,0,0,0,0,0,0,1,0,1,0,0,0,0,0,0,8,4,4,0,0,0,0,0,0,0,0,0
218973,31000,310,0,-2,9,4,5,0,0,0,0,0,0,2,2,0,1,0,1,0,0,0,5,1,4,0,0,0,1,1,0,0,0,0
218991,31000,310,0,-2,3,0,3,0,0,0,0,0,0,0,0,0,1,0,1,0,0,0,2,0,2,0,0,0,0,0,0,0,0,0
219046,31000,310,0,-2,1,0,1,0,0,0,0,0,0,0,0,0,0,0,0,0,0,0,1,0,1,0,0,0,0,0,0,0,0,0
219082,31000,310,0,-2,4,0,4,0,0,0,0,0,0,0,0,0,0,0,0,0,0,0,3,0,3,1,0,1,0,0,0,0,0,0
219091,31000,310,0,-2,1,0,1,0,0,0,0,0,0,0,0,0,0,0,0,0,0,0,1,0,1,0,0,0,0,0,0,0,0,0
219143,31000,310,0,-2,1,0,1,0,0,0,0,0,0,0,0,0,0,0,0,0,0,0,1,0,1,0,0,0,0,0,0,0,0,0
219189,31000,310,0,-2,1,0,1,0,0,0,0,0,0,0,0,0,0,0,0,0,0,0,1,0,1,0,0,0,0,0,0,0,0,0
219198,31000,310,0,-2,2,0,2,0,0,0,0,0,0,0,0,0,0,0,0,0,0,0,2,0,2,0,0,0,0,0,0,0,0,0
219259,31000,310,0,-2,1,0,1,0,0,0,0,0,0,0,0,0,0,0,0,0,0,0,1,0,1,0,0,0,0,0,0,0,0,0
219347,31000,310,0,-2,2,0,2,0,0,0,0,0,0,0,0,0,0,0,0,0,0,0,2,0,2,0,0,0,0,0,0,0,0,0
219356,31000,310,0,-2,9,7,2,0,0,0,0,0,0,0,0,0,0,0,0,0,0,0,9,7,2,0,0,0,0,0,0,0,0,0
219374,31000,310,0,-2,2,0,2,2,0,2,0,0,0,0,0,0,0,0,0,0,0,0,0,0,0,0,0,0,0,0,0,0,0,0
219383,31000,310,0,-2,2,2,0,0,0,0,0,0,0,0,0,0,0,0,0,0,0,0,2,2,0,0,0,0,0,0,0,0,0,0
219426,31000,310,0,-2,1,0,1,0,0,0,0,0,0,0,0,0,0,0,0,0,0,0,1,0,1,0,0,0,0,0,0,0,0,0
219471,31000,310,0,-2,13,4,9,0,0,0,0,0,0,0,0,0,0,0,0,0,0,0,13,4,9,0,0,0,0,0,0,0,0,0
219480,31000,310,0,-2,1,0,1,0,0,0,0,0,0,0,0,0,0,0,0,0,0,0,1,0,1,0,0,0,0,0,0,0,0,0
219505,31000,310,0,-2,1,1,0,0,0,0,0,0,0,0,0,0,0,0,0,0,0,0,1,1,0,0,0,0,0,0,0,0,0,0
219709,31000,310,0,-2,16,7,9,0,0,0,0,0,0,2,2,0,0,0,0,0,0,0,13,5,8,1,0,1,0,0,0,0,0,0
219718,31000,310,0,-2,1,1,0,0,0,0,0,0,0,0,0,0,0,0,0,0,0,0,1,1,0,0,0,0,0,0,0,0,0,0
219790,31000,310,0,-2,2,0,2,0,0,0,0,0,0,0,0,0,0,0,0,0,0,0,2,0,2,0,0,0,0,0,0,0,0,0
219806,31000,310,0,-2,3,1,2,0,0,0,0,0,0,0,0,0,0,0,0,0,0,0,3,1,2,0,0,0,0,0,0,0,0,0
219833,31000,310,0,-2,7,2,5,0,0,0,0,0,0,4,1,3,0,0,0,0,0,0,3,1,2,0,0,0,0,0,0,0,0,0
219879,31000,310,0,-2,2,1,1,0,0,0,0,0,0,0,0,0,0,0,0,0,0,0,1,0,1,0,0,0,0,0,0,1,1,0
219949,31000,310,0,-2,1,0,1,0,0,0,0,0,0,0,0,0,0,0,0,0,0,0,1,0,1,0,0,0,0,0,0,0,0,0
219976,31000,310,0,-2,5,3,2,0,0,0,0,0,0,1,0,1,0,0,0,0,0,0,4,3,1,0,0,0,0,0,0,0,0,0
220057,31000,310,0,-2,1,1,0,0,0,0,0,0,0,0,0,0,0,0,0,0,0,0,0,0,0,0,0,0,1,1,0,0,0,0
220075,31000,310,0,-2,29,4,25,0,0,0,0,0,0,1,0,1,0,0,0,0,0,0,27,4,23,1,0,1,0,0,0,0,0,0
220181,31000,310,0,-2,4,0,4,0,0,0,0,0,0,1,0,1,2,0,2,0,0,0,1,0,1,0,0,0,0,0,0,0,0,0
220215,31000,310,0,-2,1,1,0,0,0,0,0,0,0,0,0,0,0,0,0,0,0,0,1,1,0,0,0,0,0,0,0,0,0,0
220400,31000,310,0,-2,1,0,1,0,0,0,0,0,0,1,0,1,0,0,0,0,0,0,0,0,0,0,0,0,0,0,0,0,0,0
220552,31000,310,0,-2,5,1,4,0,0,0,0,0,0,0,0,0,0,0,0,0,0,0,5,1,4,0,0,0,0,0,0,0,0,0
220598,31000,310,0,-2,1,0,1,0,0,0,0,0,0,0,0,0,0,0,0,0,0,0,1,0,1,0,0,0,0,0,0,0,0,0
220604,31000,310,0,-2,6,2,4,0,0,0,0,0,0,5,2,3,0,0,0,0,0,0,1,0,1,0,0,0,0,0,0,0,0,0
220613,31000,310,0,-2,1,0,1,0,0,0,0,0,0,0,0,0,0,0,0,0,0,0,1,0,1,0,0,0,0,0,0,0,0,0
220631,31000,310,0,-2,4,1,3,0,0,0,0,0,0,0,0,0,0,0,0,0,0,0,4,1,3,0,0,0,0,0,0,0,0,0
220710,31000,310,0,-2,3,0,3,0,0,0,0,0,0,0,0,0,0,0,0,0,0,0,2,0,2,1,0,1,0,0,0,0,0,0
220792,31000,310,0,-2,5,1,4,0,0,0,0,0,0,5,1,4,0,0,0,0,0,0,0,0,0,0,0,0,0,0,0,0,0,0
220862,31000,310,0,-2,25,6,19,0,0,0,1,0,1,11,2,9,2,0,2,0,0,0,10,4,6,1,0,1,0,0,0,0,0,0
220978,31000,310,0,-2,2,1,1,0,0,0,0,0,0,0,0,0,0,0,0,0,0,0,2,1,1,0,0,0,0,0,0,0,0,0
221096,31000,310,0,-2,5,0,5,0,0,0,0,0,0,2,0,2,0,0,0,0,0,0,3,0,3,0,0,0,0,0,0,0,0,0
221184,31000,310,0,-2,3,2,1,0,0,0,0,0,0,1,1,0,0,0,0,0,0,0,1,1,0,0,0,0,1,0,1,0,0,0
221351,31000,310,0,-2,1,1,0,0,0,0,0,0,0,0,0,0,0,0,0,0,0,0,1,1,0,0,0,0,0,0,0,0,0,0
221485,31000,310,0,-2,14,3,11,0,0,0,0,0,0,10,1,9,0,0,0,0,0,0,4,2,2,0,0,0,0,0,0,0,0,0
221519,31000,310,0,-2,1,1,0,0,0,0,0,0,0,0,0,0,0,0,0,0,0,0,1,1,0,0,0,0,0,0,0,0,0,0
221740,31000,310,0,-2,14,6,8,0,0,0,0,0,0,2,0,2,1,1,0,0,0,0,10,5,5,1,0,1,0,0,0,0,0,0
221759,31000,310,0,-2,87,38,49,0,0,0,0,0,0,13,7,6,1,0,1,0,0,0,70,30,40,1,0,1,1,1,0,1,0,1
221768,31000,310,0,-2,4,1,3,0,0,0,0,0,0,0,0,0,0,0,0,0,0,0,4,1,3,0,0,0,0,0,0,0,0,0
221838,31000,310,0,-2,10,4,6,0,0,0,2,1,1,3,2,1,2,0,2,0,0,0,2,1,1,0,0,0,0,0,0,1,0,1
221847,31000,310,0,-2,4,1,3,0,0,0,0,0,0,0,0,0,1,0,1,0,0,0,2,1,1,1,0,1,0,0,0,0,0,0
221908,31000,310,0,-2,1,0,1,0,0,0,0,0,0,0,0,0,0,0,0,0,0,0,1,0,1,0,0,0,0,0,0,0,0,0
221953,31000,310,0,-2,1,0,1,0,0,0,0,0,0,0,0,0,0,0,0,0,0,0,1,0,1,0,0,0,0,0,0,0,0,0
221971,31000,310,0,-2,2,2,0,0,0,0,0,0,0,0,0,0,0,0,0,0,0,0,1,1,0,0,0,0,1,1,0,0,0,0
221999,31000,310,0,-2,110,36,74,0,0,0,4,2,2,17,3,14,4,0,4,0,0,0,68,26,42,2,0,2,13,4,9,2,1,1
222053,31000,310,0,-2,2,1,1,0,0,0,0,0,0,0,0,0,0,0,0,0,0,0,2,1,1,0,0,0,0,0,0,0,0,0
222062,31000,310,0,-2,2,1,1,0,0,0,0,0,0,0,0,0,0,0,0,0,0,0,2,1,1,0,0,0,0,0,0,0,0,0
222178,31000,310,0,-2,7,3,4,0,0,0,1,1,0,1,1,0,1,0,1,0,0,0,3,1,2,0,0,0,1,0,1,0,0,0
222497,31000,310,0,-2,16,7,9,0,0,0,0,0,0,2,1,1,6,2,4,0,0,0,6,3,3,2,1,1,0,0,0,0,0,0
222567,31000,310,0,-2,1,0,1,0,0,0,0,0,0,0,0,0,0,0,0,0,0,0,0,0,0,0,0,0,1,0,1,0,0,0
222576,31000,310,0,-2,3,2,1,0,0,0,0,0,0,0,0,0,0,0,0,0,0,0,2,2,0,0,0,0,1,0,1,0,0,0
222822,31000,310,0,-2,3,0,3,0,0,0,0,0,0,0,0,0,1,0,1,0,0,0,2,0,2,0,0,0,0,0,0,0,0,0
222831,31000,310,0,-2,10,2,8,0,0,0,1,0,1,1,0,1,1,0,1,0,0,0,7,2,5,0,0,0,0,0,0,0,0,0
222938,31000,310,0,-2,3,2,1,0,0,0,0,0,0,2,2,0,1,0,1,0,0,0,0,0,0,0,0,0,0,0,0,0,0,0
222992,31000,310,0,-2,6,1,5,0,0,0,0,0,0,1,0,1,3,0,3,0,0,0,2,1,1,0,0,0,0,0,0,0,0,0
223083,31000,310,0,-2,1,1,0,0,0,0,0,0,0,0,0,0,1,1,0,0,0,0,0,0,0,0,0,0,0,0,0,0,0,0
223223,31000,310,0,-2,91,24,67,0,0,0,12,4,8,25,5,20,13,4,9,0,0,0,31,7,24,0,0,0,10,4,6,0,0,0
223232,31000,310,0,-2,48,18,30,1,0,1,0,0,0,7,2,5,9,3,6,0,0,0,28,12,16,1,0,1,2,1,1,0,0,0
223320,31000,310,0,-2,1,0,1,0,0,0,0,0,0,0,0,0,0,0,0,0,0,0,0,0,0,0,0,0,1,0,1,0,0,0
223816,31000,310,0,-2,1,0,1,0,0,0,0,0,0,0,0,0,0,0,0,0,0,0,1,0,1,0,0,0,0,0,0,0,0,0
224004,31000,310,0,-2,2,0,2,0,0,0,0,0,0,0,0,0,1,0,1,0,0,0,1,0,1,0,0,0,0,0,0,0,0,0
224110,31000,310,0,-2,2,0,2,0,0,0,0,0,0,0,0,0,0,0,0,0,0,0,2,0,2,0,0,0,0,0,0,0,0,0
224147,31000,310,0,-2,11,2,9,0,0,0,1,0,1,0,0,0,6,1,5,0,0,0,3,1,2,0,0,0,0,0,0,1,0,1
224226,31000,310,0,-2,3,2,1,0,0,0,0,0,0,0,0,0,0,0,0,0,0,0,3,2,1,0,0,0,0,0,0,0,0,0
224305,31000,310,0,-2,2,0,2,0,0,0,0,0,0,0,0,0,0,0,0,0,0,0,2,0,2,0,0,0,0,0,0,0,0,0
224350,31000,310,0,-2,3,0,3,0,0,0,0,0,0,1,0,1,1,0,1,0,0,0,1,0,1,0,0,0,0,0,0,0,0,0
224527,31000,310,0,-2,1,0,1,0,0,0,0,0,0,0,0,0,0,0,0,0,0,0,1,0,1,0,0,0,0,0,0,0,0,0
224545,31000,310,0,-2,1,0,1,0,0,0,0,0,0,0,0,0,0,0,0,0,0,0,1,0,1,0,0,0,0,0,0,0,0,0
224554,31000,310,0,-2,2,2,0,0,0,0,1,1,0,0,0,0,0,0,0,0,0,0,1,1,0,0,0,0,0,0,0,0,0,0
224615,31000,310,0,-2,10,2,8,0,0,0,2,1,1,3,0,3,5,1,4,0,0,0,0,0,0,0,0,0,0,0,0,0,0,0
224642,31000,310,0,-2,6,2,4,0,0,0,0,0,0,0,0,0,6,2,4,0,0,0,0,0,0,0,0,0,0,0,0,0,0,0
224660,31000,310,0,-2,1,1,0,0,0,0,0,0,0,0,0,0,1,1,0,0,0,0,0,0,0,0,0,0,0,0,0,0,0,0
224679,31000,310,0,-2,4,1,3,0,0,0,0,0,0,0,0,0,3,1,2,0,0,0,1,0,1,0,0,0,0,0,0,0,0,0
224961,31000,310,0,-2,1,0,1,0,0,0,0,0,0,0,0,0,0,0,0,0,0,0,1,0,1,0,0,0,0,0,0,0,0,0
225201,31000,310,0,-2,1,0,1,0,0,0,0,0,0,0,0,0,1,0,1,0,0,0,0,0,0,0,0,0,0,0,0,0,0,0
225247,31000,310,0,-2,2,2,0,0,0,0,0,0,0,0,0,0,0,0,0,0,0,0,2,2,0,0,0,0,0,0,0,0,0,0
225308,31000,310,0,-2,2,1,1,0,0,0,0,0,0,0,0,0,0,0,0,0,0,0,2,1,1,0,0,0,0,0,0,0,0,0
225399,31000,310,0,-2,8,3,5,0,0,0,0,0,0,2,0,2,2,1,1,0,0,0,4,2,2,0,0,0,0,0,0,0,0,0
225414,31000,310,0,-2,6,2,4,0,0,0,1,1,0,3,1,2,1,0,1,0,0,0,1,0,1,0,0,0,0,0,0,0,0,0
225423,31000,310,0,-2,13,4,9,0,0,0,0,0,0,7,2,5,2,1,1,0,0,0,3,1,2,1,0,1,0,0,0,0,0,0
225432,31000,310,0,-2,20,10,10,0,0,0,1,0,1,7,3,4,6,3,3,0,0,0,6,4,2,0,0,0,0,0,0,0,0,0
225502,31000,310,0,-2,9,3,6,0,0,0,0,0,0,1,0,1,4,1,3,0,0,0,4,2,2,0,0,0,0,0,0,0,0,0
225511,31000,310,0,-2,83,25,58,0,0,0,3,0,3,34,10,24,25,9,16,0,0,0,19,5,14,0,0,0,1,0,1,1,1,0
225548,31000,310,0,-2,1,1,0,0,0,0,0,0,0,0,0,0,0,0,0,0,0,0,1,1,0,0,0,0,0,0,0,0,0,0
225575,31000,310,0,-2,1,0,1,0,0,0,0,0,0,0,0,0,0,0,0,0,0,0,0,0,0,0,0,0,1,0,1,0,0,0
225627,31000,310,0,-2,8,2,6,0,0,0,0,0,0,0,0,0,6,1,5,0,0,0,2,1,1,0,0,0,0,0,0,0,0,0
225876,31000,310,0,-2,1,0,1,0,0,0,0,0,0,0,0,0,0,0,0,0,0,0,1,0,1,0,0,0,0,0,0,0,0,0
225885,31000,310,0,-2,3,1,2,0,0,0,0,0,0,2,0,2,0,0,0,0,0,0,1,1,0,0,0,0,0,0,0,0,0,0
226019,31000,310,0,-2,1,0,1,0,0,0,0,0,0,0,0,0,0,0,0,0,0,0,1,0,1,0,0,0,0,0,0,0,0,0
226091,31000,310,0,-2,22,6,16,0,0,0,0,0,0,6,1,5,4,2,2,0,0,0,11,3,8,1,0,1,0,0,0,0,0,0
226116,31000,310,0,-2,2,0,2,0,0,0,0,0,0,0,0,0,1,0,1,0,0,0,1,0,1,0,0,0,0,0,0,0,0,0
226152,31000,310,0,-2,4,1,3,0,0,0,0,0,0,0,0,0,3,1,2,0,0,0,1,0,1,0,0,0,0,0,0,0,0,0
226231,31000,310,0,-2,2,0,2,0,0,0,0,0,0,0,0,0,0,0,0,0,0,0,2,0,2,0,0,0,0,0,0,0,0,0
226383,31000,310,0,-2,1,0,1,0,0,0,0,0,0,0,0,0,0,0,0,0,0,0,1,0,1,0,0,0,0,0,0,0,0,0
226408,31000,310,0,-2,2,1,1,0,0,0,0,0,0,2,1,1,0,0,0,0,0,0,0,0,0,0,0,0,0,0,0,0,0,0
226471,31000,310,0,-2,9,4,5,0,0,0,0,0,0,0,0,0,1,0,1,0,0,0,8,4,4,0,0,0,0,0,0,0,0,0
226587,31000,310,0,-2,2,0,2,0,0,0,0,0,0,0,0,0,0,0,0,0,0,0,2,0,2,0,0,0,0,0,0,0,0,0
226806,31000,310,0,-2,2,0,2,0,0,0,0,0,0,1,0,1,0,0,0,0,0,0,1,0,1,0,0,0,0,0,0,0,0,0
226833,31000,310,0,-2,2,2,0,0,0,0,0,0,0,0,0,0,0,0,0,0,0,0,2,2,0,0,0,0,0,0,0,0,0,0
226903,31000,310,0,-2,17,2,15,0,0,0,0,0,0,3,0,3,12,2,10,0,0,0,2,0,2,0,0,0,0,0,0,0,0,0
227146,31000,310,0,-2,1,0,1,0,0,0,0,0,0,0,0,0,0,0,0,0,0,0,1,0,1,0,0,0,0,0,0,0,0,0
227182,31000,310,0,-2,39,14,25,0,0,0,2,0,2,10,3,7,9,6,3,0,0,0,15,5,10,3,0,3,0,0,0,0,0,0
227216,31000,310,0,-2,56,22,34,0,0,0,3,0,3,8,2,6,8,3,5,0,0,0,30,14,16,4,1,3,2,1,1,1,1,0
227225,31000,310,0,-2,1,0,1,0,0,0,0,0,0,0,0,0,0,0,0,0,0,0,1,0,1,0,0,0,0,0,0,0,0,0
227331,31000,310,0,-2,3,2,1,0,0,0,0,0,0,1,1,0,2,1,1,0,0,0,0,0,0,0,0,0,0,0,0,0,0,0
227368,31000,310,0,-2,28,6,22,0,0,0,1,0,1,0,0,0,21,5,16,0,0,0,5,0,5,0,0,0,0,0,0,1,1,0
227377,31000,310,0,-2,1,0,1,0,0,0,0,0,0,0,0,0,1,0,1,0,0,0,0,0,0,0,0,0,0,0,0,0,0,0
227429,31000,310,0,-2,1,0,1,0,0,0,0,0,0,1,0,1,0,0,0,0,0,0,0,0,0,0,0,0,0,0,0,0,0,0
227526,31000,310,0,-2,12,3,9,0,0,0,0,0,0,7,2,5,1,0,1,0,0,0,1,1,0,1,0,1,2,0,2,0,0,0
227757,31000,310,0,-2,60,18,42,0,0,0,4,0,4,10,1,9,12,5,7,0,0,0,30,12,18,2,0,2,1,0,1,1,0,1
227845,31000,310,0,-2,5,1,4,0,0,0,0,0,0,0,0,0,3,1,2,0,0,0,2,0,2,0,0,0,0,0,0,0,0,0
227854,31000,310,0,-2,2,1,1,0,0,0,0,0,0,0,0,0,2,1,1,0,0,0,0,0,0,0,0,0,0,0,0,0,0,0
227863,31000,310,0,-2,19,4,15,0,0,0,1,0,1,7,3,4,3,1,2,0,0,0,8,0,8,0,0,0,0,0,0,0,0,0
227881,31000,310,0,-2,46,22,24,0,0,0,1,1,0,10,3,7,4,2,2,0,0,0,31,16,15,0,0,0,0,0,0,0,0,0
227924,31000,310,0,-2,1,1,0,0,0,0,0,0,0,0,0,0,0,0,0,0,0,0,1,1,0,0,0,0,0,0,0,0,0,0
227979,31000,310,0,-2,13,4,9,0,0,0,0,0,0,2,1,1,7,2,5,0,0,0,4,1,3,0,0,0,0,0,0,0,0,0
228042,31000,310,0,-2,2,1,1,0,0,0,0,0,0,0,0,0,0,0,0,0,0,0,2,1,1,0,0,0,0,0,0,0,0,0
228149,31000,310,0,-2,2,1,1,0,0,0,0,0,0,1,0,1,1,1,0,0,0,0,0,0,0,0,0,0,0,0,0,0,0,0
228194,31000,310,0,-2,1,1,0,0,0,0,0,0,0,1,1,0,0,0,0,0,0,0,0,0,0,0,0,0,0,0,0,0,0,0
228246,31000,310,0,-2,16,8,8,0,0,0,2,1,1,2,2,0,2,2,0,0,0,0,10,3,7,0,0,0,0,0,0,0,0,0
228325,31000,310,0,-2,1,0,1,0,0,0,0,0,0,0,0,0,0,0,0,0,0,0,1,0,1,0,0,0,0,0,0,0,0,0
228343,31000,310,0,-2,2,0,2,0,0,0,0,0,0,0,0,0,2,0,2,0,0,0,0,0,0,0,0,0,0,0,0,0,0,0
228431,31000,310,0,-2,10,4,6,0,0,0,0,0,0,2,1,1,4,2,2,0,0,0,4,1,3,0,0,0,0,0,0,0,0,0
228459,31000,310,0,-2,16,6,10,0,0,0,1,0,1,2,1,1,4,2,2,0,0,0,7,1,6,1,1,0,1,1,0,0,0,0
228468,31000,310,0,-2,1,1,0,0,0,0,0,0,0,0,0,0,0,0,0,0,0,0,1,1,0,0,0,0,0,0,0,0,0,0
228501,31000,310,0,-2,3,0,3,0,0,0,0,0,0,0,0,0,2,0,2,0,0,0,1,0,1,0,0,0,0,0,0,0,0,0
228529,31000,310,0,-2,9,4,5,0,0,0,0,0,0,1,1,0,0,0,0,0,0,0,8,3,5,0,0,0,0,0,0,0,0,0
228547,31000,310,0,-2,10,4,6,0,0,0,0,0,0,2,1,1,3,1,2,0,0,0,5,2,3,0,0,0,0,0,0,0,0,0
228635,31000,310,0,-2,62,29,33,1,0,1,13,6,7,20,5,15,11,5,6,0,0,0,10,9,1,2,1,1,0,0,0,5,3,2
228644,31000,310,0,-2,91,35,56,0,0,0,2,0,2,5,2,3,49,22,27,0,0,0,15,5,10,2,1,1,18,5,13,0,0,0
228653,31000,310,0,-2,13,4,9,0,0,0,2,1,1,5,0,5,1,0,1,0,0,0,5,3,2,0,0,0,0,0,0,0,0,0
228705,31000,310,0,-2,4,2,2,0,0,0,0,0,0,0,0,0,2,0,2,0,0,0,1,1,0,0,0,0,1,1,0,0,0,0
228723,31000,310,0,-2,43,13,30,0,0,0,0,0,0,2,2,0,9,2,7,0,0,0,31,9,22,0,0,0,1,0,1,0,0,0
228732,31000,310,0,-2,2,1,1,0,0,0,0,0,0,0,0,0,0,0,0,0,0,0,2,1,1,0,0,0,0,0,0,0,0,0
228769,31000,310,0,-2,41,12,29,0,0,0,7,3,4,6,1,5,4,1,3,0,0,0,16,5,11,3,1,2,5,1,4,0,0,0
228778,31000,310,0,-2,184,50,134,0,0,0,6,1,5,13,6,7,39,8,31,0,0,0,120,34,86,5,1,4,0,0,0,1,0,1
228787,31000,310,0,-2,14,6,8,0,0,0,4,2,2,2,1,1,0,0,0,0,0,0,2,2,0,2,0,2,4,1,3,0,0,0
228796,31000,310,0,-2,60,15,45,0,0,0,0,0,0,1,1,0,54,11,43,0,0,0,3,1,2,0,0,0,1,1,0,1,1,0
228802,31000,310,0,-2,5,1,4,0,0,0,0,0,0,1,0,1,0,0,0,0,0,0,4,1,3,0,0,0,0,0,0,0,0,0
228866,31000,310,0,-2,1,0,1,0,0,0,0,0,0,0,0,0,0,0,0,0,0,0,1,0,1,0,0,0,0,0,0,0,0,0
228875,31000,310,0,-2,16,5,11,0,0,0,1,0,1,0,0,0,3,2,1,0,0,0,12,3,9,0,0,0,0,0,0,0,0,0
228909,31000,310,0,-2,17,6,11,0,0,0,1,0,1,4,2,2,5,2,3,1,0,1,5,1,4,0,0,0,1,1,0,0,0,0
228981,31000,310,0,-2,6,1,5,0,0,0,0,0,0,0,0,0,0,0,0,0,0,0,6,1,5,0,0,0,0,0,0,0,0,0
229027,31000,310,0,-2,63,17,46,0,0,0,2,1,1,3,2,1,24,7,17,0,0,0,24,6,18,0,0,0,8,1,7,2,0,2
229090,31000,310,0,-2,13,8,5,0,0,0,3,3,0,0,0,0,2,1,1,0,0,0,7,3,4,1,1,0,0,0,0,0,0,0
229115,31000,310,0,-2,6,2,4,0,0,0,0,0,0,0,0,0,2,0,2,0,0,0,4,2,2,0,0,0,0,0,0,0,0,0
229160,31000,310,0,-2,2,0,2,0,0,0,0,0,0,2,0,2,0,0,0,0,0,0,0,0,0,0,0,0,0,0,0,0,0,0
229179,31000,310,0,-2,12,3,9,0,0,0,0,0,0,4,0,4,2,0,2,0,0,0,6,3,3,0,0,0,0,0,0,0,0,0
229267,31000,310,0,-2,10,3,7,0,0,0,0,0,0,2,1,1,5,0,5,0,0,0,3,2,1,0,0,0,0,0,0,0,0,0
229300,31000,310,0,-2,79,23,56,0,0,0,16,7,9,18,3,15,19,8,11,0,0,0,18,4,14,4,0,4,1,0,1,3,1,2
229355,31000,310,0,-2,1,1,0,0,0,0,0,0,0,0,0,0,1,1,0,0,0,0,0,0,0,0,0,0,0,0,0,0,0,0
229504,31000,310,0,-2,1,0,1,0,0,0,0,0,0,0,0,0,0,0,0,0,0,0,1,0,1,0,0,0,0,0,0,0,0,0
229540,31000,310,0,-2,3,1,2,0,0,0,0,0,0,0,0,0,2,1,1,0,0,0,1,0,1,0,0,0,0,0,0,0,0,0
229799,31000,310,0,-2,2,0,2,0,0,0,0,0,0,0,0,0,0,0,0,0,0,0,2,0,2,0,0,0,0,0,0,0,0,0
229814,31000,310,0,-2,4,1,3,0,0,0,0,0,0,0,0,0,0,0,0,0,0,0,4,1,3,0,0,0,0,0,0,0,0,0
229832,31000,310,0,-2,1,0,1,0,0,0,0,0,0,0,0,0,0,0,0,0,0,0,1,0,1,0,0,0,0,0,0,0,0,0
229841,31000,310,0,-2,1,0,1,0,0,0,0,0,0,1,0,1,0,0,0,0,0,0,0,0,0,0,0,0,0,0,0,0,0,0
229887,31000,310,0,-2,1,0,1,0,0,0,0,0,0,0,0,0,0,0,0,0,0,0,1,0,1,0,0,0,0,0,0,0,0,0
230038,31000,310,0,-2,39,26,13,0,0,0,2,1,1,0,0,0,1,0,1,0,0,0,33,22,11,0,0,0,2,2,0,1,1,0
230047,31000,310,0,-2,2,1,1,0,0,0,0,0,0,0,0,0,0,0,0,1,1,0,1,0,1,0,0,0,0,0,0,0,0,0
230171,31000,310,0,-2,8,3,5,0,0,0,0,0,0,0,0,0,1,0,1,1,0,1,6,3,3,0,0,0,0,0,0,0,0,0
230418,31000,310,0,-2,4,3,1,0,0,0,0,0,0,1,1,0,0,0,0,0,0,0,3,2,1,0,0,0,0,0,0,0,0,0
230603,31000,310,0,-2,6,4,2,0,0,0,0,0,0,0,0,0,0,0,0,0,0,0,6,4,2,0,0,0,0,0,0,0,0,0
230728,31000,310,0,-2,13,10,3,0,0,0,0,0,0,0,0,0,0,0,0,0,0,0,13,10,3,0,0,0,0,0,0,0,0,0
230737,31000,310,0,-2,8,4,4,0,0,0,0,0,0,0,0,0,0,0,0,0,0,0,7,4,3,1,0,1,0,0,0,0,0,0
230746,31000,310,0,-2,4,0,4,0,0,0,1,0,1,0,0,0,1,0,1,0,0,0,2,0,2,0,0,0,0,0,0,0,0,0
230764,31000,310,0,-2,154,48,106,0,0,0,14,5,9,5,0,5,17,6,11,0,0,0,101,33,68,6,1,5,7,1,6,4,2,2
230782,31000,310,0,-2,8,3,5,0,0,0,0,0,0,0,0,0,0,0,0,0,0,0,8,3,5,0,0,0,0,0,0,0,0,0
230807,31000,310,0,-2,4,1,3,0,0,0,0,0,0,0,0,0,1,0,1,0,0,0,3,1,2,0,0,0,0,0,0,0,0,0
230816,31000,310,0,-2,1,1,0,0,0,0,0,0,0,0,0,0,0,0,0,0,0,0,1,1,0,0,0,0,0,0,0,0,0,0
230834,31000,310,0,-2,1,0,1,0,0,0,0,0,0,0,0,0,0,0,0,0,0,0,1,0,1,0,0,0,0,0,0,0,0,0
230852,31000,310,0,-2,1,0,1,0,0,0,0,0,0,0,0,0,0,0,0,0,0,0,1,0,1,0,0,0,0,0,0,0,0,0
230889,31000,310,0,-2,1,0,1,0,0,0,0,0,0,0,0,0,0,0,0,0,0,0,1,0,1,0,0,0,0,0,0,0,0,0
230959,31000,310,0,-2,7,2,5,0,0,0,0,0,0,0,0,0,0,0,0,0,0,0,5,2,3,0,0,0,2,0,2,0,0,0
230995,31000,310,0,-2,8,2,6,0,0,0,0,0,0,0,0,0,0,0,0,0,0,0,7,2,5,0,0,0,1,0,1,0,0,0
231059,31000,310,0,-2,4,0,4,0,0,0,0,0,0,0,0,0,0,0,0,0,0,0,4,0,4,0,0,0,0,0,0,0,0,0
231165,31000,310,0,-2,1,1,0,0,0,0,0,0,0,0,0,0,0,0,0,0,0,0,1,1,0,0,0,0,0,0,0,0,0,0
231174,31000,310,0,-2,18,5,13,0,0,0,0,0,0,2,1,1,0,0,0,0,0,0,16,4,12,0,0,0,0,0,0,0,0,0
231420,31000,310,0,-2,5,2,3,0,0,0,0,0,0,2,1,1,0,0,0,0,0,0,3,1,2,0,0,0,0,0,0,0,0,0
231536,31000,310,0,-2,1,1,0,0,0,0,0,0,0,0,0,0,0,0,0,0,0,0,1,1,0,0,0,0,0,0,0,0,0,0
231624,31000,310,0,-2,25,9,16,1,1,0,1,1,0,2,1,1,0,0,0,0,0,0,21,6,15,0,0,0,0,0,0,0,0,0
231651,31000,310,0,-2,10,2,8,0,0,0,0,0,0,3,1,2,0,0,0,1,0,1,6,1,5,0,0,0,0,0,0,0,0,0
231697,31000,310,0,-2,2,0,2,0,0,0,0,0,0,0,0,0,0,0,0,0,0,0,2,0,2,0,0,0,0,0,0,0,0,0
231882,31000,310,0,-2,2,0,2,0,0,0,0,0,0,1,0,1,0,0,0,0,0,0,1,0,1,0,0,0,0,0,0,0,0,0
231970,31000,310,0,-2,14,4,10,0,0,0,1,0,1,6,1,5,1,1,0,0,0,0,6,2,4,0,0,0,0,0,0,0,0,0
232025,31000,310,0,-2,3,0,3,0,0,0,0,0,0,0,0,0,0,0,0,0,0,0,2,0,2,0,0,0,1,0,1,0,0,0
232089,31000,310,0,-2,1,0,1,0,0,0,0,0,0,0,0,0,0,0,0,0,0,0,1,0,1,0,0,0,0,0,0,0,0,0
232186,31000,310,0,-2,85,28,57,0,0,0,8,2,6,13,2,11,7,2,5,0,0,0,52,20,32,2,1,1,1,0,1,2,1,1
232265,31000,310,0,-2,4,0,4,0,0,0,0,0,0,4,0,4,0,0,0,0,0,0,0,0,0,0,0,0,0,0,0,0,0,0
232414,31000,310,0,-2,3,1,2,0,0,0,1,1,0,1,0,1,0,0,0,0,0,0,1,0,1,0,0,0,0,0,0,0,0,0
232423,31000,310,0,-2,10,5,5,0,0,0,0,0,0,1,1,0,0,0,0,0,0,0,7,4,3,2,0,2,0,0,0,0,0,0
232450,31000,310,0,-2,2,0,2,0,0,0,0,0,0,1,0,1,0,0,0,0,0,0,1,0,1,0,0,0,0,0,0,0,0,0
232557,31000,310,0,-2,52,22,30,1,0,1,1,1,0,2,1,1,2,0,2,0,0,0,45,20,25,0,0,0,1,0,1,0,0,0
232566,31000,310,0,-2,2,1,1,0,0,0,0,0,0,0,0,0,0,0,0,0,0,0,2,1,1,0,0,0,0,0,0,0,0,0
232609,31000,310,0,-2,4,1,3,0,0,0,0,0,0,0,0,0,0,0,0,0,0,0,4,1,3,0,0,0,0,0,0,0,0,0
232618,31000,310,0,-2,2,1,1,0,0,0,0,0,0,0,0,0,0,0,0,0,0,0,2,1,1,0,0,0,0,0,0,0,0,0
232672,31000,310,0,-2,3,0,3,0,0,0,0,0,0,0,0,0,0,0,0,0,0,0,3,0,3,0,0,0,0,0,0,0,0,0
232706,31000,310,0,-2,17,5,12,0,0,0,3,1,2,5,1,4,1,0,1,0,0,0,5,2,3,2,0,2,1,1,0,0,0,0
232946,31000,310,0,-2,12,4,8,0,0,0,1,1,0,2,1,1,0,0,0,0,0,0,7,2,5,2,0,2,0,0,0,0,0,0
232982,31000,310,0,-2,28,8,20,0,0,0,0,0,0,18,4,14,0,0,0,0,0,0,10,4,6,0,0,0,0,0,0,0,0,0
233082,31000,310,0,-2,1,0,1,0,0,0,0,0,0,0,0,0,0,0,0,0,0,0,1,0,1,0,0,0,0,0,0,0,0,0
233116,31000,310,0,-2,1,1,0,0,0,0,0,0,0,0,0,0,0,0,0,0,0,0,1,1,0,0,0,0,0,0,0,0,0,0
233277,31000,310,0,-2,7,2,5,0,0,0,0,0,0,0,0,0,0,0,0,0,0,0,7,2,5,0,0,0,0,0,0,0,0,0
233295,31000,310,0,-2,4,0,4,0,0,0,1,0,1,0,0,0,1,0,1,0,0,0,2,0,2,0,0,0,0,0,0,0,0,0
233310,31000,310,0,-2,2,1,1,0,0,0,0,0,0,1,1,0,0,0,0,0,0,0,1,0,1,0,0,0,0,0,0,0,0,0
233374,31000,310,0,-2,12,2,10,0,0,0,0,0,0,1,0,1,1,0,1,0,0,0,10,2,8,0,0,0,0,0,0,0,0,0
233426,31000,310,0,-2,2,0,2,0,0,0,0,0,0,0,0,0,0,0,0,0,0,0,2,0,2,0,0,0,0,0,0,0,0,0
233648,31000,310,0,-2,4,1,3,0,0,0,0,0,0,0,0,0,0,0,0,0,0,0,4,1,3,0,0,0,0,0,0,0,0,0
233718,31000,310,0,-2,1,0,1,0,0,0,0,0,0,0,0,0,0,0,0,0,0,0,1,0,1,0,0,0,0,0,0,0,0,0
233754,31000,310,0,-2,3,0,3,0,0,0,0,0,0,0,0,0,0,0,0,0,0,0,2,0,2,1,0,1,0,0,0,0,0,0
233772,31000,310,0,-2,3,1,2,0,0,0,1,0,1,1,0,1,0,0,0,0,0,0,1,1,0,0,0,0,0,0,0,0,0,0
233921,31000,310,0,-2,212,88,124,1,0,1,3,0,3,27,17,10,10,6,4,0,0,0,161,61,100,1,1,0,0,0,0,9,3,6
234030,31000,310,0,-2,80,36,44,0,0,0,5,4,1,27,11,16,3,2,1,0,0,0,39,17,22,1,0,1,2,1,1,3,1,2
234076,31000,310,0,-2,96,32,64,0,0,0,5,3,2,12,4,8,11,4,7,0,0,0,62,19,43,4,1,3,1,1,0,1,0,1
234085,31000,310,0,-2,2,0,2,0,0,0,0,0,0,1,0,1,0,0,0,0,0,0,1,0,1,0,0,0,0,0,0,0,0,0
234155,31000,310,0,-2,22,9,13,0,0,0,0,0,0,17,6,11,0,0,0,0,0,0,5,3,2,0,0,0,0,0,0,0,0,0
234164,31000,310,0,-2,1,0,1,0,0,0,0,0,0,0,0,0,0,0,0,0,0,0,0,0,0,0,0,0,1,0,1,0,0,0
234207,31000,310,0,-2,8,6,2,0,0,0,0,0,0,0,0,0,0,0,0,0,0,0,8,6,2,0,0,0,0,0,0,0,0,0
234377,31000,310,0,-2,1,0,1,0,0,0,0,0,0,0,0,0,0,0,0,0,0,0,1,0,1,0,0,0,0,0,0,0,0,0
234669,31000,310,0,-2,2,0,2,0,0,0,0,0,0,0,0,0,0,0,0,0,0,0,2,0,2,0,0,0,0,0,0,0,0,0
234711,31000,310,0,-2,2,0,2,0,0,0,0,0,0,0,0,0,0,0,0,0,0,0,1,0,1,1,0,1,0,0,0,0,0,0
234827,31000,310,0,-2,13,9,4,0,0,0,2,2,0,1,1,0,3,2,1,0,0,0,7,4,3,0,0,0,0,0,0,0,0,0
234845,31000,310,0,-2,1,0,1,1,0,1,0,0,0,0,0,0,0,0,0,0,0,0,0,0,0,0,0,0,0,0,0,0,0,0
234915,31000,310,0,-2,2,0,2,0,0,0,1,0,1,1,0,1,0,0,0,0,0,0,0,0,0,0,0,0,0,0,0,0,0,0
234933,31000,310,0,-2,3,0,3,0,0,0,0,0,0,0,0,0,0,0,0,0,0,0,3,0,3,0,0,0,0,0,0,0,0,0
234951,31000,310,0,-2,6,2,4,0,0,0,0,0,0,0,0,0,0,0,0,0,0,0,5,2,3,0,0,0,1,0,1,0,0,0
234979,31000,310,0,-2,5,1,4,0,0,0,0,0,0,0,0,0,2,0,2,0,0,0,3,1,2,0,0,0,0,0,0,0,0,0
235024,31000,310,0,-2,1,1,0,0,0,0,0,0,0,0,0,0,1,1,0,0,0,0,0,0,0,0,0,0,0,0,0,0,0,0
235097,31000,310,0,-2,7,7,0,0,0,0,1,1,0,0,0,0,0,0,0,0,0,0,6,6,0,0,0,0,0,0,0,0,0,0
235103,31000,310,0,-2,3,1,2,0,0,0,0,0,0,0,0,0,0,0,0,0,0,0,2,0,2,0,0,0,1,1,0,0,0,0
235149,31000,310,0,-2,2,1,1,0,0,0,1,0,1,0,0,0,0,0,0,0,0,0,1,1,0,0,0,0,0,0,0,0,0,0
235167,31000,310,0,-2,3,1,2,0,0,0,0,0,0,0,0,0,0,0,0,0,0,0,1,1,0,0,0,0,2,0,2,0,0,0
235237,31000,310,0,-2,9,4,5,0,0,0,0,0,0,1,1,0,2,0,2,0,0,0,2,0,2,0,0,0,4,3,1,0,0,0
235316,31000,310,0,-2,13,4,9,0,0,0,0,0,0,1,1,0,0,0,0,0,0,0,6,2,4,0,0,0,6,1,5,0,0,0
235343,31000,310,0,-2,3,0,3,0,0,0,0,0,0,0,0,0,1,0,1,0,0,0,2,0,2,0,0,0,0,0,0,0,0,0
235431,31000,310,0,-2,1,0,1,0,0,0,0,0,0,0,0,0,0,0,0,0,0,0,0,0,0,1,0,1,0,0,0,0,0,0
235547,31000,310,0,-2,3,0,3,0,0,0,0,0,0,0,0,0,0,0,0,0,0,0,1,0,1,0,0,0,2,0,2,0,0,0
235699,31000,310,0,-2,5,2,3,0,0,0,0,0,0,0,0,0,0,0,0,0,0,0,4,1,3,1,1,0,0,0,0,0,0,0
235750,31000,310,0,-2,4,1,3,0,0,0,1,0,1,0,0,0,0,0,0,0,0,0,3,1,2,0,0,0,0,0,0,0,0,0
236133,31000,310,0,-2,3,2,1,0,0,0,0,0,0,0,0,0,0,0,0,0,0,0,3,2,1,0,0,0,0,0,0,0,0,0
236188,31000,310,0,-2,4,1,3,0,0,0,0,0,0,0,0,0,0,0,0,0,0,0,4,1,3,0,0,0,0,0,0,0,0,0
236230,31000,310,0,-2,4,2,2,0,0,0,0,0,0,1,1,0,0,0,0,0,0,0,3,1,2,0,0,0,0,0,0,0,0,0
236258,31000,310,0,-2,2,1,1,0,0,0,1,0,1,0,0,0,0,0,0,0,0,0,0,0,0,1,1,0,0,0,0,0,0,0
236328,31000,310,0,-2,6,2,4,0,0,0,1,1,0,0,0,0,0,0,0,0,0,0,4,0,4,1,1,0,0,0,0,0,0,0
236382,31000,310,0,-2,3,2,1,0,0,0,1,1,0,0,0,0,0,0,0,0,0,0,2,1,1,0,0,0,0,0,0,0,0,0
236452,31000,310,0,-2,1,0,1,0,0,0,0,0,0,0,0,0,0,0,0,0,0,0,1,0,1,0,0,0,0,0,0,0,0,0
236577,31000,310,0,-2,1,0,1,0,0,0,0,0,0,0,0,0,0,0,0,0,0,0,0,0,0,0,0,0,0,0,0,1,0,1
236595,31000,310,0,-2,14,6,8,0,0,0,3,1,2,0,0,0,3,2,1,0,0,0,6,3,3,0,0,0,2,0,2,0,0,0
236610,31000,310,0,-2,1,0,1,0,0,0,0,0,0,0,0,0,0,0,0,0,0,0,1,0,1,0,0,0,0,0,0,0,0,0
236638,31000,310,0,-2,4,0,4,0,0,0,0,0,0,0,0,0,1,0,1,0,0,0,3,0,3,0,0,0,0,0,0,0,0,0
236656,31000,310,0,-2,1,0,1,0,0,0,1,0,1,0,0,0,0,0,0,0,0,0,0,0,0,0,0,0,0,0,0,0,0,0
236692,31000,310,0,-2,10,2,8,1,0,1,0,0,0,0,0,0,1,0,1,0,0,0,7,2,5,1,0,1,0,0,0,0,0,0
236887,31000,310,0,-2,6,0,6,0,0,0,0,0,0,0,0,0,1,0,1,0,0,0,5,0,5,0,0,0,0,0,0,0,0,0
236939,31000,310,0,-2,38,14,24,0,0,0,1,0,1,1,0,1,2,1,1,0,0,0,24,9,15,0,0,0,9,3,6,1,1,0
236948,31000,310,0,-2,248,86,162,1,0,1,38,12,26,22,8,14,18,7,11,4,3,1,141,47,94,7,2,5,16,7,9,1,0,1
236975,31000,310,0,-2,3,2,1,0,0,0,0,0,0,0,0,0,1,0,1,0,0,0,1,1,0,0,0,0,1,1,0,0,0,0
237011,31000,310,0,-2,6,4,2,0,0,0,0,0,0,1,0,1,0,0,0,0,0,0,4,3,1,1,1,0,0,0,0,0,0,0
237039,31000,310,0,-2,1,1,0,0,0,0,0,0,0,0,0,0,0,0,0,0,0,0,1,1,0,0,0,0,0,0,0,0,0,0
237057,31000,310,0,-2,1,0,1,0,0,0,0,0,0,0,0,0,0,0,0,0,0,0,1,0,1,0,0,0,0,0,0,0,0,0
237109,31000,310,0,-2,4,1,3,0,0,0,0,0,0,0,0,0,3,0,3,0,0,0,1,1,0,0,0,0,0,0,0,0,0,0
237312,31000,310,0,-2,2,1,1,0,0,0,0,0,0,0,0,0,0,0,0,0,0,0,2,1,1,0,0,0,0,0,0,0,0,0
237367,31000,310,0,-2,1,1,0,0,0,0,0,0,0,0,0,0,0,0,0,0,0,0,1,1,0,0,0,0,0,0,0,0,0,0
237385,31000,310,0,-2,1,0,1,0,0,0,0,0,0,0,0,0,0,0,0,0,0,0,1,0,1,0,0,0,0,0,0,0,0,0
237525,31000,310,0,-2,6,2,4,0,0,0,1,0,1,0,0,0,1,0,1,0,0,0,4,2,2,0,0,0,0,0,0,0,0,0
237701,31000,310,0,-2,2,1,1,0,0,0,0,0,0,0,0,0,0,0,0,0,0,0,2,1,1,0,0,0,0,0,0,0,0,0
237792,31000,310,0,-2,2,1,1,0,0,0,0,0,0,0,0,0,0,0,0,0,0,0,2,1,1,0,0,0,0,0,0,0,0,0
237817,31000,310,0,-2,3,2,1,0,0,0,0,0,0,0,0,0,0,0,0,0,0,0,3,2,1,0,0,0,0,0,0,0,0,0
237899,31000,310,0,-2,1,1,0,0,0,0,0,0,0,0,0,0,0,0,0,0,0,0,1,1,0,0,0,0,0,0,0,0,0,0
237932,31000,310,0,-2,1,0,1,0,0,0,0,0,0,0,0,0,0,0,0,0,0,0,1,0,1,0,0,0,0,0,0,0,0,0
237969,31000,310,0,-2,1,1,0,0,0,0,0,0,0,0,0,0,0,0,0,0,0,0,0,0,0,1,1,0,0,0,0,0,0,0
237987,31000,310,0,-2,1,0,1,0,0,0,0,0,0,0,0,0,0,0,0,0,0,0,1,0,1,0,0,0,0,0,0,0,0,0
237996,31000,310,0,-2,3,0,3,0,0,0,0,0,0,0,0,0,0,0,0,0,0,0,3,0,3,0,0,0,0,0,0,0,0,0
238032,31000,310,0,-2,19,8,11,0,0,0,0,0,0,0,0,0,0,0,0,0,0,0,17,7,10,0,0,0,2,1,1,0,0,0
238078,31000,310,0,-2,2,1,1,0,0,0,0,0,0,0,0,0,1,1,0,0,0,0,1,0,1,0,0,0,0,0,0,0,0,0
238193,31000,310,0,-2,2,0,2,0,0,0,0,0,0,1,0,1,1,0,1,0,0,0,0,0,0,0,0,0,0,0,0,0,0,0
238263,31000,310,0,-2,11,4,7,0,0,0,0,0,0,1,1,0,0,0,0,0,0,0,9,3,6,0,0,0,1,0,1,0,0,0
238333,31000,310,0,-2,2,2,0,0,0,0,0,0,0,1,1,0,0,0,0,0,0,0,1,1,0,0,0,0,0,0,0,0,0,0
238397,31000,310,0,-2,1,0,1,0,0,0,0,0,0,0,0,0,0,0,0,0,0,0,1,0,1,0,0,0,0,0,0,0,0,0
238430,31000,310,0,-2,6,3,3,0,0,0,0,0,0,1,0,1,1,1,0,0,0,0,4,2,2,0,0,0,0,0,0,0,0,0
238458,31000,310,0,-2,4,1,3,0,0,0,0,0,0,0,0,0,0,0,0,0,0,0,4,1,3,0,0,0,0,0,0,0,0,0
238476,31000,310,0,-2,9,4,5,0,0,0,0,0,0,1,0,1,1,0,1,0,0,0,4,4,0,0,0,0,3,0,3,0,0,0
238661,31000,310,0,-2,2,0,2,0,0,0,0,0,0,0,0,0,1,0,1,0,0,0,1,0,1,0,0,0,0,0,0,0,0,0
238722,31000,310,0,-2,5,2,3,0,0,0,1,1,0,0,0,0,0,0,0,0,0,0,4,1,3,0,0,0,0,0,0,0,0,0
239008,31000,310,0,-2,1,1,0,0,0,0,0,0,0,0,0,0,0,0,0,0,0,0,1,1,0,0,0,0,0,0,0,0,0,0
239017,31000,310,0,-2,1,0,1,0,0,0,0,0,0,0,0,0,0,0,0,0,0,0,1,0,1,0,0,0,0,0,0,0,0,0
239105,31000,310,0,-2,6,2,4,0,0,0,0,0,0,0,0,0,0,0,0,0,0,0,6,2,4,0,0,0,0,0,0,0,0,0
239169,31000,310,0,-2,72,11,61,0,0,0,9,3,6,6,0,6,8,0,8,1,0,1,45,7,38,3,1,2,0,0,0,0,0,0
239220,31000,310,0,-2,2,0,2,0,0,0,1,0,1,0,0,0,0,0,0,0,0,0,1,0,1,0,0,0,0,0,0,0,0,0
239248,31000,310,0,-2,6,1,5,0,0,0,0,0,0,4,0,4,0,0,0,0,0,0,2,1,1,0,0,0,0,0,0,0,0,0
239309,31000,310,0,-2,4,1,3,0,0,0,0,0,0,0,0,0,1,1,0,0,0,0,3,0,3,0,0,0,0,0,0,0,0,0
239318,31000,310,0,-2,5,0,5,0,0,0,0,0,0,0,0,0,1,0,1,0,0,0,4,0,4,0,0,0,0,0,0,0,0,0
239390,31000,310,0,-2,1,0,1,0,0,0,1,0,1,0,0,0,0,0,0,0,0,0,0,0,0,0,0,0,0,0,0,0,0,0
239442,31000,310,0,-2,1,0,1,0,0,0,0,0,0,0,0,0,0,0,0,0,0,0,1,0,1,0,0,0,0,0,0,0,0,0
239460,31000,310,0,-2,5,1,4,0,0,0,0,0,0,0,0,0,0,0,0,0,0,0,5,1,4,0,0,0,0,0,0,0,0,0
239488,31000,310,0,-2,6,4,2,1,1,0,1,1,0,0,0,0,0,0,0,0,0,0,4,2,2,0,0,0,0,0,0,0,0,0
239512,31000,310,0,-2,3,0,3,0,0,0,0,0,0,0,0,0,0,0,0,0,0,0,2,0,2,0,0,0,1,0,1,0,0,0
239628,31000,310,0,-2,1,1,0,0,0,0,0,0,0,0,0,0,0,0,0,0,0,0,1,1,0,0,0,0,0,0,0,0,0,0
239716,31000,310,0,-2,9,3,6,0,0,0,0,0,0,0,0,0,0,0,0,0,0,0,9,3,6,0,0,0,0,0,0,0,0,0
239910,31000,310,0,-2,2,0,2,0,0,0,0,0,0,0,0,0,0,0,0,0,0,0,2,0,2,0,0,0,0,0,0,0,0,0
240107,31000,310,0,-2,2,0,2,0,0,0,0,0,0,0,0,0,0,0,0,0,0,0,2,0,2,0,0,0,0,0,0,0,0,0
240116,31000,310,0,-2,4,1,3,0,0,0,0,0,0,1,1,0,1,0,1,0,0,0,2,0,2,0,0,0,0,0,0,0,0,0
240125,31000,310,0,-2,7,2,5,0,0,0,1,0,1,1,1,0,0,0,0,0,0,0,5,1,4,0,0,0,0,0,0,0,0,0
240189,31000,310,0,-2,1,0,1,0,0,0,0,0,0,1,0,1,0,0,0,0,0,0,0,0,0,0,0,0,0,0,0,0,0,0
240198,31000,310,0,-2,1,0,1,0,0,0,0,0,0,0,0,0,0,0,0,0,0,0,1,0,1,0,0,0,0,0,0,0,0,0
240268,31000,310,0,-2,5,2,3,0,0,0,0,0,0,0,0,0,0,0,0,0,0,0,4,1,3,0,0,0,1,1,0,0,0,0
240277,31000,310,0,-2,5,0,5,1,0,1,0,0,0,0,0,0,0,0,0,0,0,0,4,0,4,0,0,0,0,0,0,0,0,0
240374,31000,310,0,-2,3,1,2,0,0,0,0,0,0,0,0,0,0,0,0,0,0,0,2,0,2,1,1,0,0,0,0,0,0,0
240392,31000,310,0,-2,2,1,1,0,0,0,0,0,0,0,0,0,0,0,0,0,0,0,2,1,1,0,0,0,0,0,0,0,0,0
240426,31000,310,0,-2,1,0,1,0,0,0,0,0,0,0,0,0,0,0,0,0,0,0,1,0,1,0,0,0,0,0,0,0,0,0
240435,31000,310,0,-2,112,28,84,1,1,0,4,0,4,2,1,1,1,0,1,0,0,0,94,25,69,1,0,1,8,1,7,1,0,1
240444,31000,310,0,-2,107,31,76,0,0,0,5,2,3,3,2,1,3,1,2,0,0,0,91,24,67,1,0,1,2,1,1,2,1,1
240453,31000,310,0,-2,14,2,12,0,0,0,0,0,0,4,0,4,1,0,1,0,0,0,8,1,7,1,1,0,0,0,0,0,0,0
240462,31000,310,0,-2,5,3,2,0,0,0,0,0,0,1,1,0,0,0,0,0,0,0,4,2,2,0,0,0,0,0,0,0,0,0
240471,31000,310,0,-2,3,1,2,0,0,0,0,0,0,0,0,0,1,1,0,0,0,0,2,0,2,0,0,0,0,0,0,0,0,0
240480,31000,310,0,-2,3,1,2,0,0,0,0,0,0,0,0,0,0,0,0,0,0,0,3,1,2,0,0,0,0,0,0,0,0,0
240505,31000,310,0,-2,2,0,2,0,0,0,1,0,1,0,0,0,0,0,0,0,0,0,1,0,1,0,0,0,0,0,0,0,0,0
240514,31000,310,0,-2,1,0,1,0,0,0,0,0,0,0,0,0,0,0,0,0,0,0,1,0,1,0,0,0,0,0,0,0,0,0
240620,31000,310,0,-2,2,2,0,0,0,0,0,0,0,0,0,0,0,0,0,0,0,0,2,2,0,0,0,0,0,0,0,0,0,0
240666,31000,310,0,-2,1,1,0,0,0,0,0,0,0,0,0,0,0,0,0,0,0,0,1,1,0,0,0,0,0,0,0,0,0,0
240718,31000,310,0,-2,1,1,0,0,0,0,0,0,0,0,0,0,1,1,0,0,0,0,0,0,0,0,0,0,0,0,0,0,0,0
240727,31000,310,0,-2,45,13,32,1,1,0,1,0,1,0,0,0,1,0,1,0,0,0,25,11,14,1,0,1,14,1,13,2,0,2
240736,31000,310,0,-2,3,1,2,0,0,0,0,0,0,0,0,0,0,0,0,3,1,2,0,0,0,0,0,0,0,0,0,0,0,0
240745,31000,310,0,-2,3,1,2,0,0,0,1,0,1,0,0,0,0,0,0,2,1,1,0,0,0,0,0,0,0,0,0,0,0,0
241225,31000,310,0,-2,2,0,2,0,0,0,0,0,0,0,0,0,2,0,2,0,0,0,0,0,0,0,0,0,0,0,0,0,0,0
241331,31000,310,0,-2,2,0,2,0,0,0,0,0,0,0,0,0,2,0,2,0,0,0,0,0,0,0,0,0,0,0,0,0,0,0
241517,31000,310,0,-2,1,0,1,0,0,0,0,0,0,0,0,0,1,0,1,0,0,0,0,0,0,0,0,0,0,0,0,0,0,0
241614,31000,310,0,-2,1,0,1,0,0,0,0,0,0,0,0,0,1,0,1,0,0,0,0,0,0,0,0,0,0,0,0,0,0,0
241739,31000,310,0,-2,12,2,10,0,0,0,0,0,0,0,0,0,12,2,10,0,0,0,0,0,0,0,0,0,0,0,0,0,0,0
241951,31000,310,0,-2,1,1,0,0,0,0,0,0,0,0,0,0,1,1,0,0,0,0,0,0,0,0,0,0,0,0,0,0,0,0
242060,31000,310,0,-2,1,1,0,0,0,0,0,0,0,0,0,0,1,1,0,0,0,0,0,0,0,0,0,0,0,0,0,0,0,0
242662,31000,310,0,-2,1,0,1,0,0,0,0,0,0,0,0,0,1,0,1,0,0,0,0,0,0,0,0,0,0,0,0,0,0,0
242723,31000,310,0,-2,1,1,0,0,0,0,0,0,0,0,0,0,1,1,0,0,0,0,0,0,0,0,0,0,0,0,0,0,0,0
242972,31000,310,0,-2,7,2,5,0,0,0,0,0,0,0,0,0,4,2,2,0,0,0,3,0,3,0,0,0,0,0,0,0,0,0
243081,31000,310,0,-2,2,1,1,0,0,0,0,0,0,0,0,0,2,1,1,0,0,0,0,0,0,0,0,0,0,0,0,0,0,0
243160,31000,310,0,-2,2,1,1,0,0,0,0,0,0,0,0,0,2,1,1,0,0,0,0,0,0,0,0,0,0,0,0,0,0,0
243197,31000,310,0,-2,1,0,1,0,0,0,0,0,0,0,0,0,1,0,1,0,0,0,0,0,0,0,0,0,0,0,0,0,0,0
243346,31000,310,0,-2,5,3,2,0,0,0,0,0,0,0,0,0,5,3,2,0,0,0,0,0,0,0,0,0,0,0,0,0,0,0
243443,31000,310,0,-2,4,2,2,0,0,0,0,0,0,0,0,0,4,2,2,0,0,0,0,0,0,0,0,0,0,0,0,0,0,0
243568,31000,310,0,-2,2,1,1,0,0,0,0,0,0,0,0,0,2,1,1,0,0,0,0,0,0,0,0,0,0,0,0,0,0,0
243601,31000,310,0,-2,5,3,2,0,0,0,0,0,0,0,0,0,5,3,2,0,0,0,0,0,0,0,0,0,0,0,0,0,0,0
243638,31000,310,0,-2,3,2,1,0,0,0,0,0,0,0,0,0,0,0,0,3,2,1,0,0,0,0,0,0,0,0,0,0,0,0
243744,31000,310,0,-2,481,153,328,2,0,2,73,18,55,25,10,15,64,22,42,4,1,3,134,49,85,19,5,14,150,45,105,10,3,7
243780,31000,310,0,-2,111,43,68,0,0,0,2,1,1,14,5,9,4,0,4,0,0,0,88,37,51,2,0,2,0,0,0,1,0,1
243823,31000,310,0,-2,2,0,2,0,0,0,0,0,0,1,0,1,1,0,1,0,0,0,0,0,0,0,0,0,0,0,0,0,0,0
243832,31000,310,0,-2,2,1,1,0,0,0,0,0,0,0,0,0,2,1,1,0,0,0,0,0,0,0,0,0,0,0,0,0,0,0
244446,31000,310,0,-2,4,1,3,0,0,0,0,0,0,4,1,3,0,0,0,0,0,0,0,0,0,0,0,0,0,0,0,0,0,0
245953,31000,310,0,-2,4,0,4,0,0,0,0,0,0,0,0,0,1,0,1,0,0,0,3,0,3,0,0,0,0,0,0,0,0,0
246354,31000,310,0,-2,2,1,1,0,0,0,0,0,0,0,0,0,2,1,1,0,0,0,0,0,0,0,0,0,0,0,0,0,0,0
246813,31000,310,0,-2,1,1,0,0,0,0,0,0,0,1,1,0,0,0,0,0,0,0,0,0,0,0,0,0,0,0,0,0,0,0
247083,31000,310,0,-2,1,1,0,0,0,0,0,0,0,0,0,0,0,0,0,0,0,0,1,1,0,0,0,0,0,0,0,0,0,0
247834,31000,310,0,-2,7,2,5,0,0,0,2,0,2,2,2,0,1,0,1,0,0,0,2,0,2,0,0,0,0,0,0,0,0,0
248934,31000,310,0,-2,2,0,2,0,0,0,0,0,0,0,0,0,0,0,0,0,0,0,2,0,2,0,0,0,0,0,0,0,0,0
251260,31000,310,0,-2,1,0,1,0,0,0,0,0,0,0,0,0,0,0,0,0,0,0,1,0,1,0,0,0,0,0,0,0,0,0
251312,31000,310,0,-2,1,1,0,0,0,0,0,0,0,1,1,0,0,0,0,0,0,0,0,0,0,0,0,0,0,0,0,0,0,0
260372,31000,310,0,-2,1,0,1,0,0,0,0,0,0,0,0,0,0,0,0,0,0,0,1,0,1,0,0,0,0,0,0,0,0,0
262031,31000,310,0,-2,2,0,2,0,0,0,0,0,0,1,0,1,0,0,0,0,0,0,1,0,1,0,0,0,0,0,0,0,0,0
262086,31000,310,0,-2,3,0,3,0,0,0,0,0,0,0,0,0,1,0,1,0,0,0,1,0,1,1,0,1,0,0,0,0,0,0
262129,31000,310,0,-2,7,3,4,0,0,0,0,0,0,0,0,0,0,0,0,0,0,0,7,3,4,0,0,0,0,0,0,0,0,0
364016,31000,310,0,-2,7,1,6,1,0,1,0,0,0,0,0,0,1,0,1,0,0,0,4,1,3,0,0,0,1,0,1,0,0,0
364025,31000,310,0,-2,8,3,5,0,0,0,0,0,0,0,0,0,3,1,2,0,0,0,3,1,2,1,0,1,1,1,0,0,0,0
366252,31000,310,0,-2,5,1,4,0,0,0,0,0,0,0,0,0,0,0,0,0,0,0,5,1,4,0,0,0,0,0,0,0,0,0
366270,31000,310,0,-2,2,1,1,0,0,0,0,0,0,1,0,1,0,0,0,0,0,0,1,1,0,0,0,0,0,0,0,0,0,0
366711,31000,310,0,-2,14,4,10,0,0,0,2,0,2,0,0,0,4,2,2,0,0,0,7,2,5,0,0,0,1,0,1,0,0,0
367459,31000,310,0,-2,9,2,7,0,0,0,1,0,1,1,1,0,1,1,0,0,0,0,5,0,5,0,0,0,1,0,1,0,0,0
367954,31000,310,0,-2,10,1,9,0,0,0,0,0,0,1,0,1,5,1,4,1,0,1,3,0,3,0,0,0,0,0,0,0,0,0
369400,31000,310,0,-2,14,6,8,0,0,0,1,0,1,0,0,0,7,3,4,0,0,0,5,3,2,1,0,1,0,0,0,0,0,0
376695,31000,310,0,-2,3,1,2,0,0,0,1,0,1,0,0,0,0,0,0,2,1,1,0,0,0,0,0,0,0,0,0,0,0,0
377111,31000,310,0,-2,1,0,1,0,0,0,0,0,0,1,0,1,0,0,0,0,0,0,0,0,0,0,0,0,0,0,0,0,0,0
377555,31000,310,0,-2,6,2,4,0,0,0,0,0,0,0,0,0,1,1,0,0,0,0,5,1,4,0,0,0,0,0,0,0,0,0
378576,31000,310,0,-2,2,0,2,0,0,0,0,0,0,0,0,0,0,0,0,0,0,0,0,0,0,0,0,0,2,0,2,0,0,0
380359,31000,310,0,-2,1,0,1,1,0,1,0,0,0,0,0,0,0,0,0,0,0,0,0,0,0,0,0,0,0,0,0,0,0,0
380377,31000,310,0,-2,1,1,0,0,0,0,0,0,0,0,0,0,0,0,0,0,0,0,0,0,0,1,1,0,0,0,0,0,0,0
382957,31000,310,0,-2,1,0,1,0,0,0,0,0,0,1,0,1,0,0,0,0,0,0,0,0,0,0,0,0,0,0,0,0,0,0
384254,31000,310,0,-2,1,0,1,0,0,0,1,0,1,0,0,0,0,0,0,0,0,0,0,0,0,0,0,0,0,0,0,0,0,0
384333,31000,310,0,-2,5,2,3,0,0,0,0,0,0,1,0,1,4,2,2,0,0,0,0,0,0,0,0,0,0,0,0,0,0,0
384342,31000,310,0,-2,3,1,2,0,0,0,0,0,0,0,0,0,0,0,0,0,0,0,3,1,2,0,0,0,0,0,0,0,0,0
385415,31000,310,0,-2,4,1,3,0,0,0,0,0,0,0,0,0,2,0,2,0,0,0,1,1,0,0,0,0,0,0,0,1,0,1
385619,31000,310,0,-2,10,3,7,0,0,0,0,0,0,3,0,3,4,1,3,0,0,0,2,1,1,1,1,0,0,0,0,0,0,0
386153,31000,310,0,-2,1,0,1,0,0,0,0,0,0,0,0,0,0,0,0,0,0,0,1,0,1,0,0,0,0,0,0,0,0,0
388520,31000,310,0,-2,3,1,2,0,0,0,0,0,0,1,1,0,0,0,0,0,0,0,2,0,2,0,0,0,0,0,0,0,0,0
392415,31000,310,0,-2,2,0,2,0,0,0,0,0,0,0,0,0,2,0,2,0,0,0,0,0,0,0,0,0,0,0,0,0,0,0
399212,31000,310,0,-2,1,1,0,0,0,0,0,0,0,0,0,0,0,0,0,0,0,0,1,1,0,0,0,0,0,0,0,0,0,0
399869,31000,310,0,-2,2,1,1,0,0,0,0,0,0,0,0,0,1,1,0,0,0,0,1,0,1,0,0,0,0,0,0,0,0,0
404426,31000,310,0,-2,3,2,1,0,0,0,0,0,0,0,0,0,0,0,0,0,0,0,3,2,1,0,0,0,0,0,0,0,0,0
404480,31000,310,0,-2,1,1,0,0,0,0,0,0,0,0,0,0,0,0,0,0,0,0,1,1,0,0,0,0,0,0,0,0,0,0
405872,31000,310,0,-2,1,0,1,0,0,0,0,0,0,0,0,0,0,0,0,0,0,0,1,0,1,0,0,0,0,0,0,0,0,0
407629,31000,310,0,-2,3,1,2,0,0,0,0,0,0,0,0,0,0,0,0,0,0,0,3,1,2,0,0,0,0,0,0,0,0,0
409254,31000,310,0,-2,1,0,1,0,0,0,0,0,0,0,0,0,0,0,0,0,0,0,1,0,1,0,0,0,0,0,0,0,0,0
409315,31000,310,0,-2,13,4,9,0,0,0,1,0,1,0,0,0,12,4,8,0,0,0,0,0,0,0,0,0,0,0,0,0,0,0
409379,31000,310,0,-2,1,0,1,0,0,0,0,0,0,0,0,0,0,0,0,0,0,0,1,0,1,0,0,0,0,0,0,0,0,0
409698,31000,310,0,-2,14,6,8,0,0,0,2,1,1,1,0,1,4,2,2,0,0,0,6,3,3,0,0,0,1,0,1,0,0,0
412173,31000,310,0,-2,1,1,0,0,0,0,0,0,0,0,0,0,0,0,0,0,0,0,1,1,0,0,0,0,0,0,0,0,0,0
412599,31000,310,0,-2,1,1,0,0,0,0,0,0,0,1,1,0,0,0,0,0,0,0,0,0,0,0,0,0,0,0,0,0,0,0
413413,31000,310,0,-2,53,19,34,1,0,1,0,0,0,7,2,5,1,1,0,0,0,0,37,14,23,0,0,0,7,2,5,0,0,0
413680,31000,310,0,-2,1,1,0,0,0,0,0,0,0,0,0,0,0,0,0,0,0,0,1,1,0,0,0,0,0,0,0,0,0,0
414461,31000,310,0,-2,8,6,2,0,0,0,0,0,0,0,0,0,8,6,2,0,0,0,0,0,0,0,0,0,0,0,0,0,0,0
414939,31000,310,0,-2,4,0,4,0,0,0,0,0,0,0,0,0,0,0,0,0,0,0,0,0,0,0,0,0,4,0,4,0,0,0
420246,31000,310,0,-2,1,0,1,0,0,0,0,0,0,1,0,1,0,0,0,0,0,0,0,0,0,0,0,0,0,0,0,0,0,0
420431,31000,310,0,-2,2,1,1,0,0,0,0,0,0,1,0,1,0,0,0,0,0,0,1,1,0,0,0,0,0,0,0,0,0,0
422695,31000,310,0,-2,1,0,1,0,0,0,0,0,0,1,0,1,0,0,0,0,0,0,0,0,0,0,0,0,0,0,0,0,0,0
423643,31000,310,0,-2,1,0,1,0,0,0,0,0,0,0,0,0,1,0,1,0,0,0,0,0,0,0,0,0,0,0,0,0,0,0
428170,31000,310,0,-2,3,1,2,0,0,0,0,0,0,0,0,0,3,1,2,0,0,0,0,0,0,0,0,0,0,0,0,0,0,0
428392,31000,310,0,-2,1,0,1,0,0,0,0,0,0,0,0,0,0,0,0,0,0,0,1,0,1,0,0,0,0,0,0,0,0,0
428453,31000,310,0,-2,4,1,3,0,0,0,0,0,0,1,1,0,0,0,0,0,0,0,3,0,3,0,0,0,0,0,0,0,0,0
429128,31000,310,0,-2,1,0,1,0,0,0,0,0,0,0,0,0,0,0,0,0,0,0,1,0,1,0,0,0,0,0,0,0,0,0
432348,31000,310,0,-2,1,1,0,0,0,0,0,0,0,0,0,0,0,0,0,0,0,0,1,1,0,0,0,0,0,0,0,0,0,0
432524,31000,310,0,-2,1,1,0,0,0,0,0,0,0,1,1,0,0,0,0,0,0,0,0,0,0,0,0,0,0,0,0,0,0,0
433387,31000,310,0,-2,40,13,27,0,0,0,5,0,5,1,0,1,2,0,2,0,0,0,25,11,14,3,0,3,4,2,2,0,0,0
433420,31000,310,0,-2,1,0,1,0,0,0,0,0,0,0,0,0,1,0,1,0,0,0,0,0,0,0,0,0,0,0,0,0,0,0
433660,31000,310,0,-2,9,1,8,0,0,0,0,0,0,2,0,2,0,0,0,0,0,0,7,1,6,0,0,0,0,0,0,0,0,0
434016,31000,310,0,-2,1,0,1,0,0,0,0,0,0,0,0,0,0,0,0,0,0,0,1,0,1,0,0,0,0,0,0,0,0,0
434061,31000,310,0,-2,46,9,37,0,0,0,1,0,1,24,3,21,2,1,1,0,0,0,19,5,14,0,0,0,0,0,0,0,0,0
434672,31000,310,0,-2,9,3,6,0,0,0,0,0,0,1,0,1,0,0,0,0,0,0,6,3,3,1,0,1,0,0,0,1,0,1
434821,31000,310,0,-2,1,0,1,0,0,0,0,0,0,1,0,1,0,0,0,0,0,0,0,0,0,0,0,0,0,0,0,0,0,0
435000,31000,310,0,-2,15,0,15,0,0,0,0,0,0,8,0,8,0,0,0,0,0,0,7,0,7,0,0,0,0,0,0,0,0,0
436304,31000,310,0,-2,12,2,10,0,0,0,0,0,0,5,0,5,1,1,0,0,0,0,6,1,5,0,0,0,0,0,0,0,0,0
436429,31000,310,0,-2,4,1,3,0,0,0,1,0,1,0,0,0,2,1,1,0,0,0,1,0,1,0,0,0,0,0,0,0,0,0
437103,31000,310,0,-2,3,2,1,0,0,0,0,0,0,2,1,1,0,0,0,0,0,0,0,0,0,1,1,0,0,0,0,0,0,0
438498,31000,310,0,-2,1,0,1,0,0,0,0,0,0,1,0,1,0,0,0,0,0,0,0,0,0,0,0,0,0,0,0,0,0,0
438504,31000,310,0,-2,7,2,5,0,0,0,0,0,0,0,0,0,5,2,3,0,0,0,2,0,2,0,0,0,0,0,0,0,0,0
438665,31000,310,0,-2,3,3,0,0,0,0,0,0,0,0,0,0,0,0,0,0,0,0,0,0,0,0,0,0,3,3,0,0,0,0
439154,31000,310,0,-2,3,3,0,0,0,0,0,0,0,0,0,0,1,1,0,0,0,0,2,2,0,0,0,0,0,0,0,0,0,0
439190,31000,310,0,-2,2,1,1,0,0,0,0,0,0,0,0,0,0,0,0,0,0,0,0,0,0,1,0,1,1,1,0,0,0,0
439701,31000,310,0,-2,1,0,1,0,0,0,0,0,0,0,0,0,0,0,0,0,0,0,1,0,1,0,0,0,0,0,0,0,0,0
439738,31000,310,0,-2,1,0,1,0,0,0,0,0,0,1,0,1,0,0,0,0,0,0,0,0,0,0,0,0,0,0,0,0,0,0
439792,31000,310,0,-2,1,1,0,0,0,0,0,0,0,0,0,0,1,1,0,0,0,0,0,0,0,0,0,0,0,0,0,0,0,0
440031,31000,310,0,-2,1,0,1,0,0,0,1,0,1,0,0,0,0,0,0,0,0,0,0,0,0,0,0,0,0,0,0,0,0,0
440402,31000,310,0,-2,1,1,0,0,0,0,0,0,0,0,0,0,0,0,0,0,0,0,1,1,0,0,0,0,0,0,0,0,0,0
440794,31000,310,0,-2,2,0,2,0,0,0,0,0,0,0,0,0,2,0,2,0,0,0,0,0,0,0,0,0,0,0,0,0,0,0
440916,31000,310,0,-2,5,2,3,0,0,0,0,0,0,5,2,3,0,0,0,0,0,0,0,0,0,0,0,0,0,0,0,0,0,0
441131,31000,310,0,-2,1,0,1,0,0,0,0,0,0,0,0,0,0,0,0,0,0,0,1,0,1,0,0,0,0,0,0,0,0,0
441229,31000,310,0,-2,1,0,1,0,0,0,0,0,0,0,0,0,1,0,1,0,0,0,0,0,0,0,0,0,0,0,0,0,0,0
441371,31000,310,0,-2,8,4,4,0,0,0,0,0,0,2,2,0,2,0,2,0,0,0,3,1,2,1,1,0,0,0,0,0,0,0
441423,31000,310,0,-2,1,0,1,0,0,0,0,0,0,0,0,0,1,0,1,0,0,0,0,0,0,0,0,0,0,0,0,0,0,0
441760,31000,310,0,-2,2,0,2,0,0,0,0,0,0,1,0,1,0,0,0,0,0,0,1,0,1,0,0,0,0,0,0,0,0,0
441937,31000,310,0,-2,12,2,10,0,0,0,2,2,0,1,0,1,4,0,4,0,0,0,4,0,4,1,0,1,0,0,0,0,0,0
441982,31000,310,0,-2,1,0,1,0,0,0,0,0,0,0,0,0,0,0,0,0,0,0,1,0,1,0,0,0,0,0,0,0,0,0
442356,31000,310,0,-2,2,1,1,0,0,0,0,0,0,0,0,0,0,0,0,0,0,0,2,1,1,0,0,0,0,0,0,0,0,0
442383,31000,310,0,-2,1,1,0,0,0,0,0,0,0,0,0,0,0,0,0,0,0,0,1,1,0,0,0,0,0,0,0,0,0,0
442426,31000,310,0,-2,2,0,2,0,0,0,0,0,0,0,0,0,0,0,0,0,0,0,2,0,2,0,0,0,0,0,0,0,0,0
442569,31000,310,0,-2,6,1,5,0,0,0,0,0,0,0,0,0,0,0,0,0,0,0,5,1,4,1,0,1,0,0,0,0,0,0
442806,31000,310,0,-2,3,0,3,0,0,0,0,0,0,0,0,0,0,0,0,0,0,0,3,0,3,0,0,0,0,0,0,0,0,0
442930,31000,310,0,-2,3,0,3,0,0,0,1,0,1,0,0,0,1,0,1,0,0,0,0,0,0,1,0,1,0,0,0,0,0,0
443331,31000,310,0,-2,1,0,1,0,0,0,0,0,0,0,0,0,1,0,1,0,0,0,0,0,0,0,0,0,0,0,0,0,0,0
443410,31000,310,0,-2,2,0,2,0,0,0,0,0,0,0,0,0,0,0,0,0,0,0,1,0,1,1,0,1,0,0,0,0,0,0
443492,31000,310,0,-2,1,1,0,0,0,0,0,0,0,0,0,0,0,0,0,0,0,0,1,1,0,0,0,0,0,0,0,0,0,0
443711,31000,310,0,-2,22,3,19,0,0,0,1,0,1,8,1,7,6,0,6,0,0,0,6,2,4,0,0,0,1,0,1,0,0,0
444130,31000,310,0,-2,2,0,2,0,0,0,0,0,0,1,0,1,0,0,0,0,0,0,1,0,1,0,0,0,0,0,0,0,0,0
444556,31000,310,0,-2,1,0,1,0,0,0,0,0,0,0,0,0,1,0,1,0,0,0,0,0,0,0,0,0,0,0,0,0,0,0
444787,31000,310,0,-2,8,4,4,0,0,0,0,0,0,1,0,1,0,0,0,0,0,0,6,3,3,0,0,0,1,1,0,0,0,0
444811,31000,310,0,-2,2,1,1,0,0,0,0,0,0,2,1,1,0,0,0,0,0,0,0,0,0,0,0,0,0,0,0,0,0,0
444866,31000,310,0,-2,1,1,0,0,0,0,0,0,0,0,0,0,0,0,0,0,0,0,1,1,0,0,0,0,0,0,0,0,0,0
444954,31000,310,0,-2,2,0,2,0,0,0,0,0,0,0,0,0,0,0,0,0,0,0,2,0,2,0,0,0,0,0,0,0,0,0
445027,31000,310,0,-2,2,0,2,0,0,0,1,0,1,0,0,0,0,0,0,0,0,0,1,0,1,0,0,0,0,0,0,0,0,0
445188,31000,310,0,-2,23,8,15,0,0,0,5,2,3,1,0,1,9,2,7,0,0,0,6,2,4,0,0,0,1,1,0,1,1,0
445267,31000,310,0,-2,1,1,0,0,0,0,0,0,0,0,0,0,0,0,0,0,0,0,1,1,0,0,0,0,0,0,0,0,0,0
445692,31000,310,0,-2,2,1,1,0,0,0,0,0,0,0,0,0,0,0,0,0,0,0,2,1,1,0,0,0,0,0,0,0,0,0
445735,31000,310,0,-2,5,0,5,1,0,1,0,0,0,0,0,0,0,0,0,0,0,0,3,0,3,1,0,1,0,0,0,0,0,0
445744,31000,310,0,-2,1,1,0,0,0,0,0,0,0,1,1,0,0,0,0,0,0,0,0,0,0,0,0,0,0,0,0,0,0,0
445869,31000,310,0,-2,1,1,0,0,0,0,1,1,0,0,0,0,0,0,0,0,0,0,0,0,0,0,0,0,0,0,0,0,0,0
445948,31000,310,0,-2,3,1,2,0,0,0,0,0,0,1,0,1,1,1,0,0,0,0,1,0,1,0,0,0,0,0,0,0,0,0
446048,31000,310,0,-2,1,1,0,0,0,0,0,0,0,0,0,0,0,0,0,0,0,0,1,1,0,0,0,0,0,0,0,0,0,0
446385,31000,310,0,-2,1,0,1,0,0,0,1,0,1,0,0,0,0,0,0,0,0,0,0,0,0,0,0,0,0,0,0,0,0,0
446561,31000,310,0,-2,1,0,1,0,0,0,0,0,0,0,0,0,0,0,0,0,0,0,1,0,1,0,0,0,0,0,0,0,0,0
446640,31000,310,0,-2,1,0,1,0,0,0,0,0,0,0,0,0,0,0,0,0,0,0,0,0,0,0,0,0,1,0,1,0,0,0
447263,31000,310,0,-2,11,8,3,0,0,0,0,0,0,0,0,0,1,1,0,0,0,0,8,6,2,0,0,0,2,1,1,0,0,0
447582,31000,310,0,-2,1,1,0,0,0,0,0,0,0,0,0,0,0,0,0,0,0,0,1,1,0,0,0,0,0,0,0,0,0,0
447689,31000,310,0,-2,1,1,0,0,0,0,1,1,0,0,0,0,0,0,0,0,0,0,0,0,0,0,0,0,0,0,0,0,0,0
447698,31000,310,0,-2,1,0,1,0,0,0,0,0,0,0,0,0,0,0,0,0,0,0,1,0,1,0,0,0,0,0,0,0,0,0
447768,31000,310,0,-2,1,1,0,0,0,0,1,1,0,0,0,0,0,0,0,0,0,0,0,0,0,0,0,0,0,0,0,0,0,0
447777,31000,310,0,-2,3,0,3,0,0,0,0,0,0,0,0,0,1,0,1,0,0,0,1,0,1,1,0,1,0,0,0,0,0,0
447935,31000,310,0,-2,2,2,0,0,0,0,0,0,0,0,0,0,0,0,0,0,0,0,2,2,0,0,0,0,0,0,0,0,0,0
448354,31000,310,0,-2,1,0,1,0,0,0,0,0,0,0,0,0,1,0,1,0,0,0,0,0,0,0,0,0,0,0,0,0,0,0
448433,31000,310,0,-2,1,0,1,0,0,0,0,0,0,0,0,0,0,0,0,0,0,0,1,0,1,0,0,0,0,0,0,0,0,0
448673,31000,310,0,-2,2,1,1,0,0,0,1,1,0,0,0,0,1,0,1,0,0,0,0,0,0,0,0,0,0,0,0,0,0,0
449339,31000,310,0,-2,14,1,13,0,0,0,0,0,0,1,0,1,1,0,1,0,0,0,12,1,11,0,0,0,0,0,0,0,0,0
449384,31000,310,0,-2,1,1,0,0,0,0,0,0,0,0,0,0,0,0,0,0,0,0,1,1,0,0,0,0,0,0,0,0,0,0
449870,31000,310,0,-2,1,0,1,0,0,0,1,0,1,0,0,0,0,0,0,0,0,0,0,0,0,0,0,0,0,0,0,0,0,0
449889,31000,310,0,-2,1,0,1,0,0,0,0,0,0,0,0,0,0,0,0,0,0,0,1,0,1,0,0,0,0,0,0,0,0,0
449898,31000,310,0,-2,1,0,1,0,0,0,0,0,0,0,0,0,0,0,0,0,0,0,1,0,1,0,0,0,0,0,0,0,0,0
450058,31000,310,0,-2,5,1,4,0,0,0,0,0,0,3,0,3,0,0,0,0,0,0,2,1,1,0,0,0,0,0,0,0,0,0
450067,31000,310,0,-2,1,0,1,0,0,0,0,0,0,0,0,0,0,0,0,0,0,0,1,0,1,0,0,0,0,0,0,0,0,0
450933,31000,310,0,-2,2,0,2,0,0,0,0,0,0,0,0,0,0,0,0,0,0,0,2,0,2,0,0,0,0,0,0,0,0,0
451556,31000,310,0,-2,6,2,4,0,0,0,0,0,0,0,0,0,6,2,4,0,0,0,0,0,0,0,0,0,0,0,0,0,0,0
451866,31000,310,0,-2,2,0,2,0,0,0,0,0,0,1,0,1,0,0,0,0,0,0,1,0,1,0,0,0,0,0,0,0,0,0
451927,31000,310,0,-2,2,1,1,0,0,0,0,0,0,0,0,0,0,0,0,0,0,0,2,1,1,0,0,0,0,0,0,0,0,0
452124,31000,310,0,-2,1,1,0,0,0,0,0,0,0,0,0,0,0,0,0,0,0,0,1,1,0,0,0,0,0,0,0,0,0,0
452373,31000,310,0,-2,1,1,0,0,0,0,0,0,0,0,0,0,0,0,0,0,0,0,1,1,0,0,0,0,0,0,0,0,0,0
454184,31000,310,0,-2,5,1,4,0,0,0,1,0,1,1,0,1,0,0,0,0,0,0,2,1,1,0,0,0,1,0,1,0,0,0
454218,31000,310,0,-2,27,11,16,0,0,0,0,0,0,2,0,2,1,0,1,0,0,0,21,9,12,1,1,0,2,1,1,0,0,0
454698,31000,310,0,-2,2,0,2,0,0,0,0,0,0,0,0,0,2,0,2,0,0,0,0,0,0,0,0,0,0,0,0,0,0,0
454810,31000,310,0,-2,32,7,25,0,0,0,1,0,1,13,5,8,4,0,4,1,0,1,11,1,10,1,1,0,1,0,1,0,0,0
454856,31000,310,0,-2,1,0,1,0,0,0,0,0,0,0,0,0,0,0,0,0,0,0,1,0,1,0,0,0,0,0,0,0,0,0
455114,31000,310,0,-2,9,4,5,0,0,0,0,0,0,0,0,0,1,1,0,0,0,0,8,3,5,0,0,0,0,0,0,0,0,0
455196,31000,310,0,-2,1,0,1,0,0,0,0,0,0,0,0,0,1,0,1,0,0,0,0,0,0,0,0,0,0,0,0,0,0,0
455406,31000,310,0,-2,4,1,3,0,0,0,0,0,0,0,0,0,1,0,1,0,0,0,3,1,2,0,0,0,0,0,0,0,0,0
455479,31000,310,0,-2,1,0,1,0,0,0,0,0,0,0,0,0,0,0,0,0,0,0,1,0,1,0,0,0,0,0,0,0,0,0
455628,31000,310,0,-2,2,0,2,0,0,0,0,0,0,2,0,2,0,0,0,0,0,0,0,0,0,0,0,0,0,0,0,0,0,0
455770,31000,310,0,-2,1,1,0,0,0,0,1,1,0,0,0,0,0,0,0,0,0,0,0,0,0,0,0,0,0,0,0,0,0,0
455804,31000,310,0,-2,1,0,1,0,0,0,0,0,0,0,0,0,1,0,1,0,0,0,0,0,0,0,0,0,0,0,0,0,0,0
455992,31000,310,0,-2,1,0,1,1,0,1,0,0,0,0,0,0,0,0,0,0,0,0,0,0,0,0,0,0,0,0,0,0,0,0
456542,31000,310,0,-2,1,0,1,0,0,0,0,0,0,0,0,0,0,0,0,0,0,0,1,0,1,0,0,0,0,0,0,0,0,0
456959,31000,310,0,-2,1,0,1,0,0,0,0,0,0,0,0,0,0,0,0,0,0,0,1,0,1,0,0,0,0,0,0,0,0,0
457536,31000,310,0,-2,3,1,2,0,0,0,0,0,0,0,0,0,1,0,1,0,0,0,2,1,1,0,0,0,0,0,0,0,0,0
458210,31000,310,0,-2,4,1,3,0,0,0,1,0,1,0,0,0,1,0,1,0,0,0,1,1,0,0,0,0,1,0,1,0,0,0
458229,31000,310,0,-2,4,1,3,0,0,0,1,0,1,0,0,0,1,1,0,0,0,0,1,0,1,0,0,0,1,0,1,0,0,0
458982,31000,310,0,-2,1,1,0,0,0,0,0,0,0,1,1,0,0,0,0,0,0,0,0,0,0,0,0,0,0,0,0,0,0,0
459259,31000,310,0,-2,1,0,1,0,0,0,0,0,0,0,0,0,0,0,0,0,0,0,1,0,1,0,0,0,0,0,0,0,0,0
459736,31000,310,0,-2,1,0,1,0,0,0,1,0,1,0,0,0,0,0,0,0,0,0,0,0,0,0,0,0,0,0,0,0,0,0
459949,31000,310,0,-2,9,1,8,0,0,0,0,0,0,0,0,0,8,1,7,0,0,0,1,0,1,0,0,0,0,0,0,0,0,0
460376,31000,310,0,-2,5,1,4,0,0,0,1,0,1,0,0,0,0,0,0,0,0,0,4,1,3,0,0,0,0,0,0,0,0,0
460543,31000,310,0,-2,7,2,5,0,0,0,1,0,1,1,0,1,0,0,0,0,0,0,5,2,3,0,0,0,0,0,0,0,0,0
460756,31000,310,0,-2,4,0,4,0,0,0,0,0,0,0,0,0,2,0,2,0,0,0,0,0,0,0,0,0,2,0,2,0,0,0
460817,31000,310,0,-2,1,0,1,0,0,0,0,0,0,0,0,0,0,0,0,0,0,0,1,0,1,0,0,0,0,0,0,0,0,0
460826,31000,310,0,-2,1,0,1,0,0,0,0,0,0,0,0,0,0,0,0,0,0,0,1,0,1,0,0,0,0,0,0,0,0,0
461148,31000,310,0,-2,3,1,2,0,0,0,0,0,0,1,0,1,1,0,1,0,0,0,1,1,0,0,0,0,0,0,0,0,0,0
461218,31000,310,0,-2,1,1,0,0,0,0,0,0,0,0,0,0,0,0,0,0,0,0,1,1,0,0,0,0,0,0,0,0,0,0
461795,31000,310,0,-2,2,1,1,0,0,0,1,0,1,0,0,0,0,0,0,0,0,0,1,1,0,0,0,0,0,0,0,0,0,0
464226,31000,310,0,-2,1,1,0,0,0,0,0,0,0,0,0,0,1,1,0,0,0,0,0,0,0,0,0,0,0,0,0,0,0,0
475033,31000,310,0,-2,1,1,0,0,0,0,0,0,0,0,0,0,0,0,0,0,0,0,1,1,0,0,0,0,0,0,0,0,0,0
475495,31000,310,0,-2,5,1,4,0,0,0,0,0,0,0,0,0,1,0,1,0,0,0,4,1,3,0,0,0,0,0,0,0,0,0
476726,31000,310,0,-2,1,1,0,0,0,0,0,0,0,0,0,0,1,1,0,0,0,0,0,0,0,0,0,0,0,0,0,0,0,0
476975,31000,310,0,-2,8,1,7,0,0,0,0,0,0,2,0,2,1,0,1,0,0,0,5,1,4,0,0,0,0,0,0,0,0,0
477039,31000,310,0,-2,3,0,3,0,0,0,0,0,0,1,0,1,2,0,2,0,0,0,0,0,0,0,0,0,0,0,0,0,0,0
480073,31000,310,0,-2,1,0,1,0,0,0,0,0,0,0,0,0,0,0,0,1,0,1,0,0,0,0,0,0,0,0,0,0,0,0
480790,31000,310,0,-2,1,1,0,0,0,0,0,0,0,0,0,0,0,0,0,0,0,0,1,1,0,0,0,0,0,0,0,0,0,0
480967,31000,310,0,-2,1,0,1,1,0,1,0,0,0,0,0,0,0,0,0,0,0,0,0,0,0,0,0,0,0,0,0,0,0,0
481030,31000,310,0,-2,1,0,1,0,0,0,0,0,0,0,0,0,0,0,0,0,0,0,1,0,1,0,0,0,0,0,0,0,0,0
481094,31000,310,0,-2,2,2,0,0,0,0,1,1,0,0,0,0,0,0,0,0,0,0,0,0,0,0,0,0,1,1,0,0,0,0
481225,31000,310,0,-2,1,0,1,0,0,0,0,0,0,1,0,1,0,0,0,0,0,0,0,0,0,0,0,0,0,0,0,0,0,0
481535,31000,310,0,-2,11,2,9,0,0,0,2,0,2,0,0,0,3,0,3,0,0,0,6,2,4,0,0,0,0,0,0,0,0,0
482149,31000,310,0,-2,12,2,10,0,0,0,1,0,1,6,0,6,0,0,0,0,0,0,5,2,3,0,0,0,0,0,0,0,0,0
482158,31000,310,0,-2,2,0,2,0,0,0,0,0,0,2,0,2,0,0,0,0,0,0,0,0,0,0,0,0,0,0,0,0,0,0
482680,31000,310,0,-2,2,0,2,0,0,0,0,0,0,0,0,0,0,0,0,0,0,0,2,0,2,0,0,0,0,0,0,0,0,0
482705,31000,310,0,-2,3,1,2,0,0,0,0,0,0,0,0,0,1,0,1,0,0,0,2,1,1,0,0,0,0,0,0,0,0,0
483018,31000,310,0,-2,3,1,2,0,0,0,0,0,0,0,0,0,0,0,0,0,0,0,3,1,2,0,0,0,0,0,0,0,0,0
483036,31000,310,0,-2,2,0,2,0,0,0,0,0,0,1,0,1,0,0,0,0,0,0,1,0,1,0,0,0,0,0,0,0,0,0
483045,31000,310,0,-2,6,6,0,0,0,0,0,0,0,6,6,0,0,0,0,0,0,0,0,0,0,0,0,0,0,0,0,0,0,0
483124,31000,310,0,-2,8,4,4,0,0,0,0,0,0,0,0,0,3,1,2,0,0,0,4,3,1,1,0,1,0,0,0,0,0,0
483212,31000,310,0,-2,13,3,10,0,0,0,0,0,0,9,3,6,0,0,0,0,0,0,4,0,4,0,0,0,0,0,0,0,0,0
483647,31000,310,0,-2,4,0,4,0,0,0,0,0,0,0,0,0,0,0,0,0,0,0,4,0,4,0,0,0,0,0,0,0,0,0
483975,31000,310,0,-2,1,0,1,0,0,0,0,0,0,0,0,0,0,0,0,0,0,0,1,0,1,0,0,0,0,0,0,0,0,0
484002,31000,310,0,-2,1,0,1,0,0,0,1,0,1,0,0,0,0,0,0,0,0,0,0,0,0,0,0,0,0,0,0,0,0,0
484613,31000,310,0,-2,26,8,18,0,0,0,0,0,0,0,0,0,0,0,0,0,0,0,16,4,12,5,1,4,2,1,1,3,2,1
484844,31000,310,0,-2,3,1,2,0,0,0,1,0,1,0,0,0,0,0,0,0,0,0,0,0,0,0,0,0,0,0,0,2,1,1
484905,31000,310,0,-2,5,1,4,0,0,0,0,0,0,0,0,0,0,0,0,0,0,0,4,1,3,1,0,1,0,0,0,0,0,0
485111,31000,310,0,-2,2,0,2,0,0,0,0,0,0,0,0,0,0,0,0,0,0,0,2,0,2,0,0,0,0,0,0,0,0,0
485272,31000,310,0,-2,4,1,3,0,0,0,0,0,0,1,0,1,2,1,1,0,0,0,1,0,1,0,0,0,0,0,0,0,0,0
485458,31000,310,0,-2,1,0,1,0,0,0,0,0,0,1,0,1,0,0,0,0,0,0,0,0,0,0,0,0,0,0,0,0,0,0
485768,31000,310,0,-2,2,1,1,0,0,0,0,0,0,0,0,0,2,1,1,0,0,0,0,0,0,0,0,0,0,0,0,0,0,0
486053,31000,310,0,-2,2,0,2,0,0,0,0,0,0,0,0,0,0,0,0,0,0,0,2,0,2,0,0,0,0,0,0,0,0,0
486239,31000,310,0,-2,1,1,0,0,0,0,0,0,0,0,0,0,1,1,0,0,0,0,0,0,0,0,0,0,0,0,0,0,0,0
486257,31000,310,0,-2,1,0,1,0,0,0,0,0,0,1,0,1,0,0,0,0,0,0,0,0,0,0,0,0,0,0,0,0,0,0
486284,31000,310,0,-2,1,1,0,0,0,0,0,0,0,0,0,0,0,0,0,0,0,0,1,1,0,0,0,0,0,0,0,0,0,0
486840,31000,310,0,-2,35,13,22,0,0,0,2,0,2,9,6,3,2,1,1,0,0,0,19,4,15,0,0,0,3,2,1,0,0,0
486901,31000,310,0,-2,2,1,1,0,0,0,0,0,0,0,0,0,0,0,0,0,0,0,2,1,1,0,0,0,0,0,0,0,0,0
487010,31000,310,0,-2,12,2,10,0,0,0,0,0,0,4,0,4,1,1,0,0,0,0,4,1,3,0,0,0,0,0,0,3,0,3
487320,31000,310,0,-2,60,21,39,0,0,0,5,0,5,8,2,6,16,8,8,0,0,0,29,10,19,0,0,0,2,1,1,0,0,0
487409,31000,310,0,-2,1,1,0,0,0,0,0,0,0,1,1,0,0,0,0,0,0,0,0,0,0,0,0,0,0,0,0,0,0,0
487427,31000,310,0,-2,1,0,1,1,0,1,0,0,0,0,0,0,0,0,0,0,0,0,0,0,0,0,0,0,0,0,0,0,0,0
487472,31000,310,0,-2,1,1,0,0,0,0,0,0,0,0,0,0,1,1,0,0,0,0,0,0,0,0,0,0,0,0,0,0,0,0
487597,31000,310,0,-2,12,2,10,0,0,0,1,0,1,2,1,1,5,0,5,1,0,1,1,0,1,1,0,1,1,1,0,0,0,0
487861,31000,310,0,-2,3,2,1,0,0,0,0,0,0,2,1,1,0,0,0,0,0,0,1,1,0,0,0,0,0,0,0,0,0,0
487977,31000,310,0,-2,3,0,3,0,0,0,0,0,0,0,0,0,0,0,0,0,0,0,3,0,3,0,0,0,0,0,0,0,0,0
488077,31000,310,0,-2,4,2,2,0,0,0,0,0,0,0,0,0,1,1,0,0,0,0,1,0,1,0,0,0,2,1,1,0,0,0
488527,31000,310,0,-2,2,0,2,0,0,0,0,0,0,0,0,0,0,0,0,0,0,0,2,0,2,0,0,0,0,0,0,0,0,0
488572,31000,310,0,-2,2,0,2,0,0,0,0,0,0,0,0,0,2,0,2,0,0,0,0,0,0,0,0,0,0,0,0,0,0,0
488730,31000,310,0,-2,1,0,1,0,0,0,0,0,0,0,0,0,0,0,0,0,0,0,1,0,1,0,0,0,0,0,0,0,0,0
488785,31000,310,0,-2,1,0,1,0,0,0,0,0,0,0,0,0,0,0,0,0,0,0,1,0,1,0,0,0,0,0,0,0,0,0
488846,31000,310,0,-2,8,1,7,0,0,0,0,0,0,3,0,3,0,0,0,0,0,0,3,0,3,0,0,0,2,1,1,0,0,0
489779,31000,310,0,-2,10,6,4,0,0,0,2,1,1,1,0,1,3,3,0,0,0,0,4,2,2,0,0,0,0,0,0,0,0,0
489937,31000,310,0,-2,1,0,1,0,0,0,0,0,0,0,0,0,0,0,0,0,0,0,1,0,1,0,0,0,0,0,0,0,0,0
490133,31000,310,0,-2,2,0,2,0,0,0,0,0,0,2,0,2,0,0,0,0,0,0,0,0,0,0,0,0,0,0,0,0,0,0
490373,31000,310,0,-2,4,2,2,0,0,0,0,0,0,0,0,0,0,0,0,0,0,0,3,2,1,0,0,0,1,0,1,0,0,0
490805,31000,310,0,-2,6,2,4,0,0,0,0,0,0,1,0,1,1,1,0,0,0,0,3,0,3,0,0,0,1,1,0,0,0,0
491057,31000,310,0,-2,1,0,1,0,0,0,0,0,0,0,0,0,0,0,0,0,0,0,1,0,1,0,0,0,0,0,0,0,0,0
491525,31000,310,0,-2,1,0,1,0,0,0,0,0,0,0,0,0,1,0,1,0,0,0,0,0,0,0,0,0,0,0,0,0,0,0
491844,31000,310,0,-2,2,1,1,1,0,1,1,1,0,0,0,0,0,0,0,0,0,0,0,0,0,0,0,0,0,0,0,0,0,0
492263,31000,310,0,-2,14,7,7,0,0,0,0,0,0,1,1,0,0,0,0,0,0,0,13,6,7,0,0,0,0,0,0,0,0,0
492689,31000,310,0,-2,2,0,2,0,0,0,0,0,0,0,0,0,2,0,2,0,0,0,0,0,0,0,0,0,0,0,0,0,0,0
494250,31000,310,0,-2,2,1,1,0,0,0,0,0,0,0,0,0,1,0,1,0,0,0,1,1,0,0,0,0,0,0,0,0,0,0
494436,31000,310,0,-2,1,0,1,0,0,0,0,0,0,0,0,0,0,0,0,0,0,0,1,0,1,0,0,0,0,0,0,0,0,0
494603,31000,310,0,-2,1,0,1,0,0,0,0,0,0,0,0,0,0,0,0,0,0,0,1,0,1,0,0,0,0,0,0,0,0,0
494755,31000,310,0,-2,1,0,1,0,0,0,0,0,0,0,0,0,0,0,0,0,0,0,1,0,1,0,0,0,0,0,0,0,0,0
494843,31000,310,0,-2,1,0,1,0,0,0,0,0,0,1,0,1,0,0,0,0,0,0,0,0,0,0,0,0,0,0,0,0,0,0
495767,31000,310,0,-2,120,30,90,0,0,0,7,2,5,4,1,3,4,1,3,0,0,0,99,24,75,4,0,4,2,2,0,0,0,0
496043,31000,310,0,-2,5,3,2,0,0,0,1,0,1,1,1,0,2,1,1,0,0,0,1,1,0,0,0,0,0,0,0,0,0,0
496186,31000,310,0,-2,2,1,1,0,0,0,0,0,0,0,0,0,2,1,1,0,0,0,0,0,0,0,0,0,0,0,0,0,0,0
497000,31000,310,0,-2,3,2,1,0,0,0,0,0,0,0,0,0,1,1,0,0,0,0,2,1,1,0,0,0,0,0,0,0,0,0
497046,31000,310,0,-2,1,1,0,0,0,0,1,1,0,0,0,0,0,0,0,0,0,0,0,0,0,0,0,0,0,0,0,0,0,0
497286,31000,310,0,-2,3,2,1,0,0,0,0,0,0,0,0,0,1,0,1,0,0,0,2,2,0,0,0,0,0,0,0,0,0,0
100654,32000,320,0,-2,2,2,0,0,0,0,0,0,0,2,2,0,0,0,0,0,0,0,0,0,0,0,0,0,0,0,0,0,0,0
100663,32000,320,0,-2,242,100,142,0,0,0,22,8,14,42,7,35,12,5,7,0,0,0,121,57,64,5,4,1,3,2,1,37,17,20
100706,32000,320,0,-2,92,54,38,1,0,1,6,1,5,9,3,6,3,2,1,0,0,0,67,43,24,1,1,0,0,0,0,5,4,1
100724,32000,320,0,-2,6,3,3,0,0,0,0,0,0,3,2,1,0,0,0,0,0,0,1,1,0,0,0,0,2,0,2,0,0,0
100751,32000,320,0,-2,77,55,22,0,0,0,5,3,2,4,2,2,4,3,1,0,0,0,41,31,10,0,0,0,0,0,0,23,16,7
100812,32000,320,0,-2,5,2,3,0,0,0,0,0,0,0,0,0,0,0,0,0,0,0,5,2,3,0,0,0,0,0,0,0,0,0
100830,32000,320,0,-2,5,1,4,0,0,0,1,0,1,1,0,1,0,0,0,0,0,0,1,0,1,0,0,0,2,1,1,0,0,0
100858,32000,320,0,-2,41,27,14,0,0,0,2,1,1,4,2,2,2,0,2,0,0,0,25,18,7,0,0,0,0,0,0,8,6,2
100937,32000,320,0,-2,2,1,1,0,0,0,0,0,0,1,0,1,0,0,0,0,0,0,1,1,0,0,0,0,0,0,0,0,0,0
101286,32000,320,0,-2,1,1,0,0,0,0,0,0,0,0,0,0,0,0,0,0,0,0,1,1,0,0,0,0,0,0,0,0,0,0
101295,32000,320,0,-2,4,4,0,0,0,0,0,0,0,0,0,0,0,0,0,0,0,0,4,4,0,0,0,0,0,0,0,0,0,0
101462,32000,320,0,-2,1,1,0,0,0,0,0,0,0,1,1,0,0,0,0,0,0,0,0,0,0,0,0,0,0,0,0,0,0,0
101480,32000,320,0,-2,5,3,2,0,0,0,0,0,0,0,0,0,0,0,0,0,0,0,4,2,2,0,0,0,0,0,0,1,1,0
101514,32000,320,0,-2,3,1,2,0,0,0,0,0,0,0,0,0,0,0,0,0,0,0,3,1,2,0,0,0,0,0,0,0,0,0
101675,32000,320,0,-2,2,1,1,0,0,0,0,0,0,2,1,1,0,0,0,0,0,0,0,0,0,0,0,0,0,0,0,0,0,0
101709,32000,320,0,-2,2,2,0,0,0,0,0,0,0,0,0,0,0,0,0,0,0,0,2,2,0,0,0,0,0,0,0,0,0,0
101736,32000,320,0,-2,2,2,0,0,0,0,0,0,0,0,0,0,0,0,0,0,0,0,2,2,0,0,0,0,0,0,0,0,0,0
101879,32000,320,0,-2,1,0,1,0,0,0,0,0,0,0,0,0,0,0,0,0,0,0,1,0,1,0,0,0,0,0,0,0,0,0
101897,32000,320,0,-2,1,1,0,0,0,0,0,0,0,0,0,0,0,0,0,0,0,0,1,1,0,0,0,0,0,0,0,0,0,0
102094,32000,320,0,-2,18,6,12,0,0,0,1,0,1,0,0,0,0,0,0,0,0,0,17,6,11,0,0,0,0,0,0,0,0,0
102234,32000,320,0,-2,3,3,0,0,0,0,0,0,0,0,0,0,0,0,0,0,0,0,3,3,0,0,0,0,0,0,0,0,0,0
102368,32000,320,0,-2,2,2,0,0,0,0,0,0,0,0,0,0,0,0,0,0,0,0,1,1,0,0,0,0,0,0,0,1,1,0
102395,32000,320,0,-2,2,2,0,0,0,0,0,0,0,1,1,0,0,0,0,0,0,0,1,1,0,0,0,0,0,0,0,0,0,0
102553,32000,320,0,-2,11,6,5,1,0,1,0,0,0,0,0,0,2,2,0,0,0,0,7,4,3,0,0,0,1,0,1,0,0,0
102614,32000,320,0,-2,11,10,1,0,0,0,0,0,0,0,0,0,1,1,0,0,0,0,9,9,0,0,0,0,1,0,1,0,0,0
102845,32000,320,0,-2,1,1,0,0,0,0,0,0,0,0,0,0,0,0,0,0,0,0,1,1,0,0,0,0,0,0,0,0,0,0
103501,32000,320,0,-2,1,1,0,0,0,0,0,0,0,1,1,0,0,0,0,0,0,0,0,0,0,0,0,0,0,0,0,0,0,0
103529,32000,320,0,-2,6,5,1,0,0,0,2,2,0,0,0,0,0,0,0,0,0,0,2,2,0,0,0,0,1,1,0,1,0,1
104151,32000,320,0,-2,373,210,163,3,1,2,24,11,13,9,6,3,41,17,24,1,0,1,106,63,43,13,10,3,81,47,34,95,55,40
104160,32000,320,0,-2,1,1,0,0,0,0,0,0,0,0,0,0,1,1,0,0,0,0,0,0,0,0,0,0,0,0,0,0,0,0
104179,32000,320,0,-2,60,23,37,1,0,1,7,2,5,2,0,2,14,3,11,0,0,0,26,12,14,3,2,1,1,1,0,6,3,3
104346,32000,320,0,-2,2,2,0,0,0,0,0,0,0,0,0,0,0,0,0,0,0,0,2,2,0,0,0,0,0,0,0,0,0,0
104425,32000,320,0,-2,3,1,2,0,0,0,0,0,0,1,0,1,0,0,0,0,0,0,2,1,1,0,0,0,0,0,0,0,0,0
104577,32000,320,0,-2,2,2,0,0,0,0,0,0,0,0,0,0,1,1,0,0,0,0,1,1,0,0,0,0,0,0,0,0,0,0
104586,32000,320,0,-2,2,2,0,0,0,0,0,0,0,0,0,0,0,0,0,0,0,0,2,2,0,0,0,0,0,0,0,0,0,0
104708,32000,320,0,-2,4,4,0,0,0,0,0,0,0,0,0,0,0,0,0,0,0,0,3,3,0,0,0,0,0,0,0,1,1,0
104717,32000,320,0,-2,16,14,2,0,0,0,0,0,0,1,1,0,4,4,0,0,0,0,8,7,1,1,0,1,2,2,0,0,0,0
105136,32000,320,0,-2,7,7,0,0,0,0,0,0,0,1,1,0,1,1,0,0,0,0,3,3,0,0,0,0,2,2,0,0,0,0
105145,32000,320,0,-2,2,2,0,1,1,0,0,0,0,0,0,0,0,0,0,0,0,0,1,1,0,0,0,0,0,0,0,0,0,0
105154,32000,320,0,-2,1,1,0,0,0,0,0,0,0,0,0,0,0,0,0,0,0,0,1,1,0,0,0,0,0,0,0,0,0,0
105206,32000,320,0,-2,2,1,1,0,0,0,0,0,0,0,0,0,0,0,0,0,0,0,1,0,1,0,0,0,1,1,0,0,0,0
105297,32000,320,0,-2,4,2,2,4,2,2,0,0,0,0,0,0,0,0,0,0,0,0,0,0,0,0,0,0,0,0,0,0,0,0
105330,32000,320,0,-2,45,30,15,1,1,0,2,1,1,2,1,1,4,1,3,0,0,0,26,18,8,0,0,0,2,2,0,8,6,2
105349,32000,320,0,-2,2,1,1,0,0,0,0,0,0,0,0,0,0,0,0,1,1,0,1,0,1,0,0,0,0,0,0,0,0,0
105525,32000,320,0,-2,10,7,3,0,0,0,2,1,1,2,1,1,0,0,0,0,0,0,6,5,1,0,0,0,0,0,0,0,0,0
105589,32000,320,0,-2,1,1,0,0,0,0,0,0,0,0,0,0,0,0,0,0,0,0,1,1,0,0,0,0,0,0,0,0,0,0
105668,32000,320,0,-2,1,0,1,1,0,1,0,0,0,0,0,0,0,0,0,0,0,0,0,0,0,0,0,0,0,0,0,0,0,0
105747,32000,320,0,-2,2,1,1,0,0,0,0,0,0,0,0,0,0,0,0,0,0,0,2,1,1,0,0,0,0,0,0,0,0,0
105792,32000,320,0,-2,1,1,0,0,0,0,0,0,0,0,0,0,1,1,0,0,0,0,0,0,0,0,0,0,0,0,0,0,0,0
106148,32000,320,0,-2,6,3,3,0,0,0,0,0,0,0,0,0,2,1,1,0,0,0,2,1,1,0,0,0,2,1,1,0,0,0
106245,32000,320,0,-2,18,6,12,0,0,0,0,0,0,3,1,2,0,0,0,0,0,0,13,3,10,0,0,0,1,1,0,1,1,0
106263,32000,320,0,-2,33,12,21,0,0,0,3,1,2,1,0,1,1,0,1,0,0,0,23,9,14,1,1,0,0,0,0,4,1,3
106397,32000,320,0,-2,116,72,44,2,1,1,2,1,1,5,3,2,5,4,1,0,0,0,63,38,25,1,1,0,3,1,2,35,23,12
106412,32000,320,0,-2,5,1,4,0,0,0,0,0,0,5,1,4,0,0,0,0,0,0,0,0,0,0,0,0,0,0,0,0,0,0
106449,32000,320,0,-2,1,1,0,0,0,0,0,0,0,0,0,0,0,0,0,0,0,0,0,0,0,1,1,0,0,0,0,0,0,0
106458,32000,320,0,-2,9,6,3,0,0,0,0,0,0,1,1,0,1,0,1,0,0,0,6,5,1,0,0,0,0,0,0,1,0,1
106467,32000,320,0,-2,1,1,0,0,0,0,0,0,0,0,0,0,0,0,0,0,0,0,1,1,0,0,0,0,0,0,0,0,0,0
106485,32000,320,0,-2,2,2,0,0,0,0,0,0,0,1,1,0,0,0,0,0,0,0,1,1,0,0,0,0,0,0,0,0,0,0
106704,32000,320,0,-2,9,6,3,0,0,0,0,0,0,1,1,0,0,0,0,0,0,0,8,5,3,0,0,0,0,0,0,0,0,0
106713,32000,320,0,-2,1,1,0,0,0,0,0,0,0,0,0,0,0,0,0,0,0,0,1,1,0,0,0,0,0,0,0,0,0,0
106980,32000,320,0,-2,1,1,0,0,0,0,0,0,0,0,0,0,0,0,0,0,0,0,1,1,0,0,0,0,0,0,0,0,0,0
107071,32000,320,0,-2,3,3,0,0,0,0,0,0,0,0,0,0,1,1,0,0,0,0,2,2,0,0,0,0,0,0,0,0,0,0
107080,32000,320,0,-2,1,1,0,0,0,0,0,0,0,0,0,0,0,0,0,0,0,0,0,0,0,1,1,0,0,0,0,0,0,0
107460,32000,320,0,-2,1,1,0,0,0,0,0,0,0,0,0,0,0,0,0,0,0,0,1,1,0,0,0,0,0,0,0,0,0,0
107521,32000,320,0,-2,1,1,0,0,0,0,0,0,0,0,0,0,0,0,0,0,0,0,1,1,0,0,0,0,0,0,0,0,0,0
107585,32000,320,0,-2,1,0,1,0,0,0,0,0,0,0,0,0,0,0,0,0,0,0,1,0,1,0,0,0,0,0,0,0,0,0
107619,32000,320,0,-2,1,1,0,0,0,0,0,0,0,0,0,0,0,0,0,0,0,0,1,1,0,0,0,0,0,0,0,0,0,0
107983,32000,320,0,-2,3,3,0,0,0,0,0,0,0,0,0,0,0,0,0,0,0,0,3,3,0,0,0,0,0,0,0,0,0,0
108056,32000,320,0,-2,7,2,5,0,0,0,2,0,2,0,0,0,0,0,0,0,0,0,4,1,3,0,0,0,1,1,0,0,0,0
108232,32000,320,0,-2,4,2,2,0,0,0,0,0,0,0,0,0,2,1,1,0,0,0,2,1,1,0,0,0,0,0,0,0,0,0
108807,32000,320,0,-2,1,1,0,0,0,0,0,0,0,0,0,0,0,0,0,0,0,0,0,0,0,0,0,0,1,1,0,0,0,0
109651,32000,320,0,-2,2,0,2,0,0,0,1,0,1,0,0,0,0,0,0,0,0,0,0,0,0,0,0,0,1,0,1,0,0,0
109785,32000,320,0,-2,1,0,1,0,0,0,1,0,1,0,0,0,0,0,0,0,0,0,0,0,0,0,0,0,0,0,0,0,0,0
109819,32000,320,0,-2,1,0,1,0,0,0,0,0,0,0,0,0,1,0,1,0,0,0,0,0,0,0,0,0,0,0,0,0,0,0
110097,32000,320,0,-2,2,2,0,0,0,0,1,1,0,0,0,0,0,0,0,0,0,0,1,1,0,0,0,0,0,0,0,0,0,0
110219,32000,320,0,-2,2,2,0,0,0,0,0,0,0,0,0,0,1,1,0,0,0,0,1,1,0,0,0,0,0,0,0,0,0,0
110316,32000,320,0,-2,2,1,1,0,0,0,2,1,1,0,0,0,0,0,0,0,0,0,0,0,0,0,0,0,0,0,0,0,0,0
110361,32000,320,0,-2,5,3,2,0,0,0,1,1,0,0,0,0,3,2,1,0,0,0,1,0,1,0,0,0,0,0,0,0,0,0
110370,32000,320,0,-2,4,3,1,0,0,0,1,1,0,0,0,0,0,0,0,0,0,0,2,2,0,0,0,0,0,0,0,1,0,1
110398,32000,320,0,-2,2,1,1,0,0,0,1,1,0,0,0,0,0,0,0,0,0,0,1,0,1,0,0,0,0,0,0,0,0,0
110404,32000,320,0,-2,83,39,44,0,0,0,21,11,10,3,0,3,13,4,9,0,0,0,21,11,10,4,1,3,3,1,2,18,11,7
110413,32000,320,0,-2,3,2,1,0,0,0,1,1,0,0,0,0,2,1,1,0,0,0,0,0,0,0,0,0,0,0,0,0,0,0
110422,32000,320,0,-2,10,7,3,0,0,0,2,1,1,0,0,0,1,1,0,0,0,0,7,5,2,0,0,0,0,0,0,0,0,0
110486,32000,320,0,-2,6,6,0,0,0,0,1,1,0,0,0,0,1,1,0,0,0,0,4,4,0,0,0,0,0,0,0,0,0,0
110495,32000,320,0,-2,1,1,0,0,0,0,0,0,0,0,0,0,0,0,0,0,0,0,1,1,0,0,0,0,0,0,0,0,0,0
110501,32000,320,0,-2,14,9,5,0,0,0,6,4,2,1,0,1,0,0,0,0,0,0,5,4,1,1,0,1,1,1,0,0,0,0
110510,32000,320,0,-2,5,3,2,0,0,0,1,0,1,0,0,0,2,1,1,0,0,0,2,2,0,0,0,0,0,0,0,0,0,0
110529,32000,320,0,-2,2,1,1,0,0,0,1,1,0,0,0,0,1,0,1,0,0,0,0,0,0,0,0,0,0,0,0,0,0,0
110538,32000,320,0,-2,4,2,2,0,0,0,0,0,0,0,0,0,1,0,1,0,0,0,2,2,0,0,0,0,1,0,1,0,0,0
110547,32000,320,0,-2,4,4,0,0,0,0,1,1,0,0,0,0,1,1,0,0,0,0,2,2,0,0,0,0,0,0,0,0,0,0
110556,32000,320,0,-2,2,2,0,0,0,0,1,1,0,0,0,0,1,1,0,0,0,0,0,0,0,0,0,0,0,0,0,0,0,0
110565,32000,320,0,-2,8,3,5,0,0,0,0,0,0,1,1,0,1,0,1,0,0,0,6,2,4,0,0,0,0,0,0,0,0,0
110574,32000,320,0,-2,4,2,2,0,0,0,0,0,0,0,0,0,1,1,0,0,0,0,1,1,0,0,0,0,0,0,0,2,0,2
110583,32000,320,0,-2,19,12,7,0,0,0,4,4,0,3,1,2,5,2,3,0,0,0,6,5,1,0,0,0,0,0,0,1,0,1
110592,32000,320,0,-2,8,3,5,0,0,0,1,1,0,1,0,1,3,1,2,0,0,0,0,0,0,0,0,0,3,1,2,0,0,0
110608,32000,320,0,-2,12,7,5,0,0,0,2,2,0,0,0,0,2,1,1,0,0,0,4,2,2,2,1,1,2,1,1,0,0,0
110617,32000,320,0,-2,8,6,2,0,0,0,2,2,0,1,1,0,1,0,1,0,0,0,2,1,1,1,1,0,1,1,0,0,0,0
110635,32000,320,0,-2,108,55,53,1,1,0,17,10,7,4,2,2,14,5,9,0,0,0,45,24,21,5,2,3,5,3,2,17,8,9
110644,32000,320,0,-2,251,110,141,1,1,0,59,29,30,9,3,6,59,23,36,1,0,1,82,38,44,9,2,7,12,7,5,19,7,12
110653,32000,320,0,-2,90,33,57,1,0,1,33,12,21,1,1,0,20,6,14,0,0,0,20,9,11,2,1,1,5,2,3,8,2,6
110662,32000,320,0,-2,378,183,195,0,0,0,82,44,38,12,3,9,69,28,41,1,0,1,87,46,41,9,5,4,21,14,7,97,43,54
110671,32000,320,0,-2,30,17,13,0,0,0,7,5,2,2,1,1,10,5,5,1,1,0,7,3,4,0,0,0,2,2,0,1,0,1
110680,32000,320,0,-2,443,187,256,2,1,1,121,43,78,9,4,5,77,35,42,0,0,0,161,72,89,13,6,7,19,7,12,41,19,22
110699,32000,320,0,-2,592,201,391,1,1,0,166,54,112,17,5,12,100,35,65,0,0,0,178,66,112,29,8,21,43,17,26,58,15,43
110705,32000,320,0,-2,40,21,19,0,0,0,5,4,1,2,0,2,5,2,3,0,0,0,16,11,5,0,0,0,4,1,3,8,3,5
110714,32000,320,0,-2,53,33,20,0,0,0,8,5,3,3,3,0,7,3,4,0,0,0,21,14,7,3,2,1,5,5,0,6,1,5
111081,32000,320,0,-2,3,3,0,0,0,0,0,0,0,1,1,0,0,0,0,0,0,0,2,2,0,0,0,0,0,0,0,0,0,0
111188,32000,320,0,-2,2,1,1,0,0,0,2,1,1,0,0,0,0,0,0,0,0,0,0,0,0,0,0,0,0,0,0,0,0,0
111461,32000,320,0,-2,3,2,1,0,0,0,0,0,0,0,0,0,3,2,1,0,0,0,0,0,0,0,0,0,0,0,0,0,0,0
111638,32000,320,0,-2,1,1,0,0,0,0,0,0,0,1,1,0,0,0,0,0,0,0,0,0,0,0,0,0,0,0,0,0,0,0
111948,32000,320,0,-2,27,13,14,0,0,0,3,1,2,0,0,0,0,0,0,0,0,0,2,1,1,0,0,0,12,4,8,10,7,3
111966,32000,320,0,-2,4,3,1,0,0,0,0,0,0,1,1,0,0,0,0,0,0,0,0,0,0,0,0,0,3,2,1,0,0,0
112075,32000,320,0,-2,2,1,1,0,0,0,0,0,0,0,0,0,1,0,1,0,0,0,0,0,0,0,0,0,1,1,0,0,0,0
112260,32000,320,0,-2,2,1,1,0,0,0,0,0,0,0,0,0,1,1,0,0,0,0,0,0,0,0,0,0,0,0,0,1,0,1
112525,32000,320,0,-2,22,11,11,0,0,0,9,2,7,1,1,0,4,4,0,0,0,0,5,2,3,0,0,0,0,0,0,3,2,1
112570,32000,320,0,-2,1,1,0,0,0,0,0,0,0,0,0,0,0,0,0,0,0,0,1,1,0,0,0,0,0,0,0,0,0,0
112817,32000,320,0,-2,1,1,0,0,0,0,0,0,0,0,0,0,0,0,0,0,0,0,1,1,0,0,0,0,0,0,0,0,0,0
113096,32000,320,0,-2,1,1,0,0,0,0,0,0,0,0,0,0,0,0,0,0,0,0,0,0,0,1,1,0,0,0,0,0,0,0
113698,32000,320,0,-2,2,2,0,0,0,0,1,1,0,0,0,0,0,0,0,0,0,0,1,1,0,0,0,0,0,0,0,0,0,0
114433,32000,320,0,-2,1,1,0,0,0,0,0,0,0,0,0,0,0,0,0,0,0,0,1,1,0,0,0,0,0,0,0,0,0,0
114549,32000,320,0,-2,3,2,1,0,0,0,0,0,0,1,1,0,0,0,0,0,0,0,2,1,1,0,0,0,0,0,0,0,0,0
114813,32000,320,0,-2,1,1,0,0,0,0,0,0,0,0,0,0,1,1,0,0,0,0,0,0,0,0,0,0,0,0,0,0,0,0
114831,32000,320,0,-2,1,1,0,0,0,0,1,1,0,0,0,0,0,0,0,0,0,0,0,0,0,0,0,0,0,0,0,0,0,0
114840,32000,320,0,-2,3,1,2,0,0,0,0,0,0,1,0,1,1,0,1,0,0,0,1,1,0,0,0,0,0,0,0,0,0,0
115083,32000,320,0,-2,3,3,0,0,0,0,0,0,0,0,0,0,3,3,0,0,0,0,0,0,0,0,0,0,0,0,0,0,0,0
115409,32000,320,0,-2,2,1,1,0,0,0,0,0,0,0,0,0,0,0,0,0,0,0,2,1,1,0,0,0,0,0,0,0,0,0
115728,32000,320,0,-2,2,2,0,0,0,0,2,2,0,0,0,0,0,0,0,0,0,0,0,0,0,0,0,0,0,0,0,0,0,0
115746,32000,320,0,-2,1,1,0,0,0,0,0,0,0,0,0,0,1,1,0,0,0,0,0,0,0,0,0,0,0,0,0,0,0,0
115755,32000,320,0,-2,2,1,1,0,0,0,0,0,0,0,0,0,0,0,0,0,0,0,2,1,1,0,0,0,0,0,0,0,0,0
115861,32000,320,0,-2,1,1,0,0,0,0,0,0,0,0,0,0,1,1,0,0,0,0,0,0,0,0,0,0,0,0,0,0,0,0
116439,32000,320,0,-2,1,1,0,0,0,0,0,0,0,0,0,0,0,0,0,0,0,0,0,0,0,0,0,0,0,0,0,1,1,0
117168,32000,320,0,-2,1,1,0,0,0,0,0,0,0,0,0,0,0,0,0,0,0,0,1,1,0,0,0,0,0,0,0,0,0,0
117195,32000,320,0,-2,2,2,0,0,0,0,0,0,0,0,0,0,0,0,0,0,0,0,2,2,0,0,0,0,0,0,0,0,0,0
117274,32000,320,0,-2,1,1,0,0,0,0,0,0,0,0,0,0,0,0,0,0,0,0,1,1,0,0,0,0,0,0,0,0,0,0
117627,32000,320,0,-2,1,0,1,0,0,0,0,0,0,0,0,0,0,0,0,0,0,0,0,0,0,0,0,0,0,0,0,1,0,1
117636,32000,320,0,-2,4,0,4,0,0,0,0,0,0,2,0,2,1,0,1,0,0,0,1,0,1,0,0,0,0,0,0,0,0,0
117672,32000,320,0,-2,5,4,1,0,0,0,1,1,0,0,0,0,1,1,0,0,0,0,3,2,1,0,0,0,0,0,0,0,0,0
117681,32000,320,0,-2,10,9,1,0,0,0,3,3,0,0,0,0,1,1,0,0,0,0,2,2,0,0,0,0,3,3,0,1,0,1
117706,32000,320,0,-2,1,1,0,0,0,0,0,0,0,0,0,0,0,0,0,0,0,0,1,1,0,0,0,0,0,0,0,0,0,0
117724,32000,320,0,-2,2,1,1,0,0,0,0,0,0,0,0,0,1,0,1,0,0,0,0,0,0,0,0,0,1,1,0,0,0,0
117751,32000,320,0,-2,2,2,0,0,0,0,0,0,0,0,0,0,0,0,0,0,0,0,2,2,0,0,0,0,0,0,0,0,0,0
117788,32000,320,0,-2,1,1,0,0,0,0,1,1,0,0,0,0,0,0,0,0,0,0,0,0,0,0,0,0,0,0,0,0,0,0
117900,32000,320,0,-2,3,3,0,0,0,0,2,2,0,0,0,0,0,0,0,0,0,0,1,1,0,0,0,0,0,0,0,0,0,0
117946,32000,320,0,-2,17,8,9,0,0,0,6,1,5,0,0,0,3,3,0,0,0,0,4,2,2,1,0,1,3,2,1,0,0,0
118684,32000,320,0,-2,1,1,0,0,0,0,0,0,0,0,0,0,1,1,0,0,0,0,0,0,0,0,0,0,0,0,0,0,0,0
118693,32000,320,0,-2,1,1,0,0,0,0,0,0,0,0,0,0,0,0,0,0,0,0,1,1,0,0,0,0,0,0,0,0,0,0
118888,32000,320,0,-2,4,3,1,0,0,0,1,0,1,0,0,0,0,0,0,0,0,0,2,2,0,0,0,0,1,1,0,0,0,0
118912,32000,320,0,-2,1,1,0,0,0,0,0,0,0,1,1,0,0,0,0,0,0,0,0,0,0,0,0,0,0,0,0,0,0,0
118976,32000,320,0,-2,1,1,0,0,0,0,0,0,0,0,0,0,1,1,0,0,0,0,0,0,0,0,0,0,0,0,0,0,0,0
119058,32000,320,0,-2,1,1,0,0,0,0,0,0,0,0,0,0,0,0,0,0,0,0,1,1,0,0,0,0,0,0,0,0,0,0
119067,32000,320,0,-2,2,1,1,0,0,0,1,0,1,0,0,0,0,0,0,0,0,0,0,0,0,1,1,0,0,0,0,0,0,0
119164,32000,320,0,-2,5,4,1,0,0,0,4,3,1,0,0,0,0,0,0,0,0,0,1,1,0,0,0,0,0,0,0,0,0,0
119173,32000,320,0,-2,3,0,3,0,0,0,2,0,2,0,0,0,1,0,1,0,0,0,0,0,0,0,0,0,0,0,0,0,0,0
119216,32000,320,0,-2,5,4,1,0,0,0,0,0,0,0,0,0,2,2,0,0,0,0,3,2,1,0,0,0,0,0,0,0,0,0
119270,32000,320,0,-2,1,0,1,0,0,0,0,0,0,0,0,0,0,0,0,1,0,1,0,0,0,0,0,0,0,0,0,0,0,0
119605,32000,320,0,-2,2,2,0,0,0,0,0,0,0,0,0,0,0,0,0,0,0,0,2,2,0,0,0,0,0,0,0,0,0,0
119678,32000,320,0,-2,11,10,1,0,0,0,2,2,0,3,2,1,2,2,0,0,0,0,3,3,0,1,1,0,0,0,0,0,0,0
120254,32000,320,0,-2,6,3,3,0,0,0,0,0,0,0,0,0,1,0,1,0,0,0,5,3,2,0,0,0,0,0,0,0,0,0
120290,32000,320,0,-2,1,1,0,0,0,0,1,1,0,0,0,0,0,0,0,0,0,0,0,0,0,0,0,0,0,0,0,0,0,0
120403,32000,320,0,-2,2,2,0,0,0,0,0,0,0,1,1,0,1,1,0,0,0,0,0,0,0,0,0,0,0,0,0,0,0,0
120537,32000,320,0,-2,1,1,0,0,0,0,0,0,0,0,0,0,0,0,0,0,0,0,1,1,0,0,0,0,0,0,0,0,0,0
120883,32000,320,0,-2,8,4,4,0,0,0,1,1,0,0,0,0,3,0,3,0,0,0,2,1,1,2,2,0,0,0,0,0,0,0
120953,32000,320,0,-2,3,3,0,0,0,0,0,0,0,0,0,0,1,1,0,0,0,0,2,2,0,0,0,0,0,0,0,0,0,0
121044,32000,320,0,-2,1,1,0,0,0,0,0,0,0,1,1,0,0,0,0,0,0,0,0,0,0,0,0,0,0,0,0,0,0,0
121150,32000,320,0,-2,15,12,3,0,0,0,3,1,2,2,1,1,2,2,0,0,0,0,7,7,0,0,0,0,0,0,0,1,1,0
121257,32000,320,0,-2,3,3,0,0,0,0,0,0,0,0,0,0,3,3,0,0,0,0,0,0,0,0,0,0,0,0,0,0,0,0
121309,32000,320,0,-2,6,2,4,0,0,0,0,0,0,0,0,0,2,1,1,0,0,0,4,1,3,0,0,0,0,0,0,0,0,0
121345,32000,320,0,-2,3,2,1,0,0,0,1,1,0,0,0,0,1,0,1,0,0,0,1,1,0,0,0,0,0,0,0,0,0,0
121691,32000,320,0,-2,4,1,3,0,0,0,0,0,0,0,0,0,1,0,1,0,0,0,2,1,1,0,0,0,1,0,1,0,0,0
122205,32000,320,0,-2,3,3,0,0,0,0,1,1,0,0,0,0,2,2,0,0,0,0,0,0,0,0,0,0,0,0,0,0,0,0
122296,32000,320,0,-2,2,1,1,0,0,0,1,1,0,0,0,0,0,0,0,0,0,0,0,0,0,0,0,0,1,0,1,0,0,0
122409,32000,320,0,-2,20,10,10,0,0,0,3,1,2,2,2,0,3,1,2,0,0,0,8,3,5,1,1,0,3,2,1,0,0,0
122436,32000,320,0,-2,11,9,2,0,0,0,2,2,0,0,0,0,3,3,0,0,0,0,4,3,1,1,1,0,0,0,0,1,0,1
122506,32000,320,0,-2,1,1,0,0,0,0,1,1,0,0,0,0,0,0,0,0,0,0,0,0,0,0,0,0,0,0,0,0,0,0
122597,32000,320,0,-2,9,5,4,0,0,0,2,1,1,0,0,0,0,0,0,0,0,0,7,4,3,0,0,0,0,0,0,0,0,0
122612,32000,320,0,-2,11,6,5,0,0,0,1,1,0,2,2,0,1,1,0,0,0,0,5,1,4,0,0,0,0,0,0,2,1,1
122728,32000,320,0,-2,2,2,0,0,0,0,0,0,0,0,0,0,0,0,0,0,0,0,1,1,0,0,0,0,1,1,0,0,0,0
122755,32000,320,0,-2,16,6,10,0,0,0,7,2,5,1,1,0,1,0,1,0,0,0,5,3,2,0,0,0,1,0,1,1,0,1
122782,32000,320,0,-2,1,1,0,0,0,0,0,0,0,0,0,0,0,0,0,0,0,0,1,1,0,0,0,0,0,0,0,0,0,0
122931,32000,320,0,-2,11,4,7,0,0,0,3,0,3,0,0,0,0,0,0,0,0,0,4,2,2,1,0,1,2,1,1,1,1,0
123013,32000,320,0,-2,1,0,1,0,0,0,0,0,0,0,0,0,0,0,0,0,0,0,1,0,1,0,0,0,0,0,0,0,0,0
123165,32000,320,0,-2,2,2,0,0,0,0,0,0,0,1,1,0,0,0,0,0,0,0,1,1,0,0,0,0,0,0,0,0,0,0
123341,32000,320,0,-2,1,1,0,0,0,0,0,0,0,0,0,0,0,0,0,0,0,0,0,0,0,0,0,0,0,0,0,1,1,0
123457,32000,320,0,-2,2,1,1,0,0,0,0,0,0,0,0,0,0,0,0,0,0,0,2,1,1,0,0,0,0,0,0,0,0,0
123527,32000,320,0,-2,1,1,0,0,0,0,0,0,0,1,1,0,0,0,0,0,0,0,0,0,0,0,0,0,0,0,0,0,0,0
123554,32000,320,0,-2,6,3,3,0,0,0,0,0,0,0,0,0,2,1,1,0,0,0,0,0,0,0,0,0,4,2,2,0,0,0
123572,32000,320,0,-2,5,3,2,0,0,0,0,0,0,0,0,0,0,0,0,0,0,0,2,2,0,0,0,0,3,1,2,0,0,0
123800,32000,320,0,-2,1,0,1,0,0,0,0,0,0,0,0,0,0,0,0,0,0,0,1,0,1,0,0,0,0,0,0,0,0,0
123943,32000,320,0,-2,3,2,1,0,0,0,1,0,1,0,0,0,1,1,0,0,0,0,1,1,0,0,0,0,0,0,0,0,0,0
123952,32000,320,0,-2,1,1,0,0,0,0,0,0,0,0,0,0,1,1,0,0,0,0,0,0,0,0,0,0,0,0,0,0,0,0
123961,32000,320,0,-2,193,111,82,0,0,0,61,40,21,8,5,3,25,15,10,0,0,0,53,25,28,10,3,7,5,3,2,31,20,11
123970,32000,320,0,-2,1,1,0,0,0,0,1,1,0,0,0,0,0,0,0,0,0,0,0,0,0,0,0,0,0,0,0,0,0,0
124113,32000,320,0,-2,1,1,0,0,0,0,1,1,0,0,0,0,0,0,0,0,0,0,0,0,0,0,0,0,0,0,0,0,0,0
124557,32000,320,0,-2,43,20,23,0,0,0,11,3,8,2,1,1,2,1,1,0,0,0,18,10,8,0,0,0,4,2,2,6,3,3
125231,32000,320,0,-2,5,3,2,0,0,0,4,2,2,1,1,0,0,0,0,0,0,0,0,0,0,0,0,0,0,0,0,0,0,0
125727,32000,320,0,-2,3,2,1,0,0,0,1,1,0,0,0,0,1,1,0,0,0,0,1,0,1,0,0,0,0,0,0,0,0,0
125763,32000,320,0,-2,1,1,0,0,0,0,0,0,0,0,0,0,1,1,0,0,0,0,0,0,0,0,0,0,0,0,0,0,0,0
126100,32000,320,0,-2,2,2,0,0,0,0,1,1,0,0,0,0,0,0,0,0,0,0,1,1,0,0,0,0,0,0,0,0,0,0
126182,32000,320,0,-2,2,1,1,0,0,0,0,0,0,1,0,1,0,0,0,0,0,0,1,1,0,0,0,0,0,0,0,0,0,0
126207,32000,320,0,-2,2,2,0,0,0,0,0,0,0,0,0,0,1,1,0,0,0,0,1,1,0,0,0,0,0,0,0,0,0,0
126289,32000,320,0,-2,2,1,1,0,0,0,1,1,0,1,0,1,0,0,0,0,0,0,0,0,0,0,0,0,0,0,0,0,0,0
126562,32000,320,0,-2,421,151,270,3,1,2,30,4,26,10,2,8,52,14,38,1,1,0,242,89,153,3,2,1,75,36,39,5,2,3
126580,32000,320,0,-2,5,3,2,0,0,0,0,0,0,1,1,0,0,0,0,0,0,0,4,2,2,0,0,0,0,0,0,0,0,0
126605,32000,320,0,-2,2,2,0,0,0,0,0,0,0,1,1,0,0,0,0,0,0,0,0,0,0,0,0,0,1,1,0,0,0,0
126614,32000,320,0,-2,113,63,50,1,0,1,6,4,2,2,1,1,8,5,3,0,0,0,77,41,36,3,2,1,8,3,5,8,7,1
126669,32000,320,0,-2,6,5,1,0,0,0,1,1,0,0,0,0,1,1,0,0,0,0,4,3,1,0,0,0,0,0,0,0,0,0
126678,32000,320,0,-2,4,3,1,0,0,0,0,0,0,0,0,0,1,1,0,0,0,0,3,2,1,0,0,0,0,0,0,0,0,0
126711,32000,320,0,-2,3,2,1,0,0,0,0,0,0,0,0,0,0,0,0,0,0,0,3,2,1,0,0,0,0,0,0,0,0,0
126775,32000,320,0,-2,10,10,0,0,0,0,1,1,0,1,1,0,1,1,0,0,0,0,6,6,0,1,1,0,0,0,0,0,0,0
126818,32000,320,0,-2,12,9,3,0,0,0,0,0,0,0,0,0,2,1,1,0,0,0,6,5,1,1,1,0,3,2,1,0,0,0
126863,32000,320,0,-2,1,1,0,0,0,0,0,0,0,0,0,0,0,0,0,0,0,0,1,1,0,0,0,0,0,0,0,0,0,0
126942,32000,320,0,-2,1,1,0,0,0,0,0,0,0,0,0,0,0,0,0,0,0,0,1,1,0,0,0,0,0,0,0,0,0,0
126979,32000,320,0,-2,1,1,0,0,0,0,0,0,0,0,0,0,0,0,0,0,0,0,1,1,0,0,0,0,0,0,0,0,0,0
127060,32000,320,0,-2,20,10,10,0,0,0,2,1,1,0,0,0,2,1,1,0,0,0,12,6,6,4,2,2,0,0,0,0,0,0
127185,32000,320,0,-2,2,1,1,0,0,0,0,0,0,0,0,0,1,1,0,0,0,0,1,0,1,0,0,0,0,0,0,0,0,0
127200,32000,320,0,-2,3,0,3,0,0,0,0,0,0,0,0,0,0,0,0,0,0,0,3,0,3,0,0,0,0,0,0,0,0,0
127273,32000,320,0,-2,1,1,0,0,0,0,1,1,0,0,0,0,0,0,0,0,0,0,0,0,0,0,0,0,0,0,0,0,0,0
127556,32000,320,0,-2,4,2,2,0,0,0,0,0,0,0,0,0,1,1,0,0,0,0,2,1,1,0,0,0,0,0,0,1,0,1
127565,32000,320,0,-2,6,3,3,0,0,0,1,1,0,0,0,0,1,0,1,0,0,0,4,2,2,0,0,0,0,0,0,0,0,0
127653,32000,320,0,-2,2,0,2,0,0,0,0,0,0,0,0,0,0,0,0,0,0,0,1,0,1,0,0,0,1,0,1,0,0,0
127714,32000,320,0,-2,1,1,0,0,0,0,0,0,0,0,0,0,0,0,0,0,0,0,1,1,0,0,0,0,0,0,0,0,0,0
127732,32000,320,0,-2,2,2,0,0,0,0,1,1,0,0,0,0,1,1,0,0,0,0,0,0,0,0,0,0,0,0,0,0,0,0
127741,32000,320,0,-2,11,6,5,0,0,0,0,0,0,0,0,0,4,3,1,0,0,0,6,3,3,1,0,1,0,0,0,0,0,0
127778,32000,320,0,-2,3,2,1,0,0,0,0,0,0,0,0,0,2,1,1,0,0,0,1,1,0,0,0,0,0,0,0,0,0,0
127820,32000,320,0,-2,4,2,2,0,0,0,0,0,0,0,0,0,0,0,0,0,0,0,4,2,2,0,0,0,0,0,0,0,0,0
127884,32000,320,0,-2,1,0,1,0,0,0,0,0,0,0,0,0,1,0,1,0,0,0,0,0,0,0,0,0,0,0,0,0,0,0
127918,32000,320,0,-2,2,0,2,0,0,0,0,0,0,0,0,0,1,0,1,0,0,0,1,0,1,0,0,0,0,0,0,0,0,0
128106,32000,320,0,-2,2,0,2,0,0,0,1,0,1,0,0,0,0,0,0,0,0,0,1,0,1,0,0,0,0,0,0,0,0,0
128188,32000,320,0,-2,1,1,0,0,0,0,0,0,0,0,0,0,0,0,0,0,0,0,1,1,0,0,0,0,0,0,0,0,0,0
128300,32000,320,0,-2,24,19,5,0,0,0,7,4,3,2,2,0,3,3,0,0,0,0,10,9,1,1,0,1,1,1,0,0,0,0
128328,32000,320,0,-2,1,1,0,0,0,0,0,0,0,0,0,0,0,0,0,0,0,0,1,1,0,0,0,0,0,0,0,0,0,0
128391,32000,320,0,-2,1,1,0,0,0,0,0,0,0,0,0,0,0,0,0,0,0,0,1,1,0,0,0,0,0,0,0,0,0,0
128498,32000,320,0,-2,2,2,0,0,0,0,0,0,0,0,0,0,0,0,0,0,0,0,2,2,0,0,0,0,0,0,0,0,0,0
128744,32000,320,0,-2,10,6,4,0,0,0,3,3,0,1,0,1,1,1,0,0,0,0,2,1,1,1,0,1,2,1,1,0,0,0
129020,32000,320,0,-2,31,19,12,0,0,0,1,1,0,1,0,1,4,4,0,0,0,0,23,12,11,0,0,0,2,2,0,0,0,0
129154,32000,320,0,-2,4,4,0,0,0,0,0,0,0,1,1,0,0,0,0,0,0,0,3,3,0,0,0,0,0,0,0,0,0,0
129242,32000,320,0,-2,6,3,3,0,0,0,1,0,1,2,2,0,0,0,0,0,0,0,2,1,1,1,0,1,0,0,0,0,0,0
130110,32000,320,0,-2,1,1,0,0,0,0,0,0,0,0,0,0,0,0,0,0,0,0,1,1,0,0,0,0,0,0,0,0,0,0
130183,32000,320,0,-2,6,3,3,0,0,0,0,0,0,2,1,1,0,0,0,0,0,0,4,2,2,0,0,0,0,0,0,0,0,0
130226,32000,320,0,-2,4,3,1,0,0,0,0,0,0,0,0,0,2,2,0,0,0,0,2,1,1,0,0,0,0,0,0,0,0,0
130253,32000,320,0,-2,7,6,1,0,0,0,1,1,0,1,0,1,0,0,0,0,0,0,0,0,0,0,0,0,5,5,0,0,0,0
130314,32000,320,0,-2,1,1,0,0,0,0,1,1,0,0,0,0,0,0,0,0,0,0,0,0,0,0,0,0,0,0,0,0,0,0
130493,32000,320,0,-2,2,1,1,0,0,0,0,0,0,0,0,0,0,0,0,0,0,0,2,1,1,0,0,0,0,0,0,0,0,0
130624,32000,320,0,-2,32,29,3,1,1,0,0,0,0,0,0,0,2,2,0,0,0,0,14,13,1,1,1,0,14,12,2,0,0,0
130697,32000,320,0,-2,4,2,2,0,0,0,1,0,1,0,0,0,0,0,0,0,0,0,2,1,1,0,0,0,0,0,0,1,1,0
130794,32000,320,0,-2,101,38,63,0,0,0,17,5,12,13,6,7,10,5,5,0,0,0,50,16,34,2,2,0,4,2,2,5,2,3
130907,32000,320,0,-2,3,3,0,0,0,0,0,0,0,0,0,0,0,0,0,0,0,0,3,3,0,0,0,0,0,0,0,0,0,0
130934,32000,320,0,-2,9,8,1,0,0,0,1,0,1,3,3,0,0,0,0,0,0,0,5,5,0,0,0,0,0,0,0,0,0,0
130943,32000,320,0,-2,157,81,76,0,0,0,17,8,9,5,2,3,4,1,3,0,0,0,70,31,39,3,2,1,0,0,0,58,37,21
130989,32000,320,0,-2,1,1,0,0,0,0,0,0,0,0,0,0,0,0,0,0,0,0,1,1,0,0,0,0,0,0,0,0,0,0
131113,32000,320,0,-2,7,2,5,0,0,0,0,0,0,1,0,1,1,1,0,0,0,0,5,1,4,0,0,0,0,0,0,0,0,0
131159,32000,320,0,-2,21,9,12,0,0,0,1,1,0,5,3,2,0,0,0,0,0,0,9,3,6,0,0,0,4,2,2,2,0,2
131283,32000,320,0,-2,7,4,3,0,0,0,0,0,0,2,2,0,0,0,0,0,0,0,3,2,1,0,0,0,0,0,0,2,0,2
131399,32000,320,0,-2,1,1,0,0,0,0,1,1,0,0,0,0,0,0,0,0,0,0,0,0,0,0,0,0,0,0,0,0,0,0
131405,32000,320,0,-2,1,1,0,0,0,0,0,0,0,0,0,0,1,1,0,0,0,0,0,0,0,0,0,0,0,0,0,0,0,0
131450,32000,320,0,-2,8,6,2,0,0,0,5,3,2,1,1,0,0,0,0,0,0,0,2,2,0,0,0,0,0,0,0,0,0,0
131469,32000,320,0,-2,159,70,89,0,0,0,22,8,14,29,12,17,17,9,8,0,0,0,79,34,45,7,3,4,5,4,1,0,0,0
131496,32000,320,0,-2,20,10,10,0,0,0,6,2,4,4,2,2,1,0,1,0,0,0,6,3,3,1,1,0,1,1,0,1,1,0
131520,32000,320,0,-2,15,7,8,0,0,0,1,1,0,7,3,4,0,0,0,0,0,0,0,0,0,0,0,0,7,3,4,0,0,0
131876,32000,320,0,-2,2,1,1,0,0,0,0,0,0,2,1,1,0,0,0,0,0,0,0,0,0,0,0,0,0,0,0,0,0,0
132471,32000,320,0,-2,2,1,1,0,0,0,1,0,1,1,1,0,0,0,0,0,0,0,0,0,0,0,0,0,0,0,0,0,0,0
132602,32000,320,0,-2,2,2,0,0,0,0,0,0,0,1,1,0,0,0,0,0,0,0,1,1,0,0,0,0,0,0,0,0,0,0
132657,32000,320,0,-2,2,2,0,0,0,0,0,0,0,0,0,0,1,1,0,0,0,0,0,0,0,1,1,0,0,0,0,0,0,0
132709,32000,320,0,-2,1,1,0,0,0,0,0,0,0,0,0,0,0,0,0,0,0,0,1,1,0,0,0,0,0,0,0,0,0,0
132851,32000,320,0,-2,5,2,3,0,0,0,0,0,0,0,0,0,0,0,0,0,0,0,5,2,3,0,0,0,0,0,0,0,0,0
132903,32000,320,0,-2,3,3,0,0,0,0,0,0,0,0,0,0,0,0,0,0,0,0,2,2,0,0,0,0,0,0,0,1,1,0
133021,32000,320,0,-2,1,1,0,0,0,0,0,0,0,0,0,0,0,0,0,0,0,0,1,1,0,0,0,0,0,0,0,0,0,0
133386,32000,320,0,-2,6,4,2,0,0,0,0,0,0,1,0,1,0,0,0,0,0,0,5,4,1,0,0,0,0,0,0,0,0,0
133492,32000,320,0,-2,9,7,2,0,0,0,0,0,0,0,0,0,0,0,0,0,0,0,8,7,1,0,0,0,1,0,1,0,0,0
133508,32000,320,0,-2,9,8,1,0,0,0,0,0,0,2,2,0,0,0,0,0,0,0,7,6,1,0,0,0,0,0,0,0,0,0
133553,32000,320,0,-2,24,17,7,0,0,0,4,2,2,0,0,0,2,2,0,0,0,0,17,13,4,1,0,1,0,0,0,0,0,0
133650,32000,320,0,-2,2,1,1,0,0,0,0,0,0,0,0,0,0,0,0,0,0,0,0,0,0,0,0,0,0,0,0,2,1,1
133669,32000,320,0,-2,12,8,4,0,0,0,0,0,0,1,1,0,1,1,0,0,0,0,6,3,3,0,0,0,0,0,0,4,3,1
133702,32000,320,0,-2,2,2,0,0,0,0,0,0,0,0,0,0,1,1,0,0,0,0,1,1,0,0,0,0,0,0,0,0,0,0
133711,32000,320,0,-2,1,0,1,0,0,0,0,0,0,0,0,0,0,0,0,0,0,0,1,0,1,0,0,0,0,0,0,0,0,0
133809,32000,320,0,-2,1,0,1,0,0,0,0,0,0,0,0,0,0,0,0,0,0,0,1,0,1,0,0,0,0,0,0,0,0,0
133872,32000,320,0,-2,2,1,1,0,0,0,0,0,0,1,1,0,0,0,0,0,0,0,1,0,1,0,0,0,0,0,0,0,0,0
133881,32000,320,0,-2,8,5,3,0,0,0,0,0,0,0,0,0,0,0,0,0,0,0,7,4,3,0,0,0,0,0,0,1,1,0
133979,32000,320,0,-2,4,4,0,0,0,0,0,0,0,2,2,0,2,2,0,0,0,0,0,0,0,0,0,0,0,0,0,0,0,0
134097,32000,320,0,-2,25,14,11,0,0,0,1,1,0,1,0,1,0,0,0,0,0,0,18,10,8,2,1,1,2,1,1,1,1,0
134130,32000,320,0,-2,142,73,69,0,0,0,17,4,13,8,5,3,20,10,10,0,0,0,85,48,37,0,0,0,4,3,1,8,3,5
134237,32000,320,0,-2,20,17,3,0,0,0,7,5,2,3,3,0,2,2,0,0,0,0,8,7,1,0,0,0,0,0,0,0,0,0
134343,32000,320,0,-2,3,3,0,0,0,0,0,0,0,0,0,0,0,0,0,0,0,0,2,2,0,0,0,0,0,0,0,1,1,0
134495,32000,320,0,-2,1,1,0,0,0,0,0,0,0,0,0,0,0,0,0,0,0,0,1,1,0,0,0,0,0,0,0,0,0,0
134608,32000,320,0,-2,5,2,3,0,0,0,0,0,0,1,0,1,1,1,0,0,0,0,3,1,2,0,0,0,0,0,0,0,0,0
134945,32000,320,0,-2,2,1,1,0,0,0,1,1,0,0,0,0,0,0,0,0,0,0,1,0,1,0,0,0,0,0,0,0,0,0
135081,32000,320,0,-2,3,3,0,0,0,0,1,1,0,1,1,0,0,0,0,0,0,0,1,1,0,0,0,0,0,0,0,0,0,0
135160,32000,320,0,-2,1,1,0,0,0,0,0,0,0,0,0,0,0,0,0,0,0,0,1,1,0,0,0,0,0,0,0,0,0,0
135188,32000,320,0,-2,11,7,4,0,0,0,1,1,0,3,1,2,0,0,0,0,0,0,7,5,2,0,0,0,0,0,0,0,0,0
135717,32000,320,0,-2,8,8,0,0,0,0,2,2,0,0,0,0,5,5,0,0,0,0,1,1,0,0,0,0,0,0,0,0,0,0
135726,32000,320,0,-2,332,138,194,0,0,0,16,5,11,20,7,13,118,57,61,0,0,0,82,37,45,10,0,10,10,4,6,76,28,48
136172,32000,320,0,-2,15,8,7,0,0,0,1,0,1,2,2,0,1,1,0,0,0,0,11,5,6,0,0,0,0,0,0,0,0,0
136215,32000,320,0,-2,62,25,37,0,0,0,6,4,2,11,4,7,18,6,12,0,0,0,18,5,13,1,1,0,1,1,0,7,4,3
136233,32000,320,0,-2,4,4,0,0,0,0,0,0,0,0,0,0,0,0,0,0,0,0,3,3,0,1,1,0,0,0,0,0,0,0
136330,32000,320,0,-2,1,1,0,0,0,0,0,0,0,0,0,0,0,0,0,0,0,0,1,1,0,0,0,0,0,0,0,0,0,0
136358,32000,320,0,-2,9,4,5,0,0,0,0,0,0,2,0,2,0,0,0,0,0,0,6,4,2,0,0,0,0,0,0,1,0,1
136400,32000,320,0,-2,2,0,2,0,0,0,0,0,0,0,0,0,0,0,0,0,0,0,1,0,1,0,0,0,1,0,1,0,0,0
136473,32000,320,0,-2,7,4,3,0,0,0,0,0,0,0,0,0,0,0,0,0,0,0,7,4,3,0,0,0,0,0,0,0,0,0
136516,32000,320,0,-2,2,2,0,0,0,0,0,0,0,0,0,0,0,0,0,0,0,0,2,2,0,0,0,0,0,0,0,0,0,0
136774,32000,320,0,-2,2,0,2,0,0,0,0,0,0,0,0,0,0,0,0,0,0,0,2,0,2,0,0,0,0,0,0,0,0,0
136950,32000,320,0,-2,7,5,2,0,0,0,2,1,1,2,2,0,1,1,0,0,0,0,2,1,1,0,0,0,0,0,0,0,0,0
137032,32000,320,0,-2,2,1,1,0,0,0,0,0,0,0,0,0,1,1,0,0,0,0,0,0,0,0,0,0,1,0,1,0,0,0
137078,32000,320,0,-2,8,4,4,0,0,0,1,0,1,0,0,0,0,0,0,0,0,0,6,4,2,0,0,0,1,0,1,0,0,0
137096,32000,320,0,-2,1,1,0,0,0,0,0,0,0,0,0,0,0,0,0,0,0,0,0,0,0,0,0,0,1,1,0,0,0,0
137281,32000,320,0,-2,4,1,3,0,0,0,0,0,0,0,0,0,2,0,2,0,0,0,1,1,0,1,0,1,0,0,0,0,0,0
137315,32000,320,0,-2,1,1,0,0,0,0,0,0,0,0,0,0,0,0,0,0,0,0,1,1,0,0,0,0,0,0,0,0,0,0
137351,32000,320,0,-2,88,44,44,0,0,0,8,4,4,10,6,4,7,2,5,0,0,0,39,25,14,12,4,8,1,0,1,11,3,8
137476,32000,320,0,-2,1,0,1,0,0,0,0,0,0,1,0,1,0,0,0,0,0,0,0,0,0,0,0,0,0,0,0,0,0,0
137546,32000,320,0,-2,9,8,1,0,0,0,0,0,0,1,0,1,0,0,0,0,0,0,8,8,0,0,0,0,0,0,0,0,0,0
137564,32000,320,0,-2,2,1,1,0,0,0,1,0,1,0,0,0,0,0,0,0,0,0,1,1,0,0,0,0,0,0,0,0,0,0
137759,32000,320,0,-2,6,3,3,0,0,0,0,0,0,0,0,0,0,0,0,0,0,0,6,3,3,0,0,0,0,0,0,0,0,0
137847,32000,320,0,-2,15,11,4,0,0,0,0,0,0,2,2,0,4,3,1,0,0,0,7,4,3,1,1,0,1,1,0,0,0,0
138187,32000,320,0,-2,4,2,2,0,0,0,0,0,0,2,2,0,0,0,0,0,0,0,2,0,2,0,0,0,0,0,0,0,0,0
138275,32000,320,0,-2,1,1,0,0,0,0,0,0,0,0,0,0,0,0,0,0,0,0,1,1,0,0,0,0,0,0,0,0,0,0
138354,32000,320,0,-2,2,1,1,0,0,0,1,0,1,0,0,0,0,0,0,0,0,0,1,1,0,0,0,0,0,0,0,0,0,0
138558,32000,320,0,-2,4,4,0,0,0,0,0,0,0,2,2,0,0,0,0,0,0,0,2,2,0,0,0,0,0,0,0,0,0,0
138600,32000,320,0,-2,4,0,4,0,0,0,0,0,0,1,0,1,0,0,0,0,0,0,1,0,1,1,0,1,1,0,1,0,0,0
138682,32000,320,0,-2,1,1,0,0,0,0,0,0,0,1,1,0,0,0,0,0,0,0,0,0,0,0,0,0,0,0,0,0,0,0
138716,32000,320,0,-2,4,1,3,0,0,0,0,0,0,1,0,1,0,0,0,0,0,0,2,1,1,0,0,0,1,0,1,0,0,0
138840,32000,320,0,-2,3,3,0,0,0,0,0,0,0,3,3,0,0,0,0,0,0,0,0,0,0,0,0,0,0,0,0,0,0,0
138956,32000,320,0,-2,1,1,0,0,0,0,0,0,0,0,0,0,0,0,0,0,0,0,1,1,0,0,0,0,0,0,0,0,0,0
139144,32000,320,0,-2,3,3,0,0,0,0,0,0,0,0,0,0,0,0,0,0,0,0,3,3,0,0,0,0,0,0,0,0,0,0
139250,32000,320,0,-2,1,1,0,0,0,0,0,0,0,0,0,0,0,0,0,0,0,0,1,1,0,0,0,0,0,0,0,0,0,0
139278,32000,320,0,-2,2,1,1,0,0,0,0,0,0,1,1,0,0,0,0,0,0,0,1,0,1,0,0,0,0,0,0,0,0,0
139311,32000,320,0,-2,2,1,1,0,0,0,0,0,0,0,0,0,1,0,1,0,0,0,1,1,0,0,0,0,0,0,0,0,0,0
139366,32000,320,0,-2,4,4,0,0,0,0,1,1,0,0,0,0,0,0,0,0,0,0,3,3,0,0,0,0,0,0,0,0,0,0
139384,32000,320,0,-2,1,1,0,0,0,0,0,0,0,0,0,0,0,0,0,0,0,0,1,1,0,0,0,0,0,0,0,0,0,0
139630,32000,320,0,-2,1,1,0,0,0,0,0,0,0,0,0,0,0,0,0,0,0,0,1,1,0,0,0,0,0,0,0,0,0,0
139658,32000,320,0,-2,485,161,324,0,0,0,84,33,51,136,32,104,30,11,19,1,0,1,177,57,120,7,2,5,0,0,0,50,26,24
139719,32000,320,0,-2,4,1,3,0,0,0,1,1,0,0,0,0,0,0,0,0,0,0,2,0,2,0,0,0,1,0,1,0,0,0
139755,32000,320,0,-2,51,19,32,0,0,0,8,0,8,12,5,7,6,3,3,0,0,0,20,10,10,3,1,2,0,0,0,2,0,2
139861,32000,320,0,-2,2,1,1,0,0,0,0,0,0,1,1,0,0,0,0,0,0,0,0,0,0,0,0,0,1,0,1,0,0,0
139931,32000,320,0,-2,4,2,2,0,0,0,0,0,0,2,2,0,0,0,0,0,0,0,2,0,2,0,0,0,0,0,0,0,0,0
139940,32000,320,0,-2,36,20,16,0,0,0,6,3,3,9,6,3,1,1,0,0,0,0,18,9,9,1,1,0,0,0,0,1,0,1
139959,32000,320,0,-2,169,85,84,0,0,0,17,7,10,8,2,6,8,5,3,0,0,0,72,37,35,4,2,2,6,1,5,54,31,23
139986,32000,320,0,-2,1,0,1,0,0,0,0,0,0,0,0,0,0,0,0,0,0,0,1,0,1,0,0,0,0,0,0,0,0,0
140012,32000,320,0,-2,5,3,2,0,0,0,0,0,0,4,2,2,0,0,0,0,0,0,1,1,0,0,0,0,0,0,0,0,0,0
140243,32000,320,0,-2,2,2,0,0,0,0,0,0,0,0,0,0,0,0,0,0,0,0,2,2,0,0,0,0,0,0,0,0,0,0
140331,32000,320,0,-2,2,2,0,0,0,0,0,0,0,0,0,0,0,0,0,0,0,0,2,2,0,0,0,0,0,0,0,0,0,0
140447,32000,320,0,-2,38,29,9,0,0,0,1,1,0,3,2,1,1,1,0,0,0,0,30,22,8,1,1,0,0,0,0,2,2,0
140553,32000,320,0,-2,8,4,4,0,0,0,1,0,1,6,3,3,0,0,0,0,0,0,1,1,0,0,0,0,0,0,0,0,0,0
140562,32000,320,0,-2,32,13,19,0,0,0,0,0,0,21,7,14,3,2,1,0,0,0,8,4,4,0,0,0,0,0,0,0,0,0
140696,32000,320,0,-2,2,1,1,0,0,0,0,0,0,1,0,1,1,1,0,0,0,0,0,0,0,0,0,0,0,0,0,0,0,0
140818,32000,320,0,-2,1,0,1,0,0,0,0,0,0,0,0,0,0,0,0,0,0,0,1,0,1,0,0,0,0,0,0,0,0,0
140951,32000,320,0,-2,3,2,1,0,0,0,0,0,0,0,0,0,0,0,0,0,0,0,3,2,1,0,0,0,0,0,0,0,0,0
140960,32000,320,0,-2,1,0,1,0,0,0,0,0,0,0,0,0,0,0,0,0,0,0,1,0,1,0,0,0,0,0,0,0,0,0
141185,32000,320,0,-2,1,1,0,0,0,0,0,0,0,0,0,0,0,0,0,0,0,0,1,1,0,0,0,0,0,0,0,0,0,0
141255,32000,320,0,-2,1,1,0,0,0,0,0,0,0,0,0,0,0,0,0,0,0,0,1,1,0,0,0,0,0,0,0,0,0,0
141264,32000,320,0,-2,4,2,2,0,0,0,0,0,0,1,1,0,0,0,0,0,0,0,3,1,2,0,0,0,0,0,0,0,0,0
141334,32000,320,0,-2,4,4,0,0,0,0,0,0,0,0,0,0,0,0,0,0,0,0,4,4,0,0,0,0,0,0,0,0,0,0
141486,32000,320,0,-2,1,1,0,0,0,0,0,0,0,0,0,0,0,0,0,0,0,0,0,0,0,1,1,0,0,0,0,0,0,0
141574,32000,320,0,-2,5,4,1,0,0,0,3,2,1,0,0,0,0,0,0,0,0,0,2,2,0,0,0,0,0,0,0,0,0,0
141644,32000,320,0,-2,9,5,4,1,1,0,2,2,0,1,0,1,1,1,0,0,0,0,3,1,2,1,0,1,0,0,0,0,0,0
141963,32000,320,0,-2,3,2,1,0,0,0,1,1,0,0,0,0,0,0,0,0,0,0,2,1,1,0,0,0,0,0,0,0,0,0
141981,32000,320,0,-2,2,1,1,0,0,0,2,1,1,0,0,0,0,0,0,0,0,0,0,0,0,0,0,0,0,0,0,0,0,0
142115,32000,320,0,-2,33,19,14,0,0,0,0,0,0,0,0,0,3,1,2,0,0,0,29,17,12,1,1,0,0,0,0,0,0,0
142179,32000,320,0,-2,3,3,0,0,0,0,0,0,0,0,0,0,0,0,0,0,0,0,1,1,0,0,0,0,2,2,0,0,0,0
142276,32000,320,0,-2,7,2,5,0,0,0,2,0,2,0,0,0,0,0,0,0,0,0,2,1,1,0,0,0,3,1,2,0,0,0
142285,32000,320,0,-2,14,10,4,0,0,0,0,0,0,0,0,0,0,0,0,0,0,0,14,10,4,0,0,0,0,0,0,0,0,0
142294,32000,320,0,-2,1,0,1,0,0,0,0,0,0,0,0,0,0,0,0,0,0,0,1,0,1,0,0,0,0,0,0,0,0,0
142328,32000,320,0,-2,1,1,0,0,0,0,0,0,0,0,0,0,0,0,0,0,0,0,1,1,0,0,0,0,0,0,0,0,0,0
142443,32000,320,0,-2,2,2,0,0,0,0,0,0,0,0,0,0,0,0,0,0,0,0,2,2,0,0,0,0,0,0,0,0,0,0
142461,32000,320,0,-2,1,1,0,0,0,0,0,0,0,0,0,0,0,0,0,0,0,0,1,1,0,0,0,0,0,0,0,0,0,0
142522,32000,320,0,-2,4,4,0,0,0,0,0,0,0,0,0,0,1,1,0,0,0,0,2,2,0,0,0,0,1,1,0,0,0,0
142832,32000,320,0,-2,4,3,1,0,0,0,1,1,0,1,0,1,0,0,0,0,0,0,1,1,0,0,0,0,1,1,0,0,0,0
143048,32000,320,0,-2,6,2,4,0,0,0,2,1,1,0,0,0,2,1,1,0,0,0,1,0,1,1,0,1,0,0,0,0,0,0
143084,32000,320,0,-2,1,1,0,0,0,0,0,0,0,0,0,0,0,0,0,0,0,0,1,1,0,0,0,0,0,0,0,0,0,0
143118,32000,320,0,-2,2,2,0,0,0,0,0,0,0,0,0,0,1,1,0,0,0,0,0,0,0,0,0,0,1,1,0,0,0,0
143215,32000,320,0,-2,5,4,1,0,0,0,0,0,0,0,0,0,0,0,0,0,0,0,5,4,1,0,0,0,0,0,0,0,0,0
143233,32000,320,0,-2,1,1,0,0,0,0,0,0,0,0,0,0,0,0,0,0,0,0,1,1,0,0,0,0,0,0,0,0,0,0
143279,32000,320,0,-2,2,0,2,0,0,0,0,0,0,0,0,0,0,0,0,0,0,0,1,0,1,0,0,0,1,0,1,0,0,0
143358,32000,320,0,-2,3,3,0,0,0,0,0,0,0,0,0,0,0,0,0,0,0,0,3,3,0,0,0,0,0,0,0,0,0,0
144005,32000,320,0,-2,1,1,0,0,0,0,0,0,0,0,0,0,0,0,0,0,0,0,0,0,0,0,0,0,0,0,0,1,1,0
144014,32000,320,0,-2,1,1,0,0,0,0,0,0,0,1,1,0,0,0,0,0,0,0,0,0,0,0,0,0,0,0,0,0,0,0
144050,32000,320,0,-2,119,61,58,0,0,0,16,7,9,13,5,8,15,7,8,0,0,0,55,26,29,5,4,1,5,4,1,10,8,2
144157,32000,320,0,-2,1,1,0,0,0,0,0,0,0,1,1,0,0,0,0,0,0,0,0,0,0,0,0,0,0,0,0,0,0,0
144166,32000,320,0,-2,2,0,2,0,0,0,0,0,0,1,0,1,0,0,0,0,0,0,1,0,1,0,0,0,0,0,0,0,0,0
144175,32000,320,0,-2,1,1,0,0,0,0,0,0,0,1,1,0,0,0,0,0,0,0,0,0,0,0,0,0,0,0,0,0,0,0
144193,32000,320,0,-2,1,0,1,0,0,0,0,0,0,0,0,0,0,0,0,0,0,0,1,0,1,0,0,0,0,0,0,0,0,0
144209,32000,320,0,-2,1,0,1,0,0,0,0,0,0,1,0,1,0,0,0,0,0,0,0,0,0,0,0,0,0,0,0,0,0,0
144281,32000,320,0,-2,5,5,0,0,0,0,0,0,0,1,1,0,0,0,0,0,0,0,3,3,0,0,0,0,1,1,0,0,0,0
144500,32000,320,0,-2,8,2,6,0,0,0,0,0,0,3,1,2,1,0,1,0,0,0,3,0,3,1,1,0,0,0,0,0,0,0
144564,32000,320,0,-2,1,1,0,0,0,0,0,0,0,0,0,0,0,0,0,0,0,0,1,1,0,0,0,0,0,0,0,0,0,0
144740,32000,320,0,-2,6,2,4,0,0,0,1,0,1,1,0,1,2,1,1,0,0,0,1,0,1,0,0,0,0,0,0,1,1,0
144777,32000,320,0,-2,7,7,0,0,0,0,0,0,0,2,2,0,0,0,0,0,0,0,5,5,0,0,0,0,0,0,0,0,0,0
144865,32000,320,0,-2,2,1,1,0,0,0,0,0,0,0,0,0,0,0,0,0,0,0,2,1,1,0,0,0,0,0,0,0,0,0
144892,32000,320,0,-2,3,1,2,0,0,0,0,0,0,0,0,0,0,0,0,0,0,0,2,1,1,0,0,0,0,0,0,1,0,1
144944,32000,320,0,-2,6,2,4,0,0,0,2,1,1,0,0,0,0,0,0,0,0,0,4,1,3,0,0,0,0,0,0,0,0,0
144962,32000,320,0,-2,3,2,1,0,0,0,0,0,0,0,0,0,0,0,0,0,0,0,3,2,1,0,0,0,0,0,0,0,0,0
144971,32000,320,0,-2,1,1,0,0,0,0,0,0,0,0,0,0,0,0,0,0,0,0,0,0,0,1,1,0,0,0,0,0,0,0
145336,32000,320,0,-2,2,1,1,0,0,0,1,1,0,1,0,1,0,0,0,0,0,0,0,0,0,0,0,0,0,0,0,0,0,0
145558,32000,320,0,-2,17,7,10,0,0,0,6,1,5,0,0,0,2,1,1,0,0,0,9,5,4,0,0,0,0,0,0,0,0,0
145600,32000,320,0,-2,153,55,98,1,0,1,19,10,9,17,5,12,36,14,22,0,0,0,63,21,42,6,2,4,2,1,1,9,2,7
145628,32000,320,0,-2,1,1,0,0,0,0,0,0,0,0,0,0,1,1,0,0,0,0,0,0,0,0,0,0,0,0,0,0,0,0
145637,32000,320,0,-2,141,76,65,0,0,0,11,4,7,4,2,2,4,2,2,0,0,0,104,59,45,4,2,2,0,0,0,14,7,7
145646,32000,320,0,-2,2,2,0,0,0,0,0,0,0,0,0,0,1,1,0,0,0,0,1,1,0,0,0,0,0,0,0,0,0,0
145682,32000,320,0,-2,5,5,0,0,0,0,0,0,0,0,0,0,0,0,0,0,0,0,5,5,0,0,0,0,0,0,0,0,0,0
145691,32000,320,0,-2,1,0,1,0,0,0,0,0,0,0,0,0,0,0,0,0,0,0,1,0,1,0,0,0,0,0,0,0,0,0
145725,32000,320,0,-2,10,5,5,0,0,0,2,1,1,0,0,0,0,0,0,0,0,0,2,1,1,0,0,0,5,2,3,1,1,0
145813,32000,320,0,-2,8,3,5,0,0,0,0,0,0,0,0,0,0,0,0,0,0,0,3,2,1,0,0,0,3,1,2,2,0,2
146278,32000,320,0,-2,1,1,0,0,0,0,0,0,0,0,0,0,0,0,0,0,0,0,1,1,0,0,0,0,0,0,0,0,0,0
146296,32000,320,0,-2,2,1,1,0,0,0,0,0,0,0,0,0,0,0,0,0,0,0,2,1,1,0,0,0,0,0,0,0,0,0
146339,32000,320,0,-2,2,2,0,0,0,0,0,0,0,0,0,0,0,0,0,0,0,0,2,2,0,0,0,0,0,0,0,0,0,0
146366,32000,320,0,-2,1,0,1,0,0,0,0,0,0,0,0,0,0,0,0,0,0,0,1,0,1,0,0,0,0,0,0,0,0,0
146427,32000,320,0,-2,2,1,1,0,0,0,0,0,0,0,0,0,0,0,0,0,0,0,1,0,1,0,0,0,1,1,0,0,0,0
146472,32000,320,0,-2,6,5,1,0,0,0,0,0,0,0,0,0,2,2,0,0,0,0,4,3,1,0,0,0,0,0,0,0,0,0
146506,32000,320,0,-2,5,4,1,0,0,0,0,0,0,0,0,0,0,0,0,0,0,0,4,3,1,0,0,0,1,1,0,0,0,0
146603,32000,320,0,-2,4,1,3,0,0,0,0,0,0,0,0,0,0,0,0,0,0,0,2,0,2,0,0,0,2,1,1,0,0,0
146676,32000,320,0,-2,1,1,0,0,0,0,0,0,0,0,0,0,0,0,0,0,0,0,1,1,0,0,0,0,0,0,0,0,0,0
146685,32000,320,0,-2,4,4,0,0,0,0,1,1,0,0,0,0,0,0,0,0,0,0,3,3,0,0,0,0,0,0,0,0,0,0
146719,32000,320,0,-2,42,19,23,0,0,0,3,1,2,4,2,2,5,1,4,0,0,0,27,13,14,0,0,0,1,1,0,2,1,1
146728,32000,320,0,-2,1,0,1,0,0,0,0,0,0,0,0,0,1,0,1,0,0,0,0,0,0,0,0,0,0,0,0,0,0,0
147004,32000,320,0,-2,2,2,0,0,0,0,0,0,0,0,0,0,1,1,0,0,0,0,1,1,0,0,0,0,0,0,0,0,0,0
147013,32000,320,0,-2,4,2,2,0,0,0,0,0,0,0,0,0,0,0,0,0,0,0,4,2,2,0,0,0,0,0,0,0,0,0
147244,32000,320,0,-2,4,2,2,0,0,0,0,0,0,0,0,0,1,1,0,0,0,0,3,1,2,0,0,0,0,0,0,0,0,0
147341,32000,320,0,-2,2,1,1,0,0,0,0,0,0,0,0,0,0,0,0,0,0,0,2,1,1,0,0,0,0,0,0,0,0,0
147369,32000,320,0,-2,3,2,1,0,0,0,1,1,0,0,0,0,1,1,0,0,0,0,1,0,1,0,0,0,0,0,0,0,0,0
147536,32000,320,0,-2,7,5,2,0,0,0,0,0,0,1,0,1,0,0,0,0,0,0,3,2,1,0,0,0,0,0,0,3,3,0
147703,32000,320,0,-2,7,3,4,0,0,0,2,1,1,2,0,2,1,1,0,0,0,0,0,0,0,0,0,0,0,0,0,2,1,1
147767,32000,320,0,-2,405,161,244,0,0,0,68,26,42,38,8,30,42,17,25,0,0,0,162,68,94,12,4,8,6,1,5,77,37,40
147776,32000,320,0,-2,1,1,0,0,0,0,1,1,0,0,0,0,0,0,0,0,0,0,0,0,0,0,0,0,0,0,0,0,0,0
147800,32000,320,0,-2,1,0,1,0,0,0,0,0,0,0,0,0,0,0,0,0,0,0,1,0,1,0,0,0,0,0,0,0,0,0
147828,32000,320,0,-2,5,3,2,0,0,0,1,0,1,0,0,0,0,0,0,0,0,0,4,3,1,0,0,0,0,0,0,0,0,0
147916,32000,320,0,-2,4,4,0,0,0,0,0,0,0,0,0,0,0,0,0,0,0,0,2,2,0,0,0,0,2,2,0,0,0,0
148007,32000,320,0,-2,1,0,1,0,0,0,0,0,0,0,0,0,0,0,0,0,0,0,1,0,1,0,0,0,0,0,0,0,0,0
148256,32000,320,0,-2,1,0,1,0,0,0,0,0,0,0,0,0,0,0,0,0,0,0,1,0,1,0,0,0,0,0,0,0,0,0
148292,32000,320,0,-2,1,1,0,0,0,0,0,0,0,0,0,0,0,0,0,0,0,0,1,1,0,0,0,0,0,0,0,0,0,0
148380,32000,320,0,-2,2,1,1,0,0,0,0,0,0,0,0,0,1,1,0,0,0,0,1,0,1,0,0,0,0,0,0,0,0,0
148487,32000,320,0,-2,2,2,0,0,0,0,0,0,0,0,0,0,0,0,0,0,0,0,0,0,0,0,0,0,2,2,0,0,0,0
148496,32000,320,0,-2,3,3,0,0,0,0,1,1,0,0,0,0,1,1,0,0,0,0,1,1,0,0,0,0,0,0,0,0,0,0
148511,32000,320,0,-2,17,9,8,0,0,0,8,3,5,0,0,0,1,1,0,0,0,0,6,3,3,1,1,0,1,1,0,0,0,0
148654,32000,320,0,-2,4,2,2,0,0,0,0,0,0,0,0,0,0,0,0,0,0,0,4,2,2,0,0,0,0,0,0,0,0,0
148672,32000,320,0,-2,2,2,0,0,0,0,0,0,0,0,0,0,1,1,0,0,0,0,1,1,0,0,0,0,0,0,0,0,0,0
148821,32000,320,0,-2,1,0,1,0,0,0,0,0,0,0,0,0,0,0,0,0,0,0,1,0,1,0,0,0,0,0,0,0,0,0
148937,32000,320,0,-2,1,1,0,0,0,0,0,0,0,0,0,0,0,0,0,0,0,0,1,1,0,0,0,0,0,0,0,0,0,0
149222,32000,320,0,-2,10,8,2,0,0,0,0,0,0,2,1,1,0,0,0,0,0,0,8,7,1,0,0,0,0,0,0,0,0,0
149231,32000,320,0,-2,8,6,2,0,0,0,0,0,0,3,2,1,0,0,0,0,0,0,5,4,1,0,0,0,0,0,0,0,0,0
149365,32000,320,0,-2,2,2,0,0,0,0,0,0,0,0,0,0,0,0,0,0,0,0,2,2,0,0,0,0,0,0,0,0,0,0
149505,32000,320,0,-2,1,1,0,0,0,0,0,0,0,0,0,0,1,1,0,0,0,0,0,0,0,0,0,0,0,0,0,0,0,0
149532,32000,320,0,-2,2,2,0,0,0,0,2,2,0,0,0,0,0,0,0,0,0,0,0,0,0,0,0,0,0,0,0,0,0,0
149587,32000,320,0,-2,12,7,5,0,0,0,1,0,1,1,1,0,1,0,1,0,0,0,8,5,3,0,0,0,1,1,0,0,0,0
149727,32000,320,0,-2,1,1,0,0,0,0,0,0,0,0,0,0,0,0,0,0,0,0,1,1,0,0,0,0,0,0,0,0,0,0
149772,32000,320,0,-2,10,10,0,1,1,0,2,2,0,0,0,0,0,0,0,0,0,0,7,7,0,0,0,0,0,0,0,0,0,0
149781,32000,320,0,-2,5,3,2,0,0,0,1,0,1,0,0,0,0,0,0,0,0,0,3,2,1,0,0,0,1,1,0,0,0,0
149842,32000,320,0,-2,7,6,1,0,0,0,1,1,0,0,0,0,0,0,0,0,0,0,5,4,1,0,0,0,1,1,0,0,0,0
150066,32000,320,0,-2,1,1,0,0,0,0,0,0,0,0,0,0,0,0,0,0,0,0,1,1,0,0,0,0,0,0,0,0,0,0
150163,32000,320,0,-2,7,3,4,0,0,0,1,0,1,1,1,0,0,0,0,0,0,0,5,2,3,0,0,0,0,0,0,0,0,0
150400,32000,320,0,-2,2,0,2,0,0,0,0,0,0,0,0,0,0,0,0,0,0,0,2,0,2,0,0,0,0,0,0,0,0,0
150455,32000,320,0,-2,2,2,0,0,0,0,0,0,0,0,0,0,0,0,0,0,0,0,2,2,0,0,0,0,0,0,0,0,0,0
150534,32000,320,0,-2,2,1,1,0,0,0,0,0,0,0,0,0,0,0,0,0,0,0,0,0,0,0,0,0,2,1,1,0,0,0
150604,32000,320,0,-2,1,0,1,0,0,0,0,0,0,0,0,0,0,0,0,0,0,0,1,0,1,0,0,0,0,0,0,0,0,0
150668,32000,320,0,-2,2,0,2,0,0,0,0,0,0,0,0,0,0,0,0,0,0,0,2,0,2,0,0,0,0,0,0,0,0,0
150987,32000,320,0,-2,12,8,4,0,0,0,0,0,0,0,0,0,0,0,0,0,0,0,12,8,4,0,0,0,0,0,0,0,0,0
151102,32000,320,0,-2,2,2,0,0,0,0,0,0,0,0,0,0,0,0,0,0,0,0,2,2,0,0,0,0,0,0,0,0,0,0
151111,32000,320,0,-2,99,48,51,0,0,0,7,2,5,3,1,2,7,2,5,0,0,0,68,39,29,4,0,4,0,0,0,10,4,6
151306,32000,320,0,-2,5,3,2,0,0,0,1,0,1,0,0,0,0,0,0,0,0,0,4,3,1,0,0,0,0,0,0,0,0,0
151324,32000,320,0,-2,12,8,4,0,0,0,1,0,1,1,1,0,1,1,0,0,0,0,8,5,3,1,1,0,0,0,0,0,0,0
151333,32000,320,0,-2,1,1,0,0,0,0,0,0,0,0,0,0,0,0,0,0,0,0,1,1,0,0,0,0,0,0,0,0,0,0
151351,32000,320,0,-2,76,44,32,0,0,0,3,2,1,1,0,1,7,4,3,0,0,0,58,32,26,0,0,0,1,1,0,6,5,1
151360,32000,320,0,-2,1,1,0,0,0,0,0,0,0,0,0,0,0,0,0,0,0,0,1,1,0,0,0,0,0,0,0,0,0,0
151379,32000,320,0,-2,1,1,0,0,0,0,0,0,0,0,0,0,0,0,0,0,0,0,1,1,0,0,0,0,0,0,0,0,0,0
151388,32000,320,0,-2,1,0,1,0,0,0,0,0,0,0,0,0,0,0,0,0,0,0,1,0,1,0,0,0,0,0,0,0,0,0
151777,32000,320,0,-2,2,2,0,0,0,0,0,0,0,0,0,0,0,0,0,0,0,0,2,2,0,0,0,0,0,0,0,0,0,0
151786,32000,320,0,-2,7,6,1,0,0,0,0,0,0,0,0,0,1,0,1,0,0,0,6,6,0,0,0,0,0,0,0,0,0,0
151801,32000,320,0,-2,5,3,2,0,0,0,0,0,0,0,0,0,1,1,0,0,0,0,4,2,2,0,0,0,0,0,0,0,0,0
152080,32000,320,0,-2,37,20,17,0,0,0,1,1,0,0,0,0,1,1,0,0,0,0,25,13,12,2,0,2,2,1,1,6,4,2
152318,32000,320,0,-2,3,3,0,0,0,0,0,0,0,0,0,0,0,0,0,0,0,0,3,3,0,0,0,0,0,0,0,0,0,0
152336,32000,320,0,-2,1,0,1,0,0,0,0,0,0,0,0,0,0,0,0,0,0,0,1,0,1,0,0,0,0,0,0,0,0,0
152381,32000,320,0,-2,1,1,0,0,0,0,0,0,0,0,0,0,0,0,0,0,0,0,1,1,0,0,0,0,0,0,0,0,0,0
152390,32000,320,0,-2,1,1,0,0,0,0,0,0,0,0,0,0,0,0,0,0,0,0,1,1,0,0,0,0,0,0,0,0,0,0
152530,32000,320,0,-2,3,2,1,0,0,0,1,0,1,0,0,0,0,0,0,0,0,0,2,2,0,0,0,0,0,0,0,0,0,0
152637,32000,320,0,-2,6,5,1,0,0,0,0,0,0,0,0,0,0,0,0,0,0,0,6,5,1,0,0,0,0,0,0,0,0,0
152673,32000,320,0,-2,2,0,2,0,0,0,0,0,0,0,0,0,0,0,0,0,0,0,2,0,2,0,0,0,0,0,0,0,0,0
153001,32000,320,0,-2,1,1,0,0,0,0,0,0,0,0,0,0,0,0,0,0,0,0,1,1,0,0,0,0,0,0,0,0,0,0
153108,32000,320,0,-2,1,1,0,0,0,0,0,0,0,0,0,0,0,0,0,0,0,0,1,1,0,0,0,0,0,0,0,0,0,0
153144,32000,320,0,-2,2,2,0,0,0,0,0,0,0,0,0,0,0,0,0,0,0,0,2,2,0,0,0,0,0,0,0,0,0,0
153162,32000,320,0,-2,3,3,0,0,0,0,0,0,0,0,0,0,1,1,0,0,0,0,2,2,0,0,0,0,0,0,0,0,0,0
153214,32000,320,0,-2,6,5,1,0,0,0,0,0,0,0,0,0,1,1,0,0,0,0,5,4,1,0,0,0,0,0,0,0,0,0
153250,32000,320,0,-2,1,1,0,0,0,0,0,0,0,0,0,0,0,0,0,0,0,0,1,1,0,0,0,0,0,0,0,0,0,0
153269,32000,320,0,-2,4,1,3,0,0,0,0,0,0,0,0,0,0,0,0,0,0,0,4,1,3,0,0,0,0,0,0,0,0,0
153311,32000,320,0,-2,5,4,1,0,0,0,0,0,0,0,0,0,0,0,0,0,0,0,5,4,1,0,0,0,0,0,0,0,0,0
153375,32000,320,0,-2,2,1,1,0,0,0,0,0,0,1,1,0,0,0,0,0,0,0,0,0,0,1,0,1,0,0,0,0,0,0
153384,32000,320,0,-2,7,7,0,0,0,0,0,0,0,0,0,0,0,0,0,0,0,0,7,7,0,0,0,0,0,0,0,0,0,0
153445,32000,320,0,-2,1,1,0,0,0,0,0,0,0,1,1,0,0,0,0,0,0,0,0,0,0,0,0,0,0,0,0,0,0,0
153472,32000,320,0,-2,3,2,1,0,0,0,0,0,0,1,1,0,0,0,0,0,0,0,2,1,1,0,0,0,0,0,0,0,0,0
153533,32000,320,0,-2,4,3,1,0,0,0,0,0,0,0,0,0,0,0,0,0,0,0,4,3,1,0,0,0,0,0,0,0,0,0
153603,32000,320,0,-2,53,40,13,1,1,0,5,2,3,1,0,1,3,1,2,0,0,0,39,32,7,2,2,0,0,0,0,2,2,0
153658,32000,320,0,-2,172,83,89,0,0,0,18,3,15,4,2,2,8,3,5,0,0,0,104,54,50,1,0,1,24,12,12,13,9,4
153737,32000,320,0,-2,3,2,1,0,0,0,1,0,1,0,0,0,0,0,0,0,0,0,2,2,0,0,0,0,0,0,0,0,0,0
153825,32000,320,0,-2,3,3,0,0,0,0,0,0,0,0,0,0,0,0,0,0,0,0,3,3,0,0,0,0,0,0,0,0,0,0
153834,32000,320,0,-2,1,1,0,0,0,0,0,0,0,0,0,0,0,0,0,0,0,0,1,1,0,0,0,0,0,0,0,0,0,0
153861,32000,320,0,-2,8,8,0,0,0,0,3,3,0,1,1,0,1,1,0,0,0,0,2,2,0,1,1,0,0,0,0,0,0,0
153977,32000,320,0,-2,1,1,0,0,0,0,0,0,0,0,0,0,0,0,0,0,0,0,1,1,0,0,0,0,0,0,0,0,0,0
154004,32000,320,0,-2,4,3,1,0,0,0,0,0,0,0,0,0,1,1,0,0,0,0,3,2,1,0,0,0,0,0,0,0,0,0
154013,32000,320,0,-2,1,1,0,0,0,0,0,0,0,0,0,0,0,0,0,0,0,0,1,1,0,0,0,0,0,0,0,0,0,0
154022,32000,320,0,-2,5,3,2,0,0,0,0,0,0,1,0,1,2,1,1,0,0,0,2,2,0,0,0,0,0,0,0,0,0,0
154059,32000,320,0,-2,1,1,0,0,0,0,0,0,0,0,0,0,0,0,0,0,0,0,1,1,0,0,0,0,0,0,0,0,0,0
154095,32000,320,0,-2,8,3,5,0,0,0,0,0,0,0,0,0,1,0,1,0,0,0,6,2,4,0,0,0,0,0,0,1,1,0
154101,32000,320,0,-2,2,2,0,0,0,0,0,0,0,0,0,0,0,0,0,0,0,0,2,2,0,0,0,0,0,0,0,0,0,0
154110,32000,320,0,-2,4,3,1,0,0,0,0,0,0,0,0,0,0,0,0,0,0,0,4,3,1,0,0,0,0,0,0,0,0,0
154129,32000,320,0,-2,1,0,1,0,0,0,0,0,0,0,0,0,0,0,0,0,0,0,1,0,1,0,0,0,0,0,0,0,0,0
154156,32000,320,0,-2,2,1,1,0,0,0,0,0,0,0,0,0,0,0,0,0,0,0,2,1,1,0,0,0,0,0,0,0,0,0
154174,32000,320,0,-2,5,5,0,0,0,0,0,0,0,0,0,0,0,0,0,0,0,0,5,5,0,0,0,0,0,0,0,0,0,0
154235,32000,320,0,-2,2,1,1,0,0,0,0,0,0,0,0,0,0,0,0,0,0,0,2,1,1,0,0,0,0,0,0,0,0,0
154350,32000,320,0,-2,2,1,1,0,0,0,0,0,0,0,0,0,0,0,0,0,0,0,2,1,1,0,0,0,0,0,0,0,0,0
154378,32000,320,0,-2,1,1,0,0,0,0,0,0,0,0,0,0,0,0,0,0,0,0,1,1,0,0,0,0,0,0,0,0,0,0
154396,32000,320,0,-2,1,1,0,0,0,0,0,0,0,0,0,0,0,0,0,0,0,0,1,1,0,0,0,0,0,0,0,0,0,0
154527,32000,320,0,-2,1,1,0,0,0,0,0,0,0,0,0,0,0,0,0,0,0,0,1,1,0,0,0,0,0,0,0,0,0,0
154590,32000,320,0,-2,1,0,1,0,0,0,0,0,0,0,0,0,0,0,0,0,0,0,1,0,1,0,0,0,0,0,0,0,0,0
154697,32000,320,0,-2,1,1,0,0,0,0,0,0,0,0,0,0,0,0,0,0,0,0,1,1,0,0,0,0,0,0,0,0,0,0
154721,32000,320,0,-2,1,1,0,0,0,0,0,0,0,0,0,0,0,0,0,0,0,0,1,1,0,0,0,0,0,0,0,0,0,0
154800,32000,320,0,-2,2,2,0,0,0,0,0,0,0,0,0,0,0,0,0,0,0,0,2,2,0,0,0,0,0,0,0,0,0,0
154907,32000,320,0,-2,1,1,0,0,0,0,0,0,0,0,0,0,0,0,0,0,0,0,1,1,0,0,0,0,0,0,0,0,0,0
155025,32000,320,0,-2,4,3,1,0,0,0,0,0,0,0,0,0,0,0,0,0,0,0,4,3,1,0,0,0,0,0,0,0,0,0
155098,32000,320,0,-2,1,1,0,0,0,0,0,0,0,0,0,0,0,0,0,0,0,0,1,1,0,0,0,0,0,0,0,0,0,0
155177,32000,320,0,-2,1,1,0,0,0,0,1,1,0,0,0,0,0,0,0,0,0,0,0,0,0,0,0,0,0,0,0,0,0,0
155186,32000,320,0,-2,1,1,0,0,0,0,0,0,0,0,0,0,0,0,0,0,0,0,1,1,0,0,0,0,0,0,0,0,0,0
155195,32000,320,0,-2,4,3,1,0,0,0,0,0,0,0,0,0,0,0,0,0,0,0,4,3,1,0,0,0,0,0,0,0,0,0
155210,32000,320,0,-2,2,1,1,0,0,0,1,1,0,0,0,0,0,0,0,0,0,0,1,0,1,0,0,0,0,0,0,0,0,0
155292,32000,320,0,-2,1,1,0,0,0,0,0,0,0,1,1,0,0,0,0,0,0,0,0,0,0,0,0,0,0,0,0,0,0,0
155317,32000,320,0,-2,61,39,22,0,0,0,2,0,2,7,4,3,3,3,0,0,0,0,42,29,13,1,0,1,3,2,1,3,1,2
155399,32000,320,0,-2,128,81,47,0,0,0,3,2,1,0,0,0,6,2,4,0,0,0,64,36,28,1,0,1,0,0,0,54,41,13
155487,32000,320,0,-2,1,0,1,0,0,0,0,0,0,0,0,0,0,0,0,0,0,0,0,0,0,0,0,0,1,0,1,0,0,0
155566,32000,320,0,-2,2,2,0,0,0,0,1,1,0,0,0,0,0,0,0,0,0,0,1,1,0,0,0,0,0,0,0,0,0,0
155715,32000,320,0,-2,2,2,0,0,0,0,0,0,0,0,0,0,0,0,0,0,0,0,2,2,0,0,0,0,0,0,0,0,0,0
155812,32000,320,0,-2,2,2,0,0,0,0,0,0,0,0,0,0,0,0,0,0,0,0,2,2,0,0,0,0,0,0,0,0,0,0
155830,32000,320,0,-2,1,0,1,0,0,0,0,0,0,0,0,0,0,0,0,0,0,0,1,0,1,0,0,0,0,0,0,0,0,0
155858,32000,320,0,-2,1,0,1,0,0,0,0,0,0,0,0,0,0,0,0,0,0,0,1,0,1,0,0,0,0,0,0,0,0,0
155900,32000,320,0,-2,1,0,1,0,0,0,0,0,0,0,0,0,0,0,0,0,0,0,1,0,1,0,0,0,0,0,0,0,0,0
156082,32000,320,0,-2,3,2,1,0,0,0,0,0,0,0,0,0,0,0,0,0,0,0,1,1,0,0,0,0,2,1,1,0,0,0
156107,32000,320,0,-2,1,0,1,0,0,0,0,0,0,0,0,0,0,0,0,0,0,0,0,0,0,1,0,1,0,0,0,0,0,0
156125,32000,320,0,-2,130,115,15,1,1,0,7,4,3,8,6,2,12,12,0,0,0,0,86,78,8,3,3,0,9,7,2,4,4,0
156134,32000,320,0,-2,2,1,1,0,0,0,0,0,0,0,0,0,1,0,1,0,0,0,1,1,0,0,0,0,0,0,0,0,0,0
156213,32000,320,0,-2,3,2,1,0,0,0,0,0,0,0,0,0,0,0,0,0,0,0,3,2,1,0,0,0,0,0,0,0,0,0
156222,32000,320,0,-2,1,1,0,0,0,0,0,0,0,0,0,0,0,0,0,0,0,0,1,1,0,0,0,0,0,0,0,0,0,0
156295,32000,320,0,-2,5,2,3,0,0,0,0,0,0,1,1,0,0,0,0,0,0,0,4,1,3,0,0,0,0,0,0,0,0,0
156356,32000,320,0,-2,1,1,0,0,0,0,0,0,0,0,0,0,0,0,0,0,0,0,1,1,0,0,0,0,0,0,0,0,0,0
156365,32000,320,0,-2,2,1,1,0,0,0,0,0,0,1,1,0,0,0,0,0,0,0,1,0,1,0,0,0,0,0,0,0,0,0
156408,32000,320,0,-2,1,1,0,0,0,0,0,0,0,0,0,0,0,0,0,0,0,0,1,1,0,0,0,0,0,0,0,0,0,0
156471,32000,320,0,-2,1,1,0,0,0,0,0,0,0,0,0,0,0,0,0,0,0,0,1,1,0,0,0,0,0,0,0,0,0,0
156541,32000,320,0,-2,1,1,0,0,0,0,0,0,0,0,0,0,0,0,0,0,0,0,1,1,0,0,0,0,0,0,0,0,0,0
156620,32000,320,0,-2,33,20,13,0,0,0,1,1,0,1,1,0,0,0,0,0,0,0,30,18,12,1,0,1,0,0,0,0,0,0
156727,32000,320,0,-2,3,2,1,0,0,0,1,0,1,0,0,0,0,0,0,0,0,0,2,2,0,0,0,0,0,0,0,0,0,0
156790,32000,320,0,-2,1,1,0,0,0,0,0,0,0,0,0,0,0,0,0,0,0,0,1,1,0,0,0,0,0,0,0,0,0,0
157058,32000,320,0,-2,6,4,2,0,0,0,0,0,0,1,1,0,2,2,0,0,0,0,2,0,2,0,0,0,1,1,0,0,0,0
157085,32000,320,0,-2,136,57,79,1,1,0,4,3,1,6,3,3,5,2,3,0,0,0,114,45,69,2,1,1,0,0,0,4,2,2
157289,32000,320,0,-2,65,42,23,0,0,0,6,3,3,1,1,0,2,1,1,0,0,0,31,19,12,1,1,0,0,0,0,24,17,7
157386,32000,320,0,-2,3,2,1,1,1,0,0,0,0,0,0,0,0,0,0,0,0,0,1,0,1,0,0,0,0,0,0,1,1,0
157447,32000,320,0,-2,14,10,4,0,0,0,0,0,0,1,1,0,1,1,0,0,0,0,12,8,4,0,0,0,0,0,0,0,0,0
157535,32000,320,0,-2,3,1,2,0,0,0,0,0,0,0,0,0,0,0,0,0,0,0,3,1,2,0,0,0,0,0,0,0,0,0
157553,32000,320,0,-2,1,1,0,0,0,0,0,0,0,0,0,0,0,0,0,0,0,0,1,1,0,0,0,0,0,0,0,0,0,0
157748,32000,320,0,-2,2,1,1,0,0,0,0,0,0,0,0,0,0,0,0,0,0,0,1,1,0,0,0,0,1,0,1,0,0,0
157757,32000,320,0,-2,1,1,0,0,0,0,0,0,0,0,0,0,0,0,0,0,0,0,1,1,0,0,0,0,0,0,0,0,0,0
157818,32000,320,0,-2,3,2,1,0,0,0,0,0,0,0,0,0,0,0,0,0,0,0,3,2,1,0,0,0,0,0,0,0,0,0
157854,32000,320,0,-2,4,4,0,0,0,0,0,0,0,1,1,0,1,1,0,0,0,0,0,0,0,0,0,0,2,2,0,0,0,0
157863,32000,320,0,-2,1,1,0,0,0,0,0,0,0,0,0,0,0,0,0,0,0,0,1,1,0,0,0,0,0,0,0,0,0,0
157951,32000,320,0,-2,7,6,1,0,0,0,1,1,0,0,0,0,0,0,0,0,0,0,6,5,1,0,0,0,0,0,0,0,0,0
158431,32000,320,0,-2,4,3,1,0,0,0,0,0,0,1,0,1,0,0,0,0,0,0,2,2,0,0,0,0,0,0,0,1,1,0
158477,32000,320,0,-2,2,1,1,0,0,0,0,0,0,0,0,0,0,0,0,0,0,0,2,1,1,0,0,0,0,0,0,0,0,0
159009,32000,320,0,-2,1,0,1,0,0,0,0,0,0,1,0,1,0,0,0,0,0,0,0,0,0,0,0,0,0,0,0,0,0,0
159373,32000,320,0,-2,4,2,2,0,0,0,1,1,0,1,1,0,0,0,0,0,0,0,2,0,2,0,0,0,0,0,0,0,0,0
159382,32000,320,0,-2,2,2,0,0,0,0,0,0,0,0,0,0,0,0,0,0,0,0,2,2,0,0,0,0,0,0,0,0,0,0
159391,32000,320,0,-2,161,81,80,0,0,0,5,4,1,12,4,8,4,4,0,0,0,0,92,48,44,4,2,2,2,0,2,42,19,23
159407,32000,320,0,-2,2,2,0,0,0,0,0,0,0,0,0,0,0,0,0,0,0,0,1,1,0,1,1,0,0,0,0,0,0,0
159416,32000,320,0,-2,2,1,1,0,0,0,0,0,0,0,0,0,0,0,0,0,0,0,1,1,0,0,0,0,1,0,1,0,0,0
159568,32000,320,0,-2,1,1,0,0,0,0,0,0,0,0,0,0,0,0,0,0,0,0,1,1,0,0,0,0,0,0,0,0,0,0
159647,32000,320,0,-2,1,1,0,0,0,0,0,0,0,0,0,0,0,0,0,0,0,0,1,1,0,0,0,0,0,0,0,0,0,0
159656,32000,320,0,-2,1,1,0,0,0,0,1,1,0,0,0,0,0,0,0,0,0,0,0,0,0,0,0,0,0,0,0,0,0,0
159717,32000,320,0,-2,2,2,0,0,0,0,0,0,0,0,0,0,0,0,0,0,0,0,2,2,0,0,0,0,0,0,0,0,0,0
159939,32000,320,0,-2,2,2,0,0,0,0,0,0,0,0,0,0,0,0,0,0,0,0,2,2,0,0,0,0,0,0,0,0,0,0
159948,32000,320,0,-2,2,2,0,0,0,0,0,0,0,0,0,0,0,0,0,0,0,0,2,2,0,0,0,0,0,0,0,0,0,0
159993,32000,320,0,-2,1,1,0,0,0,0,0,0,0,0,0,0,0,0,0,0,0,0,0,0,0,0,0,0,1,1,0,0,0,0
160038,32000,320,0,-2,2,1,1,0,0,0,0,0,0,0,0,0,1,0,1,0,0,0,0,0,0,0,0,0,0,0,0,1,1,0
160481,32000,320,0,-2,1,1,0,0,0,0,0,0,0,0,0,0,0,0,0,0,0,0,1,1,0,0,0,0,0,0,0,0,0,0
160612,32000,320,0,-2,4,4,0,0,0,0,0,0,0,0,0,0,0,0,0,0,0,0,3,3,0,1,1,0,0,0,0,0,0,0
160621,32000,320,0,-2,5,4,1,0,0,0,0,0,0,2,1,1,0,0,0,1,1,0,2,2,0,0,0,0,0,0,0,0,0,0
160630,32000,320,0,-2,1,1,0,0,0,0,0,0,0,0,0,0,0,0,0,0,0,0,1,1,0,0,0,0,0,0,0,0,0,0
160658,32000,320,0,-2,44,26,18,0,0,0,2,1,1,8,4,4,3,2,1,0,0,0,25,15,10,0,0,0,0,0,0,6,4,2
160755,32000,320,0,-2,25,14,11,0,0,0,1,1,0,5,3,2,3,1,2,0,0,0,15,9,6,0,0,0,0,0,0,1,0,1
160904,32000,320,0,-2,5,2,3,0,0,0,0,0,0,4,1,3,0,0,0,0,0,0,0,0,0,0,0,0,0,0,0,1,1,0
160977,32000,320,0,-2,5,2,3,0,0,0,0,0,0,0,0,0,0,0,0,0,0,0,5,2,3,0,0,0,0,0,0,0,0,0
160995,32000,320,0,-2,1,1,0,0,0,0,0,0,0,0,0,0,0,0,0,0,0,0,1,1,0,0,0,0,0,0,0,0,0,0
161004,32000,320,0,-2,6,1,5,0,0,0,2,0,2,0,0,0,0,0,0,0,0,0,3,1,2,0,0,0,0,0,0,1,0,1
161077,32000,320,0,-2,1,1,0,0,0,0,0,0,0,0,0,0,0,0,0,0,0,0,0,0,0,0,0,0,1,1,0,0,0,0
161086,32000,320,0,-2,6,2,4,0,0,0,0,0,0,0,0,0,1,0,1,0,0,0,5,2,3,0,0,0,0,0,0,0,0,0
161217,32000,320,0,-2,1,0,1,0,0,0,0,0,0,0,0,0,0,0,0,0,0,0,1,0,1,0,0,0,0,0,0,0,0,0
161253,32000,320,0,-2,48,42,6,0,0,0,2,2,0,0,0,0,1,1,0,0,0,0,37,32,5,0,0,0,3,3,0,5,4,1
161280,32000,320,0,-2,7,5,2,0,0,0,0,0,0,0,0,0,0,0,0,0,0,0,7,5,2,0,0,0,0,0,0,0,0,0
161299,32000,320,0,-2,1,1,0,0,0,0,0,0,0,0,0,0,0,0,0,0,0,0,1,1,0,0,0,0,0,0,0,0,0,0
161457,32000,320,0,-2,8,5,3,0,0,0,0,0,0,0,0,0,0,0,0,0,0,0,7,5,2,0,0,0,1,0,1,0,0,0
161518,32000,320,0,-2,1,1,0,0,0,0,0,0,0,0,0,0,0,0,0,0,0,0,1,1,0,0,0,0,0,0,0,0,0,0
161545,32000,320,0,-2,2,2,0,0,0,0,1,1,0,0,0,0,0,0,0,0,0,0,1,1,0,0,0,0,0,0,0,0,0,0
161554,32000,320,0,-2,5,4,1,0,0,0,0,0,0,0,0,0,0,0,0,0,0,0,4,4,0,0,0,0,0,0,0,1,0,1
161572,32000,320,0,-2,1,1,0,0,0,0,0,0,0,0,0,0,0,0,0,0,0,0,1,1,0,0,0,0,0,0,0,0,0,0
161767,32000,320,0,-2,1,0,1,0,0,0,0,0,0,0,0,0,0,0,0,0,0,0,1,0,1,0,0,0,0,0,0,0,0,0
161864,32000,320,0,-2,2,1,1,0,0,0,0,0,0,2,1,1,0,0,0,0,0,0,0,0,0,0,0,0,0,0,0,0,0,0
161873,32000,320,0,-2,7,4,3,0,0,0,2,2,0,2,1,1,1,0,1,0,0,0,2,1,1,0,0,0,0,0,0,0,0,0
162061,32000,320,0,-2,2,1,1,0,0,0,0,0,0,2,1,1,0,0,0,0,0,0,0,0,0,0,0,0,0,0,0,0,0,0
162104,32000,320,0,-2,1,1,0,0,0,0,0,0,0,1,1,0,0,0,0,0,0,0,0,0,0,0,0,0,0,0,0,0,0,0
162122,32000,320,0,-2,4,3,1,0,0,0,0,0,0,2,1,1,0,0,0,0,0,0,2,2,0,0,0,0,0,0,0,0,0,0
162168,32000,320,0,-2,1,1,0,0,0,0,0,0,0,0,0,0,0,0,0,0,0,0,1,1,0,0,0,0,0,0,0,0,0,0
162557,32000,320,0,-2,4,2,2,0,0,0,1,1,0,0,0,0,0,0,0,0,0,0,3,1,2,0,0,0,0,0,0,0,0,0
162609,32000,320,0,-2,1,1,0,0,0,0,0,0,0,0,0,0,0,0,0,0,0,0,1,1,0,0,0,0,0,0,0,0,0,0
162654,32000,320,0,-2,1,0,1,0,0,0,0,0,0,0,0,0,1,0,1,0,0,0,0,0,0,0,0,0,0,0,0,0,0,0
162690,32000,320,0,-2,1,1,0,0,0,0,0,0,0,0,0,0,0,0,0,0,0,0,1,1,0,0,0,0,0,0,0,0,0,0
162760,32000,320,0,-2,2,1,1,0,0,0,0,0,0,0,0,0,0,0,0,0,0,0,2,1,1,0,0,0,0,0,0,0,0,0
162779,32000,320,0,-2,4,2,2,0,0,0,1,0,1,0,0,0,0,0,0,0,0,0,2,1,1,1,1,0,0,0,0,0,0,0
162928,32000,320,0,-2,534,201,333,2,0,2,107,39,68,72,24,48,43,17,26,0,0,0,228,91,137,19,6,13,5,3,2,58,21,37
163046,32000,320,0,-2,10,7,3,0,0,0,0,0,0,4,2,2,1,0,1,0,0,0,5,5,0,0,0,0,0,0,0,0,0,0
163204,32000,320,0,-2,2,0,2,0,0,0,0,0,0,0,0,0,0,0,0,0,0,0,1,0,1,0,0,0,1,0,1,0,0,0
163259,32000,320,0,-2,170,55,115,0,0,0,22,3,19,31,8,23,13,2,11,0,0,0,87,38,49,9,1,8,0,0,0,8,3,5
163268,32000,320,0,-2,7,3,4,0,0,0,1,1,0,0,0,0,0,0,0,0,0,0,4,2,2,0,0,0,2,0,2,0,0,0
163286,32000,320,0,-2,35,23,12,0,0,0,11,7,4,5,2,3,0,0,0,0,0,0,13,11,2,0,0,0,4,2,2,2,1,1
163295,32000,320,0,-2,5,1,4,0,0,0,2,1,1,1,0,1,1,0,1,0,0,0,1,0,1,0,0,0,0,0,0,0,0,0
163426,32000,320,0,-2,6,2,4,0,0,0,0,0,0,2,1,1,0,0,0,0,0,0,3,1,2,0,0,0,0,0,0,1,0,1
163453,32000,320,0,-2,2,1,1,0,0,0,0,0,0,2,1,1,0,0,0,0,0,0,0,0,0,0,0,0,0,0,0,0,0,0
163578,32000,320,0,-2,1,1,0,0,0,0,0,0,0,0,0,0,0,0,0,0,0,0,1,1,0,0,0,0,0,0,0,0,0,0
163657,32000,320,0,-2,4,0,4,0,0,0,0,0,0,1,0,1,0,0,0,0,0,0,3,0,3,0,0,0,0,0,0,0,0,0
163851,32000,320,0,-2,3,3,0,0,0,0,1,1,0,0,0,0,1,1,0,0,0,0,1,1,0,0,0,0,0,0,0,0,0,0
163912,32000,320,0,-2,2,1,1,0,0,0,0,0,0,1,1,0,0,0,0,0,0,0,1,0,1,0,0,0,0,0,0,0,0,0
164076,32000,320,0,-2,7,2,5,0,0,0,0,0,0,1,0,1,0,0,0,0,0,0,6,2,4,0,0,0,0,0,0,0,0,0
164155,32000,320,0,-2,15,12,3,0,0,0,2,2,0,4,2,2,0,0,0,0,0,0,9,8,1,0,0,0,0,0,0,0,0,0
164173,32000,320,0,-2,6,6,0,0,0,0,0,0,0,2,2,0,0,0,0,0,0,0,3,3,0,1,1,0,0,0,0,0,0,0
164216,32000,320,0,-2,6,3,3,0,0,0,0,0,0,1,1,0,0,0,0,0,0,0,5,2,3,0,0,0,0,0,0,0,0,0
164270,32000,320,0,-2,3,0,3,0,0,0,0,0,0,0,0,0,0,0,0,0,0,0,3,0,3,0,0,0,0,0,0,0,0,0
164447,32000,320,0,-2,2,2,0,0,0,0,0,0,0,0,0,0,0,0,0,0,0,0,2,2,0,0,0,0,0,0,0,0,0,0
164465,32000,320,0,-2,13,5,8,0,0,0,1,1,0,1,0,1,0,0,0,0,0,0,8,3,5,0,0,0,0,0,0,3,1,2
164492,32000,320,0,-2,1,1,0,0,0,0,0,0,0,0,0,0,0,0,0,0,0,0,1,1,0,0,0,0,0,0,0,0,0,0
164562,32000,320,0,-2,2,1,1,0,0,0,0,0,0,0,0,0,0,0,0,0,0,0,2,1,1,0,0,0,0,0,0,0,0,0
164580,32000,320,0,-2,1,0,1,0,0,0,0,0,0,1,0,1,0,0,0,0,0,0,0,0,0,0,0,0,0,0,0,0,0,0
164739,32000,320,0,-2,5,2,3,0,0,0,2,1,1,0,0,0,1,1,0,0,0,0,1,0,1,0,0,0,0,0,0,1,0,1
164748,32000,320,0,-2,4,2,2,0,0,0,0,0,0,0,0,0,0,0,0,0,0,0,4,2,2,0,0,0,0,0,0,0,0,0
164775,32000,320,0,-2,1,1,0,0,0,0,0,0,0,0,0,0,0,0,0,0,0,0,1,1,0,0,0,0,0,0,0,0,0,0
164872,32000,320,0,-2,1,0,1,0,0,0,0,0,0,0,0,0,1,0,1,0,0,0,0,0,0,0,0,0,0,0,0,0,0,0
164924,32000,320,0,-2,9,6,3,0,0,0,3,3,0,0,0,0,0,0,0,0,0,0,5,3,2,1,0,1,0,0,0,0,0,0
164988,32000,320,0,-2,274,107,167,0,0,0,37,14,23,19,5,14,35,14,21,0,0,0,126,49,77,12,5,7,19,6,13,26,14,12
165015,32000,320,0,-2,29,17,12,0,0,0,2,1,1,3,2,1,1,0,1,0,0,0,20,12,8,0,0,0,2,1,1,1,1,0
165033,32000,320,0,-2,3,1,2,0,0,0,0,0,0,1,0,1,0,0,0,0,0,0,2,1,1,0,0,0,0,0,0,0,0,0
165194,32000,320,0,-2,1,1,0,0,0,0,0,0,0,0,0,0,0,0,0,0,0,0,1,1,0,0,0,0,0,0,0,0,0,0
165264,32000,320,0,-2,1,1,0,0,0,0,0,0,0,0,0,0,0,0,0,0,0,0,1,1,0,0,0,0,0,0,0,0,0,0
165334,32000,320,0,-2,9,6,3,0,0,0,0,0,0,0,0,0,1,1,0,0,0,0,8,5,3,0,0,0,0,0,0,0,0,0
165529,32000,320,0,-2,5,4,1,0,0,0,1,1,0,0,0,0,0,0,0,0,0,0,4,3,1,0,0,0,0,0,0,0,0,0
165671,32000,320,0,-2,1,1,0,0,0,0,0,0,0,0,0,0,0,0,0,0,0,0,1,1,0,0,0,0,0,0,0,0,0,0
165699,32000,320,0,-2,4,1,3,0,0,0,0,0,0,0,0,0,1,0,1,0,0,0,2,1,1,0,0,0,1,0,1,0,0,0
165820,32000,320,0,-2,4,2,2,0,0,0,2,2,0,1,0,1,0,0,0,0,0,0,1,0,1,0,0,0,0,0,0,0,0,0
165866,32000,320,0,-2,1,0,1,0,0,0,0,0,0,0,0,0,0,0,0,0,0,0,1,0,1,0,0,0,0,0,0,0,0,0
165945,32000,320,0,-2,1,1,0,0,0,0,0,0,0,0,0,0,0,0,0,0,0,0,1,1,0,0,0,0,0,0,0,0,0,0
166018,32000,320,0,-2,2,0,2,0,0,0,0,0,0,0,0,0,0,0,0,0,0,0,2,0,2,0,0,0,0,0,0,0,0,0
166027,32000,320,0,-2,323,143,180,0,0,0,55,23,32,16,6,10,33,15,18,0,0,0,175,81,94,7,6,1,0,0,0,37,12,25
166124,32000,320,0,-2,4,1,3,0,0,0,1,0,1,0,0,0,0,0,0,0,0,0,3,1,2,0,0,0,0,0,0,0,0,0
166391,32000,320,0,-2,3,1,2,0,0,0,0,0,0,0,0,0,1,0,1,0,0,0,2,1,1,0,0,0,0,0,0,0,0,0
166452,32000,320,0,-2,1,1,0,0,0,0,0,0,0,0,0,0,0,0,0,0,0,0,1,1,0,0,0,0,0,0,0,0,0,0
166513,32000,320,0,-2,10,7,3,0,0,0,1,0,1,0,0,0,0,0,0,0,0,0,7,5,2,0,0,0,0,0,0,2,2,0
166629,32000,320,0,-2,39,13,26,0,0,0,4,0,4,2,0,2,2,1,1,0,0,0,27,9,18,1,1,0,1,1,0,2,1,1
166638,32000,320,0,-2,21,9,12,1,0,1,2,1,1,1,0,1,3,1,2,0,0,0,8,3,5,1,0,1,1,0,1,4,4,0
166656,32000,320,0,-2,10,7,3,0,0,0,3,2,1,0,0,0,0,0,0,0,0,0,5,3,2,0,0,0,2,2,0,0,0,0
166665,32000,320,0,-2,9,5,4,0,0,0,1,0,1,0,0,0,0,0,0,0,0,0,8,5,3,0,0,0,0,0,0,0,0,0
166674,32000,320,0,-2,1,1,0,0,0,0,0,0,0,0,0,0,0,0,0,0,0,0,1,1,0,0,0,0,0,0,0,0,0,0
166683,32000,320,0,-2,88,63,25,0,0,0,12,10,2,3,3,0,7,5,2,0,0,0,57,39,18,3,2,1,5,4,1,1,0,1
166692,32000,320,0,-2,1,1,0,0,0,0,0,0,0,0,0,0,0,0,0,0,0,0,1,1,0,0,0,0,0,0,0,0,0,0
166708,32000,320,0,-2,34,26,8,0,0,0,7,6,1,3,2,1,0,0,0,0,0,0,17,13,4,0,0,0,2,2,0,5,3,2
166823,32000,320,0,-2,1,0,1,0,0,0,0,0,0,0,0,0,0,0,0,0,0,0,1,0,1,0,0,0,0,0,0,0,0,0
166850,32000,320,0,-2,4,2,2,0,0,0,0,0,0,0,0,0,0,0,0,0,0,0,4,2,2,0,0,0,0,0,0,0,0,0
166869,32000,320,0,-2,4,1,3,0,0,0,0,0,0,0,0,0,1,1,0,0,0,0,3,0,3,0,0,0,0,0,0,0,0,0
166887,32000,320,0,-2,2,2,0,0,0,0,0,0,0,0,0,0,0,0,0,0,0,0,2,2,0,0,0,0,0,0,0,0,0,0
166911,32000,320,0,-2,1,1,0,0,0,0,0,0,0,0,0,0,0,0,0,0,0,0,0,0,0,0,0,0,1,1,0,0,0,0
166939,32000,320,0,-2,10,1,9,0,0,0,0,0,0,0,0,0,1,0,1,0,0,0,7,1,6,1,0,1,1,0,1,0,0,0
167093,32000,320,0,-2,1,0,1,0,0,0,0,0,0,0,0,0,0,0,0,0,0,0,1,0,1,0,0,0,0,0,0,0,0,0
167215,32000,320,0,-2,3,3,0,0,0,0,0,0,0,0,0,0,0,0,0,0,0,0,3,3,0,0,0,0,0,0,0,0,0,0
167288,32000,320,0,-2,1,1,0,0,0,0,0,0,0,0,0,0,1,1,0,0,0,0,0,0,0,0,0,0,0,0,0,0,0,0
167312,32000,320,0,-2,3,1,2,0,0,0,0,0,0,0,0,0,0,0,0,0,0,0,3,1,2,0,0,0,0,0,0,0,0,0
167358,32000,320,0,-2,86,41,45,0,0,0,7,4,3,8,6,2,7,3,4,0,0,0,44,16,28,3,1,2,7,5,2,10,6,4
167376,32000,320,0,-2,8,5,3,0,0,0,0,0,0,1,1,0,0,0,0,0,0,0,7,4,3,0,0,0,0,0,0,0,0,0
167394,32000,320,0,-2,1,1,0,0,0,0,0,0,0,0,0,0,0,0,0,0,0,0,1,1,0,0,0,0,0,0,0,0,0,0
167525,32000,320,0,-2,1,0,1,0,0,0,1,0,1,0,0,0,0,0,0,0,0,0,0,0,0,0,0,0,0,0,0,0,0,0
167534,32000,320,0,-2,2,1,1,0,0,0,0,0,0,0,0,0,0,0,0,0,0,0,2,1,1,0,0,0,0,0,0,0,0,0
167783,32000,320,0,-2,1,0,1,0,0,0,1,0,1,0,0,0,0,0,0,0,0,0,0,0,0,0,0,0,0,0,0,0,0,0
167792,32000,320,0,-2,1,1,0,0,0,0,0,0,0,0,0,0,0,0,0,0,0,0,1,1,0,0,0,0,0,0,0,0,0,0
167835,32000,320,0,-2,8,4,4,0,0,0,0,0,0,0,0,0,1,0,1,0,0,0,7,4,3,0,0,0,0,0,0,0,0,0
167899,32000,320,0,-2,2,2,0,0,0,0,0,0,0,0,0,0,1,1,0,0,0,0,1,1,0,0,0,0,0,0,0,0,0,0
167905,32000,320,0,-2,3,3,0,0,0,0,0,0,0,0,0,0,0,0,0,0,0,0,3,3,0,0,0,0,0,0,0,0,0,0
167987,32000,320,0,-2,13,5,8,0,0,0,0,0,0,1,0,1,0,0,0,0,0,0,6,3,3,1,0,1,3,1,2,2,1,1
167996,32000,320,0,-2,4,1,3,0,0,0,0,0,0,0,0,0,1,1,0,0,0,0,0,0,0,0,0,0,3,0,3,0,0,0
168005,32000,320,0,-2,6,3,3,0,0,0,1,0,1,0,0,0,0,0,0,0,0,0,5,3,2,0,0,0,0,0,0,0,0,0
168148,32000,320,0,-2,65,34,31,1,0,1,9,6,3,4,2,2,5,3,2,0,0,0,35,14,21,1,1,0,10,8,2,0,0,0
168218,32000,320,0,-2,9,0,9,0,0,0,4,0,4,0,0,0,1,0,1,0,0,0,4,0,4,0,0,0,0,0,0,0,0,0
168227,32000,320,0,-2,6,3,3,0,0,0,1,1,0,0,0,0,1,0,1,0,0,0,4,2,2,0,0,0,0,0,0,0,0,0
168254,32000,320,0,-2,4,0,4,0,0,0,0,0,0,0,0,0,0,0,0,0,0,0,4,0,4,0,0,0,0,0,0,0,0,0
168263,32000,320,0,-2,4,1,3,0,0,0,0,0,0,0,0,0,1,0,1,0,0,0,3,1,2,0,0,0,0,0,0,0,0,0
168281,32000,320,0,-2,1,1,0,0,0,0,0,0,0,0,0,0,0,0,0,0,0,0,1,1,0,0,0,0,0,0,0,0,0,0
168342,32000,320,0,-2,1,1,0,0,0,0,0,0,0,0,0,0,0,0,0,0,0,0,1,1,0,0,0,0,0,0,0,0,0,0
168421,32000,320,0,-2,7,5,2,0,0,0,1,0,1,1,0,1,1,1,0,0,0,0,3,3,0,0,0,0,1,1,0,0,0,0
168430,32000,320,0,-2,3,2,1,0,0,0,0,0,0,0,0,0,0,0,0,0,0,0,3,2,1,0,0,0,0,0,0,0,0,0
168528,32000,320,0,-2,2,1,1,0,0,0,0,0,0,0,0,0,0,0,0,0,0,0,2,1,1,0,0,0,0,0,0,0,0,0
168546,32000,320,0,-2,7,5,2,0,0,0,2,1,1,0,0,0,0,0,0,0,0,0,5,4,1,0,0,0,0,0,0,0,0,0
168591,32000,320,0,-2,2,2,0,0,0,0,0,0,0,0,0,0,0,0,0,0,0,0,2,2,0,0,0,0,0,0,0,0,0,0
168740,32000,320,0,-2,3,1,2,0,0,0,0,0,0,0,0,0,1,0,1,0,0,0,2,1,1,0,0,0,0,0,0,0,0,0
168786,32000,320,0,-2,1,1,0,0,0,0,0,0,0,0,0,0,0,0,0,0,0,0,0,0,0,0,0,0,1,1,0,0,0,0
168883,32000,320,0,-2,5,3,2,0,0,0,0,0,0,0,0,0,0,0,0,0,0,0,5,3,2,0,0,0,0,0,0,0,0,0
169080,32000,320,0,-2,4,3,1,0,0,0,0,0,0,0,0,0,0,0,0,0,0,0,4,3,1,0,0,0,0,0,0,0,0,0
169327,32000,320,0,-2,1,1,0,0,0,0,0,0,0,0,0,0,0,0,0,0,0,0,1,1,0,0,0,0,0,0,0,0,0,0
169363,32000,320,0,-2,1,1,0,0,0,0,0,0,0,0,0,0,0,0,0,0,0,0,1,1,0,0,0,0,0,0,0,0,0,0
169479,32000,320,0,-2,1,1,0,0,0,0,0,0,0,0,0,0,0,0,0,0,0,0,1,1,0,0,0,0,0,0,0,0,0,0
169655,32000,320,0,-2,1,1,0,0,0,0,0,0,0,0,0,0,0,0,0,0,0,0,1,1,0,0,0,0,0,0,0,0,0,0
169716,32000,320,0,-2,7,2,5,0,0,0,2,1,1,0,0,0,1,1,0,0,0,0,2,0,2,0,0,0,2,0,2,0,0,0
169798,32000,320,0,-2,5,3,2,0,0,0,0,0,0,1,0,1,1,1,0,0,0,0,3,2,1,0,0,0,0,0,0,0,0,0
169974,32000,320,0,-2,1,1,0,0,0,0,0,0,0,0,0,0,0,0,0,0,0,0,0,0,0,1,1,0,0,0,0,0,0,0
169983,32000,320,0,-2,1,0,1,0,0,0,0,0,0,1,0,1,0,0,0,0,0,0,0,0,0,0,0,0,0,0,0,0,0,0
170000,32000,320,0,-2,2,2,0,0,0,0,0,0,0,0,0,0,0,0,0,0,0,0,2,2,0,0,0,0,0,0,0,0,0,0
170037,32000,320,0,-2,1,1,0,0,0,0,0,0,0,0,0,0,0,0,0,0,0,0,1,1,0,0,0,0,0,0,0,0,0,0
170055,32000,320,0,-2,1,1,0,0,0,0,0,0,0,0,0,0,0,0,0,0,0,0,1,1,0,0,0,0,0,0,0,0,0,0
170082,32000,320,0,-2,10,6,4,0,0,0,0,0,0,2,0,2,0,0,0,0,0,0,7,5,2,0,0,0,1,1,0,0,0,0
170240,32000,320,0,-2,3,2,1,0,0,0,0,0,0,0,0,0,0,0,0,0,0,0,3,2,1,0,0,0,0,0,0,0,0,0
170286,32000,320,0,-2,6,4,2,0,0,0,0,0,0,0,0,0,0,0,0,0,0,0,0,0,0,0,0,0,6,4,2,0,0,0
170301,32000,320,0,-2,6,3,3,0,0,0,0,0,0,0,0,0,0,0,0,0,0,0,6,3,3,0,0,0,0,0,0,0,0,0
170532,32000,320,0,-2,2,2,0,0,0,0,0,0,0,0,0,0,0,0,0,0,0,0,2,2,0,0,0,0,0,0,0,0,0,0
170541,32000,320,0,-2,3,2,1,0,0,0,0,0,0,0,0,0,0,0,0,0,0,0,3,2,1,0,0,0,0,0,0,0,0,0
170550,32000,320,0,-2,3,3,0,0,0,0,0,0,0,0,0,0,1,1,0,0,0,0,2,2,0,0,0,0,0,0,0,0,0,0
170587,32000,320,0,-2,1,1,0,0,0,0,0,0,0,0,0,0,0,0,0,0,0,0,1,1,0,0,0,0,0,0,0,0,0,0
170620,32000,320,0,-2,1,1,0,0,0,0,0,0,0,0,0,0,0,0,0,0,0,0,1,1,0,0,0,0,0,0,0,0,0,0
170639,32000,320,0,-2,4,3,1,1,1,0,0,0,0,0,0,0,0,0,0,0,0,0,2,1,1,0,0,0,1,1,0,0,0,0
170657,32000,320,0,-2,1,0,1,0,0,0,0,0,0,0,0,0,1,0,1,0,0,0,0,0,0,0,0,0,0,0,0,0,0,0
170675,32000,320,0,-2,4,2,2,0,0,0,0,0,0,1,0,1,0,0,0,0,0,0,3,2,1,0,0,0,0,0,0,0,0,0
170967,32000,320,0,-2,1,1,0,0,0,0,0,0,0,0,0,0,0,0,0,0,0,0,1,1,0,0,0,0,0,0,0,0,0,0
170976,32000,320,0,-2,577,235,342,2,0,2,78,27,51,23,6,17,36,13,23,0,0,0,336,149,187,24,11,13,4,1,3,74,28,46
171100,32000,320,0,-2,48,27,21,0,0,0,4,3,1,2,1,1,3,2,1,0,0,0,34,19,15,0,0,0,0,0,0,5,2,3
171128,32000,320,0,-2,9,8,1,0,0,0,0,0,0,0,0,0,0,0,0,0,0,0,8,8,0,0,0,0,1,0,1,0,0,0
171137,32000,320,0,-2,6,3,3,0,0,0,0,0,0,1,0,1,0,0,0,0,0,0,4,2,2,0,0,0,0,0,0,1,1,0
171146,32000,320,0,-2,6,5,1,0,0,0,0,0,0,0,0,0,0,0,0,0,0,0,5,4,1,0,0,0,0,0,0,1,1,0
171234,32000,320,0,-2,1,1,0,0,0,0,0,0,0,0,0,0,0,0,0,0,0,0,1,1,0,0,0,0,0,0,0,0,0,0
171304,32000,320,0,-2,2,0,2,0,0,0,0,0,0,0,0,0,0,0,0,0,0,0,2,0,2,0,0,0,0,0,0,0,0,0
171395,32000,320,0,-2,2,2,0,0,0,0,0,0,0,0,0,0,0,0,0,0,0,0,2,2,0,0,0,0,0,0,0,0,0,0
171456,32000,320,0,-2,2,1,1,0,0,0,0,0,0,0,0,0,0,0,0,0,0,0,2,1,1,0,0,0,0,0,0,0,0,0
171492,32000,320,0,-2,1,1,0,0,0,0,0,0,0,0,0,0,0,0,0,0,0,0,1,1,0,0,0,0,0,0,0,0,0,0
171535,32000,320,0,-2,2,1,1,0,0,0,1,0,1,0,0,0,0,0,0,0,0,0,1,1,0,0,0,0,0,0,0,0,0,0
171571,32000,320,0,-2,9,7,2,0,0,0,1,0,1,0,0,0,2,2,0,0,0,0,4,3,1,0,0,0,0,0,0,2,2,0
171599,32000,320,0,-2,2,2,0,0,0,0,0,0,0,0,0,0,0,0,0,0,0,0,2,2,0,0,0,0,0,0,0,0,0,0
172051,32000,320,0,-2,3,2,1,0,0,0,0,0,0,0,0,0,0,0,0,0,0,0,3,2,1,0,0,0,0,0,0,0,0,0
172200,32000,320,0,-2,2,2,0,0,0,0,0,0,0,0,0,0,0,0,0,0,0,0,2,2,0,0,0,0,0,0,0,0,0,0
172264,32000,320,0,-2,1,0,1,0,0,0,1,0,1,0,0,0,0,0,0,0,0,0,0,0,0,0,0,0,0,0,0,0,0,0
172334,32000,320,0,-2,1,0,1,0,0,0,0,0,0,0,0,0,0,0,0,0,0,0,1,0,1,0,0,0,0,0,0,0,0,0
172608,32000,320,0,-2,9,7,2,0,0,0,2,1,1,1,1,0,0,0,0,0,0,0,6,5,1,0,0,0,0,0,0,0,0,0
172644,32000,320,0,-2,11,8,3,0,0,0,0,0,0,2,0,2,0,0,0,0,0,0,7,7,0,1,0,1,1,1,0,0,0,0
172671,32000,320,0,-2,1,1,0,0,0,0,0,0,0,0,0,0,0,0,0,0,0,0,1,1,0,0,0,0,0,0,0,0,0,0
172699,32000,320,0,-2,5,5,0,0,0,0,0,0,0,0,0,0,0,0,0,0,0,0,5,5,0,0,0,0,0,0,0,0,0,0
172963,32000,320,0,-2,1,1,0,0,0,0,0,0,0,0,0,0,0,0,0,0,0,0,0,0,0,0,0,0,1,1,0,0,0,0
173063,32000,320,0,-2,1,0,1,0,0,0,0,0,0,0,0,0,0,0,0,0,0,0,1,0,1,0,0,0,0,0,0,0,0,0
173124,32000,320,0,-2,1,0,1,0,0,0,1,0,1,0,0,0,0,0,0,0,0,0,0,0,0,0,0,0,0,0,0,0,0,0
173142,32000,320,0,-2,1,1,0,0,0,0,0,0,0,0,0,0,0,0,0,0,0,0,1,1,0,0,0,0,0,0,0,0,0,0
173160,32000,320,0,-2,8,7,1,0,0,0,0,0,0,0,0,0,0,0,0,0,0,0,8,7,1,0,0,0,0,0,0,0,0,0
173203,32000,320,0,-2,1,1,0,0,0,0,0,0,0,0,0,0,0,0,0,0,0,0,1,1,0,0,0,0,0,0,0,0,0,0
173258,32000,320,0,-2,3,1,2,0,0,0,0,0,0,0,0,0,1,0,1,0,0,0,2,1,1,0,0,0,0,0,0,0,0,0
173300,32000,320,0,-2,2,1,1,0,0,0,0,0,0,0,0,0,0,0,0,0,0,0,2,1,1,0,0,0,0,0,0,0,0,0
173328,32000,320,0,-2,3,0,3,0,0,0,0,0,0,0,0,0,0,0,0,0,0,0,3,0,3,0,0,0,0,0,0,0,0,0
173452,32000,320,0,-2,1,1,0,0,0,0,0,0,0,0,0,0,0,0,0,0,0,0,1,1,0,0,0,0,0,0,0,0,0,0
173665,32000,320,0,-2,3,3,0,0,0,0,0,0,0,1,1,0,0,0,0,0,0,0,1,1,0,1,1,0,0,0,0,0,0,0
173708,32000,320,0,-2,6,4,2,0,0,0,0,0,0,1,0,1,0,0,0,0,0,0,4,3,1,1,1,0,0,0,0,0,0,0
173902,32000,320,0,-2,8,6,2,0,0,0,1,0,1,0,0,0,0,0,0,0,0,0,7,6,1,0,0,0,0,0,0,0,0,0
174020,32000,320,0,-2,1,1,0,0,0,0,0,0,0,0,0,0,0,0,0,0,0,0,0,0,0,1,1,0,0,0,0,0,0,0
174066,32000,320,0,-2,412,146,266,0,0,0,38,8,30,17,7,10,22,9,13,2,0,2,284,102,182,16,10,6,18,5,13,15,5,10
174075,32000,320,0,-2,1,0,1,0,0,0,0,0,0,0,0,0,0,0,0,0,0,0,1,0,1,0,0,0,0,0,0,0,0,0
174127,32000,320,0,-2,2,1,1,0,0,0,1,1,0,0,0,0,0,0,0,0,0,0,1,0,1,0,0,0,0,0,0,0,0,0
174136,32000,320,0,-2,1,1,0,0,0,0,0,0,0,0,0,0,0,0,0,0,0,0,1,1,0,0,0,0,0,0,0,0,0,0
174233,32000,320,0,-2,8,7,1,0,0,0,0,0,0,0,0,0,0,0,0,0,0,0,8,7,1,0,0,0,0,0,0,0,0,0
174251,32000,320,0,-2,1,0,1,0,0,0,0,0,0,0,0,0,0,0,0,0,0,0,1,0,1,0,0,0,0,0,0,0,0,0
174358,32000,320,0,-2,1,1,0,0,0,0,0,0,0,0,0,0,0,0,0,0,0,0,1,1,0,0,0,0,0,0,0,0,0,0
174428,32000,320,0,-2,1,0,1,0,0,0,0,0,0,0,0,0,0,0,0,0,0,0,1,0,1,0,0,0,0,0,0,0,0,0
174437,32000,320,0,-2,1,1,0,0,0,0,0,0,0,0,0,0,0,0,0,0,0,0,1,1,0,0,0,0,0,0,0,0,0,0
174491,32000,320,0,-2,1,1,0,0,0,0,0,0,0,0,0,0,0,0,0,0,0,0,1,1,0,0,0,0,0,0,0,0,0,0
174747,32000,320,0,-2,1,1,0,0,0,0,0,0,0,0,0,0,0,0,0,0,0,0,1,1,0,0,0,0,0,0,0,0,0,0
174756,32000,320,0,-2,1,1,0,0,0,0,0,0,0,0,0,0,0,0,0,0,0,0,1,1,0,0,0,0,0,0,0,0,0,0
174783,32000,320,0,-2,1,1,0,0,0,0,0,0,0,0,0,0,0,0,0,0,0,0,1,1,0,0,0,0,0,0,0,0,0,0
174817,32000,320,0,-2,12,8,4,0,0,0,1,1,0,0,0,0,0,0,0,0,0,0,10,6,4,0,0,0,1,1,0,0,0,0
174844,32000,320,0,-2,1,1,0,0,0,0,0,0,0,0,0,0,0,0,0,0,0,0,1,1,0,0,0,0,0,0,0,0,0,0
174862,32000,320,0,-2,1,1,0,0,0,0,0,0,0,0,0,0,0,0,0,0,0,0,1,1,0,0,0,0,0,0,0,0,0,0
174899,32000,320,0,-2,1,1,0,0,0,0,0,0,0,0,0,0,0,0,0,0,0,0,1,1,0,0,0,0,0,0,0,0,0,0
174914,32000,320,0,-2,7,4,3,0,0,0,1,0,1,1,0,1,0,0,0,0,0,0,5,4,1,0,0,0,0,0,0,0,0,0
175005,32000,320,0,-2,9,4,5,0,0,0,0,0,0,2,0,2,1,0,1,0,0,0,6,4,2,0,0,0,0,0,0,0,0,0
175281,32000,320,0,-2,6,6,0,0,0,0,0,0,0,1,1,0,0,0,0,0,0,0,5,5,0,0,0,0,0,0,0,0,0,0
175315,32000,320,0,-2,1,0,1,0,0,0,0,0,0,1,0,1,0,0,0,0,0,0,0,0,0,0,0,0,0,0,0,0,0,0
175342,32000,320,0,-2,2,2,0,0,0,0,0,0,0,1,1,0,1,1,0,0,0,0,0,0,0,0,0,0,0,0,0,0,0,0
175421,32000,320,0,-2,1,0,1,0,0,0,0,0,0,1,0,1,0,0,0,0,0,0,0,0,0,0,0,0,0,0,0,0,0,0
175430,32000,320,0,-2,1,1,0,0,0,0,0,0,0,0,0,0,0,0,0,0,0,0,1,1,0,0,0,0,0,0,0,0,0,0
175616,32000,320,0,-2,14,8,6,1,0,1,0,0,0,1,1,0,0,0,0,0,0,0,12,7,5,0,0,0,0,0,0,0,0,0
175643,32000,320,0,-2,2,2,0,0,0,0,0,0,0,0,0,0,0,0,0,0,0,0,2,2,0,0,0,0,0,0,0,0,0,0
175786,32000,320,0,-2,4,3,1,0,0,0,0,0,0,3,2,1,0,0,0,0,0,0,0,0,0,0,0,0,1,1,0,0,0,0
175829,32000,320,0,-2,2,1,1,0,0,0,0,0,0,1,0,1,0,0,0,0,0,0,1,1,0,0,0,0,0,0,0,0,0,0
175856,32000,320,0,-2,8,3,5,0,0,0,0,0,0,5,0,5,0,0,0,0,0,0,3,3,0,0,0,0,0,0,0,0,0,0
175935,32000,320,0,-2,4,2,2,0,0,0,0,0,0,1,0,1,0,0,0,0,0,0,3,2,1,0,0,0,0,0,0,0,0,0
175980,32000,320,0,-2,1,0,1,0,0,0,0,0,0,0,0,0,0,0,0,0,0,0,1,0,1,0,0,0,0,0,0,0,0,0
176008,32000,320,0,-2,4,3,1,0,0,0,0,0,0,3,3,0,0,0,0,0,0,0,1,0,1,0,0,0,0,0,0,0,0,0
176017,32000,320,0,-2,121,58,63,0,0,0,9,4,5,31,13,18,1,1,0,0,0,0,47,21,26,1,0,1,3,2,1,29,17,12
176035,32000,320,0,-2,2,1,1,0,0,0,0,0,0,0,0,0,0,0,0,0,0,0,2,1,1,0,0,0,0,0,0,0,0,0
176044,32000,320,0,-2,2,0,2,0,0,0,0,0,0,2,0,2,0,0,0,0,0,0,0,0,0,0,0,0,0,0,0,0,0,0
176053,32000,320,0,-2,4,4,0,0,0,0,0,0,0,0,0,0,0,0,0,0,0,0,2,2,0,0,0,0,2,2,0,0,0,0
176080,32000,320,0,-2,106,75,31,0,0,0,6,3,3,6,4,2,4,2,2,0,0,0,55,40,15,3,2,1,1,0,1,31,24,7
176169,32000,320,0,-2,1,0,1,0,0,0,0,0,0,0,0,0,0,0,0,0,0,0,1,0,1,0,0,0,0,0,0,0,0,0
176178,32000,320,0,-2,3,1,2,0,0,0,0,0,0,0,0,0,0,0,0,0,0,0,3,1,2,0,0,0,0,0,0,0,0,0
176318,32000,320,0,-2,1,1,0,0,0,0,0,0,0,1,1,0,0,0,0,0,0,0,0,0,0,0,0,0,0,0,0,0,0,0
176789,32000,320,0,-2,1,1,0,0,0,0,0,0,0,0,0,0,0,0,0,0,0,0,1,1,0,0,0,0,0,0,0,0,0,0
176947,32000,320,0,-2,3,3,0,0,0,0,0,0,0,0,0,0,0,0,0,0,0,0,3,3,0,0,0,0,0,0,0,0,0,0
177038,32000,320,0,-2,2,1,1,0,0,0,0,0,0,0,0,0,0,0,0,0,0,0,1,0,1,1,1,0,0,0,0,0,0,0
177065,32000,320,0,-2,5,3,2,0,0,0,1,1,0,0,0,0,0,0,0,0,0,0,4,2,2,0,0,0,0,0,0,0,0,0
177092,32000,320,0,-2,2,2,0,0,0,0,0,0,0,0,0,0,0,0,0,0,0,0,2,2,0,0,0,0,0,0,0,0,0,0
177135,32000,320,0,-2,3,3,0,0,0,0,0,0,0,0,0,0,0,0,0,0,0,0,3,3,0,0,0,0,0,0,0,0,0,0
177214,32000,320,0,-2,2,1,1,0,0,0,0,0,0,0,0,0,0,0,0,0,0,0,0,0,0,0,0,0,2,1,1,0,0,0
177418,32000,320,0,-2,1,0,1,0,0,0,0,0,0,0,0,0,0,0,0,0,0,0,1,0,1,0,0,0,0,0,0,0,0,0
177472,32000,320,0,-2,1,1,0,0,0,0,0,0,0,0,0,0,0,0,0,0,0,0,0,0,0,1,1,0,0,0,0,0,0,0
177551,32000,320,0,-2,2,1,1,0,0,0,0,0,0,1,0,1,0,0,0,0,0,0,1,1,0,0,0,0,0,0,0,0,0,0
177676,32000,320,0,-2,4,3,1,0,0,0,0,0,0,0,0,0,0,0,0,0,0,0,4,3,1,0,0,0,0,0,0,0,0,0
177746,32000,320,0,-2,1,0,1,0,0,0,0,0,0,0,0,0,0,0,0,0,0,0,1,0,1,0,0,0,0,0,0,0,0,0
177940,32000,320,0,-2,4,2,2,0,0,0,0,0,0,1,0,1,0,0,0,0,0,0,3,2,1,0,0,0,0,0,0,0,0,0
177968,32000,320,0,-2,7,5,2,0,0,0,1,1,0,0,0,0,0,0,0,0,0,0,5,3,2,0,0,0,0,0,0,1,1,0
177977,32000,320,0,-2,1,1,0,0,0,0,0,0,0,0,0,0,0,0,0,0,0,0,1,1,0,0,0,0,0,0,0,0,0,0
177986,32000,320,0,-2,2,1,1,0,0,0,0,0,0,0,0,0,0,0,0,0,0,0,2,1,1,0,0,0,0,0,0,0,0,0
177995,32000,320,0,-2,5,5,0,0,0,0,2,2,0,0,0,0,1,1,0,0,0,0,2,2,0,0,0,0,0,0,0,0,0,0
178059,32000,320,0,-2,4,1,3,0,0,0,0,0,0,0,0,0,0,0,0,0,0,0,4,1,3,0,0,0,0,0,0,0,0,0
178217,32000,320,0,-2,2,1,1,0,0,0,0,0,0,0,0,0,0,0,0,0,0,0,2,1,1,0,0,0,0,0,0,0,0,0
178244,32000,320,0,-2,1,0,1,0,0,0,1,0,1,0,0,0,0,0,0,0,0,0,0,0,0,0,0,0,0,0,0,0,0,0
178341,32000,320,0,-2,4,4,0,1,1,0,0,0,0,0,0,0,0,0,0,0,0,0,2,2,0,0,0,0,1,1,0,0,0,0
178369,32000,320,0,-2,2,1,1,0,0,0,0,0,0,0,0,0,0,0,0,0,0,0,2,1,1,0,0,0,0,0,0,0,0,0
178387,32000,320,0,-2,3,3,0,0,0,0,0,0,0,0,0,0,0,0,0,0,0,0,1,1,0,0,0,0,2,2,0,0,0,0
178396,32000,320,0,-2,296,146,150,0,0,0,16,5,11,8,1,7,13,7,6,0,0,0,163,80,83,7,2,5,14,5,9,75,46,29
178402,32000,320,0,-2,45,24,21,0,0,0,2,1,1,4,0,4,3,1,2,0,0,0,25,15,10,2,1,1,2,1,1,7,5,2
178411,32000,320,0,-2,28,23,5,1,1,0,2,1,1,0,0,0,2,2,0,0,0,0,9,6,3,0,0,0,0,0,0,14,13,1
178420,32000,320,0,-2,31,13,18,0,0,0,1,1,0,3,2,1,3,0,3,0,0,0,18,6,12,0,0,0,3,1,2,3,3,0
178439,32000,320,0,-2,28,16,12,0,0,0,4,1,3,1,1,0,4,2,2,0,0,0,17,10,7,0,0,0,2,2,0,0,0,0
178448,32000,320,0,-2,2,2,0,0,0,0,0,0,0,0,0,0,0,0,0,0,0,0,2,2,0,0,0,0,0,0,0,0,0,0
178615,32000,320,0,-2,3,1,2,0,0,0,0,0,0,0,0,0,0,0,0,0,0,0,3,1,2,0,0,0,0,0,0,0,0,0
178624,32000,320,0,-2,5,3,2,0,0,0,1,0,1,0,0,0,0,0,0,0,0,0,4,3,1,0,0,0,0,0,0,0,0,0
178721,32000,320,0,-2,1,0,1,0,0,0,0,0,0,0,0,0,0,0,0,0,0,0,1,0,1,0,0,0,0,0,0,0,0,0
179043,32000,320,0,-2,1,1,0,0,0,0,0,0,0,0,0,0,0,0,0,0,0,0,1,1,0,0,0,0,0,0,0,0,0,0
179159,32000,320,0,-2,39,20,19,0,0,0,4,0,4,5,4,1,1,0,1,0,0,0,21,15,6,0,0,0,0,0,0,8,1,7
179308,32000,320,0,-2,5,3,2,0,0,0,0,0,0,3,1,2,0,0,0,0,0,0,2,2,0,0,0,0,0,0,0,0,0,0
179326,32000,320,0,-2,1,1,0,0,0,0,0,0,0,0,0,0,0,0,0,0,0,0,1,1,0,0,0,0,0,0,0,0,0,0
179344,32000,320,0,-2,1,0,1,0,0,0,0,0,0,0,0,0,0,0,0,0,0,0,1,0,1,0,0,0,0,0,0,0,0,0
179548,32000,320,0,-2,1,1,0,0,0,0,0,0,0,0,0,0,0,0,0,0,0,0,1,1,0,0,0,0,0,0,0,0,0,0
179557,32000,320,0,-2,2,2,0,0,0,0,1,1,0,0,0,0,0,0,0,0,0,0,1,1,0,0,0,0,0,0,0,0,0,0
179566,32000,320,0,-2,8,5,3,0,0,0,1,1,0,0,0,0,0,0,0,0,0,0,5,4,1,1,0,1,0,0,0,1,0,1
179715,32000,320,0,-2,1,1,0,0,0,0,0,0,0,0,0,0,0,0,0,0,0,0,1,1,0,0,0,0,0,0,0,0,0,0
179867,32000,320,0,-2,492,223,269,1,1,0,84,40,44,40,16,24,17,10,7,0,0,0,290,124,166,16,11,5,9,8,1,35,13,22
179894,32000,320,0,-2,2,2,0,0,0,0,0,0,0,1,1,0,0,0,0,0,0,0,1,1,0,0,0,0,0,0,0,0,0,0
179946,32000,320,0,-2,3,2,1,0,0,0,0,0,0,0,0,0,0,0,0,0,0,0,3,2,1,0,0,0,0,0,0,0,0,0
179955,32000,320,0,-2,1,1,0,0,0,0,0,0,0,0,0,0,0,0,0,0,0,0,1,1,0,0,0,0,0,0,0,0,0,0
179964,32000,320,0,-2,6,5,1,0,0,0,0,0,0,0,0,0,1,1,0,0,0,0,3,2,1,0,0,0,2,2,0,0,0,0
180106,32000,320,0,-2,3,2,1,0,0,0,0,0,0,0,0,0,0,0,0,0,0,0,2,1,1,0,0,0,1,1,0,0,0,0
180179,32000,320,0,-2,5,3,2,0,0,0,0,0,0,0,0,0,0,0,0,0,0,0,5,3,2,0,0,0,0,0,0,0,0,0
180197,32000,320,0,-2,3,1,2,0,0,0,1,0,1,0,0,0,0,0,0,0,0,0,2,1,1,0,0,0,0,0,0,0,0,0
180416,32000,320,0,-2,2,1,1,0,0,0,0,0,0,0,0,0,0,0,0,0,0,0,2,1,1,0,0,0,0,0,0,0,0,0
180461,32000,320,0,-2,22,15,7,0,0,0,0,0,0,0,0,0,2,2,0,0,0,0,15,10,5,2,0,2,3,3,0,0,0,0
180489,32000,320,0,-2,32,19,13,0,0,0,3,1,2,0,0,0,0,0,0,0,0,0,29,18,11,0,0,0,0,0,0,0,0,0
180595,32000,320,0,-2,2,0,2,0,0,0,0,0,0,0,0,0,0,0,0,0,0,0,2,0,2,0,0,0,0,0,0,0,0,0
180647,32000,320,0,-2,1,0,1,1,0,1,0,0,0,0,0,0,0,0,0,0,0,0,0,0,0,0,0,0,0,0,0,0,0,0
180692,32000,320,0,-2,1,0,1,0,0,0,0,0,0,0,0,0,0,0,0,0,0,0,1,0,1,0,0,0,0,0,0,0,0,0
180814,32000,320,0,-2,3,3,0,0,0,0,0,0,0,0,0,0,0,0,0,0,0,0,2,2,0,0,0,0,1,1,0,0,0,0
180832,32000,320,0,-2,1,1,0,0,0,0,0,0,0,0,0,0,0,0,0,0,0,0,1,1,0,0,0,0,0,0,0,0,0,0
180984,32000,320,0,-2,1,0,1,0,0,0,0,0,0,0,0,0,0,0,0,0,0,0,1,0,1,0,0,0,0,0,0,0,0,0
181002,32000,320,0,-2,19,14,5,0,0,0,7,3,4,1,1,0,0,0,0,0,0,0,6,5,1,0,0,0,5,5,0,0,0,0
181020,32000,320,0,-2,3,3,0,0,0,0,0,0,0,0,0,0,0,0,0,0,0,0,2,2,0,1,1,0,0,0,0,0,0,0
181127,32000,320,0,-2,4,3,1,0,0,0,0,0,0,0,0,0,0,0,0,0,0,0,4,3,1,0,0,0,0,0,0,0,0,0
181215,32000,320,0,-2,2,0,2,0,0,0,0,0,0,0,0,0,0,0,0,0,0,0,0,0,0,0,0,0,0,0,0,2,0,2
181303,32000,320,0,-2,6,4,2,0,0,0,0,0,0,0,0,0,1,1,0,0,0,0,4,2,2,0,0,0,1,1,0,0,0,0
181330,32000,320,0,-2,1,1,0,0,0,0,0,0,0,0,0,0,0,0,0,0,0,0,1,1,0,0,0,0,0,0,0,0,0,0
181394,32000,320,0,-2,1,1,0,0,0,0,0,0,0,0,0,0,0,0,0,0,0,0,1,1,0,0,0,0,0,0,0,0,0,0
181419,32000,320,0,-2,1,1,0,1,1,0,0,0,0,0,0,0,0,0,0,0,0,0,0,0,0,0,0,0,0,0,0,0,0,0
181428,32000,320,0,-2,144,72,72,0,0,0,14,5,9,3,0,3,5,1,4,0,0,0,74,36,38,5,0,5,1,1,0,42,29,13
181446,32000,320,0,-2,1,1,0,0,0,0,0,0,0,0,0,0,0,0,0,0,0,0,1,1,0,0,0,0,0,0,0,0,0,0
181464,32000,320,0,-2,53,26,27,0,0,0,3,1,2,1,1,0,4,1,3,0,0,0,43,23,20,0,0,0,1,0,1,1,0,1
181491,32000,320,0,-2,1,1,0,0,0,0,0,0,0,0,0,0,0,0,0,0,0,0,1,1,0,0,0,0,0,0,0,0,0,0
181534,32000,320,0,-2,2,2,0,0,0,0,0,0,0,0,0,0,0,0,0,0,0,0,2,2,0,0,0,0,0,0,0,0,0,0
181604,32000,320,0,-2,1,0,1,0,0,0,0,0,0,0,0,0,0,0,0,0,0,0,1,0,1,0,0,0,0,0,0,0,0,0
181640,32000,320,0,-2,2,2,0,0,0,0,0,0,0,0,0,0,0,0,0,0,0,0,2,2,0,0,0,0,0,0,0,0,0,0
181738,32000,320,0,-2,3,3,0,0,0,0,0,0,0,0,0,0,0,0,0,0,0,0,3,3,0,0,0,0,0,0,0,0,0,0
181747,32000,320,0,-2,15,12,3,0,0,0,3,2,1,2,0,2,1,1,0,0,0,0,7,7,0,1,1,0,0,0,0,1,1,0
181783,32000,320,0,-2,4,2,2,0,0,0,0,0,0,0,0,0,0,0,0,0,0,0,4,2,2,0,0,0,0,0,0,0,0,0
181817,32000,320,0,-2,1,1,0,0,0,0,0,0,0,0,0,0,0,0,0,0,0,0,1,1,0,0,0,0,0,0,0,0,0,0
182005,32000,320,0,-2,7,3,4,0,0,0,0,0,0,1,0,1,3,1,2,0,0,0,2,1,1,1,1,0,0,0,0,0,0,0
182281,32000,320,0,-2,14,10,4,0,0,0,3,2,1,2,1,1,1,0,1,0,0,0,6,5,1,2,2,0,0,0,0,0,0,0
182290,32000,320,0,-2,39,20,19,0,0,0,5,1,4,0,0,0,8,3,5,0,0,0,23,14,9,2,1,1,0,0,0,1,1,0
182306,32000,320,0,-2,1,1,0,0,0,0,0,0,0,0,0,0,1,1,0,0,0,0,0,0,0,0,0,0,0,0,0,0,0,0
182634,32000,320,0,-2,2,2,0,0,0,0,0,0,0,0,0,0,0,0,0,0,0,0,2,2,0,0,0,0,0,0,0,0,0,0
182670,32000,320,0,-2,118,50,68,0,0,0,2,0,2,2,1,1,2,1,1,0,0,0,83,36,47,0,0,0,0,0,0,29,12,17
182795,32000,320,0,-2,3,3,0,0,0,0,0,0,0,1,1,0,0,0,0,0,0,0,2,2,0,0,0,0,0,0,0,0,0,0
182980,32000,320,0,-2,2,2,0,0,0,0,1,1,0,0,0,0,0,0,0,0,0,0,1,1,0,0,0,0,0,0,0,0,0,0
183026,32000,320,0,-2,20,15,5,0,0,0,2,0,2,1,0,1,0,0,0,0,0,0,12,12,0,1,1,0,4,2,2,0,0,0
183044,32000,320,0,-2,42,29,13,0,0,0,1,0,1,0,0,0,1,1,0,0,0,0,32,23,9,0,0,0,5,2,3,3,3,0
183062,32000,320,0,-2,10,6,4,0,0,0,1,0,1,0,0,0,0,0,0,0,0,0,6,3,3,0,0,0,2,2,0,1,1,0
183080,32000,320,0,-2,1,1,0,0,0,0,0,0,0,0,0,0,0,0,0,0,0,0,1,1,0,0,0,0,0,0,0,0,0,0
183099,32000,320,0,-2,3,3,0,0,0,0,0,0,0,0,0,0,0,0,0,0,0,0,3,3,0,0,0,0,0,0,0,0,0,0
183211,32000,320,0,-2,2,0,2,0,0,0,0,0,0,0,0,0,0,0,0,0,0,0,2,0,2,0,0,0,0,0,0,0,0,0
183239,32000,320,0,-2,3,2,1,0,0,0,1,0,1,0,0,0,0,0,0,0,0,0,2,2,0,0,0,0,0,0,0,0,0,0
183655,32000,320,0,-2,4,2,2,0,0,0,1,0,1,1,1,0,0,0,0,0,0,0,2,1,1,0,0,0,0,0,0,0,0,0
183743,32000,320,0,-2,1,1,0,0,0,0,0,0,0,0,0,0,0,0,0,0,0,0,1,1,0,0,0,0,0,0,0,0,0,0
183910,32000,320,0,-2,1,0,1,0,0,0,0,0,0,0,0,0,0,0,0,0,0,0,1,0,1,0,0,0,0,0,0,0,0,0
183938,32000,320,0,-2,2,2,0,0,0,0,0,0,0,0,0,0,1,1,0,0,0,0,1,1,0,0,0,0,0,0,0,0,0,0
184205,32000,320,0,-2,2,2,0,0,0,0,0,0,0,0,0,0,0,0,0,0,0,0,2,2,0,0,0,0,0,0,0,0,0,0
184603,32000,320,0,-2,2,2,0,0,0,0,0,0,0,0,0,0,0,0,0,0,0,0,2,2,0,0,0,0,0,0,0,0,0,0
184612,32000,320,0,-2,2,2,0,0,0,0,0,0,0,0,0,0,1,1,0,0,0,0,1,1,0,0,0,0,0,0,0,0,0,0
184773,32000,320,0,-2,2,1,1,0,0,0,0,0,0,0,0,0,0,0,0,0,0,0,1,0,1,1,1,0,0,0,0,0,0,0
184782,32000,320,0,-2,16,8,8,0,0,0,1,1,0,3,2,1,0,0,0,0,0,0,10,5,5,1,0,1,0,0,0,1,0,1
184791,32000,320,0,-2,1,0,1,0,0,0,1,0,1,0,0,0,0,0,0,0,0,0,0,0,0,0,0,0,0,0,0,0,0,0
184995,32000,320,0,-2,2,2,0,0,0,0,0,0,0,0,0,0,1,1,0,0,0,0,1,1,0,0,0,0,0,0,0,0,0,0
185129,32000,320,0,-2,3,2,1,0,0,0,0,0,0,1,0,1,2,2,0,0,0,0,0,0,0,0,0,0,0,0,0,0,0,0
185262,32000,320,0,-2,3,1,2,0,0,0,0,0,0,0,0,0,2,0,2,0,0,0,1,1,0,0,0,0,0,0,0,0,0,0
185536,32000,320,0,-2,1,1,0,0,0,0,0,0,0,0,0,0,0,0,0,0,0,0,1,1,0,0,0,0,0,0,0,0,0,0
185572,32000,320,0,-2,2,1,1,0,0,0,0,0,0,0,0,0,0,0,0,0,0,0,2,1,1,0,0,0,0,0,0,0,0,0
185590,32000,320,0,-2,3,2,1,0,0,0,1,1,0,0,0,0,0,0,0,0,0,0,2,1,1,0,0,0,0,0,0,0,0,0
185828,32000,320,0,-2,13,8,5,0,0,0,4,2,2,1,0,1,0,0,0,0,0,0,5,3,2,0,0,0,2,2,0,1,1,0
185873,32000,320,0,-2,1,1,0,0,0,0,0,0,0,0,0,0,0,0,0,0,0,0,1,1,0,0,0,0,0,0,0,0,0,0
186034,32000,320,0,-2,1,1,0,0,0,0,1,1,0,0,0,0,0,0,0,0,0,0,0,0,0,0,0,0,0,0,0,0,0,0
186131,32000,320,0,-2,255,155,100,1,1,0,14,6,8,14,6,8,9,6,3,0,0,0,76,36,40,3,1,2,6,5,1,132,94,38
186201,32000,320,0,-2,1,0,1,0,0,0,0,0,0,0,0,0,0,0,0,0,0,0,1,0,1,0,0,0,0,0,0,0,0,0
186283,32000,320,0,-2,4,2,2,0,0,0,1,1,0,1,0,1,0,0,0,0,0,0,0,0,0,0,0,0,0,0,0,2,1,1
186371,32000,320,0,-2,3,2,1,0,0,0,0,0,0,0,0,0,0,0,0,0,0,0,0,0,0,0,0,0,3,2,1,0,0,0
186380,32000,320,0,-2,241,112,129,0,0,0,11,4,7,1,0,1,6,3,3,0,0,0,18,11,7,4,2,2,124,54,70,77,38,39
186399,32000,320,0,-2,3,1,2,0,0,0,0,0,0,0,0,0,0,0,0,0,0,0,1,0,1,1,1,0,1,0,1,0,0,0
186432,32000,320,0,-2,1,1,0,0,0,0,1,1,0,0,0,0,0,0,0,0,0,0,0,0,0,0,0,0,0,0,0,0,0,0
186584,32000,320,0,-2,7,4,3,0,0,0,1,1,0,3,2,1,2,1,1,0,0,0,1,0,1,0,0,0,0,0,0,0,0,0
186618,32000,320,0,-2,2,2,0,0,0,0,0,0,0,1,1,0,0,0,0,0,0,0,1,1,0,0,0,0,0,0,0,0,0,0
186867,32000,320,0,-2,3,2,1,0,0,0,1,1,0,0,0,0,1,1,0,0,0,0,0,0,0,0,0,0,1,0,1,0,0,0
186876,32000,320,0,-2,4,3,1,0,0,0,0,0,0,0,0,0,1,1,0,0,0,0,3,2,1,0,0,0,0,0,0,0,0,0
187046,32000,320,0,-2,1,1,0,0,0,0,0,0,0,0,0,0,0,0,0,0,0,0,1,1,0,0,0,0,0,0,0,0,0,0
187134,32000,320,0,-2,1,1,0,0,0,0,0,0,0,0,0,0,0,0,0,0,0,0,1,1,0,0,0,0,0,0,0,0,0,0
187444,32000,320,0,-2,2,2,0,0,0,0,0,0,0,0,0,0,0,0,0,0,0,0,1,1,0,1,1,0,0,0,0,0,0,0
187532,32000,320,0,-2,7,2,5,0,0,0,0,0,0,0,0,0,2,0,2,0,0,0,3,1,2,1,0,1,1,1,0,0,0,0
187596,32000,320,0,-2,1,1,0,0,0,0,0,0,0,1,1,0,0,0,0,0,0,0,0,0,0,0,0,0,0,0,0,0,0,0
187639,32000,320,0,-2,2,0,2,0,0,0,1,0,1,0,0,0,1,0,1,0,0,0,0,0,0,0,0,0,0,0,0,0,0,0
187648,32000,320,0,-2,4,3,1,0,0,0,0,0,0,0,0,0,1,1,0,0,0,0,3,2,1,0,0,0,0,0,0,0,0,0
187666,32000,320,0,-2,4,4,0,0,0,0,0,0,0,0,0,0,3,3,0,0,0,0,1,1,0,0,0,0,0,0,0,0,0,0
187897,32000,320,0,-2,1,0,1,0,0,0,0,0,0,0,0,0,1,0,1,0,0,0,0,0,0,0,0,0,0,0,0,0,0,0
187912,32000,320,0,-2,1,1,0,0,0,0,0,0,0,0,0,0,1,1,0,0,0,0,0,0,0,0,0,0,0,0,0,0,0,0
187967,32000,320,0,-2,23,14,9,0,0,0,2,1,1,0,0,0,4,3,1,0,0,0,15,9,6,0,0,0,0,0,0,2,1,1
187985,32000,320,0,-2,40,27,13,0,0,0,0,0,0,2,2,0,14,11,3,0,0,0,20,11,9,1,0,1,0,0,0,3,3,0
188030,32000,320,0,-2,34,15,19,0,0,0,0,0,0,0,0,0,5,3,2,0,0,0,23,8,15,0,0,0,0,0,0,6,4,2
188058,32000,320,0,-2,1,1,0,0,0,0,0,0,0,0,0,0,0,0,0,0,0,0,0,0,0,0,0,0,1,1,0,0,0,0
188100,32000,320,0,-2,2,2,0,1,1,0,0,0,0,0,0,0,1,1,0,0,0,0,0,0,0,0,0,0,0,0,0,0,0,0
188137,32000,320,0,-2,2,2,0,0,0,0,0,0,0,0,0,0,2,2,0,0,0,0,0,0,0,0,0,0,0,0,0,0,0,0
188304,32000,320,0,-2,6,5,1,0,0,0,1,0,1,0,0,0,2,2,0,0,0,0,3,3,0,0,0,0,0,0,0,0,0,0
188429,32000,320,0,-2,4,3,1,0,0,0,0,0,0,0,0,0,1,1,0,0,0,0,3,2,1,0,0,0,0,0,0,0,0,0
188438,32000,320,0,-2,2,2,0,0,0,0,0,0,0,0,0,0,0,0,0,0,0,0,2,2,0,0,0,0,0,0,0,0,0,0
188517,32000,320,0,-2,1,1,0,0,0,0,0,0,0,0,0,0,0,0,0,0,0,0,1,1,0,0,0,0,0,0,0,0,0,0
188580,32000,320,0,-2,1,1,0,0,0,0,0,0,0,0,0,0,0,0,0,0,0,0,1,1,0,0,0,0,0,0,0,0,0,0
188641,32000,320,0,-2,2,2,0,0,0,0,0,0,0,0,0,0,0,0,0,0,0,0,2,2,0,0,0,0,0,0,0,0,0,0
188854,32000,320,0,-2,1,1,0,0,0,0,0,0,0,1,1,0,0,0,0,0,0,0,0,0,0,0,0,0,0,0,0,0,0,0
189015,32000,320,0,-2,1,0,1,0,0,0,0,0,0,0,0,0,0,0,0,0,0,0,1,0,1,0,0,0,0,0,0,0,0,0
189088,32000,320,0,-2,1,1,0,0,0,0,0,0,0,0,0,0,0,0,0,0,0,0,1,1,0,0,0,0,0,0,0,0,0,0
189097,32000,320,0,-2,8,4,4,0,0,0,1,0,1,2,2,0,1,0,1,0,0,0,3,2,1,0,0,0,1,0,1,0,0,0
189592,32000,320,0,-2,1,1,0,0,0,0,0,0,0,0,0,0,0,0,0,0,0,0,1,1,0,0,0,0,0,0,0,0,0,0
189705,32000,320,0,-2,1,1,0,0,0,0,0,0,0,0,0,0,0,0,0,0,0,0,1,1,0,0,0,0,0,0,0,0,0,0
190035,32000,320,0,-2,2,2,0,0,0,0,1,1,0,0,0,0,0,0,0,0,0,0,1,1,0,0,0,0,0,0,0,0,0,0
190044,32000,320,0,-2,1,1,0,0,0,0,0,0,0,0,0,0,0,0,0,0,0,0,1,1,0,0,0,0,0,0,0,0,0,0
190099,32000,320,0,-2,5,1,4,0,0,0,0,0,0,2,0,2,0,0,0,0,0,0,3,1,2,0,0,0,0,0,0,0,0,0
190150,32000,320,0,-2,321,134,187,1,1,0,58,26,32,39,22,17,74,29,45,0,0,0,98,38,60,12,5,7,4,1,3,35,12,23
190415,32000,320,0,-2,51,25,26,0,0,0,6,2,4,2,1,1,4,3,1,0,0,0,39,19,20,0,0,0,0,0,0,0,0,0
190424,32000,320,0,-2,262,104,158,1,1,0,71,32,39,28,7,21,35,14,21,1,1,0,90,37,53,0,0,0,1,0,1,35,12,23
190512,32000,320,0,-2,1,1,0,0,0,0,1,1,0,0,0,0,0,0,0,0,0,0,0,0,0,0,0,0,0,0,0,0,0,0
190521,32000,320,0,-2,2,0,2,0,0,0,1,0,1,1,0,1,0,0,0,0,0,0,0,0,0,0,0,0,0,0,0,0,0,0
190549,32000,320,0,-2,4,2,2,0,0,0,0,0,0,1,1,0,1,0,1,0,0,0,2,1,1,0,0,0,0,0,0,0,0,0
190567,32000,320,0,-2,4,4,0,0,0,0,3,3,0,0,0,0,1,1,0,0,0,0,0,0,0,0,0,0,0,0,0,0,0,0
190576,32000,320,0,-2,17,9,8,0,0,0,3,0,3,3,1,2,3,2,1,0,0,0,7,5,2,0,0,0,0,0,0,1,1,0
190585,32000,320,0,-2,1,1,0,0,0,0,0,0,0,0,0,0,1,1,0,0,0,0,0,0,0,0,0,0,0,0,0,0,0,0
190594,32000,320,0,-2,5,3,2,0,0,0,1,0,1,1,1,0,3,2,1,0,0,0,0,0,0,0,0,0,0,0,0,0,0,0
190600,32000,320,0,-2,1,1,0,0,0,0,1,1,0,0,0,0,0,0,0,0,0,0,0,0,0,0,0,0,0,0,0,0,0,0
190619,32000,320,0,-2,1,1,0,0,0,0,0,0,0,0,0,0,0,0,0,0,0,0,1,1,0,0,0,0,0,0,0,0,0,0
190628,32000,320,0,-2,1,0,1,0,0,0,0,0,0,0,0,0,1,0,1,0,0,0,0,0,0,0,0,0,0,0,0,0,0,0
190637,32000,320,0,-2,2,1,1,0,0,0,1,1,0,0,0,0,1,0,1,0,0,0,0,0,0,0,0,0,0,0,0,0,0,0
190655,32000,320,0,-2,1,1,0,0,0,0,1,1,0,0,0,0,0,0,0,0,0,0,0,0,0,0,0,0,0,0,0,0,0,0
190664,32000,320,0,-2,2,1,1,0,0,0,0,0,0,0,0,0,0,0,0,0,0,0,2,1,1,0,0,0,0,0,0,0,0,0
190673,32000,320,0,-2,2,1,1,0,0,0,1,0,1,0,0,0,0,0,0,0,0,0,1,1,0,0,0,0,0,0,0,0,0,0
190716,32000,320,0,-2,2,1,1,0,0,0,0,0,0,0,0,0,0,0,0,0,0,0,2,1,1,0,0,0,0,0,0,0,0,0
190725,32000,320,0,-2,2,1,1,0,0,0,0,0,0,0,0,0,1,1,0,0,0,0,1,0,1,0,0,0,0,0,0,0,0,0
190840,32000,320,0,-2,2,2,0,0,0,0,0,0,0,0,0,0,1,1,0,0,0,0,0,0,0,0,0,0,1,1,0,0,0,0
190983,32000,320,0,-2,3,2,1,0,0,0,0,0,0,0,0,0,1,0,1,0,0,0,2,2,0,0,0,0,0,0,0,0,0,0
191241,32000,320,0,-2,2,1,1,0,0,0,0,0,0,0,0,0,1,1,0,0,0,0,1,0,1,0,0,0,0,0,0,0,0,0
191515,32000,320,0,-2,1,0,1,0,0,0,0,0,0,0,0,0,0,0,0,0,0,0,1,0,1,0,0,0,0,0,0,0,0,0
191621,32000,320,0,-2,1,0,1,0,0,0,0,0,0,0,0,0,0,0,0,0,0,0,1,0,1,0,0,0,0,0,0,0,0,0
191630,32000,320,0,-2,16,8,8,0,0,0,0,0,0,1,0,1,0,0,0,0,0,0,14,8,6,0,0,0,1,0,1,0,0,0
191649,32000,320,0,-2,2,0,2,0,0,0,0,0,0,0,0,0,0,0,0,0,0,0,1,0,1,0,0,0,0,0,0,1,0,1
191719,32000,320,0,-2,2,1,1,0,0,0,0,0,0,0,0,0,0,0,0,0,0,0,2,1,1,0,0,0,0,0,0,0,0,0
191931,32000,320,0,-2,1,1,0,0,0,0,1,1,0,0,0,0,0,0,0,0,0,0,0,0,0,0,0,0,0,0,0,0,0,0
191968,32000,320,0,-2,6,4,2,0,0,0,0,0,0,0,0,0,0,0,0,0,0,0,0,0,0,0,0,0,6,4,2,0,0,0
192022,32000,320,0,-2,2,1,1,0,0,0,0,0,0,0,0,0,0,0,0,0,0,0,2,1,1,0,0,0,0,0,0,0,0,0
192040,32000,320,0,-2,1,1,0,0,0,0,0,0,0,1,1,0,0,0,0,0,0,0,0,0,0,0,0,0,0,0,0,0,0,0
192192,32000,320,0,-2,3,3,0,0,0,0,1,1,0,0,0,0,0,0,0,0,0,0,2,2,0,0,0,0,0,0,0,0,0,0
192448,32000,320,0,-2,9,6,3,0,0,0,3,3,0,0,0,0,1,0,1,0,0,0,3,1,2,1,1,0,1,1,0,0,0,0
192712,32000,320,0,-2,1,1,0,0,0,0,0,0,0,0,0,0,1,1,0,0,0,0,0,0,0,0,0,0,0,0,0,0,0,0
192785,32000,320,0,-2,1,1,0,0,0,0,0,0,0,0,0,0,0,0,0,0,0,0,1,1,0,0,0,0,0,0,0,0,0,0
192819,32000,320,0,-2,4,2,2,0,0,0,0,0,0,0,0,0,1,1,0,0,0,0,3,1,2,0,0,0,0,0,0,0,0,0
192864,32000,320,0,-2,1,0,1,0,0,0,0,0,0,0,0,0,0,0,0,0,0,0,1,0,1,0,0,0,0,0,0,0,0,0
193016,32000,320,0,-2,2,2,0,0,0,0,1,1,0,1,1,0,0,0,0,0,0,0,0,0,0,0,0,0,0,0,0,0,0,0
193283,32000,320,0,-2,1,1,0,0,0,0,0,0,0,0,0,0,0,0,0,0,0,0,1,1,0,0,0,0,0,0,0,0,0,0
193292,32000,320,0,-2,2,1,1,0,0,0,0,0,0,1,0,1,1,1,0,0,0,0,0,0,0,0,0,0,0,0,0,0,0,0
193308,32000,320,0,-2,10,5,5,0,0,0,0,0,0,5,0,5,4,4,0,0,0,0,1,1,0,0,0,0,0,0,0,0,0,0
193326,32000,320,0,-2,2,1,1,0,0,0,0,0,0,0,0,0,0,0,0,0,0,0,2,1,1,0,0,0,0,0,0,0,0,0
193405,32000,320,0,-2,442,148,294,0,0,0,41,10,31,10,2,8,70,26,44,0,0,0,42,13,29,4,1,3,254,87,167,21,9,12
193584,32000,320,0,-2,1,1,0,0,0,0,0,0,0,0,0,0,0,0,0,0,0,0,1,1,0,0,0,0,0,0,0,0,0,0
193654,32000,320,0,-2,5,5,0,0,0,0,1,1,0,0,0,0,2,2,0,0,0,0,1,1,0,0,0,0,0,0,0,1,1,0
193900,32000,320,0,-2,53,37,16,0,0,0,17,14,3,7,6,1,5,4,1,0,0,0,14,9,5,0,0,0,2,1,1,8,3,5
193973,32000,320,0,-2,4,1,3,0,0,0,0,0,0,0,0,0,1,0,1,0,0,0,2,0,2,0,0,0,1,1,0,0,0,0
194028,32000,320,0,-2,1,1,0,0,0,0,0,0,0,0,0,0,0,0,0,0,0,0,1,1,0,0,0,0,0,0,0,0,0,0
194073,32000,320,0,-2,3,2,1,0,0,0,0,0,0,1,0,1,1,1,0,0,0,0,1,1,0,0,0,0,0,0,0,0,0,0
194091,32000,320,0,-2,11,5,6,0,0,0,2,1,1,0,0,0,2,1,1,0,0,0,5,2,3,0,0,0,0,0,0,2,1,1
194310,32000,320,0,-2,11,5,6,0,0,0,1,1,0,1,0,1,2,1,1,0,0,0,7,3,4,0,0,0,0,0,0,0,0,0
194392,32000,320,0,-2,2,1,1,0,0,0,0,0,0,0,0,0,0,0,0,0,0,0,2,1,1,0,0,0,0,0,0,0,0,0
194578,32000,320,0,-2,3,3,0,0,0,0,2,2,0,0,0,0,0,0,0,0,0,0,1,1,0,0,0,0,0,0,0,0,0,0
194824,32000,320,0,-2,6,6,0,0,0,0,1,1,0,2,2,0,0,0,0,0,0,0,3,3,0,0,0,0,0,0,0,0,0,0
194958,32000,320,0,-2,1,0,1,0,0,0,0,0,0,0,0,0,0,0,0,0,0,0,1,0,1,0,0,0,0,0,0,0,0,0
195003,32000,320,0,-2,39,28,11,0,0,0,6,5,1,5,3,2,2,1,1,0,0,0,21,16,5,0,0,0,1,0,1,4,3,1
195030,32000,320,0,-2,230,127,103,0,0,0,16,5,11,8,6,2,13,8,5,0,0,0,164,95,69,7,2,5,0,0,0,22,11,11
195049,32000,320,0,-2,59,21,38,0,0,0,16,5,11,3,1,2,5,0,5,0,0,0,25,10,15,2,1,1,0,0,0,8,4,4
195128,32000,320,0,-2,1,1,0,0,0,0,0,0,0,0,0,0,0,0,0,0,0,0,1,1,0,0,0,0,0,0,0,0,0,0
195216,32000,320,0,-2,4,4,0,0,0,0,1,1,0,0,0,0,0,0,0,0,0,0,3,3,0,0,0,0,0,0,0,0,0,0
195234,32000,320,0,-2,5,4,1,0,0,0,1,1,0,0,0,0,0,0,0,0,0,0,3,2,1,0,0,0,0,0,0,1,1,0
195304,32000,320,0,-2,3,1,2,0,0,0,1,0,1,0,0,0,1,1,0,0,0,0,0,0,0,1,0,1,0,0,0,0,0,0
195474,32000,320,0,-2,1,0,1,1,0,1,0,0,0,0,0,0,0,0,0,0,0,0,0,0,0,0,0,0,0,0,0,0,0,0
195526,32000,320,0,-2,4,0,4,0,0,0,1,0,1,0,0,0,0,0,0,0,0,0,3,0,3,0,0,0,0,0,0,0,0,0
195544,32000,320,0,-2,2,2,0,0,0,0,0,0,0,0,0,0,0,0,0,0,0,0,1,1,0,0,0,0,1,1,0,0,0,0
195720,32000,320,0,-2,4,4,0,0,0,0,0,0,0,1,1,0,0,0,0,0,0,0,2,2,0,0,0,0,1,1,0,0,0,0
195809,32000,320,0,-2,6,3,3,0,0,0,1,0,1,0,0,0,1,0,1,0,0,0,4,3,1,0,0,0,0,0,0,0,0,0
195827,32000,320,0,-2,3,3,0,0,0,0,0,0,0,0,0,0,0,0,0,0,0,0,3,3,0,0,0,0,0,0,0,0,0,0
195988,32000,320,0,-2,1,1,0,0,0,0,1,1,0,0,0,0,0,0,0,0,0,0,0,0,0,0,0,0,0,0,0,0,0,0
196006,32000,320,0,-2,5,3,2,0,0,0,0,0,0,0,0,0,1,0,1,0,0,0,4,3,1,0,0,0,0,0,0,0,0,0
196024,32000,320,0,-2,1,1,0,0,0,0,1,1,0,0,0,0,0,0,0,0,0,0,0,0,0,0,0,0,0,0,0,0,0,0
196033,32000,320,0,-2,3,2,1,0,0,0,0,0,0,0,0,0,2,1,1,0,0,0,1,1,0,0,0,0,0,0,0,0,0,0
196042,32000,320,0,-2,1,0,1,0,0,0,0,0,0,0,0,0,0,0,0,0,0,0,1,0,1,0,0,0,0,0,0,0,0,0
196060,32000,320,0,-2,4,2,2,0,0,0,0,0,0,0,0,0,0,0,0,0,0,0,3,1,2,0,0,0,0,0,0,1,1,0
196079,32000,320,0,-2,13,7,6,0,0,0,0,0,0,3,2,1,0,0,0,0,0,0,4,2,2,0,0,0,0,0,0,6,3,3
196088,32000,320,0,-2,4,3,1,0,0,0,1,1,0,0,0,0,0,0,0,0,0,0,2,2,0,0,0,0,0,0,0,1,0,1
196097,32000,320,0,-2,23,16,7,0,0,0,1,1,0,0,0,0,5,3,2,0,0,0,13,9,4,0,0,0,1,0,1,3,3,0
196103,32000,320,0,-2,7,6,1,0,0,0,1,1,0,1,1,0,0,0,0,0,0,0,4,4,0,0,0,0,0,0,0,1,0,1
196121,32000,320,0,-2,1,1,0,0,0,0,0,0,0,0,0,0,0,0,0,0,0,0,1,1,0,0,0,0,0,0,0,0,0,0
196130,32000,320,0,-2,3,2,1,0,0,0,0,0,0,0,0,0,0,0,0,0,0,0,3,2,1,0,0,0,0,0,0,0,0,0
196149,32000,320,0,-2,3,1,2,0,0,0,0,0,0,0,0,0,0,0,0,0,0,0,3,1,2,0,0,0,0,0,0,0,0,0
196176,32000,320,0,-2,2,2,0,0,0,0,0,0,0,0,0,0,0,0,0,0,0,0,2,2,0,0,0,0,0,0,0,0,0,0
196185,32000,320,0,-2,9,5,4,0,0,0,1,0,1,2,2,0,0,0,0,0,0,0,6,3,3,0,0,0,0,0,0,0,0,0
196219,32000,320,0,-2,1,1,0,0,0,0,0,0,0,0,0,0,1,1,0,0,0,0,0,0,0,0,0,0,0,0,0,0,0,0
196237,32000,320,0,-2,2,1,1,0,0,0,0,0,0,1,1,0,1,0,1,0,0,0,0,0,0,0,0,0,0,0,0,0,0,0
196246,32000,320,0,-2,1,1,0,0,0,0,0,0,0,0,0,0,0,0,0,0,0,0,1,1,0,0,0,0,0,0,0,0,0,0
196255,32000,320,0,-2,6,3,3,0,0,0,3,3,0,1,0,1,1,0,1,0,0,0,0,0,0,0,0,0,0,0,0,1,0,1
196264,32000,320,0,-2,5,4,1,0,0,0,0,0,0,1,1,0,0,0,0,0,0,0,4,3,1,0,0,0,0,0,0,0,0,0
196291,32000,320,0,-2,1,1,0,0,0,0,0,0,0,0,0,0,0,0,0,0,0,0,1,1,0,0,0,0,0,0,0,0,0,0
196307,32000,320,0,-2,4,2,2,0,0,0,0,0,0,0,0,0,1,0,1,0,0,0,3,2,1,0,0,0,0,0,0,0,0,0
196413,32000,320,0,-2,26,13,13,0,0,0,3,2,1,3,0,3,1,1,0,0,0,0,17,9,8,1,1,0,0,0,0,1,0,1
196468,32000,320,0,-2,1,0,1,0,0,0,0,0,0,0,0,0,1,0,1,0,0,0,0,0,0,0,0,0,0,0,0,0,0,0
196565,32000,320,0,-2,1,1,0,0,0,0,0,0,0,0,0,0,0,0,0,0,0,0,1,1,0,0,0,0,0,0,0,0,0,0
196592,32000,320,0,-2,15,11,4,0,0,0,4,2,2,0,0,0,2,2,0,0,0,0,8,6,2,0,0,0,1,1,0,0,0,0
196653,32000,320,0,-2,1,0,1,0,0,0,0,0,0,0,0,0,0,0,0,0,0,0,1,0,1,0,0,0,0,0,0,0,0,0
196680,32000,320,0,-2,7,7,0,0,0,0,0,0,0,2,2,0,0,0,0,0,0,0,5,5,0,0,0,0,0,0,0,0,0,0
196699,32000,320,0,-2,3,3,0,0,0,0,0,0,0,0,0,0,0,0,0,0,0,0,3,3,0,0,0,0,0,0,0,0,0,0
196866,32000,320,0,-2,5,3,2,1,1,0,0,0,0,0,0,0,0,0,0,0,0,0,3,2,1,1,0,1,0,0,0,0,0,0
197036,32000,320,0,-2,14,8,6,0,0,0,0,0,0,2,1,1,2,1,1,0,0,0,10,6,4,0,0,0,0,0,0,0,0,0
197045,32000,320,0,-2,4,3,1,0,0,0,0,0,0,1,1,0,0,0,0,0,0,0,3,2,1,0,0,0,0,0,0,0,0,0
197133,32000,320,0,-2,5,3,2,0,0,0,0,0,0,0,0,0,2,1,1,0,0,0,3,2,1,0,0,0,0,0,0,0,0,0
197151,32000,320,0,-2,8,4,4,0,0,0,0,0,0,1,1,0,2,0,2,0,0,0,5,3,2,0,0,0,0,0,0,0,0,0
197197,32000,320,0,-2,4,3,1,0,0,0,2,1,1,0,0,0,0,0,0,0,0,0,2,2,0,0,0,0,0,0,0,0,0,0
197230,32000,320,0,-2,1,1,0,0,0,0,0,0,0,0,0,0,1,1,0,0,0,0,0,0,0,0,0,0,0,0,0,0,0,0
197294,32000,320,0,-2,1,1,0,0,0,0,1,1,0,0,0,0,0,0,0,0,0,0,0,0,0,0,0,0,0,0,0,0,0,0
197708,32000,320,0,-2,5,4,1,0,0,0,0,0,0,1,0,1,2,2,0,0,0,0,2,2,0,0,0,0,0,0,0,0,0,0
197850,32000,320,0,-2,3,3,0,0,0,0,0,0,0,0,0,0,0,0,0,0,0,0,3,3,0,0,0,0,0,0,0,0,0,0
197869,32000,320,0,-2,13,7,6,0,0,0,1,1,0,1,0,1,1,0,1,0,0,0,10,6,4,0,0,0,0,0,0,0,0,0
197911,32000,320,0,-2,2,1,1,0,0,0,0,0,0,1,0,1,0,0,0,0,0,0,1,1,0,0,0,0,0,0,0,0,0,0
197984,32000,320,0,-2,2,0,2,0,0,0,0,0,0,0,0,0,0,0,0,0,0,0,2,0,2,0,0,0,0,0,0,0,0,0
198039,32000,320,0,-2,3,3,0,0,0,0,0,0,0,0,0,0,0,0,0,0,0,0,2,2,0,0,0,0,1,1,0,0,0,0
198066,32000,320,0,-2,3,3,0,0,0,0,0,0,0,0,0,0,0,0,0,0,0,0,3,3,0,0,0,0,0,0,0,0,0,0
198084,32000,320,0,-2,1,1,0,0,0,0,0,0,0,0,0,0,0,0,0,0,0,0,1,1,0,0,0,0,0,0,0,0,0,0
198136,32000,320,0,-2,7,4,3,0,0,0,0,0,0,0,0,0,0,0,0,0,0,0,7,4,3,0,0,0,0,0,0,0,0,0
198154,32000,320,0,-2,4,3,1,0,0,0,0,0,0,0,0,0,0,0,0,0,0,0,4,3,1,0,0,0,0,0,0,0,0,0
198206,32000,320,0,-2,2,2,0,0,0,0,0,0,0,0,0,0,0,0,0,0,0,0,2,2,0,0,0,0,0,0,0,0,0,0
198215,32000,320,0,-2,3,2,1,0,0,0,0,0,0,0,0,0,0,0,0,0,0,0,3,2,1,0,0,0,0,0,0,0,0,0
198233,32000,320,0,-2,3,1,2,0,0,0,0,0,0,0,0,0,0,0,0,0,0,0,3,1,2,0,0,0,0,0,0,0,0,0
198260,32000,320,0,-2,10,6,4,0,0,0,0,0,0,4,2,2,1,0,1,0,0,0,2,2,0,0,0,0,3,2,1,0,0,0
198321,32000,320,0,-2,1,1,0,0,0,0,0,0,0,0,0,0,0,0,0,0,0,0,1,1,0,0,0,0,0,0,0,0,0,0
198330,32000,320,0,-2,2,2,0,0,0,0,0,0,0,0,0,0,1,1,0,0,0,0,1,1,0,0,0,0,0,0,0,0,0,0
198385,32000,320,0,-2,7,3,4,0,0,0,0,0,0,1,1,0,2,1,1,0,0,0,4,1,3,0,0,0,0,0,0,0,0,0
198419,32000,320,0,-2,142,66,76,0,0,0,19,5,14,20,7,13,16,10,6,0,0,0,70,34,36,5,2,3,0,0,0,12,8,4
198464,32000,320,0,-2,25,16,9,0,0,0,2,0,2,0,0,0,3,3,0,0,0,0,18,11,7,0,0,0,1,1,0,1,1,0
198507,32000,320,0,-2,4,3,1,0,0,0,1,1,0,3,2,1,0,0,0,0,0,0,0,0,0,0,0,0,0,0,0,0,0,0
198516,32000,320,0,-2,5,3,2,0,0,0,0,0,0,3,2,1,0,0,0,0,0,0,2,1,1,0,0,0,0,0,0,0,0,0
198534,32000,320,0,-2,5,5,0,0,0,0,1,1,0,1,1,0,1,1,0,0,0,0,2,2,0,0,0,0,0,0,0,0,0,0
198543,32000,320,0,-2,4,1,3,1,0,1,0,0,0,0,0,0,0,0,0,0,0,0,2,1,1,0,0,0,0,0,0,1,0,1
198552,32000,320,0,-2,6,5,1,0,0,0,1,1,0,0,0,0,0,0,0,1,1,0,4,3,1,0,0,0,0,0,0,0,0,0
198561,32000,320,0,-2,1,1,0,0,0,0,0,0,0,0,0,0,0,0,0,0,0,0,1,1,0,0,0,0,0,0,0,0,0,0
198570,32000,320,0,-2,9,0,9,0,0,0,0,0,0,1,0,1,0,0,0,0,0,0,8,0,8,0,0,0,0,0,0,0,0,0
198598,32000,320,0,-2,2,2,0,0,0,0,0,0,0,0,0,0,0,0,0,0,0,0,2,2,0,0,0,0,0,0,0,0,0,0
198613,32000,320,0,-2,1,1,0,0,0,0,0,0,0,0,0,0,1,1,0,0,0,0,0,0,0,0,0,0,0,0,0,0,0,0
198622,32000,320,0,-2,1,1,0,0,0,0,0,0,0,1,1,0,0,0,0,0,0,0,0,0,0,0,0,0,0,0,0,0,0,0
198695,32000,320,0,-2,16,12,4,0,0,0,0,0,0,3,3,0,2,2,0,0,0,0,11,7,4,0,0,0,0,0,0,0,0,0
198756,32000,320,0,-2,1,0,1,0,0,0,0,0,0,1,0,1,0,0,0,0,0,0,0,0,0,0,0,0,0,0,0,0,0,0
198774,32000,320,0,-2,1,1,0,0,0,0,0,0,0,0,0,0,0,0,0,0,0,0,1,1,0,0,0,0,0,0,0,0,0,0
198808,32000,320,0,-2,1,0,1,0,0,0,0,0,0,0,0,0,0,0,0,0,0,0,1,0,1,0,0,0,0,0,0,0,0,0
198817,32000,320,0,-2,1,1,0,0,0,0,0,0,0,1,1,0,0,0,0,0,0,0,0,0,0,0,0,0,0,0,0,0,0,0
198871,32000,320,0,-2,1,1,0,0,0,0,0,0,0,0,0,0,0,0,0,0,0,0,1,1,0,0,0,0,0,0,0,0,0,0
199032,32000,320,0,-2,4,3,1,0,0,0,0,0,0,0,0,0,2,2,0,0,0,0,2,1,1,0,0,0,0,0,0,0,0,0
199102,32000,320,0,-2,14,9,5,0,0,0,1,1,0,5,2,3,0,0,0,0,0,0,2,1,1,0,0,0,3,2,1,3,3,0
199111,32000,320,0,-2,7,4,3,0,0,0,2,2,0,0,0,0,0,0,0,0,0,0,4,2,2,1,0,1,0,0,0,0,0,0
199120,32000,320,0,-2,283,85,198,0,0,0,23,14,9,28,7,21,18,3,15,0,0,0,116,34,82,7,1,6,73,19,54,18,7,11
199139,32000,320,0,-2,37,22,15,0,0,0,5,3,2,14,6,8,1,1,0,0,0,0,16,12,4,0,0,0,0,0,0,1,0,1
199148,32000,320,0,-2,32,10,22,0,0,0,1,0,1,6,1,5,5,2,3,0,0,0,16,5,11,0,0,0,2,0,2,2,2,0
199157,32000,320,0,-2,8,5,3,0,0,0,0,0,0,4,2,2,0,0,0,0,0,0,1,1,0,0,0,0,2,1,1,1,1,0
199175,32000,320,0,-2,13,8,5,0,0,0,0,0,0,3,1,2,1,1,0,0,0,0,7,4,3,0,0,0,2,2,0,0,0,0
199184,32000,320,0,-2,3,2,1,0,0,0,0,0,0,0,0,0,0,0,0,0,0,0,3,2,1,0,0,0,0,0,0,0,0,0
199193,32000,320,0,-2,172,92,80,0,0,0,16,6,10,9,4,5,5,3,2,0,0,0,107,61,46,3,1,2,5,3,2,27,14,13
199218,32000,320,0,-2,30,16,14,0,0,0,1,0,1,2,1,1,1,1,0,0,0,0,20,13,7,1,0,1,4,1,3,1,0,1
199263,32000,320,0,-2,1,1,0,0,0,0,0,0,0,0,0,0,0,0,0,0,0,0,1,1,0,0,0,0,0,0,0,0,0,0
199272,32000,320,0,-2,1,1,0,0,0,0,0,0,0,1,1,0,0,0,0,0,0,0,0,0,0,0,0,0,0,0,0,0,0,0
199281,32000,320,0,-2,3,2,1,2,2,0,0,0,0,1,0,1,0,0,0,0,0,0,0,0,0,0,0,0,0,0,0,0,0,0
199306,32000,320,0,-2,2,2,0,0,0,0,0,0,0,0,0,0,0,0,0,0,0,0,2,2,0,0,0,0,0,0,0,0,0,0
199324,32000,320,0,-2,1,1,0,0,0,0,0,0,0,0,0,0,0,0,0,0,0,0,1,1,0,0,0,0,0,0,0,0,0,0
199333,32000,320,0,-2,3,2,1,0,0,0,0,0,0,1,1,0,0,0,0,0,0,0,2,1,1,0,0,0,0,0,0,0,0,0
199412,32000,320,0,-2,2,1,1,0,0,0,0,0,0,0,0,0,0,0,0,0,0,0,2,1,1,0,0,0,0,0,0,0,0,0
199421,32000,320,0,-2,6,6,0,0,0,0,0,0,0,1,1,0,0,0,0,0,0,0,2,2,0,0,0,0,3,3,0,0,0,0
199449,32000,320,0,-2,2,2,0,1,1,0,0,0,0,0,0,0,0,0,0,0,0,0,1,1,0,0,0,0,0,0,0,0,0,0
199467,32000,320,0,-2,1,1,0,0,0,0,0,0,0,1,1,0,0,0,0,0,0,0,0,0,0,0,0,0,0,0,0,0,0,0
199476,32000,320,0,-2,1,1,0,0,0,0,0,0,0,0,0,0,0,0,0,0,0,0,1,1,0,0,0,0,0,0,0,0,0,0
199494,32000,320,0,-2,3,2,1,0,0,0,0,0,0,0,0,0,0,0,0,0,0,0,3,2,1,0,0,0,0,0,0,0,0,0
199607,32000,320,0,-2,1,1,0,0,0,0,0,0,0,0,0,0,0,0,0,0,0,0,0,0,0,1,1,0,0,0,0,0,0,0
199634,32000,320,0,-2,1,0,1,0,0,0,0,0,0,1,0,1,0,0,0,0,0,0,0,0,0,0,0,0,0,0,0,0,0,0
199643,32000,320,0,-2,1,1,0,0,0,0,0,0,0,1,1,0,0,0,0,0,0,0,0,0,0,0,0,0,0,0,0,0,0,0
199722,32000,320,0,-2,2,2,0,0,0,0,0,0,0,0,0,0,1,1,0,0,0,0,1,1,0,0,0,0,0,0,0,0,0,0
199731,32000,320,0,-2,2,2,0,0,0,0,0,0,0,0,0,0,0,0,0,0,0,0,2,2,0,0,0,0,0,0,0,0,0,0
199768,32000,320,0,-2,2,2,0,0,0,0,0,0,0,0,0,0,0,0,0,0,0,0,2,2,0,0,0,0,0,0,0,0,0,0
199847,32000,320,0,-2,64,30,34,0,0,0,12,8,4,7,1,6,5,1,4,0,0,0,38,18,20,0,0,0,0,0,0,2,2,0
199856,32000,320,0,-2,8,7,1,0,0,0,0,0,0,1,1,0,1,1,0,0,0,0,5,4,1,0,0,0,1,1,0,0,0,0
199865,32000,320,0,-2,2,1,1,0,0,0,0,0,0,0,0,0,1,1,0,0,0,0,1,0,1,0,0,0,0,0,0,0,0,0
199962,32000,320,0,-2,2,0,2,0,0,0,0,0,0,0,0,0,1,0,1,0,0,0,1,0,1,0,0,0,0,0,0,0,0,0
199999,32000,320,0,-2,3,2,1,0,0,0,0,0,0,3,2,1,0,0,0,0,0,0,0,0,0,0,0,0,0,0,0,0,0,0
200004,32000,320,0,-2,8,3,5,0,0,0,0,0,0,0,0,0,1,1,0,0,0,0,6,2,4,1,0,1,0,0,0,0,0,0
200022,32000,320,0,-2,2,1,1,0,0,0,0,0,0,0,0,0,0,0,0,0,0,0,2,1,1,0,0,0,0,0,0,0,0,0
200192,32000,320,0,-2,2,1,1,0,0,0,0,0,0,0,0,0,0,0,0,0,0,0,2,1,1,0,0,0,0,0,0,0,0,0
200208,32000,320,0,-2,1,1,0,1,1,0,0,0,0,0,0,0,0,0,0,0,0,0,0,0,0,0,0,0,0,0,0,0,0,0
200226,32000,320,0,-2,1,1,0,0,0,0,0,0,0,0,0,0,0,0,0,0,0,0,1,1,0,0,0,0,0,0,0,0,0,0
200280,32000,320,0,-2,38,27,11,0,0,0,3,0,3,1,0,1,0,0,0,1,1,0,25,20,5,0,0,0,1,1,0,7,5,2
200332,32000,320,0,-2,34,20,14,1,0,1,1,1,0,0,0,0,0,0,0,0,0,0,24,12,12,0,0,0,3,2,1,5,5,0
200341,32000,320,0,-2,2,1,1,0,0,0,0,0,0,0,0,0,0,0,0,0,0,0,2,1,1,0,0,0,0,0,0,0,0,0
200572,32000,320,0,-2,1,1,0,0,0,0,0,0,0,0,0,0,0,0,0,0,0,0,1,1,0,0,0,0,0,0,0,0,0,0
200800,32000,320,0,-2,15,10,5,0,0,0,1,0,1,0,0,0,0,0,0,0,0,0,11,8,3,0,0,0,0,0,0,3,2,1
201104,32000,320,0,-2,3,2,1,0,0,0,0,0,0,0,0,0,0,0,0,0,0,0,3,2,1,0,0,0,0,0,0,0,0,0
201195,32000,320,0,-2,2,2,0,0,0,0,0,0,0,0,0,0,0,0,0,0,0,0,2,2,0,0,0,0,0,0,0,0,0,0
201441,32000,320,0,-2,14,6,8,1,1,0,0,0,0,0,0,0,0,0,0,0,0,0,13,5,8,0,0,0,0,0,0,0,0,0
201548,32000,320,0,-2,2,1,1,0,0,0,0,0,0,0,0,0,0,0,0,0,0,0,2,1,1,0,0,0,0,0,0,0,0,0
201645,32000,320,0,-2,60,26,34,0,0,0,11,5,6,5,2,3,5,2,3,0,0,0,34,14,20,0,0,0,4,3,1,1,0,1
201654,32000,320,0,-2,3,1,2,0,0,0,0,0,0,0,0,0,0,0,0,0,0,0,3,1,2,0,0,0,0,0,0,0,0,0
201672,32000,320,0,-2,1,0,1,0,0,0,0,0,0,0,0,0,0,0,0,0,0,0,1,0,1,0,0,0,0,0,0,0,0,0
201821,32000,320,0,-2,1,0,1,0,0,0,0,0,0,1,0,1,0,0,0,0,0,0,0,0,0,0,0,0,0,0,0,0,0,0
201885,32000,320,0,-2,152,81,71,0,0,0,12,9,3,6,0,6,3,1,2,0,0,0,82,43,39,3,3,0,4,3,1,42,22,20
201946,32000,320,0,-2,2,1,1,0,0,0,0,0,0,0,0,0,0,0,0,0,0,0,2,1,1,0,0,0,0,0,0,0,0,0
201955,32000,320,0,-2,1,1,0,0,0,0,0,0,0,1,1,0,0,0,0,0,0,0,0,0,0,0,0,0,0,0,0,0,0,0
201964,32000,320,0,-2,3,1,2,0,0,0,0,0,0,0,0,0,0,0,0,0,0,0,3,1,2,0,0,0,0,0,0,0,0,0
201973,32000,320,0,-2,3,3,0,0,0,0,0,0,0,1,1,0,0,0,0,0,0,0,2,2,0,0,0,0,0,0,0,0,0,0
202046,32000,320,0,-2,2,2,0,0,0,0,0,0,0,0,0,0,1,1,0,0,0,0,1,1,0,0,0,0,0,0,0,0,0,0
202134,32000,320,0,-2,4,4,0,0,0,0,0,0,0,1,1,0,0,0,0,0,0,0,3,3,0,0,0,0,0,0,0,0,0,0
202170,32000,320,0,-2,2,1,1,0,0,0,0,0,0,0,0,0,0,0,0,0,0,0,2,1,1,0,0,0,0,0,0,0,0,0
202222,32000,320,0,-2,3,2,1,0,0,0,0,0,0,0,0,0,0,0,0,0,0,0,3,2,1,0,0,0,0,0,0,0,0,0
202356,32000,320,0,-2,1,0,1,0,0,0,1,0,1,0,0,0,0,0,0,0,0,0,0,0,0,0,0,0,0,0,0,0,0,0
202480,32000,320,0,-2,105,86,19,0,0,0,4,2,2,4,3,1,1,1,0,0,0,0,84,71,13,0,0,0,11,8,3,1,1,0
202523,32000,320,0,-2,8,6,2,0,0,0,1,1,0,0,0,0,0,0,0,0,0,0,6,4,2,1,1,0,0,0,0,0,0,0
202763,32000,320,0,-2,3,3,0,0,0,0,0,0,0,0,0,0,1,1,0,0,0,0,2,2,0,0,0,0,0,0,0,0,0,0
202806,32000,320,0,-2,2,1,1,0,0,0,0,0,0,0,0,0,0,0,0,0,0,0,2,1,1,0,0,0,0,0,0,0,0,0
203128,32000,320,0,-2,6,6,0,0,0,0,0,0,0,1,1,0,0,0,0,0,0,0,5,5,0,0,0,0,0,0,0,0,0,0
203368,32000,320,0,-2,1,0,1,0,0,0,0,0,0,0,0,0,0,0,0,0,0,0,1,0,1,0,0,0,0,0,0,0,0,0
203386,32000,320,0,-2,2,2,0,0,0,0,0,0,0,0,0,0,0,0,0,0,0,0,1,1,0,1,1,0,0,0,0,0,0,0
203517,32000,320,0,-2,9,3,6,0,0,0,0,0,0,0,0,0,1,0,1,0,0,0,6,2,4,0,0,0,0,0,0,2,1,1
203526,32000,320,0,-2,1,1,0,0,0,0,0,0,0,0,0,0,0,0,0,0,0,0,1,1,0,0,0,0,0,0,0,0,0,0
203535,32000,320,0,-2,1,0,1,0,0,0,0,0,0,0,0,0,0,0,0,0,0,0,1,0,1,0,0,0,0,0,0,0,0,0
203544,32000,320,0,-2,1,1,0,0,0,0,0,0,0,0,0,0,0,0,0,0,0,0,1,1,0,0,0,0,0,0,0,0,0,0
203678,32000,320,0,-2,1,0,1,0,0,0,0,0,0,0,0,0,0,0,0,0,0,0,1,0,1,0,0,0,0,0,0,0,0,0
203775,32000,320,0,-2,2,2,0,0,0,0,0,0,0,1,1,0,0,0,0,0,0,0,1,1,0,0,0,0,0,0,0,0,0,0
203845,32000,320,0,-2,2,1,1,0,0,0,0,0,0,0,0,0,0,0,0,0,0,0,1,0,1,0,0,0,1,1,0,0,0,0
203960,32000,320,0,-2,1,0,1,0,0,0,0,0,0,0,0,0,0,0,0,0,0,0,1,0,1,0,0,0,0,0,0,0,0,0
204015,32000,320,0,-2,1,1,0,0,0,0,0,0,0,0,0,0,0,0,0,0,0,0,1,1,0,0,0,0,0,0,0,0,0,0
204024,32000,320,0,-2,14,9,5,0,0,0,2,0,2,0,0,0,0,0,0,0,0,0,10,8,2,0,0,0,2,1,1,0,0,0
204194,32000,320,0,-2,2,1,1,0,0,0,0,0,0,0,0,0,0,0,0,0,0,0,2,1,1,0,0,0,0,0,0,0,0,0
204422,32000,320,0,-2,1,1,0,0,0,0,0,0,0,0,0,0,0,0,0,0,0,0,1,1,0,0,0,0,0,0,0,0,0,0
204477,32000,320,0,-2,27,15,12,0,0,0,1,0,1,0,0,0,0,0,0,0,0,0,14,10,4,0,0,0,3,1,2,9,4,5
204486,32000,320,0,-2,1,1,0,0,0,0,0,0,0,0,0,0,0,0,0,0,0,0,1,1,0,0,0,0,0,0,0,0,0,0
204501,32000,320,0,-2,16,10,6,0,0,0,0,0,0,1,1,0,1,1,0,0,0,0,13,8,5,0,0,0,0,0,0,1,0,1
204635,32000,320,0,-2,3,1,2,0,0,0,0,0,0,0,0,0,0,0,0,0,0,0,3,1,2,0,0,0,0,0,0,0,0,0
204796,32000,320,0,-2,302,133,169,0,0,0,39,14,25,22,10,12,17,9,8,0,0,0,186,82,104,10,3,7,7,5,2,21,10,11
204820,32000,320,0,-2,1,0,1,0,0,0,0,0,0,0,0,0,0,0,0,0,0,0,0,0,0,1,0,1,0,0,0,0,0,0
204857,32000,320,0,-2,27,17,10,0,0,0,0,0,0,1,1,0,2,1,1,0,0,0,16,12,4,0,0,0,1,0,1,7,3,4
204945,32000,320,0,-2,2,2,0,0,0,0,0,0,0,0,0,0,0,0,0,0,0,0,2,2,0,0,0,0,0,0,0,0,0,0
205179,32000,320,0,-2,1,1,0,0,0,0,0,0,0,0,0,0,0,0,0,0,0,0,1,1,0,0,0,0,0,0,0,0,0,0
205203,32000,320,0,-2,2,2,0,0,0,0,0,0,0,0,0,0,0,0,0,0,0,0,2,2,0,0,0,0,0,0,0,0,0,0
205443,32000,320,0,-2,1,1,0,0,0,0,0,0,0,0,0,0,0,0,0,0,0,0,1,1,0,0,0,0,0,0,0,0,0,0
205470,32000,320,0,-2,8,6,2,0,0,0,0,0,0,0,0,0,0,0,0,0,0,0,8,6,2,0,0,0,0,0,0,0,0,0
206011,32000,320,0,-2,2,2,0,0,0,0,0,0,0,0,0,0,0,0,0,0,0,0,2,2,0,0,0,0,0,0,0,0,0,0
206084,32000,320,0,-2,19,13,6,0,0,0,4,2,2,1,1,0,1,1,0,0,0,0,13,9,4,0,0,0,0,0,0,0,0,0
206279,32000,320,0,-2,1,1,0,0,0,0,0,0,0,0,0,0,0,0,0,0,0,0,1,1,0,0,0,0,0,0,0,0,0,0
206437,32000,320,0,-2,1,1,0,0,0,0,0,0,0,0,0,0,0,0,0,0,0,0,1,1,0,0,0,0,0,0,0,0,0,0
206446,32000,320,0,-2,3,3,0,0,0,0,0,0,0,0,0,0,0,0,0,0,0,0,2,2,0,0,0,0,1,1,0,0,0,0
206507,32000,320,0,-2,1,1,0,0,0,0,0,0,0,0,0,0,0,0,0,0,0,0,1,1,0,0,0,0,0,0,0,0,0,0
206604,32000,320,0,-2,13,6,7,0,0,0,1,0,1,2,0,2,1,1,0,0,0,0,8,5,3,0,0,0,0,0,0,1,0,1
206622,32000,320,0,-2,5,2,3,0,0,0,1,0,1,1,0,1,0,0,0,0,0,0,3,2,1,0,0,0,0,0,0,0,0,0
206695,32000,320,0,-2,10,8,2,0,0,0,0,0,0,0,0,0,0,0,0,0,0,0,8,6,2,1,1,0,0,0,0,1,1,0
206862,32000,320,0,-2,1,1,0,0,0,0,0,0,0,0,0,0,0,0,0,0,0,0,1,1,0,0,0,0,0,0,0,0,0,0
206914,32000,320,0,-2,1,1,0,0,0,0,0,0,0,0,0,0,0,0,0,0,0,0,1,1,0,0,0,0,0,0,0,0,0,0
206941,32000,320,0,-2,9,9,0,0,0,0,0,0,0,1,1,0,0,0,0,0,0,0,2,2,0,0,0,0,6,6,0,0,0,0
206996,32000,320,0,-2,1,1,0,0,0,0,0,0,0,0,0,0,0,0,0,0,0,0,1,1,0,0,0,0,0,0,0,0,0,0
207041,32000,320,0,-2,1,1,0,0,0,0,0,0,0,0,0,0,0,0,0,0,0,0,1,1,0,0,0,0,0,0,0,0,0,0
207069,32000,320,0,-2,3,2,1,0,0,0,0,0,0,0,0,0,0,0,0,0,0,0,3,2,1,0,0,0,0,0,0,0,0,0
207209,32000,320,0,-2,2,1,1,0,0,0,1,1,0,0,0,0,0,0,0,0,0,0,0,0,0,0,0,0,0,0,0,1,0,1
207236,32000,320,0,-2,2,2,0,1,1,0,0,0,0,0,0,0,0,0,0,0,0,0,1,1,0,0,0,0,0,0,0,0,0,0
207263,32000,320,0,-2,7,6,1,2,1,1,0,0,0,0,0,0,0,0,0,0,0,0,4,4,0,0,0,0,0,0,0,1,1,0
207290,32000,320,0,-2,2,2,0,0,0,0,0,0,0,0,0,0,0,0,0,0,0,0,2,2,0,0,0,0,0,0,0,0,0,0
207306,32000,320,0,-2,1,1,0,0,0,0,0,0,0,0,0,0,0,0,0,0,0,0,1,1,0,0,0,0,0,0,0,0,0,0
207315,32000,320,0,-2,14,11,3,0,0,0,1,1,0,1,0,1,2,1,1,0,0,0,9,8,1,1,1,0,0,0,0,0,0,0
207324,32000,320,0,-2,2,1,1,0,0,0,0,0,0,0,0,0,1,1,0,0,0,0,1,0,1,0,0,0,0,0,0,0,0,0
207342,32000,320,0,-2,27,9,18,0,0,0,2,1,1,1,0,1,7,2,5,0,0,0,11,3,8,3,2,1,1,0,1,2,1,1
207388,32000,320,0,-2,70,37,33,3,2,1,0,0,0,0,0,0,7,2,5,0,0,0,51,27,24,6,3,3,0,0,0,3,3,0
207397,32000,320,0,-2,3,2,1,0,0,0,0,0,0,0,0,0,0,0,0,0,0,0,3,2,1,0,0,0,0,0,0,0,0,0
207449,32000,320,0,-2,4,2,2,0,0,0,0,0,0,2,1,1,0,0,0,0,0,0,2,1,1,0,0,0,0,0,0,0,0,0
207458,32000,320,0,-2,5,3,2,0,0,0,0,0,0,0,0,0,0,0,0,0,0,0,4,2,2,1,1,0,0,0,0,0,0,0
207500,32000,320,0,-2,20,14,6,0,0,0,1,0,1,1,1,0,2,1,1,0,0,0,12,8,4,2,2,0,2,2,0,0,0,0
207564,32000,320,0,-2,1,1,0,0,0,0,0,0,0,0,0,0,0,0,0,0,0,0,1,1,0,0,0,0,0,0,0,0,0,0
207582,32000,320,0,-2,5,5,0,0,0,0,0,0,0,1,1,0,0,0,0,0,0,0,4,4,0,0,0,0,0,0,0,0,0,0
207661,32000,320,0,-2,1,1,0,0,0,0,0,0,0,0,0,0,0,0,0,0,0,0,1,1,0,0,0,0,0,0,0,0,0,0
207670,32000,320,0,-2,1,1,0,0,0,0,0,0,0,0,0,0,0,0,0,0,0,0,1,1,0,0,0,0,0,0,0,0,0,0
207722,32000,320,0,-2,1,1,0,1,1,0,0,0,0,0,0,0,0,0,0,0,0,0,0,0,0,0,0,0,0,0,0,0,0,0
207740,32000,320,0,-2,1,1,0,0,0,0,0,0,0,0,0,0,0,0,0,0,0,0,1,1,0,0,0,0,0,0,0,0,0,0
207865,32000,320,0,-2,1,1,0,0,0,0,0,0,0,0,0,0,0,0,0,0,0,0,1,1,0,0,0,0,0,0,0,0,0,0
207935,32000,320,0,-2,8,3,5,0,0,0,0,0,0,1,0,1,1,0,1,0,0,0,5,2,3,1,1,0,0,0,0,0,0,0
207971,32000,320,0,-2,9,6,3,2,2,0,1,1,0,0,0,0,1,0,1,0,0,0,3,3,0,1,0,1,0,0,0,1,0,1
208318,32000,320,0,-2,2,2,0,0,0,0,0,0,0,0,0,0,0,0,0,0,0,0,1,1,0,1,1,0,0,0,0,0,0,0
208390,32000,320,0,-2,9,7,2,0,0,0,1,0,1,0,0,0,0,0,0,0,0,0,3,3,0,2,1,1,2,2,0,1,1,0
208646,32000,320,0,-2,3,3,0,0,0,0,0,0,0,0,0,0,0,0,0,0,0,0,3,3,0,0,0,0,0,0,0,0,0,0
208822,32000,320,0,-2,5,1,4,0,0,0,0,0,0,1,1,0,1,0,1,0,0,0,3,0,3,0,0,0,0,0,0,0,0,0
209038,32000,320,0,-2,3,3,0,0,0,0,0,0,0,0,0,0,0,0,0,0,0,0,3,3,0,0,0,0,0,0,0,0,0,0
209056,32000,320,0,-2,2,2,0,0,0,0,0,0,0,0,0,0,0,0,0,0,0,0,2,2,0,0,0,0,0,0,0,0,0,0
209065,32000,320,0,-2,1,0,1,0,0,0,0,0,0,0,0,0,0,0,0,0,0,0,1,0,1,0,0,0,0,0,0,0,0,0
209250,32000,320,0,-2,4,4,0,0,0,0,0,0,0,0,0,0,0,0,0,0,0,0,4,4,0,0,0,0,0,0,0,0,0,0
209287,32000,320,0,-2,2,1,1,0,0,0,1,0,1,0,0,0,0,0,0,0,0,0,0,0,0,1,1,0,0,0,0,0,0,0
209409,32000,320,0,-2,1,1,0,0,0,0,1,1,0,0,0,0,0,0,0,0,0,0,0,0,0,0,0,0,0,0,0,0,0,0
209490,32000,320,0,-2,479,189,290,3,1,2,69,28,41,15,9,6,45,17,28,3,2,1,270,98,172,27,12,15,30,17,13,17,5,12
209506,32000,320,0,-2,1,1,0,0,0,0,0,0,0,0,0,0,0,0,0,0,0,0,1,1,0,0,0,0,0,0,0,0,0,0
209542,32000,320,0,-2,41,23,18,0,0,0,1,0,1,0,0,0,0,0,0,0,0,0,28,20,8,0,0,0,11,3,8,1,0,1
209551,32000,320,0,-2,44,24,20,0,0,0,1,1,0,1,0,1,4,2,2,0,0,0,33,19,14,1,0,1,2,1,1,2,1,1
209746,32000,320,0,-2,11,8,3,0,0,0,1,1,0,0,0,0,0,0,0,0,0,0,8,6,2,1,0,1,1,1,0,0,0,0
209807,32000,320,0,-2,6,2,4,0,0,0,2,0,2,1,1,0,0,0,0,0,0,0,2,0,2,1,1,0,0,0,0,0,0,0
209825,32000,320,0,-2,5,1,4,0,0,0,0,0,0,0,0,0,0,0,0,0,0,0,2,1,1,0,0,0,2,0,2,1,0,1
209922,32000,320,0,-2,12,6,6,0,0,0,2,0,2,0,0,0,0,0,0,0,0,0,8,4,4,0,0,0,0,0,0,2,2,0
210146,32000,320,0,-2,1,1,0,0,0,0,0,0,0,0,0,0,0,0,0,0,0,0,1,1,0,0,0,0,0,0,0,0,0,0
210234,32000,320,0,-2,1,1,0,0,0,0,0,0,0,0,0,0,0,0,0,0,0,0,1,1,0,0,0,0,0,0,0,0,0,0
210331,32000,320,0,-2,1,1,0,0,0,0,0,0,0,0,0,0,0,0,0,0,0,0,1,1,0,0,0,0,0,0,0,0,0,0
210368,32000,320,0,-2,1,1,0,0,0,0,0,0,0,0,0,0,0,0,0,0,0,0,1,1,0,0,0,0,0,0,0,0,0,0
210401,32000,320,0,-2,2,2,0,0,0,0,0,0,0,0,0,0,0,0,0,0,0,0,1,1,0,0,0,0,1,1,0,0,0,0
210429,32000,320,0,-2,1,0,1,0,0,0,0,0,0,0,0,0,1,0,1,0,0,0,0,0,0,0,0,0,0,0,0,0,0,0
210438,32000,320,0,-2,4,4,0,0,0,0,0,0,0,0,0,0,0,0,0,1,1,0,3,3,0,0,0,0,0,0,0,0,0,0
210492,32000,320,0,-2,2,2,0,0,0,0,0,0,0,0,0,0,0,0,0,0,0,0,1,1,0,0,0,0,1,1,0,0,0,0
210605,32000,320,0,-2,3,2,1,0,0,0,0,0,0,1,0,1,0,0,0,0,0,0,2,2,0,0,0,0,0,0,0,0,0,0
210739,32000,320,0,-2,1,0,1,0,0,0,0,0,0,0,0,0,0,0,0,0,0,0,1,0,1,0,0,0,0,0,0,0,0,0
210775,32000,320,0,-2,1,1,0,0,0,0,0,0,0,0,0,0,0,0,0,0,0,0,1,1,0,0,0,0,0,0,0,0,0,0
210809,32000,320,0,-2,2,1,1,0,0,0,0,0,0,0,0,0,0,0,0,0,0,0,2,1,1,0,0,0,0,0,0,0,0,0
211079,32000,320,0,-2,2,1,1,0,0,0,0,0,0,0,0,0,0,0,0,0,0,0,2,1,1,0,0,0,0,0,0,0,0,0
211088,32000,320,0,-2,6,4,2,0,0,0,0,0,0,1,0,1,0,0,0,0,0,0,5,4,1,0,0,0,0,0,0,0,0,0
211158,32000,320,0,-2,1,1,0,0,0,0,1,1,0,0,0,0,0,0,0,0,0,0,0,0,0,0,0,0,0,0,0,0,0,0
211291,32000,320,0,-2,11,5,6,0,0,0,0,0,0,1,0,1,0,0,0,0,0,0,8,4,4,0,0,0,0,0,0,2,1,1
211307,32000,320,0,-2,2,1,1,0,0,0,0,0,0,0,0,0,0,0,0,0,0,0,2,1,1,0,0,0,0,0,0,0,0,0
211343,32000,320,0,-2,1,1,0,0,0,0,0,0,0,0,0,0,0,0,0,0,0,0,1,1,0,0,0,0,0,0,0,0,0,0
211352,32000,320,0,-2,1,1,0,0,0,0,0,0,0,0,0,0,0,0,0,0,0,0,1,1,0,0,0,0,0,0,0,0,0,0
211431,32000,320,0,-2,3,2,1,0,0,0,0,0,0,0,0,0,0,0,0,0,0,0,3,2,1,0,0,0,0,0,0,0,0,0
211440,32000,320,0,-2,139,97,42,0,0,0,18,13,5,5,4,1,4,2,2,0,0,0,83,58,25,4,2,2,4,2,2,21,16,5
211477,32000,320,0,-2,1,1,0,0,0,0,0,0,0,1,1,0,0,0,0,0,0,0,0,0,0,0,0,0,0,0,0,0,0,0
211556,32000,320,0,-2,2,0,2,0,0,0,0,0,0,0,0,0,0,0,0,0,0,0,2,0,2,0,0,0,0,0,0,0,0,0
211583,32000,320,0,-2,2,1,1,0,0,0,1,0,1,1,1,0,0,0,0,0,0,0,0,0,0,0,0,0,0,0,0,0,0,0
211893,32000,320,0,-2,2,2,0,0,0,0,0,0,0,0,0,0,0,0,0,0,0,0,2,2,0,0,0,0,0,0,0,0,0,0
211927,32000,320,0,-2,1,1,0,0,0,0,0,0,0,0,0,0,0,0,0,0,0,0,1,1,0,0,0,0,0,0,0,0,0,0
211981,32000,320,0,-2,1,1,0,0,0,0,0,0,0,1,1,0,0,0,0,0,0,0,0,0,0,0,0,0,0,0,0,0,0,0
212009,32000,320,0,-2,4,1,3,0,0,0,0,0,0,0,0,0,0,0,0,0,0,0,4,1,3,0,0,0,0,0,0,0,0,0
212054,32000,320,0,-2,22,10,12,0,0,0,1,1,0,1,0,1,0,0,0,0,0,0,16,7,9,0,0,0,0,0,0,4,2,2
212106,32000,320,0,-2,7,1,6,0,0,0,1,0,1,1,0,1,0,0,0,0,0,0,5,1,4,0,0,0,0,0,0,0,0,0
212115,32000,320,0,-2,1,1,0,0,0,0,0,0,0,0,0,0,0,0,0,0,0,0,1,1,0,0,0,0,0,0,0,0,0,0
212133,32000,320,0,-2,2,2,0,0,0,0,0,0,0,0,0,0,0,0,0,0,0,0,2,2,0,0,0,0,0,0,0,0,0,0
212197,32000,320,0,-2,1,1,0,0,0,0,0,0,0,0,0,0,0,0,0,0,0,0,1,1,0,0,0,0,0,0,0,0,0,0
212601,32000,320,0,-2,1,0,1,0,0,0,0,0,0,0,0,0,0,0,0,0,0,0,1,0,1,0,0,0,0,0,0,0,0,0
212674,32000,320,0,-2,3,2,1,0,0,0,0,0,0,0,0,0,0,0,0,0,0,0,3,2,1,0,0,0,0,0,0,0,0,0
212771,32000,320,0,-2,1,1,0,0,0,0,0,0,0,0,0,0,0,0,0,0,0,0,1,1,0,0,0,0,0,0,0,0,0,0
212832,32000,320,0,-2,3,3,0,0,0,0,1,1,0,0,0,0,0,0,0,0,0,0,2,2,0,0,0,0,0,0,0,0,0,0
212869,32000,320,0,-2,1,1,0,0,0,0,0,0,0,0,0,0,0,0,0,0,0,0,1,1,0,0,0,0,0,0,0,0,0,0
212878,32000,320,0,-2,2,2,0,0,0,0,0,0,0,1,1,0,0,0,0,0,0,0,1,1,0,0,0,0,0,0,0,0,0,0
212911,32000,320,0,-2,5,5,0,0,0,0,1,1,0,1,1,0,0,0,0,0,0,0,3,3,0,0,0,0,0,0,0,0,0,0
212984,32000,320,0,-2,3,3,0,0,0,0,0,0,0,0,0,0,1,1,0,0,0,0,2,2,0,0,0,0,0,0,0,0,0,0
213011,32000,320,0,-2,4,3,1,0,0,0,1,1,0,0,0,0,0,0,0,0,0,0,3,2,1,0,0,0,0,0,0,0,0,0
213251,32000,320,0,-2,1,1,0,0,0,0,0,0,0,0,0,0,0,0,0,0,0,0,1,1,0,0,0,0,0,0,0,0,0,0
213358,32000,320,0,-2,1,0,1,0,0,0,0,0,0,0,0,0,0,0,0,0,0,0,1,0,1,0,0,0,0,0,0,0,0,0
213367,32000,320,0,-2,5,4,1,0,0,0,1,1,0,1,1,0,0,0,0,0,0,0,3,2,1,0,0,0,0,0,0,0,0,0
213376,32000,320,0,-2,2,2,0,0,0,0,0,0,0,0,0,0,0,0,0,0,0,0,2,2,0,0,0,0,0,0,0,0,0,0
213385,32000,320,0,-2,1,1,0,0,0,0,1,1,0,0,0,0,0,0,0,0,0,0,0,0,0,0,0,0,0,0,0,0,0,0
213400,32000,320,0,-2,2,2,0,0,0,0,0,0,0,1,1,0,0,0,0,0,0,0,1,1,0,0,0,0,0,0,0,0,0,0
213507,32000,320,0,-2,1,1,0,0,0,0,0,0,0,0,0,0,0,0,0,0,0,0,1,1,0,0,0,0,0,0,0,0,0,0
213525,32000,320,0,-2,4,4,0,0,0,0,1,1,0,0,0,0,0,0,0,0,0,0,3,3,0,0,0,0,0,0,0,0,0,0
213543,32000,320,0,-2,41,31,10,0,0,0,0,0,0,0,0,0,4,2,2,0,0,0,13,9,4,0,0,0,1,1,0,23,19,4
213613,32000,320,0,-2,1,1,0,0,0,0,0,0,0,0,0,0,0,0,0,0,0,0,1,1,0,0,0,0,0,0,0,0,0,0
213668,32000,320,0,-2,1,1,0,0,0,0,0,0,0,0,0,0,0,0,0,0,0,0,1,1,0,0,0,0,0,0,0,0,0,0
213826,32000,320,0,-2,1,0,1,0,0,0,0,0,0,0,0,0,0,0,0,0,0,0,1,0,1,0,0,0,0,0,0,0,0,0
213987,32000,320,0,-2,3,1,2,0,0,0,0,0,0,0,0,0,0,0,0,0,0,0,3,1,2,0,0,0,0,0,0,0,0,0
213996,32000,320,0,-2,1,1,0,0,0,0,0,0,0,1,1,0,0,0,0,0,0,0,0,0,0,0,0,0,0,0,0,0,0,0
214041,32000,320,0,-2,2,2,0,0,0,0,0,0,0,0,0,0,1,1,0,0,0,0,1,1,0,0,0,0,0,0,0,0,0,0
214069,32000,320,0,-2,2,1,1,0,0,0,0,0,0,0,0,0,0,0,0,0,0,0,2,1,1,0,0,0,0,0,0,0,0,0
214111,32000,320,0,-2,5,3,2,0,0,0,0,0,0,0,0,0,1,1,0,0,0,0,2,1,1,0,0,0,2,1,1,0,0,0
214157,32000,320,0,-2,1,1,0,0,0,0,0,0,0,0,0,0,0,0,0,0,0,0,0,0,0,0,0,0,1,1,0,0,0,0
214175,32000,320,0,-2,2,2,0,0,0,0,0,0,0,1,1,0,0,0,0,0,0,0,1,1,0,0,0,0,0,0,0,0,0,0
214272,32000,320,0,-2,2,1,1,0,0,0,0,0,0,2,1,1,0,0,0,0,0,0,0,0,0,0,0,0,0,0,0,0,0,0
214564,32000,320,0,-2,1,1,0,0,0,0,0,0,0,0,0,0,0,0,0,0,0,0,1,1,0,0,0,0,0,0,0,0,0,0
214582,32000,320,0,-2,1,0,1,0,0,0,0,0,0,1,0,1,0,0,0,0,0,0,0,0,0,0,0,0,0,0,0,0,0,0
214661,32000,320,0,-2,1,1,0,0,0,0,0,0,0,0,0,0,0,0,0,0,0,0,1,1,0,0,0,0,0,0,0,0,0,0
214944,32000,320,0,-2,1,1,0,0,0,0,1,1,0,0,0,0,0,0,0,0,0,0,0,0,0,0,0,0,0,0,0,0,0,0
215062,32000,320,0,-2,419,189,230,0,0,0,70,29,41,27,15,12,28,11,17,0,0,0,221,103,118,11,5,6,12,6,6,50,20,30
215105,32000,320,0,-2,1,0,1,0,0,0,0,0,0,0,0,0,0,0,0,0,0,0,1,0,1,0,0,0,0,0,0,0,0,0
215123,32000,320,0,-2,1,0,1,0,0,0,0,0,0,1,0,1,0,0,0,0,0,0,0,0,0,0,0,0,0,0,0,0,0,0
215132,32000,320,0,-2,19,9,10,0,0,0,8,4,4,2,1,1,0,0,0,0,0,0,9,4,5,0,0,0,0,0,0,0,0,0
215239,32000,320,0,-2,3,3,0,0,0,0,0,0,0,0,0,0,0,0,0,0,0,0,3,3,0,0,0,0,0,0,0,0,0,0
215293,32000,320,0,-2,347,142,205,0,0,0,41,19,22,17,7,10,13,8,5,1,1,0,220,79,141,3,0,3,22,13,9,30,15,15
215415,32000,320,0,-2,1,0,1,0,0,0,0,0,0,0,0,0,0,0,0,0,0,0,1,0,1,0,0,0,0,0,0,0,0,0
215424,32000,320,0,-2,1,1,0,0,0,0,0,0,0,0,0,0,0,0,0,0,0,0,1,1,0,0,0,0,0,0,0,0,0,0
215442,32000,320,0,-2,2,2,0,0,0,0,0,0,0,0,0,0,0,0,0,0,0,0,2,2,0,0,0,0,0,0,0,0,0,0
215691,32000,320,0,-2,2,1,1,0,0,0,0,0,0,0,0,0,0,0,0,0,0,0,2,1,1,0,0,0,0,0,0,0,0,0
215770,32000,320,0,-2,4,3,1,0,0,0,0,0,0,0,0,0,0,0,0,0,0,0,3,2,1,0,0,0,1,1,0,0,0,0
215929,32000,320,0,-2,5,3,2,0,0,0,0,0,0,0,0,0,0,0,0,0,0,0,5,3,2,0,0,0,0,0,0,0,0,0
215947,32000,320,0,-2,2,2,0,0,0,0,0,0,0,0,0,0,0,0,0,0,0,0,2,2,0,0,0,0,0,0,0,0,0,0
216038,32000,320,0,-2,1,1,0,0,0,0,0,0,0,0,0,0,0,0,0,0,0,0,1,1,0,0,0,0,0,0,0,0,0,0
216278,32000,320,0,-2,4,4,0,0,0,0,0,0,0,0,0,0,0,0,0,0,0,0,4,4,0,0,0,0,0,0,0,0,0,0
216287,32000,320,0,-2,10,2,8,0,0,0,0,0,0,1,0,1,0,0,0,0,0,0,8,2,6,0,0,0,0,0,0,1,0,1
216296,32000,320,0,-2,1,1,0,0,0,0,0,0,0,0,0,0,0,0,0,0,0,0,1,1,0,0,0,0,0,0,0,0,0,0
216339,32000,320,0,-2,110,52,58,0,0,0,13,6,7,16,8,8,6,2,4,0,0,0,61,32,29,1,0,1,7,1,6,6,3,3
216366,32000,320,0,-2,189,106,83,0,0,0,57,32,25,13,8,5,5,2,3,0,0,0,75,40,35,26,13,13,13,11,2,0,0,0
216524,32000,320,0,-2,3,2,1,0,0,0,0,0,0,0,0,0,0,0,0,0,0,0,2,1,1,1,1,0,0,0,0,0,0,0
216597,32000,320,0,-2,11,6,5,0,0,0,0,0,0,1,0,1,0,0,0,0,0,0,10,6,4,0,0,0,0,0,0,0,0,0
216667,32000,320,0,-2,1,1,0,0,0,0,0,0,0,0,0,0,0,0,0,0,0,0,1,1,0,0,0,0,0,0,0,0,0,0
216807,32000,320,0,-2,1,0,1,0,0,0,0,0,0,0,0,0,0,0,0,0,0,0,1,0,1,0,0,0,0,0,0,0,0,0
216825,32000,320,0,-2,1,1,0,0,0,0,0,0,0,0,0,0,0,0,0,0,0,0,1,1,0,0,0,0,0,0,0,0,0,0
216852,32000,320,0,-2,10,6,4,0,0,0,1,1,0,1,0,1,0,0,0,0,0,0,8,5,3,0,0,0,0,0,0,0,0,0
216931,32000,320,0,-2,1,0,1,0,0,0,0,0,0,0,0,0,0,0,0,0,0,0,1,0,1,0,0,0,0,0,0,0,0,0
217013,32000,320,0,-2,1,1,0,0,0,0,0,0,0,0,0,0,0,0,0,0,0,0,1,1,0,0,0,0,0,0,0,0,0,0
217059,32000,320,0,-2,2,1,1,0,0,0,0,0,0,0,0,0,0,0,0,0,0,0,2,1,1,0,0,0,0,0,0,0,0,0
217156,32000,320,0,-2,101,37,64,0,0,0,15,8,7,6,2,4,14,7,7,0,0,0,55,16,39,4,2,2,4,2,2,3,0,3
217235,32000,320,0,-2,1,1,0,0,0,0,0,0,0,0,0,0,0,0,0,0,0,0,1,1,0,0,0,0,0,0,0,0,0,0
217402,32000,320,0,-2,4,1,3,0,0,0,1,0,1,1,1,0,1,0,1,0,0,0,1,0,1,0,0,0,0,0,0,0,0,0
217420,32000,320,0,-2,1,1,0,0,0,0,0,0,0,0,0,0,0,0,0,0,0,0,1,1,0,0,0,0,0,0,0,0,0,0
217475,32000,320,0,-2,2,2,0,0,0,0,0,0,0,0,0,0,0,0,0,0,0,0,2,2,0,0,0,0,0,0,0,0,0,0
217484,32000,320,0,-2,26,13,13,1,1,0,3,1,2,0,0,0,0,0,0,0,0,0,21,10,11,0,0,0,0,0,0,1,1,0
217493,32000,320,0,-2,3,3,0,0,0,0,0,0,0,0,0,0,1,1,0,0,0,0,2,2,0,0,0,0,0,0,0,0,0,0
217518,32000,320,0,-2,8,6,2,0,0,0,1,0,1,2,2,0,0,0,0,0,0,0,5,4,1,0,0,0,0,0,0,0,0,0
217536,32000,320,0,-2,9,5,4,0,0,0,1,1,0,0,0,0,1,1,0,0,0,0,7,3,4,0,0,0,0,0,0,0,0,0
217615,32000,320,0,-2,1,1,0,0,0,0,0,0,0,1,1,0,0,0,0,0,0,0,0,0,0,0,0,0,0,0,0,0,0,0
217624,32000,320,0,-2,1,0,1,0,0,0,0,0,0,1,0,1,0,0,0,0,0,0,0,0,0,0,0,0,0,0,0,0,0,0
217633,32000,320,0,-2,3,2,1,0,0,0,0,0,0,1,0,1,1,1,0,0,0,0,1,1,0,0,0,0,0,0,0,0,0,0
217688,32000,320,0,-2,3,2,1,0,0,0,0,0,0,0,0,0,0,0,0,0,0,0,3,2,1,0,0,0,0,0,0,0,0,0
217712,32000,320,0,-2,1,1,0,0,0,0,0,0,0,1,1,0,0,0,0,0,0,0,0,0,0,0,0,0,0,0,0,0,0,0
217721,32000,320,0,-2,3,1,2,0,0,0,0,0,0,3,1,2,0,0,0,0,0,0,0,0,0,0,0,0,0,0,0,0,0,0
217749,32000,320,0,-2,1,1,0,0,0,0,0,0,0,0,0,0,0,0,0,0,0,0,1,1,0,0,0,0,0,0,0,0,0,0
217776,32000,320,0,-2,1,1,0,0,0,0,0,0,0,0,0,0,0,0,0,0,0,0,1,1,0,0,0,0,0,0,0,0,0,0
217819,32000,320,0,-2,8,4,4,0,0,0,0,0,0,2,1,1,1,1,0,0,0,0,5,2,3,0,0,0,0,0,0,0,0,0
217864,32000,320,0,-2,2,1,1,0,0,0,0,0,0,1,1,0,0,0,0,0,0,0,0,0,0,0,0,0,1,0,1,0,0,0
217873,32000,320,0,-2,4,3,1,0,0,0,1,1,0,2,1,1,0,0,0,0,0,0,1,1,0,0,0,0,0,0,0,0,0,0
217882,32000,320,0,-2,42,23,19,0,0,0,0,0,0,0,0,0,0,0,0,0,0,0,40,23,17,0,0,0,0,0,0,2,0,2
217925,32000,320,0,-2,1,1,0,0,0,0,0,0,0,0,0,0,0,0,0,0,0,0,1,1,0,0,0,0,0,0,0,0,0,0
217998,32000,320,0,-2,1,1,0,0,0,0,0,0,0,0,0,0,0,0,0,0,0,0,1,1,0,0,0,0,0,0,0,0,0,0
218070,32000,320,0,-2,5,2,3,0,0,0,1,0,1,1,0,1,0,0,0,0,0,0,3,2,1,0,0,0,0,0,0,0,0,0
218113,32000,320,0,-2,6,6,0,0,0,0,1,1,0,0,0,0,1,1,0,0,0,0,4,4,0,0,0,0,0,0,0,0,0,0
218140,32000,320,0,-2,3,3,0,0,0,0,0,0,0,0,0,0,0,0,0,0,0,0,3,3,0,0,0,0,0,0,0,0,0,0
218238,32000,320,0,-2,5,5,0,0,0,0,0,0,0,3,3,0,0,0,0,0,0,0,2,2,0,0,0,0,0,0,0,0,0,0
218335,32000,320,0,-2,1,1,0,0,0,0,0,0,0,0,0,0,0,0,0,0,0,0,1,1,0,0,0,0,0,0,0,0,0,0
218399,32000,320,0,-2,3,2,1,0,0,0,0,0,0,3,2,1,0,0,0,0,0,0,0,0,0,0,0,0,0,0,0,0,0,0
218441,32000,320,0,-2,2,1,1,0,0,0,0,0,0,0,0,0,0,0,0,0,0,0,2,1,1,0,0,0,0,0,0,0,0,0
218487,32000,320,0,-2,1,1,0,0,0,0,0,0,0,1,1,0,0,0,0,0,0,0,0,0,0,0,0,0,0,0,0,0,0,0
218520,32000,320,0,-2,3,3,0,0,0,0,0,0,0,0,0,0,0,0,0,0,0,0,3,3,0,0,0,0,0,0,0,0,0,0
218539,32000,320,0,-2,1,1,0,0,0,0,0,0,0,0,0,0,0,0,0,0,0,0,1,1,0,0,0,0,0,0,0,0,0,0
218645,32000,320,0,-2,1,0,1,0,0,0,0,0,0,0,0,0,0,0,0,0,0,0,1,0,1,0,0,0,0,0,0,0,0,0
218654,32000,320,0,-2,3,1,2,0,0,0,0,0,0,1,0,1,0,0,0,0,0,0,1,1,0,0,0,0,0,0,0,1,0,1
218663,32000,320,0,-2,37,20,17,1,1,0,5,2,3,4,3,1,1,0,1,1,1,0,18,11,7,1,0,1,0,0,0,6,2,4
218724,32000,320,0,-2,3,2,1,0,0,0,0,0,0,0,0,0,1,1,0,0,0,0,2,1,1,0,0,0,0,0,0,0,0,0
218742,32000,320,0,-2,2,1,1,0,0,0,0,0,0,1,0,1,0,0,0,0,0,0,1,1,0,0,0,0,0,0,0,0,0,0
218751,32000,320,0,-2,1,0,1,0,0,0,0,0,0,0,0,0,0,0,0,0,0,0,1,0,1,0,0,0,0,0,0,0,0,0
218821,32000,320,0,-2,3,3,0,0,0,0,0,0,0,2,2,0,0,0,0,0,0,0,1,1,0,0,0,0,0,0,0,0,0,0
218830,32000,320,0,-2,5,3,2,0,0,0,2,1,1,1,0,1,0,0,0,0,0,0,2,2,0,0,0,0,0,0,0,0,0,0
218858,32000,320,0,-2,1,0,1,0,0,0,0,0,0,1,0,1,0,0,0,0,0,0,0,0,0,0,0,0,0,0,0,0,0,0
218885,32000,320,0,-2,3,1,2,0,0,0,0,0,0,0,0,0,0,0,0,0,0,0,3,1,2,0,0,0,0,0,0,0,0,0
218894,32000,320,0,-2,3,3,0,0,0,0,0,0,0,0,0,0,0,0,0,0,0,0,2,2,0,1,1,0,0,0,0,0,0,0
218919,32000,320,0,-2,1,1,0,0,0,0,0,0,0,1,1,0,0,0,0,0,0,0,0,0,0,0,0,0,0,0,0,0,0,0
218964,32000,320,0,-2,5,3,2,0,0,0,0,0,0,0,0,0,0,0,0,0,0,0,5,3,2,0,0,0,0,0,0,0,0,0
218973,32000,320,0,-2,4,4,0,0,0,0,0,0,0,0,0,0,0,0,0,0,0,0,4,4,0,0,0,0,0,0,0,0,0,0
218991,32000,320,0,-2,1,1,0,0,0,0,0,0,0,0,0,0,0,0,0,0,0,0,1,1,0,0,0,0,0,0,0,0,0,0
219000,32000,320,0,-2,1,0,1,0,0,0,0,0,0,0,0,0,0,0,0,0,0,0,1,0,1,0,0,0,0,0,0,0,0,0
219046,32000,320,0,-2,1,0,1,0,0,0,0,0,0,0,0,0,0,0,0,0,0,0,1,0,1,0,0,0,0,0,0,0,0,0
219082,32000,320,0,-2,11,11,0,0,0,0,0,0,0,0,0,0,0,0,0,0,0,0,10,10,0,1,1,0,0,0,0,0,0,0
219091,32000,320,0,-2,1,1,0,0,0,0,0,0,0,0,0,0,0,0,0,0,0,0,1,1,0,0,0,0,0,0,0,0,0,0
219143,32000,320,0,-2,2,2,0,0,0,0,0,0,0,0,0,0,0,0,0,0,0,0,2,2,0,0,0,0,0,0,0,0,0,0
219189,32000,320,0,-2,1,1,0,0,0,0,0,0,0,0,0,0,0,0,0,0,0,0,1,1,0,0,0,0,0,0,0,0,0,0
219198,32000,320,0,-2,2,1,1,0,0,0,0,0,0,0,0,0,0,0,0,0,0,0,2,1,1,0,0,0,0,0,0,0,0,0
219204,32000,320,0,-2,1,0,1,0,0,0,0,0,0,0,0,0,0,0,0,0,0,0,1,0,1,0,0,0,0,0,0,0,0,0
219347,32000,320,0,-2,10,7,3,0,0,0,0,0,0,0,0,0,0,0,0,0,0,0,2,1,1,0,0,0,0,0,0,8,6,2
219356,32000,320,0,-2,10,4,6,0,0,0,1,0,1,0,0,0,0,0,0,0,0,0,9,4,5,0,0,0,0,0,0,0,0,0
219374,32000,320,0,-2,1,1,0,1,1,0,0,0,0,0,0,0,0,0,0,0,0,0,0,0,0,0,0,0,0,0,0,0,0,0
219408,32000,320,0,-2,1,0,1,1,0,1,0,0,0,0,0,0,0,0,0,0,0,0,0,0,0,0,0,0,0,0,0,0,0,0
219426,32000,320,0,-2,1,0,1,0,0,0,0,0,0,0,0,0,0,0,0,0,0,0,1,0,1,0,0,0,0,0,0,0,0,0
219471,32000,320,0,-2,12,9,3,0,0,0,0,0,0,0,0,0,0,0,0,0,0,0,4,3,1,0,0,0,0,0,0,8,6,2
219602,32000,320,0,-2,4,0,4,0,0,0,0,0,0,3,0,3,0,0,0,0,0,0,0,0,0,0,0,0,1,0,1,0,0,0
219639,32000,320,0,-2,2,1,1,0,0,0,0,0,0,0,0,0,1,0,1,0,0,0,1,1,0,0,0,0,0,0,0,0,0,0
219709,32000,320,0,-2,1,1,0,0,0,0,0,0,0,1,1,0,0,0,0,0,0,0,0,0,0,0,0,0,0,0,0,0,0,0
219833,32000,320,0,-2,1,1,0,0,0,0,0,0,0,0,0,0,0,0,0,0,0,0,1,1,0,0,0,0,0,0,0,0,0,0
219976,32000,320,0,-2,11,8,3,0,0,0,1,1,0,0,0,0,0,0,0,0,0,0,8,6,2,0,0,0,2,1,1,0,0,0
220075,32000,320,0,-2,16,11,5,0,0,0,0,0,0,0,0,0,1,0,1,0,0,0,13,10,3,0,0,0,0,0,0,2,1,1
220181,32000,320,0,-2,1,1,0,0,0,0,0,0,0,0,0,0,0,0,0,0,0,0,0,0,0,0,0,0,1,1,0,0,0,0
220516,32000,320,0,-2,1,1,0,0,0,0,0,0,0,0,0,0,0,0,0,0,0,0,1,1,0,0,0,0,0,0,0,0,0,0
220552,32000,320,0,-2,7,4,3,0,0,0,0,0,0,0,0,0,0,0,0,0,0,0,7,4,3,0,0,0,0,0,0,0,0,0
220598,32000,320,0,-2,2,1,1,0,0,0,0,0,0,1,0,1,0,0,0,0,0,0,0,0,0,1,1,0,0,0,0,0,0,0
220604,32000,320,0,-2,2,2,0,0,0,0,0,0,0,2,2,0,0,0,0,0,0,0,0,0,0,0,0,0,0,0,0,0,0,0
220613,32000,320,0,-2,5,2,3,0,0,0,0,0,0,0,0,0,0,0,0,0,0,0,5,2,3,0,0,0,0,0,0,0,0,0
220631,32000,320,0,-2,4,4,0,0,0,0,0,0,0,0,0,0,0,0,0,0,0,0,4,4,0,0,0,0,0,0,0,0,0,0
220710,32000,320,0,-2,4,3,1,0,0,0,0,0,0,0,0,0,0,0,0,0,0,0,4,3,1,0,0,0,0,0,0,0,0,0
220792,32000,320,0,-2,5,4,1,0,0,0,1,1,0,2,1,1,0,0,0,0,0,0,2,2,0,0,0,0,0,0,0,0,0,0
220862,32000,320,0,-2,16,12,4,0,0,0,1,1,0,4,2,2,1,1,0,0,0,0,10,8,2,0,0,0,0,0,0,0,0,0
220978,32000,320,0,-2,9,7,2,0,0,0,0,0,0,0,0,0,0,0,0,0,0,0,9,7,2,0,0,0,0,0,0,0,0,0
220996,32000,320,0,-2,2,1,1,0,0,0,0,0,0,0,0,0,0,0,0,0,0,0,2,1,1,0,0,0,0,0,0,0,0,0
221148,32000,320,0,-2,1,1,0,0,0,0,0,0,0,0,0,0,0,0,0,0,0,0,1,1,0,0,0,0,0,0,0,0,0,0
221184,32000,320,0,-2,2,1,1,0,0,0,0,0,0,0,0,0,0,0,0,0,0,0,1,1,0,0,0,0,0,0,0,1,0,1
221351,32000,320,0,-2,4,2,2,0,0,0,0,0,0,0,0,0,0,0,0,0,0,0,2,1,1,1,1,0,1,0,1,0,0,0
221485,32000,320,0,-2,2,0,2,0,0,0,0,0,0,2,0,2,0,0,0,0,0,0,0,0,0,0,0,0,0,0,0,0,0,0
221519,32000,320,0,-2,4,4,0,0,0,0,0,0,0,0,0,0,0,0,0,0,0,0,3,3,0,0,0,0,1,1,0,0,0,0
221731,32000,320,0,-2,1,1,0,0,0,0,0,0,0,0,0,0,0,0,0,0,0,0,1,1,0,0,0,0,0,0,0,0,0,0
221740,32000,320,0,-2,6,3,3,0,0,0,0,0,0,0,0,0,0,0,0,0,0,0,3,3,0,1,0,1,0,0,0,2,0,2
221759,32000,320,0,-2,130,91,39,0,0,0,10,7,3,2,1,1,4,4,0,0,0,0,66,43,23,3,2,1,0,0,0,45,34,11
221768,32000,320,0,-2,4,4,0,0,0,0,0,0,0,0,0,0,0,0,0,0,0,0,4,4,0,0,0,0,0,0,0,0,0,0
221838,32000,320,0,-2,3,2,1,0,0,0,0,0,0,1,0,1,0,0,0,0,0,0,1,1,0,1,1,0,0,0,0,0,0,0
221847,32000,320,0,-2,5,1,4,0,0,0,0,0,0,0,0,0,1,0,1,0,0,0,4,1,3,0,0,0,0,0,0,0,0,0
221892,32000,320,0,-2,1,1,0,0,0,0,0,0,0,0,0,0,1,1,0,0,0,0,0,0,0,0,0,0,0,0,0,0,0,0
221908,32000,320,0,-2,1,1,0,0,0,0,0,0,0,0,0,0,0,0,0,0,0,0,1,1,0,0,0,0,0,0,0,0,0,0
221971,32000,320,0,-2,2,2,0,0,0,0,0,0,0,0,0,0,0,0,0,0,0,0,2,2,0,0,0,0,0,0,0,0,0,0
221999,32000,320,0,-2,191,110,81,1,1,0,6,3,3,16,7,9,3,2,1,0,0,0,77,47,30,3,2,1,30,12,18,55,36,19
222053,32000,320,0,-2,1,1,0,0,0,0,0,0,0,0,0,0,0,0,0,0,0,0,1,1,0,0,0,0,0,0,0,0,0,0
222178,32000,320,0,-2,7,5,2,0,0,0,0,0,0,0,0,0,1,1,0,0,0,0,6,4,2,0,0,0,0,0,0,0,0,0
222497,32000,320,0,-2,8,4,4,0,0,0,0,0,0,1,0,1,6,4,2,0,0,0,1,0,1,0,0,0,0,0,0,0,0,0
222567,32000,320,0,-2,1,1,0,0,0,0,0,0,0,0,0,0,1,1,0,0,0,0,0,0,0,0,0,0,0,0,0,0,0,0
222576,32000,320,0,-2,2,1,1,0,0,0,0,0,0,0,0,0,0,0,0,0,0,0,1,0,1,0,0,0,1,1,0,0,0,0
222822,32000,320,0,-2,1,1,0,0,0,0,0,0,0,0,0,0,1,1,0,0,0,0,0,0,0,0,0,0,0,0,0,0,0,0
222831,32000,320,0,-2,1,1,0,0,0,0,0,0,0,0,0,0,0,0,0,0,0,0,1,1,0,0,0,0,0,0,0,0,0,0
222983,32000,320,0,-2,1,1,0,0,0,0,0,0,0,0,0,0,0,0,0,0,0,0,1,1,0,0,0,0,0,0,0,0,0,0
222992,32000,320,0,-2,15,9,6,0,0,0,4,0,4,0,0,0,1,1,0,0,0,0,9,7,2,0,0,0,1,1,0,0,0,0
223223,32000,320,0,-2,69,30,39,1,0,1,30,17,13,7,0,7,5,1,4,0,0,0,15,6,9,1,0,1,10,6,4,0,0,0
223232,32000,320,0,-2,26,11,15,1,0,1,4,2,2,1,0,1,4,1,3,0,0,0,11,5,6,1,1,0,0,0,0,4,2,2
223320,32000,320,0,-2,2,2,0,0,0,0,0,0,0,0,0,0,1,1,0,0,0,0,1,1,0,0,0,0,0,0,0,0,0,0
223427,32000,320,0,-2,1,1,0,0,0,0,0,0,0,0,0,0,0,0,0,0,0,0,1,1,0,0,0,0,0,0,0,0,0,0
223506,32000,320,0,-2,5,3,2,0,0,0,0,0,0,0,0,0,2,1,1,0,0,0,3,2,1,0,0,0,0,0,0,0,0,0
223816,32000,320,0,-2,2,2,0,0,0,0,0,0,0,0,0,0,0,0,0,1,1,0,1,1,0,0,0,0,0,0,0,0,0,0
224147,32000,320,0,-2,16,12,4,0,0,0,1,1,0,0,0,0,1,1,0,0,0,0,7,5,2,0,0,0,0,0,0,7,5,2
224305,32000,320,0,-2,4,4,0,0,0,0,1,1,0,0,0,0,0,0,0,0,0,0,3,3,0,0,0,0,0,0,0,0,0,0
224323,32000,320,0,-2,2,0,2,0,0,0,1,0,1,0,0,0,1,0,1,0,0,0,0,0,0,0,0,0,0,0,0,0,0,0
224350,32000,320,0,-2,2,1,1,0,0,0,0,0,0,0,0,0,0,0,0,0,0,0,2,1,1,0,0,0,0,0,0,0,0,0
224527,32000,320,0,-2,4,3,1,0,0,0,0,0,0,0,0,0,0,0,0,0,0,0,3,2,1,0,0,0,1,1,0,0,0,0
224545,32000,320,0,-2,1,0,1,0,0,0,0,0,0,0,0,0,0,0,0,0,0,0,1,0,1,0,0,0,0,0,0,0,0,0
224615,32000,320,0,-2,10,6,4,0,0,0,1,1,0,3,1,2,2,2,0,0,0,0,3,2,1,0,0,0,1,0,1,0,0,0
224642,32000,320,0,-2,4,4,0,0,0,0,0,0,0,0,0,0,4,4,0,0,0,0,0,0,0,0,0,0,0,0,0,0,0,0
224679,32000,320,0,-2,3,3,0,0,0,0,0,0,0,0,0,0,3,3,0,0,0,0,0,0,0,0,0,0,0,0,0,0,0,0
224891,32000,320,0,-2,1,1,0,0,0,0,0,0,0,0,0,0,0,0,0,0,0,0,1,1,0,0,0,0,0,0,0,0,0,0
224961,32000,320,0,-2,2,2,0,0,0,0,0,0,0,0,0,0,2,2,0,0,0,0,0,0,0,0,0,0,0,0,0,0,0,0
225070,32000,320,0,-2,3,3,0,0,0,0,0,0,0,0,0,0,0,0,0,0,0,0,3,3,0,0,0,0,0,0,0,0,0,0
225201,32000,320,0,-2,2,2,0,0,0,0,0,0,0,1,1,0,0,0,0,0,0,0,1,1,0,0,0,0,0,0,0,0,0,0
225247,32000,320,0,-2,1,1,0,0,0,0,0,0,0,0,0,0,0,0,0,0,0,0,1,1,0,0,0,0,0,0,0,0,0,0
225371,32000,320,0,-2,3,2,1,0,0,0,0,0,0,0,0,0,0,0,0,0,0,0,3,2,1,0,0,0,0,0,0,0,0,0
225399,32000,320,0,-2,1,0,1,0,0,0,0,0,0,0,0,0,0,0,0,0,0,0,1,0,1,0,0,0,0,0,0,0,0,0
225432,32000,320,0,-2,3,2,1,0,0,0,0,0,0,1,1,0,1,0,1,0,0,0,1,1,0,0,0,0,0,0,0,0,0,0
225502,32000,320,0,-2,1,1,0,0,0,0,0,0,0,0,0,0,0,0,0,0,0,0,1,1,0,0,0,0,0,0,0,0,0,0
225511,32000,320,0,-2,71,45,26,0,0,0,10,7,3,4,2,2,7,4,3,1,0,1,14,8,6,1,1,0,0,0,0,34,23,11
225520,32000,320,0,-2,1,1,0,0,0,0,0,0,0,0,0,0,0,0,0,0,0,0,1,1,0,0,0,0,0,0,0,0,0,0
225548,32000,320,0,-2,1,1,0,0,0,0,0,0,0,0,0,0,0,0,0,0,0,0,1,1,0,0,0,0,0,0,0,0,0,0
225627,32000,320,0,-2,6,2,4,0,0,0,0,0,0,0,0,0,5,2,3,0,0,0,1,0,1,0,0,0,0,0,0,0,0,0
226091,32000,320,0,-2,9,6,3,0,0,0,1,1,0,1,0,1,2,1,1,0,0,0,3,2,1,0,0,0,0,0,0,2,2,0
226116,32000,320,0,-2,4,2,2,0,0,0,0,0,0,0,0,0,1,1,0,0,0,0,3,1,2,0,0,0,0,0,0,0,0,0
226152,32000,320,0,-2,11,10,1,0,0,0,0,0,0,0,0,0,8,7,1,0,0,0,2,2,0,0,0,0,1,1,0,0,0,0
226204,32000,320,0,-2,4,4,0,0,0,0,1,1,0,1,1,0,0,0,0,0,0,0,2,2,0,0,0,0,0,0,0,0,0,0
226231,32000,320,0,-2,2,2,0,0,0,0,0,0,0,0,0,0,0,0,0,0,0,0,2,2,0,0,0,0,0,0,0,0,0,0
226383,32000,320,0,-2,1,1,0,0,0,0,0,0,0,0,0,0,1,1,0,0,0,0,0,0,0,0,0,0,0,0,0,0,0,0
226471,32000,320,0,-2,5,5,0,0,0,0,0,0,0,0,0,0,1,1,0,0,0,0,3,3,0,0,0,0,1,1,0,0,0,0
226578,32000,320,0,-2,1,1,0,0,0,0,0,0,0,0,0,0,0,0,0,0,0,0,1,1,0,0,0,0,0,0,0,0,0,0
226806,32000,320,0,-2,1,1,0,0,0,0,0,0,0,0,0,0,1,1,0,0,0,0,0,0,0,0,0,0,0,0,0,0,0,0
226833,32000,320,0,-2,1,1,0,0,0,0,0,0,0,0,0,0,0,0,0,0,0,0,1,1,0,0,0,0,0,0,0,0,0,0
226903,32000,320,0,-2,2,2,0,0,0,0,0,0,0,0,0,0,0,0,0,0,0,0,2,2,0,0,0,0,0,0,0,0,0,0
227182,32000,320,0,-2,8,6,2,0,0,0,0,0,0,1,1,0,1,1,0,0,0,0,5,4,1,0,0,0,1,0,1,0,0,0
227216,32000,320,0,-2,25,15,10,0,0,0,1,1,0,2,2,0,2,1,1,0,0,0,18,9,9,1,1,0,0,0,0,1,1,0
227225,32000,320,0,-2,1,1,0,0,0,0,0,0,0,0,0,0,0,0,0,0,0,0,1,1,0,0,0,0,0,0,0,0,0,0
227304,32000,320,0,-2,2,2,0,0,0,0,0,0,0,0,0,0,2,2,0,0,0,0,0,0,0,0,0,0,0,0,0,0,0,0
227368,32000,320,0,-2,11,9,2,0,0,0,0,0,0,0,0,0,9,7,2,0,0,0,1,1,0,0,0,0,0,0,0,1,1,0
227401,32000,320,0,-2,2,2,0,0,0,0,0,0,0,0,0,0,1,1,0,0,0,0,1,1,0,0,0,0,0,0,0,0,0,0
227526,32000,320,0,-2,10,7,3,0,0,0,1,1,0,3,3,0,0,0,0,0,0,0,2,1,1,0,0,0,0,0,0,4,2,2
227687,32000,320,0,-2,1,1,0,0,0,0,0,0,0,0,0,0,0,0,0,0,0,0,1,1,0,0,0,0,0,0,0,0,0,0
227757,32000,320,0,-2,143,96,47,0,0,0,9,7,2,5,4,1,10,5,5,0,0,0,45,25,20,0,0,0,4,2,2,70,53,17
227845,32000,320,0,-2,5,1,4,0,0,0,0,0,0,0,0,0,3,1,2,0,0,0,2,0,2,0,0,0,0,0,0,0,0,0
227854,32000,320,0,-2,3,2,1,0,0,0,0,0,0,1,1,0,2,1,1,0,0,0,0,0,0,0,0,0,0,0,0,0,0,0
227863,32000,320,0,-2,1,0,1,0,0,0,0,0,0,1,0,1,0,0,0,0,0,0,0,0,0,0,0,0,0,0,0,0,0,0
227881,32000,320,0,-2,29,21,8,0,0,0,0,0,0,3,1,2,8,6,2,0,0,0,15,12,3,0,0,0,0,0,0,3,2,1
227924,32000,320,0,-2,3,2,1,0,0,0,0,0,0,0,0,0,1,1,0,0,0,0,2,1,1,0,0,0,0,0,0,0,0,0
227979,32000,320,0,-2,4,4,0,0,0,0,2,2,0,0,0,0,0,0,0,0,0,0,2,2,0,0,0,0,0,0,0,0,0,0
228042,32000,320,0,-2,1,1,0,0,0,0,0,0,0,0,0,0,0,0,0,0,0,0,1,1,0,0,0,0,0,0,0,0,0,0
228149,32000,320,0,-2,3,2,1,0,0,0,0,0,0,0,0,0,3,2,1,0,0,0,0,0,0,0,0,0,0,0,0,0,0,0
228158,32000,320,0,-2,1,1,0,0,0,0,0,0,0,0,0,0,1,1,0,0,0,0,0,0,0,0,0,0,0,0,0,0,0,0
228246,32000,320,0,-2,15,7,8,0,0,0,2,0,2,2,0,2,1,1,0,0,0,0,7,5,2,0,0,0,0,0,0,3,1,2
228316,32000,320,0,-2,3,3,0,0,0,0,0,0,0,0,0,0,2,2,0,0,0,0,1,1,0,0,0,0,0,0,0,0,0,0
228343,32000,320,0,-2,2,0,2,0,0,0,1,0,1,1,0,1,0,0,0,0,0,0,0,0,0,0,0,0,0,0,0,0,0,0
228431,32000,320,0,-2,7,4,3,0,0,0,0,0,0,0,0,0,2,1,1,0,0,0,5,3,2,0,0,0,0,0,0,0,0,0
228459,32000,320,0,-2,22,14,8,0,0,0,3,1,2,0,0,0,3,3,0,0,0,0,16,10,6,0,0,0,0,0,0,0,0,0
228468,32000,320,0,-2,2,2,0,0,0,0,0,0,0,0,0,0,0,0,0,0,0,0,2,2,0,0,0,0,0,0,0,0,0,0
228501,32000,320,0,-2,5,3,2,0,0,0,0,0,0,0,0,0,3,2,1,0,0,0,2,1,1,0,0,0,0,0,0,0,0,0
228529,32000,320,0,-2,8,6,2,0,0,0,0,0,0,0,0,0,0,0,0,0,0,0,6,4,2,0,0,0,0,0,0,2,2,0
228547,32000,320,0,-2,5,3,2,0,0,0,0,0,0,0,0,0,1,0,1,0,0,0,4,3,1,0,0,0,0,0,0,0,0,0
228635,32000,320,0,-2,303,119,184,2,1,1,86,30,56,26,12,14,41,20,21,0,0,0,102,41,61,12,4,8,0,0,0,34,11,23
228644,32000,320,0,-2,133,59,74,1,1,0,14,5,9,3,3,0,48,20,28,0,0,0,31,13,18,1,1,0,32,15,17,3,1,2
228653,32000,320,0,-2,13,13,0,0,0,0,2,2,0,1,1,0,2,2,0,0,0,0,8,8,0,0,0,0,0,0,0,0,0,0
228699,32000,320,0,-2,1,1,0,0,0,0,0,0,0,0,0,0,0,0,0,0,0,0,1,1,0,0,0,0,0,0,0,0,0,0
228705,32000,320,0,-2,19,12,7,0,0,0,0,0,0,0,0,0,5,3,2,0,0,0,8,6,2,0,0,0,1,1,0,5,2,3
228723,32000,320,0,-2,151,95,56,0,0,0,28,15,13,10,4,6,31,23,8,0,0,0,63,41,22,4,3,1,10,8,2,5,1,4
228732,32000,320,0,-2,3,2,1,0,0,0,1,1,0,0,0,0,0,0,0,0,0,0,2,1,1,0,0,0,0,0,0,0,0,0
228769,32000,320,0,-2,25,18,7,0,0,0,3,2,1,5,3,2,5,2,3,0,0,0,7,6,1,1,1,0,4,4,0,0,0,0
228778,32000,320,0,-2,297,170,127,0,0,0,16,7,9,10,9,1,41,20,21,0,0,0,148,83,65,7,3,4,0,0,0,75,48,27
228787,32000,320,0,-2,54,32,22,0,0,0,11,7,4,10,4,6,3,2,1,0,0,0,21,13,8,4,1,3,5,5,0,0,0,0
228796,32000,320,0,-2,76,55,21,0,0,0,19,14,5,1,0,1,35,24,11,1,1,0,12,10,2,1,0,1,1,1,0,6,5,1
228802,32000,320,0,-2,3,2,1,0,0,0,0,0,0,0,0,0,0,0,0,0,0,0,2,1,1,1,1,0,0,0,0,0,0,0
228875,32000,320,0,-2,5,3,2,0,0,0,0,0,0,1,0,1,2,2,0,0,0,0,2,1,1,0,0,0,0,0,0,0,0,0
228884,32000,320,0,-2,1,1,0,0,0,0,0,0,0,1,1,0,0,0,0,0,0,0,0,0,0,0,0,0,0,0,0,0,0,0
228909,32000,320,0,-2,39,10,29,0,0,0,4,2,2,3,2,1,6,2,4,0,0,0,22,3,19,0,0,0,4,1,3,0,0,0
229027,32000,320,0,-2,39,24,15,0,0,0,3,1,2,1,0,1,20,10,10,0,0,0,5,4,1,0,0,0,7,7,0,3,2,1
229063,32000,320,0,-2,5,3,2,0,0,0,1,1,0,3,1,2,1,1,0,0,0,0,0,0,0,0,0,0,0,0,0,0,0,0
229090,32000,320,0,-2,7,7,0,0,0,0,2,2,0,0,0,0,1,1,0,0,0,0,4,4,0,0,0,0,0,0,0,0,0,0
229115,32000,320,0,-2,21,14,7,0,0,0,0,0,0,0,0,0,4,3,1,0,0,0,15,10,5,0,0,0,0,0,0,2,1,1
229179,32000,320,0,-2,5,4,1,0,0,0,1,0,1,2,2,0,1,1,0,0,0,0,0,0,0,0,0,0,1,1,0,0,0,0
229267,32000,320,0,-2,4,1,3,0,0,0,0,0,0,1,0,1,1,0,1,0,0,0,2,1,1,0,0,0,0,0,0,0,0,0
229300,32000,320,0,-2,320,146,174,0,0,0,56,28,28,31,13,18,53,21,32,0,0,0,78,39,39,8,3,5,8,3,5,86,39,47
229337,32000,320,0,-2,15,12,3,0,0,0,4,4,0,2,2,0,1,1,0,0,0,0,8,5,3,0,0,0,0,0,0,0,0,0
229355,32000,320,0,-2,4,1,3,0,0,0,0,0,0,0,0,0,0,0,0,0,0,0,4,1,3,0,0,0,0,0,0,0,0,0
229504,32000,320,0,-2,1,1,0,0,0,0,0,0,0,0,0,0,0,0,0,0,0,0,1,1,0,0,0,0,0,0,0,0,0,0
229540,32000,320,0,-2,1,1,0,0,0,0,0,0,0,0,0,0,0,0,0,0,0,0,1,1,0,0,0,0,0,0,0,0,0,0
229799,32000,320,0,-2,1,1,0,0,0,0,0,0,0,0,0,0,0,0,0,0,0,0,0,0,0,0,0,0,1,1,0,0,0,0
229814,32000,320,0,-2,4,3,1,0,0,0,0,0,0,0,0,0,1,0,1,0,0,0,2,2,0,0,0,0,0,0,0,1,1,0
229832,32000,320,0,-2,1,0,1,0,0,0,0,0,0,0,0,0,0,0,0,0,0,0,1,0,1,0,0,0,0,0,0,0,0,0
230038,32000,320,0,-2,33,29,4,0,0,0,0,0,0,0,0,0,6,6,0,2,2,0,22,19,3,0,0,0,2,1,1,1,1,0
230047,32000,320,0,-2,1,1,0,0,0,0,0,0,0,0,0,0,0,0,0,0,0,0,1,1,0,0,0,0,0,0,0,0,0,0
230171,32000,320,0,-2,4,3,1,1,0,1,0,0,0,0,0,0,0,0,0,0,0,0,3,3,0,0,0,0,0,0,0,0,0,0
230603,32000,320,0,-2,2,2,0,0,0,0,0,0,0,0,0,0,0,0,0,0,0,0,2,2,0,0,0,0,0,0,0,0,0,0
230728,32000,320,0,-2,55,36,19,0,0,0,6,3,3,1,0,1,5,4,1,0,0,0,37,27,10,1,0,1,3,2,1,2,0,2
230737,32000,320,0,-2,23,15,8,0,0,0,0,0,0,0,0,0,2,0,2,0,0,0,18,13,5,1,1,0,2,1,1,0,0,0
230746,32000,320,0,-2,13,10,3,0,0,0,2,1,1,1,1,0,1,1,0,0,0,0,8,7,1,1,0,1,0,0,0,0,0,0
230764,32000,320,0,-2,173,108,65,1,1,0,13,5,8,3,1,2,13,6,7,1,1,0,121,81,40,6,2,4,5,3,2,10,8,2
230782,32000,320,0,-2,9,4,5,0,0,0,0,0,0,0,0,0,2,0,2,0,0,0,7,4,3,0,0,0,0,0,0,0,0,0
230807,32000,320,0,-2,1,0,1,0,0,0,0,0,0,0,0,0,0,0,0,0,0,0,1,0,1,0,0,0,0,0,0,0,0,0
230852,32000,320,0,-2,3,1,2,0,0,0,0,0,0,0,0,0,0,0,0,0,0,0,2,0,2,0,0,0,1,1,0,0,0,0
230959,32000,320,0,-2,3,1,2,0,0,0,0,0,0,0,0,0,0,0,0,0,0,0,3,1,2,0,0,0,0,0,0,0,0,0
230995,32000,320,0,-2,7,5,2,0,0,0,0,0,0,0,0,0,0,0,0,0,0,0,7,5,2,0,0,0,0,0,0,0,0,0
231059,32000,320,0,-2,2,2,0,0,0,0,0,0,0,0,0,0,0,0,0,0,0,0,1,1,0,0,0,0,1,1,0,0,0,0
231147,32000,320,0,-2,1,1,0,0,0,0,0,0,0,0,0,0,0,0,0,0,0,0,1,1,0,0,0,0,0,0,0,0,0,0
231174,32000,320,0,-2,74,29,45,0,0,0,3,1,2,0,0,0,2,1,1,0,0,0,55,21,34,2,0,2,10,6,4,2,0,2
231420,32000,320,0,-2,1,0,1,0,0,0,0,0,0,0,0,0,0,0,0,0,0,0,1,0,1,0,0,0,0,0,0,0,0,0
231536,32000,320,0,-2,4,2,2,0,0,0,0,0,0,0,0,0,0,0,0,0,0,0,4,2,2,0,0,0,0,0,0,0,0,0
231581,32000,320,0,-2,3,3,0,0,0,0,0,0,0,1,1,0,0,0,0,0,0,0,2,2,0,0,0,0,0,0,0,0,0,0
231624,32000,320,0,-2,17,10,7,0,0,0,0,0,0,0,0,0,1,0,1,0,0,0,13,9,4,1,0,1,2,1,1,0,0,0
231651,32000,320,0,-2,6,6,0,0,0,0,0,0,0,2,2,0,0,0,0,0,0,0,4,4,0,0,0,0,0,0,0,0,0,0
231785,32000,320,0,-2,1,1,0,0,0,0,0,0,0,0,0,0,1,1,0,0,0,0,0,0,0,0,0,0,0,0,0,0,0,0
231970,32000,320,0,-2,3,2,1,0,0,0,0,0,0,1,1,0,0,0,0,0,0,0,2,1,1,0,0,0,0,0,0,0,0,0
232025,32000,320,0,-2,2,1,1,0,0,0,0,0,0,0,0,0,0,0,0,0,0,0,0,0,0,0,0,0,2,1,1,0,0,0
232089,32000,320,0,-2,1,1,0,0,0,0,0,0,0,0,0,0,0,0,0,0,0,0,1,1,0,0,0,0,0,0,0,0,0,0
232186,32000,320,0,-2,32,21,11,0,0,0,12,7,5,2,2,0,3,2,1,0,0,0,13,9,4,0,0,0,1,0,1,1,1,0
232256,32000,320,0,-2,1,1,0,0,0,0,0,0,0,0,0,0,0,0,0,0,0,0,1,1,0,0,0,0,0,0,0,0,0,0
232265,32000,320,0,-2,3,3,0,0,0,0,0,0,0,0,0,0,3,3,0,0,0,0,0,0,0,0,0,0,0,0,0,0,0,0
232308,32000,320,0,-2,1,0,1,0,0,0,0,0,0,0,0,0,0,0,0,0,0,0,1,0,1,0,0,0,0,0,0,0,0,0
232414,32000,320,0,-2,3,2,1,0,0,0,0,0,0,0,0,0,1,1,0,0,0,0,2,1,1,0,0,0,0,0,0,0,0,0
232423,32000,320,0,-2,11,7,4,0,0,0,0,0,0,0,0,0,0,0,0,0,0,0,10,6,4,0,0,0,0,0,0,1,1,0
232557,32000,320,0,-2,62,46,16,1,1,0,3,3,0,4,2,2,3,2,1,0,0,0,48,37,11,0,0,0,2,0,2,1,1,0
232566,32000,320,0,-2,2,1,1,0,0,0,0,0,0,0,0,0,0,0,0,0,0,0,2,1,1,0,0,0,0,0,0,0,0,0
232609,32000,320,0,-2,1,1,0,0,0,0,0,0,0,0,0,0,0,0,0,0,0,0,1,1,0,0,0,0,0,0,0,0,0,0
232672,32000,320,0,-2,6,4,2,0,0,0,1,1,0,0,0,0,0,0,0,0,0,0,5,3,2,0,0,0,0,0,0,0,0,0
232681,32000,320,0,-2,1,1,0,0,0,0,0,0,0,0,0,0,0,0,0,0,0,0,0,0,0,0,0,0,1,1,0,0,0,0
232706,32000,320,0,-2,1,1,0,0,0,0,1,1,0,0,0,0,0,0,0,0,0,0,0,0,0,0,0,0,0,0,0,0,0,0
232867,32000,320,0,-2,1,1,0,0,0,0,0,0,0,0,0,0,0,0,0,0,0,0,1,1,0,0,0,0,0,0,0,0,0,0
232946,32000,320,0,-2,3,2,1,0,0,0,1,1,0,1,0,1,0,0,0,0,0,0,0,0,0,1,1,0,0,0,0,0,0,0
232982,32000,320,0,-2,16,10,6,0,0,0,4,3,1,3,1,2,1,0,1,0,0,0,7,6,1,0,0,0,0,0,0,1,0,1
233082,32000,320,0,-2,1,1,0,0,0,0,0,0,0,1,1,0,0,0,0,0,0,0,0,0,0,0,0,0,0,0,0,0,0,0
233277,32000,320,0,-2,3,3,0,0,0,0,0,0,0,0,0,0,1,1,0,0,0,0,2,2,0,0,0,0,0,0,0,0,0,0
233295,32000,320,0,-2,3,3,0,0,0,0,0,0,0,0,0,0,0,0,0,0,0,0,3,3,0,0,0,0,0,0,0,0,0,0
233338,32000,320,0,-2,1,1,0,0,0,0,0,0,0,1,1,0,0,0,0,0,0,0,0,0,0,0,0,0,0,0,0,0,0,0
233374,32000,320,0,-2,4,2,2,0,0,0,0,0,0,1,0,1,1,1,0,0,0,0,2,1,1,0,0,0,0,0,0,0,0,0
233426,32000,320,0,-2,3,2,1,0,0,0,0,0,0,0,0,0,0,0,0,0,0,0,3,2,1,0,0,0,0,0,0,0,0,0
233541,32000,320,0,-2,1,1,0,0,0,0,0,0,0,1,1,0,0,0,0,0,0,0,0,0,0,0,0,0,0,0,0,0,0,0
233639,32000,320,0,-2,2,1,1,0,0,0,0,0,0,0,0,0,0,0,0,0,0,0,2,1,1,0,0,0,0,0,0,0,0,0
233772,32000,320,0,-2,2,2,0,0,0,0,0,0,0,1,1,0,0,0,0,0,0,0,1,1,0,0,0,0,0,0,0,0,0,0
233842,32000,320,0,-2,1,1,0,0,0,0,0,0,0,0,0,0,0,0,0,0,0,0,1,1,0,0,0,0,0,0,0,0,0,0
233897,32000,320,0,-2,2,2,0,0,0,0,0,0,0,0,0,0,0,0,0,0,0,0,2,2,0,0,0,0,0,0,0,0,0,0
233921,32000,320,0,-2,78,45,33,0,0,0,0,0,0,6,4,2,6,4,2,0,0,0,59,36,23,6,1,5,0,0,0,1,0,1
234030,32000,320,0,-2,65,29,36,1,0,1,10,3,7,8,3,5,4,2,2,0,0,0,26,11,15,1,1,0,0,0,0,15,9,6
234076,32000,320,0,-2,255,135,120,0,0,0,22,9,13,17,7,10,14,9,5,0,0,0,114,58,56,9,6,3,8,3,5,71,43,28
234085,32000,320,0,-2,3,2,1,0,0,0,1,0,1,0,0,0,0,0,0,0,0,0,2,2,0,0,0,0,0,0,0,0,0,0
234155,32000,320,0,-2,3,2,1,0,0,0,0,0,0,3,2,1,0,0,0,0,0,0,0,0,0,0,0,0,0,0,0,0,0,0
234173,32000,320,0,-2,3,1,2,0,0,0,0,0,0,1,0,1,0,0,0,1,1,0,1,0,1,0,0,0,0,0,0,0,0,0
234207,32000,320,0,-2,6,2,4,0,0,0,0,0,0,0,0,0,0,0,0,0,0,0,6,2,4,0,0,0,0,0,0,0,0,0
234669,32000,320,0,-2,3,3,0,0,0,0,1,1,0,0,0,0,0,0,0,0,0,0,2,2,0,0,0,0,0,0,0,0,0,0
234696,32000,320,0,-2,2,2,0,0,0,0,0,0,0,1,1,0,0,0,0,0,0,0,1,1,0,0,0,0,0,0,0,0,0,0
234915,32000,320,0,-2,3,3,0,0,0,0,0,0,0,0,0,0,0,0,0,0,0,0,3,3,0,0,0,0,0,0,0,0,0,0
234933,32000,320,0,-2,4,2,2,0,0,0,1,0,1,1,0,1,0,0,0,0,0,0,0,0,0,2,2,0,0,0,0,0,0,0
234951,32000,320,0,-2,4,3,1,0,0,0,2,1,1,0,0,0,0,0,0,0,0,0,2,2,0,0,0,0,0,0,0,0,0,0
234979,32000,320,0,-2,4,4,0,1,1,0,0,0,0,0,0,0,0,0,0,0,0,0,3,3,0,0,0,0,0,0,0,0,0,0
235024,32000,320,0,-2,1,0,1,0,0,0,0,0,0,0,0,0,0,0,0,0,0,0,1,0,1,0,0,0,0,0,0,0,0,0
235097,32000,320,0,-2,3,2,1,0,0,0,1,1,0,0,0,0,0,0,0,0,0,0,2,1,1,0,0,0,0,0,0,0,0,0
235103,32000,320,0,-2,1,1,0,0,0,0,0,0,0,0,0,0,0,0,0,0,0,0,1,1,0,0,0,0,0,0,0,0,0,0
235167,32000,320,0,-2,5,3,2,0,0,0,0,0,0,0,0,0,0,0,0,0,0,0,0,0,0,0,0,0,5,3,2,0,0,0
235316,32000,320,0,-2,4,3,1,0,0,0,0,0,0,0,0,0,0,0,0,0,0,0,2,2,0,0,0,0,2,1,1,0,0,0
235334,32000,320,0,-2,2,1,1,0,0,0,0,0,0,0,0,0,0,0,0,0,0,0,2,1,1,0,0,0,0,0,0,0,0,0
235343,32000,320,0,-2,1,1,0,0,0,0,0,0,0,0,0,0,0,0,0,0,0,0,1,1,0,0,0,0,0,0,0,0,0,0
235699,32000,320,0,-2,2,2,0,0,0,0,0,0,0,0,0,0,0,0,0,0,0,0,2,2,0,0,0,0,0,0,0,0,0,0
236133,32000,320,0,-2,2,1,1,0,0,0,2,1,1,0,0,0,0,0,0,0,0,0,0,0,0,0,0,0,0,0,0,0,0,0
236230,32000,320,0,-2,2,2,0,0,0,0,0,0,0,0,0,0,0,0,0,0,0,0,2,2,0,0,0,0,0,0,0,0,0,0
236258,32000,320,0,-2,2,2,0,0,0,0,0,0,0,0,0,0,0,0,0,0,0,0,2,2,0,0,0,0,0,0,0,0,0,0
236328,32000,320,0,-2,4,3,1,0,0,0,0,0,0,0,0,0,1,1,0,0,0,0,3,2,1,0,0,0,0,0,0,0,0,0
236452,32000,320,0,-2,1,0,1,0,0,0,0,0,0,0,0,0,0,0,0,0,0,0,1,0,1,0,0,0,0,0,0,0,0,0
236577,32000,320,0,-2,2,2,0,0,0,0,1,1,0,0,0,0,0,0,0,0,0,0,1,1,0,0,0,0,0,0,0,0,0,0
236595,32000,320,0,-2,9,6,3,0,0,0,3,3,0,1,1,0,1,1,0,0,0,0,3,1,2,0,0,0,1,0,1,0,0,0
236692,32000,320,0,-2,1,1,0,0,0,0,0,0,0,0,0,0,0,0,0,0,0,0,1,1,0,0,0,0,0,0,0,0,0,0
236708,32000,320,0,-2,1,0,1,0,0,0,0,0,0,0,0,0,0,0,0,0,0,0,1,0,1,0,0,0,0,0,0,0,0,0
236753,32000,320,0,-2,1,0,1,0,0,0,0,0,0,0,0,0,0,0,0,0,0,0,1,0,1,0,0,0,0,0,0,0,0,0
236887,32000,320,0,-2,2,2,0,0,0,0,0,0,0,0,0,0,0,0,0,0,0,0,2,2,0,0,0,0,0,0,0,0,0,0
236896,32000,320,0,-2,2,1,1,0,0,0,0,0,0,0,0,0,0,0,0,0,0,0,2,1,1,0,0,0,0,0,0,0,0,0
236939,32000,320,0,-2,40,25,15,0,0,0,4,2,2,0,0,0,2,2,0,0,0,0,13,9,4,1,1,0,19,10,9,1,1,0
236948,32000,320,0,-2,133,82,51,0,0,0,18,10,8,4,4,0,13,9,4,0,0,0,74,49,25,6,3,3,11,5,6,7,2,5
236975,32000,320,0,-2,2,1,1,0,0,0,0,0,0,0,0,0,1,0,1,0,0,0,1,1,0,0,0,0,0,0,0,0,0,0
237011,32000,320,0,-2,8,4,4,0,0,0,0,0,0,0,0,0,1,1,0,0,0,0,6,2,4,0,0,0,1,1,0,0,0,0
237039,32000,320,0,-2,2,2,0,0,0,0,1,1,0,0,0,0,0,0,0,0,0,0,0,0,0,1,1,0,0,0,0,0,0,0
237057,32000,320,0,-2,1,0,1,0,0,0,0,0,0,0,0,0,0,0,0,0,0,0,1,0,1,0,0,0,0,0,0,0,0,0
237066,32000,320,0,-2,1,1,0,0,0,0,0,0,0,0,0,0,0,0,0,0,0,0,1,1,0,0,0,0,0,0,0,0,0,0
237118,32000,320,0,-2,1,1,0,0,0,0,0,0,0,0,0,0,0,0,0,0,0,0,1,1,0,0,0,0,0,0,0,0,0,0
237181,32000,320,0,-2,2,2,0,0,0,0,0,0,0,0,0,0,0,0,0,0,0,0,2,2,0,0,0,0,0,0,0,0,0,0
237330,32000,320,0,-2,3,3,0,0,0,0,0,0,0,0,0,0,0,0,0,0,0,0,3,3,0,0,0,0,0,0,0,0,0,0
237358,32000,320,0,-2,1,1,0,0,0,0,0,0,0,0,0,0,0,0,0,0,0,0,1,1,0,0,0,0,0,0,0,0,0,0
237367,32000,320,0,-2,1,0,1,0,0,0,0,0,0,0,0,0,0,0,0,0,0,0,1,0,1,0,0,0,0,0,0,0,0,0
237525,32000,320,0,-2,10,7,3,0,0,0,1,0,1,1,1,0,0,0,0,0,0,0,8,6,2,0,0,0,0,0,0,0,0,0
237817,32000,320,0,-2,1,1,0,0,0,0,0,0,0,0,0,0,0,0,0,0,0,0,1,1,0,0,0,0,0,0,0,0,0,0
237880,32000,320,0,-2,1,0,1,0,0,0,0,0,0,0,0,0,0,0,0,0,0,0,1,0,1,0,0,0,0,0,0,0,0,0
237932,32000,320,0,-2,2,1,1,0,0,0,0,0,0,0,0,0,0,0,0,0,0,0,2,1,1,0,0,0,0,0,0,0,0,0
237950,32000,320,0,-2,2,0,2,0,0,0,0,0,0,0,0,0,0,0,0,0,0,0,2,0,2,0,0,0,0,0,0,0,0,0
237996,32000,320,0,-2,1,0,1,0,0,0,0,0,0,0,0,0,0,0,0,0,0,0,1,0,1,0,0,0,0,0,0,0,0,0
238032,32000,320,0,-2,65,34,31,0,0,0,0,0,0,4,2,2,0,0,0,0,0,0,47,25,22,0,0,0,6,3,3,8,4,4
238078,32000,320,0,-2,1,1,0,0,0,0,0,0,0,0,0,0,0,0,0,0,0,0,1,1,0,0,0,0,0,0,0,0,0,0
238193,32000,320,0,-2,1,0,1,0,0,0,0,0,0,0,0,0,1,0,1,0,0,0,0,0,0,0,0,0,0,0,0,0,0,0
238263,32000,320,0,-2,2,1,1,0,0,0,0,0,0,1,1,0,0,0,0,0,0,0,1,0,1,0,0,0,0,0,0,0,0,0
238324,32000,320,0,-2,1,1,0,0,0,0,0,0,0,0,0,0,0,0,0,0,0,0,1,1,0,0,0,0,0,0,0,0,0,0
238333,32000,320,0,-2,1,0,1,0,0,0,0,0,0,0,0,0,0,0,0,0,0,0,1,0,1,0,0,0,0,0,0,0,0,0
238397,32000,320,0,-2,2,2,0,0,0,0,0,0,0,0,0,0,0,0,0,0,0,0,2,2,0,0,0,0,0,0,0,0,0,0
238430,32000,320,0,-2,1,1,0,0,0,0,0,0,0,0,0,0,0,0,0,0,0,0,1,1,0,0,0,0,0,0,0,0,0,0
238458,32000,320,0,-2,4,4,0,0,0,0,0,0,0,0,0,0,0,0,0,0,0,0,4,4,0,0,0,0,0,0,0,0,0,0
238476,32000,320,0,-2,4,1,3,0,0,0,0,0,0,0,0,0,0,0,0,0,0,0,3,1,2,1,0,1,0,0,0,0,0,0
238616,32000,320,0,-2,3,3,0,0,0,0,0,0,0,0,0,0,0,0,0,0,0,0,3,3,0,0,0,0,0,0,0,0,0,0
238661,32000,320,0,-2,1,1,0,0,0,0,0,0,0,0,0,0,0,0,0,0,0,0,1,1,0,0,0,0,0,0,0,0,0,0
238722,32000,320,0,-2,3,2,1,0,0,0,0,0,0,0,0,0,0,0,0,0,0,0,3,2,1,0,0,0,0,0,0,0,0,0
238759,32000,320,0,-2,3,3,0,0,0,0,0,0,0,1,1,0,1,1,0,0,0,0,1,1,0,0,0,0,0,0,0,0,0,0
239017,32000,320,0,-2,2,1,1,0,0,0,0,0,0,0,0,0,0,0,0,0,0,0,2,1,1,0,0,0,0,0,0,0,0,0
239071,32000,320,0,-2,1,1,0,0,0,0,0,0,0,0,0,0,0,0,0,0,0,0,1,1,0,0,0,0,0,0,0,0,0,0
239105,32000,320,0,-2,6,3,3,0,0,0,1,0,1,0,0,0,1,1,0,0,0,0,4,2,2,0,0,0,0,0,0,0,0,0
239169,32000,320,0,-2,40,16,24,0,0,0,15,5,10,1,0,1,3,1,2,0,0,0,19,9,10,2,1,1,0,0,0,0,0,0
239220,32000,320,0,-2,1,1,0,0,0,0,0,0,0,0,0,0,0,0,0,0,0,0,1,1,0,0,0,0,0,0,0,0,0,0
239248,32000,320,0,-2,5,3,2,0,0,0,2,1,1,0,0,0,0,0,0,0,0,0,3,2,1,0,0,0,0,0,0,0,0,0
239309,32000,320,0,-2,2,2,0,0,0,0,0,0,0,0,0,0,0,0,0,0,0,0,2,2,0,0,0,0,0,0,0,0,0,0
239318,32000,320,0,-2,5,4,1,0,0,0,0,0,0,1,1,0,0,0,0,0,0,0,3,2,1,1,1,0,0,0,0,0,0,0
239390,32000,320,0,-2,1,0,1,0,0,0,0,0,0,0,0,0,0,0,0,0,0,0,1,0,1,0,0,0,0,0,0,0,0,0
239442,32000,320,0,-2,2,2,0,0,0,0,0,0,0,1,1,0,0,0,0,0,0,0,1,1,0,0,0,0,0,0,0,0,0,0
239460,32000,320,0,-2,1,1,0,0,0,0,0,0,0,0,0,0,0,0,0,0,0,0,1,1,0,0,0,0,0,0,0,0,0,0
239488,32000,320,0,-2,4,3,1,0,0,0,2,2,0,0,0,0,0,0,0,0,0,0,2,1,1,0,0,0,0,0,0,0,0,0
239716,32000,320,0,-2,2,1,1,0,0,0,0,0,0,0,0,0,0,0,0,0,0,0,2,1,1,0,0,0,0,0,0,0,0,0
240107,32000,320,0,-2,1,1,0,0,0,0,0,0,0,0,0,0,0,0,0,0,0,0,1,1,0,0,0,0,0,0,0,0,0,0
240116,32000,320,0,-2,5,5,0,0,0,0,1,1,0,0,0,0,0,0,0,0,0,0,4,4,0,0,0,0,0,0,0,0,0,0
240125,32000,320,0,-2,3,3,0,0,0,0,1,1,0,1,1,0,0,0,0,0,0,0,1,1,0,0,0,0,0,0,0,0,0,0
240268,32000,320,0,-2,4,1,3,0,0,0,0,0,0,1,0,1,0,0,0,0,0,0,2,1,1,1,0,1,0,0,0,0,0,0
240277,32000,320,0,-2,5,5,0,0,0,0,1,1,0,0,0,0,0,0,0,0,0,0,3,3,0,1,1,0,0,0,0,0,0,0
240365,32000,320,0,-2,1,0,1,0,0,0,0,0,0,0,0,0,0,0,0,0,0,0,1,0,1,0,0,0,0,0,0,0,0,0
240426,32000,320,0,-2,5,3,2,0,0,0,0,0,0,0,0,0,0,0,0,0,0,0,4,2,2,0,0,0,1,1,0,0,0,0
240435,32000,320,0,-2,181,97,84,1,1,0,16,8,8,3,1,2,2,1,1,0,0,0,151,84,67,3,1,2,5,1,4,0,0,0
240444,32000,320,0,-2,324,132,192,0,0,0,29,9,20,15,4,11,19,7,12,0,0,0,236,100,136,3,1,2,5,2,3,17,9,8
240453,32000,320,0,-2,12,8,4,0,0,0,2,2,0,0,0,0,4,2,2,0,0,0,6,4,2,0,0,0,0,0,0,0,0,0
240462,32000,320,0,-2,2,1,1,0,0,0,0,0,0,0,0,0,0,0,0,0,0,0,1,1,0,1,0,1,0,0,0,0,0,0
240471,32000,320,0,-2,1,0,1,0,0,0,0,0,0,0,0,0,0,0,0,0,0,0,1,0,1,0,0,0,0,0,0,0,0,0
240480,32000,320,0,-2,1,1,0,0,0,0,0,0,0,0,0,0,0,0,0,0,0,0,1,1,0,0,0,0,0,0,0,0,0,0
240666,32000,320,0,-2,1,0,1,0,0,0,0,0,0,0,0,0,0,0,0,0,0,0,1,0,1,0,0,0,0,0,0,0,0,0
240718,32000,320,0,-2,1,0,1,0,0,0,0,0,0,0,0,0,0,0,0,0,0,0,1,0,1,0,0,0,0,0,0,0,0,0
240727,32000,320,0,-2,25,13,12,0,0,0,0,0,0,0,0,0,0,0,0,0,0,0,15,7,8,0,0,0,9,5,4,1,1,0
240745,32000,320,0,-2,1,1,0,0,0,0,1,1,0,0,0,0,0,0,0,0,0,0,0,0,0,0,0,0,0,0,0,0,0,0
240754,32000,320,0,-2,2,0,2,0,0,0,2,0,2,0,0,0,0,0,0,0,0,0,0,0,0,0,0,0,0,0,0,0,0,0
241191,32000,320,0,-2,1,1,0,0,0,0,0,0,0,0,0,0,1,1,0,0,0,0,0,0,0,0,0,0,0,0,0,0,0,0
241377,32000,320,0,-2,1,0,1,0,0,0,0,0,0,0,0,0,1,0,1,0,0,0,0,0,0,0,0,0,0,0,0,0,0,0
241836,32000,320,0,-2,2,1,1,0,0,0,0,0,0,0,0,0,2,1,1,0,0,0,0,0,0,0,0,0,0,0,0,0,0,0
242060,32000,320,0,-2,1,1,0,0,0,0,0,0,0,0,0,0,1,1,0,0,0,0,0,0,0,0,0,0,0,0,0,0,0,0
242112,32000,320,0,-2,2,2,0,0,0,0,0,0,0,0,0,0,2,2,0,0,0,0,0,0,0,0,0,0,0,0,0,0,0,0
242130,32000,320,0,-2,1,1,0,0,0,0,0,0,0,0,0,0,1,1,0,0,0,0,0,0,0,0,0,0,0,0,0,0,0,0
242617,32000,320,0,-2,3,1,2,0,0,0,0,0,0,0,0,0,3,1,2,0,0,0,0,0,0,0,0,0,0,0,0,0,0,0
242635,32000,320,0,-2,1,1,0,0,0,0,0,0,0,0,0,0,1,1,0,0,0,0,0,0,0,0,0,0,0,0,0,0,0,0
242644,32000,320,0,-2,3,3,0,0,0,0,0,0,0,0,0,0,3,3,0,0,0,0,0,0,0,0,0,0,0,0,0,0,0,0
242662,32000,320,0,-2,2,2,0,0,0,0,0,0,0,0,0,0,2,2,0,0,0,0,0,0,0,0,0,0,0,0,0,0,0,0
242680,32000,320,0,-2,2,1,1,0,0,0,0,0,0,0,0,0,2,1,1,0,0,0,0,0,0,0,0,0,0,0,0,0,0,0
242705,32000,320,0,-2,1,1,0,0,0,0,0,0,0,0,0,0,1,1,0,0,0,0,0,0,0,0,0,0,0,0,0,0,0,0
242972,32000,320,0,-2,10,10,0,0,0,0,0,0,0,0,0,0,9,9,0,0,0,0,1,1,0,0,0,0,0,0,0,0,0,0
243081,32000,320,0,-2,4,3,1,0,0,0,0,0,0,0,0,0,4,3,1,0,0,0,0,0,0,0,0,0,0,0,0,0,0,0
243160,32000,320,0,-2,3,2,1,0,0,0,0,0,0,0,0,0,1,1,0,0,0,0,0,0,0,0,0,0,2,1,1,0,0,0
243197,32000,320,0,-2,5,2,3,0,0,0,0,0,0,0,0,0,1,1,0,0,0,0,0,0,0,0,0,0,4,1,3,0,0,0
243568,32000,320,0,-2,3,1,2,0,0,0,0,0,0,0,0,0,3,1,2,0,0,0,0,0,0,0,0,0,0,0,0,0,0,0
243577,32000,320,0,-2,7,7,0,0,0,0,0,0,0,0,0,0,7,7,0,0,0,0,0,0,0,0,0,0,0,0,0,0,0,0
243744,32000,320,0,-2,767,283,484,0,0,0,219,81,138,23,10,13,56,18,38,1,0,1,195,74,121,19,7,12,201,80,121,53,13,40
243780,32000,320,0,-2,95,52,43,0,0,0,11,5,6,8,4,4,4,1,3,0,0,0,59,36,23,1,1,0,6,3,3,6,2,4
243823,32000,320,0,-2,4,2,2,0,0,0,0,0,0,0,0,0,0,0,0,0,0,0,0,0,0,0,0,0,4,2,2,0,0,0
243832,32000,320,0,-2,5,3,2,0,0,0,0,0,0,0,0,0,5,3,2,0,0,0,0,0,0,0,0,0,0,0,0,0,0,0
243841,32000,320,0,-2,1,1,0,0,0,0,0,0,0,0,0,0,1,1,0,0,0,0,0,0,0,0,0,0,0,0,0,0,0,0
244437,32000,320,0,-2,1,0,1,0,0,0,0,0,0,0,0,0,0,0,0,0,0,0,1,0,1,0,0,0,0,0,0,0,0,0
245652,32000,320,0,-2,2,2,0,0,0,0,0,0,0,0,0,0,0,0,0,0,0,0,2,2,0,0,0,0,0,0,0,0,0,0
245953,32000,320,0,-2,3,3,0,0,0,0,0,0,0,0,0,0,0,0,0,0,0,0,3,3,0,0,0,0,0,0,0,0,0,0
246354,32000,320,0,-2,7,7,0,0,0,0,0,0,0,0,0,0,6,6,0,0,0,0,1,1,0,0,0,0,0,0,0,0,0,0
246813,32000,320,0,-2,1,1,0,0,0,0,0,0,0,0,0,0,0,0,0,0,0,0,1,1,0,0,0,0,0,0,0,0,0,0
247649,32000,320,0,-2,2,2,0,0,0,0,2,2,0,0,0,0,0,0,0,0,0,0,0,0,0,0,0,0,0,0,0,0,0,0
247834,32000,320,0,-2,9,8,1,0,0,0,1,1,0,1,1,0,0,0,0,0,0,0,6,5,1,0,0,0,1,1,0,0,0,0
248934,32000,320,0,-2,10,7,3,0,0,0,0,0,0,1,1,0,0,0,0,1,1,0,8,5,3,0,0,0,0,0,0,0,0,0
262031,32000,320,0,-2,3,3,0,0,0,0,0,0,0,0,0,0,0,0,0,0,0,0,3,3,0,0,0,0,0,0,0,0,0,0
262086,32000,320,0,-2,1,0,1,0,0,0,0,0,0,0,0,0,0,0,0,0,0,0,1,0,1,0,0,0,0,0,0,0,0,0
363633,32000,320,0,-2,1,1,0,0,0,0,0,0,0,0,0,0,1,1,0,0,0,0,0,0,0,0,0,0,0,0,0,0,0,0
364025,32000,320,0,-2,2,2,0,0,0,0,0,0,0,0,0,0,0,0,0,0,0,0,2,2,0,0,0,0,0,0,0,0,0,0
366003,32000,320,0,-2,1,1,0,0,0,0,0,0,0,0,0,0,0,0,0,0,0,0,1,1,0,0,0,0,0,0,0,0,0,0
366252,32000,320,0,-2,2,1,1,0,0,0,0,0,0,0,0,0,0,0,0,0,0,0,2,1,1,0,0,0,0,0,0,0,0,0
366553,32000,320,0,-2,1,1,0,0,0,0,0,0,0,0,0,0,0,0,0,0,0,0,1,1,0,0,0,0,0,0,0,0,0,0
366711,32000,320,0,-2,11,5,6,0,0,0,0,0,0,1,1,0,3,0,3,0,0,0,7,4,3,0,0,0,0,0,0,0,0,0
367459,32000,320,0,-2,1,0,1,0,0,0,0,0,0,0,0,0,0,0,0,0,0,0,1,0,1,0,0,0,0,0,0,0,0,0
367884,32000,320,0,-2,5,3,2,0,0,0,0,0,0,0,0,0,2,2,0,0,0,0,1,0,1,0,0,0,2,1,1,0,0,0
367954,32000,320,0,-2,5,4,1,0,0,0,2,1,1,0,0,0,2,2,0,0,0,0,1,1,0,0,0,0,0,0,0,0,0,0
376695,32000,320,0,-2,1,1,0,0,0,0,0,0,0,0,0,0,0,0,0,1,1,0,0,0,0,0,0,0,0,0,0,0,0,0
377555,32000,320,0,-2,5,4,1,0,0,0,0,0,0,1,1,0,0,0,0,0,0,0,4,3,1,0,0,0,0,0,0,0,0,0
378576,32000,320,0,-2,3,1,2,0,0,0,0,0,0,0,0,0,0,0,0,0,0,0,0,0,0,0,0,0,3,1,2,0,0,0
383996,32000,320,0,-2,1,0,1,0,0,0,0,0,0,0,0,0,0,0,0,0,0,0,1,0,1,0,0,0,0,0,0,0,0,0
384254,32000,320,0,-2,4,3,1,0,0,0,0,0,0,0,0,0,0,0,0,0,0,0,4,3,1,0,0,0,0,0,0,0,0,0
384333,32000,320,0,-2,1,1,0,0,0,0,0,0,0,0,0,0,0,0,0,0,0,0,1,1,0,0,0,0,0,0,0,0,0,0
385415,32000,320,0,-2,107,40,67,0,0,0,14,5,9,17,7,10,22,6,16,1,0,1,23,8,15,2,1,1,1,0,1,27,13,14
399911,32000,320,0,-2,2,2,0,0,0,0,1,1,0,0,0,0,1,1,0,0,0,0,0,0,0,0,0,0,0,0,0,0,0,0
404426,32000,320,0,-2,5,3,2,1,1,0,0,0,0,0,0,0,2,1,1,0,0,0,2,1,1,0,0,0,0,0,0,0,0,0
404480,32000,320,0,-2,8,4,4,0,0,0,0,0,0,0,0,0,0,0,0,0,0,0,3,3,0,0,0,0,3,1,2,2,0,2
407629,32000,320,0,-2,4,4,0,0,0,0,0,0,0,0,0,0,0,0,0,0,0,0,4,4,0,0,0,0,0,0,0,0,0,0
409254,32000,320,0,-2,1,0,1,0,0,0,0,0,0,1,0,1,0,0,0,0,0,0,0,0,0,0,0,0,0,0,0,0,0,0
409315,32000,320,0,-2,13,11,2,0,0,0,0,0,0,0,0,0,11,9,2,0,0,0,0,0,0,0,0,0,1,1,0,1,1,0
409379,32000,320,0,-2,1,0,1,0,0,0,1,0,1,0,0,0,0,0,0,0,0,0,0,0,0,0,0,0,0,0,0,0,0,0
409698,32000,320,0,-2,9,7,2,0,0,0,0,0,0,0,0,0,2,2,0,0,0,0,5,4,1,0,0,0,2,1,1,0,0,0
413413,32000,320,0,-2,5,2,3,0,0,0,0,0,0,1,1,0,0,0,0,0,0,0,4,1,3,0,0,0,0,0,0,0,0,0
413617,32000,320,0,-2,1,0,1,0,0,0,0,0,0,0,0,0,1,0,1,0,0,0,0,0,0,0,0,0,0,0,0,0,0,0
414911,32000,320,0,-2,2,2,0,0,0,0,0,0,0,0,0,0,0,0,0,0,0,0,2,2,0,0,0,0,0,0,0,0,0,0
414966,32000,320,0,-2,1,1,0,0,0,0,0,0,0,0,0,0,0,0,0,0,0,0,1,1,0,0,0,0,0,0,0,0,0,0
416458,32000,320,0,-2,1,1,0,0,0,0,1,1,0,0,0,0,0,0,0,0,0,0,0,0,0,0,0,0,0,0,0,0,0,0
420246,32000,320,0,-2,2,2,0,0,0,0,0,0,0,0,0,0,1,1,0,0,0,0,1,1,0,0,0,0,0,0,0,0,0,0
420398,32000,320,0,-2,2,1,1,0,0,0,0,0,0,0,0,0,2,1,1,0,0,0,0,0,0,0,0,0,0,0,0,0,0,0
420431,32000,320,0,-2,1,1,0,0,0,0,0,0,0,1,1,0,0,0,0,0,0,0,0,0,0,0,0,0,0,0,0,0,0,0
420440,32000,320,0,-2,1,1,0,0,0,0,0,0,0,0,0,0,0,0,0,0,0,0,1,1,0,0,0,0,0,0,0,0,0,0
423643,32000,320,0,-2,3,2,1,0,0,0,2,2,0,0,0,0,1,0,1,0,0,0,0,0,0,0,0,0,0,0,0,0,0,0
426314,32000,320,0,-2,2,2,0,0,0,0,0,0,0,0,0,0,1,1,0,0,0,0,1,1,0,0,0,0,0,0,0,0,0,0
428392,32000,320,0,-2,1,1,0,0,0,0,0,0,0,0,0,0,0,0,0,0,0,0,1,1,0,0,0,0,0,0,0,0,0,0
428426,32000,320,0,-2,1,1,0,0,0,0,1,1,0,0,0,0,0,0,0,0,0,0,0,0,0,0,0,0,0,0,0,0,0,0
428453,32000,320,0,-2,3,0,3,0,0,0,1,0,1,0,0,0,0,0,0,0,0,0,2,0,2,0,0,0,0,0,0,0,0,0
432144,32000,320,0,-2,1,1,0,0,0,0,0,0,0,0,0,0,0,0,0,0,0,0,1,1,0,0,0,0,0,0,0,0,0,0
433387,32000,320,0,-2,74,56,18,0,0,0,10,6,4,5,4,1,5,4,1,0,0,0,45,35,10,2,1,1,7,6,1,0,0,0
433660,32000,320,0,-2,16,11,5,0,0,0,1,1,0,0,0,0,2,2,0,0,0,0,12,7,5,0,0,0,0,0,0,1,1,0
434584,32000,320,0,-2,1,1,0,0,0,0,1,1,0,0,0,0,0,0,0,0,0,0,0,0,0,0,0,0,0,0,0,0,0,0
434672,32000,320,0,-2,2,1,1,0,0,0,1,1,0,1,0,1,0,0,0,0,0,0,0,0,0,0,0,0,0,0,0,0,0,0
435000,32000,320,0,-2,37,11,26,0,0,0,4,1,3,9,5,4,1,0,1,0,0,0,22,4,18,0,0,0,0,0,0,1,1,0
436429,32000,320,0,-2,10,9,1,0,0,0,2,2,0,1,0,1,3,3,0,0,0,0,2,2,0,1,1,0,1,1,0,0,0,0
437103,32000,320,0,-2,1,1,0,0,0,0,1,1,0,0,0,0,0,0,0,0,0,0,0,0,0,0,0,0,0,0,0,0,0,0
438708,32000,320,0,-2,2,2,0,0,0,0,0,0,0,0,0,0,0,0,0,0,0,0,2,2,0,0,0,0,0,0,0,0,0,0
439154,32000,320,0,-2,3,3,0,0,0,0,0,0,0,0,0,0,1,1,0,0,0,0,0,0,0,0,0,0,0,0,0,2,2,0
440794,32000,320,0,-2,1,1,0,0,0,0,0,0,0,0,0,0,1,1,0,0,0,0,0,0,0,0,0,0,0,0,0,0,0,0
441070,32000,320,0,-2,1,1,0,0,0,0,0,0,0,0,0,0,0,0,0,0,0,0,0,0,0,1,1,0,0,0,0,0,0,0
441104,32000,320,0,-2,1,1,0,0,0,0,0,0,0,1,1,0,0,0,0,0,0,0,0,0,0,0,0,0,0,0,0,0,0,0
441229,32000,320,0,-2,1,0,1,0,0,0,0,0,0,0,0,0,0,0,0,0,0,0,0,0,0,0,0,0,1,0,1,0,0,0
441371,32000,320,0,-2,8,3,5,0,0,0,2,0,2,1,0,1,2,2,0,0,0,0,1,1,0,0,0,0,2,0,2,0,0,0
441760,32000,320,0,-2,1,1,0,0,0,0,0,0,0,0,0,0,0,0,0,0,0,0,1,1,0,0,0,0,0,0,0,0,0,0
441900,32000,320,0,-2,2,1,1,0,0,0,0,0,0,0,0,0,0,0,0,0,0,0,2,1,1,0,0,0,0,0,0,0,0,0
441937,32000,320,0,-2,4,3,1,0,0,0,1,1,0,0,0,0,1,0,1,0,0,0,1,1,0,0,0,0,1,1,0,0,0,0
442356,32000,320,0,-2,1,1,0,0,0,0,0,0,0,0,0,0,0,0,0,0,0,0,1,1,0,0,0,0,0,0,0,0,0,0
442569,32000,320,0,-2,2,1,1,0,0,0,1,0,1,0,0,0,0,0,0,0,0,0,1,1,0,0,0,0,0,0,0,0,0,0
442781,32000,320,0,-2,1,0,1,0,0,0,0,0,0,1,0,1,0,0,0,0,0,0,0,0,0,0,0,0,0,0,0,0,0,0
442806,32000,320,0,-2,1,1,0,0,0,0,0,0,0,0,0,0,0,0,0,0,0,0,1,1,0,0,0,0,0,0,0,0,0,0
442930,32000,320,0,-2,1,1,0,0,0,0,0,0,0,0,0,0,0,0,0,0,0,0,1,1,0,0,0,0,0,0,0,0,0,0
443368,32000,320,0,-2,1,0,1,0,0,0,0,0,0,0,0,0,0,0,0,0,0,0,1,0,1,0,0,0,0,0,0,0,0,0
443410,32000,320,0,-2,2,2,0,0,0,0,0,0,0,0,0,0,0,0,0,0,0,0,1,1,0,1,1,0,0,0,0,0,0,0
443492,32000,320,0,-2,1,0,1,0,0,0,0,0,0,0,0,0,0,0,0,0,0,0,1,0,1,0,0,0,0,0,0,0,0,0
443711,32000,320,0,-2,5,4,1,0,0,0,2,2,0,1,1,0,0,0,0,0,0,0,2,1,1,0,0,0,0,0,0,0,0,0
444130,32000,320,0,-2,1,1,0,0,0,0,0,0,0,1,1,0,0,0,0,0,0,0,0,0,0,0,0,0,0,0,0,0,0,0
444787,32000,320,0,-2,5,5,0,0,0,0,0,0,0,0,0,0,0,0,0,0,0,0,5,5,0,0,0,0,0,0,0,0,0,0
444811,32000,320,0,-2,2,1,1,0,0,0,0,0,0,1,1,0,0,0,0,0,0,0,1,0,1,0,0,0,0,0,0,0,0,0
445188,32000,320,0,-2,13,7,6,0,0,0,6,3,3,0,0,0,2,0,2,0,0,0,0,0,0,1,1,0,2,2,0,2,1,1
445692,32000,320,0,-2,2,1,1,0,0,0,0,0,0,0,0,0,0,0,0,0,0,0,2,1,1,0,0,0,0,0,0,0,0,0
445735,32000,320,0,-2,1,0,1,0,0,0,0,0,0,0,0,0,1,0,1,0,0,0,0,0,0,0,0,0,0,0,0,0,0,0
445869,32000,320,0,-2,1,1,0,0,0,0,0,0,0,0,0,0,0,0,0,0,0,0,1,1,0,0,0,0,0,0,0,0,0,0
445948,32000,320,0,-2,2,2,0,0,0,0,0,0,0,0,0,0,1,1,0,0,0,0,0,0,0,1,1,0,0,0,0,0,0,0
446640,32000,320,0,-2,2,0,2,0,0,0,0,0,0,0,0,0,0,0,0,0,0,0,0,0,0,0,0,0,2,0,2,0,0,0
446978,32000,320,0,-2,1,1,0,0,0,0,0,0,0,0,0,0,0,0,0,0,0,0,0,0,0,1,1,0,0,0,0,0,0,0
447582,32000,320,0,-2,2,2,0,0,0,0,0,0,0,0,0,0,0,0,0,0,0,0,2,2,0,0,0,0,0,0,0,0,0,0
447689,32000,320,0,-2,5,3,2,0,0,0,1,1,0,3,1,2,0,0,0,0,0,0,0,0,0,1,1,0,0,0,0,0,0,0
447768,32000,320,0,-2,1,1,0,0,0,0,0,0,0,0,0,0,0,0,0,1,1,0,0,0,0,0,0,0,0,0,0,0,0,0
448691,32000,320,0,-2,1,0,1,0,0,0,0,0,0,0,0,0,0,0,0,0,0,0,1,0,1,0,0,0,0,0,0,0,0,0
449889,32000,320,0,-2,2,2,0,0,0,0,0,0,0,0,0,0,0,0,0,0,0,0,2,2,0,0,0,0,0,0,0,0,0,0
449898,32000,320,0,-2,1,1,0,0,0,0,0,0,0,0,0,0,0,0,0,0,0,0,0,0,0,0,0,0,1,1,0,0,0,0
450933,32000,320,0,-2,5,4,1,0,0,0,0,0,0,0,0,0,0,0,0,0,0,0,3,2,1,1,1,0,1,1,0,0,0,0
451103,32000,320,0,-2,1,1,0,0,0,0,0,0,0,0,0,0,1,1,0,0,0,0,0,0,0,0,0,0,0,0,0,0,0,0
451556,32000,320,0,-2,1,1,0,0,0,0,0,0,0,0,0,0,1,1,0,0,0,0,0,0,0,0,0,0,0,0,0,0,0,0
451927,32000,320,0,-2,1,1,0,0,0,0,0,0,0,0,0,0,0,0,0,0,0,0,1,1,0,0,0,0,0,0,0,0,0,0
452948,32000,320,0,-2,1,0,1,0,0,0,0,0,0,0,0,0,0,0,0,0,0,0,1,0,1,0,0,0,0,0,0,0,0,0
454218,32000,320,0,-2,9,7,2,0,0,0,3,3,0,2,1,1,0,0,0,0,0,0,3,2,1,0,0,0,1,1,0,0,0,0
454698,32000,320,0,-2,1,1,0,0,0,0,0,0,0,0,0,0,1,1,0,0,0,0,0,0,0,0,0,0,0,0,0,0,0,0
454810,32000,320,0,-2,5,4,1,0,0,0,0,0,0,1,1,0,3,3,0,0,0,0,1,0,1,0,0,0,0,0,0,0,0,0
455114,32000,320,0,-2,3,3,0,0,0,0,0,0,0,0,0,0,0,0,0,0,0,0,3,3,0,0,0,0,0,0,0,0,0,0
455196,32000,320,0,-2,2,2,0,0,0,0,1,1,0,0,0,0,0,0,0,0,0,0,1,1,0,0,0,0,0,0,0,0,0,0
455406,32000,320,0,-2,2,1,1,0,0,0,0,0,0,0,0,0,2,1,1,0,0,0,0,0,0,0,0,0,0,0,0,0,0,0
455992,32000,320,0,-2,2,1,1,0,0,0,0,0,0,0,0,0,0,0,0,0,0,0,1,1,0,0,0,0,1,0,1,0,0,0
456542,32000,320,0,-2,1,0,1,0,0,0,0,0,0,0,0,0,0,0,0,0,0,0,1,0,1,0,0,0,0,0,0,0,0,0
457299,32000,320,0,-2,1,1,0,0,0,0,1,1,0,0,0,0,0,0,0,0,0,0,0,0,0,0,0,0,0,0,0,0,0,0
458229,32000,320,0,-2,1,1,0,0,0,0,0,0,0,0,0,0,1,1,0,0,0,0,0,0,0,0,0,0,0,0,0,0,0,0
459213,32000,320,0,-2,2,2,0,0,0,0,0,0,0,0,0,0,0,0,0,0,0,0,2,2,0,0,0,0,0,0,0,0,0,0
459259,32000,320,0,-2,1,1,0,0,0,0,1,1,0,0,0,0,0,0,0,0,0,0,0,0,0,0,0,0,0,0,0,0,0,0
459736,32000,320,0,-2,4,1,3,0,0,0,0,0,0,0,0,0,1,1,0,0,0,0,2,0,2,1,0,1,0,0,0,0,0,0
459824,32000,320,0,-2,2,2,0,0,0,0,0,0,0,0,0,0,1,1,0,0,0,0,1,1,0,0,0,0,0,0,0,0,0,0
459949,32000,320,0,-2,24,17,7,0,0,0,1,1,0,1,0,1,11,9,2,0,0,0,9,5,4,0,0,0,1,1,0,1,1,0
460349,32000,320,0,-2,2,1,1,0,0,0,0,0,0,0,0,0,1,0,1,0,0,0,1,1,0,0,0,0,0,0,0,0,0,0
460376,32000,320,0,-2,1,1,0,0,0,0,0,0,0,0,0,0,0,0,0,0,0,0,1,1,0,0,0,0,0,0,0,0,0,0
460738,32000,320,0,-2,2,1,1,0,0,0,0,0,0,0,0,0,0,0,0,0,0,0,2,1,1,0,0,0,0,0,0,0,0,0
461148,32000,320,0,-2,2,1,1,0,0,0,1,0,1,0,0,0,0,0,0,0,0,0,1,1,0,0,0,0,0,0,0,0,0,0
461795,32000,320,0,-2,1,1,0,0,0,0,0,0,0,0,0,0,0,0,0,0,0,0,0,0,0,0,0,0,0,0,0,1,1,0
464226,32000,320,0,-2,1,1,0,0,0,0,0,0,0,0,0,0,0,0,0,0,0,0,1,1,0,0,0,0,0,0,0,0,0,0
475033,32000,320,0,-2,2,2,0,0,0,0,0,0,0,0,0,0,0,0,0,0,0,0,1,1,0,0,0,0,1,1,0,0,0,0
475495,32000,320,0,-2,2,0,2,0,0,0,0,0,0,0,0,0,0,0,0,1,0,1,1,0,1,0,0,0,0,0,0,0,0,0
475565,32000,320,0,-2,1,1,0,0,0,0,0,0,0,0,0,0,0,0,0,0,0,0,1,1,0,0,0,0,0,0,0,0,0,0
475608,32000,320,0,-2,1,1,0,0,0,0,0,0,0,0,0,0,0,0,0,0,0,0,1,1,0,0,0,0,0,0,0,0,0,0
476726,32000,320,0,-2,1,1,0,0,0,0,0,0,0,0,0,0,1,1,0,0,0,0,0,0,0,0,0,0,0,0,0,0,0,0
476975,32000,320,0,-2,1,0,1,0,0,0,1,0,1,0,0,0,0,0,0,0,0,0,0,0,0,0,0,0,0,0,0,0,0,0
480091,32000,320,0,-2,3,3,0,0,0,0,0,0,0,0,0,0,1,1,0,0,0,0,2,2,0,0,0,0,0,0,0,0,0,0
480790,32000,320,0,-2,2,1,1,0,0,0,0,0,0,0,0,0,0,0,0,0,0,0,2,1,1,0,0,0,0,0,0,0,0,0
480967,32000,320,0,-2,1,1,0,0,0,0,0,0,0,0,0,0,0,0,0,0,0,0,1,1,0,0,0,0,0,0,0,0,0,0
481535,32000,320,0,-2,5,5,0,0,0,0,1,1,0,0,0,0,1,1,0,0,0,0,3,3,0,0,0,0,0,0,0,0,0,0
482149,32000,320,0,-2,95,40,55,1,0,1,13,6,7,11,3,8,6,1,5,0,0,0,33,15,18,3,2,1,1,0,1,27,13,14
482158,32000,320,0,-2,2,2,0,0,0,0,0,0,0,0,0,0,0,0,0,0,0,0,2,2,0,0,0,0,0,0,0,0,0,0
482477,32000,320,0,-2,3,3,0,0,0,0,0,0,0,1,1,0,1,1,0,0,0,0,1,1,0,0,0,0,0,0,0,0,0,0
482680,32000,320,0,-2,4,3,1,0,0,0,0,0,0,1,1,0,0,0,0,0,0,0,3,2,1,0,0,0,0,0,0,0,0,0
482705,32000,320,0,-2,1,0,1,0,0,0,0,0,0,0,0,0,0,0,0,0,0,0,1,0,1,0,0,0,0,0,0,0,0,0
482936,32000,320,0,-2,1,1,0,0,0,0,0,0,0,0,0,0,0,0,0,0,0,0,1,1,0,0,0,0,0,0,0,0,0,0
483036,32000,320,0,-2,5,3,2,0,0,0,0,0,0,1,1,0,1,1,0,0,0,0,3,1,2,0,0,0,0,0,0,0,0,0
483045,32000,320,0,-2,1,0,1,0,0,0,0,0,0,1,0,1,0,0,0,0,0,0,0,0,0,0,0,0,0,0,0,0,0,0
483124,32000,320,0,-2,15,9,6,0,0,0,1,1,0,0,0,0,2,0,2,0,0,0,3,2,1,0,0,0,5,4,1,4,2,2
484002,32000,320,0,-2,2,2,0,0,0,0,1,1,0,0,0,0,1,1,0,0,0,0,0,0,0,0,0,0,0,0,0,0,0,0
484613,32000,320,0,-2,39,25,14,0,0,0,3,3,0,0,0,0,1,0,1,0,0,0,9,2,7,5,4,1,8,4,4,13,12,1
485458,32000,320,0,-2,3,3,0,0,0,0,0,0,0,0,0,0,0,0,0,0,0,0,3,3,0,0,0,0,0,0,0,0,0,0
485768,32000,320,0,-2,1,1,0,0,0,0,0,0,0,0,0,0,1,1,0,0,0,0,0,0,0,0,0,0,0,0,0,0,0,0
486284,32000,320,0,-2,1,1,0,0,0,0,0,0,0,0,0,0,0,0,0,0,0,0,1,1,0,0,0,0,0,0,0,0,0,0
486840,32000,320,0,-2,34,23,11,0,0,0,0,0,0,8,6,2,1,0,1,0,0,0,21,15,6,1,1,0,0,0,0,3,1,2
486901,32000,320,0,-2,1,1,0,0,0,0,0,0,0,0,0,0,0,0,0,0,0,0,1,1,0,0,0,0,0,0,0,0,0,0
487010,32000,320,0,-2,75,26,49,0,0,0,9,2,7,13,3,10,3,1,2,0,0,0,33,10,23,0,0,0,1,0,1,16,10,6
487092,32000,320,0,-2,3,3,0,0,0,0,0,0,0,2,2,0,0,0,0,0,0,0,1,1,0,0,0,0,0,0,0,0,0,0
487320,32000,320,0,-2,8,7,1,0,0,0,2,1,1,1,1,0,0,0,0,0,0,0,5,5,0,0,0,0,0,0,0,0,0,0
487524,32000,320,0,-2,2,2,0,0,0,0,0,0,0,0,0,0,0,0,0,0,0,0,2,2,0,0,0,0,0,0,0,0,0,0
487861,32000,320,0,-2,1,1,0,0,0,0,0,0,0,1,1,0,0,0,0,0,0,0,0,0,0,0,0,0,0,0,0,0,0,0
488527,32000,320,0,-2,3,3,0,0,0,0,1,1,0,1,1,0,0,0,0,0,0,0,1,1,0,0,0,0,0,0,0,0,0,0
488554,32000,320,0,-2,1,0,1,0,0,0,0,0,0,0,0,0,1,0,1,0,0,0,0,0,0,0,0,0,0,0,0,0,0,0
488730,32000,320,0,-2,2,2,0,0,0,0,0,0,0,0,0,0,0,0,0,0,0,0,2,2,0,0,0,0,0,0,0,0,0,0
489937,32000,320,0,-2,2,2,0,0,0,0,0,0,0,0,0,0,2,2,0,0,0,0,0,0,0,0,0,0,0,0,0,0,0,0
490133,32000,320,0,-2,1,1,0,0,0,0,0,0,0,0,0,0,0,0,0,0,0,0,0,0,0,0,0,0,1,1,0,0,0,0
490373,32000,320,0,-2,9,2,7,0,0,0,0,0,0,0,0,0,0,0,0,0,0,0,6,2,4,0,0,0,3,0,3,0,0,0
490805,32000,320,0,-2,6,5,1,0,0,0,0,0,0,0,0,0,0,0,0,0,0,0,6,5,1,0,0,0,0,0,0,0,0,0
491808,32000,320,0,-2,1,1,0,0,0,0,0,0,0,1,1,0,0,0,0,0,0,0,0,0,0,0,0,0,0,0,0,0,0,0
491844,32000,320,0,-2,1,1,0,0,0,0,0,0,0,0,0,0,0,0,0,0,0,0,1,1,0,0,0,0,0,0,0,0,0,0
492263,32000,320,0,-2,2,1,1,0,0,0,0,0,0,0,0,0,0,0,0,0,0,0,2,1,1,0,0,0,0,0,0,0,0,0
492689,32000,320,0,-2,14,5,9,1,1,0,1,0,1,0,0,0,9,3,6,0,0,0,1,0,1,0,0,0,0,0,0,2,1,1
493822,32000,320,0,-2,1,1,0,0,0,0,0,0,0,0,0,0,0,0,0,0,0,0,1,1,0,0,0,0,0,0,0,0,0,0
494603,32000,320,0,-2,3,3,0,0,0,0,0,0,0,0,0,0,0,0,0,0,0,0,3,3,0,0,0,0,0,0,0,0,0,0
494755,32000,320,0,-2,1,1,0,0,0,0,0,0,0,0,0,0,0,0,0,0,0,0,1,1,0,0,0,0,0,0,0,0,0,0
494959,32000,320,0,-2,1,1,0,0,0,0,0,0,0,0,0,0,0,0,0,0,0,0,1,1,0,0,0,0,0,0,0,0,0,0
495314,32000,320,0,-2,2,1,1,0,0,0,0,0,0,0,0,0,0,0,0,0,0,0,2,1,1,0,0,0,0,0,0,0,0,0
495420,32000,320,0,-2,1,1,0,0,0,0,0,0,0,0,0,0,1,1,0,0,0,0,0,0,0,0,0,0,0,0,0,0,0,0
495439,32000,320,0,-2,1,1,0,0,0,0,0,0,0,1,1,0,0,0,0,0,0,0,0,0,0,0,0,0,0,0,0,0,0,0
495767,32000,320,0,-2,139,72,67,0,0,0,11,2,9,6,2,4,10,3,7,0,0,0,104,61,43,4,2,2,3,1,2,1,1,0
496043,32000,320,0,-2,1,0,1,0,0,0,0,0,0,0,0,0,0,0,0,0,0,0,1,0,1,0,0,0,0,0,0,0,0,0
496186,32000,320,0,-2,1,1,0,0,0,0,0,0,0,0,0,0,0,0,0,0,0,0,0,0,0,0,0,0,1,1,0,0,0,0
496991,32000,320,0,-2,1,0,1,0,0,0,0,0,0,0,0,0,1,0,1,0,0,0,0,0,0,0,0,0,0,0,0,0,0,0
100654,33000,330,0,-2,25,14,11,0,0,0,0,0,0,16,10,6,0,0,0,0,0,0,7,3,4,0,0,0,1,1,0,1,0,1
100663,33000,330,0,-2,65,24,41,0,0,0,0,0,0,11,2,9,0,0,0,0,0,0,50,20,30,2,1,1,2,1,1,0,0,0
100706,33000,330,0,-2,30,7,23,0,0,0,0,0,0,2,0,2,2,0,2,0,0,0,25,6,19,1,1,0,0,0,0,0,0,0
100724,33000,330,0,-2,14,7,7,0,0,0,0,0,0,10,5,5,0,0,0,0,0,0,1,0,1,0,0,0,3,2,1,0,0,0
100733,33000,330,0,-2,3,0,3,0,0,0,0,0,0,0,0,0,0,0,0,0,0,0,3,0,3,0,0,0,0,0,0,0,0,0
100751,33000,330,0,-2,137,38,99,0,0,0,3,1,2,30,6,24,4,1,3,0,0,0,98,30,68,2,0,2,0,0,0,0,0,0
100812,33000,330,0,-2,6,2,4,0,0,0,0,0,0,2,1,1,0,0,0,0,0,0,4,1,3,0,0,0,0,0,0,0,0,0
100830,33000,330,0,-2,13,4,9,0,0,0,0,0,0,4,1,3,0,0,0,0,0,0,7,1,6,0,0,0,2,2,0,0,0,0
100858,33000,330,0,-2,41,17,24,0,0,0,0,0,0,12,3,9,3,1,2,0,0,0,24,13,11,0,0,0,2,0,2,0,0,0
100937,33000,330,0,-2,10,5,5,0,0,0,0,0,0,2,2,0,0,0,0,0,0,0,7,2,5,0,0,0,1,1,0,0,0,0
101189,33000,330,0,-2,17,10,7,0,0,0,0,0,0,3,2,1,1,1,0,0,0,0,13,7,6,0,0,0,0,0,0,0,0,0
101240,33000,330,0,-2,8,3,5,0,0,0,0,0,0,3,1,2,1,0,1,0,0,0,3,2,1,1,0,1,0,0,0,0,0,0
101435,33000,330,0,-2,2,2,0,0,0,0,0,0,0,0,0,0,0,0,0,0,0,0,0,0,0,0,0,0,2,2,0,0,0,0
101471,33000,330,0,-2,1,0,1,0,0,0,0,0,0,0,0,0,0,0,0,0,0,0,1,0,1,0,0,0,0,0,0,0,0,0
101480,33000,330,0,-2,17,8,9,0,0,0,1,0,1,2,1,1,2,1,1,0,0,0,11,6,5,0,0,0,1,0,1,0,0,0
101505,33000,330,0,-2,1,1,0,0,0,0,0,0,0,0,0,0,0,0,0,0,0,0,1,1,0,0,0,0,0,0,0,0,0,0
101514,33000,330,0,-2,6,2,4,0,0,0,0,0,0,1,1,0,0,0,0,0,0,0,4,1,3,0,0,0,1,0,1,0,0,0
101587,33000,330,0,-2,6,2,4,0,0,0,0,0,0,1,0,1,0,0,0,0,0,0,3,1,2,0,0,0,2,1,1,0,0,0
101602,33000,330,0,-2,1,0,1,0,0,0,0,0,0,0,0,0,0,0,0,0,0,0,1,0,1,0,0,0,0,0,0,0,0,0
101675,33000,330,0,-2,7,5,2,0,0,0,0,0,0,7,5,2,0,0,0,0,0,0,0,0,0,0,0,0,0,0,0,0,0,0
101693,33000,330,0,-2,2,1,1,0,0,0,0,0,0,0,0,0,1,1,0,0,0,0,1,0,1,0,0,0,0,0,0,0,0,0
101709,33000,330,0,-2,33,12,21,0,0,0,0,0,0,14,6,8,0,0,0,0,0,0,19,6,13,0,0,0,0,0,0,0,0,0
101736,33000,330,0,-2,5,0,5,0,0,0,0,0,0,1,0,1,0,0,0,0,0,0,4,0,4,0,0,0,0,0,0,0,0,0
101879,33000,330,0,-2,3,3,0,0,0,0,0,0,0,0,0,0,0,0,0,0,0,0,3,3,0,0,0,0,0,0,0,0,0,0
102030,33000,330,0,-2,1,0,1,0,0,0,0,0,0,0,0,0,0,0,0,0,0,0,1,0,1,0,0,0,0,0,0,0,0,0
102049,33000,330,0,-2,1,0,1,0,0,0,0,0,0,0,0,0,0,0,0,0,0,0,1,0,1,0,0,0,0,0,0,0,0,0
102094,33000,330,0,-2,31,25,6,0,0,0,0,0,0,9,8,1,0,0,0,1,1,0,19,15,4,1,0,1,1,1,0,0,0,0
102234,33000,330,0,-2,10,3,7,0,0,0,0,0,0,3,0,3,0,0,0,0,0,0,7,3,4,0,0,0,0,0,0,0,0,0
102270,33000,330,0,-2,13,7,6,0,0,0,0,0,0,13,7,6,0,0,0,0,0,0,0,0,0,0,0,0,0,0,0,0,0,0
102298,33000,330,0,-2,5,3,2,0,0,0,0,0,0,4,2,2,0,0,0,0,0,0,1,1,0,0,0,0,0,0,0,0,0,0
102313,33000,330,0,-2,1,0,1,0,0,0,0,0,0,1,0,1,0,0,0,0,0,0,0,0,0,0,0,0,0,0,0,0,0,0
102368,33000,330,0,-2,17,11,6,0,0,0,0,0,0,1,0,1,0,0,0,0,0,0,16,11,5,0,0,0,0,0,0,0,0,0
102377,33000,330,0,-2,4,4,0,0,0,0,0,0,0,4,4,0,0,0,0,0,0,0,0,0,0,0,0,0,0,0,0,0,0,0
102395,33000,330,0,-2,2,1,1,0,0,0,0,0,0,0,0,0,0,0,0,0,0,0,2,1,1,0,0,0,0,0,0,0,0,0
102553,33000,330,0,-2,15,8,7,0,0,0,0,0,0,0,0,0,0,0,0,1,0,1,11,7,4,1,1,0,2,0,2,0,0,0
102614,33000,330,0,-2,8,4,4,1,0,1,0,0,0,0,0,0,0,0,0,0,0,0,6,3,3,0,0,0,1,1,0,0,0,0
102632,33000,330,0,-2,3,0,3,0,0,0,0,0,0,0,0,0,0,0,0,0,0,0,3,0,3,0,0,0,0,0,0,0,0,0
102669,33000,330,0,-2,1,0,1,0,0,0,0,0,0,0,0,0,0,0,0,0,0,0,1,0,1,0,0,0,0,0,0,0,0,0
102845,33000,330,0,-2,4,1,3,0,0,0,0,0,0,0,0,0,2,1,1,1,0,1,1,0,1,0,0,0,0,0,0,0,0,0
103529,33000,330,0,-2,1,1,0,0,0,0,0,0,0,0,0,0,0,0,0,0,0,0,1,1,0,0,0,0,0,0,0,0,0,0
104151,33000,330,0,-2,207,72,135,5,0,5,5,0,5,11,4,7,40,8,32,0,0,0,77,27,50,5,3,2,60,29,31,4,1,3
104160,33000,330,0,-2,10,2,8,0,0,0,0,0,0,0,0,0,6,0,6,0,0,0,3,2,1,0,0,0,1,0,1,0,0,0
104179,33000,330,0,-2,68,26,42,1,0,1,1,0,1,7,3,4,16,5,11,0,0,0,38,15,23,3,1,2,1,1,0,1,1,0
104346,33000,330,0,-2,1,0,1,0,0,0,0,0,0,0,0,0,0,0,0,0,0,0,1,0,1,0,0,0,0,0,0,0,0,0
104425,33000,330,0,-2,5,2,3,0,0,0,0,0,0,2,1,1,0,0,0,0,0,0,2,1,1,1,0,1,0,0,0,0,0,0
104577,33000,330,0,-2,5,4,1,1,1,0,0,0,0,0,0,0,0,0,0,0,0,0,4,3,1,0,0,0,0,0,0,0,0,0
104586,33000,330,0,-2,1,1,0,0,0,0,0,0,0,0,0,0,0,0,0,0,0,0,1,1,0,0,0,0,0,0,0,0,0,0
104708,33000,330,0,-2,1,1,0,0,0,0,0,0,0,0,0,0,0,0,0,0,0,0,1,1,0,0,0,0,0,0,0,0,0,0
104717,33000,330,0,-2,28,14,14,0,0,0,0,0,0,2,1,1,5,3,2,0,0,0,19,9,10,0,0,0,2,1,1,0,0,0
105145,33000,330,0,-2,1,1,0,0,0,0,0,0,0,0,0,0,0,0,0,0,0,0,1,1,0,0,0,0,0,0,0,0,0,0
105154,33000,330,0,-2,1,1,0,0,0,0,0,0,0,0,0,0,0,0,0,0,0,0,1,1,0,0,0,0,0,0,0,0,0,0
105206,33000,330,0,-2,1,1,0,0,0,0,0,0,0,0,0,0,1,1,0,0,0,0,0,0,0,0,0,0,0,0,0,0,0,0
105297,33000,330,0,-2,3,1,2,3,1,2,0,0,0,0,0,0,0,0,0,0,0,0,0,0,0,0,0,0,0,0,0,0,0,0
105330,33000,330,0,-2,48,23,25,2,1,1,2,1,1,3,0,3,6,2,4,0,0,0,33,17,16,0,0,0,2,2,0,0,0,0
105349,33000,330,0,-2,1,1,0,0,0,0,0,0,0,0,0,0,0,0,0,0,0,0,1,1,0,0,0,0,0,0,0,0,0,0
105428,33000,330,0,-2,1,0,1,0,0,0,0,0,0,1,0,1,0,0,0,0,0,0,0,0,0,0,0,0,0,0,0,0,0,0
105525,33000,330,0,-2,2,0,2,0,0,0,0,0,0,0,0,0,0,0,0,0,0,0,2,0,2,0,0,0,0,0,0,0,0,0
105589,33000,330,0,-2,1,0,1,0,0,0,0,0,0,0,0,0,0,0,0,0,0,0,1,0,1,0,0,0,0,0,0,0,0,0
105668,33000,330,0,-2,4,2,2,0,0,0,0,0,0,0,0,0,0,0,0,0,0,0,4,2,2,0,0,0,0,0,0,0,0,0
105747,33000,330,0,-2,2,0,2,0,0,0,0,0,0,1,0,1,1,0,1,0,0,0,0,0,0,0,0,0,0,0,0,0,0,0
105792,33000,330,0,-2,1,0,1,0,0,0,0,0,0,0,0,0,0,0,0,0,0,0,1,0,1,0,0,0,0,0,0,0,0,0
105899,33000,330,0,-2,14,10,4,0,0,0,0,0,0,1,1,0,0,0,0,0,0,0,13,9,4,0,0,0,0,0,0,0,0,0
106148,33000,330,0,-2,8,3,5,0,0,0,0,0,0,1,1,0,2,1,1,1,0,1,4,1,3,0,0,0,0,0,0,0,0,0
106245,33000,330,0,-2,5,5,0,0,0,0,0,0,0,1,1,0,2,2,0,0,0,0,2,2,0,0,0,0,0,0,0,0,0,0
106263,33000,330,0,-2,42,5,37,0,0,0,0,0,0,8,0,8,2,0,2,1,0,1,27,5,22,4,0,4,0,0,0,0,0,0
106306,33000,330,0,-2,2,1,1,0,0,0,0,0,0,2,1,1,0,0,0,0,0,0,0,0,0,0,0,0,0,0,0,0,0,0
106397,33000,330,0,-2,32,20,12,0,0,0,0,0,0,10,6,4,4,2,2,0,0,0,18,12,6,0,0,0,0,0,0,0,0,0
106412,33000,330,0,-2,15,12,3,0,0,0,0,0,0,11,9,2,0,0,0,0,0,0,3,3,0,0,0,0,0,0,0,1,0,1
106449,33000,330,0,-2,9,2,7,0,0,0,0,0,0,2,1,1,1,1,0,0,0,0,6,0,6,0,0,0,0,0,0,0,0,0
106458,33000,330,0,-2,24,19,5,1,1,0,2,2,0,6,4,2,0,0,0,0,0,0,15,12,3,0,0,0,0,0,0,0,0,0
106467,33000,330,0,-2,4,0,4,0,0,0,0,0,0,0,0,0,1,0,1,0,0,0,3,0,3,0,0,0,0,0,0,0,0,0
106485,33000,330,0,-2,8,6,2,0,0,0,0,0,0,0,0,0,0,0,0,0,0,0,7,5,2,0,0,0,1,1,0,0,0,0
106625,33000,330,0,-2,1,0,1,0,0,0,0,0,0,0,0,0,0,0,0,0,0,0,1,0,1,0,0,0,0,0,0,0,0,0
106704,33000,330,0,-2,29,15,14,0,0,0,0,0,0,6,4,2,0,0,0,1,1,0,20,8,12,0,0,0,0,0,0,2,2,0
106713,33000,330,0,-2,2,1,1,0,0,0,0,0,0,0,0,0,0,0,0,0,0,0,2,1,1,0,0,0,0,0,0,0,0,0
106810,33000,330,0,-2,1,1,0,0,0,0,0,0,0,0,0,0,0,0,0,0,0,0,1,1,0,0,0,0,0,0,0,0,0,0
106999,33000,330,0,-2,1,0,1,0,0,0,0,0,0,0,0,0,0,0,0,0,0,0,1,0,1,0,0,0,0,0,0,0,0,0
107044,33000,330,0,-2,8,4,4,0,0,0,0,0,0,0,0,0,0,0,0,0,0,0,8,4,4,0,0,0,0,0,0,0,0,0
107071,33000,330,0,-2,16,6,10,0,0,0,0,0,0,2,1,1,0,0,0,0,0,0,13,5,8,0,0,0,1,0,1,0,0,0
107080,33000,330,0,-2,14,9,5,0,0,0,0,0,0,3,2,1,1,0,1,0,0,0,10,7,3,0,0,0,0,0,0,0,0,0
107141,33000,330,0,-2,5,3,2,0,0,0,0,0,0,1,0,1,1,1,0,0,0,0,3,2,1,0,0,0,0,0,0,0,0,0
107318,33000,330,0,-2,4,1,3,0,0,0,0,0,0,2,1,1,0,0,0,0,0,0,2,0,2,0,0,0,0,0,0,0,0,0
107327,33000,330,0,-2,3,1,2,0,0,0,0,0,0,1,1,0,0,0,0,0,0,0,2,0,2,0,0,0,0,0,0,0,0,0
107460,33000,330,0,-2,1,0,1,1,0,1,0,0,0,0,0,0,0,0,0,0,0,0,0,0,0,0,0,0,0,0,0,0,0,0
107512,33000,330,0,-2,10,5,5,0,0,0,0,0,0,1,1,0,0,0,0,0,0,0,8,4,4,1,0,1,0,0,0,0,0,0
107521,33000,330,0,-2,2,1,1,0,0,0,0,0,0,0,0,0,0,0,0,0,0,0,2,1,1,0,0,0,0,0,0,0,0,0
107558,33000,330,0,-2,10,6,4,0,0,0,0,0,0,0,0,0,3,2,1,0,0,0,7,4,3,0,0,0,0,0,0,0,0,0
107585,33000,330,0,-2,3,1,2,0,0,0,0,0,0,0,0,0,0,0,0,0,0,0,3,1,2,0,0,0,0,0,0,0,0,0
107637,33000,330,0,-2,2,1,1,0,0,0,0,0,0,2,1,1,0,0,0,0,0,0,0,0,0,0,0,0,0,0,0,0,0,0
107664,33000,330,0,-2,6,3,3,0,0,0,0,0,0,3,1,2,0,0,0,0,0,0,3,2,1,0,0,0,0,0,0,0,0,0
107743,33000,330,0,-2,2,2,0,0,0,0,0,0,0,0,0,0,0,0,0,0,0,0,2,2,0,0,0,0,0,0,0,0,0,0
107840,33000,330,0,-2,2,2,0,0,0,0,0,0,0,2,2,0,0,0,0,0,0,0,0,0,0,0,0,0,0,0,0,0,0,0
107877,33000,330,0,-2,4,1,3,0,0,0,0,0,0,0,0,0,1,0,1,0,0,0,3,1,2,0,0,0,0,0,0,0,0,0
107983,33000,330,0,-2,5,4,1,0,0,0,0,0,0,2,2,0,0,0,0,0,0,0,3,2,1,0,0,0,0,0,0,0,0,0
108092,33000,330,0,-2,3,3,0,0,0,0,0,0,0,0,0,0,0,0,0,0,0,0,2,2,0,0,0,0,0,0,0,1,1,0
108232,33000,330,0,-2,13,9,4,0,0,0,1,1,0,3,2,1,1,0,1,0,0,0,4,2,2,2,2,0,2,2,0,0,0,0
108807,33000,330,0,-2,1,1,0,0,0,0,0,0,0,0,0,0,1,1,0,0,0,0,0,0,0,0,0,0,0,0,0,0,0,0
108852,33000,330,0,-2,2,2,0,0,0,0,0,0,0,1,1,0,0,0,0,0,0,0,1,1,0,0,0,0,0,0,0,0,0,0
108870,33000,330,0,-2,9,7,2,0,0,0,1,1,0,1,0,1,4,4,0,0,0,0,2,1,1,1,1,0,0,0,0,0,0,0
109040,33000,330,0,-2,2,1,1,0,0,0,0,0,0,0,0,0,2,1,1,0,0,0,0,0,0,0,0,0,0,0,0,0,0,0
109208,33000,330,0,-2,5,3,2,0,0,0,1,1,0,1,0,1,1,1,0,0,0,0,2,1,1,0,0,0,0,0,0,0,0,0
109350,33000,330,0,-2,1,1,0,0,0,0,0,0,0,0,0,0,1,1,0,0,0,0,0,0,0,0,0,0,0,0,0,0,0,0
109651,33000,330,0,-2,2,2,0,0,0,0,0,0,0,0,0,0,0,0,0,0,0,0,1,1,0,0,0,0,1,1,0,0,0,0
109785,33000,330,0,-2,7,3,4,0,0,0,0,0,0,0,0,0,4,1,3,0,0,0,1,1,0,1,0,1,1,1,0,0,0,0
109819,33000,330,0,-2,8,4,4,0,0,0,0,0,0,0,0,0,5,2,3,0,0,0,3,2,1,0,0,0,0,0,0,0,0,0
110097,33000,330,0,-2,9,2,7,0,0,0,0,0,0,1,1,0,3,0,3,0,0,0,3,1,2,0,0,0,1,0,1,1,0,1
110246,33000,330,0,-2,3,1,2,0,0,0,1,0,1,0,0,0,1,0,1,0,0,0,0,0,0,0,0,0,1,1,0,0,0,0
110361,33000,330,0,-2,21,11,10,0,0,0,0,0,0,5,3,2,7,2,5,1,0,1,8,6,2,0,0,0,0,0,0,0,0,0
110370,33000,330,0,-2,19,8,11,0,0,0,5,2,3,0,0,0,9,5,4,0,0,0,4,1,3,1,0,1,0,0,0,0,0,0
110398,33000,330,0,-2,7,0,7,0,0,0,1,0,1,1,0,1,0,0,0,0,0,0,3,0,3,1,0,1,1,0,1,0,0,0
110404,33000,330,0,-2,9,5,4,0,0,0,0,0,0,0,0,0,0,0,0,0,0,0,7,4,3,1,0,1,1,1,0,0,0,0
110413,33000,330,0,-2,13,4,9,0,0,0,1,0,1,1,0,1,3,0,3,0,0,0,6,3,3,2,1,1,0,0,0,0,0,0
110422,33000,330,0,-2,38,14,24,0,0,0,4,2,2,2,1,1,10,2,8,0,0,0,14,6,8,2,2,0,5,1,4,1,0,1
110486,33000,330,0,-2,11,7,4,0,0,0,1,0,1,0,0,0,2,1,1,0,0,0,5,3,2,1,1,0,2,2,0,0,0,0
110495,33000,330,0,-2,10,6,4,0,0,0,0,0,0,0,0,0,8,5,3,0,0,0,2,1,1,0,0,0,0,0,0,0,0,0
110501,33000,330,0,-2,3,1,2,0,0,0,0,0,0,1,0,1,2,1,1,0,0,0,0,0,0,0,0,0,0,0,0,0,0,0
110510,33000,330,0,-2,14,4,10,0,0,0,1,0,1,2,1,1,7,2,5,0,0,0,2,1,1,2,0,2,0,0,0,0,0,0
110529,33000,330,0,-2,16,3,13,0,0,0,1,0,1,2,0,2,10,3,7,0,0,0,3,0,3,0,0,0,0,0,0,0,0,0
110538,33000,330,0,-2,15,6,9,0,0,0,2,2,0,2,1,1,3,1,2,0,0,0,7,2,5,0,0,0,1,0,1,0,0,0
110547,33000,330,0,-2,11,8,3,0,0,0,1,1,0,2,2,0,7,4,3,0,0,0,1,1,0,0,0,0,0,0,0,0,0,0
110556,33000,330,0,-2,9,1,8,0,0,0,1,0,1,0,0,0,2,0,2,0,0,0,3,0,3,0,0,0,3,1,2,0,0,0
110565,33000,330,0,-2,34,10,24,0,0,0,3,0,3,6,2,4,11,4,7,0,0,0,11,3,8,2,1,1,0,0,0,1,0,1
110574,33000,330,0,-2,20,7,13,1,0,1,3,0,3,3,1,2,3,2,1,0,0,0,3,1,2,0,0,0,6,2,4,1,1,0
110583,33000,330,0,-2,40,15,25,1,1,0,3,0,3,4,2,2,13,7,6,0,0,0,13,5,8,1,0,1,5,0,5,0,0,0
110592,33000,330,0,-2,29,10,19,0,0,0,3,3,0,11,4,7,11,2,9,0,0,0,0,0,0,0,0,0,1,1,0,3,0,3
110608,33000,330,0,-2,26,12,14,0,0,0,1,0,1,6,4,2,6,1,5,0,0,0,9,4,5,2,1,1,2,2,0,0,0,0
110617,33000,330,0,-2,29,11,18,0,0,0,4,0,4,2,1,1,5,2,3,1,1,0,10,5,5,1,1,0,6,1,5,0,0,0
110635,33000,330,0,-2,97,43,54,0,0,0,8,1,7,12,7,5,9,4,5,0,0,0,48,21,27,7,3,4,11,7,4,2,0,2
110644,33000,330,0,-2,92,39,53,0,0,0,12,3,9,3,1,2,18,10,8,0,0,0,47,19,28,4,3,1,5,2,3,3,1,2
110653,33000,330,0,-2,27,6,21,0,0,0,2,0,2,1,0,1,7,0,7,0,0,0,13,4,9,3,2,1,0,0,0,1,0,1
110662,33000,330,0,-2,133,49,84,1,1,0,7,3,4,15,6,9,41,12,29,0,0,0,48,20,28,1,0,1,9,2,7,11,5,6
110671,33000,330,0,-2,29,19,10,0,0,0,3,2,1,4,4,0,5,3,2,0,0,0,12,6,6,1,0,1,2,2,0,2,2,0
110680,33000,330,0,-2,81,23,58,0,0,0,10,1,9,4,1,3,17,5,12,0,0,0,37,11,26,3,1,2,3,1,2,7,3,4
110699,33000,330,0,-2,90,18,72,0,0,0,12,2,10,14,3,11,23,4,19,0,0,0,27,7,20,9,1,8,3,1,2,2,0,2
110705,33000,330,0,-2,20,8,12,0,0,0,0,0,0,1,0,1,1,1,0,0,0,0,14,5,9,0,0,0,3,2,1,1,0,1
110714,33000,330,0,-2,7,2,5,0,0,0,1,0,1,0,0,0,0,0,0,0,0,0,5,2,3,0,0,0,1,0,1,0,0,0
111081,33000,330,0,-2,5,1,4,0,0,0,1,0,1,1,0,1,1,1,0,0,0,0,2,0,2,0,0,0,0,0,0,0,0,0
111188,33000,330,0,-2,3,1,2,0,0,0,0,0,0,1,1,0,0,0,0,0,0,0,2,0,2,0,0,0,0,0,0,0,0,0
111391,33000,330,0,-2,3,0,3,0,0,0,0,0,0,1,0,1,1,0,1,0,0,0,1,0,1,0,0,0,0,0,0,0,0,0
111434,33000,330,0,-2,2,1,1,0,0,0,0,0,0,0,0,0,2,1,1,0,0,0,0,0,0,0,0,0,0,0,0,0,0,0
111948,33000,330,0,-2,17,11,6,0,0,0,0,0,0,0,0,0,3,2,1,0,0,0,3,2,1,0,0,0,10,6,4,1,1,0
111966,33000,330,0,-2,7,2,5,0,0,0,0,0,0,2,1,1,3,0,3,0,0,0,1,1,0,0,0,0,1,0,1,0,0,0
112075,33000,330,0,-2,2,0,2,0,0,0,0,0,0,0,0,0,0,0,0,0,0,0,1,0,1,0,0,0,1,0,1,0,0,0
112084,33000,330,0,-2,1,1,0,0,0,0,0,0,0,0,0,0,1,1,0,0,0,0,0,0,0,0,0,0,0,0,0,0,0,0
112260,33000,330,0,-2,14,7,7,0,0,0,1,1,0,5,3,2,2,0,2,0,0,0,6,3,3,0,0,0,0,0,0,0,0,0
112561,33000,330,0,-2,2,2,0,0,0,0,0,0,0,0,0,0,0,0,0,0,0,0,1,1,0,0,0,0,1,1,0,0,0,0
112686,33000,330,0,-2,5,2,3,0,0,0,0,0,0,2,1,1,2,1,1,0,0,0,0,0,0,0,0,0,1,0,1,0,0,0
112826,33000,330,0,-2,2,1,1,0,0,0,0,0,0,0,0,0,1,0,1,0,0,0,1,1,0,0,0,0,0,0,0,0,0,0
113096,33000,330,0,-2,3,1,2,0,0,0,1,0,1,1,0,1,0,0,0,0,0,0,0,0,0,1,1,0,0,0,0,0,0,0
113573,33000,330,0,-2,1,0,1,0,0,0,0,0,0,0,0,0,0,0,0,0,0,0,1,0,1,0,0,0,0,0,0,0,0,0
113634,33000,330,0,-2,1,0,1,0,0,0,0,0,0,0,0,0,1,0,1,0,0,0,0,0,0,0,0,0,0,0,0,0,0,0
113698,33000,330,0,-2,12,9,3,0,0,0,1,1,0,0,0,0,4,3,1,1,0,1,5,4,1,0,0,0,1,1,0,0,0,0
113856,33000,330,0,-2,2,2,0,0,0,0,0,0,0,0,0,0,1,1,0,0,0,0,0,0,0,0,0,0,1,1,0,0,0,0
113980,33000,330,0,-2,1,1,0,0,0,0,0,0,0,0,0,0,1,1,0,0,0,0,0,0,0,0,0,0,0,0,0,0,0,0
114266,33000,330,0,-2,1,0,1,0,0,0,0,0,0,0,0,0,1,0,1,0,0,0,0,0,0,0,0,0,0,0,0,0,0,0
114354,33000,330,0,-2,1,0,1,0,0,0,0,0,0,0,0,0,0,0,0,0,0,0,1,0,1,0,0,0,0,0,0,0,0,0
114813,33000,330,0,-2,7,4,3,0,0,0,1,0,1,0,0,0,5,3,2,0,0,0,1,1,0,0,0,0,0,0,0,0,0,0
114840,33000,330,0,-2,4,1,3,0,0,0,1,1,0,0,0,0,1,0,1,0,0,0,2,0,2,0,0,0,0,0,0,0,0,0
115728,33000,330,0,-2,10,4,6,0,0,0,2,0,2,2,0,2,2,1,1,0,0,0,4,3,1,0,0,0,0,0,0,0,0,0
115755,33000,330,0,-2,10,6,4,0,0,0,0,0,0,1,0,1,3,3,0,0,0,0,5,2,3,0,0,0,1,1,0,0,0,0
115861,33000,330,0,-2,1,1,0,0,0,0,0,0,0,0,0,0,1,1,0,0,0,0,0,0,0,0,0,0,0,0,0,0,0,0
116439,33000,330,0,-2,1,0,1,0,0,0,0,0,0,0,0,0,0,0,0,0,0,0,1,0,1,0,0,0,0,0,0,0,0,0
117052,33000,330,0,-2,1,0,1,0,0,0,0,0,0,0,0,0,1,0,1,0,0,0,0,0,0,0,0,0,0,0,0,0,0,0
117104,33000,330,0,-2,1,1,0,0,0,0,0,0,0,0,0,0,0,0,0,0,0,0,1,1,0,0,0,0,0,0,0,0,0,0
117140,33000,330,0,-2,2,2,0,0,0,0,0,0,0,0,0,0,0,0,0,0,0,0,2,2,0,0,0,0,0,0,0,0,0,0
117168,33000,330,0,-2,2,1,1,0,0,0,0,0,0,0,0,0,0,0,0,0,0,0,2,1,1,0,0,0,0,0,0,0,0,0
117557,33000,330,0,-2,6,6,0,0,0,0,1,1,0,5,5,0,0,0,0,0,0,0,0,0,0,0,0,0,0,0,0,0,0,0
117627,33000,330,0,-2,1,1,0,0,0,0,0,0,0,0,0,0,0,0,0,0,0,0,0,0,0,0,0,0,0,0,0,1,1,0
117636,33000,330,0,-2,2,0,2,0,0,0,0,0,0,0,0,0,1,0,1,0,0,0,1,0,1,0,0,0,0,0,0,0,0,0
117672,33000,330,0,-2,3,0,3,0,0,0,2,0,2,0,0,0,0,0,0,0,0,0,1,0,1,0,0,0,0,0,0,0,0,0
117715,33000,330,0,-2,1,0,1,0,0,0,0,0,0,0,0,0,0,0,0,0,0,0,0,0,0,0,0,0,1,0,1,0,0,0
117724,33000,330,0,-2,3,2,1,0,0,0,0,0,0,1,1,0,2,1,1,0,0,0,0,0,0,0,0,0,0,0,0,0,0,0
117733,33000,330,0,-2,2,1,1,0,0,0,0,0,0,0,0,0,1,1,0,0,0,0,0,0,0,0,0,0,0,0,0,1,0,1
117751,33000,330,0,-2,3,2,1,0,0,0,0,0,0,0,0,0,0,0,0,0,0,0,3,2,1,0,0,0,0,0,0,0,0,0
117788,33000,330,0,-2,4,3,1,0,0,0,0,0,0,0,0,0,1,1,0,0,0,0,0,0,0,0,0,0,3,2,1,0,0,0
117867,33000,330,0,-2,1,0,1,0,0,0,0,0,0,0,0,0,1,0,1,0,0,0,0,0,0,0,0,0,0,0,0,0,0,0
117900,33000,330,0,-2,5,2,3,0,0,0,2,1,1,0,0,0,2,1,1,0,0,0,0,0,0,0,0,0,0,0,0,1,0,1
117946,33000,330,0,-2,24,10,14,1,1,0,3,1,2,6,1,5,1,0,1,1,0,1,6,3,3,2,1,1,4,3,1,0,0,0
118541,33000,330,0,-2,8,4,4,0,0,0,0,0,0,0,0,0,4,1,3,0,0,0,3,2,1,1,1,0,0,0,0,0,0,0
118693,33000,330,0,-2,4,2,2,0,0,0,2,2,0,0,0,0,1,0,1,0,0,0,1,0,1,0,0,0,0,0,0,0,0,0
118888,33000,330,0,-2,1,0,1,0,0,0,1,0,1,0,0,0,0,0,0,0,0,0,0,0,0,0,0,0,0,0,0,0,0,0
118912,33000,330,0,-2,1,1,0,0,0,0,0,0,0,0,0,0,1,1,0,0,0,0,0,0,0,0,0,0,0,0,0,0,0,0
118976,33000,330,0,-2,1,0,1,0,0,0,0,0,0,0,0,0,1,0,1,0,0,0,0,0,0,0,0,0,0,0,0,0,0,0
119137,33000,330,0,-2,1,0,1,0,0,0,0,0,0,0,0,0,1,0,1,0,0,0,0,0,0,0,0,0,0,0,0,0,0,0
119164,33000,330,0,-2,3,2,1,0,0,0,1,1,0,0,0,0,1,1,0,0,0,0,0,0,0,0,0,0,1,0,1,0,0,0
119216,33000,330,0,-2,3,2,1,0,0,0,0,0,0,0,0,0,1,1,0,0,0,0,2,1,1,0,0,0,0,0,0,0,0,0
119605,33000,330,0,-2,3,1,2,0,0,0,1,0,1,0,0,0,0,0,0,0,0,0,2,1,1,0,0,0,0,0,0,0,0,0
119678,33000,330,0,-2,2,1,1,0,0,0,0,0,0,0,0,0,0,0,0,0,0,0,2,1,1,0,0,0,0,0,0,0,0,0
119775,33000,330,0,-2,1,0,1,0,0,0,0,0,0,0,0,0,1,0,1,0,0,0,0,0,0,0,0,0,0,0,0,0,0,0
120254,33000,330,0,-2,20,5,15,0,0,0,2,1,1,1,1,0,7,2,5,0,0,0,4,0,4,0,0,0,0,0,0,6,1,5
120290,33000,330,0,-2,6,1,5,0,0,0,1,0,1,0,0,0,3,0,3,0,0,0,0,0,0,0,0,0,2,1,1,0,0,0
120403,33000,330,0,-2,5,1,4,0,0,0,0,0,0,1,0,1,1,0,1,0,0,0,3,1,2,0,0,0,0,0,0,0,0,0
120421,33000,330,0,-2,2,0,2,0,0,0,0,0,0,0,0,0,1,0,1,0,0,0,0,0,0,0,0,0,0,0,0,1,0,1
120537,33000,330,0,-2,8,2,6,0,0,0,1,1,0,1,0,1,2,0,2,0,0,0,2,1,1,0,0,0,2,0,2,0,0,0
120795,33000,330,0,-2,1,1,0,0,0,0,0,0,0,1,1,0,0,0,0,0,0,0,0,0,0,0,0,0,0,0,0,0,0,0
120865,33000,330,0,-2,2,2,0,0,0,0,0,0,0,0,0,0,1,1,0,0,0,0,0,0,0,0,0,0,1,1,0,0,0,0
120883,33000,330,0,-2,20,14,6,0,0,0,1,1,0,3,1,2,6,3,3,0,0,0,10,9,1,0,0,0,0,0,0,0,0,0
120971,33000,330,0,-2,2,1,1,0,0,0,0,0,0,0,0,0,1,0,1,0,0,0,1,1,0,0,0,0,0,0,0,0,0,0
121044,33000,330,0,-2,2,1,1,0,0,0,1,0,1,0,0,0,0,0,0,0,0,0,1,1,0,0,0,0,0,0,0,0,0,0
121150,33000,330,0,-2,24,9,15,0,0,0,2,1,1,1,0,1,4,2,2,0,0,0,15,5,10,2,1,1,0,0,0,0,0,0
121178,33000,330,0,-2,1,0,1,0,0,0,1,0,1,0,0,0,0,0,0,0,0,0,0,0,0,0,0,0,0,0,0,0,0,0
121257,33000,330,0,-2,2,1,1,0,0,0,0,0,0,0,0,0,1,0,1,0,0,0,1,1,0,0,0,0,0,0,0,0,0,0
121309,33000,330,0,-2,11,4,7,0,0,0,1,0,1,1,1,0,1,0,1,0,0,0,8,3,5,0,0,0,0,0,0,0,0,0
121345,33000,330,0,-2,3,2,1,0,0,0,0,0,0,1,0,1,1,1,0,0,0,0,0,0,0,0,0,0,1,1,0,0,0,0
121691,33000,330,0,-2,13,8,5,0,0,0,0,0,0,0,0,0,2,0,2,0,0,0,9,6,3,0,0,0,2,2,0,0,0,0
121707,33000,330,0,-2,1,0,1,0,0,0,0,0,0,0,0,0,0,0,0,0,0,0,1,0,1,0,0,0,0,0,0,0,0,0
121886,33000,330,0,-2,2,0,2,0,0,0,0,0,0,0,0,0,1,0,1,0,0,0,0,0,0,0,0,0,0,0,0,1,0,1
122180,33000,330,0,-2,1,0,1,0,0,0,0,0,0,0,0,0,1,0,1,0,0,0,0,0,0,0,0,0,0,0,0,0,0,0
122205,33000,330,0,-2,1,1,0,0,0,0,0,0,0,0,0,0,0,0,0,0,0,0,1,1,0,0,0,0,0,0,0,0,0,0
122409,33000,330,0,-2,87,30,57,2,0,2,11,3,8,4,2,2,37,14,23,0,0,0,21,5,16,3,0,3,8,5,3,1,1,0
122436,33000,330,0,-2,28,14,14,0,0,0,2,2,0,2,0,2,6,3,3,0,0,0,15,7,8,1,0,1,2,2,0,0,0,0
122454,33000,330,0,-2,1,0,1,0,0,0,0,0,0,0,0,0,0,0,0,0,0,0,1,0,1,0,0,0,0,0,0,0,0,0
122506,33000,330,0,-2,5,3,2,0,0,0,0,0,0,0,0,0,0,0,0,0,0,0,5,3,2,0,0,0,0,0,0,0,0,0
122597,33000,330,0,-2,27,7,20,0,0,0,10,3,7,3,1,2,7,2,5,0,0,0,6,1,5,0,0,0,1,0,1,0,0,0
122612,33000,330,0,-2,26,20,6,0,0,0,3,3,0,3,1,2,2,2,0,1,1,0,11,8,3,6,5,1,0,0,0,0,0,0
122728,33000,330,0,-2,11,8,3,0,0,0,0,0,0,3,3,0,1,1,0,1,1,0,4,2,2,2,1,1,0,0,0,0,0,0
122737,33000,330,0,-2,1,0,1,0,0,0,1,0,1,0,0,0,0,0,0,0,0,0,0,0,0,0,0,0,0,0,0,0,0,0
122746,33000,330,0,-2,1,0,1,0,0,0,0,0,0,1,0,1,0,0,0,0,0,0,0,0,0,0,0,0,0,0,0,0,0,0
122755,33000,330,0,-2,55,34,21,0,0,0,4,2,2,9,6,3,14,7,7,1,1,0,18,11,7,3,3,0,6,4,2,0,0,0
122931,33000,330,0,-2,15,7,8,0,0,0,4,2,2,1,1,0,1,0,1,0,0,0,8,4,4,0,0,0,1,0,1,0,0,0
123217,33000,330,0,-2,3,0,3,0,0,0,0,0,0,0,0,0,1,0,1,0,0,0,2,0,2,0,0,0,0,0,0,0,0,0
123341,33000,330,0,-2,1,1,0,0,0,0,0,0,0,0,0,0,0,0,0,0,0,0,0,0,0,0,0,0,1,1,0,0,0,0
123448,33000,330,0,-2,1,0,1,0,0,0,0,0,0,0,0,0,0,0,0,0,0,0,1,0,1,0,0,0,0,0,0,0,0,0
123457,33000,330,0,-2,12,6,6,0,0,0,1,1,0,0,0,0,3,3,0,0,0,0,8,2,6,0,0,0,0,0,0,0,0,0
123509,33000,330,0,-2,1,1,0,0,0,0,0,0,0,0,0,0,0,0,0,0,0,0,1,1,0,0,0,0,0,0,0,0,0,0
123554,33000,330,0,-2,12,8,4,0,0,0,0,0,0,2,1,1,1,0,1,0,0,0,4,3,1,0,0,0,5,4,1,0,0,0
123572,33000,330,0,-2,13,2,11,0,0,0,0,0,0,1,0,1,4,2,2,0,0,0,6,0,6,1,0,1,1,0,1,0,0,0
123651,33000,330,0,-2,5,1,4,0,0,0,1,0,1,0,0,0,0,0,0,0,0,0,3,1,2,1,0,1,0,0,0,0,0,0
123800,33000,330,0,-2,6,2,4,0,0,0,0,0,0,1,1,0,4,1,3,0,0,0,1,0,1,0,0,0,0,0,0,0,0,0
123943,33000,330,0,-2,1,1,0,0,0,0,0,0,0,0,0,0,1,1,0,0,0,0,0,0,0,0,0,0,0,0,0,0,0,0
123952,33000,330,0,-2,2,2,0,0,0,0,1,1,0,0,0,0,1,1,0,0,0,0,0,0,0,0,0,0,0,0,0,0,0,0
123961,33000,330,0,-2,153,66,87,0,0,0,18,7,11,22,12,10,52,15,37,0,0,0,46,26,20,8,3,5,4,2,2,3,1,2
123970,33000,330,0,-2,1,0,1,0,0,0,0,0,0,0,0,0,0,0,0,0,0,0,1,0,1,0,0,0,0,0,0,0,0,0
124557,33000,330,0,-2,30,9,21,0,0,0,7,4,3,1,1,0,7,2,5,0,0,0,12,2,10,0,0,0,0,0,0,3,0,3
125028,33000,330,0,-2,2,0,2,0,0,0,0,0,0,0,0,0,2,0,2,0,0,0,0,0,0,0,0,0,0,0,0,0,0,0
125091,33000,330,0,-2,1,1,0,0,0,0,0,0,0,1,1,0,0,0,0,0,0,0,0,0,0,0,0,0,0,0,0,0,0,0
125471,33000,330,0,-2,2,0,2,0,0,0,0,0,0,0,0,0,1,0,1,0,0,0,1,0,1,0,0,0,0,0,0,0,0,0
125727,33000,330,0,-2,4,3,1,0,0,0,0,0,0,0,0,0,0,0,0,0,0,0,4,3,1,0,0,0,0,0,0,0,0,0
125763,33000,330,0,-2,8,7,1,0,0,0,0,0,0,2,1,1,1,1,0,0,0,0,5,5,0,0,0,0,0,0,0,0,0,0
125897,33000,330,0,-2,4,2,2,0,0,0,1,0,1,0,0,0,0,0,0,0,0,0,3,2,1,0,0,0,0,0,0,0,0,0
126100,33000,330,0,-2,2,1,1,0,0,0,0,0,0,1,0,1,1,1,0,0,0,0,0,0,0,0,0,0,0,0,0,0,0,0
126182,33000,330,0,-2,7,6,1,0,0,0,1,1,0,1,1,0,2,2,0,0,0,0,1,0,1,0,0,0,2,2,0,0,0,0
126207,33000,330,0,-2,8,1,7,0,0,0,0,0,0,0,0,0,3,0,3,0,0,0,4,1,3,0,0,0,1,0,1,0,0,0
126289,33000,330,0,-2,1,1,0,0,0,0,0,0,0,0,0,0,1,1,0,0,0,0,0,0,0,0,0,0,0,0,0,0,0,0
126562,33000,330,0,-2,51,18,33,0,0,0,2,0,2,3,1,2,7,2,5,0,0,0,35,13,22,1,0,1,2,2,0,1,0,1
126580,33000,330,0,-2,15,8,7,0,0,0,0,0,0,1,1,0,2,2,0,0,0,0,9,3,6,1,1,0,2,1,1,0,0,0
126614,33000,330,0,-2,40,18,22,0,0,0,1,1,0,1,1,0,1,0,1,0,0,0,35,16,19,1,0,1,1,0,1,0,0,0
126669,33000,330,0,-2,62,22,40,0,0,0,0,0,0,4,2,2,7,2,5,0,0,0,48,17,31,3,1,2,0,0,0,0,0,0
126678,33000,330,0,-2,21,13,8,0,0,0,0,0,0,1,1,0,1,0,1,0,0,0,17,11,6,2,1,1,0,0,0,0,0,0
126711,33000,330,0,-2,4,0,4,0,0,0,0,0,0,0,0,0,2,0,2,0,0,0,2,0,2,0,0,0,0,0,0,0,0,0
126748,33000,330,0,-2,1,1,0,0,0,0,0,0,0,0,0,0,0,0,0,0,0,0,1,1,0,0,0,0,0,0,0,0,0,0
126775,33000,330,0,-2,2,2,0,0,0,0,0,0,0,0,0,0,0,0,0,0,0,0,1,1,0,0,0,0,1,1,0,0,0,0
126818,33000,330,0,-2,32,17,15,0,0,0,1,0,1,5,4,1,0,0,0,0,0,0,19,10,9,2,2,0,5,1,4,0,0,0
126942,33000,330,0,-2,14,4,10,1,0,1,0,0,0,4,2,2,4,1,3,0,0,0,4,1,3,1,0,1,0,0,0,0,0,0
127060,33000,330,0,-2,66,32,34,13,5,8,7,3,4,3,1,2,8,6,2,0,0,0,19,8,11,13,6,7,3,3,0,0,0,0
127185,33000,330,0,-2,15,7,8,0,0,0,0,0,0,1,1,0,0,0,0,0,0,0,14,6,8,0,0,0,0,0,0,0,0,0
127200,33000,330,0,-2,9,2,7,0,0,0,0,0,0,0,0,0,2,0,2,0,0,0,7,2,5,0,0,0,0,0,0,0,0,0
127389,33000,330,0,-2,1,0,1,0,0,0,0,0,0,0,0,0,0,0,0,0,0,0,1,0,1,0,0,0,0,0,0,0,0,0
127556,33000,330,0,-2,28,17,11,1,1,0,0,0,0,2,2,0,2,2,0,0,0,0,18,9,9,0,0,0,5,3,2,0,0,0
127565,33000,330,0,-2,2,0,2,0,0,0,0,0,0,0,0,0,0,0,0,0,0,0,2,0,2,0,0,0,0,0,0,0,0,0
127653,33000,330,0,-2,1,0,1,0,0,0,0,0,0,0,0,0,0,0,0,0,0,0,1,0,1,0,0,0,0,0,0,0,0,0
127732,33000,330,0,-2,5,4,1,0,0,0,1,1,0,0,0,0,0,0,0,0,0,0,4,3,1,0,0,0,0,0,0,0,0,0
127741,33000,330,0,-2,35,17,18,0,0,0,0,0,0,6,3,3,9,4,5,0,0,0,15,6,9,1,1,0,4,3,1,0,0,0
127778,33000,330,0,-2,5,1,4,0,0,0,0,0,0,1,0,1,0,0,0,0,0,0,4,1,3,0,0,0,0,0,0,0,0,0
127820,33000,330,0,-2,1,0,1,0,0,0,0,0,0,0,0,0,0,0,0,0,0,0,1,0,1,0,0,0,0,0,0,0,0,0
127884,33000,330,0,-2,1,0,1,0,0,0,0,0,0,0,0,0,1,0,1,0,0,0,0,0,0,0,0,0,0,0,0,0,0,0
127909,33000,330,0,-2,4,0,4,0,0,0,0,0,0,0,0,0,1,0,1,0,0,0,3,0,3,0,0,0,0,0,0,0,0,0
127918,33000,330,0,-2,1,1,0,0,0,0,0,0,0,0,0,0,0,0,0,0,0,0,1,1,0,0,0,0,0,0,0,0,0,0
127945,33000,330,0,-2,1,0,1,0,0,0,0,0,0,0,0,0,0,0,0,0,0,0,1,0,1,0,0,0,0,0,0,0,0,0
128106,33000,330,0,-2,24,10,14,0,0,0,1,1,0,1,1,0,9,4,5,0,0,0,11,3,8,1,0,1,1,1,0,0,0,0
128300,33000,330,0,-2,4,0,4,0,0,0,1,0,1,0,0,0,0,0,0,0,0,0,3,0,3,0,0,0,0,0,0,0,0,0
128328,33000,330,0,-2,2,2,0,0,0,0,0,0,0,0,0,0,0,0,0,0,0,0,2,2,0,0,0,0,0,0,0,0,0,0
128391,33000,330,0,-2,16,6,10,0,0,0,0,0,0,0,0,0,3,1,2,0,0,0,13,5,8,0,0,0,0,0,0,0,0,0
128498,33000,330,0,-2,8,4,4,0,0,0,0,0,0,2,2,0,0,0,0,0,0,0,5,2,3,0,0,0,1,0,1,0,0,0
128744,33000,330,0,-2,2,1,1,0,0,0,0,0,0,1,0,1,1,1,0,0,0,0,0,0,0,0,0,0,0,0,0,0,0,0
128771,33000,330,0,-2,4,3,1,0,0,0,0,0,0,3,2,1,0,0,0,0,0,0,1,1,0,0,0,0,0,0,0,0,0,0
128780,33000,330,0,-2,3,2,1,0,0,0,0,0,0,0,0,0,0,0,0,0,0,0,3,2,1,0,0,0,0,0,0,0,0,0
128902,33000,330,0,-2,6,1,5,0,0,0,0,0,0,0,0,0,0,0,0,0,0,0,5,1,4,0,0,0,1,0,1,0,0,0
129020,33000,330,0,-2,27,15,12,0,0,0,0,0,0,4,2,2,1,0,1,0,0,0,17,10,7,1,0,1,4,3,1,0,0,0
129154,33000,330,0,-2,2,1,1,0,0,0,0,0,0,0,0,0,0,0,0,0,0,0,2,1,1,0,0,0,0,0,0,0,0,0
129215,33000,330,0,-2,2,1,1,0,0,0,0,0,0,0,0,0,0,0,0,0,0,0,2,1,1,0,0,0,0,0,0,0,0,0
129242,33000,330,0,-2,7,2,5,0,0,0,0,0,0,1,1,0,0,0,0,0,0,0,6,1,5,0,0,0,0,0,0,0,0,0
129525,33000,330,0,-2,17,10,7,0,0,0,0,0,0,2,1,1,0,0,0,0,0,0,15,9,6,0,0,0,0,0,0,0,0,0
129543,33000,330,0,-2,9,5,4,0,0,0,0,0,0,2,2,0,2,0,2,0,0,0,2,1,1,0,0,0,3,2,1,0,0,0
129941,33000,330,0,-2,23,9,14,0,0,0,0,0,0,6,2,4,6,3,3,0,0,0,11,4,7,0,0,0,0,0,0,0,0,0
130183,33000,330,0,-2,8,5,3,0,0,0,0,0,0,1,0,1,1,0,1,0,0,0,6,5,1,0,0,0,0,0,0,0,0,0
130226,33000,330,0,-2,10,5,5,0,0,0,0,0,0,3,2,1,1,1,0,1,0,1,5,2,3,0,0,0,0,0,0,0,0,0
130253,33000,330,0,-2,31,18,13,0,0,0,0,0,0,2,1,1,1,1,0,0,0,0,10,6,4,0,0,0,18,10,8,0,0,0
130314,33000,330,0,-2,5,1,4,0,0,0,0,0,0,1,1,0,0,0,0,0,0,0,3,0,3,1,0,1,0,0,0,0,0,0
130396,33000,330,0,-2,4,0,4,0,0,0,1,0,1,1,0,1,1,0,1,0,0,0,0,0,0,0,0,0,1,0,1,0,0,0
130493,33000,330,0,-2,6,3,3,0,0,0,0,0,0,2,1,1,0,0,0,0,0,0,4,2,2,0,0,0,0,0,0,0,0,0
130590,33000,330,0,-2,14,6,8,0,0,0,0,0,0,3,1,2,0,0,0,0,0,0,11,5,6,0,0,0,0,0,0,0,0,0
130624,33000,330,0,-2,8,7,1,0,0,0,0,0,0,0,0,0,0,0,0,0,0,0,4,3,1,0,0,0,4,4,0,0,0,0
130697,33000,330,0,-2,6,2,4,0,0,0,0,0,0,0,0,0,0,0,0,0,0,0,4,2,2,0,0,0,2,0,2,0,0,0
130794,33000,330,0,-2,16,9,7,0,0,0,0,0,0,2,1,1,2,2,0,0,0,0,11,6,5,0,0,0,1,0,1,0,0,0
130907,33000,330,0,-2,3,0,3,0,0,0,0,0,0,0,0,0,0,0,0,0,0,0,3,0,3,0,0,0,0,0,0,0,0,0
130934,33000,330,0,-2,24,12,12,0,0,0,0,0,0,13,7,6,0,0,0,0,0,0,11,5,6,0,0,0,0,0,0,0,0,0
130943,33000,330,0,-2,43,19,24,0,0,0,0,0,0,7,2,5,1,0,1,0,0,0,35,17,18,0,0,0,0,0,0,0,0,0
130989,33000,330,0,-2,4,0,4,0,0,0,0,0,0,1,0,1,0,0,0,0,0,0,3,0,3,0,0,0,0,0,0,0,0,0
131159,33000,330,0,-2,59,20,39,1,1,0,3,0,3,15,2,13,1,0,1,0,0,0,32,13,19,0,0,0,7,4,3,0,0,0
131283,33000,330,0,-2,17,6,11,0,0,0,0,0,0,3,0,3,0,0,0,0,0,0,14,6,8,0,0,0,0,0,0,0,0,0
131399,33000,330,0,-2,5,3,2,0,0,0,0,0,0,2,1,1,0,0,0,0,0,0,3,2,1,0,0,0,0,0,0,0,0,0
131450,33000,330,0,-2,43,15,28,0,0,0,4,2,2,8,3,5,7,3,4,0,0,0,22,7,15,2,0,2,0,0,0,0,0,0
131469,33000,330,0,-2,74,28,46,0,0,0,5,1,4,10,4,6,6,4,2,0,0,0,50,17,33,2,1,1,1,1,0,0,0,0
131496,33000,330,0,-2,38,17,21,0,0,0,5,1,4,8,3,5,2,0,2,0,0,0,17,9,8,0,0,0,5,4,1,1,0,1
131520,33000,330,0,-2,24,7,17,0,0,0,0,0,0,15,3,12,1,1,0,0,0,0,2,2,0,0,0,0,6,1,5,0,0,0
131973,33000,330,0,-2,1,0,1,0,0,0,0,0,0,0,0,0,1,0,1,0,0,0,0,0,0,0,0,0,0,0,0,0,0,0
132471,33000,330,0,-2,13,6,7,0,0,0,0,0,0,1,1,0,4,1,3,1,0,1,5,3,2,0,0,0,2,1,1,0,0,0
132602,33000,330,0,-2,20,13,7,0,0,0,0,0,0,13,7,6,1,0,1,0,0,0,5,5,0,0,0,0,1,1,0,0,0,0
132657,33000,330,0,-2,9,8,1,0,0,0,0,0,0,1,1,0,1,1,0,0,0,0,3,2,1,0,0,0,4,4,0,0,0,0
132693,33000,330,0,-2,2,0,2,0,0,0,0,0,0,0,0,0,0,0,0,0,0,0,2,0,2,0,0,0,0,0,0,0,0,0
132709,33000,330,0,-2,1,0,1,0,0,0,0,0,0,1,0,1,0,0,0,0,0,0,0,0,0,0,0,0,0,0,0,0,0,0
132851,33000,330,0,-2,9,4,5,0,0,0,1,0,1,0,0,0,2,1,1,0,0,0,6,3,3,0,0,0,0,0,0,0,0,0
132879,33000,330,0,-2,3,1,2,0,0,0,0,0,0,0,0,0,1,0,1,0,0,0,1,0,1,1,1,0,0,0,0,0,0,0
132903,33000,330,0,-2,6,1,5,0,0,0,0,0,0,1,1,0,3,0,3,0,0,0,2,0,2,0,0,0,0,0,0,0,0,0
133021,33000,330,0,-2,1,1,0,0,0,0,0,0,0,0,0,0,0,0,0,0,0,0,1,1,0,0,0,0,0,0,0,0,0,0
133386,33000,330,0,-2,9,5,4,0,0,0,0,0,0,2,1,1,2,1,1,0,0,0,5,3,2,0,0,0,0,0,0,0,0,0
133492,33000,330,0,-2,5,3,2,1,0,1,0,0,0,0,0,0,0,0,0,0,0,0,4,3,1,0,0,0,0,0,0,0,0,0
133508,33000,330,0,-2,6,1,5,0,0,0,0,0,0,0,0,0,1,0,1,0,0,0,5,1,4,0,0,0,0,0,0,0,0,0
133526,33000,330,0,-2,7,6,1,0,0,0,0,0,0,5,5,0,0,0,0,0,0,0,2,1,1,0,0,0,0,0,0,0,0,0
133553,33000,330,0,-2,4,3,1,0,0,0,0,0,0,0,0,0,0,0,0,0,0,0,4,3,1,0,0,0,0,0,0,0,0,0
133650,33000,330,0,-2,7,3,4,0,0,0,0,0,0,7,3,4,0,0,0,0,0,0,0,0,0,0,0,0,0,0,0,0,0,0
133669,33000,330,0,-2,27,20,7,0,0,0,0,0,0,7,4,3,0,0,0,0,0,0,19,15,4,1,1,0,0,0,0,0,0,0
133702,33000,330,0,-2,4,1,3,0,0,0,0,0,0,1,0,1,1,1,0,0,0,0,1,0,1,1,0,1,0,0,0,0,0,0
133711,33000,330,0,-2,8,3,5,0,0,0,0,0,0,2,1,1,1,0,1,0,0,0,4,2,2,0,0,0,1,0,1,0,0,0
133809,33000,330,0,-2,1,0,1,0,0,0,0,0,0,0,0,0,0,0,0,0,0,0,1,0,1,0,0,0,0,0,0,0,0,0
133872,33000,330,0,-2,5,1,4,0,0,0,1,0,1,1,0,1,1,1,0,0,0,0,2,0,2,0,0,0,0,0,0,0,0,0
133881,33000,330,0,-2,21,5,16,0,0,0,0,0,0,2,0,2,2,0,2,1,1,0,15,4,11,1,0,1,0,0,0,0,0,0
133979,33000,330,0,-2,20,13,7,0,0,0,0,0,0,14,10,4,4,3,1,0,0,0,0,0,0,2,0,2,0,0,0,0,0,0
134079,33000,330,0,-2,23,12,11,0,0,0,0,0,0,2,2,0,3,0,3,0,0,0,18,10,8,0,0,0,0,0,0,0,0,0
134097,33000,330,0,-2,61,22,39,0,0,0,0,0,0,12,4,8,4,2,2,0,0,0,41,15,26,2,1,1,2,0,2,0,0,0
134130,33000,330,0,-2,56,15,41,0,0,0,1,0,1,3,1,2,14,1,13,0,0,0,35,10,25,0,0,0,3,3,0,0,0,0
134237,33000,330,0,-2,3,1,2,0,0,0,0,0,0,0,0,0,1,0,1,0,0,0,1,0,1,1,1,0,0,0,0,0,0,0
134495,33000,330,0,-2,6,3,3,0,0,0,0,0,0,0,0,0,0,0,0,0,0,0,4,2,2,2,1,1,0,0,0,0,0,0
134608,33000,330,0,-2,12,5,7,0,0,0,0,0,0,6,4,2,0,0,0,0,0,0,6,1,5,0,0,0,0,0,0,0,0,0
134945,33000,330,0,-2,5,1,4,0,0,0,0,0,0,2,1,1,0,0,0,0,0,0,3,0,3,0,0,0,0,0,0,0,0,0
135081,33000,330,0,-2,6,4,2,0,0,0,0,0,0,2,2,0,2,1,1,0,0,0,2,1,1,0,0,0,0,0,0,0,0,0
135160,33000,330,0,-2,1,0,1,0,0,0,0,0,0,0,0,0,0,0,0,0,0,0,0,0,0,0,0,0,1,0,1,0,0,0
135188,33000,330,0,-2,12,4,8,0,0,0,0,0,0,4,1,3,2,0,2,0,0,0,6,3,3,0,0,0,0,0,0,0,0,0
135717,33000,330,0,-2,20,8,12,0,0,0,0,0,0,5,3,2,12,5,7,0,0,0,3,0,3,0,0,0,0,0,0,0,0,0
135726,33000,330,0,-2,53,18,35,0,0,0,0,0,0,11,5,6,22,4,18,0,0,0,15,5,10,0,0,0,2,1,1,3,3,0
136172,33000,330,0,-2,27,8,19,0,0,0,0,0,0,2,2,0,2,0,2,0,0,0,21,5,16,2,1,1,0,0,0,0,0,0
136215,33000,330,0,-2,35,21,14,0,0,0,1,1,0,3,1,2,7,4,3,0,0,0,23,15,8,1,0,1,0,0,0,0,0,0
136233,33000,330,0,-2,9,5,4,1,0,1,0,0,0,1,0,1,1,0,1,0,0,0,6,5,1,0,0,0,0,0,0,0,0,0
136330,33000,330,0,-2,6,3,3,0,0,0,0,0,0,1,0,1,1,1,0,0,0,0,4,2,2,0,0,0,0,0,0,0,0,0
136358,33000,330,0,-2,8,2,6,0,0,0,0,0,0,2,0,2,3,1,2,0,0,0,3,1,2,0,0,0,0,0,0,0,0,0
136400,33000,330,0,-2,3,1,2,0,0,0,0,0,0,0,0,0,0,0,0,0,0,0,2,1,1,0,0,0,1,0,1,0,0,0
136473,33000,330,0,-2,11,4,7,0,0,0,0,0,0,2,0,2,2,1,1,0,0,0,6,3,3,1,0,1,0,0,0,0,0,0
136516,33000,330,0,-2,2,1,1,0,0,0,0,0,0,0,0,0,1,1,0,0,0,0,1,0,1,0,0,0,0,0,0,0,0,0
136774,33000,330,0,-2,3,1,2,0,0,0,0,0,0,0,0,0,0,0,0,0,0,0,3,1,2,0,0,0,0,0,0,0,0,0
136950,33000,330,0,-2,16,6,10,0,0,0,0,0,0,2,1,1,4,0,4,0,0,0,5,3,2,3,2,1,1,0,1,1,0,1
137032,33000,330,0,-2,11,4,7,0,0,0,0,0,0,0,0,0,3,2,1,0,0,0,8,2,6,0,0,0,0,0,0,0,0,0
137078,33000,330,0,-2,7,2,5,0,0,0,0,0,0,0,0,0,1,0,1,0,0,0,6,2,4,0,0,0,0,0,0,0,0,0
137096,33000,330,0,-2,8,2,6,0,0,0,0,0,0,2,1,1,0,0,0,0,0,0,5,1,4,1,0,1,0,0,0,0,0,0
137281,33000,330,0,-2,3,1,2,0,0,0,0,0,0,0,0,0,0,0,0,0,0,0,3,1,2,0,0,0,0,0,0,0,0,0
137315,33000,330,0,-2,1,1,0,0,0,0,0,0,0,0,0,0,1,1,0,0,0,0,0,0,0,0,0,0,0,0,0,0,0,0
137351,33000,330,0,-2,92,35,57,0,0,0,2,0,2,18,10,8,5,1,4,0,0,0,54,23,31,10,0,10,1,0,1,2,1,1
137476,33000,330,0,-2,18,12,6,0,0,0,0,0,0,4,3,1,7,5,2,1,1,0,4,1,3,1,1,0,0,0,0,1,1,0
137546,33000,330,0,-2,41,26,15,0,0,0,1,1,0,7,5,2,1,1,0,0,0,0,29,17,12,2,2,0,1,0,1,0,0,0
137564,33000,330,0,-2,20,8,12,0,0,0,0,0,0,2,2,0,3,1,2,0,0,0,14,4,10,1,1,0,0,0,0,0,0,0
137759,33000,330,0,-2,13,6,7,0,0,0,0,0,0,4,2,2,1,1,0,0,0,0,7,2,5,0,0,0,1,1,0,0,0,0
137847,33000,330,0,-2,22,7,15,0,0,0,0,0,0,4,1,3,2,1,1,0,0,0,15,4,11,0,0,0,1,1,0,0,0,0
138187,33000,330,0,-2,8,4,4,0,0,0,2,1,1,0,0,0,4,1,3,0,0,0,2,2,0,0,0,0,0,0,0,0,0,0
138275,33000,330,0,-2,9,9,0,0,0,0,0,0,0,1,1,0,2,2,0,0,0,0,6,6,0,0,0,0,0,0,0,0,0,0
138293,33000,330,0,-2,14,11,3,0,0,0,0,0,0,5,5,0,1,1,0,0,0,0,8,5,3,0,0,0,0,0,0,0,0,0
138354,33000,330,0,-2,6,3,3,0,0,0,0,0,0,2,2,0,0,0,0,0,0,0,4,1,3,0,0,0,0,0,0,0,0,0
138558,33000,330,0,-2,1,1,0,0,0,0,0,0,0,0,0,0,0,0,0,0,0,0,1,1,0,0,0,0,0,0,0,0,0,0
138600,33000,330,0,-2,9,2,7,0,0,0,0,0,0,3,1,2,0,0,0,0,0,0,4,1,3,0,0,0,2,0,2,0,0,0
138682,33000,330,0,-2,2,0,2,0,0,0,0,0,0,2,0,2,0,0,0,0,0,0,0,0,0,0,0,0,0,0,0,0,0,0
138716,33000,330,0,-2,5,2,3,0,0,0,0,0,0,3,1,2,0,0,0,0,0,0,2,1,1,0,0,0,0,0,0,0,0,0
138761,33000,330,0,-2,1,1,0,0,0,0,0,0,0,1,1,0,0,0,0,0,0,0,0,0,0,0,0,0,0,0,0,0,0,0
138868,33000,330,0,-2,16,13,3,0,0,0,0,0,0,3,3,0,0,0,0,0,0,0,13,10,3,0,0,0,0,0,0,0,0,0
138947,33000,330,0,-2,9,5,4,0,0,0,0,0,0,4,2,2,0,0,0,0,0,0,1,1,0,0,0,0,4,2,2,0,0,0
139144,33000,330,0,-2,13,8,5,0,0,0,0,0,0,2,1,1,1,1,0,0,0,0,10,6,4,0,0,0,0,0,0,0,0,0
139199,33000,330,0,-2,2,0,2,0,0,0,0,0,0,0,0,0,0,0,0,0,0,0,2,0,2,0,0,0,0,0,0,0,0,0
139205,33000,330,0,-2,8,4,4,0,0,0,0,0,0,2,2,0,0,0,0,0,0,0,6,2,4,0,0,0,0,0,0,0,0,0
139250,33000,330,0,-2,2,1,1,0,0,0,0,0,0,0,0,0,1,0,1,0,0,0,1,1,0,0,0,0,0,0,0,0,0,0
139278,33000,330,0,-2,3,0,3,0,0,0,1,0,1,1,0,1,0,0,0,0,0,0,1,0,1,0,0,0,0,0,0,0,0,0
139311,33000,330,0,-2,5,4,1,0,0,0,0,0,0,2,2,0,0,0,0,0,0,0,3,2,1,0,0,0,0,0,0,0,0,0
139366,33000,330,0,-2,1,0,1,0,0,0,0,0,0,0,0,0,0,0,0,0,0,0,1,0,1,0,0,0,0,0,0,0,0,0
139393,33000,330,0,-2,7,3,4,0,0,0,0,0,0,0,0,0,1,1,0,0,0,0,6,2,4,0,0,0,0,0,0,0,0,0
139621,33000,330,0,-2,1,1,0,0,0,0,0,0,0,1,1,0,0,0,0,0,0,0,0,0,0,0,0,0,0,0,0,0,0,0
139630,33000,330,0,-2,10,8,2,0,0,0,0,0,0,4,3,1,0,0,0,0,0,0,6,5,1,0,0,0,0,0,0,0,0,0
139658,33000,330,0,-2,74,14,60,0,0,0,4,2,2,30,8,22,4,0,4,0,0,0,33,3,30,2,0,2,0,0,0,1,1,0
139700,33000,330,0,-2,2,2,0,0,0,0,0,0,0,0,0,0,0,0,0,0,0,0,2,2,0,0,0,0,0,0,0,0,0,0
139719,33000,330,0,-2,4,3,1,0,0,0,0,0,0,4,3,1,0,0,0,0,0,0,0,0,0,0,0,0,0,0,0,0,0,0
139755,33000,330,0,-2,31,16,15,0,0,0,1,0,1,13,6,7,3,1,2,0,0,0,13,9,4,1,0,1,0,0,0,0,0,0
139764,33000,330,0,-2,2,1,1,0,0,0,0,0,0,0,0,0,1,1,0,0,0,0,1,0,1,0,0,0,0,0,0,0,0,0
139861,33000,330,0,-2,3,1,2,0,0,0,0,0,0,0,0,0,0,0,0,0,0,0,3,1,2,0,0,0,0,0,0,0,0,0
139931,33000,330,0,-2,29,18,11,0,0,0,0,0,0,5,4,1,1,1,0,0,0,0,21,11,10,2,2,0,0,0,0,0,0,0
139940,33000,330,0,-2,13,7,6,0,0,0,0,0,0,5,3,2,0,0,0,0,0,0,7,4,3,0,0,0,1,0,1,0,0,0
139959,33000,330,0,-2,82,31,51,0,0,0,0,0,0,17,4,13,3,0,3,0,0,0,57,24,33,1,1,0,4,2,2,0,0,0
140012,33000,330,0,-2,4,0,4,0,0,0,1,0,1,2,0,2,0,0,0,0,0,0,1,0,1,0,0,0,0,0,0,0,0,0
140234,33000,330,0,-2,6,4,2,0,0,0,0,0,0,3,2,1,0,0,0,0,0,0,3,2,1,0,0,0,0,0,0,0,0,0
140252,33000,330,0,-2,6,4,2,0,0,0,0,0,0,3,3,0,0,0,0,0,0,0,3,1,2,0,0,0,0,0,0,0,0,0
140331,33000,330,0,-2,6,2,4,0,0,0,0,0,0,1,0,1,0,0,0,0,0,0,5,2,3,0,0,0,0,0,0,0,0,0
140447,33000,330,0,-2,30,12,18,0,0,0,1,1,0,4,1,3,1,0,1,0,0,0,24,10,14,0,0,0,0,0,0,0,0,0
140562,33000,330,0,-2,6,2,4,0,0,0,1,1,0,4,1,3,0,0,0,0,0,0,1,0,1,0,0,0,0,0,0,0,0,0
140696,33000,330,0,-2,21,12,9,0,0,0,0,0,0,8,1,7,2,1,1,1,1,0,10,9,1,0,0,0,0,0,0,0,0,0
140818,33000,330,0,-2,8,4,4,0,0,0,0,0,0,0,0,0,0,0,0,0,0,0,8,4,4,0,0,0,0,0,0,0,0,0
140872,33000,330,0,-2,15,10,5,0,0,0,0,0,0,1,1,0,1,1,0,0,0,0,13,8,5,0,0,0,0,0,0,0,0,0
140951,33000,330,0,-2,90,32,58,0,0,0,3,0,3,13,5,8,5,1,4,0,0,0,42,18,24,3,0,3,14,3,11,10,5,5
140960,33000,330,0,-2,3,2,1,0,0,0,0,0,0,3,2,1,0,0,0,0,0,0,0,0,0,0,0,0,0,0,0,0,0,0
141167,33000,330,0,-2,5,5,0,0,0,0,0,0,0,0,0,0,0,0,0,0,0,0,5,5,0,0,0,0,0,0,0,0,0,0
141185,33000,330,0,-2,4,1,3,0,0,0,0,0,0,1,0,1,0,0,0,0,0,0,3,1,2,0,0,0,0,0,0,0,0,0
141237,33000,330,0,-2,3,2,1,0,0,0,0,0,0,0,0,0,1,1,0,0,0,0,2,1,1,0,0,0,0,0,0,0,0,0
141255,33000,330,0,-2,6,2,4,0,0,0,0,0,0,4,1,3,0,0,0,0,0,0,2,1,1,0,0,0,0,0,0,0,0,0
141264,33000,330,0,-2,3,1,2,0,0,0,0,0,0,1,0,1,0,0,0,0,0,0,2,1,1,0,0,0,0,0,0,0,0,0
141325,33000,330,0,-2,3,2,1,0,0,0,0,0,0,1,0,1,0,0,0,0,0,0,2,2,0,0,0,0,0,0,0,0,0,0
141334,33000,330,0,-2,3,0,3,0,0,0,0,0,0,0,0,0,0,0,0,0,0,0,3,0,3,0,0,0,0,0,0,0,0,0
141486,33000,330,0,-2,2,0,2,0,0,0,1,0,1,0,0,0,0,0,0,1,0,1,0,0,0,0,0,0,0,0,0,0,0,0
141565,33000,330,0,-2,4,1,3,0,0,0,2,1,1,0,0,0,0,0,0,2,0,2,0,0,0,0,0,0,0,0,0,0,0,0
141574,33000,330,0,-2,17,11,6,0,0,0,6,2,4,4,4,0,0,0,0,1,0,1,6,5,1,0,0,0,0,0,0,0,0,0
141644,33000,330,0,-2,5,2,3,0,0,0,1,1,0,0,0,0,0,0,0,1,1,0,2,0,2,1,0,1,0,0,0,0,0,0
141811,33000,330,0,-2,2,0,2,0,0,0,1,0,1,0,0,0,0,0,0,0,0,0,1,0,1,0,0,0,0,0,0,0,0,0
141981,33000,330,0,-2,6,3,3,0,0,0,3,1,2,0,0,0,0,0,0,1,0,1,1,1,0,1,1,0,0,0,0,0,0,0
142115,33000,330,0,-2,37,20,17,0,0,0,1,0,1,5,5,0,4,1,3,0,0,0,23,11,12,2,1,1,2,2,0,0,0,0
142179,33000,330,0,-2,9,3,6,0,0,0,1,0,1,0,0,0,2,0,2,0,0,0,6,3,3,0,0,0,0,0,0,0,0,0
142276,33000,330,0,-2,5,2,3,0,0,0,0,0,0,0,0,0,0,0,0,0,0,0,3,1,2,0,0,0,2,1,1,0,0,0
142285,33000,330,0,-2,36,15,21,1,0,1,0,0,0,1,1,0,0,0,0,0,0,0,29,12,17,1,1,0,4,1,3,0,0,0
142294,33000,330,0,-2,9,5,4,0,0,0,0,0,0,2,1,1,2,1,1,0,0,0,4,3,1,1,0,1,0,0,0,0,0,0
142328,33000,330,0,-2,5,3,2,0,0,0,0,0,0,0,0,0,0,0,0,0,0,0,5,3,2,0,0,0,0,0,0,0,0,0
142443,33000,330,0,-2,13,6,7,0,0,0,0,0,0,0,0,0,1,0,1,0,0,0,10,4,6,1,1,0,1,1,0,0,0,0
142461,33000,330,0,-2,9,4,5,0,0,0,0,0,0,0,0,0,1,1,0,0,0,0,7,3,4,0,0,0,1,0,1,0,0,0
142522,33000,330,0,-2,2,2,0,0,0,0,0,0,0,0,0,0,0,0,0,0,0,0,2,2,0,0,0,0,0,0,0,0,0,0
142559,33000,330,0,-2,10,3,7,0,0,0,1,0,1,0,0,0,3,1,2,0,0,0,5,2,3,1,0,1,0,0,0,0,0,0
142832,33000,330,0,-2,10,3,7,0,0,0,0,0,0,2,1,1,1,0,1,0,0,0,7,2,5,0,0,0,0,0,0,0,0,0
143048,33000,330,0,-2,5,4,1,0,0,0,0,0,0,0,0,0,0,0,0,0,0,0,5,4,1,0,0,0,0,0,0,0,0,0
143084,33000,330,0,-2,10,7,3,0,0,0,1,1,0,2,2,0,1,0,1,0,0,0,4,3,1,0,0,0,2,1,1,0,0,0
143118,33000,330,0,-2,11,3,8,0,0,0,0,0,0,0,0,0,2,0,2,0,0,0,9,3,6,0,0,0,0,0,0,0,0,0
143215,33000,330,0,-2,13,4,9,0,0,0,0,0,0,2,1,1,1,1,0,0,0,0,7,2,5,1,0,1,2,0,2,0,0,0
143279,33000,330,0,-2,6,3,3,0,0,0,0,0,0,0,0,0,0,0,0,0,0,0,4,3,1,0,0,0,2,0,2,0,0,0
143288,33000,330,0,-2,5,4,1,0,0,0,0,0,0,0,0,0,1,0,1,0,0,0,4,4,0,0,0,0,0,0,0,0,0,0
143358,33000,330,0,-2,20,12,8,0,0,0,1,1,0,1,1,0,0,0,0,0,0,0,18,10,8,0,0,0,0,0,0,0,0,0
143613,33000,330,0,-2,1,0,1,0,0,0,0,0,0,0,0,0,0,0,0,0,0,0,1,0,1,0,0,0,0,0,0,0,0,0
143659,33000,330,0,-2,1,0,1,0,0,0,0,0,0,0,0,0,0,0,0,0,0,0,1,0,1,0,0,0,0,0,0,0,0,0
144005,33000,330,0,-2,4,2,2,0,0,0,0,0,0,3,1,2,0,0,0,0,0,0,0,0,0,0,0,0,1,1,0,0,0,0
144014,33000,330,0,-2,1,1,0,0,0,0,0,0,0,1,1,0,0,0,0,0,0,0,0,0,0,0,0,0,0,0,0,0,0,0
144050,33000,330,0,-2,110,27,83,0,0,0,4,0,4,14,3,11,15,3,12,0,0,0,66,20,46,4,0,4,5,0,5,2,1,1
144166,33000,330,0,-2,5,3,2,0,0,0,0,0,0,4,2,2,0,0,0,0,0,0,1,1,0,0,0,0,0,0,0,0,0,0
144175,33000,330,0,-2,1,1,0,0,0,0,0,0,0,0,0,0,0,0,0,0,0,0,1,1,0,0,0,0,0,0,0,0,0,0
144184,33000,330,0,-2,4,2,2,0,0,0,0,0,0,2,1,1,0,0,0,0,0,0,2,1,1,0,0,0,0,0,0,0,0,0
144193,33000,330,0,-2,1,1,0,0,0,0,0,0,0,0,0,0,0,0,0,0,0,0,1,1,0,0,0,0,0,0,0,0,0,0
144209,33000,330,0,-2,3,0,3,0,0,0,1,0,1,2,0,2,0,0,0,0,0,0,0,0,0,0,0,0,0,0,0,0,0,0
144218,33000,330,0,-2,2,0,2,0,0,0,0,0,0,0,0,0,2,0,2,0,0,0,0,0,0,0,0,0,0,0,0,0,0,0
144281,33000,330,0,-2,14,6,8,0,0,0,0,0,0,2,1,1,5,3,2,0,0,0,4,1,3,0,0,0,3,1,2,0,0,0
144351,33000,330,0,-2,14,10,4,0,0,0,0,0,0,1,1,0,1,1,0,0,0,0,12,8,4,0,0,0,0,0,0,0,0,0
144500,33000,330,0,-2,21,4,17,0,0,0,1,0,1,9,2,7,5,1,4,0,0,0,5,1,4,1,0,1,0,0,0,0,0,0
144564,33000,330,0,-2,2,1,1,0,0,0,0,0,0,0,0,0,0,0,0,0,0,0,2,1,1,0,0,0,0,0,0,0,0,0
144740,33000,330,0,-2,26,12,14,0,0,0,1,0,1,6,3,3,3,0,3,0,0,0,10,4,6,0,0,0,6,5,1,0,0,0
144865,33000,330,0,-2,11,4,7,0,0,0,0,0,0,1,1,0,1,0,1,0,0,0,9,3,6,0,0,0,0,0,0,0,0,0
144892,33000,330,0,-2,12,7,5,0,0,0,0,0,0,2,2,0,0,0,0,0,0,0,10,5,5,0,0,0,0,0,0,0,0,0
144944,33000,330,0,-2,5,1,4,0,0,0,0,0,0,2,1,1,0,0,0,0,0,0,3,0,3,0,0,0,0,0,0,0,0,0
144962,33000,330,0,-2,12,6,6,0,0,0,0,0,0,0,0,0,2,1,1,0,0,0,7,4,3,0,0,0,3,1,2,0,0,0
144971,33000,330,0,-2,1,0,1,0,0,0,0,0,0,0,0,0,0,0,0,0,0,0,1,0,1,0,0,0,0,0,0,0,0,0
145336,33000,330,0,-2,11,3,8,0,0,0,1,0,1,3,1,2,2,1,1,0,0,0,5,1,4,0,0,0,0,0,0,0,0,0
145372,33000,330,0,-2,12,8,4,0,0,0,0,0,0,1,1,0,0,0,0,0,0,0,11,7,4,0,0,0,0,0,0,0,0,0
145521,33000,330,0,-2,2,1,1,0,0,0,0,0,0,1,1,0,0,0,0,0,0,0,1,0,1,0,0,0,0,0,0,0,0,0
145600,33000,330,0,-2,36,16,20,1,0,1,0,0,0,6,1,5,8,2,6,0,0,0,20,12,8,1,1,0,0,0,0,0,0,0
145619,33000,330,0,-2,14,8,6,0,0,0,0,0,0,2,2,0,2,1,1,1,1,0,9,4,5,0,0,0,0,0,0,0,0,0
145628,33000,330,0,-2,1,1,0,0,0,0,0,0,0,0,0,0,1,1,0,0,0,0,0,0,0,0,0,0,0,0,0,0,0,0
145637,33000,330,0,-2,98,51,47,0,0,0,7,5,2,18,15,3,5,2,3,0,0,0,64,27,37,4,2,2,0,0,0,0,0,0
145646,33000,330,0,-2,10,5,5,0,0,0,0,0,0,2,0,2,0,0,0,0,0,0,7,5,2,1,0,1,0,0,0,0,0,0
145682,33000,330,0,-2,9,3,6,0,0,0,0,0,0,0,0,0,0,0,0,0,0,0,8,3,5,1,0,1,0,0,0,0,0,0
145691,33000,330,0,-2,16,10,6,0,0,0,0,0,0,1,1,0,1,0,1,0,0,0,14,9,5,0,0,0,0,0,0,0,0,0
145725,33000,330,0,-2,1,1,0,0,0,0,0,0,0,0,0,0,0,0,0,0,0,0,0,0,0,0,0,0,1,1,0,0,0,0
145813,33000,330,0,-2,20,11,9,0,0,0,1,1,0,2,2,0,0,0,0,0,0,0,12,5,7,1,1,0,3,1,2,1,1,0
145831,33000,330,0,-2,1,1,0,0,0,0,0,0,0,0,0,0,0,0,0,0,0,0,1,1,0,0,0,0,0,0,0,0,0,0
146205,33000,330,0,-2,16,3,13,0,0,0,0,0,0,0,0,0,0,0,0,0,0,0,16,3,13,0,0,0,0,0,0,0,0,0
146278,33000,330,0,-2,3,1,2,0,0,0,0,0,0,0,0,0,0,0,0,0,0,0,2,1,1,0,0,0,1,0,1,0,0,0
146296,33000,330,0,-2,9,7,2,0,0,0,1,0,1,3,2,1,1,1,0,0,0,0,4,4,0,0,0,0,0,0,0,0,0,0
146339,33000,330,0,-2,4,4,0,0,0,0,0,0,0,0,0,0,0,0,0,0,0,0,4,4,0,0,0,0,0,0,0,0,0,0
146348,33000,330,0,-2,2,1,1,0,0,0,0,0,0,1,1,0,0,0,0,0,0,0,1,0,1,0,0,0,0,0,0,0,0,0
146366,33000,330,0,-2,3,0,3,0,0,0,0,0,0,0,0,0,0,0,0,0,0,0,3,0,3,0,0,0,0,0,0,0,0,0
146418,33000,330,0,-2,10,5,5,0,0,0,0,0,0,2,0,2,3,2,1,0,0,0,5,3,2,0,0,0,0,0,0,0,0,0
146427,33000,330,0,-2,6,4,2,0,0,0,0,0,0,0,0,0,0,0,0,0,0,0,6,4,2,0,0,0,0,0,0,0,0,0
146472,33000,330,0,-2,26,4,22,0,0,0,4,0,4,3,0,3,8,2,6,0,0,0,10,2,8,1,0,1,0,0,0,0,0,0
146481,33000,330,0,-2,6,4,2,0,0,0,0,0,0,2,2,0,0,0,0,0,0,0,4,2,2,0,0,0,0,0,0,0,0,0
146506,33000,330,0,-2,4,1,3,0,0,0,0,0,0,0,0,0,0,0,0,0,0,0,4,1,3,0,0,0,0,0,0,0,0,0
146603,33000,330,0,-2,2,0,2,0,0,0,0,0,0,0,0,0,1,0,1,0,0,0,1,0,1,0,0,0,0,0,0,0,0,0
146612,33000,330,0,-2,9,4,5,0,0,0,0,0,0,1,0,1,2,0,2,0,0,0,5,4,1,0,0,0,1,0,1,0,0,0
146676,33000,330,0,-2,4,4,0,0,0,0,0,0,0,0,0,0,0,0,0,0,0,0,4,4,0,0,0,0,0,0,0,0,0,0
146685,33000,330,0,-2,4,2,2,0,0,0,0,0,0,2,1,1,0,0,0,0,0,0,2,1,1,0,0,0,0,0,0,0,0,0
146719,33000,330,0,-2,38,14,24,0,0,0,2,2,0,4,0,4,5,4,1,0,0,0,24,8,16,1,0,1,2,0,2,0,0,0
146977,33000,330,0,-2,1,0,1,0,0,0,0,0,0,1,0,1,0,0,0,0,0,0,0,0,0,0,0,0,0,0,0,0,0,0
147013,33000,330,0,-2,20,14,6,0,0,0,0,0,0,4,3,1,1,1,0,1,1,0,14,9,5,0,0,0,0,0,0,0,0,0
147244,33000,330,0,-2,14,8,6,0,0,0,0,0,0,1,1,0,0,0,0,0,0,0,12,6,6,1,1,0,0,0,0,0,0,0
147341,33000,330,0,-2,7,4,3,0,0,0,0,0,0,0,0,0,0,0,0,0,0,0,7,4,3,0,0,0,0,0,0,0,0,0
147369,33000,330,0,-2,13,10,3,0,0,0,0,0,0,1,1,0,0,0,0,1,1,0,11,8,3,0,0,0,0,0,0,0,0,0
147536,33000,330,0,-2,45,17,28,0,0,0,2,1,1,9,4,5,12,5,7,0,0,0,21,6,15,1,1,0,0,0,0,0,0,0
147660,33000,330,0,-2,3,0,3,0,0,0,0,0,0,1,0,1,1,0,1,0,0,0,1,0,1,0,0,0,0,0,0,0,0,0
147679,33000,330,0,-2,2,2,0,0,0,0,0,0,0,0,0,0,0,0,0,0,0,0,2,2,0,0,0,0,0,0,0,0,0,0
147703,33000,330,0,-2,13,8,5,0,0,0,0,0,0,4,2,2,1,1,0,0,0,0,7,4,3,0,0,0,0,0,0,1,1,0
147767,33000,330,0,-2,50,29,21,0,0,0,2,0,2,9,7,2,6,4,2,0,0,0,31,17,14,0,0,0,1,1,0,1,0,1
147776,33000,330,0,-2,1,1,0,0,0,0,0,0,0,0,0,0,0,0,0,0,0,0,0,0,0,0,0,0,1,1,0,0,0,0
147800,33000,330,0,-2,8,1,7,0,0,0,1,0,1,0,0,0,0,0,0,0,0,0,4,1,3,0,0,0,3,0,3,0,0,0
147828,33000,330,0,-2,4,2,2,0,0,0,0,0,0,1,0,1,0,0,0,0,0,0,3,2,1,0,0,0,0,0,0,0,0,0
147916,33000,330,0,-2,4,2,2,0,0,0,0,0,0,0,0,0,1,1,0,0,0,0,0,0,0,0,0,0,3,1,2,0,0,0
148007,33000,330,0,-2,1,0,1,0,0,0,0,0,0,1,0,1,0,0,0,0,0,0,0,0,0,0,0,0,0,0,0,0,0,0
148016,33000,330,0,-2,1,1,0,0,0,0,0,0,0,0,0,0,0,0,0,0,0,0,0,0,0,0,0,0,1,1,0,0,0,0
148131,33000,330,0,-2,13,10,3,0,0,0,0,0,0,1,1,0,0,0,0,0,0,0,12,9,3,0,0,0,0,0,0,0,0,0
148256,33000,330,0,-2,5,2,3,0,0,0,0,0,0,1,1,0,0,0,0,0,0,0,4,1,3,0,0,0,0,0,0,0,0,0
148292,33000,330,0,-2,1,1,0,0,0,0,0,0,0,1,1,0,0,0,0,0,0,0,0,0,0,0,0,0,0,0,0,0,0,0
148380,33000,330,0,-2,17,6,11,0,0,0,0,0,0,5,2,3,3,0,3,0,0,0,8,4,4,0,0,0,1,0,1,0,0,0
148405,33000,330,0,-2,3,0,3,0,0,0,0,0,0,0,0,0,0,0,0,0,0,0,3,0,3,0,0,0,0,0,0,0,0,0
148487,33000,330,0,-2,11,5,6,0,0,0,0,0,0,0,0,0,1,1,0,0,0,0,3,2,1,0,0,0,7,2,5,0,0,0
148496,33000,330,0,-2,5,3,2,0,0,0,1,0,1,0,0,0,0,0,0,0,0,0,4,3,1,0,0,0,0,0,0,0,0,0
148511,33000,330,0,-2,5,3,2,0,0,0,0,0,0,1,1,0,1,0,1,0,0,0,3,2,1,0,0,0,0,0,0,0,0,0
148584,33000,330,0,-2,2,1,1,0,0,0,0,0,0,0,0,0,0,0,0,0,0,0,2,1,1,0,0,0,0,0,0,0,0,0
148627,33000,330,0,-2,8,3,5,0,0,0,1,0,1,1,0,1,1,0,1,0,0,0,0,0,0,0,0,0,5,3,2,0,0,0
148654,33000,330,0,-2,8,3,5,0,0,0,0,0,0,1,0,1,1,1,0,0,0,0,6,2,4,0,0,0,0,0,0,0,0,0
148672,33000,330,0,-2,1,0,1,0,0,0,0,0,0,0,0,0,0,0,0,0,0,0,1,0,1,0,0,0,0,0,0,0,0,0
148821,33000,330,0,-2,1,1,0,0,0,0,0,0,0,0,0,0,0,0,0,0,0,0,1,1,0,0,0,0,0,0,0,0,0,0
148937,33000,330,0,-2,1,1,0,0,0,0,0,0,0,0,0,0,0,0,0,0,0,0,1,1,0,0,0,0,0,0,0,0,0,0
148982,33000,330,0,-2,1,1,0,0,0,0,0,0,0,0,0,0,0,0,0,0,0,0,1,1,0,0,0,0,0,0,0,0,0,0
148991,33000,330,0,-2,2,0,2,0,0,0,0,0,0,0,0,0,0,0,0,0,0,0,2,0,2,0,0,0,0,0,0,0,0,0
149222,33000,330,0,-2,84,25,59,0,0,0,2,1,1,17,7,10,6,0,6,0,0,0,57,16,41,2,1,1,0,0,0,0,0,0
149231,33000,330,0,-2,24,9,15,0,0,0,0,0,0,12,2,10,1,0,1,0,0,0,9,5,4,1,1,0,1,1,0,0,0,0
149365,33000,330,0,-2,2,0,2,0,0,0,0,0,0,1,0,1,0,0,0,0,0,0,1,0,1,0,0,0,0,0,0,0,0,0
149505,33000,330,0,-2,3,1,2,0,0,0,1,1,0,2,0,2,0,0,0,0,0,0,0,0,0,0,0,0,0,0,0,0,0,0
149514,33000,330,0,-2,6,5,1,0,0,0,0,0,0,3,3,0,0,0,0,0,0,0,3,2,1,0,0,0,0,0,0,0,0,0
149532,33000,330,0,-2,4,1,3,0,0,0,0,0,0,1,0,1,2,1,1,0,0,0,1,0,1,0,0,0,0,0,0,0,0,0
149587,33000,330,0,-2,1,0,1,0,0,0,1,0,1,0,0,0,0,0,0,0,0,0,0,0,0,0,0,0,0,0,0,0,0,0
149727,33000,330,0,-2,23,12,11,0,0,0,2,1,1,3,1,2,6,3,3,0,0,0,10,6,4,0,0,0,0,0,0,2,1,1
149772,33000,330,0,-2,5,2,3,0,0,0,0,0,0,0,0,0,0,0,0,0,0,0,5,2,3,0,0,0,0,0,0,0,0,0
149781,33000,330,0,-2,14,7,7,0,0,0,2,1,1,2,1,1,1,1,0,0,0,0,8,3,5,0,0,0,1,1,0,0,0,0
149842,33000,330,0,-2,8,6,2,0,0,0,0,0,0,0,0,0,3,2,1,0,0,0,5,4,1,0,0,0,0,0,0,0,0,0
150066,33000,330,0,-2,13,7,6,0,0,0,1,1,0,1,0,1,1,0,1,0,0,0,10,6,4,0,0,0,0,0,0,0,0,0
150136,33000,330,0,-2,3,2,1,0,0,0,0,0,0,1,1,0,0,0,0,0,0,0,2,1,1,0,0,0,0,0,0,0,0,0
150145,33000,330,0,-2,5,2,3,0,0,0,0,0,0,0,0,0,0,0,0,0,0,0,5,2,3,0,0,0,0,0,0,0,0,0
150163,33000,330,0,-2,10,4,6,0,0,0,0,0,0,4,1,3,0,0,0,0,0,0,5,2,3,0,0,0,1,1,0,0,0,0
150172,33000,330,0,-2,4,3,1,0,0,0,0,0,0,0,0,0,0,0,0,0,0,0,4,3,1,0,0,0,0,0,0,0,0,0
150400,33000,330,0,-2,8,4,4,0,0,0,0,0,0,1,1,0,1,1,0,0,0,0,6,2,4,0,0,0,0,0,0,0,0,0
150455,33000,330,0,-2,17,5,12,0,0,0,1,1,0,3,0,3,0,0,0,0,0,0,12,4,8,0,0,0,0,0,0,1,0,1
150534,33000,330,0,-2,14,10,4,0,0,0,0,0,0,0,0,0,0,0,0,0,0,0,5,3,2,0,0,0,9,7,2,0,0,0
150604,33000,330,0,-2,3,0,3,0,0,0,0,0,0,0,0,0,0,0,0,0,0,0,3,0,3,0,0,0,0,0,0,0,0,0
150668,33000,330,0,-2,3,2,1,0,0,0,0,0,0,0,0,0,0,0,0,0,0,0,3,2,1,0,0,0,0,0,0,0,0,0
150677,33000,330,0,-2,5,3,2,0,0,0,0,0,0,1,1,0,0,0,0,0,0,0,4,2,2,0,0,0,0,0,0,0,0,0
150756,33000,330,0,-2,5,2,3,0,0,0,0,0,0,0,0,0,0,0,0,0,0,0,5,2,3,0,0,0,0,0,0,0,0,0
150774,33000,330,0,-2,4,2,2,0,0,0,0,0,0,0,0,0,1,1,0,0,0,0,3,1,2,0,0,0,0,0,0,0,0,0
150941,33000,330,0,-2,3,1,2,0,0,0,0,0,0,0,0,0,1,0,1,0,0,0,2,1,1,0,0,0,0,0,0,0,0,0
150987,33000,330,0,-2,113,35,78,0,0,0,0,0,0,17,4,13,7,1,6,0,0,0,86,30,56,1,0,1,2,0,2,0,0,0
151102,33000,330,0,-2,12,5,7,0,0,0,0,0,0,1,0,1,1,0,1,0,0,0,10,5,5,0,0,0,0,0,0,0,0,0
151111,33000,330,0,-2,61,23,38,0,0,0,1,0,1,12,5,7,3,2,1,0,0,0,44,16,28,1,0,1,0,0,0,0,0,0
151263,33000,330,0,-2,8,5,3,0,0,0,0,0,0,1,1,0,0,0,0,0,0,0,6,4,2,1,0,1,0,0,0,0,0,0
151290,33000,330,0,-2,6,3,3,0,0,0,0,0,0,1,0,1,0,0,0,0,0,0,5,3,2,0,0,0,0,0,0,0,0,0
151306,33000,330,0,-2,11,7,4,0,0,0,0,0,0,1,1,0,0,0,0,0,0,0,8,4,4,2,2,0,0,0,0,0,0,0
151324,33000,330,0,-2,39,16,23,0,0,0,0,0,0,5,2,3,1,0,1,0,0,0,30,13,17,3,1,2,0,0,0,0,0,0
151333,33000,330,0,-2,4,3,1,0,0,0,0,0,0,0,0,0,0,0,0,0,0,0,4,3,1,0,0,0,0,0,0,0,0,0
151342,33000,330,0,-2,10,7,3,0,0,0,0,0,0,0,0,0,2,2,0,0,0,0,8,5,3,0,0,0,0,0,0,0,0,0
151351,33000,330,0,-2,100,43,57,0,0,0,2,1,1,15,11,4,2,1,1,0,0,0,77,28,49,4,2,2,0,0,0,0,0,0
151360,33000,330,0,-2,4,0,4,0,0,0,0,0,0,2,0,2,0,0,0,0,0,0,2,0,2,0,0,0,0,0,0,0,0,0
151379,33000,330,0,-2,7,2,5,0,0,0,0,0,0,1,0,1,0,0,0,0,0,0,6,2,4,0,0,0,0,0,0,0,0,0
151388,33000,330,0,-2,6,6,0,0,0,0,0,0,0,0,0,0,0,0,0,0,0,0,6,6,0,0,0,0,0,0,0,0,0,0
151777,33000,330,0,-2,16,11,5,1,0,1,1,1,0,1,0,1,0,0,0,0,0,0,12,9,3,1,1,0,0,0,0,0,0,0
151786,33000,330,0,-2,12,9,3,0,0,0,0,0,0,1,1,0,2,2,0,0,0,0,8,6,2,1,0,1,0,0,0,0,0,0
151801,33000,330,0,-2,3,1,2,0,0,0,0,0,0,0,0,0,0,0,0,0,0,0,3,1,2,0,0,0,0,0,0,0,0,0
151865,33000,330,0,-2,1,0,1,0,0,0,0,0,0,0,0,0,0,0,0,0,0,0,1,0,1,0,0,0,0,0,0,0,0,0
152080,33000,330,0,-2,60,35,25,0,0,0,2,2,0,8,5,3,5,3,2,0,0,0,33,20,13,6,3,3,4,2,2,2,0,2
152099,33000,330,0,-2,8,8,0,0,0,0,0,0,0,0,0,0,0,0,0,0,0,0,8,8,0,0,0,0,0,0,0,0,0,0
152318,33000,330,0,-2,3,3,0,0,0,0,0,0,0,0,0,0,0,0,0,0,0,0,3,3,0,0,0,0,0,0,0,0,0,0
152336,33000,330,0,-2,1,1,0,0,0,0,0,0,0,0,0,0,0,0,0,0,0,0,1,1,0,0,0,0,0,0,0,0,0,0
152381,33000,330,0,-2,2,1,1,0,0,0,0,0,0,1,1,0,0,0,0,0,0,0,1,0,1,0,0,0,0,0,0,0,0,0
152390,33000,330,0,-2,6,0,6,0,0,0,0,0,0,1,0,1,0,0,0,0,0,0,5,0,5,0,0,0,0,0,0,0,0,0
152530,33000,330,0,-2,9,7,2,0,0,0,0,0,0,0,0,0,0,0,0,0,0,0,9,7,2,0,0,0,0,0,0,0,0,0
152600,33000,330,0,-2,2,2,0,0,0,0,0,0,0,0,0,0,0,0,0,0,0,0,0,0,0,0,0,0,2,2,0,0,0,0
152637,33000,330,0,-2,12,4,8,0,0,0,0,0,0,1,0,1,0,0,0,0,0,0,11,4,7,0,0,0,0,0,0,0,0,0
152673,33000,330,0,-2,12,9,3,0,0,0,0,0,0,1,1,0,0,0,0,0,0,0,11,8,3,0,0,0,0,0,0,0,0,0
152992,33000,330,0,-2,14,11,3,0,0,0,0,0,0,2,2,0,1,0,1,0,0,0,8,7,1,1,0,1,1,1,0,1,1,0
153001,33000,330,0,-2,12,8,4,0,0,0,0,0,0,2,1,1,1,0,1,0,0,0,9,7,2,0,0,0,0,0,0,0,0,0
153108,33000,330,0,-2,7,5,2,0,0,0,0,0,0,0,0,0,0,0,0,0,0,0,7,5,2,0,0,0,0,0,0,0,0,0
153126,33000,330,0,-2,11,5,6,0,0,0,0,0,0,0,0,0,0,0,0,0,0,0,11,5,6,0,0,0,0,0,0,0,0,0
153144,33000,330,0,-2,13,11,2,0,0,0,0,0,0,2,1,1,1,1,0,0,0,0,10,9,1,0,0,0,0,0,0,0,0,0
153162,33000,330,0,-2,6,4,2,0,0,0,0,0,0,0,0,0,0,0,0,0,0,0,6,4,2,0,0,0,0,0,0,0,0,0
153214,33000,330,0,-2,5,1,4,0,0,0,0,0,0,1,0,1,1,1,0,0,0,0,3,0,3,0,0,0,0,0,0,0,0,0
153250,33000,330,0,-2,12,4,8,0,0,0,0,0,0,0,0,0,1,1,0,0,0,0,11,3,8,0,0,0,0,0,0,0,0,0
153269,33000,330,0,-2,17,8,9,0,0,0,0,0,0,3,3,0,0,0,0,0,0,0,12,4,8,0,0,0,0,0,0,2,1,1
153278,33000,330,0,-2,12,5,7,0,0,0,0,0,0,1,1,0,2,1,1,0,0,0,9,3,6,0,0,0,0,0,0,0,0,0
153302,33000,330,0,-2,3,1,2,0,0,0,0,0,0,0,0,0,0,0,0,0,0,0,3,1,2,0,0,0,0,0,0,0,0,0
153311,33000,330,0,-2,6,0,6,0,0,0,0,0,0,0,0,0,0,0,0,0,0,0,6,0,6,0,0,0,0,0,0,0,0,0
153320,33000,330,0,-2,1,1,0,0,0,0,0,0,0,0,0,0,0,0,0,0,0,0,1,1,0,0,0,0,0,0,0,0,0,0
153366,33000,330,0,-2,7,6,1,0,0,0,0,0,0,0,0,0,0,0,0,0,0,0,7,6,1,0,0,0,0,0,0,0,0,0
153375,33000,330,0,-2,1,1,0,0,0,0,0,0,0,0,0,0,0,0,0,0,0,0,1,1,0,0,0,0,0,0,0,0,0,0
153384,33000,330,0,-2,4,2,2,0,0,0,0,0,0,1,0,1,0,0,0,0,0,0,3,2,1,0,0,0,0,0,0,0,0,0
153472,33000,330,0,-2,14,9,5,0,0,0,0,0,0,2,2,0,1,0,1,0,0,0,11,7,4,0,0,0,0,0,0,0,0,0
153524,33000,330,0,-2,12,7,5,0,0,0,0,0,0,3,3,0,1,0,1,0,0,0,7,3,4,0,0,0,1,1,0,0,0,0
153533,33000,330,0,-2,4,4,0,0,0,0,0,0,0,0,0,0,0,0,0,0,0,0,4,4,0,0,0,0,0,0,0,0,0,0
153603,33000,330,0,-2,76,24,52,0,0,0,1,0,1,3,2,1,5,2,3,0,0,0,61,18,43,4,1,3,1,0,1,1,1,0
153621,33000,330,0,-2,8,3,5,0,0,0,0,0,0,1,1,0,0,0,0,0,0,0,7,2,5,0,0,0,0,0,0,0,0,0
153630,33000,330,0,-2,23,12,11,0,0,0,0,0,0,2,1,1,2,2,0,0,0,0,19,9,10,0,0,0,0,0,0,0,0,0
153658,33000,330,0,-2,56,21,35,0,0,0,0,0,0,4,2,2,4,3,1,0,0,0,43,12,31,0,0,0,5,4,1,0,0,0
153737,33000,330,0,-2,11,3,8,0,0,0,0,0,0,1,1,0,0,0,0,0,0,0,7,1,6,1,0,1,2,1,1,0,0,0
153825,33000,330,0,-2,13,6,7,0,0,0,1,1,0,2,1,1,1,0,1,0,0,0,8,4,4,0,0,0,0,0,0,1,0,1
153834,33000,330,0,-2,5,2,3,0,0,0,0,0,0,0,0,0,2,0,2,0,0,0,3,2,1,0,0,0,0,0,0,0,0,0
153861,33000,330,0,-2,4,0,4,0,0,0,0,0,0,0,0,0,0,0,0,0,0,0,4,0,4,0,0,0,0,0,0,0,0,0
153922,33000,330,0,-2,3,1,2,0,0,0,0,0,0,0,0,0,0,0,0,0,0,0,3,1,2,0,0,0,0,0,0,0,0,0
154004,33000,330,0,-2,6,5,1,0,0,0,0,0,0,0,0,0,0,0,0,0,0,0,6,5,1,0,0,0,0,0,0,0,0,0
154013,33000,330,0,-2,14,7,7,0,0,0,1,1,0,4,2,2,0,0,0,0,0,0,9,4,5,0,0,0,0,0,0,0,0,0
154022,33000,330,0,-2,3,0,3,0,0,0,0,0,0,2,0,2,0,0,0,0,0,0,1,0,1,0,0,0,0,0,0,0,0,0
154059,33000,330,0,-2,7,3,4,0,0,0,0,0,0,0,0,0,0,0,0,0,0,0,5,2,3,1,0,1,0,0,0,1,1,0
154095,33000,330,0,-2,6,5,1,0,0,0,0,0,0,2,2,0,0,0,0,0,0,0,4,3,1,0,0,0,0,0,0,0,0,0
154101,33000,330,0,-2,4,1,3,0,0,0,0,0,0,0,0,0,0,0,0,0,0,0,4,1,3,0,0,0,0,0,0,0,0,0
154110,33000,330,0,-2,1,0,1,0,0,0,0,0,0,0,0,0,0,0,0,0,0,0,1,0,1,0,0,0,0,0,0,0,0,0
154156,33000,330,0,-2,1,0,1,0,0,0,0,0,0,0,0,0,0,0,0,0,0,0,1,0,1,0,0,0,0,0,0,0,0,0
154174,33000,330,0,-2,3,0,3,0,0,0,0,0,0,0,0,0,0,0,0,0,0,0,3,0,3,0,0,0,0,0,0,0,0,0
154235,33000,330,0,-2,7,4,3,0,0,0,0,0,0,0,0,0,0,0,0,0,0,0,6,3,3,0,0,0,1,1,0,0,0,0
154350,33000,330,0,-2,14,6,8,0,0,0,0,0,0,1,0,1,1,0,1,0,0,0,12,6,6,0,0,0,0,0,0,0,0,0
154378,33000,330,0,-2,12,4,8,0,0,0,0,0,0,1,1,0,2,1,1,0,0,0,9,2,7,0,0,0,0,0,0,0,0,0
154396,33000,330,0,-2,5,3,2,0,0,0,0,0,0,2,1,1,0,0,0,0,0,0,3,2,1,0,0,0,0,0,0,0,0,0
154518,33000,330,0,-2,8,6,2,0,0,0,0,0,0,3,1,2,1,1,0,0,0,0,4,4,0,0,0,0,0,0,0,0,0,0
154527,33000,330,0,-2,5,3,2,0,0,0,0,0,0,1,1,0,0,0,0,0,0,0,4,2,2,0,0,0,0,0,0,0,0,0
154536,33000,330,0,-2,1,0,1,0,0,0,0,0,0,0,0,0,0,0,0,0,0,0,1,0,1,0,0,0,0,0,0,0,0,0
154590,33000,330,0,-2,3,0,3,0,0,0,1,0,1,0,0,0,0,0,0,0,0,0,2,0,2,0,0,0,0,0,0,0,0,0
154642,33000,330,0,-2,5,2,3,0,0,0,0,0,0,2,0,2,0,0,0,0,0,0,3,2,1,0,0,0,0,0,0,0,0,0
154688,33000,330,0,-2,3,2,1,0,0,0,0,0,0,0,0,0,0,0,0,0,0,0,3,2,1,0,0,0,0,0,0,0,0,0
154697,33000,330,0,-2,7,5,2,0,0,0,0,0,0,2,2,0,0,0,0,0,0,0,5,3,2,0,0,0,0,0,0,0,0,0
154712,33000,330,0,-2,1,1,0,0,0,0,0,0,0,0,0,0,0,0,0,0,0,0,1,1,0,0,0,0,0,0,0,0,0,0
154721,33000,330,0,-2,12,8,4,0,0,0,0,0,0,6,5,1,1,0,1,0,0,0,3,1,2,2,2,0,0,0,0,0,0,0
154749,33000,330,0,-2,8,6,2,0,0,0,0,0,0,2,2,0,0,0,0,0,0,0,6,4,2,0,0,0,0,0,0,0,0,0
154800,33000,330,0,-2,3,2,1,0,0,0,0,0,0,0,0,0,0,0,0,0,0,0,1,0,1,2,2,0,0,0,0,0,0,0
154855,33000,330,0,-2,3,3,0,0,0,0,0,0,0,0,0,0,1,1,0,0,0,0,2,2,0,0,0,0,0,0,0,0,0,0
154907,33000,330,0,-2,8,7,1,0,0,0,0,0,0,0,0,0,0,0,0,0,0,0,8,7,1,0,0,0,0,0,0,0,0,0
154925,33000,330,0,-2,1,0,1,0,0,0,0,0,0,0,0,0,0,0,0,0,0,0,1,0,1,0,0,0,0,0,0,0,0,0
154934,33000,330,0,-2,2,1,1,0,0,0,0,0,0,0,0,0,0,0,0,0,0,0,2,1,1,0,0,0,0,0,0,0,0,0
154952,33000,330,0,-2,5,4,1,0,0,0,0,0,0,1,1,0,1,0,1,0,0,0,3,3,0,0,0,0,0,0,0,0,0,0
154998,33000,330,0,-2,8,6,2,0,0,0,0,0,0,2,1,1,2,2,0,0,0,0,4,3,1,0,0,0,0,0,0,0,0,0
155007,33000,330,0,-2,3,1,2,0,0,0,0,0,0,1,0,1,1,0,1,0,0,0,0,0,0,1,1,0,0,0,0,0,0,0
155025,33000,330,0,-2,9,4,5,0,0,0,0,0,0,0,0,0,0,0,0,0,0,0,9,4,5,0,0,0,0,0,0,0,0,0
155061,33000,330,0,-2,2,2,0,0,0,0,0,0,0,0,0,0,0,0,0,0,0,0,2,2,0,0,0,0,0,0,0,0,0,0
155089,33000,330,0,-2,11,10,1,0,0,0,0,0,0,3,2,1,1,1,0,0,0,0,7,7,0,0,0,0,0,0,0,0,0,0
155098,33000,330,0,-2,3,2,1,0,0,0,0,0,0,1,0,1,0,0,0,0,0,0,2,2,0,0,0,0,0,0,0,0,0,0
155104,33000,330,0,-2,19,14,5,0,0,0,0,0,0,5,5,0,4,3,1,0,0,0,8,5,3,2,1,1,0,0,0,0,0,0
155177,33000,330,0,-2,1,1,0,0,0,0,0,0,0,0,0,0,0,0,0,0,0,0,1,1,0,0,0,0,0,0,0,0,0,0
155186,33000,330,0,-2,7,5,2,0,0,0,0,0,0,0,0,0,3,2,1,0,0,0,4,3,1,0,0,0,0,0,0,0,0,0
155195,33000,330,0,-2,6,5,1,0,0,0,0,0,0,2,2,0,0,0,0,0,0,0,4,3,1,0,0,0,0,0,0,0,0,0
155201,33000,330,0,-2,4,2,2,0,0,0,0,0,0,0,0,0,1,0,1,0,0,0,3,2,1,0,0,0,0,0,0,0,0,0
155210,33000,330,0,-2,1,1,0,0,0,0,0,0,0,0,0,0,0,0,0,0,0,0,1,1,0,0,0,0,0,0,0,0,0,0
155292,33000,330,0,-2,4,1,3,0,0,0,0,0,0,1,0,1,0,0,0,0,0,0,3,1,2,0,0,0,0,0,0,0,0,0
155317,33000,330,0,-2,38,10,28,0,0,0,3,0,3,2,1,1,3,1,2,0,0,0,28,8,20,0,0,0,0,0,0,2,0,2
155335,33000,330,0,-2,9,5,4,0,0,0,0,0,0,0,0,0,1,0,1,0,0,0,8,5,3,0,0,0,0,0,0,0,0,0
155399,33000,330,0,-2,23,5,18,0,0,0,0,0,0,0,0,0,1,0,1,0,0,0,18,5,13,2,0,2,0,0,0,2,0,2
155414,33000,330,0,-2,5,2,3,0,0,0,0,0,0,1,1,0,1,0,1,0,0,0,3,1,2,0,0,0,0,0,0,0,0,0
155511,33000,330,0,-2,7,5,2,0,0,0,0,0,0,1,0,1,0,0,0,0,0,0,6,5,1,0,0,0,0,0,0,0,0,0
155566,33000,330,0,-2,5,3,2,1,0,1,0,0,0,1,1,0,0,0,0,0,0,0,3,2,1,0,0,0,0,0,0,0,0,0
155618,33000,330,0,-2,4,3,1,0,0,0,0,0,0,1,1,0,0,0,0,0,0,0,3,2,1,0,0,0,0,0,0,0,0,0
155627,33000,330,0,-2,12,7,5,0,0,0,0,0,0,1,1,0,0,0,0,0,0,0,11,6,5,0,0,0,0,0,0,0,0,0
155715,33000,330,0,-2,11,8,3,0,0,0,0,0,0,5,4,1,0,0,0,0,0,0,6,4,2,0,0,0,0,0,0,0,0,0
155812,33000,330,0,-2,7,5,2,0,0,0,0,0,0,0,0,0,0,0,0,0,0,0,6,4,2,1,1,0,0,0,0,0,0,0
155830,33000,330,0,-2,1,0,1,0,0,0,0,0,0,0,0,0,0,0,0,0,0,0,1,0,1,0,0,0,0,0,0,0,0,0
155858,33000,330,0,-2,7,4,3,0,0,0,0,0,0,0,0,0,2,2,0,0,0,0,3,2,1,2,0,2,0,0,0,0,0,0
155900,33000,330,0,-2,10,4,6,0,0,0,0,0,0,1,1,0,0,0,0,0,0,0,8,3,5,1,0,1,0,0,0,0,0,0
155937,33000,330,0,-2,3,1,2,0,0,0,0,0,0,1,1,0,0,0,0,0,0,0,2,0,2,0,0,0,0,0,0,0,0,0
155973,33000,330,0,-2,1,1,0,0,0,0,0,0,0,0,0,0,0,0,0,0,0,0,1,1,0,0,0,0,0,0,0,0,0,0
156082,33000,330,0,-2,1,1,0,0,0,0,0,0,0,0,0,0,0,0,0,0,0,0,0,0,0,0,0,0,1,1,0,0,0,0
156125,33000,330,0,-2,52,16,36,2,1,1,3,1,2,5,2,3,5,1,4,0,0,0,35,11,24,1,0,1,0,0,0,1,0,1
156213,33000,330,0,-2,5,2,3,0,0,0,0,0,0,0,0,0,0,0,0,0,0,0,5,2,3,0,0,0,0,0,0,0,0,0
156231,33000,330,0,-2,1,0,1,0,0,0,0,0,0,0,0,0,0,0,0,0,0,0,1,0,1,0,0,0,0,0,0,0,0,0
156286,33000,330,0,-2,22,11,11,0,0,0,0,0,0,2,0,2,0,0,0,0,0,0,17,11,6,3,0,3,0,0,0,0,0,0
156295,33000,330,0,-2,8,2,6,0,0,0,0,0,0,1,0,1,0,0,0,0,0,0,7,2,5,0,0,0,0,0,0,0,0,0
156338,33000,330,0,-2,5,2,3,0,0,0,0,0,0,1,1,0,0,0,0,0,0,0,2,1,1,0,0,0,2,0,2,0,0,0
156356,33000,330,0,-2,5,2,3,0,0,0,0,0,0,1,1,0,0,0,0,0,0,0,3,1,2,0,0,0,1,0,1,0,0,0
156365,33000,330,0,-2,15,11,4,0,0,0,0,0,0,1,1,0,0,0,0,0,0,0,12,8,4,0,0,0,2,2,0,0,0,0
156392,33000,330,0,-2,3,1,2,0,0,0,0,0,0,1,0,1,0,0,0,0,0,0,1,0,1,1,1,0,0,0,0,0,0,0
156408,33000,330,0,-2,25,16,9,0,0,0,1,1,0,5,4,1,0,0,0,0,0,0,17,10,7,1,1,0,1,0,1,0,0,0
156541,33000,330,0,-2,28,16,12,0,0,0,1,1,0,4,4,0,0,0,0,0,0,0,23,11,12,0,0,0,0,0,0,0,0,0
156620,33000,330,0,-2,15,6,9,0,0,0,0,0,0,1,0,1,1,0,1,0,0,0,11,6,5,1,0,1,0,0,0,1,0,1
156648,33000,330,0,-2,3,0,3,0,0,0,0,0,0,0,0,0,0,0,0,0,0,0,2,0,2,0,0,0,1,0,1,0,0,0
156745,33000,330,0,-2,9,5,4,0,0,0,0,0,0,2,2,0,1,1,0,0,0,0,6,2,4,0,0,0,0,0,0,0,0,0
156860,33000,330,0,-2,2,0,2,0,0,0,0,0,0,0,0,0,0,0,0,0,0,0,2,0,2,0,0,0,0,0,0,0,0,0
156921,33000,330,0,-2,6,1,5,0,0,0,0,0,0,4,0,4,0,0,0,0,0,0,2,1,1,0,0,0,0,0,0,0,0,0
157058,33000,330,0,-2,30,9,21,0,0,0,1,0,1,14,3,11,0,0,0,0,0,0,4,0,4,0,0,0,11,6,5,0,0,0
157076,33000,330,0,-2,6,5,1,0,0,0,0,0,0,1,1,0,0,0,0,0,0,0,5,4,1,0,0,0,0,0,0,0,0,0
157085,33000,330,0,-2,69,26,43,0,0,0,1,0,1,15,11,4,1,1,0,0,0,0,50,14,36,1,0,1,0,0,0,1,0,1
157100,33000,330,0,-2,8,8,0,0,0,0,0,0,0,3,3,0,0,0,0,0,0,0,5,5,0,0,0,0,0,0,0,0,0,0
157216,33000,330,0,-2,13,10,3,0,0,0,0,0,0,2,2,0,0,0,0,0,0,0,9,8,1,0,0,0,2,0,2,0,0,0
157289,33000,330,0,-2,58,29,29,0,0,0,0,0,0,10,7,3,2,0,2,0,0,0,40,19,21,2,1,1,1,1,0,3,1,2
157331,33000,330,0,-2,1,0,1,0,0,0,0,0,0,0,0,0,0,0,0,0,0,0,1,0,1,0,0,0,0,0,0,0,0,0
157377,33000,330,0,-2,5,2,3,0,0,0,0,0,0,0,0,0,0,0,0,0,0,0,5,2,3,0,0,0,0,0,0,0,0,0
157386,33000,330,0,-2,11,5,6,0,0,0,0,0,0,2,0,2,0,0,0,0,0,0,9,5,4,0,0,0,0,0,0,0,0,0
157438,33000,330,0,-2,3,1,2,0,0,0,0,0,0,1,0,1,0,0,0,0,0,0,2,1,1,0,0,0,0,0,0,0,0,0
157447,33000,330,0,-2,25,10,15,0,0,0,0,0,0,4,1,3,1,1,0,0,0,0,19,8,11,1,0,1,0,0,0,0,0,0
157483,33000,330,0,-2,5,3,2,0,0,0,0,0,0,1,1,0,0,0,0,0,0,0,4,2,2,0,0,0,0,0,0,0,0,0
157535,33000,330,0,-2,24,18,6,0,0,0,0,0,0,2,2,0,0,0,0,0,0,0,22,16,6,0,0,0,0,0,0,0,0,0
157748,33000,330,0,-2,3,3,0,0,0,0,0,0,0,0,0,0,0,0,0,0,0,0,3,3,0,0,0,0,0,0,0,0,0,0
157757,33000,330,0,-2,8,4,4,0,0,0,2,0,2,1,0,1,0,0,0,0,0,0,4,3,1,0,0,0,1,1,0,0,0,0
157809,33000,330,0,-2,10,6,4,0,0,0,0,0,0,0,0,0,0,0,0,0,0,0,9,6,3,1,0,1,0,0,0,0,0,0
157818,33000,330,0,-2,12,4,8,0,0,0,0,0,0,1,0,1,0,0,0,0,0,0,10,4,6,1,0,1,0,0,0,0,0,0
157854,33000,330,0,-2,1,1,0,0,0,0,0,0,0,0,0,0,0,0,0,0,0,0,1,1,0,0,0,0,0,0,0,0,0,0
157863,33000,330,0,-2,11,6,5,0,0,0,0,0,0,0,0,0,0,0,0,0,0,0,11,6,5,0,0,0,0,0,0,0,0,0
157951,33000,330,0,-2,18,7,11,0,0,0,0,0,0,2,1,1,0,0,0,0,0,0,15,6,9,0,0,0,1,0,1,0,0,0
158477,33000,330,0,-2,8,5,3,0,0,0,0,0,0,2,2,0,0,0,0,0,0,0,6,3,3,0,0,0,0,0,0,0,0,0
158802,33000,330,0,-2,3,3,0,0,0,0,0,0,0,2,2,0,0,0,0,0,0,0,1,1,0,0,0,0,0,0,0,0,0,0
159009,33000,330,0,-2,21,14,7,0,0,0,0,0,0,16,9,7,0,0,0,0,0,0,5,5,0,0,0,0,0,0,0,0,0,0
159382,33000,330,0,-2,5,4,1,0,0,0,0,0,0,0,0,0,0,0,0,0,0,0,4,3,1,0,0,0,0,0,0,1,1,0
159391,33000,330,0,-2,82,44,38,0,0,0,0,0,0,19,11,8,2,1,1,0,0,0,57,30,27,3,2,1,1,0,1,0,0,0
159407,33000,330,0,-2,2,1,1,0,0,0,0,0,0,1,1,0,0,0,0,0,0,0,0,0,0,1,0,1,0,0,0,0,0,0
159416,33000,330,0,-2,6,2,4,0,0,0,0,0,0,2,0,2,0,0,0,0,0,0,4,2,2,0,0,0,0,0,0,0,0,0
159568,33000,330,0,-2,5,5,0,0,0,0,0,0,0,1,1,0,0,0,0,0,0,0,4,4,0,0,0,0,0,0,0,0,0,0
159647,33000,330,0,-2,20,11,9,0,0,0,0,0,0,6,3,3,0,0,0,0,0,0,13,8,5,0,0,0,0,0,0,1,0,1
159656,33000,330,0,-2,28,11,17,0,0,0,2,1,1,9,5,4,3,3,0,0,0,0,10,2,8,1,0,1,3,0,3,0,0,0
159717,33000,330,0,-2,19,14,5,0,0,0,0,0,0,7,6,1,0,0,0,0,0,0,9,6,3,1,1,0,2,1,1,0,0,0
159939,33000,330,0,-2,8,2,6,0,0,0,0,0,0,4,0,4,0,0,0,0,0,0,4,2,2,0,0,0,0,0,0,0,0,0
159948,33000,330,0,-2,2,0,2,0,0,0,0,0,0,0,0,0,0,0,0,0,0,0,2,0,2,0,0,0,0,0,0,0,0,0
159966,33000,330,0,-2,21,16,5,0,0,0,1,1,0,8,7,1,0,0,0,0,0,0,12,8,4,0,0,0,0,0,0,0,0,0
159993,33000,330,0,-2,15,8,7,0,0,0,0,0,0,2,0,2,0,0,0,0,0,0,13,8,5,0,0,0,0,0,0,0,0,0
160038,33000,330,0,-2,13,9,4,0,0,0,0,0,0,4,4,0,0,0,0,0,0,0,6,4,2,0,0,0,1,1,0,2,0,2
160533,33000,330,0,-2,1,0,1,0,0,0,0,0,0,1,0,1,0,0,0,0,0,0,0,0,0,0,0,0,0,0,0,0,0,0
160579,33000,330,0,-2,3,0,3,0,0,0,0,0,0,0,0,0,0,0,0,0,0,0,3,0,3,0,0,0,0,0,0,0,0,0
160612,33000,330,0,-2,26,12,14,0,0,0,0,0,0,7,2,5,2,2,0,0,0,0,16,8,8,0,0,0,0,0,0,1,0,1
160621,33000,330,0,-2,18,11,7,0,0,0,0,0,0,12,6,6,0,0,0,0,0,0,6,5,1,0,0,0,0,0,0,0,0,0
160630,33000,330,0,-2,5,3,2,0,0,0,0,0,0,5,3,2,0,0,0,0,0,0,0,0,0,0,0,0,0,0,0,0,0,0
160658,33000,330,0,-2,31,21,10,0,0,0,0,0,0,14,9,5,2,0,2,0,0,0,13,10,3,0,0,0,0,0,0,2,2,0
160755,33000,330,0,-2,61,23,38,0,0,0,4,1,3,13,4,9,7,3,4,0,0,0,31,13,18,4,1,3,0,0,0,2,1,1
160904,33000,330,0,-2,11,3,8,0,0,0,0,0,0,10,3,7,0,0,0,0,0,0,1,0,1,0,0,0,0,0,0,0,0,0
160977,33000,330,0,-2,14,9,5,0,0,0,0,0,0,3,2,1,4,4,0,0,0,0,7,3,4,0,0,0,0,0,0,0,0,0
161004,33000,330,0,-2,20,8,12,0,0,0,2,0,2,2,1,1,2,0,2,0,0,0,9,4,5,2,2,0,3,1,2,0,0,0
161077,33000,330,0,-2,3,1,2,0,0,0,0,0,0,0,0,0,0,0,0,0,0,0,3,1,2,0,0,0,0,0,0,0,0,0
161086,33000,330,0,-2,17,4,13,0,0,0,0,0,0,3,1,2,1,0,1,0,0,0,11,3,8,0,0,0,1,0,1,1,0,1
161226,33000,330,0,-2,6,2,4,0,0,0,0,0,0,0,0,0,0,0,0,0,0,0,6,2,4,0,0,0,0,0,0,0,0,0
161235,33000,330,0,-2,1,0,1,0,0,0,0,0,0,0,0,0,0,0,0,0,0,0,1,0,1,0,0,0,0,0,0,0,0,0
161253,33000,330,0,-2,27,15,12,1,0,1,0,0,0,1,1,0,1,0,1,0,0,0,17,11,6,0,0,0,6,2,4,1,1,0
161280,33000,330,0,-2,3,2,1,0,0,0,0,0,0,0,0,0,0,0,0,0,0,0,2,1,1,0,0,0,1,1,0,0,0,0
161299,33000,330,0,-2,3,3,0,0,0,0,0,0,0,0,0,0,0,0,0,0,0,0,3,3,0,0,0,0,0,0,0,0,0,0
161341,33000,330,0,-2,1,0,1,0,0,0,0,0,0,0,0,0,0,0,0,0,0,0,1,0,1,0,0,0,0,0,0,0,0,0
161457,33000,330,0,-2,8,1,7,0,0,0,1,0,1,0,0,0,0,0,0,0,0,0,7,1,6,0,0,0,0,0,0,0,0,0
161509,33000,330,0,-2,3,0,3,0,0,0,0,0,0,0,0,0,0,0,0,0,0,0,3,0,3,0,0,0,0,0,0,0,0,0
161518,33000,330,0,-2,6,2,4,0,0,0,0,0,0,0,0,0,0,0,0,0,0,0,4,2,2,0,0,0,2,0,2,0,0,0
161545,33000,330,0,-2,3,2,1,0,0,0,0,0,0,0,0,0,0,0,0,0,0,0,2,1,1,0,0,0,1,1,0,0,0,0
161554,33000,330,0,-2,19,9,10,0,0,0,0,0,0,2,2,0,0,0,0,0,0,0,16,6,10,0,0,0,1,1,0,0,0,0
161563,33000,330,0,-2,2,1,1,0,0,0,0,0,0,0,0,0,0,0,0,0,0,0,2,1,1,0,0,0,0,0,0,0,0,0
161572,33000,330,0,-2,2,1,1,0,0,0,0,0,0,0,0,0,0,0,0,0,0,0,1,0,1,0,0,0,1,1,0,0,0,0
161864,33000,330,0,-2,6,3,3,0,0,0,0,0,0,4,2,2,1,0,1,0,0,0,1,1,0,0,0,0,0,0,0,0,0,0
161873,33000,330,0,-2,3,2,1,0,0,0,0,0,0,1,0,1,1,1,0,0,0,0,1,1,0,0,0,0,0,0,0,0,0,0
162007,33000,330,0,-2,12,5,7,0,0,0,0,0,0,11,5,6,1,0,1,0,0,0,0,0,0,0,0,0,0,0,0,0,0,0
162122,33000,330,0,-2,5,0,5,0,0,0,0,0,0,1,0,1,0,0,0,0,0,0,4,0,4,0,0,0,0,0,0,0,0,0
162168,33000,330,0,-2,1,0,1,0,0,0,0,0,0,0,0,0,1,0,1,0,0,0,0,0,0,0,0,0,0,0,0,0,0,0
162210,33000,330,0,-2,1,1,0,0,0,0,0,0,0,0,0,0,0,0,0,0,0,0,1,1,0,0,0,0,0,0,0,0,0,0
162283,33000,330,0,-2,2,0,2,0,0,0,0,0,0,1,0,1,0,0,0,0,0,0,1,0,1,0,0,0,0,0,0,0,0,0
162557,33000,330,0,-2,10,3,7,1,0,1,1,0,1,3,2,1,0,0,0,0,0,0,5,1,4,0,0,0,0,0,0,0,0,0
162584,33000,330,0,-2,7,3,4,0,0,0,0,0,0,0,0,0,0,0,0,0,0,0,7,3,4,0,0,0,0,0,0,0,0,0
162654,33000,330,0,-2,7,2,5,0,0,0,0,0,0,2,0,2,1,1,0,0,0,0,4,1,3,0,0,0,0,0,0,0,0,0
162690,33000,330,0,-2,4,1,3,0,0,0,0,0,0,0,0,0,1,0,1,0,0,0,3,1,2,0,0,0,0,0,0,0,0,0
162760,33000,330,0,-2,7,4,3,0,0,0,1,0,1,2,2,0,0,0,0,0,0,0,4,2,2,0,0,0,0,0,0,0,0,0
162779,33000,330,0,-2,4,1,3,0,0,0,0,0,0,1,0,1,0,0,0,0,0,0,3,1,2,0,0,0,0,0,0,0,0,0
162928,33000,330,0,-2,86,26,60,0,0,0,7,1,6,23,7,16,4,2,2,0,0,0,46,15,31,5,1,4,0,0,0,1,0,1
163046,33000,330,0,-2,11,5,6,0,0,0,0,0,0,4,2,2,0,0,0,0,0,0,7,3,4,0,0,0,0,0,0,0,0,0
163259,33000,330,0,-2,38,8,30,0,0,0,1,0,1,20,4,16,5,1,4,0,0,0,12,3,9,0,0,0,0,0,0,0,0,0
163268,33000,330,0,-2,18,11,7,0,0,0,3,0,3,4,2,2,0,0,0,0,0,0,8,6,2,0,0,0,3,3,0,0,0,0
163286,33000,330,0,-2,66,37,29,0,0,0,1,1,0,23,13,10,9,4,5,0,0,0,27,15,12,0,0,0,5,3,2,1,1,0
163295,33000,330,0,-2,7,3,4,0,0,0,1,0,1,0,0,0,0,0,0,0,0,0,6,3,3,0,0,0,0,0,0,0,0,0
163453,33000,330,0,-2,5,4,1,0,0,0,0,0,0,3,3,0,0,0,0,0,0,0,0,0,0,0,0,0,1,1,0,1,0,1
163462,33000,330,0,-2,12,7,5,0,0,0,0,0,0,2,2,0,0,0,0,0,0,0,10,5,5,0,0,0,0,0,0,0,0,0
163578,33000,330,0,-2,7,2,5,0,0,0,1,0,1,1,1,0,0,0,0,0,0,0,5,1,4,0,0,0,0,0,0,0,0,0
163657,33000,330,0,-2,3,1,2,0,0,0,0,0,0,2,0,2,0,0,0,0,0,0,1,1,0,0,0,0,0,0,0,0,0,0
163851,33000,330,0,-2,3,2,1,0,0,0,0,0,0,0,0,0,0,0,0,0,0,0,3,2,1,0,0,0,0,0,0,0,0,0
163912,33000,330,0,-2,8,4,4,0,0,0,1,1,0,1,1,0,0,0,0,0,0,0,6,2,4,0,0,0,0,0,0,0,0,0
163976,33000,330,0,-2,1,0,1,0,0,0,0,0,0,0,0,0,0,0,0,0,0,0,1,0,1,0,0,0,0,0,0,0,0,0
164076,33000,330,0,-2,14,9,5,0,0,0,0,0,0,1,1,0,0,0,0,0,0,0,8,4,4,1,1,0,4,3,1,0,0,0
164155,33000,330,0,-2,6,2,4,0,0,0,0,0,0,2,1,1,0,0,0,0,0,0,4,1,3,0,0,0,0,0,0,0,0,0
164173,33000,330,0,-2,12,7,5,0,0,0,0,0,0,2,2,0,0,0,0,0,0,0,10,5,5,0,0,0,0,0,0,0,0,0
164216,33000,330,0,-2,11,6,5,0,0,0,0,0,0,0,0,0,0,0,0,0,0,0,11,6,5,0,0,0,0,0,0,0,0,0
164270,33000,330,0,-2,19,10,9,0,0,0,1,1,0,4,3,1,1,0,1,0,0,0,13,6,7,0,0,0,0,0,0,0,0,0
164368,33000,330,0,-2,1,0,1,0,0,0,0,0,0,0,0,0,0,0,0,0,0,0,1,0,1,0,0,0,0,0,0,0,0,0
164447,33000,330,0,-2,9,9,0,0,0,0,0,0,0,1,1,0,1,1,0,0,0,0,7,7,0,0,0,0,0,0,0,0,0,0
164465,33000,330,0,-2,12,4,8,0,0,0,1,0,1,1,0,1,1,1,0,0,0,0,7,2,5,0,0,0,0,0,0,2,1,1
164492,33000,330,0,-2,2,0,2,0,0,0,0,0,0,0,0,0,0,0,0,0,0,0,2,0,2,0,0,0,0,0,0,0,0,0
164562,33000,330,0,-2,5,3,2,0,0,0,0,0,0,0,0,0,0,0,0,0,0,0,5,3,2,0,0,0,0,0,0,0,0,0
164580,33000,330,0,-2,15,6,9,0,0,0,0,0,0,3,3,0,1,0,1,0,0,0,11,3,8,0,0,0,0,0,0,0,0,0
164739,33000,330,0,-2,20,6,14,0,0,0,2,1,1,4,2,2,0,0,0,0,0,0,14,3,11,0,0,0,0,0,0,0,0,0
164748,33000,330,0,-2,36,10,26,0,0,0,3,0,3,8,2,6,4,1,3,0,0,0,16,6,10,1,0,1,4,1,3,0,0,0
164924,33000,330,0,-2,52,28,24,0,0,0,1,1,0,5,3,2,5,1,4,0,0,0,31,15,16,4,3,1,6,5,1,0,0,0
164988,33000,330,0,-2,144,43,101,0,0,0,15,3,12,19,5,14,11,3,8,0,0,0,80,24,56,4,1,3,13,7,6,2,0,2
165015,33000,330,0,-2,11,4,7,0,0,0,0,0,0,2,0,2,0,0,0,0,0,0,8,4,4,0,0,0,0,0,0,1,0,1
165024,33000,330,0,-2,1,0,1,0,0,0,0,0,0,0,0,0,0,0,0,0,0,0,1,0,1,0,0,0,0,0,0,0,0,0
165033,33000,330,0,-2,1,0,1,0,0,0,0,0,0,0,0,0,0,0,0,0,0,0,1,0,1,0,0,0,0,0,0,0,0,0
165112,33000,330,0,-2,7,2,5,0,0,0,1,0,1,2,1,1,1,0,1,0,0,0,2,1,1,1,0,1,0,0,0,0,0,0
165194,33000,330,0,-2,3,0,3,0,0,0,0,0,0,1,0,1,0,0,0,0,0,0,1,0,1,0,0,0,1,0,1,0,0,0
165264,33000,330,0,-2,1,1,0,0,0,0,0,0,0,0,0,0,0,0,0,0,0,0,1,1,0,0,0,0,0,0,0,0,0,0
165334,33000,330,0,-2,13,7,6,0,0,0,1,0,1,3,2,1,1,1,0,0,0,0,7,3,4,0,0,0,0,0,0,1,1,0
165529,33000,330,0,-2,8,5,3,0,0,0,0,0,0,0,0,0,0,0,0,0,0,0,7,5,2,0,0,0,1,0,1,0,0,0
165574,33000,330,0,-2,4,3,1,0,0,0,0,0,0,0,0,0,1,1,0,0,0,0,3,2,1,0,0,0,0,0,0,0,0,0
165662,33000,330,0,-2,9,3,6,0,0,0,0,0,0,1,1,0,0,0,0,0,0,0,7,2,5,1,0,1,0,0,0,0,0,0
165671,33000,330,0,-2,5,2,3,0,0,0,0,0,0,0,0,0,0,0,0,0,0,0,5,2,3,0,0,0,0,0,0,0,0,0
165699,33000,330,0,-2,7,3,4,0,0,0,0,0,0,0,0,0,1,1,0,0,0,0,5,2,3,1,0,1,0,0,0,0,0,0
165820,33000,330,0,-2,1,0,1,0,0,0,0,0,0,0,0,0,1,0,1,0,0,0,0,0,0,0,0,0,0,0,0,0,0,0
165866,33000,330,0,-2,1,1,0,0,0,0,0,0,0,1,1,0,0,0,0,0,0,0,0,0,0,0,0,0,0,0,0,0,0,0
165936,33000,330,0,-2,3,1,2,0,0,0,0,0,0,0,0,0,0,0,0,0,0,0,1,1,0,0,0,0,2,0,2,0,0,0
166018,33000,330,0,-2,5,1,4,0,0,0,0,0,0,1,1,0,0,0,0,0,0,0,4,0,4,0,0,0,0,0,0,0,0,0
166027,33000,330,0,-2,66,24,42,0,0,0,5,3,2,4,3,1,12,5,7,0,0,0,43,12,31,2,1,1,0,0,0,0,0,0
166124,33000,330,0,-2,27,15,12,1,1,0,0,0,0,2,1,1,0,0,0,0,0,0,19,12,7,2,0,2,3,1,2,0,0,0
166391,33000,330,0,-2,14,7,7,0,0,0,0,0,0,0,0,0,1,0,1,0,0,0,10,5,5,0,0,0,3,2,1,0,0,0
166452,33000,330,0,-2,2,1,1,0,0,0,0,0,0,1,1,0,0,0,0,0,0,0,1,0,1,0,0,0,0,0,0,0,0,0
166513,33000,330,0,-2,31,17,14,0,0,0,1,0,1,2,1,1,3,1,2,0,0,0,22,13,9,1,1,0,2,1,1,0,0,0
166629,33000,330,0,-2,40,22,18,0,0,0,0,0,0,7,5,2,0,0,0,0,0,0,31,15,16,1,1,0,1,1,0,0,0,0
166638,33000,330,0,-2,36,10,26,0,0,0,3,1,2,5,1,4,3,0,3,0,0,0,21,7,14,0,0,0,4,1,3,0,0,0
166656,33000,330,0,-2,5,2,3,0,0,0,0,0,0,0,0,0,0,0,0,0,0,0,2,1,1,1,0,1,2,1,1,0,0,0
166665,33000,330,0,-2,3,3,0,0,0,0,0,0,0,0,0,0,0,0,0,0,0,0,3,3,0,0,0,0,0,0,0,0,0,0
166674,33000,330,0,-2,1,0,1,0,0,0,0,0,0,0,0,0,0,0,0,0,0,0,1,0,1,0,0,0,0,0,0,0,0,0
166683,33000,330,0,-2,91,28,63,0,0,0,9,1,8,5,3,2,5,2,3,0,0,0,64,21,43,2,0,2,3,1,2,3,0,3
166708,33000,330,0,-2,2,0,2,0,0,0,0,0,0,0,0,0,0,0,0,0,0,0,1,0,1,0,0,0,0,0,0,1,0,1
166717,33000,330,0,-2,15,2,13,0,0,0,1,0,1,1,0,1,0,0,0,0,0,0,4,1,3,0,0,0,9,1,8,0,0,0
166850,33000,330,0,-2,13,5,8,0,0,0,0,0,0,0,0,0,1,0,1,0,0,0,12,5,7,0,0,0,0,0,0,0,0,0
166939,33000,330,0,-2,7,1,6,0,0,0,1,0,1,1,0,1,0,0,0,0,0,0,3,0,3,0,0,0,2,1,1,0,0,0
166957,33000,330,0,-2,8,2,6,0,0,0,0,0,0,0,0,0,2,0,2,0,0,0,6,2,4,0,0,0,0,0,0,0,0,0
167057,33000,330,0,-2,8,5,3,0,0,0,0,0,0,1,1,0,0,0,0,0,0,0,7,4,3,0,0,0,0,0,0,0,0,0
167260,33000,330,0,-2,8,7,1,0,0,0,0,0,0,0,0,0,0,0,0,0,0,0,8,7,1,0,0,0,0,0,0,0,0,0
167288,33000,330,0,-2,2,1,1,0,0,0,0,0,0,1,1,0,0,0,0,0,0,0,1,0,1,0,0,0,0,0,0,0,0,0
167312,33000,330,0,-2,7,2,5,0,0,0,0,0,0,0,0,0,2,0,2,0,0,0,2,1,1,0,0,0,3,1,2,0,0,0
167358,33000,330,0,-2,52,18,34,0,0,0,4,2,2,5,1,4,4,0,4,0,0,0,30,14,16,1,0,1,8,1,7,0,0,0
167394,33000,330,0,-2,9,2,7,0,0,0,1,0,1,1,0,1,1,1,0,0,0,0,6,1,5,0,0,0,0,0,0,0,0,0
167525,33000,330,0,-2,3,3,0,0,0,0,0,0,0,0,0,0,1,1,0,0,0,0,2,2,0,0,0,0,0,0,0,0,0,0
167534,33000,330,0,-2,8,5,3,0,0,0,2,2,0,0,0,0,1,1,0,0,0,0,5,2,3,0,0,0,0,0,0,0,0,0
167598,33000,330,0,-2,6,2,4,0,0,0,1,1,0,1,0,1,0,0,0,0,0,0,4,1,3,0,0,0,0,0,0,0,0,0
167631,33000,330,0,-2,1,1,0,0,0,0,0,0,0,0,0,0,0,0,0,0,0,0,1,1,0,0,0,0,0,0,0,0,0,0
167729,33000,330,0,-2,6,1,5,0,0,0,1,0,1,0,0,0,0,0,0,0,0,0,4,1,3,0,0,0,1,0,1,0,0,0
167783,33000,330,0,-2,16,3,13,0,0,0,2,0,2,2,0,2,0,0,0,0,0,0,11,2,9,0,0,0,1,1,0,0,0,0
167835,33000,330,0,-2,7,2,5,0,0,0,0,0,0,0,0,0,1,0,1,0,0,0,5,1,4,1,1,0,0,0,0,0,0,0
167899,33000,330,0,-2,4,3,1,0,0,0,0,0,0,2,1,1,0,0,0,0,0,0,2,2,0,0,0,0,0,0,0,0,0,0
167905,33000,330,0,-2,2,1,1,0,0,0,0,0,0,1,1,0,0,0,0,0,0,0,1,0,1,0,0,0,0,0,0,0,0,0
167987,33000,330,0,-2,9,2,7,0,0,0,0,0,0,3,0,3,0,0,0,0,0,0,5,2,3,0,0,0,1,0,1,0,0,0
167996,33000,330,0,-2,8,4,4,0,0,0,0,0,0,0,0,0,1,1,0,0,0,0,2,1,1,0,0,0,5,2,3,0,0,0
168005,33000,330,0,-2,9,6,3,0,0,0,0,0,0,1,1,0,0,0,0,0,0,0,8,5,3,0,0,0,0,0,0,0,0,0
168148,33000,330,0,-2,25,11,14,0,0,0,0,0,0,3,3,0,3,2,1,0,0,0,17,5,12,1,0,1,1,1,0,0,0,0
168218,33000,330,0,-2,14,2,12,0,0,0,0,0,0,3,0,3,1,0,1,0,0,0,10,2,8,0,0,0,0,0,0,0,0,0
168227,33000,330,0,-2,8,2,6,0,0,0,0,0,0,1,1,0,0,0,0,0,0,0,6,1,5,0,0,0,1,0,1,0,0,0
168254,33000,330,0,-2,7,3,4,0,0,0,0,0,0,1,0,1,0,0,0,0,0,0,4,3,1,0,0,0,2,0,2,0,0,0
168263,33000,330,0,-2,1,0,1,0,0,0,0,0,0,0,0,0,1,0,1,0,0,0,0,0,0,0,0,0,0,0,0,0,0,0
168281,33000,330,0,-2,11,5,6,0,0,0,0,0,0,1,1,0,0,0,0,0,0,0,10,4,6,0,0,0,0,0,0,0,0,0
168342,33000,330,0,-2,4,3,1,0,0,0,0,0,0,0,0,0,0,0,0,0,0,0,4,3,1,0,0,0,0,0,0,0,0,0
168421,33000,330,0,-2,21,9,12,0,0,0,2,2,0,2,0,2,2,2,0,0,0,0,11,2,9,1,1,0,3,2,1,0,0,0
168430,33000,330,0,-2,6,2,4,0,0,0,0,0,0,0,0,0,1,0,1,0,0,0,5,2,3,0,0,0,0,0,0,0,0,0
168528,33000,330,0,-2,22,15,7,0,0,0,0,0,0,2,2,0,2,1,1,0,0,0,18,12,6,0,0,0,0,0,0,0,0,0
168546,33000,330,0,-2,17,9,8,0,0,0,1,1,0,4,3,1,1,0,1,0,0,0,11,5,6,0,0,0,0,0,0,0,0,0
168591,33000,330,0,-2,5,4,1,0,0,0,0,0,0,1,1,0,0,0,0,0,0,0,4,3,1,0,0,0,0,0,0,0,0,0
168740,33000,330,0,-2,4,2,2,0,0,0,0,0,0,2,1,1,0,0,0,0,0,0,0,0,0,0,0,0,0,0,0,2,1,1
168786,33000,330,0,-2,12,6,6,0,0,0,0,0,0,0,0,0,3,1,2,0,0,0,3,1,2,0,0,0,6,4,2,0,0,0
169080,33000,330,0,-2,16,8,8,0,0,0,1,1,0,3,2,1,0,0,0,0,0,0,12,5,7,0,0,0,0,0,0,0,0,0
169248,33000,330,0,-2,11,6,5,0,0,0,0,0,0,3,3,0,0,0,0,0,0,0,6,2,4,1,1,0,1,0,1,0,0,0
169275,33000,330,0,-2,10,2,8,0,0,0,0,0,0,7,1,6,0,0,0,0,0,0,3,1,2,0,0,0,0,0,0,0,0,0
169363,33000,330,0,-2,1,0,1,0,0,0,0,0,0,0,0,0,0,0,0,0,0,0,1,0,1,0,0,0,0,0,0,0,0,0
169442,33000,330,0,-2,3,2,1,0,0,0,0,0,0,2,1,1,0,0,0,0,0,0,1,1,0,0,0,0,0,0,0,0,0,0
169479,33000,330,0,-2,17,8,9,0,0,0,0,0,0,3,3,0,1,1,0,0,0,0,12,3,9,0,0,0,1,1,0,0,0,0
169521,33000,330,0,-2,4,1,3,0,0,0,0,0,0,0,0,0,0,0,0,0,0,0,4,1,3,0,0,0,0,0,0,0,0,0
169716,33000,330,0,-2,8,0,8,0,0,0,0,0,0,3,0,3,0,0,0,0,0,0,5,0,5,0,0,0,0,0,0,0,0,0
169798,33000,330,0,-2,18,11,7,0,0,0,0,0,0,4,3,1,0,0,0,0,0,0,12,6,6,0,0,0,2,2,0,0,0,0
169910,33000,330,0,-2,11,5,6,0,0,0,0,0,0,0,0,0,0,0,0,0,0,0,11,5,6,0,0,0,0,0,0,0,0,0
170000,33000,330,0,-2,1,0,1,0,0,0,0,0,0,0,0,0,0,0,0,0,0,0,1,0,1,0,0,0,0,0,0,0,0,0
170037,33000,330,0,-2,8,4,4,0,0,0,0,0,0,0,0,0,1,1,0,0,0,0,6,3,3,0,0,0,0,0,0,1,0,1
170055,33000,330,0,-2,7,3,4,0,0,0,0,0,0,1,0,1,0,0,0,0,0,0,6,3,3,0,0,0,0,0,0,0,0,0
170082,33000,330,0,-2,14,8,6,0,0,0,0,0,0,3,1,2,2,2,0,0,0,0,9,5,4,0,0,0,0,0,0,0,0,0
170286,33000,330,0,-2,17,11,6,0,0,0,0,0,0,0,0,0,0,0,0,0,0,0,0,0,0,0,0,0,17,11,6,0,0,0
170301,33000,330,0,-2,7,4,3,0,0,0,0,0,0,2,2,0,0,0,0,0,0,0,5,2,3,0,0,0,0,0,0,0,0,0
170532,33000,330,0,-2,9,6,3,0,0,0,0,0,0,1,1,0,1,1,0,0,0,0,4,1,3,1,1,0,2,2,0,0,0,0
170550,33000,330,0,-2,5,2,3,0,0,0,0,0,0,2,1,1,1,0,1,0,0,0,2,1,1,0,0,0,0,0,0,0,0,0
170587,33000,330,0,-2,1,1,0,0,0,0,0,0,0,0,0,0,0,0,0,0,0,0,1,1,0,0,0,0,0,0,0,0,0,0
170620,33000,330,0,-2,2,0,2,0,0,0,0,0,0,0,0,0,0,0,0,0,0,0,2,0,2,0,0,0,0,0,0,0,0,0
170639,33000,330,0,-2,6,4,2,0,0,0,1,1,0,0,0,0,1,1,0,0,0,0,4,2,2,0,0,0,0,0,0,0,0,0
170657,33000,330,0,-2,2,1,1,0,0,0,0,0,0,0,0,0,0,0,0,0,0,0,1,0,1,0,0,0,1,1,0,0,0,0
170675,33000,330,0,-2,12,4,8,0,0,0,0,0,0,1,0,1,0,0,0,0,0,0,9,3,6,1,1,0,1,0,1,0,0,0
170806,33000,330,0,-2,2,2,0,0,0,0,0,0,0,0,0,0,0,0,0,0,0,0,2,2,0,0,0,0,0,0,0,0,0,0
170967,33000,330,0,-2,2,1,1,0,0,0,0,0,0,0,0,0,1,0,1,0,0,0,1,1,0,0,0,0,0,0,0,0,0,0
170976,33000,330,0,-2,83,34,49,0,0,0,4,1,3,15,8,7,1,1,0,1,0,1,54,21,33,5,2,3,1,1,0,2,0,2
171100,33000,330,0,-2,37,15,22,0,0,0,7,0,7,4,2,2,6,4,2,0,0,0,19,8,11,1,1,0,0,0,0,0,0,0
171128,33000,330,0,-2,10,6,4,0,0,0,0,0,0,1,1,0,1,0,1,0,0,0,6,3,3,0,0,0,2,2,0,0,0,0
171146,33000,330,0,-2,1,0,1,0,0,0,0,0,0,0,0,0,0,0,0,0,0,0,1,0,1,0,0,0,0,0,0,0,0,0
171304,33000,330,0,-2,3,2,1,0,0,0,0,0,0,1,1,0,0,0,0,0,0,0,2,1,1,0,0,0,0,0,0,0,0,0
171395,33000,330,0,-2,1,0,1,0,0,0,0,0,0,0,0,0,0,0,0,0,0,0,1,0,1,0,0,0,0,0,0,0,0,0
171456,33000,330,0,-2,7,4,3,1,0,1,0,0,0,0,0,0,0,0,0,0,0,0,6,4,2,0,0,0,0,0,0,0,0,0
171492,33000,330,0,-2,13,8,5,1,0,1,0,0,0,2,2,0,0,0,0,0,0,0,10,6,4,0,0,0,0,0,0,0,0,0
171571,33000,330,0,-2,10,6,4,0,0,0,1,1,0,1,1,0,0,0,0,0,0,0,8,4,4,0,0,0,0,0,0,0,0,0
171599,33000,330,0,-2,13,10,3,0,0,0,1,0,1,3,3,0,0,0,0,0,0,0,9,7,2,0,0,0,0,0,0,0,0,0
171881,33000,330,0,-2,1,1,0,0,0,0,0,0,0,1,1,0,0,0,0,0,0,0,0,0,0,0,0,0,0,0,0,0,0,0
172051,33000,330,0,-2,8,4,4,0,0,0,0,0,0,1,1,0,1,0,1,0,0,0,6,3,3,0,0,0,0,0,0,0,0,0
172200,33000,330,0,-2,1,0,1,0,0,0,0,0,0,0,0,0,0,0,0,0,0,0,1,0,1,0,0,0,0,0,0,0,0,0
172264,33000,330,0,-2,10,7,3,0,0,0,0,0,0,3,2,1,0,0,0,0,0,0,7,5,2,0,0,0,0,0,0,0,0,0
172291,33000,330,0,-2,8,3,5,0,0,0,0,0,0,4,2,2,0,0,0,0,0,0,4,1,3,0,0,0,0,0,0,0,0,0
172307,33000,330,0,-2,6,3,3,0,0,0,0,0,0,1,0,1,0,0,0,0,0,0,5,3,2,0,0,0,0,0,0,0,0,0
172334,33000,330,0,-2,4,2,2,0,0,0,0,0,0,0,0,0,0,0,0,0,0,0,4,2,2,0,0,0,0,0,0,0,0,0
172608,33000,330,0,-2,3,1,2,0,0,0,0,0,0,1,0,1,0,0,0,0,0,0,2,1,1,0,0,0,0,0,0,0,0,0
172617,33000,330,0,-2,1,0,1,0,0,0,0,0,0,0,0,0,0,0,0,0,0,0,1,0,1,0,0,0,0,0,0,0,0,0
172699,33000,330,0,-2,8,6,2,0,0,0,0,0,0,0,0,0,0,0,0,0,0,0,7,6,1,1,0,1,0,0,0,0,0,0
173045,33000,330,0,-2,12,6,6,0,0,0,2,1,1,2,1,1,2,0,2,0,0,0,6,4,2,0,0,0,0,0,0,0,0,0
173124,33000,330,0,-2,2,2,0,0,0,0,0,0,0,0,0,0,0,0,0,0,0,0,2,2,0,0,0,0,0,0,0,0,0,0
173142,33000,330,0,-2,1,0,1,0,0,0,0,0,0,0,0,0,0,0,0,0,0,0,1,0,1,0,0,0,0,0,0,0,0,0
173160,33000,330,0,-2,23,15,8,1,1,0,0,0,0,1,1,0,0,0,0,0,0,0,13,7,6,1,1,0,7,5,2,0,0,0
173203,33000,330,0,-2,1,0,1,0,0,0,0,0,0,0,0,0,0,0,0,0,0,0,1,0,1,0,0,0,0,0,0,0,0,0
173258,33000,330,0,-2,5,2,3,0,0,0,0,0,0,0,0,0,0,0,0,0,0,0,5,2,3,0,0,0,0,0,0,0,0,0
173300,33000,330,0,-2,8,2,6,0,0,0,0,0,0,0,0,0,1,0,1,0,0,0,7,2,5,0,0,0,0,0,0,0,0,0
173328,33000,330,0,-2,8,3,5,0,0,0,0,0,0,1,1,0,0,0,0,0,0,0,5,1,4,0,0,0,2,1,1,0,0,0
173647,33000,330,0,-2,2,0,2,0,0,0,0,0,0,0,0,0,0,0,0,0,0,0,2,0,2,0,0,0,0,0,0,0,0,0
173665,33000,330,0,-2,12,5,7,0,0,0,0,0,0,0,0,0,2,0,2,0,0,0,10,5,5,0,0,0,0,0,0,0,0,0
173708,33000,330,0,-2,1,0,1,0,0,0,0,0,0,0,0,0,0,0,0,0,0,0,1,0,1,0,0,0,0,0,0,0,0,0
173902,33000,330,0,-2,6,1,5,0,0,0,0,0,0,1,0,1,0,0,0,0,0,0,5,1,4,0,0,0,0,0,0,0,0,0
173920,33000,330,0,-2,5,3,2,0,0,0,0,0,0,1,0,1,0,0,0,0,0,0,4,3,1,0,0,0,0,0,0,0,0,0
174066,33000,330,0,-2,118,45,73,1,0,1,11,5,6,10,7,3,6,4,2,0,0,0,79,27,52,8,2,6,2,0,2,1,0,1
174075,33000,330,0,-2,5,4,1,0,0,0,0,0,0,0,0,0,0,0,0,0,0,0,5,4,1,0,0,0,0,0,0,0,0,0
174127,33000,330,0,-2,3,1,2,0,0,0,0,0,0,1,1,0,0,0,0,0,0,0,1,0,1,0,0,0,1,0,1,0,0,0
174233,33000,330,0,-2,9,3,6,0,0,0,0,0,0,0,0,0,0,0,0,0,0,0,9,3,6,0,0,0,0,0,0,0,0,0
174251,33000,330,0,-2,4,3,1,0,0,0,0,0,0,0,0,0,0,0,0,0,0,0,4,3,1,0,0,0,0,0,0,0,0,0
174358,33000,330,0,-2,3,1,2,0,0,0,0,0,0,0,0,0,0,0,0,0,0,0,2,0,2,0,0,0,1,1,0,0,0,0
174376,33000,330,0,-2,1,1,0,0,0,0,0,0,0,0,0,0,0,0,0,0,0,0,1,1,0,0,0,0,0,0,0,0,0,0
174428,33000,330,0,-2,1,0,1,0,0,0,0,0,0,0,0,0,0,0,0,0,0,0,1,0,1,0,0,0,0,0,0,0,0,0
174437,33000,330,0,-2,5,0,5,0,0,0,0,0,0,0,0,0,0,0,0,0,0,0,5,0,5,0,0,0,0,0,0,0,0,0
174491,33000,330,0,-2,5,4,1,0,0,0,0,0,0,0,0,0,0,0,0,0,0,0,4,3,1,0,0,0,1,1,0,0,0,0
174738,33000,330,0,-2,1,1,0,0,0,0,0,0,0,0,0,0,0,0,0,0,0,0,1,1,0,0,0,0,0,0,0,0,0,0
174747,33000,330,0,-2,2,0,2,0,0,0,0,0,0,0,0,0,0,0,0,0,0,0,1,0,1,0,0,0,1,0,1,0,0,0
174756,33000,330,0,-2,1,0,1,0,0,0,0,0,0,0,0,0,0,0,0,0,0,0,1,0,1,0,0,0,0,0,0,0,0,0
174783,33000,330,0,-2,4,3,1,0,0,0,1,1,0,1,1,0,0,0,0,0,0,0,1,0,1,1,1,0,0,0,0,0,0,0
174792,33000,330,0,-2,7,4,3,0,0,0,1,0,1,0,0,0,1,1,0,0,0,0,5,3,2,0,0,0,0,0,0,0,0,0
174817,33000,330,0,-2,18,11,7,0,0,0,0,0,0,1,1,0,0,0,0,0,0,0,15,9,6,0,0,0,2,1,1,0,0,0
174844,33000,330,0,-2,7,4,3,0,0,0,0,0,0,1,1,0,2,2,0,1,1,0,3,0,3,0,0,0,0,0,0,0,0,0
174862,33000,330,0,-2,7,4,3,0,0,0,0,0,0,0,0,0,0,0,0,0,0,0,7,4,3,0,0,0,0,0,0,0,0,0
174899,33000,330,0,-2,2,1,1,1,0,1,0,0,0,0,0,0,0,0,0,0,0,0,1,1,0,0,0,0,0,0,0,0,0,0
174914,33000,330,0,-2,61,33,28,0,0,0,3,2,1,6,2,4,6,2,4,0,0,0,40,23,17,5,3,2,1,1,0,0,0,0
175005,33000,330,0,-2,19,4,15,0,0,0,4,1,3,0,0,0,1,0,1,0,0,0,13,3,10,1,0,1,0,0,0,0,0,0
175078,33000,330,0,-2,2,2,0,0,0,0,0,0,0,1,1,0,0,0,0,0,0,0,1,1,0,0,0,0,0,0,0,0,0,0
175227,33000,330,0,-2,3,1,2,0,0,0,0,0,0,0,0,0,0,0,0,0,0,0,2,0,2,1,1,0,0,0,0,0,0,0
175236,33000,330,0,-2,1,1,0,0,0,0,0,0,0,0,0,0,0,0,0,0,0,0,1,1,0,0,0,0,0,0,0,0,0,0
175272,33000,330,0,-2,2,0,2,0,0,0,0,0,0,0,0,0,0,0,0,0,0,0,2,0,2,0,0,0,0,0,0,0,0,0
175281,33000,330,0,-2,28,9,19,0,0,0,0,0,0,6,2,4,0,0,0,0,0,0,20,6,14,1,1,0,1,0,1,0,0,0
175342,33000,330,0,-2,13,7,6,0,0,0,0,0,0,10,5,5,1,1,0,0,0,0,2,1,1,0,0,0,0,0,0,0,0,0
175421,33000,330,0,-2,5,3,2,0,0,0,1,1,0,0,0,0,0,0,0,0,0,0,4,2,2,0,0,0,0,0,0,0,0,0
175430,33000,330,0,-2,8,7,1,0,0,0,0,0,0,3,3,0,0,0,0,0,0,0,5,4,1,0,0,0,0,0,0,0,0,0
175519,33000,330,0,-2,6,6,0,0,0,0,0,0,0,4,4,0,0,0,0,0,0,0,2,2,0,0,0,0,0,0,0,0,0,0
175573,33000,330,0,-2,8,7,1,0,0,0,0,0,0,2,2,0,0,0,0,0,0,0,5,4,1,0,0,0,1,1,0,0,0,0
175616,33000,330,0,-2,4,2,2,0,0,0,0,0,0,0,0,0,0,0,0,0,0,0,4,2,2,0,0,0,0,0,0,0,0,0
175643,33000,330,0,-2,6,5,1,0,0,0,0,0,0,1,1,0,0,0,0,0,0,0,5,4,1,0,0,0,0,0,0,0,0,0
175652,33000,330,0,-2,4,2,2,0,0,0,0,0,0,2,1,1,0,0,0,0,0,0,2,1,1,0,0,0,0,0,0,0,0,0
175786,33000,330,0,-2,18,9,9,0,0,0,0,0,0,8,3,5,0,0,0,0,0,0,8,5,3,0,0,0,2,1,1,0,0,0
175810,33000,330,0,-2,5,2,3,0,0,0,0,0,0,0,0,0,0,0,0,0,0,0,5,2,3,0,0,0,0,0,0,0,0,0
175829,33000,330,0,-2,5,3,2,0,0,0,0,0,0,0,0,0,0,0,0,0,0,0,5,3,2,0,0,0,0,0,0,0,0,0
175856,33000,330,0,-2,18,15,3,1,1,0,0,0,0,10,9,1,0,0,0,0,0,0,7,5,2,0,0,0,0,0,0,0,0,0
175883,33000,330,0,-2,7,5,2,0,0,0,0,0,0,2,1,1,0,0,0,0,0,0,5,4,1,0,0,0,0,0,0,0,0,0
175935,33000,330,0,-2,5,0,5,0,0,0,0,0,0,3,0,3,0,0,0,0,0,0,2,0,2,0,0,0,0,0,0,0,0,0
175980,33000,330,0,-2,15,10,5,0,0,0,0,0,0,4,3,1,0,0,0,0,0,0,11,7,4,0,0,0,0,0,0,0,0,0
176008,33000,330,0,-2,7,4,3,0,0,0,0,0,0,5,3,2,0,0,0,0,0,0,2,1,1,0,0,0,0,0,0,0,0,0
176017,33000,330,0,-2,86,37,49,0,0,0,0,0,0,21,7,14,2,2,0,0,0,0,59,25,34,0,0,0,2,2,0,2,1,1
176035,33000,330,0,-2,7,4,3,0,0,0,0,0,0,1,0,1,0,0,0,0,0,0,6,4,2,0,0,0,0,0,0,0,0,0
176044,33000,330,0,-2,11,6,5,0,0,0,0,0,0,11,6,5,0,0,0,0,0,0,0,0,0,0,0,0,0,0,0,0,0,0
176053,33000,330,0,-2,16,10,6,0,0,0,0,0,0,2,1,1,1,1,0,0,0,0,6,2,4,0,0,0,7,6,1,0,0,0
176071,33000,330,0,-2,1,0,1,0,0,0,0,0,0,0,0,0,0,0,0,0,0,0,1,0,1,0,0,0,0,0,0,0,0,0
176080,33000,330,0,-2,56,30,26,0,0,0,0,0,0,9,4,5,2,2,0,0,0,0,43,23,20,1,0,1,0,0,0,1,1,0
176169,33000,330,0,-2,5,1,4,0,0,0,0,0,0,2,0,2,0,0,0,0,0,0,1,0,1,0,0,0,2,1,1,0,0,0
176178,33000,330,0,-2,5,4,1,0,0,0,0,0,0,1,1,0,0,0,0,0,0,0,4,3,1,0,0,0,0,0,0,0,0,0
176239,33000,330,0,-2,6,3,3,0,0,0,0,0,0,3,1,2,0,0,0,0,0,0,3,2,1,0,0,0,0,0,0,0,0,0
176318,33000,330,0,-2,8,5,3,0,0,0,0,0,0,6,5,1,0,0,0,0,0,0,1,0,1,0,0,0,1,0,1,0,0,0
176354,33000,330,0,-2,7,6,1,0,0,0,0,0,0,2,2,0,0,0,0,0,0,0,5,4,1,0,0,0,0,0,0,0,0,0
176406,33000,330,0,-2,4,0,4,0,0,0,0,0,0,3,0,3,1,0,1,0,0,0,0,0,0,0,0,0,0,0,0,0,0,0
176479,33000,330,0,-2,1,1,0,0,0,0,0,0,0,0,0,0,0,0,0,0,0,0,1,1,0,0,0,0,0,0,0,0,0,0
176628,33000,330,0,-2,6,4,2,0,0,0,0,0,0,0,0,0,0,0,0,0,0,0,6,4,2,0,0,0,0,0,0,0,0,0
176664,33000,330,0,-2,1,1,0,0,0,0,0,0,0,0,0,0,0,0,0,0,0,0,1,1,0,0,0,0,0,0,0,0,0,0
176789,33000,330,0,-2,1,0,1,0,0,0,0,0,0,0,0,0,0,0,0,0,0,0,1,0,1,0,0,0,0,0,0,0,0,0
176910,33000,330,0,-2,4,3,1,0,0,0,0,0,0,0,0,0,1,1,0,0,0,0,3,2,1,0,0,0,0,0,0,0,0,0
176947,33000,330,0,-2,15,9,6,0,0,0,0,0,0,2,2,0,0,0,0,0,0,0,13,7,6,0,0,0,0,0,0,0,0,0
176965,33000,330,0,-2,9,6,3,0,0,0,0,0,0,0,0,0,1,1,0,0,0,0,8,5,3,0,0,0,0,0,0,0,0,0
177038,33000,330,0,-2,1,0,1,0,0,0,0,0,0,0,0,0,0,0,0,0,0,0,1,0,1,0,0,0,0,0,0,0,0,0
177065,33000,330,0,-2,27,9,18,0,0,0,0,0,0,1,0,1,1,0,1,0,0,0,19,8,11,2,0,2,4,1,3,0,0,0
177144,33000,330,0,-2,9,7,2,0,0,0,0,0,0,1,1,0,0,0,0,0,0,0,8,6,2,0,0,0,0,0,0,0,0,0
177214,33000,330,0,-2,13,9,4,0,0,0,0,0,0,0,0,0,0,0,0,0,0,0,6,4,2,0,0,0,7,5,2,0,0,0
177339,33000,330,0,-2,5,5,0,0,0,0,0,0,0,1,1,0,0,0,0,0,0,0,1,1,0,0,0,0,3,3,0,0,0,0
177418,33000,330,0,-2,5,2,3,0,0,0,0,0,0,2,1,1,1,0,1,0,0,0,2,1,1,0,0,0,0,0,0,0,0,0
177472,33000,330,0,-2,10,3,7,0,0,0,0,0,0,0,0,0,0,0,0,0,0,0,5,2,3,0,0,0,5,1,4,0,0,0
177542,33000,330,0,-2,2,1,1,0,0,0,0,0,0,0,0,0,0,0,0,0,0,0,2,1,1,0,0,0,0,0,0,0,0,0
177551,33000,330,0,-2,11,5,6,0,0,0,0,0,0,10,5,5,0,0,0,0,0,0,1,0,1,0,0,0,0,0,0,0,0,0
177676,33000,330,0,-2,4,0,4,0,0,0,0,0,0,0,0,0,0,0,0,0,0,0,4,0,4,0,0,0,0,0,0,0,0,0
177940,33000,330,0,-2,8,8,0,0,0,0,0,0,0,5,5,0,0,0,0,0,0,0,3,3,0,0,0,0,0,0,0,0,0,0
177968,33000,330,0,-2,21,11,10,0,0,0,0,0,0,3,1,2,2,2,0,1,1,0,15,7,8,0,0,0,0,0,0,0,0,0
177977,33000,330,0,-2,2,0,2,0,0,0,0,0,0,0,0,0,0,0,0,0,0,0,2,0,2,0,0,0,0,0,0,0,0,0
177986,33000,330,0,-2,2,2,0,0,0,0,0,0,0,0,0,0,0,0,0,0,0,0,2,2,0,0,0,0,0,0,0,0,0,0
177995,33000,330,0,-2,4,2,2,0,0,0,0,0,0,0,0,0,0,0,0,0,0,0,4,2,2,0,0,0,0,0,0,0,0,0
178059,33000,330,0,-2,16,8,8,0,0,0,0,0,0,1,0,1,1,1,0,0,0,0,14,7,7,0,0,0,0,0,0,0,0,0
178208,33000,330,0,-2,9,4,5,0,0,0,0,0,0,0,0,0,0,0,0,0,0,0,9,4,5,0,0,0,0,0,0,0,0,0
178217,33000,330,0,-2,1,1,0,0,0,0,0,0,0,0,0,0,0,0,0,0,0,0,1,1,0,0,0,0,0,0,0,0,0,0
178244,33000,330,0,-2,12,7,5,0,0,0,0,0,0,2,2,0,0,0,0,0,0,0,10,5,5,0,0,0,0,0,0,0,0,0
178341,33000,330,0,-2,14,10,4,1,1,0,0,0,0,4,4,0,0,0,0,0,0,0,7,4,3,0,0,0,1,1,0,1,0,1
178369,33000,330,0,-2,12,9,3,0,0,0,0,0,0,3,3,0,1,0,1,0,0,0,8,6,2,0,0,0,0,0,0,0,0,0
178387,33000,330,0,-2,12,7,5,0,0,0,0,0,0,0,0,0,0,0,0,0,0,0,3,2,1,0,0,0,8,5,3,1,0,1
178396,33000,330,0,-2,134,47,87,1,0,1,1,0,1,20,8,12,5,4,1,0,0,0,92,30,62,3,1,2,10,3,7,2,1,1
178402,33000,330,0,-2,73,27,46,0,0,0,0,0,0,11,3,8,6,4,2,0,0,0,49,15,34,4,3,1,2,1,1,1,1,0
178411,33000,330,0,-2,21,8,13,0,0,0,0,0,0,1,1,0,0,0,0,0,0,0,19,7,12,0,0,0,1,0,1,0,0,0
178420,33000,330,0,-2,45,19,26,0,0,0,2,2,0,13,5,8,3,2,1,0,0,0,24,9,15,2,1,1,1,0,1,0,0,0
178439,33000,330,0,-2,14,3,11,0,0,0,0,0,0,1,0,1,2,0,2,0,0,0,10,3,7,1,0,1,0,0,0,0,0,0
178448,33000,330,0,-2,6,5,1,0,0,0,0,0,0,2,1,1,0,0,0,0,0,0,4,4,0,0,0,0,0,0,0,0,0,0
178615,33000,330,0,-2,19,11,8,0,0,0,1,0,1,2,1,1,0,0,0,0,0,0,16,10,6,0,0,0,0,0,0,0,0,0
178624,33000,330,0,-2,12,7,5,0,0,0,1,0,1,1,1,0,3,2,1,0,0,0,7,4,3,0,0,0,0,0,0,0,0,0
178721,33000,330,0,-2,9,5,4,0,0,0,0,0,0,0,0,0,1,1,0,0,0,0,8,4,4,0,0,0,0,0,0,0,0,0
179043,33000,330,0,-2,9,2,7,0,0,0,0,0,0,0,0,0,1,0,1,0,0,0,7,2,5,0,0,0,1,0,1,0,0,0
179159,33000,330,0,-2,19,11,8,0,0,0,0,0,0,4,3,1,1,1,0,0,0,0,13,7,6,1,0,1,0,0,0,0,0,0
179326,33000,330,0,-2,9,4,5,0,0,0,0,0,0,0,0,0,0,0,0,0,0,0,9,4,5,0,0,0,0,0,0,0,0,0
179344,33000,330,0,-2,3,1,2,0,0,0,0,0,0,0,0,0,0,0,0,0,0,0,3,1,2,0,0,0,0,0,0,0,0,0
179539,33000,330,0,-2,1,1,0,0,0,0,0,0,0,0,0,0,0,0,0,0,0,0,1,1,0,0,0,0,0,0,0,0,0,0
179548,33000,330,0,-2,6,4,2,0,0,0,1,0,1,1,1,0,0,0,0,0,0,0,3,2,1,1,1,0,0,0,0,0,0,0
179557,33000,330,0,-2,24,16,8,0,0,0,0,0,0,6,3,3,0,0,0,0,0,0,17,12,5,0,0,0,1,1,0,0,0,0
179566,33000,330,0,-2,27,10,17,0,0,0,0,0,0,3,1,2,0,0,0,0,0,0,22,8,14,2,1,1,0,0,0,0,0,0
179645,33000,330,0,-2,8,4,4,0,0,0,0,0,0,1,1,0,0,0,0,0,0,0,7,3,4,0,0,0,0,0,0,0,0,0
179812,33000,330,0,-2,2,0,2,0,0,0,0,0,0,0,0,0,0,0,0,0,0,0,2,0,2,0,0,0,0,0,0,0,0,0
179867,33000,330,0,-2,98,30,68,0,0,0,2,2,0,24,10,14,7,2,5,0,0,0,64,16,48,1,0,1,0,0,0,0,0,0
179894,33000,330,0,-2,14,7,7,0,0,0,0,0,0,2,0,2,1,0,1,0,0,0,11,7,4,0,0,0,0,0,0,0,0,0
179946,33000,330,0,-2,5,3,2,0,0,0,0,0,0,1,0,1,0,0,0,0,0,0,4,3,1,0,0,0,0,0,0,0,0,0
179955,33000,330,0,-2,7,6,1,0,0,0,0,0,0,2,1,1,0,0,0,0,0,0,5,5,0,0,0,0,0,0,0,0,0,0
179964,33000,330,0,-2,2,1,1,0,0,0,0,0,0,0,0,0,0,0,0,0,0,0,2,1,1,0,0,0,0,0,0,0,0,0
180106,33000,330,0,-2,5,2,3,0,0,0,0,0,0,0,0,0,0,0,0,1,0,1,0,0,0,0,0,0,4,2,2,0,0,0
180179,33000,330,0,-2,14,7,7,1,0,1,0,0,0,1,1,0,0,0,0,0,0,0,12,6,6,0,0,0,0,0,0,0,0,0
180197,33000,330,0,-2,5,2,3,0,0,0,0,0,0,0,0,0,0,0,0,0,0,0,5,2,3,0,0,0,0,0,0,0,0,0
180258,33000,330,0,-2,11,7,4,0,0,0,0,0,0,0,0,0,2,1,1,0,0,0,6,6,0,1,0,1,1,0,1,1,0,1
180373,33000,330,0,-2,2,2,0,0,0,0,0,0,0,0,0,0,0,0,0,0,0,0,0,0,0,0,0,0,2,2,0,0,0,0
180416,33000,330,0,-2,3,2,1,0,0,0,0,0,0,0,0,0,0,0,0,0,0,0,3,2,1,0,0,0,0,0,0,0,0,0
180461,33000,330,0,-2,37,16,21,0,0,0,0,0,0,2,1,1,0,0,0,0,0,0,32,13,19,2,1,1,1,1,0,0,0,0
180489,33000,330,0,-2,16,7,9,1,0,1,0,0,0,1,1,0,2,2,0,0,0,0,12,4,8,0,0,0,0,0,0,0,0,0
180522,33000,330,0,-2,4,4,0,0,0,0,0,0,0,2,2,0,0,0,0,0,0,0,1,1,0,0,0,0,1,1,0,0,0,0
180595,33000,330,0,-2,4,1,3,0,0,0,0,0,0,0,0,0,0,0,0,1,0,1,2,1,1,0,0,0,1,0,1,0,0,0
180692,33000,330,0,-2,6,3,3,0,0,0,0,0,0,0,0,0,0,0,0,0,0,0,3,2,1,0,0,0,3,1,2,0,0,0
180814,33000,330,0,-2,11,5,6,0,0,0,0,0,0,0,0,0,0,0,0,0,0,0,9,4,5,0,0,0,2,1,1,0,0,0
180832,33000,330,0,-2,2,0,2,0,0,0,0,0,0,0,0,0,0,0,0,0,0,0,2,0,2,0,0,0,0,0,0,0,0,0
180878,33000,330,0,-2,1,0,1,0,0,0,0,0,0,0,0,0,0,0,0,0,0,0,1,0,1,0,0,0,0,0,0,0,0,0
180902,33000,330,0,-2,2,1,1,0,0,0,0,0,0,0,0,0,0,0,0,0,0,0,1,1,0,1,0,1,0,0,0,0,0,0
180948,33000,330,0,-2,4,4,0,0,0,0,0,0,0,0,0,0,0,0,0,0,0,0,4,4,0,0,0,0,0,0,0,0,0,0
180984,33000,330,0,-2,9,4,5,0,0,0,0,0,0,0,0,0,0,0,0,0,0,0,9,4,5,0,0,0,0,0,0,0,0,0
181002,33000,330,0,-2,16,3,13,0,0,0,0,0,0,1,0,1,1,0,1,0,0,0,13,3,10,0,0,0,1,0,1,0,0,0
181020,33000,330,0,-2,8,3,5,0,0,0,0,0,0,0,0,0,0,0,0,0,0,0,7,2,5,1,1,0,0,0,0,0,0,0
181127,33000,330,0,-2,7,4,3,0,0,0,0,0,0,1,1,0,0,0,0,0,0,0,6,3,3,0,0,0,0,0,0,0,0,0
181215,33000,330,0,-2,6,1,5,0,0,0,0,0,0,0,0,0,0,0,0,0,0,0,6,1,5,0,0,0,0,0,0,0,0,0
181303,33000,330,0,-2,7,2,5,0,0,0,0,0,0,0,0,0,2,0,2,0,0,0,5,2,3,0,0,0,0,0,0,0,0,0
181330,33000,330,0,-2,13,8,5,0,0,0,1,0,1,1,1,0,1,1,0,0,0,0,10,6,4,0,0,0,0,0,0,0,0,0
181394,33000,330,0,-2,12,6,6,0,0,0,1,0,1,1,1,0,5,3,2,0,0,0,4,1,3,1,1,0,0,0,0,0,0,0
181428,33000,330,0,-2,17,3,14,0,0,0,1,0,1,1,0,1,2,0,2,0,0,0,12,2,10,0,0,0,0,0,0,1,1,0
181446,33000,330,0,-2,6,2,4,0,0,0,1,0,1,0,0,0,0,0,0,0,0,0,5,2,3,0,0,0,0,0,0,0,0,0
181464,33000,330,0,-2,63,30,33,0,0,0,1,1,0,9,8,1,6,1,5,0,0,0,45,20,25,1,0,1,0,0,0,1,0,1
181534,33000,330,0,-2,5,3,2,0,0,0,0,0,0,0,0,0,0,0,0,0,0,0,5,3,2,0,0,0,0,0,0,0,0,0
181604,33000,330,0,-2,2,1,1,0,0,0,0,0,0,0,0,0,0,0,0,0,0,0,2,1,1,0,0,0,0,0,0,0,0,0
181640,33000,330,0,-2,3,0,3,0,0,0,0,0,0,0,0,0,0,0,0,0,0,0,3,0,3,0,0,0,0,0,0,0,0,0
181738,33000,330,0,-2,3,2,1,0,0,0,0,0,0,0,0,0,0,0,0,0,0,0,3,2,1,0,0,0,0,0,0,0,0,0
181747,33000,330,0,-2,4,1,3,0,0,0,1,0,1,0,0,0,0,0,0,0,0,0,2,1,1,1,0,1,0,0,0,0,0,0
181783,33000,330,0,-2,7,5,2,0,0,0,0,0,0,1,1,0,0,0,0,1,0,1,5,4,1,0,0,0,0,0,0,0,0,0
181817,33000,330,0,-2,4,1,3,0,0,0,0,0,0,0,0,0,0,0,0,0,0,0,4,1,3,0,0,0,0,0,0,0,0,0
181853,33000,330,0,-2,4,3,1,0,0,0,0,0,0,0,0,0,1,0,1,0,0,0,3,3,0,0,0,0,0,0,0,0,0,0
182005,33000,330,0,-2,7,2,5,0,0,0,1,0,1,3,2,1,0,0,0,0,0,0,2,0,2,1,0,1,0,0,0,0,0,0
182281,33000,330,0,-2,49,20,29,1,0,1,3,0,3,19,12,7,9,2,7,0,0,0,15,5,10,1,0,1,0,0,0,1,1,0
182290,33000,330,0,-2,43,11,32,1,1,0,6,0,6,1,0,1,6,0,6,0,0,0,21,7,14,5,2,3,0,0,0,3,1,2
182306,33000,330,0,-2,2,1,1,0,0,0,0,0,0,0,0,0,0,0,0,0,0,0,2,1,1,0,0,0,0,0,0,0,0,0
182458,33000,330,0,-2,2,1,1,0,0,0,0,0,0,0,0,0,0,0,0,0,0,0,2,1,1,0,0,0,0,0,0,0,0,0
182500,33000,330,0,-2,2,2,0,0,0,0,0,0,0,0,0,0,0,0,0,0,0,0,1,1,0,1,1,0,0,0,0,0,0,0
182634,33000,330,0,-2,9,3,6,0,0,0,0,0,0,1,1,0,0,0,0,0,0,0,8,2,6,0,0,0,0,0,0,0,0,0
182670,33000,330,0,-2,49,21,28,1,1,0,2,1,1,2,1,1,0,0,0,0,0,0,42,18,24,2,0,2,0,0,0,0,0,0
182795,33000,330,0,-2,10,6,4,0,0,0,0,0,0,1,1,0,2,2,0,0,0,0,6,2,4,1,1,0,0,0,0,0,0,0
182829,33000,330,0,-2,2,0,2,0,0,0,0,0,0,1,0,1,0,0,0,0,0,0,1,0,1,0,0,0,0,0,0,0,0,0
182980,33000,330,0,-2,2,1,1,0,0,0,1,0,1,0,0,0,0,0,0,0,0,0,1,1,0,0,0,0,0,0,0,0,0,0
183026,33000,330,0,-2,7,0,7,0,0,0,1,0,1,0,0,0,0,0,0,0,0,0,6,0,6,0,0,0,0,0,0,0,0,0
183044,33000,330,0,-2,28,8,20,0,0,0,0,0,0,1,1,0,2,1,1,0,0,0,22,5,17,1,1,0,2,0,2,0,0,0
183062,33000,330,0,-2,2,0,2,0,0,0,0,0,0,0,0,0,0,0,0,0,0,0,2,0,2,0,0,0,0,0,0,0,0,0
183080,33000,330,0,-2,2,1,1,0,0,0,0,0,0,0,0,0,0,0,0,0,0,0,2,1,1,0,0,0,0,0,0,0,0,0
183211,33000,330,0,-2,10,4,6,0,0,0,0,0,0,0,0,0,0,0,0,0,0,0,10,4,6,0,0,0,0,0,0,0,0,0
183239,33000,330,0,-2,9,6,3,0,0,0,0,0,0,0,0,0,0,0,0,0,0,0,9,6,3,0,0,0,0,0,0,0,0,0
183257,33000,330,0,-2,3,2,1,0,0,0,0,0,0,0,0,0,0,0,0,0,0,0,3,2,1,0,0,0,0,0,0,0,0,0
183327,33000,330,0,-2,1,0,1,0,0,0,0,0,0,0,0,0,0,0,0,0,0,0,1,0,1,0,0,0,0,0,0,0,0,0
183655,33000,330,0,-2,2,1,1,0,0,0,0,0,0,2,1,1,0,0,0,0,0,0,0,0,0,0,0,0,0,0,0,0,0,0
183743,33000,330,0,-2,1,1,0,0,0,0,0,0,0,1,1,0,0,0,0,0,0,0,0,0,0,0,0,0,0,0,0,0,0,0
183789,33000,330,0,-2,1,0,1,0,0,0,0,0,0,1,0,1,0,0,0,0,0,0,0,0,0,0,0,0,0,0,0,0,0,0
183859,33000,330,0,-2,1,0,1,0,0,0,0,0,0,0,0,0,0,0,0,0,0,0,1,0,1,0,0,0,0,0,0,0,0,0
183910,33000,330,0,-2,5,1,4,0,0,0,0,0,0,0,0,0,0,0,0,0,0,0,5,1,4,0,0,0,0,0,0,0,0,0
183938,33000,330,0,-2,3,1,2,0,0,0,0,0,0,1,1,0,0,0,0,0,0,0,2,0,2,0,0,0,0,0,0,0,0,0
183974,33000,330,0,-2,12,5,7,0,0,0,0,0,0,1,0,1,1,0,1,0,0,0,10,5,5,0,0,0,0,0,0,0,0,0
184180,33000,330,0,-2,5,1,4,0,0,0,0,0,0,1,1,0,2,0,2,0,0,0,2,0,2,0,0,0,0,0,0,0,0,0
184205,33000,330,0,-2,2,1,1,0,0,0,0,0,0,1,1,0,1,0,1,0,0,0,0,0,0,0,0,0,0,0,0,0,0,0
184348,33000,330,0,-2,7,7,0,0,0,0,0,0,0,0,0,0,0,0,0,0,0,0,7,7,0,0,0,0,0,0,0,0,0,0
184603,33000,330,0,-2,9,4,5,0,0,0,0,0,0,1,1,0,1,1,0,0,0,0,6,1,5,1,1,0,0,0,0,0,0,0
184612,33000,330,0,-2,3,1,2,0,0,0,1,0,1,0,0,0,0,0,0,0,0,0,2,1,1,0,0,0,0,0,0,0,0,0
184694,33000,330,0,-2,5,3,2,0,0,0,0,0,0,1,1,0,0,0,0,0,0,0,4,2,2,0,0,0,0,0,0,0,0,0
184773,33000,330,0,-2,2,1,1,0,0,0,1,0,1,0,0,0,0,0,0,0,0,0,1,1,0,0,0,0,0,0,0,0,0,0
184791,33000,330,0,-2,9,4,5,0,0,0,0,0,0,3,1,2,0,0,0,1,1,0,3,1,2,0,0,0,2,1,1,0,0,0
184995,33000,330,0,-2,7,2,5,1,0,1,0,0,0,0,0,0,1,0,1,0,0,0,4,1,3,1,1,0,0,0,0,0,0,0
185262,33000,330,0,-2,8,2,6,0,0,0,0,0,0,2,0,2,1,0,1,0,0,0,4,2,2,0,0,0,1,0,1,0,0,0
185509,33000,330,0,-2,1,0,1,0,0,0,0,0,0,1,0,1,0,0,0,0,0,0,0,0,0,0,0,0,0,0,0,0,0,0
185536,33000,330,0,-2,3,0,3,0,0,0,2,0,2,1,0,1,0,0,0,0,0,0,0,0,0,0,0,0,0,0,0,0,0,0
185572,33000,330,0,-2,14,7,7,0,0,0,0,0,0,2,0,2,1,0,1,0,0,0,11,7,4,0,0,0,0,0,0,0,0,0
185590,33000,330,0,-2,11,6,5,0,0,0,0,0,0,3,1,2,1,1,0,0,0,0,5,3,2,0,0,0,2,1,1,0,0,0
185828,33000,330,0,-2,23,12,11,0,0,0,2,0,2,5,4,1,5,1,4,0,0,0,10,6,4,1,1,0,0,0,0,0,0,0
185873,33000,330,0,-2,5,0,5,0,0,0,0,0,0,0,0,0,2,0,2,0,0,0,3,0,3,0,0,0,0,0,0,0,0,0
186034,33000,330,0,-2,5,1,4,0,0,0,0,0,0,1,0,1,1,0,1,0,0,0,2,0,2,1,1,0,0,0,0,0,0,0
186131,33000,330,0,-2,21,11,10,0,0,0,0,0,0,4,3,1,2,1,1,0,0,0,12,6,6,1,1,0,1,0,1,1,0,1
186283,33000,330,0,-2,13,1,12,0,0,0,1,0,1,5,0,5,1,0,1,0,0,0,6,1,5,0,0,0,0,0,0,0,0,0
186371,33000,330,0,-2,2,1,1,0,0,0,0,0,0,0,0,0,0,0,0,0,0,0,0,0,0,0,0,0,2,1,1,0,0,0
186380,33000,330,0,-2,94,25,69,0,0,0,3,1,2,6,2,4,5,1,4,0,0,0,6,4,2,0,0,0,74,17,57,0,0,0
186399,33000,330,0,-2,5,2,3,0,0,0,0,0,0,0,0,0,0,0,0,1,0,1,1,0,1,1,1,0,2,1,1,0,0,0
186432,33000,330,0,-2,8,5,3,0,0,0,0,0,0,2,2,0,2,1,1,0,0,0,4,2,2,0,0,0,0,0,0,0,0,0
186469,33000,330,0,-2,2,1,1,0,0,0,0,0,0,0,0,0,0,0,0,0,0,0,2,1,1,0,0,0,0,0,0,0,0,0
186584,33000,330,0,-2,34,9,25,0,0,0,0,0,0,6,1,5,8,3,5,0,0,0,19,4,15,0,0,0,0,0,0,1,1,0
186618,33000,330,0,-2,4,2,2,0,0,0,0,0,0,2,2,0,1,0,1,0,0,0,1,0,1,0,0,0,0,0,0,0,0,0
186876,33000,330,0,-2,4,1,3,0,0,0,0,0,0,1,0,1,0,0,0,0,0,0,3,1,2,0,0,0,0,0,0,0,0,0
187046,33000,330,0,-2,6,3,3,0,0,0,2,1,1,2,1,1,1,0,1,0,0,0,1,1,0,0,0,0,0,0,0,0,0,0
187134,33000,330,0,-2,8,4,4,0,0,0,0,0,0,5,4,1,1,0,1,0,0,0,2,0,2,0,0,0,0,0,0,0,0,0
187444,33000,330,0,-2,8,2,6,0,0,0,0,0,0,1,0,1,3,0,3,0,0,0,3,1,2,0,0,0,1,1,0,0,0,0
187620,33000,330,0,-2,3,0,3,0,0,0,0,0,0,1,0,1,1,0,1,0,0,0,1,0,1,0,0,0,0,0,0,0,0,0
187639,33000,330,0,-2,4,0,4,0,0,0,1,0,1,0,0,0,1,0,1,0,0,0,2,0,2,0,0,0,0,0,0,0,0,0
187648,33000,330,0,-2,13,6,7,0,0,0,0,0,0,1,1,0,2,0,2,0,0,0,5,2,3,0,0,0,3,2,1,2,1,1
187666,33000,330,0,-2,1,1,0,0,0,0,0,0,0,0,0,0,0,0,0,0,0,0,1,1,0,0,0,0,0,0,0,0,0,0
187897,33000,330,0,-2,17,12,5,1,1,0,1,1,0,0,0,0,1,0,1,1,1,0,7,4,3,1,1,0,5,4,1,0,0,0
187903,33000,330,0,-2,1,0,1,0,0,0,0,0,0,0,0,0,1,0,1,0,0,0,0,0,0,0,0,0,0,0,0,0,0,0
187912,33000,330,0,-2,3,2,1,1,0,1,0,0,0,0,0,0,2,2,0,0,0,0,0,0,0,0,0,0,0,0,0,0,0,0
187958,33000,330,0,-2,1,0,1,0,0,0,0,0,0,0,0,0,1,0,1,0,0,0,0,0,0,0,0,0,0,0,0,0,0,0
187967,33000,330,0,-2,4,3,1,0,0,0,0,0,0,0,0,0,3,3,0,0,0,0,1,0,1,0,0,0,0,0,0,0,0,0
187976,33000,330,0,-2,1,0,1,0,0,0,0,0,0,0,0,0,0,0,0,0,0,0,1,0,1,0,0,0,0,0,0,0,0,0
187985,33000,330,0,-2,52,27,25,1,1,0,2,1,1,3,2,1,9,4,5,0,0,0,29,13,16,4,3,1,3,3,0,1,0,1
187994,33000,330,0,-2,1,0,1,1,0,1,0,0,0,0,0,0,0,0,0,0,0,0,0,0,0,0,0,0,0,0,0,0,0,0
188030,33000,330,0,-2,19,14,5,0,0,0,0,0,0,3,3,0,3,2,1,0,0,0,12,8,4,0,0,0,0,0,0,1,1,0
188049,33000,330,0,-2,1,1,0,0,0,0,0,0,0,0,0,0,0,0,0,0,0,0,1,1,0,0,0,0,0,0,0,0,0,0
188058,33000,330,0,-2,1,0,1,0,0,0,0,0,0,0,0,0,0,0,0,0,0,0,0,0,0,0,0,0,1,0,1,0,0,0
188100,33000,330,0,-2,4,2,2,1,1,0,0,0,0,0,0,0,1,1,0,0,0,0,1,0,1,0,0,0,1,0,1,0,0,0
188137,33000,330,0,-2,1,0,1,0,0,0,0,0,0,0,0,0,1,0,1,0,0,0,0,0,0,0,0,0,0,0,0,0,0,0
188182,33000,330,0,-2,4,3,1,0,0,0,0,0,0,0,0,0,1,0,1,0,0,0,0,0,0,0,0,0,3,3,0,0,0,0
188304,33000,330,0,-2,19,14,5,1,1,0,2,2,0,4,4,0,4,3,1,0,0,0,7,4,3,0,0,0,1,0,1,0,0,0
188429,33000,330,0,-2,16,6,10,0,0,0,0,0,0,4,1,3,1,0,1,0,0,0,11,5,6,0,0,0,0,0,0,0,0,0
188438,33000,330,0,-2,2,1,1,0,0,0,0,0,0,0,0,0,0,0,0,0,0,0,2,1,1,0,0,0,0,0,0,0,0,0
188517,33000,330,0,-2,6,2,4,0,0,0,0,0,0,2,1,1,0,0,0,0,0,0,4,1,3,0,0,0,0,0,0,0,0,0
188526,33000,330,0,-2,2,2,0,0,0,0,0,0,0,1,1,0,0,0,0,0,0,0,1,1,0,0,0,0,0,0,0,0,0,0
188535,33000,330,0,-2,5,4,1,0,0,0,1,1,0,0,0,0,0,0,0,0,0,0,4,3,1,0,0,0,0,0,0,0,0,0
188580,33000,330,0,-2,5,0,5,0,0,0,0,0,0,0,0,0,0,0,0,0,0,0,4,0,4,1,0,1,0,0,0,0,0,0
188641,33000,330,0,-2,10,6,4,0,0,0,2,0,2,0,0,0,1,1,0,0,0,0,6,4,2,0,0,0,0,0,0,1,1,0
188854,33000,330,0,-2,6,2,4,0,0,0,0,0,0,0,0,0,1,1,0,0,0,0,5,1,4,0,0,0,0,0,0,0,0,0
189088,33000,330,0,-2,13,6,7,0,0,0,2,0,2,1,1,0,0,0,0,0,0,0,9,5,4,0,0,0,1,0,1,0,0,0
189097,33000,330,0,-2,26,6,20,0,0,0,2,0,2,3,1,2,4,2,2,0,0,0,13,2,11,0,0,0,4,1,3,0,0,0
189501,33000,330,0,-2,2,0,2,0,0,0,0,0,0,0,0,0,1,0,1,0,0,0,1,0,1,0,0,0,0,0,0,0,0,0
189565,33000,330,0,-2,2,0,2,0,0,0,0,0,0,0,0,0,0,0,0,0,0,0,1,0,1,0,0,0,1,0,1,0,0,0
189583,33000,330,0,-2,11,4,7,0,0,0,0,0,0,6,2,4,0,0,0,0,0,0,5,2,3,0,0,0,0,0,0,0,0,0
189592,33000,330,0,-2,3,2,1,0,0,0,0,0,0,0,0,0,0,0,0,0,0,0,2,1,1,0,0,0,1,1,0,0,0,0
189705,33000,330,0,-2,8,5,3,0,0,0,0,0,0,0,0,0,1,1,0,0,0,0,7,4,3,0,0,0,0,0,0,0,0,0
189811,33000,330,0,-2,1,0,1,0,0,0,0,0,0,1,0,1,0,0,0,0,0,0,0,0,0,0,0,0,0,0,0,0,0,0
189848,33000,330,0,-2,3,2,1,0,0,0,0,0,0,1,1,0,0,0,0,0,0,0,2,1,1,0,0,0,0,0,0,0,0,0
190035,33000,330,0,-2,5,2,3,0,0,0,1,0,1,0,0,0,0,0,0,0,0,0,4,2,2,0,0,0,0,0,0,0,0,0
190044,33000,330,0,-2,13,7,6,0,0,0,0,0,0,1,1,0,0,0,0,0,0,0,10,5,5,0,0,0,0,0,0,2,1,1
190099,33000,330,0,-2,21,10,11,0,0,0,1,0,1,4,2,2,3,1,2,0,0,0,12,7,5,0,0,0,0,0,0,1,0,1
190150,33000,330,0,-2,29,16,13,0,0,0,0,0,0,4,1,3,4,3,1,0,0,0,19,10,9,1,1,0,1,1,0,0,0,0
190169,33000,330,0,-2,1,0,1,0,0,0,0,0,0,0,0,0,0,0,0,0,0,0,1,0,1,0,0,0,0,0,0,0,0,0
190372,33000,330,0,-2,1,0,1,0,0,0,0,0,0,0,0,0,0,0,0,0,0,0,1,0,1,0,0,0,0,0,0,0,0,0
190415,33000,330,0,-2,38,22,16,0,0,0,2,1,1,3,3,0,4,2,2,0,0,0,27,14,13,1,1,0,1,1,0,0,0,0
190424,33000,330,0,-2,17,1,16,0,0,0,2,0,2,0,0,0,4,0,4,0,0,0,9,1,8,0,0,0,0,0,0,2,0,2
190442,33000,330,0,-2,3,3,0,0,0,0,0,0,0,1,1,0,0,0,0,0,0,0,2,2,0,0,0,0,0,0,0,0,0,0
190503,33000,330,0,-2,2,0,2,0,0,0,0,0,0,0,0,0,0,0,0,0,0,0,2,0,2,0,0,0,0,0,0,0,0,0
190512,33000,330,0,-2,6,1,5,0,0,0,1,1,0,1,0,1,2,0,2,0,0,0,2,0,2,0,0,0,0,0,0,0,0,0
190521,33000,330,0,-2,14,4,10,0,0,0,0,0,0,9,4,5,4,0,4,1,0,1,0,0,0,0,0,0,0,0,0,0,0,0
190549,33000,330,0,-2,1,0,1,0,0,0,0,0,0,1,0,1,0,0,0,0,0,0,0,0,0,0,0,0,0,0,0,0,0,0
190558,33000,330,0,-2,2,0,2,0,0,0,0,0,0,1,0,1,0,0,0,0,0,0,1,0,1,0,0,0,0,0,0,0,0,0
190567,33000,330,0,-2,2,1,1,0,0,0,0,0,0,2,1,1,0,0,0,0,0,0,0,0,0,0,0,0,0,0,0,0,0,0
190576,33000,330,0,-2,4,1,3,0,0,0,0,0,0,3,1,2,1,0,1,0,0,0,0,0,0,0,0,0,0,0,0,0,0,0
190585,33000,330,0,-2,1,1,0,1,1,0,0,0,0,0,0,0,0,0,0,0,0,0,0,0,0,0,0,0,0,0,0,0,0,0
190594,33000,330,0,-2,1,0,1,0,0,0,0,0,0,0,0,0,1,0,1,0,0,0,0,0,0,0,0,0,0,0,0,0,0,0
190600,33000,330,0,-2,4,3,1,0,0,0,0,0,0,1,1,0,0,0,0,0,0,0,2,1,1,0,0,0,0,0,0,1,1,0
190619,33000,330,0,-2,1,0,1,0,0,0,0,0,0,1,0,1,0,0,0,0,0,0,0,0,0,0,0,0,0,0,0,0,0,0
190628,33000,330,0,-2,2,0,2,0,0,0,0,0,0,1,0,1,1,0,1,0,0,0,0,0,0,0,0,0,0,0,0,0,0,0
190637,33000,330,0,-2,1,1,0,0,0,0,0,0,0,1,1,0,0,0,0,0,0,0,0,0,0,0,0,0,0,0,0,0,0,0
190646,33000,330,0,-2,1,0,1,0,0,0,0,0,0,1,0,1,0,0,0,0,0,0,0,0,0,0,0,0,0,0,0,0,0,0
190655,33000,330,0,-2,3,0,3,0,0,0,1,0,1,0,0,0,2,0,2,0,0,0,0,0,0,0,0,0,0,0,0,0,0,0
190664,33000,330,0,-2,1,1,0,0,0,0,0,0,0,0,0,0,1,1,0,0,0,0,0,0,0,0,0,0,0,0,0,0,0,0
190673,33000,330,0,-2,2,0,2,0,0,0,0,0,0,0,0,0,0,0,0,0,0,0,2,0,2,0,0,0,0,0,0,0,0,0
190716,33000,330,0,-2,16,7,9,0,0,0,0,0,0,3,1,2,0,0,0,0,0,0,13,6,7,0,0,0,0,0,0,0,0,0
190725,33000,330,0,-2,5,1,4,0,0,0,0,0,0,1,0,1,0,0,0,0,0,0,4,1,3,0,0,0,0,0,0,0,0,0
190761,33000,330,0,-2,2,0,2,0,0,0,0,0,0,0,0,0,0,0,0,0,0,0,1,0,1,0,0,0,1,0,1,0,0,0
190840,33000,330,0,-2,1,0,1,0,0,0,0,0,0,0,0,0,0,0,0,0,0,0,0,0,0,0,0,0,1,0,1,0,0,0
190983,33000,330,0,-2,10,3,7,0,0,0,0,0,0,1,1,0,0,0,0,0,0,0,8,2,6,0,0,0,1,0,1,0,0,0
191126,33000,330,0,-2,2,0,2,0,0,0,1,0,1,0,0,0,0,0,0,0,0,0,0,0,0,0,0,0,1,0,1,0,0,0
191199,33000,330,0,-2,1,1,0,0,0,0,0,0,0,0,0,0,0,0,0,0,0,0,0,0,0,0,0,0,1,1,0,0,0,0
191205,33000,330,0,-2,1,1,0,0,0,0,0,0,0,0,0,0,0,0,0,0,0,0,1,1,0,0,0,0,0,0,0,0,0,0
191241,33000,330,0,-2,29,15,14,0,0,0,0,0,0,4,3,1,3,2,1,0,0,0,14,6,8,2,0,2,6,4,2,0,0,0
191515,33000,330,0,-2,9,3,6,0,0,0,0,0,0,0,0,0,1,1,0,0,0,0,6,2,4,1,0,1,1,0,1,0,0,0
191533,33000,330,0,-2,16,10,6,0,0,0,0,0,0,1,1,0,1,0,1,0,0,0,14,9,5,0,0,0,0,0,0,0,0,0
191621,33000,330,0,-2,3,1,2,0,0,0,0,0,0,0,0,0,0,0,0,0,0,0,3,1,2,0,0,0,0,0,0,0,0,0
191630,33000,330,0,-2,17,12,5,0,0,0,0,0,0,1,1,0,0,0,0,0,0,0,16,11,5,0,0,0,0,0,0,0,0,0
191649,33000,330,0,-2,29,11,18,0,0,0,1,0,1,5,2,3,4,2,2,0,0,0,19,7,12,0,0,0,0,0,0,0,0,0
191676,33000,330,0,-2,4,3,1,0,0,0,0,0,0,0,0,0,0,0,0,0,0,0,4,3,1,0,0,0,0,0,0,0,0,0
191931,33000,330,0,-2,10,6,4,0,0,0,0,0,0,1,0,1,2,0,2,0,0,0,7,6,1,0,0,0,0,0,0,0,0,0
191968,33000,330,0,-2,13,7,6,0,0,0,0,0,0,0,0,0,0,0,0,0,0,0,2,1,1,0,0,0,11,6,5,0,0,0
191986,33000,330,0,-2,4,1,3,0,0,0,0,0,0,0,0,0,0,0,0,0,0,0,4,1,3,0,0,0,0,0,0,0,0,0
192040,33000,330,0,-2,2,1,1,0,0,0,0,0,0,0,0,0,0,0,0,0,0,0,2,1,1,0,0,0,0,0,0,0,0,0
192110,33000,330,0,-2,5,2,3,0,0,0,0,0,0,2,0,2,1,1,0,0,0,0,2,1,1,0,0,0,0,0,0,0,0,0
192192,33000,330,0,-2,6,2,4,0,0,0,0,0,0,1,1,0,0,0,0,0,0,0,5,1,4,0,0,0,0,0,0,0,0,0
192323,33000,330,0,-2,4,2,2,0,0,0,0,0,0,0,0,0,0,0,0,0,0,0,3,2,1,1,0,1,0,0,0,0,0,0
192448,33000,330,0,-2,29,13,16,0,0,0,1,0,1,2,1,1,2,1,1,0,0,0,17,7,10,0,0,0,6,4,2,1,0,1
192703,33000,330,0,-2,4,3,1,0,0,0,0,0,0,2,1,1,0,0,0,0,0,0,2,2,0,0,0,0,0,0,0,0,0,0
192712,33000,330,0,-2,9,2,7,0,0,0,1,0,1,1,0,1,0,0,0,0,0,0,7,2,5,0,0,0,0,0,0,0,0,0
192749,33000,330,0,-2,6,3,3,0,0,0,0,0,0,3,2,1,0,0,0,0,0,0,3,1,2,0,0,0,0,0,0,0,0,0
192819,33000,330,0,-2,13,7,6,0,0,0,0,0,0,4,3,1,3,1,2,0,0,0,6,3,3,0,0,0,0,0,0,0,0,0
192864,33000,330,0,-2,5,0,5,0,0,0,0,0,0,0,0,0,0,0,0,0,0,0,0,0,0,0,0,0,5,0,5,0,0,0
192925,33000,330,0,-2,7,5,2,0,0,0,0,0,0,0,0,0,0,0,0,0,0,0,7,5,2,0,0,0,0,0,0,0,0,0
193283,33000,330,0,-2,4,1,3,0,0,0,0,0,0,1,0,1,0,0,0,0,0,0,3,1,2,0,0,0,0,0,0,0,0,0
193292,33000,330,0,-2,3,1,2,0,0,0,0,0,0,0,0,0,0,0,0,0,0,0,3,1,2,0,0,0,0,0,0,0,0,0
193308,33000,330,0,-2,14,6,8,0,0,0,1,0,1,6,2,4,2,2,0,0,0,0,5,2,3,0,0,0,0,0,0,0,0,0
193353,33000,330,0,-2,5,1,4,0,0,0,0,0,0,1,0,1,1,0,1,0,0,0,3,1,2,0,0,0,0,0,0,0,0,0
193399,33000,330,0,-2,11,3,8,0,0,0,0,0,0,1,0,1,5,1,4,0,0,0,4,1,3,1,1,0,0,0,0,0,0,0
193405,33000,330,0,-2,50,6,44,0,0,0,3,1,2,1,0,1,20,2,18,0,0,0,3,0,3,0,0,0,23,3,20,0,0,0
193584,33000,330,0,-2,3,2,1,0,0,0,0,0,0,1,0,1,0,0,0,0,0,0,2,2,0,0,0,0,0,0,0,0,0,0
193654,33000,330,0,-2,4,2,2,0,0,0,0,0,0,0,0,0,1,0,1,0,0,0,3,2,1,0,0,0,0,0,0,0,0,0
193751,33000,330,0,-2,1,1,0,0,0,0,0,0,0,0,0,0,0,0,0,0,0,0,1,1,0,0,0,0,0,0,0,0,0,0
193821,33000,330,0,-2,1,0,1,0,0,0,0,0,0,0,0,0,0,0,0,0,0,0,0,0,0,0,0,0,1,0,1,0,0,0
193894,33000,330,0,-2,1,1,0,0,0,0,0,0,0,1,1,0,0,0,0,0,0,0,0,0,0,0,0,0,0,0,0,0,0,0
193900,33000,330,0,-2,49,17,32,0,0,0,4,2,2,10,3,7,4,1,3,0,0,0,26,9,17,0,0,0,4,2,2,1,0,1
193946,33000,330,0,-2,2,1,1,0,0,0,0,0,0,0,0,0,0,0,0,0,0,0,2,1,1,0,0,0,0,0,0,0,0,0
193973,33000,330,0,-2,11,6,5,0,0,0,0,0,0,3,2,1,0,0,0,0,0,0,7,4,3,0,0,0,0,0,0,1,0,1
194091,33000,330,0,-2,1,0,1,0,0,0,0,0,0,0,0,0,0,0,0,0,0,0,1,0,1,0,0,0,0,0,0,0,0,0
194116,33000,330,0,-2,2,0,2,0,0,0,0,0,0,1,0,1,0,0,0,0,0,0,1,0,1,0,0,0,0,0,0,0,0,0
194161,33000,330,0,-2,4,2,2,0,0,0,0,0,0,2,1,1,0,0,0,0,0,0,2,1,1,0,0,0,0,0,0,0,0,0
194222,33000,330,0,-2,6,1,5,0,0,0,0,0,0,0,0,0,0,0,0,0,0,0,6,1,5,0,0,0,0,0,0,0,0,0
194310,33000,330,0,-2,17,7,10,0,0,0,2,0,2,5,4,1,2,1,1,0,0,0,8,2,6,0,0,0,0,0,0,0,0,0
194392,33000,330,0,-2,1,0,1,0,0,0,0,0,0,0,0,0,0,0,0,0,0,0,1,0,1,0,0,0,0,0,0,0,0,0
194578,33000,330,0,-2,12,5,7,0,0,0,3,0,3,0,0,0,3,2,1,0,0,0,4,2,2,0,0,0,2,1,1,0,0,0
194824,33000,330,0,-2,4,3,1,0,0,0,0,0,0,0,0,0,0,0,0,0,0,0,4,3,1,0,0,0,0,0,0,0,0,0
195003,33000,330,0,-2,31,9,22,0,0,0,0,0,0,7,1,6,3,1,2,0,0,0,19,6,13,2,1,1,0,0,0,0,0,0
195030,33000,330,0,-2,29,10,19,0,0,0,1,0,1,4,2,2,4,3,1,0,0,0,20,5,15,0,0,0,0,0,0,0,0,0
195049,33000,330,0,-2,2,1,1,0,0,0,0,0,0,0,0,0,0,0,0,0,0,0,1,1,0,0,0,0,0,0,0,1,0,1
195128,33000,330,0,-2,5,3,2,0,0,0,0,0,0,1,0,1,0,0,0,0,0,0,4,3,1,0,0,0,0,0,0,0,0,0
195164,33000,330,0,-2,15,6,9,0,0,0,1,0,1,2,1,1,1,0,1,0,0,0,11,5,6,0,0,0,0,0,0,0,0,0
195173,33000,330,0,-2,9,9,0,1,1,0,0,0,0,4,4,0,0,0,0,0,0,0,3,3,0,0,0,0,0,0,0,1,1,0
195216,33000,330,0,-2,4,2,2,0,0,0,0,0,0,1,0,1,0,0,0,0,0,0,3,2,1,0,0,0,0,0,0,0,0,0
195234,33000,330,0,-2,14,7,7,0,0,0,1,0,1,1,0,1,0,0,0,0,0,0,10,7,3,1,0,1,1,0,1,0,0,0
195243,33000,330,0,-2,4,3,1,0,0,0,0,0,0,0,0,0,0,0,0,0,0,0,4,3,1,0,0,0,0,0,0,0,0,0
195322,33000,330,0,-2,1,0,1,0,0,0,0,0,0,0,0,0,0,0,0,0,0,0,1,0,1,0,0,0,0,0,0,0,0,0
195474,33000,330,0,-2,18,4,14,0,0,0,0,0,0,5,2,3,0,0,0,0,0,0,12,2,10,0,0,0,0,0,0,1,0,1
195526,33000,330,0,-2,11,5,6,0,0,0,1,0,1,2,2,0,0,0,0,0,0,0,8,3,5,0,0,0,0,0,0,0,0,0
195544,33000,330,0,-2,3,2,1,0,0,0,0,0,0,1,1,0,0,0,0,0,0,0,2,1,1,0,0,0,0,0,0,0,0,0
195720,33000,330,0,-2,8,4,4,0,0,0,0,0,0,1,0,1,1,0,1,0,0,0,6,4,2,0,0,0,0,0,0,0,0,0
195784,33000,330,0,-2,5,2,3,0,0,0,0,0,0,1,1,0,0,0,0,0,0,0,4,1,3,0,0,0,0,0,0,0,0,0
195809,33000,330,0,-2,23,11,12,0,0,0,4,1,3,5,3,2,1,1,0,0,0,0,13,6,7,0,0,0,0,0,0,0,0,0
195827,33000,330,0,-2,5,1,4,0,0,0,0,0,0,1,0,1,1,0,1,0,0,0,3,1,2,0,0,0,0,0,0,0,0,0
195988,33000,330,0,-2,4,2,2,0,0,0,0,0,0,0,0,0,0,0,0,0,0,0,4,2,2,0,0,0,0,0,0,0,0,0
196006,33000,330,0,-2,3,1,2,0,0,0,0,0,0,0,0,0,0,0,0,0,0,0,3,1,2,0,0,0,0,0,0,0,0,0
196015,33000,330,0,-2,2,1,1,0,0,0,0,0,0,0,0,0,0,0,0,0,0,0,2,1,1,0,0,0,0,0,0,0,0,0
196024,33000,330,0,-2,5,3,2,0,0,0,0,0,0,0,0,0,0,0,0,0,0,0,5,3,2,0,0,0,0,0,0,0,0,0
196033,33000,330,0,-2,3,1,2,0,0,0,0,0,0,0,0,0,1,0,1,0,0,0,2,1,1,0,0,0,0,0,0,0,0,0
196042,33000,330,0,-2,1,0,1,0,0,0,0,0,0,1,0,1,0,0,0,0,0,0,0,0,0,0,0,0,0,0,0,0,0,0
196051,33000,330,0,-2,3,1,2,0,0,0,0,0,0,0,0,0,0,0,0,0,0,0,2,1,1,1,0,1,0,0,0,0,0,0
196060,33000,330,0,-2,12,10,2,0,0,0,1,1,0,5,5,0,1,1,0,0,0,0,5,3,2,0,0,0,0,0,0,0,0,0
196079,33000,330,0,-2,13,4,9,0,0,0,0,0,0,2,1,1,0,0,0,0,0,0,11,3,8,0,0,0,0,0,0,0,0,0
196088,33000,330,0,-2,27,17,10,0,0,0,0,0,0,10,7,3,0,0,0,0,0,0,17,10,7,0,0,0,0,0,0,0,0,0
196097,33000,330,0,-2,31,14,17,0,0,0,0,0,0,6,3,3,1,1,0,0,0,0,19,9,10,0,0,0,4,1,3,1,0,1
196103,33000,330,0,-2,4,1,3,0,0,0,1,0,1,1,1,0,0,0,0,0,0,0,2,0,2,0,0,0,0,0,0,0,0,0
196112,33000,330,0,-2,1,1,0,0,0,0,0,0,0,0,0,0,0,0,0,0,0,0,1,1,0,0,0,0,0,0,0,0,0,0
196121,33000,330,0,-2,9,5,4,0,0,0,0,0,0,3,1,2,0,0,0,0,0,0,6,4,2,0,0,0,0,0,0,0,0,0
196130,33000,330,0,-2,7,3,4,0,0,0,0,0,0,4,2,2,0,0,0,0,0,0,3,1,2,0,0,0,0,0,0,0,0,0
196149,33000,330,0,-2,2,0,2,0,0,0,0,0,0,0,0,0,0,0,0,0,0,0,2,0,2,0,0,0,0,0,0,0,0,0
196167,33000,330,0,-2,3,1,2,0,0,0,0,0,0,0,0,0,0,0,0,0,0,0,3,1,2,0,0,0,0,0,0,0,0,0
196176,33000,330,0,-2,5,1,4,0,0,0,0,0,0,1,0,1,1,1,0,0,0,0,2,0,2,1,0,1,0,0,0,0,0,0
196185,33000,330,0,-2,6,1,5,0,0,0,0,0,0,1,0,1,0,0,0,0,0,0,5,1,4,0,0,0,0,0,0,0,0,0
196194,33000,330,0,-2,5,2,3,0,0,0,0,0,0,1,1,0,1,0,1,0,0,0,3,1,2,0,0,0,0,0,0,0,0,0
196200,33000,330,0,-2,8,3,5,0,0,0,1,0,1,0,0,0,1,1,0,0,0,0,6,2,4,0,0,0,0,0,0,0,0,0
196219,33000,330,0,-2,3,2,1,0,0,0,0,0,0,0,0,0,1,1,0,0,0,0,2,1,1,0,0,0,0,0,0,0,0,0
196246,33000,330,0,-2,2,0,2,0,0,0,0,0,0,0,0,0,0,0,0,0,0,0,1,0,1,1,0,1,0,0,0,0,0,0
196291,33000,330,0,-2,6,3,3,0,0,0,0,0,0,1,0,1,1,1,0,0,0,0,4,2,2,0,0,0,0,0,0,0,0,0
196307,33000,330,0,-2,4,3,1,0,0,0,0,0,0,0,0,0,0,0,0,0,0,0,4,3,1,0,0,0,0,0,0,0,0,0
196413,33000,330,0,-2,47,16,31,0,0,0,1,0,1,12,8,4,0,0,0,0,0,0,29,6,23,1,0,1,2,0,2,2,2,0
196565,33000,330,0,-2,3,1,2,0,0,0,0,0,0,2,1,1,1,0,1,0,0,0,0,0,0,0,0,0,0,0,0,0,0,0
196680,33000,330,0,-2,5,2,3,0,0,0,0,0,0,0,0,0,0,0,0,0,0,0,5,2,3,0,0,0,0,0,0,0,0,0
196866,33000,330,0,-2,14,6,8,0,0,0,0,0,0,3,1,2,1,1,0,0,0,0,9,3,6,1,1,0,0,0,0,0,0,0
196884,33000,330,0,-2,5,2,3,0,0,0,0,0,0,4,2,2,0,0,0,0,0,0,1,0,1,0,0,0,0,0,0,0,0,0
197036,33000,330,0,-2,7,5,2,0,0,0,0,0,0,0,0,0,0,0,0,0,0,0,6,5,1,1,0,1,0,0,0,0,0,0
197045,33000,330,0,-2,15,7,8,0,0,0,2,2,0,1,0,1,1,0,1,0,0,0,11,5,6,0,0,0,0,0,0,0,0,0
197133,33000,330,0,-2,6,1,5,0,0,0,0,0,0,0,0,0,0,0,0,0,0,0,5,1,4,1,0,1,0,0,0,0,0,0
197197,33000,330,0,-2,17,9,8,0,0,0,0,0,0,3,2,1,0,0,0,0,0,0,14,7,7,0,0,0,0,0,0,0,0,0
197230,33000,330,0,-2,3,1,2,0,0,0,0,0,0,0,0,0,0,0,0,0,0,0,3,1,2,0,0,0,0,0,0,0,0,0
197285,33000,330,0,-2,2,0,2,0,0,0,0,0,0,0,0,0,2,0,2,0,0,0,0,0,0,0,0,0,0,0,0,0,0,0
197814,33000,330,0,-2,2,0,2,0,0,0,0,0,0,0,0,0,0,0,0,0,0,0,2,0,2,0,0,0,0,0,0,0,0,0
197850,33000,330,0,-2,6,0,6,0,0,0,0,0,0,3,0,3,0,0,0,0,0,0,3,0,3,0,0,0,0,0,0,0,0,0
197869,33000,330,0,-2,40,21,19,0,0,0,0,0,0,8,7,1,0,0,0,1,1,0,27,10,17,2,1,1,2,2,0,0,0,0
197887,33000,330,0,-2,3,0,3,0,0,0,0,0,0,0,0,0,1,0,1,0,0,0,2,0,2,0,0,0,0,0,0,0,0,0
197911,33000,330,0,-2,9,4,5,0,0,0,0,0,0,3,1,2,2,1,1,0,0,0,3,1,2,0,0,0,0,0,0,1,1,0
197966,33000,330,0,-2,3,1,2,0,0,0,0,0,0,1,0,1,0,0,0,0,0,0,2,1,1,0,0,0,0,0,0,0,0,0
197984,33000,330,0,-2,54,40,14,0,0,0,0,0,0,3,3,0,5,5,0,0,0,0,46,32,14,0,0,0,0,0,0,0,0,0
198011,33000,330,0,-2,1,0,1,0,0,0,0,0,0,1,0,1,0,0,0,0,0,0,0,0,0,0,0,0,0,0,0,0,0,0
198039,33000,330,0,-2,6,2,4,0,0,0,0,0,0,0,0,0,0,0,0,0,0,0,6,2,4,0,0,0,0,0,0,0,0,0
198066,33000,330,0,-2,7,5,2,0,0,0,0,0,0,2,2,0,1,1,0,0,0,0,4,2,2,0,0,0,0,0,0,0,0,0
198109,33000,330,0,-2,1,0,1,0,0,0,0,0,0,1,0,1,0,0,0,0,0,0,0,0,0,0,0,0,0,0,0,0,0,0
198118,33000,330,0,-2,3,2,1,0,0,0,0,0,0,0,0,0,0,0,0,0,0,0,3,2,1,0,0,0,0,0,0,0,0,0
198136,33000,330,0,-2,28,16,12,0,0,0,2,2,0,6,4,2,1,1,0,0,0,0,19,9,10,0,0,0,0,0,0,0,0,0
198154,33000,330,0,-2,7,2,5,0,0,0,0,0,0,1,1,0,0,0,0,0,0,0,6,1,5,0,0,0,0,0,0,0,0,0
198206,33000,330,0,-2,1,0,1,0,0,0,0,0,0,0,0,0,0,0,0,0,0,0,1,0,1,0,0,0,0,0,0,0,0,0
198215,33000,330,0,-2,16,9,7,0,0,0,0,0,0,4,4,0,0,0,0,0,0,0,12,5,7,0,0,0,0,0,0,0,0,0
198233,33000,330,0,-2,4,1,3,0,0,0,0,0,0,1,1,0,0,0,0,0,0,0,3,0,3,0,0,0,0,0,0,0,0,0
198251,33000,330,0,-2,14,5,9,0,0,0,0,0,0,6,2,4,0,0,0,0,0,0,7,2,5,0,0,0,1,1,0,0,0,0
198260,33000,330,0,-2,8,3,5,0,0,0,0,0,0,3,1,2,1,0,1,0,0,0,4,2,2,0,0,0,0,0,0,0,0,0
198303,33000,330,0,-2,13,10,3,1,0,1,0,0,0,4,2,2,0,0,0,0,0,0,7,7,0,0,0,0,1,1,0,0,0,0
198321,33000,330,0,-2,3,0,3,0,0,0,0,0,0,1,0,1,0,0,0,0,0,0,2,0,2,0,0,0,0,0,0,0,0,0
198330,33000,330,0,-2,4,0,4,0,0,0,0,0,0,0,0,0,2,0,2,0,0,0,2,0,2,0,0,0,0,0,0,0,0,0
198367,33000,330,0,-2,5,1,4,0,0,0,0,0,0,1,0,1,0,0,0,0,0,0,4,1,3,0,0,0,0,0,0,0,0,0
198376,33000,330,0,-2,1,0,1,0,0,0,0,0,0,1,0,1,0,0,0,0,0,0,0,0,0,0,0,0,0,0,0,0,0,0
198385,33000,330,0,-2,27,19,8,0,0,0,0,0,0,7,6,1,2,2,0,0,0,0,15,10,5,3,1,2,0,0,0,0,0,0
198419,33000,330,0,-2,35,13,22,0,0,0,1,0,1,8,2,6,1,1,0,0,0,0,24,10,14,1,0,1,0,0,0,0,0,0
198455,33000,330,0,-2,1,0,1,0,0,0,0,0,0,1,0,1,0,0,0,0,0,0,0,0,0,0,0,0,0,0,0,0,0,0
198464,33000,330,0,-2,51,28,23,0,0,0,0,0,0,4,3,1,17,12,5,0,0,0,24,10,14,2,1,1,4,2,2,0,0,0
198507,33000,330,0,-2,9,6,3,0,0,0,0,0,0,8,6,2,0,0,0,0,0,0,0,0,0,0,0,0,1,0,1,0,0,0
198516,33000,330,0,-2,34,17,17,0,0,0,0,0,0,9,6,3,0,0,0,0,0,0,21,10,11,1,1,0,3,0,3,0,0,0
198534,33000,330,0,-2,5,1,4,0,0,0,0,0,0,2,1,1,0,0,0,0,0,0,3,0,3,0,0,0,0,0,0,0,0,0
198543,33000,330,0,-2,11,5,6,1,1,0,0,0,0,6,3,3,0,0,0,0,0,0,3,0,3,0,0,0,1,1,0,0,0,0
198552,33000,330,0,-2,8,4,4,0,0,0,0,0,0,4,2,2,1,0,1,1,1,0,2,1,1,0,0,0,0,0,0,0,0,0
198561,33000,330,0,-2,31,17,14,0,0,0,0,0,0,3,1,2,0,0,0,0,0,0,25,14,11,3,2,1,0,0,0,0,0,0
198598,33000,330,0,-2,7,5,2,0,0,0,0,0,0,2,2,0,0,0,0,0,0,0,5,3,2,0,0,0,0,0,0,0,0,0
198613,33000,330,0,-2,14,9,5,1,0,1,0,0,0,2,2,0,0,0,0,0,0,0,11,7,4,0,0,0,0,0,0,0,0,0
198622,33000,330,0,-2,8,1,7,0,0,0,0,0,0,5,1,4,0,0,0,0,0,0,3,0,3,0,0,0,0,0,0,0,0,0
198640,33000,330,0,-2,2,0,2,0,0,0,0,0,0,1,0,1,0,0,0,0,0,0,1,0,1,0,0,0,0,0,0,0,0,0
198695,33000,330,0,-2,44,17,27,0,0,0,0,0,0,7,2,5,1,0,1,0,0,0,35,15,20,1,0,1,0,0,0,0,0,0
198729,33000,330,0,-2,4,2,2,0,0,0,0,0,0,2,1,1,0,0,0,0,0,0,2,1,1,0,0,0,0,0,0,0,0,0
198774,33000,330,0,-2,4,1,3,0,0,0,0,0,0,3,1,2,0,0,0,0,0,0,1,0,1,0,0,0,0,0,0,0,0,0
198808,33000,330,0,-2,8,6,2,0,0,0,0,0,0,1,1,0,0,0,0,1,1,0,6,4,2,0,0,0,0,0,0,0,0,0
198817,33000,330,0,-2,1,1,0,0,0,0,0,0,0,1,1,0,0,0,0,0,0,0,0,0,0,0,0,0,0,0,0,0,0,0
198835,33000,330,0,-2,9,5,4,0,0,0,0,0,0,1,1,0,0,0,0,0,0,0,8,4,4,0,0,0,0,0,0,0,0,0
198862,33000,330,0,-2,5,5,0,0,0,0,0,0,0,4,4,0,0,0,0,0,0,0,1,1,0,0,0,0,0,0,0,0,0,0
198871,33000,330,0,-2,10,9,1,0,0,0,1,1,0,3,3,0,0,0,0,0,0,0,6,5,1,0,0,0,0,0,0,0,0,0
198899,33000,330,0,-2,10,7,3,0,0,0,0,0,0,1,0,1,2,1,1,0,0,0,7,6,1,0,0,0,0,0,0,0,0,0
198905,33000,330,0,-2,3,2,1,0,0,0,0,0,0,0,0,0,0,0,0,0,0,0,3,2,1,0,0,0,0,0,0,0,0,0
198923,33000,330,0,-2,1,0,1,0,0,0,0,0,0,0,0,0,0,0,0,0,0,0,1,0,1,0,0,0,0,0,0,0,0,0
198950,33000,330,0,-2,11,2,9,0,0,0,0,0,0,2,0,2,0,0,0,1,1,0,8,1,7,0,0,0,0,0,0,0,0,0
198969,33000,330,0,-2,6,5,1,0,0,0,0,0,0,2,2,0,0,0,0,0,0,0,4,3,1,0,0,0,0,0,0,0,0,0
199032,33000,330,0,-2,7,5,2,0,0,0,0,0,0,1,0,1,0,0,0,0,0,0,6,5,1,0,0,0,0,0,0,0,0,0
199069,33000,330,0,-2,5,3,2,0,0,0,0,0,0,1,1,0,0,0,0,0,0,0,3,2,1,1,0,1,0,0,0,0,0,0
199087,33000,330,0,-2,2,0,2,0,0,0,0,0,0,1,0,1,0,0,0,0,0,0,1,0,1,0,0,0,0,0,0,0,0,0
199102,33000,330,0,-2,13,6,7,0,0,0,0,0,0,4,2,2,1,0,1,0,0,0,1,0,1,0,0,0,7,4,3,0,0,0
199111,33000,330,0,-2,14,7,7,0,0,0,0,0,0,2,0,2,0,0,0,0,0,0,11,7,4,1,0,1,0,0,0,0,0,0
199120,33000,330,0,-2,61,25,36,0,0,0,0,0,0,11,4,7,1,0,1,0,0,0,28,15,13,3,1,2,18,5,13,0,0,0
199139,33000,330,0,-2,44,23,21,0,0,0,1,0,1,9,3,6,2,1,1,0,0,0,30,18,12,0,0,0,0,0,0,2,1,1
199148,33000,330,0,-2,21,10,11,0,0,0,0,0,0,5,2,3,1,0,1,0,0,0,13,7,6,1,0,1,1,1,0,0,0,0
199157,33000,330,0,-2,15,10,5,0,0,0,0,0,0,6,4,2,0,0,0,0,0,0,0,0,0,0,0,0,9,6,3,0,0,0
199175,33000,330,0,-2,10,4,6,0,0,0,0,0,0,0,0,0,0,0,0,0,0,0,8,4,4,0,0,0,2,0,2,0,0,0
199184,33000,330,0,-2,3,2,1,0,0,0,0,0,0,0,0,0,0,0,0,0,0,0,2,2,0,0,0,0,1,0,1,0,0,0
199193,33000,330,0,-2,79,31,48,1,0,1,2,1,1,16,6,10,2,1,1,1,1,0,53,20,33,4,2,2,0,0,0,0,0,0
199209,33000,330,0,-2,9,6,3,0,0,0,0,0,0,3,2,1,0,0,0,0,0,0,6,4,2,0,0,0,0,0,0,0,0,0
199218,33000,330,0,-2,24,7,17,0,0,0,0,0,0,4,1,3,0,0,0,0,0,0,14,5,9,2,0,2,4,1,3,0,0,0
199272,33000,330,0,-2,7,5,2,0,0,0,0,0,0,1,1,0,1,1,0,0,0,0,4,2,2,0,0,0,1,1,0,0,0,0
199281,33000,330,0,-2,14,8,6,2,1,1,0,0,0,3,2,1,0,0,0,0,0,0,9,5,4,0,0,0,0,0,0,0,0,0
199306,33000,330,0,-2,11,7,4,0,0,0,0,0,0,3,2,1,0,0,0,0,0,0,7,5,2,1,0,1,0,0,0,0,0,0
199324,33000,330,0,-2,2,1,1,0,0,0,0,0,0,0,0,0,0,0,0,0,0,0,2,1,1,0,0,0,0,0,0,0,0,0
199333,33000,330,0,-2,4,1,3,0,0,0,0,0,0,2,0,2,0,0,0,0,0,0,2,1,1,0,0,0,0,0,0,0,0,0
199412,33000,330,0,-2,13,8,5,1,1,0,0,0,0,4,3,1,0,0,0,0,0,0,8,4,4,0,0,0,0,0,0,0,0,0
199421,33000,330,0,-2,3,0,3,0,0,0,0,0,0,0,0,0,0,0,0,0,0,0,1,0,1,0,0,0,2,0,2,0,0,0
199467,33000,330,0,-2,1,0,1,0,0,0,0,0,0,1,0,1,0,0,0,0,0,0,0,0,0,0,0,0,0,0,0,0,0,0
199476,33000,330,0,-2,8,1,7,3,0,3,0,0,0,0,0,0,1,0,1,0,0,0,4,1,3,0,0,0,0,0,0,0,0,0
199485,33000,330,0,-2,1,0,1,0,0,0,0,0,0,0,0,0,1,0,1,0,0,0,0,0,0,0,0,0,0,0,0,0,0,0
199494,33000,330,0,-2,8,0,8,0,0,0,0,0,0,3,0,3,0,0,0,1,0,1,4,0,4,0,0,0,0,0,0,0,0,0
199582,33000,330,0,-2,12,8,4,0,0,0,0,0,0,0,0,0,0,0,0,0,0,0,0,0,0,0,0,0,12,8,4,0,0,0
199607,33000,330,0,-2,3,2,1,0,0,0,0,0,0,0,0,0,1,1,0,0,0,0,2,1,1,0,0,0,0,0,0,0,0,0
199634,33000,330,0,-2,2,0,2,0,0,0,0,0,0,2,0,2,0,0,0,0,0,0,0,0,0,0,0,0,0,0,0,0,0,0
199643,33000,330,0,-2,4,2,2,0,0,0,0,0,0,3,2,1,0,0,0,0,0,0,0,0,0,1,0,1,0,0,0,0,0,0
199698,33000,330,0,-2,6,3,3,0,0,0,0,0,0,2,0,2,4,3,1,0,0,0,0,0,0,0,0,0,0,0,0,0,0,0
199722,33000,330,0,-2,5,1,4,0,0,0,0,0,0,3,1,2,0,0,0,0,0,0,2,0,2,0,0,0,0,0,0,0,0,0
199731,33000,330,0,-2,4,0,4,0,0,0,0,0,0,0,0,0,0,0,0,0,0,0,4,0,4,0,0,0,0,0,0,0,0,0
199740,33000,330,0,-2,1,0,1,0,0,0,0,0,0,0,0,0,0,0,0,0,0,0,1,0,1,0,0,0,0,0,0,0,0,0
199759,33000,330,0,-2,2,1,1,0,0,0,0,0,0,0,0,0,0,0,0,0,0,0,2,1,1,0,0,0,0,0,0,0,0,0
199768,33000,330,0,-2,1,0,1,0,0,0,0,0,0,0,0,0,0,0,0,0,0,0,1,0,1,0,0,0,0,0,0,0,0,0
199786,33000,330,0,-2,2,1,1,0,0,0,0,0,0,2,1,1,0,0,0,0,0,0,0,0,0,0,0,0,0,0,0,0,0,0
199838,33000,330,0,-2,2,0,2,0,0,0,0,0,0,0,0,0,0,0,0,0,0,0,2,0,2,0,0,0,0,0,0,0,0,0
199847,33000,330,0,-2,27,16,11,0,0,0,0,0,0,1,1,0,3,1,2,0,0,0,17,13,4,1,0,1,2,1,1,3,0,3
199856,33000,330,0,-2,14,5,9,0,0,0,1,1,0,2,0,2,0,0,0,0,0,0,8,3,5,0,0,0,3,1,2,0,0,0
199865,33000,330,0,-2,8,1,7,0,0,0,0,0,0,0,0,0,0,0,0,0,0,0,4,1,3,0,0,0,4,0,4,0,0,0
199892,33000,330,0,-2,2,0,2,0,0,0,0,0,0,1,0,1,0,0,0,0,0,0,1,0,1,0,0,0,0,0,0,0,0,0
199908,33000,330,0,-2,3,1,2,0,0,0,0,0,0,0,0,0,0,0,0,0,0,0,3,1,2,0,0,0,0,0,0,0,0,0
199926,33000,330,0,-2,2,0,2,0,0,0,0,0,0,0,0,0,0,0,0,0,0,0,2,0,2,0,0,0,0,0,0,0,0,0
199962,33000,330,0,-2,10,6,4,0,0,0,0,0,0,0,0,0,1,0,1,0,0,0,9,6,3,0,0,0,0,0,0,0,0,0
199999,33000,330,0,-2,8,4,4,0,0,0,0,0,0,8,4,4,0,0,0,0,0,0,0,0,0,0,0,0,0,0,0,0,0,0
200004,33000,330,0,-2,37,26,11,0,0,0,0,0,0,14,11,3,1,0,1,0,0,0,22,15,7,0,0,0,0,0,0,0,0,0
200022,33000,330,0,-2,3,2,1,0,0,0,0,0,0,0,0,0,0,0,0,0,0,0,3,2,1,0,0,0,0,0,0,0,0,0
200059,33000,330,0,-2,3,1,2,0,0,0,0,0,0,0,0,0,0,0,0,0,0,0,3,1,2,0,0,0,0,0,0,0,0,0
200156,33000,330,0,-2,7,5,2,0,0,0,0,0,0,0,0,0,0,0,0,0,0,0,7,5,2,0,0,0,0,0,0,0,0,0
200192,33000,330,0,-2,1,0,1,0,0,0,0,0,0,0,0,0,0,0,0,0,0,0,1,0,1,0,0,0,0,0,0,0,0,0
200217,33000,330,0,-2,6,3,3,0,0,0,0,0,0,0,0,0,0,0,0,0,0,0,5,3,2,0,0,0,1,0,1,0,0,0
200226,33000,330,0,-2,2,2,0,0,0,0,0,0,0,0,0,0,0,0,0,0,0,0,0,0,0,1,1,0,1,1,0,0,0,0
200253,33000,330,0,-2,13,8,5,0,0,0,0,0,0,1,1,0,1,1,0,0,0,0,10,6,4,0,0,0,1,0,1,0,0,0
200280,33000,330,0,-2,41,14,27,3,1,2,0,0,0,2,1,1,0,0,0,0,0,0,31,12,19,3,0,3,2,0,2,0,0,0
200305,33000,330,0,-2,1,0,1,0,0,0,0,0,0,0,0,0,0,0,0,0,0,0,1,0,1,0,0,0,0,0,0,0,0,0
200332,33000,330,0,-2,15,6,9,0,0,0,0,0,0,1,0,1,1,0,1,0,0,0,11,5,6,0,0,0,2,1,1,0,0,0
200341,33000,330,0,-2,1,0,1,0,0,0,0,0,0,0,0,0,0,0,0,0,0,0,1,0,1,0,0,0,0,0,0,0,0,0
200572,33000,330,0,-2,2,2,0,0,0,0,0,0,0,0,0,0,0,0,0,0,0,0,2,2,0,0,0,0,0,0,0,0,0,0
200800,33000,330,0,-2,30,14,16,0,0,0,1,1,0,6,3,3,0,0,0,0,0,0,23,10,13,0,0,0,0,0,0,0,0,0
201061,33000,330,0,-2,1,0,1,0,0,0,0,0,0,0,0,0,0,0,0,0,0,0,1,0,1,0,0,0,0,0,0,0,0,0
201104,33000,330,0,-2,14,9,5,0,0,0,0,0,0,1,1,0,0,0,0,0,0,0,13,8,5,0,0,0,0,0,0,0,0,0
201195,33000,330,0,-2,6,4,2,0,0,0,0,0,0,0,0,0,0,0,0,0,0,0,6,4,2,0,0,0,0,0,0,0,0,0
201371,33000,330,0,-2,5,2,3,0,0,0,0,0,0,0,0,0,0,0,0,0,0,0,5,2,3,0,0,0,0,0,0,0,0,0
201441,33000,330,0,-2,25,10,15,0,0,0,0,0,0,2,1,1,3,2,1,0,0,0,19,6,13,1,1,0,0,0,0,0,0,0
201469,33000,330,0,-2,8,2,6,0,0,0,0,0,0,2,0,2,0,0,0,0,0,0,6,2,4,0,0,0,0,0,0,0,0,0
201548,33000,330,0,-2,10,5,5,0,0,0,1,1,0,1,1,0,1,0,1,0,0,0,7,3,4,0,0,0,0,0,0,0,0,0
201645,33000,330,0,-2,14,4,10,0,0,0,1,0,1,2,1,1,2,1,1,0,0,0,8,2,6,0,0,0,1,0,1,0,0,0
201654,33000,330,0,-2,11,4,7,0,0,0,0,0,0,0,0,0,0,0,0,0,0,0,11,4,7,0,0,0,0,0,0,0,0,0
201672,33000,330,0,-2,3,1,2,0,0,0,0,0,0,0,0,0,0,0,0,0,0,0,3,1,2,0,0,0,0,0,0,0,0,0
201690,33000,330,0,-2,12,7,5,0,0,0,0,0,0,10,6,4,0,0,0,0,0,0,1,0,1,0,0,0,1,1,0,0,0,0
201821,33000,330,0,-2,3,0,3,0,0,0,0,0,0,0,0,0,0,0,0,0,0,0,3,0,3,0,0,0,0,0,0,0,0,0
201885,33000,330,0,-2,104,44,60,0,0,0,2,1,1,22,7,15,5,2,3,0,0,0,72,33,39,3,1,2,0,0,0,0,0,0
201946,33000,330,0,-2,5,4,1,0,0,0,0,0,0,0,0,0,0,0,0,0,0,0,4,4,0,0,0,0,1,0,1,0,0,0
201955,33000,330,0,-2,5,1,4,0,0,0,0,0,0,2,0,2,0,0,0,0,0,0,2,1,1,1,0,1,0,0,0,0,0,0
201964,33000,330,0,-2,1,1,0,0,0,0,0,0,0,0,0,0,0,0,0,0,0,0,1,1,0,0,0,0,0,0,0,0,0,0
202046,33000,330,0,-2,1,0,1,0,0,0,0,0,0,0,0,0,0,0,0,0,0,0,1,0,1,0,0,0,0,0,0,0,0,0
202073,33000,330,0,-2,1,0,1,0,0,0,0,0,0,0,0,0,0,0,0,0,0,0,1,0,1,0,0,0,0,0,0,0,0,0
202134,33000,330,0,-2,11,9,2,0,0,0,0,0,0,2,2,0,1,1,0,0,0,0,6,5,1,1,0,1,1,1,0,0,0,0
202170,33000,330,0,-2,4,0,4,0,0,0,0,0,0,0,0,0,0,0,0,0,0,0,4,0,4,0,0,0,0,0,0,0,0,0
202222,33000,330,0,-2,4,0,4,0,0,0,0,0,0,2,0,2,0,0,0,0,0,0,2,0,2,0,0,0,0,0,0,0,0,0
202356,33000,330,0,-2,1,1,0,0,0,0,0,0,0,0,0,0,0,0,0,0,0,0,1,1,0,0,0,0,0,0,0,0,0,0
202480,33000,330,0,-2,33,13,20,0,0,0,0,0,0,3,1,2,1,1,0,0,0,0,26,10,16,2,1,1,1,0,1,0,0,0
202514,33000,330,0,-2,9,6,3,0,0,0,0,0,0,2,2,0,0,0,0,0,0,0,6,3,3,0,0,0,1,1,0,0,0,0
202523,33000,330,0,-2,13,8,5,0,0,0,0,0,0,2,1,1,0,0,0,0,0,0,11,7,4,0,0,0,0,0,0,0,0,0
202763,33000,330,0,-2,11,8,3,0,0,0,0,0,0,0,0,0,1,1,0,0,0,0,10,7,3,0,0,0,0,0,0,0,0,0
202806,33000,330,0,-2,5,1,4,0,0,0,0,0,0,1,1,0,0,0,0,0,0,0,3,0,3,1,0,1,0,0,0,0,0,0
202903,33000,330,0,-2,1,1,0,0,0,0,0,0,0,0,0,0,0,0,0,0,0,0,1,1,0,0,0,0,0,0,0,0,0,0
203085,33000,330,0,-2,4,3,1,0,0,0,0,0,0,0,0,0,0,0,0,0,0,0,4,3,1,0,0,0,0,0,0,0,0,0
203128,33000,330,0,-2,8,3,5,0,0,0,0,0,0,0,0,0,0,0,0,0,0,0,7,2,5,1,1,0,0,0,0,0,0,0
203155,33000,330,0,-2,1,1,0,0,0,0,0,0,0,0,0,0,0,0,0,0,0,0,1,1,0,0,0,0,0,0,0,0,0,0
203368,33000,330,0,-2,20,10,10,0,0,0,1,0,1,3,0,3,1,1,0,0,0,0,14,9,5,1,0,1,0,0,0,0,0,0
203517,33000,330,0,-2,20,14,6,0,0,0,0,0,0,4,4,0,1,1,0,0,0,0,12,6,6,0,0,0,1,1,0,2,2,0
203535,33000,330,0,-2,9,3,6,0,0,0,0,0,0,0,0,0,0,0,0,0,0,0,1,0,1,0,0,0,8,3,5,0,0,0
203544,33000,330,0,-2,2,1,1,0,0,0,0,0,0,1,0,1,1,1,0,0,0,0,0,0,0,0,0,0,0,0,0,0,0,0
203580,33000,330,0,-2,11,9,2,0,0,0,0,0,0,2,2,0,0,0,0,0,0,0,9,7,2,0,0,0,0,0,0,0,0,0
203599,33000,330,0,-2,1,0,1,0,0,0,0,0,0,1,0,1,0,0,0,0,0,0,0,0,0,0,0,0,0,0,0,0,0,0
203678,33000,330,0,-2,6,1,5,0,0,0,0,0,0,0,0,0,0,0,0,0,0,0,6,1,5,0,0,0,0,0,0,0,0,0
203757,33000,330,0,-2,10,2,8,0,0,0,0,0,0,1,0,1,0,0,0,0,0,0,9,2,7,0,0,0,0,0,0,0,0,0
203775,33000,330,0,-2,7,1,6,0,0,0,0,0,0,0,0,0,0,0,0,0,0,0,7,1,6,0,0,0,0,0,0,0,0,0
203845,33000,330,0,-2,7,3,4,0,0,0,0,0,0,1,0,1,0,0,0,0,0,0,6,3,3,0,0,0,0,0,0,0,0,0
204015,33000,330,0,-2,1,0,1,0,0,0,0,0,0,0,0,0,0,0,0,0,0,0,1,0,1,0,0,0,0,0,0,0,0,0
204024,33000,330,0,-2,24,16,8,0,0,0,0,0,0,3,2,1,2,2,0,0,0,0,19,12,7,0,0,0,0,0,0,0,0,0
204185,33000,330,0,-2,2,1,1,0,0,0,0,0,0,1,0,1,0,0,0,0,0,0,1,1,0,0,0,0,0,0,0,0,0,0
204194,33000,330,0,-2,6,4,2,0,0,0,0,0,0,0,0,0,0,0,0,0,0,0,6,4,2,0,0,0,0,0,0,0,0,0
204200,33000,330,0,-2,8,6,2,0,0,0,0,0,0,1,1,0,0,0,0,0,0,0,7,5,2,0,0,0,0,0,0,0,0,0
204255,33000,330,0,-2,3,1,2,0,0,0,0,0,0,0,0,0,0,0,0,0,0,0,3,1,2,0,0,0,0,0,0,0,0,0
204264,33000,330,0,-2,5,3,2,0,0,0,0,0,0,1,1,0,0,0,0,0,0,0,4,2,2,0,0,0,0,0,0,0,0,0
204422,33000,330,0,-2,2,1,1,0,0,0,0,0,0,0,0,0,0,0,0,0,0,0,1,0,1,0,0,0,1,1,0,0,0,0
204440,33000,330,0,-2,3,0,3,0,0,0,0,0,0,0,0,0,0,0,0,0,0,0,3,0,3,0,0,0,0,0,0,0,0,0
204468,33000,330,0,-2,4,3,1,0,0,0,0,0,0,0,0,0,0,0,0,0,0,0,3,2,1,1,1,0,0,0,0,0,0,0
204486,33000,330,0,-2,5,4,1,0,0,0,0,0,0,1,1,0,0,0,0,0,0,0,4,3,1,0,0,0,0,0,0,0,0,0
204501,33000,330,0,-2,24,11,13,0,0,0,0,0,0,3,0,3,0,0,0,0,0,0,17,11,6,0,0,0,2,0,2,2,0,2
204617,33000,330,0,-2,5,3,2,0,0,0,0,0,0,0,0,0,0,0,0,0,0,0,4,3,1,1,0,1,0,0,0,0,0,0
204635,33000,330,0,-2,8,3,5,0,0,0,0,0,0,0,0,0,0,0,0,0,0,0,8,3,5,0,0,0,0,0,0,0,0,0
204671,33000,330,0,-2,3,1,2,0,0,0,0,0,0,1,0,1,0,0,0,0,0,0,2,1,1,0,0,0,0,0,0,0,0,0
204680,33000,330,0,-2,1,0,1,0,0,0,0,0,0,0,0,0,0,0,0,0,0,0,1,0,1,0,0,0,0,0,0,0,0,0
204705,33000,330,0,-2,1,0,1,0,0,0,0,0,0,0,0,0,0,0,0,0,0,0,1,0,1,0,0,0,0,0,0,0,0,0
204796,33000,330,0,-2,108,30,78,0,0,0,4,2,2,14,9,5,4,3,1,0,0,0,80,15,65,4,1,3,2,0,2,0,0,0
204839,33000,330,0,-2,1,1,0,0,0,0,0,0,0,0,0,0,0,0,0,0,0,0,1,1,0,0,0,0,0,0,0,0,0,0
204857,33000,330,0,-2,34,12,22,0,0,0,1,0,1,4,0,4,1,0,1,0,0,0,24,9,15,0,0,0,3,2,1,1,1,0
204909,33000,330,0,-2,18,9,9,0,0,0,0,0,0,3,0,3,0,0,0,0,0,0,13,8,5,2,1,1,0,0,0,0,0,0
204936,33000,330,0,-2,8,5,3,0,0,0,0,0,0,0,0,0,0,0,0,0,0,0,5,4,1,1,1,0,2,0,2,0,0,0
204945,33000,330,0,-2,9,4,5,0,0,0,0,0,0,0,0,0,1,0,1,0,0,0,7,4,3,1,0,1,0,0,0,0,0,0
204990,33000,330,0,-2,4,1,3,0,0,0,0,0,0,4,1,3,0,0,0,0,0,0,0,0,0,0,0,0,0,0,0,0,0,0
205054,33000,330,0,-2,1,0,1,0,0,0,0,0,0,0,0,0,0,0,0,0,0,0,1,0,1,0,0,0,0,0,0,0,0,0
205179,33000,330,0,-2,4,1,3,0,0,0,0,0,0,0,0,0,1,0,1,0,0,0,2,1,1,1,0,1,0,0,0,0,0,0
205203,33000,330,0,-2,5,3,2,0,0,0,0,0,0,1,0,1,0,0,0,0,0,0,4,3,1,0,0,0,0,0,0,0,0,0
205391,33000,330,0,-2,1,1,0,0,0,0,0,0,0,0,0,0,0,0,0,0,0,0,1,1,0,0,0,0,0,0,0,0,0,0
205443,33000,330,0,-2,5,5,0,0,0,0,0,0,0,1,1,0,0,0,0,0,0,0,4,4,0,0,0,0,0,0,0,0,0,0
205470,33000,330,0,-2,6,3,3,0,0,0,0,0,0,3,0,3,0,0,0,0,0,0,3,3,0,0,0,0,0,0,0,0,0,0
205957,33000,330,0,-2,10,4,6,0,0,0,0,0,0,0,0,0,1,0,1,0,0,0,9,4,5,0,0,0,0,0,0,0,0,0
205966,33000,330,0,-2,1,1,0,0,0,0,0,0,0,0,0,0,0,0,0,0,0,0,1,1,0,0,0,0,0,0,0,0,0,0
206011,33000,330,0,-2,3,2,1,0,0,0,0,0,0,0,0,0,0,0,0,0,0,0,3,2,1,0,0,0,0,0,0,0,0,0
206048,33000,330,0,-2,21,10,11,0,0,0,0,0,0,1,1,0,3,1,2,0,0,0,16,8,8,1,0,1,0,0,0,0,0,0
206084,33000,330,0,-2,28,12,16,0,0,0,0,0,0,7,2,5,2,1,1,0,0,0,18,9,9,1,0,1,0,0,0,0,0,0
206279,33000,330,0,-2,3,0,3,0,0,0,1,0,1,0,0,0,1,0,1,0,0,0,1,0,1,0,0,0,0,0,0,0,0,0
206349,33000,330,0,-2,2,1,1,0,0,0,0,0,0,0,0,0,0,0,0,0,0,0,2,1,1,0,0,0,0,0,0,0,0,0
206437,33000,330,0,-2,7,3,4,0,0,0,0,0,0,1,1,0,0,0,0,0,0,0,6,2,4,0,0,0,0,0,0,0,0,0
206446,33000,330,0,-2,2,0,2,0,0,0,0,0,0,0,0,0,0,0,0,0,0,0,2,0,2,0,0,0,0,0,0,0,0,0
206491,33000,330,0,-2,3,2,1,0,0,0,0,0,0,3,2,1,0,0,0,0,0,0,0,0,0,0,0,0,0,0,0,0,0,0
206507,33000,330,0,-2,5,2,3,0,0,0,0,0,0,1,0,1,0,0,0,0,0,0,3,2,1,1,0,1,0,0,0,0,0,0
206525,33000,330,0,-2,19,6,13,0,0,0,0,0,0,3,2,1,0,0,0,0,0,0,16,4,12,0,0,0,0,0,0,0,0,0
206589,33000,330,0,-2,8,3,5,1,0,1,1,0,1,0,0,0,1,1,0,0,0,0,5,2,3,0,0,0,0,0,0,0,0,0
206604,33000,330,0,-2,21,15,6,0,0,0,0,0,0,2,2,0,0,0,0,0,0,0,18,12,6,1,1,0,0,0,0,0,0,0
206622,33000,330,0,-2,29,16,13,0,0,0,1,1,0,4,2,2,1,0,1,0,0,0,22,12,10,0,0,0,1,1,0,0,0,0
206695,33000,330,0,-2,23,11,12,0,0,0,0,0,0,0,0,0,2,1,1,0,0,0,19,9,10,1,0,1,1,1,0,0,0,0
206835,33000,330,0,-2,3,3,0,0,0,0,0,0,0,0,0,0,0,0,0,0,0,0,2,2,0,0,0,0,1,1,0,0,0,0
206862,33000,330,0,-2,8,3,5,1,0,1,0,0,0,1,0,1,1,0,1,0,0,0,5,3,2,0,0,0,0,0,0,0,0,0
206914,33000,330,0,-2,5,1,4,0,0,0,0,0,0,1,0,1,0,0,0,0,0,0,4,1,3,0,0,0,0,0,0,0,0,0
206941,33000,330,0,-2,28,15,13,0,0,0,1,1,0,2,2,0,0,0,0,0,0,0,13,6,7,0,0,0,12,6,6,0,0,0
206996,33000,330,0,-2,4,0,4,2,0,2,0,0,0,0,0,0,0,0,0,0,0,0,1,0,1,1,0,1,0,0,0,0,0,0
207041,33000,330,0,-2,1,1,0,0,0,0,0,0,0,0,0,0,0,0,0,0,0,0,0,0,0,0,0,0,1,1,0,0,0,0
207050,33000,330,0,-2,5,3,2,1,0,1,0,0,0,0,0,0,1,1,0,0,0,0,3,2,1,0,0,0,0,0,0,0,0,0
207069,33000,330,0,-2,4,1,3,0,0,0,0,0,0,1,1,0,1,0,1,0,0,0,2,0,2,0,0,0,0,0,0,0,0,0
207209,33000,330,0,-2,6,3,3,0,0,0,0,0,0,5,3,2,1,0,1,0,0,0,0,0,0,0,0,0,0,0,0,0,0,0
207254,33000,330,0,-2,1,1,0,0,0,0,0,0,0,0,0,0,0,0,0,0,0,0,1,1,0,0,0,0,0,0,0,0,0,0
207263,33000,330,0,-2,21,11,10,2,1,1,0,0,0,2,2,0,1,1,0,0,0,0,14,6,8,2,1,1,0,0,0,0,0,0
207281,33000,330,0,-2,2,0,2,0,0,0,0,0,0,0,0,0,0,0,0,0,0,0,2,0,2,0,0,0,0,0,0,0,0,0
207290,33000,330,0,-2,11,6,5,1,1,0,0,0,0,2,2,0,0,0,0,0,0,0,7,3,4,1,0,1,0,0,0,0,0,0
207306,33000,330,0,-2,3,1,2,1,0,1,0,0,0,0,0,0,0,0,0,0,0,0,1,0,1,0,0,0,1,1,0,0,0,0
207315,33000,330,0,-2,1,1,0,0,0,0,0,0,0,0,0,0,0,0,0,0,0,0,1,1,0,0,0,0,0,0,0,0,0,0
207324,33000,330,0,-2,8,5,3,0,0,0,0,0,0,3,1,2,0,0,0,0,0,0,5,4,1,0,0,0,0,0,0,0,0,0
207342,33000,330,0,-2,5,0,5,0,0,0,0,0,0,0,0,0,0,0,0,0,0,0,4,0,4,1,0,1,0,0,0,0,0,0
207351,33000,330,0,-2,5,3,2,0,0,0,0,0,0,1,1,0,0,0,0,0,0,0,3,2,1,0,0,0,1,0,1,0,0,0
207388,33000,330,0,-2,22,18,4,0,0,0,0,0,0,4,4,0,2,0,2,0,0,0,14,12,2,2,2,0,0,0,0,0,0,0
207403,33000,330,0,-2,4,4,0,0,0,0,0,0,0,1,1,0,0,0,0,0,0,0,3,3,0,0,0,0,0,0,0,0,0,0
207449,33000,330,0,-2,5,1,4,0,0,0,0,0,0,2,1,1,1,0,1,0,0,0,2,0,2,0,0,0,0,0,0,0,0,0
207458,33000,330,0,-2,14,10,4,1,1,0,0,0,0,2,1,1,0,0,0,0,0,0,11,8,3,0,0,0,0,0,0,0,0,0
207500,33000,330,0,-2,62,29,33,1,0,1,0,0,0,8,5,3,5,2,3,0,0,0,42,21,21,4,1,3,1,0,1,1,0,1
207582,33000,330,0,-2,29,14,15,0,0,0,1,0,1,2,2,0,4,2,2,0,0,0,22,10,12,0,0,0,0,0,0,0,0,0
207661,33000,330,0,-2,15,3,12,2,0,2,0,0,0,1,0,1,0,0,0,0,0,0,12,3,9,0,0,0,0,0,0,0,0,0
207670,33000,330,0,-2,1,0,1,0,0,0,0,0,0,0,0,0,0,0,0,0,0,0,1,0,1,0,0,0,0,0,0,0,0,0
207722,33000,330,0,-2,6,4,2,1,1,0,0,0,0,1,1,0,1,0,1,0,0,0,3,2,1,0,0,0,0,0,0,0,0,0
207740,33000,330,0,-2,6,0,6,0,0,0,0,0,0,2,0,2,0,0,0,0,0,0,4,0,4,0,0,0,0,0,0,0,0,0
207847,33000,330,0,-2,6,3,3,1,1,0,0,0,0,2,2,0,1,0,1,0,0,0,2,0,2,0,0,0,0,0,0,0,0,0
207856,33000,330,0,-2,4,3,1,0,0,0,0,0,0,0,0,0,0,0,0,0,0,0,3,2,1,0,0,0,0,0,0,1,1,0
207865,33000,330,0,-2,3,1,2,0,0,0,0,0,0,0,0,0,0,0,0,0,0,0,3,1,2,0,0,0,0,0,0,0,0,0
207935,33000,330,0,-2,9,4,5,0,0,0,1,1,0,0,0,0,1,0,1,0,0,0,6,2,4,1,1,0,0,0,0,0,0,0
207971,33000,330,0,-2,42,16,26,1,0,1,1,0,1,7,5,2,0,0,0,0,0,0,28,11,17,2,0,2,2,0,2,1,0,1
208035,33000,330,0,-2,3,3,0,1,1,0,0,0,0,1,1,0,0,0,0,0,0,0,1,1,0,0,0,0,0,0,0,0,0,0
208646,33000,330,0,-2,3,1,2,0,0,0,0,0,0,1,1,0,0,0,0,0,0,0,2,0,2,0,0,0,0,0,0,0,0,0
208822,33000,330,0,-2,16,8,8,0,0,0,1,1,0,0,0,0,0,0,0,0,0,0,13,6,7,2,1,1,0,0,0,0,0,0
209056,33000,330,0,-2,8,3,5,0,0,0,0,0,0,1,1,0,2,1,1,0,0,0,5,1,4,0,0,0,0,0,0,0,0,0
209065,33000,330,0,-2,9,4,5,0,0,0,0,0,0,1,1,0,2,1,1,0,0,0,5,1,4,1,1,0,0,0,0,0,0,0
209074,33000,330,0,-2,6,3,3,1,1,0,0,0,0,0,0,0,0,0,0,0,0,0,2,2,0,0,0,0,3,0,3,0,0,0
209287,33000,330,0,-2,3,2,1,0,0,0,0,0,0,0,0,0,0,0,0,0,0,0,2,1,1,1,1,0,0,0,0,0,0,0
209409,33000,330,0,-2,6,1,5,0,0,0,0,0,0,0,0,0,0,0,0,0,0,0,5,1,4,1,0,1,0,0,0,0,0,0
209490,33000,330,0,-2,9,3,6,0,0,0,0,0,0,2,1,1,2,1,1,0,0,0,3,1,2,0,0,0,2,0,2,0,0,0
209506,33000,330,0,-2,2,1,1,0,0,0,1,0,1,0,0,0,0,0,0,0,0,0,1,1,0,0,0,0,0,0,0,0,0,0
209542,33000,330,0,-2,48,23,25,0,0,0,2,0,2,2,1,1,2,1,1,0,0,0,13,5,8,1,0,1,28,16,12,0,0,0
209551,33000,330,0,-2,84,33,51,1,0,1,2,0,2,10,7,3,6,2,4,1,1,0,61,22,39,1,0,1,1,1,0,1,0,1
209612,33000,330,0,-2,5,1,4,0,0,0,0,0,0,0,0,0,2,0,2,0,0,0,2,1,1,1,0,1,0,0,0,0,0,0
209746,33000,330,0,-2,22,7,15,0,0,0,1,0,1,7,1,6,3,2,1,0,0,0,8,3,5,2,1,1,1,0,1,0,0,0
209807,33000,330,0,-2,14,8,6,0,0,0,0,0,0,1,1,0,4,1,3,0,0,0,8,5,3,1,1,0,0,0,0,0,0,0
209825,33000,330,0,-2,21,14,7,0,0,0,0,0,0,2,2,0,5,4,1,0,0,0,9,5,4,0,0,0,3,1,2,2,2,0
209922,33000,330,0,-2,4,2,2,0,0,0,0,0,0,1,1,0,0,0,0,0,0,0,3,1,2,0,0,0,0,0,0,0,0,0
210155,33000,330,0,-2,1,0,1,0,0,0,0,0,0,0,0,0,0,0,0,0,0,0,1,0,1,0,0,0,0,0,0,0,0,0
210234,33000,330,0,-2,1,1,0,0,0,0,0,0,0,0,0,0,0,0,0,0,0,0,1,1,0,0,0,0,0,0,0,0,0,0
210304,33000,330,0,-2,1,1,0,0,0,0,0,0,0,0,0,0,0,0,0,0,0,0,1,1,0,0,0,0,0,0,0,0,0,0
210331,33000,330,0,-2,3,2,1,0,0,0,0,0,0,0,0,0,0,0,0,0,0,0,3,2,1,0,0,0,0,0,0,0,0,0
210401,33000,330,0,-2,13,4,9,1,0,1,1,1,0,1,0,1,2,0,2,0,0,0,4,0,4,1,1,0,3,2,1,0,0,0
210429,33000,330,0,-2,2,1,1,0,0,0,0,0,0,0,0,0,1,1,0,0,0,0,1,0,1,0,0,0,0,0,0,0,0,0
210438,33000,330,0,-2,1,0,1,0,0,0,0,0,0,0,0,0,0,0,0,0,0,0,0,0,0,1,0,1,0,0,0,0,0,0
210492,33000,330,0,-2,1,0,1,0,0,0,0,0,0,0,0,0,0,0,0,0,0,0,1,0,1,0,0,0,0,0,0,0,0,0
210571,33000,330,0,-2,11,3,8,0,0,0,0,0,0,3,1,2,2,1,1,0,0,0,6,1,5,0,0,0,0,0,0,0,0,0
210599,33000,330,0,-2,5,1,4,0,0,0,0,0,0,3,1,2,0,0,0,0,0,0,1,0,1,1,0,1,0,0,0,0,0,0
210605,33000,330,0,-2,7,1,6,0,0,0,0,0,0,1,0,1,0,0,0,0,0,0,6,1,5,0,0,0,0,0,0,0,0,0
210669,33000,330,0,-2,18,6,12,0,0,0,1,0,1,2,2,0,0,0,0,0,0,0,15,4,11,0,0,0,0,0,0,0,0,0
210739,33000,330,0,-2,5,0,5,0,0,0,0,0,0,0,0,0,1,0,1,0,0,0,4,0,4,0,0,0,0,0,0,0,0,0
210775,33000,330,0,-2,11,9,2,0,0,0,1,1,0,1,1,0,0,0,0,0,0,0,9,7,2,0,0,0,0,0,0,0,0,0
210809,33000,330,0,-2,3,1,2,0,0,0,0,0,0,0,0,0,0,0,0,0,0,0,3,1,2,0,0,0,0,0,0,0,0,0
211024,33000,330,0,-2,2,1,1,0,0,0,0,0,0,0,0,0,0,0,0,0,0,0,1,1,0,1,0,1,0,0,0,0,0,0
211079,33000,330,0,-2,5,3,2,0,0,0,0,0,0,2,1,1,0,0,0,0,0,0,3,2,1,0,0,0,0,0,0,0,0,0
211088,33000,330,0,-2,6,3,3,0,0,0,0,0,0,0,0,0,0,0,0,0,0,0,6,3,3,0,0,0,0,0,0,0,0,0
211158,33000,330,0,-2,5,4,1,0,0,0,0,0,0,1,1,0,1,0,1,0,0,0,2,2,0,1,1,0,0,0,0,0,0,0
211291,33000,330,0,-2,22,10,12,0,0,0,1,1,0,5,3,2,1,0,1,0,0,0,14,6,8,1,0,1,0,0,0,0,0,0
211352,33000,330,0,-2,3,2,1,0,0,0,0,0,0,0,0,0,0,0,0,0,0,0,3,2,1,0,0,0,0,0,0,0,0,0
211361,33000,330,0,-2,1,1,0,0,0,0,0,0,0,1,1,0,0,0,0,0,0,0,0,0,0,0,0,0,0,0,0,0,0,0
211431,33000,330,0,-2,2,1,1,0,0,0,1,0,1,0,0,0,1,1,0,0,0,0,0,0,0,0,0,0,0,0,0,0,0,0
211440,33000,330,0,-2,41,11,30,0,0,0,2,0,2,6,1,5,1,0,1,0,0,0,29,9,20,1,1,0,2,0,2,0,0,0
211468,33000,330,0,-2,5,1,4,0,0,0,0,0,0,0,0,0,1,0,1,0,0,0,3,1,2,1,0,1,0,0,0,0,0,0
211477,33000,330,0,-2,6,1,5,0,0,0,0,0,0,2,0,2,0,0,0,0,0,0,4,1,3,0,0,0,0,0,0,0,0,0
211556,33000,330,0,-2,4,2,2,0,0,0,0,0,0,0,0,0,2,1,1,0,0,0,1,0,1,1,1,0,0,0,0,0,0,0
211583,33000,330,0,-2,4,1,3,0,0,0,0,0,0,1,0,1,0,0,0,0,0,0,3,1,2,0,0,0,0,0,0,0,0,0
211608,33000,330,0,-2,2,1,1,0,0,0,0,0,0,2,1,1,0,0,0,0,0,0,0,0,0,0,0,0,0,0,0,0,0,0
211644,33000,330,0,-2,5,4,1,0,0,0,0,0,0,1,1,0,1,1,0,0,0,0,2,1,1,0,0,0,1,1,0,0,0,0
211893,33000,330,0,-2,4,2,2,0,0,0,0,0,0,0,0,0,0,0,0,0,0,0,4,2,2,0,0,0,0,0,0,0,0,0
211981,33000,330,0,-2,7,5,2,0,0,0,0,0,0,1,1,0,0,0,0,0,0,0,4,3,1,1,1,0,1,0,1,0,0,0
212009,33000,330,0,-2,8,5,3,0,0,0,1,1,0,2,0,2,0,0,0,0,0,0,5,4,1,0,0,0,0,0,0,0,0,0
212054,33000,330,0,-2,20,3,17,0,0,0,1,0,1,1,0,1,1,1,0,0,0,0,15,2,13,2,0,2,0,0,0,0,0,0
212106,33000,330,0,-2,15,6,9,0,0,0,0,0,0,0,0,0,0,0,0,0,0,0,13,6,7,1,0,1,1,0,1,0,0,0
212115,33000,330,0,-2,4,2,2,0,0,0,0,0,0,1,0,1,0,0,0,0,0,0,3,2,1,0,0,0,0,0,0,0,0,0
212133,33000,330,0,-2,26,18,8,0,0,0,0,0,0,5,3,2,0,0,0,0,0,0,20,15,5,1,0,1,0,0,0,0,0,0
212160,33000,330,0,-2,2,2,0,0,0,0,0,0,0,0,0,0,0,0,0,0,0,0,2,2,0,0,0,0,0,0,0,0,0,0
212197,33000,330,0,-2,3,1,2,0,0,0,0,0,0,0,0,0,1,0,1,0,0,0,2,1,1,0,0,0,0,0,0,0,0,0
212577,33000,330,0,-2,4,2,2,0,0,0,0,0,0,2,2,0,0,0,0,0,0,0,2,0,2,0,0,0,0,0,0,0,0,0
212601,33000,330,0,-2,18,10,8,0,0,0,0,0,0,0,0,0,1,1,0,0,0,0,16,8,8,0,0,0,1,1,0,0,0,0
212656,33000,330,0,-2,2,1,1,0,0,0,0,0,0,0,0,0,0,0,0,0,0,0,2,1,1,0,0,0,0,0,0,0,0,0
212674,33000,330,0,-2,11,6,5,1,0,1,0,0,0,0,0,0,0,0,0,0,0,0,10,6,4,0,0,0,0,0,0,0,0,0
212832,33000,330,0,-2,2,1,1,0,0,0,0,0,0,0,0,0,0,0,0,0,0,0,2,1,1,0,0,0,0,0,0,0,0,0
212869,33000,330,0,-2,1,1,0,0,0,0,0,0,0,0,0,0,0,0,0,0,0,0,1,1,0,0,0,0,0,0,0,0,0,0
212878,33000,330,0,-2,1,0,1,0,0,0,0,0,0,0,0,0,0,0,0,0,0,0,1,0,1,0,0,0,0,0,0,0,0,0
212911,33000,330,0,-2,7,3,4,0,0,0,0,0,0,1,1,0,0,0,0,0,0,0,6,2,4,0,0,0,0,0,0,0,0,0
212984,33000,330,0,-2,8,4,4,0,0,0,1,1,0,1,1,0,0,0,0,0,0,0,6,2,4,0,0,0,0,0,0,0,0,0
213011,33000,330,0,-2,10,3,7,0,0,0,1,0,1,1,1,0,1,0,1,0,0,0,7,2,5,0,0,0,0,0,0,0,0,0
213020,33000,330,0,-2,4,2,2,0,0,0,1,1,0,0,0,0,0,0,0,0,0,0,3,1,2,0,0,0,0,0,0,0,0,0
213251,33000,330,0,-2,15,8,7,1,1,0,1,0,1,2,1,1,1,1,0,0,0,0,10,5,5,0,0,0,0,0,0,0,0,0
213303,33000,330,0,-2,4,2,2,0,0,0,0,0,0,0,0,0,0,0,0,0,0,0,4,2,2,0,0,0,0,0,0,0,0,0
213321,33000,330,0,-2,1,1,0,0,0,0,0,0,0,0,0,0,0,0,0,0,0,0,1,1,0,0,0,0,0,0,0,0,0,0
213349,33000,330,0,-2,4,1,3,0,0,0,0,0,0,0,0,0,1,0,1,0,0,0,3,1,2,0,0,0,0,0,0,0,0,0
213358,33000,330,0,-2,9,3,6,0,0,0,0,0,0,0,0,0,0,0,0,0,0,0,8,2,6,0,0,0,1,1,0,0,0,0
213367,33000,330,0,-2,13,7,6,0,0,0,0,0,0,0,0,0,1,0,1,0,0,0,11,7,4,0,0,0,0,0,0,1,0,1
213376,33000,330,0,-2,2,0,2,0,0,0,0,0,0,0,0,0,0,0,0,0,0,0,2,0,2,0,0,0,0,0,0,0,0,0
213385,33000,330,0,-2,8,5,3,0,0,0,1,1,0,0,0,0,0,0,0,0,0,0,5,4,1,1,0,1,1,0,1,0,0,0
213400,33000,330,0,-2,1,0,1,0,0,0,0,0,0,0,0,0,0,0,0,0,0,0,1,0,1,0,0,0,0,0,0,0,0,0
213507,33000,330,0,-2,11,5,6,0,0,0,0,0,0,0,0,0,1,1,0,0,0,0,10,4,6,0,0,0,0,0,0,0,0,0
213543,33000,330,0,-2,12,6,6,0,0,0,0,0,0,3,3,0,0,0,0,0,0,0,9,3,6,0,0,0,0,0,0,0,0,0
213598,33000,330,0,-2,8,1,7,0,0,0,0,0,0,6,1,5,0,0,0,0,0,0,1,0,1,1,0,1,0,0,0,0,0,0
213668,33000,330,0,-2,13,8,5,0,0,0,0,0,0,0,0,0,1,1,0,0,0,0,11,7,4,0,0,0,1,0,1,0,0,0
213774,33000,330,0,-2,1,1,0,0,0,0,0,0,0,0,0,0,0,0,0,0,0,0,1,1,0,0,0,0,0,0,0,0,0,0
213783,33000,330,0,-2,2,1,1,0,0,0,0,0,0,1,1,0,0,0,0,0,0,0,1,0,1,0,0,0,0,0,0,0,0,0
213826,33000,330,0,-2,7,4,3,0,0,0,0,0,0,1,0,1,1,1,0,0,0,0,3,2,1,0,0,0,2,1,1,0,0,0
213987,33000,330,0,-2,15,7,8,0,0,0,0,0,0,1,0,1,0,0,0,0,0,0,12,7,5,0,0,0,2,0,2,0,0,0
213996,33000,330,0,-2,8,4,4,0,0,0,0,0,0,0,0,0,0,0,0,0,0,0,8,4,4,0,0,0,0,0,0,0,0,0
214041,33000,330,0,-2,2,1,1,0,0,0,0,0,0,1,1,0,0,0,0,0,0,0,1,0,1,0,0,0,0,0,0,0,0,0
214069,33000,330,0,-2,4,2,2,0,0,0,0,0,0,1,1,0,0,0,0,0,0,0,3,1,2,0,0,0,0,0,0,0,0,0
214111,33000,330,0,-2,4,1,3,0,0,0,0,0,0,0,0,0,0,0,0,0,0,0,2,0,2,0,0,0,2,1,1,0,0,0
214148,33000,330,0,-2,3,0,3,0,0,0,0,0,0,1,0,1,0,0,0,0,0,0,2,0,2,0,0,0,0,0,0,0,0,0
214157,33000,330,0,-2,17,4,13,0,0,0,0,0,0,1,1,0,0,0,0,0,0,0,11,2,9,2,0,2,3,1,2,0,0,0
214166,33000,330,0,-2,6,2,4,0,0,0,0,0,0,0,0,0,0,0,0,0,0,0,5,2,3,1,0,1,0,0,0,0,0,0
214175,33000,330,0,-2,10,3,7,0,0,0,0,0,0,0,0,0,2,1,1,0,0,0,8,2,6,0,0,0,0,0,0,0,0,0
214272,33000,330,0,-2,6,4,2,0,0,0,1,1,0,0,0,0,0,0,0,0,0,0,5,3,2,0,0,0,0,0,0,0,0,0
215062,33000,330,0,-2,34,7,27,0,0,0,0,0,0,8,2,6,4,1,3,0,0,0,19,3,16,1,1,0,2,0,2,0,0,0
215105,33000,330,0,-2,3,1,2,0,0,0,0,0,0,1,0,1,0,0,0,0,0,0,2,1,1,0,0,0,0,0,0,0,0,0
215114,33000,330,0,-2,4,4,0,0,0,0,0,0,0,0,0,0,0,0,0,0,0,0,4,4,0,0,0,0,0,0,0,0,0,0
215132,33000,330,0,-2,1,0,1,0,0,0,0,0,0,1,0,1,0,0,0,0,0,0,0,0,0,0,0,0,0,0,0,0,0,0
215239,33000,330,0,-2,1,1,0,0,0,0,0,0,0,1,1,0,0,0,0,0,0,0,0,0,0,0,0,0,0,0,0,0,0,0
215266,33000,330,0,-2,1,0,1,0,0,0,0,0,0,0,0,0,0,0,0,0,0,0,0,0,0,0,0,0,1,0,1,0,0,0
215275,33000,330,0,-2,2,2,0,0,0,0,0,0,0,0,0,0,1,1,0,0,0,0,1,1,0,0,0,0,0,0,0,0,0,0
215284,33000,330,0,-2,1,0,1,0,0,0,0,0,0,0,0,0,0,0,0,0,0,0,1,0,1,0,0,0,0,0,0,0,0,0
215293,33000,330,0,-2,57,31,26,0,0,0,0,0,0,11,5,6,3,0,3,1,0,1,37,22,15,2,1,1,3,3,0,0,0,0
215415,33000,330,0,-2,2,0,2,0,0,0,0,0,0,0,0,0,0,0,0,0,0,0,2,0,2,0,0,0,0,0,0,0,0,0
215442,33000,330,0,-2,6,3,3,0,0,0,0,0,0,0,0,0,0,0,0,0,0,0,6,3,3,0,0,0,0,0,0,0,0,0
215585,33000,330,0,-2,1,0,1,0,0,0,0,0,0,0,0,0,0,0,0,0,0,0,1,0,1,0,0,0,0,0,0,0,0,0
215655,33000,330,0,-2,20,14,6,0,0,0,0,0,0,3,3,0,3,2,1,0,0,0,12,8,4,1,0,1,0,0,0,1,1,0
215691,33000,330,0,-2,14,5,9,0,0,0,0,0,0,3,0,3,1,1,0,0,0,0,10,4,6,0,0,0,0,0,0,0,0,0
215743,33000,330,0,-2,27,19,8,0,0,0,0,0,0,3,1,2,0,0,0,0,0,0,23,17,6,0,0,0,0,0,0,1,1,0
215770,33000,330,0,-2,30,8,22,0,0,0,2,0,2,4,2,2,1,1,0,0,0,0,20,4,16,0,0,0,3,1,2,0,0,0
215798,33000,330,0,-2,9,3,6,0,0,0,0,0,0,0,0,0,0,0,0,0,0,0,8,3,5,0,0,0,1,0,1,0,0,0
215929,33000,330,0,-2,9,4,5,0,0,0,1,1,0,2,1,1,0,0,0,0,0,0,6,2,4,0,0,0,0,0,0,0,0,0
215947,33000,330,0,-2,10,4,6,0,0,0,0,0,0,1,0,1,0,0,0,0,0,0,9,4,5,0,0,0,0,0,0,0,0,0
216010,33000,330,0,-2,2,1,1,0,0,0,0,0,0,0,0,0,1,0,1,0,0,0,1,1,0,0,0,0,0,0,0,0,0,0
216038,33000,330,0,-2,5,1,4,0,0,0,0,0,0,0,0,0,0,0,0,0,0,0,5,1,4,0,0,0,0,0,0,0,0,0
216278,33000,330,0,-2,10,6,4,0,0,0,0,0,0,1,1,0,0,0,0,0,0,0,9,5,4,0,0,0,0,0,0,0,0,0
216287,33000,330,0,-2,9,3,6,0,0,0,0,0,0,0,0,0,1,1,0,0,0,0,6,2,4,2,0,2,0,0,0,0,0,0
216339,33000,330,0,-2,44,19,25,0,0,0,2,1,1,10,5,5,4,1,3,0,0,0,26,11,15,1,0,1,0,0,0,1,1,0
216357,33000,330,0,-2,15,9,6,0,0,0,1,0,1,0,0,0,0,0,0,0,0,0,14,9,5,0,0,0,0,0,0,0,0,0
216366,33000,330,0,-2,15,3,12,0,0,0,1,1,0,5,0,5,0,0,0,0,0,0,7,2,5,0,0,0,2,0,2,0,0,0
216524,33000,330,0,-2,10,4,6,0,0,0,0,0,0,1,1,0,1,0,1,0,0,0,7,2,5,0,0,0,1,1,0,0,0,0
216597,33000,330,0,-2,21,5,16,0,0,0,0,0,0,2,0,2,0,0,0,0,0,0,19,5,14,0,0,0,0,0,0,0,0,0
216667,33000,330,0,-2,5,2,3,0,0,0,0,0,0,1,0,1,0,0,0,0,0,0,4,2,2,0,0,0,0,0,0,0,0,0
216694,33000,330,0,-2,3,3,0,0,0,0,0,0,0,2,2,0,0,0,0,0,0,0,1,1,0,0,0,0,0,0,0,0,0,0
216764,33000,330,0,-2,3,2,1,0,0,0,0,0,0,0,0,0,0,0,0,0,0,0,3,2,1,0,0,0,0,0,0,0,0,0
216807,33000,330,0,-2,2,2,0,0,0,0,0,0,0,0,0,0,0,0,0,0,0,0,2,2,0,0,0,0,0,0,0,0,0,0
216816,33000,330,0,-2,2,1,1,0,0,0,0,0,0,0,0,0,0,0,0,0,0,0,2,1,1,0,0,0,0,0,0,0,0,0
216852,33000,330,0,-2,11,3,8,0,0,0,0,0,0,1,0,1,0,0,0,0,0,0,10,3,7,0,0,0,0,0,0,0,0,0
216931,33000,330,0,-2,5,3,2,0,0,0,0,0,0,1,1,0,0,0,0,0,0,0,3,1,2,0,0,0,1,1,0,0,0,0
217013,33000,330,0,-2,2,1,1,0,0,0,0,0,0,1,0,1,0,0,0,0,0,0,1,1,0,0,0,0,0,0,0,0,0,0
217059,33000,330,0,-2,5,1,4,0,0,0,0,0,0,0,0,0,1,0,1,0,0,0,4,1,3,0,0,0,0,0,0,0,0,0
217156,33000,330,0,-2,31,18,13,0,0,0,0,0,0,3,0,3,3,1,2,0,0,0,21,13,8,1,1,0,3,3,0,0,0,0
217165,33000,330,0,-2,18,8,10,0,0,0,0,0,0,1,0,1,0,0,0,0,0,0,16,8,8,0,0,0,1,0,1,0,0,0
217235,33000,330,0,-2,13,2,11,0,0,0,1,1,0,1,0,1,0,0,0,0,0,0,11,1,10,0,0,0,0,0,0,0,0,0
217402,33000,330,0,-2,15,5,10,0,0,0,0,0,0,2,1,1,1,0,1,0,0,0,12,4,8,0,0,0,0,0,0,0,0,0
217420,33000,330,0,-2,7,5,2,0,0,0,0,0,0,2,1,1,0,0,0,0,0,0,5,4,1,0,0,0,0,0,0,0,0,0
217484,33000,330,0,-2,15,10,5,0,0,0,0,0,0,1,1,0,0,0,0,0,0,0,14,9,5,0,0,0,0,0,0,0,0,0
217493,33000,330,0,-2,9,1,8,0,0,0,0,0,0,3,0,3,0,0,0,0,0,0,5,1,4,0,0,0,1,0,1,0,0,0
217518,33000,330,0,-2,10,3,7,0,0,0,0,0,0,0,0,0,3,2,1,0,0,0,6,1,5,1,0,1,0,0,0,0,0,0
217536,33000,330,0,-2,10,3,7,0,0,0,0,0,0,0,0,0,1,0,1,0,0,0,8,3,5,0,0,0,1,0,1,0,0,0
217624,33000,330,0,-2,7,4,3,0,0,0,1,0,1,6,4,2,0,0,0,0,0,0,0,0,0,0,0,0,0,0,0,0,0,0
217633,33000,330,0,-2,29,12,17,0,0,0,0,0,0,2,0,2,1,1,0,0,0,0,22,9,13,0,0,0,4,2,2,0,0,0
217688,33000,330,0,-2,8,8,0,0,0,0,0,0,0,3,3,0,0,0,0,0,0,0,5,5,0,0,0,0,0,0,0,0,0,0
217721,33000,330,0,-2,6,3,3,0,0,0,0,0,0,5,3,2,0,0,0,0,0,0,0,0,0,1,0,1,0,0,0,0,0,0
217749,33000,330,0,-2,11,9,2,0,0,0,0,0,0,0,0,0,0,0,0,0,0,0,11,9,2,0,0,0,0,0,0,0,0,0
217776,33000,330,0,-2,2,1,1,0,0,0,0,0,0,0,0,0,1,1,0,0,0,0,1,0,1,0,0,0,0,0,0,0,0,0
217819,33000,330,0,-2,21,13,8,0,0,0,0,0,0,1,1,0,1,1,0,0,0,0,15,8,7,2,1,1,0,0,0,2,2,0
217837,33000,330,0,-2,1,0,1,0,0,0,0,0,0,0,0,0,0,0,0,0,0,0,1,0,1,0,0,0,0,0,0,0,0,0
217864,33000,330,0,-2,6,5,1,0,0,0,0,0,0,0,0,0,0,0,0,0,0,0,2,1,1,0,0,0,4,4,0,0,0,0
217873,33000,330,0,-2,2,1,1,0,0,0,0,0,0,2,1,1,0,0,0,0,0,0,0,0,0,0,0,0,0,0,0,0,0,0
217882,33000,330,0,-2,60,26,34,0,0,0,0,0,0,0,0,0,0,0,0,0,0,0,59,26,33,0,0,0,0,0,0,1,0,1
217891,33000,330,0,-2,5,3,2,0,0,0,0,0,0,5,3,2,0,0,0,0,0,0,0,0,0,0,0,0,0,0,0,0,0,0
217907,33000,330,0,-2,11,6,5,0,0,0,0,0,0,3,1,2,0,0,0,0,0,0,8,5,3,0,0,0,0,0,0,0,0,0
217925,33000,330,0,-2,7,1,6,0,0,0,0,0,0,0,0,0,1,1,0,0,0,0,6,0,6,0,0,0,0,0,0,0,0,0
217934,33000,330,0,-2,5,2,3,0,0,0,0,0,0,2,1,1,0,0,0,0,0,0,3,1,2,0,0,0,0,0,0,0,0,0
217961,33000,330,0,-2,13,3,10,0,0,0,0,0,0,0,0,0,0,0,0,0,0,0,13,3,10,0,0,0,0,0,0,0,0,0
218061,33000,330,0,-2,7,4,3,0,0,0,0,0,0,2,1,1,0,0,0,0,0,0,5,3,2,0,0,0,0,0,0,0,0,0
218070,33000,330,0,-2,33,8,25,0,0,0,0,0,0,6,0,6,3,0,3,0,0,0,23,7,16,0,0,0,0,0,0,1,1,0
218113,33000,330,0,-2,7,3,4,0,0,0,0,0,0,2,1,1,0,0,0,0,0,0,5,2,3,0,0,0,0,0,0,0,0,0
218140,33000,330,0,-2,4,0,4,0,0,0,0,0,0,0,0,0,0,0,0,0,0,0,4,0,4,0,0,0,0,0,0,0,0,0
218229,33000,330,0,-2,4,3,1,0,0,0,0,0,0,0,0,0,0,0,0,0,0,0,4,3,1,0,0,0,0,0,0,0,0,0
218238,33000,330,0,-2,17,11,6,0,0,0,0,0,0,4,1,3,0,0,0,0,0,0,11,8,3,0,0,0,1,1,0,1,1,0
218353,33000,330,0,-2,2,1,1,0,0,0,0,0,0,1,0,1,0,0,0,0,0,0,1,1,0,0,0,0,0,0,0,0,0,0
218399,33000,330,0,-2,5,2,3,0,0,0,0,0,0,5,2,3,0,0,0,0,0,0,0,0,0,0,0,0,0,0,0,0,0,0
218414,33000,330,0,-2,12,9,3,0,0,0,0,0,0,2,2,0,0,0,0,0,0,0,10,7,3,0,0,0,0,0,0,0,0,0
218441,33000,330,0,-2,6,3,3,0,0,0,0,0,0,0,0,0,0,0,0,0,0,0,6,3,3,0,0,0,0,0,0,0,0,0
218520,33000,330,0,-2,3,1,2,0,0,0,0,0,0,0,0,0,0,0,0,0,0,0,3,1,2,0,0,0,0,0,0,0,0,0
218539,33000,330,0,-2,30,17,13,0,0,0,2,1,1,6,3,3,0,0,0,0,0,0,22,13,9,0,0,0,0,0,0,0,0,0
218645,33000,330,0,-2,10,2,8,0,0,0,0,0,0,3,1,2,0,0,0,0,0,0,7,1,6,0,0,0,0,0,0,0,0,0
218654,33000,330,0,-2,3,0,3,0,0,0,0,0,0,0,0,0,0,0,0,0,0,0,2,0,2,1,0,1,0,0,0,0,0,0
218663,33000,330,0,-2,124,60,64,0,0,0,2,0,2,21,7,14,3,2,1,0,0,0,91,48,43,4,2,2,2,0,2,1,1,0
218672,33000,330,0,-2,1,0,1,0,0,0,0,0,0,1,0,1,0,0,0,0,0,0,0,0,0,0,0,0,0,0,0,0,0,0
218681,33000,330,0,-2,1,0,1,0,0,0,0,0,0,0,0,0,0,0,0,0,0,0,0,0,0,1,0,1,0,0,0,0,0,0
218690,33000,330,0,-2,2,1,1,0,0,0,0,0,0,1,1,0,0,0,0,0,0,0,1,0,1,0,0,0,0,0,0,0,0,0
218724,33000,330,0,-2,23,9,14,0,0,0,1,1,0,4,2,2,2,1,1,0,0,0,16,5,11,0,0,0,0,0,0,0,0,0
218733,33000,330,0,-2,17,13,4,0,0,0,0,0,0,13,10,3,0,0,0,0,0,0,4,3,1,0,0,0,0,0,0,0,0,0
218742,33000,330,0,-2,17,6,11,0,0,0,1,0,1,6,3,3,0,0,0,0,0,0,10,3,7,0,0,0,0,0,0,0,0,0
218821,33000,330,0,-2,8,4,4,0,0,0,0,0,0,2,1,1,0,0,0,0,0,0,6,3,3,0,0,0,0,0,0,0,0,0
218830,33000,330,0,-2,11,2,9,0,0,0,1,0,1,3,0,3,1,0,1,0,0,0,6,2,4,0,0,0,0,0,0,0,0,0
218858,33000,330,0,-2,4,1,3,0,0,0,0,0,0,2,0,2,0,0,0,0,0,0,2,1,1,0,0,0,0,0,0,0,0,0
218885,33000,330,0,-2,9,4,5,0,0,0,0,0,0,0,0,0,1,1,0,0,0,0,8,3,5,0,0,0,0,0,0,0,0,0
218894,33000,330,0,-2,5,0,5,0,0,0,0,0,0,4,0,4,0,0,0,0,0,0,1,0,1,0,0,0,0,0,0,0,0,0
218919,33000,330,0,-2,1,0,1,0,0,0,0,0,0,1,0,1,0,0,0,0,0,0,0,0,0,0,0,0,0,0,0,0,0,0
218955,33000,330,0,-2,1,0,1,0,0,0,0,0,0,1,0,1,0,0,0,0,0,0,0,0,0,0,0,0,0,0,0,0,0,0
218964,33000,330,0,-2,17,9,8,0,0,0,0,0,0,6,4,2,1,0,1,0,0,0,10,5,5,0,0,0,0,0,0,0,0,0
218973,33000,330,0,-2,15,10,5,0,0,0,0,0,0,2,2,0,1,1,0,0,0,0,9,5,4,1,1,0,2,1,1,0,0,0
218991,33000,330,0,-2,2,1,1,0,0,0,0,0,0,2,1,1,0,0,0,0,0,0,0,0,0,0,0,0,0,0,0,0,0,0
219000,33000,330,0,-2,4,2,2,0,0,0,0,0,0,1,1,0,0,0,0,0,0,0,3,1,2,0,0,0,0,0,0,0,0,0
219046,33000,330,0,-2,2,1,1,0,0,0,0,0,0,0,0,0,0,0,0,0,0,0,2,1,1,0,0,0,0,0,0,0,0,0
219082,33000,330,0,-2,4,4,0,0,0,0,0,0,0,0,0,0,0,0,0,0,0,0,4,4,0,0,0,0,0,0,0,0,0,0
219091,33000,330,0,-2,10,7,3,0,0,0,0,0,0,0,0,0,0,0,0,0,0,0,10,7,3,0,0,0,0,0,0,0,0,0
219143,33000,330,0,-2,1,0,1,0,0,0,0,0,0,0,0,0,0,0,0,0,0,0,1,0,1,0,0,0,0,0,0,0,0,0
219198,33000,330,0,-2,8,5,3,0,0,0,0,0,0,0,0,0,3,1,2,0,0,0,5,4,1,0,0,0,0,0,0,0,0,0
219259,33000,330,0,-2,3,1,2,0,0,0,0,0,0,0,0,0,1,0,1,0,0,0,2,1,1,0,0,0,0,0,0,0,0,0
219295,33000,330,0,-2,8,7,1,0,0,0,0,0,0,0,0,0,0,0,0,0,0,0,8,7,1,0,0,0,0,0,0,0,0,0
219347,33000,330,0,-2,4,1,3,0,0,0,0,0,0,0,0,0,2,0,2,0,0,0,2,1,1,0,0,0,0,0,0,0,0,0
219356,33000,330,0,-2,26,13,13,0,0,0,0,0,0,3,3,0,0,0,0,0,0,0,20,9,11,0,0,0,3,1,2,0,0,0
219374,33000,330,0,-2,1,0,1,1,0,1,0,0,0,0,0,0,0,0,0,0,0,0,0,0,0,0,0,0,0,0,0,0,0,0
219383,33000,330,0,-2,7,7,0,0,0,0,0,0,0,0,0,0,0,0,0,0,0,0,7,7,0,0,0,0,0,0,0,0,0,0
219471,33000,330,0,-2,21,13,8,0,0,0,0,0,0,6,5,1,1,1,0,0,0,0,14,7,7,0,0,0,0,0,0,0,0,0
219602,33000,330,0,-2,53,28,25,0,0,0,2,0,2,15,8,7,1,1,0,0,0,0,33,18,15,0,0,0,2,1,1,0,0,0
219709,33000,330,0,-2,8,2,6,0,0,0,0,0,0,1,0,1,0,0,0,0,0,0,6,1,5,0,0,0,0,0,0,1,1,0
219718,33000,330,0,-2,20,12,8,0,0,0,0,0,0,2,1,1,1,1,0,0,0,0,17,10,7,0,0,0,0,0,0,0,0,0
219790,33000,330,0,-2,7,6,1,0,0,0,0,0,0,1,1,0,0,0,0,0,0,0,6,5,1,0,0,0,0,0,0,0,0,0
219806,33000,330,0,-2,10,6,4,0,0,0,0,0,0,0,0,0,0,0,0,0,0,0,10,6,4,0,0,0,0,0,0,0,0,0
219824,33000,330,0,-2,1,0,1,0,0,0,0,0,0,0,0,0,0,0,0,0,0,0,1,0,1,0,0,0,0,0,0,0,0,0
219833,33000,330,0,-2,10,4,6,0,0,0,2,1,1,5,1,4,0,0,0,0,0,0,3,2,1,0,0,0,0,0,0,0,0,0
219888,33000,330,0,-2,2,1,1,0,0,0,0,0,0,0,0,0,0,0,0,0,0,0,2,1,1,0,0,0,0,0,0,0,0,0
219949,33000,330,0,-2,9,9,0,0,0,0,0,0,0,1,1,0,0,0,0,0,0,0,6,6,0,0,0,0,2,2,0,0,0,0
219976,33000,330,0,-2,21,8,13,0,0,0,0,0,0,0,0,0,1,0,1,0,0,0,14,6,8,0,0,0,6,2,4,0,0,0
220057,33000,330,0,-2,8,2,6,0,0,0,0,0,0,1,0,1,0,0,0,0,0,0,5,1,4,0,0,0,1,1,0,1,0,1
220075,33000,330,0,-2,42,20,22,1,1,0,0,0,0,10,6,4,0,0,0,0,0,0,29,12,17,2,1,1,0,0,0,0,0,0
220181,33000,330,0,-2,1,0,1,0,0,0,0,0,0,0,0,0,0,0,0,0,0,0,1,0,1,0,0,0,0,0,0,0,0,0
220215,33000,330,0,-2,6,3,3,0,0,0,0,0,0,0,0,0,0,0,0,0,0,0,6,3,3,0,0,0,0,0,0,0,0,0
220400,33000,330,0,-2,9,6,3,0,0,0,0,0,0,2,2,0,0,0,0,0,0,0,7,4,3,0,0,0,0,0,0,0,0,0
220473,33000,330,0,-2,9,2,7,0,0,0,1,0,1,0,0,0,0,0,0,0,0,0,8,2,6,0,0,0,0,0,0,0,0,0
220516,33000,330,0,-2,9,5,4,0,0,0,0,0,0,1,0,1,1,1,0,0,0,0,7,4,3,0,0,0,0,0,0,0,0,0
220598,33000,330,0,-2,9,7,2,0,0,0,0,0,0,8,7,1,0,0,0,0,0,0,1,0,1,0,0,0,0,0,0,0,0,0
220604,33000,330,0,-2,3,2,1,0,0,0,0,0,0,3,2,1,0,0,0,0,0,0,0,0,0,0,0,0,0,0,0,0,0,0
220613,33000,330,0,-2,10,5,5,0,0,0,0,0,0,0,0,0,1,1,0,0,0,0,7,3,4,0,0,0,2,1,1,0,0,0
220631,33000,330,0,-2,22,11,11,0,0,0,0,0,0,2,2,0,1,1,0,0,0,0,18,7,11,0,0,0,1,1,0,0,0,0
220710,33000,330,0,-2,15,10,5,0,0,0,0,0,0,3,2,1,1,1,0,0,0,0,10,7,3,0,0,0,1,0,1,0,0,0
220792,33000,330,0,-2,13,3,10,0,0,0,0,0,0,13,3,10,0,0,0,0,0,0,0,0,0,0,0,0,0,0,0,0,0,0
220862,33000,330,0,-2,32,13,19,0,0,0,0,0,0,13,5,8,1,1,0,0,0,0,17,7,10,0,0,0,1,0,1,0,0,0
220978,33000,330,0,-2,10,2,8,0,0,0,0,0,0,1,1,0,0,0,0,0,0,0,9,1,8,0,0,0,0,0,0,0,0,0
221096,33000,330,0,-2,3,1,2,0,0,0,0,0,0,0,0,0,0,0,0,0,0,0,3,1,2,0,0,0,0,0,0,0,0,0
221184,33000,330,0,-2,1,0,1,0,0,0,0,0,0,0,0,0,0,0,0,0,0,0,1,0,1,0,0,0,0,0,0,0,0,0
221351,33000,330,0,-2,15,7,8,0,0,0,1,1,0,4,1,3,0,0,0,0,0,0,10,5,5,0,0,0,0,0,0,0,0,0
221485,33000,330,0,-2,2,1,1,0,0,0,0,0,0,1,1,0,0,0,0,0,0,0,1,0,1,0,0,0,0,0,0,0,0,0
221519,33000,330,0,-2,13,6,7,0,0,0,0,0,0,0,0,0,1,0,1,0,0,0,11,6,5,1,0,1,0,0,0,0,0,0
221643,33000,330,0,-2,2,1,1,0,0,0,0,0,0,2,1,1,0,0,0,0,0,0,0,0,0,0,0,0,0,0,0,0,0,0
221661,33000,330,0,-2,3,2,1,0,0,0,0,0,0,0,0,0,0,0,0,0,0,0,3,2,1,0,0,0,0,0,0,0,0,0
221731,33000,330,0,-2,6,2,4,0,0,0,0,0,0,0,0,0,0,0,0,0,0,0,5,2,3,0,0,0,1,0,1,0,0,0
221740,33000,330,0,-2,35,15,20,0,0,0,1,0,1,4,2,2,1,0,1,0,0,0,28,12,16,1,1,0,0,0,0,0,0,0
221759,33000,330,0,-2,81,46,35,0,0,0,0,0,0,18,13,5,3,2,1,0,0,0,58,31,27,0,0,0,0,0,0,2,0,2
221768,33000,330,0,-2,27,14,13,0,0,0,0,0,0,7,6,1,1,0,1,0,0,0,19,8,11,0,0,0,0,0,0,0,0,0
221838,33000,330,0,-2,58,29,29,0,0,0,0,0,0,31,16,15,2,1,1,0,0,0,23,12,11,1,0,1,1,0,1,0,0,0
221847,33000,330,0,-2,25,9,16,0,0,0,0,0,0,4,4,0,5,2,3,0,0,0,16,3,13,0,0,0,0,0,0,0,0,0
221892,33000,330,0,-2,17,7,10,0,0,0,0,0,0,1,1,0,0,0,0,0,0,0,15,5,10,1,1,0,0,0,0,0,0,0
221908,33000,330,0,-2,3,1,2,0,0,0,0,0,0,0,0,0,0,0,0,0,0,0,3,1,2,0,0,0,0,0,0,0,0,0
221953,33000,330,0,-2,18,13,5,0,0,0,0,0,0,2,2,0,0,0,0,0,0,0,12,7,5,0,0,0,2,2,0,2,2,0
221971,33000,330,0,-2,4,3,1,0,0,0,0,0,0,0,0,0,0,0,0,0,0,0,4,3,1,0,0,0,0,0,0,0,0,0
221999,33000,330,0,-2,104,54,50,0,0,0,2,0,2,24,14,10,4,2,2,0,0,0,53,26,27,5,1,4,16,11,5,0,0,0
222053,33000,330,0,-2,8,4,4,0,0,0,0,0,0,0,0,0,0,0,0,0,0,0,7,3,4,0,0,0,1,1,0,0,0,0
222062,33000,330,0,-2,2,1,1,0,0,0,0,0,0,0,0,0,0,0,0,0,0,0,2,1,1,0,0,0,0,0,0,0,0,0
222178,33000,330,0,-2,11,8,3,0,0,0,0,0,0,1,1,0,0,0,0,0,0,0,10,7,3,0,0,0,0,0,0,0,0,0
222497,33000,330,0,-2,2,0,2,0,0,0,0,0,0,1,0,1,0,0,0,0,0,0,1,0,1,0,0,0,0,0,0,0,0,0
222576,33000,330,0,-2,8,4,4,0,0,0,0,0,0,0,0,0,4,1,3,0,0,0,3,3,0,0,0,0,1,0,1,0,0,0
222822,33000,330,0,-2,8,6,2,0,0,0,0,0,0,4,4,0,1,0,1,0,0,0,3,2,1,0,0,0,0,0,0,0,0,0
222831,33000,330,0,-2,18,8,10,1,1,0,0,0,0,2,2,0,6,1,5,0,0,0,9,4,5,0,0,0,0,0,0,0,0,0
222877,33000,330,0,-2,4,4,0,0,0,0,0,0,0,0,0,0,0,0,0,0,0,0,4,4,0,0,0,0,0,0,0,0,0,0
222983,33000,330,0,-2,10,6,4,0,0,0,0,0,0,1,1,0,2,1,1,0,0,0,6,3,3,0,0,0,1,1,0,0,0,0
222992,33000,330,0,-2,3,1,2,0,0,0,0,0,0,0,0,0,0,0,0,0,0,0,2,1,1,0,0,0,1,0,1,0,0,0
223223,33000,330,0,-2,32,5,27,0,0,0,1,0,1,12,2,10,6,1,5,0,0,0,13,2,11,0,0,0,0,0,0,0,0,0
223232,33000,330,0,-2,29,16,13,0,0,0,0,0,0,5,4,1,4,1,3,1,1,0,11,5,6,0,0,0,8,5,3,0,0,0
223320,33000,330,0,-2,7,4,3,0,0,0,0,0,0,1,1,0,4,2,2,0,0,0,2,1,1,0,0,0,0,0,0,0,0,0
223427,33000,330,0,-2,1,0,1,0,0,0,0,0,0,0,0,0,1,0,1,0,0,0,0,0,0,0,0,0,0,0,0,0,0,0
223506,33000,330,0,-2,2,0,2,0,0,0,0,0,0,0,0,0,1,0,1,0,0,0,1,0,1,0,0,0,0,0,0,0,0,0
223816,33000,330,0,-2,3,1,2,0,0,0,1,0,1,0,0,0,1,0,1,0,0,0,1,1,0,0,0,0,0,0,0,0,0,0
223898,33000,330,0,-2,1,1,0,0,0,0,0,0,0,0,0,0,1,1,0,0,0,0,0,0,0,0,0,0,0,0,0,0,0,0
223922,33000,330,0,-2,2,1,1,0,0,0,0,0,0,0,0,0,0,0,0,0,0,0,2,1,1,0,0,0,0,0,0,0,0,0
224004,33000,330,0,-2,10,4,6,0,0,0,0,0,0,0,0,0,0,0,0,0,0,0,10,4,6,0,0,0,0,0,0,0,0,0
224110,33000,330,0,-2,1,0,1,0,0,0,0,0,0,1,0,1,0,0,0,0,0,0,0,0,0,0,0,0,0,0,0,0,0,0
224147,33000,330,0,-2,22,10,12,0,0,0,0,0,0,3,2,1,8,2,6,0,0,0,9,6,3,1,0,1,1,0,1,0,0,0
224226,33000,330,0,-2,10,7,3,0,0,0,0,0,0,0,0,0,0,0,0,0,0,0,10,7,3,0,0,0,0,0,0,0,0,0
224244,33000,330,0,-2,1,1,0,0,0,0,0,0,0,0,0,0,0,0,0,0,0,0,1,1,0,0,0,0,0,0,0,0,0,0
224305,33000,330,0,-2,3,2,1,0,0,0,1,1,0,1,1,0,0,0,0,0,0,0,1,0,1,0,0,0,0,0,0,0,0,0
224323,33000,330,0,-2,4,4,0,0,0,0,0,0,0,0,0,0,0,0,0,0,0,0,4,4,0,0,0,0,0,0,0,0,0,0
224350,33000,330,0,-2,1,0,1,0,0,0,0,0,0,0,0,0,1,0,1,0,0,0,0,0,0,0,0,0,0,0,0,0,0,0
224527,33000,330,0,-2,6,3,3,0,0,0,0,0,0,0,0,0,0,0,0,1,0,1,5,3,2,0,0,0,0,0,0,0,0,0
224545,33000,330,0,-2,1,0,1,0,0,0,0,0,0,0,0,0,0,0,0,0,0,0,1,0,1,0,0,0,0,0,0,0,0,0
224554,33000,330,0,-2,21,7,14,0,0,0,0,0,0,1,0,1,5,1,4,1,0,1,13,6,7,1,0,1,0,0,0,0,0,0
224615,33000,330,0,-2,12,6,6,0,0,0,0,0,0,2,2,0,1,1,0,0,0,0,7,2,5,0,0,0,2,1,1,0,0,0
224891,33000,330,0,-2,6,4,2,0,0,0,0,0,0,3,1,2,1,1,0,0,0,0,2,2,0,0,0,0,0,0,0,0,0,0
224961,33000,330,0,-2,1,1,0,0,0,0,0,0,0,0,0,0,0,0,0,0,0,0,1,1,0,0,0,0,0,0,0,0,0,0
225070,33000,330,0,-2,1,1,0,1,1,0,0,0,0,0,0,0,0,0,0,0,0,0,0,0,0,0,0,0,0,0,0,0,0,0
225247,33000,330,0,-2,12,6,6,0,0,0,0,0,0,0,0,0,2,1,1,0,0,0,7,3,4,2,1,1,0,0,0,1,1,0
225308,33000,330,0,-2,1,0,1,0,0,0,0,0,0,0,0,0,0,0,0,0,0,0,1,0,1,0,0,0,0,0,0,0,0,0
225371,33000,330,0,-2,1,0,1,0,0,0,0,0,0,0,0,0,0,0,0,0,0,0,1,0,1,0,0,0,0,0,0,0,0,0
225399,33000,330,0,-2,21,8,13,0,0,0,0,0,0,6,2,4,3,2,1,0,0,0,11,4,7,0,0,0,0,0,0,1,0,1
225414,33000,330,0,-2,2,0,2,0,0,0,0,0,0,0,0,0,1,0,1,0,0,0,1,0,1,0,0,0,0,0,0,0,0,0
225423,33000,330,0,-2,23,5,18,0,0,0,2,0,2,10,3,7,7,1,6,0,0,0,4,1,3,0,0,0,0,0,0,0,0,0
225432,33000,330,0,-2,1,0,1,0,0,0,0,0,0,0,0,0,0,0,0,0,0,0,0,0,0,1,0,1,0,0,0,0,0,0
225511,33000,330,0,-2,30,16,14,0,0,0,2,0,2,7,3,4,4,2,2,0,0,0,14,10,4,0,0,0,2,0,2,1,1,0
225520,33000,330,0,-2,4,4,0,0,0,0,0,0,0,1,1,0,0,0,0,0,0,0,3,3,0,0,0,0,0,0,0,0,0,0
225548,33000,330,0,-2,15,9,6,0,0,0,0,0,0,1,0,1,3,1,2,0,0,0,11,8,3,0,0,0,0,0,0,0,0,0
225627,33000,330,0,-2,41,20,21,0,0,0,0,0,0,3,2,1,15,4,11,0,0,0,22,14,8,1,0,1,0,0,0,0,0,0
225876,33000,330,0,-2,3,2,1,0,0,0,0,0,0,0,0,0,0,0,0,0,0,0,3,2,1,0,0,0,0,0,0,0,0,0
225885,33000,330,0,-2,2,0,2,0,0,0,0,0,0,0,0,0,0,0,0,0,0,0,2,0,2,0,0,0,0,0,0,0,0,0
226019,33000,330,0,-2,1,0,1,0,0,0,0,0,0,0,0,0,0,0,0,0,0,0,1,0,1,0,0,0,0,0,0,0,0,0
226091,33000,330,0,-2,19,15,4,0,0,0,0,0,0,3,2,1,2,1,1,0,0,0,10,8,2,0,0,0,3,3,0,1,1,0
226152,33000,330,0,-2,27,15,12,0,0,0,0,0,0,1,1,0,21,10,11,0,0,0,3,3,0,0,0,0,0,0,0,2,1,1
226204,33000,330,0,-2,13,2,11,0,0,0,0,0,0,5,1,4,4,1,3,0,0,0,4,0,4,0,0,0,0,0,0,0,0,0
226231,33000,330,0,-2,8,6,2,0,0,0,0,0,0,0,0,0,0,0,0,0,0,0,8,6,2,0,0,0,0,0,0,0,0,0
226383,33000,330,0,-2,13,6,7,0,0,0,0,0,0,0,0,0,3,2,1,0,0,0,9,4,5,0,0,0,1,0,1,0,0,0
226408,33000,330,0,-2,3,1,2,0,0,0,0,0,0,0,0,0,2,1,1,0,0,0,1,0,1,0,0,0,0,0,0,0,0,0
226471,33000,330,0,-2,8,6,2,0,0,0,0,0,0,2,1,1,2,2,0,0,0,0,4,3,1,0,0,0,0,0,0,0,0,0
226578,33000,330,0,-2,11,1,10,1,0,1,1,0,1,0,0,0,3,0,3,0,0,0,6,1,5,0,0,0,0,0,0,0,0,0
226587,33000,330,0,-2,16,9,7,0,0,0,1,1,0,3,1,2,3,2,1,1,0,1,8,5,3,0,0,0,0,0,0,0,0,0
226806,33000,330,0,-2,11,2,9,0,0,0,1,0,1,1,1,0,4,0,4,0,0,0,3,1,2,0,0,0,1,0,1,1,0,1
226833,33000,330,0,-2,7,4,3,0,0,0,0,0,0,2,2,0,0,0,0,0,0,0,3,1,2,1,0,1,0,0,0,1,1,0
226903,33000,330,0,-2,12,4,8,0,0,0,0,0,0,0,0,0,8,2,6,0,0,0,3,2,1,0,0,0,1,0,1,0,0,0
227146,33000,330,0,-2,2,0,2,0,0,0,0,0,0,0,0,0,1,0,1,0,0,0,1,0,1,0,0,0,0,0,0,0,0,0
227182,33000,330,0,-2,4,2,2,0,0,0,0,0,0,1,0,1,0,0,0,0,0,0,3,2,1,0,0,0,0,0,0,0,0,0
227216,33000,330,0,-2,51,31,20,0,0,0,1,1,0,10,5,5,4,0,4,0,0,0,31,21,10,1,1,0,4,3,1,0,0,0
227225,33000,330,0,-2,11,3,8,1,0,1,0,0,0,0,0,0,2,0,2,0,0,0,8,3,5,0,0,0,0,0,0,0,0,0
227304,33000,330,0,-2,2,0,2,0,0,0,0,0,0,1,0,1,0,0,0,0,0,0,1,0,1,0,0,0,0,0,0,0,0,0
227331,33000,330,0,-2,17,8,9,0,0,0,0,0,0,1,1,0,9,4,5,0,0,0,7,3,4,0,0,0,0,0,0,0,0,0
227368,33000,330,0,-2,57,27,30,0,0,0,1,0,1,5,4,1,35,11,24,0,0,0,14,10,4,1,1,0,1,1,0,0,0,0
227377,33000,330,0,-2,2,1,1,0,0,0,0,0,0,0,0,0,2,1,1,0,0,0,0,0,0,0,0,0,0,0,0,0,0,0
227526,33000,330,0,-2,19,8,11,0,0,0,0,0,0,11,6,5,3,1,2,0,0,0,3,1,2,2,0,2,0,0,0,0,0,0
227687,33000,330,0,-2,7,6,1,0,0,0,0,0,0,3,2,1,0,0,0,0,0,0,4,4,0,0,0,0,0,0,0,0,0,0
227757,33000,330,0,-2,43,18,25,0,0,0,4,1,3,7,2,5,10,2,8,1,1,0,18,11,7,1,0,1,1,1,0,1,0,1
227845,33000,330,0,-2,15,7,8,0,0,0,0,0,0,0,0,0,4,0,4,0,0,0,11,7,4,0,0,0,0,0,0,0,0,0
227854,33000,330,0,-2,2,1,1,0,0,0,0,0,0,1,1,0,1,0,1,0,0,0,0,0,0,0,0,0,0,0,0,0,0,0
227863,33000,330,0,-2,23,12,11,0,0,0,2,0,2,4,3,1,8,4,4,0,0,0,8,4,4,0,0,0,0,0,0,1,1,0
227881,33000,330,0,-2,22,9,13,0,0,0,0,0,0,5,5,0,8,1,7,0,0,0,9,3,6,0,0,0,0,0,0,0,0,0
227924,33000,330,0,-2,1,1,0,0,0,0,0,0,0,0,0,0,1,1,0,0,0,0,0,0,0,0,0,0,0,0,0,0,0,0
227979,33000,330,0,-2,21,8,13,0,0,0,1,1,0,8,0,8,5,3,2,0,0,0,6,4,2,0,0,0,0,0,0,1,0,1
228042,33000,330,0,-2,7,4,3,0,0,0,0,0,0,0,0,0,2,1,1,0,0,0,5,3,2,0,0,0,0,0,0,0,0,0
228149,33000,330,0,-2,7,3,4,0,0,0,0,0,0,1,0,1,0,0,0,0,0,0,5,2,3,0,0,0,1,1,0,0,0,0
228158,33000,330,0,-2,5,1,4,0,0,0,0,0,0,0,0,0,2,0,2,0,0,0,3,1,2,0,0,0,0,0,0,0,0,0
228194,33000,330,0,-2,6,3,3,0,0,0,0,0,0,2,1,1,2,1,1,0,0,0,2,1,1,0,0,0,0,0,0,0,0,0
228246,33000,330,0,-2,35,19,16,0,0,0,0,0,0,11,6,5,4,2,2,0,0,0,18,11,7,1,0,1,0,0,0,1,0,1
228316,33000,330,0,-2,3,1,2,0,0,0,0,0,0,0,0,0,3,1,2,0,0,0,0,0,0,0,0,0,0,0,0,0,0,0
228325,33000,330,0,-2,12,6,6,0,0,0,0,0,0,0,0,0,1,1,0,0,0,0,10,5,5,1,0,1,0,0,0,0,0,0
228343,33000,330,0,-2,11,4,7,0,0,0,0,0,0,0,0,0,2,0,2,0,0,0,9,4,5,0,0,0,0,0,0,0,0,0
228431,33000,330,0,-2,24,14,10,0,0,0,0,0,0,2,2,0,1,0,1,0,0,0,18,11,7,3,1,2,0,0,0,0,0,0
228459,33000,330,0,-2,87,38,49,0,0,0,2,1,1,6,3,3,29,12,17,0,0,0,39,16,23,2,0,2,7,5,2,2,1,1
228468,33000,330,0,-2,3,1,2,0,0,0,0,0,0,0,0,0,1,0,1,0,0,0,1,1,0,0,0,0,1,0,1,0,0,0
228501,33000,330,0,-2,4,2,2,0,0,0,0,0,0,1,0,1,1,1,0,0,0,0,1,0,1,0,0,0,1,1,0,0,0,0
228529,33000,330,0,-2,23,13,10,0,0,0,0,0,0,6,2,4,3,2,1,0,0,0,12,8,4,1,1,0,1,0,1,0,0,0
228547,33000,330,0,-2,4,1,3,0,0,0,1,0,1,2,1,1,0,0,0,0,0,0,1,0,1,0,0,0,0,0,0,0,0,0
228635,33000,330,0,-2,3,1,2,0,0,0,0,0,0,0,0,0,1,0,1,0,0,0,0,0,0,2,1,1,0,0,0,0,0,0
228644,33000,330,0,-2,47,16,31,0,0,0,3,2,1,1,0,1,20,7,13,0,0,0,10,5,5,0,0,0,13,2,11,0,0,0
228653,33000,330,0,-2,4,1,3,0,0,0,1,0,1,1,1,0,0,0,0,0,0,0,2,0,2,0,0,0,0,0,0,0,0,0
228699,33000,330,0,-2,2,0,2,0,0,0,0,0,0,0,0,0,0,0,0,0,0,0,2,0,2,0,0,0,0,0,0,0,0,0
228705,33000,330,0,-2,13,7,6,0,0,0,0,0,0,1,0,1,7,4,3,0,0,0,5,3,2,0,0,0,0,0,0,0,0,0
228723,33000,330,0,-2,160,57,103,0,0,0,3,1,2,25,8,17,51,19,32,0,0,0,74,27,47,5,2,3,2,0,2,0,0,0
228732,33000,330,0,-2,2,1,1,0,0,0,0,0,0,0,0,0,0,0,0,0,0,0,2,1,1,0,0,0,0,0,0,0,0,0
228769,33000,330,0,-2,19,6,13,0,0,0,1,1,0,1,0,1,4,0,4,0,0,0,6,2,4,0,0,0,7,3,4,0,0,0
228778,33000,330,0,-2,109,38,71,0,0,0,5,3,2,9,5,4,22,7,15,0,0,0,67,21,46,6,2,4,0,0,0,0,0,0
228787,33000,330,0,-2,28,7,21,1,0,1,0,0,0,5,1,4,0,0,0,0,0,0,16,4,12,4,0,4,2,2,0,0,0,0
228796,33000,330,0,-2,67,30,37,0,0,0,2,0,2,4,4,0,49,16,33,0,0,0,11,9,2,0,0,0,1,1,0,0,0,0
228802,33000,330,0,-2,4,2,2,0,0,0,0,0,0,0,0,0,0,0,0,0,0,0,4,2,2,0,0,0,0,0,0,0,0,0
228866,33000,330,0,-2,2,0,2,0,0,0,0,0,0,0,0,0,1,0,1,0,0,0,1,0,1,0,0,0,0,0,0,0,0,0
228875,33000,330,0,-2,73,31,42,1,0,1,2,0,2,12,4,8,18,9,9,0,0,0,33,14,19,3,0,3,4,4,0,0,0,0
228884,33000,330,0,-2,1,1,0,0,0,0,0,0,0,1,1,0,0,0,0,0,0,0,0,0,0,0,0,0,0,0,0,0,0,0
228909,33000,330,0,-2,7,1,6,0,0,0,0,0,0,2,0,2,4,1,3,0,0,0,1,0,1,0,0,0,0,0,0,0,0,0
228981,33000,330,0,-2,3,3,0,0,0,0,0,0,0,0,0,0,0,0,0,0,0,0,3,3,0,0,0,0,0,0,0,0,0,0
229018,33000,330,0,-2,1,1,0,0,0,0,0,0,0,0,0,0,0,0,0,0,0,0,0,0,0,0,0,0,1,1,0,0,0,0
229027,33000,330,0,-2,58,29,29,0,0,0,3,1,2,6,6,0,20,10,10,0,0,0,14,6,8,1,0,1,12,6,6,2,0,2
229063,33000,330,0,-2,19,11,8,0,0,0,1,1,0,15,9,6,2,0,2,0,0,0,1,1,0,0,0,0,0,0,0,0,0,0
229090,33000,330,0,-2,7,2,5,0,0,0,0,0,0,0,0,0,3,0,3,0,0,0,4,2,2,0,0,0,0,0,0,0,0,0
229115,33000,330,0,-2,22,12,10,0,0,0,0,0,0,2,2,0,3,1,2,0,0,0,17,9,8,0,0,0,0,0,0,0,0,0
229160,33000,330,0,-2,16,7,9,0,0,0,0,0,0,4,1,3,2,2,0,0,0,0,10,4,6,0,0,0,0,0,0,0,0,0
229179,33000,330,0,-2,12,3,9,0,0,0,0,0,0,4,0,4,1,0,1,0,0,0,6,2,4,0,0,0,1,1,0,0,0,0
229267,33000,330,0,-2,13,4,9,0,0,0,0,0,0,2,1,1,4,1,3,0,0,0,7,2,5,0,0,0,0,0,0,0,0,0
229300,33000,330,0,-2,79,14,65,0,0,0,2,1,1,25,3,22,38,7,31,0,0,0,13,3,10,0,0,0,0,0,0,1,0,1
229337,33000,330,0,-2,5,1,4,0,0,0,0,0,0,1,0,1,2,0,2,0,0,0,2,1,1,0,0,0,0,0,0,0,0,0
229355,33000,330,0,-2,18,5,13,0,0,0,0,0,0,3,1,2,3,0,3,0,0,0,11,3,8,1,1,0,0,0,0,0,0,0
229504,33000,330,0,-2,7,3,4,0,0,0,0,0,0,0,0,0,0,0,0,0,0,0,6,2,4,1,1,0,0,0,0,0,0,0
229540,33000,330,0,-2,3,2,1,0,0,0,0,0,0,0,0,0,1,1,0,0,0,0,1,1,0,0,0,0,1,0,1,0,0,0
229780,33000,330,0,-2,3,2,1,0,0,0,0,0,0,2,1,1,1,1,0,0,0,0,0,0,0,0,0,0,0,0,0,0,0,0
229799,33000,330,0,-2,3,1,2,0,0,0,0,0,0,1,1,0,0,0,0,0,0,0,2,0,2,0,0,0,0,0,0,0,0,0
229814,33000,330,0,-2,18,7,11,0,0,0,0,0,0,3,1,2,3,2,1,0,0,0,12,4,8,0,0,0,0,0,0,0,0,0
229841,33000,330,0,-2,5,1,4,0,0,0,0,0,0,1,0,1,2,1,1,0,0,0,2,0,2,0,0,0,0,0,0,0,0,0
229887,33000,330,0,-2,3,1,2,0,0,0,0,0,0,2,1,1,0,0,0,0,0,0,1,0,1,0,0,0,0,0,0,0,0,0
230038,33000,330,0,-2,50,28,22,0,0,0,1,1,0,1,0,1,1,1,0,1,1,0,42,23,19,2,1,1,2,1,1,0,0,0
230047,33000,330,0,-2,2,1,1,0,0,0,0,0,0,0,0,0,0,0,0,2,1,1,0,0,0,0,0,0,0,0,0,0,0,0
230171,33000,330,0,-2,23,11,12,0,0,0,0,0,0,2,1,1,1,1,0,2,1,1,17,7,10,0,0,0,1,1,0,0,0,0
230597,33000,330,0,-2,1,1,0,0,0,0,0,0,0,0,0,0,0,0,0,0,0,0,1,1,0,0,0,0,0,0,0,0,0,0
230603,33000,330,0,-2,17,11,6,0,0,0,1,1,0,2,2,0,0,0,0,1,1,0,13,7,6,0,0,0,0,0,0,0,0,0
230728,33000,330,0,-2,97,44,53,3,1,2,3,1,2,10,10,0,6,1,5,2,2,0,70,27,43,1,1,0,2,1,1,0,0,0
230737,33000,330,0,-2,26,16,10,0,0,0,1,1,0,1,1,0,5,2,3,0,0,0,18,12,6,1,0,1,0,0,0,0,0,0
230746,33000,330,0,-2,41,21,20,1,1,0,3,0,3,1,1,0,10,6,4,0,0,0,24,12,12,2,1,1,0,0,0,0,0,0
230764,33000,330,0,-2,85,41,44,2,2,0,4,1,3,7,5,2,7,2,5,0,0,0,58,27,31,3,2,1,4,2,2,0,0,0
230782,33000,330,0,-2,5,2,3,0,0,0,1,0,1,0,0,0,1,0,1,0,0,0,3,2,1,0,0,0,0,0,0,0,0,0
230807,33000,330,0,-2,3,2,1,0,0,0,0,0,0,0,0,0,2,2,0,0,0,0,1,0,1,0,0,0,0,0,0,0,0,0
230816,33000,330,0,-2,6,1,5,0,0,0,0,0,0,0,0,0,1,0,1,0,0,0,5,1,4,0,0,0,0,0,0,0,0,0
230834,33000,330,0,-2,2,1,1,0,0,0,0,0,0,0,0,0,0,0,0,0,0,0,1,0,1,0,0,0,1,1,0,0,0,0
230852,33000,330,0,-2,7,4,3,0,0,0,0,0,0,0,0,0,0,0,0,0,0,0,6,3,3,0,0,0,1,1,0,0,0,0
230913,33000,330,0,-2,1,1,0,0,0,0,1,1,0,0,0,0,0,0,0,0,0,0,0,0,0,0,0,0,0,0,0,0,0,0
230959,33000,330,0,-2,12,5,7,0,0,0,0,0,0,0,0,0,0,0,0,0,0,0,8,3,5,0,0,0,3,2,1,1,0,1
230995,33000,330,0,-2,18,9,9,0,0,0,0,0,0,1,1,0,0,0,0,0,0,0,14,7,7,0,0,0,3,1,2,0,0,0
231059,33000,330,0,-2,7,2,5,0,0,0,1,0,1,0,0,0,1,0,1,0,0,0,2,1,1,1,0,1,2,1,1,0,0,0
231165,33000,330,0,-2,1,0,1,0,0,0,0,0,0,0,0,0,0,0,0,0,0,0,1,0,1,0,0,0,0,0,0,0,0,0
231174,33000,330,0,-2,15,10,5,0,0,0,0,0,0,1,1,0,0,0,0,0,0,0,12,9,3,0,0,0,2,0,2,0,0,0
231420,33000,330,0,-2,12,8,4,0,0,0,0,0,0,4,2,2,0,0,0,0,0,0,8,6,2,0,0,0,0,0,0,0,0,0
231554,33000,330,0,-2,3,2,1,0,0,0,0,0,0,1,1,0,0,0,0,0,0,0,2,1,1,0,0,0,0,0,0,0,0,0
231581,33000,330,0,-2,17,9,8,0,0,0,0,0,0,1,0,1,0,0,0,0,0,0,15,8,7,0,0,0,1,1,0,0,0,0
231624,33000,330,0,-2,21,6,15,0,0,0,0,0,0,3,0,3,0,0,0,0,0,0,17,6,11,0,0,0,1,0,1,0,0,0
231651,33000,330,0,-2,45,13,32,0,0,0,0,0,0,16,5,11,1,0,1,1,0,1,27,8,19,0,0,0,0,0,0,0,0,0
231785,33000,330,0,-2,14,4,10,0,0,0,0,0,0,7,1,6,1,0,1,0,0,0,5,2,3,0,0,0,1,1,0,0,0,0
231970,33000,330,0,-2,9,1,8,0,0,0,0,0,0,5,1,4,0,0,0,0,0,0,3,0,3,1,0,1,0,0,0,0,0,0
232025,33000,330,0,-2,22,11,11,0,0,0,0,0,0,1,0,1,0,0,0,0,0,0,6,2,4,0,0,0,15,9,6,0,0,0
232043,33000,330,0,-2,3,2,1,0,0,0,0,0,0,0,0,0,0,0,0,0,0,0,3,2,1,0,0,0,0,0,0,0,0,0
232089,33000,330,0,-2,6,6,0,0,0,0,1,1,0,0,0,0,0,0,0,0,0,0,4,4,0,0,0,0,1,1,0,0,0,0
232186,33000,330,0,-2,71,25,46,0,0,0,6,0,6,16,4,12,7,2,5,0,0,0,37,17,20,4,1,3,1,1,0,0,0,0
232195,33000,330,0,-2,1,1,0,0,0,0,0,0,0,0,0,0,0,0,0,0,0,0,1,1,0,0,0,0,0,0,0,0,0,0
232256,33000,330,0,-2,2,1,1,0,0,0,0,0,0,0,0,0,0,0,0,0,0,0,2,1,1,0,0,0,0,0,0,0,0,0
232265,33000,330,0,-2,6,4,2,0,0,0,0,0,0,6,4,2,0,0,0,0,0,0,0,0,0,0,0,0,0,0,0,0,0,0
232423,33000,330,0,-2,22,12,10,0,0,0,0,0,0,3,2,1,0,0,0,0,0,0,19,10,9,0,0,0,0,0,0,0,0,0
232557,33000,330,0,-2,226,94,132,1,0,1,9,5,4,25,7,18,8,5,3,0,0,0,179,75,104,0,0,0,3,1,2,1,1,0
232566,33000,330,0,-2,10,4,6,0,0,0,0,0,0,3,0,3,0,0,0,0,0,0,7,4,3,0,0,0,0,0,0,0,0,0
232575,33000,330,0,-2,1,1,0,0,0,0,0,0,0,0,0,0,0,0,0,0,0,0,1,1,0,0,0,0,0,0,0,0,0,0
232609,33000,330,0,-2,7,2,5,0,0,0,0,0,0,1,0,1,0,0,0,0,0,0,4,2,2,0,0,0,2,0,2,0,0,0
232672,33000,330,0,-2,14,5,9,0,0,0,0,0,0,3,1,2,0,0,0,0,0,0,10,4,6,1,0,1,0,0,0,0,0,0
232681,33000,330,0,-2,4,1,3,0,0,0,0,0,0,0,0,0,0,0,0,0,0,0,2,0,2,0,0,0,2,1,1,0,0,0
232706,33000,330,0,-2,11,4,7,0,0,0,1,0,1,1,1,0,1,1,0,0,0,0,8,2,6,0,0,0,0,0,0,0,0,0
232946,33000,330,0,-2,4,2,2,0,0,0,0,0,0,0,0,0,1,1,0,0,0,0,2,1,1,0,0,0,1,0,1,0,0,0
232982,33000,330,0,-2,25,12,13,0,0,0,0,0,0,13,6,7,2,1,1,0,0,0,10,5,5,0,0,0,0,0,0,0,0,0
233037,33000,330,0,-2,1,1,0,0,0,0,0,0,0,0,0,0,0,0,0,0,0,0,1,1,0,0,0,0,0,0,0,0,0,0
233277,33000,330,0,-2,29,20,9,0,0,0,0,0,0,4,4,0,1,0,1,0,0,0,23,16,7,1,0,1,0,0,0,0,0,0
233295,33000,330,0,-2,18,10,8,0,0,0,1,0,1,1,1,0,0,0,0,0,0,0,16,9,7,0,0,0,0,0,0,0,0,0
233301,33000,330,0,-2,6,2,4,0,0,0,0,0,0,0,0,0,0,0,0,0,0,0,5,1,4,1,1,0,0,0,0,0,0,0
233310,33000,330,0,-2,1,1,0,0,0,0,0,0,0,0,0,0,0,0,0,0,0,0,1,1,0,0,0,0,0,0,0,0,0,0
233329,33000,330,0,-2,1,0,1,0,0,0,0,0,0,1,0,1,0,0,0,0,0,0,0,0,0,0,0,0,0,0,0,0,0,0
233374,33000,330,0,-2,23,16,7,0,0,0,1,1,0,7,6,1,1,0,1,0,0,0,13,8,5,0,0,0,1,1,0,0,0,0
233426,33000,330,0,-2,7,3,4,0,0,0,0,0,0,1,0,1,0,0,0,0,0,0,6,3,3,0,0,0,0,0,0,0,0,0
233541,33000,330,0,-2,11,5,6,0,0,0,1,0,1,0,0,0,1,0,1,0,0,0,7,4,3,0,0,0,1,1,0,1,0,1
233639,33000,330,0,-2,1,0,1,0,0,0,0,0,0,0,0,0,0,0,0,0,0,0,1,0,1,0,0,0,0,0,0,0,0,0
233718,33000,330,0,-2,2,1,1,0,0,0,0,0,0,0,0,0,0,0,0,0,0,0,2,1,1,0,0,0,0,0,0,0,0,0
233772,33000,330,0,-2,2,0,2,0,0,0,0,0,0,1,0,1,0,0,0,0,0,0,1,0,1,0,0,0,0,0,0,0,0,0
233897,33000,330,0,-2,5,4,1,0,0,0,0,0,0,1,1,0,0,0,0,0,0,0,3,2,1,0,0,0,1,1,0,0,0,0
233921,33000,330,0,-2,15,5,10,0,0,0,0,0,0,0,0,0,0,0,0,0,0,0,15,5,10,0,0,0,0,0,0,0,0,0
234030,33000,330,0,-2,97,31,66,0,0,0,4,1,3,23,7,16,7,3,4,0,0,0,57,16,41,4,3,1,0,0,0,2,1,1
234076,33000,330,0,-2,62,25,37,0,0,0,0,0,0,12,3,9,3,0,3,1,1,0,38,18,20,3,0,3,5,3,2,0,0,0
234085,33000,330,0,-2,9,7,2,0,0,0,0,0,0,3,2,1,0,0,0,0,0,0,6,5,1,0,0,0,0,0,0,0,0,0
234155,33000,330,0,-2,5,4,1,0,0,0,0,0,0,5,4,1,0,0,0,0,0,0,0,0,0,0,0,0,0,0,0,0,0,0
234173,33000,330,0,-2,4,2,2,0,0,0,0,0,0,0,0,0,0,0,0,0,0,0,3,1,2,1,1,0,0,0,0,0,0,0
234207,33000,330,0,-2,17,9,8,0,0,0,0,0,0,3,1,2,1,1,0,0,0,0,10,4,6,2,2,0,1,1,0,0,0,0
234711,33000,330,0,-2,1,0,1,0,0,0,0,0,0,0,0,0,0,0,0,0,0,0,1,0,1,0,0,0,0,0,0,0,0,0
234827,33000,330,0,-2,16,6,10,0,0,0,1,0,1,0,0,0,0,0,0,0,0,0,14,6,8,1,0,1,0,0,0,0,0,0
234845,33000,330,0,-2,5,3,2,0,0,0,0,0,0,0,0,0,0,0,0,0,0,0,4,2,2,0,0,0,1,1,0,0,0,0
234979,33000,330,0,-2,1,0,1,0,0,0,1,0,1,0,0,0,0,0,0,0,0,0,0,0,0,0,0,0,0,0,0,0,0,0
235024,33000,330,0,-2,3,2,1,0,0,0,0,0,0,2,1,1,0,0,0,0,0,0,1,1,0,0,0,0,0,0,0,0,0,0
235097,33000,330,0,-2,17,11,6,0,0,0,1,0,1,3,3,0,2,1,1,0,0,0,10,6,4,1,1,0,0,0,0,0,0,0
235103,33000,330,0,-2,8,3,5,0,0,0,1,0,1,0,0,0,0,0,0,0,0,0,2,0,2,0,0,0,5,3,2,0,0,0
235149,33000,330,0,-2,2,0,2,0,0,0,0,0,0,0,0,0,0,0,0,0,0,0,1,0,1,1,0,1,0,0,0,0,0,0
235167,33000,330,0,-2,5,0,5,0,0,0,0,0,0,0,0,0,1,0,1,0,0,0,1,0,1,0,0,0,3,0,3,0,0,0
235316,33000,330,0,-2,14,6,8,0,0,0,0,0,0,1,0,1,0,0,0,0,0,0,9,4,5,0,0,0,3,1,2,1,1,0
235343,33000,330,0,-2,1,1,0,0,0,0,1,1,0,0,0,0,0,0,0,0,0,0,0,0,0,0,0,0,0,0,0,0,0,0
235431,33000,330,0,-2,6,1,5,0,0,0,0,0,0,2,0,2,0,0,0,0,0,0,3,1,2,1,0,1,0,0,0,0,0,0
235699,33000,330,0,-2,8,2,6,0,0,0,1,0,1,2,0,2,1,1,0,0,0,0,3,1,2,1,0,1,0,0,0,0,0,0
236072,33000,330,0,-2,1,1,0,0,0,0,0,0,0,0,0,0,0,0,0,0,0,0,1,1,0,0,0,0,0,0,0,0,0,0
236188,33000,330,0,-2,3,3,0,0,0,0,0,0,0,0,0,0,0,0,0,0,0,0,2,2,0,1,1,0,0,0,0,0,0,0
236212,33000,330,0,-2,1,1,0,0,0,0,0,0,0,0,0,0,1,1,0,0,0,0,0,0,0,0,0,0,0,0,0,0,0,0
236230,33000,330,0,-2,4,0,4,0,0,0,1,0,1,0,0,0,1,0,1,0,0,0,2,0,2,0,0,0,0,0,0,0,0,0
236258,33000,330,0,-2,3,0,3,0,0,0,0,0,0,0,0,0,0,0,0,0,0,0,2,0,2,1,0,1,0,0,0,0,0,0
236328,33000,330,0,-2,6,2,4,0,0,0,0,0,0,0,0,0,1,1,0,0,0,0,4,1,3,0,0,0,1,0,1,0,0,0
236382,33000,330,0,-2,3,1,2,0,0,0,0,0,0,0,0,0,0,0,0,0,0,0,3,1,2,0,0,0,0,0,0,0,0,0
236452,33000,330,0,-2,6,1,5,0,0,0,1,1,0,2,0,2,0,0,0,0,0,0,3,0,3,0,0,0,0,0,0,0,0,0
236504,33000,330,0,-2,1,1,0,0,0,0,0,0,0,0,0,0,0,0,0,0,0,0,0,0,0,0,0,0,1,1,0,0,0,0
236513,33000,330,0,-2,8,6,2,0,0,0,1,1,0,0,0,0,0,0,0,0,0,0,0,0,0,1,1,0,6,4,2,0,0,0
236595,33000,330,0,-2,34,11,23,0,0,0,5,1,4,4,2,2,2,0,2,1,0,1,17,6,11,0,0,0,5,2,3,0,0,0
236638,33000,330,0,-2,1,0,1,0,0,0,0,0,0,0,0,0,0,0,0,0,0,0,1,0,1,0,0,0,0,0,0,0,0,0
236656,33000,330,0,-2,1,0,1,0,0,0,1,0,1,0,0,0,0,0,0,0,0,0,0,0,0,0,0,0,0,0,0,0,0,0
236692,33000,330,0,-2,8,4,4,0,0,0,0,0,0,0,0,0,2,1,1,0,0,0,3,0,3,0,0,0,3,3,0,0,0,0
236753,33000,330,0,-2,4,3,1,0,0,0,0,0,0,0,0,0,0,0,0,0,0,0,3,2,1,0,0,0,1,1,0,0,0,0
236887,33000,330,0,-2,1,1,0,0,0,0,0,0,0,0,0,0,1,1,0,0,0,0,0,0,0,0,0,0,0,0,0,0,0,0
236939,33000,330,0,-2,36,17,19,0,0,0,2,0,2,1,0,1,6,3,3,1,1,0,17,8,9,2,1,1,7,4,3,0,0,0
236948,33000,330,0,-2,80,39,41,0,0,0,6,2,4,9,4,5,8,4,4,0,0,0,44,23,21,6,3,3,5,3,2,2,0,2
236975,33000,330,0,-2,8,4,4,1,0,1,0,0,0,0,0,0,4,2,2,0,0,0,3,2,1,0,0,0,0,0,0,0,0,0
237011,33000,330,0,-2,6,2,4,0,0,0,0,0,0,0,0,0,0,0,0,0,0,0,5,1,4,1,1,0,0,0,0,0,0,0
237057,33000,330,0,-2,10,3,7,0,0,0,1,1,0,2,1,1,1,0,1,0,0,0,5,1,4,0,0,0,1,0,1,0,0,0
237066,33000,330,0,-2,3,1,2,0,0,0,0,0,0,1,0,1,0,0,0,0,0,0,2,1,1,0,0,0,0,0,0,0,0,0
237118,33000,330,0,-2,4,2,2,0,0,0,0,0,0,0,0,0,0,0,0,0,0,0,3,2,1,1,0,1,0,0,0,0,0,0
237181,33000,330,0,-2,2,2,0,0,0,0,0,0,0,0,0,0,0,0,0,0,0,0,2,2,0,0,0,0,0,0,0,0,0,0
237312,33000,330,0,-2,9,9,0,0,0,0,0,0,0,1,1,0,0,0,0,0,0,0,8,8,0,0,0,0,0,0,0,0,0,0
237330,33000,330,0,-2,4,1,3,0,0,0,0,0,0,0,0,0,0,0,0,0,0,0,4,1,3,0,0,0,0,0,0,0,0,0
237358,33000,330,0,-2,6,5,1,0,0,0,0,0,0,0,0,0,0,0,0,0,0,0,6,5,1,0,0,0,0,0,0,0,0,0
237367,33000,330,0,-2,9,7,2,0,0,0,0,0,0,2,2,0,1,1,0,0,0,0,6,4,2,0,0,0,0,0,0,0,0,0
237525,33000,330,0,-2,37,29,8,0,0,0,1,1,0,7,6,1,2,1,1,0,0,0,26,20,6,0,0,0,1,1,0,0,0,0
237701,33000,330,0,-2,1,0,1,0,0,0,0,0,0,0,0,0,0,0,0,0,0,0,1,0,1,0,0,0,0,0,0,0,0,0
237783,33000,330,0,-2,5,4,1,0,0,0,0,0,0,0,0,0,0,0,0,0,0,0,4,3,1,0,0,0,1,1,0,0,0,0
237792,33000,330,0,-2,13,7,6,0,0,0,0,0,0,2,1,1,0,0,0,0,0,0,10,5,5,0,0,0,0,0,0,1,1,0
237817,33000,330,0,-2,2,2,0,0,0,0,0,0,0,0,0,0,0,0,0,0,0,0,2,2,0,0,0,0,0,0,0,0,0,0
237880,33000,330,0,-2,2,2,0,0,0,0,0,0,0,0,0,0,0,0,0,0,0,0,2,2,0,0,0,0,0,0,0,0,0,0
237899,33000,330,0,-2,8,4,4,0,0,0,0,0,0,4,2,2,0,0,0,0,0,0,3,2,1,0,0,0,1,0,1,0,0,0
237932,33000,330,0,-2,5,4,1,0,0,0,0,0,0,2,2,0,0,0,0,0,0,0,3,2,1,0,0,0,0,0,0,0,0,0
237950,33000,330,0,-2,5,3,2,0,0,0,0,0,0,1,0,1,0,0,0,0,0,0,4,3,1,0,0,0,0,0,0,0,0,0
237969,33000,330,0,-2,10,7,3,0,0,0,0,0,0,0,0,0,0,0,0,0,0,0,9,6,3,0,0,0,1,1,0,0,0,0
238032,33000,330,0,-2,60,29,31,0,0,0,1,0,1,8,7,1,2,0,2,0,0,0,41,19,22,0,0,0,8,3,5,0,0,0
238078,33000,330,0,-2,4,4,0,0,0,0,0,0,0,2,2,0,0,0,0,0,0,0,2,2,0,0,0,0,0,0,0,0,0,0
238193,33000,330,0,-2,7,0,7,0,0,0,0,0,0,1,0,1,2,0,2,0,0,0,4,0,4,0,0,0,0,0,0,0,0,0
238263,33000,330,0,-2,11,1,10,0,0,0,3,0,3,1,0,1,1,0,1,0,0,0,6,1,5,0,0,0,0,0,0,0,0,0
238324,33000,330,0,-2,1,0,1,0,0,0,0,0,0,0,0,0,0,0,0,0,0,0,1,0,1,0,0,0,0,0,0,0,0,0
238333,33000,330,0,-2,2,2,0,0,0,0,0,0,0,0,0,0,0,0,0,0,0,0,2,2,0,0,0,0,0,0,0,0,0,0
238397,33000,330,0,-2,2,1,1,0,0,0,0,0,0,0,0,0,1,0,1,0,0,0,1,1,0,0,0,0,0,0,0,0,0,0
238430,33000,330,0,-2,6,2,4,0,0,0,0,0,0,0,0,0,0,0,0,0,0,0,6,2,4,0,0,0,0,0,0,0,0,0
238458,33000,330,0,-2,18,7,11,0,0,0,0,0,0,4,4,0,1,1,0,0,0,0,11,2,9,0,0,0,1,0,1,1,0,1
238476,33000,330,0,-2,5,2,3,0,0,0,1,1,0,0,0,0,0,0,0,0,0,0,4,1,3,0,0,0,0,0,0,0,0,0
238616,33000,330,0,-2,8,6,2,0,0,0,0,0,0,0,0,0,0,0,0,0,0,0,8,6,2,0,0,0,0,0,0,0,0,0
238661,33000,330,0,-2,3,0,3,0,0,0,0,0,0,1,0,1,0,0,0,0,0,0,2,0,2,0,0,0,0,0,0,0,0,0
238759,33000,330,0,-2,2,0,2,0,0,0,0,0,0,0,0,0,0,0,0,0,0,0,2,0,2,0,0,0,0,0,0,0,0,0
238980,33000,330,0,-2,2,0,2,0,0,0,0,0,0,0,0,0,0,0,0,0,0,0,0,0,0,0,0,0,2,0,2,0,0,0
239008,33000,330,0,-2,2,0,2,0,0,0,0,0,0,0,0,0,0,0,0,0,0,0,2,0,2,0,0,0,0,0,0,0,0,0
239017,33000,330,0,-2,10,5,5,0,0,0,1,0,1,0,0,0,0,0,0,0,0,0,8,4,4,0,0,0,1,1,0,0,0,0
239080,33000,330,0,-2,9,4,5,0,0,0,0,0,0,1,1,0,1,0,1,0,0,0,6,3,3,0,0,0,1,0,1,0,0,0
239105,33000,330,0,-2,19,8,11,0,0,0,1,0,1,1,1,0,3,1,2,0,0,0,12,5,7,2,1,1,0,0,0,0,0,0
239169,33000,330,0,-2,3,0,3,0,0,0,0,0,0,2,0,2,0,0,0,0,0,0,1,0,1,0,0,0,0,0,0,0,0,0
239220,33000,330,0,-2,4,1,3,0,0,0,0,0,0,0,0,0,0,0,0,0,0,0,4,1,3,0,0,0,0,0,0,0,0,0
239248,33000,330,0,-2,2,1,1,0,0,0,0,0,0,0,0,0,1,0,1,0,0,0,1,1,0,0,0,0,0,0,0,0,0,0
239309,33000,330,0,-2,5,2,3,0,0,0,0,0,0,0,0,0,1,0,1,0,0,0,4,2,2,0,0,0,0,0,0,0,0,0
239318,33000,330,0,-2,6,6,0,0,0,0,0,0,0,0,0,0,0,0,0,1,1,0,5,5,0,0,0,0,0,0,0,0,0,0
239372,33000,330,0,-2,1,0,1,0,0,0,0,0,0,0,0,0,0,0,0,0,0,0,1,0,1,0,0,0,0,0,0,0,0,0
239390,33000,330,0,-2,2,1,1,0,0,0,0,0,0,0,0,0,0,0,0,0,0,0,2,1,1,0,0,0,0,0,0,0,0,0
239460,33000,330,0,-2,3,0,3,0,0,0,1,0,1,0,0,0,0,0,0,0,0,0,2,0,2,0,0,0,0,0,0,0,0,0
239488,33000,330,0,-2,3,1,2,0,0,0,0,0,0,1,1,0,0,0,0,0,0,0,2,0,2,0,0,0,0,0,0,0,0,0
239512,33000,330,0,-2,2,1,1,0,0,0,0,0,0,0,0,0,0,0,0,0,0,0,2,1,1,0,0,0,0,0,0,0,0,0
239628,33000,330,0,-2,4,2,2,0,0,0,0,0,0,0,0,0,1,1,0,0,0,0,3,1,2,0,0,0,0,0,0,0,0,0
239716,33000,330,0,-2,3,1,2,0,0,0,0,0,0,0,0,0,0,0,0,0,0,0,3,1,2,0,0,0,0,0,0,0,0,0
240107,33000,330,0,-2,10,0,10,1,0,1,0,0,0,0,0,0,0,0,0,0,0,0,9,0,9,0,0,0,0,0,0,0,0,0
240116,33000,330,0,-2,10,3,7,0,0,0,1,0,1,0,0,0,0,0,0,0,0,0,9,3,6,0,0,0,0,0,0,0,0,0
240125,33000,330,0,-2,1,1,0,0,0,0,0,0,0,0,0,0,0,0,0,0,0,0,0,0,0,0,0,0,1,1,0,0,0,0
240198,33000,330,0,-2,1,0,1,0,0,0,0,0,0,0,0,0,0,0,0,0,0,0,1,0,1,0,0,0,0,0,0,0,0,0
240268,33000,330,0,-2,13,4,9,0,0,0,1,1,0,1,0,1,0,0,0,0,0,0,8,3,5,1,0,1,2,0,2,0,0,0
240277,33000,330,0,-2,27,7,20,0,0,0,6,0,6,1,0,1,4,1,3,0,0,0,15,5,10,1,1,0,0,0,0,0,0,0
240338,33000,330,0,-2,2,1,1,0,0,0,0,0,0,1,1,0,0,0,0,0,0,0,1,0,1,0,0,0,0,0,0,0,0,0
240365,33000,330,0,-2,21,9,12,1,1,0,0,0,0,0,0,0,0,0,0,0,0,0,13,5,8,1,1,0,6,2,4,0,0,0
240374,33000,330,0,-2,13,4,9,0,0,0,0,0,0,2,1,1,1,0,1,0,0,0,8,3,5,0,0,0,1,0,1,1,0,1
240392,33000,330,0,-2,1,1,0,0,0,0,0,0,0,0,0,0,0,0,0,0,0,0,1,1,0,0,0,0,0,0,0,0,0,0
240426,33000,330,0,-2,12,7,5,0,0,0,1,1,0,0,0,0,1,0,1,0,0,0,8,6,2,2,0,2,0,0,0,0,0,0
240435,33000,330,0,-2,66,17,49,0,0,0,3,1,2,1,1,0,2,0,2,0,0,0,51,11,40,2,1,1,7,3,4,0,0,0
240444,33000,330,0,-2,129,46,83,1,0,1,11,3,8,13,8,5,12,4,8,0,0,0,83,25,58,0,0,0,8,6,2,1,0,1
240453,33000,330,0,-2,29,6,23,0,0,0,1,0,1,4,1,3,2,0,2,0,0,0,21,5,16,1,0,1,0,0,0,0,0,0
240462,33000,330,0,-2,7,1,6,0,0,0,0,0,0,0,0,0,1,0,1,0,0,0,5,1,4,0,0,0,1,0,1,0,0,0
240471,33000,330,0,-2,10,3,7,0,0,0,1,0,1,0,0,0,0,0,0,0,0,0,8,3,5,1,0,1,0,0,0,0,0,0
240480,33000,330,0,-2,11,5,6,0,0,0,1,0,1,0,0,0,0,0,0,0,0,0,9,5,4,1,0,1,0,0,0,0,0,0
240505,33000,330,0,-2,1,0,1,0,0,0,0,0,0,0,0,0,0,0,0,0,0,0,0,0,0,0,0,0,0,0,0,1,0,1
240514,33000,330,0,-2,2,2,0,0,0,0,1,1,0,0,0,0,0,0,0,0,0,0,1,1,0,0,0,0,0,0,0,0,0,0
240620,33000,330,0,-2,2,0,2,0,0,0,0,0,0,1,0,1,1,0,1,0,0,0,0,0,0,0,0,0,0,0,0,0,0,0
240657,33000,330,0,-2,3,3,0,0,0,0,0,0,0,0,0,0,0,0,0,0,0,0,3,3,0,0,0,0,0,0,0,0,0,0
240727,33000,330,0,-2,41,21,20,0,0,0,1,0,1,3,3,0,2,2,0,0,0,0,28,12,16,0,0,0,7,4,3,0,0,0
240754,33000,330,0,-2,4,0,4,0,0,0,1,0,1,0,0,0,0,0,0,3,0,3,0,0,0,0,0,0,0,0,0,0,0,0
240790,33000,330,0,-2,4,1,3,0,0,0,2,0,2,0,0,0,0,0,0,2,1,1,0,0,0,0,0,0,0,0,0,0,0,0
241225,33000,330,0,-2,2,2,0,0,0,0,0,0,0,0,0,0,2,2,0,0,0,0,0,0,0,0,0,0,0,0,0,0,0,0
241377,33000,330,0,-2,1,1,0,0,0,0,0,0,0,0,0,0,1,1,0,0,0,0,0,0,0,0,0,0,0,0,0,0,0,0
241410,33000,330,0,-2,2,0,2,0,0,0,0,0,0,0,0,0,2,0,2,0,0,0,0,0,0,0,0,0,0,0,0,0,0,0
241836,33000,330,0,-2,1,0,1,0,0,0,0,0,0,0,0,0,1,0,1,0,0,0,0,0,0,0,0,0,0,0,0,0,0,0
242060,33000,330,0,-2,1,0,1,0,0,0,0,0,0,0,0,0,1,0,1,0,0,0,0,0,0,0,0,0,0,0,0,0,0,0
242972,33000,330,0,-2,40,6,34,0,0,0,0,0,0,0,0,0,40,6,34,0,0,0,0,0,0,0,0,0,0,0,0,0,0,0
243081,33000,330,0,-2,3,0,3,0,0,0,0,0,0,0,0,0,3,0,3,0,0,0,0,0,0,0,0,0,0,0,0,0,0,0
243197,33000,330,0,-2,2,1,1,0,0,0,0,0,0,0,0,0,0,0,0,0,0,0,0,0,0,0,0,0,2,1,1,0,0,0
243443,33000,330,0,-2,1,0,1,0,0,0,0,0,0,0,0,0,1,0,1,0,0,0,0,0,0,0,0,0,0,0,0,0,0,0
243568,33000,330,0,-2,6,4,2,0,0,0,0,0,0,0,0,0,6,4,2,0,0,0,0,0,0,0,0,0,0,0,0,0,0,0
243647,33000,330,0,-2,1,0,1,0,0,0,0,0,0,0,0,0,0,0,0,1,0,1,0,0,0,0,0,0,0,0,0,0,0,0
243744,33000,330,0,-2,137,49,88,0,0,0,13,3,10,8,5,3,11,3,8,0,0,0,43,16,27,4,0,4,56,22,34,2,0,2
243780,33000,330,0,-2,84,35,49,0,0,0,3,1,2,8,5,3,6,2,4,0,0,0,62,25,37,1,0,1,3,2,1,1,0,1
243823,33000,330,0,-2,1,1,0,0,0,0,0,0,0,0,0,0,0,0,0,0,0,0,0,0,0,0,0,0,1,1,0,0,0,0
244233,33000,330,0,-2,1,1,0,0,0,0,0,0,0,1,1,0,0,0,0,0,0,0,0,0,0,0,0,0,0,0,0,0,0,0
246354,33000,330,0,-2,3,1,2,0,0,0,0,0,0,0,0,0,3,1,2,0,0,0,0,0,0,0,0,0,0,0,0,0,0,0
247649,33000,330,0,-2,3,1,2,0,0,0,0,0,0,0,0,0,0,0,0,0,0,0,3,1,2,0,0,0,0,0,0,0,0,0
247834,33000,330,0,-2,3,2,1,0,0,0,0,0,0,2,1,1,0,0,0,0,0,0,1,1,0,0,0,0,0,0,0,0,0,0
247940,33000,330,0,-2,4,1,3,0,0,0,0,0,0,0,0,0,0,0,0,0,0,0,4,1,3,0,0,0,0,0,0,0,0,0
248934,33000,330,0,-2,7,2,5,0,0,0,1,0,1,1,0,1,1,0,1,0,0,0,4,2,2,0,0,0,0,0,0,0,0,0
251260,33000,330,0,-2,3,3,0,0,0,0,0,0,0,1,1,0,0,0,0,0,0,0,2,2,0,0,0,0,0,0,0,0,0,0
262031,33000,330,0,-2,2,2,0,0,0,0,0,0,0,0,0,0,0,0,0,0,0,0,2,2,0,0,0,0,0,0,0,0,0,0
262086,33000,330,0,-2,19,6,13,0,0,0,3,2,1,2,0,2,5,2,3,0,0,0,7,2,5,1,0,1,0,0,0,1,0,1
262129,33000,330,0,-2,5,1,4,0,0,0,0,0,0,1,0,1,0,0,0,0,0,0,4,1,3,0,0,0,0,0,0,0,0,0
363633,33000,330,0,-2,1,1,0,0,0,0,0,0,0,0,0,0,1,1,0,0,0,0,0,0,0,0,0,0,0,0,0,0,0,0
363934,33000,330,0,-2,2,0,2,0,0,0,0,0,0,0,0,0,0,0,0,0,0,0,2,0,2,0,0,0,0,0,0,0,0,0
364025,33000,330,0,-2,2,2,0,0,0,0,0,0,0,0,0,0,0,0,0,0,0,0,2,2,0,0,0,0,0,0,0,0,0,0
366252,33000,330,0,-2,6,2,4,0,0,0,1,0,1,0,0,0,0,0,0,0,0,0,3,1,2,0,0,0,2,1,1,0,0,0
366340,33000,330,0,-2,3,1,2,3,1,2,0,0,0,0,0,0,0,0,0,0,0,0,0,0,0,0,0,0,0,0,0,0,0,0
366395,33000,330,0,-2,1,1,0,0,0,0,0,0,0,0,0,0,0,0,0,0,0,0,1,1,0,0,0,0,0,0,0,0,0,0
366465,33000,330,0,-2,1,0,1,0,0,0,0,0,0,1,0,1,0,0,0,0,0,0,0,0,0,0,0,0,0,0,0,0,0,0
366711,33000,330,0,-2,9,4,5,1,1,0,0,0,0,2,1,1,2,0,2,0,0,0,3,2,1,0,0,0,1,0,1,0,0,0
367459,33000,330,0,-2,5,1,4,0,0,0,0,0,0,0,0,0,0,0,0,0,0,0,5,1,4,0,0,0,0,0,0,0,0,0
367954,33000,330,0,-2,5,4,1,0,0,0,1,1,0,1,1,0,0,0,0,0,0,0,3,2,1,0,0,0,0,0,0,0,0,0
372921,33000,330,0,-2,1,1,0,0,0,0,0,0,0,0,0,0,0,0,0,0,0,0,0,0,0,1,1,0,0,0,0,0,0,0
376224,33000,330,0,-2,1,0,1,0,0,0,0,0,0,0,0,0,1,0,1,0,0,0,0,0,0,0,0,0,0,0,0,0,0,0
376695,33000,330,0,-2,4,3,1,0,0,0,0,0,0,0,0,0,0,0,0,4,3,1,0,0,0,0,0,0,0,0,0,0,0,0
377564,33000,330,0,-2,1,0,1,0,0,0,0,0,0,0,0,0,0,0,0,0,0,0,1,0,1,0,0,0,0,0,0,0,0,0
378576,33000,330,0,-2,1,0,1,0,0,0,0,0,0,0,0,0,0,0,0,0,0,0,0,0,0,0,0,0,1,0,1,0,0,0
380359,33000,330,0,-2,1,1,0,1,1,0,0,0,0,0,0,0,0,0,0,0,0,0,0,0,0,0,0,0,0,0,0,0,0,0
380368,33000,330,0,-2,1,0,1,0,0,0,0,0,0,0,0,0,0,0,0,0,0,0,1,0,1,0,0,0,0,0,0,0,0,0
380377,33000,330,0,-2,1,0,1,1,0,1,0,0,0,0,0,0,0,0,0,0,0,0,0,0,0,0,0,0,0,0,0,0,0,0
383996,33000,330,0,-2,1,0,1,0,0,0,0,0,0,1,0,1,0,0,0,0,0,0,0,0,0,0,0,0,0,0,0,0,0,0
384254,33000,330,0,-2,4,0,4,0,0,0,0,0,0,1,0,1,1,0,1,0,0,0,2,0,2,0,0,0,0,0,0,0,0,0
384342,33000,330,0,-2,1,1,0,0,0,0,0,0,0,0,0,0,1,1,0,0,0,0,0,0,0,0,0,0,0,0,0,0,0,0
385415,33000,330,0,-2,2,2,0,0,0,0,0,0,0,0,0,0,1,1,0,0,0,0,1,1,0,0,0,0,0,0,0,0,0,0
385503,33000,330,0,-2,1,1,0,0,0,0,0,0,0,0,0,0,0,0,0,0,0,0,1,1,0,0,0,0,0,0,0,0,0,0
392415,33000,330,0,-2,1,0,1,0,0,0,0,0,0,0,0,0,1,0,1,0,0,0,0,0,0,0,0,0,0,0,0,0,0,0
399212,33000,330,0,-2,1,1,0,0,0,0,0,0,0,0,0,0,0,0,0,0,0,0,1,1,0,0,0,0,0,0,0,0,0,0
399911,33000,330,0,-2,2,0,2,0,0,0,1,0,1,0,0,0,0,0,0,0,0,0,1,0,1,0,0,0,0,0,0,0,0,0
403478,33000,330,0,-2,5,5,0,0,0,0,0,0,0,1,1,0,0,0,0,0,0,0,4,4,0,0,0,0,0,0,0,0,0,0
403487,33000,330,0,-2,3,2,1,0,0,0,0,0,0,0,0,0,0,0,0,0,0,0,3,2,1,0,0,0,0,0,0,0,0,0
404426,33000,330,0,-2,1,1,0,1,1,0,0,0,0,0,0,0,0,0,0,0,0,0,0,0,0,0,0,0,0,0,0,0,0,0
405872,33000,330,0,-2,1,0,1,0,0,0,0,0,0,0,0,0,0,0,0,0,0,0,1,0,1,0,0,0,0,0,0,0,0,0
407629,33000,330,0,-2,1,0,1,0,0,0,0,0,0,0,0,0,0,0,0,0,0,0,1,0,1,0,0,0,0,0,0,0,0,0
408844,33000,330,0,-2,8,7,1,0,0,0,0,0,0,1,1,0,7,6,1,0,0,0,0,0,0,0,0,0,0,0,0,0,0,0
409254,33000,330,0,-2,6,0,6,0,0,0,0,0,0,2,0,2,1,0,1,0,0,0,3,0,3,0,0,0,0,0,0,0,0,0
409315,33000,330,0,-2,1,1,0,0,0,0,0,0,0,0,0,0,1,1,0,0,0,0,0,0,0,0,0,0,0,0,0,0,0,0
409379,33000,330,0,-2,1,0,1,0,0,0,0,0,0,0,0,0,0,0,0,0,0,0,1,0,1,0,0,0,0,0,0,0,0,0
409698,33000,330,0,-2,7,3,4,0,0,0,1,0,1,0,0,0,2,1,1,0,0,0,3,2,1,0,0,0,1,0,1,0,0,0
413413,33000,330,0,-2,42,7,35,0,0,0,1,0,1,7,2,5,1,0,1,0,0,0,28,4,24,0,0,0,5,1,4,0,0,0
413617,33000,330,0,-2,3,2,1,3,2,1,0,0,0,0,0,0,0,0,0,0,0,0,0,0,0,0,0,0,0,0,0,0,0,0
414911,33000,330,0,-2,1,1,0,0,0,0,0,0,0,0,0,0,0,0,0,0,0,0,1,1,0,0,0,0,0,0,0,0,0,0
417734,33000,330,0,-2,1,1,0,0,0,0,0,0,0,0,0,0,0,0,0,0,0,0,1,1,0,0,0,0,0,0,0,0,0,0
420246,33000,330,0,-2,1,0,1,0,0,0,0,0,0,1,0,1,0,0,0,0,0,0,0,0,0,0,0,0,0,0,0,0,0,0
420398,33000,330,0,-2,2,1,1,0,0,0,0,0,0,1,0,1,1,1,0,0,0,0,0,0,0,0,0,0,0,0,0,0,0,0
420556,33000,330,0,-2,1,0,1,0,0,0,0,0,0,0,0,0,0,0,0,0,0,0,1,0,1,0,0,0,0,0,0,0,0,0
420802,33000,330,0,-2,1,1,0,0,0,0,0,0,0,0,0,0,0,0,0,0,0,0,1,1,0,0,0,0,0,0,0,0,0,0
421708,33000,330,0,-2,4,0,4,0,0,0,0,0,0,0,0,0,0,0,0,0,0,0,3,0,3,1,0,1,0,0,0,0,0,0
422695,33000,330,0,-2,1,0,1,0,0,0,0,0,0,0,0,0,1,0,1,0,0,0,0,0,0,0,0,0,0,0,0,0,0,0
423652,33000,330,0,-2,1,0,1,0,0,0,0,0,0,0,0,0,0,0,0,0,0,0,1,0,1,0,0,0,0,0,0,0,0,0
428453,33000,330,0,-2,2,1,1,0,0,0,0,0,0,1,0,1,0,0,0,0,0,0,1,1,0,0,0,0,0,0,0,0,0,0
433004,33000,330,0,-2,1,1,0,0,0,0,0,0,0,0,0,0,0,0,0,0,0,0,1,1,0,0,0,0,0,0,0,0,0,0
433387,33000,330,0,-2,199,66,133,2,0,2,3,3,0,26,8,18,38,14,24,3,1,2,115,37,78,9,2,7,3,1,2,0,0,0
433660,33000,330,0,-2,25,8,17,0,0,0,1,1,0,4,3,1,4,0,4,0,0,0,13,4,9,2,0,2,0,0,0,1,0,1
434016,33000,330,0,-2,3,1,2,2,1,1,0,0,0,0,0,0,0,0,0,0,0,0,1,0,1,0,0,0,0,0,0,0,0,0
434672,33000,330,0,-2,5,1,4,0,0,0,0,0,0,2,1,1,0,0,0,0,0,0,3,0,3,0,0,0,0,0,0,0,0,0
435000,33000,330,0,-2,1,0,1,0,0,0,0,0,0,0,0,0,0,0,0,0,0,0,1,0,1,0,0,0,0,0,0,0,0,0
436429,33000,330,0,-2,3,1,2,0,0,0,0,0,0,0,0,0,0,0,0,0,0,0,2,0,2,1,1,0,0,0,0,0,0,0
438665,33000,330,0,-2,2,1,1,0,0,0,0,0,0,0,0,0,2,1,1,0,0,0,0,0,0,0,0,0,0,0,0,0,0,0
438708,33000,330,0,-2,1,1,0,0,0,0,0,0,0,0,0,0,0,0,0,0,0,0,1,1,0,0,0,0,0,0,0,0,0,0
439154,33000,330,0,-2,5,1,4,0,0,0,0,0,0,0,0,0,1,0,1,0,0,0,4,1,3,0,0,0,0,0,0,0,0,0
439190,33000,330,0,-2,2,1,1,0,0,0,1,0,1,0,0,0,0,0,0,0,0,0,0,0,0,0,0,0,1,1,0,0,0,0
439792,33000,330,0,-2,1,0,1,0,0,0,0,0,0,1,0,1,0,0,0,0,0,0,0,0,0,0,0,0,0,0,0,0,0,0
440402,33000,330,0,-2,2,0,2,0,0,0,0,0,0,1,0,1,0,0,0,0,0,0,1,0,1,0,0,0,0,0,0,0,0,0
441052,33000,330,0,-2,1,1,0,0,0,0,1,1,0,0,0,0,0,0,0,0,0,0,0,0,0,0,0,0,0,0,0,0,0,0
441900,33000,330,0,-2,9,1,8,0,0,0,1,0,1,1,0,1,3,0,3,0,0,0,4,1,3,0,0,0,0,0,0,0,0,0
441937,33000,330,0,-2,7,3,4,0,0,0,0,0,0,1,1,0,5,2,3,0,0,0,0,0,0,1,0,1,0,0,0,0,0,0
442295,33000,330,0,-2,1,0,1,0,0,0,0,0,0,0,0,0,0,0,0,0,0,0,1,0,1,0,0,0,0,0,0,0,0,0
442569,33000,330,0,-2,1,1,0,0,0,0,0,0,0,0,0,0,0,0,0,0,0,0,1,1,0,0,0,0,0,0,0,0,0,0
442781,33000,330,0,-2,1,0,1,1,0,1,0,0,0,0,0,0,0,0,0,0,0,0,0,0,0,0,0,0,0,0,0,0,0,0
442806,33000,330,0,-2,1,1,0,0,0,0,0,0,0,0,0,0,0,0,0,0,0,0,1,1,0,0,0,0,0,0,0,0,0,0
442930,33000,330,0,-2,2,1,1,0,0,0,0,0,0,0,0,0,1,0,1,0,0,0,1,1,0,0,0,0,0,0,0,0,0,0
443331,33000,330,0,-2,2,0,2,0,0,0,0,0,0,0,0,0,2,0,2,0,0,0,0,0,0,0,0,0,0,0,0,0,0,0
443368,33000,330,0,-2,1,0,1,0,0,0,0,0,0,0,0,0,0,0,0,0,0,0,1,0,1,0,0,0,0,0,0,0,0,0
443410,33000,330,0,-2,1,1,0,0,0,0,0,0,0,0,0,0,0,0,0,0,0,0,1,1,0,0,0,0,0,0,0,0,0,0
443492,33000,330,0,-2,3,1,2,0,0,0,0,0,0,0,0,0,0,0,0,0,0,0,3,1,2,0,0,0,0,0,0,0,0,0
443711,33000,330,0,-2,2,1,1,0,0,0,0,0,0,0,0,0,1,1,0,0,0,0,1,0,1,0,0,0,0,0,0,0,0,0
444219,33000,330,0,-2,1,0,1,0,0,0,0,0,0,1,0,1,0,0,0,0,0,0,0,0,0,0,0,0,0,0,0,0,0,0
444787,33000,330,0,-2,2,1,1,1,1,0,0,0,0,0,0,0,0,0,0,0,0,0,1,0,1,0,0,0,0,0,0,0,0,0
445188,33000,330,0,-2,6,2,4,0,0,0,1,0,1,0,0,0,4,1,3,0,0,0,1,1,0,0,0,0,0,0,0,0,0,0
445267,33000,330,0,-2,2,0,2,0,0,0,0,0,0,0,0,0,0,0,0,0,0,0,2,0,2,0,0,0,0,0,0,0,0,0
445708,33000,330,0,-2,4,2,2,0,0,0,0,0,0,1,1,0,0,0,0,0,0,0,3,1,2,0,0,0,0,0,0,0,0,0
445735,33000,330,0,-2,2,0,2,0,0,0,0,0,0,1,0,1,0,0,0,0,0,0,1,0,1,0,0,0,0,0,0,0,0,0
445744,33000,330,0,-2,1,1,0,0,0,0,0,0,0,0,0,0,0,0,0,0,0,0,1,1,0,0,0,0,0,0,0,0,0,0
445869,33000,330,0,-2,2,2,0,0,0,0,0,0,0,0,0,0,0,0,0,0,0,0,2,2,0,0,0,0,0,0,0,0,0,0
446048,33000,330,0,-2,9,7,2,0,0,0,0,0,0,1,1,0,0,0,0,0,0,0,8,6,2,0,0,0,0,0,0,0,0,0
446118,33000,330,0,-2,4,1,3,0,0,0,0,0,0,0,0,0,4,1,3,0,0,0,0,0,0,0,0,0,0,0,0,0,0,0
446233,33000,330,0,-2,2,2,0,0,0,0,0,0,0,1,1,0,0,0,0,0,0,0,1,1,0,0,0,0,0,0,0,0,0,0
446640,33000,330,0,-2,1,1,0,0,0,0,0,0,0,0,0,0,0,0,0,0,0,0,1,1,0,0,0,0,0,0,0,0,0,0
446978,33000,330,0,-2,4,2,2,0,0,0,0,0,0,0,0,0,1,0,1,0,0,0,3,2,1,0,0,0,0,0,0,0,0,0
447689,33000,330,0,-2,3,2,1,0,0,0,0,0,0,1,1,0,0,0,0,0,0,0,2,1,1,0,0,0,0,0,0,0,0,0
447698,33000,330,0,-2,1,0,1,0,0,0,0,0,0,0,0,0,0,0,0,0,0,0,1,0,1,0,0,0,0,0,0,0,0,0
447953,33000,330,0,-2,2,2,0,0,0,0,0,0,0,0,0,0,0,0,0,0,0,0,2,2,0,0,0,0,0,0,0,0,0,0
448336,33000,330,0,-2,1,1,0,0,0,0,0,0,0,0,0,0,0,0,0,0,0,0,1,1,0,0,0,0,0,0,0,0,0,0
449339,33000,330,0,-2,28,5,23,0,0,0,1,1,0,1,0,1,1,0,1,0,0,0,25,4,21,0,0,0,0,0,0,0,0,0
450058,33000,330,0,-2,5,1,4,1,1,0,0,0,0,1,0,1,0,0,0,0,0,0,3,0,3,0,0,0,0,0,0,0,0,0
450067,33000,330,0,-2,4,2,2,0,0,0,0,0,0,1,1,0,0,0,0,0,0,0,2,1,1,1,0,1,0,0,0,0,0,0
450933,33000,330,0,-2,17,4,13,0,0,0,0,0,0,2,0,2,0,0,0,0,0,0,11,3,8,1,0,1,3,1,2,0,0,0
451750,33000,330,0,-2,12,7,5,0,0,0,1,0,1,2,2,0,2,2,0,0,0,0,7,3,4,0,0,0,0,0,0,0,0,0
454184,33000,330,0,-2,1,1,0,0,0,0,0,0,0,0,0,0,1,1,0,0,0,0,0,0,0,0,0,0,0,0,0,0,0,0
454810,33000,330,0,-2,1,1,0,0,0,0,0,0,0,0,0,0,0,0,0,0,0,0,1,1,0,0,0,0,0,0,0,0,0,0
454856,33000,330,0,-2,1,0,1,0,0,0,0,0,0,0,0,0,0,0,0,0,0,0,1,0,1,0,0,0,0,0,0,0,0,0
455114,33000,330,0,-2,9,3,6,0,0,0,0,0,0,0,0,0,3,1,2,0,0,0,6,2,4,0,0,0,0,0,0,0,0,0
455628,33000,330,0,-2,1,1,0,0,0,0,0,0,0,1,1,0,0,0,0,0,0,0,0,0,0,0,0,0,0,0,0,0,0,0
455664,33000,330,0,-2,2,1,1,0,0,0,0,0,0,0,0,0,1,0,1,0,0,0,1,1,0,0,0,0,0,0,0,0,0,0
455770,33000,330,0,-2,5,5,0,0,0,0,0,0,0,0,0,0,0,0,0,0,0,0,4,4,0,0,0,0,1,1,0,0,0,0
456959,33000,330,0,-2,2,0,2,0,0,0,0,0,0,1,0,1,1,0,1,0,0,0,0,0,0,0,0,0,0,0,0,0,0,0
458210,33000,330,0,-2,5,1,4,0,0,0,2,0,2,0,0,0,1,0,1,0,0,0,2,1,1,0,0,0,0,0,0,0,0,0
458229,33000,330,0,-2,4,1,3,0,0,0,2,1,1,0,0,0,0,0,0,0,0,0,1,0,1,0,0,0,1,0,1,0,0,0
458681,33000,330,0,-2,1,0,1,0,0,0,0,0,0,1,0,1,0,0,0,0,0,0,0,0,0,0,0,0,0,0,0,0,0,0
459736,33000,330,0,-2,2,0,2,0,0,0,0,0,0,0,0,0,0,0,0,0,0,0,2,0,2,0,0,0,0,0,0,0,0,0
459824,33000,330,0,-2,1,0,1,0,0,0,0,0,0,0,0,0,0,0,0,0,0,0,1,0,1,0,0,0,0,0,0,0,0,0
459949,33000,330,0,-2,18,8,10,0,0,0,1,1,0,4,2,2,11,4,7,0,0,0,2,1,1,0,0,0,0,0,0,0,0,0
459958,33000,330,0,-2,2,1,1,0,0,0,0,0,0,1,0,1,1,1,0,0,0,0,0,0,0,0,0,0,0,0,0,0,0,0
460020,33000,330,0,-2,3,2,1,0,0,0,0,0,0,3,2,1,0,0,0,0,0,0,0,0,0,0,0,0,0,0,0,0,0,0
460376,33000,330,0,-2,7,2,5,0,0,0,0,0,0,1,0,1,1,0,1,0,0,0,4,2,2,1,0,1,0,0,0,0,0,0
460394,33000,330,0,-2,1,1,0,0,0,0,0,0,0,0,0,0,1,1,0,0,0,0,0,0,0,0,0,0,0,0,0,0,0,0
461148,33000,330,0,-2,2,0,2,0,0,0,1,0,1,0,0,0,1,0,1,0,0,0,0,0,0,0,0,0,0,0,0,0,0,0
461795,33000,330,0,-2,4,2,2,0,0,0,0,0,0,2,1,1,0,0,0,0,0,0,1,1,0,0,0,0,0,0,0,1,0,1
462354,33000,330,0,-2,1,0,1,0,0,0,0,0,0,0,0,0,1,0,1,0,0,0,0,0,0,0,0,0,0,0,0,0,0,0
464226,33000,330,0,-2,10,7,3,0,0,0,1,1,0,1,1,0,2,2,0,0,0,0,6,3,3,0,0,0,0,0,0,0,0,0
475495,33000,330,0,-2,2,1,1,0,0,0,0,0,0,0,0,0,0,0,0,0,0,0,2,1,1,0,0,0,0,0,0,0,0,0
475565,33000,330,0,-2,1,0,1,0,0,0,0,0,0,0,0,0,1,0,1,0,0,0,0,0,0,0,0,0,0,0,0,0,0,0
475608,33000,330,0,-2,1,1,0,0,0,0,0,0,0,1,1,0,0,0,0,0,0,0,0,0,0,0,0,0,0,0,0,0,0,0
476726,33000,330,0,-2,1,0,1,0,0,0,0,0,0,0,0,0,1,0,1,0,0,0,0,0,0,0,0,0,0,0,0,0,0,0
477039,33000,330,0,-2,4,1,3,0,0,0,0,0,0,2,0,2,0,0,0,0,0,0,2,1,1,0,0,0,0,0,0,0,0,0
480091,33000,330,0,-2,58,21,37,1,0,1,2,1,1,1,1,0,3,2,1,0,0,0,48,16,32,3,1,2,0,0,0,0,0,0
480790,33000,330,0,-2,1,0,1,0,0,0,0,0,0,0,0,0,0,0,0,0,0,0,1,0,1,0,0,0,0,0,0,0,0,0
481030,33000,330,0,-2,1,0,1,0,0,0,0,0,0,0,0,0,0,0,0,0,0,0,1,0,1,0,0,0,0,0,0,0,0,0
481535,33000,330,0,-2,1,0,1,0,0,0,0,0,0,0,0,0,0,0,0,0,0,0,1,0,1,0,0,0,0,0,0,0,0,0
482149,33000,330,0,-2,18,9,9,0,0,0,0,0,0,8,1,7,0,0,0,0,0,0,10,8,2,0,0,0,0,0,0,0,0,0
482158,33000,330,0,-2,3,1,2,0,0,0,0,0,0,2,0,2,0,0,0,0,0,0,0,0,0,0,0,0,1,1,0,0,0,0
482680,33000,330,0,-2,9,4,5,0,0,0,0,0,0,0,0,0,0,0,0,0,0,0,8,3,5,0,0,0,1,1,0,0,0,0
482705,33000,330,0,-2,4,2,2,0,0,0,1,0,1,2,1,1,0,0,0,0,0,0,0,0,0,0,0,0,1,1,0,0,0,0
482936,33000,330,0,-2,2,1,1,0,0,0,0,0,0,0,0,0,0,0,0,0,0,0,2,1,1,0,0,0,0,0,0,0,0,0
483018,33000,330,0,-2,2,0,2,0,0,0,0,0,0,0,0,0,0,0,0,0,0,0,2,0,2,0,0,0,0,0,0,0,0,0
483036,33000,330,0,-2,5,3,2,0,0,0,0,0,0,2,0,2,1,1,0,0,0,0,1,1,0,1,1,0,0,0,0,0,0,0
483045,33000,330,0,-2,7,4,3,0,0,0,1,1,0,3,1,2,0,0,0,0,0,0,3,2,1,0,0,0,0,0,0,0,0,0
483124,33000,330,0,-2,21,3,18,1,0,1,1,0,1,1,0,1,5,2,3,0,0,0,8,0,8,0,0,0,5,1,4,0,0,0
484613,33000,330,0,-2,38,11,27,0,0,0,0,0,0,5,1,4,2,0,2,0,0,0,21,8,13,2,0,2,8,2,6,0,0,0
484844,33000,330,0,-2,2,0,2,0,0,0,0,0,0,0,0,0,0,0,0,0,0,0,2,0,2,0,0,0,0,0,0,0,0,0
484905,33000,330,0,-2,1,0,1,0,0,0,0,0,0,1,0,1,0,0,0,0,0,0,0,0,0,0,0,0,0,0,0,0,0,0
485111,33000,330,0,-2,2,1,1,0,0,0,0,0,0,1,1,0,0,0,0,0,0,0,1,0,1,0,0,0,0,0,0,0,0,0
485272,33000,330,0,-2,1,1,0,0,0,0,0,0,0,0,0,0,1,1,0,0,0,0,0,0,0,0,0,0,0,0,0,0,0,0
485458,33000,330,0,-2,1,1,0,0,0,0,0,0,0,0,0,0,0,0,0,0,0,0,1,1,0,0,0,0,0,0,0,0,0,0
486840,33000,330,0,-2,41,21,20,0,0,0,1,1,0,9,4,5,1,1,0,1,0,1,27,13,14,1,1,0,1,1,0,0,0,0
486901,33000,330,0,-2,14,6,8,0,0,0,0,0,0,2,0,2,0,0,0,0,0,0,12,6,6,0,0,0,0,0,0,0,0,0
487010,33000,330,0,-2,6,2,4,0,0,0,0,0,0,2,1,1,0,0,0,0,0,0,4,1,3,0,0,0,0,0,0,0,0,0
487092,33000,330,0,-2,5,2,3,0,0,0,1,1,0,1,0,1,0,0,0,0,0,0,3,1,2,0,0,0,0,0,0,0,0,0
487162,33000,330,0,-2,3,0,3,0,0,0,0,0,0,0,0,0,0,0,0,0,0,0,3,0,3,0,0,0,0,0,0,0,0,0
487302,33000,330,0,-2,1,1,0,0,0,0,0,0,0,0,0,0,0,0,0,0,0,0,1,1,0,0,0,0,0,0,0,0,0,0
487320,33000,330,0,-2,9,4,5,0,0,0,1,0,1,0,0,0,2,0,2,0,0,0,5,3,2,0,0,0,1,1,0,0,0,0
487375,33000,330,0,-2,1,0,1,0,0,0,0,0,0,1,0,1,0,0,0,0,0,0,0,0,0,0,0,0,0,0,0,0,0,0
487524,33000,330,0,-2,6,4,2,0,0,0,0,0,0,1,1,0,0,0,0,0,0,0,5,3,2,0,0,0,0,0,0,0,0,0
488387,33000,330,0,-2,1,1,0,0,0,0,0,0,0,0,0,0,0,0,0,0,0,0,1,1,0,0,0,0,0,0,0,0,0,0
488730,33000,330,0,-2,1,1,0,0,0,0,0,0,0,0,0,0,1,1,0,0,0,0,0,0,0,0,0,0,0,0,0,0,0,0
488785,33000,330,0,-2,3,1,2,0,0,0,0,0,0,0,0,0,1,1,0,0,0,0,2,0,2,0,0,0,0,0,0,0,0,0
488846,33000,330,0,-2,2,0,2,0,0,0,0,0,0,0,0,0,0,0,0,0,0,0,0,0,0,0,0,0,2,0,2,0,0,0
489937,33000,330,0,-2,4,3,1,0,0,0,0,0,0,0,0,0,0,0,0,0,0,0,4,3,1,0,0,0,0,0,0,0,0,0
490133,33000,330,0,-2,6,3,3,0,0,0,0,0,0,2,2,0,0,0,0,0,0,0,1,1,0,1,0,1,2,0,2,0,0,0
490373,33000,330,0,-2,3,2,1,0,0,0,0,0,0,0,0,0,0,0,0,0,0,0,2,2,0,0,0,0,1,0,1,0,0,0
490805,33000,330,0,-2,15,5,10,0,0,0,0,0,0,4,1,3,3,0,3,0,0,0,7,4,3,1,0,1,0,0,0,0,0,0
492263,33000,330,0,-2,6,2,4,0,0,0,1,1,0,0,0,0,0,0,0,0,0,0,5,1,4,0,0,0,0,0,0,0,0,0
492689,33000,330,0,-2,3,2,1,0,0,0,0,0,0,0,0,0,3,2,1,0,0,0,0,0,0,0,0,0,0,0,0,0,0,0
492801,33000,330,0,-2,1,0,1,0,0,0,0,0,0,1,0,1,0,0,0,0,0,0,0,0,0,0,0,0,0,0,0,0,0,0
494162,33000,330,0,-2,2,0,2,0,0,0,0,0,0,2,0,2,0,0,0,0,0,0,0,0,0,0,0,0,0,0,0,0,0,0
494287,33000,330,0,-2,1,0,1,0,0,0,0,0,0,0,0,0,1,0,1,0,0,0,0,0,0,0,0,0,0,0,0,0,0,0
494603,33000,330,0,-2,12,10,2,0,0,0,0,0,0,0,0,0,0,0,0,0,0,0,12,10,2,0,0,0,0,0,0,0,0,0
494843,33000,330,0,-2,4,3,1,0,0,0,0,0,0,4,3,1,0,0,0,0,0,0,0,0,0,0,0,0,0,0,0,0,0,0
495314,33000,330,0,-2,4,1,3,0,0,0,0,0,0,0,0,0,4,1,3,0,0,0,0,0,0,0,0,0,0,0,0,0,0,0
495420,33000,330,0,-2,1,0,1,0,0,0,0,0,0,0,0,0,0,0,0,0,0,0,1,0,1,0,0,0,0,0,0,0,0,0
495457,33000,330,0,-2,1,1,0,0,0,0,0,0,0,1,1,0,0,0,0,0,0,0,0,0,0,0,0,0,0,0,0,0,0,0
495767,33000,330,0,-2,140,70,70,0,0,0,4,1,3,22,11,11,11,5,6,0,0,0,100,52,48,3,1,2,0,0,0,0,0,0
497277,33000,330,0,-2,1,0,1,0,0,0,0,0,0,1,0,1,0,0,0,0,0,0,0,0,0,0,0,0,0,0,0,0,0,0
100663,34000,340,0,-2,83,28,55,0,0,0,1,0,1,10,1,9,2,0,2,0,0,0,34,5,29,0,0,0,1,0,1,35,22,13
100724,34000,340,0,-2,1,0,1,0,0,0,0,0,0,1,0,1,0,0,0,0,0,0,0,0,0,0,0,0,0,0,0,0,0,0
100751,34000,340,0,-2,50,12,38,0,0,0,2,1,1,9,1,8,0,0,0,0,0,0,36,8,28,0,0,0,0,0,0,3,2,1
100830,34000,340,0,-2,3,0,3,0,0,0,0,0,0,0,0,0,0,0,0,0,0,0,3,0,3,0,0,0,0,0,0,0,0,0
100858,34000,340,0,-2,3,0,3,0,0,0,0,0,0,0,0,0,0,0,0,0,0,0,2,0,2,1,0,1,0,0,0,0,0,0
100937,34000,340,0,-2,1,0,1,0,0,0,0,0,0,0,0,0,0,0,0,0,0,0,1,0,1,0,0,0,0,0,0,0,0,0
101879,34000,340,0,-2,1,0,1,0,0,0,0,0,0,0,0,0,0,0,0,0,0,0,1,0,1,0,0,0,0,0,0,0,0,0
102094,34000,340,0,-2,3,2,1,0,0,0,0,0,0,2,1,1,0,0,0,0,0,0,1,1,0,0,0,0,0,0,0,0,0,0
102368,34000,340,0,-2,1,1,0,0,0,0,0,0,0,1,1,0,0,0,0,0,0,0,0,0,0,0,0,0,0,0,0,0,0,0
102553,34000,340,0,-2,1,0,1,0,0,0,0,0,0,0,0,0,0,0,0,0,0,0,1,0,1,0,0,0,0,0,0,0,0,0
104151,34000,340,0,-2,21,4,17,1,0,1,1,0,1,1,0,1,0,0,0,0,0,0,5,2,3,0,0,0,13,2,11,0,0,0
104160,34000,340,0,-2,1,0,1,0,0,0,0,0,0,0,0,0,0,0,0,0,0,0,1,0,1,0,0,0,0,0,0,0,0,0
104179,34000,340,0,-2,15,4,11,0,0,0,0,0,0,0,0,0,3,0,3,0,0,0,11,3,8,0,0,0,0,0,0,1,1,0
104717,34000,340,0,-2,13,6,7,0,0,0,0,0,0,0,0,0,3,0,3,0,0,0,10,6,4,0,0,0,0,0,0,0,0,0
105330,34000,340,0,-2,11,2,9,0,0,0,0,0,0,0,0,0,1,0,1,0,0,0,9,2,7,0,0,0,1,0,1,0,0,0
105792,34000,340,0,-2,1,0,1,0,0,0,0,0,0,0,0,0,0,0,0,0,0,0,1,0,1,0,0,0,0,0,0,0,0,0
106245,34000,340,0,-2,1,0,1,0,0,0,0,0,0,0,0,0,1,0,1,0,0,0,0,0,0,0,0,0,0,0,0,0,0,0
106263,34000,340,0,-2,90,23,67,1,0,1,1,0,1,36,7,29,1,1,0,0,0,0,49,14,35,0,0,0,1,1,0,1,0,1
106397,34000,340,0,-2,12,2,10,0,0,0,0,0,0,4,1,3,1,1,0,0,0,0,7,0,7,0,0,0,0,0,0,0,0,0
106458,34000,340,0,-2,7,4,3,0,0,0,0,0,0,1,0,1,1,0,1,0,0,0,4,3,1,0,0,0,0,0,0,1,1,0
106467,34000,340,0,-2,1,0,1,0,0,0,0,0,0,0,0,0,0,0,0,0,0,0,1,0,1,0,0,0,0,0,0,0,0,0
107044,34000,340,0,-2,1,1,0,0,0,0,0,0,0,0,0,0,0,0,0,0,0,0,1,1,0,0,0,0,0,0,0,0,0,0
107141,34000,340,0,-2,1,0,1,0,0,0,0,0,0,0,0,0,0,0,0,0,0,0,1,0,1,0,0,0,0,0,0,0,0,0
110097,34000,340,0,-2,1,0,1,0,0,0,0,0,0,0,0,0,0,0,0,0,0,0,1,0,1,0,0,0,0,0,0,0,0,0
110361,34000,340,0,-2,4,1,3,0,0,0,0,0,0,0,0,0,2,0,2,0,0,0,1,0,1,1,1,0,0,0,0,0,0,0
110404,34000,340,0,-2,2,2,0,0,0,0,2,2,0,0,0,0,0,0,0,0,0,0,0,0,0,0,0,0,0,0,0,0,0,0
110422,34000,340,0,-2,5,2,3,0,0,0,0,0,0,0,0,0,0,0,0,0,0,0,4,2,2,0,0,0,1,0,1,0,0,0
110486,34000,340,0,-2,2,1,1,0,0,0,0,0,0,0,0,0,0,0,0,0,0,0,1,1,0,1,0,1,0,0,0,0,0,0
110529,34000,340,0,-2,2,0,2,0,0,0,0,0,0,0,0,0,0,0,0,0,0,0,2,0,2,0,0,0,0,0,0,0,0,0
110538,34000,340,0,-2,5,1,4,1,0,1,0,0,0,0,0,0,0,0,0,0,0,0,2,1,1,0,0,0,2,0,2,0,0,0
110556,34000,340,0,-2,1,0,1,0,0,0,0,0,0,0,0,0,0,0,0,0,0,0,1,0,1,0,0,0,0,0,0,0,0,0
110565,34000,340,0,-2,3,2,1,0,0,0,0,0,0,0,0,0,3,2,1,0,0,0,0,0,0,0,0,0,0,0,0,0,0,0
110574,34000,340,0,-2,1,1,0,0,0,0,1,1,0,0,0,0,0,0,0,0,0,0,0,0,0,0,0,0,0,0,0,0,0,0
110583,34000,340,0,-2,2,1,1,0,0,0,0,0,0,0,0,0,1,0,1,0,0,0,1,1,0,0,0,0,0,0,0,0,0,0
110592,34000,340,0,-2,2,0,2,0,0,0,0,0,0,1,0,1,1,0,1,0,0,0,0,0,0,0,0,0,0,0,0,0,0,0
110608,34000,340,0,-2,7,3,4,0,0,0,1,0,1,0,0,0,4,2,2,0,0,0,2,1,1,0,0,0,0,0,0,0,0,0
110617,34000,340,0,-2,6,5,1,0,0,0,0,0,0,0,0,0,2,2,0,0,0,0,4,3,1,0,0,0,0,0,0,0,0,0
110635,34000,340,0,-2,37,16,21,0,0,0,7,4,3,0,0,0,2,2,0,0,0,0,17,8,9,3,1,2,3,1,2,5,0,5
110644,34000,340,0,-2,167,62,105,0,0,0,33,16,17,8,4,4,38,13,25,0,0,0,63,20,43,7,4,3,7,2,5,11,3,8
110653,34000,340,0,-2,65,26,39,0,0,0,22,10,12,0,0,0,13,5,8,0,0,0,19,5,14,3,1,2,3,3,0,5,2,3
110662,34000,340,0,-2,348,94,254,0,0,0,85,27,58,21,1,20,96,28,68,2,1,1,76,11,65,12,3,9,22,10,12,34,13,21
110671,34000,340,0,-2,12,8,4,0,0,0,2,2,0,0,0,0,3,1,2,0,0,0,3,3,0,0,0,0,1,1,0,3,1,2
110680,34000,340,0,-2,250,77,173,1,0,1,65,16,49,12,1,11,41,17,24,0,0,0,97,34,63,9,2,7,13,3,10,12,4,8
110699,34000,340,0,-2,119,41,78,0,0,0,43,12,31,7,3,4,31,7,24,2,1,1,25,11,14,2,1,1,3,3,0,6,3,3
110705,34000,340,0,-2,13,8,5,0,0,0,1,1,0,1,0,1,2,2,0,0,0,0,8,5,3,0,0,0,0,0,0,1,0,1
110714,34000,340,0,-2,10,2,8,0,0,0,3,0,3,0,0,0,1,0,1,0,0,0,6,2,4,0,0,0,0,0,0,0,0,0
111948,34000,340,0,-2,1,0,1,0,0,0,0,0,0,0,0,0,1,0,1,0,0,0,0,0,0,0,0,0,0,0,0,0,0,0
112075,34000,340,0,-2,1,1,0,0,0,0,0,0,0,0,0,0,1,1,0,0,0,0,0,0,0,0,0,0,0,0,0,0,0,0
112084,34000,340,0,-2,1,0,1,0,0,0,0,0,0,0,0,0,1,0,1,0,0,0,0,0,0,0,0,0,0,0,0,0,0,0
112172,34000,340,0,-2,1,0,1,0,0,0,0,0,0,0,0,0,0,0,0,0,0,0,1,0,1,0,0,0,0,0,0,0,0,0
112525,34000,340,0,-2,2,1,1,0,0,0,0,0,0,0,0,0,2,1,1,0,0,0,0,0,0,0,0,0,0,0,0,0,0,0
113698,34000,340,0,-2,1,1,0,0,0,0,0,0,0,0,0,0,0,0,0,0,0,0,1,1,0,0,0,0,0,0,0,0,0,0
114354,34000,340,0,-2,1,0,1,0,0,0,0,0,0,0,0,0,0,0,0,0,0,0,1,0,1,0,0,0,0,0,0,0,0,0
115126,34000,340,0,-2,1,0,1,0,0,0,1,0,1,0,0,0,0,0,0,0,0,0,0,0,0,0,0,0,0,0,0,0,0,0
115728,34000,340,0,-2,1,1,0,0,0,0,0,0,0,0,0,0,0,0,0,0,0,0,0,0,0,1,1,0,0,0,0,0,0,0
115755,34000,340,0,-2,1,0,1,0,0,0,0,0,0,0,0,0,0,0,0,0,0,0,1,0,1,0,0,0,0,0,0,0,0,0
117140,34000,340,0,-2,2,0,2,0,0,0,0,0,0,0,0,0,1,0,1,0,0,0,0,0,0,0,0,0,1,0,1,0,0,0
117636,34000,340,0,-2,31,8,23,0,0,0,11,4,7,1,0,1,10,1,9,0,0,0,8,3,5,1,0,1,0,0,0,0,0,0
117672,34000,340,0,-2,2,0,2,0,0,0,0,0,0,0,0,0,0,0,0,0,0,0,2,0,2,0,0,0,0,0,0,0,0,0
117946,34000,340,0,-2,3,2,1,0,0,0,0,0,0,0,0,0,0,0,0,0,0,0,1,1,0,0,0,0,2,1,1,0,0,0
118541,34000,340,0,-2,1,0,1,1,0,1,0,0,0,0,0,0,0,0,0,0,0,0,0,0,0,0,0,0,0,0,0,0,0,0
118976,34000,340,0,-2,2,0,2,0,0,0,1,0,1,0,0,0,0,0,0,0,0,0,1,0,1,0,0,0,0,0,0,0,0,0
119164,34000,340,0,-2,1,1,0,0,0,0,0,0,0,1,1,0,0,0,0,0,0,0,0,0,0,0,0,0,0,0,0,0,0,0
119173,34000,340,0,-2,10,2,8,2,0,2,1,0,1,0,0,0,3,2,1,0,0,0,3,0,3,1,0,1,0,0,0,0,0,0
119331,34000,340,0,-2,1,0,1,0,0,0,0,0,0,0,0,0,0,0,0,0,0,0,1,0,1,0,0,0,0,0,0,0,0,0
119678,34000,340,0,-2,2,2,0,0,0,0,0,0,0,1,1,0,1,1,0,0,0,0,0,0,0,0,0,0,0,0,0,0,0,0
120254,34000,340,0,-2,2,1,1,0,0,0,0,0,0,1,0,1,0,0,0,0,0,0,1,1,0,0,0,0,0,0,0,0,0,0
120342,34000,340,0,-2,1,0,1,0,0,0,0,0,0,0,0,0,0,0,0,0,0,0,1,0,1,0,0,0,0,0,0,0,0,0
120403,34000,340,0,-2,1,0,1,0,0,0,1,0,1,0,0,0,0,0,0,0,0,0,0,0,0,0,0,0,0,0,0,0,0,0
120537,34000,340,0,-2,1,0,1,0,0,0,0,0,0,0,0,0,1,0,1,0,0,0,0,0,0,0,0,0,0,0,0,0,0,0
120865,34000,340,0,-2,1,0,1,0,0,0,0,0,0,0,0,0,0,0,0,0,0,0,1,0,1,0,0,0,0,0,0,0,0,0
120883,34000,340,0,-2,3,3,0,0,0,0,0,0,0,0,0,0,2,2,0,0,0,0,1,1,0,0,0,0,0,0,0,0,0,0
121150,34000,340,0,-2,4,1,3,0,0,0,1,1,0,0,0,0,2,0,2,0,0,0,1,0,1,0,0,0,0,0,0,0,0,0
121309,34000,340,0,-2,4,2,2,0,0,0,0,0,0,0,0,0,2,1,1,1,1,0,1,0,1,0,0,0,0,0,0,0,0,0
121345,34000,340,0,-2,2,0,2,0,0,0,1,0,1,0,0,0,0,0,0,0,0,0,0,0,0,0,0,0,1,0,1,0,0,0
121691,34000,340,0,-2,2,2,0,0,0,0,1,1,0,0,0,0,0,0,0,0,0,0,1,1,0,0,0,0,0,0,0,0,0,0
122409,34000,340,0,-2,20,7,13,0,0,0,6,0,6,1,0,1,4,2,2,0,0,0,6,4,2,0,0,0,3,1,2,0,0,0
122436,34000,340,0,-2,3,1,2,0,0,0,1,1,0,0,0,0,0,0,0,0,0,0,2,0,2,0,0,0,0,0,0,0,0,0
122597,34000,340,0,-2,1,1,0,0,0,0,1,1,0,0,0,0,0,0,0,0,0,0,0,0,0,0,0,0,0,0,0,0,0,0
122612,34000,340,0,-2,1,0,1,0,0,0,0,0,0,0,0,0,0,0,0,0,0,0,1,0,1,0,0,0,0,0,0,0,0,0
122728,34000,340,0,-2,1,1,0,0,0,0,0,0,0,0,0,0,1,1,0,0,0,0,0,0,0,0,0,0,0,0,0,0,0,0
122755,34000,340,0,-2,8,2,6,0,0,0,4,1,3,0,0,0,0,0,0,0,0,0,2,0,2,1,1,0,1,0,1,0,0,0
122931,34000,340,0,-2,2,1,1,0,0,0,0,0,0,0,0,0,0,0,0,0,0,0,2,1,1,0,0,0,0,0,0,0,0,0
123013,34000,340,0,-2,1,0,1,0,0,0,0,0,0,0,0,0,1,0,1,0,0,0,0,0,0,0,0,0,0,0,0,0,0,0
123457,34000,340,0,-2,1,0,1,0,0,0,0,0,0,0,0,0,0,0,0,0,0,0,1,0,1,0,0,0,0,0,0,0,0,0
123527,34000,340,0,-2,1,0,1,0,0,0,0,0,0,1,0,1,0,0,0,0,0,0,0,0,0,0,0,0,0,0,0,0,0,0
123554,34000,340,0,-2,1,1,0,0,0,0,0,0,0,0,0,0,0,0,0,0,0,0,0,0,0,0,0,0,1,1,0,0,0,0
123572,34000,340,0,-2,1,1,0,0,0,0,1,1,0,0,0,0,0,0,0,0,0,0,0,0,0,0,0,0,0,0,0,0,0,0
123943,34000,340,0,-2,5,1,4,0,0,0,2,0,2,0,0,0,1,1,0,0,0,0,1,0,1,0,0,0,1,0,1,0,0,0
123961,34000,340,0,-2,100,46,54,0,0,0,32,17,15,6,0,6,17,8,9,1,0,1,35,16,19,4,1,3,1,0,1,4,4,0
124557,34000,340,0,-2,4,3,1,0,0,0,1,1,0,0,0,0,1,1,0,0,0,0,2,1,1,0,0,0,0,0,0,0,0,0
125727,34000,340,0,-2,1,0,1,0,0,0,0,0,0,0,0,0,0,0,0,0,0,0,0,0,0,0,0,0,1,0,1,0,0,0
125763,34000,340,0,-2,1,0,1,0,0,0,0,0,0,0,0,0,1,0,1,0,0,0,0,0,0,0,0,0,0,0,0,0,0,0
125897,34000,340,0,-2,1,0,1,0,0,0,0,0,0,0,0,0,1,0,1,0,0,0,0,0,0,0,0,0,0,0,0,0,0,0
126562,34000,340,0,-2,484,208,276,6,1,5,57,26,31,29,12,17,62,21,41,2,1,1,131,55,76,1,1,0,189,86,103,7,5,2
126580,34000,340,0,-2,7,3,4,0,0,0,0,0,0,1,1,0,2,0,2,0,0,0,3,1,2,0,0,0,1,1,0,0,0,0
126614,34000,340,0,-2,25,3,22,0,0,0,1,0,1,3,0,3,3,0,3,0,0,0,15,2,13,0,0,0,2,0,2,1,1,0
126669,34000,340,0,-2,1,0,1,0,0,0,0,0,0,0,0,0,0,0,0,0,0,0,1,0,1,0,0,0,0,0,0,0,0,0
126678,34000,340,0,-2,2,1,1,0,0,0,1,0,1,0,0,0,0,0,0,0,0,0,1,1,0,0,0,0,0,0,0,0,0,0
126818,34000,340,0,-2,20,5,15,0,0,0,0,0,0,1,1,0,1,0,1,0,0,0,17,4,13,0,0,0,1,0,1,0,0,0
127060,34000,340,0,-2,1,0,1,0,0,0,0,0,0,0,0,0,0,0,0,0,0,0,1,0,1,0,0,0,0,0,0,0,0,0
127556,34000,340,0,-2,3,1,2,0,0,0,0,0,0,1,0,1,0,0,0,0,0,0,0,0,0,0,0,0,2,1,1,0,0,0
127741,34000,340,0,-2,3,0,3,0,0,0,0,0,0,0,0,0,1,0,1,0,0,0,0,0,0,0,0,0,2,0,2,0,0,0
127918,34000,340,0,-2,3,2,1,0,0,0,0,0,0,1,1,0,0,0,0,0,0,0,2,1,1,0,0,0,0,0,0,0,0,0
128498,34000,340,0,-2,1,0,1,0,0,0,0,0,0,0,0,0,0,0,0,0,0,0,1,0,1,0,0,0,0,0,0,0,0,0
129020,34000,340,0,-2,45,12,33,0,0,0,4,1,3,4,0,4,5,2,3,0,0,0,31,9,22,1,0,1,0,0,0,0,0,0
129215,34000,340,0,-2,1,0,1,0,0,0,0,0,0,0,0,0,0,0,0,0,0,0,1,0,1,0,0,0,0,0,0,0,0,0
129242,34000,340,0,-2,3,1,2,0,0,0,0,0,0,0,0,0,1,0,1,0,0,0,2,1,1,0,0,0,0,0,0,0,0,0
129525,34000,340,0,-2,1,0,1,0,0,0,0,0,0,1,0,1,0,0,0,0,0,0,0,0,0,0,0,0,0,0,0,0,0,0
129941,34000,340,0,-2,6,1,5,0,0,0,1,0,1,1,0,1,0,0,0,0,0,0,4,1,3,0,0,0,0,0,0,0,0,0
130226,34000,340,0,-2,3,1,2,0,0,0,0,0,0,0,0,0,0,0,0,0,0,0,3,1,2,0,0,0,0,0,0,0,0,0
130253,34000,340,0,-2,5,0,5,0,0,0,0,0,0,0,0,0,0,0,0,0,0,0,3,0,3,0,0,0,2,0,2,0,0,0
130314,34000,340,0,-2,4,0,4,0,0,0,0,0,0,0,0,0,1,0,1,0,0,0,3,0,3,0,0,0,0,0,0,0,0,0
130624,34000,340,0,-2,44,32,12,0,0,0,1,0,1,3,3,0,7,6,1,0,0,0,22,17,5,2,1,1,9,5,4,0,0,0
130697,34000,340,0,-2,2,0,2,0,0,0,1,0,1,1,0,1,0,0,0,0,0,0,0,0,0,0,0,0,0,0,0,0,0,0
130776,34000,340,0,-2,1,0,1,0,0,0,0,0,0,0,0,0,0,0,0,0,0,0,1,0,1,0,0,0,0,0,0,0,0,0
130794,34000,340,0,-2,21,4,17,0,0,0,1,0,1,1,0,1,2,0,2,0,0,0,17,4,13,0,0,0,0,0,0,0,0,0
130934,34000,340,0,-2,5,0,5,0,0,0,0,0,0,5,0,5,0,0,0,0,0,0,0,0,0,0,0,0,0,0,0,0,0,0
130943,34000,340,0,-2,26,6,20,0,0,0,3,2,1,1,0,1,2,0,2,0,0,0,20,4,16,0,0,0,0,0,0,0,0,0
131159,34000,340,0,-2,4,0,4,0,0,0,0,0,0,1,0,1,0,0,0,0,0,0,3,0,3,0,0,0,0,0,0,0,0,0
131283,34000,340,0,-2,1,0,1,0,0,0,0,0,0,0,0,0,0,0,0,0,0,0,1,0,1,0,0,0,0,0,0,0,0,0
131469,34000,340,0,-2,162,83,79,0,0,0,45,24,21,17,5,12,5,3,2,0,0,0,89,50,39,1,0,1,5,1,4,0,0,0
131496,34000,340,0,-2,32,6,26,0,0,0,5,0,5,5,1,4,1,1,0,0,0,0,17,4,13,0,0,0,1,0,1,3,0,3
131520,34000,340,0,-2,27,4,23,0,0,0,0,0,0,17,3,14,2,0,2,0,0,0,1,0,1,2,1,1,5,0,5,0,0,0
132471,34000,340,0,-2,6,2,4,0,0,0,1,1,0,1,0,1,2,0,2,0,0,0,2,1,1,0,0,0,0,0,0,0,0,0
132657,34000,340,0,-2,5,3,2,0,0,0,0,0,0,0,0,0,0,0,0,0,0,0,2,1,1,0,0,0,3,2,1,0,0,0
133492,34000,340,0,-2,3,0,3,0,0,0,0,0,0,0,0,0,0,0,0,0,0,0,2,0,2,1,0,1,0,0,0,0,0,0
133508,34000,340,0,-2,3,0,3,0,0,0,0,0,0,1,0,1,0,0,0,0,0,0,2,0,2,0,0,0,0,0,0,0,0,0
133553,34000,340,0,-2,1,1,0,0,0,0,0,0,0,0,0,0,0,0,0,0,0,0,1,1,0,0,0,0,0,0,0,0,0,0
133669,34000,340,0,-2,2,0,2,0,0,0,0,0,0,2,0,2,0,0,0,0,0,0,0,0,0,0,0,0,0,0,0,0,0,0
133711,34000,340,0,-2,2,1,1,0,0,0,0,0,0,0,0,0,0,0,0,0,0,0,2,1,1,0,0,0,0,0,0,0,0,0
133872,34000,340,0,-2,1,0,1,0,0,0,0,0,0,0,0,0,0,0,0,0,0,0,1,0,1,0,0,0,0,0,0,0,0,0
133881,34000,340,0,-2,1,0,1,0,0,0,0,0,0,0,0,0,0,0,0,0,0,0,1,0,1,0,0,0,0,0,0,0,0,0
134079,34000,340,0,-2,3,1,2,0,0,0,0,0,0,0,0,0,1,0,1,0,0,0,2,1,1,0,0,0,0,0,0,0,0,0
134097,34000,340,0,-2,18,5,13,0,0,0,0,0,0,7,1,6,2,0,2,0,0,0,8,3,5,0,0,0,1,1,0,0,0,0
134130,34000,340,0,-2,95,39,56,0,0,0,11,4,7,8,2,6,13,7,6,0,0,0,62,26,36,0,0,0,1,0,1,0,0,0
134945,34000,340,0,-2,3,0,3,0,0,0,0,0,0,0,0,0,1,0,1,0,0,0,2,0,2,0,0,0,0,0,0,0,0,0
135726,34000,340,0,-2,281,91,190,0,0,0,17,6,11,24,6,18,126,27,99,0,0,0,66,26,40,10,6,4,15,7,8,23,13,10
136172,34000,340,0,-2,1,0,1,0,0,0,0,0,0,0,0,0,0,0,0,0,0,0,1,0,1,0,0,0,0,0,0,0,0,0
136215,34000,340,0,-2,41,11,30,0,0,0,10,6,4,2,0,2,10,0,10,0,0,0,19,5,14,0,0,0,0,0,0,0,0,0
136233,34000,340,0,-2,2,0,2,0,0,0,0,0,0,0,0,0,1,0,1,0,0,0,1,0,1,0,0,0,0,0,0,0,0,0
136330,34000,340,0,-2,1,0,1,0,0,0,0,0,0,0,0,0,0,0,0,0,0,0,1,0,1,0,0,0,0,0,0,0,0,0
136358,34000,340,0,-2,2,1,1,0,0,0,0,0,0,0,0,0,0,0,0,0,0,0,2,1,1,0,0,0,0,0,0,0,0,0
136950,34000,340,0,-2,1,0,1,0,0,0,0,0,0,0,0,0,0,0,0,0,0,0,1,0,1,0,0,0,0,0,0,0,0,0
137032,34000,340,0,-2,1,0,1,0,0,0,0,0,0,0,0,0,0,0,0,0,0,0,1,0,1,0,0,0,0,0,0,0,0,0
137351,34000,340,0,-2,221,106,115,0,0,0,42,23,19,16,5,11,5,4,1,0,0,0,95,43,52,34,18,16,3,1,2,26,12,14
137476,34000,340,0,-2,2,1,1,0,0,0,0,0,0,0,0,0,1,0,1,0,0,0,0,0,0,1,1,0,0,0,0,0,0,0
137546,34000,340,0,-2,3,1,2,0,0,0,0,0,0,0,0,0,0,0,0,0,0,0,3,1,2,0,0,0,0,0,0,0,0,0
137564,34000,340,0,-2,1,0,1,0,0,0,0,0,0,0,0,0,0,0,0,0,0,0,0,0,0,1,0,1,0,0,0,0,0,0
137759,34000,340,0,-2,1,0,1,0,0,0,0,0,0,0,0,0,0,0,0,0,0,0,1,0,1,0,0,0,0,0,0,0,0,0
137847,34000,340,0,-2,3,2,1,0,0,0,0,0,0,0,0,0,0,0,0,0,0,0,3,2,1,0,0,0,0,0,0,0,0,0
138293,34000,340,0,-2,1,0,1,0,0,0,0,0,0,0,0,0,0,0,0,0,0,0,1,0,1,0,0,0,0,0,0,0,0,0
138600,34000,340,0,-2,1,1,0,0,0,0,0,0,0,0,0,0,0,0,0,0,0,0,1,1,0,0,0,0,0,0,0,0,0,0
139393,34000,340,0,-2,3,2,1,0,0,0,0,0,0,0,0,0,0,0,0,0,0,0,2,2,0,0,0,0,0,0,0,1,0,1
139630,34000,340,0,-2,3,2,1,0,0,0,1,1,0,0,0,0,0,0,0,0,0,0,2,1,1,0,0,0,0,0,0,0,0,0
139658,34000,340,0,-2,90,14,76,0,0,0,8,2,6,36,3,33,7,2,5,0,0,0,35,7,28,3,0,3,0,0,0,1,0,1
139719,34000,340,0,-2,1,0,1,0,0,0,0,0,0,1,0,1,0,0,0,0,0,0,0,0,0,0,0,0,0,0,0,0,0,0
139755,34000,340,0,-2,3,0,3,0,0,0,0,0,0,1,0,1,0,0,0,0,0,0,2,0,2,0,0,0,0,0,0,0,0,0
139861,34000,340,0,-2,3,0,3,0,0,0,0,0,0,2,0,2,0,0,0,0,0,0,1,0,1,0,0,0,0,0,0,0,0,0
139931,34000,340,0,-2,5,0,5,0,0,0,1,0,1,0,0,0,0,0,0,0,0,0,3,0,3,0,0,0,1,0,1,0,0,0
139940,34000,340,0,-2,3,1,2,0,0,0,0,0,0,2,0,2,0,0,0,0,0,0,1,1,0,0,0,0,0,0,0,0,0,0
139959,34000,340,0,-2,30,8,22,0,0,0,5,3,2,4,1,3,1,1,0,0,0,0,14,3,11,0,0,0,5,0,5,1,0,1
139968,34000,340,0,-2,1,0,1,0,0,0,0,0,0,0,0,0,0,0,0,0,0,0,1,0,1,0,0,0,0,0,0,0,0,0
140252,34000,340,0,-2,2,0,2,0,0,0,1,0,1,0,0,0,0,0,0,0,0,0,1,0,1,0,0,0,0,0,0,0,0,0
140447,34000,340,0,-2,3,1,2,0,0,0,0,0,0,2,0,2,0,0,0,0,0,0,1,1,0,0,0,0,0,0,0,0,0,0
140553,34000,340,0,-2,1,0,1,0,0,0,0,0,0,1,0,1,0,0,0,0,0,0,0,0,0,0,0,0,0,0,0,0,0,0
140562,34000,340,0,-2,14,3,11,0,0,0,0,0,0,12,3,9,1,0,1,0,0,0,1,0,1,0,0,0,0,0,0,0,0,0
140696,34000,340,0,-2,1,0,1,0,0,0,0,0,0,0,0,0,0,0,0,0,0,0,1,0,1,0,0,0,0,0,0,0,0,0
140818,34000,340,0,-2,1,1,0,0,0,0,0,0,0,0,0,0,0,0,0,0,0,0,1,1,0,0,0,0,0,0,0,0,0,0
140872,34000,340,0,-2,1,0,1,0,0,0,0,0,0,0,0,0,0,0,0,0,0,0,1,0,1,0,0,0,0,0,0,0,0,0
141264,34000,340,0,-2,2,0,2,0,0,0,0,0,0,2,0,2,0,0,0,0,0,0,0,0,0,0,0,0,0,0,0,0,0,0
141486,34000,340,0,-2,2,1,1,0,0,0,1,0,1,1,1,0,0,0,0,0,0,0,0,0,0,0,0,0,0,0,0,0,0,0
141574,34000,340,0,-2,4,0,4,0,0,0,1,0,1,0,0,0,0,0,0,0,0,0,1,0,1,2,0,2,0,0,0,0,0,0
141644,34000,340,0,-2,1,0,1,0,0,0,0,0,0,0,0,0,0,0,0,0,0,0,1,0,1,0,0,0,0,0,0,0,0,0
142115,34000,340,0,-2,10,6,4,0,0,0,0,0,0,0,0,0,1,1,0,0,0,0,8,5,3,0,0,0,1,0,1,0,0,0
142276,34000,340,0,-2,2,2,0,0,0,0,0,0,0,0,0,0,0,0,0,0,0,0,1,1,0,0,0,0,1,1,0,0,0,0
142285,34000,340,0,-2,1,0,1,0,0,0,0,0,0,0,0,0,0,0,0,0,0,0,0,0,0,0,0,0,0,0,0,1,0,1
142461,34000,340,0,-2,1,0,1,0,0,0,0,0,0,0,0,0,0,0,0,0,0,0,1,0,1,0,0,0,0,0,0,0,0,0
142559,34000,340,0,-2,1,0,1,0,0,0,0,0,0,0,0,0,0,0,0,0,0,0,1,0,1,0,0,0,0,0,0,0,0,0
143118,34000,340,0,-2,1,0,1,0,0,0,0,0,0,0,0,0,0,0,0,0,0,0,1,0,1,0,0,0,0,0,0,0,0,0
143279,34000,340,0,-2,1,0,1,0,0,0,0,0,0,0,0,0,0,0,0,0,0,0,1,0,1,0,0,0,0,0,0,0,0,0
144050,34000,340,0,-2,141,43,98,0,0,0,26,9,17,20,3,17,14,3,11,0,0,0,63,22,41,6,2,4,1,0,1,11,4,7
144166,34000,340,0,-2,3,1,2,0,0,0,0,0,0,0,0,0,2,0,2,0,0,0,0,0,0,0,0,0,0,0,0,1,1,0
144500,34000,340,0,-2,1,0,1,0,0,0,0,0,0,1,0,1,0,0,0,0,0,0,0,0,0,0,0,0,0,0,0,0,0,0
144892,34000,340,0,-2,2,1,1,0,0,0,0,0,0,0,0,0,0,0,0,0,0,0,1,1,0,0,0,0,1,0,1,0,0,0
144962,34000,340,0,-2,3,1,2,0,0,0,1,1,0,0,0,0,1,0,1,0,0,0,1,0,1,0,0,0,0,0,0,0,0,0
145336,34000,340,0,-2,3,2,1,0,0,0,0,0,0,0,0,0,1,1,0,0,0,0,0,0,0,0,0,0,2,1,1,0,0,0
145558,34000,340,0,-2,44,25,19,0,0,0,26,16,10,3,2,1,0,0,0,0,0,0,14,6,8,1,1,0,0,0,0,0,0,0
145600,34000,340,0,-2,453,91,362,1,0,1,121,31,90,93,11,82,76,18,58,0,0,0,141,28,113,6,1,5,9,0,9,6,2,4
145619,34000,340,0,-2,1,1,0,0,0,0,0,0,0,0,0,0,0,0,0,0,0,0,1,1,0,0,0,0,0,0,0,0,0,0
145628,34000,340,0,-2,1,1,0,0,0,0,0,0,0,1,1,0,0,0,0,0,0,0,0,0,0,0,0,0,0,0,0,0,0,0
145637,34000,340,0,-2,25,7,18,0,0,0,0,0,0,1,1,0,5,2,3,0,0,0,18,3,15,1,1,0,0,0,0,0,0,0
145725,34000,340,0,-2,4,1,3,0,0,0,1,1,0,0,0,0,0,0,0,0,0,0,0,0,0,0,0,0,3,0,3,0,0,0
145813,34000,340,0,-2,9,4,5,0,0,0,0,0,0,0,0,0,0,0,0,0,0,0,7,4,3,0,0,0,2,0,2,0,0,0
146481,34000,340,0,-2,3,1,2,0,0,0,1,0,1,0,0,0,0,0,0,0,0,0,1,0,1,1,1,0,0,0,0,0,0,0
146506,34000,340,0,-2,1,0,1,0,0,0,0,0,0,0,0,0,0,0,0,0,0,0,1,0,1,0,0,0,0,0,0,0,0,0
146685,34000,340,0,-2,1,0,1,0,0,0,0,0,0,0,0,0,0,0,0,0,0,0,1,0,1,0,0,0,0,0,0,0,0,0
146719,34000,340,0,-2,9,0,9,0,0,0,1,0,1,2,0,2,2,0,2,0,0,0,3,0,3,0,0,0,1,0,1,0,0,0
147660,34000,340,0,-2,1,1,0,0,0,0,0,0,0,0,0,0,0,0,0,0,0,0,1,1,0,0,0,0,0,0,0,0,0,0
147679,34000,340,0,-2,1,0,1,0,0,0,1,0,1,0,0,0,0,0,0,0,0,0,0,0,0,0,0,0,0,0,0,0,0,0
147703,34000,340,0,-2,2,0,2,0,0,0,0,0,0,0,0,0,0,0,0,0,0,0,2,0,2,0,0,0,0,0,0,0,0,0
147767,34000,340,0,-2,45,16,29,0,0,0,3,1,2,7,2,5,10,5,5,0,0,0,21,6,15,2,0,2,1,1,0,1,1,0
147828,34000,340,0,-2,2,0,2,0,0,0,0,0,0,0,0,0,0,0,0,0,0,0,2,0,2,0,0,0,0,0,0,0,0,0
148016,34000,340,0,-2,1,1,0,0,0,0,0,0,0,0,0,0,0,0,0,0,0,0,1,1,0,0,0,0,0,0,0,0,0,0
148487,34000,340,0,-2,1,1,0,0,0,0,0,0,0,0,0,0,0,0,0,0,0,0,0,0,0,0,0,0,1,1,0,0,0,0
148496,34000,340,0,-2,1,0,1,0,0,0,0,0,0,0,0,0,0,0,0,0,0,0,1,0,1,0,0,0,0,0,0,0,0,0
148511,34000,340,0,-2,40,15,25,0,0,0,10,5,5,3,0,3,6,0,6,0,0,0,18,9,9,1,1,0,2,0,2,0,0,0
148654,34000,340,0,-2,1,0,1,0,0,0,0,0,0,0,0,0,0,0,0,0,0,0,1,0,1,0,0,0,0,0,0,0,0,0
149222,34000,340,0,-2,97,6,91,0,0,0,1,0,1,14,0,14,1,0,1,0,0,0,77,6,71,4,0,4,0,0,0,0,0,0
149231,34000,340,0,-2,6,1,5,0,0,0,0,0,0,1,0,1,0,0,0,0,0,0,5,1,4,0,0,0,0,0,0,0,0,0
149505,34000,340,0,-2,1,0,1,0,0,0,0,0,0,0,0,0,1,0,1,0,0,0,0,0,0,0,0,0,0,0,0,0,0,0
149772,34000,340,0,-2,3,0,3,0,0,0,0,0,0,0,0,0,0,0,0,0,0,0,3,0,3,0,0,0,0,0,0,0,0,0
150066,34000,340,0,-2,2,2,0,0,0,0,0,0,0,1,1,0,0,0,0,0,0,0,1,1,0,0,0,0,0,0,0,0,0,0
150163,34000,340,0,-2,6,1,5,0,0,0,0,0,0,0,0,0,0,0,0,0,0,0,5,1,4,0,0,0,1,0,1,0,0,0
150455,34000,340,0,-2,2,0,2,0,0,0,0,0,0,0,0,0,0,0,0,0,0,0,2,0,2,0,0,0,0,0,0,0,0,0
150534,34000,340,0,-2,5,3,2,0,0,0,0,0,0,0,0,0,0,0,0,0,0,0,1,0,1,0,0,0,4,3,1,0,0,0
150604,34000,340,0,-2,2,0,2,0,0,0,0,0,0,0,0,0,1,0,1,0,0,0,1,0,1,0,0,0,0,0,0,0,0,0
150756,34000,340,0,-2,2,2,0,0,0,0,0,0,0,0,0,0,1,1,0,0,0,0,1,1,0,0,0,0,0,0,0,0,0,0
151102,34000,340,0,-2,2,1,1,0,0,0,0,0,0,0,0,0,0,0,0,0,0,0,2,1,1,0,0,0,0,0,0,0,0,0
151111,34000,340,0,-2,126,22,104,0,0,0,8,1,7,12,3,9,4,1,3,0,0,0,95,16,79,6,0,6,0,0,0,1,1,0
151263,34000,340,0,-2,1,0,1,0,0,0,0,0,0,0,0,0,0,0,0,0,0,0,1,0,1,0,0,0,0,0,0,0,0,0
151324,34000,340,0,-2,5,2,3,0,0,0,0,0,0,0,0,0,0,0,0,0,0,0,5,2,3,0,0,0,0,0,0,0,0,0
151351,34000,340,0,-2,8,0,8,0,0,0,0,0,0,0,0,0,0,0,0,0,0,0,6,0,6,1,0,1,1,0,1,0,0,0
151786,34000,340,0,-2,2,0,2,0,0,0,0,0,0,0,0,0,0,0,0,0,0,0,2,0,2,0,0,0,0,0,0,0,0,0
151801,34000,340,0,-2,1,0,1,0,0,0,0,0,0,0,0,0,0,0,0,0,0,0,1,0,1,0,0,0,0,0,0,0,0,0
152080,34000,340,0,-2,7,1,6,0,0,0,0,0,0,0,0,0,0,0,0,0,0,0,7,1,6,0,0,0,0,0,0,0,0,0
152318,34000,340,0,-2,1,1,0,0,0,0,0,0,0,0,0,0,0,0,0,0,0,0,1,1,0,0,0,0,0,0,0,0,0,0
152390,34000,340,0,-2,1,0,1,0,0,0,0,0,0,0,0,0,0,0,0,0,0,0,1,0,1,0,0,0,0,0,0,0,0,0
152637,34000,340,0,-2,1,0,1,0,0,0,0,0,0,0,0,0,0,0,0,0,0,0,1,0,1,0,0,0,0,0,0,0,0,0
153001,34000,340,0,-2,2,0,2,0,0,0,0,0,0,0,0,0,0,0,0,0,0,0,2,0,2,0,0,0,0,0,0,0,0,0
153144,34000,340,0,-2,2,0,2,0,0,0,0,0,0,0,0,0,0,0,0,0,0,0,2,0,2,0,0,0,0,0,0,0,0,0
153162,34000,340,0,-2,2,0,2,0,0,0,0,0,0,0,0,0,0,0,0,0,0,0,2,0,2,0,0,0,0,0,0,0,0,0
153214,34000,340,0,-2,1,0,1,0,0,0,0,0,0,0,0,0,0,0,0,0,0,0,1,0,1,0,0,0,0,0,0,0,0,0
153269,34000,340,0,-2,2,2,0,0,0,0,0,0,0,0,0,0,0,0,0,0,0,0,2,2,0,0,0,0,0,0,0,0,0,0
153366,34000,340,0,-2,1,1,0,0,0,0,0,0,0,0,0,0,0,0,0,0,0,0,1,1,0,0,0,0,0,0,0,0,0,0
153472,34000,340,0,-2,1,1,0,0,0,0,0,0,0,0,0,0,0,0,0,0,0,0,1,1,0,0,0,0,0,0,0,0,0,0
153603,34000,340,0,-2,47,8,39,0,0,0,1,0,1,1,0,1,3,0,3,0,0,0,40,7,33,1,0,1,0,0,0,1,1,0
153630,34000,340,0,-2,1,0,1,0,0,0,0,0,0,0,0,0,0,0,0,0,0,0,1,0,1,0,0,0,0,0,0,0,0,0
153658,34000,340,0,-2,148,63,85,1,0,1,9,4,5,3,3,0,3,0,3,0,0,0,93,34,59,1,0,1,9,4,5,29,18,11
153737,34000,340,0,-2,1,0,1,0,0,0,0,0,0,0,0,0,0,0,0,0,0,0,1,0,1,0,0,0,0,0,0,0,0,0
153825,34000,340,0,-2,2,0,2,0,0,0,0,0,0,0,0,0,0,0,0,0,0,0,2,0,2,0,0,0,0,0,0,0,0,0
153861,34000,340,0,-2,1,0,1,0,0,0,0,0,0,0,0,0,0,0,0,0,0,0,1,0,1,0,0,0,0,0,0,0,0,0
154004,34000,340,0,-2,1,0,1,0,0,0,0,0,0,0,0,0,0,0,0,0,0,0,1,0,1,0,0,0,0,0,0,0,0,0
154013,34000,340,0,-2,1,1,0,0,0,0,0,0,0,0,0,0,0,0,0,0,0,0,1,1,0,0,0,0,0,0,0,0,0,0
154095,34000,340,0,-2,1,0,1,0,0,0,0,0,0,0,0,0,0,0,0,0,0,0,1,0,1,0,0,0,0,0,0,0,0,0
154156,34000,340,0,-2,4,1,3,0,0,0,0,0,0,0,0,0,1,0,1,0,0,0,3,1,2,0,0,0,0,0,0,0,0,0
154350,34000,340,0,-2,1,1,0,0,0,0,0,0,0,0,0,0,1,1,0,0,0,0,0,0,0,0,0,0,0,0,0,0,0,0
154697,34000,340,0,-2,1,0,1,0,0,0,0,0,0,0,0,0,0,0,0,0,0,0,1,0,1,0,0,0,0,0,0,0,0,0
154855,34000,340,0,-2,1,0,1,0,0,0,0,0,0,0,0,0,0,0,0,0,0,0,1,0,1,0,0,0,0,0,0,0,0,0
155025,34000,340,0,-2,3,0,3,0,0,0,0,0,0,0,0,0,0,0,0,0,0,0,3,0,3,0,0,0,0,0,0,0,0,0
155098,34000,340,0,-2,1,1,0,0,0,0,0,0,0,0,0,0,0,0,0,0,0,0,1,1,0,0,0,0,0,0,0,0,0,0
155104,34000,340,0,-2,1,1,0,0,0,0,0,0,0,0,0,0,1,1,0,0,0,0,0,0,0,0,0,0,0,0,0,0,0,0
155186,34000,340,0,-2,1,1,0,0,0,0,0,0,0,0,0,0,0,0,0,0,0,0,1,1,0,0,0,0,0,0,0,0,0,0
155292,34000,340,0,-2,1,0,1,0,0,0,0,0,0,0,0,0,0,0,0,0,0,0,1,0,1,0,0,0,0,0,0,0,0,0
155317,34000,340,0,-2,200,106,94,0,0,0,31,13,18,7,2,5,5,2,3,0,0,0,118,72,46,5,2,3,5,2,3,29,13,16
155399,34000,340,0,-2,51,11,40,0,0,0,0,0,0,1,1,0,5,1,4,0,0,0,39,7,32,0,0,0,0,0,0,6,2,4
155511,34000,340,0,-2,1,1,0,0,0,0,1,1,0,0,0,0,0,0,0,0,0,0,0,0,0,0,0,0,0,0,0,0,0,0
155566,34000,340,0,-2,2,0,2,0,0,0,0,0,0,0,0,0,0,0,0,0,0,0,2,0,2,0,0,0,0,0,0,0,0,0
156125,34000,340,0,-2,8,5,3,0,0,0,3,3,0,0,0,0,1,0,1,0,0,0,4,2,2,0,0,0,0,0,0,0,0,0
156286,34000,340,0,-2,3,1,2,0,0,0,0,0,0,1,0,1,2,1,1,0,0,0,0,0,0,0,0,0,0,0,0,0,0,0
156295,34000,340,0,-2,2,1,1,0,0,0,0,0,0,0,0,0,0,0,0,0,0,0,2,1,1,0,0,0,0,0,0,0,0,0
156408,34000,340,0,-2,2,1,1,0,0,0,0,0,0,0,0,0,0,0,0,0,0,0,2,1,1,0,0,0,0,0,0,0,0,0
156541,34000,340,0,-2,2,1,1,0,0,0,0,0,0,0,0,0,0,0,0,0,0,0,2,1,1,0,0,0,0,0,0,0,0,0
156620,34000,340,0,-2,1,0,1,0,0,0,0,0,0,0,0,0,0,0,0,0,0,0,1,0,1,0,0,0,0,0,0,0,0,0
157085,34000,340,0,-2,48,10,38,0,0,0,0,0,0,1,0,1,2,0,2,0,0,0,45,10,35,0,0,0,0,0,0,0,0,0
157100,34000,340,0,-2,1,0,1,0,0,0,0,0,0,0,0,0,0,0,0,0,0,0,1,0,1,0,0,0,0,0,0,0,0,0
157216,34000,340,0,-2,2,1,1,0,0,0,0,0,0,0,0,0,0,0,0,0,0,0,2,1,1,0,0,0,0,0,0,0,0,0
157289,34000,340,0,-2,243,138,105,1,1,0,22,11,11,8,4,4,6,3,3,0,0,0,107,51,56,1,1,0,88,60,28,10,7,3
157401,34000,340,0,-2,1,0,1,0,0,0,0,0,0,0,0,0,0,0,0,0,0,0,1,0,1,0,0,0,0,0,0,0,0,0
157535,34000,340,0,-2,2,2,0,0,0,0,0,0,0,0,0,0,0,0,0,0,0,0,1,1,0,0,0,0,1,1,0,0,0,0
157757,34000,340,0,-2,4,0,4,0,0,0,0,0,0,0,0,0,0,0,0,0,0,0,4,0,4,0,0,0,0,0,0,0,0,0
157818,34000,340,0,-2,1,0,1,0,0,0,0,0,0,0,0,0,0,0,0,0,0,0,1,0,1,0,0,0,0,0,0,0,0,0
159009,34000,340,0,-2,2,0,2,0,0,0,0,0,0,2,0,2,0,0,0,0,0,0,0,0,0,0,0,0,0,0,0,0,0,0
159373,34000,340,0,-2,5,2,3,0,0,0,0,0,0,4,2,2,0,0,0,0,0,0,1,0,1,0,0,0,0,0,0,0,0,0
159382,34000,340,0,-2,2,1,1,0,0,0,0,0,0,0,0,0,0,0,0,0,0,0,2,1,1,0,0,0,0,0,0,0,0,0
159391,34000,340,0,-2,40,6,34,0,0,0,0,0,0,2,0,2,1,1,0,0,0,0,33,5,28,3,0,3,1,0,1,0,0,0
159416,34000,340,0,-2,1,0,1,0,0,0,0,0,0,0,0,0,0,0,0,0,0,0,1,0,1,0,0,0,0,0,0,0,0,0
159568,34000,340,0,-2,2,0,2,0,0,0,0,0,0,1,0,1,0,0,0,0,0,0,1,0,1,0,0,0,0,0,0,0,0,0
159647,34000,340,0,-2,3,2,1,0,0,0,0,0,0,0,0,0,0,0,0,0,0,0,2,1,1,1,1,0,0,0,0,0,0,0
159656,34000,340,0,-2,3,1,2,0,0,0,0,0,0,0,0,0,1,0,1,0,0,0,2,1,1,0,0,0,0,0,0,0,0,0
160038,34000,340,0,-2,1,0,1,0,0,0,0,0,0,0,0,0,0,0,0,0,0,0,0,0,0,0,0,0,1,0,1,0,0,0
160612,34000,340,0,-2,2,1,1,0,0,0,0,0,0,1,0,1,0,0,0,0,0,0,1,1,0,0,0,0,0,0,0,0,0,0
160658,34000,340,0,-2,20,7,13,0,0,0,1,0,1,12,6,6,1,0,1,0,0,0,4,0,4,2,1,1,0,0,0,0,0,0
160755,34000,340,0,-2,147,30,117,2,0,2,8,2,6,21,3,18,10,2,8,0,0,0,84,16,68,7,2,5,2,2,0,13,3,10
160904,34000,340,0,-2,4,0,4,0,0,0,0,0,0,2,0,2,0,0,0,1,0,1,1,0,1,0,0,0,0,0,0,0,0,0
160977,34000,340,0,-2,4,1,3,0,0,0,0,0,0,0,0,0,0,0,0,0,0,0,4,1,3,0,0,0,0,0,0,0,0,0
161004,34000,340,0,-2,3,2,1,0,0,0,0,0,0,0,0,0,0,0,0,0,0,0,1,0,1,0,0,0,2,2,0,0,0,0
161086,34000,340,0,-2,3,1,2,0,0,0,0,0,0,0,0,0,1,0,1,0,0,0,1,0,1,0,0,0,1,1,0,0,0,0
161226,34000,340,0,-2,1,1,0,0,0,0,0,0,0,0,0,0,0,0,0,0,0,0,1,1,0,0,0,0,0,0,0,0,0,0
161235,34000,340,0,-2,1,1,0,0,0,0,0,0,0,0,0,0,0,0,0,0,0,0,1,1,0,0,0,0,0,0,0,0,0,0
161253,34000,340,0,-2,3,3,0,0,0,0,0,0,0,0,0,0,0,0,0,0,0,0,3,3,0,0,0,0,0,0,0,0,0,0
161341,34000,340,0,-2,1,0,1,0,0,0,0,0,0,0,0,0,0,0,0,0,0,0,1,0,1,0,0,0,0,0,0,0,0,0
161457,34000,340,0,-2,3,0,3,0,0,0,0,0,0,1,0,1,0,0,0,0,0,0,2,0,2,0,0,0,0,0,0,0,0,0
161554,34000,340,0,-2,2,1,1,0,0,0,0,0,0,0,0,0,1,0,1,0,0,0,1,1,0,0,0,0,0,0,0,0,0,0
161767,34000,340,0,-2,1,1,0,0,0,0,0,0,0,0,0,0,0,0,0,0,0,0,1,1,0,0,0,0,0,0,0,0,0,0
162283,34000,340,0,-2,1,0,1,0,0,0,0,0,0,1,0,1,0,0,0,0,0,0,0,0,0,0,0,0,0,0,0,0,0,0
162557,34000,340,0,-2,1,0,1,0,0,0,0,0,0,0,0,0,0,0,0,0,0,0,1,0,1,0,0,0,0,0,0,0,0,0
162584,34000,340,0,-2,3,1,2,0,0,0,0,0,0,0,0,0,0,0,0,0,0,0,3,1,2,0,0,0,0,0,0,0,0,0
162654,34000,340,0,-2,3,2,1,0,0,0,1,0,1,0,0,0,0,0,0,0,0,0,2,2,0,0,0,0,0,0,0,0,0,0
162779,34000,340,0,-2,4,0,4,0,0,0,0,0,0,1,0,1,0,0,0,0,0,0,3,0,3,0,0,0,0,0,0,0,0,0
162928,34000,340,0,-2,459,116,343,2,0,2,64,22,42,96,15,81,39,14,25,0,0,0,210,48,162,8,1,7,4,2,2,36,14,22
163046,34000,340,0,-2,3,1,2,0,0,0,0,0,0,0,0,0,0,0,0,0,0,0,3,1,2,0,0,0,0,0,0,0,0,0
163259,34000,340,0,-2,28,5,23,0,0,0,7,1,6,4,0,4,1,0,1,0,0,0,15,4,11,1,0,1,0,0,0,0,0,0
163268,34000,340,0,-2,1,0,1,0,0,0,0,0,0,1,0,1,0,0,0,0,0,0,0,0,0,0,0,0,0,0,0,0,0,0
163286,34000,340,0,-2,5,1,4,0,0,0,0,0,0,0,0,0,0,0,0,0,0,0,2,0,2,1,0,1,2,1,1,0,0,0
163453,34000,340,0,-2,7,1,6,0,0,0,0,0,0,2,0,2,1,0,1,0,0,0,0,0,0,1,0,1,1,0,1,2,1,1
163462,34000,340,0,-2,2,1,1,0,0,0,0,0,0,0,0,0,0,0,0,0,0,0,2,1,1,0,0,0,0,0,0,0,0,0
163851,34000,340,0,-2,2,0,2,0,0,0,0,0,0,0,0,0,0,0,0,0,0,0,2,0,2,0,0,0,0,0,0,0,0,0
163912,34000,340,0,-2,1,0,1,0,0,0,0,0,0,0,0,0,0,0,0,0,0,0,1,0,1,0,0,0,0,0,0,0,0,0
164076,34000,340,0,-2,5,3,2,0,0,0,0,0,0,1,0,1,0,0,0,0,0,0,4,3,1,0,0,0,0,0,0,0,0,0
164155,34000,340,0,-2,1,0,1,0,0,0,0,0,0,0,0,0,0,0,0,0,0,0,1,0,1,0,0,0,0,0,0,0,0,0
164173,34000,340,0,-2,2,2,0,0,0,0,0,0,0,0,0,0,0,0,0,0,0,0,2,2,0,0,0,0,0,0,0,0,0,0
164447,34000,340,0,-2,2,0,2,0,0,0,0,0,0,0,0,0,0,0,0,0,0,0,2,0,2,0,0,0,0,0,0,0,0,0
164465,34000,340,0,-2,2,1,1,0,0,0,0,0,0,0,0,0,0,0,0,0,0,0,2,1,1,0,0,0,0,0,0,0,0,0
164492,34000,340,0,-2,1,0,1,0,0,0,0,0,0,0,0,0,0,0,0,0,0,0,1,0,1,0,0,0,0,0,0,0,0,0
164562,34000,340,0,-2,1,1,0,0,0,0,0,0,0,0,0,0,0,0,0,0,0,0,1,1,0,0,0,0,0,0,0,0,0,0
164580,34000,340,0,-2,5,0,5,0,0,0,1,0,1,0,0,0,1,0,1,0,0,0,3,0,3,0,0,0,0,0,0,0,0,0
164739,34000,340,0,-2,2,1,1,0,0,0,0,0,0,0,0,0,0,0,0,0,0,0,2,1,1,0,0,0,0,0,0,0,0,0
164924,34000,340,0,-2,10,5,5,0,0,0,0,0,0,1,0,1,0,0,0,0,0,0,9,5,4,0,0,0,0,0,0,0,0,0
164988,34000,340,0,-2,47,9,38,0,0,0,5,0,5,2,0,2,12,4,8,0,0,0,25,4,21,1,1,0,2,0,2,0,0,0
165334,34000,340,0,-2,1,0,1,0,0,0,0,0,0,0,0,0,0,0,0,0,0,0,1,0,1,0,0,0,0,0,0,0,0,0
165529,34000,340,0,-2,1,0,1,0,0,0,0,0,0,0,0,0,0,0,0,0,0,0,1,0,1,0,0,0,0,0,0,0,0,0
165574,34000,340,0,-2,3,2,1,0,0,0,1,0,1,0,0,0,0,0,0,0,0,0,2,2,0,0,0,0,0,0,0,0,0,0
165662,34000,340,0,-2,5,0,5,0,0,0,1,0,1,1,0,1,0,0,0,0,0,0,3,0,3,0,0,0,0,0,0,0,0,0
165699,34000,340,0,-2,2,1,1,0,0,0,0,0,0,0,0,0,1,1,0,0,0,0,0,0,0,0,0,0,1,0,1,0,0,0
165802,34000,340,0,-2,1,0,1,0,0,0,0,0,0,0,0,0,0,0,0,0,0,0,1,0,1,0,0,0,0,0,0,0,0,0
165820,34000,340,0,-2,2,0,2,0,0,0,0,0,0,0,0,0,0,0,0,0,0,0,2,0,2,0,0,0,0,0,0,0,0,0
165866,34000,340,0,-2,1,0,1,0,0,0,0,0,0,0,0,0,0,0,0,0,0,0,1,0,1,0,0,0,0,0,0,0,0,0
165936,34000,340,0,-2,2,0,2,0,0,0,0,0,0,0,0,0,0,0,0,0,0,0,2,0,2,0,0,0,0,0,0,0,0,0
166027,34000,340,0,-2,16,3,13,0,0,0,1,0,1,2,0,2,5,0,5,0,0,0,8,3,5,0,0,0,0,0,0,0,0,0
166124,34000,340,0,-2,3,2,1,0,0,0,0,0,0,0,0,0,0,0,0,0,0,0,3,2,1,0,0,0,0,0,0,0,0,0
166133,34000,340,0,-2,1,1,0,0,0,0,0,0,0,0,0,0,0,0,0,0,0,0,1,1,0,0,0,0,0,0,0,0,0,0
166391,34000,340,0,-2,1,0,1,0,0,0,0,0,0,1,0,1,0,0,0,0,0,0,0,0,0,0,0,0,0,0,0,0,0,0
166452,34000,340,0,-2,2,1,1,0,0,0,0,0,0,1,0,1,1,1,0,0,0,0,0,0,0,0,0,0,0,0,0,0,0,0
166513,34000,340,0,-2,8,3,5,0,0,0,1,0,1,0,0,0,0,0,0,0,0,0,5,3,2,0,0,0,1,0,1,1,0,1
166629,34000,340,0,-2,15,4,11,0,0,0,0,0,0,1,0,1,0,0,0,0,0,0,14,4,10,0,0,0,0,0,0,0,0,0
166638,34000,340,0,-2,3,1,2,0,0,0,0,0,0,0,0,0,0,0,0,0,0,0,3,1,2,0,0,0,0,0,0,0,0,0
166656,34000,340,0,-2,64,21,43,0,0,0,21,4,17,6,3,3,3,1,2,1,0,1,22,8,14,0,0,0,2,1,1,9,4,5
166683,34000,340,0,-2,30,6,24,0,0,0,5,1,4,9,3,6,3,0,3,0,0,0,12,2,10,0,0,0,0,0,0,1,0,1
166708,34000,340,0,-2,273,120,153,0,0,0,41,16,25,15,8,7,15,8,7,0,0,0,165,72,93,0,0,0,11,2,9,26,14,12
166850,34000,340,0,-2,2,1,1,0,0,0,0,0,0,0,0,0,1,1,0,0,0,0,1,0,1,0,0,0,0,0,0,0,0,0
166911,34000,340,0,-2,1,0,1,0,0,0,0,0,0,0,0,0,0,0,0,0,0,0,0,0,0,0,0,0,1,0,1,0,0,0
166939,34000,340,0,-2,1,0,1,0,0,0,0,0,0,0,0,0,0,0,0,0,0,0,1,0,1,0,0,0,0,0,0,0,0,0
167057,34000,340,0,-2,1,0,1,0,0,0,0,0,0,0,0,0,0,0,0,0,0,0,1,0,1,0,0,0,0,0,0,0,0,0
167093,34000,340,0,-2,5,0,5,0,0,0,0,0,0,0,0,0,0,0,0,0,0,0,0,0,0,0,0,0,5,0,5,0,0,0
167358,34000,340,0,-2,11,2,9,0,0,0,0,0,0,2,0,2,2,1,1,0,0,0,5,1,4,0,0,0,1,0,1,1,0,1
167394,34000,340,0,-2,1,0,1,0,0,0,0,0,0,0,0,0,0,0,0,0,0,0,1,0,1,0,0,0,0,0,0,0,0,0
167534,34000,340,0,-2,1,1,0,0,0,0,0,0,0,0,0,0,0,0,0,0,0,0,1,1,0,0,0,0,0,0,0,0,0,0
167598,34000,340,0,-2,4,0,4,0,0,0,0,0,0,0,0,0,1,0,1,0,0,0,3,0,3,0,0,0,0,0,0,0,0,0
167631,34000,340,0,-2,1,0,1,0,0,0,0,0,0,0,0,0,0,0,0,0,0,0,1,0,1,0,0,0,0,0,0,0,0,0
167729,34000,340,0,-2,1,0,1,0,0,0,0,0,0,0,0,0,1,0,1,0,0,0,0,0,0,0,0,0,0,0,0,0,0,0
167783,34000,340,0,-2,2,0,2,0,0,0,0,0,0,0,0,0,0,0,0,0,0,0,2,0,2,0,0,0,0,0,0,0,0,0
167792,34000,340,0,-2,1,0,1,0,0,0,0,0,0,0,0,0,0,0,0,0,0,0,1,0,1,0,0,0,0,0,0,0,0,0
167835,34000,340,0,-2,1,0,1,0,0,0,0,0,0,0,0,0,0,0,0,0,0,0,1,0,1,0,0,0,0,0,0,0,0,0
167899,34000,340,0,-2,3,0,3,0,0,0,0,0,0,0,0,0,1,0,1,0,0,0,2,0,2,0,0,0,0,0,0,0,0,0
167987,34000,340,0,-2,2,0,2,0,0,0,0,0,0,1,0,1,0,0,0,0,0,0,1,0,1,0,0,0,0,0,0,0,0,0
167996,34000,340,0,-2,1,0,1,0,0,0,0,0,0,0,0,0,0,0,0,0,0,0,0,0,0,0,0,0,1,0,1,0,0,0
168005,34000,340,0,-2,2,1,1,0,0,0,0,0,0,0,0,0,0,0,0,0,0,0,2,1,1,0,0,0,0,0,0,0,0,0
168148,34000,340,0,-2,92,26,66,0,0,0,11,3,8,3,2,1,10,4,6,0,0,0,48,11,37,2,0,2,13,4,9,5,2,3
168218,34000,340,0,-2,1,1,0,0,0,0,0,0,0,0,0,0,0,0,0,0,0,0,1,1,0,0,0,0,0,0,0,0,0,0
168227,34000,340,0,-2,1,0,1,0,0,0,0,0,0,0,0,0,0,0,0,0,0,0,1,0,1,0,0,0,0,0,0,0,0,0
168254,34000,340,0,-2,1,0,1,0,0,0,0,0,0,0,0,0,0,0,0,0,0,0,1,0,1,0,0,0,0,0,0,0,0,0
168263,34000,340,0,-2,1,0,1,0,0,0,0,0,0,0,0,0,0,0,0,0,0,0,1,0,1,0,0,0,0,0,0,0,0,0
168281,34000,340,0,-2,1,0,1,0,0,0,0,0,0,0,0,0,0,0,0,0,0,0,1,0,1,0,0,0,0,0,0,0,0,0
168421,34000,340,0,-2,2,1,1,0,0,0,0,0,0,0,0,0,0,0,0,0,0,0,2,1,1,0,0,0,0,0,0,0,0,0
168528,34000,340,0,-2,1,0,1,0,0,0,0,0,0,0,0,0,0,0,0,0,0,0,1,0,1,0,0,0,0,0,0,0,0,0
169080,34000,340,0,-2,2,1,1,0,0,0,0,0,0,0,0,0,0,0,0,0,0,0,2,1,1,0,0,0,0,0,0,0,0,0
169363,34000,340,0,-2,2,0,2,0,0,0,0,0,0,0,0,0,0,0,0,0,0,0,2,0,2,0,0,0,0,0,0,0,0,0
169716,34000,340,0,-2,4,1,3,0,0,0,0,0,0,3,1,2,0,0,0,0,0,0,0,0,0,0,0,0,0,0,0,1,0,1
169798,34000,340,0,-2,1,1,0,0,0,0,0,0,0,0,0,0,0,0,0,0,0,0,1,1,0,0,0,0,0,0,0,0,0,0
169983,34000,340,0,-2,1,0,1,0,0,0,0,0,0,0,0,0,0,0,0,0,0,0,1,0,1,0,0,0,0,0,0,0,0,0
170082,34000,340,0,-2,1,0,1,0,0,0,1,0,1,0,0,0,0,0,0,0,0,0,0,0,0,0,0,0,0,0,0,0,0,0
170286,34000,340,0,-2,1,0,1,0,0,0,0,0,0,0,0,0,0,0,0,0,0,0,0,0,0,0,0,0,1,0,1,0,0,0
170301,34000,340,0,-2,1,0,1,0,0,0,0,0,0,0,0,0,0,0,0,0,0,0,1,0,1,0,0,0,0,0,0,0,0,0
170532,34000,340,0,-2,2,1,1,0,0,0,0,0,0,0,0,0,0,0,0,0,0,0,0,0,0,1,0,1,1,1,0,0,0,0
170639,34000,340,0,-2,4,0,4,1,0,1,0,0,0,0,0,0,0,0,0,0,0,0,3,0,3,0,0,0,0,0,0,0,0,0
170806,34000,340,0,-2,1,0,1,0,0,0,0,0,0,0,0,0,0,0,0,0,0,0,0,0,0,0,0,0,1,0,1,0,0,0
170976,34000,340,0,-2,154,36,118,0,0,0,13,4,9,19,6,13,13,0,13,0,0,0,103,23,80,2,1,1,2,1,1,2,1,1
171100,34000,340,0,-2,43,13,30,1,0,1,0,0,0,1,1,0,1,1,0,0,0,0,39,10,29,1,1,0,0,0,0,0,0,0
171137,34000,340,0,-2,1,1,0,0,0,0,0,0,0,0,0,0,0,0,0,0,0,0,1,1,0,0,0,0,0,0,0,0,0,0
171146,34000,340,0,-2,4,0,4,0,0,0,0,0,0,1,0,1,0,0,0,0,0,0,3,0,3,0,0,0,0,0,0,0,0,0
171456,34000,340,0,-2,3,2,1,0,0,0,0,0,0,0,0,0,0,0,0,0,0,0,3,2,1,0,0,0,0,0,0,0,0,0
171492,34000,340,0,-2,1,1,0,0,0,0,0,0,0,0,0,0,0,0,0,0,0,0,1,1,0,0,0,0,0,0,0,0,0,0
172051,34000,340,0,-2,5,3,2,0,0,0,0,0,0,0,0,0,0,0,0,0,0,0,5,3,2,0,0,0,0,0,0,0,0,0
172334,34000,340,0,-2,2,0,2,0,0,0,0,0,0,0,0,0,0,0,0,0,0,0,2,0,2,0,0,0,0,0,0,0,0,0
172644,34000,340,0,-2,47,27,20,0,0,0,11,7,4,3,1,2,2,0,2,0,0,0,20,11,9,1,0,1,3,2,1,7,6,1
172699,34000,340,0,-2,3,2,1,0,0,0,0,0,0,0,0,0,1,1,0,0,0,0,2,1,1,0,0,0,0,0,0,0,0,0
173911,34000,340,0,-2,1,1,0,0,0,0,0,0,0,0,0,0,0,0,0,0,0,0,1,1,0,0,0,0,0,0,0,0,0,0
173957,34000,340,0,-2,6,3,3,0,0,0,0,0,0,0,0,0,1,0,1,0,0,0,5,3,2,0,0,0,0,0,0,0,0,0
174066,34000,340,0,-2,75,13,62,0,0,0,2,1,1,7,2,5,2,0,2,0,0,0,56,8,48,3,1,2,4,1,3,1,0,1
174075,34000,340,0,-2,3,0,3,0,0,0,0,0,0,0,0,0,1,0,1,0,0,0,2,0,2,0,0,0,0,0,0,0,0,0
174233,34000,340,0,-2,1,0,1,0,0,0,0,0,0,0,0,0,0,0,0,0,0,0,1,0,1,0,0,0,0,0,0,0,0,0
174491,34000,340,0,-2,1,0,1,0,0,0,0,0,0,0,0,0,1,0,1,0,0,0,0,0,0,0,0,0,0,0,0,0,0,0
174747,34000,340,0,-2,1,0,1,0,0,0,0,0,0,0,0,0,0,0,0,0,0,0,1,0,1,0,0,0,0,0,0,0,0,0
174914,34000,340,0,-2,1,1,0,0,0,0,0,0,0,0,0,0,1,1,0,0,0,0,0,0,0,0,0,0,0,0,0,0,0,0
175421,34000,340,0,-2,1,0,1,0,0,0,0,0,0,0,0,0,0,0,0,0,0,0,1,0,1,0,0,0,0,0,0,0,0,0
175519,34000,340,0,-2,1,0,1,0,0,0,0,0,0,1,0,1,0,0,0,0,0,0,0,0,0,0,0,0,0,0,0,0,0,0
175616,34000,340,0,-2,1,0,1,0,0,0,0,0,0,0,0,0,0,0,0,0,0,0,1,0,1,0,0,0,0,0,0,0,0,0
175786,34000,340,0,-2,1,0,1,0,0,0,0,0,0,0,0,0,0,0,0,0,0,0,1,0,1,0,0,0,0,0,0,0,0,0
175856,34000,340,0,-2,3,0,3,0,0,0,0,0,0,2,0,2,0,0,0,0,0,0,0,0,0,0,0,0,0,0,0,1,0,1
175980,34000,340,0,-2,1,0,1,0,0,0,0,0,0,0,0,0,0,0,0,0,0,0,0,0,0,1,0,1,0,0,0,0,0,0
176008,34000,340,0,-2,1,0,1,0,0,0,0,0,0,0,0,0,0,0,0,0,0,0,1,0,1,0,0,0,0,0,0,0,0,0
176017,34000,340,0,-2,1006,220,786,0,0,0,31,13,18,309,35,274,13,3,10,0,0,0,605,149,456,18,5,13,9,5,4,21,10,11
176053,34000,340,0,-2,1,0,1,0,0,0,0,0,0,0,0,0,0,0,0,0,0,0,1,0,1,0,0,0,0,0,0,0,0,0
176080,34000,340,0,-2,43,9,34,0,0,0,0,0,0,4,0,4,1,0,1,0,0,0,38,9,29,0,0,0,0,0,0,0,0,0
176318,34000,340,0,-2,2,2,0,0,0,0,0,0,0,2,2,0,0,0,0,0,0,0,0,0,0,0,0,0,0,0,0,0,0,0
176965,34000,340,0,-2,4,1,3,0,0,0,0,0,0,0,0,0,0,0,0,0,0,0,3,1,2,1,0,1,0,0,0,0,0,0
177065,34000,340,0,-2,1,0,1,0,0,0,0,0,0,0,0,0,1,0,1,0,0,0,0,0,0,0,0,0,0,0,0,0,0,0
177339,34000,340,0,-2,1,0,1,0,0,0,0,0,0,0,0,0,0,0,0,0,0,0,1,0,1,0,0,0,0,0,0,0,0,0
177418,34000,340,0,-2,1,0,1,0,0,0,0,0,0,0,0,0,0,0,0,0,0,0,1,0,1,0,0,0,0,0,0,0,0,0
177472,34000,340,0,-2,1,0,1,0,0,0,0,0,0,0,0,0,0,0,0,0,0,0,1,0,1,0,0,0,0,0,0,0,0,0
177551,34000,340,0,-2,1,1,0,0,0,0,0,0,0,0,0,0,0,0,0,0,0,0,1,1,0,0,0,0,0,0,0,0,0,0
177986,34000,340,0,-2,6,4,2,0,0,0,1,1,0,0,0,0,0,0,0,0,0,0,5,3,2,0,0,0,0,0,0,0,0,0
178244,34000,340,0,-2,2,1,1,0,0,0,0,0,0,0,0,0,0,0,0,0,0,0,2,1,1,0,0,0,0,0,0,0,0,0
178341,34000,340,0,-2,2,1,1,0,0,0,0,0,0,0,0,0,1,0,1,0,0,0,1,1,0,0,0,0,0,0,0,0,0,0
178387,34000,340,0,-2,1,1,0,0,0,0,0,0,0,0,0,0,0,0,0,0,0,0,0,0,0,0,0,0,1,1,0,0,0,0
178396,34000,340,0,-2,118,17,101,1,0,1,2,0,2,9,1,8,6,1,5,0,0,0,83,13,70,4,1,3,11,1,10,2,0,2
178402,34000,340,0,-2,139,70,69,0,0,0,17,9,8,12,5,7,3,1,2,0,0,0,44,23,21,2,0,2,40,17,23,21,15,6
178411,34000,340,0,-2,5,3,2,0,0,0,0,0,0,0,0,0,1,1,0,0,0,0,3,1,2,1,1,0,0,0,0,0,0,0
178420,34000,340,0,-2,9,2,7,0,0,0,3,0,3,0,0,0,1,0,1,0,0,0,5,2,3,0,0,0,0,0,0,0,0,0
178615,34000,340,0,-2,1,0,1,0,0,0,0,0,0,0,0,0,0,0,0,0,0,0,1,0,1,0,0,0,0,0,0,0,0,0
178624,34000,340,0,-2,4,1,3,1,1,0,0,0,0,0,0,0,0,0,0,0,0,0,3,0,3,0,0,0,0,0,0,0,0,0
179159,34000,340,0,-2,258,127,131,0,0,0,42,21,21,12,4,8,11,4,7,0,0,0,154,75,79,8,3,5,2,2,0,29,18,11
179344,34000,340,0,-2,1,0,1,0,0,0,0,0,0,0,0,0,0,0,0,0,0,0,1,0,1,0,0,0,0,0,0,0,0,0
179557,34000,340,0,-2,1,0,1,0,0,0,0,0,0,0,0,0,0,0,0,0,0,0,1,0,1,0,0,0,0,0,0,0,0,0
179566,34000,340,0,-2,5,1,4,0,0,0,0,0,0,0,0,0,1,1,0,0,0,0,4,0,4,0,0,0,0,0,0,0,0,0
179812,34000,340,0,-2,1,0,1,0,0,0,0,0,0,1,0,1,0,0,0,0,0,0,0,0,0,0,0,0,0,0,0,0,0,0
179867,34000,340,0,-2,372,55,317,1,0,1,25,5,20,52,6,46,10,2,8,0,0,0,272,39,233,8,2,6,2,0,2,2,1,1
180106,34000,340,0,-2,2,0,2,0,0,0,0,0,0,0,0,0,0,0,0,0,0,0,0,0,0,0,0,0,2,0,2,0,0,0
180258,34000,340,0,-2,1,0,1,0,0,0,0,0,0,0,0,0,0,0,0,0,0,0,1,0,1,0,0,0,0,0,0,0,0,0
180461,34000,340,0,-2,5,1,4,0,0,0,0,0,0,0,0,0,0,0,0,0,0,0,5,1,4,0,0,0,0,0,0,0,0,0
180489,34000,340,0,-2,6,6,0,0,0,0,0,0,0,0,0,0,0,0,0,0,0,0,6,6,0,0,0,0,0,0,0,0,0,0
180814,34000,340,0,-2,1,0,1,0,0,0,0,0,0,0,0,0,0,0,0,0,0,0,1,0,1,0,0,0,0,0,0,0,0,0
181002,34000,340,0,-2,12,2,10,0,0,0,0,0,0,1,0,1,1,0,1,0,0,0,8,2,6,0,0,0,2,0,2,0,0,0
181020,34000,340,0,-2,1,1,0,0,0,0,0,0,0,0,0,0,0,0,0,0,0,0,0,0,0,0,0,0,1,1,0,0,0,0
181215,34000,340,0,-2,2,2,0,0,0,0,0,0,0,0,0,0,0,0,0,0,0,0,2,2,0,0,0,0,0,0,0,0,0,0
181330,34000,340,0,-2,3,1,2,0,0,0,1,1,0,0,0,0,0,0,0,0,0,0,2,0,2,0,0,0,0,0,0,0,0,0
181394,34000,340,0,-2,1,1,0,0,0,0,0,0,0,0,0,0,0,0,0,0,0,0,1,1,0,0,0,0,0,0,0,0,0,0
181428,34000,340,0,-2,279,142,137,0,0,0,28,15,13,10,5,5,18,8,10,0,0,0,192,95,97,2,0,2,3,1,2,26,18,8
181464,34000,340,0,-2,8,6,2,0,0,0,1,1,0,1,0,1,1,1,0,0,0,0,5,4,1,0,0,0,0,0,0,0,0,0
181534,34000,340,0,-2,1,0,1,0,0,0,0,0,0,0,0,0,0,0,0,0,0,0,1,0,1,0,0,0,0,0,0,0,0,0
182005,34000,340,0,-2,1,0,1,0,0,0,0,0,0,1,0,1,0,0,0,0,0,0,0,0,0,0,0,0,0,0,0,0,0,0
182281,34000,340,0,-2,1,1,0,0,0,0,0,0,0,0,0,0,0,0,0,0,0,0,0,0,0,0,0,0,1,1,0,0,0,0
182290,34000,340,0,-2,6,2,4,0,0,0,0,0,0,0,0,0,0,0,0,0,0,0,5,1,4,1,1,0,0,0,0,0,0,0
182634,34000,340,0,-2,1,1,0,0,0,0,0,0,0,0,0,0,0,0,0,0,0,0,1,1,0,0,0,0,0,0,0,0,0,0
182670,34000,340,0,-2,3,2,1,0,0,0,0,0,0,0,0,0,1,1,0,0,0,0,2,1,1,0,0,0,0,0,0,0,0,0
182795,34000,340,0,-2,1,0,1,0,0,0,0,0,0,0,0,0,0,0,0,0,0,0,1,0,1,0,0,0,0,0,0,0,0,0
182980,34000,340,0,-2,2,0,2,0,0,0,0,0,0,0,0,0,0,0,0,0,0,0,2,0,2,0,0,0,0,0,0,0,0,0
183026,34000,340,0,-2,1,1,0,0,0,0,0,0,0,0,0,0,0,0,0,0,0,0,1,1,0,0,0,0,0,0,0,0,0,0
183044,34000,340,0,-2,10,1,9,0,0,0,0,0,0,0,0,0,0,0,0,0,0,0,10,1,9,0,0,0,0,0,0,0,0,0
183062,34000,340,0,-2,1,0,1,0,0,0,0,0,0,0,0,0,0,0,0,0,0,0,1,0,1,0,0,0,0,0,0,0,0,0
183071,34000,340,0,-2,1,1,0,0,0,0,0,0,0,0,0,0,0,0,0,0,0,0,1,1,0,0,0,0,0,0,0,0,0,0
183080,34000,340,0,-2,1,1,0,0,0,0,0,0,0,0,0,0,0,0,0,0,0,0,1,1,0,0,0,0,0,0,0,0,0,0
183211,34000,340,0,-2,2,1,1,0,0,0,0,0,0,0,0,0,0,0,0,0,0,0,2,1,1,0,0,0,0,0,0,0,0,0
183239,34000,340,0,-2,4,1,3,0,0,0,0,0,0,0,0,0,0,0,0,0,0,0,4,1,3,0,0,0,0,0,0,0,0,0
183822,34000,340,0,-2,2,0,2,0,0,0,0,0,0,2,0,2,0,0,0,0,0,0,0,0,0,0,0,0,0,0,0,0,0,0
183910,34000,340,0,-2,2,2,0,0,0,0,0,0,0,0,0,0,0,0,0,0,0,0,2,2,0,0,0,0,0,0,0,0,0,0
184180,34000,340,0,-2,1,0,1,0,0,0,0,0,0,0,0,0,1,0,1,0,0,0,0,0,0,0,0,0,0,0,0,0,0,0
184603,34000,340,0,-2,3,0,3,0,0,0,0,0,0,0,0,0,0,0,0,0,0,0,2,0,2,0,0,0,1,0,1,0,0,0
184694,34000,340,0,-2,2,0,2,0,0,0,0,0,0,1,0,1,0,0,0,0,0,0,1,0,1,0,0,0,0,0,0,0,0,0
184773,34000,340,0,-2,1,1,0,0,0,0,0,0,0,0,0,0,0,0,0,0,0,0,1,1,0,0,0,0,0,0,0,0,0,0
184782,34000,340,0,-2,6,2,4,0,0,0,1,1,0,0,0,0,1,0,1,0,0,0,3,1,2,1,0,1,0,0,0,0,0,0
185262,34000,340,0,-2,1,0,1,0,0,0,0,0,0,0,0,0,0,0,0,0,0,0,1,0,1,0,0,0,0,0,0,0,0,0
185572,34000,340,0,-2,5,1,4,0,0,0,0,0,0,0,0,0,0,0,0,0,0,0,4,1,3,1,0,1,0,0,0,0,0,0
185590,34000,340,0,-2,18,1,17,0,0,0,0,0,0,3,0,3,3,1,2,0,0,0,8,0,8,2,0,2,2,0,2,0,0,0
185873,34000,340,0,-2,1,1,0,0,0,0,0,0,0,0,0,0,0,0,0,0,0,0,0,0,0,0,0,0,1,1,0,0,0,0
186131,34000,340,0,-2,5,0,5,0,0,0,0,0,0,0,0,0,0,0,0,0,0,0,4,0,4,0,0,0,1,0,1,0,0,0
186201,34000,340,0,-2,1,0,1,0,0,0,0,0,0,0,0,0,0,0,0,0,0,0,1,0,1,0,0,0,0,0,0,0,0,0
186380,34000,340,0,-2,556,276,280,0,0,0,22,9,13,13,3,10,13,3,10,1,0,1,23,15,8,4,2,2,438,214,224,42,30,12
186399,34000,340,0,-2,1,1,0,0,0,0,1,1,0,0,0,0,0,0,0,0,0,0,0,0,0,0,0,0,0,0,0,0,0,0
186432,34000,340,0,-2,2,1,1,0,0,0,0,0,0,0,0,0,0,0,0,0,0,0,2,1,1,0,0,0,0,0,0,0,0,0
186584,34000,340,0,-2,3,1,2,0,0,0,0,0,0,0,0,0,0,0,0,0,0,0,3,1,2,0,0,0,0,0,0,0,0,0
186867,34000,340,0,-2,1,0,1,0,0,0,0,0,0,0,0,0,0,0,0,0,0,0,1,0,1,0,0,0,0,0,0,0,0,0
187444,34000,340,0,-2,2,0,2,0,0,0,0,0,0,0,0,0,0,0,0,0,0,0,2,0,2,0,0,0,0,0,0,0,0,0
187897,34000,340,0,-2,1,0,1,0,0,0,0,0,0,0,0,0,0,0,0,0,0,0,1,0,1,0,0,0,0,0,0,0,0,0
187985,34000,340,0,-2,60,10,50,2,0,2,3,0,3,2,0,2,19,4,15,0,0,0,30,4,26,2,1,1,0,0,0,2,1,1
188030,34000,340,0,-2,6,2,4,0,0,0,0,0,0,0,0,0,3,1,2,0,0,0,3,1,2,0,0,0,0,0,0,0,0,0
188182,34000,340,0,-2,1,0,1,0,0,0,0,0,0,0,0,0,0,0,0,0,0,0,0,0,0,0,0,0,1,0,1,0,0,0
188429,34000,340,0,-2,2,0,2,0,0,0,0,0,0,0,0,0,1,0,1,0,0,0,1,0,1,0,0,0,0,0,0,0,0,0
188526,34000,340,0,-2,1,1,0,0,0,0,0,0,0,0,0,0,0,0,0,0,0,0,1,1,0,0,0,0,0,0,0,0,0,0
188580,34000,340,0,-2,112,10,102,1,0,1,3,1,2,8,0,8,7,1,6,2,1,1,66,0,66,3,0,3,22,7,15,0,0,0
188641,34000,340,0,-2,3,1,2,0,0,0,0,0,0,0,0,0,0,0,0,0,0,0,3,1,2,0,0,0,0,0,0,0,0,0
188854,34000,340,0,-2,1,0,1,0,0,0,0,0,0,0,0,0,0,0,0,0,0,0,1,0,1,0,0,0,0,0,0,0,0,0
189088,34000,340,0,-2,1,1,0,0,0,0,0,0,0,0,0,0,0,0,0,0,0,0,1,1,0,0,0,0,0,0,0,0,0,0
189097,34000,340,0,-2,4,0,4,0,0,0,0,0,0,0,0,0,1,0,1,0,0,0,1,0,1,0,0,0,2,0,2,0,0,0
189705,34000,340,0,-2,1,1,0,0,0,0,0,0,0,0,0,0,0,0,0,0,0,0,1,1,0,0,0,0,0,0,0,0,0,0
190044,34000,340,0,-2,3,1,2,0,0,0,0,0,0,0,0,0,0,0,0,0,0,0,3,1,2,0,0,0,0,0,0,0,0,0
190071,34000,340,0,-2,1,0,1,0,0,0,0,0,0,1,0,1,0,0,0,0,0,0,0,0,0,0,0,0,0,0,0,0,0,0
190150,34000,340,0,-2,214,48,166,0,0,0,41,9,32,16,3,13,50,10,40,1,0,1,90,22,68,4,0,4,8,2,6,4,2,2
190415,34000,340,0,-2,87,26,61,1,0,1,14,6,8,3,0,3,6,2,4,0,0,0,60,15,45,2,2,0,1,1,0,0,0,0
190424,34000,340,0,-2,161,26,135,1,0,1,33,6,27,26,6,20,24,5,19,0,0,0,76,9,67,0,0,0,0,0,0,1,0,1
190503,34000,340,0,-2,1,1,0,0,0,0,0,0,0,1,1,0,0,0,0,0,0,0,0,0,0,0,0,0,0,0,0,0,0,0
190716,34000,340,0,-2,1,0,1,0,0,0,0,0,0,0,0,0,0,0,0,0,0,0,1,0,1,0,0,0,0,0,0,0,0,0
190761,34000,340,0,-2,1,1,0,0,0,0,0,0,0,0,0,0,0,0,0,0,0,0,0,0,0,0,0,0,1,1,0,0,0,0
191126,34000,340,0,-2,1,1,0,0,0,0,0,0,0,0,0,0,0,0,0,0,0,0,1,1,0,0,0,0,0,0,0,0,0,0
191241,34000,340,0,-2,2,1,1,0,0,0,0,0,0,1,1,0,0,0,0,0,0,0,1,0,1,0,0,0,0,0,0,0,0,0
191515,34000,340,0,-2,1,1,0,0,0,0,0,0,0,0,0,0,0,0,0,0,0,0,1,1,0,0,0,0,0,0,0,0,0,0
191533,34000,340,0,-2,1,0,1,0,0,0,0,0,0,0,0,0,0,0,0,0,0,0,1,0,1,0,0,0,0,0,0,0,0,0
191649,34000,340,0,-2,3,1,2,0,0,0,0,0,0,0,0,0,1,1,0,0,0,0,2,0,2,0,0,0,0,0,0,0,0,0
191676,34000,340,0,-2,1,0,1,0,0,0,0,0,0,0,0,0,0,0,0,0,0,0,1,0,1,0,0,0,0,0,0,0,0,0
191931,34000,340,0,-2,3,2,1,0,0,0,0,0,0,0,0,0,0,0,0,0,0,0,3,2,1,0,0,0,0,0,0,0,0,0
191968,34000,340,0,-2,2,0,2,0,0,0,0,0,0,0,0,0,0,0,0,0,0,0,1,0,1,0,0,0,1,0,1,0,0,0
191986,34000,340,0,-2,2,2,0,0,0,0,0,0,0,1,1,0,0,0,0,0,0,0,1,1,0,0,0,0,0,0,0,0,0,0
192323,34000,340,0,-2,3,1,2,0,0,0,0,0,0,0,0,0,0,0,0,0,0,0,3,1,2,0,0,0,0,0,0,0,0,0
192749,34000,340,0,-2,1,0,1,0,0,0,0,0,0,0,0,0,0,0,0,0,0,0,1,0,1,0,0,0,0,0,0,0,0,0
192819,34000,340,0,-2,5,2,3,0,0,0,0,0,0,0,0,0,0,0,0,0,0,0,5,2,3,0,0,0,0,0,0,0,0,0
192925,34000,340,0,-2,1,0,1,0,0,0,0,0,0,0,0,0,0,0,0,0,0,0,1,0,1,0,0,0,0,0,0,0,0,0
193292,34000,340,0,-2,1,0,1,0,0,0,0,0,0,1,0,1,0,0,0,0,0,0,0,0,0,0,0,0,0,0,0,0,0,0
193326,34000,340,0,-2,1,0,1,0,0,0,0,0,0,0,0,0,0,0,0,0,0,0,1,0,1,0,0,0,0,0,0,0,0,0
193353,34000,340,0,-2,1,0,1,0,0,0,0,0,0,0,0,0,0,0,0,0,0,0,1,0,1,0,0,0,0,0,0,0,0,0
193405,34000,340,0,-2,407,148,259,0,0,0,45,18,27,7,3,4,30,10,20,0,0,0,43,7,36,2,0,2,163,52,111,117,58,59
193584,34000,340,0,-2,1,0,1,0,0,0,0,0,0,0,0,0,1,0,1,0,0,0,0,0,0,0,0,0,0,0,0,0,0,0
193900,34000,340,0,-2,711,132,579,1,0,1,137,35,102,114,20,94,145,16,129,1,0,1,239,39,200,25,5,20,1,1,0,48,16,32
193973,34000,340,0,-2,4,1,3,0,0,0,0,0,0,0,0,0,0,0,0,0,0,0,4,1,3,0,0,0,0,0,0,0,0,0
194073,34000,340,0,-2,4,3,1,0,0,0,2,2,0,1,0,1,0,0,0,0,0,0,1,1,0,0,0,0,0,0,0,0,0,0
194091,34000,340,0,-2,2,0,2,0,0,0,0,0,0,1,0,1,0,0,0,0,0,0,1,0,1,0,0,0,0,0,0,0,0,0
194161,34000,340,0,-2,1,1,0,0,0,0,0,0,0,0,0,0,0,0,0,0,0,0,1,1,0,0,0,0,0,0,0,0,0,0
194310,34000,340,0,-2,5,0,5,0,0,0,0,0,0,0,0,0,0,0,0,0,0,0,4,0,4,0,0,0,1,0,1,0,0,0
194578,34000,340,0,-2,2,1,1,0,0,0,0,0,0,2,1,1,0,0,0,0,0,0,0,0,0,0,0,0,0,0,0,0,0,0
194824,34000,340,0,-2,3,0,3,0,0,0,1,0,1,0,0,0,0,0,0,0,0,0,2,0,2,0,0,0,0,0,0,0,0,0
195003,34000,340,0,-2,2,0,2,0,0,0,0,0,0,0,0,0,1,0,1,0,0,0,1,0,1,0,0,0,0,0,0,0,0,0
195030,34000,340,0,-2,40,12,28,0,0,0,5,2,3,5,1,4,2,0,2,0,0,0,23,7,16,1,0,1,0,0,0,4,2,2
195049,34000,340,0,-2,2,0,2,0,0,0,1,0,1,0,0,0,1,0,1,0,0,0,0,0,0,0,0,0,0,0,0,0,0,0
195128,34000,340,0,-2,2,2,0,0,0,0,0,0,0,0,0,0,0,0,0,0,0,0,2,2,0,0,0,0,0,0,0,0,0,0
195164,34000,340,0,-2,4,2,2,0,0,0,0,0,0,0,0,0,0,0,0,0,0,0,4,2,2,0,0,0,0,0,0,0,0,0
195173,34000,340,0,-2,1,0,1,0,0,0,0,0,0,0,0,0,0,0,0,0,0,0,1,0,1,0,0,0,0,0,0,0,0,0
195216,34000,340,0,-2,1,0,1,0,0,0,0,0,0,0,0,0,0,0,0,0,0,0,1,0,1,0,0,0,0,0,0,0,0,0
195234,34000,340,0,-2,2,0,2,0,0,0,0,0,0,0,0,0,0,0,0,0,0,0,2,0,2,0,0,0,0,0,0,0,0,0
195243,34000,340,0,-2,1,0,1,0,0,0,0,0,0,0,0,0,1,0,1,0,0,0,0,0,0,0,0,0,0,0,0,0,0,0
195474,34000,340,0,-2,1,0,1,0,0,0,0,0,0,0,0,0,0,0,0,0,0,0,1,0,1,0,0,0,0,0,0,0,0,0
195526,34000,340,0,-2,2,1,1,0,0,0,0,0,0,0,0,0,0,0,0,0,0,0,1,1,0,0,0,0,1,0,1,0,0,0
195720,34000,340,0,-2,1,0,1,0,0,0,0,0,0,0,0,0,0,0,0,0,0,0,1,0,1,0,0,0,0,0,0,0,0,0
195809,34000,340,0,-2,5,0,5,0,0,0,3,0,3,0,0,0,0,0,0,0,0,0,2,0,2,0,0,0,0,0,0,0,0,0
196006,34000,340,0,-2,2,1,1,0,0,0,0,0,0,0,0,0,0,0,0,0,0,0,2,1,1,0,0,0,0,0,0,0,0,0
196024,34000,340,0,-2,1,0,1,0,0,0,0,0,0,0,0,0,0,0,0,0,0,0,0,0,0,1,0,1,0,0,0,0,0,0
196033,34000,340,0,-2,5,3,2,0,0,0,0,0,0,0,0,0,0,0,0,0,0,0,5,3,2,0,0,0,0,0,0,0,0,0
196051,34000,340,0,-2,7,1,6,0,0,0,0,0,0,0,0,0,0,0,0,0,0,0,7,1,6,0,0,0,0,0,0,0,0,0
196060,34000,340,0,-2,6,2,4,0,0,0,1,1,0,1,0,1,0,0,0,0,0,0,4,1,3,0,0,0,0,0,0,0,0,0
196079,34000,340,0,-2,31,7,24,0,0,0,0,0,0,1,1,0,0,0,0,0,0,0,28,4,24,0,0,0,0,0,0,2,2,0
196088,34000,340,0,-2,18,9,9,0,0,0,0,0,0,3,1,2,1,1,0,0,0,0,13,6,7,1,1,0,0,0,0,0,0,0
196097,34000,340,0,-2,9,2,7,0,0,0,2,0,2,0,0,0,0,0,0,0,0,0,3,0,3,1,0,1,2,1,1,1,1,0
196103,34000,340,0,-2,4,2,2,0,0,0,0,0,0,0,0,0,0,0,0,0,0,0,4,2,2,0,0,0,0,0,0,0,0,0
196121,34000,340,0,-2,1,0,1,0,0,0,0,0,0,0,0,0,0,0,0,0,0,0,1,0,1,0,0,0,0,0,0,0,0,0
196130,34000,340,0,-2,1,0,1,0,0,0,0,0,0,0,0,0,0,0,0,0,0,0,1,0,1,0,0,0,0,0,0,0,0,0
196149,34000,340,0,-2,1,0,1,0,0,0,0,0,0,0,0,0,0,0,0,0,0,0,1,0,1,0,0,0,0,0,0,0,0,0
196158,34000,340,0,-2,5,3,2,0,0,0,0,0,0,0,0,0,0,0,0,0,0,0,5,3,2,0,0,0,0,0,0,0,0,0
196167,34000,340,0,-2,2,0,2,0,0,0,0,0,0,0,0,0,0,0,0,0,0,0,2,0,2,0,0,0,0,0,0,0,0,0
196176,34000,340,0,-2,1,0,1,0,0,0,0,0,0,0,0,0,0,0,0,0,0,0,1,0,1,0,0,0,0,0,0,0,0,0
196185,34000,340,0,-2,2,1,1,0,0,0,1,0,1,0,0,0,0,0,0,0,0,0,1,1,0,0,0,0,0,0,0,0,0,0
196194,34000,340,0,-2,2,0,2,0,0,0,0,0,0,0,0,0,0,0,0,0,0,0,2,0,2,0,0,0,0,0,0,0,0,0
196200,34000,340,0,-2,1,0,1,0,0,0,0,0,0,0,0,0,0,0,0,0,0,0,1,0,1,0,0,0,0,0,0,0,0,0
196219,34000,340,0,-2,1,0,1,0,0,0,0,0,0,0,0,0,0,0,0,0,0,0,1,0,1,0,0,0,0,0,0,0,0,0
196228,34000,340,0,-2,25,5,20,0,0,0,9,3,6,5,0,5,5,2,3,0,0,0,6,0,6,0,0,0,0,0,0,0,0,0
196237,34000,340,0,-2,1,0,1,0,0,0,0,0,0,1,0,1,0,0,0,0,0,0,0,0,0,0,0,0,0,0,0,0,0,0
196246,34000,340,0,-2,1,0,1,0,0,0,0,0,0,0,0,0,0,0,0,0,0,0,1,0,1,0,0,0,0,0,0,0,0,0
196255,34000,340,0,-2,50,31,19,0,0,0,16,9,7,3,1,2,2,2,0,0,0,0,15,14,1,3,2,1,0,0,0,11,3,8
196264,34000,340,0,-2,7,5,2,0,0,0,0,0,0,0,0,0,0,0,0,0,0,0,7,5,2,0,0,0,0,0,0,0,0,0
196307,34000,340,0,-2,92,48,44,0,0,0,12,5,7,9,2,7,5,1,4,0,0,0,49,28,21,0,0,0,1,1,0,16,11,5
196413,34000,340,0,-2,1,1,0,0,0,0,0,0,0,1,1,0,0,0,0,0,0,0,0,0,0,0,0,0,0,0,0,0,0,0
196592,34000,340,0,-2,1,0,1,0,0,0,0,0,0,0,0,0,1,0,1,0,0,0,0,0,0,0,0,0,0,0,0,0,0,0
196699,34000,340,0,-2,1,0,1,0,0,0,0,0,0,0,0,0,0,0,0,0,0,0,1,0,1,0,0,0,0,0,0,0,0,0
196866,34000,340,0,-2,2,2,0,0,0,0,0,0,0,0,0,0,0,0,0,0,0,0,2,2,0,0,0,0,0,0,0,0,0,0
197036,34000,340,0,-2,1,0,1,0,0,0,0,0,0,0,0,0,0,0,0,0,0,0,1,0,1,0,0,0,0,0,0,0,0,0
197045,34000,340,0,-2,1,0,1,0,0,0,0,0,0,0,0,0,0,0,0,0,0,0,1,0,1,0,0,0,0,0,0,0,0,0
197133,34000,340,0,-2,5,0,5,0,0,0,0,0,0,0,0,0,0,0,0,0,0,0,4,0,4,0,0,0,1,0,1,0,0,0
197869,34000,340,0,-2,12,4,8,0,0,0,1,1,0,1,1,0,0,0,0,0,0,0,9,2,7,1,0,1,0,0,0,0,0,0
197911,34000,340,0,-2,8,1,7,0,0,0,0,0,0,0,0,0,0,0,0,0,0,0,7,1,6,0,0,0,1,0,1,0,0,0
198039,34000,340,0,-2,2,2,0,0,0,0,0,0,0,0,0,0,1,1,0,0,0,0,1,1,0,0,0,0,0,0,0,0,0,0
198136,34000,340,0,-2,7,5,2,0,0,0,1,1,0,0,0,0,0,0,0,0,0,0,6,4,2,0,0,0,0,0,0,0,0,0
198215,34000,340,0,-2,3,1,2,0,0,0,0,0,0,0,0,0,0,0,0,0,0,0,3,1,2,0,0,0,0,0,0,0,0,0
198303,34000,340,0,-2,1,1,0,0,0,0,0,0,0,1,1,0,0,0,0,0,0,0,0,0,0,0,0,0,0,0,0,0,0,0
198385,34000,340,0,-2,3,1,2,0,0,0,0,0,0,0,0,0,0,0,0,0,0,0,2,1,1,0,0,0,1,0,1,0,0,0
198419,34000,340,0,-2,139,49,90,0,0,0,12,0,12,19,6,13,9,4,5,0,0,0,85,34,51,8,1,7,0,0,0,6,4,2
198455,34000,340,0,-2,1,1,0,0,0,0,0,0,0,0,0,0,0,0,0,0,0,0,1,1,0,0,0,0,0,0,0,0,0,0
198464,34000,340,0,-2,45,7,38,0,0,0,0,0,0,7,1,6,10,3,7,0,0,0,26,2,24,1,1,0,1,0,1,0,0,0
198507,34000,340,0,-2,1,0,1,0,0,0,0,0,0,1,0,1,0,0,0,0,0,0,0,0,0,0,0,0,0,0,0,0,0,0
198516,34000,340,0,-2,3,2,1,0,0,0,0,0,0,0,0,0,1,0,1,0,0,0,2,2,0,0,0,0,0,0,0,0,0,0
198543,34000,340,0,-2,3,0,3,0,0,0,0,0,0,3,0,3,0,0,0,0,0,0,0,0,0,0,0,0,0,0,0,0,0,0
198561,34000,340,0,-2,1,0,1,0,0,0,0,0,0,0,0,0,0,0,0,0,0,0,1,0,1,0,0,0,0,0,0,0,0,0
198570,34000,340,0,-2,1,1,0,0,0,0,0,0,0,1,1,0,0,0,0,0,0,0,0,0,0,0,0,0,0,0,0,0,0,0
198598,34000,340,0,-2,3,2,1,0,0,0,0,0,0,0,0,0,0,0,0,0,0,0,3,2,1,0,0,0,0,0,0,0,0,0
198695,34000,340,0,-2,2,0,2,0,0,0,0,0,0,0,0,0,1,0,1,0,0,0,1,0,1,0,0,0,0,0,0,0,0,0
198756,34000,340,0,-2,1,0,1,0,0,0,0,0,0,1,0,1,0,0,0,0,0,0,0,0,0,0,0,0,0,0,0,0,0,0
198808,34000,340,0,-2,2,1,1,0,0,0,0,0,0,0,0,0,0,0,0,0,0,0,2,1,1,0,0,0,0,0,0,0,0,0
198835,34000,340,0,-2,1,0,1,0,0,0,0,0,0,0,0,0,0,0,0,0,0,0,1,0,1,0,0,0,0,0,0,0,0,0
198871,34000,340,0,-2,2,0,2,0,0,0,0,0,0,0,0,0,0,0,0,0,0,0,2,0,2,0,0,0,0,0,0,0,0,0
198899,34000,340,0,-2,5,3,2,0,0,0,0,0,0,0,0,0,0,0,0,0,0,0,5,3,2,0,0,0,0,0,0,0,0,0
198950,34000,340,0,-2,1,0,1,0,0,0,0,0,0,0,0,0,1,0,1,0,0,0,0,0,0,0,0,0,0,0,0,0,0,0
198969,34000,340,0,-2,2,0,2,0,0,0,0,0,0,0,0,0,0,0,0,0,0,0,2,0,2,0,0,0,0,0,0,0,0,0
199102,34000,340,0,-2,4,1,3,0,0,0,0,0,0,3,1,2,0,0,0,0,0,0,0,0,0,0,0,0,1,0,1,0,0,0
199111,34000,340,0,-2,2,0,2,0,0,0,0,0,0,0,0,0,0,0,0,0,0,0,2,0,2,0,0,0,0,0,0,0,0,0
199120,34000,340,0,-2,187,44,143,0,0,0,19,5,14,20,1,19,15,6,9,0,0,0,86,22,64,6,1,5,36,8,28,5,1,4
199139,34000,340,0,-2,8,5,3,0,0,0,0,0,0,0,0,0,2,2,0,0,0,0,6,3,3,0,0,0,0,0,0,0,0,0
199148,34000,340,0,-2,4,2,2,0,0,0,0,0,0,2,0,2,1,1,0,0,0,0,1,1,0,0,0,0,0,0,0,0,0,0
199157,34000,340,0,-2,2,1,1,0,0,0,0,0,0,1,1,0,0,0,0,0,0,0,0,0,0,0,0,0,1,0,1,0,0,0
199193,34000,340,0,-2,34,10,24,1,0,1,3,2,1,1,0,1,0,0,0,0,0,0,26,6,20,0,0,0,2,1,1,1,1,0
199218,34000,340,0,-2,3,0,3,0,0,0,0,0,0,0,0,0,0,0,0,0,0,0,2,0,2,0,0,0,1,0,1,0,0,0
199272,34000,340,0,-2,3,2,1,0,0,0,0,0,0,0,0,0,1,1,0,0,0,0,2,1,1,0,0,0,0,0,0,0,0,0
199281,34000,340,0,-2,1,0,1,1,0,1,0,0,0,0,0,0,0,0,0,0,0,0,0,0,0,0,0,0,0,0,0,0,0,0
199643,34000,340,0,-2,1,0,1,0,0,0,0,0,0,1,0,1,0,0,0,0,0,0,0,0,0,0,0,0,0,0,0,0,0,0
199698,34000,340,0,-2,1,0,1,0,0,0,0,0,0,0,0,0,0,0,0,0,0,0,1,0,1,0,0,0,0,0,0,0,0,0
199847,34000,340,0,-2,34,5,29,0,0,0,3,0,3,7,1,6,4,1,3,0,0,0,19,2,17,0,0,0,0,0,0,1,1,0
199962,34000,340,0,-2,4,1,3,0,0,0,0,0,0,1,0,1,0,0,0,0,0,0,3,1,2,0,0,0,0,0,0,0,0,0
199999,34000,340,0,-2,2,0,2,0,0,0,0,0,0,1,0,1,0,0,0,0,0,0,0,0,0,0,0,0,1,0,1,0,0,0
200004,34000,340,0,-2,8,2,6,0,0,0,0,0,0,1,1,0,1,0,1,0,0,0,6,1,5,0,0,0,0,0,0,0,0,0
200022,34000,340,0,-2,1,0,1,0,0,0,0,0,0,0,0,0,0,0,0,0,0,0,1,0,1,0,0,0,0,0,0,0,0,0
200226,34000,340,0,-2,2,0,2,0,0,0,0,0,0,0,0,0,0,0,0,0,0,0,2,0,2,0,0,0,0,0,0,0,0,0
200253,34000,340,0,-2,1,0,1,0,0,0,0,0,0,0,0,0,1,0,1,0,0,0,0,0,0,0,0,0,0,0,0,0,0,0
200280,34000,340,0,-2,5,2,3,1,1,0,0,0,0,0,0,0,0,0,0,0,0,0,4,1,3,0,0,0,0,0,0,0,0,0
200314,34000,340,0,-2,1,0,1,0,0,0,0,0,0,0,0,0,0,0,0,0,0,0,1,0,1,0,0,0,0,0,0,0,0,0
200332,34000,340,0,-2,5,1,4,0,0,0,0,0,0,0,0,0,0,0,0,0,0,0,5,1,4,0,0,0,0,0,0,0,0,0
200800,34000,340,0,-2,6,3,3,0,0,0,0,0,0,0,0,0,0,0,0,0,0,0,6,3,3,0,0,0,0,0,0,0,0,0
201195,34000,340,0,-2,1,0,1,0,0,0,0,0,0,0,0,0,0,0,0,0,0,0,1,0,1,0,0,0,0,0,0,0,0,0
201371,34000,340,0,-2,3,1,2,0,0,0,0,0,0,0,0,0,0,0,0,0,0,0,3,1,2,0,0,0,0,0,0,0,0,0
201645,34000,340,0,-2,33,9,24,0,0,0,4,2,2,4,1,3,5,2,3,0,0,0,20,4,16,0,0,0,0,0,0,0,0,0
201654,34000,340,0,-2,3,0,3,0,0,0,0,0,0,0,0,0,0,0,0,0,0,0,3,0,3,0,0,0,0,0,0,0,0,0
201885,34000,340,0,-2,123,19,104,0,0,0,7,1,6,11,2,9,9,3,6,0,0,0,91,12,79,0,0,0,2,0,2,3,1,2
202356,34000,340,0,-2,1,1,0,0,0,0,0,0,0,0,0,0,0,0,0,0,0,0,1,1,0,0,0,0,0,0,0,0,0,0
202480,34000,340,0,-2,5,2,3,0,0,0,1,1,0,0,0,0,0,0,0,0,0,0,3,1,2,0,0,0,0,0,0,1,0,1
202523,34000,340,0,-2,2,1,1,0,0,0,0,0,0,0,0,0,0,0,0,0,0,0,2,1,1,0,0,0,0,0,0,0,0,0
202763,34000,340,0,-2,4,0,4,0,0,0,0,0,0,0,0,0,0,0,0,0,0,0,4,0,4,0,0,0,0,0,0,0,0,0
203517,34000,340,0,-2,12,2,10,0,0,0,0,0,0,0,0,0,0,0,0,0,0,0,12,2,10,0,0,0,0,0,0,0,0,0
203535,34000,340,0,-2,1,1,0,0,0,0,0,0,0,0,0,0,0,0,0,0,0,0,0,0,0,0,0,0,1,1,0,0,0,0
203580,34000,340,0,-2,1,0,1,0,0,0,0,0,0,0,0,0,0,0,0,0,0,0,1,0,1,0,0,0,0,0,0,0,0,0
204024,34000,340,0,-2,3,1,2,0,0,0,1,1,0,0,0,0,0,0,0,0,0,0,1,0,1,0,0,0,1,0,1,0,0,0
204194,34000,340,0,-2,1,0,1,0,0,0,0,0,0,0,0,0,0,0,0,0,0,0,1,0,1,0,0,0,0,0,0,0,0,0
204200,34000,340,0,-2,1,1,0,0,0,0,0,0,0,0,0,0,0,0,0,0,0,0,1,1,0,0,0,0,0,0,0,0,0,0
204264,34000,340,0,-2,2,0,2,0,0,0,0,0,0,0,0,0,0,0,0,0,0,0,2,0,2,0,0,0,0,0,0,0,0,0
204477,34000,340,0,-2,3,1,2,0,0,0,1,1,0,0,0,0,0,0,0,0,0,0,2,0,2,0,0,0,0,0,0,0,0,0
204501,34000,340,0,-2,1,0,1,0,0,0,0,0,0,1,0,1,0,0,0,0,0,0,0,0,0,0,0,0,0,0,0,0,0,0
204635,34000,340,0,-2,2,1,1,0,0,0,0,0,0,1,1,0,0,0,0,0,0,0,1,0,1,0,0,0,0,0,0,0,0,0
204796,34000,340,0,-2,723,148,575,0,0,0,39,8,31,78,20,58,22,6,16,0,0,0,531,102,429,19,6,13,32,4,28,2,2,0
204857,34000,340,0,-2,3,2,1,0,0,0,0,0,0,0,0,0,0,0,0,0,0,0,2,1,1,0,0,0,1,1,0,0,0,0
206084,34000,340,0,-2,260,92,168,0,0,0,34,16,18,43,5,38,12,4,8,0,0,0,168,67,101,1,0,1,2,0,2,0,0,0
206507,34000,340,0,-2,3,0,3,0,0,0,0,0,0,0,0,0,0,0,0,0,0,0,3,0,3,0,0,0,0,0,0,0,0,0
206525,34000,340,0,-2,1,1,0,0,0,0,0,0,0,0,0,0,0,0,0,0,0,0,1,1,0,0,0,0,0,0,0,0,0,0
206589,34000,340,0,-2,1,1,0,0,0,0,0,0,0,0,0,0,0,0,0,0,0,0,1,1,0,0,0,0,0,0,0,0,0,0
206604,34000,340,0,-2,2,1,1,0,0,0,0,0,0,0,0,0,0,0,0,0,0,0,2,1,1,0,0,0,0,0,0,0,0,0
206695,34000,340,0,-2,4,1,3,0,0,0,0,0,0,1,1,0,0,0,0,0,0,0,3,0,3,0,0,0,0,0,0,0,0,0
206862,34000,340,0,-2,2,1,1,0,0,0,0,0,0,0,0,0,0,0,0,0,0,0,1,1,0,1,0,1,0,0,0,0,0,0
206914,34000,340,0,-2,2,0,2,0,0,0,0,0,0,0,0,0,0,0,0,0,0,0,2,0,2,0,0,0,0,0,0,0,0,0
207209,34000,340,0,-2,2,0,2,0,0,0,0,0,0,0,0,0,0,0,0,0,0,0,2,0,2,0,0,0,0,0,0,0,0,0
207263,34000,340,0,-2,10,1,9,0,0,0,1,0,1,0,0,0,0,0,0,0,0,0,5,1,4,1,0,1,0,0,0,3,0,3
207315,34000,340,0,-2,53,9,44,4,0,4,4,0,4,6,0,6,5,0,5,0,0,0,30,7,23,2,1,1,1,1,0,1,0,1
207342,34000,340,0,-2,28,1,27,2,0,2,2,0,2,1,0,1,3,0,3,0,0,0,18,1,17,1,0,1,1,0,1,0,0,0
207351,34000,340,0,-2,1,1,0,0,0,0,0,0,0,0,0,0,0,0,0,0,0,0,1,1,0,0,0,0,0,0,0,0,0,0
207388,34000,340,0,-2,6,1,5,0,0,0,1,0,1,0,0,0,0,0,0,0,0,0,4,1,3,1,0,1,0,0,0,0,0,0
207500,34000,340,0,-2,11,4,7,0,0,0,0,0,0,2,2,0,1,0,1,0,0,0,7,2,5,0,0,0,1,0,1,0,0,0
207582,34000,340,0,-2,4,3,1,0,0,0,0,0,0,0,0,0,0,0,0,0,0,0,4,3,1,0,0,0,0,0,0,0,0,0
207865,34000,340,0,-2,2,1,1,0,0,0,0,0,0,0,0,0,0,0,0,0,0,0,2,1,1,0,0,0,0,0,0,0,0,0
207971,34000,340,0,-2,2,1,1,0,0,0,0,0,0,0,0,0,0,0,0,0,0,0,1,1,0,0,0,0,1,0,1,0,0,0
209250,34000,340,0,-2,1,1,0,0,0,0,0,0,0,0,0,0,0,0,0,0,0,0,1,1,0,0,0,0,0,0,0,0,0,0
209490,34000,340,0,-2,415,182,233,1,0,1,71,28,43,10,4,6,30,20,10,4,3,1,213,83,130,9,5,4,54,28,26,23,11,12
209542,34000,340,0,-2,14,0,14,0,0,0,0,0,0,0,0,0,0,0,0,0,0,0,8,0,8,1,0,1,5,0,5,0,0,0
209551,34000,340,0,-2,10,4,6,0,0,0,0,0,0,0,0,0,1,1,0,0,0,0,9,3,6,0,0,0,0,0,0,0,0,0
209612,34000,340,0,-2,4,1,3,0,0,0,0,0,0,0,0,0,1,0,1,0,0,0,3,1,2,0,0,0,0,0,0,0,0,0
209807,34000,340,0,-2,1,1,0,0,0,0,0,0,0,1,1,0,0,0,0,0,0,0,0,0,0,0,0,0,0,0,0,0,0,0
209825,34000,340,0,-2,2,2,0,0,0,0,0,0,0,0,0,0,0,0,0,0,0,0,1,1,0,1,1,0,0,0,0,0,0,0
210331,34000,340,0,-2,1,1,0,0,0,0,0,0,0,0,0,0,0,0,0,0,0,0,1,1,0,0,0,0,0,0,0,0,0,0
210429,34000,340,0,-2,1,1,0,0,0,0,0,0,0,0,0,0,0,0,0,0,0,0,1,1,0,0,0,0,0,0,0,0,0,0
210438,34000,340,0,-2,1,0,1,0,0,0,0,0,0,0,0,0,0,0,0,0,0,0,1,0,1,0,0,0,0,0,0,0,0,0
210571,34000,340,0,-2,3,2,1,0,0,0,0,0,0,1,1,0,0,0,0,0,0,0,2,1,1,0,0,0,0,0,0,0,0,0
210739,34000,340,0,-2,1,1,0,0,0,0,0,0,0,0,0,0,0,0,0,0,0,0,1,1,0,0,0,0,0,0,0,0,0,0
211088,34000,340,0,-2,3,2,1,0,0,0,0,0,0,0,0,0,0,0,0,0,0,0,3,2,1,0,0,0,0,0,0,0,0,0
211158,34000,340,0,-2,2,0,2,0,0,0,0,0,0,0,0,0,0,0,0,0,0,0,2,0,2,0,0,0,0,0,0,0,0,0
211291,34000,340,0,-2,2,1,1,0,0,0,0,0,0,1,0,1,1,1,0,0,0,0,0,0,0,0,0,0,0,0,0,0,0,0
211440,34000,340,0,-2,3,1,2,0,0,0,0,0,0,0,0,0,1,1,0,0,0,0,2,0,2,0,0,0,0,0,0,0,0,0
211583,34000,340,0,-2,2,1,1,0,0,0,0,0,0,0,0,0,0,0,0,0,0,0,2,1,1,0,0,0,0,0,0,0,0,0
211644,34000,340,0,-2,3,1,2,0,0,0,0,0,0,1,1,0,0,0,0,0,0,0,2,0,2,0,0,0,0,0,0,0,0,0
211981,34000,340,0,-2,5,0,5,0,0,0,0,0,0,0,0,0,0,0,0,0,0,0,5,0,5,0,0,0,0,0,0,0,0,0
212054,34000,340,0,-2,6,1,5,0,0,0,0,0,0,0,0,0,1,0,1,0,0,0,5,1,4,0,0,0,0,0,0,0,0,0
212106,34000,340,0,-2,3,0,3,0,0,0,0,0,0,0,0,0,0,0,0,0,0,0,3,0,3,0,0,0,0,0,0,0,0,0
212160,34000,340,0,-2,1,0,1,0,0,0,0,0,0,0,0,0,0,0,0,0,0,0,1,0,1,0,0,0,0,0,0,0,0,0
212601,34000,340,0,-2,5,0,5,0,0,0,0,0,0,0,0,0,0,0,0,0,0,0,5,0,5,0,0,0,0,0,0,0,0,0
212674,34000,340,0,-2,2,1,1,0,0,0,0,0,0,0,0,0,0,0,0,0,0,0,2,1,1,0,0,0,0,0,0,0,0,0
212911,34000,340,0,-2,1,0,1,0,0,0,0,0,0,1,0,1,0,0,0,0,0,0,0,0,0,0,0,0,0,0,0,0,0,0
212984,34000,340,0,-2,1,0,1,0,0,0,0,0,0,0,0,0,0,0,0,0,0,0,1,0,1,0,0,0,0,0,0,0,0,0
213367,34000,340,0,-2,6,3,3,0,0,0,0,0,0,1,1,0,0,0,0,0,0,0,5,2,3,0,0,0,0,0,0,0,0,0
213507,34000,340,0,-2,1,0,1,0,0,0,0,0,0,0,0,0,0,0,0,0,0,0,1,0,1,0,0,0,0,0,0,0,0,0
213543,34000,340,0,-2,12,5,7,0,0,0,0,0,0,0,0,0,2,2,0,0,0,0,8,3,5,1,0,1,1,0,1,0,0,0
213598,34000,340,0,-2,1,0,1,0,0,0,0,0,0,1,0,1,0,0,0,0,0,0,0,0,0,0,0,0,0,0,0,0,0,0
213668,34000,340,0,-2,1,0,1,0,0,0,0,0,0,0,0,0,0,0,0,0,0,0,1,0,1,0,0,0,0,0,0,0,0,0
213987,34000,340,0,-2,1,0,1,0,0,0,0,0,0,0,0,0,0,0,0,0,0,0,1,0,1,0,0,0,0,0,0,0,0,0
214175,34000,340,0,-2,1,0,1,0,0,0,0,0,0,0,0,0,0,0,0,0,0,0,1,0,1,0,0,0,0,0,0,0,0,0
215062,34000,340,0,-2,373,114,259,1,1,0,57,14,43,44,15,29,28,11,17,0,0,0,207,64,143,11,3,8,19,5,14,6,1,5
215293,34000,340,0,-2,48,8,40,0,0,0,3,1,2,3,1,2,2,0,2,0,0,0,30,4,26,1,0,1,6,1,5,3,1,2
215442,34000,340,0,-2,2,0,2,0,0,0,0,0,0,0,0,0,0,0,0,0,0,0,2,0,2,0,0,0,0,0,0,0,0,0
215743,34000,340,0,-2,1,0,1,0,0,0,0,0,0,0,0,0,0,0,0,0,0,0,1,0,1,0,0,0,0,0,0,0,0,0
215770,34000,340,0,-2,1,0,1,0,0,0,0,0,0,0,0,0,0,0,0,0,0,0,1,0,1,0,0,0,0,0,0,0,0,0
215798,34000,340,0,-2,2,0,2,0,0,0,0,0,0,0,0,0,0,0,0,0,0,0,2,0,2,0,0,0,0,0,0,0,0,0
215947,34000,340,0,-2,1,1,0,0,0,0,0,0,0,0,0,0,0,0,0,0,0,0,1,1,0,0,0,0,0,0,0,0,0,0
216038,34000,340,0,-2,6,1,5,0,0,0,0,0,0,1,0,1,0,0,0,0,0,0,5,1,4,0,0,0,0,0,0,0,0,0
216296,34000,340,0,-2,1,0,1,0,0,0,0,0,0,0,0,0,1,0,1,0,0,0,0,0,0,0,0,0,0,0,0,0,0,0
216339,34000,340,0,-2,55,27,28,0,0,0,5,1,4,22,11,11,5,2,3,0,0,0,18,11,7,1,0,1,4,2,2,0,0,0
216357,34000,340,0,-2,1,0,1,0,0,0,0,0,0,0,0,0,0,0,0,0,0,0,1,0,1,0,0,0,0,0,0,0,0,0
216366,34000,340,0,-2,20,4,16,0,0,0,3,2,1,3,0,3,0,0,0,0,0,0,12,2,10,2,0,2,0,0,0,0,0,0
216524,34000,340,0,-2,2,1,1,0,0,0,0,0,0,0,0,0,0,0,0,0,0,0,2,1,1,0,0,0,0,0,0,0,0,0
216597,34000,340,0,-2,1,0,1,0,0,0,0,0,0,0,0,0,0,0,0,0,0,0,1,0,1,0,0,0,0,0,0,0,0,0
216667,34000,340,0,-2,1,1,0,0,0,0,0,0,0,0,0,0,0,0,0,0,0,0,1,1,0,0,0,0,0,0,0,0,0,0
216694,34000,340,0,-2,1,0,1,0,0,0,0,0,0,0,0,0,0,0,0,0,0,0,1,0,1,0,0,0,0,0,0,0,0,0
216764,34000,340,0,-2,2,0,2,0,0,0,0,0,0,0,0,0,0,0,0,0,0,0,2,0,2,0,0,0,0,0,0,0,0,0
216931,34000,340,0,-2,1,0,1,0,0,0,1,0,1,0,0,0,0,0,0,0,0,0,0,0,0,0,0,0,0,0,0,0,0,0
217059,34000,340,0,-2,1,0,1,0,0,0,0,0,0,0,0,0,0,0,0,0,0,0,1,0,1,0,0,0,0,0,0,0,0,0
217156,34000,340,0,-2,21,4,17,0,0,0,2,1,1,0,0,0,1,0,1,0,0,0,17,3,14,0,0,0,1,0,1,0,0,0
217235,34000,340,0,-2,1,0,1,0,0,0,0,0,0,0,0,0,0,0,0,0,0,0,1,0,1,0,0,0,0,0,0,0,0,0
217402,34000,340,0,-2,2,1,1,0,0,0,0,0,0,0,0,0,0,0,0,0,0,0,2,1,1,0,0,0,0,0,0,0,0,0
217484,34000,340,0,-2,7,2,5,0,0,0,1,0,1,0,0,0,0,0,0,0,0,0,5,1,4,1,1,0,0,0,0,0,0,0
217536,34000,340,0,-2,1,1,0,0,0,0,0,0,0,0,0,0,0,0,0,0,0,0,1,1,0,0,0,0,0,0,0,0,0,0
217633,34000,340,0,-2,2,0,2,0,0,0,0,0,0,0,0,0,0,0,0,0,0,0,2,0,2,0,0,0,0,0,0,0,0,0
217688,34000,340,0,-2,4,2,2,0,0,0,0,0,0,0,0,0,0,0,0,0,0,0,4,2,2,0,0,0,0,0,0,0,0,0
217749,34000,340,0,-2,1,1,0,0,0,0,0,0,0,0,0,0,0,0,0,0,0,0,1,1,0,0,0,0,0,0,0,0,0,0
217864,34000,340,0,-2,1,1,0,0,0,0,0,0,0,0,0,0,0,0,0,0,0,0,0,0,0,0,0,0,1,1,0,0,0,0
217882,34000,340,0,-2,3,1,2,0,0,0,0,0,0,0,0,0,0,0,0,0,0,0,3,1,2,0,0,0,0,0,0,0,0,0
218061,34000,340,0,-2,2,0,2,0,0,0,0,0,0,0,0,0,0,0,0,0,0,0,2,0,2,0,0,0,0,0,0,0,0,0
218070,34000,340,0,-2,2,0,2,0,0,0,0,0,0,0,0,0,0,0,0,0,0,0,2,0,2,0,0,0,0,0,0,0,0,0
218113,34000,340,0,-2,2,0,2,0,0,0,0,0,0,0,0,0,0,0,0,0,0,0,2,0,2,0,0,0,0,0,0,0,0,0
218414,34000,340,0,-2,1,0,1,0,0,0,0,0,0,0,0,0,0,0,0,0,0,0,1,0,1,0,0,0,0,0,0,0,0,0
218539,34000,340,0,-2,2,1,1,0,0,0,0,0,0,1,0,1,0,0,0,0,0,0,1,1,0,0,0,0,0,0,0,0,0,0
218663,34000,340,0,-2,16,2,14,0,0,0,0,0,0,6,1,5,0,0,0,0,0,0,9,1,8,1,0,1,0,0,0,0,0,0
218724,34000,340,0,-2,2,0,2,0,0,0,0,0,0,0,0,0,0,0,0,0,0,0,2,0,2,0,0,0,0,0,0,0,0,0
218742,34000,340,0,-2,2,1,1,0,0,0,0,0,0,0,0,0,0,0,0,0,0,0,1,0,1,0,0,0,0,0,0,1,1,0
218885,34000,340,0,-2,1,0,1,0,0,0,0,0,0,0,0,0,0,0,0,0,0,0,1,0,1,0,0,0,0,0,0,0,0,0
218964,34000,340,0,-2,3,0,3,0,0,0,0,0,0,0,0,0,0,0,0,0,0,0,3,0,3,0,0,0,0,0,0,0,0,0
219000,34000,340,0,-2,1,0,1,0,0,0,0,0,0,0,0,0,0,0,0,0,0,0,1,0,1,0,0,0,0,0,0,0,0,0
219082,34000,340,0,-2,1,0,1,0,0,0,0,0,0,0,0,0,0,0,0,0,0,0,1,0,1,0,0,0,0,0,0,0,0,0
219198,34000,340,0,-2,1,0,1,0,0,0,0,0,0,0,0,0,0,0,0,0,0,0,1,0,1,0,0,0,0,0,0,0,0,0
219356,34000,340,0,-2,2,0,2,0,0,0,0,0,0,0,0,0,0,0,0,0,0,0,2,0,2,0,0,0,0,0,0,0,0,0
219471,34000,340,0,-2,3,1,2,0,0,0,0,0,0,0,0,0,0,0,0,0,0,0,3,1,2,0,0,0,0,0,0,0,0,0
219718,34000,340,0,-2,3,2,1,0,0,0,0,0,0,0,0,0,0,0,0,0,0,0,3,2,1,0,0,0,0,0,0,0,0,0
219806,34000,340,0,-2,1,1,0,0,0,0,0,0,0,0,0,0,0,0,0,0,0,0,1,1,0,0,0,0,0,0,0,0,0,0
219879,34000,340,0,-2,3,2,1,0,0,0,0,0,0,0,0,0,0,0,0,0,0,0,3,2,1,0,0,0,0,0,0,0,0,0
219949,34000,340,0,-2,1,0,1,0,0,0,0,0,0,0,0,0,0,0,0,0,0,0,1,0,1,0,0,0,0,0,0,0,0,0
219976,34000,340,0,-2,1,0,1,0,0,0,0,0,0,0,0,0,0,0,0,0,0,0,0,0,0,0,0,0,1,0,1,0,0,0
220075,34000,340,0,-2,19,0,19,0,0,0,0,0,0,0,0,0,1,0,1,0,0,0,18,0,18,0,0,0,0,0,0,0,0,0
220181,34000,340,0,-2,3,2,1,0,0,0,0,0,0,3,2,1,0,0,0,0,0,0,0,0,0,0,0,0,0,0,0,0,0,0
220613,34000,340,0,-2,1,0,1,0,0,0,0,0,0,0,0,0,0,0,0,0,0,0,1,0,1,0,0,0,0,0,0,0,0,0
220631,34000,340,0,-2,6,1,5,0,0,0,0,0,0,0,0,0,0,0,0,0,0,0,6,1,5,0,0,0,0,0,0,0,0,0
220710,34000,340,0,-2,2,1,1,0,0,0,0,0,0,0,0,0,0,0,0,0,0,0,2,1,1,0,0,0,0,0,0,0,0,0
220792,34000,340,0,-2,31,10,21,0,0,0,0,0,0,26,6,20,1,0,1,0,0,0,4,4,0,0,0,0,0,0,0,0,0,0
220862,34000,340,0,-2,4,0,4,0,0,0,0,0,0,2,0,2,0,0,0,0,0,0,0,0,0,1,0,1,1,0,1,0,0,0
220978,34000,340,0,-2,6,3,3,0,0,0,0,0,0,0,0,0,0,0,0,0,0,0,5,3,2,1,0,1,0,0,0,0,0,0
221351,34000,340,0,-2,6,0,6,0,0,0,0,0,0,2,0,2,3,0,3,0,0,0,1,0,1,0,0,0,0,0,0,0,0,0
221397,34000,340,0,-2,1,1,0,0,0,0,0,0,0,0,0,0,0,0,0,0,0,0,1,1,0,0,0,0,0,0,0,0,0,0
221485,34000,340,0,-2,3,3,0,0,0,0,0,0,0,0,0,0,1,1,0,0,0,0,2,2,0,0,0,0,0,0,0,0,0,0
221643,34000,340,0,-2,7,5,2,0,0,0,0,0,0,1,1,0,1,0,1,0,0,0,4,4,0,1,0,1,0,0,0,0,0,0
221740,34000,340,0,-2,3,0,3,0,0,0,0,0,0,0,0,0,0,0,0,0,0,0,3,0,3,0,0,0,0,0,0,0,0,0
221759,34000,340,0,-2,16,8,8,0,0,0,1,0,1,0,0,0,3,1,2,0,0,0,12,7,5,0,0,0,0,0,0,0,0,0
221768,34000,340,0,-2,2,1,1,0,0,0,0,0,0,1,0,1,0,0,0,0,0,0,1,1,0,0,0,0,0,0,0,0,0,0
221838,34000,340,0,-2,3,1,2,0,0,0,0,0,0,1,0,1,1,0,1,0,0,0,1,1,0,0,0,0,0,0,0,0,0,0
221847,34000,340,0,-2,4,1,3,0,0,0,0,0,0,0,0,0,0,0,0,0,0,0,4,1,3,0,0,0,0,0,0,0,0,0
221892,34000,340,0,-2,2,0,2,0,0,0,0,0,0,0,0,0,0,0,0,0,0,0,2,0,2,0,0,0,0,0,0,0,0,0
221953,34000,340,0,-2,2,1,1,0,0,0,0,0,0,0,0,0,0,0,0,0,0,0,2,1,1,0,0,0,0,0,0,0,0,0
221999,34000,340,0,-2,26,7,19,0,0,0,2,2,0,4,3,1,0,0,0,0,0,0,16,2,14,2,0,2,1,0,1,1,0,1
222053,34000,340,0,-2,3,3,0,0,0,0,0,0,0,1,1,0,1,1,0,0,0,0,1,1,0,0,0,0,0,0,0,0,0,0
222178,34000,340,0,-2,1,0,1,0,0,0,0,0,0,0,0,0,0,0,0,0,0,0,1,0,1,0,0,0,0,0,0,0,0,0
222983,34000,340,0,-2,1,1,0,0,0,0,1,1,0,0,0,0,0,0,0,0,0,0,0,0,0,0,0,0,0,0,0,0,0,0
223223,34000,340,0,-2,144,20,124,0,0,0,25,5,20,35,1,34,23,2,21,1,1,0,42,7,35,6,1,5,12,3,9,0,0,0
223232,34000,340,0,-2,5,2,3,0,0,0,1,0,1,0,0,0,0,0,0,0,0,0,3,2,1,1,0,1,0,0,0,0,0,0
224147,34000,340,0,-2,3,0,3,0,0,0,0,0,0,0,0,0,0,0,0,0,0,0,2,0,2,1,0,1,0,0,0,0,0,0
224545,34000,340,0,-2,1,0,1,0,0,0,0,0,0,0,0,0,0,0,0,0,0,0,1,0,1,0,0,0,0,0,0,0,0,0
224554,34000,340,0,-2,3,3,0,0,0,0,0,0,0,0,0,0,0,0,0,0,0,0,3,3,0,0,0,0,0,0,0,0,0,0
224615,34000,340,0,-2,4,0,4,0,0,0,0,0,0,2,0,2,1,0,1,0,0,0,1,0,1,0,0,0,0,0,0,0,0,0
225247,34000,340,0,-2,2,1,1,0,0,0,0,0,0,0,0,0,1,1,0,0,0,0,1,0,1,0,0,0,0,0,0,0,0,0
225399,34000,340,0,-2,1,1,0,0,0,0,0,0,0,0,0,0,0,0,0,0,0,0,1,1,0,0,0,0,0,0,0,0,0,0
225502,34000,340,0,-2,1,0,1,0,0,0,0,0,0,0,0,0,0,0,0,0,0,0,1,0,1,0,0,0,0,0,0,0,0,0
225511,34000,340,0,-2,17,5,12,0,0,0,4,1,3,2,0,2,3,0,3,0,0,0,6,3,3,1,0,1,0,0,0,1,1,0
225520,34000,340,0,-2,1,0,1,0,0,0,0,0,0,0,0,0,0,0,0,0,0,0,1,0,1,0,0,0,0,0,0,0,0,0
225548,34000,340,0,-2,1,0,1,0,0,0,0,0,0,0,0,0,0,0,0,0,0,0,1,0,1,0,0,0,0,0,0,0,0,0
225627,34000,340,0,-2,66,36,30,0,0,0,11,7,4,4,1,3,25,14,11,0,0,0,22,12,10,3,2,1,0,0,0,1,0,1
225885,34000,340,0,-2,1,0,1,0,0,0,0,0,0,0,0,0,0,0,0,0,0,0,1,0,1,0,0,0,0,0,0,0,0,0
226152,34000,340,0,-2,3,2,1,0,0,0,0,0,0,0,0,0,3,2,1,0,0,0,0,0,0,0,0,0,0,0,0,0,0,0
226383,34000,340,0,-2,1,1,0,0,0,0,0,0,0,0,0,0,0,0,0,0,0,0,0,0,0,0,0,0,1,1,0,0,0,0
226471,34000,340,0,-2,2,0,2,0,0,0,0,0,0,1,0,1,0,0,0,0,0,0,1,0,1,0,0,0,0,0,0,0,0,0
226587,34000,340,0,-2,2,1,1,0,0,0,0,0,0,0,0,0,0,0,0,0,0,0,2,1,1,0,0,0,0,0,0,0,0,0
227216,34000,340,0,-2,9,2,7,0,0,0,0,0,0,0,0,0,1,0,1,0,0,0,8,2,6,0,0,0,0,0,0,0,0,0
227368,34000,340,0,-2,120,52,68,0,0,0,18,7,11,3,1,2,72,29,43,0,0,0,8,2,6,0,0,0,1,0,1,18,13,5
227687,34000,340,0,-2,2,2,0,0,0,0,1,1,0,0,0,0,0,0,0,0,0,0,1,1,0,0,0,0,0,0,0,0,0,0
227757,34000,340,0,-2,9,4,5,0,0,0,0,0,0,0,0,0,1,0,1,0,0,0,8,4,4,0,0,0,0,0,0,0,0,0
227881,34000,340,0,-2,8,2,6,1,0,1,1,1,0,1,0,1,1,0,1,0,0,0,4,1,3,0,0,0,0,0,0,0,0,0
227979,34000,340,0,-2,1,1,0,0,0,0,0,0,0,0,0,0,0,0,0,0,0,0,1,1,0,0,0,0,0,0,0,0,0,0
228246,34000,340,0,-2,6,5,1,0,0,0,0,0,0,1,1,0,1,1,0,0,0,0,3,2,1,0,0,0,0,0,0,1,1,0
228343,34000,340,0,-2,2,0,2,0,0,0,0,0,0,0,0,0,1,0,1,0,0,0,1,0,1,0,0,0,0,0,0,0,0,0
228431,34000,340,0,-2,2,1,1,0,0,0,0,0,0,1,1,0,0,0,0,0,0,0,1,0,1,0,0,0,0,0,0,0,0,0
228459,34000,340,0,-2,10,3,7,0,0,0,0,0,0,0,0,0,1,0,1,0,0,0,8,2,6,0,0,0,1,1,0,0,0,0
228529,34000,340,0,-2,3,2,1,0,0,0,0,0,0,0,0,0,1,0,1,0,0,0,2,2,0,0,0,0,0,0,0,0,0,0
228547,34000,340,0,-2,1,0,1,0,0,0,0,0,0,0,0,0,0,0,0,0,0,0,1,0,1,0,0,0,0,0,0,0,0,0
228635,34000,340,0,-2,91,27,64,0,0,0,10,3,7,12,0,12,11,6,5,0,0,0,51,15,36,4,1,3,1,0,1,2,2,0
228644,34000,340,0,-2,131,22,109,0,0,0,9,3,6,7,2,5,40,6,34,0,0,0,36,6,30,0,0,0,39,5,34,0,0,0
228653,34000,340,0,-2,51,22,29,0,0,0,5,2,3,2,2,0,7,1,6,0,0,0,31,14,17,0,0,0,1,1,0,5,2,3
228705,34000,340,0,-2,1,0,1,0,0,0,0,0,0,0,0,0,0,0,0,0,0,0,1,0,1,0,0,0,0,0,0,0,0,0
228723,34000,340,0,-2,99,17,82,1,1,0,10,1,9,6,1,5,13,3,10,0,0,0,64,11,53,1,0,1,4,0,4,0,0,0
228769,34000,340,0,-2,2,0,2,0,0,0,0,0,0,0,0,0,1,0,1,0,0,0,1,0,1,0,0,0,0,0,0,0,0,0
228778,34000,340,0,-2,46,9,37,0,0,0,1,1,0,2,1,1,8,1,7,0,0,0,34,6,28,1,0,1,0,0,0,0,0,0
228787,34000,340,0,-2,4,1,3,0,0,0,0,0,0,0,0,0,0,0,0,0,0,0,4,1,3,0,0,0,0,0,0,0,0,0
228796,34000,340,0,-2,9,1,8,0,0,0,0,0,0,0,0,0,7,1,6,0,0,0,1,0,1,0,0,0,1,0,1,0,0,0
228802,34000,340,0,-2,272,102,170,0,0,0,44,22,22,42,6,36,26,8,18,0,0,0,157,66,91,0,0,0,0,0,0,3,0,3
228875,34000,340,0,-2,5,1,4,0,0,0,0,0,0,0,0,0,2,0,2,0,0,0,2,0,2,0,0,0,1,1,0,0,0,0
228909,34000,340,0,-2,13,3,10,0,0,0,2,0,2,1,0,1,5,0,5,0,0,0,3,1,2,1,1,0,0,0,0,1,1,0
229018,34000,340,0,-2,1,1,0,0,0,0,0,0,0,0,0,0,0,0,0,0,0,0,1,1,0,0,0,0,0,0,0,0,0,0
229027,34000,340,0,-2,2,2,0,0,0,0,0,0,0,0,0,0,2,2,0,0,0,0,0,0,0,0,0,0,0,0,0,0,0,0
229063,34000,340,0,-2,1,0,1,0,0,0,0,0,0,1,0,1,0,0,0,0,0,0,0,0,0,0,0,0,0,0,0,0,0,0
229115,34000,340,0,-2,2,1,1,0,0,0,0,0,0,0,0,0,0,0,0,0,0,0,2,1,1,0,0,0,0,0,0,0,0,0
229179,34000,340,0,-2,4,0,4,0,0,0,0,0,0,0,0,0,2,0,2,0,0,0,1,0,1,0,0,0,1,0,1,0,0,0
229267,34000,340,0,-2,4,1,3,0,0,0,0,0,0,0,0,0,2,1,1,0,0,0,2,0,2,0,0,0,0,0,0,0,0,0
229337,34000,340,0,-2,64,25,39,1,0,1,10,7,3,7,4,3,13,5,8,0,0,0,33,9,24,0,0,0,0,0,0,0,0,0
230038,34000,340,0,-2,3,1,2,0,0,0,0,0,0,0,0,0,0,0,0,0,0,0,0,0,0,0,0,0,2,1,1,1,0,1
230603,34000,340,0,-2,1,1,0,0,0,0,0,0,0,0,0,0,0,0,0,0,0,0,1,1,0,0,0,0,0,0,0,0,0,0
230728,34000,340,0,-2,6,3,3,1,0,1,1,1,0,0,0,0,0,0,0,0,0,0,3,2,1,1,0,1,0,0,0,0,0,0
230737,34000,340,0,-2,1,0,1,0,0,0,0,0,0,0,0,0,0,0,0,0,0,0,1,0,1,0,0,0,0,0,0,0,0,0
230764,34000,340,0,-2,279,81,198,4,1,3,15,3,12,1,1,0,32,7,25,3,1,2,193,52,141,11,4,7,13,6,7,7,6,1
230782,34000,340,0,-2,2,1,1,0,0,0,0,0,0,0,0,0,1,1,0,0,0,0,0,0,0,0,0,0,0,0,0,1,0,1
230959,34000,340,0,-2,4,2,2,0,0,0,0,0,0,0,0,0,0,0,0,0,0,0,2,1,1,0,0,0,2,1,1,0,0,0
230995,34000,340,0,-2,2,0,2,0,0,0,0,0,0,0,0,0,0,0,0,0,0,0,2,0,2,0,0,0,0,0,0,0,0,0
231174,34000,340,0,-2,4,1,3,0,0,0,1,0,1,0,0,0,0,0,0,0,0,0,2,1,1,1,0,1,0,0,0,0,0,0
231420,34000,340,0,-2,3,2,1,0,0,0,0,0,0,0,0,0,1,0,1,0,0,0,2,2,0,0,0,0,0,0,0,0,0,0
231581,34000,340,0,-2,1,1,0,0,0,0,0,0,0,0,0,0,0,0,0,0,0,0,1,1,0,0,0,0,0,0,0,0,0,0
231624,34000,340,0,-2,6,3,3,0,0,0,0,0,0,2,1,1,0,0,0,0,0,0,4,2,2,0,0,0,0,0,0,0,0,0
231970,34000,340,0,-2,25,1,24,0,0,0,1,1,0,6,0,6,0,0,0,0,0,0,17,0,17,1,0,1,0,0,0,0,0,0
232043,34000,340,0,-2,1,0,1,0,0,0,0,0,0,0,0,0,0,0,0,0,0,0,1,0,1,0,0,0,0,0,0,0,0,0
232089,34000,340,0,-2,1,0,1,0,0,0,0,0,0,0,0,0,0,0,0,0,0,0,1,0,1,0,0,0,0,0,0,0,0,0
232186,34000,340,0,-2,14,2,12,0,0,0,0,0,0,2,0,2,1,0,1,0,0,0,10,1,9,1,1,0,0,0,0,0,0,0
232265,34000,340,0,-2,4,0,4,0,0,0,0,0,0,2,0,2,0,0,0,0,0,0,2,0,2,0,0,0,0,0,0,0,0,0
232308,34000,340,0,-2,1,0,1,0,0,0,0,0,0,0,0,0,0,0,0,0,0,0,1,0,1,0,0,0,0,0,0,0,0,0
232423,34000,340,0,-2,7,3,4,0,0,0,0,0,0,0,0,0,1,1,0,0,0,0,6,2,4,0,0,0,0,0,0,0,0,0
232557,34000,340,0,-2,4,2,2,0,0,0,0,0,0,0,0,0,0,0,0,0,0,0,4,2,2,0,0,0,0,0,0,0,0,0
232566,34000,340,0,-2,1,1,0,0,0,0,0,0,0,0,0,0,0,0,0,0,0,0,1,1,0,0,0,0,0,0,0,0,0,0
232672,34000,340,0,-2,2,1,1,0,0,0,0,0,0,0,0,0,0,0,0,0,0,0,2,1,1,0,0,0,0,0,0,0,0,0
232681,34000,340,0,-2,1,1,0,0,0,0,0,0,0,0,0,0,0,0,0,0,0,0,1,1,0,0,0,0,0,0,0,0,0,0
232706,34000,340,0,-2,3,0,3,0,0,0,0,0,0,0,0,0,0,0,0,0,0,0,3,0,3,0,0,0,0,0,0,0,0,0
233277,34000,340,0,-2,1,1,0,0,0,0,0,0,0,0,0,0,0,0,0,0,0,0,1,1,0,0,0,0,0,0,0,0,0,0
233295,34000,340,0,-2,1,1,0,0,0,0,0,0,0,1,1,0,0,0,0,0,0,0,0,0,0,0,0,0,0,0,0,0,0,0
233374,34000,340,0,-2,4,1,3,0,0,0,0,0,0,1,0,1,1,0,1,0,0,0,2,1,1,0,0,0,0,0,0,0,0,0
233426,34000,340,0,-2,1,0,1,0,0,0,0,0,0,0,0,0,0,0,0,0,0,0,1,0,1,0,0,0,0,0,0,0,0,0
233541,34000,340,0,-2,2,0,2,0,0,0,0,0,0,0,0,0,0,0,0,0,0,0,1,0,1,0,0,0,1,0,1,0,0,0
233897,34000,340,0,-2,4,1,3,0,0,0,0,0,0,0,0,0,0,0,0,0,0,0,4,1,3,0,0,0,0,0,0,0,0,0
233921,34000,340,0,-2,22,2,20,0,0,0,2,1,1,0,0,0,1,0,1,0,0,0,19,1,18,0,0,0,0,0,0,0,0,0
234030,34000,340,0,-2,86,19,67,0,0,0,5,3,2,12,2,10,4,0,4,0,0,0,59,10,49,2,1,1,0,0,0,4,3,1
234076,34000,340,0,-2,33,9,24,0,0,0,2,0,2,4,3,1,0,0,0,0,0,0,23,6,17,1,0,1,0,0,0,3,0,3
234085,34000,340,0,-2,3,1,2,0,0,0,0,0,0,0,0,0,0,0,0,0,0,0,3,1,2,0,0,0,0,0,0,0,0,0
234155,34000,340,0,-2,4,0,4,0,0,0,0,0,0,2,0,2,0,0,0,0,0,0,2,0,2,0,0,0,0,0,0,0,0,0
234207,34000,340,0,-2,1,0,1,0,0,0,0,0,0,0,0,0,0,0,0,0,0,0,1,0,1,0,0,0,0,0,0,0,0,0
234696,34000,340,0,-2,1,0,1,0,0,0,0,0,0,0,0,0,0,0,0,0,0,0,1,0,1,0,0,0,0,0,0,0,0,0
235547,34000,340,0,-2,3,0,3,0,0,0,0,0,0,0,0,0,0,0,0,0,0,0,2,0,2,0,0,0,1,0,1,0,0,0
235699,34000,340,0,-2,1,0,1,0,0,0,0,0,0,0,0,0,0,0,0,0,0,0,0,0,0,1,0,1,0,0,0,0,0,0
236258,34000,340,0,-2,2,0,2,0,0,0,0,0,0,0,0,0,0,0,0,0,0,0,0,0,0,0,0,0,2,0,2,0,0,0
236328,34000,340,0,-2,1,0,1,0,0,0,0,0,0,0,0,0,0,0,0,0,0,0,1,0,1,0,0,0,0,0,0,0,0,0
236452,34000,340,0,-2,1,0,1,0,0,0,1,0,1,0,0,0,0,0,0,0,0,0,0,0,0,0,0,0,0,0,0,0,0,0
236595,34000,340,0,-2,3,1,2,0,0,0,0,0,0,0,0,0,0,0,0,0,0,0,3,1,2,0,0,0,0,0,0,0,0,0
236638,34000,340,0,-2,1,0,1,0,0,0,1,0,1,0,0,0,0,0,0,0,0,0,0,0,0,0,0,0,0,0,0,0,0,0
236939,34000,340,0,-2,20,6,14,0,0,0,0,0,0,1,1,0,1,1,0,0,0,0,9,2,7,0,0,0,9,2,7,0,0,0
236948,34000,340,0,-2,442,195,247,0,0,0,82,31,51,17,12,5,31,15,16,2,0,2,185,78,107,23,10,13,90,43,47,12,6,6
236975,34000,340,0,-2,1,0,1,0,0,0,0,0,0,0,0,0,0,0,0,0,0,0,1,0,1,0,0,0,0,0,0,0,0,0
237011,34000,340,0,-2,2,1,1,0,0,0,0,0,0,0,0,0,0,0,0,0,0,0,2,1,1,0,0,0,0,0,0,0,0,0
237057,34000,340,0,-2,2,0,2,0,0,0,0,0,0,0,0,0,1,0,1,0,0,0,1,0,1,0,0,0,0,0,0,0,0,0
237181,34000,340,0,-2,1,0,1,0,0,0,0,0,0,0,0,0,0,0,0,0,0,0,1,0,1,0,0,0,0,0,0,0,0,0
237330,34000,340,0,-2,2,1,1,0,0,0,1,1,0,0,0,0,0,0,0,0,0,0,1,0,1,0,0,0,0,0,0,0,0,0
237358,34000,340,0,-2,3,1,2,0,0,0,0,0,0,0,0,0,0,0,0,0,0,0,3,1,2,0,0,0,0,0,0,0,0,0
237367,34000,340,0,-2,1,0,1,0,0,0,0,0,0,0,0,0,0,0,0,0,0,0,1,0,1,0,0,0,0,0,0,0,0,0
237701,34000,340,0,-2,2,0,2,0,0,0,0,0,0,0,0,0,0,0,0,0,0,0,2,0,2,0,0,0,0,0,0,0,0,0
237792,34000,340,0,-2,1,1,0,0,0,0,0,0,0,0,0,0,0,0,0,0,0,0,1,1,0,0,0,0,0,0,0,0,0,0
237880,34000,340,0,-2,1,0,1,0,0,0,0,0,0,0,0,0,0,0,0,0,0,0,1,0,1,0,0,0,0,0,0,0,0,0
237950,34000,340,0,-2,1,0,1,0,0,0,0,0,0,0,0,0,0,0,0,0,0,0,1,0,1,0,0,0,0,0,0,0,0,0
238032,34000,340,0,-2,13,4,9,0,0,0,0,0,0,0,0,0,0,0,0,0,0,0,10,4,6,0,0,0,2,0,2,1,0,1
238078,34000,340,0,-2,1,0,1,0,0,0,0,0,0,0,0,0,0,0,0,0,0,0,1,0,1,0,0,0,0,0,0,0,0,0
238476,34000,340,0,-2,3,1,2,0,0,0,0,0,0,0,0,0,0,0,0,0,0,0,1,0,1,0,0,0,2,1,1,0,0,0
238616,34000,340,0,-2,1,1,0,0,0,0,0,0,0,0,0,0,0,0,0,0,0,0,1,1,0,0,0,0,0,0,0,0,0,0
238661,34000,340,0,-2,1,0,1,0,0,0,0,0,0,0,0,0,0,0,0,0,0,0,1,0,1,0,0,0,0,0,0,0,0,0
238759,34000,340,0,-2,3,0,3,0,0,0,0,0,0,0,0,0,0,0,0,0,0,0,3,0,3,0,0,0,0,0,0,0,0,0
239169,34000,340,0,-2,75,14,61,0,0,0,4,1,3,0,0,0,5,2,3,0,0,0,65,11,54,1,0,1,0,0,0,0,0,0
239318,34000,340,0,-2,1,0,1,0,0,0,0,0,0,0,0,0,0,0,0,0,0,0,1,0,1,0,0,0,0,0,0,0,0,0
239512,34000,340,0,-2,1,0,1,0,0,0,0,0,0,0,0,0,0,0,0,0,0,0,1,0,1,0,0,0,0,0,0,0,0,0
240268,34000,340,0,-2,1,1,0,0,0,0,0,0,0,0,0,0,0,0,0,0,0,0,1,1,0,0,0,0,0,0,0,0,0,0
240338,34000,340,0,-2,1,0,1,0,0,0,0,0,0,0,0,0,0,0,0,0,0,0,0,0,0,0,0,0,1,0,1,0,0,0
240444,34000,340,0,-2,42,6,36,0,0,0,2,1,1,0,0,0,3,0,3,0,0,0,35,5,30,1,0,1,1,0,1,0,0,0
240453,34000,340,0,-2,5,2,3,0,0,0,0,0,0,0,0,0,0,0,0,0,0,0,5,2,3,0,0,0,0,0,0,0,0,0
240462,34000,340,0,-2,2,1,1,0,0,0,0,0,0,0,0,0,0,0,0,0,0,0,2,1,1,0,0,0,0,0,0,0,0,0
240471,34000,340,0,-2,1,0,1,0,0,0,0,0,0,0,0,0,0,0,0,0,0,0,1,0,1,0,0,0,0,0,0,0,0,0
240480,34000,340,0,-2,2,0,2,0,0,0,0,0,0,0,0,0,0,0,0,0,0,0,2,0,2,0,0,0,0,0,0,0,0,0
240727,34000,340,0,-2,30,10,20,0,0,0,1,0,1,1,0,1,2,1,1,0,0,0,22,8,14,0,0,0,4,1,3,0,0,0
241395,34000,340,0,-2,1,0,1,0,0,0,0,0,0,0,0,0,1,0,1,0,0,0,0,0,0,0,0,0,0,0,0,0,0,0
242653,34000,340,0,-2,2,1,1,0,0,0,0,0,0,0,0,0,2,1,1,0,0,0,0,0,0,0,0,0,0,0,0,0,0,0
242662,34000,340,0,-2,1,0,1,0,0,0,0,0,0,0,0,0,1,0,1,0,0,0,0,0,0,0,0,0,0,0,0,0,0,0
243081,34000,340,0,-2,16,5,11,0,0,0,0,0,0,0,0,0,16,5,11,0,0,0,0,0,0,0,0,0,0,0,0,0,0,0
243197,34000,340,0,-2,6,1,5,0,0,0,0,0,0,0,0,0,6,1,5,0,0,0,0,0,0,0,0,0,0,0,0,0,0,0
243568,34000,340,0,-2,6,4,2,0,0,0,0,0,0,0,0,0,6,4,2,0,0,0,0,0,0,0,0,0,0,0,0,0,0,0
243744,34000,340,0,-2,10,0,10,0,0,0,2,0,2,0,0,0,0,0,0,0,0,0,4,0,4,0,0,0,4,0,4,0,0,0
243780,34000,340,0,-2,35,15,20,0,0,0,2,1,1,1,1,0,3,1,2,0,0,0,24,8,16,2,2,0,1,0,1,2,2,0
243823,34000,340,0,-2,1,1,0,0,0,0,0,0,0,0,0,0,0,0,0,0,0,0,1,1,0,0,0,0,0,0,0,0,0,0
260372,34000,340,0,-2,1,0,1,0,0,0,0,0,0,0,0,0,0,0,0,0,0,0,1,0,1,0,0,0,0,0,0,0,0,0
363633,34000,340,0,-2,1,0,1,0,0,0,0,0,0,0,0,0,0,0,0,0,0,0,1,0,1,0,0,0,0,0,0,0,0,0
364016,34000,340,0,-2,1,0,1,0,0,0,0,0,0,0,0,0,0,0,0,0,0,0,1,0,1,0,0,0,0,0,0,0,0,0
366252,34000,340,0,-2,1,0,1,0,0,0,0,0,0,0,0,0,0,0,0,0,0,0,1,0,1,0,0,0,0,0,0,0,0,0
366711,34000,340,0,-2,1,1,0,0,0,0,0,0,0,0,0,0,1,1,0,0,0,0,0,0,0,0,0,0,0,0,0,0,0,0
385415,34000,340,0,-2,2,1,1,0,0,0,0,0,0,1,1,0,0,0,0,0,0,0,1,0,1,0,0,0,0,0,0,0,0,0
405872,34000,340,0,-2,1,0,1,0,0,0,0,0,0,0,0,0,0,0,0,0,0,0,1,0,1,0,0,0,0,0,0,0,0,0
407629,34000,340,0,-2,2,1,1,0,0,0,0,0,0,0,0,0,0,0,0,0,0,0,2,1,1,0,0,0,0,0,0,0,0,0
409254,34000,340,0,-2,1,0,1,0,0,0,0,0,0,0,0,0,0,0,0,0,0,0,1,0,1,0,0,0,0,0,0,0,0,0
409315,34000,340,0,-2,1,1,0,0,0,0,0,0,0,0,0,0,1,1,0,0,0,0,0,0,0,0,0,0,0,0,0,0,0,0
409698,34000,340,0,-2,1,0,1,0,0,0,0,0,0,0,0,0,0,0,0,0,0,0,1,0,1,0,0,0,0,0,0,0,0,0
420246,34000,340,0,-2,2,0,2,0,0,0,0,0,0,0,0,0,1,0,1,0,0,0,1,0,1,0,0,0,0,0,0,0,0,0
423643,34000,340,0,-2,7,1,6,1,0,1,0,0,0,0,0,0,3,0,3,0,0,0,3,1,2,0,0,0,0,0,0,0,0,0
434061,34000,340,0,-2,1,0,1,0,0,0,0,0,0,1,0,1,0,0,0,0,0,0,0,0,0,0,0,0,0,0,0,0,0,0
435000,34000,340,0,-2,19,4,15,0,0,0,2,1,1,8,2,6,0,0,0,0,0,0,9,1,8,0,0,0,0,0,0,0,0,0
444787,34000,340,0,-2,3,2,1,0,0,0,0,0,0,0,0,0,0,0,0,0,0,0,2,1,1,1,1,0,0,0,0,0,0,0
445188,34000,340,0,-2,5,3,2,0,0,0,0,0,0,0,0,0,3,2,1,0,0,0,2,1,1,0,0,0,0,0,0,0,0,0
445708,34000,340,0,-2,1,0,1,0,0,0,0,0,0,0,0,0,0,0,0,0,0,0,1,0,1,0,0,0,0,0,0,0,0,0
445735,34000,340,0,-2,3,0,3,0,0,0,0,0,0,0,0,0,0,0,0,0,0,0,3,0,3,0,0,0,0,0,0,0,0,0
446048,34000,340,0,-2,1,0,1,0,0,0,0,0,0,0,0,0,0,0,0,0,0,0,1,0,1,0,0,0,0,0,0,0,0,0
459736,34000,340,0,-2,1,0,1,0,0,0,0,0,0,0,0,0,1,0,1,0,0,0,0,0,0,0,0,0,0,0,0,0,0,0
459824,34000,340,0,-2,4,1,3,0,0,0,0,0,0,1,0,1,0,0,0,0,0,0,3,1,2,0,0,0,0,0,0,0,0,0
476726,34000,340,0,-2,2,1,1,0,0,0,0,0,0,0,0,0,2,1,1,0,0,0,0,0,0,0,0,0,0,0,0,0,0,0
480790,34000,340,0,-2,7,1,6,0,0,0,0,0,0,0,0,0,1,0,1,0,0,0,6,1,5,0,0,0,0,0,0,0,0,0
482149,34000,340,0,-2,191,102,89,1,1,0,22,10,12,26,9,17,13,8,5,0,0,0,108,61,47,0,0,0,12,8,4,9,5,4
482680,34000,340,0,-2,3,0,3,0,0,0,0,0,0,0,0,0,0,0,0,0,0,0,3,0,3,0,0,0,0,0,0,0,0,0
484844,34000,340,0,-2,2,2,0,0,0,0,0,0,0,0,0,0,0,0,0,0,0,0,1,1,0,0,0,0,0,0,0,1,1,0
484905,34000,340,0,-2,1,0,1,0,0,0,0,0,0,1,0,1,0,0,0,0,0,0,0,0,0,0,0,0,0,0,0,0,0,0
486840,34000,340,0,-2,1,0,1,0,0,0,0,0,0,0,0,0,0,0,0,0,0,0,1,0,1,0,0,0,0,0,0,0,0,0
486901,34000,340,0,-2,1,1,0,0,0,0,0,0,0,0,0,0,0,0,0,0,0,0,1,1,0,0,0,0,0,0,0,0,0,0
487010,34000,340,0,-2,440,237,203,0,0,0,41,16,25,36,12,24,24,13,11,0,0,0,299,169,130,6,5,1,1,1,0,33,21,12
487092,34000,340,0,-2,2,0,2,0,0,0,0,0,0,0,0,0,1,0,1,0,0,0,1,0,1,0,0,0,0,0,0,0,0,0
487375,34000,340,0,-2,2,1,1,0,0,0,0,0,0,0,0,0,1,0,1,0,0,0,1,1,0,0,0,0,0,0,0,0,0,0
487524,34000,340,0,-2,4,2,2,0,0,0,0,0,0,1,1,0,0,0,0,0,0,0,3,1,2,0,0,0,0,0,0,0,0,0
488527,34000,340,0,-2,6,2,4,0,0,0,1,1,0,1,0,1,1,0,1,0,0,0,1,1,0,0,0,0,1,0,1,1,0,1
488785,34000,340,0,-2,1,0,1,0,0,0,0,0,0,0,0,0,1,0,1,0,0,0,0,0,0,0,0,0,0,0,0,0,0,0
490373,34000,340,0,-2,85,48,37,0,0,0,10,8,2,1,0,1,4,3,1,0,0,0,35,24,11,2,2,0,13,4,9,20,7,13
492689,34000,340,0,-2,114,49,65,0,0,0,21,8,13,4,2,2,48,19,29,0,0,0,23,11,12,3,1,2,1,0,1,14,8,6
495448,34000,340,0,-2,1,1,0,0,0,0,0,0,0,0,0,0,1,1,0,0,0,0,0,0,0,0,0,0,0,0,0,0,0,0
495767,34000,340,0,-2,65,15,50,0,0,0,7,0,7,2,1,1,8,2,6,0,0,0,46,12,34,1,0,1,1,0,1,0,0,0
100654,35000,350,0,-2,6,3,3,0,0,0,0,0,0,4,1,3,0,0,0,0,0,0,2,2,0,0,0,0,0,0,0,0,0,0
100663,35000,350,0,-2,112,42,70,0,0,0,0,0,0,67,24,43,4,3,1,0,0,0,26,12,14,6,2,4,9,1,8,0,0,0
100706,35000,350,0,-2,13,12,1,0,0,0,0,0,0,2,2,0,1,1,0,0,0,0,10,9,1,0,0,0,0,0,0,0,0,0
100724,35000,350,0,-2,22,10,12,0,0,0,0,0,0,22,10,12,0,0,0,0,0,0,0,0,0,0,0,0,0,0,0,0,0,0
100751,35000,350,0,-2,102,40,62,0,0,0,1,1,0,50,10,40,1,1,0,0,0,0,47,28,19,2,0,2,1,0,1,0,0,0
100760,35000,350,0,-2,2,2,0,0,0,0,0,0,0,0,0,0,0,0,0,0,0,0,2,2,0,0,0,0,0,0,0,0,0,0
100830,35000,350,0,-2,13,9,4,0,0,0,1,0,1,12,9,3,0,0,0,0,0,0,0,0,0,0,0,0,0,0,0,0,0,0
100858,35000,350,0,-2,13,4,9,0,0,0,0,0,0,2,0,2,0,0,0,0,0,0,11,4,7,0,0,0,0,0,0,0,0,0
100937,35000,350,0,-2,2,2,0,0,0,0,0,0,0,1,1,0,0,0,0,0,0,0,1,1,0,0,0,0,0,0,0,0,0,0
101028,35000,350,0,-2,2,2,0,0,0,0,0,0,0,2,2,0,0,0,0,0,0,0,0,0,0,0,0,0,0,0,0,0,0,0
101161,35000,350,0,-2,8,5,3,0,0,0,0,0,0,2,2,0,0,0,0,0,0,0,6,3,3,0,0,0,0,0,0,0,0,0
101189,35000,350,0,-2,3,3,0,0,0,0,0,0,0,1,1,0,0,0,0,0,0,0,2,2,0,0,0,0,0,0,0,0,0,0
101240,35000,350,0,-2,3,2,1,0,0,0,0,0,0,1,0,1,0,0,0,0,0,0,2,2,0,0,0,0,0,0,0,0,0,0
101286,35000,350,0,-2,1,1,0,0,0,0,0,0,0,0,0,0,0,0,0,0,0,0,0,0,0,0,0,0,1,1,0,0,0,0
101435,35000,350,0,-2,1,1,0,0,0,0,0,0,0,0,0,0,0,0,0,0,0,0,0,0,0,0,0,0,1,1,0,0,0,0
101462,35000,350,0,-2,1,0,1,0,0,0,0,0,0,0,0,0,0,0,0,0,0,0,1,0,1,0,0,0,0,0,0,0,0,0
101480,35000,350,0,-2,25,11,14,0,0,0,0,0,0,2,1,1,0,0,0,0,0,0,22,10,12,0,0,0,1,0,1,0,0,0
101505,35000,350,0,-2,5,3,2,0,0,0,0,0,0,1,0,1,0,0,0,0,0,0,4,3,1,0,0,0,0,0,0,0,0,0
101569,35000,350,0,-2,6,4,2,0,0,0,0,0,0,5,3,2,0,0,0,0,0,0,0,0,0,0,0,0,1,1,0,0,0,0
101587,35000,350,0,-2,3,1,2,0,0,0,0,0,0,1,0,1,0,0,0,0,0,0,0,0,0,0,0,0,2,1,1,0,0,0
101602,35000,350,0,-2,2,2,0,0,0,0,0,0,0,0,0,0,0,0,0,0,0,0,2,2,0,0,0,0,0,0,0,0,0,0
101648,35000,350,0,-2,1,1,0,0,0,0,0,0,0,0,0,0,0,0,0,0,0,0,1,1,0,0,0,0,0,0,0,0,0,0
101675,35000,350,0,-2,12,9,3,0,0,0,0,0,0,11,8,3,0,0,0,0,0,0,1,1,0,0,0,0,0,0,0,0,0,0
101709,35000,350,0,-2,6,5,1,0,0,0,0,0,0,0,0,0,0,0,0,0,0,0,6,5,1,0,0,0,0,0,0,0,0,0
101736,35000,350,0,-2,2,2,0,0,0,0,0,0,0,0,0,0,0,0,0,0,0,0,2,2,0,0,0,0,0,0,0,0,0,0
101879,35000,350,0,-2,11,5,6,0,0,0,0,0,0,1,0,1,0,0,0,0,0,0,10,5,5,0,0,0,0,0,0,0,0,0
101994,35000,350,0,-2,1,1,0,0,0,0,0,0,0,0,0,0,0,0,0,0,0,0,1,1,0,0,0,0,0,0,0,0,0,0
102067,35000,350,0,-2,2,1,1,0,0,0,0,0,0,1,0,1,0,0,0,0,0,0,1,1,0,0,0,0,0,0,0,0,0,0
102076,35000,350,0,-2,4,3,1,0,0,0,0,0,0,0,0,0,0,0,0,0,0,0,4,3,1,0,0,0,0,0,0,0,0,0
102094,35000,350,0,-2,24,15,9,0,0,0,0,0,0,14,9,5,0,0,0,0,0,0,10,6,4,0,0,0,0,0,0,0,0,0
102234,35000,350,0,-2,2,1,1,0,0,0,0,0,0,1,0,1,0,0,0,0,0,0,1,1,0,0,0,0,0,0,0,0,0,0
102270,35000,350,0,-2,21,10,11,0,0,0,0,0,0,20,10,10,0,0,0,0,0,0,1,0,1,0,0,0,0,0,0,0,0,0
102298,35000,350,0,-2,8,3,5,0,0,0,0,0,0,8,3,5,0,0,0,0,0,0,0,0,0,0,0,0,0,0,0,0,0,0
102368,35000,350,0,-2,5,4,1,0,0,0,0,0,0,1,1,0,0,0,0,0,0,0,3,2,1,0,0,0,1,1,0,0,0,0
102429,35000,350,0,-2,2,1,1,0,0,0,0,0,0,0,0,0,0,0,0,0,0,0,2,1,1,0,0,0,0,0,0,0,0,0
102553,35000,350,0,-2,5,3,2,1,0,1,0,0,0,0,0,0,0,0,0,0,0,0,2,2,0,1,1,0,0,0,0,1,0,1
102614,35000,350,0,-2,4,1,3,0,0,0,0,0,0,0,0,0,0,0,0,0,0,0,3,0,3,0,0,0,1,1,0,0,0,0
102632,35000,350,0,-2,3,2,1,0,0,0,0,0,0,0,0,0,0,0,0,0,0,0,3,2,1,0,0,0,0,0,0,0,0,0
102669,35000,350,0,-2,4,3,1,1,1,0,0,0,0,0,0,0,0,0,0,0,0,0,2,2,0,1,0,1,0,0,0,0,0,0
104151,35000,350,0,-2,59,36,23,1,0,1,2,1,1,1,0,1,16,8,8,0,0,0,19,12,7,0,0,0,20,15,5,0,0,0
104160,35000,350,0,-2,5,2,3,0,0,0,0,0,0,0,0,0,1,0,1,0,0,0,2,1,1,0,0,0,2,1,1,0,0,0
104179,35000,350,0,-2,49,21,28,0,0,0,1,0,1,2,2,0,21,8,13,0,0,0,18,7,11,1,1,0,4,1,3,2,2,0
104346,35000,350,0,-2,13,9,4,0,0,0,0,0,0,0,0,0,8,6,2,0,0,0,4,2,2,1,1,0,0,0,0,0,0,0
104425,35000,350,0,-2,1,1,0,0,0,0,0,0,0,0,0,0,0,0,0,0,0,0,0,0,0,0,0,0,0,0,0,1,1,0
104577,35000,350,0,-2,2,2,0,0,0,0,0,0,0,0,0,0,1,1,0,0,0,0,1,1,0,0,0,0,0,0,0,0,0,0
104586,35000,350,0,-2,4,1,3,0,0,0,0,0,0,0,0,0,0,0,0,0,0,0,4,1,3,0,0,0,0,0,0,0,0,0
104708,35000,350,0,-2,4,3,1,0,0,0,0,0,0,0,0,0,2,2,0,0,0,0,1,1,0,0,0,0,1,0,1,0,0,0
104717,35000,350,0,-2,61,27,34,0,0,0,1,0,1,3,2,1,22,10,12,0,0,0,29,11,18,4,3,1,2,1,1,0,0,0
105136,35000,350,0,-2,1,0,1,0,0,0,0,0,0,0,0,0,0,0,0,0,0,0,0,0,0,1,0,1,0,0,0,0,0,0
105145,35000,350,0,-2,1,1,0,0,0,0,0,0,0,0,0,0,0,0,0,0,0,0,1,1,0,0,0,0,0,0,0,0,0,0
105154,35000,350,0,-2,3,3,0,0,0,0,0,0,0,0,0,0,1,1,0,0,0,0,2,2,0,0,0,0,0,0,0,0,0,0
105206,35000,350,0,-2,6,6,0,0,0,0,0,0,0,0,0,0,1,1,0,0,0,0,4,4,0,0,0,0,1,1,0,0,0,0
105297,35000,350,0,-2,6,5,1,6,5,1,0,0,0,0,0,0,0,0,0,0,0,0,0,0,0,0,0,0,0,0,0,0,0,0
105330,35000,350,0,-2,30,18,12,4,1,3,1,0,1,2,2,0,4,2,2,0,0,0,14,11,3,3,2,1,2,0,2,0,0,0
105525,35000,350,0,-2,11,8,3,0,0,0,0,0,0,1,0,1,5,4,1,0,0,0,5,4,1,0,0,0,0,0,0,0,0,0
105589,35000,350,0,-2,1,1,0,0,0,0,0,0,0,0,0,0,0,0,0,0,0,0,0,0,0,0,0,0,1,1,0,0,0,0
105792,35000,350,0,-2,2,2,0,0,0,0,0,0,0,0,0,0,1,1,0,0,0,0,1,1,0,0,0,0,0,0,0,0,0,0
105899,35000,350,0,-2,9,6,3,0,0,0,0,0,0,0,0,0,3,2,1,0,0,0,5,3,2,0,0,0,1,1,0,0,0,0
106148,35000,350,0,-2,4,3,1,0,0,0,0,0,0,0,0,0,2,2,0,0,0,0,2,1,1,0,0,0,0,0,0,0,0,0
106245,35000,350,0,-2,12,5,7,0,0,0,0,0,0,7,2,5,0,0,0,0,0,0,4,2,2,0,0,0,1,1,0,0,0,0
106263,35000,350,0,-2,57,13,44,1,0,1,1,1,0,24,5,19,7,2,5,1,1,0,17,2,15,2,1,1,2,0,2,2,1,1
106397,35000,350,0,-2,59,29,30,1,1,0,2,0,2,3,2,1,18,6,12,0,0,0,34,20,14,1,0,1,0,0,0,0,0,0
106412,35000,350,0,-2,4,3,1,0,0,0,0,0,0,4,3,1,0,0,0,0,0,0,0,0,0,0,0,0,0,0,0,0,0,0
106449,35000,350,0,-2,5,5,0,1,1,0,0,0,0,0,0,0,0,0,0,0,0,0,3,3,0,1,1,0,0,0,0,0,0,0
106458,35000,350,0,-2,21,9,12,0,0,0,0,0,0,7,1,6,0,0,0,0,0,0,12,7,5,0,0,0,0,0,0,2,1,1
106467,35000,350,0,-2,3,0,3,0,0,0,0,0,0,0,0,0,0,0,0,0,0,0,3,0,3,0,0,0,0,0,0,0,0,0
106485,35000,350,0,-2,7,3,4,0,0,0,0,0,0,4,2,2,1,0,1,0,0,0,2,1,1,0,0,0,0,0,0,0,0,0
106546,35000,350,0,-2,1,1,0,0,0,0,0,0,0,0,0,0,0,0,0,0,0,0,1,1,0,0,0,0,0,0,0,0,0,0
106704,35000,350,0,-2,30,12,18,0,0,0,0,0,0,3,0,3,3,1,2,0,0,0,23,10,13,1,1,0,0,0,0,0,0,0
106713,35000,350,0,-2,1,1,0,0,0,0,0,0,0,0,0,0,0,0,0,0,0,0,1,1,0,0,0,0,0,0,0,0,0,0
106795,35000,350,0,-2,3,1,2,0,0,0,0,0,0,0,0,0,1,0,1,0,0,0,2,1,1,0,0,0,0,0,0,0,0,0
106883,35000,350,0,-2,2,2,0,0,0,0,0,0,0,1,1,0,0,0,0,0,0,0,1,1,0,0,0,0,0,0,0,0,0,0
106980,35000,350,0,-2,2,1,1,0,0,0,0,0,0,0,0,0,0,0,0,0,0,0,2,1,1,0,0,0,0,0,0,0,0,0
107044,35000,350,0,-2,3,2,1,0,0,0,0,0,0,0,0,0,0,0,0,0,0,0,3,2,1,0,0,0,0,0,0,0,0,0
107071,35000,350,0,-2,1,1,0,0,0,0,0,0,0,0,0,0,0,0,0,0,0,0,1,1,0,0,0,0,0,0,0,0,0,0
107080,35000,350,0,-2,35,11,24,0,0,0,0,0,0,6,2,4,5,0,5,1,0,1,20,6,14,3,3,0,0,0,0,0,0,0
107141,35000,350,0,-2,4,1,3,0,0,0,0,0,0,0,0,0,2,0,2,0,0,0,2,1,1,0,0,0,0,0,0,0,0,0
107318,35000,350,0,-2,1,1,0,0,0,0,0,0,0,1,1,0,0,0,0,0,0,0,0,0,0,0,0,0,0,0,0,0,0,0
107512,35000,350,0,-2,2,1,1,0,0,0,0,0,0,0,0,0,1,0,1,0,0,0,1,1,0,0,0,0,0,0,0,0,0,0
107585,35000,350,0,-2,1,0,1,0,0,0,0,0,0,0,0,0,0,0,0,0,0,0,1,0,1,0,0,0,0,0,0,0,0,0
107600,35000,350,0,-2,8,5,3,0,0,0,0,0,0,8,5,3,0,0,0,0,0,0,0,0,0,0,0,0,0,0,0,0,0,0
107619,35000,350,0,-2,5,3,2,0,0,0,0,0,0,4,3,1,0,0,0,0,0,0,1,0,1,0,0,0,0,0,0,0,0,0
107637,35000,350,0,-2,5,1,4,0,0,0,0,0,0,4,1,3,0,0,0,0,0,0,1,0,1,0,0,0,0,0,0,0,0,0
107664,35000,350,0,-2,4,3,1,0,0,0,0,0,0,1,0,1,0,0,0,0,0,0,1,1,0,0,0,0,2,2,0,0,0,0
107725,35000,350,0,-2,1,1,0,0,0,0,0,0,0,0,0,0,0,0,0,0,0,0,1,1,0,0,0,0,0,0,0,0,0,0
107877,35000,350,0,-2,2,0,2,0,0,0,0,0,0,0,0,0,0,0,0,0,0,0,2,0,2,0,0,0,0,0,0,0,0,0
107974,35000,350,0,-2,2,1,1,0,0,0,0,0,0,1,1,0,0,0,0,0,0,0,1,0,1,0,0,0,0,0,0,0,0,0
107983,35000,350,0,-2,2,2,0,0,0,0,0,0,0,1,1,0,0,0,0,0,0,0,1,1,0,0,0,0,0,0,0,0,0,0
108092,35000,350,0,-2,1,1,0,0,0,0,0,0,0,0,0,0,0,0,0,0,0,0,1,1,0,0,0,0,0,0,0,0,0,0
108232,35000,350,0,-2,4,3,1,0,0,0,2,2,0,0,0,0,0,0,0,0,0,0,1,1,0,1,0,1,0,0,0,0,0,0
108852,35000,350,0,-2,1,1,0,0,0,0,0,0,0,0,0,0,1,1,0,0,0,0,0,0,0,0,0,0,0,0,0,0,0,0
108870,35000,350,0,-2,1,0,1,0,0,0,0,0,0,1,0,1,0,0,0,0,0,0,0,0,0,0,0,0,0,0,0,0,0,0
109350,35000,350,0,-2,1,1,0,0,0,0,0,0,0,0,0,0,1,1,0,0,0,0,0,0,0,0,0,0,0,0,0,0,0,0
109785,35000,350,0,-2,6,6,0,0,0,0,0,0,0,0,0,0,2,2,0,0,0,0,0,0,0,1,1,0,3,3,0,0,0,0
109819,35000,350,0,-2,5,3,2,0,0,0,0,0,0,0,0,0,4,2,2,0,0,0,1,1,0,0,0,0,0,0,0,0,0,0
109907,35000,350,0,-2,2,2,0,0,0,0,0,0,0,0,0,0,1,1,0,0,0,0,1,1,0,0,0,0,0,0,0,0,0,0
110097,35000,350,0,-2,3,1,2,0,0,0,0,0,0,0,0,0,1,0,1,0,0,0,2,1,1,0,0,0,0,0,0,0,0,0
110246,35000,350,0,-2,7,6,1,0,0,0,1,1,0,0,0,0,0,0,0,0,0,0,5,4,1,0,0,0,1,1,0,0,0,0
110334,35000,350,0,-2,1,1,0,0,0,0,0,0,0,0,0,0,1,1,0,0,0,0,0,0,0,0,0,0,0,0,0,0,0,0
110361,35000,350,0,-2,9,7,2,0,0,0,1,1,0,0,0,0,3,3,0,0,0,0,5,3,2,0,0,0,0,0,0,0,0,0
110370,35000,350,0,-2,7,5,2,0,0,0,0,0,0,4,3,1,3,2,1,0,0,0,0,0,0,0,0,0,0,0,0,0,0,0
110398,35000,350,0,-2,2,2,0,0,0,0,0,0,0,0,0,0,1,1,0,0,0,0,1,1,0,0,0,0,0,0,0,0,0,0
110404,35000,350,0,-2,30,21,9,0,0,0,2,2,0,1,1,0,17,10,7,0,0,0,5,4,1,1,1,0,3,2,1,1,1,0
110413,35000,350,0,-2,11,4,7,0,0,0,1,0,1,0,0,0,7,3,4,0,0,0,2,1,1,1,0,1,0,0,0,0,0,0
110422,35000,350,0,-2,30,20,10,0,0,0,1,1,0,0,0,0,12,6,6,0,0,0,10,10,0,0,0,0,6,3,3,1,0,1
110486,35000,350,0,-2,5,2,3,0,0,0,0,0,0,0,0,0,2,1,1,0,0,0,3,1,2,0,0,0,0,0,0,0,0,0
110495,35000,350,0,-2,4,4,0,0,0,0,0,0,0,1,1,0,2,2,0,0,0,0,1,1,0,0,0,0,0,0,0,0,0,0
110501,35000,350,0,-2,1,1,0,0,0,0,0,0,0,0,0,0,1,1,0,0,0,0,0,0,0,0,0,0,0,0,0,0,0,0
110510,35000,350,0,-2,8,6,2,0,0,0,0,0,0,1,1,0,6,4,2,0,0,0,1,1,0,0,0,0,0,0,0,0,0,0
110529,35000,350,0,-2,11,3,8,0,0,0,0,0,0,1,1,0,8,2,6,0,0,0,0,0,0,1,0,1,0,0,0,1,0,1
110538,35000,350,0,-2,19,12,7,0,0,0,1,1,0,0,0,0,9,4,5,0,0,0,6,6,0,1,0,1,2,1,1,0,0,0
110547,35000,350,0,-2,9,5,4,0,0,0,1,0,1,1,1,0,6,3,3,0,0,0,1,1,0,0,0,0,0,0,0,0,0,0
110556,35000,350,0,-2,16,10,6,0,0,0,1,0,1,1,1,0,11,7,4,0,0,0,3,2,1,0,0,0,0,0,0,0,0,0
110565,35000,350,0,-2,4,4,0,0,0,0,0,0,0,0,0,0,2,2,0,0,0,0,2,2,0,0,0,0,0,0,0,0,0,0
110574,35000,350,0,-2,1,1,0,0,0,0,0,0,0,0,0,0,0,0,0,0,0,0,0,0,0,0,0,0,1,1,0,0,0,0
110583,35000,350,0,-2,18,16,2,0,0,0,0,0,0,1,1,0,10,8,2,0,0,0,5,5,0,0,0,0,2,2,0,0,0,0
110592,35000,350,0,-2,1,1,0,0,0,0,0,0,0,0,0,0,1,1,0,0,0,0,0,0,0,0,0,0,0,0,0,0,0,0
110608,35000,350,0,-2,20,17,3,0,0,0,0,0,0,1,1,0,16,13,3,0,0,0,1,1,0,0,0,0,2,2,0,0,0,0
110617,35000,350,0,-2,21,15,6,0,0,0,6,5,1,3,3,0,6,2,4,0,0,0,3,3,0,1,1,0,2,1,1,0,0,0
110635,35000,350,0,-2,133,58,75,0,0,0,31,13,18,20,11,9,43,18,25,1,1,0,13,6,7,4,2,2,12,4,8,9,3,6
110644,35000,350,0,-2,107,45,62,1,0,1,9,4,5,4,2,2,39,19,20,2,1,1,43,15,28,2,1,1,4,1,3,3,2,1
110653,35000,350,0,-2,45,21,24,0,0,0,4,3,1,0,0,0,30,13,17,0,0,0,5,4,1,1,0,1,3,1,2,2,0,2
110662,35000,350,0,-2,482,146,336,2,1,1,23,8,15,49,17,32,315,83,232,1,0,1,44,16,28,7,2,5,19,8,11,22,11,11
110671,35000,350,0,-2,47,19,28,0,0,0,2,2,0,3,1,2,30,10,20,0,0,0,8,4,4,1,1,0,2,1,1,1,0,1
110680,35000,350,0,-2,229,73,156,1,1,0,17,6,11,9,6,3,141,45,96,2,1,1,34,8,26,7,2,5,8,1,7,10,3,7
110699,35000,350,0,-2,44,21,23,0,0,0,10,2,8,6,5,1,17,10,7,0,0,0,10,3,7,0,0,0,1,1,0,0,0,0
110705,35000,350,0,-2,27,19,8,0,0,0,0,0,0,1,1,0,18,14,4,0,0,0,5,2,3,0,0,0,2,1,1,1,1,0
110714,35000,350,0,-2,17,7,10,0,0,0,1,1,0,1,0,1,6,2,4,0,0,0,7,3,4,1,1,0,1,0,1,0,0,0
111081,35000,350,0,-2,8,5,3,0,0,0,1,0,1,0,0,0,4,3,1,0,0,0,3,2,1,0,0,0,0,0,0,0,0,0
111188,35000,350,0,-2,2,1,1,0,0,0,0,0,0,1,0,1,0,0,0,0,0,0,1,1,0,0,0,0,0,0,0,0,0,0
111461,35000,350,0,-2,6,5,1,0,0,0,0,0,0,1,1,0,4,3,1,0,0,0,1,1,0,0,0,0,0,0,0,0,0,0
111896,35000,350,0,-2,2,2,0,0,0,0,0,0,0,0,0,0,1,1,0,0,0,0,1,1,0,0,0,0,0,0,0,0,0,0
111948,35000,350,0,-2,2,2,0,0,0,0,0,0,0,0,0,0,1,1,0,0,0,0,0,0,0,0,0,0,1,1,0,0,0,0
111966,35000,350,0,-2,11,7,4,0,0,0,0,0,0,2,1,1,5,4,1,0,0,0,0,0,0,0,0,0,4,2,2,0,0,0
112075,35000,350,0,-2,1,0,1,0,0,0,0,0,0,0,0,0,1,0,1,0,0,0,0,0,0,0,0,0,0,0,0,0,0,0
112172,35000,350,0,-2,2,1,1,0,0,0,0,0,0,0,0,0,2,1,1,0,0,0,0,0,0,0,0,0,0,0,0,0,0,0
112260,35000,350,0,-2,6,6,0,0,0,0,0,0,0,2,2,0,4,4,0,0,0,0,0,0,0,0,0,0,0,0,0,0,0,0
112525,35000,350,0,-2,14,3,11,0,0,0,3,1,2,0,0,0,8,2,6,0,0,0,2,0,2,0,0,0,0,0,0,1,0,1
112561,35000,350,0,-2,2,2,0,0,0,0,0,0,0,0,0,0,0,0,0,0,0,0,2,2,0,0,0,0,0,0,0,0,0,0
112826,35000,350,0,-2,1,1,0,0,0,0,0,0,0,0,0,0,1,1,0,0,0,0,0,0,0,0,0,0,0,0,0,0,0,0
113193,35000,350,0,-2,1,1,0,0,0,0,0,0,0,0,0,0,1,1,0,0,0,0,0,0,0,0,0,0,0,0,0,0,0,0
113856,35000,350,0,-2,19,18,1,0,0,0,0,0,0,2,1,1,8,8,0,0,0,0,0,0,0,0,0,0,9,9,0,0,0,0
113980,35000,350,0,-2,9,9,0,0,0,0,0,0,0,2,2,0,6,6,0,0,0,0,1,1,0,0,0,0,0,0,0,0,0,0
114266,35000,350,0,-2,2,2,0,0,0,0,0,0,0,0,0,0,0,0,0,0,0,0,1,1,0,0,0,0,1,1,0,0,0,0
114433,35000,350,0,-2,2,2,0,0,0,0,0,0,0,0,0,0,0,0,0,0,0,0,2,2,0,0,0,0,0,0,0,0,0,0
114549,35000,350,0,-2,1,1,0,0,0,0,0,0,0,1,1,0,0,0,0,0,0,0,0,0,0,0,0,0,0,0,0,0,0,0
114789,35000,350,0,-2,1,0,1,0,0,0,0,0,0,0,0,0,1,0,1,0,0,0,0,0,0,0,0,0,0,0,0,0,0,0
114813,35000,350,0,-2,1,1,0,0,0,0,0,0,0,0,0,0,1,1,0,0,0,0,0,0,0,0,0,0,0,0,0,0,0,0
114840,35000,350,0,-2,1,1,0,0,0,0,0,0,0,0,0,0,0,0,0,0,0,0,1,1,0,0,0,0,0,0,0,0,0,0
115083,35000,350,0,-2,1,1,0,0,0,0,0,0,0,0,0,0,1,1,0,0,0,0,0,0,0,0,0,0,0,0,0,0,0,0
115296,35000,350,0,-2,2,2,0,1,1,0,0,0,0,0,0,0,1,1,0,0,0,0,0,0,0,0,0,0,0,0,0,0,0,0
115393,35000,350,0,-2,3,2,1,0,0,0,0,0,0,0,0,0,3,2,1,0,0,0,0,0,0,0,0,0,0,0,0,0,0,0
115409,35000,350,0,-2,8,5,3,1,0,1,0,0,0,0,0,0,4,3,1,0,0,0,3,2,1,0,0,0,0,0,0,0,0,0
115755,35000,350,0,-2,13,11,2,0,0,0,1,1,0,0,0,0,1,1,0,0,0,0,11,9,2,0,0,0,0,0,0,0,0,0
116439,35000,350,0,-2,4,3,1,0,0,0,0,0,0,0,0,0,1,1,0,0,0,0,3,2,1,0,0,0,0,0,0,0,0,0
116846,35000,350,0,-2,1,0,1,0,0,0,0,0,0,0,0,0,1,0,1,0,0,0,0,0,0,0,0,0,0,0,0,0,0,0
117140,35000,350,0,-2,4,4,0,0,0,0,0,0,0,2,2,0,0,0,0,0,0,0,0,0,0,0,0,0,2,2,0,0,0,0
117168,35000,350,0,-2,2,1,1,0,0,0,0,0,0,0,0,0,1,1,0,0,0,0,1,0,1,0,0,0,0,0,0,0,0,0
117195,35000,350,0,-2,1,0,1,0,0,0,0,0,0,0,0,0,0,0,0,0,0,0,1,0,1,0,0,0,0,0,0,0,0,0
117247,35000,350,0,-2,2,1,1,0,0,0,0,0,0,0,0,0,0,0,0,0,0,0,0,0,0,0,0,0,2,1,1,0,0,0
117274,35000,350,0,-2,2,2,0,0,0,0,0,0,0,0,0,0,0,0,0,0,0,0,2,2,0,0,0,0,0,0,0,0,0,0
117520,35000,350,0,-2,3,0,3,0,0,0,2,0,2,1,0,1,0,0,0,0,0,0,0,0,0,0,0,0,0,0,0,0,0,0
117627,35000,350,0,-2,2,0,2,0,0,0,0,0,0,0,0,0,1,0,1,0,0,0,0,0,0,0,0,0,0,0,0,1,0,1
117636,35000,350,0,-2,7,0,7,0,0,0,0,0,0,0,0,0,7,0,7,0,0,0,0,0,0,0,0,0,0,0,0,0,0,0
117645,35000,350,0,-2,3,2,1,1,1,0,0,0,0,1,0,1,0,0,0,0,0,0,1,1,0,0,0,0,0,0,0,0,0,0
117672,35000,350,0,-2,2,0,2,0,0,0,0,0,0,0,0,0,1,0,1,0,0,0,1,0,1,0,0,0,0,0,0,0,0,0
117690,35000,350,0,-2,10,8,2,0,0,0,0,0,0,4,3,1,0,0,0,0,0,0,1,1,0,0,0,0,5,4,1,0,0,0
117706,35000,350,0,-2,14,12,2,0,0,0,1,1,0,3,2,1,5,4,1,0,0,0,4,4,0,0,0,0,0,0,0,1,1,0
117715,35000,350,0,-2,7,5,2,0,0,0,0,0,0,1,1,0,0,0,0,0,0,0,0,0,0,0,0,0,6,4,2,0,0,0
117724,35000,350,0,-2,13,12,1,0,0,0,0,0,0,6,5,1,0,0,0,0,0,0,2,2,0,0,0,0,5,5,0,0,0,0
117733,35000,350,0,-2,16,13,3,0,0,0,0,0,0,6,5,1,8,7,1,0,0,0,1,0,1,0,0,0,1,1,0,0,0,0
117751,35000,350,0,-2,5,5,0,0,0,0,0,0,0,1,1,0,1,1,0,0,0,0,2,2,0,1,1,0,0,0,0,0,0,0
117788,35000,350,0,-2,10,10,0,0,0,0,0,0,0,1,1,0,1,1,0,0,0,0,0,0,0,0,0,0,8,8,0,0,0,0
117867,35000,350,0,-2,4,4,0,0,0,0,0,0,0,0,0,0,3,3,0,1,1,0,0,0,0,0,0,0,0,0,0,0,0,0
117946,35000,350,0,-2,15,12,3,0,0,0,0,0,0,4,3,1,6,5,1,0,0,0,2,2,0,0,0,0,3,2,1,0,0,0
118718,35000,350,0,-2,2,2,0,0,0,0,0,0,0,0,0,0,2,2,0,0,0,0,0,0,0,0,0,0,0,0,0,0,0,0
118888,35000,350,0,-2,5,3,2,0,0,0,1,1,0,3,1,2,0,0,0,0,0,0,0,0,0,1,1,0,0,0,0,0,0,0
118912,35000,350,0,-2,1,1,0,0,0,0,1,1,0,0,0,0,0,0,0,0,0,0,0,0,0,0,0,0,0,0,0,0,0,0
118976,35000,350,0,-2,2,2,0,0,0,0,0,0,0,0,0,0,2,2,0,0,0,0,0,0,0,0,0,0,0,0,0,0,0,0
119058,35000,350,0,-2,1,0,1,0,0,0,0,0,0,0,0,0,0,0,0,0,0,0,0,0,0,1,0,1,0,0,0,0,0,0
119137,35000,350,0,-2,2,2,0,0,0,0,0,0,0,0,0,0,1,1,0,0,0,0,0,0,0,0,0,0,1,1,0,0,0,0
119164,35000,350,0,-2,12,9,3,0,0,0,0,0,0,0,0,0,5,4,1,0,0,0,1,1,0,0,0,0,6,4,2,0,0,0
119173,35000,350,0,-2,2,0,2,1,0,1,0,0,0,0,0,0,0,0,0,0,0,0,0,0,0,0,0,0,1,0,1,0,0,0
119216,35000,350,0,-2,8,7,1,1,1,0,0,0,0,0,0,0,2,2,0,0,0,0,5,4,1,0,0,0,0,0,0,0,0,0
119678,35000,350,0,-2,1,1,0,0,0,0,0,0,0,0,0,0,1,1,0,0,0,0,0,0,0,0,0,0,0,0,0,0,0,0
119775,35000,350,0,-2,1,1,0,0,0,0,0,0,0,1,1,0,0,0,0,0,0,0,0,0,0,0,0,0,0,0,0,0,0,0
120254,35000,350,0,-2,12,4,8,0,0,0,1,0,1,1,0,1,7,2,5,0,0,0,0,0,0,0,0,0,3,2,1,0,0,0
120342,35000,350,0,-2,1,0,1,0,0,0,0,0,0,0,0,0,0,0,0,0,0,0,1,0,1,0,0,0,0,0,0,0,0,0
120403,35000,350,0,-2,5,4,1,0,0,0,0,0,0,2,1,1,2,2,0,0,0,0,0,0,0,0,0,0,1,1,0,0,0,0
120421,35000,350,0,-2,1,1,0,0,0,0,0,0,0,0,0,0,1,1,0,0,0,0,0,0,0,0,0,0,0,0,0,0,0,0
120883,35000,350,0,-2,9,4,5,0,0,0,2,0,2,0,0,0,2,1,1,0,0,0,4,2,2,1,1,0,0,0,0,0,0,0
121150,35000,350,0,-2,6,6,0,0,0,0,0,0,0,0,0,0,4,4,0,0,0,0,2,2,0,0,0,0,0,0,0,0,0,0
121257,35000,350,0,-2,10,5,5,0,0,0,1,1,0,0,0,0,9,4,5,0,0,0,0,0,0,0,0,0,0,0,0,0,0,0
121309,35000,350,0,-2,10,6,4,0,0,0,1,0,1,0,0,0,2,1,1,0,0,0,7,5,2,0,0,0,0,0,0,0,0,0
121345,35000,350,0,-2,32,19,13,0,0,0,1,1,0,0,0,0,20,12,8,0,0,0,1,1,0,0,0,0,10,5,5,0,0,0
121619,35000,350,0,-2,1,0,1,0,0,0,0,0,0,0,0,0,0,0,0,0,0,0,0,0,0,0,0,0,1,0,1,0,0,0
121691,35000,350,0,-2,12,8,4,0,0,0,1,0,1,1,1,0,3,2,1,0,0,0,4,3,1,2,1,1,1,1,0,0,0,0
121707,35000,350,0,-2,4,4,0,0,0,0,0,0,0,0,0,0,1,1,0,0,0,0,3,3,0,0,0,0,0,0,0,0,0,0
121886,35000,350,0,-2,4,3,1,0,0,0,0,0,0,0,0,0,3,2,1,0,0,0,0,0,0,0,0,0,0,0,0,1,1,0
121901,35000,350,0,-2,2,2,0,0,0,0,0,0,0,0,0,0,0,0,0,0,0,0,2,2,0,0,0,0,0,0,0,0,0,0
122205,35000,350,0,-2,2,2,0,0,0,0,0,0,0,0,0,0,0,0,0,0,0,0,0,0,0,0,0,0,1,1,0,1,1,0
122296,35000,350,0,-2,1,0,1,0,0,0,0,0,0,0,0,0,0,0,0,0,0,0,0,0,0,0,0,0,1,0,1,0,0,0
122320,35000,350,0,-2,1,1,0,0,0,0,0,0,0,0,0,0,1,1,0,0,0,0,0,0,0,0,0,0,0,0,0,0,0,0
122409,35000,350,0,-2,47,25,22,0,0,0,2,1,1,4,2,2,28,14,14,1,0,1,9,7,2,1,0,1,2,1,1,0,0,0
122436,35000,350,0,-2,14,8,6,0,0,0,1,0,1,0,0,0,8,5,3,0,0,0,4,3,1,1,0,1,0,0,0,0,0,0
122597,35000,350,0,-2,12,2,10,0,0,0,1,1,0,1,0,1,4,1,3,0,0,0,5,0,5,1,0,1,0,0,0,0,0,0
122612,35000,350,0,-2,11,10,1,0,0,0,2,2,0,2,1,1,6,6,0,0,0,0,1,1,0,0,0,0,0,0,0,0,0,0
122694,35000,350,0,-2,1,1,0,0,0,0,0,0,0,0,0,0,1,1,0,0,0,0,0,0,0,0,0,0,0,0,0,0,0,0
122737,35000,350,0,-2,1,1,0,0,0,0,0,0,0,0,0,0,0,0,0,0,0,0,0,0,0,0,0,0,1,1,0,0,0,0
122746,35000,350,0,-2,2,1,1,0,0,0,0,0,0,0,0,0,2,1,1,0,0,0,0,0,0,0,0,0,0,0,0,0,0,0
122755,35000,350,0,-2,10,7,3,0,0,0,1,1,0,1,1,0,3,0,3,0,0,0,2,2,0,3,3,0,0,0,0,0,0,0
122782,35000,350,0,-2,10,9,1,0,0,0,2,1,1,2,2,0,2,2,0,0,0,0,1,1,0,0,0,0,1,1,0,2,2,0
122889,35000,350,0,-2,2,2,0,0,0,0,0,0,0,0,0,0,1,1,0,0,0,0,1,1,0,0,0,0,0,0,0,0,0,0
122931,35000,350,0,-2,7,5,2,0,0,0,1,1,0,0,0,0,2,1,1,0,0,0,2,1,1,1,1,0,1,1,0,0,0,0
123013,35000,350,0,-2,2,2,0,0,0,0,0,0,0,1,1,0,1,1,0,0,0,0,0,0,0,0,0,0,0,0,0,0,0,0
123165,35000,350,0,-2,9,4,5,0,0,0,0,0,0,0,0,0,8,3,5,0,0,0,1,1,0,0,0,0,0,0,0,0,0,0
123217,35000,350,0,-2,1,1,0,0,0,0,0,0,0,0,0,0,1,1,0,0,0,0,0,0,0,0,0,0,0,0,0,0,0,0
123299,35000,350,0,-2,3,3,0,0,0,0,0,0,0,0,0,0,0,0,0,0,0,0,2,2,0,1,1,0,0,0,0,0,0,0
123341,35000,350,0,-2,4,3,1,0,0,0,0,0,0,0,0,0,2,2,0,0,0,0,1,1,0,0,0,0,1,0,1,0,0,0
123484,35000,350,0,-2,4,4,0,0,0,0,0,0,0,1,1,0,1,1,0,0,0,0,2,2,0,0,0,0,0,0,0,0,0,0
123527,35000,350,0,-2,4,4,0,0,0,0,0,0,0,1,1,0,2,2,0,0,0,0,1,1,0,0,0,0,0,0,0,0,0,0
123554,35000,350,0,-2,4,2,2,0,0,0,0,0,0,0,0,0,1,0,1,0,0,0,0,0,0,0,0,0,3,2,1,0,0,0
123563,35000,350,0,-2,1,0,1,0,0,0,1,0,1,0,0,0,0,0,0,0,0,0,0,0,0,0,0,0,0,0,0,0,0,0
123572,35000,350,0,-2,5,3,2,0,0,0,0,0,0,0,0,0,2,1,1,0,0,0,2,1,1,0,0,0,1,1,0,0,0,0
123800,35000,350,0,-2,3,3,0,0,0,0,0,0,0,0,0,0,1,1,0,0,0,0,2,2,0,0,0,0,0,0,0,0,0,0
123943,35000,350,0,-2,10,3,7,0,0,0,0,0,0,2,0,2,7,3,4,0,0,0,1,0,1,0,0,0,0,0,0,0,0,0
123961,35000,350,0,-2,190,113,77,1,0,1,9,6,3,20,8,12,142,86,56,0,0,0,9,6,3,6,5,1,3,2,1,0,0,0
124292,35000,350,0,-2,5,1,4,0,0,0,0,0,0,0,0,0,0,0,0,0,0,0,5,1,4,0,0,0,0,0,0,0,0,0
124557,35000,350,0,-2,1,1,0,0,0,0,0,0,0,0,0,0,1,1,0,0,0,0,0,0,0,0,0,0,0,0,0,0,0,0
125028,35000,350,0,-2,4,3,1,0,0,0,0,0,0,0,0,0,3,2,1,0,0,0,1,1,0,0,0,0,0,0,0,0,0,0
125462,35000,350,0,-2,1,0,1,0,0,0,0,0,0,0,0,0,1,0,1,0,0,0,0,0,0,0,0,0,0,0,0,0,0,0
125471,35000,350,0,-2,6,5,1,0,0,0,0,0,0,3,2,1,0,0,0,0,0,0,0,0,0,0,0,0,3,3,0,0,0,0
125727,35000,350,0,-2,5,3,2,0,0,0,0,0,0,0,0,0,2,0,2,0,0,0,2,2,0,0,0,0,1,1,0,0,0,0
125763,35000,350,0,-2,5,4,1,0,0,0,0,0,0,0,0,0,4,3,1,0,0,0,1,1,0,0,0,0,0,0,0,0,0,0
126100,35000,350,0,-2,25,20,5,0,0,0,0,0,0,0,0,0,14,14,0,0,0,0,9,6,3,0,0,0,1,0,1,1,0,1
126182,35000,350,0,-2,10,7,3,0,0,0,0,0,0,0,0,0,6,5,1,0,0,0,4,2,2,0,0,0,0,0,0,0,0,0
126207,35000,350,0,-2,2,1,1,0,0,0,0,0,0,0,0,0,0,0,0,0,0,0,2,1,1,0,0,0,0,0,0,0,0,0
126289,35000,350,0,-2,3,2,1,0,0,0,0,0,0,0,0,0,1,1,0,0,0,0,2,1,1,0,0,0,0,0,0,0,0,0
126562,35000,350,0,-2,34,12,22,0,0,0,1,1,0,4,2,2,8,1,7,0,0,0,9,5,4,0,0,0,12,3,9,0,0,0
126580,35000,350,0,-2,15,13,2,0,0,0,0,0,0,1,0,1,4,4,0,0,0,0,9,8,1,1,1,0,0,0,0,0,0,0
126614,35000,350,0,-2,53,31,22,0,0,0,18,9,9,0,0,0,14,9,5,0,0,0,19,12,7,0,0,0,2,1,1,0,0,0
126669,35000,350,0,-2,5,4,1,0,0,0,0,0,0,1,1,0,0,0,0,0,0,0,4,3,1,0,0,0,0,0,0,0,0,0
126678,35000,350,0,-2,14,9,5,0,0,0,1,0,1,4,3,1,2,2,0,0,0,0,6,3,3,0,0,0,0,0,0,1,1,0
126711,35000,350,0,-2,3,1,2,0,0,0,0,0,0,0,0,0,1,0,1,0,0,0,2,1,1,0,0,0,0,0,0,0,0,0
126748,35000,350,0,-2,1,0,1,0,0,0,0,0,0,0,0,0,0,0,0,0,0,0,1,0,1,0,0,0,0,0,0,0,0,0
126775,35000,350,0,-2,14,9,5,1,1,0,1,0,1,1,0,1,3,3,0,0,0,0,7,4,3,1,1,0,0,0,0,0,0,0
126818,35000,350,0,-2,29,18,11,1,1,0,0,0,0,1,0,1,6,4,2,0,0,0,17,11,6,2,1,1,2,1,1,0,0,0
126951,35000,350,0,-2,2,2,0,0,0,0,0,0,0,0,0,0,0,0,0,0,0,0,2,2,0,0,0,0,0,0,0,0,0,0
127060,35000,350,0,-2,14,8,6,1,1,0,1,1,0,0,0,0,6,3,3,0,0,0,2,2,0,3,1,2,1,0,1,0,0,0
127185,35000,350,0,-2,11,7,4,2,2,0,0,0,0,0,0,0,2,1,1,0,0,0,6,3,3,1,1,0,0,0,0,0,0,0
127200,35000,350,0,-2,5,4,1,0,0,0,0,0,0,1,1,0,1,1,0,0,0,0,3,2,1,0,0,0,0,0,0,0,0,0
127389,35000,350,0,-2,3,3,0,0,0,0,0,0,0,0,0,0,2,2,0,0,0,0,1,1,0,0,0,0,0,0,0,0,0,0
127556,35000,350,0,-2,15,9,6,0,0,0,1,0,1,0,0,0,1,0,1,0,0,0,10,7,3,0,0,0,1,1,0,2,1,1
127653,35000,350,0,-2,2,2,0,0,0,0,0,0,0,0,0,0,0,0,0,0,0,0,1,1,0,0,0,0,1,1,0,0,0,0
127732,35000,350,0,-2,4,2,2,0,0,0,0,0,0,0,0,0,1,0,1,0,0,0,3,2,1,0,0,0,0,0,0,0,0,0
127741,35000,350,0,-2,28,17,11,0,0,0,0,0,0,1,1,0,4,4,0,0,0,0,10,7,3,0,0,0,13,5,8,0,0,0
127778,35000,350,0,-2,7,4,3,0,0,0,0,0,0,0,0,0,5,2,3,0,0,0,2,2,0,0,0,0,0,0,0,0,0,0
127820,35000,350,0,-2,5,3,2,0,0,0,0,0,0,1,0,1,3,2,1,0,0,0,1,1,0,0,0,0,0,0,0,0,0,0
127909,35000,350,0,-2,1,1,0,0,0,0,0,0,0,0,0,0,0,0,0,0,0,0,0,0,0,0,0,0,1,1,0,0,0,0
127918,35000,350,0,-2,7,6,1,0,0,0,0,0,0,0,0,0,2,1,1,0,0,0,4,4,0,1,1,0,0,0,0,0,0,0
128258,35000,350,0,-2,5,3,2,0,0,0,0,0,0,0,0,0,3,2,1,0,0,0,2,1,1,0,0,0,0,0,0,0,0,0
128328,35000,350,0,-2,3,0,3,0,0,0,0,0,0,0,0,0,0,0,0,0,0,0,3,0,3,0,0,0,0,0,0,0,0,0
128391,35000,350,0,-2,8,4,4,0,0,0,0,0,0,0,0,0,3,2,1,0,0,0,4,2,2,1,0,1,0,0,0,0,0,0
128498,35000,350,0,-2,1,0,1,0,0,0,0,0,0,0,0,0,0,0,0,0,0,0,1,0,1,0,0,0,0,0,0,0,0,0
128744,35000,350,0,-2,1,0,1,0,0,0,0,0,0,0,0,0,0,0,0,0,0,0,1,0,1,0,0,0,0,0,0,0,0,0
128771,35000,350,0,-2,4,4,0,0,0,0,0,0,0,0,0,0,1,1,0,0,0,0,3,3,0,0,0,0,0,0,0,0,0,0
128902,35000,350,0,-2,14,10,4,0,0,0,0,0,0,1,1,0,0,0,0,0,0,0,12,9,3,0,0,0,1,0,1,0,0,0
129020,35000,350,0,-2,33,18,15,0,0,0,1,1,0,5,3,2,5,4,1,0,0,0,20,8,12,0,0,0,2,2,0,0,0,0
129154,35000,350,0,-2,10,8,2,0,0,0,0,0,0,1,1,0,4,2,2,0,0,0,5,5,0,0,0,0,0,0,0,0,0,0
129215,35000,350,0,-2,16,8,8,0,0,0,0,0,0,2,1,1,4,1,3,0,0,0,9,6,3,0,0,0,1,0,1,0,0,0
129242,35000,350,0,-2,6,2,4,0,0,0,1,0,1,0,0,0,1,0,1,0,0,0,4,2,2,0,0,0,0,0,0,0,0,0
129491,35000,350,0,-2,1,1,0,0,0,0,0,0,0,0,0,0,1,1,0,0,0,0,0,0,0,0,0,0,0,0,0,0,0,0
129525,35000,350,0,-2,14,8,6,0,0,0,2,1,1,2,2,0,1,1,0,0,0,0,8,3,5,0,0,0,1,1,0,0,0,0
129543,35000,350,0,-2,1,1,0,0,0,0,0,0,0,0,0,0,1,1,0,0,0,0,0,0,0,0,0,0,0,0,0,0,0,0
129695,35000,350,0,-2,1,1,0,0,0,0,0,0,0,0,0,0,0,0,0,0,0,0,0,0,0,0,0,0,1,1,0,0,0,0
129729,35000,350,0,-2,1,1,0,0,0,0,0,0,0,0,0,0,0,0,0,0,0,0,1,1,0,0,0,0,0,0,0,0,0,0
129774,35000,350,0,-2,1,1,0,0,0,0,0,0,0,0,0,0,0,0,0,0,0,0,1,1,0,0,0,0,0,0,0,0,0,0
129808,35000,350,0,-2,1,0,1,0,0,0,0,0,0,0,0,0,0,0,0,0,0,0,1,0,1,0,0,0,0,0,0,0,0,0
129941,35000,350,0,-2,5,4,1,0,0,0,0,0,0,2,1,1,1,1,0,0,0,0,2,2,0,0,0,0,0,0,0,0,0,0
130226,35000,350,0,-2,3,3,0,0,0,0,0,0,0,2,2,0,1,1,0,0,0,0,0,0,0,0,0,0,0,0,0,0,0,0
130253,35000,350,0,-2,17,13,4,0,0,0,1,0,1,1,1,0,1,0,1,0,0,0,4,3,1,0,0,0,10,9,1,0,0,0
130314,35000,350,0,-2,6,4,2,0,0,0,0,0,0,1,1,0,1,1,0,0,0,0,4,2,2,0,0,0,0,0,0,0,0,0
130493,35000,350,0,-2,12,9,3,0,0,0,0,0,0,3,3,0,2,1,1,0,0,0,2,1,1,0,0,0,5,4,1,0,0,0
130624,35000,350,0,-2,25,24,1,1,1,0,0,0,0,2,2,0,3,3,0,0,0,0,14,14,0,1,1,0,4,3,1,0,0,0
130697,35000,350,0,-2,1,1,0,0,0,0,0,0,0,0,0,0,0,0,0,0,0,0,1,1,0,0,0,0,0,0,0,0,0,0
130776,35000,350,0,-2,5,3,2,0,0,0,0,0,0,2,2,0,2,0,2,0,0,0,1,1,0,0,0,0,0,0,0,0,0,0
130794,35000,350,0,-2,35,15,20,0,0,0,4,2,2,11,7,4,6,2,4,0,0,0,13,4,9,0,0,0,1,0,1,0,0,0
130907,35000,350,0,-2,1,1,0,0,0,0,0,0,0,0,0,0,0,0,0,0,0,0,1,1,0,0,0,0,0,0,0,0,0,0
130934,35000,350,0,-2,10,4,6,0,0,0,0,0,0,8,3,5,1,0,1,0,0,0,1,1,0,0,0,0,0,0,0,0,0,0
130943,35000,350,0,-2,35,22,13,1,1,0,4,3,1,11,5,6,5,2,3,0,0,0,12,10,2,2,1,1,0,0,0,0,0,0
130989,35000,350,0,-2,2,1,1,0,0,0,0,0,0,0,0,0,0,0,0,0,0,0,2,1,1,0,0,0,0,0,0,0,0,0
131159,35000,350,0,-2,14,6,8,0,0,0,2,0,2,1,1,0,0,0,0,0,0,0,6,3,3,0,0,0,4,2,2,1,0,1
131283,35000,350,0,-2,5,3,2,0,0,0,0,0,0,2,1,1,2,1,1,0,0,0,1,1,0,0,0,0,0,0,0,0,0,0
131450,35000,350,0,-2,25,18,7,0,0,0,2,2,0,18,12,6,2,1,1,0,0,0,3,3,0,0,0,0,0,0,0,0,0,0
131469,35000,350,0,-2,15,11,4,0,0,0,0,0,0,8,7,1,2,1,1,1,1,0,4,2,2,0,0,0,0,0,0,0,0,0
131496,35000,350,0,-2,8,5,3,0,0,0,0,0,0,4,2,2,0,0,0,0,0,0,2,1,1,0,0,0,2,2,0,0,0,0
131520,35000,350,0,-2,17,4,13,0,0,0,1,0,1,8,1,7,0,0,0,0,0,0,0,0,0,1,0,1,7,3,4,0,0,0
132408,35000,350,0,-2,1,1,0,0,0,0,0,0,0,0,0,0,0,0,0,0,0,0,1,1,0,0,0,0,0,0,0,0,0,0
132471,35000,350,0,-2,2,0,2,0,0,0,0,0,0,0,0,0,0,0,0,0,0,0,1,0,1,0,0,0,0,0,0,1,0,1
132602,35000,350,0,-2,2,0,2,0,0,0,0,0,0,2,0,2,0,0,0,0,0,0,0,0,0,0,0,0,0,0,0,0,0,0
132657,35000,350,0,-2,10,8,2,0,0,0,0,0,0,2,2,0,2,2,0,0,0,0,2,2,0,0,0,0,4,2,2,0,0,0
132709,35000,350,0,-2,1,0,1,0,0,0,0,0,0,1,0,1,0,0,0,0,0,0,0,0,0,0,0,0,0,0,0,0,0,0
132842,35000,350,0,-2,1,0,1,0,0,0,0,0,0,0,0,0,1,0,1,0,0,0,0,0,0,0,0,0,0,0,0,0,0,0
132851,35000,350,0,-2,5,4,1,0,0,0,0,0,0,0,0,0,0,0,0,0,0,0,5,4,1,0,0,0,0,0,0,0,0,0
132903,35000,350,0,-2,4,2,2,0,0,0,0,0,0,1,1,0,1,0,1,0,0,0,2,1,1,0,0,0,0,0,0,0,0,0
133021,35000,350,0,-2,3,3,0,0,0,0,0,0,0,1,1,0,0,0,0,0,0,0,2,2,0,0,0,0,0,0,0,0,0,0
133386,35000,350,0,-2,39,21,18,0,0,0,2,2,0,13,7,6,1,0,1,1,1,0,18,8,10,0,0,0,4,3,1,0,0,0
133465,35000,350,0,-2,1,1,0,0,0,0,0,0,0,0,0,0,0,0,0,0,0,0,1,1,0,0,0,0,0,0,0,0,0,0
133492,35000,350,0,-2,10,7,3,0,0,0,0,0,0,1,1,0,2,1,1,0,0,0,7,5,2,0,0,0,0,0,0,0,0,0
133508,35000,350,0,-2,14,14,0,0,0,0,0,0,0,0,0,0,3,3,0,0,0,0,10,10,0,0,0,0,1,1,0,0,0,0
133553,35000,350,0,-2,15,12,3,0,0,0,0,0,0,4,2,2,0,0,0,0,0,0,10,9,1,0,0,0,1,1,0,0,0,0
133650,35000,350,0,-2,12,5,7,0,0,0,0,0,0,10,3,7,0,0,0,0,0,0,1,1,0,0,0,0,0,0,0,1,1,0
133669,35000,350,0,-2,19,11,8,0,0,0,2,2,0,8,3,5,5,3,2,0,0,0,4,3,1,0,0,0,0,0,0,0,0,0
133702,35000,350,0,-2,17,16,1,0,0,0,0,0,0,8,8,0,1,1,0,0,0,0,6,6,0,2,1,1,0,0,0,0,0,0
133711,35000,350,0,-2,7,5,2,0,0,0,0,0,0,1,1,0,0,0,0,0,0,0,5,3,2,0,0,0,1,1,0,0,0,0
133809,35000,350,0,-2,1,0,1,0,0,0,0,0,0,0,0,0,0,0,0,0,0,0,1,0,1,0,0,0,0,0,0,0,0,0
133872,35000,350,0,-2,2,1,1,0,0,0,0,0,0,0,0,0,1,0,1,0,0,0,1,1,0,0,0,0,0,0,0,0,0,0
133881,35000,350,0,-2,18,12,6,0,0,0,1,0,1,4,3,1,1,1,0,0,0,0,10,7,3,1,0,1,1,1,0,0,0,0
133979,35000,350,0,-2,12,6,6,0,0,0,0,0,0,12,6,6,0,0,0,0,0,0,0,0,0,0,0,0,0,0,0,0,0,0
134079,35000,350,0,-2,23,15,8,0,0,0,0,0,0,3,3,0,9,6,3,0,0,0,10,6,4,1,0,1,0,0,0,0,0,0
134097,35000,350,0,-2,28,19,9,0,0,0,0,0,0,10,6,4,0,0,0,0,0,0,18,13,5,0,0,0,0,0,0,0,0,0
134130,35000,350,0,-2,97,39,58,0,0,0,1,0,1,25,11,14,16,10,6,0,0,0,46,15,31,1,0,1,8,3,5,0,0,0
134237,35000,350,0,-2,15,10,5,0,0,0,0,0,0,6,4,2,3,2,1,0,0,0,4,3,1,2,1,1,0,0,0,0,0,0
134343,35000,350,0,-2,3,1,2,0,0,0,0,0,0,0,0,0,0,0,0,0,0,0,2,1,1,0,0,0,1,0,1,0,0,0
134608,35000,350,0,-2,5,3,2,0,0,0,0,0,0,0,0,0,3,1,2,0,0,0,2,2,0,0,0,0,0,0,0,0,0,0
134945,35000,350,0,-2,7,4,3,0,0,0,0,0,0,3,1,2,2,1,1,0,0,0,2,2,0,0,0,0,0,0,0,0,0,0
135081,35000,350,0,-2,1,1,0,0,0,0,0,0,0,0,0,0,1,1,0,0,0,0,0,0,0,0,0,0,0,0,0,0,0,0
135188,35000,350,0,-2,1,1,0,0,0,0,0,0,0,0,0,0,0,0,0,0,0,0,1,1,0,0,0,0,0,0,0,0,0,0
135717,35000,350,0,-2,10,8,2,0,0,0,0,0,0,2,1,1,8,7,1,0,0,0,0,0,0,0,0,0,0,0,0,0,0,0
135726,35000,350,0,-2,361,113,248,0,0,0,3,0,3,68,23,45,192,60,132,0,0,0,28,11,17,5,0,5,30,3,27,35,16,19
136172,35000,350,0,-2,15,10,5,0,0,0,0,0,0,4,4,0,3,3,0,0,0,0,8,3,5,0,0,0,0,0,0,0,0,0
136215,35000,350,0,-2,60,25,35,0,0,0,3,1,2,27,9,18,19,9,10,0,0,0,8,6,2,0,0,0,0,0,0,3,0,3
136233,35000,350,0,-2,1,0,1,0,0,0,0,0,0,0,0,0,0,0,0,0,0,0,1,0,1,0,0,0,0,0,0,0,0,0
136330,35000,350,0,-2,5,5,0,0,0,0,0,0,0,0,0,0,0,0,0,0,0,0,4,4,0,0,0,0,0,0,0,1,1,0
136358,35000,350,0,-2,17,10,7,0,0,0,0,0,0,12,6,6,1,1,0,0,0,0,4,3,1,0,0,0,0,0,0,0,0,0
136701,35000,350,0,-2,2,0,2,0,0,0,0,0,0,0,0,0,2,0,2,0,0,0,0,0,0,0,0,0,0,0,0,0,0,0
136774,35000,350,0,-2,13,13,0,0,0,0,0,0,0,1,1,0,3,3,0,0,0,0,9,9,0,0,0,0,0,0,0,0,0,0
136950,35000,350,0,-2,13,9,4,0,0,0,0,0,0,4,3,1,4,1,3,0,0,0,5,5,0,0,0,0,0,0,0,0,0,0
137032,35000,350,0,-2,11,9,2,0,0,0,0,0,0,1,1,0,2,1,1,0,0,0,7,6,1,1,1,0,0,0,0,0,0,0
137078,35000,350,0,-2,9,5,4,0,0,0,1,1,0,0,0,0,3,2,1,0,0,0,4,2,2,0,0,0,1,0,1,0,0,0
137096,35000,350,0,-2,5,4,1,0,0,0,0,0,0,0,0,0,1,1,0,0,0,0,3,3,0,0,0,0,1,0,1,0,0,0
137209,35000,350,0,-2,1,1,0,0,0,0,0,0,0,0,0,0,1,1,0,0,0,0,0,0,0,0,0,0,0,0,0,0,0,0
137272,35000,350,0,-2,1,1,0,0,0,0,0,0,0,0,0,0,1,1,0,0,0,0,0,0,0,0,0,0,0,0,0,0,0,0
137281,35000,350,0,-2,2,2,0,0,0,0,0,0,0,0,0,0,0,0,0,0,0,0,2,2,0,0,0,0,0,0,0,0,0,0
137315,35000,350,0,-2,1,0,1,0,0,0,1,0,1,0,0,0,0,0,0,0,0,0,0,0,0,0,0,0,0,0,0,0,0,0
137351,35000,350,0,-2,36,19,17,0,0,0,1,0,1,7,5,2,7,4,3,0,0,0,14,8,6,7,2,5,0,0,0,0,0,0
137476,35000,350,0,-2,14,7,7,0,0,0,0,0,0,10,4,6,3,3,0,0,0,0,1,0,1,0,0,0,0,0,0,0,0,0
137546,35000,350,0,-2,22,16,6,0,0,0,0,0,0,3,3,0,5,2,3,0,0,0,14,11,3,0,0,0,0,0,0,0,0,0
137564,35000,350,0,-2,13,7,6,0,0,0,0,0,0,2,2,0,7,2,5,0,0,0,2,2,0,1,1,0,1,0,1,0,0,0
137759,35000,350,0,-2,11,9,2,0,0,0,0,0,0,5,3,2,0,0,0,0,0,0,6,6,0,0,0,0,0,0,0,0,0,0
137847,35000,350,0,-2,16,8,8,0,0,0,0,0,0,1,0,1,6,3,3,0,0,0,8,5,3,0,0,0,1,0,1,0,0,0
138187,35000,350,0,-2,24,17,7,0,0,0,2,2,0,7,4,3,3,2,1,0,0,0,6,6,0,0,0,0,4,3,1,2,0,2
138275,35000,350,0,-2,5,3,2,0,0,0,0,0,0,0,0,0,1,0,1,0,0,0,4,3,1,0,0,0,0,0,0,0,0,0
138354,35000,350,0,-2,2,2,0,0,0,0,0,0,0,0,0,0,0,0,0,0,0,0,2,2,0,0,0,0,0,0,0,0,0,0
138558,35000,350,0,-2,5,2,3,0,0,0,0,0,0,1,0,1,0,0,0,0,0,0,4,2,2,0,0,0,0,0,0,0,0,0
138600,35000,350,0,-2,7,2,5,0,0,0,0,0,0,5,2,3,0,0,0,0,0,0,0,0,0,0,0,0,2,0,2,0,0,0
138682,35000,350,0,-2,2,0,2,0,0,0,0,0,0,2,0,2,0,0,0,0,0,0,0,0,0,0,0,0,0,0,0,0,0,0
138716,35000,350,0,-2,4,3,1,0,0,0,0,0,0,4,3,1,0,0,0,0,0,0,0,0,0,0,0,0,0,0,0,0,0,0
138840,35000,350,0,-2,3,2,1,0,0,0,0,0,0,2,2,0,1,0,1,0,0,0,0,0,0,0,0,0,0,0,0,0,0,0
138901,35000,350,0,-2,1,1,0,0,0,0,0,0,0,1,1,0,0,0,0,0,0,0,0,0,0,0,0,0,0,0,0,0,0,0
138947,35000,350,0,-2,23,13,10,0,0,0,0,0,0,20,12,8,0,0,0,0,0,0,0,0,0,0,0,0,3,1,2,0,0,0
138956,35000,350,0,-2,3,3,0,0,0,0,0,0,0,2,2,0,0,0,0,0,0,0,1,1,0,0,0,0,0,0,0,0,0,0
139144,35000,350,0,-2,19,9,10,0,0,0,0,0,0,2,1,1,4,1,3,0,0,0,13,7,6,0,0,0,0,0,0,0,0,0
139199,35000,350,0,-2,1,0,1,0,0,0,0,0,0,0,0,0,1,0,1,0,0,0,0,0,0,0,0,0,0,0,0,0,0,0
139205,35000,350,0,-2,2,2,0,0,0,0,0,0,0,1,1,0,1,1,0,0,0,0,0,0,0,0,0,0,0,0,0,0,0,0
139250,35000,350,0,-2,3,0,3,0,0,0,0,0,0,0,0,0,0,0,0,0,0,0,3,0,3,0,0,0,0,0,0,0,0,0
139278,35000,350,0,-2,2,2,0,0,0,0,0,0,0,0,0,0,0,0,0,0,0,0,2,2,0,0,0,0,0,0,0,0,0,0
139311,35000,350,0,-2,13,12,1,0,0,0,4,4,0,5,4,1,0,0,0,0,0,0,2,2,0,1,1,0,1,1,0,0,0,0
139357,35000,350,0,-2,2,2,0,0,0,0,0,0,0,0,0,0,0,0,0,0,0,0,2,2,0,0,0,0,0,0,0,0,0,0
139366,35000,350,0,-2,15,12,3,0,0,0,0,0,0,6,5,1,0,0,0,0,0,0,8,6,2,0,0,0,1,1,0,0,0,0
139384,35000,350,0,-2,10,8,2,0,0,0,0,0,0,0,0,0,0,0,0,0,0,0,10,8,2,0,0,0,0,0,0,0,0,0
139393,35000,350,0,-2,8,6,2,0,0,0,0,0,0,1,1,0,0,0,0,0,0,0,7,5,2,0,0,0,0,0,0,0,0,0
139579,35000,350,0,-2,2,2,0,0,0,0,0,0,0,2,2,0,0,0,0,0,0,0,0,0,0,0,0,0,0,0,0,0,0,0
139630,35000,350,0,-2,1,1,0,0,0,0,0,0,0,1,1,0,0,0,0,0,0,0,0,0,0,0,0,0,0,0,0,0,0,0
139658,35000,350,0,-2,79,35,44,1,0,1,6,3,3,42,20,22,6,2,4,0,0,0,22,10,12,1,0,1,0,0,0,1,0,1
139700,35000,350,0,-2,2,2,0,0,0,0,0,0,0,2,2,0,0,0,0,0,0,0,0,0,0,0,0,0,0,0,0,0,0,0
139719,35000,350,0,-2,7,3,4,0,0,0,0,0,0,7,3,4,0,0,0,0,0,0,0,0,0,0,0,0,0,0,0,0,0,0
139755,35000,350,0,-2,243,110,133,0,0,0,1,0,1,216,93,123,8,3,5,0,0,0,15,12,3,1,1,0,2,1,1,0,0,0
139764,35000,350,0,-2,4,4,0,0,0,0,0,0,0,1,1,0,0,0,0,0,0,0,3,3,0,0,0,0,0,0,0,0,0,0
139861,35000,350,0,-2,18,16,2,0,0,0,0,0,0,8,7,1,0,0,0,0,0,0,9,8,1,0,0,0,1,1,0,0,0,0
139931,35000,350,0,-2,70,33,37,0,0,0,0,0,0,45,16,29,0,0,0,0,0,0,18,12,6,5,4,1,2,1,1,0,0,0
139940,35000,350,0,-2,53,22,31,0,0,0,0,0,0,41,18,23,0,0,0,0,0,0,10,4,6,0,0,0,2,0,2,0,0,0
139959,35000,350,0,-2,163,63,100,0,0,0,3,2,1,50,12,38,13,6,7,2,0,2,85,39,46,6,3,3,4,1,3,0,0,0
139968,35000,350,0,-2,3,2,1,0,0,0,0,0,0,2,1,1,0,0,0,0,0,0,1,1,0,0,0,0,0,0,0,0,0,0
139986,35000,350,0,-2,8,8,0,0,0,0,0,0,0,4,4,0,0,0,0,0,0,0,4,4,0,0,0,0,0,0,0,0,0,0
140012,35000,350,0,-2,9,8,1,0,0,0,0,0,0,6,6,0,1,1,0,0,0,0,2,1,1,0,0,0,0,0,0,0,0,0
140146,35000,350,0,-2,1,1,0,0,0,0,0,0,0,1,1,0,0,0,0,0,0,0,0,0,0,0,0,0,0,0,0,0,0,0
140243,35000,350,0,-2,3,1,2,0,0,0,1,1,0,0,0,0,1,0,1,0,0,0,1,0,1,0,0,0,0,0,0,0,0,0
140331,35000,350,0,-2,14,9,5,0,0,0,0,0,0,0,0,0,4,1,3,0,0,0,10,8,2,0,0,0,0,0,0,0,0,0
140447,35000,350,0,-2,8,6,2,0,0,0,0,0,0,1,1,0,0,0,0,0,0,0,7,5,2,0,0,0,0,0,0,0,0,0
140562,35000,350,0,-2,31,10,21,0,0,0,1,0,1,29,10,19,0,0,0,0,0,0,0,0,0,1,0,1,0,0,0,0,0,0
140678,35000,350,0,-2,6,5,1,0,0,0,0,0,0,0,0,0,0,0,0,0,0,0,6,5,1,0,0,0,0,0,0,0,0,0
140696,35000,350,0,-2,4,2,2,0,0,0,0,0,0,3,1,2,0,0,0,0,0,0,1,1,0,0,0,0,0,0,0,0,0,0
140720,35000,350,0,-2,4,3,1,0,0,0,0,0,0,4,3,1,0,0,0,0,0,0,0,0,0,0,0,0,0,0,0,0,0,0
140818,35000,350,0,-2,1,1,0,0,0,0,0,0,0,0,0,0,0,0,0,0,0,0,1,1,0,0,0,0,0,0,0,0,0,0
140872,35000,350,0,-2,1,1,0,0,0,0,0,0,0,0,0,0,0,0,0,0,0,0,1,1,0,0,0,0,0,0,0,0,0,0
140942,35000,350,0,-2,4,3,1,0,0,0,0,0,0,2,1,1,0,0,0,0,0,0,2,2,0,0,0,0,0,0,0,0,0,0
140951,35000,350,0,-2,26,12,14,0,0,0,1,0,1,8,4,4,1,0,1,0,0,0,9,4,5,0,0,0,7,4,3,0,0,0
140960,35000,350,0,-2,5,1,4,0,0,0,0,0,0,3,0,3,0,0,0,0,0,0,1,1,0,1,0,1,0,0,0,0,0,0
141006,35000,350,0,-2,2,2,0,0,0,0,0,0,0,0,0,0,0,0,0,0,0,0,2,2,0,0,0,0,0,0,0,0,0,0
141237,35000,350,0,-2,4,4,0,0,0,0,0,0,0,0,0,0,0,0,0,0,0,0,4,4,0,0,0,0,0,0,0,0,0,0
141255,35000,350,0,-2,6,4,2,0,0,0,0,0,0,2,1,1,0,0,0,0,0,0,4,3,1,0,0,0,0,0,0,0,0,0
141264,35000,350,0,-2,6,6,0,0,0,0,0,0,0,3,3,0,1,1,0,0,0,0,1,1,0,0,0,0,1,1,0,0,0,0
141325,35000,350,0,-2,1,1,0,0,0,0,0,0,0,0,0,0,0,0,0,0,0,0,1,1,0,0,0,0,0,0,0,0,0,0
141334,35000,350,0,-2,16,7,9,0,0,0,0,0,0,4,1,3,2,1,1,0,0,0,10,5,5,0,0,0,0,0,0,0,0,0
141486,35000,350,0,-2,2,2,0,0,0,0,0,0,0,0,0,0,1,1,0,0,0,0,1,1,0,0,0,0,0,0,0,0,0,0
141565,35000,350,0,-2,1,0,1,0,0,0,0,0,0,0,0,0,0,0,0,0,0,0,1,0,1,0,0,0,0,0,0,0,0,0
141574,35000,350,0,-2,16,11,5,0,0,0,4,2,2,0,0,0,3,2,1,0,0,0,3,2,1,6,5,1,0,0,0,0,0,0
141644,35000,350,0,-2,4,4,0,0,0,0,1,1,0,0,0,0,0,0,0,1,1,0,1,1,0,1,1,0,0,0,0,0,0,0
141680,35000,350,0,-2,2,2,0,0,0,0,1,1,0,0,0,0,0,0,0,0,0,0,0,0,0,1,1,0,0,0,0,0,0,0
141796,35000,350,0,-2,1,0,1,0,0,0,0,0,0,0,0,0,0,0,0,0,0,0,0,0,0,1,0,1,0,0,0,0,0,0
141802,35000,350,0,-2,2,2,0,0,0,0,1,1,0,0,0,0,0,0,0,0,0,0,0,0,0,1,1,0,0,0,0,0,0,0
141811,35000,350,0,-2,2,1,1,0,0,0,2,1,1,0,0,0,0,0,0,0,0,0,0,0,0,0,0,0,0,0,0,0,0,0
141839,35000,350,0,-2,2,1,1,0,0,0,0,0,0,0,0,0,0,0,0,1,1,0,1,0,1,0,0,0,0,0,0,0,0,0
141990,35000,350,0,-2,1,1,0,0,0,0,0,0,0,0,0,0,0,0,0,0,0,0,1,1,0,0,0,0,0,0,0,0,0,0
142115,35000,350,0,-2,37,22,15,0,0,0,1,0,1,0,0,0,2,1,1,0,0,0,30,18,12,3,2,1,1,1,0,0,0,0
142179,35000,350,0,-2,1,0,1,0,0,0,0,0,0,0,0,0,0,0,0,0,0,0,1,0,1,0,0,0,0,0,0,0,0,0
142276,35000,350,0,-2,9,6,3,0,0,0,0,0,0,0,0,0,0,0,0,0,0,0,6,4,2,0,0,0,3,2,1,0,0,0
142285,35000,350,0,-2,19,18,1,0,0,0,1,1,0,0,0,0,3,3,0,0,0,0,12,11,1,0,0,0,3,3,0,0,0,0
142294,35000,350,0,-2,3,2,1,0,0,0,0,0,0,0,0,0,0,0,0,0,0,0,3,2,1,0,0,0,0,0,0,0,0,0
142328,35000,350,0,-2,5,5,0,0,0,0,0,0,0,0,0,0,3,3,0,0,0,0,2,2,0,0,0,0,0,0,0,0,0,0
142443,35000,350,0,-2,12,9,3,0,0,0,0,0,0,0,0,0,0,0,0,0,0,0,10,7,3,0,0,0,2,2,0,0,0,0
142461,35000,350,0,-2,1,0,1,0,0,0,0,0,0,0,0,0,0,0,0,0,0,0,1,0,1,0,0,0,0,0,0,0,0,0
142522,35000,350,0,-2,10,7,3,0,0,0,0,0,0,0,0,0,1,1,0,0,0,0,6,4,2,0,0,0,3,2,1,0,0,0
142559,35000,350,0,-2,16,5,11,0,0,0,0,0,0,0,0,0,3,0,3,0,0,0,11,4,7,0,0,0,1,0,1,1,1,0
142832,35000,350,0,-2,1,1,0,0,0,0,0,0,0,0,0,0,0,0,0,0,0,0,1,1,0,0,0,0,0,0,0,0,0,0
143084,35000,350,0,-2,9,5,4,0,0,0,0,0,0,1,1,0,2,1,1,0,0,0,6,3,3,0,0,0,0,0,0,0,0,0
143118,35000,350,0,-2,6,4,2,0,0,0,0,0,0,0,0,0,1,1,0,0,0,0,5,3,2,0,0,0,0,0,0,0,0,0
143215,35000,350,0,-2,15,13,2,0,0,0,1,1,0,1,1,0,1,1,0,1,0,1,11,10,1,0,0,0,0,0,0,0,0,0
143233,35000,350,0,-2,1,1,0,0,0,0,0,0,0,0,0,0,0,0,0,0,0,0,1,1,0,0,0,0,0,0,0,0,0,0
143279,35000,350,0,-2,4,3,1,0,0,0,0,0,0,0,0,0,0,0,0,0,0,0,1,0,1,0,0,0,3,3,0,0,0,0
143358,35000,350,0,-2,8,7,1,1,0,1,0,0,0,1,1,0,0,0,0,0,0,0,6,6,0,0,0,0,0,0,0,0,0,0
143613,35000,350,0,-2,4,3,1,0,0,0,0,0,0,0,0,0,0,0,0,0,0,0,4,3,1,0,0,0,0,0,0,0,0,0
144050,35000,350,0,-2,29,16,13,0,0,0,2,1,1,16,7,9,7,6,1,0,0,0,2,1,1,0,0,0,2,1,1,0,0,0
144157,35000,350,0,-2,1,1,0,0,0,0,0,0,0,0,0,0,0,0,0,0,0,0,0,0,0,1,1,0,0,0,0,0,0,0
144281,35000,350,0,-2,3,0,3,0,0,0,0,0,0,2,0,2,0,0,0,0,0,0,0,0,0,0,0,0,1,0,1,0,0,0
144351,35000,350,0,-2,8,7,1,0,0,0,0,0,0,2,2,0,0,0,0,0,0,0,3,3,0,1,1,0,1,1,0,1,0,1
144564,35000,350,0,-2,3,3,0,0,0,0,0,0,0,0,0,0,0,0,0,0,0,0,3,3,0,0,0,0,0,0,0,0,0,0
144740,35000,350,0,-2,5,3,2,0,0,0,0,0,0,0,0,0,1,1,0,0,0,0,1,1,0,0,0,0,3,1,2,0,0,0
144865,35000,350,0,-2,2,2,0,0,0,0,1,1,0,0,0,0,0,0,0,0,0,0,1,1,0,0,0,0,0,0,0,0,0,0
144892,35000,350,0,-2,11,9,2,0,0,0,0,0,0,1,1,0,0,0,0,0,0,0,10,8,2,0,0,0,0,0,0,0,0,0
144944,35000,350,0,-2,5,2,3,0,0,0,0,0,0,0,0,0,3,0,3,0,0,0,2,2,0,0,0,0,0,0,0,0,0,0
144962,35000,350,0,-2,1,1,0,0,0,0,0,0,0,0,0,0,0,0,0,0,0,0,1,1,0,0,0,0,0,0,0,0,0,0
144971,35000,350,0,-2,2,1,1,0,0,0,0,0,0,0,0,0,0,0,0,0,0,0,2,1,1,0,0,0,0,0,0,0,0,0
145336,35000,350,0,-2,5,2,3,0,0,0,0,0,0,3,2,1,0,0,0,0,0,0,1,0,1,0,0,0,1,0,1,0,0,0
145372,35000,350,0,-2,8,3,5,0,0,0,0,0,0,1,1,0,0,0,0,0,0,0,7,2,5,0,0,0,0,0,0,0,0,0
145497,35000,350,0,-2,2,1,1,0,0,0,0,0,0,0,0,0,2,1,1,0,0,0,0,0,0,0,0,0,0,0,0,0,0,0
145521,35000,350,0,-2,3,3,0,0,0,0,0,0,0,0,0,0,1,1,0,0,0,0,2,2,0,0,0,0,0,0,0,0,0,0
145558,35000,350,0,-2,3,3,0,0,0,0,0,0,0,0,0,0,1,1,0,0,0,0,2,2,0,0,0,0,0,0,0,0,0,0
145600,35000,350,0,-2,43,23,20,1,1,0,0,0,0,21,12,9,5,3,2,0,0,0,11,5,6,3,2,1,2,0,2,0,0,0
145619,35000,350,0,-2,4,3,1,0,0,0,0,0,0,0,0,0,1,0,1,0,0,0,3,3,0,0,0,0,0,0,0,0,0,0
145637,35000,350,0,-2,65,42,23,0,0,0,3,2,1,15,10,5,4,2,2,0,0,0,38,24,14,2,2,0,1,0,1,2,2,0
145646,35000,350,0,-2,7,4,3,0,0,0,0,0,0,1,0,1,0,0,0,0,0,0,6,4,2,0,0,0,0,0,0,0,0,0
145682,35000,350,0,-2,5,5,0,0,0,0,0,0,0,0,0,0,0,0,0,0,0,0,4,4,0,0,0,0,0,0,0,1,1,0
145691,35000,350,0,-2,7,6,1,0,0,0,0,0,0,0,0,0,1,1,0,0,0,0,6,5,1,0,0,0,0,0,0,0,0,0
145707,35000,350,0,-2,1,1,0,0,0,0,0,0,0,0,0,0,0,0,0,0,0,0,1,1,0,0,0,0,0,0,0,0,0,0
145725,35000,350,0,-2,7,4,3,0,0,0,0,0,0,0,0,0,0,0,0,0,0,0,1,0,1,0,0,0,6,4,2,0,0,0
145813,35000,350,0,-2,16,10,6,0,0,0,0,0,0,1,0,1,2,1,1,0,0,0,7,6,1,1,1,0,5,2,3,0,0,0
145831,35000,350,0,-2,5,4,1,0,0,0,0,0,0,0,0,0,0,0,0,0,0,0,5,4,1,0,0,0,0,0,0,0,0,0
146205,35000,350,0,-2,2,2,0,0,0,0,1,1,0,0,0,0,0,0,0,0,0,0,1,1,0,0,0,0,0,0,0,0,0,0
146278,35000,350,0,-2,1,1,0,0,0,0,0,0,0,0,0,0,0,0,0,0,0,0,1,1,0,0,0,0,0,0,0,0,0,0
146296,35000,350,0,-2,3,3,0,0,0,0,0,0,0,0,0,0,0,0,0,0,0,0,3,3,0,0,0,0,0,0,0,0,0,0
146339,35000,350,0,-2,1,1,0,0,0,0,0,0,0,1,1,0,0,0,0,0,0,0,0,0,0,0,0,0,0,0,0,0,0,0
146348,35000,350,0,-2,4,4,0,0,0,0,0,0,0,1,1,0,1,1,0,0,0,0,1,1,0,0,0,0,1,1,0,0,0,0
146366,35000,350,0,-2,2,2,0,0,0,0,0,0,0,0,0,0,0,0,0,0,0,0,2,2,0,0,0,0,0,0,0,0,0,0
146418,35000,350,0,-2,1,0,1,0,0,0,0,0,0,0,0,0,0,0,0,0,0,0,1,0,1,0,0,0,0,0,0,0,0,0
146427,35000,350,0,-2,26,5,21,0,0,0,0,0,0,6,3,3,2,1,1,0,0,0,17,0,17,0,0,0,1,1,0,0,0,0
146472,35000,350,0,-2,9,8,1,0,0,0,0,0,0,0,0,0,2,1,1,0,0,0,7,7,0,0,0,0,0,0,0,0,0,0
146481,35000,350,0,-2,5,4,1,0,0,0,0,0,0,1,0,1,2,2,0,0,0,0,2,2,0,0,0,0,0,0,0,0,0,0
146506,35000,350,0,-2,6,6,0,0,0,0,0,0,0,0,0,0,0,0,0,0,0,0,6,6,0,0,0,0,0,0,0,0,0,0
146603,35000,350,0,-2,2,2,0,0,0,0,0,0,0,0,0,0,0,0,0,0,0,0,2,2,0,0,0,0,0,0,0,0,0,0
146612,35000,350,0,-2,7,5,2,0,0,0,0,0,0,0,0,0,2,2,0,0,0,0,3,2,1,0,0,0,2,1,1,0,0,0
146667,35000,350,0,-2,1,0,1,0,0,0,0,0,0,0,0,0,0,0,0,0,0,0,1,0,1,0,0,0,0,0,0,0,0,0
146676,35000,350,0,-2,10,6,4,0,0,0,0,0,0,3,2,1,0,0,0,0,0,0,7,4,3,0,0,0,0,0,0,0,0,0
146685,35000,350,0,-2,1,1,0,0,0,0,0,0,0,0,0,0,0,0,0,0,0,0,1,1,0,0,0,0,0,0,0,0,0,0
146719,35000,350,0,-2,34,15,19,0,0,0,1,1,0,10,5,5,3,2,1,0,0,0,19,7,12,0,0,0,1,0,1,0,0,0
147004,35000,350,0,-2,2,2,0,0,0,0,0,0,0,0,0,0,1,1,0,0,0,0,1,1,0,0,0,0,0,0,0,0,0,0
147013,35000,350,0,-2,4,2,2,0,0,0,0,0,0,1,1,0,0,0,0,0,0,0,3,1,2,0,0,0,0,0,0,0,0,0
147244,35000,350,0,-2,11,10,1,0,0,0,0,0,0,2,2,0,1,1,0,0,0,0,7,6,1,1,1,0,0,0,0,0,0,0
147341,35000,350,0,-2,1,1,0,0,0,0,0,0,0,0,0,0,0,0,0,0,0,0,1,1,0,0,0,0,0,0,0,0,0,0
147369,35000,350,0,-2,11,9,2,0,0,0,1,1,0,0,0,0,2,2,0,0,0,0,8,6,2,0,0,0,0,0,0,0,0,0
147378,35000,350,0,-2,4,4,0,0,0,0,0,0,0,0,0,0,1,1,0,0,0,0,3,3,0,0,0,0,0,0,0,0,0,0
147536,35000,350,0,-2,4,1,3,0,0,0,0,0,0,2,0,2,0,0,0,0,0,0,2,1,1,0,0,0,0,0,0,0,0,0
147660,35000,350,0,-2,7,5,2,0,0,0,1,0,1,1,1,0,1,1,0,0,0,0,4,3,1,0,0,0,0,0,0,0,0,0
147703,35000,350,0,-2,7,3,4,0,0,0,1,0,1,1,1,0,0,0,0,0,0,0,4,2,2,0,0,0,1,0,1,0,0,0
147767,35000,350,0,-2,23,12,11,0,0,0,1,1,0,6,6,0,2,1,1,0,0,0,13,4,9,1,0,1,0,0,0,0,0,0
147776,35000,350,0,-2,7,6,1,0,0,0,0,0,0,2,2,0,3,2,1,0,0,0,2,2,0,0,0,0,0,0,0,0,0,0
147800,35000,350,0,-2,2,1,1,0,0,0,0,0,0,0,0,0,0,0,0,0,0,0,0,0,0,0,0,0,2,1,1,0,0,0
147828,35000,350,0,-2,5,4,1,0,0,0,0,0,0,1,1,0,0,0,0,0,0,0,4,3,1,0,0,0,0,0,0,0,0,0
148131,35000,350,0,-2,1,0,1,0,0,0,0,0,0,0,0,0,0,0,0,0,0,0,1,0,1,0,0,0,0,0,0,0,0,0
148256,35000,350,0,-2,1,1,0,0,0,0,0,0,0,0,0,0,0,0,0,0,0,0,1,1,0,0,0,0,0,0,0,0,0,0
148292,35000,350,0,-2,1,0,1,0,0,0,0,0,0,0,0,0,0,0,0,0,0,0,1,0,1,0,0,0,0,0,0,0,0,0
148487,35000,350,0,-2,5,4,1,0,0,0,0,0,0,2,1,1,2,2,0,0,0,0,0,0,0,0,0,0,1,1,0,0,0,0
148496,35000,350,0,-2,4,1,3,0,0,0,0,0,0,1,0,1,2,0,2,0,0,0,1,1,0,0,0,0,0,0,0,0,0,0
148511,35000,350,0,-2,105,23,82,1,0,1,16,5,11,14,2,12,28,5,23,0,0,0,42,9,33,3,2,1,1,0,1,0,0,0
148627,35000,350,0,-2,6,3,3,0,0,0,0,0,0,0,0,0,0,0,0,0,0,0,1,1,0,1,0,1,4,2,2,0,0,0
148654,35000,350,0,-2,3,3,0,0,0,0,1,1,0,0,0,0,0,0,0,0,0,0,2,2,0,0,0,0,0,0,0,0,0,0
148672,35000,350,0,-2,2,2,0,0,0,0,0,0,0,0,0,0,0,0,0,0,0,0,2,2,0,0,0,0,0,0,0,0,0,0
148885,35000,350,0,-2,5,2,3,0,0,0,0,0,0,0,0,0,3,0,3,0,0,0,2,2,0,0,0,0,0,0,0,0,0,0
148991,35000,350,0,-2,1,1,0,0,0,0,0,0,0,0,0,0,0,0,0,0,0,0,1,1,0,0,0,0,0,0,0,0,0,0
149222,35000,350,0,-2,35,19,16,0,0,0,0,0,0,5,3,2,1,1,0,0,0,0,27,13,14,1,1,0,0,0,0,1,1,0
149231,35000,350,0,-2,21,8,13,0,0,0,0,0,0,5,2,3,2,0,2,0,0,0,14,6,8,0,0,0,0,0,0,0,0,0
149329,35000,350,0,-2,4,4,0,0,0,0,0,0,0,0,0,0,4,4,0,0,0,0,0,0,0,0,0,0,0,0,0,0,0,0
149365,35000,350,0,-2,6,4,2,0,0,0,0,0,0,2,1,1,1,1,0,0,0,0,3,2,1,0,0,0,0,0,0,0,0,0
149505,35000,350,0,-2,1,1,0,0,0,0,0,0,0,0,0,0,0,0,0,0,0,0,1,1,0,0,0,0,0,0,0,0,0,0
149514,35000,350,0,-2,1,1,0,0,0,0,0,0,0,0,0,0,0,0,0,0,0,0,1,1,0,0,0,0,0,0,0,0,0,0
149532,35000,350,0,-2,3,3,0,0,0,0,0,0,0,2,2,0,0,0,0,0,0,0,1,1,0,0,0,0,0,0,0,0,0,0
149727,35000,350,0,-2,5,5,0,0,0,0,0,0,0,0,0,0,2,2,0,0,0,0,3,3,0,0,0,0,0,0,0,0,0,0
149772,35000,350,0,-2,17,12,5,0,0,0,0,0,0,0,0,0,0,0,0,0,0,0,17,12,5,0,0,0,0,0,0,0,0,0
149781,35000,350,0,-2,7,6,1,0,0,0,0,0,0,1,1,0,1,1,0,0,0,0,3,2,1,0,0,0,2,2,0,0,0,0
149842,35000,350,0,-2,5,2,3,0,0,0,0,0,0,0,0,0,3,0,3,0,0,0,2,2,0,0,0,0,0,0,0,0,0,0
150066,35000,350,0,-2,2,1,1,0,0,0,0,0,0,0,0,0,0,0,0,0,0,0,2,1,1,0,0,0,0,0,0,0,0,0
150136,35000,350,0,-2,18,6,12,0,0,0,1,1,0,4,1,3,0,0,0,0,0,0,12,4,8,1,0,1,0,0,0,0,0,0
150145,35000,350,0,-2,3,2,1,0,0,0,1,1,0,0,0,0,0,0,0,0,0,0,2,1,1,0,0,0,0,0,0,0,0,0
150163,35000,350,0,-2,10,3,7,0,0,0,0,0,0,0,0,0,1,0,1,0,0,0,8,3,5,0,0,0,1,0,1,0,0,0
150172,35000,350,0,-2,1,1,0,0,0,0,0,0,0,0,0,0,1,1,0,0,0,0,0,0,0,0,0,0,0,0,0,0,0,0
150288,35000,350,0,-2,2,2,0,0,0,0,0,0,0,0,0,0,0,0,0,0,0,0,2,2,0,0,0,0,0,0,0,0,0,0
150400,35000,350,0,-2,2,2,0,0,0,0,0,0,0,0,0,0,0,0,0,0,0,0,2,2,0,0,0,0,0,0,0,0,0,0
150455,35000,350,0,-2,5,2,3,0,0,0,0,0,0,0,0,0,0,0,0,0,0,0,5,2,3,0,0,0,0,0,0,0,0,0
150534,35000,350,0,-2,1,1,0,0,0,0,0,0,0,0,0,0,0,0,0,0,0,0,0,0,0,0,0,0,1,1,0,0,0,0
150604,35000,350,0,-2,4,3,1,0,0,0,0,0,0,0,0,0,0,0,0,0,0,0,4,3,1,0,0,0,0,0,0,0,0,0
150668,35000,350,0,-2,5,2,3,0,0,0,0,0,0,0,0,0,0,0,0,0,0,0,5,2,3,0,0,0,0,0,0,0,0,0
150941,35000,350,0,-2,1,0,1,0,0,0,0,0,0,0,0,0,0,0,0,0,0,0,1,0,1,0,0,0,0,0,0,0,0,0
150987,35000,350,0,-2,11,10,1,0,0,0,0,0,0,1,1,0,0,0,0,0,0,0,9,8,1,0,0,0,1,1,0,0,0,0
151102,35000,350,0,-2,6,2,4,0,0,0,0,0,0,0,0,0,0,0,0,0,0,0,6,2,4,0,0,0,0,0,0,0,0,0
151111,35000,350,0,-2,56,24,32,0,0,0,3,0,3,14,8,6,8,3,5,0,0,0,30,13,17,1,0,1,0,0,0,0,0,0
151263,35000,350,0,-2,20,10,10,0,0,0,0,0,0,4,2,2,1,1,0,0,0,0,14,6,8,1,1,0,0,0,0,0,0,0
151290,35000,350,0,-2,1,0,1,0,0,0,0,0,0,1,0,1,0,0,0,0,0,0,0,0,0,0,0,0,0,0,0,0,0,0
151306,35000,350,0,-2,12,7,5,0,0,0,0,0,0,1,1,0,0,0,0,0,0,0,11,6,5,0,0,0,0,0,0,0,0,0
151324,35000,350,0,-2,24,14,10,0,0,0,0,0,0,1,1,0,0,0,0,0,0,0,23,13,10,0,0,0,0,0,0,0,0,0
151333,35000,350,0,-2,5,3,2,0,0,0,0,0,0,1,1,0,0,0,0,0,0,0,4,2,2,0,0,0,0,0,0,0,0,0
151342,35000,350,0,-2,5,3,2,0,0,0,0,0,0,2,1,1,0,0,0,0,0,0,2,1,1,1,1,0,0,0,0,0,0,0
151351,35000,350,0,-2,98,64,34,1,0,1,3,2,1,9,2,7,3,2,1,0,0,0,79,56,23,1,1,0,0,0,0,2,1,1
151360,35000,350,0,-2,7,4,3,0,0,0,0,0,0,3,2,1,2,1,1,0,0,0,2,1,1,0,0,0,0,0,0,0,0,0
151379,35000,350,0,-2,7,3,4,0,0,0,1,0,1,1,1,0,0,0,0,0,0,0,5,2,3,0,0,0,0,0,0,0,0,0
151388,35000,350,0,-2,2,1,1,0,0,0,0,0,0,0,0,0,0,0,0,0,0,0,2,1,1,0,0,0,0,0,0,0,0,0
151777,35000,350,0,-2,9,8,1,0,0,0,0,0,0,0,0,0,0,0,0,0,0,0,9,8,1,0,0,0,0,0,0,0,0,0
151786,35000,350,0,-2,7,1,6,0,0,0,0,0,0,1,0,1,1,0,1,0,0,0,5,1,4,0,0,0,0,0,0,0,0,0
151801,35000,350,0,-2,17,7,10,0,0,0,0,0,0,1,0,1,1,1,0,0,0,0,14,6,8,0,0,0,1,0,1,0,0,0
151810,35000,350,0,-2,2,1,1,0,0,0,0,0,0,2,1,1,0,0,0,0,0,0,0,0,0,0,0,0,0,0,0,0,0,0
152080,35000,350,0,-2,171,88,83,1,1,0,3,3,0,22,7,15,29,17,12,0,0,0,78,43,35,5,4,1,29,13,16,4,0,4
152318,35000,350,0,-2,12,6,6,0,0,0,0,0,0,1,0,1,0,0,0,0,0,0,11,6,5,0,0,0,0,0,0,0,0,0
152381,35000,350,0,-2,5,1,4,0,0,0,0,0,0,0,0,0,0,0,0,0,0,0,5,1,4,0,0,0,0,0,0,0,0,0
152390,35000,350,0,-2,16,9,7,0,0,0,0,0,0,2,2,0,1,1,0,0,0,0,5,1,4,0,0,0,0,0,0,8,5,3
152530,35000,350,0,-2,2,2,0,0,0,0,0,0,0,0,0,0,0,0,0,0,0,0,2,2,0,0,0,0,0,0,0,0,0,0
152567,35000,350,0,-2,31,13,18,0,0,0,0,0,0,0,0,0,0,0,0,0,0,0,29,11,18,0,0,0,2,2,0,0,0,0
152637,35000,350,0,-2,10,3,7,0,0,0,1,1,0,0,0,0,0,0,0,0,0,0,8,2,6,0,0,0,0,0,0,1,0,1
152673,35000,350,0,-2,3,3,0,0,0,0,0,0,0,0,0,0,0,0,0,0,0,0,3,3,0,0,0,0,0,0,0,0,0,0
152798,35000,350,0,-2,1,1,0,0,0,0,0,0,0,0,0,0,0,0,0,0,0,0,1,1,0,0,0,0,0,0,0,0,0,0
152992,35000,350,0,-2,1,0,1,0,0,0,0,0,0,0,0,0,0,0,0,0,0,0,1,0,1,0,0,0,0,0,0,0,0,0
153001,35000,350,0,-2,3,0,3,0,0,0,0,0,0,0,0,0,3,0,3,0,0,0,0,0,0,0,0,0,0,0,0,0,0,0
153108,35000,350,0,-2,13,2,11,0,0,0,0,0,0,1,0,1,0,0,0,0,0,0,12,2,10,0,0,0,0,0,0,0,0,0
153126,35000,350,0,-2,6,3,3,0,0,0,0,0,0,0,0,0,0,0,0,0,0,0,6,3,3,0,0,0,0,0,0,0,0,0
153144,35000,350,0,-2,9,4,5,0,0,0,1,0,1,1,1,0,0,0,0,0,0,0,6,3,3,1,0,1,0,0,0,0,0,0
153162,35000,350,0,-2,3,2,1,0,0,0,1,0,1,0,0,0,0,0,0,0,0,0,2,2,0,0,0,0,0,0,0,0,0,0
153214,35000,350,0,-2,5,5,0,0,0,0,0,0,0,2,2,0,1,1,0,0,0,0,2,2,0,0,0,0,0,0,0,0,0,0
153269,35000,350,0,-2,16,8,8,0,0,0,0,0,0,2,1,1,3,0,3,0,0,0,7,6,1,1,1,0,1,0,1,2,0,2
153278,35000,350,0,-2,20,11,9,0,0,0,0,0,0,0,0,0,0,0,0,0,0,0,20,11,9,0,0,0,0,0,0,0,0,0
153296,35000,350,0,-2,3,2,1,0,0,0,1,1,0,0,0,0,0,0,0,0,0,0,2,1,1,0,0,0,0,0,0,0,0,0
153302,35000,350,0,-2,2,1,1,0,0,0,0,0,0,0,0,0,0,0,0,0,0,0,2,1,1,0,0,0,0,0,0,0,0,0
153311,35000,350,0,-2,2,1,1,0,0,0,0,0,0,0,0,0,0,0,0,0,0,0,2,1,1,0,0,0,0,0,0,0,0,0
153366,35000,350,0,-2,8,2,6,0,0,0,0,0,0,0,0,0,0,0,0,0,0,0,8,2,6,0,0,0,0,0,0,0,0,0
153384,35000,350,0,-2,16,9,7,0,0,0,0,0,0,1,1,0,0,0,0,0,0,0,15,8,7,0,0,0,0,0,0,0,0,0
153472,35000,350,0,-2,15,8,7,0,0,0,0,0,0,0,0,0,2,1,1,0,0,0,13,7,6,0,0,0,0,0,0,0,0,0
153524,35000,350,0,-2,4,3,1,0,0,0,0,0,0,1,0,1,0,0,0,0,0,0,3,3,0,0,0,0,0,0,0,0,0,0
153533,35000,350,0,-2,2,2,0,0,0,0,0,0,0,0,0,0,0,0,0,0,0,0,2,2,0,0,0,0,0,0,0,0,0,0
153603,35000,350,0,-2,60,29,31,1,1,0,1,1,0,1,0,1,3,2,1,0,0,0,52,25,27,0,0,0,0,0,0,2,0,2
153630,35000,350,0,-2,11,6,5,0,0,0,0,0,0,0,0,0,1,0,1,0,0,0,10,6,4,0,0,0,0,0,0,0,0,0
153658,35000,350,0,-2,129,56,73,1,0,1,4,3,1,19,9,10,13,4,9,0,0,0,80,34,46,0,0,0,8,4,4,4,2,2
153737,35000,350,0,-2,13,9,4,0,0,0,1,1,0,0,0,0,1,1,0,0,0,0,9,5,4,0,0,0,2,2,0,0,0,0
153825,35000,350,0,-2,3,1,2,0,0,0,0,0,0,0,0,0,0,0,0,0,0,0,3,1,2,0,0,0,0,0,0,0,0,0
153834,35000,350,0,-2,1,0,1,0,0,0,0,0,0,0,0,0,0,0,0,0,0,0,0,0,0,0,0,0,1,0,1,0,0,0
153861,35000,350,0,-2,12,5,7,1,1,0,1,0,1,0,0,0,0,0,0,0,0,0,9,3,6,1,1,0,0,0,0,0,0,0
153922,35000,350,0,-2,1,1,0,0,0,0,0,0,0,0,0,0,0,0,0,0,0,0,1,1,0,0,0,0,0,0,0,0,0,0
153977,35000,350,0,-2,1,1,0,0,0,0,0,0,0,0,0,0,0,0,0,0,0,0,1,1,0,0,0,0,0,0,0,0,0,0
154004,35000,350,0,-2,4,1,3,0,0,0,0,0,0,0,0,0,1,0,1,0,0,0,3,1,2,0,0,0,0,0,0,0,0,0
154013,35000,350,0,-2,5,2,3,0,0,0,0,0,0,2,0,2,0,0,0,0,0,0,3,2,1,0,0,0,0,0,0,0,0,0
154059,35000,350,0,-2,1,1,0,0,0,0,0,0,0,0,0,0,0,0,0,0,0,0,1,1,0,0,0,0,0,0,0,0,0,0
154095,35000,350,0,-2,6,2,4,0,0,0,0,0,0,0,0,0,0,0,0,0,0,0,6,2,4,0,0,0,0,0,0,0,0,0
154101,35000,350,0,-2,2,2,0,0,0,0,0,0,0,0,0,0,0,0,0,0,0,0,2,2,0,0,0,0,0,0,0,0,0,0
154110,35000,350,0,-2,2,1,1,0,0,0,0,0,0,0,0,0,0,0,0,0,0,0,1,1,0,0,0,0,1,0,1,0,0,0
154129,35000,350,0,-2,3,0,3,0,0,0,0,0,0,0,0,0,0,0,0,0,0,0,3,0,3,0,0,0,0,0,0,0,0,0
154235,35000,350,0,-2,4,2,2,0,0,0,0,0,0,1,0,1,0,0,0,0,0,0,3,2,1,0,0,0,0,0,0,0,0,0
154350,35000,350,0,-2,1,1,0,0,0,0,0,0,0,0,0,0,0,0,0,0,0,0,0,0,0,0,0,0,1,1,0,0,0,0
154378,35000,350,0,-2,3,3,0,0,0,0,0,0,0,0,0,0,0,0,0,0,0,0,3,3,0,0,0,0,0,0,0,0,0,0
154493,35000,350,0,-2,3,3,0,0,0,0,0,0,0,0,0,0,0,0,0,0,0,0,2,2,0,0,0,0,1,1,0,0,0,0
154518,35000,350,0,-2,5,0,5,0,0,0,0,0,0,0,0,0,0,0,0,0,0,0,5,0,5,0,0,0,0,0,0,0,0,0
154527,35000,350,0,-2,16,5,11,0,0,0,0,0,0,0,0,0,0,0,0,0,0,0,15,5,10,1,0,1,0,0,0,0,0,0
154536,35000,350,0,-2,1,1,0,0,0,0,0,0,0,0,0,0,0,0,0,0,0,0,1,1,0,0,0,0,0,0,0,0,0,0
154642,35000,350,0,-2,1,1,0,0,0,0,0,0,0,0,0,0,0,0,0,0,0,0,1,1,0,0,0,0,0,0,0,0,0,0
154688,35000,350,0,-2,7,7,0,0,0,0,0,0,0,0,0,0,0,0,0,0,0,0,7,7,0,0,0,0,0,0,0,0,0,0
154697,35000,350,0,-2,3,1,2,0,0,0,0,0,0,0,0,0,1,0,1,0,0,0,2,1,1,0,0,0,0,0,0,0,0,0
154712,35000,350,0,-2,2,1,1,0,0,0,0,0,0,0,0,0,0,0,0,0,0,0,2,1,1,0,0,0,0,0,0,0,0,0
154721,35000,350,0,-2,13,9,4,0,0,0,0,0,0,0,0,0,4,1,3,0,0,0,9,8,1,0,0,0,0,0,0,0,0,0
154800,35000,350,0,-2,7,3,4,0,0,0,0,0,0,1,1,0,0,0,0,0,0,0,5,2,3,1,0,1,0,0,0,0,0,0
154855,35000,350,0,-2,1,0,1,0,0,0,0,0,0,0,0,0,0,0,0,0,0,0,1,0,1,0,0,0,0,0,0,0,0,0
154907,35000,350,0,-2,1,1,0,0,0,0,0,0,0,0,0,0,0,0,0,0,0,0,1,1,0,0,0,0,0,0,0,0,0,0
154934,35000,350,0,-2,1,0,1,0,0,0,0,0,0,0,0,0,0,0,0,0,0,0,1,0,1,0,0,0,0,0,0,0,0,0
154952,35000,350,0,-2,4,4,0,0,0,0,0,0,0,0,0,0,1,1,0,0,0,0,3,3,0,0,0,0,0,0,0,0,0,0
154998,35000,350,0,-2,7,3,4,0,0,0,0,0,0,0,0,0,0,0,0,0,0,0,7,3,4,0,0,0,0,0,0,0,0,0
155025,35000,350,0,-2,4,2,2,0,0,0,0,0,0,0,0,0,1,0,1,0,0,0,1,1,0,1,1,0,1,0,1,0,0,0
155052,35000,350,0,-2,1,0,1,0,0,0,0,0,0,0,0,0,1,0,1,0,0,0,0,0,0,0,0,0,0,0,0,0,0,0
155061,35000,350,0,-2,5,3,2,0,0,0,0,0,0,0,0,0,0,0,0,0,0,0,5,3,2,0,0,0,0,0,0,0,0,0
155098,35000,350,0,-2,4,3,1,0,0,0,0,0,0,0,0,0,0,0,0,0,0,0,4,3,1,0,0,0,0,0,0,0,0,0
155104,35000,350,0,-2,2,1,1,0,0,0,0,0,0,0,0,0,2,1,1,0,0,0,0,0,0,0,0,0,0,0,0,0,0,0
155177,35000,350,0,-2,2,1,1,0,0,0,0,0,0,0,0,0,1,1,0,0,0,0,1,0,1,0,0,0,0,0,0,0,0,0
155186,35000,350,0,-2,4,1,3,0,0,0,0,0,0,0,0,0,0,0,0,0,0,0,4,1,3,0,0,0,0,0,0,0,0,0
155195,35000,350,0,-2,7,3,4,0,0,0,0,0,0,2,1,1,1,1,0,0,0,0,4,1,3,0,0,0,0,0,0,0,0,0
155210,35000,350,0,-2,2,2,0,0,0,0,0,0,0,1,1,0,0,0,0,0,0,0,1,1,0,0,0,0,0,0,0,0,0,0
155292,35000,350,0,-2,8,5,3,0,0,0,0,0,0,2,1,1,1,1,0,0,0,0,4,2,2,1,1,0,0,0,0,0,0,0
155317,35000,350,0,-2,69,52,17,3,2,1,2,2,0,8,6,2,9,7,2,2,1,1,42,32,10,3,2,1,0,0,0,0,0,0
155335,35000,350,0,-2,1,1,0,0,0,0,0,0,0,0,0,0,0,0,0,0,0,0,1,1,0,0,0,0,0,0,0,0,0,0
155399,35000,350,0,-2,64,23,41,0,0,0,2,0,2,8,4,4,5,3,2,0,0,0,48,16,32,1,0,1,0,0,0,0,0,0
155450,35000,350,0,-2,1,1,0,0,0,0,0,0,0,1,1,0,0,0,0,0,0,0,0,0,0,0,0,0,0,0,0,0,0,0
155511,35000,350,0,-2,2,0,2,0,0,0,0,0,0,0,0,0,0,0,0,0,0,0,2,0,2,0,0,0,0,0,0,0,0,0
155566,35000,350,0,-2,3,1,2,0,0,0,0,0,0,0,0,0,0,0,0,0,0,0,2,1,1,1,0,1,0,0,0,0,0,0
155593,35000,350,0,-2,2,1,1,0,0,0,0,0,0,0,0,0,0,0,0,0,0,0,2,1,1,0,0,0,0,0,0,0,0,0
155627,35000,350,0,-2,4,2,2,0,0,0,0,0,0,0,0,0,0,0,0,0,0,0,4,2,2,0,0,0,0,0,0,0,0,0
155681,35000,350,0,-2,5,3,2,0,0,0,0,0,0,0,0,0,0,0,0,0,0,0,5,3,2,0,0,0,0,0,0,0,0,0
155715,35000,350,0,-2,1,0,1,0,0,0,0,0,0,0,0,0,1,0,1,0,0,0,0,0,0,0,0,0,0,0,0,0,0,0
155812,35000,350,0,-2,5,4,1,0,0,0,0,0,0,1,1,0,0,0,0,0,0,0,4,3,1,0,0,0,0,0,0,0,0,0
155830,35000,350,0,-2,1,1,0,0,0,0,0,0,0,0,0,0,1,1,0,0,0,0,0,0,0,0,0,0,0,0,0,0,0,0
155858,35000,350,0,-2,3,2,1,0,0,0,0,0,0,0,0,0,1,0,1,0,0,0,1,1,0,0,0,0,1,1,0,0,0,0
155900,35000,350,0,-2,1,1,0,0,0,0,0,0,0,1,1,0,0,0,0,0,0,0,0,0,0,0,0,0,0,0,0,0,0,0
155937,35000,350,0,-2,3,1,2,0,0,0,0,0,0,0,0,0,2,0,2,0,0,0,1,1,0,0,0,0,0,0,0,0,0,0
155973,35000,350,0,-2,1,1,0,0,0,0,0,0,0,1,1,0,0,0,0,0,0,0,0,0,0,0,0,0,0,0,0,0,0,0
156082,35000,350,0,-2,7,5,2,1,1,0,0,0,0,0,0,0,0,0,0,0,0,0,4,4,0,0,0,0,2,0,2,0,0,0
156125,35000,350,0,-2,45,33,12,0,0,0,0,0,0,4,4,0,11,8,3,0,0,0,28,19,9,0,0,0,1,1,0,1,1,0
156213,35000,350,0,-2,6,2,4,0,0,0,0,0,0,0,0,0,0,0,0,0,0,0,6,2,4,0,0,0,0,0,0,0,0,0
156222,35000,350,0,-2,1,1,0,0,0,0,0,0,0,0,0,0,0,0,0,0,0,0,1,1,0,0,0,0,0,0,0,0,0,0
156286,35000,350,0,-2,8,4,4,0,0,0,0,0,0,1,0,1,0,0,0,0,0,0,7,4,3,0,0,0,0,0,0,0,0,0
156295,35000,350,0,-2,12,3,9,0,0,0,0,0,0,1,0,1,1,0,1,0,0,0,10,3,7,0,0,0,0,0,0,0,0,0
156338,35000,350,0,-2,3,2,1,0,0,0,0,0,0,0,0,0,0,0,0,0,0,0,2,1,1,1,1,0,0,0,0,0,0,0
156356,35000,350,0,-2,3,2,1,0,0,0,0,0,0,0,0,0,0,0,0,0,0,0,2,1,1,0,0,0,1,1,0,0,0,0
156365,35000,350,0,-2,3,2,1,0,0,0,0,0,0,1,0,1,0,0,0,0,0,0,2,2,0,0,0,0,0,0,0,0,0,0
156392,35000,350,0,-2,7,3,4,0,0,0,2,1,1,0,0,0,0,0,0,0,0,0,5,2,3,0,0,0,0,0,0,0,0,0
156408,35000,350,0,-2,11,4,7,0,0,0,0,0,0,2,1,1,0,0,0,0,0,0,8,3,5,1,0,1,0,0,0,0,0,0
156541,35000,350,0,-2,3,2,1,0,0,0,0,0,0,0,0,0,0,0,0,0,0,0,3,2,1,0,0,0,0,0,0,0,0,0
156620,35000,350,0,-2,26,26,0,0,0,0,0,0,0,0,0,0,0,0,0,0,0,0,26,26,0,0,0,0,0,0,0,0,0,0
156727,35000,350,0,-2,4,2,2,0,0,0,0,0,0,1,1,0,0,0,0,0,0,0,3,1,2,0,0,0,0,0,0,0,0,0
156745,35000,350,0,-2,4,4,0,0,0,0,0,0,0,1,1,0,0,0,0,0,0,0,2,2,0,0,0,0,1,1,0,0,0,0
156851,35000,350,0,-2,1,1,0,0,0,0,0,0,0,0,0,0,0,0,0,0,0,0,1,1,0,0,0,0,0,0,0,0,0,0
156860,35000,350,0,-2,3,2,1,0,0,0,0,0,0,0,0,0,2,2,0,0,0,0,1,0,1,0,0,0,0,0,0,0,0,0
156921,35000,350,0,-2,9,4,5,0,0,0,0,0,0,5,1,4,0,0,0,0,0,0,4,3,1,0,0,0,0,0,0,0,0,0
157058,35000,350,0,-2,3,2,1,0,0,0,0,0,0,1,1,0,0,0,0,0,0,0,2,1,1,0,0,0,0,0,0,0,0,0
157076,35000,350,0,-2,6,2,4,0,0,0,0,0,0,1,0,1,0,0,0,0,0,0,5,2,3,0,0,0,0,0,0,0,0,0
157085,35000,350,0,-2,94,53,41,0,0,0,0,0,0,15,10,5,6,3,3,0,0,0,73,40,33,0,0,0,0,0,0,0,0,0
157100,35000,350,0,-2,1,1,0,0,0,0,0,0,0,0,0,0,0,0,0,0,0,0,1,1,0,0,0,0,0,0,0,0,0,0
157216,35000,350,0,-2,12,5,7,0,0,0,0,0,0,0,0,0,0,0,0,0,0,0,12,5,7,0,0,0,0,0,0,0,0,0
157289,35000,350,0,-2,67,18,49,0,0,0,2,1,1,21,10,11,5,0,5,0,0,0,36,7,29,2,0,2,1,0,1,0,0,0
157304,35000,350,0,-2,1,0,1,0,0,0,0,0,0,1,0,1,0,0,0,0,0,0,0,0,0,0,0,0,0,0,0,0,0,0
157331,35000,350,0,-2,2,1,1,0,0,0,0,0,0,0,0,0,0,0,0,0,0,0,2,1,1,0,0,0,0,0,0,0,0,0
157386,35000,350,0,-2,8,4,4,0,0,0,0,0,0,0,0,0,0,0,0,0,0,0,8,4,4,0,0,0,0,0,0,0,0,0
157401,35000,350,0,-2,2,2,0,0,0,0,0,0,0,0,0,0,0,0,0,0,0,0,2,2,0,0,0,0,0,0,0,0,0,0
157438,35000,350,0,-2,1,1,0,0,0,0,0,0,0,0,0,0,0,0,0,0,0,0,1,1,0,0,0,0,0,0,0,0,0,0
157447,35000,350,0,-2,19,11,8,0,0,0,0,0,0,2,1,1,0,0,0,0,0,0,15,10,5,2,0,2,0,0,0,0,0,0
157535,35000,350,0,-2,2,1,1,0,0,0,0,0,0,0,0,0,0,0,0,0,0,0,2,1,1,0,0,0,0,0,0,0,0,0
157553,35000,350,0,-2,3,3,0,0,0,0,0,0,0,0,0,0,0,0,0,0,0,0,3,3,0,0,0,0,0,0,0,0,0,0
157739,35000,350,0,-2,1,1,0,0,0,0,0,0,0,0,0,0,0,0,0,0,0,0,1,1,0,0,0,0,0,0,0,0,0,0
157748,35000,350,0,-2,4,4,0,0,0,0,0,0,0,0,0,0,0,0,0,0,0,0,2,2,0,0,0,0,2,2,0,0,0,0
157757,35000,350,0,-2,2,0,2,0,0,0,0,0,0,2,0,2,0,0,0,0,0,0,0,0,0,0,0,0,0,0,0,0,0,0
157809,35000,350,0,-2,3,3,0,0,0,0,0,0,0,0,0,0,0,0,0,0,0,0,3,3,0,0,0,0,0,0,0,0,0,0
157818,35000,350,0,-2,8,6,2,0,0,0,0,0,0,2,1,1,0,0,0,0,0,0,6,5,1,0,0,0,0,0,0,0,0,0
157951,35000,350,0,-2,18,11,7,0,0,0,0,0,0,1,1,0,0,0,0,0,0,0,16,9,7,1,1,0,0,0,0,0,0,0
158477,35000,350,0,-2,1,1,0,0,0,0,0,0,0,0,0,0,0,0,0,0,0,0,1,1,0,0,0,0,0,0,0,0,0,0
158662,35000,350,0,-2,6,3,3,0,0,0,0,0,0,5,2,3,0,0,0,0,0,0,1,1,0,0,0,0,0,0,0,0,0,0
158802,35000,350,0,-2,6,5,1,0,0,0,0,0,0,4,4,0,0,0,0,0,0,0,1,0,1,0,0,0,1,1,0,0,0,0
159009,35000,350,0,-2,12,5,7,0,0,0,0,0,0,10,4,6,0,0,0,0,0,0,1,1,0,0,0,0,0,0,0,1,0,1
159373,35000,350,0,-2,27,5,22,0,0,0,0,0,0,17,3,14,0,0,0,0,0,0,8,2,6,0,0,0,1,0,1,1,0,1
159382,35000,350,0,-2,6,5,1,0,0,0,0,0,0,2,1,1,0,0,0,0,0,0,4,4,0,0,0,0,0,0,0,0,0,0
159391,35000,350,0,-2,171,65,106,0,0,0,6,2,4,115,42,73,3,2,1,0,0,0,40,15,25,0,0,0,1,0,1,6,4,2
159407,35000,350,0,-2,2,0,2,0,0,0,0,0,0,0,0,0,0,0,0,0,0,0,2,0,2,0,0,0,0,0,0,0,0,0
159416,35000,350,0,-2,7,2,5,0,0,0,0,0,0,5,0,5,0,0,0,0,0,0,0,0,0,0,0,0,2,2,0,0,0,0
159568,35000,350,0,-2,7,5,2,0,0,0,0,0,0,3,2,1,0,0,0,0,0,0,4,3,1,0,0,0,0,0,0,0,0,0
159647,35000,350,0,-2,18,10,8,0,0,0,0,0,0,16,9,7,0,0,0,0,0,0,2,1,1,0,0,0,0,0,0,0,0,0
159656,35000,350,0,-2,13,9,4,0,0,0,0,0,0,10,6,4,1,1,0,0,0,0,2,2,0,0,0,0,0,0,0,0,0,0
159717,35000,350,0,-2,5,4,1,0,0,0,0,0,0,0,0,0,1,1,0,0,0,0,3,2,1,0,0,0,1,1,0,0,0,0
159939,35000,350,0,-2,1,1,0,0,0,0,0,0,0,0,0,0,0,0,0,0,0,0,1,1,0,0,0,0,0,0,0,0,0,0
159948,35000,350,0,-2,3,2,1,0,0,0,0,0,0,0,0,0,0,0,0,0,0,0,3,2,1,0,0,0,0,0,0,0,0,0
159966,35000,350,0,-2,20,15,5,0,0,0,0,0,0,5,3,2,0,0,0,0,0,0,13,11,2,0,0,0,2,1,1,0,0,0
159993,35000,350,0,-2,2,1,1,0,0,0,0,0,0,1,0,1,0,0,0,0,0,0,1,1,0,0,0,0,0,0,0,0,0,0
160038,35000,350,0,-2,6,5,1,0,0,0,0,0,0,1,1,0,0,0,0,0,0,0,1,1,0,0,0,0,4,3,1,0,0,0
160065,35000,350,0,-2,1,1,0,0,0,0,0,0,0,1,1,0,0,0,0,0,0,0,0,0,0,0,0,0,0,0,0,0,0,0
160612,35000,350,0,-2,5,4,1,0,0,0,0,0,0,0,0,0,0,0,0,0,0,0,5,4,1,0,0,0,0,0,0,0,0,0
160621,35000,350,0,-2,15,6,9,0,0,0,0,0,0,15,6,9,0,0,0,0,0,0,0,0,0,0,0,0,0,0,0,0,0,0
160630,35000,350,0,-2,8,6,2,0,0,0,0,0,0,8,6,2,0,0,0,0,0,0,0,0,0,0,0,0,0,0,0,0,0,0
160649,35000,350,0,-2,1,1,0,0,0,0,0,0,0,1,1,0,0,0,0,0,0,0,0,0,0,0,0,0,0,0,0,0,0,0
160658,35000,350,0,-2,10,1,9,1,0,1,0,0,0,5,1,4,1,0,1,0,0,0,3,0,3,0,0,0,0,0,0,0,0,0
160755,35000,350,0,-2,64,28,36,0,0,0,2,1,1,28,12,16,7,5,2,0,0,0,26,10,16,0,0,0,0,0,0,1,0,1
160904,35000,350,0,-2,14,7,7,0,0,0,0,0,0,14,7,7,0,0,0,0,0,0,0,0,0,0,0,0,0,0,0,0,0,0
160959,35000,350,0,-2,2,1,1,0,0,0,0,0,0,0,0,0,0,0,0,0,0,0,2,1,1,0,0,0,0,0,0,0,0,0
160977,35000,350,0,-2,15,7,8,0,0,0,0,0,0,2,1,1,0,0,0,0,0,0,13,6,7,0,0,0,0,0,0,0,0,0
161004,35000,350,0,-2,42,15,27,0,0,0,0,0,0,2,0,2,0,0,0,0,0,0,27,11,16,0,0,0,11,4,7,2,0,2
161077,35000,350,0,-2,1,0,1,0,0,0,0,0,0,0,0,0,0,0,0,0,0,0,1,0,1,0,0,0,0,0,0,0,0,0
161086,35000,350,0,-2,13,8,5,0,0,0,0,0,0,0,0,0,1,1,0,0,0,0,12,7,5,0,0,0,0,0,0,0,0,0
161217,35000,350,0,-2,3,2,1,0,0,0,0,0,0,0,0,0,0,0,0,0,0,0,2,2,0,0,0,0,1,0,1,0,0,0
161226,35000,350,0,-2,4,2,2,0,0,0,0,0,0,0,0,0,0,0,0,0,0,0,4,2,2,0,0,0,0,0,0,0,0,0
161235,35000,350,0,-2,2,0,2,0,0,0,0,0,0,1,0,1,0,0,0,0,0,0,0,0,0,0,0,0,0,0,0,1,0,1
161253,35000,350,0,-2,48,39,9,2,2,0,2,2,0,2,2,0,1,0,1,0,0,0,29,22,7,3,2,1,9,9,0,0,0,0
161299,35000,350,0,-2,2,2,0,0,0,0,0,0,0,0,0,0,0,0,0,0,0,0,2,2,0,0,0,0,0,0,0,0,0,0
161341,35000,350,0,-2,2,1,1,0,0,0,0,0,0,0,0,0,0,0,0,0,0,0,2,1,1,0,0,0,0,0,0,0,0,0
161457,35000,350,0,-2,16,7,9,0,0,0,2,0,2,2,2,0,1,1,0,0,0,0,8,2,6,0,0,0,3,2,1,0,0,0
161509,35000,350,0,-2,4,2,2,0,0,0,1,1,0,0,0,0,0,0,0,0,0,0,3,1,2,0,0,0,0,0,0,0,0,0
161518,35000,350,0,-2,8,5,3,0,0,0,0,0,0,0,0,0,0,0,0,0,0,0,8,5,3,0,0,0,0,0,0,0,0,0
161545,35000,350,0,-2,5,5,0,0,0,0,0,0,0,1,1,0,0,0,0,0,0,0,4,4,0,0,0,0,0,0,0,0,0,0
161554,35000,350,0,-2,14,11,3,0,0,0,0,0,0,0,0,0,0,0,0,0,0,0,14,11,3,0,0,0,0,0,0,0,0,0
161563,35000,350,0,-2,3,3,0,0,0,0,0,0,0,0,0,0,0,0,0,0,0,0,3,3,0,0,0,0,0,0,0,0,0,0
161572,35000,350,0,-2,2,2,0,0,0,0,0,0,0,0,0,0,0,0,0,0,0,0,2,2,0,0,0,0,0,0,0,0,0,0
161581,35000,350,0,-2,1,1,0,0,0,0,0,0,0,0,0,0,0,0,0,0,0,0,1,1,0,0,0,0,0,0,0,0,0,0
161688,35000,350,0,-2,1,1,0,0,0,0,0,0,0,0,0,0,0,0,0,0,0,0,0,0,0,0,0,0,1,1,0,0,0,0
161767,35000,350,0,-2,11,6,5,0,0,0,0,0,0,4,2,2,1,0,1,1,0,1,4,4,0,0,0,0,0,0,0,1,0,1
161864,35000,350,0,-2,5,1,4,0,0,0,0,0,0,5,1,4,0,0,0,0,0,0,0,0,0,0,0,0,0,0,0,0,0,0
161873,35000,350,0,-2,3,2,1,0,0,0,0,0,0,3,2,1,0,0,0,0,0,0,0,0,0,0,0,0,0,0,0,0,0,0
162007,35000,350,0,-2,4,3,1,1,1,0,0,0,0,3,2,1,0,0,0,0,0,0,0,0,0,0,0,0,0,0,0,0,0,0
162061,35000,350,0,-2,1,1,0,0,0,0,0,0,0,1,1,0,0,0,0,0,0,0,0,0,0,0,0,0,0,0,0,0,0,0
162104,35000,350,0,-2,5,3,2,0,0,0,0,0,0,0,0,0,0,0,0,0,0,0,5,3,2,0,0,0,0,0,0,0,0,0
162168,35000,350,0,-2,2,1,1,0,0,0,0,0,0,0,0,0,0,0,0,0,0,0,2,1,1,0,0,0,0,0,0,0,0,0
162557,35000,350,0,-2,1,1,0,0,0,0,0,0,0,0,0,0,0,0,0,1,1,0,0,0,0,0,0,0,0,0,0,0,0,0
162584,35000,350,0,-2,4,2,2,0,0,0,0,0,0,0,0,0,0,0,0,0,0,0,4,2,2,0,0,0,0,0,0,0,0,0
162609,35000,350,0,-2,2,1,1,0,0,0,0,0,0,0,0,0,0,0,0,0,0,0,1,0,1,0,0,0,1,1,0,0,0,0
162654,35000,350,0,-2,4,1,3,0,0,0,1,0,1,2,1,1,1,0,1,0,0,0,0,0,0,0,0,0,0,0,0,0,0,0
162690,35000,350,0,-2,7,4,3,0,0,0,0,0,0,1,1,0,0,0,0,0,0,0,6,3,3,0,0,0,0,0,0,0,0,0
162706,35000,350,0,-2,3,1,2,0,0,0,0,0,0,0,0,0,0,0,0,0,0,0,3,1,2,0,0,0,0,0,0,0,0,0
162928,35000,350,0,-2,23,9,14,0,0,0,1,0,1,15,6,9,1,0,1,0,0,0,2,0,2,3,3,0,1,0,1,0,0,0
163046,35000,350,0,-2,11,9,2,0,0,0,0,0,0,8,7,1,0,0,0,0,0,0,1,1,0,1,1,0,1,0,1,0,0,0
163259,35000,350,0,-2,64,26,38,0,0,0,0,0,0,57,22,35,0,0,0,1,1,0,5,3,2,1,0,1,0,0,0,0,0,0
163268,35000,350,0,-2,3,2,1,0,0,0,0,0,0,2,1,1,0,0,0,0,0,0,1,1,0,0,0,0,0,0,0,0,0,0
163286,35000,350,0,-2,28,13,15,0,0,0,0,0,0,15,8,7,11,4,7,0,0,0,0,0,0,0,0,0,2,1,1,0,0,0
163295,35000,350,0,-2,7,5,2,0,0,0,0,0,0,7,5,2,0,0,0,0,0,0,0,0,0,0,0,0,0,0,0,0,0,0
163426,35000,350,0,-2,8,4,4,0,0,0,1,1,0,3,2,1,1,0,1,0,0,0,0,0,0,0,0,0,0,0,0,3,1,2
163453,35000,350,0,-2,11,8,3,0,0,0,0,0,0,10,7,3,0,0,0,0,0,0,0,0,0,0,0,0,0,0,0,1,1,0
163462,35000,350,0,-2,14,10,4,0,0,0,0,0,0,1,1,0,0,0,0,0,0,0,13,9,4,0,0,0,0,0,0,0,0,0
163532,35000,350,0,-2,8,6,2,0,0,0,0,0,0,0,0,0,7,5,2,0,0,0,1,1,0,0,0,0,0,0,0,0,0,0
163578,35000,350,0,-2,6,3,3,0,0,0,0,0,0,3,1,2,0,0,0,0,0,0,3,2,1,0,0,0,0,0,0,0,0,0
163851,35000,350,0,-2,5,2,3,0,0,0,0,0,0,2,0,2,0,0,0,0,0,0,3,2,1,0,0,0,0,0,0,0,0,0
163912,35000,350,0,-2,6,4,2,0,0,0,0,0,0,1,1,0,1,1,0,0,0,0,4,2,2,0,0,0,0,0,0,0,0,0
163976,35000,350,0,-2,6,5,1,0,0,0,2,1,1,0,0,0,0,0,0,0,0,0,4,4,0,0,0,0,0,0,0,0,0,0
164076,35000,350,0,-2,3,3,0,0,0,0,0,0,0,0,0,0,0,0,0,0,0,0,3,3,0,0,0,0,0,0,0,0,0,0
164155,35000,350,0,-2,4,2,2,0,0,0,0,0,0,2,1,1,2,1,1,0,0,0,0,0,0,0,0,0,0,0,0,0,0,0
164173,35000,350,0,-2,4,2,2,0,0,0,0,0,0,0,0,0,0,0,0,0,0,0,4,2,2,0,0,0,0,0,0,0,0,0
164216,35000,350,0,-2,18,8,10,0,0,0,0,0,0,3,1,2,0,0,0,0,0,0,15,7,8,0,0,0,0,0,0,0,0,0
164270,35000,350,0,-2,4,3,1,0,0,0,0,0,0,1,1,0,0,0,0,0,0,0,3,2,1,0,0,0,0,0,0,0,0,0
164465,35000,350,0,-2,34,19,15,0,0,0,2,0,2,2,2,0,7,3,4,0,0,0,21,12,9,0,0,0,1,1,0,1,1,0
164492,35000,350,0,-2,1,0,1,0,0,0,0,0,0,0,0,0,0,0,0,0,0,0,1,0,1,0,0,0,0,0,0,0,0,0
164562,35000,350,0,-2,7,4,3,0,0,0,0,0,0,0,0,0,2,1,1,0,0,0,5,3,2,0,0,0,0,0,0,0,0,0
164580,35000,350,0,-2,5,3,2,0,0,0,0,0,0,0,0,0,2,1,1,0,0,0,3,2,1,0,0,0,0,0,0,0,0,0
164632,35000,350,0,-2,2,1,1,0,0,0,0,0,0,1,1,0,1,0,1,0,0,0,0,0,0,0,0,0,0,0,0,0,0,0
164739,35000,350,0,-2,15,10,5,0,0,0,0,0,0,5,4,1,2,1,1,0,0,0,8,5,3,0,0,0,0,0,0,0,0,0
164748,35000,350,0,-2,6,5,1,0,0,0,2,2,0,1,1,0,1,1,0,0,0,0,2,1,1,0,0,0,0,0,0,0,0,0
164924,35000,350,0,-2,64,44,20,1,1,0,4,3,1,16,13,3,14,8,6,0,0,0,24,15,9,0,0,0,5,4,1,0,0,0
164988,35000,350,0,-2,79,34,45,0,0,0,1,1,0,10,5,5,18,8,10,0,0,0,31,13,18,2,0,2,17,7,10,0,0,0
165015,35000,350,0,-2,13,9,4,0,0,0,0,0,0,0,0,0,8,4,4,0,0,0,4,4,0,0,0,0,1,1,0,0,0,0
165024,35000,350,0,-2,2,1,1,0,0,0,0,0,0,1,0,1,0,0,0,0,0,0,1,1,0,0,0,0,0,0,0,0,0,0
165033,35000,350,0,-2,1,0,1,0,0,0,0,0,0,0,0,0,0,0,0,0,0,0,1,0,1,0,0,0,0,0,0,0,0,0
165194,35000,350,0,-2,1,1,0,0,0,0,0,0,0,0,0,0,0,0,0,0,0,0,0,0,0,0,0,0,1,1,0,0,0,0
165334,35000,350,0,-2,15,10,5,0,0,0,0,0,0,1,1,0,3,2,1,0,0,0,9,6,3,2,1,1,0,0,0,0,0,0
165529,35000,350,0,-2,8,6,2,0,0,0,0,0,0,0,0,0,0,0,0,0,0,0,8,6,2,0,0,0,0,0,0,0,0,0
165574,35000,350,0,-2,2,2,0,0,0,0,0,0,0,1,1,0,0,0,0,0,0,0,1,1,0,0,0,0,0,0,0,0,0,0
165662,35000,350,0,-2,6,5,1,0,0,0,0,0,0,0,0,0,1,1,0,0,0,0,4,3,1,1,1,0,0,0,0,0,0,0
165671,35000,350,0,-2,2,2,0,0,0,0,0,0,0,0,0,0,0,0,0,0,0,0,2,2,0,0,0,0,0,0,0,0,0,0
165699,35000,350,0,-2,3,2,1,0,0,0,0,0,0,0,0,0,2,2,0,0,0,0,0,0,0,1,0,1,0,0,0,0,0,0
165820,35000,350,0,-2,3,0,3,0,0,0,0,0,0,0,0,0,2,0,2,0,0,0,1,0,1,0,0,0,0,0,0,0,0,0
165866,35000,350,0,-2,3,3,0,0,0,0,0,0,0,0,0,0,1,1,0,0,0,0,2,2,0,0,0,0,0,0,0,0,0,0
165936,35000,350,0,-2,9,4,5,0,0,0,0,0,0,0,0,0,0,0,0,0,0,0,6,2,4,0,0,0,3,2,1,0,0,0
165945,35000,350,0,-2,1,1,0,0,0,0,0,0,0,1,1,0,0,0,0,0,0,0,0,0,0,0,0,0,0,0,0,0,0,0
166018,35000,350,0,-2,14,9,5,0,0,0,0,0,0,0,0,0,3,3,0,0,0,0,9,4,5,1,1,0,1,1,0,0,0,0
166027,35000,350,0,-2,74,48,26,0,0,0,5,4,1,18,16,2,13,4,9,0,0,0,31,19,12,1,0,1,0,0,0,6,5,1
166124,35000,350,0,-2,24,18,6,0,0,0,1,0,1,3,3,0,1,0,1,0,0,0,16,12,4,0,0,0,3,3,0,0,0,0
166391,35000,350,0,-2,3,1,2,0,0,0,0,0,0,0,0,0,1,0,1,0,0,0,0,0,0,0,0,0,2,1,1,0,0,0
166452,35000,350,0,-2,2,1,1,0,0,0,0,0,0,1,0,1,1,1,0,0,0,0,0,0,0,0,0,0,0,0,0,0,0,0
166513,35000,350,0,-2,9,8,1,0,0,0,0,0,0,0,0,0,2,2,0,0,0,0,6,6,0,0,0,0,1,0,1,0,0,0
166629,35000,350,0,-2,51,31,20,0,0,0,15,10,5,2,2,0,6,3,3,0,0,0,24,13,11,1,1,0,1,1,0,2,1,1
166638,35000,350,0,-2,5,4,1,0,0,0,0,0,0,0,0,0,0,0,0,0,0,0,5,4,1,0,0,0,0,0,0,0,0,0
166647,35000,350,0,-2,1,1,0,0,0,0,0,0,0,0,0,0,0,0,0,0,0,0,1,1,0,0,0,0,0,0,0,0,0,0
166656,35000,350,0,-2,1,1,0,0,0,0,0,0,0,0,0,0,0,0,0,0,0,0,0,0,0,0,0,0,1,1,0,0,0,0
166674,35000,350,0,-2,5,3,2,0,0,0,0,0,0,2,2,0,1,0,1,0,0,0,2,1,1,0,0,0,0,0,0,0,0,0
166683,35000,350,0,-2,47,33,14,0,0,0,0,0,0,4,3,1,11,7,4,0,0,0,18,14,4,0,0,0,11,8,3,3,1,2
166708,35000,350,0,-2,14,11,3,0,0,0,0,0,0,0,0,0,3,2,1,0,0,0,11,9,2,0,0,0,0,0,0,0,0,0
166823,35000,350,0,-2,2,0,2,0,0,0,0,0,0,0,0,0,0,0,0,0,0,0,2,0,2,0,0,0,0,0,0,0,0,0
166850,35000,350,0,-2,1,1,0,0,0,0,0,0,0,0,0,0,0,0,0,0,0,0,1,1,0,0,0,0,0,0,0,0,0,0
166939,35000,350,0,-2,18,13,5,0,0,0,0,0,0,0,0,0,2,2,0,0,0,0,10,6,4,0,0,0,6,5,1,0,0,0
167057,35000,350,0,-2,2,1,1,0,0,0,0,0,0,1,1,0,1,0,1,0,0,0,0,0,0,0,0,0,0,0,0,0,0,0
167093,35000,350,0,-2,3,1,2,0,0,0,0,0,0,1,1,0,0,0,0,0,0,0,1,0,1,0,0,0,1,0,1,0,0,0
167288,35000,350,0,-2,1,1,0,0,0,0,0,0,0,0,0,0,0,0,0,0,0,0,1,1,0,0,0,0,0,0,0,0,0,0
167312,35000,350,0,-2,5,4,1,0,0,0,1,1,0,0,0,0,3,3,0,0,0,0,0,0,0,0,0,0,1,0,1,0,0,0
167358,35000,350,0,-2,16,13,3,0,0,0,1,1,0,2,2,0,3,3,0,0,0,0,10,7,3,0,0,0,0,0,0,0,0,0
167376,35000,350,0,-2,2,2,0,0,0,0,0,0,0,1,1,0,0,0,0,0,0,0,1,1,0,0,0,0,0,0,0,0,0,0
167394,35000,350,0,-2,1,0,1,0,0,0,0,0,0,0,0,0,0,0,0,0,0,0,1,0,1,0,0,0,0,0,0,0,0,0
167534,35000,350,0,-2,2,2,0,0,0,0,0,0,0,0,0,0,0,0,0,0,0,0,2,2,0,0,0,0,0,0,0,0,0,0
167598,35000,350,0,-2,9,4,5,0,0,0,0,0,0,1,0,1,4,2,2,0,0,0,4,2,2,0,0,0,0,0,0,0,0,0
167729,35000,350,0,-2,3,0,3,0,0,0,0,0,0,0,0,0,3,0,3,0,0,0,0,0,0,0,0,0,0,0,0,0,0,0
167783,35000,350,0,-2,14,9,5,0,0,0,1,0,1,5,3,2,2,1,1,0,0,0,4,4,0,0,0,0,2,1,1,0,0,0
167792,35000,350,0,-2,10,6,4,0,0,0,1,1,0,0,0,0,0,0,0,0,0,0,9,5,4,0,0,0,0,0,0,0,0,0
167835,35000,350,0,-2,28,20,8,0,0,0,0,0,0,0,0,0,7,5,2,0,0,0,20,14,6,0,0,0,0,0,0,1,1,0
167899,35000,350,0,-2,22,17,5,0,0,0,0,0,0,5,3,2,2,1,1,0,0,0,14,13,1,0,0,0,1,0,1,0,0,0
167905,35000,350,0,-2,6,5,1,0,0,0,0,0,0,1,0,1,1,1,0,0,0,0,3,3,0,0,0,0,1,1,0,0,0,0
167996,35000,350,0,-2,1,1,0,0,0,0,0,0,0,0,0,0,0,0,0,0,0,0,0,0,0,0,0,0,1,1,0,0,0,0
168005,35000,350,0,-2,6,4,2,1,0,1,1,1,0,1,1,0,2,1,1,0,0,0,1,1,0,0,0,0,0,0,0,0,0,0
168148,35000,350,0,-2,83,28,55,1,0,1,5,3,2,13,6,7,11,6,5,0,0,0,45,11,34,0,0,0,8,2,6,0,0,0
168218,35000,350,0,-2,3,0,3,0,0,0,0,0,0,1,0,1,0,0,0,0,0,0,1,0,1,1,0,1,0,0,0,0,0,0
168227,35000,350,0,-2,7,5,2,0,0,0,0,0,0,0,0,0,1,1,0,0,0,0,4,2,2,0,0,0,2,2,0,0,0,0
168254,35000,350,0,-2,10,6,4,0,0,0,0,0,0,2,1,1,2,0,2,0,0,0,4,3,1,1,1,0,1,1,0,0,0,0
168263,35000,350,0,-2,9,4,5,0,0,0,0,0,0,1,1,0,0,0,0,0,0,0,8,3,5,0,0,0,0,0,0,0,0,0
168281,35000,350,0,-2,5,3,2,0,0,0,0,0,0,2,1,1,0,0,0,0,0,0,3,2,1,0,0,0,0,0,0,0,0,0
168342,35000,350,0,-2,13,9,4,0,0,0,0,0,0,0,0,0,1,0,1,0,0,0,11,9,2,1,0,1,0,0,0,0,0,0
168421,35000,350,0,-2,2,2,0,0,0,0,0,0,0,0,0,0,0,0,0,0,0,0,1,1,0,0,0,0,1,1,0,0,0,0
168430,35000,350,0,-2,9,6,3,0,0,0,0,0,0,0,0,0,2,2,0,0,0,0,7,4,3,0,0,0,0,0,0,0,0,0
168528,35000,350,0,-2,7,4,3,0,0,0,0,0,0,0,0,0,0,0,0,0,0,0,7,4,3,0,0,0,0,0,0,0,0,0
168546,35000,350,0,-2,6,4,2,0,0,0,0,0,0,0,0,0,0,0,0,0,0,0,6,4,2,0,0,0,0,0,0,0,0,0
168591,35000,350,0,-2,1,1,0,0,0,0,0,0,0,0,0,0,0,0,0,0,0,0,1,1,0,0,0,0,0,0,0,0,0,0
168740,35000,350,0,-2,12,7,5,0,0,0,0,0,0,4,3,1,2,1,1,1,0,1,3,2,1,1,1,0,1,0,1,0,0,0
168786,35000,350,0,-2,5,4,1,0,0,0,0,0,0,0,0,0,0,0,0,0,0,0,0,0,0,0,0,0,5,4,1,0,0,0
168847,35000,350,0,-2,3,2,1,0,0,0,0,0,0,0,0,0,0,0,0,0,0,0,3,2,1,0,0,0,0,0,0,0,0,0
168883,35000,350,0,-2,1,1,0,0,0,0,0,0,0,0,0,0,0,0,0,0,0,0,1,1,0,0,0,0,0,0,0,0,0,0
169080,35000,350,0,-2,1,1,0,0,0,0,0,0,0,0,0,0,0,0,0,0,0,0,1,1,0,0,0,0,0,0,0,0,0,0
169327,35000,350,0,-2,3,3,0,0,0,0,0,0,0,0,0,0,0,0,0,0,0,0,3,3,0,0,0,0,0,0,0,0,0,0
169363,35000,350,0,-2,5,4,1,0,0,0,0,0,0,1,1,0,0,0,0,0,0,0,4,3,1,0,0,0,0,0,0,0,0,0
169442,35000,350,0,-2,3,2,1,0,0,0,0,0,0,2,2,0,0,0,0,0,0,0,1,0,1,0,0,0,0,0,0,0,0,0
169479,35000,350,0,-2,8,5,3,0,0,0,0,0,0,2,1,1,0,0,0,0,0,0,6,4,2,0,0,0,0,0,0,0,0,0
169521,35000,350,0,-2,1,1,0,0,0,0,0,0,0,0,0,0,0,0,0,0,0,0,1,1,0,0,0,0,0,0,0,0,0,0
169716,35000,350,0,-2,2,1,1,0,0,0,0,0,0,2,1,1,0,0,0,0,0,0,0,0,0,0,0,0,0,0,0,0,0,0
169798,35000,350,0,-2,8,6,2,0,0,0,1,1,0,2,2,0,0,0,0,0,0,0,3,2,1,0,0,0,2,1,1,0,0,0
169910,35000,350,0,-2,17,8,9,1,0,1,0,0,0,1,0,1,1,1,0,1,0,1,13,7,6,0,0,0,0,0,0,0,0,0
169974,35000,350,0,-2,1,0,1,0,0,0,0,0,0,0,0,0,0,0,0,0,0,0,1,0,1,0,0,0,0,0,0,0,0,0
169983,35000,350,0,-2,3,1,2,0,0,0,0,0,0,1,0,1,0,0,0,0,0,0,2,1,1,0,0,0,0,0,0,0,0,0
170037,35000,350,0,-2,2,0,2,0,0,0,0,0,0,0,0,0,0,0,0,0,0,0,1,0,1,0,0,0,0,0,0,1,0,1
170055,35000,350,0,-2,3,2,1,0,0,0,0,0,0,3,2,1,0,0,0,0,0,0,0,0,0,0,0,0,0,0,0,0,0,0
170082,35000,350,0,-2,6,5,1,0,0,0,1,1,0,0,0,0,0,0,0,0,0,0,5,4,1,0,0,0,0,0,0,0,0,0
170240,35000,350,0,-2,15,11,4,0,0,0,0,0,0,8,5,3,0,0,0,0,0,0,7,6,1,0,0,0,0,0,0,0,0,0
170286,35000,350,0,-2,15,6,9,0,0,0,0,0,0,0,0,0,0,0,0,0,0,0,0,0,0,0,0,0,15,6,9,0,0,0
170301,35000,350,0,-2,6,2,4,0,0,0,0,0,0,1,0,1,2,1,1,0,0,0,3,1,2,0,0,0,0,0,0,0,0,0
170444,35000,350,0,-2,8,2,6,1,1,0,0,0,0,0,0,0,0,0,0,0,0,0,6,1,5,0,0,0,1,0,1,0,0,0
170532,35000,350,0,-2,3,1,2,0,0,0,0,0,0,1,0,1,0,0,0,0,0,0,2,1,1,0,0,0,0,0,0,0,0,0
170541,35000,350,0,-2,11,11,0,0,0,0,0,0,0,2,2,0,0,0,0,0,0,0,9,9,0,0,0,0,0,0,0,0,0,0
170620,35000,350,0,-2,1,1,0,0,0,0,0,0,0,0,0,0,0,0,0,0,0,0,1,1,0,0,0,0,0,0,0,0,0,0
170639,35000,350,0,-2,15,9,6,2,1,1,1,1,0,0,0,0,0,0,0,0,0,0,11,6,5,0,0,0,1,1,0,0,0,0
170657,35000,350,0,-2,1,1,0,0,0,0,0,0,0,0,0,0,1,1,0,0,0,0,0,0,0,0,0,0,0,0,0,0,0,0
170790,35000,350,0,-2,3,2,1,0,0,0,0,0,0,1,0,1,0,0,0,0,0,0,2,2,0,0,0,0,0,0,0,0,0,0
170967,35000,350,0,-2,1,0,1,0,0,0,0,0,0,1,0,1,0,0,0,0,0,0,0,0,0,0,0,0,0,0,0,0,0,0
170976,35000,350,0,-2,138,78,60,0,0,0,13,8,5,40,22,18,4,2,2,0,0,0,76,43,33,4,2,2,0,0,0,1,1,0
171100,35000,350,0,-2,42,17,25,0,0,0,1,0,1,5,3,2,8,3,5,0,0,0,28,11,17,0,0,0,0,0,0,0,0,0
171128,35000,350,0,-2,16,11,5,0,0,0,0,0,0,0,0,0,0,0,0,0,0,0,15,10,5,0,0,0,1,1,0,0,0,0
171137,35000,350,0,-2,2,1,1,0,0,0,0,0,0,1,0,1,0,0,0,0,0,0,1,1,0,0,0,0,0,0,0,0,0,0
171146,35000,350,0,-2,6,4,2,0,0,0,0,0,0,1,0,1,1,1,0,0,0,0,4,3,1,0,0,0,0,0,0,0,0,0
171155,35000,350,0,-2,2,2,0,0,0,0,0,0,0,0,0,0,0,0,0,0,0,0,2,2,0,0,0,0,0,0,0,0,0,0
171225,35000,350,0,-2,3,2,1,0,0,0,0,0,0,0,0,0,0,0,0,0,0,0,3,2,1,0,0,0,0,0,0,0,0,0
171304,35000,350,0,-2,1,1,0,0,0,0,0,0,0,0,0,0,0,0,0,0,0,0,1,1,0,0,0,0,0,0,0,0,0,0
171395,35000,350,0,-2,4,2,2,1,1,0,0,0,0,0,0,0,0,0,0,0,0,0,3,1,2,0,0,0,0,0,0,0,0,0
171456,35000,350,0,-2,9,8,1,0,0,0,0,0,0,0,0,0,0,0,0,0,0,0,8,7,1,0,0,0,1,1,0,0,0,0
171483,35000,350,0,-2,1,0,1,0,0,0,0,0,0,0,0,0,0,0,0,0,0,0,1,0,1,0,0,0,0,0,0,0,0,0
171492,35000,350,0,-2,3,1,2,0,0,0,0,0,0,0,0,0,0,0,0,0,0,0,3,1,2,0,0,0,0,0,0,0,0,0
171535,35000,350,0,-2,8,6,2,0,0,0,0,0,0,2,2,0,1,1,0,0,0,0,5,3,2,0,0,0,0,0,0,0,0,0
171571,35000,350,0,-2,2,1,1,0,0,0,0,0,0,0,0,0,1,0,1,0,0,0,1,1,0,0,0,0,0,0,0,0,0,0
171599,35000,350,0,-2,6,3,3,0,0,0,0,0,0,0,0,0,1,1,0,0,0,0,5,2,3,0,0,0,0,0,0,0,0,0
172051,35000,350,0,-2,3,3,0,0,0,0,0,0,0,1,1,0,1,1,0,0,0,0,1,1,0,0,0,0,0,0,0,0,0,0
172200,35000,350,0,-2,2,2,0,0,0,0,0,0,0,0,0,0,0,0,0,0,0,0,2,2,0,0,0,0,0,0,0,0,0,0
172264,35000,350,0,-2,7,5,2,0,0,0,0,0,0,0,0,0,0,0,0,0,0,0,7,5,2,0,0,0,0,0,0,0,0,0
172291,35000,350,0,-2,4,3,1,0,0,0,0,0,0,0,0,0,2,1,1,0,0,0,2,2,0,0,0,0,0,0,0,0,0,0
172307,35000,350,0,-2,2,1,1,0,0,0,0,0,0,0,0,0,1,0,1,0,0,0,1,1,0,0,0,0,0,0,0,0,0,0
172440,35000,350,0,-2,11,9,2,1,0,1,0,0,0,0,0,0,0,0,0,0,0,0,10,9,1,0,0,0,0,0,0,0,0,0
172477,35000,350,0,-2,2,2,0,0,0,0,0,0,0,1,1,0,0,0,0,0,0,0,1,1,0,0,0,0,0,0,0,0,0,0
172617,35000,350,0,-2,1,0,1,0,0,0,0,0,0,0,0,0,0,0,0,0,0,0,1,0,1,0,0,0,0,0,0,0,0,0
172635,35000,350,0,-2,4,4,0,0,0,0,0,0,0,4,4,0,0,0,0,0,0,0,0,0,0,0,0,0,0,0,0,0,0,0
172644,35000,350,0,-2,10,7,3,0,0,0,0,0,0,2,2,0,0,0,0,0,0,0,7,5,2,0,0,0,1,0,1,0,0,0
172699,35000,350,0,-2,15,10,5,0,0,0,0,0,0,5,3,2,2,2,0,0,0,0,8,5,3,0,0,0,0,0,0,0,0,0
173045,35000,350,0,-2,4,3,1,0,0,0,0,0,0,2,1,1,0,0,0,0,0,0,2,2,0,0,0,0,0,0,0,0,0,0
173063,35000,350,0,-2,1,1,0,0,0,0,0,0,0,0,0,0,0,0,0,0,0,0,1,1,0,0,0,0,0,0,0,0,0,0
173124,35000,350,0,-2,1,0,1,0,0,0,0,0,0,0,0,0,0,0,0,0,0,0,1,0,1,0,0,0,0,0,0,0,0,0
173160,35000,350,0,-2,6,4,2,0,0,0,0,0,0,1,1,0,0,0,0,0,0,0,5,3,2,0,0,0,0,0,0,0,0,0
173258,35000,350,0,-2,16,8,8,0,0,0,0,0,0,2,1,1,4,1,3,0,0,0,10,6,4,0,0,0,0,0,0,0,0,0
173300,35000,350,0,-2,16,10,6,0,0,0,1,0,1,1,1,0,0,0,0,0,0,0,13,8,5,1,1,0,0,0,0,0,0,0
173452,35000,350,0,-2,1,1,0,0,0,0,0,0,0,0,0,0,0,0,0,0,0,0,1,1,0,0,0,0,0,0,0,0,0,0
173559,35000,350,0,-2,1,1,0,0,0,0,0,0,0,0,0,0,1,1,0,0,0,0,0,0,0,0,0,0,0,0,0,0,0,0
173647,35000,350,0,-2,3,1,2,0,0,0,0,0,0,0,0,0,0,0,0,0,0,0,2,1,1,0,0,0,1,0,1,0,0,0
173665,35000,350,0,-2,9,9,0,0,0,0,0,0,0,2,2,0,1,1,0,0,0,0,6,6,0,0,0,0,0,0,0,0,0,0
173708,35000,350,0,-2,1,0,1,0,0,0,0,0,0,0,0,0,0,0,0,0,0,0,0,0,0,0,0,0,1,0,1,0,0,0
173799,35000,350,0,-2,1,0,1,0,0,0,0,0,0,0,0,0,1,0,1,0,0,0,0,0,0,0,0,0,0,0,0,0,0,0
173902,35000,350,0,-2,5,2,3,0,0,0,0,0,0,1,1,0,0,0,0,0,0,0,3,1,2,1,0,1,0,0,0,0,0,0
173920,35000,350,0,-2,2,1,1,0,0,0,0,0,0,0,0,0,1,0,1,0,0,0,1,1,0,0,0,0,0,0,0,0,0,0
173993,35000,350,0,-2,1,1,0,0,0,0,0,0,0,0,0,0,0,0,0,0,0,0,1,1,0,0,0,0,0,0,0,0,0,0
174066,35000,350,0,-2,150,70,80,1,0,1,7,4,3,67,32,35,6,4,2,0,0,0,55,21,34,7,4,3,6,5,1,1,0,1
174075,35000,350,0,-2,6,3,3,0,0,0,0,0,0,0,0,0,0,0,0,0,0,0,6,3,3,0,0,0,0,0,0,0,0,0
174136,35000,350,0,-2,1,1,0,0,0,0,0,0,0,0,0,0,0,0,0,0,0,0,1,1,0,0,0,0,0,0,0,0,0,0
174233,35000,350,0,-2,19,12,7,0,0,0,2,1,1,1,1,0,0,0,0,0,0,0,15,9,6,1,1,0,0,0,0,0,0,0
174251,35000,350,0,-2,2,0,2,0,0,0,0,0,0,0,0,0,0,0,0,0,0,0,2,0,2,0,0,0,0,0,0,0,0,0
174358,35000,350,0,-2,3,2,1,0,0,0,0,0,0,0,0,0,0,0,0,0,0,0,3,2,1,0,0,0,0,0,0,0,0,0
174376,35000,350,0,-2,1,1,0,0,0,0,0,0,0,0,0,0,0,0,0,0,0,0,1,1,0,0,0,0,0,0,0,0,0,0
174437,35000,350,0,-2,2,2,0,0,0,0,0,0,0,0,0,0,0,0,0,0,0,0,2,2,0,0,0,0,0,0,0,0,0,0
174473,35000,350,0,-2,1,1,0,0,0,0,0,0,0,0,0,0,0,0,0,0,0,0,1,1,0,0,0,0,0,0,0,0,0,0
174491,35000,350,0,-2,4,2,2,0,0,0,1,0,1,0,0,0,0,0,0,0,0,0,3,2,1,0,0,0,0,0,0,0,0,0
174738,35000,350,0,-2,2,1,1,0,0,0,0,0,0,0,0,0,0,0,0,0,0,0,2,1,1,0,0,0,0,0,0,0,0,0
174747,35000,350,0,-2,6,3,3,0,0,0,0,0,0,1,0,1,0,0,0,0,0,0,3,3,0,0,0,0,2,0,2,0,0,0
174756,35000,350,0,-2,1,1,0,0,0,0,0,0,0,0,0,0,0,0,0,0,0,0,1,1,0,0,0,0,0,0,0,0,0,0
174783,35000,350,0,-2,1,1,0,0,0,0,0,0,0,0,0,0,0,0,0,0,0,0,1,1,0,0,0,0,0,0,0,0,0,0
174792,35000,350,0,-2,10,6,4,1,1,0,0,0,0,0,0,0,1,1,0,0,0,0,8,4,4,0,0,0,0,0,0,0,0,0
174817,35000,350,0,-2,6,5,1,0,0,0,0,0,0,0,0,0,0,0,0,0,0,0,6,5,1,0,0,0,0,0,0,0,0,0
174844,35000,350,0,-2,20,15,5,0,0,0,1,0,1,0,0,0,1,1,0,0,0,0,18,14,4,0,0,0,0,0,0,0,0,0
174899,35000,350,0,-2,3,2,1,0,0,0,0,0,0,0,0,0,0,0,0,0,0,0,1,1,0,2,1,1,0,0,0,0,0,0
174914,35000,350,0,-2,37,28,9,0,0,0,0,0,0,4,2,2,9,5,4,0,0,0,23,20,3,1,1,0,0,0,0,0,0,0
175005,35000,350,0,-2,6,5,1,0,0,0,0,0,0,3,3,0,0,0,0,0,0,0,3,2,1,0,0,0,0,0,0,0,0,0
175041,35000,350,0,-2,1,0,1,0,0,0,0,0,0,0,0,0,0,0,0,0,0,0,0,0,0,0,0,0,1,0,1,0,0,0
175157,35000,350,0,-2,1,1,0,0,0,0,0,0,0,1,1,0,0,0,0,0,0,0,0,0,0,0,0,0,0,0,0,0,0,0
175263,35000,350,0,-2,1,0,1,0,0,0,0,0,0,0,0,0,0,0,0,0,0,0,1,0,1,0,0,0,0,0,0,0,0,0
175272,35000,350,0,-2,3,3,0,0,0,0,0,0,0,0,0,0,0,0,0,0,0,0,3,3,0,0,0,0,0,0,0,0,0,0
175281,35000,350,0,-2,9,8,1,0,0,0,0,0,0,5,5,0,1,1,0,0,0,0,3,2,1,0,0,0,0,0,0,0,0,0
175342,35000,350,0,-2,5,4,1,0,0,0,0,0,0,5,4,1,0,0,0,0,0,0,0,0,0,0,0,0,0,0,0,0,0,0
175421,35000,350,0,-2,2,2,0,0,0,0,0,0,0,1,1,0,0,0,0,0,0,0,1,1,0,0,0,0,0,0,0,0,0,0
175519,35000,350,0,-2,9,9,0,0,0,0,0,0,0,8,8,0,0,0,0,0,0,0,0,0,0,0,0,0,1,1,0,0,0,0
175573,35000,350,0,-2,17,13,4,0,0,0,0,0,0,5,5,0,0,0,0,0,0,0,12,8,4,0,0,0,0,0,0,0,0,0
175616,35000,350,0,-2,17,13,4,0,0,0,0,0,0,14,10,4,0,0,0,0,0,0,3,3,0,0,0,0,0,0,0,0,0,0
175643,35000,350,0,-2,3,2,1,0,0,0,0,0,0,0,0,0,0,0,0,0,0,0,3,2,1,0,0,0,0,0,0,0,0,0
175786,35000,350,0,-2,25,12,13,0,0,0,0,0,0,16,9,7,0,0,0,0,0,0,8,3,5,0,0,0,1,0,1,0,0,0
175810,35000,350,0,-2,6,4,2,0,0,0,0,0,0,3,2,1,0,0,0,0,0,0,3,2,1,0,0,0,0,0,0,0,0,0
175829,35000,350,0,-2,10,7,3,0,0,0,0,0,0,2,1,1,0,0,0,0,0,0,8,6,2,0,0,0,0,0,0,0,0,0
175856,35000,350,0,-2,30,18,12,0,0,0,0,0,0,29,18,11,0,0,0,0,0,0,1,0,1,0,0,0,0,0,0,0,0,0
175883,35000,350,0,-2,12,10,2,0,0,0,0,0,0,2,0,2,0,0,0,1,1,0,9,9,0,0,0,0,0,0,0,0,0,0
175935,35000,350,0,-2,4,3,1,0,0,0,0,0,0,1,0,1,1,1,0,0,0,0,2,2,0,0,0,0,0,0,0,0,0,0
176008,35000,350,0,-2,16,12,4,0,0,0,0,0,0,13,10,3,0,0,0,0,0,0,3,2,1,0,0,0,0,0,0,0,0,0
176017,35000,350,0,-2,80,57,23,0,0,0,0,0,0,45,32,13,1,0,1,0,0,0,32,23,9,1,1,0,1,1,0,0,0,0
176035,35000,350,0,-2,2,0,2,0,0,0,0,0,0,2,0,2,0,0,0,0,0,0,0,0,0,0,0,0,0,0,0,0,0,0
176044,35000,350,0,-2,11,4,7,0,0,0,0,0,0,11,4,7,0,0,0,0,0,0,0,0,0,0,0,0,0,0,0,0,0,0
176053,35000,350,0,-2,3,1,2,0,0,0,0,0,0,0,0,0,1,0,1,0,0,0,0,0,0,0,0,0,2,1,1,0,0,0
176071,35000,350,0,-2,27,15,12,0,0,0,0,0,0,7,3,4,0,0,0,0,0,0,14,9,5,2,1,1,4,2,2,0,0,0
176080,35000,350,0,-2,74,37,37,1,1,0,0,0,0,43,15,28,1,0,1,0,0,0,27,19,8,1,1,0,1,1,0,0,0,0
176169,35000,350,0,-2,3,2,1,0,0,0,0,0,0,1,0,1,0,0,0,0,0,0,2,2,0,0,0,0,0,0,0,0,0,0
176178,35000,350,0,-2,17,6,11,0,0,0,0,0,0,11,3,8,1,0,1,0,0,0,5,3,2,0,0,0,0,0,0,0,0,0
176239,35000,350,0,-2,7,7,0,0,0,0,0,0,0,1,1,0,0,0,0,0,0,0,6,6,0,0,0,0,0,0,0,0,0,0
176318,35000,350,0,-2,12,7,5,0,0,0,0,0,0,12,7,5,0,0,0,0,0,0,0,0,0,0,0,0,0,0,0,0,0,0
176354,35000,350,0,-2,10,4,6,0,0,0,0,0,0,5,1,4,0,0,0,0,0,0,5,3,2,0,0,0,0,0,0,0,0,0
176406,35000,350,0,-2,13,11,2,0,0,0,0,0,0,13,11,2,0,0,0,0,0,0,0,0,0,0,0,0,0,0,0,0,0,0
176479,35000,350,0,-2,3,2,1,0,0,0,0,0,0,3,2,1,0,0,0,0,0,0,0,0,0,0,0,0,0,0,0,0,0,0
176789,35000,350,0,-2,3,3,0,0,0,0,0,0,0,0,0,0,0,0,0,0,0,0,3,3,0,0,0,0,0,0,0,0,0,0
176947,35000,350,0,-2,6,2,4,0,0,0,0,0,0,1,0,1,0,0,0,0,0,0,5,2,3,0,0,0,0,0,0,0,0,0
176965,35000,350,0,-2,18,15,3,1,1,0,0,0,0,2,2,0,0,0,0,0,0,0,15,12,3,0,0,0,0,0,0,0,0,0
177065,35000,350,0,-2,5,1,4,0,0,0,0,0,0,1,0,1,0,0,0,0,0,0,3,0,3,0,0,0,1,1,0,0,0,0
177117,35000,350,0,-2,2,0,2,0,0,0,0,0,0,0,0,0,0,0,0,0,0,0,2,0,2,0,0,0,0,0,0,0,0,0
177135,35000,350,0,-2,1,1,0,0,0,0,0,0,0,0,0,0,0,0,0,0,0,0,1,1,0,0,0,0,0,0,0,0,0,0
177144,35000,350,0,-2,12,5,7,0,0,0,0,0,0,2,2,0,0,0,0,0,0,0,10,3,7,0,0,0,0,0,0,0,0,0
177214,35000,350,0,-2,13,11,2,0,0,0,0,0,0,0,0,0,0,0,0,0,0,0,9,8,1,0,0,0,4,3,1,0,0,0
177250,35000,350,0,-2,2,1,1,0,0,0,0,0,0,0,0,0,0,0,0,0,0,0,1,0,1,0,0,0,1,1,0,0,0,0
177339,35000,350,0,-2,8,5,3,0,0,0,0,0,0,0,0,0,1,1,0,0,0,0,4,3,1,1,1,0,2,0,2,0,0,0
177418,35000,350,0,-2,2,1,1,0,0,0,0,0,0,0,0,0,1,0,1,0,0,0,1,1,0,0,0,0,0,0,0,0,0,0
177472,35000,350,0,-2,19,13,6,0,0,0,0,0,0,2,1,1,0,0,0,0,0,0,16,11,5,0,0,0,1,1,0,0,0,0
177551,35000,350,0,-2,21,17,4,0,0,0,1,1,0,14,10,4,0,0,0,0,0,0,5,5,0,1,1,0,0,0,0,0,0,0
177676,35000,350,0,-2,2,2,0,0,0,0,0,0,0,0,0,0,0,0,0,0,0,0,1,1,0,1,1,0,0,0,0,0,0,0
177746,35000,350,0,-2,9,5,4,0,0,0,0,0,0,1,0,1,2,0,2,0,0,0,6,5,1,0,0,0,0,0,0,0,0,0
177940,35000,350,0,-2,8,6,2,2,2,0,0,0,0,2,2,0,0,0,0,0,0,0,4,2,2,0,0,0,0,0,0,0,0,0
177968,35000,350,0,-2,16,11,5,0,0,0,0,0,0,2,1,1,2,1,1,0,0,0,11,9,2,0,0,0,0,0,0,1,0,1
177986,35000,350,0,-2,7,6,1,0,0,0,0,0,0,1,1,0,1,1,0,0,0,0,5,4,1,0,0,0,0,0,0,0,0,0
177995,35000,350,0,-2,1,1,0,0,0,0,0,0,0,0,0,0,0,0,0,0,0,0,1,1,0,0,0,0,0,0,0,0,0,0
178059,35000,350,0,-2,4,2,2,0,0,0,0,0,0,1,1,0,0,0,0,0,0,0,2,1,1,1,0,1,0,0,0,0,0,0
178208,35000,350,0,-2,3,3,0,0,0,0,0,0,0,0,0,0,0,0,0,0,0,0,2,2,0,1,1,0,0,0,0,0,0,0
178244,35000,350,0,-2,5,4,1,0,0,0,0,0,0,2,2,0,0,0,0,0,0,0,3,2,1,0,0,0,0,0,0,0,0,0
178341,35000,350,0,-2,14,7,7,0,0,0,0,0,0,3,1,2,2,2,0,0,0,0,6,2,4,0,0,0,2,1,1,1,1,0
178369,35000,350,0,-2,4,3,1,0,0,0,0,0,0,0,0,0,0,0,0,0,0,0,4,3,1,0,0,0,0,0,0,0,0,0
178387,35000,350,0,-2,12,7,5,0,0,0,0,0,0,0,0,0,0,0,0,0,0,0,5,2,3,0,0,0,7,5,2,0,0,0
178396,35000,350,0,-2,127,65,62,1,1,0,3,1,2,33,18,15,9,5,4,0,0,0,67,32,35,1,0,1,9,5,4,4,3,1
178402,35000,350,0,-2,12,7,5,0,0,0,1,1,0,7,5,2,1,0,1,0,0,0,1,0,1,0,0,0,2,1,1,0,0,0
178411,35000,350,0,-2,17,10,7,1,1,0,0,0,0,0,0,0,0,0,0,0,0,0,12,7,5,0,0,0,4,2,2,0,0,0
178420,35000,350,0,-2,16,9,7,0,0,0,0,0,0,8,4,4,0,0,0,0,0,0,6,4,2,0,0,0,1,1,0,1,0,1
178448,35000,350,0,-2,5,4,1,0,0,0,0,0,0,0,0,0,0,0,0,0,0,0,5,4,1,0,0,0,0,0,0,0,0,0
178615,35000,350,0,-2,8,4,4,0,0,0,0,0,0,0,0,0,0,0,0,0,0,0,8,4,4,0,0,0,0,0,0,0,0,0
178624,35000,350,0,-2,12,3,9,0,0,0,0,0,0,2,2,0,2,0,2,0,0,0,8,1,7,0,0,0,0,0,0,0,0,0
178697,35000,350,0,-2,11,7,4,0,0,0,0,0,0,0,0,0,0,0,0,0,0,0,11,7,4,0,0,0,0,0,0,0,0,0
178721,35000,350,0,-2,5,3,2,0,0,0,0,0,0,0,0,0,1,0,1,0,0,0,4,3,1,0,0,0,0,0,0,0,0,0
179043,35000,350,0,-2,5,5,0,0,0,0,0,0,0,1,1,0,0,0,0,0,0,0,3,3,0,0,0,0,1,1,0,0,0,0
179159,35000,350,0,-2,118,32,86,1,0,1,0,0,0,53,12,41,6,3,3,0,0,0,53,16,37,5,1,4,0,0,0,0,0,0
179308,35000,350,0,-2,8,7,1,0,0,0,0,0,0,4,4,0,1,1,0,0,0,0,3,2,1,0,0,0,0,0,0,0,0,0
179326,35000,350,0,-2,10,6,4,0,0,0,0,0,0,0,0,0,0,0,0,0,0,0,9,5,4,0,0,0,1,1,0,0,0,0
179344,35000,350,0,-2,1,1,0,0,0,0,0,0,0,0,0,0,0,0,0,0,0,0,1,1,0,0,0,0,0,0,0,0,0,0
179539,35000,350,0,-2,5,4,1,0,0,0,0,0,0,0,0,0,2,1,1,0,0,0,3,3,0,0,0,0,0,0,0,0,0,0
179548,35000,350,0,-2,12,4,8,0,0,0,0,0,0,2,1,1,0,0,0,1,0,1,8,2,6,1,1,0,0,0,0,0,0,0
179557,35000,350,0,-2,12,8,4,0,0,0,0,0,0,4,3,1,0,0,0,0,0,0,6,4,2,0,0,0,2,1,1,0,0,0
179566,35000,350,0,-2,22,15,7,1,1,0,1,1,0,2,2,0,0,0,0,0,0,0,16,10,6,0,0,0,2,1,1,0,0,0
179715,35000,350,0,-2,3,2,1,0,0,0,0,0,0,0,0,0,0,0,0,0,0,0,3,2,1,0,0,0,0,0,0,0,0,0
179812,35000,350,0,-2,4,4,0,0,0,0,0,0,0,1,1,0,2,2,0,0,0,0,1,1,0,0,0,0,0,0,0,0,0,0
179867,35000,350,0,-2,397,100,297,0,0,0,12,4,8,157,40,117,14,1,13,0,0,0,199,52,147,10,3,7,3,0,3,2,0,2
179894,35000,350,0,-2,2,1,1,0,0,0,0,0,0,0,0,0,0,0,0,0,0,0,2,1,1,0,0,0,0,0,0,0,0,0
179946,35000,350,0,-2,1,0,1,0,0,0,0,0,0,0,0,0,0,0,0,0,0,0,1,0,1,0,0,0,0,0,0,0,0,0
179955,35000,350,0,-2,2,1,1,0,0,0,0,0,0,1,0,1,0,0,0,0,0,0,1,1,0,0,0,0,0,0,0,0,0,0
179964,35000,350,0,-2,2,0,2,0,0,0,0,0,0,0,0,0,0,0,0,0,0,0,1,0,1,0,0,0,1,0,1,0,0,0
180054,35000,350,0,-2,3,1,2,3,1,2,0,0,0,0,0,0,0,0,0,0,0,0,0,0,0,0,0,0,0,0,0,0,0,0
180106,35000,350,0,-2,5,4,1,0,0,0,0,0,0,0,0,0,0,0,0,0,0,0,2,2,0,0,0,0,3,2,1,0,0,0
180179,35000,350,0,-2,9,5,4,0,0,0,0,0,0,0,0,0,1,1,0,0,0,0,8,4,4,0,0,0,0,0,0,0,0,0
180249,35000,350,0,-2,1,1,0,0,0,0,0,0,0,0,0,0,0,0,0,0,0,0,1,1,0,0,0,0,0,0,0,0,0,0
180258,35000,350,0,-2,3,3,0,0,0,0,0,0,0,0,0,0,0,0,0,0,0,0,1,1,0,0,0,0,2,2,0,0,0,0
180276,35000,350,0,-2,1,1,0,0,0,0,0,0,0,0,0,0,0,0,0,0,0,0,1,1,0,0,0,0,0,0,0,0,0,0
180328,35000,350,0,-2,7,4,3,7,4,3,0,0,0,0,0,0,0,0,0,0,0,0,0,0,0,0,0,0,0,0,0,0,0,0
180373,35000,350,0,-2,1,1,0,0,0,0,0,0,0,0,0,0,0,0,0,0,0,0,1,1,0,0,0,0,0,0,0,0,0,0
180416,35000,350,0,-2,5,5,0,0,0,0,0,0,0,0,0,0,0,0,0,0,0,0,5,5,0,0,0,0,0,0,0,0,0,0
180461,35000,350,0,-2,56,35,21,0,0,0,2,1,1,0,0,0,3,3,0,0,0,0,41,27,14,3,1,2,7,3,4,0,0,0
180489,35000,350,0,-2,20,17,3,1,0,1,0,0,0,0,0,0,1,1,0,0,0,0,18,16,2,0,0,0,0,0,0,0,0,0
180522,35000,350,0,-2,1,1,0,0,0,0,0,0,0,0,0,0,0,0,0,0,0,0,0,0,0,0,0,0,1,1,0,0,0,0
180595,35000,350,0,-2,8,6,2,0,0,0,0,0,0,0,0,0,0,0,0,0,0,0,7,5,2,0,0,0,1,1,0,0,0,0
180692,35000,350,0,-2,4,2,2,0,0,0,0,0,0,0,0,0,1,1,0,0,0,0,1,0,1,0,0,0,2,1,1,0,0,0
180814,35000,350,0,-2,7,2,5,0,0,0,0,0,0,0,0,0,0,0,0,0,0,0,6,1,5,1,1,0,0,0,0,0,0,0
180902,35000,350,0,-2,2,1,1,0,0,0,0,0,0,0,0,0,0,0,0,0,0,0,2,1,1,0,0,0,0,0,0,0,0,0
180948,35000,350,0,-2,4,3,1,0,0,0,0,0,0,0,0,0,0,0,0,0,0,0,4,3,1,0,0,0,0,0,0,0,0,0
181002,35000,350,0,-2,48,23,25,0,0,0,6,4,2,6,2,4,3,1,2,0,0,0,22,8,14,0,0,0,11,8,3,0,0,0
181020,35000,350,0,-2,2,2,0,0,0,0,0,0,0,1,1,0,0,0,0,0,0,0,0,0,0,0,0,0,1,1,0,0,0,0
181127,35000,350,0,-2,1,1,0,0,0,0,0,0,0,0,0,0,0,0,0,0,0,0,1,1,0,0,0,0,0,0,0,0,0,0
181215,35000,350,0,-2,14,9,5,0,0,0,0,0,0,0,0,0,0,0,0,0,0,0,14,9,5,0,0,0,0,0,0,0,0,0
181303,35000,350,0,-2,14,8,6,0,0,0,0,0,0,4,2,2,0,0,0,0,0,0,10,6,4,0,0,0,0,0,0,0,0,0
181394,35000,350,0,-2,3,2,1,0,0,0,0,0,0,1,1,0,0,0,0,0,0,0,2,1,1,0,0,0,0,0,0,0,0,0
181428,35000,350,0,-2,46,29,17,0,0,0,0,0,0,7,4,3,10,6,4,0,0,0,27,19,8,2,0,2,0,0,0,0,0,0
181446,35000,350,0,-2,7,4,3,0,0,0,0,0,0,2,1,1,0,0,0,0,0,0,5,3,2,0,0,0,0,0,0,0,0,0
181464,35000,350,0,-2,66,38,28,1,0,1,2,1,1,5,1,4,12,3,9,0,0,0,45,32,13,1,1,0,0,0,0,0,0,0
181491,35000,350,0,-2,3,1,2,0,0,0,0,0,0,0,0,0,0,0,0,0,0,0,3,1,2,0,0,0,0,0,0,0,0,0
181534,35000,350,0,-2,2,1,1,0,0,0,0,0,0,0,0,0,0,0,0,0,0,0,1,1,0,0,0,0,1,0,1,0,0,0
181604,35000,350,0,-2,1,1,0,0,0,0,0,0,0,0,0,0,0,0,0,0,0,0,1,1,0,0,0,0,0,0,0,0,0,0
181640,35000,350,0,-2,3,2,1,0,0,0,0,0,0,0,0,0,0,0,0,0,0,0,3,2,1,0,0,0,0,0,0,0,0,0
181738,35000,350,0,-2,1,0,1,0,0,0,0,0,0,0,0,0,0,0,0,0,0,0,1,0,1,0,0,0,0,0,0,0,0,0
181783,35000,350,0,-2,15,12,3,0,0,0,0,0,0,1,0,1,0,0,0,0,0,0,14,12,2,0,0,0,0,0,0,0,0,0
182148,35000,350,0,-2,1,0,1,0,0,0,0,0,0,0,0,0,0,0,0,0,0,0,1,0,1,0,0,0,0,0,0,0,0,0
182281,35000,350,0,-2,16,8,8,0,0,0,0,0,0,2,0,2,7,5,2,1,1,0,4,1,3,1,1,0,0,0,0,1,0,1
182290,35000,350,0,-2,15,3,12,0,0,0,0,0,0,2,1,1,7,1,6,0,0,0,6,1,5,0,0,0,0,0,0,0,0,0
182306,35000,350,0,-2,1,0,1,0,0,0,0,0,0,0,0,0,0,0,0,0,0,0,0,0,0,0,0,0,1,0,1,0,0,0
182500,35000,350,0,-2,2,1,1,0,0,0,0,0,0,0,0,0,1,1,0,0,0,0,1,0,1,0,0,0,0,0,0,0,0,0
182564,35000,350,0,-2,2,1,1,1,1,0,0,0,0,0,0,0,0,0,0,0,0,0,1,0,1,0,0,0,0,0,0,0,0,0
182634,35000,350,0,-2,4,4,0,0,0,0,0,0,0,0,0,0,1,1,0,0,0,0,3,3,0,0,0,0,0,0,0,0,0,0
182670,35000,350,0,-2,43,27,16,0,0,0,0,0,0,0,0,0,1,0,1,0,0,0,41,27,14,1,0,1,0,0,0,0,0,0
182795,35000,350,0,-2,6,4,2,0,0,0,0,0,0,0,0,0,0,0,0,0,0,0,6,4,2,0,0,0,0,0,0,0,0,0
182980,35000,350,0,-2,9,3,6,0,0,0,0,0,0,0,0,0,1,1,0,0,0,0,8,2,6,0,0,0,0,0,0,0,0,0
183026,35000,350,0,-2,9,6,3,0,0,0,0,0,0,1,1,0,1,1,0,0,0,0,6,4,2,1,0,1,0,0,0,0,0,0
183044,35000,350,0,-2,16,6,10,0,0,0,0,0,0,0,0,0,3,0,3,0,0,0,11,5,6,0,0,0,2,1,1,0,0,0
183062,35000,350,0,-2,5,4,1,0,0,0,0,0,0,0,0,0,1,1,0,0,0,0,4,3,1,0,0,0,0,0,0,0,0,0
183080,35000,350,0,-2,7,3,4,0,0,0,0,0,0,0,0,0,0,0,0,0,0,0,7,3,4,0,0,0,0,0,0,0,0,0
183211,35000,350,0,-2,3,3,0,0,0,0,0,0,0,0,0,0,0,0,0,0,0,0,3,3,0,0,0,0,0,0,0,0,0,0
183239,35000,350,0,-2,16,8,8,0,0,0,0,0,0,1,1,0,2,0,2,0,0,0,12,7,5,0,0,0,1,0,1,0,0,0
183275,35000,350,0,-2,1,0,1,0,0,0,0,0,0,0,0,0,0,0,0,0,0,0,1,0,1,0,0,0,0,0,0,0,0,0
183655,35000,350,0,-2,8,5,3,0,0,0,0,0,0,4,3,1,1,0,1,0,0,0,3,2,1,0,0,0,0,0,0,0,0,0
183743,35000,350,0,-2,1,1,0,0,0,0,0,0,0,0,0,0,0,0,0,0,0,0,0,0,0,0,0,0,1,1,0,0,0,0
183789,35000,350,0,-2,1,1,0,0,0,0,0,0,0,0,0,0,0,0,0,0,0,0,0,0,0,1,1,0,0,0,0,0,0,0
183822,35000,350,0,-2,1,0,1,0,0,0,0,0,0,0,0,0,1,0,1,0,0,0,0,0,0,0,0,0,0,0,0,0,0,0
183859,35000,350,0,-2,2,1,1,0,0,0,0,0,0,0,0,0,0,0,0,0,0,0,2,1,1,0,0,0,0,0,0,0,0,0
183938,35000,350,0,-2,3,3,0,0,0,0,0,0,0,0,0,0,1,1,0,0,0,0,2,2,0,0,0,0,0,0,0,0,0,0
183974,35000,350,0,-2,2,2,0,0,0,0,0,0,0,0,0,0,0,0,0,0,0,0,2,2,0,0,0,0,0,0,0,0,0,0
184180,35000,350,0,-2,5,3,2,0,0,0,0,0,0,0,0,0,2,0,2,0,0,0,3,3,0,0,0,0,0,0,0,0,0,0
184348,35000,350,0,-2,4,2,2,0,0,0,0,0,0,1,1,0,0,0,0,0,0,0,3,1,2,0,0,0,0,0,0,0,0,0
184481,35000,350,0,-2,2,2,0,0,0,0,0,0,0,2,2,0,0,0,0,0,0,0,0,0,0,0,0,0,0,0,0,0,0,0
184612,35000,350,0,-2,5,2,3,0,0,0,0,0,0,5,2,3,0,0,0,0,0,0,0,0,0,0,0,0,0,0,0,0,0,0
184694,35000,350,0,-2,6,3,3,0,0,0,0,0,0,1,1,0,0,0,0,0,0,0,4,2,2,0,0,0,1,0,1,0,0,0
184773,35000,350,0,-2,2,2,0,0,0,0,1,1,0,0,0,0,0,0,0,0,0,0,1,1,0,0,0,0,0,0,0,0,0,0
184782,35000,350,0,-2,69,25,44,0,0,0,2,0,2,21,6,15,14,2,12,0,0,0,28,14,14,1,0,1,0,0,0,3,3,0
184791,35000,350,0,-2,6,4,2,0,0,0,0,0,0,2,1,1,0,0,0,0,0,0,4,3,1,0,0,0,0,0,0,0,0,0
184995,35000,350,0,-2,1,1,0,0,0,0,0,0,0,1,1,0,0,0,0,0,0,0,0,0,0,0,0,0,0,0,0,0,0,0
185129,35000,350,0,-2,6,5,1,0,0,0,1,1,0,5,4,1,0,0,0,0,0,0,0,0,0,0,0,0,0,0,0,0,0,0
185262,35000,350,0,-2,5,4,1,0,0,0,1,1,0,1,1,0,1,0,1,0,0,0,2,2,0,0,0,0,0,0,0,0,0,0
185509,35000,350,0,-2,3,3,0,0,0,0,0,0,0,1,1,0,0,0,0,0,0,0,2,2,0,0,0,0,0,0,0,0,0,0
185536,35000,350,0,-2,4,4,0,0,0,0,0,0,0,1,1,0,0,0,0,0,0,0,3,3,0,0,0,0,0,0,0,0,0,0
185572,35000,350,0,-2,8,3,5,1,0,1,0,0,0,0,0,0,2,1,1,0,0,0,5,2,3,0,0,0,0,0,0,0,0,0
185590,35000,350,0,-2,17,11,6,0,0,0,2,1,1,4,3,1,3,1,2,0,0,0,5,4,1,0,0,0,3,2,1,0,0,0
185828,35000,350,0,-2,21,10,11,0,0,0,0,0,0,8,2,6,9,5,4,0,0,0,3,3,0,0,0,0,1,0,1,0,0,0
185873,35000,350,0,-2,4,4,0,0,0,0,1,1,0,0,0,0,0,0,0,0,0,0,2,2,0,1,1,0,0,0,0,0,0,0
186034,35000,350,0,-2,1,1,0,0,0,0,0,0,0,1,1,0,0,0,0,0,0,0,0,0,0,0,0,0,0,0,0,0,0,0
186122,35000,350,0,-2,3,3,0,0,0,0,0,0,0,1,1,0,0,0,0,0,0,0,2,2,0,0,0,0,0,0,0,0,0,0
186131,35000,350,0,-2,26,20,6,0,0,0,3,3,0,6,6,0,4,3,1,0,0,0,12,7,5,0,0,0,1,1,0,0,0,0
186201,35000,350,0,-2,5,5,0,0,0,0,0,0,0,0,0,0,1,1,0,0,0,0,4,4,0,0,0,0,0,0,0,0,0,0
186283,35000,350,0,-2,8,4,4,0,0,0,0,0,0,3,0,3,1,1,0,0,0,0,4,3,1,0,0,0,0,0,0,0,0,0
186371,35000,350,0,-2,14,12,2,0,0,0,0,0,0,1,1,0,0,0,0,0,0,0,1,1,0,0,0,0,12,10,2,0,0,0
186380,35000,350,0,-2,97,46,51,1,0,1,2,2,0,2,0,2,2,2,0,0,0,0,0,0,0,0,0,0,87,42,45,3,0,3
186399,35000,350,0,-2,10,9,1,0,0,0,0,0,0,0,0,0,0,0,0,0,0,0,0,0,0,0,0,0,10,9,1,0,0,0
186584,35000,350,0,-2,9,6,3,0,0,0,0,0,0,1,1,0,1,0,1,0,0,0,4,4,0,1,0,1,1,0,1,1,1,0
186645,35000,350,0,-2,2,0,2,0,0,0,0,0,0,0,0,0,0,0,0,0,0,0,0,0,0,0,0,0,0,0,0,2,0,2
186867,35000,350,0,-2,3,3,0,0,0,0,0,0,0,0,0,0,2,2,0,0,0,0,1,1,0,0,0,0,0,0,0,0,0,0
186876,35000,350,0,-2,24,19,5,0,0,0,1,1,0,2,2,0,5,3,2,0,0,0,16,13,3,0,0,0,0,0,0,0,0,0
187134,35000,350,0,-2,3,1,2,0,0,0,0,0,0,1,0,1,1,1,0,0,0,0,0,0,0,0,0,0,1,0,1,0,0,0
187198,35000,350,0,-2,6,5,1,0,0,0,0,0,0,5,4,1,0,0,0,0,0,0,0,0,0,0,0,0,1,1,0,0,0,0
187444,35000,350,0,-2,7,4,3,0,0,0,1,1,0,0,0,0,2,1,1,0,0,0,4,2,2,0,0,0,0,0,0,0,0,0
187532,35000,350,0,-2,9,7,2,1,1,0,0,0,0,0,0,0,2,2,0,0,0,0,4,3,1,0,0,0,2,1,1,0,0,0
187596,35000,350,0,-2,23,14,9,23,14,9,0,0,0,0,0,0,0,0,0,0,0,0,0,0,0,0,0,0,0,0,0,0,0,0
187620,35000,350,0,-2,1,0,1,0,0,0,0,0,0,0,0,0,1,0,1,0,0,0,0,0,0,0,0,0,0,0,0,0,0,0
187639,35000,350,0,-2,3,3,0,0,0,0,0,0,0,0,0,0,2,2,0,0,0,0,1,1,0,0,0,0,0,0,0,0,0,0
187648,35000,350,0,-2,11,7,4,0,0,0,0,0,0,0,0,0,3,3,0,0,0,0,8,4,4,0,0,0,0,0,0,0,0,0
187666,35000,350,0,-2,6,3,3,0,0,0,0,0,0,0,0,0,5,3,2,0,0,0,1,0,1,0,0,0,0,0,0,0,0,0
187897,35000,350,0,-2,8,4,4,0,0,0,1,1,0,0,0,0,5,3,2,0,0,0,2,0,2,0,0,0,0,0,0,0,0,0
187903,35000,350,0,-2,1,0,1,0,0,0,0,0,0,0,0,0,1,0,1,0,0,0,0,0,0,0,0,0,0,0,0,0,0,0
187912,35000,350,0,-2,7,7,0,0,0,0,0,0,0,1,1,0,2,2,0,0,0,0,4,4,0,0,0,0,0,0,0,0,0,0
187967,35000,350,0,-2,23,11,12,5,1,4,0,0,0,1,1,0,13,6,7,0,0,0,4,3,1,0,0,0,0,0,0,0,0,0
187985,35000,350,0,-2,42,20,22,2,2,0,0,0,0,2,1,1,26,9,17,0,0,0,7,5,2,1,1,0,2,2,0,2,0,2
187994,35000,350,0,-2,1,1,0,0,0,0,0,0,0,0,0,0,1,1,0,0,0,0,0,0,0,0,0,0,0,0,0,0,0,0
188003,35000,350,0,-2,3,3,0,0,0,0,0,0,0,0,0,0,2,2,0,0,0,0,1,1,0,0,0,0,0,0,0,0,0,0
188021,35000,350,0,-2,1,1,0,0,0,0,0,0,0,0,0,0,1,1,0,0,0,0,0,0,0,0,0,0,0,0,0,0,0,0
188030,35000,350,0,-2,7,3,4,0,0,0,1,1,0,1,0,1,4,1,3,0,0,0,1,1,0,0,0,0,0,0,0,0,0,0
188049,35000,350,0,-2,1,1,0,0,0,0,0,0,0,0,0,0,1,1,0,0,0,0,0,0,0,0,0,0,0,0,0,0,0,0
188058,35000,350,0,-2,1,1,0,0,0,0,0,0,0,0,0,0,0,0,0,0,0,0,0,0,0,0,0,0,1,1,0,0,0,0
188100,35000,350,0,-2,15,8,7,8,4,4,0,0,0,0,0,0,3,3,0,0,0,0,1,0,1,1,0,1,2,1,1,0,0,0
188137,35000,350,0,-2,9,7,2,0,0,0,0,0,0,0,0,0,7,5,2,0,0,0,2,2,0,0,0,0,0,0,0,0,0,0
188304,35000,350,0,-2,9,7,2,0,0,0,0,0,0,1,1,0,6,4,2,0,0,0,1,1,0,0,0,0,1,1,0,0,0,0
188429,35000,350,0,-2,7,4,3,0,0,0,0,0,0,0,0,0,4,2,2,0,0,0,3,2,1,0,0,0,0,0,0,0,0,0
188438,35000,350,0,-2,3,2,1,0,0,0,0,0,0,1,1,0,0,0,0,0,0,0,2,1,1,0,0,0,0,0,0,0,0,0
188526,35000,350,0,-2,3,2,1,0,0,0,0,0,0,1,0,1,0,0,0,0,0,0,2,2,0,0,0,0,0,0,0,0,0,0
188580,35000,350,0,-2,20,5,15,0,0,0,3,0,3,1,0,1,2,0,2,0,0,0,9,3,6,2,2,0,2,0,2,1,0,1
188641,35000,350,0,-2,17,11,6,0,0,0,0,0,0,1,1,0,0,0,0,0,0,0,16,10,6,0,0,0,0,0,0,0,0,0
188854,35000,350,0,-2,3,2,1,0,0,0,0,0,0,1,1,0,1,1,0,0,0,0,0,0,0,1,0,1,0,0,0,0,0,0
189015,35000,350,0,-2,6,2,4,0,0,0,0,0,0,4,2,2,0,0,0,0,0,0,2,0,2,0,0,0,0,0,0,0,0,0
189088,35000,350,0,-2,2,1,1,0,0,0,0,0,0,0,0,0,0,0,0,0,0,0,2,1,1,0,0,0,0,0,0,0,0,0
189097,35000,350,0,-2,5,5,0,0,0,0,0,0,0,3,3,0,1,1,0,0,0,0,1,1,0,0,0,0,0,0,0,0,0,0
189547,35000,350,0,-2,2,1,1,0,0,0,0,0,0,0,0,0,0,0,0,0,0,0,2,1,1,0,0,0,0,0,0,0,0,0
189565,35000,350,0,-2,3,2,1,0,0,0,0,0,0,0,0,0,2,1,1,0,0,0,1,1,0,0,0,0,0,0,0,0,0,0
189705,35000,350,0,-2,3,2,1,0,0,0,0,0,0,1,0,1,0,0,0,0,0,0,2,2,0,0,0,0,0,0,0,0,0,0
189839,35000,350,0,-2,1,0,1,0,0,0,0,0,0,0,0,0,0,0,0,0,0,0,1,0,1,0,0,0,0,0,0,0,0,0
189848,35000,350,0,-2,8,6,2,0,0,0,0,0,0,0,0,0,0,0,0,0,0,0,8,6,2,0,0,0,0,0,0,0,0,0
189857,35000,350,0,-2,3,3,0,0,0,0,0,0,0,2,2,0,0,0,0,0,0,0,1,1,0,0,0,0,0,0,0,0,0,0
190035,35000,350,0,-2,3,2,1,0,0,0,0,0,0,2,1,1,1,1,0,0,0,0,0,0,0,0,0,0,0,0,0,0,0,0
190044,35000,350,0,-2,9,5,4,0,0,0,0,0,0,0,0,0,0,0,0,0,0,0,9,5,4,0,0,0,0,0,0,0,0,0
190053,35000,350,0,-2,1,1,0,0,0,0,0,0,0,0,0,0,0,0,0,0,0,0,1,1,0,0,0,0,0,0,0,0,0,0
190099,35000,350,0,-2,20,14,6,1,1,0,0,0,0,2,2,0,0,0,0,0,0,0,17,11,6,0,0,0,0,0,0,0,0,0
190150,35000,350,0,-2,123,91,32,2,1,1,2,1,1,35,21,14,61,49,12,0,0,0,14,14,0,3,3,0,4,2,2,2,0,2
190415,35000,350,0,-2,236,120,116,0,0,0,29,11,18,23,14,9,8,4,4,0,0,0,160,80,80,5,2,3,11,9,2,0,0,0
190424,35000,350,0,-2,90,20,70,1,0,1,12,1,11,26,7,19,38,9,29,0,0,0,9,2,7,0,0,0,2,0,2,2,1,1
190442,35000,350,0,-2,3,3,0,0,0,0,0,0,0,0,0,0,0,0,0,0,0,0,3,3,0,0,0,0,0,0,0,0,0,0
190503,35000,350,0,-2,25,15,10,0,0,0,1,0,1,3,3,0,3,2,1,0,0,0,17,9,8,0,0,0,1,1,0,0,0,0
190512,35000,350,0,-2,2,0,2,0,0,0,1,0,1,0,0,0,1,0,1,0,0,0,0,0,0,0,0,0,0,0,0,0,0,0
190521,35000,350,0,-2,21,14,7,0,0,0,0,0,0,16,11,5,5,3,2,0,0,0,0,0,0,0,0,0,0,0,0,0,0,0
190530,35000,350,0,-2,8,7,1,0,0,0,0,0,0,3,3,0,5,4,1,0,0,0,0,0,0,0,0,0,0,0,0,0,0,0
190549,35000,350,0,-2,1,1,0,0,0,0,0,0,0,0,0,0,1,1,0,0,0,0,0,0,0,0,0,0,0,0,0,0,0,0
190558,35000,350,0,-2,8,5,3,0,0,0,1,1,0,2,1,1,1,0,1,0,0,0,4,3,1,0,0,0,0,0,0,0,0,0
190567,35000,350,0,-2,4,4,0,0,0,0,0,0,0,0,0,0,3,3,0,0,0,0,1,1,0,0,0,0,0,0,0,0,0,0
190576,35000,350,0,-2,5,3,2,0,0,0,0,0,0,3,1,2,1,1,0,0,0,0,0,0,0,1,1,0,0,0,0,0,0,0
190585,35000,350,0,-2,14,9,5,0,0,0,0,0,0,2,2,0,10,6,4,0,0,0,2,1,1,0,0,0,0,0,0,0,0,0
190594,35000,350,0,-2,9,6,3,0,0,0,3,3,0,3,2,1,1,0,1,0,0,0,2,1,1,0,0,0,0,0,0,0,0,0
190600,35000,350,0,-2,6,4,2,0,0,0,2,2,0,1,1,0,3,1,2,0,0,0,0,0,0,0,0,0,0,0,0,0,0,0
190619,35000,350,0,-2,8,4,4,0,0,0,1,1,0,4,1,3,2,2,0,1,0,1,0,0,0,0,0,0,0,0,0,0,0,0
190628,35000,350,0,-2,14,11,3,1,0,1,4,4,0,3,3,0,6,4,2,0,0,0,0,0,0,0,0,0,0,0,0,0,0,0
190637,35000,350,0,-2,17,14,3,0,0,0,2,2,0,10,9,1,5,3,2,0,0,0,0,0,0,0,0,0,0,0,0,0,0,0
190646,35000,350,0,-2,1,1,0,0,0,0,0,0,0,0,0,0,1,1,0,0,0,0,0,0,0,0,0,0,0,0,0,0,0,0
190655,35000,350,0,-2,6,3,3,0,0,0,0,0,0,4,2,2,2,1,1,0,0,0,0,0,0,0,0,0,0,0,0,0,0,0
190664,35000,350,0,-2,3,1,2,0,0,0,1,0,1,1,1,0,1,0,1,0,0,0,0,0,0,0,0,0,0,0,0,0,0,0
190673,35000,350,0,-2,5,4,1,0,0,0,2,2,0,1,1,0,2,1,1,0,0,0,0,0,0,0,0,0,0,0,0,0,0,0
190691,35000,350,0,-2,6,5,1,0,0,0,3,3,0,2,2,0,0,0,0,0,0,0,0,0,0,1,0,1,0,0,0,0,0,0
190725,35000,350,0,-2,4,4,0,0,0,0,0,0,0,1,1,0,1,1,0,0,0,0,2,2,0,0,0,0,0,0,0,0,0,0
190840,35000,350,0,-2,7,5,2,0,0,0,0,0,0,1,1,0,2,1,1,0,0,0,2,1,1,0,0,0,1,1,0,1,1,0
190983,35000,350,0,-2,6,3,3,1,0,1,0,0,0,0,0,0,0,0,0,0,0,0,5,3,2,0,0,0,0,0,0,0,0,0
191083,35000,350,0,-2,1,1,0,0,0,0,0,0,0,0,0,0,0,0,0,0,0,0,1,1,0,0,0,0,0,0,0,0,0,0
191199,35000,350,0,-2,1,1,0,0,0,0,0,0,0,0,0,0,0,0,0,0,0,0,1,1,0,0,0,0,0,0,0,0,0,0
191241,35000,350,0,-2,7,6,1,0,0,0,0,0,0,0,0,0,3,3,0,0,0,0,4,3,1,0,0,0,0,0,0,0,0,0
191302,35000,350,0,-2,1,0,1,0,0,0,0,0,0,0,0,0,0,0,0,0,0,0,1,0,1,0,0,0,0,0,0,0,0,0
191339,35000,350,0,-2,9,5,4,0,0,0,0,0,0,0,0,0,0,0,0,0,0,0,9,5,4,0,0,0,0,0,0,0,0,0
191515,35000,350,0,-2,13,9,4,0,0,0,0,0,0,0,0,0,0,0,0,0,0,0,10,7,3,0,0,0,3,2,1,0,0,0
191533,35000,350,0,-2,5,2,3,0,0,0,0,0,0,0,0,0,0,0,0,0,0,0,4,2,2,0,0,0,1,0,1,0,0,0
191630,35000,350,0,-2,8,6,2,0,0,0,0,0,0,4,3,1,0,0,0,0,0,0,4,3,1,0,0,0,0,0,0,0,0,0
191649,35000,350,0,-2,9,6,3,0,0,0,1,1,0,2,0,2,3,3,0,0,0,0,2,1,1,0,0,0,0,0,0,1,1,0
191676,35000,350,0,-2,2,1,1,0,0,0,0,0,0,0,0,0,1,0,1,0,0,0,1,1,0,0,0,0,0,0,0,0,0,0
191719,35000,350,0,-2,7,4,3,0,0,0,0,0,0,0,0,0,0,0,0,0,0,0,7,4,3,0,0,0,0,0,0,0,0,0
191931,35000,350,0,-2,14,9,5,0,0,0,0,0,0,2,1,1,6,2,4,0,0,0,5,5,0,0,0,0,1,1,0,0,0,0
191968,35000,350,0,-2,56,28,28,0,0,0,0,0,0,3,2,1,0,0,0,2,1,1,21,8,13,0,0,0,30,17,13,0,0,0
192040,35000,350,0,-2,1,1,0,0,0,0,0,0,0,1,1,0,0,0,0,0,0,0,0,0,0,0,0,0,0,0,0,0,0,0
192110,35000,350,0,-2,1,1,0,0,0,0,0,0,0,0,0,0,0,0,0,0,0,0,1,1,0,0,0,0,0,0,0,0,0,0
192192,35000,350,0,-2,2,2,0,0,0,0,0,0,0,0,0,0,1,1,0,0,0,0,1,1,0,0,0,0,0,0,0,0,0,0
192448,35000,350,0,-2,4,4,0,0,0,0,0,0,0,1,1,0,0,0,0,0,0,0,3,3,0,0,0,0,0,0,0,0,0,0
192703,35000,350,0,-2,8,7,1,0,0,0,1,1,0,4,3,1,2,2,0,0,0,0,1,1,0,0,0,0,0,0,0,0,0,0
192712,35000,350,0,-2,1,1,0,0,0,0,0,0,0,0,0,0,0,0,0,0,0,0,1,1,0,0,0,0,0,0,0,0,0,0
192819,35000,350,0,-2,14,9,5,0,0,0,0,0,0,4,2,2,2,1,1,0,0,0,8,6,2,0,0,0,0,0,0,0,0,0
192864,35000,350,0,-2,2,2,0,0,0,0,0,0,0,0,0,0,0,0,0,0,0,0,0,0,0,0,0,0,2,2,0,0,0,0
193016,35000,350,0,-2,1,1,0,0,0,0,0,0,0,0,0,0,1,1,0,0,0,0,0,0,0,0,0,0,0,0,0,0,0,0
193283,35000,350,0,-2,4,4,0,0,0,0,0,0,0,2,2,0,0,0,0,0,0,0,2,2,0,0,0,0,0,0,0,0,0,0
193292,35000,350,0,-2,4,4,0,0,0,0,0,0,0,0,0,0,1,1,0,0,0,0,3,3,0,0,0,0,0,0,0,0,0,0
193308,35000,350,0,-2,1,1,0,0,0,0,0,0,0,1,1,0,0,0,0,0,0,0,0,0,0,0,0,0,0,0,0,0,0,0
193326,35000,350,0,-2,4,1,3,0,0,0,0,0,0,0,0,0,1,0,1,0,0,0,3,1,2,0,0,0,0,0,0,0,0,0
193353,35000,350,0,-2,4,3,1,0,0,0,0,0,0,2,2,0,2,1,1,0,0,0,0,0,0,0,0,0,0,0,0,0,0,0
193399,35000,350,0,-2,31,15,16,0,0,0,0,0,0,5,4,1,24,9,15,0,0,0,1,1,0,0,0,0,1,1,0,0,0,0
193405,35000,350,0,-2,135,10,125,0,0,0,4,0,4,14,0,14,62,3,59,0,0,0,3,2,1,1,1,0,50,3,47,1,1,0
193584,35000,350,0,-2,2,2,0,0,0,0,0,0,0,0,0,0,0,0,0,0,0,0,2,2,0,0,0,0,0,0,0,0,0,0
193654,35000,350,0,-2,11,7,4,0,0,0,0,0,0,6,3,3,3,3,0,0,0,0,1,1,0,1,0,1,0,0,0,0,0,0
193751,35000,350,0,-2,1,1,0,0,0,0,0,0,0,0,0,0,0,0,0,0,0,0,1,1,0,0,0,0,0,0,0,0,0,0
193830,35000,350,0,-2,4,4,0,0,0,0,1,1,0,1,1,0,1,1,0,0,0,0,1,1,0,0,0,0,0,0,0,0,0,0
193900,35000,350,0,-2,52,34,18,0,0,0,3,2,1,22,11,11,17,13,4,0,0,0,5,3,2,0,0,0,4,4,0,1,1,0
193946,35000,350,0,-2,4,4,0,0,0,0,0,0,0,0,0,0,0,0,0,0,0,0,4,4,0,0,0,0,0,0,0,0,0,0
193973,35000,350,0,-2,4,2,2,1,1,0,0,0,0,1,0,1,0,0,0,0,0,0,2,1,1,0,0,0,0,0,0,0,0,0
194028,35000,350,0,-2,2,0,2,0,0,0,0,0,0,0,0,0,0,0,0,0,0,0,2,0,2,0,0,0,0,0,0,0,0,0
194091,35000,350,0,-2,5,3,2,0,0,0,0,0,0,0,0,0,4,2,2,0,0,0,1,1,0,0,0,0,0,0,0,0,0,0
194161,35000,350,0,-2,1,1,0,0,0,0,0,0,0,0,0,0,1,1,0,0,0,0,0,0,0,0,0,0,0,0,0,0,0,0
194222,35000,350,0,-2,9,7,2,0,0,0,1,1,0,2,1,1,0,0,0,0,0,0,6,5,1,0,0,0,0,0,0,0,0,0
194240,35000,350,0,-2,1,1,0,0,0,0,0,0,0,0,0,0,0,0,0,0,0,0,1,1,0,0,0,0,0,0,0,0,0,0
194310,35000,350,0,-2,7,3,4,0,0,0,1,0,1,5,3,2,1,0,1,0,0,0,0,0,0,0,0,0,0,0,0,0,0,0
194392,35000,350,0,-2,3,1,2,0,0,0,0,0,0,0,0,0,0,0,0,0,0,0,3,1,2,0,0,0,0,0,0,0,0,0
194763,35000,350,0,-2,2,2,0,0,0,0,0,0,0,0,0,0,2,2,0,0,0,0,0,0,0,0,0,0,0,0,0,0,0,0
194824,35000,350,0,-2,32,21,11,0,0,0,1,1,0,5,3,2,5,3,2,0,0,0,21,14,7,0,0,0,0,0,0,0,0,0
194958,35000,350,0,-2,6,4,2,0,0,0,0,0,0,1,0,1,0,0,0,0,0,0,4,3,1,0,0,0,1,1,0,0,0,0
195003,35000,350,0,-2,35,20,15,0,0,0,0,0,0,7,5,2,4,3,1,0,0,0,23,12,11,1,0,1,0,0,0,0,0,0
195030,35000,350,0,-2,43,21,22,0,0,0,2,0,2,13,8,5,0,0,0,0,0,0,24,12,12,4,1,3,0,0,0,0,0,0
195049,35000,350,0,-2,8,6,2,0,0,0,0,0,0,2,2,0,4,2,2,0,0,0,2,2,0,0,0,0,0,0,0,0,0,0
195058,35000,350,0,-2,6,6,0,0,0,0,0,0,0,2,2,0,1,1,0,0,0,0,3,3,0,0,0,0,0,0,0,0,0,0
195128,35000,350,0,-2,6,4,2,0,0,0,0,0,0,0,0,0,0,0,0,0,0,0,6,4,2,0,0,0,0,0,0,0,0,0
195164,35000,350,0,-2,15,12,3,0,0,0,0,0,0,0,0,0,1,1,0,0,0,0,14,11,3,0,0,0,0,0,0,0,0,0
195173,35000,350,0,-2,1,1,0,0,0,0,1,1,0,0,0,0,0,0,0,0,0,0,0,0,0,0,0,0,0,0,0,0,0,0
195216,35000,350,0,-2,13,8,5,0,0,0,0,0,0,1,1,0,0,0,0,0,0,0,12,7,5,0,0,0,0,0,0,0,0,0
195234,35000,350,0,-2,9,7,2,0,0,0,0,0,0,3,3,0,0,0,0,0,0,0,5,4,1,0,0,0,1,0,1,0,0,0
195243,35000,350,0,-2,1,0,1,0,0,0,0,0,0,0,0,0,0,0,0,0,0,0,1,0,1,0,0,0,0,0,0,0,0,0
195304,35000,350,0,-2,10,8,2,0,0,0,0,0,0,4,3,1,1,1,0,0,0,0,5,4,1,0,0,0,0,0,0,0,0,0
195322,35000,350,0,-2,2,1,1,0,0,0,0,0,0,1,1,0,0,0,0,0,0,0,1,0,1,0,0,0,0,0,0,0,0,0
195438,35000,350,0,-2,1,1,0,0,0,0,0,0,0,0,0,0,1,1,0,0,0,0,0,0,0,0,0,0,0,0,0,0,0,0
195474,35000,350,0,-2,12,8,4,0,0,0,1,1,0,0,0,0,0,0,0,0,0,0,10,6,4,0,0,0,0,0,0,1,1,0
195526,35000,350,0,-2,16,12,4,1,1,0,0,0,0,4,4,0,0,0,0,0,0,0,11,7,4,0,0,0,0,0,0,0,0,0
195544,35000,350,0,-2,4,3,1,0,0,0,1,1,0,0,0,0,2,1,1,0,0,0,1,1,0,0,0,0,0,0,0,0,0,0
195720,35000,350,0,-2,11,6,5,0,0,0,0,0,0,3,1,2,0,0,0,0,0,0,8,5,3,0,0,0,0,0,0,0,0,0
195809,35000,350,0,-2,5,3,2,0,0,0,0,0,0,1,1,0,3,2,1,0,0,0,0,0,0,0,0,0,1,0,1,0,0,0
195827,35000,350,0,-2,3,2,1,0,0,0,0,0,0,1,1,0,0,0,0,0,0,0,1,1,0,1,0,1,0,0,0,0,0,0
195988,35000,350,0,-2,1,1,0,0,0,0,0,0,0,0,0,0,0,0,0,0,0,0,1,1,0,0,0,0,0,0,0,0,0,0
196006,35000,350,0,-2,20,12,8,0,0,0,0,0,0,1,1,0,2,2,0,0,0,0,17,9,8,0,0,0,0,0,0,0,0,0
196015,35000,350,0,-2,6,6,0,0,0,0,1,1,0,0,0,0,0,0,0,0,0,0,4,4,0,1,1,0,0,0,0,0,0,0
196024,35000,350,0,-2,5,2,3,0,0,0,0,0,0,0,0,0,0,0,0,0,0,0,5,2,3,0,0,0,0,0,0,0,0,0
196033,35000,350,0,-2,7,3,4,0,0,0,0,0,0,1,0,1,0,0,0,0,0,0,6,3,3,0,0,0,0,0,0,0,0,0
196042,35000,350,0,-2,23,17,6,0,0,0,0,0,0,2,0,2,8,6,2,0,0,0,12,11,1,0,0,0,0,0,0,1,0,1
196051,35000,350,0,-2,7,5,2,1,1,0,0,0,0,1,1,0,0,0,0,0,0,0,4,3,1,1,0,1,0,0,0,0,0,0
196060,35000,350,0,-2,28,13,15,0,0,0,8,1,7,0,0,0,3,2,1,0,0,0,14,8,6,1,0,1,0,0,0,2,2,0
196079,35000,350,0,-2,51,35,16,0,0,0,0,0,0,2,1,1,1,1,0,0,0,0,40,25,15,0,0,0,0,0,0,8,8,0
196088,35000,350,0,-2,49,30,19,0,0,0,0,0,0,19,10,9,1,0,1,0,0,0,28,20,8,0,0,0,0,0,0,1,0,1
196097,35000,350,0,-2,40,22,18,0,0,0,2,0,2,8,6,2,2,0,2,0,0,0,25,15,10,1,1,0,2,0,2,0,0,0
196103,35000,350,0,-2,2,2,0,0,0,0,0,0,0,0,0,0,0,0,0,0,0,0,2,2,0,0,0,0,0,0,0,0,0,0
196112,35000,350,0,-2,1,0,1,0,0,0,0,0,0,0,0,0,0,0,0,0,0,0,1,0,1,0,0,0,0,0,0,0,0,0
196121,35000,350,0,-2,14,5,9,0,0,0,0,0,0,1,0,1,0,0,0,0,0,0,13,5,8,0,0,0,0,0,0,0,0,0
196130,35000,350,0,-2,28,15,13,0,0,0,0,0,0,6,4,2,2,2,0,0,0,0,20,9,11,0,0,0,0,0,0,0,0,0
196149,35000,350,0,-2,13,6,7,0,0,0,0,0,0,2,2,0,0,0,0,0,0,0,11,4,7,0,0,0,0,0,0,0,0,0
196158,35000,350,0,-2,6,2,4,0,0,0,0,0,0,0,0,0,0,0,0,0,0,0,6,2,4,0,0,0,0,0,0,0,0,0
196167,35000,350,0,-2,22,12,10,0,0,0,0,0,0,0,0,0,1,1,0,0,0,0,21,11,10,0,0,0,0,0,0,0,0,0
196176,35000,350,0,-2,6,0,6,0,0,0,0,0,0,1,0,1,2,0,2,0,0,0,3,0,3,0,0,0,0,0,0,0,0,0
196185,35000,350,0,-2,30,18,12,0,0,0,0,0,0,2,2,0,3,3,0,0,0,0,24,12,12,1,1,0,0,0,0,0,0,0
196194,35000,350,0,-2,6,5,1,0,0,0,0,0,0,1,1,0,0,0,0,0,0,0,5,4,1,0,0,0,0,0,0,0,0,0
196200,35000,350,0,-2,8,5,3,0,0,0,0,0,0,0,0,0,0,0,0,0,0,0,8,5,3,0,0,0,0,0,0,0,0,0
196219,35000,350,0,-2,17,8,9,0,0,0,0,0,0,2,0,2,8,3,5,0,0,0,6,5,1,0,0,0,0,0,0,1,0,1
196228,35000,350,0,-2,7,5,2,0,0,0,0,0,0,4,2,2,3,3,0,0,0,0,0,0,0,0,0,0,0,0,0,0,0,0
196237,35000,350,0,-2,7,2,5,0,0,0,0,0,0,1,1,0,1,0,1,0,0,0,5,1,4,0,0,0,0,0,0,0,0,0
196246,35000,350,0,-2,5,4,1,0,0,0,0,0,0,0,0,0,1,1,0,0,0,0,4,3,1,0,0,0,0,0,0,0,0,0
196255,35000,350,0,-2,13,10,3,0,0,0,0,0,0,10,7,3,3,3,0,0,0,0,0,0,0,0,0,0,0,0,0,0,0,0
196291,35000,350,0,-2,3,2,1,0,0,0,0,0,0,0,0,0,3,2,1,0,0,0,0,0,0,0,0,0,0,0,0,0,0,0
196307,35000,350,0,-2,4,4,0,0,0,0,0,0,0,0,0,0,0,0,0,0,0,0,4,4,0,0,0,0,0,0,0,0,0,0
196413,35000,350,0,-2,42,23,19,0,0,0,1,1,0,9,5,4,1,0,1,0,0,0,28,14,14,3,3,0,0,0,0,0,0,0
196431,35000,350,0,-2,1,1,0,0,0,0,0,0,0,1,1,0,0,0,0,0,0,0,0,0,0,0,0,0,0,0,0,0,0,0
196468,35000,350,0,-2,7,6,1,0,0,0,0,0,0,1,1,0,4,3,1,0,0,0,1,1,0,0,0,0,0,0,0,1,1,0
196592,35000,350,0,-2,4,2,2,0,0,0,0,0,0,0,0,0,2,0,2,0,0,0,1,1,0,0,0,0,1,1,0,0,0,0
196699,35000,350,0,-2,3,1,2,0,0,0,0,0,0,0,0,0,0,0,0,0,0,0,3,1,2,0,0,0,0,0,0,0,0,0
196866,35000,350,0,-2,25,15,10,0,0,0,2,1,1,4,2,2,1,0,1,0,0,0,15,10,5,3,2,1,0,0,0,0,0,0
197036,35000,350,0,-2,27,24,3,1,0,1,0,0,0,4,4,0,2,1,1,0,0,0,20,19,1,0,0,0,0,0,0,0,0,0
197045,35000,350,0,-2,2,1,1,0,0,0,0,0,0,0,0,0,0,0,0,0,0,0,2,1,1,0,0,0,0,0,0,0,0,0
197133,35000,350,0,-2,20,18,2,0,0,0,0,0,0,1,1,0,3,3,0,0,0,0,14,12,2,0,0,0,1,1,0,1,1,0
197151,35000,350,0,-2,5,2,3,0,0,0,0,0,0,5,2,3,0,0,0,0,0,0,0,0,0,0,0,0,0,0,0,0,0,0
197230,35000,350,0,-2,7,3,4,0,0,0,0,0,0,0,0,0,0,0,0,0,0,0,7,3,4,0,0,0,0,0,0,0,0,0
197294,35000,350,0,-2,1,1,0,0,0,0,0,0,0,0,0,0,0,0,0,0,0,0,1,1,0,0,0,0,0,0,0,0,0,0
197708,35000,350,0,-2,16,10,6,0,0,0,0,0,0,4,4,0,8,5,3,0,0,0,4,1,3,0,0,0,0,0,0,0,0,0
197735,35000,350,0,-2,7,7,0,0,0,0,0,0,0,0,0,0,4,4,0,0,0,0,3,3,0,0,0,0,0,0,0,0,0,0
197814,35000,350,0,-2,1,1,0,0,0,0,0,0,0,0,0,0,0,0,0,0,0,0,1,1,0,0,0,0,0,0,0,0,0,0
197869,35000,350,0,-2,43,22,21,1,1,0,1,0,1,3,2,1,0,0,0,0,0,0,36,19,17,2,0,2,0,0,0,0,0,0
197887,35000,350,0,-2,1,1,0,0,0,0,0,0,0,0,0,0,0,0,0,0,0,0,1,1,0,0,0,0,0,0,0,0,0,0
197911,35000,350,0,-2,10,3,7,0,0,0,0,0,0,4,1,3,2,0,2,0,0,0,2,1,1,1,1,0,1,0,1,0,0,0
197984,35000,350,0,-2,6,5,1,0,0,0,0,0,0,2,1,1,0,0,0,0,0,0,4,4,0,0,0,0,0,0,0,0,0,0
197993,35000,350,0,-2,8,5,3,0,0,0,0,0,0,7,5,2,0,0,0,0,0,0,1,0,1,0,0,0,0,0,0,0,0,0
198011,35000,350,0,-2,2,1,1,0,0,0,0,0,0,1,1,0,1,0,1,0,0,0,0,0,0,0,0,0,0,0,0,0,0,0
198039,35000,350,0,-2,4,4,0,0,0,0,0,0,0,1,1,0,0,0,0,0,0,0,3,3,0,0,0,0,0,0,0,0,0,0
198066,35000,350,0,-2,16,11,5,0,0,0,0,0,0,0,0,0,3,2,1,0,0,0,13,9,4,0,0,0,0,0,0,0,0,0
198084,35000,350,0,-2,5,4,1,0,0,0,0,0,0,0,0,0,0,0,0,0,0,0,5,4,1,0,0,0,0,0,0,0,0,0
198118,35000,350,0,-2,1,0,1,0,0,0,0,0,0,1,0,1,0,0,0,0,0,0,0,0,0,0,0,0,0,0,0,0,0,0
198136,35000,350,0,-2,10,7,3,1,0,1,0,0,0,1,1,0,0,0,0,0,0,0,8,6,2,0,0,0,0,0,0,0,0,0
198154,35000,350,0,-2,3,0,3,0,0,0,0,0,0,1,0,1,2,0,2,0,0,0,0,0,0,0,0,0,0,0,0,0,0,0
198206,35000,350,0,-2,3,2,1,0,0,0,0,0,0,2,1,1,0,0,0,0,0,0,1,1,0,0,0,0,0,0,0,0,0,0
198215,35000,350,0,-2,5,2,3,0,0,0,0,0,0,1,0,1,0,0,0,0,0,0,4,2,2,0,0,0,0,0,0,0,0,0
198251,35000,350,0,-2,2,0,2,0,0,0,1,0,1,1,0,1,0,0,0,0,0,0,0,0,0,0,0,0,0,0,0,0,0,0
198260,35000,350,0,-2,2,2,0,0,0,0,0,0,0,2,2,0,0,0,0,0,0,0,0,0,0,0,0,0,0,0,0,0,0,0
198303,35000,350,0,-2,4,4,0,0,0,0,0,0,0,1,1,0,0,0,0,0,0,0,3,3,0,0,0,0,0,0,0,0,0,0
198330,35000,350,0,-2,6,5,1,0,0,0,0,0,0,1,1,0,1,1,0,0,0,0,3,2,1,1,1,0,0,0,0,0,0,0
198376,35000,350,0,-2,5,3,2,0,0,0,0,0,0,1,1,0,0,0,0,0,0,0,4,2,2,0,0,0,0,0,0,0,0,0
198385,35000,350,0,-2,37,19,18,0,0,0,3,0,3,9,6,3,4,3,1,0,0,0,19,9,10,1,1,0,1,0,1,0,0,0
198419,35000,350,0,-2,19,9,10,0,0,0,0,0,0,10,4,6,1,1,0,0,0,0,6,3,3,1,1,0,1,0,1,0,0,0
198455,35000,350,0,-2,5,4,1,0,0,0,0,0,0,4,3,1,0,0,0,0,0,0,1,1,0,0,0,0,0,0,0,0,0,0
198464,35000,350,0,-2,63,16,47,1,0,1,1,0,1,17,3,14,27,9,18,0,0,0,15,4,11,0,0,0,2,0,2,0,0,0
198507,35000,350,0,-2,6,4,2,0,0,0,0,0,0,4,3,1,0,0,0,0,0,0,2,1,1,0,0,0,0,0,0,0,0,0
198516,35000,350,0,-2,16,10,6,0,0,0,0,0,0,4,2,2,0,0,0,0,0,0,11,7,4,0,0,0,1,1,0,0,0,0
198534,35000,350,0,-2,13,8,5,2,1,1,0,0,0,5,3,2,2,0,2,0,0,0,4,4,0,0,0,0,0,0,0,0,0,0
198543,35000,350,0,-2,13,11,2,1,1,0,0,0,0,8,6,2,0,0,0,0,0,0,4,4,0,0,0,0,0,0,0,0,0,0
198552,35000,350,0,-2,8,3,5,0,0,0,0,0,0,2,0,2,0,0,0,0,0,0,6,3,3,0,0,0,0,0,0,0,0,0
198561,35000,350,0,-2,16,8,8,0,0,0,0,0,0,4,2,2,1,1,0,0,0,0,11,5,6,0,0,0,0,0,0,0,0,0
198570,35000,350,0,-2,2,1,1,0,0,0,0,0,0,1,0,1,0,0,0,0,0,0,1,1,0,0,0,0,0,0,0,0,0,0
198598,35000,350,0,-2,3,2,1,0,0,0,0,0,0,1,1,0,0,0,0,0,0,0,2,1,1,0,0,0,0,0,0,0,0,0
198613,35000,350,0,-2,4,1,3,0,0,0,0,0,0,2,0,2,0,0,0,0,0,0,2,1,1,0,0,0,0,0,0,0,0,0
198622,35000,350,0,-2,19,8,11,0,0,0,0,0,0,15,5,10,0,0,0,0,0,0,4,3,1,0,0,0,0,0,0,0,0,0
198668,35000,350,0,-2,5,2,3,0,0,0,0,0,0,0,0,0,0,0,0,0,0,0,5,2,3,0,0,0,0,0,0,0,0,0
198695,35000,350,0,-2,17,13,4,0,0,0,1,1,0,4,2,2,0,0,0,0,0,0,11,9,2,1,1,0,0,0,0,0,0,0
198710,35000,350,0,-2,1,1,0,0,0,0,0,0,0,0,0,0,0,0,0,0,0,0,1,1,0,0,0,0,0,0,0,0,0,0
198756,35000,350,0,-2,6,4,2,0,0,0,0,0,0,3,1,2,0,0,0,0,0,0,3,3,0,0,0,0,0,0,0,0,0,0
198774,35000,350,0,-2,5,2,3,0,0,0,0,0,0,0,0,0,1,0,1,0,0,0,4,2,2,0,0,0,0,0,0,0,0,0
198808,35000,350,0,-2,3,3,0,0,0,0,0,0,0,0,0,0,0,0,0,0,0,0,3,3,0,0,0,0,0,0,0,0,0,0
198817,35000,350,0,-2,5,5,0,0,0,0,0,0,0,3,3,0,0,0,0,0,0,0,2,2,0,0,0,0,0,0,0,0,0,0
198862,35000,350,0,-2,4,2,2,0,0,0,0,0,0,4,2,2,0,0,0,0,0,0,0,0,0,0,0,0,0,0,0,0,0,0
198871,35000,350,0,-2,2,1,1,0,0,0,0,0,0,0,0,0,0,0,0,0,0,0,2,1,1,0,0,0,0,0,0,0,0,0
198899,35000,350,0,-2,2,2,0,0,0,0,0,0,0,1,1,0,0,0,0,0,0,0,1,1,0,0,0,0,0,0,0,0,0,0
198905,35000,350,0,-2,1,1,0,0,0,0,0,0,0,0,0,0,0,0,0,0,0,0,1,1,0,0,0,0,0,0,0,0,0,0
198950,35000,350,0,-2,4,1,3,0,0,0,0,0,0,1,0,1,1,0,1,0,0,0,2,1,1,0,0,0,0,0,0,0,0,0
198969,35000,350,0,-2,7,4,3,0,0,0,0,0,0,1,1,0,0,0,0,0,0,0,6,3,3,0,0,0,0,0,0,0,0,0
199087,35000,350,0,-2,2,1,1,0,0,0,0,0,0,1,1,0,0,0,0,0,0,0,1,0,1,0,0,0,0,0,0,0,0,0
199102,35000,350,0,-2,15,8,7,0,0,0,0,0,0,8,5,3,1,0,1,0,0,0,0,0,0,0,0,0,6,3,3,0,0,0
199111,35000,350,0,-2,17,6,11,0,0,0,0,0,0,2,0,2,0,0,0,0,0,0,14,6,8,1,0,1,0,0,0,0,0,0
199120,35000,350,0,-2,60,20,40,0,0,0,9,4,5,12,5,7,1,1,0,0,0,0,19,6,13,1,0,1,18,4,14,0,0,0
199139,35000,350,0,-2,33,23,10,1,1,0,1,0,1,16,12,4,5,3,2,0,0,0,10,7,3,0,0,0,0,0,0,0,0,0
199148,35000,350,0,-2,27,17,10,0,0,0,2,1,1,11,8,3,0,0,0,0,0,0,11,7,4,1,0,1,1,0,1,1,1,0
199157,35000,350,0,-2,32,24,8,0,0,0,0,0,0,11,10,1,1,1,0,0,0,0,1,1,0,0,0,0,19,12,7,0,0,0
199184,35000,350,0,-2,12,8,4,0,0,0,0,0,0,6,4,2,0,0,0,0,0,0,4,2,2,0,0,0,2,2,0,0,0,0
199193,35000,350,0,-2,117,51,66,1,1,0,2,0,2,33,20,13,12,4,8,2,1,1,56,21,35,8,3,5,3,1,2,0,0,0
199209,35000,350,0,-2,2,2,0,0,0,0,0,0,0,2,2,0,0,0,0,0,0,0,0,0,0,0,0,0,0,0,0,0,0,0
199218,35000,350,0,-2,19,13,6,0,0,0,0,0,0,5,5,0,2,0,2,0,0,0,10,6,4,0,0,0,2,2,0,0,0,0
199281,35000,350,0,-2,16,7,9,11,6,5,0,0,0,2,0,2,0,0,0,0,0,0,3,1,2,0,0,0,0,0,0,0,0,0
199306,35000,350,0,-2,1,0,1,0,0,0,0,0,0,1,0,1,0,0,0,0,0,0,0,0,0,0,0,0,0,0,0,0,0,0
199324,35000,350,0,-2,1,0,1,0,0,0,0,0,0,0,0,0,0,0,0,0,0,0,1,0,1,0,0,0,0,0,0,0,0,0
199333,35000,350,0,-2,1,1,0,0,0,0,0,0,0,1,1,0,0,0,0,0,0,0,0,0,0,0,0,0,0,0,0,0,0,0
199412,35000,350,0,-2,4,4,0,0,0,0,0,0,0,2,2,0,0,0,0,0,0,0,2,2,0,0,0,0,0,0,0,0,0,0
199421,35000,350,0,-2,1,0,1,0,0,0,0,0,0,0,0,0,0,0,0,0,0,0,1,0,1,0,0,0,0,0,0,0,0,0
199449,35000,350,0,-2,3,3,0,0,0,0,0,0,0,1,1,0,0,0,0,0,0,0,2,2,0,0,0,0,0,0,0,0,0,0
199485,35000,350,0,-2,2,2,0,0,0,0,0,0,0,0,0,0,1,1,0,0,0,0,1,1,0,0,0,0,0,0,0,0,0,0
199582,35000,350,0,-2,5,4,1,0,0,0,0,0,0,1,1,0,0,0,0,0,0,0,0,0,0,0,0,0,4,3,1,0,0,0
199625,35000,350,0,-2,2,1,1,0,0,0,0,0,0,0,0,0,0,0,0,0,0,0,2,1,1,0,0,0,0,0,0,0,0,0
199634,35000,350,0,-2,1,0,1,0,0,0,0,0,0,0,0,0,0,0,0,0,0,0,1,0,1,0,0,0,0,0,0,0,0,0
199643,35000,350,0,-2,3,3,0,0,0,0,0,0,0,3,3,0,0,0,0,0,0,0,0,0,0,0,0,0,0,0,0,0,0,0
199698,35000,350,0,-2,5,2,3,0,0,0,0,0,0,0,0,0,0,0,0,0,0,0,5,2,3,0,0,0,0,0,0,0,0,0
199722,35000,350,0,-2,2,0,2,0,0,0,0,0,0,0,0,0,0,0,0,0,0,0,2,0,2,0,0,0,0,0,0,0,0,0
199731,35000,350,0,-2,5,4,1,1,0,1,0,0,0,0,0,0,0,0,0,0,0,0,4,4,0,0,0,0,0,0,0,0,0,0
199740,35000,350,0,-2,1,1,0,0,0,0,0,0,0,1,1,0,0,0,0,0,0,0,0,0,0,0,0,0,0,0,0,0,0,0
199768,35000,350,0,-2,2,1,1,0,0,0,0,0,0,0,0,0,0,0,0,0,0,0,2,1,1,0,0,0,0,0,0,0,0,0
199786,35000,350,0,-2,1,1,0,0,0,0,0,0,0,1,1,0,0,0,0,0,0,0,0,0,0,0,0,0,0,0,0,0,0,0
199795,35000,350,0,-2,3,3,0,0,0,0,0,0,0,0,0,0,0,0,0,0,0,0,3,3,0,0,0,0,0,0,0,0,0,0
199838,35000,350,0,-2,3,3,0,0,0,0,0,0,0,3,3,0,0,0,0,0,0,0,0,0,0,0,0,0,0,0,0,0,0,0
199847,35000,350,0,-2,37,21,16,0,0,0,0,0,0,18,9,9,3,1,2,0,0,0,13,11,2,2,0,2,1,0,1,0,0,0
199856,35000,350,0,-2,2,2,0,0,0,0,0,0,0,0,0,0,0,0,0,0,0,0,2,2,0,0,0,0,0,0,0,0,0,0
199865,35000,350,0,-2,6,3,3,0,0,0,0,0,0,0,0,0,1,1,0,0,0,0,4,2,2,0,0,0,1,0,1,0,0,0
199892,35000,350,0,-2,6,4,2,0,0,0,0,0,0,4,3,1,1,1,0,0,0,0,1,0,1,0,0,0,0,0,0,0,0,0
199926,35000,350,0,-2,2,2,0,0,0,0,0,0,0,0,0,0,0,0,0,0,0,0,2,2,0,0,0,0,0,0,0,0,0,0
199953,35000,350,0,-2,2,1,1,0,0,0,0,0,0,1,1,0,1,0,1,0,0,0,0,0,0,0,0,0,0,0,0,0,0,0
199962,35000,350,0,-2,5,1,4,0,0,0,0,0,0,0,0,0,5,1,4,0,0,0,0,0,0,0,0,0,0,0,0,0,0,0
199999,35000,350,0,-2,13,5,8,0,0,0,0,0,0,3,0,3,0,0,0,0,0,0,1,1,0,0,0,0,9,4,5,0,0,0
200004,35000,350,0,-2,17,9,8,0,0,0,0,0,0,0,0,0,1,1,0,0,0,0,15,8,7,1,0,1,0,0,0,0,0,0
200022,35000,350,0,-2,4,1,3,0,0,0,0,0,0,1,1,0,0,0,0,0,0,0,3,0,3,0,0,0,0,0,0,0,0,0
200192,35000,350,0,-2,4,2,2,0,0,0,0,0,0,0,0,0,0,0,0,0,0,0,3,2,1,1,0,1,0,0,0,0,0,0
200208,35000,350,0,-2,1,1,0,1,1,0,0,0,0,0,0,0,0,0,0,0,0,0,0,0,0,0,0,0,0,0,0,0,0,0
200217,35000,350,0,-2,5,4,1,0,0,0,0,0,0,0,0,0,0,0,0,0,0,0,5,4,1,0,0,0,0,0,0,0,0,0
200226,35000,350,0,-2,1,0,1,0,0,0,0,0,0,0,0,0,0,0,0,0,0,0,1,0,1,0,0,0,0,0,0,0,0,0
200253,35000,350,0,-2,2,2,0,0,0,0,0,0,0,0,0,0,0,0,0,0,0,0,2,2,0,0,0,0,0,0,0,0,0,0
200280,35000,350,0,-2,35,20,15,1,1,0,4,2,2,3,2,1,1,0,1,1,1,0,22,13,9,3,1,2,0,0,0,0,0,0
200305,35000,350,0,-2,6,5,1,0,0,0,0,0,0,0,0,0,0,0,0,0,0,0,6,5,1,0,0,0,0,0,0,0,0,0
200314,35000,350,0,-2,1,1,0,0,0,0,0,0,0,0,0,0,0,0,0,0,0,0,1,1,0,0,0,0,0,0,0,0,0,0
200332,35000,350,0,-2,57,27,30,4,3,1,20,8,12,3,1,2,2,0,2,0,0,0,25,13,12,1,0,1,2,2,0,0,0,0
200341,35000,350,0,-2,2,2,0,0,0,0,0,0,0,1,1,0,0,0,0,0,0,0,1,1,0,0,0,0,0,0,0,0,0,0
200466,35000,350,0,-2,2,0,2,2,0,2,0,0,0,0,0,0,0,0,0,0,0,0,0,0,0,0,0,0,0,0,0,0,0,0
200554,35000,350,0,-2,3,3,0,1,1,0,0,0,0,0,0,0,0,0,0,0,0,0,2,2,0,0,0,0,0,0,0,0,0,0
200572,35000,350,0,-2,6,4,2,0,0,0,0,0,0,0,0,0,0,0,0,1,1,0,5,3,2,0,0,0,0,0,0,0,0,0
200800,35000,350,0,-2,14,10,4,0,0,0,0,0,0,3,3,0,0,0,0,0,0,0,11,7,4,0,0,0,0,0,0,0,0,0
201061,35000,350,0,-2,3,2,1,0,0,0,0,0,0,1,1,0,0,0,0,0,0,0,1,1,0,1,0,1,0,0,0,0,0,0
201104,35000,350,0,-2,19,7,12,0,0,0,1,1,0,2,0,2,0,0,0,0,0,0,16,6,10,0,0,0,0,0,0,0,0,0
201140,35000,350,0,-2,2,1,1,0,0,0,0,0,0,0,0,0,0,0,0,0,0,0,2,1,1,0,0,0,0,0,0,0,0,0
201195,35000,350,0,-2,21,10,11,0,0,0,0,0,0,0,0,0,0,0,0,0,0,0,21,10,11,0,0,0,0,0,0,0,0,0
201283,35000,350,0,-2,2,2,0,0,0,0,0,0,0,0,0,0,0,0,0,0,0,0,2,2,0,0,0,0,0,0,0,0,0,0
201371,35000,350,0,-2,3,0,3,0,0,0,0,0,0,0,0,0,1,0,1,0,0,0,2,0,2,0,0,0,0,0,0,0,0,0
201441,35000,350,0,-2,13,10,3,0,0,0,0,0,0,0,0,0,1,1,0,0,0,0,12,9,3,0,0,0,0,0,0,0,0,0
201548,35000,350,0,-2,6,3,3,0,0,0,0,0,0,0,0,0,0,0,0,0,0,0,6,3,3,0,0,0,0,0,0,0,0,0
201645,35000,350,0,-2,45,24,21,0,0,0,1,0,1,23,12,11,5,2,3,0,0,0,16,10,6,0,0,0,0,0,0,0,0,0
201654,35000,350,0,-2,8,6,2,0,0,0,0,0,0,0,0,0,0,0,0,0,0,0,7,5,2,0,0,0,1,1,0,0,0,0
201672,35000,350,0,-2,4,4,0,0,0,0,0,0,0,2,2,0,0,0,0,0,0,0,2,2,0,0,0,0,0,0,0,0,0,0
201690,35000,350,0,-2,4,2,2,0,0,0,0,0,0,4,2,2,0,0,0,0,0,0,0,0,0,0,0,0,0,0,0,0,0,0
201885,35000,350,0,-2,64,29,35,1,0,1,0,0,0,26,10,16,1,0,1,0,0,0,33,19,14,1,0,1,2,0,2,0,0,0
201955,35000,350,0,-2,2,0,2,0,0,0,0,0,0,0,0,0,0,0,0,0,0,0,2,0,2,0,0,0,0,0,0,0,0,0
201973,35000,350,0,-2,4,4,0,0,0,0,0,0,0,0,0,0,0,0,0,0,0,0,4,4,0,0,0,0,0,0,0,0,0,0
202073,35000,350,0,-2,1,1,0,0,0,0,0,0,0,0,0,0,0,0,0,0,0,0,1,1,0,0,0,0,0,0,0,0,0,0
202134,35000,350,0,-2,4,4,0,0,0,0,0,0,0,1,1,0,1,1,0,0,0,0,2,2,0,0,0,0,0,0,0,0,0,0
202170,35000,350,0,-2,2,2,0,0,0,0,0,0,0,1,1,0,0,0,0,0,0,0,1,1,0,0,0,0,0,0,0,0,0,0
202222,35000,350,0,-2,1,1,0,0,0,0,0,0,0,1,1,0,0,0,0,0,0,0,0,0,0,0,0,0,0,0,0,0,0,0
202356,35000,350,0,-2,8,6,2,0,0,0,0,0,0,3,2,1,1,1,0,0,0,0,4,3,1,0,0,0,0,0,0,0,0,0
202480,35000,350,0,-2,30,18,12,0,0,0,1,1,0,4,4,0,1,1,0,0,0,0,18,10,8,2,2,0,3,0,3,1,0,1
202523,35000,350,0,-2,21,6,15,0,0,0,0,0,0,3,1,2,0,0,0,0,0,0,18,5,13,0,0,0,0,0,0,0,0,0
202648,35000,350,0,-2,2,1,1,0,0,0,0,0,0,0,0,0,0,0,0,0,0,0,1,0,1,0,0,0,1,1,0,0,0,0
202763,35000,350,0,-2,3,3,0,0,0,0,0,0,0,0,0,0,0,0,0,0,0,0,3,3,0,0,0,0,0,0,0,0,0,0
202903,35000,350,0,-2,5,2,3,0,0,0,0,0,0,0,0,0,0,0,0,0,0,0,5,2,3,0,0,0,0,0,0,0,0,0
203085,35000,350,0,-2,3,3,0,0,0,0,0,0,0,0,0,0,0,0,0,0,0,0,3,3,0,0,0,0,0,0,0,0,0,0
203128,35000,350,0,-2,3,1,2,0,0,0,0,0,0,0,0,0,1,0,1,0,0,0,2,1,1,0,0,0,0,0,0,0,0,0
203155,35000,350,0,-2,4,3,1,0,0,0,0,0,0,0,0,0,0,0,0,0,0,0,4,3,1,0,0,0,0,0,0,0,0,0
203368,35000,350,0,-2,1,0,1,0,0,0,0,0,0,0,0,0,0,0,0,0,0,0,1,0,1,0,0,0,0,0,0,0,0,0
203517,35000,350,0,-2,45,27,18,0,0,0,0,0,0,3,2,1,1,0,1,0,0,0,36,20,16,0,0,0,5,5,0,0,0,0
203535,35000,350,0,-2,13,6,7,1,0,1,0,0,0,0,0,0,1,1,0,0,0,0,3,1,2,0,0,0,8,4,4,0,0,0
203599,35000,350,0,-2,3,3,0,0,0,0,0,0,0,0,0,0,0,0,0,0,0,0,3,3,0,0,0,0,0,0,0,0,0,0
203678,35000,350,0,-2,8,0,8,0,0,0,0,0,0,0,0,0,0,0,0,0,0,0,7,0,7,1,0,1,0,0,0,0,0,0
203775,35000,350,0,-2,3,2,1,0,0,0,0,0,0,1,1,0,0,0,0,0,0,0,2,1,1,0,0,0,0,0,0,0,0,0
203845,35000,350,0,-2,3,1,2,1,1,0,0,0,0,0,0,0,0,0,0,0,0,0,2,0,2,0,0,0,0,0,0,0,0,0
204024,35000,350,0,-2,44,21,23,0,0,0,1,1,0,3,1,2,1,1,0,0,0,0,28,15,13,1,0,1,10,3,7,0,0,0
204176,35000,350,0,-2,1,1,0,0,0,0,0,0,0,0,0,0,0,0,0,0,0,0,1,1,0,0,0,0,0,0,0,0,0,0
204185,35000,350,0,-2,6,0,6,0,0,0,0,0,0,0,0,0,0,0,0,0,0,0,6,0,6,0,0,0,0,0,0,0,0,0
204194,35000,350,0,-2,12,6,6,0,0,0,0,0,0,0,0,0,0,0,0,0,0,0,11,6,5,0,0,0,1,0,1,0,0,0
204200,35000,350,0,-2,6,2,4,0,0,0,0,0,0,0,0,0,0,0,0,0,0,0,6,2,4,0,0,0,0,0,0,0,0,0
204264,35000,350,0,-2,5,1,4,0,0,0,0,0,0,0,0,0,0,0,0,0,0,0,5,1,4,0,0,0,0,0,0,0,0,0
204440,35000,350,0,-2,1,0,1,0,0,0,0,0,0,0,0,0,0,0,0,0,0,0,1,0,1,0,0,0,0,0,0,0,0,0
204468,35000,350,0,-2,1,1,0,0,0,0,0,0,0,0,0,0,0,0,0,0,0,0,1,1,0,0,0,0,0,0,0,0,0,0
204486,35000,350,0,-2,2,2,0,0,0,0,0,0,0,0,0,0,0,0,0,0,0,0,2,2,0,0,0,0,0,0,0,0,0,0
204501,35000,350,0,-2,16,10,6,0,0,0,0,0,0,2,2,0,0,0,0,0,0,0,12,7,5,0,0,0,1,1,0,1,0,1
204608,35000,350,0,-2,1,1,0,0,0,0,0,0,0,1,1,0,0,0,0,0,0,0,0,0,0,0,0,0,0,0,0,0,0,0
204617,35000,350,0,-2,6,5,1,0,0,0,0,0,0,1,1,0,1,1,0,0,0,0,3,2,1,0,0,0,1,1,0,0,0,0
204635,35000,350,0,-2,1,1,0,0,0,0,0,0,0,0,0,0,0,0,0,0,0,0,1,1,0,0,0,0,0,0,0,0,0,0
204705,35000,350,0,-2,1,0,1,0,0,0,0,0,0,0,0,0,0,0,0,0,0,0,1,0,1,0,0,0,0,0,0,0,0,0
204796,35000,350,0,-2,691,242,449,1,0,1,42,21,21,204,69,135,41,16,25,0,0,0,295,98,197,23,5,18,81,32,49,4,1,3
204857,35000,350,0,-2,19,9,10,0,0,0,0,0,0,1,1,0,0,0,0,0,0,0,18,8,10,0,0,0,0,0,0,0,0,0
204936,35000,350,0,-2,4,4,0,0,0,0,0,0,0,2,2,0,0,0,0,0,0,0,2,2,0,0,0,0,0,0,0,0,0,0
204945,35000,350,0,-2,2,2,0,0,0,0,0,0,0,0,0,0,0,0,0,0,0,0,2,2,0,0,0,0,0,0,0,0,0,0
205203,35000,350,0,-2,2,1,1,0,0,0,0,0,0,1,1,0,0,0,0,0,0,0,1,0,1,0,0,0,0,0,0,0,0,0
205443,35000,350,0,-2,3,2,1,0,0,0,0,0,0,0,0,0,0,0,0,0,0,0,3,2,1,0,0,0,0,0,0,0,0,0
205470,35000,350,0,-2,3,3,0,0,0,0,0,0,0,1,1,0,0,0,0,0,0,0,2,2,0,0,0,0,0,0,0,0,0,0
206048,35000,350,0,-2,3,2,1,0,0,0,0,0,0,0,0,0,0,0,0,0,0,0,3,2,1,0,0,0,0,0,0,0,0,0
206084,35000,350,0,-2,60,24,36,0,0,0,2,0,2,21,9,12,4,3,1,0,0,0,33,12,21,0,0,0,0,0,0,0,0,0
206437,35000,350,0,-2,1,1,0,0,0,0,0,0,0,0,0,0,0,0,0,0,0,0,1,1,0,0,0,0,0,0,0,0,0,0
206507,35000,350,0,-2,3,2,1,0,0,0,0,0,0,1,0,1,0,0,0,0,0,0,2,2,0,0,0,0,0,0,0,0,0,0
206525,35000,350,0,-2,7,3,4,0,0,0,0,0,0,0,0,0,0,0,0,0,0,0,7,3,4,0,0,0,0,0,0,0,0,0
206589,35000,350,0,-2,11,8,3,0,0,0,0,0,0,2,2,0,0,0,0,0,0,0,9,6,3,0,0,0,0,0,0,0,0,0
206604,35000,350,0,-2,12,8,4,0,0,0,0,0,0,4,3,1,0,0,0,0,0,0,8,5,3,0,0,0,0,0,0,0,0,0
206622,35000,350,0,-2,14,8,6,0,0,0,1,0,1,4,2,2,1,1,0,0,0,0,7,5,2,1,0,1,0,0,0,0,0,0
206695,35000,350,0,-2,8,4,4,0,0,0,0,0,0,0,0,0,0,0,0,0,0,0,8,4,4,0,0,0,0,0,0,0,0,0
206835,35000,350,0,-2,1,1,0,0,0,0,0,0,0,0,0,0,0,0,0,0,0,0,1,1,0,0,0,0,0,0,0,0,0,0
206862,35000,350,0,-2,5,4,1,0,0,0,0,0,0,0,0,0,0,0,0,1,1,0,4,3,1,0,0,0,0,0,0,0,0,0
206914,35000,350,0,-2,6,4,2,0,0,0,0,0,0,2,1,1,0,0,0,0,0,0,4,3,1,0,0,0,0,0,0,0,0,0
206923,35000,350,0,-2,1,0,1,0,0,0,0,0,0,0,0,0,0,0,0,0,0,0,1,0,1,0,0,0,0,0,0,0,0,0
206932,35000,350,0,-2,1,0,1,0,0,0,0,0,0,1,0,1,0,0,0,0,0,0,0,0,0,0,0,0,0,0,0,0,0,0
206941,35000,350,0,-2,9,5,4,0,0,0,0,0,0,0,0,0,0,0,0,0,0,0,4,2,2,0,0,0,5,3,2,0,0,0
207041,35000,350,0,-2,2,2,0,0,0,0,0,0,0,0,0,0,0,0,0,0,0,0,2,2,0,0,0,0,0,0,0,0,0,0
207050,35000,350,0,-2,2,1,1,1,0,1,0,0,0,0,0,0,0,0,0,0,0,0,1,1,0,0,0,0,0,0,0,0,0,0
207209,35000,350,0,-2,4,1,3,0,0,0,0,0,0,0,0,0,0,0,0,0,0,0,2,0,2,1,1,0,0,0,0,1,0,1
207236,35000,350,0,-2,3,1,2,0,0,0,0,0,0,0,0,0,1,0,1,0,0,0,2,1,1,0,0,0,0,0,0,0,0,0
207254,35000,350,0,-2,1,1,0,1,1,0,0,0,0,0,0,0,0,0,0,0,0,0,0,0,0,0,0,0,0,0,0,0,0,0
207263,35000,350,0,-2,26,14,12,8,2,6,0,0,0,1,1,0,2,2,0,0,0,0,13,9,4,1,0,1,1,0,1,0,0,0
207290,35000,350,0,-2,11,7,4,3,2,1,0,0,0,0,0,0,2,1,1,0,0,0,6,4,2,0,0,0,0,0,0,0,0,0
207306,35000,350,0,-2,3,1,2,0,0,0,0,0,0,1,1,0,0,0,0,0,0,0,2,0,2,0,0,0,0,0,0,0,0,0
207315,35000,350,0,-2,5,4,1,0,0,0,0,0,0,0,0,0,0,0,0,0,0,0,5,4,1,0,0,0,0,0,0,0,0,0
207324,35000,350,0,-2,4,2,2,0,0,0,0,0,0,0,0,0,0,0,0,0,0,0,4,2,2,0,0,0,0,0,0,0,0,0
207342,35000,350,0,-2,22,9,13,0,0,0,1,0,1,4,1,3,2,1,1,0,0,0,12,6,6,2,0,2,0,0,0,1,1,0
207388,35000,350,0,-2,48,23,25,3,2,1,0,0,0,3,1,2,3,2,1,0,0,0,35,17,18,4,1,3,0,0,0,0,0,0
207397,35000,350,0,-2,7,6,1,1,1,0,0,0,0,0,0,0,0,0,0,0,0,0,5,4,1,1,1,0,0,0,0,0,0,0
207403,35000,350,0,-2,2,2,0,0,0,0,0,0,0,0,0,0,0,0,0,0,0,0,2,2,0,0,0,0,0,0,0,0,0,0
207449,35000,350,0,-2,8,7,1,1,1,0,0,0,0,0,0,0,0,0,0,0,0,0,7,6,1,0,0,0,0,0,0,0,0,0
207458,35000,350,0,-2,7,5,2,0,0,0,0,0,0,2,2,0,1,1,0,0,0,0,3,1,2,0,0,0,0,0,0,1,1,0
207500,35000,350,0,-2,60,37,23,5,4,1,2,1,1,6,3,3,6,2,4,0,0,0,33,22,11,2,1,1,4,2,2,2,2,0
207564,35000,350,0,-2,10,7,3,0,0,0,0,0,0,2,1,1,0,0,0,0,0,0,6,4,2,2,2,0,0,0,0,0,0,0
207582,35000,350,0,-2,3,1,2,1,0,1,0,0,0,0,0,0,0,0,0,0,0,0,2,1,1,0,0,0,0,0,0,0,0,0
207661,35000,350,0,-2,4,4,0,0,0,0,0,0,0,0,0,0,1,1,0,0,0,0,2,2,0,1,1,0,0,0,0,0,0,0
207722,35000,350,0,-2,1,1,0,1,1,0,0,0,0,0,0,0,0,0,0,0,0,0,0,0,0,0,0,0,0,0,0,0,0,0
207740,35000,350,0,-2,1,1,0,0,0,0,0,0,0,0,0,0,0,0,0,0,0,0,1,1,0,0,0,0,0,0,0,0,0,0
207847,35000,350,0,-2,8,5,3,1,1,0,0,0,0,0,0,0,0,0,0,0,0,0,7,4,3,0,0,0,0,0,0,0,0,0
207865,35000,350,0,-2,12,9,3,0,0,0,0,0,0,0,0,0,0,0,0,0,0,0,11,9,2,1,0,1,0,0,0,0,0,0
207935,35000,350,0,-2,1,0,1,0,0,0,0,0,0,0,0,0,0,0,0,0,0,0,1,0,1,0,0,0,0,0,0,0,0,0
207971,35000,350,0,-2,6,4,2,0,0,0,1,1,0,0,0,0,0,0,0,0,0,0,3,1,2,1,1,0,1,1,0,0,0,0
208318,35000,350,0,-2,2,2,0,0,0,0,0,0,0,1,1,0,0,0,0,0,0,0,1,1,0,0,0,0,0,0,0,0,0,0
208390,35000,350,0,-2,4,2,2,0,0,0,0,0,0,1,0,1,0,0,0,0,0,0,2,2,0,0,0,0,1,0,1,0,0,0
208406,35000,350,0,-2,4,2,2,0,0,0,0,0,0,0,0,0,2,1,1,0,0,0,2,1,1,0,0,0,0,0,0,0,0,0
208646,35000,350,0,-2,3,1,2,0,0,0,0,0,0,0,0,0,0,0,0,0,0,0,3,1,2,0,0,0,0,0,0,0,0,0
208822,35000,350,0,-2,4,2,2,0,0,0,0,0,0,0,0,0,1,1,0,0,0,0,3,1,2,0,0,0,0,0,0,0,0,0
209056,35000,350,0,-2,4,4,0,0,0,0,0,0,0,0,0,0,2,2,0,0,0,0,2,2,0,0,0,0,0,0,0,0,0,0
209065,35000,350,0,-2,6,4,2,0,0,0,0,0,0,0,0,0,2,1,1,0,0,0,4,3,1,0,0,0,0,0,0,0,0,0
209074,35000,350,0,-2,4,3,1,1,1,0,0,0,0,0,0,0,0,0,0,0,0,0,2,1,1,0,0,0,1,1,0,0,0,0
209250,35000,350,0,-2,4,3,1,0,0,0,1,1,0,0,0,0,0,0,0,0,0,0,3,2,1,0,0,0,0,0,0,0,0,0
209287,35000,350,0,-2,2,2,0,0,0,0,0,0,0,1,1,0,0,0,0,0,0,0,1,1,0,0,0,0,0,0,0,0,0,0
209409,35000,350,0,-2,1,1,0,0,0,0,0,0,0,0,0,0,0,0,0,0,0,0,1,1,0,0,0,0,0,0,0,0,0,0
209490,35000,350,0,-2,46,27,19,1,0,1,3,1,2,4,3,1,6,4,2,1,0,1,23,12,11,0,0,0,7,6,1,1,1,0
209506,35000,350,0,-2,1,1,0,0,0,0,0,0,0,0,0,0,0,0,0,0,0,0,1,1,0,0,0,0,0,0,0,0,0,0
209542,35000,350,0,-2,35,18,17,0,0,0,2,2,0,0,0,0,3,1,2,0,0,0,8,6,2,1,0,1,20,9,11,1,0,1
209551,35000,350,0,-2,96,43,53,2,1,1,9,0,9,5,3,2,11,6,5,0,0,0,63,30,33,5,2,3,0,0,0,1,1,0
209612,35000,350,0,-2,1,0,1,0,0,0,0,0,0,0,0,0,1,0,1,0,0,0,0,0,0,0,0,0,0,0,0,0,0,0
209746,35000,350,0,-2,2,2,0,0,0,0,0,0,0,0,0,0,0,0,0,0,0,0,2,2,0,0,0,0,0,0,0,0,0,0
209807,35000,350,0,-2,12,8,4,0,0,0,1,1,0,3,3,0,3,0,3,0,0,0,4,3,1,1,1,0,0,0,0,0,0,0
209825,35000,350,0,-2,30,19,11,0,0,0,0,0,0,0,0,0,3,2,1,0,0,0,19,12,7,0,0,0,4,2,2,4,3,1
209922,35000,350,0,-2,9,7,2,0,0,0,0,0,0,2,2,0,1,1,0,0,0,0,5,3,2,1,1,0,0,0,0,0,0,0
210146,35000,350,0,-2,1,1,0,0,0,0,0,0,0,0,0,0,0,0,0,0,0,0,1,1,0,0,0,0,0,0,0,0,0,0
210155,35000,350,0,-2,3,2,1,1,0,1,0,0,0,0,0,0,0,0,0,0,0,0,2,2,0,0,0,0,0,0,0,0,0,0
210270,35000,350,0,-2,1,1,0,0,0,0,0,0,0,0,0,0,0,0,0,0,0,0,1,1,0,0,0,0,0,0,0,0,0,0
210368,35000,350,0,-2,1,1,0,0,0,0,0,0,0,0,0,0,0,0,0,0,0,0,1,1,0,0,0,0,0,0,0,0,0,0
210401,35000,350,0,-2,6,6,0,0,0,0,0,0,0,0,0,0,1,1,0,0,0,0,4,4,0,0,0,0,1,1,0,0,0,0
210429,35000,350,0,-2,3,3,0,0,0,0,0,0,0,0,0,0,1,1,0,0,0,0,2,2,0,0,0,0,0,0,0,0,0,0
210438,35000,350,0,-2,5,2,3,0,0,0,0,0,0,2,2,0,0,0,0,0,0,0,3,0,3,0,0,0,0,0,0,0,0,0
210571,35000,350,0,-2,6,5,1,0,0,0,0,0,0,0,0,0,5,4,1,0,0,0,1,1,0,0,0,0,0,0,0,0,0,0
210605,35000,350,0,-2,1,1,0,0,0,0,0,0,0,0,0,0,0,0,0,0,0,0,1,1,0,0,0,0,0,0,0,0,0,0
210669,35000,350,0,-2,6,6,0,0,0,0,0,0,0,0,0,0,0,0,0,0,0,0,6,6,0,0,0,0,0,0,0,0,0,0
210739,35000,350,0,-2,13,12,1,0,0,0,0,0,0,0,0,0,2,2,0,0,0,0,11,10,1,0,0,0,0,0,0,0,0,0
210809,35000,350,0,-2,1,0,1,0,0,0,0,0,0,0,0,0,0,0,0,0,0,0,1,0,1,0,0,0,0,0,0,0,0,0
211088,35000,350,0,-2,4,2,2,0,0,0,0,0,0,1,1,0,0,0,0,0,0,0,2,1,1,0,0,0,1,0,1,0,0,0
211273,35000,350,0,-2,7,6,1,0,0,0,0,0,0,4,3,1,1,1,0,0,0,0,1,1,0,0,0,0,1,1,0,0,0,0
211291,35000,350,0,-2,19,10,9,0,0,0,0,0,0,1,1,0,0,0,0,0,0,0,17,8,9,0,0,0,1,1,0,0,0,0
211307,35000,350,0,-2,5,3,2,0,0,0,0,0,0,0,0,0,0,0,0,0,0,0,3,1,2,0,0,0,2,2,0,0,0,0
211343,35000,350,0,-2,2,1,1,0,0,0,0,0,0,0,0,0,0,0,0,0,0,0,2,1,1,0,0,0,0,0,0,0,0,0
211361,35000,350,0,-2,2,2,0,0,0,0,0,0,0,0,0,0,0,0,0,0,0,0,2,2,0,0,0,0,0,0,0,0,0,0
211431,35000,350,0,-2,2,2,0,0,0,0,0,0,0,0,0,0,0,0,0,0,0,0,2,2,0,0,0,0,0,0,0,0,0,0
211440,35000,350,0,-2,6,4,2,0,0,0,1,1,0,1,0,1,0,0,0,0,0,0,4,3,1,0,0,0,0,0,0,0,0,0
211477,35000,350,0,-2,1,1,0,0,0,0,0,0,0,0,0,0,0,0,0,0,0,0,1,1,0,0,0,0,0,0,0,0,0,0
211556,35000,350,0,-2,6,5,1,0,0,0,0,0,0,2,2,0,0,0,0,0,0,0,4,3,1,0,0,0,0,0,0,0,0,0
211583,35000,350,0,-2,1,1,0,0,0,0,0,0,0,1,1,0,0,0,0,0,0,0,0,0,0,0,0,0,0,0,0,0,0,0
211608,35000,350,0,-2,4,2,2,0,0,0,0,0,0,3,2,1,0,0,0,0,0,0,1,0,1,0,0,0,0,0,0,0,0,0
211644,35000,350,0,-2,1,1,0,0,0,0,0,0,0,0,0,0,0,0,0,0,0,0,1,1,0,0,0,0,0,0,0,0,0,0
211927,35000,350,0,-2,4,3,1,0,0,0,0,0,0,1,0,1,0,0,0,0,0,0,3,3,0,0,0,0,0,0,0,0,0,0
211981,35000,350,0,-2,3,2,1,0,0,0,0,0,0,1,1,0,0,0,0,0,0,0,2,1,1,0,0,0,0,0,0,0,0,0
212009,35000,350,0,-2,26,12,14,0,0,0,0,0,0,2,1,1,3,0,3,0,0,0,21,11,10,0,0,0,0,0,0,0,0,0
212045,35000,350,0,-2,1,0,1,0,0,0,0,0,0,0,0,0,0,0,0,0,0,0,1,0,1,0,0,0,0,0,0,0,0,0
212054,35000,350,0,-2,23,10,13,0,0,0,2,1,1,13,6,7,0,0,0,0,0,0,6,2,4,1,0,1,1,1,0,0,0,0
212106,35000,350,0,-2,13,10,3,0,0,0,0,0,0,0,0,0,0,0,0,0,0,0,11,8,3,1,1,0,1,1,0,0,0,0
212115,35000,350,0,-2,4,4,0,0,0,0,0,0,0,2,2,0,1,1,0,0,0,0,1,1,0,0,0,0,0,0,0,0,0,0
212133,35000,350,0,-2,6,3,3,0,0,0,0,0,0,3,1,2,0,0,0,0,0,0,3,2,1,0,0,0,0,0,0,0,0,0
212160,35000,350,0,-2,2,2,0,0,0,0,0,0,0,0,0,0,0,0,0,0,0,0,2,2,0,0,0,0,0,0,0,0,0,0
212197,35000,350,0,-2,11,7,4,0,0,0,1,0,1,1,0,1,3,3,0,0,0,0,5,3,2,0,0,0,1,1,0,0,0,0
212577,35000,350,0,-2,13,9,4,0,0,0,2,2,0,1,0,1,3,2,1,0,0,0,4,3,1,0,0,0,1,1,0,2,1,1
212601,35000,350,0,-2,13,7,6,0,0,0,0,0,0,1,0,1,0,0,0,0,0,0,11,7,4,0,0,0,1,0,1,0,0,0
212656,35000,350,0,-2,1,0,1,0,0,0,0,0,0,0,0,0,0,0,0,0,0,0,1,0,1,0,0,0,0,0,0,0,0,0
212674,35000,350,0,-2,19,15,4,0,0,0,2,1,1,1,1,0,0,0,0,0,0,0,16,13,3,0,0,0,0,0,0,0,0,0
212832,35000,350,0,-2,8,4,4,0,0,0,0,0,0,2,0,2,0,0,0,0,0,0,6,4,2,0,0,0,0,0,0,0,0,0
212869,35000,350,0,-2,11,5,6,0,0,0,0,0,0,2,0,2,2,1,1,0,0,0,7,4,3,0,0,0,0,0,0,0,0,0
212878,35000,350,0,-2,5,4,1,0,0,0,1,1,0,0,0,0,0,0,0,0,0,0,4,3,1,0,0,0,0,0,0,0,0,0
212911,35000,350,0,-2,7,5,2,0,0,0,1,1,0,2,1,1,0,0,0,0,0,0,3,2,1,1,1,0,0,0,0,0,0,0
212975,35000,350,0,-2,6,5,1,0,0,0,0,0,0,0,0,0,0,0,0,0,0,0,6,5,1,0,0,0,0,0,0,0,0,0
212984,35000,350,0,-2,1,1,0,0,0,0,0,0,0,0,0,0,0,0,0,0,0,0,1,1,0,0,0,0,0,0,0,0,0,0
213011,35000,350,0,-2,2,2,0,0,0,0,0,0,0,0,0,0,0,0,0,0,0,0,2,2,0,0,0,0,0,0,0,0,0,0
213020,35000,350,0,-2,6,4,2,0,0,0,0,0,0,0,0,0,0,0,0,0,0,0,4,2,2,0,0,0,2,2,0,0,0,0
213251,35000,350,0,-2,3,3,0,0,0,0,0,0,0,0,0,0,0,0,0,0,0,0,3,3,0,0,0,0,0,0,0,0,0,0
213321,35000,350,0,-2,2,2,0,0,0,0,0,0,0,0,0,0,0,0,0,0,0,0,2,2,0,0,0,0,0,0,0,0,0,0
213349,35000,350,0,-2,4,1,3,0,0,0,0,0,0,0,0,0,0,0,0,0,0,0,3,1,2,1,0,1,0,0,0,0,0,0
213358,35000,350,0,-2,6,5,1,0,0,0,0,0,0,0,0,0,0,0,0,0,0,0,6,5,1,0,0,0,0,0,0,0,0,0
213367,35000,350,0,-2,14,5,9,0,0,0,0,0,0,5,4,1,0,0,0,0,0,0,9,1,8,0,0,0,0,0,0,0,0,0
213376,35000,350,0,-2,5,5,0,0,0,0,0,0,0,1,1,0,0,0,0,0,0,0,4,4,0,0,0,0,0,0,0,0,0,0
213385,35000,350,0,-2,2,1,1,0,0,0,1,0,1,0,0,0,0,0,0,0,0,0,1,1,0,0,0,0,0,0,0,0,0,0
213400,35000,350,0,-2,1,1,0,0,0,0,0,0,0,0,0,0,0,0,0,0,0,0,1,1,0,0,0,0,0,0,0,0,0,0
213507,35000,350,0,-2,6,3,3,0,0,0,0,0,0,0,0,0,2,0,2,0,0,0,4,3,1,0,0,0,0,0,0,0,0,0
213525,35000,350,0,-2,1,1,0,0,0,0,0,0,0,0,0,0,0,0,0,0,0,0,1,1,0,0,0,0,0,0,0,0,0,0
213543,35000,350,0,-2,5,1,4,0,0,0,0,0,0,1,0,1,0,0,0,0,0,0,3,1,2,1,0,1,0,0,0,0,0,0
213598,35000,350,0,-2,8,5,3,0,0,0,0,0,0,4,3,1,0,0,0,0,0,0,3,2,1,1,0,1,0,0,0,0,0,0
213613,35000,350,0,-2,2,1,1,0,0,0,0,0,0,0,0,0,0,0,0,0,0,0,1,1,0,1,0,1,0,0,0,0,0,0
213631,35000,350,0,-2,1,1,0,0,0,0,0,0,0,1,1,0,0,0,0,0,0,0,0,0,0,0,0,0,0,0,0,0,0,0
213668,35000,350,0,-2,23,15,8,0,0,0,1,0,1,1,0,1,2,2,0,0,0,0,17,12,5,0,0,0,2,1,1,0,0,0
213774,35000,350,0,-2,5,3,2,0,0,0,0,0,0,2,0,2,0,0,0,0,0,0,3,3,0,0,0,0,0,0,0,0,0,0
213783,35000,350,0,-2,6,3,3,0,0,0,0,0,0,0,0,0,0,0,0,0,0,0,6,3,3,0,0,0,0,0,0,0,0,0
213826,35000,350,0,-2,5,4,1,0,0,0,0,0,0,1,1,0,0,0,0,0,0,0,4,3,1,0,0,0,0,0,0,0,0,0
213987,35000,350,0,-2,2,2,0,0,0,0,0,0,0,0,0,0,0,0,0,0,0,0,2,2,0,0,0,0,0,0,0,0,0,0
213996,35000,350,0,-2,19,12,7,0,0,0,0,0,0,4,3,1,0,0,0,0,0,0,15,9,6,0,0,0,0,0,0,0,0,0
214041,35000,350,0,-2,19,12,7,0,0,0,0,0,0,2,2,0,4,4,0,0,0,0,8,3,5,1,0,1,3,2,1,1,1,0
214069,35000,350,0,-2,5,5,0,0,0,0,0,0,0,0,0,0,0,0,0,0,0,0,5,5,0,0,0,0,0,0,0,0,0,0
214111,35000,350,0,-2,7,6,1,0,0,0,0,0,0,3,2,1,0,0,0,0,0,0,4,4,0,0,0,0,0,0,0,0,0,0
214157,35000,350,0,-2,4,3,1,0,0,0,0,0,0,0,0,0,0,0,0,0,0,0,2,2,0,1,0,1,1,1,0,0,0,0
214166,35000,350,0,-2,1,0,1,0,0,0,0,0,0,0,0,0,0,0,0,0,0,0,1,0,1,0,0,0,0,0,0,0,0,0
214175,35000,350,0,-2,8,5,3,0,0,0,0,0,0,0,0,0,3,0,3,0,0,0,4,4,0,1,1,0,0,0,0,0,0,0
214290,35000,350,0,-2,1,0,1,0,0,0,0,0,0,0,0,0,0,0,0,0,0,0,1,0,1,0,0,0,0,0,0,0,0,0
214379,35000,350,0,-2,1,0,1,0,0,0,0,0,0,0,0,0,0,0,0,0,0,0,1,0,1,0,0,0,0,0,0,0,0,0
214564,35000,350,0,-2,3,3,0,0,0,0,0,0,0,3,3,0,0,0,0,0,0,0,0,0,0,0,0,0,0,0,0,0,0,0
214883,35000,350,0,-2,1,1,0,0,0,0,0,0,0,1,1,0,0,0,0,0,0,0,0,0,0,0,0,0,0,0,0,0,0,0
214944,35000,350,0,-2,3,3,0,0,0,0,0,0,0,0,0,0,0,0,0,1,1,0,2,2,0,0,0,0,0,0,0,0,0,0
215062,35000,350,0,-2,172,68,104,1,1,0,7,3,4,86,35,51,19,6,13,1,1,0,45,20,25,7,1,6,4,1,3,2,0,2
215123,35000,350,0,-2,2,2,0,0,0,0,0,0,0,1,1,0,0,0,0,0,0,0,1,1,0,0,0,0,0,0,0,0,0,0
215132,35000,350,0,-2,3,3,0,0,0,0,0,0,0,0,0,0,0,0,0,0,0,0,3,3,0,0,0,0,0,0,0,0,0,0
215239,35000,350,0,-2,3,2,1,0,0,0,1,1,0,1,1,0,1,0,1,0,0,0,0,0,0,0,0,0,0,0,0,0,0,0
215275,35000,350,0,-2,2,1,1,0,0,0,0,0,0,0,0,0,0,0,0,0,0,0,2,1,1,0,0,0,0,0,0,0,0,0
215293,35000,350,0,-2,30,23,7,0,0,0,0,0,0,6,5,1,0,0,0,0,0,0,18,14,4,1,0,1,5,4,1,0,0,0
215415,35000,350,0,-2,2,2,0,0,0,0,0,0,0,0,0,0,0,0,0,0,0,0,2,2,0,0,0,0,0,0,0,0,0,0
215442,35000,350,0,-2,4,3,1,0,0,0,0,0,0,0,0,0,0,0,0,0,0,0,4,3,1,0,0,0,0,0,0,0,0,0
215655,35000,350,0,-2,7,7,0,0,0,0,0,0,0,0,0,0,3,3,0,0,0,0,4,4,0,0,0,0,0,0,0,0,0,0
215691,35000,350,0,-2,13,8,5,0,0,0,0,0,0,9,5,4,0,0,0,0,0,0,3,3,0,1,0,1,0,0,0,0,0,0
215743,35000,350,0,-2,8,7,1,0,0,0,0,0,0,0,0,0,1,1,0,0,0,0,7,6,1,0,0,0,0,0,0,0,0,0
215770,35000,350,0,-2,10,8,2,0,0,0,1,1,0,5,4,1,0,0,0,0,0,0,4,3,1,0,0,0,0,0,0,0,0,0
215798,35000,350,0,-2,9,3,6,0,0,0,0,0,0,1,1,0,0,0,0,0,0,0,8,2,6,0,0,0,0,0,0,0,0,0
215929,35000,350,0,-2,9,5,4,0,0,0,2,1,1,0,0,0,0,0,0,0,0,0,6,4,2,0,0,0,1,0,1,0,0,0
215947,35000,350,0,-2,3,2,1,0,0,0,0,0,0,0,0,0,0,0,0,0,0,0,3,2,1,0,0,0,0,0,0,0,0,0
216010,35000,350,0,-2,3,3,0,0,0,0,0,0,0,0,0,0,0,0,0,0,0,0,3,3,0,0,0,0,0,0,0,0,0,0
216038,35000,350,0,-2,19,13,6,0,0,0,0,0,0,0,0,0,0,0,0,0,0,0,19,13,6,0,0,0,0,0,0,0,0,0
216278,35000,350,0,-2,5,2,3,0,0,0,0,0,0,0,0,0,0,0,0,0,0,0,5,2,3,0,0,0,0,0,0,0,0,0
216287,35000,350,0,-2,13,11,2,0,0,0,0,0,0,1,1,0,1,1,0,0,0,0,7,6,1,3,3,0,1,0,1,0,0,0
216296,35000,350,0,-2,2,2,0,0,0,0,0,0,0,0,0,0,0,0,0,0,0,0,2,2,0,0,0,0,0,0,0,0,0,0
216357,35000,350,0,-2,5,2,3,0,0,0,0,0,0,0,0,0,0,0,0,0,0,0,5,2,3,0,0,0,0,0,0,0,0,0
216366,35000,350,0,-2,52,20,32,0,0,0,5,1,4,22,10,12,2,0,2,0,0,0,15,7,8,8,2,6,0,0,0,0,0,0
216524,35000,350,0,-2,5,3,2,0,0,0,0,0,0,1,0,1,0,0,0,0,0,0,4,3,1,0,0,0,0,0,0,0,0,0
216597,35000,350,0,-2,40,25,15,0,0,0,12,5,7,19,13,6,0,0,0,0,0,0,9,7,2,0,0,0,0,0,0,0,0,0
216667,35000,350,0,-2,14,7,7,1,0,1,0,0,0,2,1,1,0,0,0,0,0,0,10,6,4,0,0,0,1,0,1,0,0,0
216764,35000,350,0,-2,35,27,8,0,0,0,0,0,0,15,10,5,2,2,0,0,0,0,18,15,3,0,0,0,0,0,0,0,0,0
216782,35000,350,0,-2,1,1,0,0,0,0,0,0,0,0,0,0,0,0,0,0,0,0,1,1,0,0,0,0,0,0,0,0,0,0
216807,35000,350,0,-2,6,4,2,0,0,0,0,0,0,0,0,0,0,0,0,0,0,0,6,4,2,0,0,0,0,0,0,0,0,0
216825,35000,350,0,-2,4,2,2,0,0,0,0,0,0,0,0,0,0,0,0,0,0,0,3,2,1,1,0,1,0,0,0,0,0,0
216852,35000,350,0,-2,14,10,4,0,0,0,1,0,1,6,4,2,2,2,0,0,0,0,5,4,1,0,0,0,0,0,0,0,0,0
216931,35000,350,0,-2,7,4,3,0,0,0,0,0,0,1,0,1,0,0,0,0,0,0,6,4,2,0,0,0,0,0,0,0,0,0
216940,35000,350,0,-2,1,1,0,0,0,0,0,0,0,0,0,0,0,0,0,0,0,0,1,1,0,0,0,0,0,0,0,0,0,0
217013,35000,350,0,-2,1,0,1,0,0,0,0,0,0,0,0,0,0,0,0,0,0,0,1,0,1,0,0,0,0,0,0,0,0,0
217059,35000,350,0,-2,8,4,4,0,0,0,0,0,0,1,1,0,1,1,0,0,0,0,6,2,4,0,0,0,0,0,0,0,0,0
217156,35000,350,0,-2,42,21,21,0,0,0,0,0,0,15,4,11,4,2,2,0,0,0,14,9,5,2,2,0,7,4,3,0,0,0
217165,35000,350,0,-2,8,6,2,0,0,0,0,0,0,3,2,1,0,0,0,0,0,0,5,4,1,0,0,0,0,0,0,0,0,0
217235,35000,350,0,-2,13,12,1,0,0,0,0,0,0,2,2,0,1,1,0,0,0,0,9,9,0,1,0,1,0,0,0,0,0,0
217402,35000,350,0,-2,7,6,1,0,0,0,0,0,0,0,0,0,0,0,0,0,0,0,7,6,1,0,0,0,0,0,0,0,0,0
217475,35000,350,0,-2,2,1,1,0,0,0,0,0,0,0,0,0,0,0,0,0,0,0,2,1,1,0,0,0,0,0,0,0,0,0
217484,35000,350,0,-2,15,11,4,1,1,0,1,1,0,2,2,0,0,0,0,0,0,0,11,7,4,0,0,0,0,0,0,0,0,0
217493,35000,350,0,-2,14,11,3,0,0,0,0,0,0,1,0,1,2,2,0,0,0,0,7,7,0,1,1,0,3,1,2,0,0,0
217518,35000,350,0,-2,14,10,4,1,1,0,1,0,1,1,0,1,1,1,0,0,0,0,9,7,2,1,1,0,0,0,0,0,0,0
217536,35000,350,0,-2,5,3,2,0,0,0,0,0,0,2,2,0,1,0,1,0,0,0,2,1,1,0,0,0,0,0,0,0,0,0
217624,35000,350,0,-2,9,3,6,0,0,0,0,0,0,9,3,6,0,0,0,0,0,0,0,0,0,0,0,0,0,0,0,0,0,0
217633,35000,350,0,-2,8,4,4,0,0,0,0,0,0,2,2,0,0,0,0,0,0,0,6,2,4,0,0,0,0,0,0,0,0,0
217688,35000,350,0,-2,1,1,0,0,0,0,0,0,0,0,0,0,0,0,0,0,0,0,1,1,0,0,0,0,0,0,0,0,0,0
217712,35000,350,0,-2,1,0,1,0,0,0,0,0,0,1,0,1,0,0,0,0,0,0,0,0,0,0,0,0,0,0,0,0,0,0
217721,35000,350,0,-2,15,11,4,0,0,0,0,0,0,14,10,4,0,0,0,0,0,0,1,1,0,0,0,0,0,0,0,0,0,0
217749,35000,350,0,-2,3,1,2,0,0,0,0,0,0,0,0,0,0,0,0,0,0,0,3,1,2,0,0,0,0,0,0,0,0,0
217776,35000,350,0,-2,2,2,0,0,0,0,0,0,0,1,1,0,0,0,0,0,0,0,1,1,0,0,0,0,0,0,0,0,0,0
217819,35000,350,0,-2,8,3,5,0,0,0,0,0,0,4,1,3,0,0,0,0,0,0,4,2,2,0,0,0,0,0,0,0,0,0
217864,35000,350,0,-2,1,1,0,0,0,0,0,0,0,0,0,0,0,0,0,0,0,0,1,1,0,0,0,0,0,0,0,0,0,0
217873,35000,350,0,-2,3,1,2,0,0,0,0,0,0,3,1,2,0,0,0,0,0,0,0,0,0,0,0,0,0,0,0,0,0,0
217882,35000,350,0,-2,44,27,17,0,0,0,0,0,0,0,0,0,0,0,0,0,0,0,44,27,17,0,0,0,0,0,0,0,0,0
217891,35000,350,0,-2,1,1,0,0,0,0,0,0,0,1,1,0,0,0,0,0,0,0,0,0,0,0,0,0,0,0,0,0,0,0
217907,35000,350,0,-2,2,1,1,0,0,0,0,0,0,0,0,0,0,0,0,0,0,0,2,1,1,0,0,0,0,0,0,0,0,0
217925,35000,350,0,-2,9,5,4,0,0,0,2,0,2,0,0,0,3,1,2,2,2,0,2,2,0,0,0,0,0,0,0,0,0,0
217934,35000,350,0,-2,2,1,1,0,0,0,0,0,0,1,0,1,0,0,0,0,0,0,1,1,0,0,0,0,0,0,0,0,0,0
217961,35000,350,0,-2,6,4,2,0,0,0,0,0,0,2,0,2,0,0,0,0,0,0,4,4,0,0,0,0,0,0,0,0,0,0
218061,35000,350,0,-2,19,12,7,0,0,0,0,0,0,12,8,4,3,2,1,0,0,0,4,2,2,0,0,0,0,0,0,0,0,0
218070,35000,350,0,-2,18,10,8,0,0,0,0,0,0,4,3,1,0,0,0,0,0,0,14,7,7,0,0,0,0,0,0,0,0,0
218113,35000,350,0,-2,6,2,4,0,0,0,0,0,0,1,0,1,0,0,0,0,0,0,5,2,3,0,0,0,0,0,0,0,0,0
218140,35000,350,0,-2,1,0,1,0,0,0,0,0,0,0,0,0,0,0,0,0,0,0,0,0,0,0,0,0,0,0,0,1,0,1
218238,35000,350,0,-2,7,6,1,0,0,0,0,0,0,1,1,0,0,0,0,0,0,0,3,2,1,0,0,0,3,3,0,0,0,0
218335,35000,350,0,-2,1,1,0,0,0,0,0,0,0,0,0,0,1,1,0,0,0,0,0,0,0,0,0,0,0,0,0,0,0,0
218353,35000,350,0,-2,4,2,2,0,0,0,0,0,0,3,2,1,0,0,0,0,0,0,1,0,1,0,0,0,0,0,0,0,0,0
218399,35000,350,0,-2,21,12,9,0,0,0,0,0,0,21,12,9,0,0,0,0,0,0,0,0,0,0,0,0,0,0,0,0,0,0
218441,35000,350,0,-2,14,12,2,0,0,0,0,0,0,1,1,0,0,0,0,0,0,0,13,11,2,0,0,0,0,0,0,0,0,0
218487,35000,350,0,-2,1,0,1,0,0,0,0,0,0,0,0,0,0,0,0,0,0,0,1,0,1,0,0,0,0,0,0,0,0,0
218645,35000,350,0,-2,2,2,0,0,0,0,0,0,0,1,1,0,0,0,0,0,0,0,1,1,0,0,0,0,0,0,0,0,0,0
218654,35000,350,0,-2,5,4,1,0,0,0,0,0,0,1,0,1,2,2,0,0,0,0,2,2,0,0,0,0,0,0,0,0,0,0
218663,35000,350,0,-2,27,15,12,0,0,0,0,0,0,9,5,4,1,1,0,0,0,0,14,9,5,2,0,2,1,0,1,0,0,0
218690,35000,350,0,-2,1,1,0,0,0,0,0,0,0,0,0,0,0,0,0,0,0,0,1,1,0,0,0,0,0,0,0,0,0,0
218724,35000,350,0,-2,54,39,15,0,0,0,0,0,0,11,8,3,3,2,1,0,0,0,38,29,9,0,0,0,2,0,2,0,0,0
218733,35000,350,0,-2,7,4,3,0,0,0,0,0,0,6,3,3,0,0,0,0,0,0,1,1,0,0,0,0,0,0,0,0,0,0
218742,35000,350,0,-2,4,3,1,1,1,0,0,0,0,1,1,0,0,0,0,0,0,0,2,1,1,0,0,0,0,0,0,0,0,0
218751,35000,350,0,-2,1,1,0,0,0,0,0,0,0,0,0,0,0,0,0,0,0,0,1,1,0,0,0,0,0,0,0,0,0,0
218821,35000,350,0,-2,22,10,12,0,0,0,0,0,0,10,2,8,1,1,0,0,0,0,10,6,4,1,1,0,0,0,0,0,0,0
218830,35000,350,0,-2,5,4,1,0,0,0,0,0,0,1,0,1,0,0,0,0,0,0,4,4,0,0,0,0,0,0,0,0,0,0
218858,35000,350,0,-2,10,8,2,0,0,0,0,0,0,7,7,0,0,0,0,0,0,0,3,1,2,0,0,0,0,0,0,0,0,0
218885,35000,350,0,-2,1,1,0,0,0,0,0,0,0,0,0,0,0,0,0,0,0,0,1,1,0,0,0,0,0,0,0,0,0,0
218894,35000,350,0,-2,5,3,2,0,0,0,0,0,0,3,1,2,0,0,0,0,0,0,2,2,0,0,0,0,0,0,0,0,0,0
218919,35000,350,0,-2,4,1,3,0,0,0,0,0,0,4,1,3,0,0,0,0,0,0,0,0,0,0,0,0,0,0,0,0,0,0
218964,35000,350,0,-2,7,5,2,0,0,0,0,0,0,2,0,2,1,1,0,0,0,0,3,3,0,1,1,0,0,0,0,0,0,0
218973,35000,350,0,-2,9,3,6,0,0,0,0,0,0,3,0,3,0,0,0,0,0,0,6,3,3,0,0,0,0,0,0,0,0,0
219000,35000,350,0,-2,5,4,1,0,0,0,0,0,0,0,0,0,1,0,1,0,0,0,4,4,0,0,0,0,0,0,0,0,0,0
219046,35000,350,0,-2,1,1,0,0,0,0,0,0,0,0,0,0,0,0,0,0,0,0,1,1,0,0,0,0,0,0,0,0,0,0
219082,35000,350,0,-2,3,2,1,0,0,0,0,0,0,0,0,0,0,0,0,0,0,0,3,2,1,0,0,0,0,0,0,0,0,0
219091,35000,350,0,-2,1,1,0,0,0,0,0,0,0,0,0,0,0,0,0,0,0,0,1,1,0,0,0,0,0,0,0,0,0,0
219143,35000,350,0,-2,2,0,2,0,0,0,0,0,0,1,0,1,0,0,0,0,0,0,1,0,1,0,0,0,0,0,0,0,0,0
219259,35000,350,0,-2,2,1,1,0,0,0,0,0,0,0,0,0,1,0,1,0,0,0,1,1,0,0,0,0,0,0,0,0,0,0
219277,35000,350,0,-2,3,1,2,3,1,2,0,0,0,0,0,0,0,0,0,0,0,0,0,0,0,0,0,0,0,0,0,0,0,0
219347,35000,350,0,-2,8,7,1,0,0,0,0,0,0,0,0,0,0,0,0,0,0,0,8,7,1,0,0,0,0,0,0,0,0,0
219356,35000,350,0,-2,36,21,15,1,0,1,1,1,0,3,2,1,1,0,1,0,0,0,25,18,7,1,0,1,4,0,4,0,0,0
219374,35000,350,0,-2,1,0,1,1,0,1,0,0,0,0,0,0,0,0,0,0,0,0,0,0,0,0,0,0,0,0,0,0,0,0
219383,35000,350,0,-2,3,1,2,0,0,0,0,0,0,1,1,0,0,0,0,0,0,0,2,0,2,0,0,0,0,0,0,0,0,0
219408,35000,350,0,-2,2,2,0,2,2,0,0,0,0,0,0,0,0,0,0,0,0,0,0,0,0,0,0,0,0,0,0,0,0,0
219426,35000,350,0,-2,4,2,2,0,0,0,0,0,0,0,0,0,0,0,0,0,0,0,4,2,2,0,0,0,0,0,0,0,0,0
219471,35000,350,0,-2,26,17,9,0,0,0,0,0,0,1,0,1,2,1,1,0,0,0,21,15,6,2,1,1,0,0,0,0,0,0
219480,35000,350,0,-2,3,2,1,0,0,0,0,0,0,0,0,0,0,0,0,0,0,0,3,2,1,0,0,0,0,0,0,0,0,0
219602,35000,350,0,-2,6,5,1,0,0,0,0,0,0,2,1,1,0,0,0,0,0,0,2,2,0,1,1,0,1,1,0,0,0,0
219639,35000,350,0,-2,2,0,2,0,0,0,0,0,0,2,0,2,0,0,0,0,0,0,0,0,0,0,0,0,0,0,0,0,0,0
219709,35000,350,0,-2,22,11,11,1,0,1,2,1,1,9,3,6,1,1,0,0,0,0,7,5,2,1,0,1,1,1,0,0,0,0
219718,35000,350,0,-2,6,4,2,0,0,0,0,0,0,1,1,0,1,0,1,0,0,0,4,3,1,0,0,0,0,0,0,0,0,0
219790,35000,350,0,-2,1,0,1,0,0,0,0,0,0,0,0,0,0,0,0,0,0,0,1,0,1,0,0,0,0,0,0,0,0,0
219806,35000,350,0,-2,7,3,4,0,0,0,0,0,0,1,0,1,1,1,0,0,0,0,5,2,3,0,0,0,0,0,0,0,0,0
219824,35000,350,0,-2,9,4,5,0,0,0,0,0,0,2,0,2,1,1,0,0,0,0,6,3,3,0,0,0,0,0,0,0,0,0
219833,35000,350,0,-2,5,3,2,0,0,0,0,0,0,2,1,1,0,0,0,0,0,0,3,2,1,0,0,0,0,0,0,0,0,0
219879,35000,350,0,-2,2,2,0,0,0,0,0,0,0,0,0,0,0,0,0,0,0,0,2,2,0,0,0,0,0,0,0,0,0,0
219888,35000,350,0,-2,5,2,3,0,0,0,0,0,0,0,0,0,0,0,0,0,0,0,5,2,3,0,0,0,0,0,0,0,0,0
219949,35000,350,0,-2,1,1,0,0,0,0,0,0,0,0,0,0,0,0,0,0,0,0,1,1,0,0,0,0,0,0,0,0,0,0
219976,35000,350,0,-2,12,10,2,0,0,0,0,0,0,0,0,0,0,0,0,0,0,0,2,1,1,0,0,0,10,9,1,0,0,0
220057,35000,350,0,-2,4,3,1,0,0,0,0,0,0,2,2,0,0,0,0,0,0,0,1,0,1,0,0,0,1,1,0,0,0,0
220075,35000,350,0,-2,31,17,14,0,0,0,0,0,0,2,2,0,2,0,2,0,0,0,27,15,12,0,0,0,0,0,0,0,0,0
220215,35000,350,0,-2,16,7,9,0,0,0,0,0,0,2,2,0,0,0,0,0,0,0,11,4,7,0,0,0,3,1,2,0,0,0
220400,35000,350,0,-2,5,3,2,0,0,0,0,0,0,4,2,2,0,0,0,0,0,0,1,1,0,0,0,0,0,0,0,0,0,0
220473,35000,350,0,-2,2,1,1,0,0,0,0,0,0,0,0,0,0,0,0,0,0,0,2,1,1,0,0,0,0,0,0,0,0,0
220516,35000,350,0,-2,4,2,2,0,0,0,0,0,0,0,0,0,0,0,0,0,0,0,4,2,2,0,0,0,0,0,0,0,0,0
220552,35000,350,0,-2,3,2,1,0,0,0,0,0,0,0,0,0,0,0,0,0,0,0,3,2,1,0,0,0,0,0,0,0,0,0
220598,35000,350,0,-2,5,2,3,0,0,0,0,0,0,4,2,2,0,0,0,0,0,0,0,0,0,1,0,1,0,0,0,0,0,0
220604,35000,350,0,-2,2,1,1,0,0,0,0,0,0,1,1,0,0,0,0,0,0,0,1,0,1,0,0,0,0,0,0,0,0,0
220613,35000,350,0,-2,17,10,7,0,0,0,0,0,0,2,0,2,3,2,1,0,0,0,10,7,3,0,0,0,2,1,1,0,0,0
220631,35000,350,0,-2,27,21,6,0,0,0,0,0,0,1,1,0,1,1,0,0,0,0,23,18,5,0,0,0,2,1,1,0,0,0
220710,35000,350,0,-2,3,1,2,0,0,0,0,0,0,0,0,0,0,0,0,0,0,0,2,1,1,0,0,0,1,0,1,0,0,0
220792,35000,350,0,-2,37,11,26,0,0,0,1,1,0,27,7,20,8,2,6,0,0,0,1,1,0,0,0,0,0,0,0,0,0,0
220862,35000,350,0,-2,19,11,8,0,0,0,0,0,0,14,7,7,0,0,0,0,0,0,5,4,1,0,0,0,0,0,0,0,0,0
220978,35000,350,0,-2,20,15,5,0,0,0,0,0,0,6,6,0,1,0,1,0,0,0,12,8,4,1,1,0,0,0,0,0,0,0
221096,35000,350,0,-2,6,5,1,0,0,0,1,1,0,0,0,0,0,0,0,0,0,0,5,4,1,0,0,0,0,0,0,0,0,0
221148,35000,350,0,-2,2,1,1,0,0,0,0,0,0,1,0,1,0,0,0,0,0,0,1,1,0,0,0,0,0,0,0,0,0,0
221184,35000,350,0,-2,1,1,0,0,0,0,0,0,0,0,0,0,0,0,0,0,0,0,1,1,0,0,0,0,0,0,0,0,0,0
221351,35000,350,0,-2,16,6,10,0,0,0,0,0,0,10,2,8,0,0,0,0,0,0,3,2,1,2,2,0,1,0,1,0,0,0
221397,35000,350,0,-2,4,4,0,0,0,0,0,0,0,0,0,0,0,0,0,0,0,0,4,4,0,0,0,0,0,0,0,0,0,0
221485,35000,350,0,-2,3,0,3,0,0,0,0,0,0,3,0,3,0,0,0,0,0,0,0,0,0,0,0,0,0,0,0,0,0,0
221519,35000,350,0,-2,23,10,13,0,0,0,1,0,1,0,0,0,0,0,0,0,0,0,21,9,12,0,0,0,1,1,0,0,0,0
221643,35000,350,0,-2,4,2,2,0,0,0,0,0,0,1,0,1,0,0,0,0,0,0,3,2,1,0,0,0,0,0,0,0,0,0
221661,35000,350,0,-2,4,3,1,0,0,0,0,0,0,1,1,0,3,2,1,0,0,0,0,0,0,0,0,0,0,0,0,0,0,0
221740,35000,350,0,-2,23,9,14,1,0,1,0,0,0,7,1,6,0,0,0,0,0,0,15,8,7,0,0,0,0,0,0,0,0,0
221759,35000,350,0,-2,147,70,77,0,0,0,3,1,2,25,14,11,7,3,4,0,0,0,102,44,58,6,4,2,0,0,0,4,4,0
221768,35000,350,0,-2,25,11,14,0,0,0,0,0,0,4,3,1,0,0,0,0,0,0,21,8,13,0,0,0,0,0,0,0,0,0
221838,35000,350,0,-2,15,9,6,0,0,0,0,0,0,11,5,6,0,0,0,0,0,0,4,4,0,0,0,0,0,0,0,0,0,0
221847,35000,350,0,-2,9,6,3,0,0,0,0,0,0,1,1,0,0,0,0,0,0,0,8,5,3,0,0,0,0,0,0,0,0,0
221892,35000,350,0,-2,1,1,0,0,0,0,0,0,0,0,0,0,0,0,0,0,0,0,1,1,0,0,0,0,0,0,0,0,0,0
221908,35000,350,0,-2,6,5,1,0,0,0,0,0,0,1,1,0,0,0,0,0,0,0,5,4,1,0,0,0,0,0,0,0,0,0
221953,35000,350,0,-2,6,2,4,0,0,0,0,0,0,0,0,0,0,0,0,0,0,0,6,2,4,0,0,0,0,0,0,0,0,0
221971,35000,350,0,-2,4,3,1,0,0,0,0,0,0,0,0,0,0,0,0,0,0,0,3,3,0,0,0,0,1,0,1,0,0,0
221999,35000,350,0,-2,143,71,72,1,0,1,0,0,0,84,39,45,7,2,5,0,0,0,39,23,16,6,4,2,5,2,3,1,1,0
222053,35000,350,0,-2,2,2,0,0,0,0,0,0,0,0,0,0,0,0,0,0,0,0,2,2,0,0,0,0,0,0,0,0,0,0
222062,35000,350,0,-2,3,2,1,0,0,0,0,0,0,0,0,0,0,0,0,0,0,0,2,1,1,0,0,0,1,1,0,0,0,0
222178,35000,350,0,-2,12,9,3,0,0,0,2,1,1,2,1,1,0,0,0,0,0,0,4,3,1,0,0,0,4,4,0,0,0,0
222497,35000,350,0,-2,7,3,4,0,0,0,0,0,0,1,0,1,3,2,1,0,0,0,3,1,2,0,0,0,0,0,0,0,0,0
222567,35000,350,0,-2,2,2,0,0,0,0,0,0,0,0,0,0,1,1,0,0,0,0,1,1,0,0,0,0,0,0,0,0,0,0
222576,35000,350,0,-2,15,8,7,0,0,0,0,0,0,1,0,1,4,2,2,0,0,0,9,5,4,0,0,0,1,1,0,0,0,0
222822,35000,350,0,-2,2,1,1,0,0,0,0,0,0,0,0,0,0,0,0,0,0,0,2,1,1,0,0,0,0,0,0,0,0,0
222831,35000,350,0,-2,3,3,0,0,0,0,0,0,0,0,0,0,1,1,0,0,0,0,2,2,0,0,0,0,0,0,0,0,0,0
222877,35000,350,0,-2,1,1,0,0,0,0,0,0,0,0,0,0,0,0,0,0,0,0,1,1,0,0,0,0,0,0,0,0,0,0
222983,35000,350,0,-2,4,2,2,0,0,0,0,0,0,1,0,1,0,0,0,0,0,0,2,1,1,0,0,0,1,1,0,0,0,0
222992,35000,350,0,-2,8,5,3,0,0,0,0,0,0,3,2,1,3,2,1,0,0,0,2,1,1,0,0,0,0,0,0,0,0,0
223223,35000,350,0,-2,102,13,89,0,0,0,1,0,1,28,2,26,42,3,39,0,0,0,12,4,8,5,0,5,14,4,10,0,0,0
223232,35000,350,0,-2,18,4,14,0,0,0,0,0,0,2,0,2,2,1,1,0,0,0,11,2,9,2,1,1,1,0,1,0,0,0
223320,35000,350,0,-2,4,2,2,0,0,0,0,0,0,0,0,0,3,2,1,0,0,0,1,0,1,0,0,0,0,0,0,0,0,0
223427,35000,350,0,-2,6,4,2,0,0,0,0,0,0,0,0,0,2,1,1,0,0,0,4,3,1,0,0,0,0,0,0,0,0,0
223506,35000,350,0,-2,3,2,1,0,0,0,0,0,0,0,0,0,2,1,1,0,0,0,1,1,0,0,0,0,0,0,0,0,0,0
223816,35000,350,0,-2,9,7,2,0,0,0,0,0,0,2,2,0,0,0,0,1,0,1,6,5,1,0,0,0,0,0,0,0,0,0
223898,35000,350,0,-2,5,3,2,0,0,0,0,0,0,1,1,0,2,2,0,0,0,0,2,0,2,0,0,0,0,0,0,0,0,0
224004,35000,350,0,-2,1,1,0,0,0,0,0,0,0,0,0,0,0,0,0,0,0,0,1,1,0,0,0,0,0,0,0,0,0,0
224110,35000,350,0,-2,1,1,0,0,0,0,0,0,0,0,0,0,0,0,0,0,0,0,1,1,0,0,0,0,0,0,0,0,0,0
224147,35000,350,0,-2,5,4,1,0,0,0,1,0,1,0,0,0,3,3,0,0,0,0,0,0,0,0,0,0,1,1,0,0,0,0
224305,35000,350,0,-2,3,2,1,0,0,0,0,0,0,0,0,0,0,0,0,0,0,0,3,2,1,0,0,0,0,0,0,0,0,0
224323,35000,350,0,-2,3,3,0,0,0,0,0,0,0,0,0,0,3,3,0,0,0,0,0,0,0,0,0,0,0,0,0,0,0,0
224350,35000,350,0,-2,2,2,0,0,0,0,0,0,0,0,0,0,0,0,0,0,0,0,2,2,0,0,0,0,0,0,0,0,0,0
224527,35000,350,0,-2,7,6,1,0,0,0,0,0,0,1,0,1,1,1,0,0,0,0,4,4,0,0,0,0,1,1,0,0,0,0
224545,35000,350,0,-2,3,2,1,0,0,0,0,0,0,1,0,1,0,0,0,0,0,0,2,2,0,0,0,0,0,0,0,0,0,0
224554,35000,350,0,-2,4,3,1,0,0,0,0,0,0,0,0,0,0,0,0,0,0,0,4,3,1,0,0,0,0,0,0,0,0,0
224615,35000,350,0,-2,13,8,5,0,0,0,0,0,0,2,0,2,6,4,2,0,0,0,4,3,1,0,0,0,1,1,0,0,0,0
224642,35000,350,0,-2,6,6,0,0,0,0,0,0,0,0,0,0,5,5,0,0,0,0,0,0,0,0,0,0,0,0,0,1,1,0
224891,35000,350,0,-2,1,1,0,0,0,0,0,0,0,0,0,0,0,0,0,0,0,0,1,1,0,0,0,0,0,0,0,0,0,0
224961,35000,350,0,-2,3,2,1,0,0,0,0,0,0,0,0,0,3,2,1,0,0,0,0,0,0,0,0,0,0,0,0,0,0,0
225070,35000,350,0,-2,6,5,1,0,0,0,0,0,0,0,0,0,0,0,0,0,0,0,6,5,1,0,0,0,0,0,0,0,0,0
225247,35000,350,0,-2,3,2,1,0,0,0,0,0,0,0,0,0,0,0,0,0,0,0,3,2,1,0,0,0,0,0,0,0,0,0
225308,35000,350,0,-2,2,2,0,1,1,0,0,0,0,0,0,0,0,0,0,0,0,0,0,0,0,1,1,0,0,0,0,0,0,0
225371,35000,350,0,-2,1,1,0,0,0,0,0,0,0,0,0,0,0,0,0,0,0,0,1,1,0,0,0,0,0,0,0,0,0,0
225399,35000,350,0,-2,9,6,3,0,0,0,0,0,0,0,0,0,6,5,1,0,0,0,3,1,2,0,0,0,0,0,0,0,0,0
225414,35000,350,0,-2,4,2,2,0,0,0,0,0,0,0,0,0,2,0,2,0,0,0,2,2,0,0,0,0,0,0,0,0,0,0
225423,35000,350,0,-2,8,6,2,0,0,0,1,1,0,6,5,1,0,0,0,0,0,0,1,0,1,0,0,0,0,0,0,0,0,0
225432,35000,350,0,-2,3,1,2,0,0,0,0,0,0,2,1,1,0,0,0,0,0,0,0,0,0,1,0,1,0,0,0,0,0,0
225502,35000,350,0,-2,3,3,0,0,0,0,0,0,0,0,0,0,2,2,0,0,0,0,1,1,0,0,0,0,0,0,0,0,0,0
225511,35000,350,0,-2,40,22,18,0,0,0,0,0,0,16,9,7,14,6,8,0,0,0,9,7,2,0,0,0,0,0,0,1,0,1
225520,35000,350,0,-2,4,3,1,0,0,0,0,0,0,2,1,1,1,1,0,0,0,0,1,1,0,0,0,0,0,0,0,0,0,0
225548,35000,350,0,-2,8,5,3,0,0,0,0,0,0,0,0,0,3,1,2,0,0,0,5,4,1,0,0,0,0,0,0,0,0,0
225627,35000,350,0,-2,12,10,2,0,0,0,0,0,0,3,2,1,7,6,1,0,0,0,2,2,0,0,0,0,0,0,0,0,0,0
225876,35000,350,0,-2,6,2,4,0,0,0,0,0,0,0,0,0,4,0,4,0,0,0,2,2,0,0,0,0,0,0,0,0,0,0
225885,35000,350,0,-2,5,1,4,0,0,0,0,0,0,3,1,2,2,0,2,0,0,0,0,0,0,0,0,0,0,0,0,0,0,0
226091,35000,350,0,-2,28,20,8,1,1,0,0,0,0,15,9,6,2,2,0,0,0,0,5,3,2,1,1,0,3,3,0,1,1,0
226116,35000,350,0,-2,5,2,3,0,0,0,0,0,0,5,2,3,0,0,0,0,0,0,0,0,0,0,0,0,0,0,0,0,0,0
226134,35000,350,0,-2,2,2,0,0,0,0,0,0,0,0,0,0,2,2,0,0,0,0,0,0,0,0,0,0,0,0,0,0,0,0
226152,35000,350,0,-2,4,3,1,0,0,0,0,0,0,0,0,0,4,3,1,0,0,0,0,0,0,0,0,0,0,0,0,0,0,0
226204,35000,350,0,-2,5,2,3,0,0,0,0,0,0,0,0,0,4,1,3,0,0,0,1,1,0,0,0,0,0,0,0,0,0,0
226231,35000,350,0,-2,5,4,1,0,0,0,0,0,0,0,0,0,0,0,0,0,0,0,5,4,1,0,0,0,0,0,0,0,0,0
226277,35000,350,0,-2,2,2,0,0,0,0,0,0,0,0,0,0,2,2,0,0,0,0,0,0,0,0,0,0,0,0,0,0,0,0
226383,35000,350,0,-2,5,2,3,0,0,0,0,0,0,0,0,0,2,0,2,0,0,0,3,2,1,0,0,0,0,0,0,0,0,0
226408,35000,350,0,-2,1,1,0,0,0,0,0,0,0,1,1,0,0,0,0,0,0,0,0,0,0,0,0,0,0,0,0,0,0,0
226471,35000,350,0,-2,5,5,0,0,0,0,0,0,0,0,0,0,2,2,0,0,0,0,3,3,0,0,0,0,0,0,0,0,0,0
226578,35000,350,0,-2,12,6,6,0,0,0,0,0,0,1,1,0,5,2,3,0,0,0,6,3,3,0,0,0,0,0,0,0,0,0
226806,35000,350,0,-2,8,5,3,0,0,0,0,0,0,1,0,1,3,2,1,0,0,0,4,3,1,0,0,0,0,0,0,0,0,0
226833,35000,350,0,-2,20,11,9,0,0,0,0,0,0,2,2,0,6,2,4,0,0,0,9,5,4,1,1,0,0,0,0,2,1,1
227146,35000,350,0,-2,1,0,1,0,0,0,0,0,0,0,0,0,0,0,0,0,0,0,1,0,1,0,0,0,0,0,0,0,0,0
227182,35000,350,0,-2,30,22,8,0,0,0,0,0,0,8,6,2,9,7,2,0,0,0,12,8,4,1,1,0,0,0,0,0,0,0
227216,35000,350,0,-2,66,36,30,0,0,0,2,0,2,9,3,6,23,10,13,0,0,0,20,15,5,3,3,0,9,5,4,0,0,0
227225,35000,350,0,-2,1,1,0,0,0,0,0,0,0,0,0,0,0,0,0,0,0,0,1,1,0,0,0,0,0,0,0,0,0,0
227368,35000,350,0,-2,59,22,37,0,0,0,0,0,0,0,0,0,54,19,35,0,0,0,5,3,2,0,0,0,0,0,0,0,0,0
227377,35000,350,0,-2,2,1,1,0,0,0,0,0,0,0,0,0,1,0,1,0,0,0,0,0,0,0,0,0,0,0,0,1,1,0
227386,35000,350,0,-2,4,4,0,0,0,0,0,0,0,0,0,0,0,0,0,0,0,0,4,4,0,0,0,0,0,0,0,0,0,0
227401,35000,350,0,-2,4,3,1,0,0,0,0,0,0,0,0,0,1,0,1,0,0,0,3,3,0,0,0,0,0,0,0,0,0,0
227526,35000,350,0,-2,15,10,5,0,0,0,0,0,0,7,3,4,6,6,0,0,0,0,2,1,1,0,0,0,0,0,0,0,0,0
227687,35000,350,0,-2,1,0,1,0,0,0,0,0,0,0,0,0,1,0,1,0,0,0,0,0,0,0,0,0,0,0,0,0,0,0
227757,35000,350,0,-2,54,28,26,0,0,0,7,4,3,14,10,4,26,9,17,0,0,0,4,3,1,1,1,0,0,0,0,2,1,1
227845,35000,350,0,-2,8,8,0,0,0,0,0,0,0,1,1,0,5,5,0,0,0,0,1,1,0,0,0,0,0,0,0,1,1,0
227854,35000,350,0,-2,6,2,4,0,0,0,0,0,0,1,0,1,4,1,3,0,0,0,0,0,0,1,1,0,0,0,0,0,0,0
227863,35000,350,0,-2,19,11,8,0,0,0,0,0,0,6,3,3,10,7,3,0,0,0,2,1,1,0,0,0,0,0,0,1,0,1
227881,35000,350,0,-2,16,10,6,0,0,0,0,0,0,3,2,1,0,0,0,0,0,0,12,7,5,0,0,0,0,0,0,1,1,0
227924,35000,350,0,-2,10,7,3,0,0,0,0,0,0,0,0,0,7,4,3,0,0,0,3,3,0,0,0,0,0,0,0,0,0,0
227979,35000,350,0,-2,9,5,4,0,0,0,1,1,0,6,4,2,1,0,1,0,0,0,1,0,1,0,0,0,0,0,0,0,0,0
228042,35000,350,0,-2,6,5,1,0,0,0,0,0,0,0,0,0,2,1,1,0,0,0,4,4,0,0,0,0,0,0,0,0,0,0
228149,35000,350,0,-2,6,4,2,0,0,0,0,0,0,0,0,0,5,3,2,0,0,0,1,1,0,0,0,0,0,0,0,0,0,0
228158,35000,350,0,-2,14,5,9,0,0,0,1,1,0,0,0,0,8,1,7,0,0,0,5,3,2,0,0,0,0,0,0,0,0,0
228246,35000,350,0,-2,7,5,2,0,0,0,0,0,0,1,0,1,1,0,1,0,0,0,5,5,0,0,0,0,0,0,0,0,0,0
228316,35000,350,0,-2,7,4,3,0,0,0,0,0,0,0,0,0,5,3,2,0,0,0,0,0,0,0,0,0,1,1,0,1,0,1
228325,35000,350,0,-2,4,2,2,1,1,0,0,0,0,1,0,1,0,0,0,0,0,0,2,1,1,0,0,0,0,0,0,0,0,0
228343,35000,350,0,-2,11,4,7,0,0,0,0,0,0,0,0,0,5,1,4,0,0,0,6,3,3,0,0,0,0,0,0,0,0,0
228431,35000,350,0,-2,10,5,5,1,1,0,0,0,0,0,0,0,2,1,1,0,0,0,7,3,4,0,0,0,0,0,0,0,0,0
228459,35000,350,0,-2,27,15,12,0,0,0,0,0,0,3,2,1,6,2,4,0,0,0,10,6,4,2,1,1,6,4,2,0,0,0
228468,35000,350,0,-2,1,0,1,0,0,0,0,0,0,0,0,0,1,0,1,0,0,0,0,0,0,0,0,0,0,0,0,0,0,0
228501,35000,350,0,-2,4,2,2,0,0,0,0,0,0,0,0,0,0,0,0,0,0,0,3,2,1,0,0,0,0,0,0,1,0,1
228529,35000,350,0,-2,7,7,0,0,0,0,0,0,0,0,0,0,1,1,0,0,0,0,6,6,0,0,0,0,0,0,0,0,0,0
228547,35000,350,0,-2,3,1,2,0,0,0,0,0,0,0,0,0,2,0,2,0,0,0,1,1,0,0,0,0,0,0,0,0,0,0
228608,35000,350,0,-2,1,1,0,0,0,0,0,0,0,0,0,0,0,0,0,0,0,0,1,1,0,0,0,0,0,0,0,0,0,0
228635,35000,350,0,-2,58,23,35,0,0,0,4,3,1,14,3,11,16,6,10,0,0,0,16,9,7,3,0,3,0,0,0,5,2,3
228644,35000,350,0,-2,169,34,135,1,0,1,2,1,1,4,0,4,85,15,70,0,0,0,16,2,14,0,0,0,61,16,45,0,0,0
228699,35000,350,0,-2,1,1,0,0,0,0,0,0,0,0,0,0,0,0,0,0,0,0,1,1,0,0,0,0,0,0,0,0,0,0
228705,35000,350,0,-2,2,2,0,0,0,0,0,0,0,0,0,0,1,1,0,0,0,0,1,1,0,0,0,0,0,0,0,0,0,0
228723,35000,350,0,-2,80,42,38,1,1,0,0,0,0,10,3,7,25,10,15,0,0,0,44,28,16,0,0,0,0,0,0,0,0,0
228769,35000,350,0,-2,23,13,10,0,0,0,1,0,1,1,0,1,6,4,2,1,0,1,5,4,1,0,0,0,9,5,4,0,0,0
228778,35000,350,0,-2,135,63,72,0,0,0,3,1,2,24,14,10,63,24,39,0,0,0,41,23,18,0,0,0,0,0,0,4,1,3
228787,35000,350,0,-2,17,8,9,1,1,0,1,0,1,1,1,0,1,1,0,0,0,0,8,3,5,3,2,1,2,0,2,0,0,0
228796,35000,350,0,-2,13,10,3,0,0,0,0,0,0,1,1,0,11,8,3,0,0,0,1,1,0,0,0,0,0,0,0,0,0,0
228802,35000,350,0,-2,7,6,1,0,0,0,0,0,0,2,1,1,1,1,0,0,0,0,4,4,0,0,0,0,0,0,0,0,0,0
228866,35000,350,0,-2,1,1,0,0,0,0,0,0,0,0,0,0,0,0,0,0,0,0,1,1,0,0,0,0,0,0,0,0,0,0
228875,35000,350,0,-2,35,15,20,0,0,0,1,0,1,1,0,1,23,7,16,0,0,0,7,6,1,0,0,0,3,2,1,0,0,0
228884,35000,350,0,-2,8,5,3,0,0,0,0,0,0,8,5,3,0,0,0,0,0,0,0,0,0,0,0,0,0,0,0,0,0,0
228909,35000,350,0,-2,27,4,23,0,0,0,0,0,0,4,1,3,12,0,12,0,0,0,9,3,6,0,0,0,2,0,2,0,0,0
228981,35000,350,0,-2,2,1,1,0,0,0,0,0,0,0,0,0,1,0,1,0,0,0,1,1,0,0,0,0,0,0,0,0,0,0
229027,35000,350,0,-2,17,8,9,0,0,0,1,1,0,0,0,0,6,4,2,0,0,0,5,3,2,0,0,0,5,0,5,0,0,0
229063,35000,350,0,-2,26,15,11,0,0,0,0,0,0,16,11,5,4,2,2,0,0,0,6,2,4,0,0,0,0,0,0,0,0,0
229115,35000,350,0,-2,61,30,31,2,0,2,0,0,0,7,5,2,34,14,20,0,0,0,17,11,6,1,0,1,0,0,0,0,0,0
229160,35000,350,0,-2,2,1,1,0,0,0,0,0,0,2,1,1,0,0,0,0,0,0,0,0,0,0,0,0,0,0,0,0,0,0
229179,35000,350,0,-2,18,13,5,0,0,0,0,0,0,1,0,1,6,3,3,1,1,0,5,5,0,2,2,0,3,2,1,0,0,0
229267,35000,350,0,-2,8,4,4,0,0,0,0,0,0,0,0,0,5,2,3,0,0,0,3,2,1,0,0,0,0,0,0,0,0,0
229300,35000,350,0,-2,169,10,159,0,0,0,5,2,3,45,2,43,91,4,87,1,1,0,16,1,15,1,0,1,5,0,5,5,0,5
229337,35000,350,0,-2,39,5,34,0,0,0,1,0,1,5,1,4,16,1,15,0,0,0,17,3,14,0,0,0,0,0,0,0,0,0
229355,35000,350,0,-2,9,5,4,0,0,0,0,0,0,1,1,0,0,0,0,0,0,0,8,4,4,0,0,0,0,0,0,0,0,0
229407,35000,350,0,-2,1,0,1,0,0,0,0,0,0,0,0,0,1,0,1,0,0,0,0,0,0,0,0,0,0,0,0,0,0,0
229504,35000,350,0,-2,3,3,0,0,0,0,0,0,0,1,1,0,2,2,0,0,0,0,0,0,0,0,0,0,0,0,0,0,0,0
229540,35000,350,0,-2,7,5,2,0,0,0,0,0,0,0,0,0,4,3,1,0,0,0,3,2,1,0,0,0,0,0,0,0,0,0
229814,35000,350,0,-2,4,2,2,0,0,0,0,0,0,0,0,0,0,0,0,0,0,0,4,2,2,0,0,0,0,0,0,0,0,0
229832,35000,350,0,-2,2,1,1,0,0,0,0,0,0,0,0,0,1,0,1,0,0,0,1,1,0,0,0,0,0,0,0,0,0,0
229841,35000,350,0,-2,1,0,1,0,0,0,0,0,0,0,0,0,1,0,1,0,0,0,0,0,0,0,0,0,0,0,0,0,0,0
229887,35000,350,0,-2,15,12,3,0,0,0,0,0,0,8,7,1,7,5,2,0,0,0,0,0,0,0,0,0,0,0,0,0,0,0
230038,35000,350,0,-2,27,13,14,0,0,0,0,0,0,0,0,0,4,2,2,2,2,0,19,8,11,0,0,0,1,1,0,1,0,1
230047,35000,350,0,-2,3,3,0,0,0,0,0,0,0,0,0,0,0,0,0,3,3,0,0,0,0,0,0,0,0,0,0,0,0,0
230171,35000,350,0,-2,18,13,5,0,0,0,0,0,0,1,1,0,0,0,0,1,1,0,16,11,5,0,0,0,0,0,0,0,0,0
230597,35000,350,0,-2,3,3,0,0,0,0,0,0,0,0,0,0,0,0,0,0,0,0,3,3,0,0,0,0,0,0,0,0,0,0
230603,35000,350,0,-2,2,2,0,0,0,0,0,0,0,0,0,0,0,0,0,0,0,0,2,2,0,0,0,0,0,0,0,0,0,0
230728,35000,350,0,-2,45,28,17,1,0,1,0,0,0,0,0,0,4,2,2,0,0,0,37,23,14,1,1,0,2,2,0,0,0,0
230737,35000,350,0,-2,35,27,8,0,0,0,1,1,0,1,1,0,4,3,1,0,0,0,28,21,7,1,1,0,0,0,0,0,0,0
230746,35000,350,0,-2,18,8,10,1,0,1,0,0,0,0,0,0,5,2,3,0,0,0,12,6,6,0,0,0,0,0,0,0,0,0
230764,35000,350,0,-2,256,133,123,7,5,2,13,7,6,9,3,6,46,13,33,5,4,1,133,73,60,4,2,2,33,23,10,6,3,3
230782,35000,350,0,-2,17,8,9,0,0,0,0,0,0,0,0,0,1,1,0,0,0,0,14,6,8,2,1,1,0,0,0,0,0,0
230807,35000,350,0,-2,4,4,0,0,0,0,0,0,0,0,0,0,1,1,0,0,0,0,3,3,0,0,0,0,0,0,0,0,0,0
230816,35000,350,0,-2,10,1,9,1,0,1,0,0,0,0,0,0,2,1,1,0,0,0,7,0,7,0,0,0,0,0,0,0,0,0
230834,35000,350,0,-2,2,1,1,0,0,0,0,0,0,0,0,0,0,0,0,0,0,0,0,0,0,0,0,0,2,1,1,0,0,0
230852,35000,350,0,-2,6,4,2,0,0,0,0,0,0,0,0,0,0,0,0,0,0,0,4,3,1,0,0,0,2,1,1,0,0,0
230913,35000,350,0,-2,3,2,1,0,0,0,0,0,0,0,0,0,0,0,0,0,0,0,2,1,1,0,0,0,1,1,0,0,0,0
230959,35000,350,0,-2,32,17,15,0,0,0,0,0,0,0,0,0,0,0,0,0,0,0,18,8,10,0,0,0,14,9,5,0,0,0
230995,35000,350,0,-2,22,14,8,0,0,0,1,1,0,0,0,0,0,0,0,0,0,0,16,10,6,0,0,0,5,3,2,0,0,0
231059,35000,350,0,-2,6,5,1,0,0,0,2,1,1,0,0,0,0,0,0,0,0,0,1,1,0,0,0,0,3,3,0,0,0,0
231174,35000,350,0,-2,19,13,6,0,0,0,7,4,3,2,1,1,1,0,1,0,0,0,9,8,1,0,0,0,0,0,0,0,0,0
231420,35000,350,0,-2,3,1,2,0,0,0,0,0,0,0,0,0,0,0,0,0,0,0,3,1,2,0,0,0,0,0,0,0,0,0
231536,35000,350,0,-2,1,0,1,0,0,0,0,0,0,0,0,0,0,0,0,0,0,0,1,0,1,0,0,0,0,0,0,0,0,0
231554,35000,350,0,-2,1,1,0,0,0,0,0,0,0,0,0,0,0,0,0,0,0,0,1,1,0,0,0,0,0,0,0,0,0,0
231581,35000,350,0,-2,7,5,2,0,0,0,0,0,0,0,0,0,0,0,0,0,0,0,7,5,2,0,0,0,0,0,0,0,0,0
231624,35000,350,0,-2,18,10,8,0,0,0,0,0,0,10,5,5,0,0,0,0,0,0,2,1,1,0,0,0,6,4,2,0,0,0
231651,35000,350,0,-2,25,17,8,0,0,0,0,0,0,9,6,3,1,1,0,1,1,0,14,9,5,0,0,0,0,0,0,0,0,0
231697,35000,350,0,-2,1,1,0,0,0,0,0,0,0,1,1,0,0,0,0,0,0,0,0,0,0,0,0,0,0,0,0,0,0,0
231970,35000,350,0,-2,26,4,22,1,0,1,1,0,1,15,1,14,1,1,0,0,0,0,5,2,3,3,0,3,0,0,0,0,0,0
232025,35000,350,0,-2,3,1,2,0,0,0,0,0,0,0,0,0,1,0,1,0,0,0,0,0,0,0,0,0,2,1,1,0,0,0
232043,35000,350,0,-2,5,1,4,0,0,0,1,0,1,0,0,0,0,0,0,0,0,0,4,1,3,0,0,0,0,0,0,0,0,0
232089,35000,350,0,-2,2,1,1,0,0,0,0,0,0,0,0,0,0,0,0,0,0,0,2,1,1,0,0,0,0,0,0,0,0,0
232186,35000,350,0,-2,23,10,13,0,0,0,2,0,2,4,2,2,6,2,4,0,0,0,10,6,4,0,0,0,0,0,0,1,0,1
232256,35000,350,0,-2,5,4,1,0,0,0,0,0,0,0,0,0,0,0,0,0,0,0,5,4,1,0,0,0,0,0,0,0,0,0
232265,35000,350,0,-2,6,3,3,0,0,0,0,0,0,5,3,2,1,0,1,0,0,0,0,0,0,0,0,0,0,0,0,0,0,0
232308,35000,350,0,-2,2,0,2,0,0,0,0,0,0,0,0,0,0,0,0,0,0,0,2,0,2,0,0,0,0,0,0,0,0,0
232414,35000,350,0,-2,2,2,0,0,0,0,0,0,0,2,2,0,0,0,0,0,0,0,0,0,0,0,0,0,0,0,0,0,0,0
232423,35000,350,0,-2,34,12,22,0,0,0,0,0,0,0,0,0,4,1,3,0,0,0,29,11,18,0,0,0,1,0,1,0,0,0
232557,35000,350,0,-2,89,69,20,0,0,0,3,3,0,7,4,3,5,2,3,0,0,0,70,57,13,0,0,0,4,3,1,0,0,0
232566,35000,350,0,-2,1,1,0,0,0,0,0,0,0,1,1,0,0,0,0,0,0,0,0,0,0,0,0,0,0,0,0,0,0,0
232575,35000,350,0,-2,1,1,0,0,0,0,0,0,0,0,0,0,0,0,0,0,0,0,1,1,0,0,0,0,0,0,0,0,0,0
232609,35000,350,0,-2,7,5,2,0,0,0,0,0,0,0,0,0,0,0,0,0,0,0,2,2,0,0,0,0,5,3,2,0,0,0
232672,35000,350,0,-2,13,4,9,0,0,0,0,0,0,0,0,0,0,0,0,0,0,0,12,3,9,1,1,0,0,0,0,0,0,0
232681,35000,350,0,-2,1,1,0,0,0,0,0,0,0,0,0,0,0,0,0,0,0,0,1,1,0,0,0,0,0,0,0,0,0,0
232706,35000,350,0,-2,21,11,10,0,0,0,0,0,0,6,4,2,11,4,7,0,0,0,3,2,1,0,0,0,1,1,0,0,0,0
232788,35000,350,0,-2,1,1,0,0,0,0,0,0,0,0,0,0,0,0,0,0,0,0,1,1,0,0,0,0,0,0,0,0,0,0
232937,35000,350,0,-2,2,0,2,0,0,0,0,0,0,2,0,2,0,0,0,0,0,0,0,0,0,0,0,0,0,0,0,0,0,0
232946,35000,350,0,-2,7,5,2,0,0,0,1,1,0,0,0,0,1,1,0,0,0,0,5,3,2,0,0,0,0,0,0,0,0,0
232982,35000,350,0,-2,6,2,4,0,0,0,0,0,0,4,1,3,1,0,1,0,0,0,1,1,0,0,0,0,0,0,0,0,0,0
233116,35000,350,0,-2,2,1,1,0,0,0,0,0,0,0,0,0,0,0,0,0,0,0,1,1,0,1,0,1,0,0,0,0,0,0
233277,35000,350,0,-2,22,12,10,0,0,0,0,0,0,3,3,0,3,0,3,0,0,0,14,8,6,1,0,1,1,1,0,0,0,0
233295,35000,350,0,-2,13,9,4,0,0,0,0,0,0,4,2,2,1,1,0,0,0,0,8,6,2,0,0,0,0,0,0,0,0,0
233301,35000,350,0,-2,5,4,1,0,0,0,0,0,0,3,2,1,0,0,0,0,0,0,2,2,0,0,0,0,0,0,0,0,0,0
233374,35000,350,0,-2,54,32,22,0,0,0,0,0,0,19,11,8,2,1,1,0,0,0,30,19,11,0,0,0,2,1,1,1,0,1
233426,35000,350,0,-2,3,0,3,0,0,0,0,0,0,1,0,1,0,0,0,0,0,0,2,0,2,0,0,0,0,0,0,0,0,0
233541,35000,350,0,-2,12,9,3,0,0,0,0,0,0,1,1,0,3,1,2,0,0,0,5,4,1,0,0,0,3,3,0,0,0,0
233639,35000,350,0,-2,3,1,2,0,0,0,0,0,0,2,1,1,0,0,0,0,0,0,1,0,1,0,0,0,0,0,0,0,0,0
233648,35000,350,0,-2,2,2,0,0,0,0,0,0,0,0,0,0,0,0,0,0,0,0,2,2,0,0,0,0,0,0,0,0,0,0
233718,35000,350,0,-2,9,3,6,0,0,0,0,0,0,2,1,1,0,0,0,0,0,0,4,1,3,0,0,0,3,1,2,0,0,0
233772,35000,350,0,-2,4,2,2,0,0,0,0,0,0,4,2,2,0,0,0,0,0,0,0,0,0,0,0,0,0,0,0,0,0,0
233897,35000,350,0,-2,7,4,3,0,0,0,0,0,0,0,0,0,0,0,0,0,0,0,7,4,3,0,0,0,0,0,0,0,0,0
233903,35000,350,0,-2,1,0,1,0,0,0,0,0,0,0,0,0,0,0,0,0,0,0,1,0,1,0,0,0,0,0,0,0,0,0
233921,35000,350,0,-2,86,38,48,0,0,0,5,3,2,5,3,2,4,2,2,0,0,0,70,28,42,2,2,0,0,0,0,0,0,0
233949,35000,350,0,-2,2,2,0,0,0,0,0,0,0,0,0,0,0,0,0,0,0,0,2,2,0,0,0,0,0,0,0,0,0,0
234030,35000,350,0,-2,22,8,14,0,0,0,1,0,1,10,4,6,4,2,2,0,0,0,7,2,5,0,0,0,0,0,0,0,0,0
234076,35000,350,0,-2,33,17,16,0,0,0,3,2,1,14,7,7,1,0,1,0,0,0,11,6,5,2,2,0,2,0,2,0,0,0
234085,35000,350,0,-2,26,16,10,0,0,0,0,0,0,0,0,0,1,0,1,0,0,0,25,16,9,0,0,0,0,0,0,0,0,0
234173,35000,350,0,-2,1,1,0,0,0,0,0,0,0,0,0,0,0,0,0,0,0,0,1,1,0,0,0,0,0,0,0,0,0,0
234207,35000,350,0,-2,39,15,24,0,0,0,1,0,1,5,0,5,3,0,3,0,0,0,25,11,14,3,2,1,2,2,0,0,0,0
234669,35000,350,0,-2,8,2,6,0,0,0,3,0,3,0,0,0,2,1,1,1,1,0,0,0,0,2,0,2,0,0,0,0,0,0
234711,35000,350,0,-2,5,4,1,0,0,0,0,0,0,0,0,0,4,3,1,0,0,0,1,1,0,0,0,0,0,0,0,0,0,0
234827,35000,350,0,-2,27,13,14,0,0,0,0,0,0,0,0,0,4,0,4,0,0,0,21,12,9,2,1,1,0,0,0,0,0,0
234845,35000,350,0,-2,4,2,2,0,0,0,0,0,0,0,0,0,0,0,0,0,0,0,2,1,1,2,1,1,0,0,0,0,0,0
234933,35000,350,0,-2,6,5,1,0,0,0,0,0,0,1,1,0,0,0,0,0,0,0,4,4,0,1,0,1,0,0,0,0,0,0
234951,35000,350,0,-2,2,0,2,0,0,0,0,0,0,0,0,0,0,0,0,0,0,0,2,0,2,0,0,0,0,0,0,0,0,0
234979,35000,350,0,-2,3,1,2,0,0,0,0,0,0,0,0,0,0,0,0,0,0,0,2,0,2,1,1,0,0,0,0,0,0,0
235097,35000,350,0,-2,14,12,2,0,0,0,0,0,0,1,1,0,0,0,0,1,1,0,12,10,2,0,0,0,0,0,0,0,0,0
235103,35000,350,0,-2,3,0,3,0,0,0,1,0,1,0,0,0,0,0,0,0,0,0,2,0,2,0,0,0,0,0,0,0,0,0
235149,35000,350,0,-2,1,1,0,0,0,0,0,0,0,0,0,0,0,0,0,0,0,0,0,0,0,1,1,0,0,0,0,0,0,0
235167,35000,350,0,-2,4,3,1,0,0,0,0,0,0,0,0,0,0,0,0,0,0,0,0,0,0,1,1,0,3,2,1,0,0,0
235237,35000,350,0,-2,7,3,4,1,0,1,0,0,0,2,1,1,0,0,0,0,0,0,2,0,2,0,0,0,2,2,0,0,0,0
235316,35000,350,0,-2,19,13,6,0,0,0,0,0,0,0,0,0,0,0,0,0,0,0,9,5,4,0,0,0,10,8,2,0,0,0
235334,35000,350,0,-2,1,1,0,0,0,0,0,0,0,0,0,0,0,0,0,0,0,0,1,1,0,0,0,0,0,0,0,0,0,0
235343,35000,350,0,-2,6,5,1,0,0,0,0,0,0,0,0,0,0,0,0,0,0,0,5,4,1,1,1,0,0,0,0,0,0,0
235422,35000,350,0,-2,6,3,3,0,0,0,0,0,0,0,0,0,5,3,2,0,0,0,1,0,1,0,0,0,0,0,0,0,0,0
235431,35000,350,0,-2,2,1,1,0,0,0,1,1,0,0,0,0,1,0,1,0,0,0,0,0,0,0,0,0,0,0,0,0,0,0
235547,35000,350,0,-2,6,0,6,0,0,0,0,0,0,1,0,1,0,0,0,0,0,0,1,0,1,0,0,0,4,0,4,0,0,0
235671,35000,350,0,-2,3,2,1,1,1,0,0,0,0,0,0,0,0,0,0,0,0,0,2,1,1,0,0,0,0,0,0,0,0,0
235699,35000,350,0,-2,6,3,3,0,0,0,1,0,1,2,2,0,1,0,1,0,0,0,1,0,1,0,0,0,1,1,0,0,0,0
235750,35000,350,0,-2,8,2,6,0,0,0,0,0,0,0,0,0,2,0,2,0,0,0,5,2,3,0,0,0,1,0,1,0,0,0
236188,35000,350,0,-2,5,3,2,1,1,0,0,0,0,1,0,1,1,1,0,0,0,0,2,1,1,0,0,0,0,0,0,0,0,0
236212,35000,350,0,-2,4,3,1,0,0,0,0,0,0,0,0,0,2,1,1,0,0,0,2,2,0,0,0,0,0,0,0,0,0,0
236230,35000,350,0,-2,18,9,9,1,0,1,1,0,1,3,1,2,4,3,1,0,0,0,9,5,4,0,0,0,0,0,0,0,0,0
236258,35000,350,0,-2,2,2,0,0,0,0,0,0,0,0,0,0,0,0,0,0,0,0,2,2,0,0,0,0,0,0,0,0,0,0
236328,35000,350,0,-2,9,4,5,0,0,0,0,0,0,2,2,0,0,0,0,0,0,0,7,2,5,0,0,0,0,0,0,0,0,0
236382,35000,350,0,-2,2,2,0,0,0,0,0,0,0,1,1,0,0,0,0,0,0,0,1,1,0,0,0,0,0,0,0,0,0,0
236452,35000,350,0,-2,2,0,2,0,0,0,0,0,0,0,0,0,0,0,0,0,0,0,2,0,2,0,0,0,0,0,0,0,0,0
236504,35000,350,0,-2,2,2,0,0,0,0,0,0,0,0,0,0,0,0,0,0,0,0,0,0,0,0,0,0,2,2,0,0,0,0
236513,35000,350,0,-2,3,3,0,0,0,0,0,0,0,0,0,0,1,1,0,0,0,0,0,0,0,0,0,0,2,2,0,0,0,0
236577,35000,350,0,-2,12,9,3,0,0,0,0,0,0,2,2,0,1,1,0,0,0,0,6,5,1,0,0,0,1,1,0,2,0,2
236595,35000,350,0,-2,13,11,2,0,0,0,0,0,0,3,3,0,2,2,0,0,0,0,6,6,0,0,0,0,2,0,2,0,0,0
236610,35000,350,0,-2,1,0,1,0,0,0,0,0,0,0,0,0,0,0,0,0,0,0,1,0,1,0,0,0,0,0,0,0,0,0
236638,35000,350,0,-2,4,3,1,0,0,0,0,0,0,0,0,0,0,0,0,0,0,0,3,2,1,1,1,0,0,0,0,0,0,0
236656,35000,350,0,-2,1,1,0,0,0,0,0,0,0,0,0,0,0,0,0,0,0,0,1,1,0,0,0,0,0,0,0,0,0,0
236692,35000,350,0,-2,26,4,22,1,1,0,2,0,2,1,0,1,1,0,1,0,0,0,19,1,18,1,1,0,1,1,0,0,0,0
236753,35000,350,0,-2,5,3,2,0,0,0,0,0,0,1,1,0,1,1,0,0,0,0,3,1,2,0,0,0,0,0,0,0,0,0
236887,35000,350,0,-2,1,1,0,0,0,0,0,0,0,0,0,0,0,0,0,0,0,0,1,1,0,0,0,0,0,0,0,0,0,0
236896,35000,350,0,-2,2,1,1,0,0,0,0,0,0,0,0,0,1,0,1,0,0,0,1,1,0,0,0,0,0,0,0,0,0,0
236939,35000,350,0,-2,62,42,20,0,0,0,3,2,1,3,3,0,4,4,0,1,0,1,20,15,5,1,0,1,30,18,12,0,0,0
236948,35000,350,0,-2,187,88,99,1,0,1,36,18,18,22,11,11,20,13,7,1,0,1,49,24,25,11,2,9,41,19,22,6,1,5
236975,35000,350,0,-2,2,1,1,0,0,0,0,0,0,0,0,0,0,0,0,0,0,0,2,1,1,0,0,0,0,0,0,0,0,0
237011,35000,350,0,-2,6,4,2,0,0,0,2,1,1,1,0,1,1,1,0,0,0,0,2,2,0,0,0,0,0,0,0,0,0,0
237039,35000,350,0,-2,2,1,1,0,0,0,0,0,0,0,0,0,0,0,0,0,0,0,2,1,1,0,0,0,0,0,0,0,0,0
237057,35000,350,0,-2,6,4,2,0,0,0,1,1,0,0,0,0,0,0,0,0,0,0,3,2,1,0,0,0,2,1,1,0,0,0
237066,35000,350,0,-2,8,5,3,0,0,0,0,0,0,2,1,1,1,0,1,2,1,1,3,3,0,0,0,0,0,0,0,0,0,0
237118,35000,350,0,-2,3,3,0,0,0,0,0,0,0,0,0,0,0,0,0,0,0,0,3,3,0,0,0,0,0,0,0,0,0,0
237181,35000,350,0,-2,1,0,1,0,0,0,0,0,0,0,0,0,1,0,1,0,0,0,0,0,0,0,0,0,0,0,0,0,0,0
237312,35000,350,0,-2,8,6,2,0,0,0,0,0,0,1,1,0,0,0,0,0,0,0,7,5,2,0,0,0,0,0,0,0,0,0
237330,35000,350,0,-2,3,2,1,0,0,0,0,0,0,0,0,0,0,0,0,0,0,0,3,2,1,0,0,0,0,0,0,0,0,0
237358,35000,350,0,-2,6,3,3,0,0,0,0,0,0,0,0,0,0,0,0,0,0,0,6,3,3,0,0,0,0,0,0,0,0,0
237367,35000,350,0,-2,2,2,0,0,0,0,0,0,0,0,0,0,0,0,0,0,0,0,2,2,0,0,0,0,0,0,0,0,0,0
237385,35000,350,0,-2,2,0,2,0,0,0,0,0,0,0,0,0,0,0,0,0,0,0,2,0,2,0,0,0,0,0,0,0,0,0
237525,35000,350,0,-2,13,10,3,1,1,0,0,0,0,2,1,1,0,0,0,0,0,0,10,8,2,0,0,0,0,0,0,0,0,0
237686,35000,350,0,-2,3,1,2,0,0,0,0,0,0,0,0,0,0,0,0,0,0,0,3,1,2,0,0,0,0,0,0,0,0,0
237701,35000,350,0,-2,5,4,1,0,0,0,0,0,0,0,0,0,0,0,0,0,0,0,5,4,1,0,0,0,0,0,0,0,0,0
237783,35000,350,0,-2,2,2,0,0,0,0,0,0,0,0,0,0,0,0,0,0,0,0,2,2,0,0,0,0,0,0,0,0,0,0
237792,35000,350,0,-2,3,2,1,0,0,0,0,0,0,0,0,0,0,0,0,0,0,0,3,2,1,0,0,0,0,0,0,0,0,0
237817,35000,350,0,-2,2,1,1,0,0,0,0,0,0,0,0,0,0,0,0,0,0,0,2,1,1,0,0,0,0,0,0,0,0,0
237880,35000,350,0,-2,1,1,0,0,0,0,0,0,0,0,0,0,1,1,0,0,0,0,0,0,0,0,0,0,0,0,0,0,0,0
237899,35000,350,0,-2,1,1,0,0,0,0,0,0,0,0,0,0,0,0,0,0,0,0,1,1,0,0,0,0,0,0,0,0,0,0
237932,35000,350,0,-2,3,3,0,0,0,0,0,0,0,0,0,0,1,1,0,0,0,0,2,2,0,0,0,0,0,0,0,0,0,0
237950,35000,350,0,-2,5,4,1,0,0,0,0,0,0,2,1,1,1,1,0,0,0,0,2,2,0,0,0,0,0,0,0,0,0,0
237969,35000,350,0,-2,4,2,2,0,0,0,0,0,0,0,0,0,0,0,0,0,0,0,4,2,2,0,0,0,0,0,0,0,0,0
238014,35000,350,0,-2,1,0,1,0,0,0,0,0,0,0,0,0,0,0,0,0,0,0,1,0,1,0,0,0,0,0,0,0,0,0
238032,35000,350,0,-2,12,4,8,0,0,0,0,0,0,1,0,1,0,0,0,0,0,0,11,4,7,0,0,0,0,0,0,0,0,0
238193,35000,350,0,-2,4,3,1,0,0,0,0,0,0,0,0,0,1,1,0,0,0,0,3,2,1,0,0,0,0,0,0,0,0,0
238263,35000,350,0,-2,11,6,5,0,0,0,2,0,2,1,1,0,0,0,0,0,0,0,8,5,3,0,0,0,0,0,0,0,0,0
238333,35000,350,0,-2,4,2,2,0,0,0,0,0,0,1,1,0,1,0,1,0,0,0,2,1,1,0,0,0,0,0,0,0,0,0
238458,35000,350,0,-2,12,7,5,0,0,0,0,0,0,0,0,0,0,0,0,0,0,0,9,5,4,0,0,0,3,2,1,0,0,0
238476,35000,350,0,-2,13,6,7,0,0,0,0,0,0,1,1,0,1,1,0,0,0,0,2,1,1,0,0,0,9,3,6,0,0,0
238616,35000,350,0,-2,4,2,2,0,0,0,0,0,0,0,0,0,0,0,0,0,0,0,4,2,2,0,0,0,0,0,0,0,0,0
238661,35000,350,0,-2,5,3,2,0,0,0,0,0,0,2,2,0,1,1,0,0,0,0,2,0,2,0,0,0,0,0,0,0,0,0
238722,35000,350,0,-2,5,2,3,0,0,0,0,0,0,0,0,0,0,0,0,0,0,0,5,2,3,0,0,0,0,0,0,0,0,0
238759,35000,350,0,-2,7,3,4,0,0,0,0,0,0,2,2,0,3,1,2,0,0,0,2,0,2,0,0,0,0,0,0,0,0,0
238980,35000,350,0,-2,1,1,0,0,0,0,1,1,0,0,0,0,0,0,0,0,0,0,0,0,0,0,0,0,0,0,0,0,0,0
239017,35000,350,0,-2,8,5,3,0,0,0,0,0,0,0,0,0,0,0,0,0,0,0,8,5,3,0,0,0,0,0,0,0,0,0
239080,35000,350,0,-2,4,1,3,0,0,0,0,0,0,0,0,0,1,1,0,0,0,0,1,0,1,0,0,0,2,0,2,0,0,0
239105,35000,350,0,-2,18,5,13,0,0,0,1,0,1,2,1,1,3,1,2,0,0,0,11,3,8,1,0,1,0,0,0,0,0,0
239169,35000,350,0,-2,45,14,31,0,0,0,7,1,6,8,4,4,4,0,4,0,0,0,25,8,17,1,1,0,0,0,0,0,0,0
239220,35000,350,0,-2,3,2,1,0,0,0,0,0,0,0,0,0,0,0,0,0,0,0,3,2,1,0,0,0,0,0,0,0,0,0
239248,35000,350,0,-2,5,4,1,0,0,0,0,0,0,1,1,0,1,1,0,0,0,0,3,2,1,0,0,0,0,0,0,0,0,0
239318,35000,350,0,-2,9,8,1,0,0,0,0,0,0,3,3,0,2,2,0,0,0,0,4,3,1,0,0,0,0,0,0,0,0,0
239372,35000,350,0,-2,5,2,3,0,0,0,0,0,0,0,0,0,0,0,0,0,0,0,5,2,3,0,0,0,0,0,0,0,0,0
239390,35000,350,0,-2,2,0,2,0,0,0,0,0,0,1,0,1,0,0,0,0,0,0,1,0,1,0,0,0,0,0,0,0,0,0
239424,35000,350,0,-2,1,1,0,0,0,0,0,0,0,0,0,0,0,0,0,0,0,0,1,1,0,0,0,0,0,0,0,0,0,0
239460,35000,350,0,-2,1,1,0,0,0,0,0,0,0,0,0,0,0,0,0,0,0,0,1,1,0,0,0,0,0,0,0,0,0,0
239628,35000,350,0,-2,25,14,11,0,0,0,1,0,1,0,0,0,0,0,0,0,0,0,20,11,9,0,0,0,4,3,1,0,0,0
239637,35000,350,0,-2,1,1,0,0,0,0,0,0,0,0,0,0,0,0,0,0,0,0,1,1,0,0,0,0,0,0,0,0,0,0
239716,35000,350,0,-2,22,8,14,1,0,1,0,0,0,0,0,0,1,0,1,0,0,0,19,8,11,0,0,0,1,0,1,0,0,0
239910,35000,350,0,-2,2,0,2,0,0,0,0,0,0,0,0,0,0,0,0,0,0,0,2,0,2,0,0,0,0,0,0,0,0,0
240107,35000,350,0,-2,9,4,5,0,0,0,0,0,0,1,1,0,0,0,0,0,0,0,6,3,3,0,0,0,2,0,2,0,0,0
240116,35000,350,0,-2,2,1,1,0,0,0,0,0,0,0,0,0,0,0,0,0,0,0,1,1,0,0,0,0,1,0,1,0,0,0
240125,35000,350,0,-2,5,2,3,0,0,0,0,0,0,0,0,0,1,1,0,0,0,0,4,1,3,0,0,0,0,0,0,0,0,0
240189,35000,350,0,-2,7,5,2,0,0,0,0,0,0,0,0,0,1,0,1,0,0,0,6,5,1,0,0,0,0,0,0,0,0,0
240198,35000,350,0,-2,1,0,1,0,0,0,0,0,0,0,0,0,0,0,0,0,0,0,1,0,1,0,0,0,0,0,0,0,0,0
240268,35000,350,0,-2,14,7,7,0,0,0,2,0,2,0,0,0,0,0,0,0,0,0,6,3,3,0,0,0,6,4,2,0,0,0
240277,35000,350,0,-2,9,5,4,0,0,0,0,0,0,0,0,0,0,0,0,0,0,0,9,5,4,0,0,0,0,0,0,0,0,0
240329,35000,350,0,-2,18,11,7,0,0,0,2,1,1,0,0,0,0,0,0,0,0,0,6,3,3,0,0,0,10,7,3,0,0,0
240365,35000,350,0,-2,31,20,11,1,1,0,1,1,0,7,4,3,0,0,0,0,0,0,15,9,6,1,1,0,6,4,2,0,0,0
240374,35000,350,0,-2,1,1,0,0,0,0,0,0,0,0,0,0,0,0,0,0,0,0,1,1,0,0,0,0,0,0,0,0,0,0
240417,35000,350,0,-2,6,3,3,0,0,0,0,0,0,0,0,0,0,0,0,0,0,0,5,3,2,0,0,0,1,0,1,0,0,0
240426,35000,350,0,-2,3,3,0,0,0,0,0,0,0,0,0,0,0,0,0,0,0,0,2,2,0,0,0,0,1,1,0,0,0,0
240444,35000,350,0,-2,130,71,59,1,0,1,1,0,1,13,8,5,22,13,9,0,0,0,57,34,23,1,0,1,34,16,18,1,0,1
240453,35000,350,0,-2,28,20,8,1,1,0,0,0,0,12,8,4,1,1,0,0,0,0,13,9,4,0,0,0,1,1,0,0,0,0
240462,35000,350,0,-2,12,8,4,0,0,0,0,0,0,0,0,0,0,0,0,0,0,0,12,8,4,0,0,0,0,0,0,0,0,0
240471,35000,350,0,-2,7,2,5,1,0,1,0,0,0,0,0,0,0,0,0,0,0,0,5,2,3,1,0,1,0,0,0,0,0,0
240480,35000,350,0,-2,16,13,3,0,0,0,0,0,0,0,0,0,2,1,1,0,0,0,14,12,2,0,0,0,0,0,0,0,0,0
240505,35000,350,0,-2,7,5,2,0,0,0,0,0,0,0,0,0,2,0,2,0,0,0,3,3,0,0,0,0,2,2,0,0,0,0
240514,35000,350,0,-2,2,1,1,0,0,0,0,0,0,0,0,0,0,0,0,0,0,0,2,1,1,0,0,0,0,0,0,0,0,0
240596,35000,350,0,-2,2,1,1,0,0,0,0,0,0,0,0,0,1,1,0,0,0,0,1,0,1,0,0,0,0,0,0,0,0,0
240620,35000,350,0,-2,27,9,18,1,0,1,0,0,0,0,0,0,4,0,4,0,0,0,20,8,12,2,1,1,0,0,0,0,0,0
240657,35000,350,0,-2,4,3,1,0,0,0,0,0,0,0,0,0,0,0,0,0,0,0,4,3,1,0,0,0,0,0,0,0,0,0
240666,35000,350,0,-2,3,3,0,0,0,0,0,0,0,0,0,0,0,0,0,0,0,0,3,3,0,0,0,0,0,0,0,0,0,0
240693,35000,350,0,-2,5,1,4,0,0,0,0,0,0,0,0,0,1,0,1,0,0,0,4,1,3,0,0,0,0,0,0,0,0,0
240718,35000,350,0,-2,2,2,0,0,0,0,0,0,0,0,0,0,0,0,0,0,0,0,2,2,0,0,0,0,0,0,0,0,0,0
240727,35000,350,0,-2,37,22,15,0,0,0,0,0,0,0,0,0,5,3,2,0,0,0,22,13,9,0,0,0,10,6,4,0,0,0
240736,35000,350,0,-2,5,4,1,0,0,0,0,0,0,0,0,0,0,0,0,5,4,1,0,0,0,0,0,0,0,0,0,0,0,0
240754,35000,350,0,-2,3,2,1,0,0,0,0,0,0,0,0,0,0,0,0,3,2,1,0,0,0,0,0,0,0,0,0,0,0,0
241517,35000,350,0,-2,2,1,1,0,0,0,0,0,0,0,0,0,2,1,1,0,0,0,0,0,0,0,0,0,0,0,0,0,0,0
241836,35000,350,0,-2,8,0,8,0,0,0,0,0,0,0,0,0,8,0,8,0,0,0,0,0,0,0,0,0,0,0,0,0,0,0
242060,35000,350,0,-2,2,2,0,0,0,0,0,0,0,0,0,0,2,2,0,0,0,0,0,0,0,0,0,0,0,0,0,0,0,0
242635,35000,350,0,-2,3,0,3,0,0,0,0,0,0,0,0,0,3,0,3,0,0,0,0,0,0,0,0,0,0,0,0,0,0,0
242653,35000,350,0,-2,2,1,1,0,0,0,0,0,0,0,0,0,2,1,1,0,0,0,0,0,0,0,0,0,0,0,0,0,0,0
242671,35000,350,0,-2,1,0,1,0,0,0,0,0,0,0,0,0,1,0,1,0,0,0,0,0,0,0,0,0,0,0,0,0,0,0
242705,35000,350,0,-2,2,2,0,0,0,0,0,0,0,0,0,0,2,2,0,0,0,0,0,0,0,0,0,0,0,0,0,0,0,0
242972,35000,350,0,-2,14,10,4,0,0,0,0,0,0,1,1,0,7,4,3,1,0,1,5,5,0,0,0,0,0,0,0,0,0,0
243197,35000,350,0,-2,37,20,17,0,0,0,0,0,0,0,0,0,4,3,1,0,0,0,0,0,0,0,0,0,33,17,16,0,0,0
243443,35000,350,0,-2,1,1,0,0,0,0,0,0,0,0,0,0,1,1,0,0,0,0,0,0,0,0,0,0,0,0,0,0,0,0
243638,35000,350,0,-2,10,6,4,0,0,0,0,0,0,0,0,0,0,0,0,10,6,4,0,0,0,0,0,0,0,0,0,0,0,0
243744,35000,350,0,-2,97,54,43,0,0,0,12,7,5,0,0,0,15,12,3,1,1,0,9,5,4,0,0,0,58,27,31,2,2,0
243780,35000,350,0,-2,97,36,61,0,0,0,6,1,5,6,4,2,9,5,4,0,0,0,68,22,46,3,2,1,4,2,2,1,0,1
243823,35000,350,0,-2,9,2,7,0,0,0,0,0,0,0,0,0,6,2,4,0,0,0,1,0,1,0,0,0,2,0,2,0,0,0
244446,35000,350,0,-2,1,0,1,0,0,0,0,0,0,0,0,0,0,0,0,0,0,0,1,0,1,0,0,0,0,0,0,0,0,0
245652,35000,350,0,-2,1,1,0,0,0,0,0,0,0,0,0,0,1,1,0,0,0,0,0,0,0,0,0,0,0,0,0,0,0,0
245953,35000,350,0,-2,1,1,0,0,0,0,0,0,0,0,0,0,0,0,0,0,0,0,1,1,0,0,0,0,0,0,0,0,0,0
246354,35000,350,0,-2,5,3,2,0,0,0,0,0,0,0,0,0,5,3,2,0,0,0,0,0,0,0,0,0,0,0,0,0,0,0
246813,35000,350,0,-2,9,9,0,0,0,0,1,1,0,4,4,0,1,1,0,0,0,0,3,3,0,0,0,0,0,0,0,0,0,0
247603,35000,350,0,-2,1,1,0,0,0,0,0,0,0,0,0,0,1,1,0,0,0,0,0,0,0,0,0,0,0,0,0,0,0,0
247649,35000,350,0,-2,4,3,1,0,0,0,0,0,0,0,0,0,0,0,0,0,0,0,4,3,1,0,0,0,0,0,0,0,0,0
247834,35000,350,0,-2,23,23,0,0,0,0,0,0,0,5,5,0,1,1,0,0,0,0,17,17,0,0,0,0,0,0,0,0,0,0
251260,35000,350,0,-2,2,1,1,0,0,0,0,0,0,0,0,0,0,0,0,0,0,0,1,1,0,1,0,1,0,0,0,0,0,0
260372,35000,350,0,-2,1,0,1,1,0,1,0,0,0,0,0,0,0,0,0,0,0,0,0,0,0,0,0,0,0,0,0,0,0,0
262031,35000,350,0,-2,1,0,1,0,0,0,0,0,0,1,0,1,0,0,0,0,0,0,0,0,0,0,0,0,0,0,0,0,0,0
262129,35000,350,0,-2,6,3,3,0,0,0,0,0,0,3,2,1,0,0,0,0,0,0,3,1,2,0,0,0,0,0,0,0,0,0
363633,35000,350,0,-2,3,2,1,0,0,0,0,0,0,0,0,0,3,2,1,0,0,0,0,0,0,0,0,0,0,0,0,0,0,0
364016,35000,350,0,-2,3,0,3,1,0,1,0,0,0,0,0,0,1,0,1,0,0,0,1,0,1,0,0,0,0,0,0,0,0,0
364025,35000,350,0,-2,1,1,0,0,0,0,0,0,0,0,0,0,0,0,0,0,0,0,1,1,0,0,0,0,0,0,0,0,0,0
366252,35000,350,0,-2,24,16,8,0,0,0,1,0,1,1,1,0,0,0,0,0,0,0,22,15,7,0,0,0,0,0,0,0,0,0
366395,35000,350,0,-2,2,2,0,0,0,0,0,0,0,1,1,0,0,0,0,0,0,0,1,1,0,0,0,0,0,0,0,0,0,0
366465,35000,350,0,-2,4,0,4,0,0,0,0,0,0,3,0,3,0,0,0,0,0,0,1,0,1,0,0,0,0,0,0,0,0,0
366711,35000,350,0,-2,8,7,1,0,0,0,0,0,0,0,0,0,6,5,1,0,0,0,1,1,0,1,1,0,0,0,0,0,0,0
367459,35000,350,0,-2,2,2,0,0,0,0,0,0,0,0,0,0,0,0,0,0,0,0,2,2,0,0,0,0,0,0,0,0,0,0
367954,35000,350,0,-2,1,1,0,0,0,0,0,0,0,0,0,0,0,0,0,0,0,0,0,0,0,0,0,0,1,1,0,0,0,0
368911,35000,350,0,-2,2,1,1,0,0,0,0,0,0,1,0,1,0,0,0,0,0,0,1,1,0,0,0,0,0,0,0,0,0,0
376695,35000,350,0,-2,6,5,1,0,0,0,0,0,0,0,0,0,0,0,0,6,5,1,0,0,0,0,0,0,0,0,0,0,0,0
377555,35000,350,0,-2,2,0,2,0,0,0,0,0,0,0,0,0,2,0,2,0,0,0,0,0,0,0,0,0,0,0,0,0,0,0
377564,35000,350,0,-2,4,3,1,0,0,0,0,0,0,1,1,0,1,0,1,1,1,0,0,0,0,1,1,0,0,0,0,0,0,0
380377,35000,350,0,-2,9,7,2,9,7,2,0,0,0,0,0,0,0,0,0,0,0,0,0,0,0,0,0,0,0,0,0,0,0,0
383190,35000,350,0,-2,1,1,0,0,0,0,0,0,0,0,0,0,0,0,0,1,1,0,0,0,0,0,0,0,0,0,0,0,0,0
384254,35000,350,0,-2,1,1,0,0,0,0,0,0,0,0,0,0,0,0,0,0,0,0,1,1,0,0,0,0,0,0,0,0,0,0
384333,35000,350,0,-2,1,0,1,0,0,0,0,0,0,0,0,0,1,0,1,0,0,0,0,0,0,0,0,0,0,0,0,0,0,0
384342,35000,350,0,-2,7,1,6,0,0,0,0,0,0,0,0,0,0,0,0,0,0,0,7,1,6,0,0,0,0,0,0,0,0,0
385415,35000,350,0,-2,9,6,3,0,0,0,0,0,0,2,1,1,5,4,1,0,0,0,2,1,1,0,0,0,0,0,0,0,0,0
399212,35000,350,0,-2,1,1,0,0,0,0,0,0,0,0,0,0,0,0,0,0,0,0,1,1,0,0,0,0,0,0,0,0,0,0
399869,35000,350,0,-2,1,1,0,0,0,0,0,0,0,0,0,0,1,1,0,0,0,0,0,0,0,0,0,0,0,0,0,0,0,0
403469,35000,350,0,-2,1,0,1,0,0,0,0,0,0,0,0,0,0,0,0,0,0,0,1,0,1,0,0,0,0,0,0,0,0,0
403478,35000,350,0,-2,2,1,1,0,0,0,0,0,0,0,0,0,0,0,0,0,0,0,2,1,1,0,0,0,0,0,0,0,0,0
404222,35000,350,0,-2,1,1,0,0,0,0,0,0,0,0,0,0,1,1,0,0,0,0,0,0,0,0,0,0,0,0,0,0,0,0
404426,35000,350,0,-2,2,2,0,1,1,0,0,0,0,0,0,0,0,0,0,0,0,0,1,1,0,0,0,0,0,0,0,0,0,0
405872,35000,350,0,-2,5,4,1,0,0,0,0,0,0,2,2,0,0,0,0,0,0,0,3,2,1,0,0,0,0,0,0,0,0,0
406033,35000,350,0,-2,1,1,0,0,0,0,0,0,0,0,0,0,0,0,0,0,0,0,1,1,0,0,0,0,0,0,0,0,0,0
407629,35000,350,0,-2,6,4,2,0,0,0,0,0,0,1,0,1,0,0,0,0,0,0,5,4,1,0,0,0,0,0,0,0,0,0
409315,35000,350,0,-2,11,8,3,0,0,0,0,0,0,0,0,0,11,8,3,0,0,0,0,0,0,0,0,0,0,0,0,0,0,0
409698,35000,350,0,-2,8,4,4,0,0,0,0,0,0,3,3,0,3,0,3,0,0,0,2,1,1,0,0,0,0,0,0,0,0,0
413617,35000,350,0,-2,1,1,0,1,1,0,0,0,0,0,0,0,0,0,0,0,0,0,0,0,0,0,0,0,0,0,0,0,0,0
414595,35000,350,0,-2,1,1,0,0,0,0,0,0,0,0,0,0,0,0,0,0,0,0,0,0,0,0,0,0,1,1,0,0,0,0
416801,35000,350,0,-2,2,1,1,0,0,0,1,0,1,0,0,0,0,0,0,0,0,0,1,1,0,0,0,0,0,0,0,0,0,0
418533,35000,350,0,-2,5,2,3,0,0,0,0,0,0,0,0,0,0,0,0,0,0,0,5,2,3,0,0,0,0,0,0,0,0,0
420246,35000,350,0,-2,1,0,1,0,0,0,0,0,0,0,0,0,0,0,0,0,0,0,1,0,1,0,0,0,0,0,0,0,0,0
420398,35000,350,0,-2,17,7,10,0,0,0,0,0,0,0,0,0,12,4,8,0,0,0,5,3,2,0,0,0,0,0,0,0,0,0
420431,35000,350,0,-2,5,2,3,0,0,0,0,0,0,5,2,3,0,0,0,0,0,0,0,0,0,0,0,0,0,0,0,0,0,0
420538,35000,350,0,-2,3,3,0,0,0,0,0,0,0,0,0,0,0,0,0,0,0,0,3,3,0,0,0,0,0,0,0,0,0,0
420556,35000,350,0,-2,1,1,0,0,0,0,0,0,0,0,0,0,0,0,0,0,0,0,1,1,0,0,0,0,0,0,0,0,0,0
422020,35000,350,0,-2,1,1,0,0,0,0,0,0,0,0,0,0,1,1,0,0,0,0,0,0,0,0,0,0,0,0,0,0,0,0
423643,35000,350,0,-2,14,5,9,0,0,0,0,0,0,0,0,0,6,4,2,0,0,0,8,1,7,0,0,0,0,0,0,0,0,0
423652,35000,350,0,-2,1,1,0,0,0,0,0,0,0,0,0,0,0,0,0,0,0,0,1,1,0,0,0,0,0,0,0,0,0,0
428392,35000,350,0,-2,1,1,0,0,0,0,0,0,0,0,0,0,0,0,0,0,0,0,1,1,0,0,0,0,0,0,0,0,0,0
429094,35000,350,0,-2,1,0,1,0,0,0,0,0,0,0,0,0,0,0,0,0,0,0,1,0,1,0,0,0,0,0,0,0,0,0
431141,35000,350,0,-2,2,1,1,0,0,0,0,0,0,0,0,0,0,0,0,0,0,0,2,1,1,0,0,0,0,0,0,0,0,0
432524,35000,350,0,-2,2,2,0,0,0,0,0,0,0,2,2,0,0,0,0,0,0,0,0,0,0,0,0,0,0,0,0,0,0,0
433420,35000,350,0,-2,10,5,5,1,0,1,0,0,0,1,0,1,3,1,2,0,0,0,4,3,1,1,1,0,0,0,0,0,0,0
433660,35000,350,0,-2,14,11,3,0,0,0,0,0,0,1,1,0,2,2,0,0,0,0,11,8,3,0,0,0,0,0,0,0,0,0
434016,35000,350,0,-2,3,3,0,2,2,0,0,0,0,0,0,0,0,0,0,0,0,0,1,1,0,0,0,0,0,0,0,0,0,0
434672,35000,350,0,-2,13,11,2,0,0,0,0,0,0,8,7,1,2,2,0,0,0,0,2,1,1,0,0,0,1,1,0,0,0,0
435000,35000,350,0,-2,7,6,1,0,0,0,0,0,0,2,2,0,0,0,0,0,0,0,5,4,1,0,0,0,0,0,0,0,0,0
436304,35000,350,0,-2,1,0,1,0,0,0,0,0,0,1,0,1,0,0,0,0,0,0,0,0,0,0,0,0,0,0,0,0,0,0
436429,35000,350,0,-2,1,1,0,0,0,0,0,0,0,1,1,0,0,0,0,0,0,0,0,0,0,0,0,0,0,0,0,0,0,0
437103,35000,350,0,-2,2,2,0,0,0,0,0,0,0,1,1,0,0,0,0,0,0,0,1,1,0,0,0,0,0,0,0,0,0,0
438665,35000,350,0,-2,1,1,0,0,0,0,0,0,0,0,0,0,0,0,0,0,0,0,1,1,0,0,0,0,0,0,0,0,0,0
439118,35000,350,0,-2,1,0,1,1,0,1,0,0,0,0,0,0,0,0,0,0,0,0,0,0,0,0,0,0,0,0,0,0,0,0
439701,35000,350,0,-2,1,1,0,0,0,0,0,0,0,0,0,0,0,0,0,0,0,0,1,1,0,0,0,0,0,0,0,0,0,0
440402,35000,350,0,-2,4,1,3,0,0,0,0,0,0,1,0,1,0,0,0,0,0,0,3,1,2,0,0,0,0,0,0,0,0,0
441609,35000,350,0,-2,4,4,0,0,0,0,0,0,0,0,0,0,4,4,0,0,0,0,0,0,0,0,0,0,0,0,0,0,0,0
441937,35000,350,0,-2,13,6,7,0,0,0,3,1,2,0,0,0,8,3,5,0,0,0,0,0,0,0,0,0,2,2,0,0,0,0
442781,35000,350,0,-2,3,3,0,3,3,0,0,0,0,0,0,0,0,0,0,0,0,0,0,0,0,0,0,0,0,0,0,0,0,0
442806,35000,350,0,-2,2,2,0,0,0,0,0,0,0,0,0,0,0,0,0,0,0,0,2,2,0,0,0,0,0,0,0,0,0,0
442930,35000,350,0,-2,1,1,0,0,0,0,0,0,0,0,0,0,1,1,0,0,0,0,0,0,0,0,0,0,0,0,0,0,0,0
443410,35000,350,0,-2,3,2,1,0,0,0,0,0,0,0,0,0,1,1,0,0,0,0,2,1,1,0,0,0,0,0,0,0,0,0
444954,35000,350,0,-2,2,2,0,0,0,0,0,0,0,0,0,0,0,0,0,0,0,0,2,2,0,0,0,0,0,0,0,0,0,0
445188,35000,350,0,-2,12,4,8,0,0,0,0,0,0,0,0,0,11,4,7,0,0,0,1,0,1,0,0,0,0,0,0,0,0,0
445708,35000,350,0,-2,4,2,2,0,0,0,0,0,0,1,0,1,1,1,0,0,0,0,1,1,0,1,0,1,0,0,0,0,0,0
445735,35000,350,0,-2,10,0,10,0,0,0,0,0,0,0,0,0,7,0,7,0,0,0,3,0,3,0,0,0,0,0,0,0,0,0
445948,35000,350,0,-2,2,1,1,0,0,0,0,0,0,1,0,1,0,0,0,0,0,0,1,1,0,0,0,0,0,0,0,0,0,0
446048,35000,350,0,-2,4,1,3,0,0,0,0,0,0,0,0,0,0,0,0,0,0,0,4,1,3,0,0,0,0,0,0,0,0,0
446233,35000,350,0,-2,1,0,1,0,0,0,0,0,0,0,0,0,0,0,0,0,0,0,1,0,1,0,0,0,0,0,0,0,0,0
446385,35000,350,0,-2,1,1,0,0,0,0,0,0,0,0,0,0,0,0,0,0,0,0,1,1,0,0,0,0,0,0,0,0,0,0
446552,35000,350,0,-2,1,1,0,0,0,0,0,0,0,0,0,0,0,0,0,0,0,0,1,1,0,0,0,0,0,0,0,0,0,0
446561,35000,350,0,-2,2,2,0,0,0,0,0,0,0,0,0,0,2,2,0,0,0,0,0,0,0,0,0,0,0,0,0,0,0,0
446640,35000,350,0,-2,6,6,0,0,0,0,0,0,0,3,3,0,0,0,0,0,0,0,2,2,0,0,0,0,1,1,0,0,0,0
446774,35000,350,0,-2,5,0,5,0,0,0,0,0,0,0,0,0,0,0,0,0,0,0,5,0,5,0,0,0,0,0,0,0,0,0
447582,35000,350,0,-2,1,1,0,0,0,0,0,0,0,0,0,0,0,0,0,0,0,0,1,1,0,0,0,0,0,0,0,0,0,0
447689,35000,350,0,-2,3,0,3,0,0,0,0,0,0,1,0,1,0,0,0,0,0,0,2,0,2,0,0,0,0,0,0,0,0,0
450933,35000,350,0,-2,1,1,0,1,1,0,0,0,0,0,0,0,0,0,0,0,0,0,0,0,0,0,0,0,0,0,0,0,0,0
451510,35000,350,0,-2,1,1,0,0,0,0,0,0,0,0,0,0,0,0,0,0,0,0,1,1,0,0,0,0,0,0,0,0,0,0
451556,35000,350,0,-2,8,3,5,0,0,0,0,0,0,0,0,0,8,3,5,0,0,0,0,0,0,0,0,0,0,0,0,0,0,0
451927,35000,350,0,-2,2,1,1,0,0,0,0,0,0,0,0,0,0,0,0,0,0,0,2,1,1,0,0,0,0,0,0,0,0,0
452948,35000,350,0,-2,1,1,0,0,0,0,0,0,0,0,0,0,0,0,0,0,0,0,1,1,0,0,0,0,0,0,0,0,0,0
454184,35000,350,0,-2,1,1,0,0,0,0,0,0,0,0,0,0,0,0,0,0,0,0,0,0,0,1,1,0,0,0,0,0,0,0
455114,35000,350,0,-2,2,1,1,0,0,0,0,0,0,0,0,0,0,0,0,0,0,0,2,1,1,0,0,0,0,0,0,0,0,0
455196,35000,350,0,-2,1,1,0,0,0,0,0,0,0,1,1,0,0,0,0,0,0,0,0,0,0,0,0,0,0,0,0,0,0,0
456542,35000,350,0,-2,2,2,0,0,0,0,0,0,0,0,0,0,0,0,0,0,0,0,2,2,0,0,0,0,0,0,0,0,0,0
456852,35000,350,0,-2,2,2,0,0,0,0,0,0,0,1,1,0,1,1,0,0,0,0,0,0,0,0,0,0,0,0,0,0,0,0
459259,35000,350,0,-2,2,1,1,0,0,0,0,0,0,0,0,0,2,1,1,0,0,0,0,0,0,0,0,0,0,0,0,0,0,0
459268,35000,350,0,-2,2,2,0,0,0,0,0,0,0,0,0,0,1,1,0,0,0,0,1,1,0,0,0,0,0,0,0,0,0,0
459736,35000,350,0,-2,5,4,1,0,0,0,2,1,1,2,2,0,1,1,0,0,0,0,0,0,0,0,0,0,0,0,0,0,0,0
459824,35000,350,0,-2,4,4,0,0,0,0,1,1,0,1,1,0,0,0,0,0,0,0,1,1,0,1,1,0,0,0,0,0,0,0
459949,35000,350,0,-2,2,2,0,0,0,0,0,0,0,0,0,0,1,1,0,0,0,0,1,1,0,0,0,0,0,0,0,0,0,0
460394,35000,350,0,-2,1,1,0,0,0,0,0,0,0,0,0,0,1,1,0,0,0,0,0,0,0,0,0,0,0,0,0,0,0,0
460464,35000,350,0,-2,2,1,1,0,0,0,0,0,0,0,0,0,1,0,1,0,0,0,0,0,0,0,0,0,0,0,0,1,1,0
461148,35000,350,0,-2,5,2,3,0,0,0,0,0,0,0,0,0,4,1,3,0,0,0,1,1,0,0,0,0,0,0,0,0,0,0
462354,35000,350,0,-2,1,1,0,0,0,0,0,0,0,0,0,0,1,1,0,0,0,0,0,0,0,0,0,0,0,0,0,0,0,0
464226,35000,350,0,-2,4,1,3,0,0,0,0,0,0,0,0,0,4,1,3,0,0,0,0,0,0,0,0,0,0,0,0,0,0,0
475565,35000,350,0,-2,3,2,1,0,0,0,0,0,0,3,2,1,0,0,0,0,0,0,0,0,0,0,0,0,0,0,0,0,0,0
476726,35000,350,0,-2,2,1,1,0,0,0,0,0,0,0,0,0,2,1,1,0,0,0,0,0,0,0,0,0,0,0,0,0,0,0
480091,35000,350,0,-2,5,1,4,0,0,0,0,0,0,0,0,0,0,0,0,0,0,0,5,1,4,0,0,0,0,0,0,0,0,0
480790,35000,350,0,-2,3,3,0,0,0,0,0,0,0,2,2,0,1,1,0,0,0,0,0,0,0,0,0,0,0,0,0,0,0,0
480967,35000,350,0,-2,2,2,0,1,1,0,0,0,0,0,0,0,0,0,0,0,0,0,1,1,0,0,0,0,0,0,0,0,0,0
481030,35000,350,0,-2,1,1,0,0,0,0,0,0,0,0,0,0,0,0,0,0,0,0,1,1,0,0,0,0,0,0,0,0,0,0
481775,35000,350,0,-2,1,1,0,0,0,0,0,0,0,1,1,0,0,0,0,0,0,0,0,0,0,0,0,0,0,0,0,0,0,0
482149,35000,350,0,-2,54,13,41,0,0,0,3,2,1,30,5,25,4,1,3,0,0,0,14,4,10,2,1,1,1,0,1,0,0,0
482158,35000,350,0,-2,5,3,2,0,0,0,0,0,0,0,0,0,0,0,0,0,0,0,5,3,2,0,0,0,0,0,0,0,0,0
482680,35000,350,0,-2,23,12,11,0,0,0,0,0,0,1,1,0,2,0,2,0,0,0,20,11,9,0,0,0,0,0,0,0,0,0
482699,35000,350,0,-2,2,2,0,0,0,0,0,0,0,0,0,0,0,0,0,0,0,0,2,2,0,0,0,0,0,0,0,0,0,0
482936,35000,350,0,-2,3,3,0,0,0,0,0,0,0,1,1,0,0,0,0,0,0,0,2,2,0,0,0,0,0,0,0,0,0,0
483018,35000,350,0,-2,3,1,2,0,0,0,0,0,0,1,0,1,0,0,0,0,0,0,1,1,0,1,0,1,0,0,0,0,0,0
483045,35000,350,0,-2,16,4,12,0,0,0,0,0,0,13,3,10,0,0,0,0,0,0,3,1,2,0,0,0,0,0,0,0,0,0
483212,35000,350,0,-2,1,1,0,0,0,0,0,0,0,0,0,0,0,0,0,0,0,0,1,1,0,0,0,0,0,0,0,0,0,0
484844,35000,350,0,-2,5,1,4,0,0,0,1,0,1,0,0,0,0,0,0,0,0,0,0,0,0,0,0,0,0,0,0,4,1,3
484905,35000,350,0,-2,3,2,1,0,0,0,0,0,0,1,1,0,1,1,0,0,0,0,0,0,0,1,0,1,0,0,0,0,0,0
485111,35000,350,0,-2,5,2,3,0,0,0,0,0,0,2,1,1,0,0,0,0,0,0,3,1,2,0,0,0,0,0,0,0,0,0
485458,35000,350,0,-2,8,6,2,0,0,0,1,1,0,2,0,2,0,0,0,0,0,0,5,5,0,0,0,0,0,0,0,0,0,0
486196,35000,350,0,-2,1,1,0,0,0,0,0,0,0,0,0,0,1,1,0,0,0,0,0,0,0,0,0,0,0,0,0,0,0,0
486257,35000,350,0,-2,1,1,0,0,0,0,0,0,0,1,1,0,0,0,0,0,0,0,0,0,0,0,0,0,0,0,0,0,0,0
486284,35000,350,0,-2,1,0,1,0,0,0,0,0,0,0,0,0,0,0,0,0,0,0,1,0,1,0,0,0,0,0,0,0,0,0
486424,35000,350,0,-2,2,0,2,0,0,0,0,0,0,2,0,2,0,0,0,0,0,0,0,0,0,0,0,0,0,0,0,0,0,0
486840,35000,350,0,-2,45,21,24,1,0,1,0,0,0,15,4,11,11,5,6,0,0,0,13,8,5,1,1,0,3,3,0,1,0,1
486901,35000,350,0,-2,1,1,0,0,0,0,0,0,0,0,0,0,0,0,0,0,0,0,1,1,0,0,0,0,0,0,0,0,0,0
487010,35000,350,0,-2,33,12,21,0,0,0,0,0,0,22,8,14,1,1,0,0,0,0,8,2,6,2,1,1,0,0,0,0,0,0
487092,35000,350,0,-2,2,2,0,0,0,0,0,0,0,1,1,0,0,0,0,0,0,0,0,0,0,1,1,0,0,0,0,0,0,0
487162,35000,350,0,-2,5,4,1,0,0,0,0,0,0,1,0,1,0,0,0,0,0,0,4,4,0,0,0,0,0,0,0,0,0,0
487320,35000,350,0,-2,8,5,3,0,0,0,0,0,0,1,1,0,4,2,2,0,0,0,3,2,1,0,0,0,0,0,0,0,0,0
487524,35000,350,0,-2,13,10,3,0,0,0,0,0,0,0,0,0,0,0,0,0,0,0,12,9,3,0,0,0,1,1,0,0,0,0
488305,35000,350,0,-2,1,0,1,0,0,0,0,0,0,0,0,0,0,0,0,0,0,0,1,0,1,0,0,0,0,0,0,0,0,0
488527,35000,350,0,-2,4,4,0,0,0,0,0,0,0,0,0,0,0,0,0,0,0,0,4,4,0,0,0,0,0,0,0,0,0,0
488730,35000,350,0,-2,2,1,1,0,0,0,0,0,0,0,0,0,1,0,1,0,0,0,1,1,0,0,0,0,0,0,0,0,0,0
489937,35000,350,0,-2,2,2,0,0,0,0,0,0,0,0,0,0,0,0,0,0,0,0,2,2,0,0,0,0,0,0,0,0,0,0
490106,35000,350,0,-2,1,1,0,0,0,0,1,1,0,0,0,0,0,0,0,0,0,0,0,0,0,0,0,0,0,0,0,0,0,0
490373,35000,350,0,-2,14,3,11,0,0,0,0,0,0,1,0,1,2,1,1,0,0,0,6,1,5,2,0,2,3,1,2,0,0,0
490805,35000,350,0,-2,6,3,3,0,0,0,0,0,0,1,0,1,2,1,1,0,0,0,3,2,1,0,0,0,0,0,0,0,0,0
491181,35000,350,0,-2,1,1,0,0,0,0,0,0,0,0,0,0,0,0,0,0,0,0,1,1,0,0,0,0,0,0,0,0,0,0
491525,35000,350,0,-2,3,0,3,0,0,0,0,0,0,0,0,0,2,0,2,0,0,0,1,0,1,0,0,0,0,0,0,0,0,0
491844,35000,350,0,-2,1,1,0,1,1,0,0,0,0,0,0,0,0,0,0,0,0,0,0,0,0,0,0,0,0,0,0,0,0,0
492263,35000,350,0,-2,1,0,1,0,0,0,0,0,0,1,0,1,0,0,0,0,0,0,0,0,0,0,0,0,0,0,0,0,0,0
492689,35000,350,0,-2,37,5,32,0,0,0,0,0,0,0,0,0,34,5,29,0,0,0,3,0,3,0,0,0,0,0,0,0,0,0
493080,35000,350,0,-2,1,1,0,0,0,0,0,0,0,0,0,0,1,1,0,0,0,0,0,0,0,0,0,0,0,0,0,0,0,0
494250,35000,350,0,-2,1,1,0,0,0,0,0,0,0,0,0,0,1,1,0,0,0,0,0,0,0,0,0,0,0,0,0,0,0,0
494287,35000,350,0,-2,1,0,1,0,0,0,0,0,0,0,0,0,1,0,1,0,0,0,0,0,0,0,0,0,0,0,0,0,0,0
494603,35000,350,0,-2,5,5,0,0,0,0,0,0,0,1,1,0,0,0,0,0,0,0,4,4,0,0,0,0,0,0,0,0,0,0
495767,35000,350,0,-2,75,46,29,0,0,0,2,2,0,7,3,4,6,4,2,0,0,0,57,36,21,3,1,2,0,0,0,0,0,0
100724,36000,360,0,-2,3,0,3,0,0,0,0,0,0,2,0,2,0,0,0,0,0,0,0,0,0,0,0,0,1,0,1,0,0,0
100751,36000,360,0,-2,6,2,4,0,0,0,0,0,0,2,1,1,0,0,0,0,0,0,4,1,3,0,0,0,0,0,0,0,0,0
100830,36000,360,0,-2,1,0,1,0,0,0,0,0,0,0,0,0,0,0,0,0,0,0,1,0,1,0,0,0,0,0,0,0,0,0
102368,36000,360,0,-2,4,1,3,0,0,0,0,0,0,1,1,0,0,0,0,0,0,0,3,0,3,0,0,0,0,0,0,0,0,0
102845,36000,360,0,-2,17,5,12,0,0,0,0,0,0,3,0,3,3,0,3,1,0,1,10,5,5,0,0,0,0,0,0,0,0,0
104151,36000,360,0,-2,5,4,1,0,0,0,0,0,0,0,0,0,0,0,0,0,0,0,3,2,1,0,0,0,1,1,0,1,1,0
104717,36000,360,0,-2,3,1,2,0,0,0,0,0,0,0,0,0,2,0,2,0,0,0,1,1,0,0,0,0,0,0,0,0,0,0
105589,36000,360,0,-2,1,0,1,0,0,0,0,0,0,1,0,1,0,0,0,0,0,0,0,0,0,0,0,0,0,0,0,0,0,0
105659,36000,360,0,-2,2,1,1,0,0,0,0,0,0,0,0,0,0,0,0,0,0,0,2,1,1,0,0,0,0,0,0,0,0,0
105899,36000,360,0,-2,6,4,2,0,0,0,0,0,0,1,0,1,1,0,1,0,0,0,3,3,0,0,0,0,1,1,0,0,0,0
106263,36000,360,0,-2,7,1,6,0,0,0,0,0,0,5,1,4,0,0,0,0,0,0,1,0,1,1,0,1,0,0,0,0,0,0
106397,36000,360,0,-2,1,0,1,0,0,0,0,0,0,0,0,0,0,0,0,0,0,0,0,0,0,1,0,1,0,0,0,0,0,0
106458,36000,360,0,-2,1,1,0,0,0,0,0,0,0,0,0,0,0,0,0,0,0,0,1,1,0,0,0,0,0,0,0,0,0,0
106485,36000,360,0,-2,2,1,1,1,1,0,0,0,0,0,0,0,0,0,0,0,0,0,1,0,1,0,0,0,0,0,0,0,0,0
106980,36000,360,0,-2,1,0,1,0,0,0,0,0,0,0,0,0,0,0,0,0,0,0,1,0,1,0,0,0,0,0,0,0,0,0
107600,36000,360,0,-2,1,1,0,0,0,0,0,0,0,1,1,0,0,0,0,0,0,0,0,0,0,0,0,0,0,0,0,0,0,0
107637,36000,360,0,-2,1,0,1,0,0,0,0,0,0,1,0,1,0,0,0,0,0,0,0,0,0,0,0,0,0,0,0,0,0,0
107877,36000,360,0,-2,2,0,2,0,0,0,0,0,0,0,0,0,0,0,0,0,0,0,2,0,2,0,0,0,0,0,0,0,0,0
107974,36000,360,0,-2,2,1,1,0,0,0,0,0,0,0,0,0,0,0,0,0,0,0,2,1,1,0,0,0,0,0,0,0,0,0
109785,36000,360,0,-2,2,2,0,0,0,0,0,0,0,0,0,0,1,1,0,0,0,0,1,1,0,0,0,0,0,0,0,0,0,0
110644,36000,360,0,-2,1,1,0,0,0,0,0,0,0,0,0,0,0,0,0,0,0,0,1,1,0,0,0,0,0,0,0,0,0,0
110662,36000,360,0,-2,10,4,6,0,0,0,0,0,0,0,0,0,3,1,2,0,0,0,7,3,4,0,0,0,0,0,0,0,0,0
110680,36000,360,0,-2,6,3,3,0,0,0,1,0,1,0,0,0,1,0,1,0,0,0,3,2,1,1,1,0,0,0,0,0,0,0
111638,36000,360,0,-2,1,1,0,0,0,0,0,0,0,0,0,0,1,1,0,0,0,0,0,0,0,0,0,0,0,0,0,0,0,0
112075,36000,360,0,-2,4,1,3,0,0,0,0,0,0,0,0,0,0,0,0,0,0,0,0,0,0,0,0,0,4,1,3,0,0,0
112394,36000,360,0,-2,9,3,6,0,0,0,0,0,0,1,0,1,5,2,3,0,0,0,2,0,2,1,1,0,0,0,0,0,0,0
115010,36000,360,0,-2,6,2,4,0,0,0,0,0,0,0,0,0,1,1,0,0,0,0,1,0,1,0,0,0,4,1,3,0,0,0
115746,36000,360,0,-2,1,0,1,0,0,0,0,0,0,0,0,0,0,0,0,0,0,0,1,0,1,0,0,0,0,0,0,0,0,0
117104,36000,360,0,-2,2,0,2,0,0,0,0,0,0,0,0,0,0,0,0,0,0,0,2,0,2,0,0,0,0,0,0,0,0,0
117520,36000,360,0,-2,2,0,2,0,0,0,0,0,0,0,0,0,2,0,2,0,0,0,0,0,0,0,0,0,0,0,0,0,0,0
117751,36000,360,0,-2,2,0,2,0,0,0,0,0,0,0,0,0,0,0,0,0,0,0,2,0,2,0,0,0,0,0,0,0,0,0
117946,36000,360,0,-2,1,0,1,0,0,0,0,0,0,0,0,0,1,0,1,0,0,0,0,0,0,0,0,0,0,0,0,0,0,0
120078,36000,360,0,-2,7,0,7,0,0,0,0,0,0,0,0,0,1,0,1,0,0,0,0,0,0,0,0,0,6,0,6,0,0,0
120661,36000,360,0,-2,2,1,1,0,0,0,0,0,0,0,0,0,1,1,0,0,0,0,1,0,1,0,0,0,0,0,0,0,0,0
121150,36000,360,0,-2,1,0,1,0,0,0,0,0,0,0,0,0,0,0,0,0,0,0,1,0,1,0,0,0,0,0,0,0,0,0
123679,36000,360,0,-2,2,0,2,0,0,0,0,0,0,1,0,1,0,0,0,0,0,0,1,0,1,0,0,0,0,0,0,0,0,0
123943,36000,360,0,-2,1,0,1,0,0,0,0,0,0,0,0,0,1,0,1,0,0,0,0,0,0,0,0,0,0,0,0,0,0,0
123961,36000,360,0,-2,5,3,2,0,0,0,1,1,0,0,0,0,3,1,2,0,0,0,1,1,0,0,0,0,0,0,0,0,0,0
124283,36000,360,0,-2,2,0,2,0,0,0,0,0,0,0,0,0,1,0,1,0,0,0,1,0,1,0,0,0,0,0,0,0,0,0
124706,36000,360,0,-2,1,1,0,0,0,0,0,0,0,0,0,0,0,0,0,0,0,0,0,0,0,0,0,0,1,1,0,0,0,0
124937,36000,360,0,-2,2,1,1,0,0,0,0,0,0,0,0,0,2,1,1,0,0,0,0,0,0,0,0,0,0,0,0,0,0,0
125231,36000,360,0,-2,49,14,35,0,0,0,0,0,0,11,2,9,6,3,3,0,0,0,24,8,16,4,0,4,4,1,3,0,0,0
126605,36000,360,0,-2,3,1,2,0,0,0,0,0,0,0,0,0,2,1,1,0,0,0,0,0,0,1,0,1,0,0,0,0,0,0
126687,36000,360,0,-2,2,1,1,0,0,0,0,0,0,0,0,0,2,1,1,0,0,0,0,0,0,0,0,0,0,0,0,0,0,0
126827,36000,360,0,-2,81,19,62,3,2,1,0,0,0,23,2,21,12,1,11,0,0,0,41,14,27,0,0,0,2,0,2,0,0,0
127714,36000,360,0,-2,3,0,3,0,0,0,0,0,0,1,0,1,0,0,0,0,0,0,2,0,2,0,0,0,0,0,0,0,0,0
127820,36000,360,0,-2,1,1,0,0,0,0,0,0,0,0,0,0,0,0,0,0,0,0,1,1,0,0,0,0,0,0,0,0,0,0
127918,36000,360,0,-2,6,2,4,0,0,0,1,1,0,0,0,0,1,1,0,0,0,0,4,0,4,0,0,0,0,0,0,0,0,0
128179,36000,360,0,-2,2,0,2,0,0,0,0,0,0,0,0,0,0,0,0,0,0,0,2,0,2,0,0,0,0,0,0,0,0,0
128188,36000,360,0,-2,2,1,1,0,0,0,0,0,0,1,1,0,1,0,1,0,0,0,0,0,0,0,0,0,0,0,0,0,0,0
130110,36000,360,0,-2,2,1,1,0,0,0,0,0,0,1,1,0,0,0,0,0,0,0,1,0,1,0,0,0,0,0,0,0,0,0
130253,36000,360,0,-2,1,0,1,0,0,0,0,0,0,0,0,0,0,0,0,0,0,0,1,0,1,0,0,0,0,0,0,0,0,0
130624,36000,360,0,-2,1,1,0,0,0,0,0,0,0,0,0,0,0,0,0,0,0,0,1,1,0,0,0,0,0,0,0,0,0,0
131803,36000,360,0,-2,45,14,31,2,1,1,0,0,0,27,9,18,0,0,0,0,0,0,11,3,8,0,0,0,5,1,4,0,0,0
131876,36000,360,0,-2,2,1,1,0,0,0,0,0,0,1,1,0,1,0,1,0,0,0,0,0,0,0,0,0,0,0,0,0,0,0
133650,36000,360,0,-2,1,1,0,0,0,0,0,0,0,1,1,0,0,0,0,0,0,0,0,0,0,0,0,0,0,0,0,0,0,0
133845,36000,360,0,-2,4,1,3,0,0,0,0,0,0,2,1,1,0,0,0,0,0,0,1,0,1,0,0,0,1,0,1,0,0,0
133854,36000,360,0,-2,2,0,2,0,0,0,0,0,0,0,0,0,1,0,1,0,0,0,1,0,1,0,0,0,0,0,0,0,0,0
133863,36000,360,0,-2,2,1,1,0,0,0,0,0,0,1,1,0,1,0,1,0,0,0,0,0,0,0,0,0,0,0,0,0,0,0
133881,36000,360,0,-2,6,1,5,0,0,0,0,0,0,2,0,2,0,0,0,0,0,0,4,1,3,0,0,0,0,0,0,0,0,0
134130,36000,360,0,-2,1,0,1,0,0,0,0,0,0,0,0,0,0,0,0,0,0,0,1,0,1,0,0,0,0,0,0,0,0,0
134343,36000,360,0,-2,1,1,0,0,0,0,0,0,0,0,0,0,0,0,0,0,0,0,1,1,0,0,0,0,0,0,0,0,0,0
134495,36000,360,0,-2,2,0,2,0,0,0,0,0,0,0,0,0,1,0,1,0,0,0,1,0,1,0,0,0,0,0,0,0,0,0
134811,36000,360,0,-2,1,1,0,0,0,0,0,0,0,1,1,0,0,0,0,0,0,0,0,0,0,0,0,0,0,0,0,0,0,0
135726,36000,360,0,-2,4,4,0,0,0,0,0,0,0,0,0,0,0,0,0,0,0,0,4,4,0,0,0,0,0,0,0,0,0,0
136215,36000,360,0,-2,1,1,0,0,0,0,0,0,0,0,0,0,0,0,0,0,0,0,1,1,0,0,0,0,0,0,0,0,0,0
136774,36000,360,0,-2,1,1,0,0,0,0,0,0,0,0,0,0,1,1,0,0,0,0,0,0,0,0,0,0,0,0,0,0,0,0
137032,36000,360,0,-2,24,8,16,0,0,0,0,0,0,8,3,5,6,1,5,0,0,0,4,3,1,2,1,1,4,0,4,0,0,0
137078,36000,360,0,-2,1,0,1,0,0,0,0,0,0,0,0,0,0,0,0,0,0,0,1,0,1,0,0,0,0,0,0,0,0,0
137281,36000,360,0,-2,1,0,1,0,0,0,0,0,0,0,0,0,0,0,0,0,0,0,1,0,1,0,0,0,0,0,0,0,0,0
137759,36000,360,0,-2,1,0,1,0,0,0,0,0,0,0,0,0,0,0,0,0,0,0,1,0,1,0,0,0,0,0,0,0,0,0
138293,36000,360,0,-2,3,3,0,0,0,0,0,0,0,1,1,0,1,1,0,0,0,0,1,1,0,0,0,0,0,0,0,0,0,0
139199,36000,360,0,-2,1,0,1,0,0,0,0,0,0,0,0,0,0,0,0,0,0,0,1,0,1,0,0,0,0,0,0,0,0,0
139348,36000,360,0,-2,1,1,0,0,0,0,0,0,0,0,0,0,0,0,0,0,0,0,1,1,0,0,0,0,0,0,0,0,0,0
139658,36000,360,0,-2,1,0,1,0,0,0,0,0,0,1,0,1,0,0,0,0,0,0,0,0,0,0,0,0,0,0,0,0,0,0
139959,36000,360,0,-2,1,0,1,0,0,0,0,0,0,0,0,0,0,0,0,0,0,0,1,0,1,0,0,0,0,0,0,0,0,0
140818,36000,360,0,-2,2,0,2,0,0,0,0,0,0,0,0,0,0,0,0,0,0,0,2,0,2,0,0,0,0,0,0,0,0,0
140942,36000,360,0,-2,1,0,1,0,0,0,0,0,0,1,0,1,0,0,0,0,0,0,0,0,0,0,0,0,0,0,0,0,0,0
141237,36000,360,0,-2,1,0,1,0,0,0,0,0,0,0,0,0,0,0,0,0,0,0,1,0,1,0,0,0,0,0,0,0,0,0
141325,36000,360,0,-2,1,0,1,0,0,0,0,0,0,1,0,1,0,0,0,0,0,0,0,0,0,0,0,0,0,0,0,0,0,0
141574,36000,360,0,-2,2,0,2,0,0,0,1,0,1,0,0,0,0,0,0,0,0,0,1,0,1,0,0,0,0,0,0,0,0,0
142285,36000,360,0,-2,1,1,0,0,0,0,0,0,0,0,0,0,0,0,0,0,0,0,1,1,0,0,0,0,0,0,0,0,0,0
144050,36000,360,0,-2,3,2,1,0,0,0,1,1,0,1,1,0,0,0,0,0,0,0,1,0,1,0,0,0,0,0,0,0,0,0
144865,36000,360,0,-2,2,1,1,0,0,0,0,0,0,0,0,0,0,0,0,0,0,0,2,1,1,0,0,0,0,0,0,0,0,0
145336,36000,360,0,-2,1,0,1,0,0,0,0,0,0,0,0,0,0,0,0,0,0,0,1,0,1,0,0,0,0,0,0,0,0,0
145682,36000,360,0,-2,1,1,0,0,0,0,0,0,0,0,0,0,0,0,0,0,0,0,1,1,0,0,0,0,0,0,0,0,0,0
146472,36000,360,0,-2,4,1,3,0,0,0,1,0,1,1,0,1,1,0,1,0,0,0,1,1,0,0,0,0,0,0,0,0,0,0
146490,36000,360,0,-2,2,1,1,0,0,0,0,0,0,0,0,0,0,0,0,0,0,0,2,1,1,0,0,0,0,0,0,0,0,0
146667,36000,360,0,-2,3,0,3,0,0,0,0,0,0,0,0,0,0,0,0,0,0,0,3,0,3,0,0,0,0,0,0,0,0,0
147369,36000,360,0,-2,3,2,1,0,0,0,0,0,0,0,0,0,2,1,1,0,0,0,1,1,0,0,0,0,0,0,0,0,0,0
147590,36000,360,0,-2,3,1,2,0,0,0,0,0,0,0,0,0,0,0,0,0,0,0,3,1,2,0,0,0,0,0,0,0,0,0
147679,36000,360,0,-2,3,1,2,0,0,0,0,0,0,0,0,0,3,1,2,0,0,0,0,0,0,0,0,0,0,0,0,0,0,0
147697,36000,360,0,-2,2,2,0,0,0,0,0,0,0,0,0,0,0,0,0,0,0,0,2,2,0,0,0,0,0,0,0,0,0,0
147767,36000,360,0,-2,2,2,0,0,0,0,1,1,0,0,0,0,0,0,0,0,0,0,1,1,0,0,0,0,0,0,0,0,0,0
147800,36000,360,0,-2,1,0,1,0,0,0,0,0,0,0,0,0,0,0,0,0,0,0,1,0,1,0,0,0,0,0,0,0,0,0
147828,36000,360,0,-2,2,1,1,0,0,0,0,0,0,0,0,0,0,0,0,0,0,0,2,1,1,0,0,0,0,0,0,0,0,0
148131,36000,360,0,-2,3,0,3,0,0,0,0,0,0,0,0,0,0,0,0,0,0,0,3,0,3,0,0,0,0,0,0,0,0,0
148511,36000,360,0,-2,4,0,4,0,0,0,0,0,0,2,0,2,0,0,0,0,0,0,2,0,2,0,0,0,0,0,0,0,0,0
148821,36000,360,0,-2,1,0,1,0,0,0,0,0,0,0,0,0,0,0,0,0,0,0,1,0,1,0,0,0,0,0,0,0,0,0
148876,36000,360,0,-2,1,0,1,0,0,0,0,0,0,0,0,0,0,0,0,0,0,0,1,0,1,0,0,0,0,0,0,0,0,0
149727,36000,360,0,-2,3,0,3,0,0,0,0,0,0,0,0,0,1,0,1,0,0,0,2,0,2,0,0,0,0,0,0,0,0,0
149772,36000,360,0,-2,1,0,1,0,0,0,0,0,0,0,0,0,0,0,0,0,0,0,1,0,1,0,0,0,0,0,0,0,0,0
149781,36000,360,0,-2,2,0,2,0,0,0,0,0,0,0,0,0,0,0,0,0,0,0,2,0,2,0,0,0,0,0,0,0,0,0
149842,36000,360,0,-2,2,1,1,0,0,0,0,0,0,0,0,0,0,0,0,0,0,0,2,1,1,0,0,0,0,0,0,0,0,0
150941,36000,360,0,-2,5,3,2,0,0,0,0,0,0,0,0,0,1,1,0,0,0,0,4,2,2,0,0,0,0,0,0,0,0,0
151351,36000,360,0,-2,5,3,2,0,0,0,0,0,0,1,1,0,0,0,0,0,0,0,3,2,1,1,0,1,0,0,0,0,0,0
152567,36000,360,0,-2,6,2,4,0,0,0,0,0,0,0,0,0,0,0,0,0,0,0,4,1,3,0,0,0,2,1,1,0,0,0
152673,36000,360,0,-2,1,0,1,0,0,0,1,0,1,0,0,0,0,0,0,0,0,0,0,0,0,0,0,0,0,0,0,0,0,0
153001,36000,360,0,-2,2,0,2,0,0,0,0,0,0,0,0,0,0,0,0,0,0,0,2,0,2,0,0,0,0,0,0,0,0,0
153269,36000,360,0,-2,1,1,0,0,0,0,0,0,0,0,0,0,0,0,0,0,0,0,1,1,0,0,0,0,0,0,0,0,0,0
153278,36000,360,0,-2,1,0,1,0,0,0,0,0,0,0,0,0,0,0,0,0,0,0,1,0,1,0,0,0,0,0,0,0,0,0
153302,36000,360,0,-2,1,0,1,0,0,0,0,0,0,0,0,0,0,0,0,0,0,0,1,0,1,0,0,0,0,0,0,0,0,0
153320,36000,360,0,-2,2,1,1,0,0,0,0,0,0,0,0,0,0,0,0,0,0,0,2,1,1,0,0,0,0,0,0,0,0,0
153472,36000,360,0,-2,2,1,1,0,0,0,0,0,0,0,0,0,0,0,0,0,0,0,2,1,1,0,0,0,0,0,0,0,0,0
153603,36000,360,0,-2,3,3,0,0,0,0,0,0,0,0,0,0,0,0,0,0,0,0,3,3,0,0,0,0,0,0,0,0,0,0
153621,36000,360,0,-2,2,2,0,0,0,0,0,0,0,1,1,0,0,0,0,0,0,0,1,1,0,0,0,0,0,0,0,0,0,0
153861,36000,360,0,-2,2,1,1,0,0,0,0,0,0,0,0,0,0,0,0,0,0,0,2,1,1,0,0,0,0,0,0,0,0,0
154129,36000,360,0,-2,1,0,1,0,0,0,0,0,0,0,0,0,0,0,0,0,0,0,1,0,1,0,0,0,0,0,0,0,0,0
154174,36000,360,0,-2,2,1,1,0,0,0,0,0,0,0,0,0,0,0,0,0,0,0,2,1,1,0,0,0,0,0,0,0,0,0
154350,36000,360,0,-2,5,2,3,0,0,0,0,0,0,0,0,0,1,1,0,0,0,0,4,1,3,0,0,0,0,0,0,0,0,0
154749,36000,360,0,-2,2,1,1,0,0,0,0,0,0,1,0,1,0,0,0,0,0,0,1,1,0,0,0,0,0,0,0,0,0,0
155177,36000,360,0,-2,3,0,3,0,0,0,0,0,0,0,0,0,1,0,1,0,0,0,2,0,2,0,0,0,0,0,0,0,0,0
155195,36000,360,0,-2,3,2,1,0,0,0,0,0,0,0,0,0,0,0,0,0,0,0,3,2,1,0,0,0,0,0,0,0,0,0
155283,36000,360,0,-2,2,0,2,0,0,0,0,0,0,0,0,0,0,0,0,0,0,0,2,0,2,0,0,0,0,0,0,0,0,0
155566,36000,360,0,-2,1,0,1,0,0,0,0,0,0,0,0,0,0,0,0,0,0,0,1,0,1,0,0,0,0,0,0,0,0,0
155593,36000,360,0,-2,3,0,3,0,0,0,0,0,0,0,0,0,0,0,0,0,0,0,3,0,3,0,0,0,0,0,0,0,0,0
155627,36000,360,0,-2,1,1,0,0,0,0,0,0,0,0,0,0,0,0,0,0,0,0,1,1,0,0,0,0,0,0,0,0,0,0
155636,36000,360,0,-2,1,0,1,0,0,0,0,0,0,0,0,0,1,0,1,0,0,0,0,0,0,0,0,0,0,0,0,0,0,0
155812,36000,360,0,-2,3,2,1,0,0,0,0,0,0,0,0,0,0,0,0,0,0,0,3,2,1,0,0,0,0,0,0,0,0,0
155973,36000,360,0,-2,2,1,1,0,0,0,0,0,0,0,0,0,0,0,0,0,0,0,2,1,1,0,0,0,0,0,0,0,0,0
156125,36000,360,0,-2,1,1,0,0,0,0,0,0,0,0,0,0,0,0,0,0,0,0,1,1,0,0,0,0,0,0,0,0,0,0
156134,36000,360,0,-2,4,1,3,0,0,0,0,0,0,2,1,1,1,0,1,0,0,0,1,0,1,0,0,0,0,0,0,0,0,0
156356,36000,360,0,-2,3,1,2,0,0,0,0,0,0,1,0,1,0,0,0,0,0,0,2,1,1,0,0,0,0,0,0,0,0,0
157021,36000,360,0,-2,10,1,9,0,0,0,0,0,0,6,1,5,1,0,1,0,0,0,3,0,3,0,0,0,0,0,0,0,0,0
157100,36000,360,0,-2,2,1,1,0,0,0,0,0,0,0,0,0,0,0,0,0,0,0,2,1,1,0,0,0,0,0,0,0,0,0
157289,36000,360,0,-2,1,1,0,0,0,0,0,0,0,0,0,0,0,0,0,0,0,0,1,1,0,0,0,0,0,0,0,0,0,0
157757,36000,360,0,-2,1,1,0,0,0,0,0,0,0,0,0,0,0,0,0,0,0,0,1,1,0,0,0,0,0,0,0,0,0,0
157951,36000,360,0,-2,1,1,0,0,0,0,0,0,0,0,0,0,0,0,0,0,0,0,1,1,0,0,0,0,0,0,0,0,0,0
159197,36000,360,0,-2,1,1,0,0,0,0,0,0,0,0,0,0,0,0,0,0,0,0,1,1,0,0,0,0,0,0,0,0,0,0
160658,36000,360,0,-2,1,0,1,0,0,0,0,0,0,0,0,0,0,0,0,0,0,0,1,0,1,0,0,0,0,0,0,0,0,0
160977,36000,360,0,-2,3,2,1,0,0,0,0,0,0,0,0,0,0,0,0,0,0,0,3,2,1,0,0,0,0,0,0,0,0,0
160995,36000,360,0,-2,2,0,2,0,0,0,0,0,0,0,0,0,0,0,0,0,0,0,2,0,2,0,0,0,0,0,0,0,0,0
161253,36000,360,0,-2,1,0,1,0,0,0,0,0,0,0,0,0,0,0,0,0,0,0,1,0,1,0,0,0,0,0,0,0,0,0
161572,36000,360,0,-2,1,0,1,0,0,0,0,0,0,0,0,0,0,0,0,0,0,0,1,0,1,0,0,0,0,0,0,0,0,0
161688,36000,360,0,-2,1,1,0,0,0,0,0,0,0,0,0,0,0,0,0,0,0,0,1,1,0,0,0,0,0,0,0,0,0,0
161767,36000,360,0,-2,1,1,0,0,0,0,0,0,0,0,0,0,0,0,0,0,0,0,1,1,0,0,0,0,0,0,0,0,0,0
162210,36000,360,0,-2,1,1,0,0,0,0,0,0,0,1,1,0,0,0,0,0,0,0,0,0,0,0,0,0,0,0,0,0,0,0
162690,36000,360,0,-2,1,0,1,0,0,0,0,0,0,0,0,0,0,0,0,0,0,0,1,0,1,0,0,0,0,0,0,0,0,0
163046,36000,360,0,-2,2,1,1,0,0,0,0,0,0,0,0,0,0,0,0,0,0,0,2,1,1,0,0,0,0,0,0,0,0,0
164076,36000,360,0,-2,2,0,2,0,0,0,0,0,0,0,0,0,0,0,0,0,0,0,2,0,2,0,0,0,0,0,0,0,0,0
164368,36000,360,0,-2,4,2,2,0,0,0,0,0,0,0,0,0,2,1,1,0,0,0,1,1,0,0,0,0,1,0,1,0,0,0
164988,36000,360,0,-2,2,1,1,0,0,0,0,0,0,0,0,0,0,0,0,0,0,0,1,0,1,0,0,0,1,1,0,0,0,0
165802,36000,360,0,-2,3,2,1,0,0,0,0,0,0,0,0,0,0,0,0,0,0,0,3,2,1,0,0,0,0,0,0,0,0,0
166683,36000,360,0,-2,7,3,4,0,0,0,1,0,1,0,0,0,1,0,1,0,0,0,4,3,1,1,0,1,0,0,0,0,0,0
168528,36000,360,0,-2,4,2,2,0,0,0,0,0,0,0,0,0,0,0,0,0,0,0,4,2,2,0,0,0,0,0,0,0,0,0
168591,36000,360,0,-2,1,1,0,0,0,0,0,0,0,0,0,0,0,0,0,0,0,0,1,1,0,0,0,0,0,0,0,0,0,0
169655,36000,360,0,-2,3,1,2,0,0,0,0,0,0,1,1,0,0,0,0,0,0,0,2,0,2,0,0,0,0,0,0,0,0,0
169910,36000,360,0,-2,3,1,2,0,0,0,0,0,0,0,0,0,0,0,0,0,0,0,3,1,2,0,0,0,0,0,0,0,0,0
169983,36000,360,0,-2,1,1,0,0,0,0,0,0,0,0,0,0,0,0,0,0,0,0,1,1,0,0,0,0,0,0,0,0,0,0
170082,36000,360,0,-2,2,0,2,0,0,0,0,0,0,0,0,0,0,0,0,0,0,0,2,0,2,0,0,0,0,0,0,0,0,0
170240,36000,360,0,-2,1,0,1,0,0,0,0,0,0,1,0,1,0,0,0,0,0,0,0,0,0,0,0,0,0,0,0,0,0,0
170286,36000,360,0,-2,2,0,2,0,0,0,0,0,0,0,0,0,0,0,0,0,0,0,0,0,0,0,0,0,2,0,2,0,0,0
170550,36000,360,0,-2,1,1,0,0,0,0,0,0,0,1,1,0,0,0,0,0,0,0,0,0,0,0,0,0,0,0,0,0,0,0
170657,36000,360,0,-2,1,0,1,0,0,0,0,0,0,0,0,0,0,0,0,0,0,0,1,0,1,0,0,0,0,0,0,0,0,0
171155,36000,360,0,-2,1,0,1,0,0,0,0,0,0,0,0,0,0,0,0,0,0,0,1,0,1,0,0,0,0,0,0,0,0,0
172671,36000,360,0,-2,1,0,1,0,0,0,0,0,0,0,0,0,0,0,0,0,0,0,1,0,1,0,0,0,0,0,0,0,0,0
173045,36000,360,0,-2,1,0,1,0,0,0,0,0,0,0,0,0,0,0,0,0,0,0,1,0,1,0,0,0,0,0,0,0,0,0
173203,36000,360,0,-2,1,1,0,0,0,0,0,0,0,0,0,0,0,0,0,0,0,0,1,1,0,0,0,0,0,0,0,0,0,0
173902,36000,360,0,-2,1,0,1,0,0,0,0,0,0,0,0,0,0,0,0,0,0,0,1,0,1,0,0,0,0,0,0,0,0,0
174066,36000,360,0,-2,3,1,2,0,0,0,0,0,0,0,0,0,1,0,1,0,0,0,2,1,1,0,0,0,0,0,0,0,0,0
174127,36000,360,0,-2,1,0,1,0,0,0,0,0,0,0,0,0,0,0,0,0,0,0,1,0,1,0,0,0,0,0,0,0,0,0
174233,36000,360,0,-2,4,0,4,0,0,0,0,0,0,0,0,0,1,0,1,0,0,0,3,0,3,0,0,0,0,0,0,0,0,0
174507,36000,360,0,-2,1,1,0,0,0,0,0,0,0,0,0,0,1,1,0,0,0,0,0,0,0,0,0,0,0,0,0,0,0,0
175573,36000,360,0,-2,1,1,0,0,0,0,0,0,0,0,0,0,0,0,0,0,0,0,1,1,0,0,0,0,0,0,0,0,0,0
175643,36000,360,0,-2,1,0,1,0,0,0,0,0,0,0,0,0,0,0,0,0,0,0,1,0,1,0,0,0,0,0,0,0,0,0
175829,36000,360,0,-2,3,0,3,0,0,0,0,0,0,0,0,0,0,0,0,0,0,0,3,0,3,0,0,0,0,0,0,0,0,0
176008,36000,360,0,-2,1,0,1,0,0,0,0,0,0,0,0,0,0,0,0,0,0,0,1,0,1,0,0,0,0,0,0,0,0,0
176080,36000,360,0,-2,1,1,0,0,0,0,0,0,0,1,1,0,0,0,0,0,0,0,0,0,0,0,0,0,0,0,0,0,0,0
176239,36000,360,0,-2,1,0,1,0,0,0,0,0,0,0,0,0,0,0,0,0,0,0,1,0,1,0,0,0,0,0,0,0,0,0
177092,36000,360,0,-2,4,2,2,0,0,0,1,0,1,1,1,0,0,0,0,0,0,0,2,1,1,0,0,0,0,0,0,0,0,0
177302,36000,360,0,-2,41,9,32,1,0,1,0,0,0,12,3,9,5,2,3,0,0,0,18,2,16,5,2,3,0,0,0,0,0,0
177339,36000,360,0,-2,2,1,1,0,0,0,0,0,0,0,0,0,0,0,0,0,0,0,2,1,1,0,0,0,0,0,0,0,0,0
177977,36000,360,0,-2,5,4,1,0,0,0,0,0,0,0,0,0,0,0,0,0,0,0,5,4,1,0,0,0,0,0,0,0,0,0
178396,36000,360,0,-2,4,3,1,0,0,0,0,0,0,1,1,0,0,0,0,0,0,0,2,1,1,0,0,0,1,1,0,0,0,0
178624,36000,360,0,-2,5,2,3,0,0,0,0,0,0,0,0,0,0,0,0,0,0,0,5,2,3,0,0,0,0,0,0,0,0,0
179812,36000,360,0,-2,1,0,1,0,0,0,0,0,0,0,0,0,0,0,0,0,0,0,1,0,1,0,0,0,0,0,0,0,0,0
179867,36000,360,0,-2,1,0,1,0,0,0,0,0,0,0,0,0,0,0,0,0,0,0,1,0,1,0,0,0,0,0,0,0,0,0
179964,36000,360,0,-2,3,0,3,0,0,0,0,0,0,0,0,0,1,0,1,0,0,0,2,0,2,0,0,0,0,0,0,0,0,0
180179,36000,360,0,-2,2,2,0,0,0,0,0,0,0,0,0,0,1,1,0,0,0,0,1,1,0,0,0,0,0,0,0,0,0,0
180197,36000,360,0,-2,2,0,2,0,0,0,0,0,0,0,0,0,0,0,0,0,0,0,2,0,2,0,0,0,0,0,0,0,0,0
180416,36000,360,0,-2,2,0,2,0,0,0,0,0,0,0,0,0,1,0,1,0,0,0,1,0,1,0,0,0,0,0,0,0,0,0
180461,36000,360,0,-2,3,1,2,0,0,0,0,0,0,0,0,0,0,0,0,0,0,0,3,1,2,0,0,0,0,0,0,0,0,0
180489,36000,360,0,-2,5,0,5,0,0,0,1,0,1,0,0,0,0,0,0,0,0,0,4,0,4,0,0,0,0,0,0,0,0,0
180814,36000,360,0,-2,2,0,2,0,0,0,0,0,0,0,0,0,0,0,0,0,0,0,2,0,2,0,0,0,0,0,0,0,0,0
181303,36000,360,0,-2,1,1,0,0,0,0,0,0,0,0,0,0,0,0,0,0,0,0,0,0,0,1,1,0,0,0,0,0,0,0
181464,36000,360,0,-2,8,6,2,0,0,0,0,0,0,1,1,0,1,1,0,0,0,0,6,4,2,0,0,0,0,0,0,0,0,0
183044,36000,360,0,-2,2,2,0,0,0,0,0,0,0,0,0,0,1,1,0,0,0,0,1,1,0,0,0,0,0,0,0,0,0,0
183488,36000,360,0,-2,1,0,1,0,0,0,0,0,0,0,0,0,1,0,1,0,0,0,0,0,0,0,0,0,0,0,0,0,0,0
184959,36000,360,0,-2,2,0,2,0,0,0,0,0,0,0,0,0,1,0,1,0,0,0,1,0,1,0,0,0,0,0,0,0,0,0
185721,36000,360,0,-2,3,1,2,0,0,0,0,0,0,0,0,0,0,0,0,0,0,0,3,1,2,0,0,0,0,0,0,0,0,0
187532,36000,360,0,-2,1,1,0,0,0,0,0,0,0,0,0,0,1,1,0,0,0,0,0,0,0,0,0,0,0,0,0,0,0,0
187596,36000,360,0,-2,2,1,1,2,1,1,0,0,0,0,0,0,0,0,0,0,0,0,0,0,0,0,0,0,0,0,0,0,0,0
187985,36000,360,0,-2,3,3,0,0,0,0,0,0,0,0,0,0,1,1,0,0,0,0,2,2,0,0,0,0,0,0,0,0,0,0
188058,36000,360,0,-2,1,0,1,0,0,0,0,0,0,0,0,0,1,0,1,0,0,0,0,0,0,0,0,0,0,0,0,0,0,0
188641,36000,360,0,-2,2,1,1,0,0,0,0,0,0,1,1,0,0,0,0,0,0,0,1,0,1,0,0,0,0,0,0,0,0,0
188854,36000,360,0,-2,1,0,1,0,0,0,0,0,0,0,0,0,0,0,0,0,0,0,1,0,1,0,0,0,0,0,0,0,0,0
190415,36000,360,0,-2,3,2,1,0,0,0,0,0,0,0,0,0,0,0,0,0,0,0,2,1,1,1,1,0,0,0,0,0,0,0
190503,36000,360,0,-2,3,0,3,0,0,0,0,0,0,0,0,0,0,0,0,0,0,0,3,0,3,0,0,0,0,0,0,0,0,0
191205,36000,360,0,-2,1,1,0,0,0,0,0,0,0,0,0,0,0,0,0,0,0,0,1,1,0,0,0,0,0,0,0,0,0,0
191968,36000,360,0,-2,2,1,1,0,0,0,0,0,0,0,0,0,0,0,0,0,0,0,2,1,1,0,0,0,0,0,0,0,0,0
192448,36000,360,0,-2,1,0,1,0,0,0,0,0,0,1,0,1,0,0,0,0,0,0,0,0,0,0,0,0,0,0,0,0,0,0
192925,36000,360,0,-2,6,0,6,0,0,0,0,0,0,1,0,1,0,0,0,0,0,0,5,0,5,0,0,0,0,0,0,0,0,0
194958,36000,360,0,-2,3,1,2,0,0,0,0,0,0,2,1,1,0,0,0,0,0,0,1,0,1,0,0,0,0,0,0,0,0,0
195580,36000,360,0,-2,1,0,1,0,0,0,0,0,0,0,0,0,0,0,0,0,0,0,1,0,1,0,0,0,0,0,0,0,0,0
196413,36000,360,0,-2,1,1,0,0,0,0,0,0,0,0,0,0,0,0,0,0,0,0,1,1,0,0,0,0,0,0,0,0,0,0
197036,36000,360,0,-2,1,1,0,0,0,0,0,0,0,0,0,0,0,0,0,0,0,0,1,1,0,0,0,0,0,0,0,0,0,0
197869,36000,360,0,-2,1,0,1,0,0,0,0,0,0,0,0,0,0,0,0,0,0,0,1,0,1,0,0,0,0,0,0,0,0,0
197887,36000,360,0,-2,1,0,1,0,0,0,0,0,0,0,0,0,0,0,0,0,0,0,1,0,1,0,0,0,0,0,0,0,0,0
197984,36000,360,0,-2,1,0,1,0,0,0,0,0,0,0,0,0,0,0,0,0,0,0,1,0,1,0,0,0,0,0,0,0,0,0
198154,36000,360,0,-2,1,0,1,0,0,0,0,0,0,0,0,0,0,0,0,0,0,0,1,0,1,0,0,0,0,0,0,0,0,0
198330,36000,360,0,-2,1,0,1,0,0,0,0,0,0,0,0,0,0,0,0,0,0,0,1,0,1,0,0,0,0,0,0,0,0,0
198419,36000,360,0,-2,3,2,1,0,0,0,0,0,0,0,0,0,1,1,0,0,0,0,2,1,1,0,0,0,0,0,0,0,0,0
198534,36000,360,0,-2,1,0,1,0,0,0,0,0,0,1,0,1,0,0,0,0,0,0,0,0,0,0,0,0,0,0,0,0,0,0
198622,36000,360,0,-2,1,0,1,0,0,0,0,0,0,0,0,0,0,0,0,0,0,0,1,0,1,0,0,0,0,0,0,0,0,0
198695,36000,360,0,-2,2,0,2,0,0,0,0,0,0,1,0,1,0,0,0,0,0,0,1,0,1,0,0,0,0,0,0,0,0,0
198774,36000,360,0,-2,1,0,1,0,0,0,0,0,0,0,0,0,0,0,0,0,0,0,1,0,1,0,0,0,0,0,0,0,0,0
198978,36000,360,0,-2,29,8,21,0,0,0,0,0,0,12,6,6,1,1,0,0,0,0,13,1,12,3,0,3,0,0,0,0,0,0
199111,36000,360,0,-2,2,1,1,0,0,0,0,0,0,0,0,0,0,0,0,0,0,0,2,1,1,0,0,0,0,0,0,0,0,0
199272,36000,360,0,-2,5,1,4,0,0,0,0,0,0,0,0,0,1,1,0,0,0,0,4,0,4,0,0,0,0,0,0,0,0,0
199847,36000,360,0,-2,1,0,1,0,0,0,0,0,0,0,0,0,0,0,0,0,0,0,1,0,1,0,0,0,0,0,0,0,0,0
200156,36000,360,0,-2,4,2,2,0,0,0,0,0,0,0,0,0,0,0,0,0,0,0,4,2,2,0,0,0,0,0,0,0,0,0
200332,36000,360,0,-2,1,0,1,0,0,0,0,0,0,0,0,0,0,0,0,0,0,0,1,0,1,0,0,0,0,0,0,0,0,0
201104,36000,360,0,-2,1,0,1,0,0,0,0,0,0,0,0,0,0,0,0,0,0,0,1,0,1,0,0,0,0,0,0,0,0,0
201371,36000,360,0,-2,4,1,3,0,0,0,0,0,0,0,0,0,0,0,0,0,0,0,4,1,3,0,0,0,0,0,0,0,0,0
201654,36000,360,0,-2,4,1,3,0,0,0,0,0,0,0,0,0,0,0,0,0,0,0,3,0,3,1,1,0,0,0,0,0,0,0
201751,36000,360,0,-2,2,1,1,0,0,0,0,0,0,0,0,0,0,0,0,0,0,0,2,1,1,0,0,0,0,0,0,0,0,0
202170,36000,360,0,-2,1,0,1,0,0,0,0,0,0,0,0,0,0,0,0,0,0,0,1,0,1,0,0,0,0,0,0,0,0,0
202903,36000,360,0,-2,3,2,1,0,0,0,0,0,0,0,0,0,0,0,0,0,0,0,3,2,1,0,0,0,0,0,0,0,0,0
203517,36000,360,0,-2,6,1,5,0,0,0,0,0,0,0,0,0,0,0,0,0,0,0,5,1,4,0,0,0,1,0,1,0,0,0
203720,36000,360,0,-2,3,2,1,0,0,0,0,0,0,0,0,0,0,0,0,0,0,0,3,2,1,0,0,0,0,0,0,0,0,0
204440,36000,360,0,-2,2,1,1,0,0,0,0,0,0,0,0,0,0,0,0,0,0,0,2,1,1,0,0,0,0,0,0,0,0,0
204468,36000,360,0,-2,1,0,1,0,0,0,0,0,0,0,0,0,0,0,0,0,0,0,1,0,1,0,0,0,0,0,0,0,0,0
204486,36000,360,0,-2,2,2,0,0,0,0,0,0,0,0,0,0,0,0,0,0,0,0,2,2,0,0,0,0,0,0,0,0,0,0
204501,36000,360,0,-2,2,0,2,0,0,0,0,0,0,0,0,0,0,0,0,0,0,0,2,0,2,0,0,0,0,0,0,0,0,0
204796,36000,360,0,-2,10,3,7,0,0,0,1,1,0,1,0,1,1,1,0,0,0,0,7,1,6,0,0,0,0,0,0,0,0,0
204884,36000,360,0,-2,2,0,2,0,0,0,0,0,0,0,0,0,0,0,0,0,0,0,2,0,2,0,0,0,0,0,0,0,0,0
205203,36000,360,0,-2,1,0,1,0,0,0,0,0,0,0,0,0,0,0,0,0,0,0,1,0,1,0,0,0,0,0,0,0,0,0
205443,36000,360,0,-2,2,2,0,0,0,0,0,0,0,1,1,0,0,0,0,0,0,0,1,1,0,0,0,0,0,0,0,0,0,0
205887,36000,360,0,-2,1,0,1,0,0,0,0,0,0,0,0,0,0,0,0,0,0,0,1,0,1,0,0,0,0,0,0,0,0,0
206011,36000,360,0,-2,1,1,0,0,0,0,0,0,0,0,0,0,0,0,0,0,0,0,1,1,0,0,0,0,0,0,0,0,0,0
206084,36000,360,0,-2,1,0,1,0,0,0,0,0,0,0,0,0,0,0,0,0,0,0,1,0,1,0,0,0,0,0,0,0,0,0
206695,36000,360,0,-2,1,1,0,0,0,0,0,0,0,0,0,0,0,0,0,0,0,0,1,1,0,0,0,0,0,0,0,0,0,0
206862,36000,360,0,-2,4,3,1,0,0,0,0,0,0,0,0,0,2,2,0,0,0,0,2,1,1,0,0,0,0,0,0,0,0,0
206932,36000,360,0,-2,1,0,1,0,0,0,0,0,0,0,0,0,0,0,0,0,0,0,1,0,1,0,0,0,0,0,0,0,0,0
206941,36000,360,0,-2,2,0,2,0,0,0,0,0,0,0,0,0,0,0,0,0,0,0,0,0,0,0,0,0,2,0,2,0,0,0
207157,36000,360,0,-2,1,0,1,0,0,0,0,0,0,0,0,0,0,0,0,0,0,0,1,0,1,0,0,0,0,0,0,0,0,0
207254,36000,360,0,-2,11,2,9,1,1,0,0,0,0,3,0,3,1,0,1,0,0,0,6,1,5,0,0,0,0,0,0,0,0,0
207263,36000,360,0,-2,2,1,1,0,0,0,0,0,0,0,0,0,0,0,0,0,0,0,2,1,1,0,0,0,0,0,0,0,0,0
207290,36000,360,0,-2,2,0,2,0,0,0,0,0,0,0,0,0,0,0,0,0,0,0,2,0,2,0,0,0,0,0,0,0,0,0
207342,36000,360,0,-2,2,0,2,0,0,0,0,0,0,0,0,0,0,0,0,0,0,0,2,0,2,0,0,0,0,0,0,0,0,0
207351,36000,360,0,-2,2,0,2,0,0,0,0,0,0,0,0,0,1,0,1,0,0,0,1,0,1,0,0,0,0,0,0,0,0,0
207388,36000,360,0,-2,1,0,1,0,0,0,1,0,1,0,0,0,0,0,0,0,0,0,0,0,0,0,0,0,0,0,0,0,0,0
207403,36000,360,0,-2,1,1,0,0,0,0,0,0,0,0,0,0,0,0,0,0,0,0,1,1,0,0,0,0,0,0,0,0,0,0
207564,36000,360,0,-2,2,2,0,0,0,0,0,0,0,1,1,0,0,0,0,0,0,0,1,1,0,0,0,0,0,0,0,0,0,0
207962,36000,360,0,-2,4,2,2,0,0,0,0,0,0,0,0,0,0,0,0,0,0,0,4,2,2,0,0,0,0,0,0,0,0,0
208318,36000,360,0,-2,1,1,0,0,0,0,0,0,0,0,0,0,0,0,0,0,0,0,1,1,0,0,0,0,0,0,0,0,0,0
209542,36000,360,0,-2,3,0,3,0,0,0,0,0,0,0,0,0,0,0,0,0,0,0,0,0,0,0,0,0,3,0,3,0,0,0
209551,36000,360,0,-2,4,2,2,0,0,0,0,0,0,0,0,0,0,0,0,0,0,0,4,2,2,0,0,0,0,0,0,0,0,0
210809,36000,360,0,-2,1,1,0,0,0,0,0,0,0,1,1,0,0,0,0,0,0,0,0,0,0,0,0,0,0,0,0,0,0,0
212197,36000,360,0,-2,1,1,0,0,0,0,0,0,0,0,0,0,0,0,0,0,0,0,1,1,0,0,0,0,0,0,0,0,0,0
213534,36000,360,0,-2,3,0,3,0,0,0,0,0,0,0,0,0,3,0,3,0,0,0,0,0,0,0,0,0,0,0,0,0,0,0
214892,36000,360,0,-2,1,1,0,0,0,0,0,0,0,0,0,0,0,0,0,0,0,0,1,1,0,0,0,0,0,0,0,0,0,0
214944,36000,360,0,-2,8,6,2,0,0,0,1,0,1,0,0,0,0,0,0,0,0,0,7,6,1,0,0,0,0,0,0,0,0,0
214971,36000,360,0,-2,2,1,1,0,0,0,0,0,0,0,0,0,0,0,0,0,0,0,2,1,1,0,0,0,0,0,0,0,0,0
215114,36000,360,0,-2,5,3,2,0,0,0,0,0,0,1,1,0,0,0,0,0,0,0,4,2,2,0,0,0,0,0,0,0,0,0
215293,36000,360,0,-2,8,3,5,0,0,0,0,0,0,0,0,0,0,0,0,0,0,0,7,3,4,0,0,0,1,0,1,0,0,0
215929,36000,360,0,-2,1,0,1,0,0,0,0,0,0,0,0,0,1,0,1,0,0,0,0,0,0,0,0,0,0,0,0,0,0,0
216597,36000,360,0,-2,5,0,5,0,0,0,1,0,1,3,0,3,0,0,0,0,0,0,1,0,1,0,0,0,0,0,0,0,0,0
216782,36000,360,0,-2,2,1,1,0,0,0,0,0,0,2,1,1,0,0,0,0,0,0,0,0,0,0,0,0,0,0,0,0,0,0
217059,36000,360,0,-2,4,3,1,0,0,0,0,0,0,0,0,0,2,2,0,0,0,0,2,1,1,0,0,0,0,0,0,0,0,0
217484,36000,360,0,-2,1,0,1,0,0,0,0,0,0,0,0,0,0,0,0,0,0,0,1,0,1,0,0,0,0,0,0,0,0,0
217493,36000,360,0,-2,3,0,3,0,0,0,0,0,0,0,0,0,0,0,0,0,0,0,1,0,1,0,0,0,2,0,2,0,0,0
217624,36000,360,0,-2,1,1,0,0,0,0,0,0,0,1,1,0,0,0,0,0,0,0,0,0,0,0,0,0,0,0,0,0,0,0
217688,36000,360,0,-2,7,3,4,0,0,0,0,0,0,2,1,1,0,0,0,0,0,0,5,2,3,0,0,0,0,0,0,0,0,0
217819,36000,360,0,-2,1,1,0,0,0,0,0,0,0,0,0,0,0,0,0,0,0,0,1,1,0,0,0,0,0,0,0,0,0,0
217882,36000,360,0,-2,2,1,1,0,0,0,0,0,0,0,0,0,0,0,0,0,0,0,2,1,1,0,0,0,0,0,0,0,0,0
218751,36000,360,0,-2,2,0,2,0,0,0,0,0,0,0,0,0,1,0,1,0,0,0,1,0,1,0,0,0,0,0,0,0,0,0
218955,36000,360,0,-2,1,1,0,0,0,0,0,0,0,1,1,0,0,0,0,0,0,0,0,0,0,0,0,0,0,0,0,0,0,0
219143,36000,360,0,-2,2,1,1,0,0,0,0,0,0,0,0,0,0,0,0,0,0,0,2,1,1,0,0,0,0,0,0,0,0,0
219709,36000,360,0,-2,1,1,0,0,0,0,0,0,0,0,0,0,0,0,0,0,0,0,1,1,0,0,0,0,0,0,0,0,0,0
219903,36000,360,0,-2,5,2,3,0,0,0,0,0,0,2,2,0,3,0,3,0,0,0,0,0,0,0,0,0,0,0,0,0,0,0
220473,36000,360,0,-2,1,0,1,0,0,0,0,0,0,0,0,0,0,0,0,0,0,0,1,0,1,0,0,0,0,0,0,0,0,0
220613,36000,360,0,-2,1,0,1,0,0,0,0,0,0,0,0,0,0,0,0,0,0,0,1,0,1,0,0,0,0,0,0,0,0,0
220792,36000,360,0,-2,2,1,1,0,0,0,0,0,0,2,1,1,0,0,0,0,0,0,0,0,0,0,0,0,0,0,0,0,0,0
221661,36000,360,0,-2,4,1,3,0,0,0,0,0,0,0,0,0,0,0,0,0,0,0,4,1,3,0,0,0,0,0,0,0,0,0
221759,36000,360,0,-2,8,4,4,0,0,0,0,0,0,1,0,1,0,0,0,0,0,0,7,4,3,0,0,0,0,0,0,0,0,0
221971,36000,360,0,-2,2,2,0,0,0,0,0,0,0,1,1,0,0,0,0,0,0,0,0,0,0,0,0,0,1,1,0,0,0,0
221999,36000,360,0,-2,4,1,3,0,0,0,0,0,0,1,0,1,0,0,0,0,0,0,2,1,1,0,0,0,1,0,1,0,0,0
222831,36000,360,0,-2,6,1,5,0,0,0,0,0,0,0,0,0,3,1,2,0,0,0,3,0,3,0,0,0,0,0,0,0,0,0
222938,36000,360,0,-2,5,0,5,0,0,0,0,0,0,3,0,3,1,0,1,0,0,0,1,0,1,0,0,0,0,0,0,0,0,0
223223,36000,360,0,-2,2,2,0,0,0,0,0,0,0,1,1,0,1,1,0,0,0,0,0,0,0,0,0,0,0,0,0,0,0,0
223232,36000,360,0,-2,1,0,1,0,0,0,0,0,0,0,0,0,0,0,0,0,0,0,1,0,1,0,0,0,0,0,0,0,0,0
223463,36000,360,0,-2,4,0,4,0,0,0,0,0,0,3,0,3,1,0,1,0,0,0,0,0,0,0,0,0,0,0,0,0,0,0
223506,36000,360,0,-2,1,1,0,0,0,0,0,0,0,0,0,0,0,0,0,0,0,0,1,1,0,0,0,0,0,0,0,0,0,0
223816,36000,360,0,-2,2,1,1,0,0,0,0,0,0,1,1,0,0,0,0,0,0,0,1,0,1,0,0,0,0,0,0,0,0,0
224554,36000,360,0,-2,1,0,1,0,0,0,0,0,0,0,0,0,0,0,0,0,0,0,1,0,1,0,0,0,0,0,0,0,0,0
224615,36000,360,0,-2,1,1,0,0,0,0,0,0,0,0,0,0,1,1,0,0,0,0,0,0,0,0,0,0,0,0,0,0,0,0
224660,36000,360,0,-2,2,2,0,0,0,0,0,0,0,0,0,0,1,1,0,0,0,0,1,1,0,0,0,0,0,0,0,0,0,0
224679,36000,360,0,-2,4,3,1,0,0,0,0,0,0,0,0,0,4,3,1,0,0,0,0,0,0,0,0,0,0,0,0,0,0,0
225201,36000,360,0,-2,5,1,4,0,0,0,0,0,0,0,0,0,5,1,4,0,0,0,0,0,0,0,0,0,0,0,0,0,0,0
225308,36000,360,0,-2,1,0,1,0,0,0,0,0,0,0,0,0,0,0,0,0,0,0,1,0,1,0,0,0,0,0,0,0,0,0
225627,36000,360,0,-2,1,0,1,0,0,0,0,0,0,0,0,0,1,0,1,0,0,0,0,0,0,0,0,0,0,0,0,0,0,0
226471,36000,360,0,-2,1,0,1,0,0,0,0,0,0,0,0,0,0,0,0,0,0,0,1,0,1,0,0,0,0,0,0,0,0,0
226903,36000,360,0,-2,70,25,45,0,0,0,2,0,2,4,1,3,39,14,25,0,0,0,21,9,12,4,1,3,0,0,0,0,0,0
227331,36000,360,0,-2,2,0,2,0,0,0,0,0,0,0,0,0,2,0,2,0,0,0,0,0,0,0,0,0,0,0,0,0,0,0
227845,36000,360,0,-2,5,1,4,0,0,0,1,0,1,2,0,2,0,0,0,0,0,0,2,1,1,0,0,0,0,0,0,0,0,0
227863,36000,360,0,-2,2,0,2,0,0,0,0,0,0,1,0,1,1,0,1,0,0,0,0,0,0,0,0,0,0,0,0,0,0,0
228042,36000,360,0,-2,2,0,2,0,0,0,0,0,0,0,0,0,0,0,0,0,0,0,2,0,2,0,0,0,0,0,0,0,0,0
228459,36000,360,0,-2,2,0,2,0,0,0,0,0,0,0,0,0,1,0,1,0,0,0,1,0,1,0,0,0,0,0,0,0,0,0
228644,36000,360,0,-2,1,0,1,0,0,0,0,0,0,0,0,0,0,0,0,0,0,0,0,0,0,0,0,0,1,0,1,0,0,0
228769,36000,360,0,-2,2,1,1,0,0,0,0,0,0,1,0,1,1,1,0,0,0,0,0,0,0,0,0,0,0,0,0,0,0,0
228778,36000,360,0,-2,3,1,2,0,0,0,0,0,0,0,0,0,1,0,1,0,0,0,2,1,1,0,0,0,0,0,0,0,0,0
229027,36000,360,0,-2,3,2,1,0,0,0,0,0,0,0,0,0,0,0,0,0,0,0,1,1,0,1,0,1,1,1,0,0,0,0
229337,36000,360,0,-2,1,0,1,0,0,0,0,0,0,0,0,0,0,0,0,0,0,0,1,0,1,0,0,0,0,0,0,0,0,0
230047,36000,360,0,-2,3,0,3,0,0,0,0,0,0,0,0,0,0,0,0,1,0,1,2,0,2,0,0,0,0,0,0,0,0,0
230746,36000,360,0,-2,1,1,0,0,0,0,0,0,0,0,0,0,0,0,0,0,0,0,1,1,0,0,0,0,0,0,0,0,0,0
230764,36000,360,0,-2,13,10,3,0,0,0,0,0,0,1,0,1,2,2,0,0,0,0,9,7,2,0,0,0,1,1,0,0,0,0
230807,36000,360,0,-2,6,3,3,0,0,0,1,1,0,0,0,0,1,1,0,0,0,0,4,1,3,0,0,0,0,0,0,0,0,0
230995,36000,360,0,-2,2,1,1,0,0,0,0,0,0,0,0,0,0,0,0,0,0,0,2,1,1,0,0,0,0,0,0,0,0,0
231174,36000,360,0,-2,4,1,3,0,0,0,0,0,0,0,0,0,0,0,0,0,0,0,4,1,3,0,0,0,0,0,0,0,0,0
232043,36000,360,0,-2,5,3,2,0,0,0,0,0,0,1,1,0,0,0,0,0,0,0,4,2,2,0,0,0,0,0,0,0,0,0
232308,36000,360,0,-2,7,0,7,0,0,0,0,0,0,1,0,1,0,0,0,0,0,0,6,0,6,0,0,0,0,0,0,0,0,0
232609,36000,360,0,-2,1,0,1,0,0,0,0,0,0,0,0,0,0,0,0,0,0,0,1,0,1,0,0,0,0,0,0,0,0,0
232797,36000,360,0,-2,18,1,17,1,0,1,1,0,1,7,0,7,3,0,3,0,0,0,6,1,5,0,0,0,0,0,0,0,0,0
234076,36000,360,0,-2,1,1,0,0,0,0,0,0,0,0,0,0,0,0,0,0,0,0,1,1,0,0,0,0,0,0,0,0,0,0
234207,36000,360,0,-2,1,0,1,0,0,0,0,0,0,0,0,0,0,0,0,0,0,0,1,0,1,0,0,0,0,0,0,0,0,0
235343,36000,360,0,-2,1,0,1,0,0,0,0,0,0,0,0,0,0,0,0,0,0,0,1,0,1,0,0,0,0,0,0,0,0,0
236133,36000,360,0,-2,3,1,2,0,0,0,0,0,0,0,0,0,0,0,0,0,0,0,3,1,2,0,0,0,0,0,0,0,0,0
236258,36000,360,0,-2,1,0,1,0,0,0,0,0,0,0,0,0,0,0,0,0,0,0,1,0,1,0,0,0,0,0,0,0,0,0
236887,36000,360,0,-2,1,0,1,0,0,0,0,0,0,0,0,0,0,0,0,0,0,0,1,0,1,0,0,0,0,0,0,0,0,0
237783,36000,360,0,-2,1,0,1,0,0,0,0,0,0,0,0,0,0,0,0,0,0,0,1,0,1,0,0,0,0,0,0,0,0,0
237987,36000,360,0,-2,1,0,1,0,0,0,0,0,0,0,0,0,0,0,0,0,0,0,1,0,1,0,0,0,0,0,0,0,0,0
237996,36000,360,0,-2,10,0,10,0,0,0,0,0,0,1,0,1,0,0,0,0,0,0,8,0,8,1,0,1,0,0,0,0,0,0
239248,36000,360,0,-2,2,1,1,0,0,0,1,1,0,1,0,1,0,0,0,0,0,0,0,0,0,0,0,0,0,0,0,0,0,0
239460,36000,360,0,-2,3,1,2,0,0,0,0,0,0,0,0,0,0,0,0,0,0,0,3,1,2,0,0,0,0,0,0,0,0,0
239488,36000,360,0,-2,1,0,1,0,0,0,1,0,1,0,0,0,0,0,0,0,0,0,0,0,0,0,0,0,0,0,0,0,0,0
240116,36000,360,0,-2,1,0,1,0,0,0,0,0,0,0,0,0,0,0,0,0,0,0,1,0,1,0,0,0,0,0,0,0,0,0
240198,36000,360,0,-2,1,0,1,0,0,0,0,0,0,0,0,0,0,0,0,0,0,0,1,0,1,0,0,0,0,0,0,0,0,0
240329,36000,360,0,-2,1,0,1,0,0,0,0,0,0,0,0,0,0,0,0,0,0,0,1,0,1,0,0,0,0,0,0,0,0,0
240718,36000,360,0,-2,7,7,0,0,0,0,0,0,0,0,0,0,1,1,0,0,0,0,6,6,0,0,0,0,0,0,0,0,0,0
240727,36000,360,0,-2,4,1,3,0,0,0,0,0,0,1,1,0,2,0,2,0,0,0,1,0,1,0,0,0,0,0,0,0,0,0
240745,36000,360,0,-2,1,0,1,0,0,0,1,0,1,0,0,0,0,0,0,0,0,0,0,0,0,0,0,0,0,0,0,0,0,0
240754,36000,360,0,-2,1,0,1,0,0,0,0,0,0,0,0,0,0,0,0,1,0,1,0,0,0,0,0,0,0,0,0,0,0,0
241304,36000,360,0,-2,8,2,6,0,0,0,0,0,0,0,0,0,8,2,6,0,0,0,0,0,0,0,0,0,0,0,0,0,0,0
241377,36000,360,0,-2,1,0,1,0,0,0,0,0,0,0,0,0,1,0,1,0,0,0,0,0,0,0,0,0,0,0,0,0,0,0
241836,36000,360,0,-2,2,1,1,0,0,0,0,0,0,0,0,0,2,1,1,0,0,0,0,0,0,0,0,0,0,0,0,0,0,0
241951,36000,360,0,-2,1,1,0,0,0,0,0,0,0,0,0,0,1,1,0,0,0,0,0,0,0,0,0,0,0,0,0,0,0,0
242112,36000,360,0,-2,2,1,1,0,0,0,0,0,0,0,0,0,2,1,1,0,0,0,0,0,0,0,0,0,0,0,0,0,0,0
242130,36000,360,0,-2,1,0,1,0,0,0,0,0,0,0,0,0,1,0,1,0,0,0,0,0,0,0,0,0,0,0,0,0,0,0
242149,36000,360,0,-2,2,1,1,0,0,0,0,0,0,0,0,0,2,1,1,0,0,0,0,0,0,0,0,0,0,0,0,0,0,0
242635,36000,360,0,-2,1,1,0,0,0,0,0,0,0,0,0,0,1,1,0,0,0,0,0,0,0,0,0,0,0,0,0,0,0,0
242972,36000,360,0,-2,97,24,73,0,0,0,0,0,0,2,0,2,87,22,65,1,0,1,7,2,5,0,0,0,0,0,0,0,0,0
243832,36000,360,0,-2,1,1,0,0,0,0,0,0,0,0,0,0,1,1,0,0,0,0,0,0,0,0,0,0,0,0,0,0,0,0
243841,36000,360,0,-2,6,1,5,0,0,0,0,0,0,0,0,0,6,1,5,0,0,0,0,0,0,0,0,0,0,0,0,0,0,0
245652,36000,360,0,-2,3,2,1,1,0,1,0,0,0,1,1,0,0,0,0,0,0,0,1,1,0,0,0,0,0,0,0,0,0,0
245962,36000,360,0,-2,2,1,1,0,0,0,0,0,0,1,1,0,1,0,1,0,0,0,0,0,0,0,0,0,0,0,0,0,0,0
248934,36000,360,0,-2,1,1,0,0,0,0,0,0,0,0,0,0,0,0,0,0,0,0,1,1,0,0,0,0,0,0,0,0,0,0
260813,36000,360,0,-2,2,0,2,0,0,0,0,0,0,1,0,1,0,0,0,0,0,0,0,0,0,0,0,0,1,0,1,0,0,0
260992,36000,360,0,-2,3,1,2,0,0,0,0,0,0,2,0,2,0,0,0,0,0,0,1,1,0,0,0,0,0,0,0,0,0,0
261861,36000,360,0,-2,2,0,2,0,0,0,0,0,0,0,0,0,0,0,0,0,0,0,2,0,2,0,0,0,0,0,0,0,0,0
366270,36000,360,0,-2,2,1,1,0,0,0,0,0,0,2,1,1,0,0,0,0,0,0,0,0,0,0,0,0,0,0,0,0,0,0
367112,36000,360,0,-2,1,1,0,0,0,0,0,0,0,1,1,0,0,0,0,0,0,0,0,0,0,0,0,0,0,0,0,0,0,0
377111,36000,360,0,-2,2,1,1,0,0,0,0,0,0,0,0,0,2,1,1,0,0,0,0,0,0,0,0,0,0,0,0,0,0,0
377661,36000,360,0,-2,1,0,1,0,0,0,0,0,0,0,0,0,0,0,0,0,0,0,1,0,1,0,0,0,0,0,0,0,0,0
378576,36000,360,0,-2,2,0,2,0,0,0,0,0,0,0,0,0,0,0,0,0,0,0,0,0,0,0,0,0,2,0,2,0,0,0
384412,36000,360,0,-2,2,0,2,0,0,0,0,0,0,2,0,2,0,0,0,0,0,0,0,0,0,0,0,0,0,0,0,0,0,0
412599,36000,360,0,-2,1,0,1,0,0,0,0,0,0,1,0,1,0,0,0,0,0,0,0,0,0,0,0,0,0,0,0,0,0,0
413680,36000,360,0,-2,3,0,3,0,0,0,0,0,0,0,0,0,2,0,2,0,0,0,0,0,0,1,0,1,0,0,0,0,0,0
414939,36000,360,0,-2,6,1,5,0,0,0,0,0,0,0,0,0,2,0,2,0,0,0,0,0,0,0,0,0,4,1,3,0,0,0
430704,36000,360,0,-2,1,0,1,0,0,0,0,0,0,0,0,0,0,0,0,0,0,0,1,0,1,0,0,0,0,0,0,0,0,0
431141,36000,360,0,-2,3,1,2,0,0,0,1,0,1,0,0,0,0,0,0,0,0,0,2,1,1,0,0,0,0,0,0,0,0,0
433013,36000,360,0,-2,2,0,2,0,0,0,0,0,0,0,0,0,0,0,0,0,0,0,2,0,2,0,0,0,0,0,0,0,0,0
433420,36000,360,0,-2,8,2,6,0,0,0,0,0,0,2,1,1,1,0,1,0,0,0,4,1,3,1,0,1,0,0,0,0,0,0
434821,36000,360,0,-2,1,0,1,0,0,0,0,0,0,1,0,1,0,0,0,0,0,0,0,0,0,0,0,0,0,0,0,0,0,0
436429,36000,360,0,-2,40,12,28,1,1,0,2,0,2,8,4,4,15,5,10,0,0,0,8,1,7,2,0,2,4,1,3,0,0,0
438498,36000,360,0,-2,3,1,2,0,0,0,1,1,0,1,0,1,0,0,0,0,0,0,1,0,1,0,0,0,0,0,0,0,0,0
438586,36000,360,0,-2,3,1,2,0,0,0,0,0,0,3,1,2,0,0,0,0,0,0,0,0,0,0,0,0,0,0,0,0,0,0
441025,36000,360,0,-2,2,0,2,0,0,0,0,0,0,0,0,0,0,0,0,0,0,0,1,0,1,1,0,1,0,0,0,0,0,0
441371,36000,360,0,-2,238,40,198,1,0,1,4,2,2,101,11,90,69,14,55,0,0,0,41,10,31,17,3,14,5,0,5,0,0,0
441423,36000,360,0,-2,2,0,2,0,0,0,0,0,0,0,0,0,2,0,2,0,0,0,0,0,0,0,0,0,0,0,0,0,0,0
442383,36000,360,0,-2,2,0,2,0,0,0,0,0,0,0,0,0,0,0,0,0,0,0,2,0,2,0,0,0,0,0,0,0,0,0
442842,36000,360,0,-2,1,0,1,0,0,0,0,0,0,0,0,0,0,0,0,0,0,0,0,0,0,0,0,0,1,0,1,0,0,0
442930,36000,360,0,-2,2,0,2,0,0,0,0,0,0,1,0,1,1,0,1,0,0,0,0,0,0,0,0,0,0,0,0,0,0,0
443571,36000,360,0,-2,4,2,2,0,0,0,0,0,0,0,0,0,3,1,2,0,0,0,1,1,0,0,0,0,0,0,0,0,0,0
443650,36000,360,0,-2,1,0,1,0,0,0,0,0,0,0,0,0,0,0,0,0,0,0,1,0,1,0,0,0,0,0,0,0,0,0
444556,36000,360,0,-2,1,0,1,0,0,0,0,0,0,1,0,1,0,0,0,0,0,0,0,0,0,0,0,0,0,0,0,0,0,0
445027,36000,360,0,-2,73,25,48,3,1,2,0,0,0,28,9,19,8,3,5,1,1,0,29,10,19,0,0,0,4,1,3,0,0,0
445249,36000,360,0,-2,2,0,2,0,0,0,0,0,0,2,0,2,0,0,0,0,0,0,0,0,0,0,0,0,0,0,0,0,0,0
445948,36000,360,0,-2,7,3,4,0,0,0,1,1,0,2,2,0,4,0,4,0,0,0,0,0,0,0,0,0,0,0,0,0,0,0
446118,36000,360,0,-2,1,0,1,0,0,0,0,0,0,0,0,0,1,0,1,0,0,0,0,0,0,0,0,0,0,0,0,0,0,0
446385,36000,360,0,-2,2,1,1,0,0,0,0,0,0,0,0,0,1,1,0,0,0,0,1,0,1,0,0,0,0,0,0,0,0,0
446561,36000,360,0,-2,2,1,1,0,0,0,0,0,0,0,0,0,0,0,0,0,0,0,2,1,1,0,0,0,0,0,0,0,0,0
446640,36000,360,0,-2,3,2,1,0,0,0,0,0,0,0,0,0,0,0,0,0,0,0,2,1,1,0,0,0,1,1,0,0,0,0
447263,36000,360,0,-2,4,0,4,0,0,0,0,0,0,0,0,0,3,0,3,0,0,0,1,0,1,0,0,0,0,0,0,0,0,0
447698,36000,360,0,-2,1,0,1,0,0,0,0,0,0,0,0,0,0,0,0,0,0,0,1,0,1,0,0,0,0,0,0,0,0,0
447777,36000,360,0,-2,5,2,3,0,0,0,1,0,1,2,1,1,1,0,1,0,0,0,0,0,0,1,1,0,0,0,0,0,0,0
450933,36000,360,0,-2,1,0,1,1,0,1,0,0,0,0,0,0,0,0,0,0,0,0,0,0,0,0,0,0,0,0,0,0,0,0
451477,36000,360,0,-2,9,4,5,0,0,0,0,0,0,3,1,2,1,0,1,1,1,0,3,2,1,1,0,1,0,0,0,0,0,0
451556,36000,360,0,-2,9,1,8,0,0,0,0,0,0,0,0,0,7,0,7,0,0,0,2,1,1,0,0,0,0,0,0,0,0,0
451866,36000,360,0,-2,2,0,2,0,0,0,0,0,0,2,0,2,0,0,0,0,0,0,0,0,0,0,0,0,0,0,0,0,0,0
451927,36000,360,0,-2,1,0,1,0,0,0,0,0,0,0,0,0,0,0,0,0,0,0,1,0,1,0,0,0,0,0,0,0,0,0
454810,36000,360,0,-2,62,17,45,0,0,0,2,0,2,23,6,17,4,1,3,1,0,1,24,8,16,7,2,5,1,0,1,0,0,0
455196,36000,360,0,-2,8,3,5,0,0,0,0,0,0,5,1,4,0,0,0,0,0,0,3,2,1,0,0,0,0,0,0,0,0,0
455336,36000,360,0,-2,1,1,0,0,0,0,0,0,0,0,0,0,0,0,0,1,1,0,0,0,0,0,0,0,0,0,0,0,0,0
456205,36000,360,0,-2,2,0,2,0,0,0,0,0,0,1,0,1,0,0,0,0,0,0,1,0,1,0,0,0,0,0,0,0,0,0
456579,36000,360,0,-2,1,0,1,0,0,0,0,0,0,0,0,0,1,0,1,0,0,0,0,0,0,0,0,0,0,0,0,0,0,0
458405,36000,360,0,-2,1,0,1,0,0,0,0,0,0,0,0,0,0,0,0,0,0,0,1,0,1,0,0,0,0,0,0,0,0,0
458441,36000,360,0,-2,2,1,1,0,0,0,0,0,0,2,1,1,0,0,0,0,0,0,0,0,0,0,0,0,0,0,0,0,0,0
458982,36000,360,0,-2,1,1,0,0,0,0,0,0,0,0,0,0,0,0,0,0,0,0,1,1,0,0,0,0,0,0,0,0,0,0
460190,36000,360,0,-2,3,2,1,0,0,0,0,0,0,2,1,1,1,1,0,0,0,0,0,0,0,0,0,0,0,0,0,0,0,0
460206,36000,360,0,-2,1,0,1,0,0,0,0,0,0,0,0,0,1,0,1,0,0,0,0,0,0,0,0,0,0,0,0,0,0,0
460349,36000,360,0,-2,2,0,2,0,0,0,0,0,0,0,0,0,1,0,1,0,0,0,1,0,1,0,0,0,0,0,0,0,0,0
460738,36000,360,0,-2,5,2,3,0,0,0,0,0,0,0,0,0,0,0,0,0,0,0,4,1,3,0,0,0,1,1,0,0,0,0
460756,36000,360,0,-2,1,1,0,0,0,0,1,1,0,0,0,0,0,0,0,0,0,0,0,0,0,0,0,0,0,0,0,0,0,0
460817,36000,360,0,-2,2,0,2,0,0,0,0,0,0,1,0,1,1,0,1,0,0,0,0,0,0,0,0,0,0,0,0,0,0,0
460826,36000,360,0,-2,3,1,2,0,0,0,0,0,0,2,0,2,0,0,0,0,0,0,1,1,0,0,0,0,0,0,0,0,0,0
461014,36000,360,0,-2,1,1,0,0,0,0,0,0,0,1,1,0,0,0,0,0,0,0,0,0,0,0,0,0,0,0,0,0,0,0
461148,36000,360,0,-2,5,3,2,0,0,0,0,0,0,2,2,0,2,0,2,0,0,0,1,1,0,0,0,0,0,0,0,0,0,0
461218,36000,360,0,-2,3,0,3,0,0,0,0,0,0,2,0,2,0,0,0,0,0,0,1,0,1,0,0,0,0,0,0,0,0,0
464226,36000,360,0,-2,2,1,1,0,0,0,0,0,0,0,0,0,1,1,0,0,0,0,1,0,1,0,0,0,0,0,0,0,0,0
475839,36000,360,0,-2,1,0,1,0,0,0,0,0,0,0,0,0,0,0,0,0,0,0,1,0,1,0,0,0,0,0,0,0,0,0
476726,36000,360,0,-2,3,2,1,0,0,0,0,0,0,0,0,0,3,2,1,0,0,0,0,0,0,0,0,0,0,0,0,0,0,0
482936,36000,360,0,-2,1,0,1,0,0,0,0,0,0,0,0,0,0,0,0,0,0,0,1,0,1,0,0,0,0,0,0,0,0,0
483124,36000,360,0,-2,1,0,1,0,0,0,0,0,0,0,0,0,0,0,0,0,0,0,1,0,1,0,0,0,0,0,0,0,0,0
484613,36000,360,0,-2,80,26,54,3,0,3,2,1,1,10,6,4,2,0,2,0,0,0,33,12,21,7,3,4,23,4,19,0,0,0
484835,36000,360,0,-2,1,1,0,0,0,0,0,0,0,0,0,0,1,1,0,0,0,0,0,0,0,0,0,0,0,0,0,0,0,0
485768,36000,360,0,-2,1,0,1,0,0,0,0,0,0,0,0,0,1,0,1,0,0,0,0,0,0,0,0,0,0,0,0,0,0,0
486901,36000,360,0,-2,1,1,0,0,0,0,0,0,0,0,0,0,0,0,0,0,0,0,1,1,0,0,0,0,0,0,0,0,0,0
487588,36000,360,0,-2,1,1,0,0,0,0,0,0,0,1,1,0,0,0,0,0,0,0,0,0,0,0,0,0,0,0,0,0,0,0
487603,36000,360,0,-2,1,0,1,0,0,0,0,0,0,0,0,0,1,0,1,0,0,0,0,0,0,0,0,0,0,0,0,0,0,0
488077,36000,360,0,-2,17,7,10,0,0,0,1,1,0,0,0,0,1,0,1,0,0,0,5,1,4,1,1,0,9,4,5,0,0,0
491525,36000,360,0,-2,1,0,1,0,0,0,0,0,0,0,0,0,0,0,0,0,0,0,1,0,1,0,0,0,0,0,0,0,0,0
492476,36000,360,0,-2,2,0,2,0,0,0,0,0,0,0,0,0,2,0,2,0,0,0,0,0,0,0,0,0,0,0,0,0,0,0
494010,36000,360,0,-2,1,0,1,0,0,0,0,0,0,1,0,1,0,0,0,0,0,0,0,0,0,0,0,0,0,0,0,0,0,0
494250,36000,360,0,-2,4,0,4,0,0,0,0,0,0,1,0,1,1,0,1,0,0,0,1,0,1,1,0,1,0,0,0,0,0,0
494278,36000,360,0,-2,2,0,2,0,0,0,0,0,0,0,0,0,2,0,2,0,0,0,0,0,0,0,0,0,0,0,0,0,0,0
494755,36000,360,0,-2,3,0,3,0,0,0,0,0,0,0,0,0,0,0,0,0,0,0,3,0,3,0,0,0,0,0,0,0,0,0
494852,36000,360,0,-2,2,0,2,0,0,0,0,0,0,0,0,0,0,0,0,0,0,0,2,0,2,0,0,0,0,0,0,0,0,0
495767,36000,360,0,-2,4,1,3,0,0,0,0,0,0,1,0,1,0,0,0,0,0,0,2,1,1,1,0,1,0,0,0,0,0,0
497000,36000,360,0,-2,2,0,2,0,0,0,0,0,0,0,0,0,0,0,0,0,0,0,2,0,2,0,0,0,0,0,0,0,0,0
100654,37000,370,0,-2,19,2,17,0,0,0,0,0,0,15,2,13,0,0,0,0,0,0,4,0,4,0,0,0,0,0,0,0,0,0
100663,37000,370,0,-2,101,15,86,0,0,0,0,0,0,56,10,46,1,0,1,0,0,0,31,4,27,1,0,1,11,1,10,1,0,1
100706,37000,370,0,-2,30,4,26,1,0,1,2,0,2,3,0,3,0,0,0,0,0,0,24,4,20,0,0,0,0,0,0,0,0,0
100724,37000,370,0,-2,12,2,10,0,0,0,0,0,0,6,1,5,0,0,0,0,0,0,1,0,1,0,0,0,5,1,4,0,0,0
100733,37000,370,0,-2,1,0,1,0,0,0,0,0,0,0,0,0,0,0,0,0,0,0,1,0,1,0,0,0,0,0,0,0,0,0
100751,37000,370,0,-2,115,19,96,0,0,0,1,0,1,28,2,26,2,0,2,0,0,0,83,17,66,0,0,0,1,0,1,0,0,0
100760,37000,370,0,-2,3,0,3,0,0,0,0,0,0,1,0,1,0,0,0,0,0,0,2,0,2,0,0,0,0,0,0,0,0,0
100812,37000,370,0,-2,7,0,7,0,0,0,0,0,0,0,0,0,0,0,0,0,0,0,7,0,7,0,0,0,0,0,0,0,0,0
100830,37000,370,0,-2,19,6,13,0,0,0,0,0,0,5,1,4,0,0,0,0,0,0,9,5,4,0,0,0,5,0,5,0,0,0
100858,37000,370,0,-2,28,3,25,0,0,0,0,0,0,6,0,6,1,0,1,0,0,0,21,3,18,0,0,0,0,0,0,0,0,0
100937,37000,370,0,-2,3,0,3,0,0,0,0,0,0,0,0,0,0,0,0,0,0,0,3,0,3,0,0,0,0,0,0,0,0,0
101028,37000,370,0,-2,10,4,6,0,0,0,0,0,0,5,2,3,0,0,0,0,0,0,5,2,3,0,0,0,0,0,0,0,0,0
101116,37000,370,0,-2,2,0,2,0,0,0,0,0,0,2,0,2,0,0,0,0,0,0,0,0,0,0,0,0,0,0,0,0,0,0
101143,37000,370,0,-2,6,0,6,0,0,0,0,0,0,1,0,1,0,0,0,0,0,0,5,0,5,0,0,0,0,0,0,0,0,0
101161,37000,370,0,-2,10,1,9,0,0,0,0,0,0,4,0,4,0,0,0,0,0,0,5,1,4,1,0,1,0,0,0,0,0,0
101189,37000,370,0,-2,4,1,3,0,0,0,0,0,0,1,0,1,0,0,0,0,0,0,3,1,2,0,0,0,0,0,0,0,0,0
101240,37000,370,0,-2,5,1,4,1,1,0,0,0,0,0,0,0,0,0,0,0,0,0,4,0,4,0,0,0,0,0,0,0,0,0
101286,37000,370,0,-2,17,0,17,0,0,0,0,0,0,5,0,5,0,0,0,0,0,0,7,0,7,2,0,2,3,0,3,0,0,0
101295,37000,370,0,-2,14,1,13,0,0,0,0,0,0,0,0,0,1,0,1,0,0,0,13,1,12,0,0,0,0,0,0,0,0,0
101301,37000,370,0,-2,1,0,1,0,0,0,0,0,0,1,0,1,0,0,0,0,0,0,0,0,0,0,0,0,0,0,0,0,0,0
101365,37000,370,0,-2,1,0,1,0,0,0,0,0,0,1,0,1,0,0,0,0,0,0,0,0,0,0,0,0,0,0,0,0,0,0
101462,37000,370,0,-2,2,0,2,0,0,0,0,0,0,1,0,1,0,0,0,0,0,0,1,0,1,0,0,0,0,0,0,0,0,0
101471,37000,370,0,-2,3,1,2,0,0,0,0,0,0,2,1,1,0,0,0,0,0,0,1,0,1,0,0,0,0,0,0,0,0,0
101480,37000,370,0,-2,10,2,8,0,0,0,0,0,0,0,0,0,0,0,0,0,0,0,10,2,8,0,0,0,0,0,0,0,0,0
101505,37000,370,0,-2,10,3,7,0,0,0,0,0,0,4,0,4,0,0,0,0,0,0,6,3,3,0,0,0,0,0,0,0,0,0
101514,37000,370,0,-2,8,1,7,0,0,0,0,0,0,4,1,3,0,0,0,0,0,0,2,0,2,1,0,1,1,0,1,0,0,0
101569,37000,370,0,-2,2,1,1,0,0,0,0,0,0,2,1,1,0,0,0,0,0,0,0,0,0,0,0,0,0,0,0,0,0,0
101587,37000,370,0,-2,2,0,2,0,0,0,0,0,0,0,0,0,0,0,0,0,0,0,2,0,2,0,0,0,0,0,0,0,0,0
101602,37000,370,0,-2,4,0,4,0,0,0,0,0,0,0,0,0,0,0,0,0,0,0,4,0,4,0,0,0,0,0,0,0,0,0
101648,37000,370,0,-2,3,1,2,0,0,0,0,0,0,2,1,1,0,0,0,0,0,0,1,0,1,0,0,0,0,0,0,0,0,0
101675,37000,370,0,-2,3,1,2,0,0,0,0,0,0,3,1,2,0,0,0,0,0,0,0,0,0,0,0,0,0,0,0,0,0,0
101709,37000,370,0,-2,8,1,7,0,0,0,0,0,0,1,0,1,0,0,0,0,0,0,7,1,6,0,0,0,0,0,0,0,0,0
101736,37000,370,0,-2,6,1,5,0,0,0,0,0,0,0,0,0,1,0,1,0,0,0,5,1,4,0,0,0,0,0,0,0,0,0
101879,37000,370,0,-2,15,1,14,0,0,0,0,0,0,3,0,3,0,0,0,0,0,0,12,1,11,0,0,0,0,0,0,0,0,0
101897,37000,370,0,-2,7,0,7,1,0,1,0,0,0,0,0,0,2,0,2,0,0,0,4,0,4,0,0,0,0,0,0,0,0,0
101994,37000,370,0,-2,3,1,2,0,0,0,0,0,0,0,0,0,0,0,0,0,0,0,3,1,2,0,0,0,0,0,0,0,0,0
102030,37000,370,0,-2,10,2,8,0,0,0,0,0,0,5,1,4,0,0,0,0,0,0,4,1,3,1,0,1,0,0,0,0,0,0
102049,37000,370,0,-2,2,0,2,0,0,0,0,0,0,0,0,0,0,0,0,0,0,0,2,0,2,0,0,0,0,0,0,0,0,0
102067,37000,370,0,-2,6,0,6,0,0,0,0,0,0,3,0,3,0,0,0,0,0,0,3,0,3,0,0,0,0,0,0,0,0,0
102076,37000,370,0,-2,1,0,1,0,0,0,0,0,0,0,0,0,0,0,0,0,0,0,1,0,1,0,0,0,0,0,0,0,0,0
102094,37000,370,0,-2,24,3,21,0,0,0,1,0,1,7,0,7,0,0,0,0,0,0,15,3,12,1,0,1,0,0,0,0,0,0
102234,37000,370,0,-2,6,0,6,0,0,0,0,0,0,3,0,3,1,0,1,0,0,0,2,0,2,0,0,0,0,0,0,0,0,0
102270,37000,370,0,-2,3,0,3,0,0,0,0,0,0,3,0,3,0,0,0,0,0,0,0,0,0,0,0,0,0,0,0,0,0,0
102298,37000,370,0,-2,5,0,5,0,0,0,0,0,0,5,0,5,0,0,0,0,0,0,0,0,0,0,0,0,0,0,0,0,0,0
102313,37000,370,0,-2,7,2,5,0,0,0,0,0,0,7,2,5,0,0,0,0,0,0,0,0,0,0,0,0,0,0,0,0,0,0
102368,37000,370,0,-2,9,1,8,0,0,0,0,0,0,0,0,0,0,0,0,0,0,0,8,1,7,0,0,0,1,0,1,0,0,0
102377,37000,370,0,-2,7,1,6,0,0,0,0,0,0,7,1,6,0,0,0,0,0,0,0,0,0,0,0,0,0,0,0,0,0,0
102429,37000,370,0,-2,3,0,3,0,0,0,0,0,0,1,0,1,0,0,0,0,0,0,2,0,2,0,0,0,0,0,0,0,0,0
102553,37000,370,0,-2,28,9,19,1,0,1,0,0,0,0,0,0,1,0,1,1,0,1,18,7,11,3,2,1,4,0,4,0,0,0
102614,37000,370,0,-2,10,2,8,1,0,1,0,0,0,0,0,0,2,0,2,0,0,0,6,2,4,1,0,1,0,0,0,0,0,0
102632,37000,370,0,-2,4,0,4,1,0,1,0,0,0,0,0,0,0,0,0,0,0,0,3,0,3,0,0,0,0,0,0,0,0,0
102845,37000,370,0,-2,18,5,13,1,0,1,1,0,1,2,1,1,6,0,6,1,0,1,7,4,3,0,0,0,0,0,0,0,0,0
103501,37000,370,0,-2,4,0,4,0,0,0,1,0,1,0,0,0,0,0,0,0,0,0,3,0,3,0,0,0,0,0,0,0,0,0
103529,37000,370,0,-2,6,0,6,1,0,1,0,0,0,0,0,0,0,0,0,0,0,0,4,0,4,0,0,0,1,0,1,0,0,0
103893,37000,370,0,-2,2,0,2,0,0,0,0,0,0,0,0,0,1,0,1,0,0,0,1,0,1,0,0,0,0,0,0,0,0,0
103909,37000,370,0,-2,1,0,1,0,0,0,0,0,0,0,0,0,0,0,0,0,0,0,1,0,1,0,0,0,0,0,0,0,0,0
103927,37000,370,0,-2,1,0,1,0,0,0,0,0,0,0,0,0,0,0,0,0,0,0,0,0,0,1,0,1,0,0,0,0,0,0
104090,37000,370,0,-2,2,0,2,0,0,0,0,0,0,0,0,0,1,0,1,0,0,0,1,0,1,0,0,0,0,0,0,0,0,0
104151,37000,370,0,-2,198,55,143,4,3,1,12,2,10,13,4,9,47,14,33,1,0,1,85,23,62,6,1,5,28,7,21,2,1,1
104160,37000,370,0,-2,8,3,5,0,0,0,0,0,0,0,0,0,5,3,2,0,0,0,2,0,2,0,0,0,1,0,1,0,0,0
104179,37000,370,0,-2,32,5,27,0,0,0,1,0,1,4,2,2,13,2,11,1,0,1,12,1,11,1,0,1,0,0,0,0,0,0
104346,37000,370,0,-2,4,1,3,0,0,0,1,1,0,0,0,0,3,0,3,0,0,0,0,0,0,0,0,0,0,0,0,0,0,0
104425,37000,370,0,-2,8,1,7,0,0,0,1,1,0,0,0,0,2,0,2,0,0,0,5,0,5,0,0,0,0,0,0,0,0,0
104577,37000,370,0,-2,6,1,5,0,0,0,0,0,0,0,0,0,0,0,0,0,0,0,6,1,5,0,0,0,0,0,0,0,0,0
104586,37000,370,0,-2,12,5,7,0,0,0,1,1,0,0,0,0,2,0,2,0,0,0,9,4,5,0,0,0,0,0,0,0,0,0
104708,37000,370,0,-2,5,1,4,0,0,0,0,0,0,0,0,0,2,1,1,0,0,0,3,0,3,0,0,0,0,0,0,0,0,0
104717,37000,370,0,-2,35,5,30,2,0,2,1,0,1,2,0,2,4,0,4,0,0,0,24,4,20,2,1,1,0,0,0,0,0,0
105136,37000,370,0,-2,6,2,4,0,0,0,0,0,0,0,0,0,3,1,2,0,0,0,3,1,2,0,0,0,0,0,0,0,0,0
105145,37000,370,0,-2,4,2,2,0,0,0,0,0,0,0,0,0,2,1,1,0,0,0,2,1,1,0,0,0,0,0,0,0,0,0
105154,37000,370,0,-2,2,0,2,0,0,0,0,0,0,0,0,0,1,0,1,0,0,0,1,0,1,0,0,0,0,0,0,0,0,0
105206,37000,370,0,-2,15,2,13,0,0,0,0,0,0,0,0,0,1,0,1,0,0,0,14,2,12,0,0,0,0,0,0,0,0,0
105215,37000,370,0,-2,1,0,1,0,0,0,0,0,0,0,0,0,0,0,0,0,0,0,1,0,1,0,0,0,0,0,0,0,0,0
105297,37000,370,0,-2,6,2,4,6,2,4,0,0,0,0,0,0,0,0,0,0,0,0,0,0,0,0,0,0,0,0,0,0,0,0
105330,37000,370,0,-2,26,7,19,2,1,1,0,0,0,1,0,1,5,2,3,0,0,0,16,4,12,1,0,1,1,0,1,0,0,0
105349,37000,370,0,-2,6,0,6,0,0,0,0,0,0,0,0,0,0,0,0,1,0,1,5,0,5,0,0,0,0,0,0,0,0,0
105428,37000,370,0,-2,2,1,1,0,0,0,0,0,0,0,0,0,0,0,0,0,0,0,2,1,1,0,0,0,0,0,0,0,0,0
105525,37000,370,0,-2,6,1,5,0,0,0,0,0,0,0,0,0,5,1,4,0,0,0,0,0,0,1,0,1,0,0,0,0,0,0
105534,37000,370,0,-2,21,12,9,1,0,1,1,1,0,1,0,1,6,4,2,0,0,0,12,7,5,0,0,0,0,0,0,0,0,0
105543,37000,370,0,-2,4,1,3,0,0,0,1,0,1,0,0,0,2,1,1,0,0,0,0,0,0,1,0,1,0,0,0,0,0,0
105589,37000,370,0,-2,4,0,4,0,0,0,0,0,0,0,0,0,0,0,0,0,0,0,2,0,2,0,0,0,2,0,2,0,0,0
105659,37000,370,0,-2,3,1,2,0,0,0,0,0,0,0,0,0,1,1,0,0,0,0,2,0,2,0,0,0,0,0,0,0,0,0
105668,37000,370,0,-2,8,3,5,0,0,0,0,0,0,0,0,0,3,1,2,0,0,0,5,2,3,0,0,0,0,0,0,0,0,0
105747,37000,370,0,-2,2,0,2,0,0,0,0,0,0,1,0,1,0,0,0,0,0,0,1,0,1,0,0,0,0,0,0,0,0,0
105792,37000,370,0,-2,1,0,1,0,0,0,0,0,0,0,0,0,1,0,1,0,0,0,0,0,0,0,0,0,0,0,0,0,0,0
105899,37000,370,0,-2,4,1,3,0,0,0,0,0,0,0,0,0,0,0,0,0,0,0,4,1,3,0,0,0,0,0,0,0,0,0
106041,37000,370,0,-2,1,0,1,0,0,0,0,0,0,0,0,0,0,0,0,0,0,0,1,0,1,0,0,0,0,0,0,0,0,0
106148,37000,370,0,-2,8,2,6,0,0,0,0,0,0,0,0,0,4,2,2,0,0,0,3,0,3,0,0,0,1,0,1,0,0,0
106245,37000,370,0,-2,21,7,14,0,0,0,0,0,0,5,2,3,2,1,1,0,0,0,12,2,10,1,1,0,1,1,0,0,0,0
106263,37000,370,0,-2,34,4,30,0,0,0,1,0,1,7,1,6,3,0,3,0,0,0,22,3,19,1,0,1,0,0,0,0,0,0
106306,37000,370,0,-2,3,0,3,0,0,0,0,0,0,3,0,3,0,0,0,0,0,0,0,0,0,0,0,0,0,0,0,0,0,0
106397,37000,370,0,-2,114,24,90,1,0,1,6,1,5,11,2,9,6,1,5,1,0,1,83,18,65,2,0,2,3,2,1,1,0,1
106412,37000,370,0,-2,9,0,9,1,0,1,0,0,0,8,0,8,0,0,0,0,0,0,0,0,0,0,0,0,0,0,0,0,0,0
106449,37000,370,0,-2,6,1,5,0,0,0,0,0,0,0,0,0,0,0,0,0,0,0,6,1,5,0,0,0,0,0,0,0,0,0
106458,37000,370,0,-2,30,4,26,0,0,0,0,0,0,8,2,6,1,0,1,0,0,0,19,1,18,0,0,0,0,0,0,2,1,1
106467,37000,370,0,-2,9,1,8,1,0,1,0,0,0,1,0,1,0,0,0,0,0,0,7,1,6,0,0,0,0,0,0,0,0,0
106485,37000,370,0,-2,20,4,16,0,0,0,1,1,0,3,0,3,0,0,0,0,0,0,16,3,13,0,0,0,0,0,0,0,0,0
106546,37000,370,0,-2,3,0,3,0,0,0,0,0,0,2,0,2,0,0,0,0,0,0,1,0,1,0,0,0,0,0,0,0,0,0
106625,37000,370,0,-2,2,0,2,0,0,0,0,0,0,0,0,0,0,0,0,0,0,0,2,0,2,0,0,0,0,0,0,0,0,0
106704,37000,370,0,-2,33,6,27,0,0,0,0,0,0,6,0,6,0,0,0,0,0,0,24,5,19,3,1,2,0,0,0,0,0,0
106980,37000,370,0,-2,4,1,3,0,0,0,0,0,0,1,0,1,0,0,0,0,0,0,3,1,2,0,0,0,0,0,0,0,0,0
106999,37000,370,0,-2,3,0,3,0,0,0,0,0,0,0,0,0,0,0,0,0,0,0,3,0,3,0,0,0,0,0,0,0,0,0
107044,37000,370,0,-2,21,3,18,0,0,0,0,0,0,0,0,0,0,0,0,0,0,0,21,3,18,0,0,0,0,0,0,0,0,0
107071,37000,370,0,-2,9,2,7,0,0,0,0,0,0,1,0,1,0,0,0,0,0,0,8,2,6,0,0,0,0,0,0,0,0,0
107080,37000,370,0,-2,1,0,1,0,0,0,0,0,0,0,0,0,0,0,0,0,0,0,1,0,1,0,0,0,0,0,0,0,0,0
107141,37000,370,0,-2,4,1,3,0,0,0,0,0,0,0,0,0,0,0,0,0,0,0,4,1,3,0,0,0,0,0,0,0,0,0
107318,37000,370,0,-2,5,1,4,0,0,0,0,0,0,1,0,1,0,0,0,0,0,0,4,1,3,0,0,0,0,0,0,0,0,0
107327,37000,370,0,-2,1,0,1,0,0,0,0,0,0,1,0,1,0,0,0,0,0,0,0,0,0,0,0,0,0,0,0,0,0,0
107460,37000,370,0,-2,3,0,3,0,0,0,0,0,0,0,0,0,0,0,0,1,0,1,2,0,2,0,0,0,0,0,0,0,0,0
107512,37000,370,0,-2,6,1,5,0,0,0,0,0,0,0,0,0,1,0,1,0,0,0,5,1,4,0,0,0,0,0,0,0,0,0
107521,37000,370,0,-2,3,0,3,0,0,0,0,0,0,1,0,1,0,0,0,0,0,0,2,0,2,0,0,0,0,0,0,0,0,0
107558,37000,370,0,-2,1,0,1,0,0,0,0,0,0,0,0,0,0,0,0,0,0,0,1,0,1,0,0,0,0,0,0,0,0,0
107585,37000,370,0,-2,2,0,2,0,0,0,0,0,0,0,0,0,0,0,0,0,0,0,2,0,2,0,0,0,0,0,0,0,0,0
107600,37000,370,0,-2,8,0,8,0,0,0,0,0,0,7,0,7,1,0,1,0,0,0,0,0,0,0,0,0,0,0,0,0,0,0
107619,37000,370,0,-2,3,1,2,0,0,0,0,0,0,2,0,2,0,0,0,0,0,0,1,1,0,0,0,0,0,0,0,0,0,0
107637,37000,370,0,-2,1,0,1,0,0,0,0,0,0,1,0,1,0,0,0,0,0,0,0,0,0,0,0,0,0,0,0,0,0,0
107664,37000,370,0,-2,3,2,1,0,0,0,0,0,0,1,1,0,0,0,0,0,0,0,2,1,1,0,0,0,0,0,0,0,0,0
107725,37000,370,0,-2,6,0,6,0,0,0,0,0,0,0,0,0,0,0,0,0,0,0,6,0,6,0,0,0,0,0,0,0,0,0
107743,37000,370,0,-2,1,0,1,0,0,0,0,0,0,0,0,0,0,0,0,0,0,0,1,0,1,0,0,0,0,0,0,0,0,0
107840,37000,370,0,-2,1,1,0,0,0,0,0,0,0,1,1,0,0,0,0,0,0,0,0,0,0,0,0,0,0,0,0,0,0,0
107877,37000,370,0,-2,1,0,1,0,0,0,0,0,0,0,0,0,0,0,0,0,0,0,1,0,1,0,0,0,0,0,0,0,0,0
107974,37000,370,0,-2,4,0,4,0,0,0,0,0,0,1,0,1,0,0,0,0,0,0,3,0,3,0,0,0,0,0,0,0,0,0
107983,37000,370,0,-2,15,2,13,0,0,0,0,0,0,2,0,2,0,0,0,0,0,0,12,2,10,0,0,0,1,0,1,0,0,0
107992,37000,370,0,-2,5,0,5,0,0,0,0,0,0,2,0,2,0,0,0,0,0,0,3,0,3,0,0,0,0,0,0,0,0,0
108092,37000,370,0,-2,7,1,6,0,0,0,0,0,0,0,0,0,1,0,1,0,0,0,6,1,5,0,0,0,0,0,0,0,0,0
108232,37000,370,0,-2,8,3,5,0,0,0,0,0,0,2,1,1,2,2,0,0,0,0,4,0,4,0,0,0,0,0,0,0,0,0
108852,37000,370,0,-2,1,0,1,0,0,0,0,0,0,0,0,0,0,0,0,0,0,0,1,0,1,0,0,0,0,0,0,0,0,0
108870,37000,370,0,-2,5,0,5,0,0,0,0,0,0,2,0,2,2,0,2,0,0,0,1,0,1,0,0,0,0,0,0,0,0,0
109208,37000,370,0,-2,6,1,5,0,0,0,0,0,0,1,0,1,3,0,3,0,0,0,0,0,0,0,0,0,1,0,1,1,1,0
109350,37000,370,0,-2,6,1,5,0,0,0,0,0,0,1,0,1,0,0,0,0,0,0,3,0,3,2,1,1,0,0,0,0,0,0
109651,37000,370,0,-2,12,3,9,0,0,0,5,2,3,0,0,0,1,0,1,0,0,0,3,1,2,0,0,0,2,0,2,1,0,1
109785,37000,370,0,-2,27,7,20,1,0,1,6,3,3,3,1,2,7,2,5,0,0,0,7,1,6,0,0,0,3,0,3,0,0,0
109819,37000,370,0,-2,5,0,5,0,0,0,1,0,1,2,0,2,2,0,2,0,0,0,0,0,0,0,0,0,0,0,0,0,0,0
110097,37000,370,0,-2,47,18,29,0,0,0,14,7,7,2,0,2,12,3,9,0,0,0,15,6,9,0,0,0,0,0,0,4,2,2
110246,37000,370,0,-2,6,0,6,1,0,1,0,0,0,1,0,1,1,0,1,0,0,0,2,0,2,1,0,1,0,0,0,0,0,0
110316,37000,370,0,-2,4,0,4,0,0,0,0,0,0,1,0,1,1,0,1,0,0,0,1,0,1,0,0,0,1,0,1,0,0,0
110334,37000,370,0,-2,2,1,1,0,0,0,0,0,0,0,0,0,0,0,0,0,0,0,2,1,1,0,0,0,0,0,0,0,0,0
110361,37000,370,0,-2,22,5,17,0,0,0,1,0,1,1,0,1,7,1,6,0,0,0,12,4,8,1,0,1,0,0,0,0,0,0
110370,37000,370,0,-2,17,3,14,1,0,1,2,1,1,2,0,2,7,2,5,0,0,0,4,0,4,0,0,0,0,0,0,1,0,1
110398,37000,370,0,-2,2,1,1,0,0,0,1,0,1,0,0,0,0,0,0,0,0,0,1,1,0,0,0,0,0,0,0,0,0,0
110404,37000,370,0,-2,23,7,16,0,0,0,3,1,2,1,0,1,7,3,4,1,0,1,9,2,7,0,0,0,1,1,0,1,0,1
110413,37000,370,0,-2,16,1,15,0,0,0,0,0,0,0,0,0,9,1,8,0,0,0,6,0,6,0,0,0,1,0,1,0,0,0
110422,37000,370,0,-2,31,5,26,0,0,0,5,1,4,1,0,1,10,3,7,0,0,0,12,1,11,1,0,1,2,0,2,0,0,0
110468,37000,370,0,-2,3,0,3,0,0,0,1,0,1,0,0,0,2,0,2,0,0,0,0,0,0,0,0,0,0,0,0,0,0,0
110486,37000,370,0,-2,9,0,9,0,0,0,0,0,0,1,0,1,4,0,4,0,0,0,4,0,4,0,0,0,0,0,0,0,0,0
110495,37000,370,0,-2,11,0,11,0,0,0,0,0,0,0,0,0,7,0,7,0,0,0,4,0,4,0,0,0,0,0,0,0,0,0
110501,37000,370,0,-2,1,0,1,0,0,0,0,0,0,0,0,0,0,0,0,0,0,0,1,0,1,0,0,0,0,0,0,0,0,0
110510,37000,370,0,-2,13,3,10,0,0,0,0,0,0,5,1,4,6,2,4,0,0,0,1,0,1,0,0,0,1,0,1,0,0,0
110529,37000,370,0,-2,17,4,13,0,0,0,2,0,2,3,0,3,10,3,7,0,0,0,2,1,1,0,0,0,0,0,0,0,0,0
110538,37000,370,0,-2,15,4,11,0,0,0,1,1,0,0,0,0,2,1,1,0,0,0,9,2,7,3,0,3,0,0,0,0,0,0
110547,37000,370,0,-2,5,0,5,0,0,0,0,0,0,2,0,2,2,0,2,0,0,0,1,0,1,0,0,0,0,0,0,0,0,0
110556,37000,370,0,-2,6,1,5,0,0,0,0,0,0,0,0,0,4,1,3,0,0,0,2,0,2,0,0,0,0,0,0,0,0,0
110565,37000,370,0,-2,20,3,17,0,0,0,4,1,3,2,1,1,7,0,7,0,0,0,6,1,5,0,0,0,0,0,0,1,0,1
110574,37000,370,0,-2,10,1,9,0,0,0,1,1,0,2,0,2,3,0,3,1,0,1,2,0,2,1,0,1,0,0,0,0,0,0
110583,37000,370,0,-2,45,14,31,0,0,0,8,1,7,6,2,4,20,9,11,0,0,0,6,2,4,3,0,3,2,0,2,0,0,0
110592,37000,370,0,-2,13,3,10,0,0,0,1,1,0,2,0,2,8,1,7,0,0,0,1,0,1,0,0,0,1,1,0,0,0,0
110608,37000,370,0,-2,23,5,18,0,0,0,3,0,3,2,1,1,12,4,8,0,0,0,5,0,5,0,0,0,1,0,1,0,0,0
110617,37000,370,0,-2,22,1,21,1,0,1,2,0,2,3,0,3,5,0,5,0,0,0,8,1,7,2,0,2,1,0,1,0,0,0
110635,37000,370,0,-2,86,30,56,0,0,0,22,10,12,13,2,11,18,3,15,0,0,0,12,6,6,9,5,4,9,4,5,3,0,3
110644,37000,370,0,-2,104,19,85,0,0,0,12,3,9,4,0,4,35,6,29,0,0,0,39,7,32,6,1,5,5,2,3,3,0,3
110653,37000,370,0,-2,70,11,59,0,0,0,15,2,13,4,0,4,28,7,21,0,0,0,21,2,19,0,0,0,1,0,1,1,0,1
110662,37000,370,0,-2,485,104,381,1,0,1,56,19,37,45,4,41,236,47,189,3,1,2,73,19,54,14,2,12,23,6,17,34,6,28
110671,37000,370,0,-2,43,7,36,1,0,1,3,1,2,1,0,1,24,4,20,0,0,0,12,1,11,0,0,0,2,1,1,0,0,0
110680,37000,370,0,-2,132,31,101,0,0,0,32,6,26,5,3,2,37,7,30,1,1,0,45,8,37,4,1,3,4,3,1,4,2,2
110699,37000,370,0,-2,102,32,70,0,0,0,37,13,24,7,3,4,22,4,18,1,0,1,21,7,14,3,2,1,3,1,2,8,2,6
110705,37000,370,0,-2,44,8,36,0,0,0,3,0,3,3,2,1,14,4,10,0,0,0,18,1,17,1,0,1,5,1,4,0,0,0
110714,37000,370,0,-2,36,11,25,0,0,0,4,1,3,0,0,0,7,3,4,0,0,0,22,6,16,1,0,1,0,0,0,2,1,1
111081,37000,370,0,-2,14,2,12,0,0,0,1,0,1,1,0,1,4,0,4,0,0,0,7,2,5,0,0,0,0,0,0,1,0,1
111188,37000,370,0,-2,1,0,1,0,0,0,0,0,0,0,0,0,1,0,1,0,0,0,0,0,0,0,0,0,0,0,0,0,0,0
111391,37000,370,0,-2,5,1,4,0,0,0,0,0,0,1,0,1,3,1,2,0,0,0,1,0,1,0,0,0,0,0,0,0,0,0
111434,37000,370,0,-2,3,0,3,0,0,0,0,0,0,0,0,0,3,0,3,0,0,0,0,0,0,0,0,0,0,0,0,0,0,0
111461,37000,370,0,-2,5,0,5,0,0,0,1,0,1,0,0,0,3,0,3,0,0,0,1,0,1,0,0,0,0,0,0,0,0,0
111638,37000,370,0,-2,1,0,1,0,0,0,0,0,0,0,0,0,1,0,1,0,0,0,0,0,0,0,0,0,0,0,0,0,0,0
111887,37000,370,0,-2,4,2,2,0,0,0,1,1,0,0,0,0,3,1,2,0,0,0,0,0,0,0,0,0,0,0,0,0,0,0
111920,37000,370,0,-2,4,1,3,0,0,0,0,0,0,0,0,0,3,1,2,0,0,0,1,0,1,0,0,0,0,0,0,0,0,0
111948,37000,370,0,-2,20,3,17,0,0,0,1,0,1,0,0,0,7,2,5,0,0,0,4,0,4,1,0,1,7,1,6,0,0,0
111966,37000,370,0,-2,13,2,11,0,0,0,1,0,1,3,0,3,4,1,3,0,0,0,0,0,0,0,0,0,5,1,4,0,0,0
112075,37000,370,0,-2,6,1,5,0,0,0,1,0,1,0,0,0,1,0,1,0,0,0,1,0,1,0,0,0,3,1,2,0,0,0
112172,37000,370,0,-2,1,0,1,0,0,0,0,0,0,0,0,0,1,0,1,0,0,0,0,0,0,0,0,0,0,0,0,0,0,0
112251,37000,370,0,-2,9,1,8,0,0,0,1,0,1,1,0,1,5,1,4,0,0,0,2,0,2,0,0,0,0,0,0,0,0,0
112260,37000,370,0,-2,2,1,1,1,1,0,0,0,0,0,0,0,1,0,1,0,0,0,0,0,0,0,0,0,0,0,0,0,0,0
112376,37000,370,0,-2,1,0,1,0,0,0,0,0,0,0,0,0,1,0,1,0,0,0,0,0,0,0,0,0,0,0,0,0,0,0
112394,37000,370,0,-2,2,1,1,0,0,0,0,0,0,0,0,0,1,0,1,0,0,0,1,1,0,0,0,0,0,0,0,0,0,0
112525,37000,370,0,-2,45,14,31,0,0,0,8,4,4,1,0,1,23,5,18,0,0,0,11,3,8,1,1,0,1,1,0,0,0,0
112561,37000,370,0,-2,8,1,7,0,0,0,0,0,0,0,0,0,2,1,1,0,0,0,6,0,6,0,0,0,0,0,0,0,0,0
112570,37000,370,0,-2,2,1,1,0,0,0,0,0,0,1,0,1,0,0,0,0,0,0,1,1,0,0,0,0,0,0,0,0,0,0
112686,37000,370,0,-2,2,1,1,0,0,0,0,0,0,0,0,0,1,1,0,0,0,0,1,0,1,0,0,0,0,0,0,0,0,0
112817,37000,370,0,-2,1,0,1,0,0,0,0,0,0,1,0,1,0,0,0,0,0,0,0,0,0,0,0,0,0,0,0,0,0,0
112826,37000,370,0,-2,2,0,2,0,0,0,0,0,0,1,0,1,1,0,1,0,0,0,0,0,0,0,0,0,0,0,0,0,0,0
113096,37000,370,0,-2,2,0,2,0,0,0,2,0,2,0,0,0,0,0,0,0,0,0,0,0,0,0,0,0,0,0,0,0,0,0
113193,37000,370,0,-2,3,0,3,0,0,0,0,0,0,0,0,0,1,0,1,0,0,0,1,0,1,0,0,0,0,0,0,1,0,1
113218,37000,370,0,-2,1,0,1,0,0,0,0,0,0,0,0,0,0,0,0,0,0,0,1,0,1,0,0,0,0,0,0,0,0,0
113333,37000,370,0,-2,1,0,1,0,0,0,1,0,1,0,0,0,0,0,0,0,0,0,0,0,0,0,0,0,0,0,0,0,0,0
113573,37000,370,0,-2,21,6,15,0,0,0,0,0,0,0,0,0,17,5,12,0,0,0,1,0,1,1,0,1,0,0,0,2,1,1
113634,37000,370,0,-2,8,2,6,0,0,0,1,0,1,2,1,1,2,1,1,0,0,0,3,0,3,0,0,0,0,0,0,0,0,0
113698,37000,370,0,-2,7,1,6,0,0,0,0,0,0,0,0,0,2,1,1,0,0,0,4,0,4,0,0,0,1,0,1,0,0,0
113856,37000,370,0,-2,21,10,11,1,0,1,1,1,0,0,0,0,2,1,1,0,0,0,4,2,2,0,0,0,12,6,6,1,0,1
113980,37000,370,0,-2,14,4,10,0,0,0,2,0,2,2,0,2,5,3,2,0,0,0,3,1,2,2,0,2,0,0,0,0,0,0
114266,37000,370,0,-2,8,2,6,0,0,0,1,0,1,0,0,0,6,2,4,0,0,0,0,0,0,0,0,0,1,0,1,0,0,0
114354,37000,370,0,-2,4,2,2,0,0,0,2,0,2,0,0,0,0,0,0,0,0,0,2,2,0,0,0,0,0,0,0,0,0,0
114433,37000,370,0,-2,2,0,2,0,0,0,0,0,0,0,0,0,0,0,0,0,0,0,2,0,2,0,0,0,0,0,0,0,0,0
114549,37000,370,0,-2,1,0,1,0,0,0,0,0,0,0,0,0,0,0,0,0,0,0,1,0,1,0,0,0,0,0,0,0,0,0
114585,37000,370,0,-2,2,0,2,0,0,0,0,0,0,0,0,0,1,0,1,0,0,0,1,0,1,0,0,0,0,0,0,0,0,0
114789,37000,370,0,-2,4,1,3,0,0,0,0,0,0,0,0,0,2,1,1,0,0,0,2,0,2,0,0,0,0,0,0,0,0,0
114813,37000,370,0,-2,10,2,8,0,0,0,0,0,0,0,0,0,8,2,6,0,0,0,2,0,2,0,0,0,0,0,0,0,0,0
114840,37000,370,0,-2,2,1,1,0,0,0,1,1,0,0,0,0,0,0,0,0,0,0,1,0,1,0,0,0,0,0,0,0,0,0
115001,37000,370,0,-2,6,4,2,0,0,0,1,1,0,0,0,0,2,0,2,0,0,0,2,2,0,0,0,0,1,1,0,0,0,0
115010,37000,370,0,-2,4,0,4,0,0,0,0,0,0,0,0,0,1,0,1,1,0,1,0,0,0,0,0,0,2,0,2,0,0,0
115083,37000,370,0,-2,3,1,2,0,0,0,0,0,0,1,0,1,0,0,0,0,0,0,1,1,0,1,0,1,0,0,0,0,0,0
115214,37000,370,0,-2,1,0,1,0,0,0,0,0,0,0,0,0,0,0,0,0,0,0,1,0,1,0,0,0,0,0,0,0,0,0
115287,37000,370,0,-2,1,0,1,0,0,0,0,0,0,0,0,0,0,0,0,0,0,0,1,0,1,0,0,0,0,0,0,0,0,0
115393,37000,370,0,-2,5,1,4,0,0,0,0,0,0,0,0,0,3,0,3,0,0,0,1,0,1,0,0,0,1,1,0,0,0,0
115409,37000,370,0,-2,5,1,4,0,0,0,2,1,1,0,0,0,2,0,2,0,0,0,1,0,1,0,0,0,0,0,0,0,0,0
115746,37000,370,0,-2,1,0,1,0,0,0,0,0,0,0,0,0,0,0,0,0,0,0,1,0,1,0,0,0,0,0,0,0,0,0
115755,37000,370,0,-2,5,0,5,0,0,0,0,0,0,0,0,0,1,0,1,0,0,0,3,0,3,1,0,1,0,0,0,0,0,0
115861,37000,370,0,-2,5,0,5,0,0,0,0,0,0,0,0,0,5,0,5,0,0,0,0,0,0,0,0,0,0,0,0,0,0,0
115931,37000,370,0,-2,3,0,3,0,0,0,0,0,0,0,0,0,2,0,2,0,0,0,1,0,1,0,0,0,0,0,0,0,0,0
116439,37000,370,0,-2,2,0,2,0,0,0,1,0,1,0,0,0,1,0,1,0,0,0,0,0,0,0,0,0,0,0,0,0,0,0
117104,37000,370,0,-2,2,0,2,0,0,0,0,0,0,0,0,0,0,0,0,0,0,0,2,0,2,0,0,0,0,0,0,0,0,0
117140,37000,370,0,-2,5,2,3,0,0,0,0,0,0,1,1,0,3,0,3,0,0,0,0,0,0,0,0,0,1,1,0,0,0,0
117168,37000,370,0,-2,2,1,1,0,0,0,0,0,0,0,0,0,0,0,0,0,0,0,1,1,0,0,0,0,1,0,1,0,0,0
117195,37000,370,0,-2,4,0,4,0,0,0,0,0,0,0,0,0,0,0,0,0,0,0,4,0,4,0,0,0,0,0,0,0,0,0
117247,37000,370,0,-2,4,1,3,0,0,0,2,0,2,0,0,0,1,0,1,0,0,0,0,0,0,0,0,0,1,1,0,0,0,0
117274,37000,370,0,-2,1,0,1,0,0,0,0,0,0,0,0,0,0,0,0,0,0,0,0,0,0,1,0,1,0,0,0,0,0,0
117627,37000,370,0,-2,8,2,6,0,0,0,3,0,3,0,0,0,4,2,2,0,0,0,1,0,1,0,0,0,0,0,0,0,0,0
117636,37000,370,0,-2,14,2,12,0,0,0,0,0,0,1,0,1,10,0,10,0,0,0,1,0,1,2,2,0,0,0,0,0,0,0
117645,37000,370,0,-2,16,4,12,0,0,0,1,0,1,3,0,3,9,4,5,0,0,0,3,0,3,0,0,0,0,0,0,0,0,0
117672,37000,370,0,-2,6,1,5,0,0,0,0,0,0,0,0,0,3,0,3,0,0,0,3,1,2,0,0,0,0,0,0,0,0,0
117681,37000,370,0,-2,3,1,2,0,0,0,0,0,0,0,0,0,0,0,0,0,0,0,0,0,0,0,0,0,3,1,2,0,0,0
117690,37000,370,0,-2,9,4,5,0,0,0,2,1,1,0,0,0,3,1,2,0,0,0,2,1,1,0,0,0,2,1,1,0,0,0
117706,37000,370,0,-2,23,7,16,0,0,0,2,2,0,1,0,1,6,3,3,0,0,0,11,0,11,2,1,1,1,1,0,0,0,0
117715,37000,370,0,-2,8,7,1,1,1,0,1,1,0,0,0,0,1,1,0,0,0,0,0,0,0,0,0,0,5,4,1,0,0,0
117724,37000,370,0,-2,14,7,7,0,0,0,4,1,3,1,0,1,1,1,0,0,0,0,1,0,1,0,0,0,7,5,2,0,0,0
117733,37000,370,0,-2,9,4,5,0,0,0,2,2,0,0,0,0,2,1,1,0,0,0,4,1,3,0,0,0,1,0,1,0,0,0
117788,37000,370,0,-2,12,11,1,0,0,0,3,3,0,0,0,0,1,1,0,0,0,0,0,0,0,1,1,0,7,6,1,0,0,0
117867,37000,370,0,-2,4,0,4,0,0,0,1,0,1,1,0,1,1,0,1,0,0,0,1,0,1,0,0,0,0,0,0,0,0,0
117900,37000,370,0,-2,4,3,1,0,0,0,1,0,1,0,0,0,1,1,0,0,0,0,2,2,0,0,0,0,0,0,0,0,0,0
117946,37000,370,0,-2,33,7,26,0,0,0,2,0,2,8,1,7,10,2,8,0,0,0,7,4,3,0,0,0,6,0,6,0,0,0
118347,37000,370,0,-2,1,1,0,0,0,0,0,0,0,0,0,0,0,0,0,0,0,0,0,0,0,0,0,0,1,1,0,0,0,0
118541,37000,370,0,-2,1,1,0,0,0,0,0,0,0,0,0,0,0,0,0,0,0,0,1,1,0,0,0,0,0,0,0,0,0,0
118684,37000,370,0,-2,5,1,4,0,0,0,0,0,0,0,0,0,2,1,1,0,0,0,2,0,2,0,0,0,1,0,1,0,0,0
118718,37000,370,0,-2,4,1,3,0,0,0,1,0,1,0,0,0,2,1,1,0,0,0,1,0,1,0,0,0,0,0,0,0,0,0
118888,37000,370,0,-2,13,1,12,0,0,0,1,0,1,1,0,1,3,0,3,0,0,0,7,1,6,1,0,1,0,0,0,0,0,0
118930,37000,370,0,-2,2,1,1,0,0,0,0,0,0,0,0,0,0,0,0,0,0,0,1,1,0,0,0,0,1,0,1,0,0,0
118976,37000,370,0,-2,45,21,24,1,1,0,1,1,0,2,0,2,23,10,13,0,0,0,15,7,8,1,0,1,1,1,0,1,1,0
119058,37000,370,0,-2,4,3,1,0,0,0,0,0,0,0,0,0,0,0,0,0,0,0,2,2,0,0,0,0,2,1,1,0,0,0
119067,37000,370,0,-2,3,0,3,0,0,0,0,0,0,0,0,0,3,0,3,0,0,0,0,0,0,0,0,0,0,0,0,0,0,0
119137,37000,370,0,-2,9,1,8,0,0,0,1,1,0,0,0,0,1,0,1,0,0,0,5,0,5,0,0,0,0,0,0,2,0,2
119164,37000,370,0,-2,44,9,35,0,0,0,5,1,4,4,2,2,19,2,17,0,0,0,10,2,8,0,0,0,6,2,4,0,0,0
119173,37000,370,0,-2,10,0,10,0,0,0,0,0,0,2,0,2,5,0,5,0,0,0,3,0,3,0,0,0,0,0,0,0,0,0
119216,37000,370,0,-2,11,3,8,0,0,0,1,1,0,1,0,1,6,1,5,0,0,0,3,1,2,0,0,0,0,0,0,0,0,0
119331,37000,370,0,-2,3,1,2,0,0,0,0,0,0,0,0,0,2,1,1,0,0,0,1,0,1,0,0,0,0,0,0,0,0,0
119605,37000,370,0,-2,9,3,6,0,0,0,1,1,0,1,1,0,2,0,2,0,0,0,5,1,4,0,0,0,0,0,0,0,0,0
119678,37000,370,0,-2,16,8,8,1,1,0,2,1,1,1,1,0,4,1,3,0,0,0,7,3,4,1,1,0,0,0,0,0,0,0
120078,37000,370,0,-2,2,0,2,0,0,0,0,0,0,0,0,0,1,0,1,0,0,0,0,0,0,0,0,0,1,0,1,0,0,0
120254,37000,370,0,-2,12,3,9,0,0,0,0,0,0,0,0,0,8,1,7,0,0,0,4,2,2,0,0,0,0,0,0,0,0,0
120290,37000,370,0,-2,11,1,10,0,0,0,4,0,4,0,0,0,3,0,3,0,0,0,3,1,2,0,0,0,1,0,1,0,0,0
120342,37000,370,0,-2,1,0,1,0,0,0,0,0,0,0,0,0,0,0,0,0,0,0,1,0,1,0,0,0,0,0,0,0,0,0
120403,37000,370,0,-2,15,3,12,0,0,0,4,1,3,1,0,1,2,0,2,0,0,0,5,1,4,1,1,0,2,0,2,0,0,0
120421,37000,370,0,-2,5,1,4,0,0,0,0,0,0,0,0,0,2,0,2,0,0,0,1,0,1,0,0,0,1,1,0,1,0,1
120537,37000,370,0,-2,2,0,2,0,0,0,0,0,0,0,0,0,0,0,0,0,0,0,1,0,1,0,0,0,1,0,1,0,0,0
120661,37000,370,0,-2,7,1,6,1,0,1,1,0,1,1,1,0,2,0,2,0,0,0,2,0,2,0,0,0,0,0,0,0,0,0
120698,37000,370,0,-2,3,1,2,0,0,0,2,0,2,0,0,0,1,1,0,0,0,0,0,0,0,0,0,0,0,0,0,0,0,0
120883,37000,370,0,-2,64,18,46,0,0,0,12,5,7,4,1,3,19,4,15,0,0,0,21,5,16,6,1,5,0,0,0,2,2,0
120953,37000,370,0,-2,3,0,3,0,0,0,0,0,0,0,0,0,2,0,2,0,0,0,1,0,1,0,0,0,0,0,0,0,0,0
121044,37000,370,0,-2,3,2,1,0,0,0,1,1,0,0,0,0,1,1,0,0,0,0,0,0,0,0,0,0,1,0,1,0,0,0
121150,37000,370,0,-2,23,5,18,0,0,0,2,0,2,2,1,1,4,1,3,0,0,0,12,3,9,1,0,1,2,0,2,0,0,0
121257,37000,370,0,-2,10,3,7,0,0,0,0,0,0,0,0,0,6,2,4,0,0,0,2,0,2,0,0,0,2,1,1,0,0,0
121309,37000,370,0,-2,18,1,17,0,0,0,1,0,1,0,0,0,8,1,7,0,0,0,9,0,9,0,0,0,0,0,0,0,0,0
121345,37000,370,0,-2,17,2,15,0,0,0,0,0,0,0,0,0,7,1,6,0,0,0,9,1,8,0,0,0,1,0,1,0,0,0
121363,37000,370,0,-2,1,0,1,0,0,0,0,0,0,0,0,0,0,0,0,0,0,0,1,0,1,0,0,0,0,0,0,0,0,0
121619,37000,370,0,-2,3,1,2,0,0,0,0,0,0,0,0,0,2,1,1,0,0,0,0,0,0,0,0,0,1,0,1,0,0,0
121691,37000,370,0,-2,12,3,9,0,0,0,1,0,1,0,0,0,4,1,3,0,0,0,4,2,2,0,0,0,3,0,3,0,0,0
121707,37000,370,0,-2,8,0,8,0,0,0,1,0,1,0,0,0,0,0,0,0,0,0,6,0,6,1,0,1,0,0,0,0,0,0
121886,37000,370,0,-2,3,0,3,0,0,0,1,0,1,0,0,0,2,0,2,0,0,0,0,0,0,0,0,0,0,0,0,0,0,0
121901,37000,370,0,-2,4,2,2,0,0,0,0,0,0,0,0,0,3,2,1,0,0,0,1,0,1,0,0,0,0,0,0,0,0,0
122180,37000,370,0,-2,2,1,1,0,0,0,0,0,0,1,1,0,1,0,1,0,0,0,0,0,0,0,0,0,0,0,0,0,0,0
122205,37000,370,0,-2,7,2,5,0,0,0,0,0,0,0,0,0,1,0,1,0,0,0,5,2,3,0,0,0,0,0,0,1,0,1
122296,37000,370,0,-2,10,0,10,0,0,0,2,0,2,1,0,1,0,0,0,0,0,0,2,0,2,0,0,0,5,0,5,0,0,0
122375,37000,370,0,-2,1,0,1,0,0,0,1,0,1,0,0,0,0,0,0,0,0,0,0,0,0,0,0,0,0,0,0,0,0,0
122409,37000,370,0,-2,25,4,21,0,0,0,4,3,1,0,0,0,9,0,9,0,0,0,9,1,8,3,0,3,0,0,0,0,0,0
122436,37000,370,0,-2,25,4,21,0,0,0,3,1,2,2,0,2,9,2,7,0,0,0,11,1,10,0,0,0,0,0,0,0,0,0
122506,37000,370,0,-2,1,0,1,0,0,0,0,0,0,0,0,0,0,0,0,0,0,0,1,0,1,0,0,0,0,0,0,0,0,0
122597,37000,370,0,-2,3,1,2,0,0,0,1,0,1,0,0,0,1,0,1,0,0,0,1,1,0,0,0,0,0,0,0,0,0,0
122612,37000,370,0,-2,46,15,31,0,0,0,10,2,8,2,0,2,15,5,10,1,1,0,9,6,3,7,1,6,1,0,1,1,0,1
122685,37000,370,0,-2,2,0,2,0,0,0,0,0,0,0,0,0,2,0,2,0,0,0,0,0,0,0,0,0,0,0,0,0,0,0
122694,37000,370,0,-2,1,0,1,0,0,0,0,0,0,0,0,0,1,0,1,0,0,0,0,0,0,0,0,0,0,0,0,0,0,0
122728,37000,370,0,-2,5,0,5,0,0,0,0,0,0,0,0,0,0,0,0,0,0,0,3,0,3,2,0,2,0,0,0,0,0,0
122746,37000,370,0,-2,5,2,3,0,0,0,1,1,0,0,0,0,1,0,1,0,0,0,1,0,1,0,0,0,2,1,1,0,0,0
122755,37000,370,0,-2,10,3,7,0,0,0,6,1,5,1,0,1,3,2,1,0,0,0,0,0,0,0,0,0,0,0,0,0,0,0
122782,37000,370,0,-2,6,1,5,0,0,0,2,0,2,1,0,1,1,0,1,0,0,0,2,1,1,0,0,0,0,0,0,0,0,0
122791,37000,370,0,-2,5,0,5,0,0,0,2,0,2,0,0,0,3,0,3,0,0,0,0,0,0,0,0,0,0,0,0,0,0,0
122889,37000,370,0,-2,1,0,1,0,0,0,0,0,0,0,0,0,0,0,0,0,0,0,1,0,1,0,0,0,0,0,0,0,0,0
122931,37000,370,0,-2,31,7,24,0,0,0,8,0,8,1,0,1,4,1,3,1,0,1,12,5,7,2,0,2,3,1,2,0,0,0
123165,37000,370,0,-2,6,1,5,0,0,0,1,0,1,0,0,0,4,1,3,0,0,0,1,0,1,0,0,0,0,0,0,0,0,0
123217,37000,370,0,-2,6,1,5,0,0,0,0,0,0,0,0,0,6,1,5,0,0,0,0,0,0,0,0,0,0,0,0,0,0,0
123299,37000,370,0,-2,3,1,2,0,0,0,0,0,0,0,0,0,0,0,0,0,0,0,3,1,2,0,0,0,0,0,0,0,0,0
123341,37000,370,0,-2,5,0,5,0,0,0,0,0,0,0,0,0,1,0,1,0,0,0,3,0,3,0,0,0,1,0,1,0,0,0
123448,37000,370,0,-2,1,0,1,0,0,0,0,0,0,0,0,0,0,0,0,0,0,0,1,0,1,0,0,0,0,0,0,0,0,0
123457,37000,370,0,-2,9,1,8,0,0,0,0,0,0,0,0,0,0,0,0,0,0,0,9,1,8,0,0,0,0,0,0,0,0,0
123484,37000,370,0,-2,8,0,8,0,0,0,0,0,0,0,0,0,1,0,1,0,0,0,6,0,6,0,0,0,1,0,1,0,0,0
123509,37000,370,0,-2,10,2,8,0,0,0,5,1,4,3,1,2,1,0,1,0,0,0,0,0,0,0,0,0,1,0,1,0,0,0
123527,37000,370,0,-2,1,0,1,0,0,0,0,0,0,1,0,1,0,0,0,0,0,0,0,0,0,0,0,0,0,0,0,0,0,0
123554,37000,370,0,-2,8,2,6,1,1,0,1,1,0,1,0,1,1,0,1,0,0,0,1,0,1,1,0,1,2,0,2,0,0,0
123563,37000,370,0,-2,6,1,5,0,0,0,1,0,1,2,1,1,1,0,1,0,0,0,1,0,1,1,0,1,0,0,0,0,0,0
123572,37000,370,0,-2,3,0,3,0,0,0,0,0,0,1,0,1,0,0,0,0,0,0,2,0,2,0,0,0,0,0,0,0,0,0
123651,37000,370,0,-2,3,1,2,0,0,0,0,0,0,0,0,0,0,0,0,0,0,0,3,1,2,0,0,0,0,0,0,0,0,0
123679,37000,370,0,-2,2,0,2,0,0,0,1,0,1,0,0,0,1,0,1,0,0,0,0,0,0,0,0,0,0,0,0,0,0,0
123800,37000,370,0,-2,15,3,12,0,0,0,4,1,3,1,0,1,6,0,6,0,0,0,3,2,1,1,0,1,0,0,0,0,0,0
123943,37000,370,0,-2,5,1,4,0,0,0,1,0,1,0,0,0,1,0,1,0,0,0,1,0,1,0,0,0,2,1,1,0,0,0
123952,37000,370,0,-2,2,1,1,0,0,0,0,0,0,0,0,0,1,1,0,0,0,0,1,0,1,0,0,0,0,0,0,0,0,0
123961,37000,370,0,-2,243,86,157,0,0,0,36,8,28,34,13,21,115,43,72,1,1,0,42,14,28,8,6,2,4,0,4,3,1,2
123970,37000,370,0,-2,8,3,5,0,0,0,0,0,0,1,1,0,3,1,2,0,0,0,2,1,1,2,0,2,0,0,0,0,0,0
124113,37000,370,0,-2,1,0,1,0,0,0,0,0,0,0,0,0,0,0,0,0,0,0,0,0,0,0,0,0,1,0,1,0,0,0
124283,37000,370,0,-2,2,2,0,0,0,0,2,2,0,0,0,0,0,0,0,0,0,0,0,0,0,0,0,0,0,0,0,0,0,0
124292,37000,370,0,-2,4,1,3,0,0,0,0,0,0,0,0,0,2,0,2,0,0,0,2,1,1,0,0,0,0,0,0,0,0,0
124557,37000,370,0,-2,19,1,18,0,0,0,5,0,5,4,1,3,2,0,2,0,0,0,8,0,8,0,0,0,0,0,0,0,0,0
124937,37000,370,0,-2,4,1,3,0,0,0,0,0,0,1,1,0,1,0,1,0,0,0,1,0,1,1,0,1,0,0,0,0,0,0
125019,37000,370,0,-2,6,3,3,0,0,0,0,0,0,0,0,0,1,0,1,0,0,0,4,2,2,0,0,0,1,1,0,0,0,0
125028,37000,370,0,-2,7,3,4,0,0,0,0,0,0,0,0,0,5,2,3,0,0,0,2,1,1,0,0,0,0,0,0,0,0,0
125231,37000,370,0,-2,3,0,3,0,0,0,0,0,0,2,0,2,1,0,1,0,0,0,0,0,0,0,0,0,0,0,0,0,0,0
125471,37000,370,0,-2,8,3,5,0,0,0,0,0,0,1,0,1,2,0,2,0,0,0,0,0,0,0,0,0,5,3,2,0,0,0
125499,37000,370,0,-2,1,0,1,0,0,0,0,0,0,0,0,0,0,0,0,0,0,0,1,0,1,0,0,0,0,0,0,0,0,0
125532,37000,370,0,-2,2,0,2,0,0,0,0,0,0,0,0,0,0,0,0,0,0,0,1,0,1,0,0,0,1,0,1,0,0,0
125727,37000,370,0,-2,5,1,4,0,0,0,0,0,0,0,0,0,0,0,0,0,0,0,3,0,3,1,0,1,1,1,0,0,0,0
125763,37000,370,0,-2,4,2,2,0,0,0,1,1,0,1,1,0,1,0,1,0,0,0,1,0,1,0,0,0,0,0,0,0,0,0
126049,37000,370,0,-2,2,1,1,0,0,0,0,0,0,0,0,0,1,0,1,0,0,0,1,1,0,0,0,0,0,0,0,0,0,0
126100,37000,370,0,-2,8,0,8,0,0,0,0,0,0,0,0,0,4,0,4,0,0,0,3,0,3,0,0,0,1,0,1,0,0,0
126182,37000,370,0,-2,1,0,1,0,0,0,0,0,0,0,0,0,1,0,1,0,0,0,0,0,0,0,0,0,0,0,0,0,0,0
126207,37000,370,0,-2,5,1,4,0,0,0,0,0,0,0,0,0,2,0,2,0,0,0,3,1,2,0,0,0,0,0,0,0,0,0
126289,37000,370,0,-2,8,2,6,0,0,0,0,0,0,0,0,0,2,1,1,0,0,0,6,1,5,0,0,0,0,0,0,0,0,0
126562,37000,370,0,-2,87,11,76,1,0,1,7,3,4,6,1,5,15,3,12,1,0,1,43,3,40,5,1,4,9,0,9,0,0,0
126580,37000,370,0,-2,5,1,4,0,0,0,1,0,1,0,0,0,2,0,2,0,0,0,2,1,1,0,0,0,0,0,0,0,0,0
126614,37000,370,0,-2,68,23,45,0,0,0,1,0,1,3,1,2,8,4,4,0,0,0,50,17,33,2,0,2,4,1,3,0,0,0
126669,37000,370,0,-2,7,1,6,0,0,0,0,0,0,0,0,0,0,0,0,0,0,0,7,1,6,0,0,0,0,0,0,0,0,0
126678,37000,370,0,-2,22,2,20,0,0,0,1,0,1,1,0,1,7,1,6,0,0,0,11,1,10,1,0,1,1,0,1,0,0,0
126687,37000,370,0,-2,7,2,5,1,0,1,0,0,0,0,0,0,2,0,2,0,0,0,3,2,1,1,0,1,0,0,0,0,0,0
126711,37000,370,0,-2,10,2,8,0,0,0,0,0,0,0,0,0,2,0,2,0,0,0,8,2,6,0,0,0,0,0,0,0,0,0
126748,37000,370,0,-2,1,1,0,0,0,0,0,0,0,0,0,0,0,0,0,0,0,0,1,1,0,0,0,0,0,0,0,0,0,0
126775,37000,370,0,-2,16,2,14,0,0,0,1,0,1,0,0,0,1,0,1,0,0,0,11,1,10,1,0,1,2,1,1,0,0,0
126818,37000,370,0,-2,47,13,34,1,0,1,0,0,0,2,2,0,3,0,3,0,0,0,32,10,22,1,0,1,8,1,7,0,0,0
126863,37000,370,0,-2,1,0,1,0,0,0,1,0,1,0,0,0,0,0,0,0,0,0,0,0,0,0,0,0,0,0,0,0,0,0
126942,37000,370,0,-2,3,2,1,0,0,0,1,1,0,0,0,0,2,1,1,0,0,0,0,0,0,0,0,0,0,0,0,0,0,0
126951,37000,370,0,-2,4,0,4,0,0,0,0,0,0,0,0,0,2,0,2,0,0,0,2,0,2,0,0,0,0,0,0,0,0,0
126979,37000,370,0,-2,8,1,7,0,0,0,1,0,1,1,0,1,0,0,0,0,0,0,5,1,4,0,0,0,1,0,1,0,0,0
127060,37000,370,0,-2,23,8,15,3,1,2,1,1,0,1,0,1,8,2,6,0,0,0,5,3,2,5,1,4,0,0,0,0,0,0
127185,37000,370,0,-2,3,1,2,0,0,0,0,0,0,0,0,0,1,0,1,0,0,0,2,1,1,0,0,0,0,0,0,0,0,0
127200,37000,370,0,-2,9,0,9,0,0,0,1,0,1,0,0,0,0,0,0,0,0,0,7,0,7,1,0,1,0,0,0,0,0,0
127273,37000,370,0,-2,3,0,3,0,0,0,0,0,0,0,0,0,0,0,0,0,0,0,3,0,3,0,0,0,0,0,0,0,0,0
127389,37000,370,0,-2,1,0,1,0,0,0,0,0,0,0,0,0,1,0,1,0,0,0,0,0,0,0,0,0,0,0,0,0,0,0
127556,37000,370,0,-2,9,0,9,0,0,0,0,0,0,0,0,0,1,0,1,0,0,0,7,0,7,0,0,0,1,0,1,0,0,0
127565,37000,370,0,-2,92,26,66,3,3,0,3,0,3,7,5,2,16,3,13,0,0,0,54,13,41,7,1,6,2,1,1,0,0,0
127653,37000,370,0,-2,3,0,3,0,0,0,1,0,1,0,0,0,0,0,0,0,0,0,2,0,2,0,0,0,0,0,0,0,0,0
127732,37000,370,0,-2,2,0,2,0,0,0,0,0,0,0,0,0,1,0,1,0,0,0,1,0,1,0,0,0,0,0,0,0,0,0
127741,37000,370,0,-2,11,3,8,0,0,0,0,0,0,0,0,0,1,0,1,0,0,0,10,3,7,0,0,0,0,0,0,0,0,0
127778,37000,370,0,-2,1,0,1,0,0,0,0,0,0,0,0,0,0,0,0,0,0,0,1,0,1,0,0,0,0,0,0,0,0,0
127820,37000,370,0,-2,78,15,63,1,0,1,6,1,5,9,5,4,12,1,11,0,0,0,46,6,40,2,1,1,2,1,1,0,0,0
127884,37000,370,0,-2,4,0,4,0,0,0,0,0,0,0,0,0,4,0,4,0,0,0,0,0,0,0,0,0,0,0,0,0,0,0
127909,37000,370,0,-2,3,0,3,0,0,0,0,0,0,0,0,0,1,0,1,0,0,0,2,0,2,0,0,0,0,0,0,0,0,0
127918,37000,370,0,-2,30,8,22,1,0,1,1,0,1,2,1,1,8,2,6,0,0,0,15,5,10,2,0,2,1,0,1,0,0,0
127945,37000,370,0,-2,13,3,10,0,0,0,0,0,0,2,0,2,0,0,0,0,0,0,10,3,7,1,0,1,0,0,0,0,0,0
128106,37000,370,0,-2,8,0,8,0,0,0,1,0,1,0,0,0,6,0,6,0,0,0,1,0,1,0,0,0,0,0,0,0,0,0
128188,37000,370,0,-2,2,0,2,0,0,0,0,0,0,0,0,0,1,0,1,0,0,0,1,0,1,0,0,0,0,0,0,0,0,0
128300,37000,370,0,-2,2,0,2,0,0,0,0,0,0,0,0,0,0,0,0,0,0,0,2,0,2,0,0,0,0,0,0,0,0,0
128328,37000,370,0,-2,4,0,4,0,0,0,0,0,0,2,0,2,0,0,0,0,0,0,2,0,2,0,0,0,0,0,0,0,0,0
128391,37000,370,0,-2,4,0,4,0,0,0,0,0,0,0,0,0,1,0,1,0,0,0,3,0,3,0,0,0,0,0,0,0,0,0
128498,37000,370,0,-2,5,0,5,0,0,0,0,0,0,3,0,3,0,0,0,0,0,0,1,0,1,0,0,0,1,0,1,0,0,0
128744,37000,370,0,-2,25,0,25,0,0,0,1,0,1,4,0,4,10,0,10,0,0,0,9,0,9,0,0,0,1,0,1,0,0,0
128771,37000,370,0,-2,3,0,3,0,0,0,0,0,0,0,0,0,0,0,0,0,0,0,3,0,3,0,0,0,0,0,0,0,0,0
128780,37000,370,0,-2,1,1,0,0,0,0,0,0,0,0,0,0,0,0,0,0,0,0,1,1,0,0,0,0,0,0,0,0,0,0
128902,37000,370,0,-2,8,2,6,0,0,0,1,0,1,0,0,0,0,0,0,0,0,0,6,1,5,0,0,0,1,1,0,0,0,0
129020,37000,370,0,-2,157,38,119,0,0,0,5,2,3,19,8,11,16,2,14,0,0,0,92,21,71,0,0,0,23,4,19,2,1,1
129154,37000,370,0,-2,16,1,15,0,0,0,0,0,0,4,1,3,4,0,4,0,0,0,8,0,8,0,0,0,0,0,0,0,0,0
129215,37000,370,0,-2,1,0,1,0,0,0,0,0,0,0,0,0,0,0,0,0,0,0,1,0,1,0,0,0,0,0,0,0,0,0
129242,37000,370,0,-2,16,2,14,0,0,0,1,0,1,4,0,4,3,2,1,0,0,0,8,0,8,0,0,0,0,0,0,0,0,0
129525,37000,370,0,-2,27,6,21,0,0,0,0,0,0,3,1,2,1,1,0,0,0,0,19,3,16,2,1,1,1,0,1,1,0,1
129695,37000,370,0,-2,2,0,2,0,0,0,0,0,0,0,0,0,0,0,0,0,0,0,1,0,1,0,0,0,1,0,1,0,0,0
129774,37000,370,0,-2,1,0,1,0,0,0,0,0,0,0,0,0,0,0,0,0,0,0,0,0,0,0,0,0,1,0,1,0,0,0
129941,37000,370,0,-2,10,4,6,0,0,0,0,0,0,3,1,2,2,0,2,0,0,0,5,3,2,0,0,0,0,0,0,0,0,0
130110,37000,370,0,-2,3,0,3,0,0,0,0,0,0,1,0,1,2,0,2,0,0,0,0,0,0,0,0,0,0,0,0,0,0,0
130183,37000,370,0,-2,1,0,1,0,0,0,0,0,0,0,0,0,1,0,1,0,0,0,0,0,0,0,0,0,0,0,0,0,0,0
130226,37000,370,0,-2,9,1,8,0,0,0,0,0,0,3,1,2,3,0,3,0,0,0,3,0,3,0,0,0,0,0,0,0,0,0
130253,37000,370,0,-2,20,4,16,0,0,0,1,0,1,1,0,1,0,0,0,0,0,0,8,2,6,0,0,0,10,2,8,0,0,0
130314,37000,370,0,-2,5,1,4,0,0,0,0,0,0,1,0,1,0,0,0,0,0,0,4,1,3,0,0,0,0,0,0,0,0,0
130396,37000,370,0,-2,2,0,2,0,0,0,0,0,0,1,0,1,0,0,0,0,0,0,1,0,1,0,0,0,0,0,0,0,0,0
130493,37000,370,0,-2,6,0,6,0,0,0,0,0,0,1,0,1,0,0,0,0,0,0,0,0,0,0,0,0,5,0,5,0,0,0
130590,37000,370,0,-2,5,0,5,0,0,0,0,0,0,1,0,1,0,0,0,0,0,0,3,0,3,0,0,0,1,0,1,0,0,0
130606,37000,370,0,-2,1,0,1,0,0,0,0,0,0,0,0,0,0,0,0,0,0,0,1,0,1,0,0,0,0,0,0,0,0,0
130624,37000,370,0,-2,63,35,28,1,0,1,1,1,0,4,2,2,4,3,1,2,2,0,29,18,11,1,1,0,21,8,13,0,0,0
130697,37000,370,0,-2,7,0,7,0,0,0,0,0,0,1,0,1,0,0,0,0,0,0,5,0,5,0,0,0,1,0,1,0,0,0
130776,37000,370,0,-2,1,0,1,0,0,0,0,0,0,0,0,0,0,0,0,0,0,0,1,0,1,0,0,0,0,0,0,0,0,0
130794,37000,370,0,-2,58,9,49,0,0,0,3,0,3,6,0,6,14,2,12,0,0,0,32,6,26,0,0,0,1,1,0,2,0,2
130882,37000,370,0,-2,1,0,1,1,0,1,0,0,0,0,0,0,0,0,0,0,0,0,0,0,0,0,0,0,0,0,0,0,0,0
130907,37000,370,0,-2,12,3,9,0,0,0,0,0,0,5,2,3,0,0,0,0,0,0,6,0,6,1,1,0,0,0,0,0,0,0
130934,37000,370,0,-2,21,6,15,0,0,0,0,0,0,13,5,8,0,0,0,0,0,0,7,1,6,1,0,1,0,0,0,0,0,0
130943,37000,370,0,-2,23,4,19,0,0,0,2,0,2,1,0,1,1,0,1,0,0,0,19,4,15,0,0,0,0,0,0,0,0,0
131113,37000,370,0,-2,2,1,1,0,0,0,0,0,0,0,0,0,0,0,0,0,0,0,2,1,1,0,0,0,0,0,0,0,0,0
131159,37000,370,0,-2,31,8,23,0,0,0,1,1,0,9,1,8,1,0,1,0,0,0,18,5,13,1,0,1,1,1,0,0,0,0
131283,37000,370,0,-2,26,7,19,0,0,0,0,0,0,3,1,2,2,1,1,0,0,0,17,3,14,0,0,0,2,0,2,2,2,0
131399,37000,370,0,-2,4,2,2,0,0,0,0,0,0,3,1,2,1,1,0,0,0,0,0,0,0,0,0,0,0,0,0,0,0,0
131405,37000,370,0,-2,2,0,2,0,0,0,0,0,0,0,0,0,0,0,0,0,0,0,2,0,2,0,0,0,0,0,0,0,0,0
131450,37000,370,0,-2,10,1,9,0,0,0,2,0,2,2,0,2,1,0,1,0,0,0,5,1,4,0,0,0,0,0,0,0,0,0
131469,37000,370,0,-2,51,12,39,0,0,0,3,0,3,9,1,8,8,2,6,0,0,0,27,8,19,3,0,3,1,1,0,0,0,0
131496,37000,370,0,-2,41,14,27,0,0,0,3,1,2,10,3,7,3,0,3,0,0,0,16,6,10,2,1,1,7,3,4,0,0,0
131520,37000,370,0,-2,48,8,40,0,0,0,1,0,1,31,6,25,4,0,4,0,0,0,1,1,0,0,0,0,11,1,10,0,0,0
131803,37000,370,0,-2,2,0,2,0,0,0,0,0,0,0,0,0,0,0,0,0,0,0,2,0,2,0,0,0,0,0,0,0,0,0
131973,37000,370,0,-2,2,0,2,0,0,0,0,0,0,1,0,1,0,0,0,0,0,0,1,0,1,0,0,0,0,0,0,0,0,0
132408,37000,370,0,-2,2,0,2,0,0,0,0,0,0,0,0,0,0,0,0,0,0,0,2,0,2,0,0,0,0,0,0,0,0,0
132471,37000,370,0,-2,17,0,17,0,0,0,0,0,0,4,0,4,6,0,6,0,0,0,3,0,3,0,0,0,4,0,4,0,0,0
132602,37000,370,0,-2,9,2,7,0,0,0,0,0,0,8,1,7,0,0,0,0,0,0,1,1,0,0,0,0,0,0,0,0,0,0
132657,37000,370,0,-2,17,7,10,0,0,0,0,0,0,0,0,0,0,0,0,0,0,0,8,3,5,0,0,0,9,4,5,0,0,0
132709,37000,370,0,-2,5,1,4,0,0,0,1,0,1,1,0,1,1,0,1,0,0,0,2,1,1,0,0,0,0,0,0,0,0,0
132842,37000,370,0,-2,1,0,1,0,0,0,0,0,0,0,0,0,1,0,1,0,0,0,0,0,0,0,0,0,0,0,0,0,0,0
132851,37000,370,0,-2,6,0,6,0,0,0,0,0,0,1,0,1,1,0,1,0,0,0,4,0,4,0,0,0,0,0,0,0,0,0
132903,37000,370,0,-2,9,1,8,0,0,0,1,0,1,1,0,1,4,1,3,0,0,0,3,0,3,0,0,0,0,0,0,0,0,0
133021,37000,370,0,-2,1,0,1,0,0,0,0,0,0,0,0,0,0,0,0,0,0,0,1,0,1,0,0,0,0,0,0,0,0,0
133386,37000,370,0,-2,12,2,10,0,0,0,0,0,0,2,1,1,1,0,1,0,0,0,9,1,8,0,0,0,0,0,0,0,0,0
133465,37000,370,0,-2,2,0,2,0,0,0,0,0,0,1,0,1,0,0,0,0,0,0,1,0,1,0,0,0,0,0,0,0,0,0
133492,37000,370,0,-2,14,5,9,0,0,0,1,0,1,2,1,1,1,1,0,0,0,0,9,3,6,1,0,1,0,0,0,0,0,0
133508,37000,370,0,-2,13,4,9,0,0,0,0,0,0,0,0,0,3,2,1,0,0,0,10,2,8,0,0,0,0,0,0,0,0,0
133526,37000,370,0,-2,5,0,5,0,0,0,0,0,0,5,0,5,0,0,0,0,0,0,0,0,0,0,0,0,0,0,0,0,0,0
133553,37000,370,0,-2,37,8,29,0,0,0,0,0,0,1,1,0,3,1,2,0,0,0,27,5,22,0,0,0,6,1,5,0,0,0
133650,37000,370,0,-2,11,5,6,0,0,0,0,0,0,9,4,5,1,0,1,0,0,0,0,0,0,1,1,0,0,0,0,0,0,0
133669,37000,370,0,-2,20,3,17,0,0,0,1,1,0,7,1,6,4,0,4,0,0,0,8,1,7,0,0,0,0,0,0,0,0,0
133702,37000,370,0,-2,40,11,29,0,0,0,0,0,0,11,5,6,2,0,2,1,1,0,24,5,19,1,0,1,1,0,1,0,0,0
133711,37000,370,0,-2,8,2,6,0,0,0,0,0,0,1,1,0,3,0,3,0,0,0,4,1,3,0,0,0,0,0,0,0,0,0
133809,37000,370,0,-2,2,0,2,0,0,0,0,0,0,0,0,0,0,0,0,0,0,0,2,0,2,0,0,0,0,0,0,0,0,0
133845,37000,370,0,-2,5,0,5,0,0,0,0,0,0,1,0,1,0,0,0,0,0,0,4,0,4,0,0,0,0,0,0,0,0,0
133863,37000,370,0,-2,2,0,2,0,0,0,0,0,0,0,0,0,0,0,0,0,0,0,2,0,2,0,0,0,0,0,0,0,0,0
133872,37000,370,0,-2,6,0,6,0,0,0,0,0,0,1,0,1,3,0,3,0,0,0,2,0,2,0,0,0,0,0,0,0,0,0
133881,37000,370,0,-2,21,8,13,0,0,0,0,0,0,3,0,3,2,1,1,0,0,0,15,7,8,0,0,0,1,0,1,0,0,0
133960,37000,370,0,-2,20,12,8,0,0,0,0,0,0,2,0,2,1,1,0,0,0,0,15,9,6,0,0,0,2,2,0,0,0,0
133979,37000,370,0,-2,24,8,16,0,0,0,0,0,0,19,6,13,3,2,1,0,0,0,0,0,0,2,0,2,0,0,0,0,0,0
133997,37000,370,0,-2,10,4,6,0,0,0,0,0,0,3,1,2,5,1,4,0,0,0,0,0,0,2,2,0,0,0,0,0,0,0
134079,37000,370,0,-2,10,1,9,0,0,0,0,0,0,0,0,0,3,1,2,0,0,0,7,0,7,0,0,0,0,0,0,0,0,0
134097,37000,370,0,-2,35,7,28,0,0,0,0,0,0,7,1,6,3,1,2,0,0,0,22,4,18,1,0,1,1,1,0,1,0,1
134130,37000,370,0,-2,136,31,105,1,1,0,6,1,5,19,3,16,20,6,14,0,0,0,84,20,64,0,0,0,5,0,5,1,0,1
134237,37000,370,0,-2,322,141,181,1,0,1,12,4,8,49,20,29,87,39,48,3,0,3,139,63,76,27,11,16,4,4,0,0,0,0
134343,37000,370,0,-2,5,2,3,0,0,0,0,0,0,0,0,0,0,0,0,0,0,0,5,2,3,0,0,0,0,0,0,0,0,0
134495,37000,370,0,-2,9,4,5,0,0,0,0,0,0,2,0,2,2,1,1,0,0,0,5,3,2,0,0,0,0,0,0,0,0,0
134608,37000,370,0,-2,13,3,10,0,0,0,0,0,0,3,0,3,2,2,0,1,0,1,7,1,6,0,0,0,0,0,0,0,0,0
134811,37000,370,0,-2,2,0,2,0,0,0,1,0,1,0,0,0,0,0,0,0,0,0,0,0,0,1,0,1,0,0,0,0,0,0
134945,37000,370,0,-2,11,2,9,0,0,0,1,0,1,0,0,0,0,0,0,0,0,0,10,2,8,0,0,0,0,0,0,0,0,0
135081,37000,370,0,-2,30,14,16,0,0,0,2,1,1,7,3,4,7,4,3,0,0,0,11,5,6,3,1,2,0,0,0,0,0,0
135160,37000,370,0,-2,9,3,6,0,0,0,0,0,0,1,1,0,1,0,1,0,0,0,7,2,5,0,0,0,0,0,0,0,0,0
135188,37000,370,0,-2,7,2,5,0,0,0,0,0,0,1,0,1,0,0,0,0,0,0,5,1,4,0,0,0,0,0,0,1,1,0
135391,37000,370,0,-2,34,9,25,0,0,0,1,1,0,2,0,2,5,1,4,0,0,0,25,7,18,1,0,1,0,0,0,0,0,0
135717,37000,370,0,-2,53,11,42,0,0,0,2,1,1,8,1,7,38,7,31,0,0,0,3,1,2,0,0,0,1,1,0,1,0,1
135726,37000,370,0,-2,369,85,284,0,0,0,8,3,5,55,3,52,229,59,170,2,0,2,23,6,17,3,0,3,24,5,19,25,9,16
136172,37000,370,0,-2,29,5,24,0,0,0,1,0,1,4,0,4,2,0,2,0,0,0,18,4,14,4,1,3,0,0,0,0,0,0
136215,37000,370,0,-2,135,22,113,0,0,0,7,3,4,46,7,39,41,7,34,0,0,0,36,5,31,1,0,1,2,0,2,2,0,2
136233,37000,370,0,-2,22,3,19,0,0,0,1,0,1,0,0,0,1,0,1,0,0,0,18,3,15,2,0,2,0,0,0,0,0,0
136330,37000,370,0,-2,13,1,12,0,0,0,0,0,0,1,0,1,3,1,2,0,0,0,8,0,8,0,0,0,0,0,0,1,0,1
136358,37000,370,0,-2,8,3,5,0,0,0,0,0,0,5,2,3,0,0,0,0,0,0,3,1,2,0,0,0,0,0,0,0,0,0
136400,37000,370,0,-2,4,2,2,0,0,0,0,0,0,1,0,1,0,0,0,0,0,0,1,1,0,0,0,0,2,1,1,0,0,0
136473,37000,370,0,-2,15,3,12,0,0,0,0,0,0,4,1,3,0,0,0,0,0,0,9,2,7,2,0,2,0,0,0,0,0,0
136516,37000,370,0,-2,2,0,2,0,0,0,0,0,0,1,0,1,0,0,0,0,0,0,1,0,1,0,0,0,0,0,0,0,0,0
136701,37000,370,0,-2,1,0,1,0,0,0,0,0,0,0,0,0,1,0,1,0,0,0,0,0,0,0,0,0,0,0,0,0,0,0
136774,37000,370,0,-2,6,2,4,1,0,1,0,0,0,0,0,0,0,0,0,0,0,0,5,2,3,0,0,0,0,0,0,0,0,0
136950,37000,370,0,-2,11,1,10,0,0,0,0,0,0,2,0,2,1,0,1,0,0,0,7,1,6,1,0,1,0,0,0,0,0,0
137032,37000,370,0,-2,9,1,8,0,0,0,0,0,0,1,0,1,0,0,0,0,0,0,4,0,4,1,0,1,3,1,2,0,0,0
137078,37000,370,0,-2,21,4,17,0,0,0,1,0,1,6,1,5,2,0,2,0,0,0,10,2,8,0,0,0,2,1,1,0,0,0
137096,37000,370,0,-2,27,10,17,0,0,0,0,0,0,7,4,3,6,3,3,0,0,0,11,2,9,1,0,1,2,1,1,0,0,0
137209,37000,370,0,-2,1,0,1,0,0,0,0,0,0,0,0,0,0,0,0,0,0,0,1,0,1,0,0,0,0,0,0,0,0,0
137272,37000,370,0,-2,1,0,1,0,0,0,0,0,0,0,0,0,1,0,1,0,0,0,0,0,0,0,0,0,0,0,0,0,0,0
137281,37000,370,0,-2,18,3,15,0,0,0,0,0,0,6,1,5,1,0,1,0,0,0,11,2,9,0,0,0,0,0,0,0,0,0
137315,37000,370,0,-2,7,1,6,0,0,0,0,0,0,0,0,0,2,0,2,0,0,0,3,0,3,0,0,0,2,1,1,0,0,0
137351,37000,370,0,-2,93,12,81,0,0,0,1,0,1,17,1,16,8,1,7,0,0,0,46,8,38,18,1,17,1,0,1,2,1,1
137476,37000,370,0,-2,7,1,6,0,0,0,0,0,0,0,0,0,6,1,5,0,0,0,1,0,1,0,0,0,0,0,0,0,0,0
137546,37000,370,0,-2,20,1,19,0,0,0,0,0,0,0,0,0,2,0,2,0,0,0,17,1,16,0,0,0,1,0,1,0,0,0
137564,37000,370,0,-2,14,2,12,0,0,0,0,0,0,0,0,0,3,0,3,0,0,0,11,2,9,0,0,0,0,0,0,0,0,0
137759,37000,370,0,-2,14,1,13,0,0,0,0,0,0,10,1,9,0,0,0,0,0,0,4,0,4,0,0,0,0,0,0,0,0,0
137801,37000,370,0,-2,6,0,6,0,0,0,0,0,0,2,0,2,1,0,1,0,0,0,2,0,2,1,0,1,0,0,0,0,0,0
137847,37000,370,0,-2,23,1,22,0,0,0,0,0,0,2,0,2,5,1,4,0,0,0,14,0,14,1,0,1,1,0,1,0,0,0
138187,37000,370,0,-2,16,3,13,0,0,0,0,0,0,4,1,3,3,1,2,0,0,0,8,1,7,0,0,0,0,0,0,1,0,1
138275,37000,370,0,-2,4,0,4,0,0,0,0,0,0,0,0,0,0,0,0,0,0,0,4,0,4,0,0,0,0,0,0,0,0,0
138293,37000,370,0,-2,2,1,1,0,0,0,0,0,0,1,1,0,0,0,0,0,0,0,1,0,1,0,0,0,0,0,0,0,0,0
138309,37000,370,0,-2,13,0,13,0,0,0,0,0,0,4,0,4,1,0,1,0,0,0,6,0,6,2,0,2,0,0,0,0,0,0
138354,37000,370,0,-2,13,3,10,0,0,0,0,0,0,2,1,1,1,0,1,0,0,0,10,2,8,0,0,0,0,0,0,0,0,0
138558,37000,370,0,-2,4,0,4,0,0,0,0,0,0,0,0,0,0,0,0,0,0,0,3,0,3,0,0,0,1,0,1,0,0,0
138600,37000,370,0,-2,13,0,13,0,0,0,0,0,0,5,0,5,0,0,0,0,0,0,3,0,3,1,0,1,3,0,3,1,0,1
138655,37000,370,0,-2,1,0,1,0,0,0,0,0,0,0,0,0,1,0,1,0,0,0,0,0,0,0,0,0,0,0,0,0,0,0
138682,37000,370,0,-2,11,0,11,0,0,0,0,0,0,11,0,11,0,0,0,0,0,0,0,0,0,0,0,0,0,0,0,0,0,0
138716,37000,370,0,-2,7,0,7,0,0,0,0,0,0,7,0,7,0,0,0,0,0,0,0,0,0,0,0,0,0,0,0,0,0,0
138761,37000,370,0,-2,1,0,1,0,0,0,0,0,0,1,0,1,0,0,0,0,0,0,0,0,0,0,0,0,0,0,0,0,0,0
138840,37000,370,0,-2,13,2,11,0,0,0,0,0,0,10,1,9,0,0,0,0,0,0,3,1,2,0,0,0,0,0,0,0,0,0
138929,37000,370,0,-2,2,0,2,0,0,0,0,0,0,2,0,2,0,0,0,0,0,0,0,0,0,0,0,0,0,0,0,0,0,0
138947,37000,370,0,-2,21,9,12,0,0,0,0,0,0,19,8,11,0,0,0,0,0,0,0,0,0,0,0,0,2,1,1,0,0,0
138956,37000,370,0,-2,10,0,10,0,0,0,0,0,0,9,0,9,0,0,0,0,0,0,1,0,1,0,0,0,0,0,0,0,0,0
139144,37000,370,0,-2,15,1,14,0,0,0,0,0,0,0,0,0,0,0,0,0,0,0,12,1,11,1,0,1,2,0,2,0,0,0
139199,37000,370,0,-2,13,2,11,0,0,0,0,0,0,3,1,2,3,0,3,0,0,0,7,1,6,0,0,0,0,0,0,0,0,0
139250,37000,370,0,-2,8,2,6,0,0,0,0,0,0,2,0,2,0,0,0,0,0,0,6,2,4,0,0,0,0,0,0,0,0,0
139278,37000,370,0,-2,9,2,7,0,0,0,0,0,0,2,0,2,0,0,0,0,0,0,6,2,4,1,0,1,0,0,0,0,0,0
139311,37000,370,0,-2,10,1,9,0,0,0,1,0,1,6,0,6,0,0,0,0,0,0,2,1,1,0,0,0,1,0,1,0,0,0
139357,37000,370,0,-2,1,0,1,0,0,0,0,0,0,0,0,0,0,0,0,0,0,0,1,0,1,0,0,0,0,0,0,0,0,0
139366,37000,370,0,-2,10,0,10,0,0,0,0,0,0,4,0,4,1,0,1,0,0,0,5,0,5,0,0,0,0,0,0,0,0,0
139384,37000,370,0,-2,10,1,9,0,0,0,0,0,0,2,0,2,1,0,1,0,0,0,7,1,6,0,0,0,0,0,0,0,0,0
139393,37000,370,0,-2,7,1,6,0,0,0,0,0,0,0,0,0,0,0,0,0,0,0,7,1,6,0,0,0,0,0,0,0,0,0
139463,37000,370,0,-2,1,0,1,0,0,0,0,0,0,0,0,0,0,0,0,0,0,0,1,0,1,0,0,0,0,0,0,0,0,0
139579,37000,370,0,-2,1,0,1,0,0,0,0,0,0,1,0,1,0,0,0,0,0,0,0,0,0,0,0,0,0,0,0,0,0,0
139621,37000,370,0,-2,1,0,1,0,0,0,0,0,0,1,0,1,0,0,0,0,0,0,0,0,0,0,0,0,0,0,0,0,0,0
139630,37000,370,0,-2,4,2,2,0,0,0,0,0,0,0,0,0,0,0,0,0,0,0,4,2,2,0,0,0,0,0,0,0,0,0
139658,37000,370,0,-2,118,23,95,0,0,0,11,3,8,64,4,60,5,3,2,0,0,0,33,11,22,2,0,2,1,0,1,2,2,0
139700,37000,370,0,-2,3,0,3,0,0,0,0,0,0,0,0,0,0,0,0,0,0,0,3,0,3,0,0,0,0,0,0,0,0,0
139719,37000,370,0,-2,7,1,6,0,0,0,0,0,0,7,1,6,0,0,0,0,0,0,0,0,0,0,0,0,0,0,0,0,0,0
139755,37000,370,0,-2,93,15,78,0,0,0,4,1,3,62,7,55,6,1,5,0,0,0,13,5,8,5,1,4,1,0,1,2,0,2
139764,37000,370,0,-2,3,0,3,0,0,0,0,0,0,2,0,2,0,0,0,0,0,0,1,0,1,0,0,0,0,0,0,0,0,0
139861,37000,370,0,-2,4,0,4,0,0,0,0,0,0,1,0,1,0,0,0,0,0,0,2,0,2,1,0,1,0,0,0,0,0,0
139931,37000,370,0,-2,42,10,32,0,0,0,0,0,0,13,2,11,2,0,2,0,0,0,27,8,19,0,0,0,0,0,0,0,0,0
139940,37000,370,0,-2,47,9,38,0,0,0,2,0,2,30,4,26,2,1,1,0,0,0,11,4,7,0,0,0,1,0,1,1,0,1
139959,37000,370,0,-2,92,9,83,0,0,0,1,0,1,10,2,8,3,0,3,0,0,0,71,7,64,3,0,3,4,0,4,0,0,0
139968,37000,370,0,-2,1,0,1,0,0,0,0,0,0,1,0,1,0,0,0,0,0,0,0,0,0,0,0,0,0,0,0,0,0,0
139986,37000,370,0,-2,3,0,3,0,0,0,0,0,0,2,0,2,0,0,0,0,0,0,1,0,1,0,0,0,0,0,0,0,0,0
140012,37000,370,0,-2,9,2,7,0,0,0,1,0,1,2,0,2,0,0,0,0,0,0,6,2,4,0,0,0,0,0,0,0,0,0
140234,37000,370,0,-2,3,1,2,0,0,0,0,0,0,2,1,1,0,0,0,0,0,0,1,0,1,0,0,0,0,0,0,0,0,0
140243,37000,370,0,-2,8,0,8,0,0,0,0,0,0,3,0,3,0,0,0,0,0,0,5,0,5,0,0,0,0,0,0,0,0,0
140252,37000,370,0,-2,28,10,18,0,0,0,0,0,0,12,3,9,2,0,2,0,0,0,13,6,7,1,1,0,0,0,0,0,0,0
140331,37000,370,0,-2,9,2,7,0,0,0,0,0,0,3,0,3,0,0,0,0,0,0,6,2,4,0,0,0,0,0,0,0,0,0
140447,37000,370,0,-2,23,2,21,1,0,1,0,0,0,10,0,10,2,0,2,0,0,0,9,2,7,1,0,1,0,0,0,0,0,0
140553,37000,370,0,-2,13,2,11,0,0,0,0,0,0,10,0,10,0,0,0,0,0,0,2,1,1,0,0,0,1,1,0,0,0,0
140562,37000,370,0,-2,51,6,45,0,0,0,0,0,0,50,6,44,1,0,1,0,0,0,0,0,0,0,0,0,0,0,0,0,0,0
140678,37000,370,0,-2,1,0,1,0,0,0,0,0,0,0,0,0,0,0,0,0,0,0,1,0,1,0,0,0,0,0,0,0,0,0
140696,37000,370,0,-2,1,0,1,0,0,0,0,0,0,0,0,0,1,0,1,0,0,0,0,0,0,0,0,0,0,0,0,0,0,0
140720,37000,370,0,-2,1,0,1,0,0,0,0,0,0,1,0,1,0,0,0,0,0,0,0,0,0,0,0,0,0,0,0,0,0,0
140818,37000,370,0,-2,11,1,10,0,0,0,0,0,0,0,0,0,0,0,0,0,0,0,11,1,10,0,0,0,0,0,0,0,0,0
140872,37000,370,0,-2,10,0,10,0,0,0,0,0,0,0,0,0,2,0,2,0,0,0,8,0,8,0,0,0,0,0,0,0,0,0
140942,37000,370,0,-2,3,0,3,0,0,0,0,0,0,2,0,2,0,0,0,0,0,0,1,0,1,0,0,0,0,0,0,0,0,0
140951,37000,370,0,-2,21,6,15,0,0,0,0,0,0,6,1,5,3,2,1,0,0,0,11,3,8,0,0,0,1,0,1,0,0,0
140960,37000,370,0,-2,4,1,3,0,0,0,0,0,0,2,0,2,0,0,0,0,0,0,2,1,1,0,0,0,0,0,0,0,0,0
140988,37000,370,0,-2,6,0,6,0,0,0,0,0,0,0,0,0,0,0,0,0,0,0,6,0,6,0,0,0,0,0,0,0,0,0
141006,37000,370,0,-2,2,0,2,0,0,0,0,0,0,2,0,2,0,0,0,0,0,0,0,0,0,0,0,0,0,0,0,0,0,0
141167,37000,370,0,-2,10,2,8,0,0,0,0,0,0,3,2,1,1,0,1,0,0,0,6,0,6,0,0,0,0,0,0,0,0,0
141185,37000,370,0,-2,1,1,0,0,0,0,0,0,0,1,1,0,0,0,0,0,0,0,0,0,0,0,0,0,0,0,0,0,0,0
141237,37000,370,0,-2,4,1,3,0,0,0,0,0,0,0,0,0,0,0,0,0,0,0,4,1,3,0,0,0,0,0,0,0,0,0
141255,37000,370,0,-2,11,0,11,0,0,0,0,0,0,6,0,6,0,0,0,0,0,0,5,0,5,0,0,0,0,0,0,0,0,0
141264,37000,370,0,-2,16,2,14,0,0,0,0,0,0,5,1,4,1,1,0,0,0,0,8,0,8,2,0,2,0,0,0,0,0,0
141325,37000,370,0,-2,3,0,3,0,0,0,0,0,0,3,0,3,0,0,0,0,0,0,0,0,0,0,0,0,0,0,0,0,0,0
141334,37000,370,0,-2,18,2,16,0,0,0,1,0,1,3,0,3,0,0,0,0,0,0,14,2,12,0,0,0,0,0,0,0,0,0
141486,37000,370,0,-2,4,1,3,0,0,0,0,0,0,0,0,0,1,0,1,0,0,0,1,1,0,2,0,2,0,0,0,0,0,0
141565,37000,370,0,-2,2,0,2,0,0,0,0,0,0,0,0,0,1,0,1,0,0,0,0,0,0,1,0,1,0,0,0,0,0,0
141574,37000,370,0,-2,2,0,2,0,0,0,1,0,1,0,0,0,0,0,0,1,0,1,0,0,0,0,0,0,0,0,0,0,0,0
141644,37000,370,0,-2,9,3,6,1,0,1,4,2,2,0,0,0,0,0,0,1,0,1,2,0,2,1,1,0,0,0,0,0,0,0
141796,37000,370,0,-2,1,0,1,0,0,0,1,0,1,0,0,0,0,0,0,0,0,0,0,0,0,0,0,0,0,0,0,0,0,0
141963,37000,370,0,-2,1,0,1,0,0,0,1,0,1,0,0,0,0,0,0,0,0,0,0,0,0,0,0,0,0,0,0,0,0,0
141990,37000,370,0,-2,1,0,1,0,0,0,0,0,0,0,0,0,1,0,1,0,0,0,0,0,0,0,0,0,0,0,0,0,0,0
142054,37000,370,0,-2,1,0,1,0,0,0,0,0,0,0,0,0,1,0,1,0,0,0,0,0,0,0,0,0,0,0,0,0,0,0
142115,37000,370,0,-2,33,4,29,0,0,0,1,0,1,0,0,0,9,3,6,1,0,1,17,1,16,3,0,3,2,0,2,0,0,0
142179,37000,370,0,-2,12,4,8,0,0,0,0,0,0,0,0,0,1,1,0,0,0,0,11,3,8,0,0,0,0,0,0,0,0,0
142276,37000,370,0,-2,11,1,10,0,0,0,0,0,0,0,0,0,0,0,0,0,0,0,9,1,8,0,0,0,2,0,2,0,0,0
142285,37000,370,0,-2,35,4,31,1,0,1,0,0,0,0,0,0,1,1,0,0,0,0,28,2,26,2,1,1,2,0,2,1,0,1
142294,37000,370,0,-2,6,1,5,0,0,0,0,0,0,0,0,0,0,0,0,0,0,0,5,1,4,1,0,1,0,0,0,0,0,0
142328,37000,370,0,-2,8,0,8,0,0,0,0,0,0,0,0,0,0,0,0,0,0,0,8,0,8,0,0,0,0,0,0,0,0,0
142443,37000,370,0,-2,6,1,5,0,0,0,0,0,0,0,0,0,0,0,0,0,0,0,5,0,5,0,0,0,1,1,0,0,0,0
142461,37000,370,0,-2,9,1,8,0,0,0,0,0,0,0,0,0,0,0,0,0,0,0,8,1,7,0,0,0,1,0,1,0,0,0
142522,37000,370,0,-2,15,2,13,0,0,0,0,0,0,0,0,0,0,0,0,0,0,0,14,1,13,0,0,0,1,1,0,0,0,0
142559,37000,370,0,-2,8,0,8,0,0,0,0,0,0,0,0,0,1,0,1,0,0,0,6,0,6,0,0,0,1,0,1,0,0,0
142832,37000,370,0,-2,3,0,3,0,0,0,0,0,0,1,0,1,1,0,1,0,0,0,0,0,0,0,0,0,1,0,1,0,0,0
143048,37000,370,0,-2,2,0,2,0,0,0,0,0,0,0,0,0,0,0,0,0,0,0,2,0,2,0,0,0,0,0,0,0,0,0
143084,37000,370,0,-2,7,0,7,0,0,0,0,0,0,0,0,0,1,0,1,0,0,0,6,0,6,0,0,0,0,0,0,0,0,0
143118,37000,370,0,-2,8,3,5,0,0,0,0,0,0,0,0,0,2,0,2,0,0,0,6,3,3,0,0,0,0,0,0,0,0,0
143215,37000,370,0,-2,3,0,3,0,0,0,0,0,0,2,0,2,0,0,0,0,0,0,1,0,1,0,0,0,0,0,0,0,0,0
143233,37000,370,0,-2,1,0,1,0,0,0,0,0,0,0,0,0,0,0,0,0,0,0,1,0,1,0,0,0,0,0,0,0,0,0
143279,37000,370,0,-2,2,0,2,0,0,0,0,0,0,0,0,0,0,0,0,0,0,0,0,0,0,0,0,0,2,0,2,0,0,0
143288,37000,370,0,-2,3,0,3,0,0,0,0,0,0,1,0,1,0,0,0,0,0,0,2,0,2,0,0,0,0,0,0,0,0,0
143297,37000,370,0,-2,1,0,1,0,0,0,0,0,0,0,0,0,0,0,0,0,0,0,1,0,1,0,0,0,0,0,0,0,0,0
143358,37000,370,0,-2,19,8,11,0,0,0,0,0,0,2,1,1,0,0,0,0,0,0,16,6,10,1,1,0,0,0,0,0,0,0
143613,37000,370,0,-2,3,0,3,0,0,0,1,0,1,0,0,0,0,0,0,0,0,0,2,0,2,0,0,0,0,0,0,0,0,0
143659,37000,370,0,-2,1,0,1,0,0,0,0,0,0,0,0,0,0,0,0,0,0,0,1,0,1,0,0,0,0,0,0,0,0,0
144005,37000,370,0,-2,5,3,2,0,0,0,0,0,0,1,1,0,2,0,2,0,0,0,1,1,0,0,0,0,1,1,0,0,0,0
144050,37000,370,0,-2,82,26,56,0,0,0,6,1,5,38,16,22,10,5,5,0,0,0,24,2,22,1,0,1,1,1,0,2,1,1
144281,37000,370,0,-2,8,2,6,0,0,0,1,0,1,3,1,2,0,0,0,0,0,0,3,0,3,0,0,0,1,1,0,0,0,0
144351,37000,370,0,-2,31,8,23,0,0,0,0,0,0,4,1,3,8,1,7,0,0,0,18,6,12,1,0,1,0,0,0,0,0,0
144740,37000,370,0,-2,25,6,19,0,0,0,1,0,1,5,2,3,7,3,4,0,0,0,10,1,9,1,0,1,1,0,1,0,0,0
144777,37000,370,0,-2,3,0,3,0,0,0,0,0,0,0,0,0,0,0,0,0,0,0,3,0,3,0,0,0,0,0,0,0,0,0
144865,37000,370,0,-2,5,3,2,0,0,0,1,1,0,0,0,0,1,0,1,0,0,0,3,2,1,0,0,0,0,0,0,0,0,0
144892,37000,370,0,-2,4,1,3,0,0,0,0,0,0,0,0,0,1,1,0,0,0,0,3,0,3,0,0,0,0,0,0,0,0,0
144944,37000,370,0,-2,10,2,8,0,0,0,3,0,3,1,0,1,1,0,1,0,0,0,4,2,2,1,0,1,0,0,0,0,0,0
144962,37000,370,0,-2,6,1,5,0,0,0,0,0,0,0,0,0,0,0,0,0,0,0,5,1,4,0,0,0,1,0,1,0,0,0
144971,37000,370,0,-2,2,0,2,0,0,0,0,0,0,0,0,0,0,0,0,0,0,0,1,0,1,0,0,0,1,0,1,0,0,0
145336,37000,370,0,-2,9,4,5,0,0,0,0,0,0,4,0,4,0,0,0,0,0,0,3,3,0,0,0,0,2,1,1,0,0,0
145372,37000,370,0,-2,13,3,10,0,0,0,0,0,0,0,0,0,0,0,0,0,0,0,13,3,10,0,0,0,0,0,0,0,0,0
145497,37000,370,0,-2,2,1,1,0,0,0,0,0,0,0,0,0,0,0,0,0,0,0,1,0,1,0,0,0,1,1,0,0,0,0
145521,37000,370,0,-2,1,0,1,0,0,0,0,0,0,0,0,0,0,0,0,0,0,0,1,0,1,0,0,0,0,0,0,0,0,0
145558,37000,370,0,-2,15,4,11,0,0,0,0,0,0,5,2,3,4,2,2,0,0,0,6,0,6,0,0,0,0,0,0,0,0,0
145600,37000,370,0,-2,134,29,105,0,0,0,9,3,6,44,6,38,39,10,29,0,0,0,36,9,27,4,1,3,1,0,1,1,0,1
145619,37000,370,0,-2,3,0,3,0,0,0,0,0,0,0,0,0,0,0,0,0,0,0,3,0,3,0,0,0,0,0,0,0,0,0
145628,37000,370,0,-2,12,3,9,0,0,0,1,1,0,1,0,1,8,1,7,0,0,0,2,1,1,0,0,0,0,0,0,0,0,0
145637,37000,370,0,-2,103,21,82,0,0,0,6,1,5,7,2,5,7,2,5,0,0,0,80,16,64,2,0,2,0,0,0,1,0,1
145646,37000,370,0,-2,10,0,10,0,0,0,0,0,0,1,0,1,1,0,1,0,0,0,8,0,8,0,0,0,0,0,0,0,0,0
145682,37000,370,0,-2,6,0,6,0,0,0,1,0,1,1,0,1,0,0,0,0,0,0,4,0,4,0,0,0,0,0,0,0,0,0
145691,37000,370,0,-2,8,1,7,0,0,0,0,0,0,0,0,0,0,0,0,0,0,0,7,0,7,1,1,0,0,0,0,0,0,0
145707,37000,370,0,-2,1,0,1,0,0,0,0,0,0,0,0,0,0,0,0,0,0,0,1,0,1,0,0,0,0,0,0,0,0,0
145725,37000,370,0,-2,15,9,6,0,0,0,1,1,0,5,3,2,0,0,0,0,0,0,1,0,1,1,0,1,7,5,2,0,0,0
145813,37000,370,0,-2,15,2,13,0,0,0,0,0,0,0,0,0,0,0,0,0,0,0,10,1,9,0,0,0,5,1,4,0,0,0
145831,37000,370,0,-2,2,1,1,0,0,0,0,0,0,0,0,0,0,0,0,0,0,0,2,1,1,0,0,0,0,0,0,0,0,0
146205,37000,370,0,-2,4,2,2,0,0,0,0,0,0,0,0,0,0,0,0,0,0,0,4,2,2,0,0,0,0,0,0,0,0,0
146278,37000,370,0,-2,1,0,1,0,0,0,0,0,0,0,0,0,0,0,0,0,0,0,1,0,1,0,0,0,0,0,0,0,0,0
146296,37000,370,0,-2,5,2,3,0,0,0,0,0,0,2,1,1,1,0,1,0,0,0,2,1,1,0,0,0,0,0,0,0,0,0
146339,37000,370,0,-2,2,0,2,0,0,0,0,0,0,1,0,1,0,0,0,0,0,0,0,0,0,1,0,1,0,0,0,0,0,0
146348,37000,370,0,-2,4,1,3,0,0,0,0,0,0,0,0,0,2,0,2,0,0,0,2,1,1,0,0,0,0,0,0,0,0,0
146366,37000,370,0,-2,1,0,1,0,0,0,0,0,0,0,0,0,0,0,0,0,0,0,1,0,1,0,0,0,0,0,0,0,0,0
146418,37000,370,0,-2,1,0,1,0,0,0,0,0,0,0,0,0,0,0,0,0,0,0,1,0,1,0,0,0,0,0,0,0,0,0
146427,37000,370,0,-2,2,1,1,0,0,0,0,0,0,0,0,0,0,0,0,0,0,0,2,1,1,0,0,0,0,0,0,0,0,0
146472,37000,370,0,-2,13,0,13,0,0,0,0,0,0,0,0,0,8,0,8,0,0,0,5,0,5,0,0,0,0,0,0,0,0,0
146481,37000,370,0,-2,2,1,1,0,0,0,1,1,0,0,0,0,1,0,1,0,0,0,0,0,0,0,0,0,0,0,0,0,0,0
146506,37000,370,0,-2,5,2,3,0,0,0,0,0,0,0,0,0,0,0,0,0,0,0,4,2,2,0,0,0,1,0,1,0,0,0
146603,37000,370,0,-2,1,0,1,0,0,0,0,0,0,0,0,0,0,0,0,0,0,0,1,0,1,0,0,0,0,0,0,0,0,0
146612,37000,370,0,-2,2,0,2,0,0,0,0,0,0,0,0,0,0,0,0,0,0,0,2,0,2,0,0,0,0,0,0,0,0,0
146667,37000,370,0,-2,2,0,2,0,0,0,0,0,0,0,0,0,0,0,0,0,0,0,2,0,2,0,0,0,0,0,0,0,0,0
146676,37000,370,0,-2,2,0,2,0,0,0,0,0,0,0,0,0,0,0,0,0,0,0,2,0,2,0,0,0,0,0,0,0,0,0
146685,37000,370,0,-2,8,1,7,0,0,0,0,0,0,0,0,0,0,0,0,0,0,0,8,1,7,0,0,0,0,0,0,0,0,0
146700,37000,370,0,-2,3,0,3,0,0,0,0,0,0,1,0,1,2,0,2,0,0,0,0,0,0,0,0,0,0,0,0,0,0,0
146719,37000,370,0,-2,34,8,26,0,0,0,6,2,4,3,2,1,8,2,6,0,0,0,14,2,12,1,0,1,1,0,1,1,0,1
146755,37000,370,0,-2,1,0,1,0,0,0,0,0,0,0,0,0,0,0,0,0,0,0,1,0,1,0,0,0,0,0,0,0,0,0
146977,37000,370,0,-2,1,0,1,0,0,0,0,0,0,1,0,1,0,0,0,0,0,0,0,0,0,0,0,0,0,0,0,0,0,0
147004,37000,370,0,-2,8,1,7,0,0,0,0,0,0,0,0,0,2,1,1,0,0,0,5,0,5,0,0,0,1,0,1,0,0,0
147013,37000,370,0,-2,1,0,1,0,0,0,0,0,0,0,0,0,0,0,0,0,0,0,1,0,1,0,0,0,0,0,0,0,0,0
147244,37000,370,0,-2,9,1,8,0,0,0,0,0,0,0,0,0,0,0,0,0,0,0,9,1,8,0,0,0,0,0,0,0,0,0
147341,37000,370,0,-2,1,0,1,0,0,0,0,0,0,0,0,0,0,0,0,0,0,0,1,0,1,0,0,0,0,0,0,0,0,0
147369,37000,370,0,-2,12,3,9,0,0,0,1,0,1,4,1,3,5,2,3,0,0,0,2,0,2,0,0,0,0,0,0,0,0,0
147378,37000,370,0,-2,2,0,2,0,0,0,0,0,0,0,0,0,2,0,2,0,0,0,0,0,0,0,0,0,0,0,0,0,0,0
147536,37000,370,0,-2,5,1,4,0,0,0,0,0,0,1,1,0,2,0,2,0,0,0,2,0,2,0,0,0,0,0,0,0,0,0
147590,37000,370,0,-2,2,0,2,0,0,0,0,0,0,0,0,0,1,0,1,0,0,0,0,0,0,1,0,1,0,0,0,0,0,0
147660,37000,370,0,-2,7,2,5,0,0,0,0,0,0,1,0,1,0,0,0,0,0,0,6,2,4,0,0,0,0,0,0,0,0,0
147679,37000,370,0,-2,5,1,4,0,0,0,0,0,0,0,0,0,1,0,1,0,0,0,4,1,3,0,0,0,0,0,0,0,0,0
147697,37000,370,0,-2,2,0,2,0,0,0,0,0,0,1,0,1,0,0,0,0,0,0,1,0,1,0,0,0,0,0,0,0,0,0
147703,37000,370,0,-2,19,6,13,0,0,0,0,0,0,1,1,0,2,0,2,0,0,0,14,5,9,1,0,1,0,0,0,1,0,1
147767,37000,370,0,-2,333,88,245,0,0,0,39,10,29,43,12,31,49,11,38,0,0,0,178,49,129,8,0,8,6,1,5,10,5,5
147776,37000,370,0,-2,1,1,0,0,0,0,0,0,0,0,0,0,0,0,0,0,0,0,1,1,0,0,0,0,0,0,0,0,0,0
147800,37000,370,0,-2,5,0,5,0,0,0,1,0,1,0,0,0,0,0,0,0,0,0,2,0,2,0,0,0,2,0,2,0,0,0
147828,37000,370,0,-2,3,0,3,0,0,0,0,0,0,0,0,0,0,0,0,0,0,0,3,0,3,0,0,0,0,0,0,0,0,0
148131,37000,370,0,-2,5,0,5,0,0,0,0,0,0,0,0,0,0,0,0,0,0,0,5,0,5,0,0,0,0,0,0,0,0,0
148292,37000,370,0,-2,1,0,1,0,0,0,0,0,0,0,0,0,0,0,0,0,0,0,0,0,0,1,0,1,0,0,0,0,0,0
148405,37000,370,0,-2,6,0,6,0,0,0,0,0,0,0,0,0,0,0,0,0,0,0,6,0,6,0,0,0,0,0,0,0,0,0
148487,37000,370,0,-2,3,0,3,0,0,0,0,0,0,0,0,0,0,0,0,0,0,0,3,0,3,0,0,0,0,0,0,0,0,0
148496,37000,370,0,-2,21,2,19,0,0,0,1,0,1,3,1,2,8,0,8,0,0,0,8,1,7,1,0,1,0,0,0,0,0,0
148511,37000,370,0,-2,4,0,4,0,0,0,0,0,0,2,0,2,1,0,1,0,0,0,1,0,1,0,0,0,0,0,0,0,0,0
148575,37000,370,0,-2,1,0,1,0,0,0,0,0,0,0,0,0,0,0,0,0,0,0,1,0,1,0,0,0,0,0,0,0,0,0
148584,37000,370,0,-2,2,0,2,0,0,0,0,0,0,1,0,1,0,0,0,0,0,0,1,0,1,0,0,0,0,0,0,0,0,0
148627,37000,370,0,-2,2,0,2,0,0,0,0,0,0,0,0,0,1,0,1,0,0,0,0,0,0,0,0,0,1,0,1,0,0,0
148654,37000,370,0,-2,10,4,6,0,0,0,0,0,0,1,1,0,0,0,0,0,0,0,8,3,5,1,0,1,0,0,0,0,0,0
148672,37000,370,0,-2,1,0,1,0,0,0,0,0,0,0,0,0,0,0,0,0,0,0,1,0,1,0,0,0,0,0,0,0,0,0
148821,37000,370,0,-2,3,0,3,0,0,0,0,0,0,0,0,0,0,0,0,0,0,0,3,0,3,0,0,0,0,0,0,0,0,0
148876,37000,370,0,-2,1,1,0,0,0,0,0,0,0,0,0,0,0,0,0,0,0,0,1,1,0,0,0,0,0,0,0,0,0,0
148885,37000,370,0,-2,5,1,4,0,0,0,0,0,0,1,1,0,3,0,3,0,0,0,1,0,1,0,0,0,0,0,0,0,0,0
148937,37000,370,0,-2,1,0,1,0,0,0,0,0,0,0,0,0,0,0,0,0,0,0,1,0,1,0,0,0,0,0,0,0,0,0
148991,37000,370,0,-2,1,0,1,0,0,0,0,0,0,0,0,0,0,0,0,0,0,0,1,0,1,0,0,0,0,0,0,0,0,0
149222,37000,370,0,-2,126,15,111,1,0,1,2,0,2,12,2,10,4,1,3,0,0,0,102,12,90,5,0,5,0,0,0,0,0,0
149231,37000,370,0,-2,28,8,20,0,0,0,1,0,1,3,1,2,0,0,0,0,0,0,24,7,17,0,0,0,0,0,0,0,0,0
149365,37000,370,0,-2,26,1,25,0,0,0,0,0,0,11,1,10,2,0,2,1,0,1,12,0,12,0,0,0,0,0,0,0,0,0
149505,37000,370,0,-2,3,0,3,0,0,0,0,0,0,0,0,0,1,0,1,0,0,0,2,0,2,0,0,0,0,0,0,0,0,0
149514,37000,370,0,-2,7,2,5,0,0,0,0,0,0,0,0,0,1,0,1,0,0,0,6,2,4,0,0,0,0,0,0,0,0,0
149587,37000,370,0,-2,14,3,11,0,0,0,0,0,0,2,0,2,2,0,2,0,0,0,10,3,7,0,0,0,0,0,0,0,0,0
149727,37000,370,0,-2,6,1,5,0,0,0,0,0,0,0,0,0,2,0,2,0,0,0,3,1,2,0,0,0,1,0,1,0,0,0
149772,37000,370,0,-2,16,2,14,1,0,1,0,0,0,1,0,1,0,0,0,0,0,0,14,2,12,0,0,0,0,0,0,0,0,0
149781,37000,370,0,-2,8,0,8,0,0,0,1,0,1,1,0,1,0,0,0,0,0,0,6,0,6,0,0,0,0,0,0,0,0,0
149842,37000,370,0,-2,6,1,5,0,0,0,0,0,0,1,0,1,1,0,1,0,0,0,4,1,3,0,0,0,0,0,0,0,0,0
150066,37000,370,0,-2,4,0,4,0,0,0,0,0,0,0,0,0,0,0,0,0,0,0,4,0,4,0,0,0,0,0,0,0,0,0
150136,37000,370,0,-2,5,0,5,0,0,0,0,0,0,0,0,0,0,0,0,0,0,0,5,0,5,0,0,0,0,0,0,0,0,0
150145,37000,370,0,-2,4,0,4,0,0,0,0,0,0,0,0,0,0,0,0,0,0,0,4,0,4,0,0,0,0,0,0,0,0,0
150163,37000,370,0,-2,11,1,10,0,0,0,0,0,0,4,1,3,0,0,0,0,0,0,7,0,7,0,0,0,0,0,0,0,0,0
150172,37000,370,0,-2,1,0,1,0,0,0,0,0,0,0,0,0,1,0,1,0,0,0,0,0,0,0,0,0,0,0,0,0,0,0
150288,37000,370,0,-2,1,1,0,0,0,0,0,0,0,0,0,0,0,0,0,0,0,0,1,1,0,0,0,0,0,0,0,0,0,0
150400,37000,370,0,-2,5,1,4,0,0,0,0,0,0,1,0,1,0,0,0,0,0,0,4,1,3,0,0,0,0,0,0,0,0,0
150455,37000,370,0,-2,8,1,7,0,0,0,0,0,0,0,0,0,1,0,1,0,0,0,6,0,6,1,1,0,0,0,0,0,0,0
150534,37000,370,0,-2,5,0,5,0,0,0,0,0,0,0,0,0,0,0,0,0,0,0,3,0,3,0,0,0,2,0,2,0,0,0
150604,37000,370,0,-2,4,1,3,0,0,0,0,0,0,0,0,0,0,0,0,0,0,0,3,0,3,0,0,0,1,1,0,0,0,0
150756,37000,370,0,-2,1,0,1,0,0,0,0,0,0,0,0,0,0,0,0,0,0,0,1,0,1,0,0,0,0,0,0,0,0,0
150941,37000,370,0,-2,5,1,4,0,0,0,1,0,1,0,0,0,0,0,0,0,0,0,4,1,3,0,0,0,0,0,0,0,0,0
150987,37000,370,0,-2,62,10,52,0,0,0,2,0,2,5,0,5,3,0,3,0,0,0,50,9,41,1,1,0,1,0,1,0,0,0
151102,37000,370,0,-2,14,3,11,0,0,0,0,0,0,0,0,0,0,0,0,0,0,0,14,3,11,0,0,0,0,0,0,0,0,0
151111,37000,370,0,-2,145,41,104,0,0,0,2,0,2,16,5,11,12,5,7,0,0,0,108,30,78,4,1,3,0,0,0,3,0,3
151263,37000,370,0,-2,12,0,12,0,0,0,0,0,0,0,0,0,0,0,0,0,0,0,12,0,12,0,0,0,0,0,0,0,0,0
151290,37000,370,0,-2,7,0,7,0,0,0,0,0,0,0,0,0,0,0,0,0,0,0,7,0,7,0,0,0,0,0,0,0,0,0
151306,37000,370,0,-2,22,1,21,0,0,0,2,0,2,0,0,0,0,0,0,0,0,0,17,1,16,2,0,2,1,0,1,0,0,0
151324,37000,370,0,-2,23,4,19,0,0,0,0,0,0,1,0,1,1,0,1,0,0,0,20,3,17,1,1,0,0,0,0,0,0,0
151333,37000,370,0,-2,4,1,3,0,0,0,0,0,0,0,0,0,0,0,0,0,0,0,3,0,3,1,1,0,0,0,0,0,0,0
151342,37000,370,0,-2,11,3,8,0,0,0,0,0,0,1,0,1,0,0,0,0,0,0,8,2,6,2,1,1,0,0,0,0,0,0
151351,37000,370,0,-2,94,22,72,0,0,0,4,0,4,5,2,3,6,1,5,0,0,0,76,18,58,2,1,1,0,0,0,1,0,1
151360,37000,370,0,-2,6,2,4,0,0,0,0,0,0,0,0,0,2,0,2,0,0,0,4,2,2,0,0,0,0,0,0,0,0,0
151379,37000,370,0,-2,3,1,2,0,0,0,0,0,0,1,0,1,0,0,0,0,0,0,2,1,1,0,0,0,0,0,0,0,0,0
151388,37000,370,0,-2,2,1,1,0,0,0,0,0,0,0,0,0,0,0,0,0,0,0,2,1,1,0,0,0,0,0,0,0,0,0
151661,37000,370,0,-2,8,0,8,0,0,0,1,0,1,0,0,0,2,0,2,0,0,0,4,0,4,1,0,1,0,0,0,0,0,0
151777,37000,370,0,-2,8,0,8,0,0,0,0,0,0,0,0,0,0,0,0,0,0,0,7,0,7,1,0,1,0,0,0,0,0,0
151786,37000,370,0,-2,8,0,8,0,0,0,0,0,0,1,0,1,0,0,0,0,0,0,6,0,6,0,0,0,1,0,1,0,0,0
151801,37000,370,0,-2,17,3,14,0,0,0,0,0,0,0,0,0,1,1,0,0,0,0,15,2,13,1,0,1,0,0,0,0,0,0
152080,37000,370,0,-2,39,4,35,1,0,1,4,0,4,1,1,0,4,0,4,0,0,0,22,1,21,1,0,1,5,2,3,1,0,1
152099,37000,370,0,-2,7,3,4,0,0,0,0,0,0,0,0,0,0,0,0,0,0,0,7,3,4,0,0,0,0,0,0,0,0,0
152318,37000,370,0,-2,5,1,4,0,0,0,0,0,0,1,0,1,0,0,0,0,0,0,4,1,3,0,0,0,0,0,0,0,0,0
152336,37000,370,0,-2,4,0,4,0,0,0,0,0,0,0,0,0,0,0,0,0,0,0,4,0,4,0,0,0,0,0,0,0,0,0
152390,37000,370,0,-2,11,1,10,0,0,0,0,0,0,0,0,0,0,0,0,0,0,0,9,0,9,0,0,0,0,0,0,2,1,1
152530,37000,370,0,-2,12,2,10,0,0,0,0,0,0,0,0,0,0,0,0,0,0,0,12,2,10,0,0,0,0,0,0,0,0,0
152600,37000,370,0,-2,5,1,4,0,0,0,0,0,0,0,0,0,0,0,0,0,0,0,0,0,0,0,0,0,5,1,4,0,0,0
152637,37000,370,0,-2,68,14,54,1,0,1,0,0,0,5,2,3,1,1,0,0,0,0,60,11,49,1,0,1,0,0,0,0,0,0
152673,37000,370,0,-2,1,0,1,0,0,0,0,0,0,0,0,0,0,0,0,0,0,0,1,0,1,0,0,0,0,0,0,0,0,0
152798,37000,370,0,-2,1,0,1,0,0,0,0,0,0,0,0,0,0,0,0,0,0,0,1,0,1,0,0,0,0,0,0,0,0,0
152992,37000,370,0,-2,4,0,4,0,0,0,0,0,0,0,0,0,0,0,0,0,0,0,1,0,1,0,0,0,3,0,3,0,0,0
153001,37000,370,0,-2,6,0,6,0,0,0,0,0,0,0,0,0,1,0,1,0,0,0,5,0,5,0,0,0,0,0,0,0,0,0
153108,37000,370,0,-2,2,0,2,0,0,0,0,0,0,0,0,0,0,0,0,0,0,0,2,0,2,0,0,0,0,0,0,0,0,0
153126,37000,370,0,-2,6,0,6,0,0,0,2,0,2,0,0,0,1,0,1,0,0,0,3,0,3,0,0,0,0,0,0,0,0,0
153144,37000,370,0,-2,10,1,9,0,0,0,0,0,0,2,0,2,0,0,0,0,0,0,7,1,6,0,0,0,1,0,1,0,0,0
153162,37000,370,0,-2,3,0,3,0,0,0,0,0,0,0,0,0,0,0,0,0,0,0,3,0,3,0,0,0,0,0,0,0,0,0
153214,37000,370,0,-2,8,1,7,0,0,0,1,0,1,0,0,0,0,0,0,0,0,0,7,1,6,0,0,0,0,0,0,0,0,0
153241,37000,370,0,-2,1,0,1,0,0,0,0,0,0,0,0,0,0,0,0,0,0,0,1,0,1,0,0,0,0,0,0,0,0,0
153250,37000,370,0,-2,3,0,3,0,0,0,0,0,0,0,0,0,0,0,0,0,0,0,3,0,3,0,0,0,0,0,0,0,0,0
153269,37000,370,0,-2,36,9,27,0,0,0,1,0,1,2,0,2,2,2,0,0,0,0,31,7,24,0,0,0,0,0,0,0,0,0
153311,37000,370,0,-2,10,1,9,0,0,0,0,0,0,1,0,1,0,0,0,0,0,0,8,1,7,1,0,1,0,0,0,0,0,0
153320,37000,370,0,-2,3,0,3,0,0,0,0,0,0,0,0,0,0,0,0,0,0,0,3,0,3,0,0,0,0,0,0,0,0,0
153366,37000,370,0,-2,8,0,8,0,0,0,0,0,0,0,0,0,0,0,0,0,0,0,8,0,8,0,0,0,0,0,0,0,0,0
153375,37000,370,0,-2,3,0,3,0,0,0,0,0,0,0,0,0,0,0,0,0,0,0,3,0,3,0,0,0,0,0,0,0,0,0
153384,37000,370,0,-2,5,1,4,0,0,0,1,0,1,0,0,0,0,0,0,0,0,0,4,1,3,0,0,0,0,0,0,0,0,0
153445,37000,370,0,-2,3,2,1,0,0,0,0,0,0,1,1,0,1,1,0,0,0,0,1,0,1,0,0,0,0,0,0,0,0,0
153472,37000,370,0,-2,3,0,3,0,0,0,0,0,0,0,0,0,0,0,0,0,0,0,3,0,3,0,0,0,0,0,0,0,0,0
153524,37000,370,0,-2,9,3,6,0,0,0,0,0,0,0,0,0,0,0,0,0,0,0,9,3,6,0,0,0,0,0,0,0,0,0
153533,37000,370,0,-2,4,1,3,0,0,0,0,0,0,0,0,0,0,0,0,0,0,0,4,1,3,0,0,0,0,0,0,0,0,0
153603,37000,370,0,-2,54,7,47,0,0,0,2,2,0,3,1,2,1,0,1,0,0,0,47,4,43,0,0,0,0,0,0,1,0,1
153621,37000,370,0,-2,4,1,3,0,0,0,0,0,0,1,0,1,1,0,1,0,0,0,2,1,1,0,0,0,0,0,0,0,0,0
153630,37000,370,0,-2,9,2,7,0,0,0,0,0,0,0,0,0,0,0,0,0,0,0,9,2,7,0,0,0,0,0,0,0,0,0
153658,37000,370,0,-2,18,1,17,0,0,0,0,0,0,0,0,0,1,0,1,0,0,0,15,1,14,1,0,1,1,0,1,0,0,0
153737,37000,370,0,-2,10,1,9,0,0,0,0,0,0,0,0,0,0,0,0,0,0,0,8,1,7,0,0,0,1,0,1,1,0,1
153825,37000,370,0,-2,1,0,1,0,0,0,0,0,0,0,0,0,0,0,0,0,0,0,1,0,1,0,0,0,0,0,0,0,0,0
153834,37000,370,0,-2,8,3,5,0,0,0,0,0,0,0,0,0,2,1,1,0,0,0,6,2,4,0,0,0,0,0,0,0,0,0
153861,37000,370,0,-2,9,2,7,0,0,0,1,0,1,0,0,0,1,1,0,0,0,0,6,1,5,0,0,0,1,0,1,0,0,0
153922,37000,370,0,-2,1,0,1,0,0,0,0,0,0,0,0,0,0,0,0,0,0,0,1,0,1,0,0,0,0,0,0,0,0,0
154004,37000,370,0,-2,4,0,4,0,0,0,0,0,0,0,0,0,0,0,0,0,0,0,4,0,4,0,0,0,0,0,0,0,0,0
154013,37000,370,0,-2,4,0,4,0,0,0,0,0,0,0,0,0,0,0,0,0,0,0,4,0,4,0,0,0,0,0,0,0,0,0
154022,37000,370,0,-2,1,0,1,0,0,0,0,0,0,0,0,0,1,0,1,0,0,0,0,0,0,0,0,0,0,0,0,0,0,0
154059,37000,370,0,-2,2,0,2,0,0,0,0,0,0,0,0,0,0,0,0,0,0,0,2,0,2,0,0,0,0,0,0,0,0,0
154095,37000,370,0,-2,8,2,6,0,0,0,0,0,0,0,0,0,0,0,0,0,0,0,8,2,6,0,0,0,0,0,0,0,0,0
154101,37000,370,0,-2,3,0,3,0,0,0,0,0,0,0,0,0,0,0,0,0,0,0,3,0,3,0,0,0,0,0,0,0,0,0
154110,37000,370,0,-2,1,0,1,0,0,0,0,0,0,0,0,0,0,0,0,0,0,0,1,0,1,0,0,0,0,0,0,0,0,0
154129,37000,370,0,-2,1,0,1,0,0,0,0,0,0,0,0,0,0,0,0,0,0,0,1,0,1,0,0,0,0,0,0,0,0,0
154156,37000,370,0,-2,6,1,5,0,0,0,0,0,0,0,0,0,0,0,0,0,0,0,6,1,5,0,0,0,0,0,0,0,0,0
154174,37000,370,0,-2,17,2,15,0,0,0,2,0,2,1,0,1,2,0,2,0,0,0,12,2,10,0,0,0,0,0,0,0,0,0
154235,37000,370,0,-2,7,0,7,0,0,0,0,0,0,0,0,0,0,0,0,0,0,0,6,0,6,0,0,0,1,0,1,0,0,0
154350,37000,370,0,-2,5,1,4,0,0,0,0,0,0,0,0,0,0,0,0,0,0,0,5,1,4,0,0,0,0,0,0,0,0,0
154378,37000,370,0,-2,5,0,5,0,0,0,0,0,0,0,0,0,0,0,0,0,0,0,5,0,5,0,0,0,0,0,0,0,0,0
154396,37000,370,0,-2,5,0,5,0,0,0,0,0,0,0,0,0,0,0,0,0,0,0,5,0,5,0,0,0,0,0,0,0,0,0
154493,37000,370,0,-2,22,9,13,0,0,0,0,0,0,1,0,1,0,0,0,1,0,1,10,4,6,0,0,0,9,5,4,1,0,1
154518,37000,370,0,-2,5,1,4,0,0,0,2,0,2,0,0,0,0,0,0,0,0,0,3,1,2,0,0,0,0,0,0,0,0,0
154527,37000,370,0,-2,3,1,2,0,0,0,0,0,0,0,0,0,0,0,0,0,0,0,3,1,2,0,0,0,0,0,0,0,0,0
154536,37000,370,0,-2,2,0,2,0,0,0,0,0,0,0,0,0,0,0,0,0,0,0,2,0,2,0,0,0,0,0,0,0,0,0
154572,37000,370,0,-2,5,2,3,0,0,0,1,0,1,0,0,0,0,0,0,0,0,0,3,2,1,0,0,0,1,0,1,0,0,0
154590,37000,370,0,-2,1,0,1,0,0,0,0,0,0,0,0,0,0,0,0,0,0,0,1,0,1,0,0,0,0,0,0,0,0,0
154688,37000,370,0,-2,10,3,7,0,0,0,0,0,0,0,0,0,0,0,0,0,0,0,10,3,7,0,0,0,0,0,0,0,0,0
154697,37000,370,0,-2,13,2,11,0,0,0,0,0,0,1,0,1,2,1,1,0,0,0,10,1,9,0,0,0,0,0,0,0,0,0
154721,37000,370,0,-2,8,3,5,0,0,0,0,0,0,0,0,0,1,0,1,0,0,0,7,3,4,0,0,0,0,0,0,0,0,0
154749,37000,370,0,-2,1,0,1,0,0,0,0,0,0,0,0,0,0,0,0,0,0,0,1,0,1,0,0,0,0,0,0,0,0,0
154800,37000,370,0,-2,8,1,7,0,0,0,0,0,0,0,0,0,0,0,0,0,0,0,8,1,7,0,0,0,0,0,0,0,0,0
154855,37000,370,0,-2,1,0,1,0,0,0,0,0,0,0,0,0,0,0,0,0,0,0,1,0,1,0,0,0,0,0,0,0,0,0
154907,37000,370,0,-2,6,0,6,0,0,0,0,0,0,1,0,1,0,0,0,0,0,0,5,0,5,0,0,0,0,0,0,0,0,0
154925,37000,370,0,-2,1,0,1,0,0,0,0,0,0,0,0,0,0,0,0,0,0,0,1,0,1,0,0,0,0,0,0,0,0,0
154934,37000,370,0,-2,2,0,2,0,0,0,0,0,0,0,0,0,1,0,1,0,0,0,1,0,1,0,0,0,0,0,0,0,0,0
154952,37000,370,0,-2,3,0,3,0,0,0,0,0,0,0,0,0,0,0,0,0,0,0,3,0,3,0,0,0,0,0,0,0,0,0
154998,37000,370,0,-2,5,0,5,0,0,0,0,0,0,0,0,0,1,0,1,0,0,0,4,0,4,0,0,0,0,0,0,0,0,0
155007,37000,370,0,-2,2,0,2,0,0,0,0,0,0,0,0,0,0,0,0,0,0,0,2,0,2,0,0,0,0,0,0,0,0,0
155025,37000,370,0,-2,11,0,11,0,0,0,0,0,0,0,0,0,2,0,2,0,0,0,9,0,9,0,0,0,0,0,0,0,0,0
155061,37000,370,0,-2,8,0,8,0,0,0,1,0,1,0,0,0,1,0,1,0,0,0,5,0,5,0,0,0,1,0,1,0,0,0
155070,37000,370,0,-2,1,0,1,0,0,0,0,0,0,0,0,0,0,0,0,0,0,0,1,0,1,0,0,0,0,0,0,0,0,0
155089,37000,370,0,-2,9,0,9,0,0,0,0,0,0,0,0,0,0,0,0,0,0,0,9,0,9,0,0,0,0,0,0,0,0,0
155098,37000,370,0,-2,5,0,5,0,0,0,0,0,0,0,0,0,0,0,0,0,0,0,5,0,5,0,0,0,0,0,0,0,0,0
155104,37000,370,0,-2,5,0,5,0,0,0,0,0,0,0,0,0,2,0,2,0,0,0,3,0,3,0,0,0,0,0,0,0,0,0
155177,37000,370,0,-2,2,0,2,0,0,0,0,0,0,0,0,0,0,0,0,0,0,0,2,0,2,0,0,0,0,0,0,0,0,0
155186,37000,370,0,-2,2,0,2,0,0,0,0,0,0,0,0,0,0,0,0,0,0,0,2,0,2,0,0,0,0,0,0,0,0,0
155195,37000,370,0,-2,2,0,2,0,0,0,0,0,0,0,0,0,0,0,0,0,0,0,2,0,2,0,0,0,0,0,0,0,0,0
155210,37000,370,0,-2,16,0,16,0,0,0,0,0,0,1,0,1,1,0,1,0,0,0,13,0,13,1,0,1,0,0,0,0,0,0
155283,37000,370,0,-2,6,4,2,0,0,0,0,0,0,1,1,0,2,0,2,0,0,0,3,3,0,0,0,0,0,0,0,0,0,0
155292,37000,370,0,-2,8,0,8,0,0,0,0,0,0,1,0,1,2,0,2,0,0,0,5,0,5,0,0,0,0,0,0,0,0,0
155317,37000,370,0,-2,138,26,112,2,0,2,3,0,3,7,2,5,8,2,6,0,0,0,107,21,86,5,1,4,5,0,5,1,0,1
155335,37000,370,0,-2,7,2,5,0,0,0,1,0,1,1,0,1,1,0,1,0,0,0,4,2,2,0,0,0,0,0,0,0,0,0
155399,37000,370,0,-2,41,12,29,1,0,1,0,0,0,1,1,0,3,0,3,0,0,0,35,11,24,1,0,1,0,0,0,0,0,0
155414,37000,370,0,-2,5,0,5,0,0,0,0,0,0,0,0,0,1,0,1,0,0,0,3,0,3,1,0,1,0,0,0,0,0,0
155450,37000,370,0,-2,3,0,3,0,0,0,0,0,0,0,0,0,0,0,0,0,0,0,3,0,3,0,0,0,0,0,0,0,0,0
155487,37000,370,0,-2,1,0,1,0,0,0,0,0,0,0,0,0,0,0,0,0,0,0,0,0,0,0,0,0,1,0,1,0,0,0
155566,37000,370,0,-2,3,0,3,0,0,0,0,0,0,0,0,0,0,0,0,0,0,0,2,0,2,1,0,1,0,0,0,0,0,0
155593,37000,370,0,-2,3,0,3,0,0,0,0,0,0,0,0,0,0,0,0,0,0,0,3,0,3,0,0,0,0,0,0,0,0,0
155618,37000,370,0,-2,1,0,1,0,0,0,0,0,0,0,0,0,0,0,0,0,0,0,1,0,1,0,0,0,0,0,0,0,0,0
155681,37000,370,0,-2,6,0,6,0,0,0,0,0,0,0,0,0,0,0,0,0,0,0,6,0,6,0,0,0,0,0,0,0,0,0
155715,37000,370,0,-2,2,0,2,0,0,0,0,0,0,0,0,0,1,0,1,0,0,0,1,0,1,0,0,0,0,0,0,0,0,0
155812,37000,370,0,-2,3,0,3,0,0,0,0,0,0,0,0,0,0,0,0,0,0,0,3,0,3,0,0,0,0,0,0,0,0,0
155858,37000,370,0,-2,5,0,5,0,0,0,0,0,0,0,0,0,2,0,2,0,0,0,3,0,3,0,0,0,0,0,0,0,0,0
155900,37000,370,0,-2,5,0,5,0,0,0,0,0,0,0,0,0,0,0,0,0,0,0,5,0,5,0,0,0,0,0,0,0,0,0
155937,37000,370,0,-2,1,0,1,0,0,0,0,0,0,0,0,0,0,0,0,0,0,0,1,0,1,0,0,0,0,0,0,0,0,0
155973,37000,370,0,-2,1,0,1,0,0,0,0,0,0,0,0,0,0,0,0,0,0,0,1,0,1,0,0,0,0,0,0,0,0,0
156082,37000,370,0,-2,4,0,4,0,0,0,0,0,0,0,0,0,0,0,0,0,0,0,4,0,4,0,0,0,0,0,0,0,0,0
156107,37000,370,0,-2,1,0,1,0,0,0,0,0,0,0,0,0,0,0,0,0,0,0,1,0,1,0,0,0,0,0,0,0,0,0
156125,37000,370,0,-2,42,11,31,0,0,0,2,0,2,5,1,4,3,1,2,0,0,0,30,9,21,1,0,1,1,0,1,0,0,0
156189,37000,370,0,-2,6,1,5,0,0,0,0,0,0,0,0,0,0,0,0,0,0,0,6,1,5,0,0,0,0,0,0,0,0,0
156213,37000,370,0,-2,9,0,9,0,0,0,1,0,1,0,0,0,1,0,1,0,0,0,7,0,7,0,0,0,0,0,0,0,0,0
156222,37000,370,0,-2,10,3,7,0,0,0,0,0,0,2,1,1,0,0,0,0,0,0,8,2,6,0,0,0,0,0,0,0,0,0
156231,37000,370,0,-2,1,0,1,0,0,0,0,0,0,0,0,0,0,0,0,0,0,0,1,0,1,0,0,0,0,0,0,0,0,0
156286,37000,370,0,-2,4,1,3,0,0,0,0,0,0,0,0,0,0,0,0,0,0,0,3,1,2,1,0,1,0,0,0,0,0,0
156295,37000,370,0,-2,4,3,1,0,0,0,0,0,0,0,0,0,0,0,0,0,0,0,4,3,1,0,0,0,0,0,0,0,0,0
156338,37000,370,0,-2,3,0,3,0,0,0,0,0,0,0,0,0,0,0,0,0,0,0,2,0,2,0,0,0,1,0,1,0,0,0
156356,37000,370,0,-2,1,0,1,0,0,0,0,0,0,0,0,0,0,0,0,0,0,0,1,0,1,0,0,0,0,0,0,0,0,0
156365,37000,370,0,-2,14,1,13,0,0,0,0,0,0,1,0,1,0,0,0,0,0,0,11,1,10,0,0,0,2,0,2,0,0,0
156392,37000,370,0,-2,6,1,5,0,0,0,0,0,0,0,0,0,0,0,0,0,0,0,5,1,4,1,0,1,0,0,0,0,0,0
156408,37000,370,0,-2,3,0,3,0,0,0,0,0,0,1,0,1,0,0,0,0,0,0,2,0,2,0,0,0,0,0,0,0,0,0
156471,37000,370,0,-2,1,0,1,0,0,0,0,0,0,0,0,0,0,0,0,0,0,0,1,0,1,0,0,0,0,0,0,0,0,0
156541,37000,370,0,-2,14,4,10,0,0,0,0,0,0,0,0,0,0,0,0,0,0,0,12,4,8,0,0,0,2,0,2,0,0,0
156620,37000,370,0,-2,23,5,18,0,0,0,0,0,0,2,0,2,0,0,0,0,0,0,16,2,14,3,2,1,1,1,0,1,0,1
156648,37000,370,0,-2,3,0,3,0,0,0,0,0,0,0,0,0,0,0,0,0,0,0,3,0,3,0,0,0,0,0,0,0,0,0
156727,37000,370,0,-2,3,0,3,0,0,0,0,0,0,1,0,1,0,0,0,0,0,0,1,0,1,1,0,1,0,0,0,0,0,0
156745,37000,370,0,-2,1,0,1,0,0,0,0,0,0,0,0,0,0,0,0,0,0,0,1,0,1,0,0,0,0,0,0,0,0,0
156790,37000,370,0,-2,1,0,1,0,0,0,0,0,0,0,0,0,1,0,1,0,0,0,0,0,0,0,0,0,0,0,0,0,0,0
156860,37000,370,0,-2,2,0,2,0,0,0,0,0,0,1,0,1,0,0,0,0,0,0,1,0,1,0,0,0,0,0,0,0,0,0
156921,37000,370,0,-2,5,1,4,0,0,0,0,0,0,2,1,1,0,0,0,0,0,0,3,0,3,0,0,0,0,0,0,0,0,0
157021,37000,370,0,-2,3,1,2,0,0,0,0,0,0,0,0,0,0,0,0,0,0,0,3,1,2,0,0,0,0,0,0,0,0,0
157058,37000,370,0,-2,8,2,6,1,0,1,0,0,0,4,1,3,0,0,0,0,0,0,1,0,1,1,1,0,1,0,1,0,0,0
157076,37000,370,0,-2,4,1,3,0,0,0,0,0,0,1,1,0,0,0,0,0,0,0,3,0,3,0,0,0,0,0,0,0,0,0
157085,37000,370,0,-2,160,25,135,0,0,0,3,1,2,10,2,8,7,3,4,0,0,0,138,19,119,2,0,2,0,0,0,0,0,0
157100,37000,370,0,-2,2,0,2,0,0,0,0,0,0,0,0,0,0,0,0,0,0,0,2,0,2,0,0,0,0,0,0,0,0,0
157216,37000,370,0,-2,9,0,9,0,0,0,0,0,0,0,0,0,0,0,0,0,0,0,9,0,9,0,0,0,0,0,0,0,0,0
157289,37000,370,0,-2,77,20,57,0,0,0,4,0,4,13,4,9,5,3,2,0,0,0,49,12,37,4,1,3,0,0,0,2,0,2
157304,37000,370,0,-2,1,1,0,0,0,0,0,0,0,0,0,0,0,0,0,0,0,0,1,1,0,0,0,0,0,0,0,0,0,0
157331,37000,370,0,-2,3,0,3,0,0,0,0,0,0,0,0,0,0,0,0,0,0,0,2,0,2,0,0,0,1,0,1,0,0,0
157377,37000,370,0,-2,2,0,2,0,0,0,0,0,0,0,0,0,0,0,0,0,0,0,2,0,2,0,0,0,0,0,0,0,0,0
157401,37000,370,0,-2,5,1,4,0,0,0,0,0,0,0,0,0,0,0,0,0,0,0,4,1,3,0,0,0,1,0,1,0,0,0
157438,37000,370,0,-2,1,0,1,0,0,0,0,0,0,0,0,0,0,0,0,0,0,0,1,0,1,0,0,0,0,0,0,0,0,0
157447,37000,370,0,-2,15,5,10,0,0,0,0,0,0,1,1,0,0,0,0,0,0,0,13,4,9,1,0,1,0,0,0,0,0,0
157483,37000,370,0,-2,1,0,1,0,0,0,0,0,0,0,0,0,0,0,0,0,0,0,1,0,1,0,0,0,0,0,0,0,0,0
157535,37000,370,0,-2,6,2,4,0,0,0,0,0,0,0,0,0,0,0,0,0,0,0,6,2,4,0,0,0,0,0,0,0,0,0
157553,37000,370,0,-2,2,0,2,0,0,0,0,0,0,0,0,0,0,0,0,0,0,0,2,0,2,0,0,0,0,0,0,0,0,0
157739,37000,370,0,-2,2,0,2,0,0,0,0,0,0,0,0,0,0,0,0,0,0,0,2,0,2,0,0,0,0,0,0,0,0,0
157748,37000,370,0,-2,17,1,16,0,0,0,1,0,1,0,0,0,0,0,0,0,0,0,14,1,13,0,0,0,2,0,2,0,0,0
157757,37000,370,0,-2,11,2,9,0,0,0,0,0,0,1,0,1,0,0,0,0,0,0,10,2,8,0,0,0,0,0,0,0,0,0
157809,37000,370,0,-2,4,1,3,0,0,0,0,0,0,0,0,0,0,0,0,0,0,0,4,1,3,0,0,0,0,0,0,0,0,0
157818,37000,370,0,-2,7,0,7,0,0,0,0,0,0,0,0,0,0,0,0,0,0,0,7,0,7,0,0,0,0,0,0,0,0,0
157854,37000,370,0,-2,3,0,3,0,0,0,0,0,0,0,0,0,0,0,0,0,0,0,3,0,3,0,0,0,0,0,0,0,0,0
157863,37000,370,0,-2,5,2,3,0,0,0,0,0,0,0,0,0,0,0,0,0,0,0,5,2,3,0,0,0,0,0,0,0,0,0
157951,37000,370,0,-2,16,1,15,0,0,0,0,0,0,0,0,0,0,0,0,0,0,0,16,1,15,0,0,0,0,0,0,0,0,0
158477,37000,370,0,-2,5,2,3,0,0,0,0,0,0,3,1,2,1,1,0,0,0,0,1,0,1,0,0,0,0,0,0,0,0,0
158662,37000,370,0,-2,6,0,6,0,0,0,0,0,0,3,0,3,0,0,0,0,0,0,3,0,3,0,0,0,0,0,0,0,0,0
158802,37000,370,0,-2,1,0,1,0,0,0,0,0,0,1,0,1,0,0,0,0,0,0,0,0,0,0,0,0,0,0,0,0,0,0
158884,37000,370,0,-2,4,3,1,0,0,0,0,0,0,1,1,0,0,0,0,0,0,0,3,2,1,0,0,0,0,0,0,0,0,0
159009,37000,370,0,-2,10,1,9,0,0,0,0,0,0,10,1,9,0,0,0,0,0,0,0,0,0,0,0,0,0,0,0,0,0,0
159197,37000,370,0,-2,3,0,3,0,0,0,0,0,0,2,0,2,0,0,0,0,0,0,1,0,1,0,0,0,0,0,0,0,0,0
159382,37000,370,0,-2,10,1,9,0,0,0,0,0,0,1,0,1,0,0,0,0,0,0,9,1,8,0,0,0,0,0,0,0,0,0
159391,37000,370,0,-2,175,37,138,1,1,0,2,2,0,42,3,39,8,2,6,0,0,0,111,25,86,7,2,5,2,1,1,2,1,1
159407,37000,370,0,-2,2,0,2,0,0,0,0,0,0,0,0,0,0,0,0,0,0,0,2,0,2,0,0,0,0,0,0,0,0,0
159416,37000,370,0,-2,16,2,14,0,0,0,2,0,2,7,1,6,0,0,0,0,0,0,6,1,5,1,0,1,0,0,0,0,0,0
159568,37000,370,0,-2,13,3,10,0,0,0,0,0,0,1,0,1,0,0,0,0,0,0,12,3,9,0,0,0,0,0,0,0,0,0
159647,37000,370,0,-2,21,2,19,0,0,0,0,0,0,5,2,3,0,0,0,0,0,0,15,0,15,0,0,0,0,0,0,1,0,1
159656,37000,370,0,-2,13,5,8,0,0,0,0,0,0,5,1,4,0,0,0,0,0,0,5,2,3,1,1,0,2,1,1,0,0,0
159717,37000,370,0,-2,17,2,15,0,0,0,0,0,0,3,0,3,0,0,0,0,0,0,12,2,10,0,0,0,2,0,2,0,0,0
159939,37000,370,0,-2,3,2,1,0,0,0,0,0,0,2,2,0,0,0,0,0,0,0,1,0,1,0,0,0,0,0,0,0,0,0
159948,37000,370,0,-2,8,2,6,0,0,0,0,0,0,1,0,1,0,0,0,0,0,0,6,1,5,0,0,0,1,1,0,0,0,0
159966,37000,370,0,-2,13,4,9,0,0,0,0,0,0,4,3,1,0,0,0,0,0,0,9,1,8,0,0,0,0,0,0,0,0,0
159993,37000,370,0,-2,18,6,12,0,0,0,2,0,2,5,2,3,1,1,0,0,0,0,10,3,7,0,0,0,0,0,0,0,0,0
160038,37000,370,0,-2,14,2,12,0,0,0,0,0,0,5,0,5,1,0,1,0,0,0,7,2,5,0,0,0,1,0,1,0,0,0
160065,37000,370,0,-2,5,1,4,0,0,0,0,0,0,2,0,2,0,0,0,0,0,0,3,1,2,0,0,0,0,0,0,0,0,0
160074,37000,370,0,-2,7,2,5,0,0,0,1,0,1,1,1,0,0,0,0,0,0,0,5,1,4,0,0,0,0,0,0,0,0,0
160579,37000,370,0,-2,2,1,1,0,0,0,0,0,0,0,0,0,0,0,0,0,0,0,2,1,1,0,0,0,0,0,0,0,0,0
160612,37000,370,0,-2,19,2,17,0,0,0,0,0,0,3,0,3,3,0,3,0,0,0,13,2,11,0,0,0,0,0,0,0,0,0
160621,37000,370,0,-2,17,4,13,0,0,0,0,0,0,14,3,11,0,0,0,0,0,0,3,1,2,0,0,0,0,0,0,0,0,0
160649,37000,370,0,-2,2,1,1,0,0,0,0,0,0,2,1,1,0,0,0,0,0,0,0,0,0,0,0,0,0,0,0,0,0,0
160658,37000,370,0,-2,11,2,9,0,0,0,0,0,0,5,0,5,0,0,0,0,0,0,6,2,4,0,0,0,0,0,0,0,0,0
160667,37000,370,0,-2,5,0,5,0,0,0,1,0,1,0,0,0,0,0,0,0,0,0,4,0,4,0,0,0,0,0,0,0,0,0
160755,37000,370,0,-2,79,13,66,0,0,0,1,1,0,25,1,24,4,0,4,0,0,0,44,11,33,4,0,4,1,0,1,0,0,0
160904,37000,370,0,-2,8,0,8,0,0,0,0,0,0,8,0,8,0,0,0,0,0,0,0,0,0,0,0,0,0,0,0,0,0,0
160959,37000,370,0,-2,1,0,1,0,0,0,0,0,0,0,0,0,0,0,0,0,0,0,1,0,1,0,0,0,0,0,0,0,0,0
160977,37000,370,0,-2,10,2,8,0,0,0,2,1,1,0,0,0,1,0,1,0,0,0,6,1,5,1,0,1,0,0,0,0,0,0
160995,37000,370,0,-2,2,0,2,0,0,0,0,0,0,0,0,0,0,0,0,0,0,0,2,0,2,0,0,0,0,0,0,0,0,0
161004,37000,370,0,-2,12,3,9,0,0,0,0,0,0,0,0,0,1,1,0,0,0,0,9,1,8,0,0,0,1,1,0,1,0,1
161086,37000,370,0,-2,14,3,11,0,0,0,0,0,0,0,0,0,2,0,2,0,0,0,11,2,9,1,1,0,0,0,0,0,0,0
161217,37000,370,0,-2,3,0,3,0,0,0,0,0,0,0,0,0,0,0,0,0,0,0,3,0,3,0,0,0,0,0,0,0,0,0
161226,37000,370,0,-2,5,1,4,0,0,0,0,0,0,0,0,0,0,0,0,0,0,0,5,1,4,0,0,0,0,0,0,0,0,0
161253,37000,370,0,-2,31,9,22,0,0,0,0,0,0,0,0,0,2,1,1,0,0,0,27,8,19,0,0,0,1,0,1,1,0,1
161280,37000,370,0,-2,7,2,5,0,0,0,0,0,0,0,0,0,0,0,0,0,0,0,6,2,4,0,0,0,1,0,1,0,0,0
161299,37000,370,0,-2,1,0,1,0,0,0,0,0,0,0,0,0,0,0,0,0,0,0,1,0,1,0,0,0,0,0,0,0,0,0
161341,37000,370,0,-2,1,0,1,0,0,0,0,0,0,0,0,0,0,0,0,0,0,0,1,0,1,0,0,0,0,0,0,0,0,0
161457,37000,370,0,-2,12,1,11,0,0,0,0,0,0,0,0,0,0,0,0,0,0,0,12,1,11,0,0,0,0,0,0,0,0,0
161484,37000,370,0,-2,2,0,2,0,0,0,0,0,0,0,0,0,0,0,0,0,0,0,2,0,2,0,0,0,0,0,0,0,0,0
161509,37000,370,0,-2,3,0,3,0,0,0,0,0,0,0,0,0,0,0,0,0,0,0,3,0,3,0,0,0,0,0,0,0,0,0
161518,37000,370,0,-2,3,0,3,0,0,0,0,0,0,0,0,0,0,0,0,0,0,0,2,0,2,0,0,0,1,0,1,0,0,0
161554,37000,370,0,-2,17,2,15,0,0,0,0,0,0,0,0,0,1,0,1,0,0,0,14,2,12,1,0,1,1,0,1,0,0,0
161563,37000,370,0,-2,4,0,4,0,0,0,0,0,0,0,0,0,0,0,0,0,0,0,4,0,4,0,0,0,0,0,0,0,0,0
161572,37000,370,0,-2,5,3,2,0,0,0,1,1,0,0,0,0,0,0,0,0,0,0,3,2,1,0,0,0,1,0,1,0,0,0
161688,37000,370,0,-2,3,2,1,0,0,0,0,0,0,0,0,0,0,0,0,0,0,0,3,2,1,0,0,0,0,0,0,0,0,0
161767,37000,370,0,-2,15,6,9,0,0,0,2,1,1,3,3,0,2,1,1,0,0,0,7,1,6,1,0,1,0,0,0,0,0,0
161864,37000,370,0,-2,1,0,1,0,0,0,1,0,1,0,0,0,0,0,0,0,0,0,0,0,0,0,0,0,0,0,0,0,0,0
161873,37000,370,0,-2,5,2,3,0,0,0,0,0,0,3,1,2,0,0,0,0,0,0,2,1,1,0,0,0,0,0,0,0,0,0
162007,37000,370,0,-2,28,5,23,0,0,0,0,0,0,16,4,12,0,0,0,0,0,0,0,0,0,0,0,0,6,1,5,6,0,6
162061,37000,370,0,-2,2,0,2,0,0,0,0,0,0,0,0,0,0,0,0,0,0,0,2,0,2,0,0,0,0,0,0,0,0,0
162104,37000,370,0,-2,1,0,1,0,0,0,0,0,0,0,0,0,0,0,0,0,0,0,1,0,1,0,0,0,0,0,0,0,0,0
162122,37000,370,0,-2,6,0,6,0,0,0,0,0,0,2,0,2,0,0,0,0,0,0,3,0,3,0,0,0,1,0,1,0,0,0
162168,37000,370,0,-2,1,0,1,0,0,0,0,0,0,0,0,0,0,0,0,0,0,0,1,0,1,0,0,0,0,0,0,0,0,0
162283,37000,370,0,-2,8,2,6,0,0,0,0,0,0,8,2,6,0,0,0,0,0,0,0,0,0,0,0,0,0,0,0,0,0,0
162557,37000,370,0,-2,7,1,6,0,0,0,0,0,0,2,0,2,0,0,0,0,0,0,4,1,3,0,0,0,1,0,1,0,0,0
162584,37000,370,0,-2,1,0,1,0,0,0,0,0,0,0,0,0,0,0,0,0,0,0,1,0,1,0,0,0,0,0,0,0,0,0
162609,37000,370,0,-2,2,0,2,0,0,0,0,0,0,0,0,0,0,0,0,0,0,0,2,0,2,0,0,0,0,0,0,0,0,0
162654,37000,370,0,-2,2,2,0,0,0,0,0,0,0,0,0,0,0,0,0,1,1,0,1,1,0,0,0,0,0,0,0,0,0,0
162690,37000,370,0,-2,11,0,11,0,0,0,0,0,0,2,0,2,0,0,0,0,0,0,8,0,8,0,0,0,1,0,1,0,0,0
162706,37000,370,0,-2,4,0,4,0,0,0,0,0,0,0,0,0,0,0,0,0,0,0,4,0,4,0,0,0,0,0,0,0,0,0
162760,37000,370,0,-2,5,0,5,0,0,0,0,0,0,0,0,0,0,0,0,0,0,0,5,0,5,0,0,0,0,0,0,0,0,0
162779,37000,370,0,-2,8,2,6,0,0,0,0,0,0,2,0,2,2,0,2,0,0,0,4,2,2,0,0,0,0,0,0,0,0,0
162928,37000,370,0,-2,331,46,285,2,1,1,9,3,6,163,19,144,16,1,15,1,0,1,123,21,102,14,1,13,2,0,2,1,0,1
163028,37000,370,0,-2,7,0,7,0,0,0,2,0,2,2,0,2,1,0,1,0,0,0,1,0,1,1,0,1,0,0,0,0,0,0
163046,37000,370,0,-2,11,4,7,0,0,0,0,0,0,2,1,1,1,1,0,0,0,0,8,2,6,0,0,0,0,0,0,0,0,0
163204,37000,370,0,-2,4,0,4,0,0,0,0,0,0,3,0,3,0,0,0,0,0,0,0,0,0,0,0,0,1,0,1,0,0,0
163259,37000,370,0,-2,32,6,26,1,0,1,1,0,1,16,3,13,1,0,1,0,0,0,10,2,8,0,0,0,0,0,0,3,1,2
163268,37000,370,0,-2,9,4,5,0,0,0,1,0,1,2,2,0,0,0,0,0,0,0,5,1,4,0,0,0,1,1,0,0,0,0
163286,37000,370,0,-2,14,2,12,0,0,0,0,0,0,6,0,6,0,0,0,0,0,0,6,1,5,1,0,1,1,1,0,0,0,0
163295,37000,370,0,-2,12,3,9,0,0,0,1,0,1,6,1,5,0,0,0,0,0,0,5,2,3,0,0,0,0,0,0,0,0,0
163426,37000,370,0,-2,5,1,4,0,0,0,0,0,0,1,0,1,2,1,1,0,0,0,1,0,1,0,0,0,0,0,0,1,0,1
163453,37000,370,0,-2,21,3,18,0,0,0,0,0,0,15,2,13,1,1,0,0,0,0,1,0,1,1,0,1,2,0,2,1,0,1
163578,37000,370,0,-2,11,1,10,0,0,0,0,0,0,3,0,3,0,0,0,0,0,0,8,1,7,0,0,0,0,0,0,0,0,0
163657,37000,370,0,-2,2,0,2,0,0,0,0,0,0,0,0,0,1,0,1,0,0,0,1,0,1,0,0,0,0,0,0,0,0,0
163851,37000,370,0,-2,10,0,10,0,0,0,0,0,0,2,0,2,0,0,0,0,0,0,8,0,8,0,0,0,0,0,0,0,0,0
163912,37000,370,0,-2,4,0,4,0,0,0,1,0,1,0,0,0,0,0,0,0,0,0,3,0,3,0,0,0,0,0,0,0,0,0
164076,37000,370,0,-2,36,8,28,0,0,0,0,0,0,15,4,11,0,0,0,0,0,0,17,3,14,1,0,1,3,1,2,0,0,0
164085,37000,370,0,-2,3,0,3,0,0,0,0,0,0,2,0,2,0,0,0,0,0,0,1,0,1,0,0,0,0,0,0,0,0,0
164155,37000,370,0,-2,9,2,7,0,0,0,0,0,0,2,1,1,0,0,0,0,0,0,7,1,6,0,0,0,0,0,0,0,0,0
164173,37000,370,0,-2,3,0,3,0,0,0,0,0,0,1,0,1,1,0,1,0,0,0,1,0,1,0,0,0,0,0,0,0,0,0
164216,37000,370,0,-2,4,0,4,0,0,0,0,0,0,1,0,1,0,0,0,0,0,0,3,0,3,0,0,0,0,0,0,0,0,0
164270,37000,370,0,-2,8,1,7,0,0,0,0,0,0,0,0,0,0,0,0,0,0,0,8,1,7,0,0,0,0,0,0,0,0,0
164313,37000,370,0,-2,5,0,5,0,0,0,1,0,1,1,0,1,0,0,0,0,0,0,3,0,3,0,0,0,0,0,0,0,0,0
164368,37000,370,0,-2,1,0,1,0,0,0,1,0,1,0,0,0,0,0,0,0,0,0,0,0,0,0,0,0,0,0,0,0,0,0
164447,37000,370,0,-2,2,0,2,0,0,0,1,0,1,0,0,0,0,0,0,0,0,0,1,0,1,0,0,0,0,0,0,0,0,0
164465,37000,370,0,-2,5,1,4,0,0,0,0,0,0,1,1,0,0,0,0,1,0,1,2,0,2,0,0,0,1,0,1,0,0,0
164492,37000,370,0,-2,4,1,3,0,0,0,0,0,0,0,0,0,1,0,1,0,0,0,3,1,2,0,0,0,0,0,0,0,0,0
164562,37000,370,0,-2,6,1,5,0,0,0,0,0,0,0,0,0,0,0,0,0,0,0,6,1,5,0,0,0,0,0,0,0,0,0
164580,37000,370,0,-2,9,3,6,0,0,0,1,0,1,1,1,0,1,0,1,0,0,0,6,2,4,0,0,0,0,0,0,0,0,0
164632,37000,370,0,-2,3,3,0,0,0,0,0,0,0,0,0,0,0,0,0,0,0,0,3,3,0,0,0,0,0,0,0,0,0,0
164739,37000,370,0,-2,8,1,7,0,0,0,1,0,1,0,0,0,0,0,0,0,0,0,6,1,5,1,0,1,0,0,0,0,0,0
164748,37000,370,0,-2,25,7,18,0,0,0,3,1,2,1,0,1,3,0,3,0,0,0,12,5,7,2,0,2,2,1,1,2,0,2
164775,37000,370,0,-2,9,2,7,0,0,0,0,0,0,1,0,1,0,0,0,0,0,0,8,2,6,0,0,0,0,0,0,0,0,0
164872,37000,370,0,-2,7,3,4,0,0,0,0,0,0,1,0,1,4,2,2,0,0,0,2,1,1,0,0,0,0,0,0,0,0,0
164924,37000,370,0,-2,54,25,29,0,0,0,2,0,2,4,3,1,4,1,3,0,0,0,39,18,21,1,1,0,3,1,2,1,1,0
164988,37000,370,0,-2,112,21,91,0,0,0,7,0,7,10,2,8,7,1,6,0,0,0,72,15,57,6,0,6,8,2,6,2,1,1
165015,37000,370,0,-2,19,4,15,0,0,0,1,0,1,1,0,1,0,0,0,0,0,0,15,3,12,0,0,0,2,1,1,0,0,0
165024,37000,370,0,-2,5,1,4,0,0,0,0,0,0,1,0,1,1,1,0,0,0,0,3,0,3,0,0,0,0,0,0,0,0,0
165033,37000,370,0,-2,4,1,3,0,0,0,0,0,0,0,0,0,0,0,0,0,0,0,4,1,3,0,0,0,0,0,0,0,0,0
165112,37000,370,0,-2,5,3,2,0,0,0,1,1,0,1,0,1,1,1,0,0,0,0,2,1,1,0,0,0,0,0,0,0,0,0
165194,37000,370,0,-2,5,1,4,0,0,0,0,0,0,0,0,0,0,0,0,0,0,0,5,1,4,0,0,0,0,0,0,0,0,0
165264,37000,370,0,-2,3,1,2,0,0,0,0,0,0,2,0,2,0,0,0,0,0,0,1,1,0,0,0,0,0,0,0,0,0,0
165334,37000,370,0,-2,13,5,8,0,0,0,0,0,0,4,1,3,1,0,1,0,0,0,7,3,4,0,0,0,1,1,0,0,0,0
165529,37000,370,0,-2,6,2,4,0,0,0,0,0,0,0,0,0,0,0,0,0,0,0,6,2,4,0,0,0,0,0,0,0,0,0
165574,37000,370,0,-2,4,1,3,0,0,0,0,0,0,0,0,0,0,0,0,0,0,0,4,1,3,0,0,0,0,0,0,0,0,0
165662,37000,370,0,-2,10,1,9,0,0,0,3,0,3,2,0,2,0,0,0,0,0,0,4,0,4,1,1,0,0,0,0,0,0,0
165671,37000,370,0,-2,3,1,2,0,0,0,0,0,0,0,0,0,0,0,0,0,0,0,3,1,2,0,0,0,0,0,0,0,0,0
165699,37000,370,0,-2,13,2,11,0,0,0,0,0,0,0,0,0,2,0,2,0,0,0,9,1,8,0,0,0,2,1,1,0,0,0
165802,37000,370,0,-2,4,0,4,0,0,0,0,0,0,1,0,1,0,0,0,1,0,1,2,0,2,0,0,0,0,0,0,0,0,0
165820,37000,370,0,-2,10,0,10,0,0,0,0,0,0,1,0,1,1,0,1,0,0,0,8,0,8,0,0,0,0,0,0,0,0,0
165866,37000,370,0,-2,7,0,7,0,0,0,1,0,1,0,0,0,0,0,0,0,0,0,6,0,6,0,0,0,0,0,0,0,0,0
165884,37000,370,0,-2,2,1,1,0,0,0,1,1,0,0,0,0,0,0,0,1,0,1,0,0,0,0,0,0,0,0,0,0,0,0
165936,37000,370,0,-2,6,1,5,0,0,0,0,0,0,0,0,0,0,0,0,0,0,0,4,1,3,0,0,0,2,0,2,0,0,0
165945,37000,370,0,-2,6,2,4,0,0,0,0,0,0,1,1,0,1,1,0,0,0,0,4,0,4,0,0,0,0,0,0,0,0,0
166018,37000,370,0,-2,1,0,1,0,0,0,0,0,0,0,0,0,1,0,1,0,0,0,0,0,0,0,0,0,0,0,0,0,0,0
166027,37000,370,0,-2,329,83,246,1,0,1,38,7,31,30,4,26,46,12,34,0,0,0,197,57,140,9,0,9,0,0,0,8,3,5
166124,37000,370,0,-2,6,3,3,0,0,0,0,0,0,0,0,0,0,0,0,0,0,0,6,3,3,0,0,0,0,0,0,0,0,0
166133,37000,370,0,-2,5,2,3,0,0,0,0,0,0,0,0,0,1,0,1,0,0,0,4,2,2,0,0,0,0,0,0,0,0,0
166391,37000,370,0,-2,2,1,1,0,0,0,0,0,0,0,0,0,0,0,0,0,0,0,2,1,1,0,0,0,0,0,0,0,0,0
166452,37000,370,0,-2,5,0,5,0,0,0,0,0,0,0,0,0,1,0,1,0,0,0,4,0,4,0,0,0,0,0,0,0,0,0
166513,37000,370,0,-2,15,8,7,0,0,0,1,1,0,1,0,1,0,0,0,0,0,0,8,5,3,0,0,0,2,0,2,3,2,1
166629,37000,370,0,-2,42,13,29,0,0,0,3,0,3,3,1,2,2,0,2,0,0,0,29,10,19,2,1,1,3,1,2,0,0,0
166638,37000,370,0,-2,5,1,4,0,0,0,0,0,0,1,0,1,1,0,1,0,0,0,3,1,2,0,0,0,0,0,0,0,0,0
166647,37000,370,0,-2,4,0,4,0,0,0,1,0,1,0,0,0,1,0,1,0,0,0,2,0,2,0,0,0,0,0,0,0,0,0
166656,37000,370,0,-2,4,1,3,0,0,0,1,0,1,1,1,0,0,0,0,0,0,0,2,0,2,0,0,0,0,0,0,0,0,0
166665,37000,370,0,-2,3,1,2,0,0,0,0,0,0,1,0,1,0,0,0,0,0,0,2,1,1,0,0,0,0,0,0,0,0,0
166674,37000,370,0,-2,7,4,3,0,0,0,0,0,0,1,0,1,0,0,0,0,0,0,5,4,1,0,0,0,1,0,1,0,0,0
166683,37000,370,0,-2,153,30,123,0,0,0,14,1,13,12,4,8,20,3,17,0,0,0,96,19,77,5,2,3,3,1,2,3,0,3
166708,37000,370,0,-2,24,4,20,0,0,0,1,0,1,7,2,5,5,1,4,0,0,0,10,0,10,0,0,0,1,1,0,0,0,0
166717,37000,370,0,-2,3,1,2,0,0,0,0,0,0,1,0,1,0,0,0,0,0,0,0,0,0,0,0,0,2,1,1,0,0,0
166823,37000,370,0,-2,4,0,4,0,0,0,1,0,1,0,0,0,0,0,0,0,0,0,3,0,3,0,0,0,0,0,0,0,0,0
166850,37000,370,0,-2,8,3,5,0,0,0,1,0,1,0,0,0,1,0,1,0,0,0,6,3,3,0,0,0,0,0,0,0,0,0
166869,37000,370,0,-2,3,2,1,0,0,0,1,0,1,0,0,0,0,0,0,0,0,0,2,2,0,0,0,0,0,0,0,0,0,0
166887,37000,370,0,-2,1,0,1,0,0,0,0,0,0,0,0,0,0,0,0,0,0,0,1,0,1,0,0,0,0,0,0,0,0,0
166939,37000,370,0,-2,4,1,3,0,0,0,0,0,0,0,0,0,0,0,0,0,0,0,2,0,2,0,0,0,2,1,1,0,0,0
166957,37000,370,0,-2,7,3,4,0,0,0,0,0,0,0,0,0,0,0,0,0,0,0,7,3,4,0,0,0,0,0,0,0,0,0
167057,37000,370,0,-2,6,1,5,0,0,0,0,0,0,0,0,0,0,0,0,0,0,0,5,1,4,1,0,1,0,0,0,0,0,0
167093,37000,370,0,-2,2,1,1,0,0,0,0,0,0,0,0,0,0,0,0,0,0,0,2,1,1,0,0,0,0,0,0,0,0,0
167288,37000,370,0,-2,2,1,1,0,0,0,0,0,0,0,0,0,0,0,0,0,0,0,2,1,1,0,0,0,0,0,0,0,0,0
167312,37000,370,0,-2,5,1,4,0,0,0,0,0,0,1,0,1,1,0,1,0,0,0,2,0,2,0,0,0,1,1,0,0,0,0
167358,37000,370,0,-2,40,11,29,0,0,0,2,0,2,5,2,3,5,1,4,0,0,0,24,8,16,1,0,1,3,0,3,0,0,0
167376,37000,370,0,-2,7,1,6,1,0,1,0,0,0,0,0,0,3,1,2,0,0,0,2,0,2,0,0,0,1,0,1,0,0,0
167394,37000,370,0,-2,3,1,2,0,0,0,0,0,0,0,0,0,0,0,0,0,0,0,3,1,2,0,0,0,0,0,0,0,0,0
167525,37000,370,0,-2,2,0,2,0,0,0,0,0,0,0,0,0,0,0,0,0,0,0,1,0,1,1,0,1,0,0,0,0,0,0
167534,37000,370,0,-2,9,2,7,0,0,0,0,0,0,4,1,3,1,0,1,0,0,0,4,1,3,0,0,0,0,0,0,0,0,0
167598,37000,370,0,-2,6,4,2,0,0,0,0,0,0,1,1,0,1,0,1,0,0,0,4,3,1,0,0,0,0,0,0,0,0,0
167631,37000,370,0,-2,1,0,1,0,0,0,0,0,0,1,0,1,0,0,0,0,0,0,0,0,0,0,0,0,0,0,0,0,0,0
167677,37000,370,0,-2,1,1,0,0,0,0,0,0,0,0,0,0,0,0,0,0,0,0,1,1,0,0,0,0,0,0,0,0,0,0
167729,37000,370,0,-2,5,1,4,0,0,0,0,0,0,0,0,0,2,0,2,0,0,0,3,1,2,0,0,0,0,0,0,0,0,0
167783,37000,370,0,-2,15,2,13,0,0,0,1,0,1,4,1,3,0,0,0,0,0,0,9,1,8,1,0,1,0,0,0,0,0,0
167792,37000,370,0,-2,2,0,2,0,0,0,1,0,1,0,0,0,0,0,0,0,0,0,1,0,1,0,0,0,0,0,0,0,0,0
167835,37000,370,0,-2,22,6,16,0,0,0,0,0,0,1,1,0,3,0,3,0,0,0,17,5,12,1,0,1,0,0,0,0,0,0
167899,37000,370,0,-2,8,0,8,0,0,0,1,0,1,0,0,0,0,0,0,0,0,0,7,0,7,0,0,0,0,0,0,0,0,0
167905,37000,370,0,-2,6,1,5,0,0,0,0,0,0,1,0,1,1,0,1,0,0,0,3,0,3,0,0,0,1,1,0,0,0,0
167987,37000,370,0,-2,23,1,22,0,0,0,2,0,2,3,0,3,0,0,0,0,0,0,15,1,14,2,0,2,1,0,1,0,0,0
167996,37000,370,0,-2,5,1,4,0,0,0,0,0,0,1,0,1,0,0,0,0,0,0,2,1,1,0,0,0,2,0,2,0,0,0
168005,37000,370,0,-2,22,8,14,0,0,0,1,1,0,3,1,2,1,0,1,0,0,0,16,5,11,0,0,0,1,1,0,0,0,0
168148,37000,370,0,-2,85,17,68,0,0,0,6,1,5,11,2,9,9,5,4,0,0,0,48,7,41,2,0,2,9,2,7,0,0,0
168218,37000,370,0,-2,9,0,9,1,0,1,0,0,0,0,0,0,1,0,1,0,0,0,7,0,7,0,0,0,0,0,0,0,0,0
168227,37000,370,0,-2,6,0,6,0,0,0,1,0,1,1,0,1,0,0,0,0,0,0,2,0,2,1,0,1,1,0,1,0,0,0
168254,37000,370,0,-2,7,2,5,0,0,0,0,0,0,1,0,1,0,0,0,0,0,0,6,2,4,0,0,0,0,0,0,0,0,0
168263,37000,370,0,-2,5,1,4,0,0,0,0,0,0,0,0,0,0,0,0,0,0,0,5,1,4,0,0,0,0,0,0,0,0,0
168281,37000,370,0,-2,2,0,2,0,0,0,1,0,1,0,0,0,0,0,0,0,0,0,1,0,1,0,0,0,0,0,0,0,0,0
168342,37000,370,0,-2,7,2,5,0,0,0,1,1,0,0,0,0,2,0,2,0,0,0,4,1,3,0,0,0,0,0,0,0,0,0
168421,37000,370,0,-2,17,3,14,0,0,0,1,0,1,0,0,0,0,0,0,0,0,0,9,2,7,0,0,0,6,1,5,1,0,1
168430,37000,370,0,-2,15,3,12,0,0,0,0,0,0,1,1,0,2,0,2,0,0,0,11,2,9,1,0,1,0,0,0,0,0,0
168528,37000,370,0,-2,6,1,5,0,0,0,1,0,1,0,0,0,0,0,0,0,0,0,5,1,4,0,0,0,0,0,0,0,0,0
168591,37000,370,0,-2,2,0,2,0,0,0,0,0,0,0,0,0,0,0,0,0,0,0,2,0,2,0,0,0,0,0,0,0,0,0
168740,37000,370,0,-2,19,5,14,0,0,0,4,1,3,3,1,2,3,1,2,0,0,0,5,0,5,1,1,0,1,0,1,2,1,1
168786,37000,370,0,-2,1,0,1,0,0,0,0,0,0,0,0,0,0,0,0,0,0,0,1,0,1,0,0,0,0,0,0,0,0,0
168883,37000,370,0,-2,3,0,3,0,0,0,0,0,0,0,0,0,0,0,0,0,0,0,3,0,3,0,0,0,0,0,0,0,0,0
169080,37000,370,0,-2,4,0,4,0,0,0,0,0,0,0,0,0,0,0,0,0,0,0,4,0,4,0,0,0,0,0,0,0,0,0
169327,37000,370,0,-2,1,0,1,0,0,0,0,0,0,0,0,0,0,0,0,0,0,0,1,0,1,0,0,0,0,0,0,0,0,0
169363,37000,370,0,-2,4,0,4,0,0,0,0,0,0,0,0,0,0,0,0,0,0,0,4,0,4,0,0,0,0,0,0,0,0,0
169442,37000,370,0,-2,4,0,4,0,0,0,0,0,0,2,0,2,0,0,0,0,0,0,2,0,2,0,0,0,0,0,0,0,0,0
169479,37000,370,0,-2,7,2,5,0,0,0,1,1,0,1,0,1,0,0,0,0,0,0,4,1,3,1,0,1,0,0,0,0,0,0
169521,37000,370,0,-2,5,2,3,0,0,0,0,0,0,1,1,0,0,0,0,0,0,0,4,1,3,0,0,0,0,0,0,0,0,0
169655,37000,370,0,-2,6,1,5,0,0,0,0,0,0,2,0,2,0,0,0,0,0,0,4,1,3,0,0,0,0,0,0,0,0,0
169716,37000,370,0,-2,9,2,7,0,0,0,0,0,0,4,1,3,2,0,2,0,0,0,3,1,2,0,0,0,0,0,0,0,0,0
169761,37000,370,0,-2,1,1,0,0,0,0,0,0,0,1,1,0,0,0,0,0,0,0,0,0,0,0,0,0,0,0,0,0,0,0
169798,37000,370,0,-2,7,3,4,0,0,0,1,0,1,1,0,1,1,1,0,0,0,0,3,1,2,0,0,0,1,1,0,0,0,0
169910,37000,370,0,-2,3,0,3,0,0,0,0,0,0,0,0,0,1,0,1,0,0,0,2,0,2,0,0,0,0,0,0,0,0,0
169983,37000,370,0,-2,3,0,3,0,0,0,0,0,0,0,0,0,0,0,0,0,0,0,3,0,3,0,0,0,0,0,0,0,0,0
170000,37000,370,0,-2,8,5,3,0,0,0,0,0,0,0,0,0,1,0,1,0,0,0,7,5,2,0,0,0,0,0,0,0,0,0
170037,37000,370,0,-2,6,2,4,0,0,0,0,0,0,0,0,0,1,0,1,0,0,0,5,2,3,0,0,0,0,0,0,0,0,0
170055,37000,370,0,-2,13,6,7,0,0,0,1,0,1,1,0,1,1,1,0,0,0,0,10,5,5,0,0,0,0,0,0,0,0,0
170082,37000,370,0,-2,8,0,8,0,0,0,0,0,0,2,0,2,0,0,0,0,0,0,6,0,6,0,0,0,0,0,0,0,0,0
170240,37000,370,0,-2,10,4,6,0,0,0,1,0,1,1,0,1,0,0,0,0,0,0,6,3,3,1,0,1,1,1,0,0,0,0
170286,37000,370,0,-2,15,5,10,0,0,0,0,0,0,0,0,0,0,0,0,0,0,0,0,0,0,0,0,0,15,5,10,0,0,0
170301,37000,370,0,-2,12,1,11,0,0,0,2,0,2,0,0,0,1,0,1,0,0,0,9,1,8,0,0,0,0,0,0,0,0,0
170444,37000,370,0,-2,2,1,1,0,0,0,0,0,0,1,0,1,0,0,0,0,0,0,1,1,0,0,0,0,0,0,0,0,0,0
170532,37000,370,0,-2,5,1,4,0,0,0,0,0,0,0,0,0,0,0,0,0,0,0,4,0,4,0,0,0,1,1,0,0,0,0
170541,37000,370,0,-2,10,2,8,0,0,0,0,0,0,0,0,0,0,0,0,0,0,0,8,2,6,0,0,0,1,0,1,1,0,1
170550,37000,370,0,-2,9,5,4,0,0,0,1,1,0,0,0,0,1,0,1,0,0,0,7,4,3,0,0,0,0,0,0,0,0,0
170620,37000,370,0,-2,4,1,3,0,0,0,0,0,0,2,1,1,0,0,0,0,0,0,1,0,1,0,0,0,1,0,1,0,0,0
170639,37000,370,0,-2,8,0,8,1,0,1,0,0,0,0,0,0,0,0,0,0,0,0,7,0,7,0,0,0,0,0,0,0,0,0
170657,37000,370,0,-2,9,1,8,0,0,0,1,0,1,0,0,0,1,0,1,0,0,0,7,1,6,0,0,0,0,0,0,0,0,0
170675,37000,370,0,-2,14,2,12,0,0,0,0,0,0,4,0,4,0,0,0,0,0,0,10,2,8,0,0,0,0,0,0,0,0,0
170790,37000,370,0,-2,8,0,8,0,0,0,0,0,0,0,0,0,1,0,1,0,0,0,3,0,3,0,0,0,4,0,4,0,0,0
170976,37000,370,0,-2,166,35,131,0,0,0,7,2,5,16,3,13,11,2,9,0,0,0,127,26,101,5,2,3,0,0,0,0,0,0
171100,37000,370,0,-2,36,9,27,1,0,1,2,0,2,10,4,6,2,0,2,0,0,0,21,5,16,0,0,0,0,0,0,0,0,0
171128,37000,370,0,-2,12,1,11,0,0,0,1,0,1,0,0,0,0,0,0,0,0,0,11,1,10,0,0,0,0,0,0,0,0,0
171137,37000,370,0,-2,4,1,3,0,0,0,0,0,0,0,0,0,1,0,1,0,0,0,3,1,2,0,0,0,0,0,0,0,0,0
171146,37000,370,0,-2,9,1,8,0,0,0,1,0,1,1,0,1,0,0,0,0,0,0,6,1,5,1,0,1,0,0,0,0,0,0
171225,37000,370,0,-2,6,2,4,0,0,0,0,0,0,1,1,0,1,0,1,0,0,0,3,0,3,1,1,0,0,0,0,0,0,0
171234,37000,370,0,-2,2,1,1,0,0,0,0,0,0,0,0,0,0,0,0,0,0,0,2,1,1,0,0,0,0,0,0,0,0,0
171304,37000,370,0,-2,1,0,1,0,0,0,0,0,0,1,0,1,0,0,0,0,0,0,0,0,0,0,0,0,0,0,0,0,0,0
171395,37000,370,0,-2,2,0,2,0,0,0,0,0,0,0,0,0,0,0,0,0,0,0,2,0,2,0,0,0,0,0,0,0,0,0
171456,37000,370,0,-2,5,1,4,0,0,0,0,0,0,0,0,0,0,0,0,0,0,0,5,1,4,0,0,0,0,0,0,0,0,0
171483,37000,370,0,-2,3,0,3,0,0,0,0,0,0,0,0,0,0,0,0,0,0,0,3,0,3,0,0,0,0,0,0,0,0,0
171492,37000,370,0,-2,1,0,1,0,0,0,0,0,0,0,0,0,0,0,0,0,0,0,1,0,1,0,0,0,0,0,0,0,0,0
171535,37000,370,0,-2,12,4,8,0,0,0,0,0,0,2,1,1,0,0,0,0,0,0,10,3,7,0,0,0,0,0,0,0,0,0
171571,37000,370,0,-2,10,1,9,0,0,0,0,0,0,1,0,1,0,0,0,0,0,0,9,1,8,0,0,0,0,0,0,0,0,0
171599,37000,370,0,-2,3,1,2,0,0,0,1,0,1,0,0,0,0,0,0,0,0,0,2,1,1,0,0,0,0,0,0,0,0,0
171881,37000,370,0,-2,1,0,1,0,0,0,0,0,0,0,0,0,0,0,0,0,0,0,1,0,1,0,0,0,0,0,0,0,0,0
172051,37000,370,0,-2,4,0,4,0,0,0,0,0,0,1,0,1,0,0,0,0,0,0,3,0,3,0,0,0,0,0,0,0,0,0
172200,37000,370,0,-2,2,1,1,0,0,0,0,0,0,0,0,0,0,0,0,0,0,0,2,1,1,0,0,0,0,0,0,0,0,0
172264,37000,370,0,-2,3,1,2,0,0,0,0,0,0,0,0,0,0,0,0,0,0,0,3,1,2,0,0,0,0,0,0,0,0,0
172291,37000,370,0,-2,5,1,4,0,0,0,1,0,1,0,0,0,0,0,0,0,0,0,4,1,3,0,0,0,0,0,0,0,0,0
172307,37000,370,0,-2,3,0,3,0,0,0,0,0,0,0,0,0,0,0,0,0,0,0,3,0,3,0,0,0,0,0,0,0,0,0
172334,37000,370,0,-2,10,5,5,0,0,0,0,0,0,0,0,0,0,0,0,0,0,0,10,5,5,0,0,0,0,0,0,0,0,0
172617,37000,370,0,-2,4,1,3,0,0,0,0,0,0,1,0,1,0,0,0,0,0,0,3,1,2,0,0,0,0,0,0,0,0,0
172635,37000,370,0,-2,1,0,1,0,0,0,0,0,0,0,0,0,0,0,0,0,0,0,1,0,1,0,0,0,0,0,0,0,0,0
172644,37000,370,0,-2,18,2,16,0,0,0,0,0,0,6,0,6,0,0,0,0,0,0,11,2,9,1,0,1,0,0,0,0,0,0
172699,37000,370,0,-2,12,0,12,0,0,0,1,0,1,0,0,0,0,0,0,0,0,0,11,0,11,0,0,0,0,0,0,0,0,0
172963,37000,370,0,-2,1,0,1,0,0,0,0,0,0,0,0,0,0,0,0,0,0,0,1,0,1,0,0,0,0,0,0,0,0,0
173045,37000,370,0,-2,11,0,11,0,0,0,1,0,1,1,0,1,1,0,1,0,0,0,8,0,8,0,0,0,0,0,0,0,0,0
173063,37000,370,0,-2,1,0,1,0,0,0,0,0,0,0,0,0,0,0,0,0,0,0,1,0,1,0,0,0,0,0,0,0,0,0
173124,37000,370,0,-2,1,0,1,0,0,0,0,0,0,0,0,0,0,0,0,0,0,0,1,0,1,0,0,0,0,0,0,0,0,0
173142,37000,370,0,-2,3,0,3,0,0,0,0,0,0,0,0,0,0,0,0,0,0,0,2,0,2,0,0,0,1,0,1,0,0,0
173160,37000,370,0,-2,9,1,8,0,0,0,0,0,0,1,0,1,0,0,0,0,0,0,5,0,5,1,0,1,2,1,1,0,0,0
173258,37000,370,0,-2,6,1,5,0,0,0,1,0,1,0,0,0,1,0,1,0,0,0,4,1,3,0,0,0,0,0,0,0,0,0
173300,37000,370,0,-2,11,1,10,0,0,0,0,0,0,0,0,0,0,0,0,0,0,0,11,1,10,0,0,0,0,0,0,0,0,0
173328,37000,370,0,-2,8,1,7,0,0,0,0,0,0,0,0,0,0,0,0,0,0,0,7,1,6,0,0,0,0,0,0,1,0,1
173461,37000,370,0,-2,1,0,1,0,0,0,0,0,0,0,0,0,0,0,0,0,0,0,0,0,0,1,0,1,0,0,0,0,0,0
173647,37000,370,0,-2,1,1,0,0,0,0,0,0,0,0,0,0,0,0,0,0,0,0,1,1,0,0,0,0,0,0,0,0,0,0
173665,37000,370,0,-2,3,1,2,0,0,0,0,0,0,0,0,0,0,0,0,0,0,0,3,1,2,0,0,0,0,0,0,0,0,0
173708,37000,370,0,-2,2,1,1,0,0,0,0,0,0,0,0,0,0,0,0,0,0,0,1,0,1,0,0,0,1,1,0,0,0,0
173902,37000,370,0,-2,7,1,6,0,0,0,0,0,0,0,0,0,0,0,0,0,0,0,7,1,6,0,0,0,0,0,0,0,0,0
173911,37000,370,0,-2,2,0,2,0,0,0,0,0,0,0,0,0,0,0,0,0,0,0,2,0,2,0,0,0,0,0,0,0,0,0
173920,37000,370,0,-2,3,0,3,0,0,0,0,0,0,0,0,0,0,0,0,0,0,0,3,0,3,0,0,0,0,0,0,0,0,0
173957,37000,370,0,-2,12,1,11,0,0,0,0,0,0,1,0,1,3,0,3,0,0,0,8,1,7,0,0,0,0,0,0,0,0,0
174020,37000,370,0,-2,4,1,3,0,0,0,1,0,1,1,0,1,0,0,0,0,0,0,1,1,0,0,0,0,1,0,1,0,0,0
174066,37000,370,0,-2,122,20,102,0,0,0,10,3,7,9,0,9,8,0,8,0,0,0,85,16,69,5,1,4,5,0,5,0,0,0
174127,37000,370,0,-2,1,1,0,0,0,0,0,0,0,0,0,0,1,1,0,0,0,0,0,0,0,0,0,0,0,0,0,0,0,0
174136,37000,370,0,-2,1,0,1,0,0,0,1,0,1,0,0,0,0,0,0,0,0,0,0,0,0,0,0,0,0,0,0,0,0,0
174154,37000,370,0,-2,2,0,2,0,0,0,0,0,0,0,0,0,0,0,0,0,0,0,2,0,2,0,0,0,0,0,0,0,0,0
174233,37000,370,0,-2,8,2,6,0,0,0,0,0,0,1,0,1,0,0,0,0,0,0,7,2,5,0,0,0,0,0,0,0,0,0
174251,37000,370,0,-2,1,1,0,1,1,0,0,0,0,0,0,0,0,0,0,0,0,0,0,0,0,0,0,0,0,0,0,0,0,0
174358,37000,370,0,-2,1,0,1,0,0,0,0,0,0,0,0,0,0,0,0,0,0,0,1,0,1,0,0,0,0,0,0,0,0,0
174428,37000,370,0,-2,2,0,2,0,0,0,1,0,1,0,0,0,0,0,0,0,0,0,1,0,1,0,0,0,0,0,0,0,0,0
174437,37000,370,0,-2,2,0,2,0,0,0,0,0,0,0,0,0,0,0,0,0,0,0,2,0,2,0,0,0,0,0,0,0,0,0
174491,37000,370,0,-2,5,0,5,0,0,0,1,0,1,0,0,0,0,0,0,0,0,0,4,0,4,0,0,0,0,0,0,0,0,0
174507,37000,370,0,-2,6,0,6,0,0,0,0,0,0,0,0,0,0,0,0,0,0,0,6,0,6,0,0,0,0,0,0,0,0,0
174525,37000,370,0,-2,2,0,2,0,0,0,0,0,0,0,0,0,0,0,0,0,0,0,2,0,2,0,0,0,0,0,0,0,0,0
174747,37000,370,0,-2,3,1,2,0,0,0,1,1,0,0,0,0,0,0,0,0,0,0,2,0,2,0,0,0,0,0,0,0,0,0
174756,37000,370,0,-2,1,0,1,0,0,0,0,0,0,0,0,0,0,0,0,0,0,0,1,0,1,0,0,0,0,0,0,0,0,0
174783,37000,370,0,-2,8,0,8,0,0,0,0,0,0,0,0,0,0,0,0,0,0,0,8,0,8,0,0,0,0,0,0,0,0,0
174792,37000,370,0,-2,8,2,6,0,0,0,0,0,0,0,0,0,0,0,0,0,0,0,6,2,4,0,0,0,2,0,2,0,0,0
174817,37000,370,0,-2,16,3,13,0,0,0,1,1,0,2,0,2,0,0,0,0,0,0,12,1,11,0,0,0,1,1,0,0,0,0
174844,37000,370,0,-2,3,1,2,0,0,0,0,0,0,0,0,0,0,0,0,0,0,0,3,1,2,0,0,0,0,0,0,0,0,0
174899,37000,370,0,-2,3,2,1,1,0,1,0,0,0,0,0,0,0,0,0,0,0,0,2,2,0,0,0,0,0,0,0,0,0,0
174914,37000,370,0,-2,11,2,9,0,0,0,1,0,1,0,0,0,0,0,0,0,0,0,9,1,8,1,1,0,0,0,0,0,0,0
175005,37000,370,0,-2,15,1,14,0,0,0,0,0,0,0,0,0,0,0,0,1,0,1,13,1,12,1,0,1,0,0,0,0,0,0
175014,37000,370,0,-2,6,1,5,0,0,0,3,1,2,0,0,0,0,0,0,0,0,0,3,0,3,0,0,0,0,0,0,0,0,0
175041,37000,370,0,-2,2,1,1,0,0,0,1,1,0,0,0,0,0,0,0,0,0,0,1,0,1,0,0,0,0,0,0,0,0,0
175227,37000,370,0,-2,1,1,0,0,0,0,0,0,0,0,0,0,0,0,0,0,0,0,1,1,0,0,0,0,0,0,0,0,0,0
175281,37000,370,0,-2,23,4,19,0,0,0,3,2,1,0,0,0,2,0,2,0,0,0,18,2,16,0,0,0,0,0,0,0,0,0
175315,37000,370,0,-2,2,0,2,0,0,0,0,0,0,1,0,1,1,0,1,0,0,0,0,0,0,0,0,0,0,0,0,0,0,0
175342,37000,370,0,-2,15,4,11,0,0,0,0,0,0,13,2,11,1,1,0,0,0,0,1,1,0,0,0,0,0,0,0,0,0,0
175421,37000,370,0,-2,9,5,4,0,0,0,0,0,0,1,0,1,0,0,0,0,0,0,8,5,3,0,0,0,0,0,0,0,0,0
175430,37000,370,0,-2,6,3,3,0,0,0,0,0,0,0,0,0,0,0,0,0,0,0,6,3,3,0,0,0,0,0,0,0,0,0
175519,37000,370,0,-2,2,0,2,0,0,0,0,0,0,2,0,2,0,0,0,0,0,0,0,0,0,0,0,0,0,0,0,0,0,0
175573,37000,370,0,-2,5,0,5,0,0,0,0,0,0,3,0,3,0,0,0,0,0,0,2,0,2,0,0,0,0,0,0,0,0,0
175616,37000,370,0,-2,15,1,14,0,0,0,0,0,0,7,0,7,0,0,0,0,0,0,8,1,7,0,0,0,0,0,0,0,0,0
175643,37000,370,0,-2,1,0,1,0,0,0,0,0,0,0,0,0,0,0,0,0,0,0,1,0,1,0,0,0,0,0,0,0,0,0
175652,37000,370,0,-2,2,0,2,0,0,0,0,0,0,2,0,2,0,0,0,0,0,0,0,0,0,0,0,0,0,0,0,0,0,0
175786,37000,370,0,-2,23,1,22,1,0,1,0,0,0,14,0,14,0,0,0,0,0,0,6,1,5,0,0,0,2,0,2,0,0,0
175810,37000,370,0,-2,3,0,3,0,0,0,0,0,0,1,0,1,0,0,0,0,0,0,2,0,2,0,0,0,0,0,0,0,0,0
175829,37000,370,0,-2,6,0,6,0,0,0,0,0,0,1,0,1,0,0,0,0,0,0,5,0,5,0,0,0,0,0,0,0,0,0
175856,37000,370,0,-2,104,31,73,0,0,0,0,0,0,100,29,71,0,0,0,0,0,0,3,2,1,0,0,0,0,0,0,1,0,1
175883,37000,370,0,-2,11,2,9,0,0,0,1,1,0,1,0,1,0,0,0,0,0,0,9,1,8,0,0,0,0,0,0,0,0,0
175935,37000,370,0,-2,5,0,5,0,0,0,0,0,0,0,0,0,0,0,0,0,0,0,5,0,5,0,0,0,0,0,0,0,0,0
175980,37000,370,0,-2,4,0,4,0,0,0,0,0,0,1,0,1,0,0,0,0,0,0,3,0,3,0,0,0,0,0,0,0,0,0
175999,37000,370,0,-2,1,0,1,0,0,0,0,0,0,1,0,1,0,0,0,0,0,0,0,0,0,0,0,0,0,0,0,0,0,0
176008,37000,370,0,-2,2,1,1,0,0,0,0,0,0,1,0,1,0,0,0,0,0,0,1,1,0,0,0,0,0,0,0,0,0,0
176017,37000,370,0,-2,233,17,216,1,0,1,1,0,1,147,6,141,3,0,3,0,0,0,77,10,67,2,1,1,2,0,2,0,0,0
176035,37000,370,0,-2,12,2,10,0,0,0,0,0,0,1,1,0,0,0,0,0,0,0,11,1,10,0,0,0,0,0,0,0,0,0
176044,37000,370,0,-2,5,0,5,0,0,0,0,0,0,5,0,5,0,0,0,0,0,0,0,0,0,0,0,0,0,0,0,0,0,0
176053,37000,370,0,-2,8,2,6,0,0,0,0,0,0,1,0,1,0,0,0,0,0,0,4,2,2,0,0,0,3,0,3,0,0,0
176071,37000,370,0,-2,34,2,32,0,0,0,1,0,1,9,1,8,2,0,2,0,0,0,20,1,19,0,0,0,2,0,2,0,0,0
176080,37000,370,0,-2,65,9,56,0,0,0,1,0,1,14,1,13,0,0,0,0,0,0,50,8,42,0,0,0,0,0,0,0,0,0
176169,37000,370,0,-2,2,0,2,0,0,0,0,0,0,0,0,0,0,0,0,0,0,0,2,0,2,0,0,0,0,0,0,0,0,0
176178,37000,370,0,-2,6,0,6,0,0,0,0,0,0,3,0,3,0,0,0,0,0,0,3,0,3,0,0,0,0,0,0,0,0,0
176239,37000,370,0,-2,23,5,18,0,0,0,0,0,0,5,1,4,1,0,1,0,0,0,17,4,13,0,0,0,0,0,0,0,0,0
176318,37000,370,0,-2,2,0,2,0,0,0,0,0,0,1,0,1,0,0,0,0,0,0,0,0,0,0,0,0,1,0,1,0,0,0
176354,37000,370,0,-2,3,0,3,0,0,0,0,0,0,1,0,1,0,0,0,0,0,0,2,0,2,0,0,0,0,0,0,0,0,0
176406,37000,370,0,-2,10,1,9,0,0,0,0,0,0,10,1,9,0,0,0,0,0,0,0,0,0,0,0,0,0,0,0,0,0,0
176451,37000,370,0,-2,1,0,1,0,0,0,0,0,0,0,0,0,0,0,0,0,0,0,1,0,1,0,0,0,0,0,0,0,0,0
176479,37000,370,0,-2,23,6,17,0,0,0,0,0,0,3,0,3,0,0,0,1,0,1,19,6,13,0,0,0,0,0,0,0,0,0
176600,37000,370,0,-2,1,0,1,0,0,0,0,0,0,0,0,0,0,0,0,0,0,0,1,0,1,0,0,0,0,0,0,0,0,0
176628,37000,370,0,-2,4,0,4,0,0,0,0,0,0,1,0,1,1,0,1,0,0,0,2,0,2,0,0,0,0,0,0,0,0,0
176789,37000,370,0,-2,3,0,3,0,0,0,0,0,0,1,0,1,0,0,0,0,0,0,1,0,1,0,0,0,1,0,1,0,0,0
176910,37000,370,0,-2,3,0,3,0,0,0,0,0,0,0,0,0,0,0,0,0,0,0,3,0,3,0,0,0,0,0,0,0,0,0
176947,37000,370,0,-2,1,0,1,0,0,0,0,0,0,0,0,0,0,0,0,0,0,0,1,0,1,0,0,0,0,0,0,0,0,0
176965,37000,370,0,-2,15,4,11,0,0,0,0,0,0,2,0,2,3,1,2,0,0,0,9,3,6,1,0,1,0,0,0,0,0,0
177038,37000,370,0,-2,2,0,2,0,0,0,0,0,0,0,0,0,1,0,1,0,0,0,1,0,1,0,0,0,0,0,0,0,0,0
177065,37000,370,0,-2,11,2,9,0,0,0,0,0,0,0,0,0,0,0,0,0,0,0,7,1,6,2,1,1,2,0,2,0,0,0
177092,37000,370,0,-2,2,0,2,0,0,0,0,0,0,0,0,0,0,0,0,0,0,0,2,0,2,0,0,0,0,0,0,0,0,0
177135,37000,370,0,-2,7,0,7,0,0,0,0,0,0,0,0,0,0,0,0,0,0,0,7,0,7,0,0,0,0,0,0,0,0,0
177144,37000,370,0,-2,1,0,1,0,0,0,0,0,0,0,0,0,0,0,0,0,0,0,1,0,1,0,0,0,0,0,0,0,0,0
177214,37000,370,0,-2,6,1,5,0,0,0,0,0,0,0,0,0,0,0,0,0,0,0,3,1,2,0,0,0,3,0,3,0,0,0
177250,37000,370,0,-2,2,0,2,0,0,0,0,0,0,0,0,0,0,0,0,0,0,0,2,0,2,0,0,0,0,0,0,0,0,0
177302,37000,370,0,-2,1,0,1,0,0,0,0,0,0,1,0,1,0,0,0,0,0,0,0,0,0,0,0,0,0,0,0,0,0,0
177339,37000,370,0,-2,8,1,7,0,0,0,0,0,0,0,0,0,0,0,0,0,0,0,5,0,5,2,0,2,1,1,0,0,0,0
177418,37000,370,0,-2,3,1,2,0,0,0,0,0,0,1,0,1,0,0,0,0,0,0,2,1,1,0,0,0,0,0,0,0,0,0
177472,37000,370,0,-2,6,0,6,0,0,0,0,0,0,0,0,0,0,0,0,0,0,0,3,0,3,0,0,0,3,0,3,0,0,0
177551,37000,370,0,-2,6,0,6,0,0,0,0,0,0,4,0,4,0,0,0,0,0,0,2,0,2,0,0,0,0,0,0,0,0,0
177676,37000,370,0,-2,14,4,10,0,0,0,0,0,0,0,0,0,0,0,0,0,0,0,14,4,10,0,0,0,0,0,0,0,0,0
177940,37000,370,0,-2,4,0,4,0,0,0,0,0,0,1,0,1,0,0,0,0,0,0,2,0,2,0,0,0,1,0,1,0,0,0
177968,37000,370,0,-2,16,2,14,0,0,0,0,0,0,1,0,1,1,1,0,0,0,0,14,1,13,0,0,0,0,0,0,0,0,0
177977,37000,370,0,-2,3,0,3,0,0,0,0,0,0,0,0,0,0,0,0,0,0,0,3,0,3,0,0,0,0,0,0,0,0,0
177986,37000,370,0,-2,31,3,28,0,0,0,1,0,1,4,0,4,3,1,2,0,0,0,22,2,20,1,0,1,0,0,0,0,0,0
177995,37000,370,0,-2,12,3,9,0,0,0,1,1,0,1,0,1,1,1,0,0,0,0,7,0,7,2,1,1,0,0,0,0,0,0
178059,37000,370,0,-2,1,0,1,0,0,0,0,0,0,1,0,1,0,0,0,0,0,0,0,0,0,0,0,0,0,0,0,0,0,0
178208,37000,370,0,-2,4,1,3,0,0,0,0,0,0,0,0,0,0,0,0,0,0,0,4,1,3,0,0,0,0,0,0,0,0,0
178217,37000,370,0,-2,4,0,4,0,0,0,0,0,0,0,0,0,0,0,0,0,0,0,4,0,4,0,0,0,0,0,0,0,0,0
178244,37000,370,0,-2,3,0,3,0,0,0,0,0,0,1,0,1,0,0,0,0,0,0,2,0,2,0,0,0,0,0,0,0,0,0
178341,37000,370,0,-2,22,4,18,1,0,1,0,0,0,1,1,0,0,0,0,0,0,0,19,2,17,0,0,0,1,1,0,0,0,0
178369,37000,370,0,-2,8,2,6,0,0,0,0,0,0,1,1,0,1,0,1,0,0,0,6,1,5,0,0,0,0,0,0,0,0,0
178387,37000,370,0,-2,17,1,16,0,0,0,0,0,0,1,0,1,2,0,2,0,0,0,9,1,8,0,0,0,4,0,4,1,0,1
178396,37000,370,0,-2,153,18,135,0,0,0,3,0,3,11,0,11,9,1,8,0,0,0,124,17,107,3,0,3,3,0,3,0,0,0
178402,37000,370,0,-2,39,7,32,0,0,0,2,1,1,6,0,6,4,1,3,0,0,0,23,4,19,4,1,3,0,0,0,0,0,0
178411,37000,370,0,-2,21,3,18,0,0,0,1,0,1,1,0,1,1,0,1,0,0,0,17,3,14,0,0,0,1,0,1,0,0,0
178420,37000,370,0,-2,26,4,22,0,0,0,1,0,1,8,1,7,2,0,2,0,0,0,14,3,11,1,0,1,0,0,0,0,0,0
178439,37000,370,0,-2,3,0,3,0,0,0,0,0,0,0,0,0,0,0,0,0,0,0,3,0,3,0,0,0,0,0,0,0,0,0
178448,37000,370,0,-2,4,0,4,0,0,0,0,0,0,0,0,0,0,0,0,0,0,0,3,0,3,0,0,0,1,0,1,0,0,0
178615,37000,370,0,-2,9,3,6,0,0,0,0,0,0,0,0,0,1,1,0,0,0,0,8,2,6,0,0,0,0,0,0,0,0,0
178624,37000,370,0,-2,10,0,10,1,0,1,0,0,0,0,0,0,0,0,0,0,0,0,9,0,9,0,0,0,0,0,0,0,0,0
178697,37000,370,0,-2,3,1,2,0,0,0,0,0,0,0,0,0,0,0,0,0,0,0,3,1,2,0,0,0,0,0,0,0,0,0
178721,37000,370,0,-2,7,2,5,0,0,0,0,0,0,1,1,0,0,0,0,0,0,0,5,1,4,1,0,1,0,0,0,0,0,0
178891,37000,370,0,-2,1,0,1,0,0,0,0,0,0,1,0,1,0,0,0,0,0,0,0,0,0,0,0,0,0,0,0,0,0,0
178989,37000,370,0,-2,1,0,1,0,0,0,0,0,0,0,0,0,0,0,0,0,0,0,1,0,1,0,0,0,0,0,0,0,0,0
179043,37000,370,0,-2,10,0,10,0,0,0,0,0,0,2,0,2,1,0,1,0,0,0,6,0,6,0,0,0,1,0,1,0,0,0
179159,37000,370,0,-2,129,18,111,0,0,0,0,0,0,53,3,50,4,2,2,0,0,0,66,10,56,6,3,3,0,0,0,0,0,0
179308,37000,370,0,-2,36,8,28,0,0,0,1,0,1,15,2,13,1,0,1,0,0,0,13,5,8,3,1,2,3,0,3,0,0,0
179326,37000,370,0,-2,7,1,6,0,0,0,0,0,0,0,0,0,0,0,0,0,0,0,6,1,5,1,0,1,0,0,0,0,0,0
179344,37000,370,0,-2,1,0,1,0,0,0,0,0,0,0,0,0,0,0,0,0,0,0,1,0,1,0,0,0,0,0,0,0,0,0
179539,37000,370,0,-2,35,7,28,0,0,0,0,0,0,2,1,1,2,0,2,0,0,0,29,4,25,0,0,0,2,2,0,0,0,0
179548,37000,370,0,-2,2,0,2,0,0,0,0,0,0,0,0,0,0,0,0,0,0,0,2,0,2,0,0,0,0,0,0,0,0,0
179557,37000,370,0,-2,16,3,13,0,0,0,0,0,0,2,1,1,1,0,1,0,0,0,12,2,10,0,0,0,1,0,1,0,0,0
179566,37000,370,0,-2,26,7,19,0,0,0,1,0,1,0,0,0,0,0,0,0,0,0,24,7,17,1,0,1,0,0,0,0,0,0
179645,37000,370,0,-2,4,0,4,0,0,0,0,0,0,0,0,0,0,0,0,0,0,0,4,0,4,0,0,0,0,0,0,0,0,0
179715,37000,370,0,-2,4,2,2,0,0,0,0,0,0,0,0,0,0,0,0,0,0,0,4,2,2,0,0,0,0,0,0,0,0,0
179812,37000,370,0,-2,3,1,2,0,0,0,0,0,0,1,1,0,0,0,0,0,0,0,2,0,2,0,0,0,0,0,0,0,0,0
179867,37000,370,0,-2,505,70,435,0,0,0,13,4,9,134,6,128,16,2,14,0,0,0,319,53,266,12,4,8,9,0,9,2,1,1
179894,37000,370,0,-2,13,1,12,0,0,0,1,0,1,2,1,1,1,0,1,0,0,0,9,0,9,0,0,0,0,0,0,0,0,0
179946,37000,370,0,-2,3,0,3,0,0,0,0,0,0,0,0,0,0,0,0,0,0,0,3,0,3,0,0,0,0,0,0,0,0,0
179955,37000,370,0,-2,3,0,3,0,0,0,1,0,1,0,0,0,0,0,0,0,0,0,2,0,2,0,0,0,0,0,0,0,0,0
179964,37000,370,0,-2,1,0,1,0,0,0,0,0,0,0,0,0,0,0,0,0,0,0,1,0,1,0,0,0,0,0,0,0,0,0
180054,37000,370,0,-2,1,0,1,1,0,1,0,0,0,0,0,0,0,0,0,0,0,0,0,0,0,0,0,0,0,0,0,0,0,0
180106,37000,370,0,-2,2,0,2,0,0,0,0,0,0,0,0,0,0,0,0,0,0,0,1,0,1,0,0,0,1,0,1,0,0,0
180179,37000,370,0,-2,6,0,6,0,0,0,0,0,0,0,0,0,0,0,0,0,0,0,6,0,6,0,0,0,0,0,0,0,0,0
180197,37000,370,0,-2,3,0,3,0,0,0,0,0,0,0,0,0,0,0,0,0,0,0,3,0,3,0,0,0,0,0,0,0,0,0
180212,37000,370,0,-2,3,0,3,2,0,2,0,0,0,0,0,0,0,0,0,0,0,0,1,0,1,0,0,0,0,0,0,0,0,0
180249,37000,370,0,-2,3,0,3,0,0,0,0,0,0,0,0,0,0,0,0,0,0,0,3,0,3,0,0,0,0,0,0,0,0,0
180258,37000,370,0,-2,5,0,5,0,0,0,0,0,0,0,0,0,0,0,0,0,0,0,3,0,3,2,0,2,0,0,0,0,0,0
180328,37000,370,0,-2,3,0,3,3,0,3,0,0,0,0,0,0,0,0,0,0,0,0,0,0,0,0,0,0,0,0,0,0,0,0
180373,37000,370,0,-2,4,0,4,1,0,1,0,0,0,0,0,0,0,0,0,0,0,0,2,0,2,0,0,0,1,0,1,0,0,0
180416,37000,370,0,-2,1,0,1,0,0,0,0,0,0,0,0,0,1,0,1,0,0,0,0,0,0,0,0,0,0,0,0,0,0,0
180461,37000,370,0,-2,30,6,24,1,0,1,1,0,1,0,0,0,3,0,3,0,0,0,23,4,19,1,1,0,0,0,0,1,1,0
180489,37000,370,0,-2,23,7,16,2,0,2,0,0,0,1,1,0,1,0,1,0,0,0,19,6,13,0,0,0,0,0,0,0,0,0
180522,37000,370,0,-2,1,0,1,0,0,0,0,0,0,0,0,0,0,0,0,0,0,0,1,0,1,0,0,0,0,0,0,0,0,0
180647,37000,370,0,-2,3,0,3,1,0,1,0,0,0,0,0,0,0,0,0,0,0,0,2,0,2,0,0,0,0,0,0,0,0,0
180692,37000,370,0,-2,2,0,2,0,0,0,0,0,0,0,0,0,0,0,0,0,0,0,1,0,1,0,0,0,1,0,1,0,0,0
180814,37000,370,0,-2,4,2,2,0,0,0,0,0,0,0,0,0,0,0,0,0,0,0,3,1,2,0,0,0,1,1,0,0,0,0
180878,37000,370,0,-2,1,0,1,0,0,0,0,0,0,0,0,0,0,0,0,0,0,0,1,0,1,0,0,0,0,0,0,0,0,0
180902,37000,370,0,-2,6,0,6,0,0,0,0,0,0,0,0,0,0,0,0,0,0,0,6,0,6,0,0,0,0,0,0,0,0,0
180948,37000,370,0,-2,5,0,5,0,0,0,0,0,0,0,0,0,0,0,0,0,0,0,5,0,5,0,0,0,0,0,0,0,0,0
180984,37000,370,0,-2,2,0,2,0,0,0,0,0,0,0,0,0,0,0,0,0,0,0,2,0,2,0,0,0,0,0,0,0,0,0
181002,37000,370,0,-2,58,8,50,1,0,1,0,0,0,3,0,3,12,1,11,1,0,1,31,6,25,1,0,1,9,1,8,0,0,0
181020,37000,370,0,-2,6,1,5,0,0,0,0,0,0,0,0,0,0,0,0,0,0,0,5,1,4,1,0,1,0,0,0,0,0,0
181127,37000,370,0,-2,1,1,0,0,0,0,0,0,0,0,0,0,0,0,0,0,0,0,1,1,0,0,0,0,0,0,0,0,0,0
181215,37000,370,0,-2,8,1,7,0,0,0,0,0,0,0,0,0,0,0,0,0,0,0,8,1,7,0,0,0,0,0,0,0,0,0
181303,37000,370,0,-2,21,5,16,2,1,1,0,0,0,3,1,2,3,0,3,0,0,0,12,3,9,1,0,1,0,0,0,0,0,0
181312,37000,370,0,-2,2,0,2,0,0,0,0,0,0,0,0,0,0,0,0,0,0,0,2,0,2,0,0,0,0,0,0,0,0,0
181330,37000,370,0,-2,2,0,2,0,0,0,0,0,0,0,0,0,0,0,0,0,0,0,2,0,2,0,0,0,0,0,0,0,0,0
181394,37000,370,0,-2,7,1,6,0,0,0,0,0,0,0,0,0,0,0,0,0,0,0,7,1,6,0,0,0,0,0,0,0,0,0
181428,37000,370,0,-2,48,7,41,0,0,0,1,0,1,2,0,2,7,1,6,0,0,0,37,6,31,1,0,1,0,0,0,0,0,0
181446,37000,370,0,-2,1,1,0,0,0,0,0,0,0,0,0,0,0,0,0,0,0,0,1,1,0,0,0,0,0,0,0,0,0,0
181464,37000,370,0,-2,35,8,27,0,0,0,0,0,0,0,0,0,1,0,1,0,0,0,33,8,25,1,0,1,0,0,0,0,0,0
181491,37000,370,0,-2,5,0,5,0,0,0,0,0,0,0,0,0,0,0,0,0,0,0,5,0,5,0,0,0,0,0,0,0,0,0
181534,37000,370,0,-2,6,1,5,0,0,0,0,0,0,1,1,0,0,0,0,0,0,0,5,0,5,0,0,0,0,0,0,0,0,0
181604,37000,370,0,-2,4,0,4,0,0,0,0,0,0,0,0,0,0,0,0,0,0,0,4,0,4,0,0,0,0,0,0,0,0,0
181640,37000,370,0,-2,6,0,6,0,0,0,1,0,1,0,0,0,0,0,0,0,0,0,5,0,5,0,0,0,0,0,0,0,0,0
181738,37000,370,0,-2,3,0,3,0,0,0,0,0,0,1,0,1,0,0,0,0,0,0,2,0,2,0,0,0,0,0,0,0,0,0
181747,37000,370,0,-2,5,1,4,0,0,0,0,0,0,0,0,0,0,0,0,0,0,0,5,1,4,0,0,0,0,0,0,0,0,0
181783,37000,370,0,-2,4,0,4,0,0,0,0,0,0,0,0,0,0,0,0,0,0,0,4,0,4,0,0,0,0,0,0,0,0,0
181817,37000,370,0,-2,2,0,2,0,0,0,0,0,0,0,0,0,2,0,2,0,0,0,0,0,0,0,0,0,0,0,0,0,0,0
182005,37000,370,0,-2,19,3,16,0,0,0,3,1,2,3,0,3,6,2,4,0,0,0,6,0,6,0,0,0,1,0,1,0,0,0
182148,37000,370,0,-2,1,0,1,0,0,0,0,0,0,0,0,0,0,0,0,0,0,0,1,0,1,0,0,0,0,0,0,0,0,0
182281,37000,370,0,-2,28,7,21,0,0,0,6,1,5,2,0,2,5,1,4,0,0,0,12,3,9,3,2,1,0,0,0,0,0,0
182290,37000,370,0,-2,43,6,37,1,0,1,2,0,2,2,0,2,10,1,9,0,0,0,24,4,20,3,1,2,0,0,0,1,0,1
182306,37000,370,0,-2,6,1,5,1,0,1,0,0,0,0,0,0,1,0,1,0,0,0,4,1,3,0,0,0,0,0,0,0,0,0
182519,37000,370,0,-2,1,0,1,0,0,0,0,0,0,0,0,0,0,0,0,0,0,0,1,0,1,0,0,0,0,0,0,0,0,0
182564,37000,370,0,-2,2,0,2,0,0,0,0,0,0,0,0,0,0,0,0,0,0,0,2,0,2,0,0,0,0,0,0,0,0,0
182634,37000,370,0,-2,7,0,7,0,0,0,0,0,0,0,0,0,0,0,0,0,0,0,7,0,7,0,0,0,0,0,0,0,0,0
182670,37000,370,0,-2,35,8,27,0,0,0,1,0,1,0,0,0,1,0,1,0,0,0,31,8,23,2,0,2,0,0,0,0,0,0
182795,37000,370,0,-2,4,1,3,0,0,0,1,0,1,0,0,0,1,0,1,0,0,0,2,1,1,0,0,0,0,0,0,0,0,0
182829,37000,370,0,-2,5,0,5,0,0,0,0,0,0,0,0,0,0,0,0,0,0,0,5,0,5,0,0,0,0,0,0,0,0,0
182980,37000,370,0,-2,19,6,13,0,0,0,0,0,0,1,0,1,0,0,0,0,0,0,18,6,12,0,0,0,0,0,0,0,0,0
183026,37000,370,0,-2,605,170,435,7,3,4,13,3,10,49,10,39,46,14,32,0,0,0,446,131,315,19,6,13,25,3,22,0,0,0
183044,37000,370,0,-2,45,13,32,0,0,0,0,0,0,0,0,0,2,0,2,0,0,0,37,11,26,1,1,0,5,1,4,0,0,0
183062,37000,370,0,-2,5,2,3,0,0,0,0,0,0,0,0,0,0,0,0,0,0,0,5,2,3,0,0,0,0,0,0,0,0,0
183071,37000,370,0,-2,1,0,1,0,0,0,0,0,0,0,0,0,0,0,0,0,0,0,1,0,1,0,0,0,0,0,0,0,0,0
183080,37000,370,0,-2,6,1,5,0,0,0,0,0,0,0,0,0,1,0,1,0,0,0,5,1,4,0,0,0,0,0,0,0,0,0
183099,37000,370,0,-2,1,0,1,0,0,0,0,0,0,0,0,0,0,0,0,0,0,0,1,0,1,0,0,0,0,0,0,0,0,0
183132,37000,370,0,-2,1,0,1,0,0,0,0,0,0,0,0,0,0,0,0,0,0,0,1,0,1,0,0,0,0,0,0,0,0,0
183211,37000,370,0,-2,8,0,8,0,0,0,0,0,0,0,0,0,0,0,0,0,0,0,7,0,7,1,0,1,0,0,0,0,0,0
183239,37000,370,0,-2,5,1,4,0,0,0,0,0,0,0,0,0,0,0,0,0,0,0,5,1,4,0,0,0,0,0,0,0,0,0
183257,37000,370,0,-2,3,0,3,0,0,0,0,0,0,0,0,0,0,0,0,0,0,0,3,0,3,0,0,0,0,0,0,0,0,0
183327,37000,370,0,-2,11,2,9,0,0,0,0,0,0,0,0,0,0,0,0,0,0,0,8,2,6,1,0,1,2,0,2,0,0,0
183655,37000,370,0,-2,7,1,6,0,0,0,0,0,0,1,0,1,1,0,1,0,0,0,5,1,4,0,0,0,0,0,0,0,0,0
183743,37000,370,0,-2,1,0,1,0,0,0,0,0,0,0,0,0,0,0,0,0,0,0,1,0,1,0,0,0,0,0,0,0,0,0
183789,37000,370,0,-2,5,1,4,0,0,0,0,0,0,0,0,0,1,0,1,0,0,0,3,1,2,0,0,0,1,0,1,0,0,0
183804,37000,370,0,-2,2,1,1,0,0,0,0,0,0,0,0,0,0,0,0,0,0,0,2,1,1,0,0,0,0,0,0,0,0,0
183822,37000,370,0,-2,10,4,6,0,0,0,0,0,0,4,2,2,3,1,2,0,0,0,3,1,2,0,0,0,0,0,0,0,0,0
183859,37000,370,0,-2,4,0,4,0,0,0,0,0,0,1,0,1,0,0,0,0,0,0,3,0,3,0,0,0,0,0,0,0,0,0
183910,37000,370,0,-2,5,3,2,0,0,0,1,0,1,1,0,1,1,1,0,0,0,0,2,2,0,0,0,0,0,0,0,0,0,0
183938,37000,370,0,-2,4,1,3,0,0,0,1,0,1,0,0,0,1,0,1,0,0,0,2,1,1,0,0,0,0,0,0,0,0,0
183974,37000,370,0,-2,4,1,3,0,0,0,0,0,0,1,1,0,1,0,1,0,0,0,2,0,2,0,0,0,0,0,0,0,0,0
184180,37000,370,0,-2,4,0,4,0,0,0,0,0,0,0,0,0,0,0,0,0,0,0,4,0,4,0,0,0,0,0,0,0,0,0
184205,37000,370,0,-2,2,1,1,1,0,1,0,0,0,0,0,0,1,1,0,0,0,0,0,0,0,0,0,0,0,0,0,0,0,0
184348,37000,370,0,-2,6,5,1,0,0,0,0,0,0,0,0,0,0,0,0,0,0,0,6,5,1,0,0,0,0,0,0,0,0,0
184481,37000,370,0,-2,8,3,5,0,0,0,0,0,0,5,2,3,3,1,2,0,0,0,0,0,0,0,0,0,0,0,0,0,0,0
184603,37000,370,0,-2,4,0,4,0,0,0,0,0,0,0,0,0,0,0,0,0,0,0,1,0,1,2,0,2,1,0,1,0,0,0
184612,37000,370,0,-2,15,6,9,0,0,0,1,1,0,1,0,1,7,3,4,0,0,0,3,1,2,0,0,0,2,0,2,1,1,0
184694,37000,370,0,-2,1,0,1,0,0,0,0,0,0,0,0,0,0,0,0,0,0,0,1,0,1,0,0,0,0,0,0,0,0,0
184773,37000,370,0,-2,6,0,6,0,0,0,0,0,0,1,0,1,2,0,2,0,0,0,3,0,3,0,0,0,0,0,0,0,0,0
184782,37000,370,0,-2,28,3,25,0,0,0,1,1,0,3,0,3,2,0,2,0,0,0,18,1,17,3,1,2,0,0,0,1,0,1
184791,37000,370,0,-2,7,1,6,0,0,0,1,0,1,1,1,0,0,0,0,0,0,0,5,0,5,0,0,0,0,0,0,0,0,0
184959,37000,370,0,-2,3,1,2,0,0,0,0,0,0,1,0,1,0,0,0,0,0,0,2,1,1,0,0,0,0,0,0,0,0,0
184995,37000,370,0,-2,4,1,3,0,0,0,0,0,0,2,0,2,1,0,1,0,0,0,1,1,0,0,0,0,0,0,0,0,0,0
185129,37000,370,0,-2,9,4,5,0,0,0,1,0,1,2,1,1,1,0,1,0,0,0,3,3,0,1,0,1,1,0,1,0,0,0
185262,37000,370,0,-2,25,10,15,0,0,0,2,1,1,7,1,6,3,2,1,0,0,0,9,4,5,1,1,0,2,1,1,1,0,1
185509,37000,370,0,-2,2,0,2,0,0,0,0,0,0,0,0,0,1,0,1,0,0,0,1,0,1,0,0,0,0,0,0,0,0,0
185536,37000,370,0,-2,2,1,1,0,0,0,0,0,0,0,0,0,0,0,0,0,0,0,2,1,1,0,0,0,0,0,0,0,0,0
185572,37000,370,0,-2,1,0,1,0,0,0,0,0,0,0,0,0,0,0,0,0,0,0,1,0,1,0,0,0,0,0,0,0,0,0
185590,37000,370,0,-2,17,5,12,0,0,0,1,0,1,1,1,0,3,1,2,0,0,0,8,2,6,0,0,0,4,1,3,0,0,0
185721,37000,370,0,-2,6,0,6,0,0,0,1,0,1,0,0,0,0,0,0,0,0,0,5,0,5,0,0,0,0,0,0,0,0,0
185828,37000,370,0,-2,9,2,7,0,0,0,0,0,0,3,0,3,1,0,1,0,0,0,3,0,3,0,0,0,2,2,0,0,0,0
185873,37000,370,0,-2,12,1,11,0,0,0,0,0,0,0,0,0,0,0,0,0,0,0,11,1,10,0,0,0,1,0,1,0,0,0
186034,37000,370,0,-2,3,1,2,0,0,0,0,0,0,1,0,1,2,1,1,0,0,0,0,0,0,0,0,0,0,0,0,0,0,0
186122,37000,370,0,-2,2,0,2,0,0,0,0,0,0,0,0,0,0,0,0,0,0,0,2,0,2,0,0,0,0,0,0,0,0,0
186131,37000,370,0,-2,68,22,46,0,0,0,6,3,3,12,4,8,8,1,7,0,0,0,37,13,24,1,1,0,2,0,2,2,0,2
186186,37000,370,0,-2,2,0,2,0,0,0,0,0,0,0,0,0,2,0,2,0,0,0,0,0,0,0,0,0,0,0,0,0,0,0
186201,37000,370,0,-2,1,0,1,0,0,0,0,0,0,1,0,1,0,0,0,0,0,0,0,0,0,0,0,0,0,0,0,0,0,0
186283,37000,370,0,-2,5,0,5,0,0,0,0,0,0,1,0,1,2,0,2,0,0,0,2,0,2,0,0,0,0,0,0,0,0,0
186371,37000,370,0,-2,1,0,1,0,0,0,0,0,0,0,0,0,0,0,0,0,0,0,0,0,0,0,0,0,1,0,1,0,0,0
186380,37000,370,0,-2,137,18,119,0,0,0,3,0,3,8,2,6,7,0,7,0,0,0,15,3,12,1,0,1,100,13,87,3,0,3
186399,37000,370,0,-2,5,1,4,0,0,0,0,0,0,0,0,0,0,0,0,0,0,0,2,1,1,0,0,0,3,0,3,0,0,0
186432,37000,370,0,-2,5,2,3,0,0,0,0,0,0,3,0,3,0,0,0,0,0,0,2,2,0,0,0,0,0,0,0,0,0,0
186584,37000,370,0,-2,5,2,3,0,0,0,0,0,0,1,0,1,3,2,1,0,0,0,1,0,1,0,0,0,0,0,0,0,0,0
186618,37000,370,0,-2,6,0,6,0,0,0,0,0,0,0,0,0,0,0,0,0,0,0,6,0,6,0,0,0,0,0,0,0,0,0
186645,37000,370,0,-2,6,2,4,0,0,0,0,0,0,1,0,1,2,2,0,0,0,0,3,0,3,0,0,0,0,0,0,0,0,0
186867,37000,370,0,-2,25,8,17,0,0,0,3,2,1,2,0,2,3,1,2,0,0,0,13,3,10,0,0,0,4,2,2,0,0,0
186876,37000,370,0,-2,14,4,10,0,0,0,2,0,2,1,1,0,3,1,2,0,0,0,8,2,6,0,0,0,0,0,0,0,0,0
187046,37000,370,0,-2,1,0,1,0,0,0,0,0,0,1,0,1,0,0,0,0,0,0,0,0,0,0,0,0,0,0,0,0,0,0
187134,37000,370,0,-2,3,1,2,0,0,0,0,0,0,1,0,1,0,0,0,0,0,0,1,1,0,0,0,0,1,0,1,0,0,0
187198,37000,370,0,-2,5,2,3,0,0,0,0,0,0,1,0,1,1,0,1,0,0,0,2,2,0,1,0,1,0,0,0,0,0,0
187444,37000,370,0,-2,9,1,8,0,0,0,1,0,1,2,0,2,4,0,4,0,0,0,1,1,0,0,0,0,1,0,1,0,0,0
187532,37000,370,0,-2,18,8,10,1,0,1,1,0,1,2,2,0,8,4,4,0,0,0,6,2,4,0,0,0,0,0,0,0,0,0
187596,37000,370,0,-2,6,3,3,6,3,3,0,0,0,0,0,0,0,0,0,0,0,0,0,0,0,0,0,0,0,0,0,0,0,0
187620,37000,370,0,-2,1,0,1,0,0,0,0,0,0,0,0,0,1,0,1,0,0,0,0,0,0,0,0,0,0,0,0,0,0,0
187639,37000,370,0,-2,7,0,7,0,0,0,0,0,0,0,0,0,4,0,4,0,0,0,3,0,3,0,0,0,0,0,0,0,0,0
187648,37000,370,0,-2,7,1,6,0,0,0,0,0,0,0,0,0,1,1,0,0,0,0,4,0,4,1,0,1,1,0,1,0,0,0
187666,37000,370,0,-2,6,0,6,0,0,0,0,0,0,0,0,0,4,0,4,0,0,0,1,0,1,1,0,1,0,0,0,0,0,0
187897,37000,370,0,-2,3,0,3,0,0,0,0,0,0,0,0,0,2,0,2,0,0,0,1,0,1,0,0,0,0,0,0,0,0,0
187903,37000,370,0,-2,1,1,0,0,0,0,0,0,0,0,0,0,1,1,0,0,0,0,0,0,0,0,0,0,0,0,0,0,0,0
187912,37000,370,0,-2,10,1,9,0,0,0,0,0,0,0,0,0,6,1,5,0,0,0,4,0,4,0,0,0,0,0,0,0,0,0
187967,37000,370,0,-2,24,7,17,1,0,1,0,0,0,1,1,0,7,1,6,0,0,0,15,5,10,0,0,0,0,0,0,0,0,0
187985,37000,370,0,-2,118,27,91,5,0,5,7,3,4,0,0,0,58,15,43,0,0,0,39,7,32,6,2,4,1,0,1,2,0,2
187994,37000,370,0,-2,3,1,2,0,0,0,0,0,0,0,0,0,3,1,2,0,0,0,0,0,0,0,0,0,0,0,0,0,0,0
188003,37000,370,0,-2,4,1,3,0,0,0,0,0,0,0,0,0,2,1,1,0,0,0,2,0,2,0,0,0,0,0,0,0,0,0
188021,37000,370,0,-2,1,0,1,0,0,0,0,0,0,0,0,0,1,0,1,0,0,0,0,0,0,0,0,0,0,0,0,0,0,0
188030,37000,370,0,-2,27,5,22,1,0,1,0,0,0,1,0,1,16,5,11,0,0,0,8,0,8,0,0,0,0,0,0,1,0,1
188100,37000,370,0,-2,11,0,11,5,0,5,0,0,0,0,0,0,1,0,1,0,0,0,2,0,2,1,0,1,2,0,2,0,0,0
188137,37000,370,0,-2,2,1,1,0,0,0,0,0,0,0,0,0,2,1,1,0,0,0,0,0,0,0,0,0,0,0,0,0,0,0
188182,37000,370,0,-2,1,0,1,0,0,0,0,0,0,0,0,0,1,0,1,0,0,0,0,0,0,0,0,0,0,0,0,0,0,0
188225,37000,370,0,-2,2,0,2,0,0,0,0,0,0,0,0,0,0,0,0,0,0,0,1,0,1,1,0,1,0,0,0,0,0,0
188304,37000,370,0,-2,15,5,10,1,1,0,0,0,0,1,1,0,6,3,3,0,0,0,5,0,5,0,0,0,2,0,2,0,0,0
188340,37000,370,0,-2,1,1,0,0,0,0,0,0,0,0,0,0,0,0,0,0,0,0,1,1,0,0,0,0,0,0,0,0,0,0
188429,37000,370,0,-2,7,1,6,0,0,0,2,1,1,0,0,0,1,0,1,0,0,0,3,0,3,0,0,0,1,0,1,0,0,0
188438,37000,370,0,-2,3,0,3,0,0,0,0,0,0,0,0,0,0,0,0,0,0,0,3,0,3,0,0,0,0,0,0,0,0,0
188517,37000,370,0,-2,3,0,3,0,0,0,0,0,0,2,0,2,0,0,0,0,0,0,1,0,1,0,0,0,0,0,0,0,0,0
188526,37000,370,0,-2,4,0,4,0,0,0,0,0,0,0,0,0,0,0,0,0,0,0,4,0,4,0,0,0,0,0,0,0,0,0
188535,37000,370,0,-2,5,0,5,0,0,0,0,0,0,1,0,1,1,0,1,0,0,0,2,0,2,1,0,1,0,0,0,0,0,0
188580,37000,370,0,-2,94,12,82,0,0,0,5,2,3,16,2,14,8,1,7,0,0,0,58,7,51,1,0,1,6,0,6,0,0,0
188641,37000,370,0,-2,14,2,12,0,0,0,0,0,0,0,0,0,0,0,0,0,0,0,14,2,12,0,0,0,0,0,0,0,0,0
188854,37000,370,0,-2,7,4,3,0,0,0,1,1,0,2,2,0,1,0,1,0,0,0,1,1,0,0,0,0,2,0,2,0,0,0
189015,37000,370,0,-2,1,0,1,0,0,0,0,0,0,0,0,0,0,0,0,0,0,0,1,0,1,0,0,0,0,0,0,0,0,0
189088,37000,370,0,-2,9,1,8,0,0,0,0,0,0,1,1,0,0,0,0,0,0,0,8,0,8,0,0,0,0,0,0,0,0,0
189097,37000,370,0,-2,9,2,7,0,0,0,1,0,1,1,1,0,2,0,2,0,0,0,3,1,2,0,0,0,2,0,2,0,0,0
189228,37000,370,0,-2,2,0,2,0,0,0,1,0,1,0,0,0,1,0,1,0,0,0,0,0,0,0,0,0,0,0,0,0,0,0
189413,37000,370,0,-2,9,2,7,0,0,0,0,0,0,4,0,4,5,2,3,0,0,0,0,0,0,0,0,0,0,0,0,0,0,0
189547,37000,370,0,-2,7,0,7,0,0,0,0,0,0,0,0,0,0,0,0,0,0,0,7,0,7,0,0,0,0,0,0,0,0,0
189565,37000,370,0,-2,3,1,2,0,0,0,0,0,0,1,1,0,0,0,0,0,0,0,2,0,2,0,0,0,0,0,0,0,0,0
189583,37000,370,0,-2,3,2,1,0,0,0,0,0,0,0,0,0,1,1,0,0,0,0,2,1,1,0,0,0,0,0,0,0,0,0
189592,37000,370,0,-2,1,1,0,0,0,0,0,0,0,0,0,0,0,0,0,0,0,0,1,1,0,0,0,0,0,0,0,0,0,0
189705,37000,370,0,-2,7,1,6,0,0,0,1,0,1,1,0,1,0,0,0,0,0,0,5,1,4,0,0,0,0,0,0,0,0,0
189811,37000,370,0,-2,2,0,2,0,0,0,0,0,0,0,0,0,2,0,2,0,0,0,0,0,0,0,0,0,0,0,0,0,0,0
190035,37000,370,0,-2,5,3,2,0,0,0,3,2,1,1,0,1,1,1,0,0,0,0,0,0,0,0,0,0,0,0,0,0,0,0
190044,37000,370,0,-2,16,0,16,0,0,0,0,0,0,1,0,1,0,0,0,0,0,0,14,0,14,0,0,0,1,0,1,0,0,0
190099,37000,370,0,-2,11,2,9,0,0,0,0,0,0,2,0,2,0,0,0,0,0,0,9,2,7,0,0,0,0,0,0,0,0,0
190114,37000,370,0,-2,1,0,1,0,0,0,0,0,0,1,0,1,0,0,0,0,0,0,0,0,0,0,0,0,0,0,0,0,0,0
190150,37000,370,0,-2,518,134,384,1,0,1,67,20,47,86,20,66,154,33,121,0,0,0,155,37,118,17,9,8,17,12,5,21,3,18
190415,37000,370,0,-2,116,24,92,0,0,0,7,2,5,7,2,5,17,2,15,0,0,0,79,18,61,6,0,6,0,0,0,0,0,0
190424,37000,370,0,-2,471,78,393,6,1,5,87,13,74,124,18,106,164,25,139,1,0,1,80,18,62,0,0,0,1,0,1,8,3,5
190442,37000,370,0,-2,3,1,2,0,0,0,0,0,0,1,0,1,0,0,0,0,0,0,2,1,1,0,0,0,0,0,0,0,0,0
190503,37000,370,0,-2,9,3,6,0,0,0,0,0,0,0,0,0,3,0,3,1,1,0,4,1,3,0,0,0,1,1,0,0,0,0
190512,37000,370,0,-2,6,2,4,0,0,0,2,1,1,2,1,1,2,0,2,0,0,0,0,0,0,0,0,0,0,0,0,0,0,0
190521,37000,370,0,-2,8,2,6,0,0,0,2,1,1,1,1,0,3,0,3,0,0,0,2,0,2,0,0,0,0,0,0,0,0,0
190530,37000,370,0,-2,2,0,2,0,0,0,0,0,0,1,0,1,1,0,1,0,0,0,0,0,0,0,0,0,0,0,0,0,0,0
190549,37000,370,0,-2,6,2,4,0,0,0,1,1,0,1,0,1,2,0,2,1,1,0,1,0,1,0,0,0,0,0,0,0,0,0
190567,37000,370,0,-2,2,1,1,0,0,0,1,1,0,1,0,1,0,0,0,0,0,0,0,0,0,0,0,0,0,0,0,0,0,0
190576,37000,370,0,-2,7,5,2,0,0,0,0,0,0,2,2,0,4,3,1,0,0,0,1,0,1,0,0,0,0,0,0,0,0,0
190585,37000,370,0,-2,12,5,7,0,0,0,0,0,0,3,1,2,8,3,5,0,0,0,1,1,0,0,0,0,0,0,0,0,0,0
190594,37000,370,0,-2,7,6,1,0,0,0,1,1,0,1,1,0,3,3,0,0,0,0,2,1,1,0,0,0,0,0,0,0,0,0
190600,37000,370,0,-2,3,1,2,0,0,0,0,0,0,1,0,1,2,1,1,0,0,0,0,0,0,0,0,0,0,0,0,0,0,0
190619,37000,370,0,-2,2,0,2,0,0,0,0,0,0,1,0,1,1,0,1,0,0,0,0,0,0,0,0,0,0,0,0,0,0,0
190628,37000,370,0,-2,12,2,10,0,0,0,1,0,1,1,0,1,7,1,6,0,0,0,2,1,1,0,0,0,0,0,0,1,0,1
190637,37000,370,0,-2,4,3,1,0,0,0,0,0,0,0,0,0,3,3,0,0,0,0,0,0,0,0,0,0,0,0,0,1,0,1
190646,37000,370,0,-2,2,1,1,0,0,0,0,0,0,1,1,0,1,0,1,0,0,0,0,0,0,0,0,0,0,0,0,0,0,0
190655,37000,370,0,-2,2,0,2,0,0,0,0,0,0,1,0,1,0,0,0,0,0,0,1,0,1,0,0,0,0,0,0,0,0,0
190664,37000,370,0,-2,10,3,7,0,0,0,1,0,1,1,0,1,6,2,4,0,0,0,1,0,1,1,1,0,0,0,0,0,0,0
190673,37000,370,0,-2,3,0,3,0,0,0,2,0,2,1,0,1,0,0,0,0,0,0,0,0,0,0,0,0,0,0,0,0,0,0
190682,37000,370,0,-2,1,0,1,0,0,0,0,0,0,1,0,1,0,0,0,0,0,0,0,0,0,0,0,0,0,0,0,0,0,0
190716,37000,370,0,-2,9,2,7,0,0,0,0,0,0,0,0,0,0,0,0,0,0,0,9,2,7,0,0,0,0,0,0,0,0,0
190725,37000,370,0,-2,14,1,13,0,0,0,0,0,0,2,0,2,1,0,1,0,0,0,9,1,8,1,0,1,1,0,1,0,0,0
190761,37000,370,0,-2,1,0,1,0,0,0,0,0,0,0,0,0,0,0,0,0,0,0,1,0,1,0,0,0,0,0,0,0,0,0
190840,37000,370,0,-2,5,1,4,0,0,0,0,0,0,0,0,0,0,0,0,0,0,0,3,0,3,1,0,1,1,1,0,0,0,0
190983,37000,370,0,-2,3,0,3,1,0,1,0,0,0,0,0,0,0,0,0,0,0,0,2,0,2,0,0,0,0,0,0,0,0,0
191126,37000,370,0,-2,3,0,3,0,0,0,0,0,0,0,0,0,0,0,0,0,0,0,1,0,1,0,0,0,2,0,2,0,0,0
191199,37000,370,0,-2,3,0,3,0,0,0,0,0,0,0,0,0,0,0,0,0,0,0,2,0,2,0,0,0,1,0,1,0,0,0
191241,37000,370,0,-2,45,10,35,0,0,0,4,1,3,5,2,3,12,3,9,0,0,0,22,4,18,1,0,1,0,0,0,1,0,1
191302,37000,370,0,-2,2,0,2,0,0,0,0,0,0,0,0,0,0,0,0,0,0,0,2,0,2,0,0,0,0,0,0,0,0,0
191320,37000,370,0,-2,1,0,1,0,0,0,0,0,0,1,0,1,0,0,0,0,0,0,0,0,0,0,0,0,0,0,0,0,0,0
191339,37000,370,0,-2,3,0,3,0,0,0,0,0,0,0,0,0,1,0,1,0,0,0,2,0,2,0,0,0,0,0,0,0,0,0
191515,37000,370,0,-2,3,0,3,0,0,0,0,0,0,0,0,0,0,0,0,0,0,0,3,0,3,0,0,0,0,0,0,0,0,0
191533,37000,370,0,-2,7,1,6,0,0,0,1,0,1,0,0,0,0,0,0,0,0,0,3,1,2,0,0,0,3,0,3,0,0,0
191597,37000,370,0,-2,1,0,1,0,0,0,0,0,0,1,0,1,0,0,0,0,0,0,0,0,0,0,0,0,0,0,0,0,0,0
191612,37000,370,0,-2,6,2,4,0,0,0,0,0,0,0,0,0,0,0,0,0,0,0,6,2,4,0,0,0,0,0,0,0,0,0
191630,37000,370,0,-2,3,1,2,0,0,0,0,0,0,0,0,0,0,0,0,0,0,0,3,1,2,0,0,0,0,0,0,0,0,0
191649,37000,370,0,-2,1,0,1,0,0,0,0,0,0,0,0,0,0,0,0,0,0,0,1,0,1,0,0,0,0,0,0,0,0,0
191676,37000,370,0,-2,6,2,4,0,0,0,0,0,0,1,1,0,0,0,0,0,0,0,5,1,4,0,0,0,0,0,0,0,0,0
191719,37000,370,0,-2,7,2,5,0,0,0,0,0,0,0,0,0,0,0,0,0,0,0,7,2,5,0,0,0,0,0,0,0,0,0
191931,37000,370,0,-2,11,4,7,0,0,0,0,0,0,0,0,0,1,1,0,0,0,0,9,3,6,0,0,0,1,0,1,0,0,0
191968,37000,370,0,-2,7,1,6,0,0,0,0,0,0,0,0,0,0,0,0,0,0,0,3,0,3,0,0,0,4,1,3,0,0,0
191986,37000,370,0,-2,3,1,2,0,0,0,0,0,0,0,0,0,1,0,1,0,0,0,2,1,1,0,0,0,0,0,0,0,0,0
192022,37000,370,0,-2,6,2,4,0,0,0,1,0,1,1,1,0,0,0,0,0,0,0,4,1,3,0,0,0,0,0,0,0,0,0
192040,37000,370,0,-2,6,5,1,0,0,0,1,1,0,0,0,0,0,0,0,0,0,0,4,4,0,1,0,1,0,0,0,0,0,0
192110,37000,370,0,-2,6,2,4,0,0,0,0,0,0,1,1,0,1,1,0,0,0,0,4,0,4,0,0,0,0,0,0,0,0,0
192192,37000,370,0,-2,5,0,5,0,0,0,0,0,0,0,0,0,0,0,0,0,0,0,5,0,5,0,0,0,0,0,0,0,0,0
192271,37000,370,0,-2,3,0,3,0,0,0,0,0,0,0,0,0,0,0,0,0,0,0,3,0,3,0,0,0,0,0,0,0,0,0
192323,37000,370,0,-2,7,0,7,0,0,0,1,0,1,1,0,1,0,0,0,0,0,0,5,0,5,0,0,0,0,0,0,0,0,0
192448,37000,370,0,-2,31,5,26,0,0,0,2,1,1,5,1,4,3,0,3,0,0,0,18,3,15,0,0,0,3,0,3,0,0,0
192703,37000,370,0,-2,2,1,1,0,0,0,0,0,0,0,0,0,2,1,1,0,0,0,0,0,0,0,0,0,0,0,0,0,0,0
192712,37000,370,0,-2,4,0,4,0,0,0,1,0,1,0,0,0,0,0,0,0,0,0,2,0,2,1,0,1,0,0,0,0,0,0
192749,37000,370,0,-2,8,4,4,0,0,0,0,0,0,0,0,0,0,0,0,0,0,0,7,4,3,0,0,0,1,0,1,0,0,0
192785,37000,370,0,-2,3,1,2,0,0,0,0,0,0,0,0,0,0,0,0,0,0,0,3,1,2,0,0,0,0,0,0,0,0,0
192819,37000,370,0,-2,7,1,6,0,0,0,0,0,0,0,0,0,1,1,0,0,0,0,6,0,6,0,0,0,0,0,0,0,0,0
192864,37000,370,0,-2,2,0,2,0,0,0,0,0,0,0,0,0,0,0,0,0,0,0,0,0,0,0,0,0,2,0,2,0,0,0
192925,37000,370,0,-2,2,0,2,0,0,0,0,0,0,0,0,0,0,0,0,1,0,1,1,0,1,0,0,0,0,0,0,0,0,0
193016,37000,370,0,-2,48,13,35,0,0,0,1,0,1,10,5,5,13,2,11,0,0,0,13,3,10,4,1,3,3,2,1,4,0,4
193283,37000,370,0,-2,10,2,8,0,0,0,0,0,0,0,0,0,0,0,0,0,0,0,10,2,8,0,0,0,0,0,0,0,0,0
193292,37000,370,0,-2,4,0,4,0,0,0,0,0,0,0,0,0,1,0,1,0,0,0,3,0,3,0,0,0,0,0,0,0,0,0
193308,37000,370,0,-2,9,1,8,0,0,0,0,0,0,5,1,4,2,0,2,0,0,0,2,0,2,0,0,0,0,0,0,0,0,0
193326,37000,370,0,-2,3,1,2,0,0,0,0,0,0,0,0,0,1,0,1,0,0,0,2,1,1,0,0,0,0,0,0,0,0,0
193353,37000,370,0,-2,3,0,3,0,0,0,0,0,0,0,0,0,0,0,0,0,0,0,3,0,3,0,0,0,0,0,0,0,0,0
193399,37000,370,0,-2,11,5,6,0,0,0,0,0,0,1,0,1,3,1,2,0,0,0,6,4,2,0,0,0,1,0,1,0,0,0
193405,37000,370,0,-2,440,59,381,1,0,1,14,3,11,40,4,36,198,20,178,0,0,0,16,4,12,5,1,4,166,27,139,0,0,0
193478,37000,370,0,-2,1,1,0,0,0,0,0,0,0,0,0,0,0,0,0,0,0,0,1,1,0,0,0,0,0,0,0,0,0,0
193584,37000,370,0,-2,3,3,0,0,0,0,1,1,0,0,0,0,0,0,0,0,0,0,2,2,0,0,0,0,0,0,0,0,0,0
193654,37000,370,0,-2,9,3,6,0,0,0,1,0,1,4,2,2,3,1,2,0,0,0,1,0,1,0,0,0,0,0,0,0,0,0
193751,37000,370,0,-2,5,1,4,0,0,0,0,0,0,0,0,0,0,0,0,0,0,0,5,1,4,0,0,0,0,0,0,0,0,0
193821,37000,370,0,-2,1,0,1,0,0,0,1,0,1,0,0,0,0,0,0,0,0,0,0,0,0,0,0,0,0,0,0,0,0,0
193830,37000,370,0,-2,2,0,2,0,0,0,1,0,1,1,0,1,0,0,0,0,0,0,0,0,0,0,0,0,0,0,0,0,0,0
193894,37000,370,0,-2,3,0,3,0,0,0,0,0,0,3,0,3,0,0,0,0,0,0,0,0,0,0,0,0,0,0,0,0,0,0
193900,37000,370,0,-2,420,74,346,1,0,1,68,15,53,71,11,60,129,18,111,0,0,0,135,26,109,6,1,5,5,0,5,5,3,2
193946,37000,370,0,-2,6,0,6,0,0,0,0,0,0,0,0,0,0,0,0,0,0,0,6,0,6,0,0,0,0,0,0,0,0,0
193973,37000,370,0,-2,5,1,4,0,0,0,0,0,0,0,0,0,0,0,0,0,0,0,5,1,4,0,0,0,0,0,0,0,0,0
194073,37000,370,0,-2,5,2,3,0,0,0,0,0,0,2,1,1,0,0,0,1,1,0,1,0,1,0,0,0,1,0,1,0,0,0
194091,37000,370,0,-2,18,2,16,0,0,0,0,0,0,1,0,1,5,0,5,0,0,0,12,2,10,0,0,0,0,0,0,0,0,0
194161,37000,370,0,-2,2,0,2,0,0,0,0,0,0,1,0,1,0,0,0,0,0,0,0,0,0,0,0,0,1,0,1,0,0,0
194222,37000,370,0,-2,3,0,3,0,0,0,0,0,0,1,0,1,0,0,0,0,0,0,2,0,2,0,0,0,0,0,0,0,0,0
194240,37000,370,0,-2,4,0,4,0,0,0,0,0,0,0,0,0,0,0,0,0,0,0,3,0,3,1,0,1,0,0,0,0,0,0
194310,37000,370,0,-2,22,4,18,0,0,0,2,0,2,4,1,3,4,3,1,0,0,0,12,0,12,0,0,0,0,0,0,0,0,0
194392,37000,370,0,-2,2,0,2,0,0,0,0,0,0,0,0,0,0,0,0,0,0,0,2,0,2,0,0,0,0,0,0,0,0,0
194499,37000,370,0,-2,14,3,11,0,0,0,1,1,0,1,0,1,4,1,3,0,0,0,8,1,7,0,0,0,0,0,0,0,0,0
194578,37000,370,0,-2,8,2,6,0,0,0,1,0,1,1,0,1,0,0,0,0,0,0,5,2,3,0,0,0,0,0,0,1,0,1
194824,37000,370,0,-2,2,2,0,0,0,0,0,0,0,0,0,0,0,0,0,0,0,0,2,2,0,0,0,0,0,0,0,0,0,0
194958,37000,370,0,-2,8,3,5,0,0,0,0,0,0,4,2,2,0,0,0,0,0,0,4,1,3,0,0,0,0,0,0,0,0,0
195003,37000,370,0,-2,39,7,32,0,0,0,1,0,1,7,1,6,4,0,4,0,0,0,25,6,19,2,0,2,0,0,0,0,0,0
195030,37000,370,0,-2,258,58,200,0,0,0,16,3,13,48,11,37,21,4,17,0,0,0,159,37,122,10,1,9,0,0,0,4,2,2
195049,37000,370,0,-2,8,3,5,0,0,0,2,0,2,1,1,0,4,2,2,0,0,0,1,0,1,0,0,0,0,0,0,0,0,0
195058,37000,370,0,-2,1,0,1,0,0,0,0,0,0,0,0,0,1,0,1,0,0,0,0,0,0,0,0,0,0,0,0,0,0,0
195128,37000,370,0,-2,11,5,6,0,0,0,1,0,1,0,0,0,0,0,0,0,0,0,10,5,5,0,0,0,0,0,0,0,0,0
195164,37000,370,0,-2,4,1,3,0,0,0,0,0,0,1,0,1,1,1,0,0,0,0,2,0,2,0,0,0,0,0,0,0,0,0
195173,37000,370,0,-2,1,0,1,0,0,0,0,0,0,0,0,0,0,0,0,0,0,0,1,0,1,0,0,0,0,0,0,0,0,0
195216,37000,370,0,-2,8,0,8,0,0,0,1,0,1,0,0,0,0,0,0,0,0,0,7,0,7,0,0,0,0,0,0,0,0,0
195234,37000,370,0,-2,3,0,3,0,0,0,0,0,0,1,0,1,1,0,1,0,0,0,1,0,1,0,0,0,0,0,0,0,0,0
195243,37000,370,0,-2,1,1,0,0,0,0,0,0,0,1,1,0,0,0,0,0,0,0,0,0,0,0,0,0,0,0,0,0,0,0
195304,37000,370,0,-2,6,0,6,0,0,0,0,0,0,1,0,1,0,0,0,0,0,0,5,0,5,0,0,0,0,0,0,0,0,0
195322,37000,370,0,-2,2,0,2,0,0,0,0,0,0,0,0,0,0,0,0,0,0,0,2,0,2,0,0,0,0,0,0,0,0,0
195438,37000,370,0,-2,1,0,1,0,0,0,0,0,0,0,0,0,0,0,0,0,0,0,1,0,1,0,0,0,0,0,0,0,0,0
195474,37000,370,0,-2,14,3,11,0,0,0,0,0,0,1,0,1,2,1,1,0,0,0,11,2,9,0,0,0,0,0,0,0,0,0
195526,37000,370,0,-2,9,2,7,0,0,0,0,0,0,0,0,0,0,0,0,0,0,0,9,2,7,0,0,0,0,0,0,0,0,0
195544,37000,370,0,-2,9,1,8,0,0,0,0,0,0,0,0,0,1,0,1,0,0,0,7,1,6,0,0,0,1,0,1,0,0,0
195720,37000,370,0,-2,9,3,6,0,0,0,0,0,0,0,0,0,0,0,0,0,0,0,9,3,6,0,0,0,0,0,0,0,0,0
195784,37000,370,0,-2,1,0,1,0,0,0,0,0,0,0,0,0,0,0,0,0,0,0,1,0,1,0,0,0,0,0,0,0,0,0
195809,37000,370,0,-2,12,4,8,0,0,0,2,2,0,6,1,5,2,1,1,0,0,0,2,0,2,0,0,0,0,0,0,0,0,0
195827,37000,370,0,-2,3,2,1,0,0,0,2,2,0,0,0,0,0,0,0,0,0,0,1,0,1,0,0,0,0,0,0,0,0,0
195988,37000,370,0,-2,1,0,1,0,0,0,0,0,0,0,0,0,0,0,0,0,0,0,1,0,1,0,0,0,0,0,0,0,0,0
196006,37000,370,0,-2,5,0,5,0,0,0,0,0,0,0,0,0,0,0,0,0,0,0,5,0,5,0,0,0,0,0,0,0,0,0
196015,37000,370,0,-2,2,0,2,0,0,0,0,0,0,0,0,0,0,0,0,0,0,0,2,0,2,0,0,0,0,0,0,0,0,0
196024,37000,370,0,-2,3,0,3,0,0,0,0,0,0,0,0,0,1,0,1,0,0,0,2,0,2,0,0,0,0,0,0,0,0,0
196033,37000,370,0,-2,5,2,3,0,0,0,0,0,0,0,0,0,0,0,0,0,0,0,5,2,3,0,0,0,0,0,0,0,0,0
196042,37000,370,0,-2,6,0,6,0,0,0,0,0,0,1,0,1,0,0,0,0,0,0,5,0,5,0,0,0,0,0,0,0,0,0
196051,37000,370,0,-2,1,0,1,0,0,0,0,0,0,0,0,0,0,0,0,0,0,0,1,0,1,0,0,0,0,0,0,0,0,0
196060,37000,370,0,-2,9,1,8,0,0,0,0,0,0,0,0,0,0,0,0,0,0,0,9,1,8,0,0,0,0,0,0,0,0,0
196079,37000,370,0,-2,33,4,29,0,0,0,0,0,0,0,0,0,0,0,0,0,0,0,33,4,29,0,0,0,0,0,0,0,0,0
196088,37000,370,0,-2,4,1,3,0,0,0,0,0,0,0,0,0,0,0,0,0,0,0,4,1,3,0,0,0,0,0,0,0,0,0
196097,37000,370,0,-2,7,1,6,0,0,0,0,0,0,3,0,3,0,0,0,0,0,0,4,1,3,0,0,0,0,0,0,0,0,0
196103,37000,370,0,-2,4,0,4,0,0,0,0,0,0,0,0,0,0,0,0,0,0,0,4,0,4,0,0,0,0,0,0,0,0,0
196112,37000,370,0,-2,2,0,2,0,0,0,0,0,0,0,0,0,0,0,0,0,0,0,2,0,2,0,0,0,0,0,0,0,0,0
196121,37000,370,0,-2,11,0,11,0,0,0,0,0,0,0,0,0,0,0,0,0,0,0,11,0,11,0,0,0,0,0,0,0,0,0
196130,37000,370,0,-2,8,1,7,0,0,0,0,0,0,0,0,0,0,0,0,0,0,0,7,1,6,1,0,1,0,0,0,0,0,0
196149,37000,370,0,-2,6,0,6,0,0,0,0,0,0,0,0,0,0,0,0,0,0,0,6,0,6,0,0,0,0,0,0,0,0,0
196158,37000,370,0,-2,1,0,1,0,0,0,0,0,0,0,0,0,0,0,0,0,0,0,1,0,1,0,0,0,0,0,0,0,0,0
196167,37000,370,0,-2,6,1,5,0,0,0,0,0,0,0,0,0,0,0,0,0,0,0,6,1,5,0,0,0,0,0,0,0,0,0
196176,37000,370,0,-2,3,0,3,0,0,0,0,0,0,0,0,0,1,0,1,0,0,0,2,0,2,0,0,0,0,0,0,0,0,0
196185,37000,370,0,-2,8,1,7,0,0,0,0,0,0,0,0,0,0,0,0,0,0,0,8,1,7,0,0,0,0,0,0,0,0,0
196194,37000,370,0,-2,10,1,9,0,0,0,0,0,0,1,0,1,0,0,0,0,0,0,9,1,8,0,0,0,0,0,0,0,0,0
196200,37000,370,0,-2,3,0,3,0,0,0,0,0,0,0,0,0,0,0,0,0,0,0,3,0,3,0,0,0,0,0,0,0,0,0
196219,37000,370,0,-2,2,1,1,0,0,0,0,0,0,0,0,0,1,1,0,0,0,0,1,0,1,0,0,0,0,0,0,0,0,0
196228,37000,370,0,-2,9,2,7,0,0,0,1,1,0,6,1,5,0,0,0,0,0,0,2,0,2,0,0,0,0,0,0,0,0,0
196237,37000,370,0,-2,1,0,1,0,0,0,0,0,0,0,0,0,0,0,0,0,0,0,1,0,1,0,0,0,0,0,0,0,0,0
196246,37000,370,0,-2,3,1,2,0,0,0,0,0,0,0,0,0,0,0,0,0,0,0,3,1,2,0,0,0,0,0,0,0,0,0
196255,37000,370,0,-2,6,2,4,0,0,0,2,1,1,4,1,3,0,0,0,0,0,0,0,0,0,0,0,0,0,0,0,0,0,0
196264,37000,370,0,-2,5,0,5,0,0,0,0,0,0,1,0,1,0,0,0,0,0,0,4,0,4,0,0,0,0,0,0,0,0,0
196291,37000,370,0,-2,1,0,1,0,0,0,0,0,0,0,0,0,0,0,0,0,0,0,1,0,1,0,0,0,0,0,0,0,0,0
196307,37000,370,0,-2,4,0,4,1,0,1,0,0,0,0,0,0,0,0,0,0,0,0,3,0,3,0,0,0,0,0,0,0,0,0
196413,37000,370,0,-2,30,7,23,0,0,0,2,0,2,6,2,4,2,1,1,0,0,0,17,3,14,0,0,0,1,0,1,2,1,1
196468,37000,370,0,-2,2,0,2,0,0,0,1,0,1,0,0,0,1,0,1,0,0,0,0,0,0,0,0,0,0,0,0,0,0,0
196565,37000,370,0,-2,2,1,1,0,0,0,0,0,0,0,0,0,0,0,0,0,0,0,2,1,1,0,0,0,0,0,0,0,0,0
196592,37000,370,0,-2,29,5,24,0,0,0,2,0,2,4,2,2,10,2,8,0,0,0,10,1,9,1,0,1,2,0,2,0,0,0
196653,37000,370,0,-2,4,0,4,0,0,0,0,0,0,0,0,0,0,0,0,0,0,0,4,0,4,0,0,0,0,0,0,0,0,0
196680,37000,370,0,-2,1,0,1,0,0,0,0,0,0,0,0,0,0,0,0,0,0,0,1,0,1,0,0,0,0,0,0,0,0,0
196699,37000,370,0,-2,4,0,4,0,0,0,0,0,0,0,0,0,0,0,0,0,0,0,4,0,4,0,0,0,0,0,0,0,0,0
196866,37000,370,0,-2,11,2,9,0,0,0,0,0,0,0,0,0,1,0,1,0,0,0,10,2,8,0,0,0,0,0,0,0,0,0
196884,37000,370,0,-2,1,0,1,0,0,0,0,0,0,0,0,0,1,0,1,0,0,0,0,0,0,0,0,0,0,0,0,0,0,0
197036,37000,370,0,-2,24,7,17,1,0,1,0,0,0,2,1,1,2,0,2,0,0,0,18,6,12,1,0,1,0,0,0,0,0,0
197045,37000,370,0,-2,13,1,12,0,0,0,0,0,0,0,0,0,1,0,1,0,0,0,11,1,10,1,0,1,0,0,0,0,0,0
197133,37000,370,0,-2,19,3,16,0,0,0,1,0,1,3,1,2,2,0,2,0,0,0,8,0,8,0,0,0,4,1,3,1,1,0
197151,37000,370,0,-2,9,3,6,0,0,0,0,0,0,0,0,0,4,2,2,0,0,0,5,1,4,0,0,0,0,0,0,0,0,0
197197,37000,370,0,-2,2,0,2,0,0,0,0,0,0,0,0,0,0,0,0,0,0,0,2,0,2,0,0,0,0,0,0,0,0,0
197230,37000,370,0,-2,1,0,1,0,0,0,0,0,0,0,0,0,0,0,0,0,0,0,1,0,1,0,0,0,0,0,0,0,0,0
197294,37000,370,0,-2,7,1,6,0,0,0,0,0,0,2,1,1,3,0,3,0,0,0,2,0,2,0,0,0,0,0,0,0,0,0
197708,37000,370,0,-2,11,4,7,0,0,0,0,0,0,1,0,1,3,1,2,0,0,0,7,3,4,0,0,0,0,0,0,0,0,0
197814,37000,370,0,-2,2,1,1,0,0,0,0,0,0,1,0,1,1,1,0,0,0,0,0,0,0,0,0,0,0,0,0,0,0,0
197850,37000,370,0,-2,6,0,6,0,0,0,1,0,1,1,0,1,0,0,0,0,0,0,4,0,4,0,0,0,0,0,0,0,0,0
197869,37000,370,0,-2,50,12,38,0,0,0,1,0,1,4,1,3,0,0,0,1,0,1,39,10,29,1,0,1,4,1,3,0,0,0
197887,37000,370,0,-2,3,2,1,0,0,0,0,0,0,0,0,0,0,0,0,0,0,0,3,2,1,0,0,0,0,0,0,0,0,0
197911,37000,370,0,-2,3,0,3,0,0,0,0,0,0,0,0,0,1,0,1,0,0,0,1,0,1,0,0,0,1,0,1,0,0,0
197966,37000,370,0,-2,1,0,1,0,0,0,0,0,0,0,0,0,0,0,0,0,0,0,1,0,1,0,0,0,0,0,0,0,0,0
197984,37000,370,0,-2,11,3,8,0,0,0,0,0,0,0,0,0,0,0,0,0,0,0,11,3,8,0,0,0,0,0,0,0,0,0
197993,37000,370,0,-2,3,1,2,0,0,0,0,0,0,3,1,2,0,0,0,0,0,0,0,0,0,0,0,0,0,0,0,0,0,0
198011,37000,370,0,-2,3,2,1,0,0,0,0,0,0,0,0,0,1,1,0,0,0,0,2,1,1,0,0,0,0,0,0,0,0,0
198039,37000,370,0,-2,6,0,6,0,0,0,0,0,0,0,0,0,0,0,0,0,0,0,6,0,6,0,0,0,0,0,0,0,0,0
198066,37000,370,0,-2,13,6,7,0,0,0,0,0,0,1,0,1,1,1,0,0,0,0,11,5,6,0,0,0,0,0,0,0,0,0
198084,37000,370,0,-2,5,0,5,0,0,0,0,0,0,2,0,2,0,0,0,0,0,0,3,0,3,0,0,0,0,0,0,0,0,0
198118,37000,370,0,-2,9,2,7,0,0,0,0,0,0,1,0,1,0,0,0,0,0,0,8,2,6,0,0,0,0,0,0,0,0,0
198136,37000,370,0,-2,8,3,5,0,0,0,0,0,0,2,0,2,0,0,0,0,0,0,6,3,3,0,0,0,0,0,0,0,0,0
198154,37000,370,0,-2,8,0,8,0,0,0,0,0,0,0,0,0,1,0,1,0,0,0,7,0,7,0,0,0,0,0,0,0,0,0
198206,37000,370,0,-2,3,0,3,0,0,0,0,0,0,0,0,0,0,0,0,0,0,0,3,0,3,0,0,0,0,0,0,0,0,0
198215,37000,370,0,-2,6,4,2,0,0,0,0,0,0,1,0,1,0,0,0,0,0,0,5,4,1,0,0,0,0,0,0,0,0,0
198233,37000,370,0,-2,2,0,2,0,0,0,1,0,1,0,0,0,0,0,0,0,0,0,1,0,1,0,0,0,0,0,0,0,0,0
198251,37000,370,0,-2,3,0,3,0,0,0,0,0,0,1,0,1,0,0,0,0,0,0,2,0,2,0,0,0,0,0,0,0,0,0
198260,37000,370,0,-2,10,1,9,0,0,0,0,0,0,5,0,5,0,0,0,0,0,0,4,1,3,1,0,1,0,0,0,0,0,0
198321,37000,370,0,-2,3,1,2,0,0,0,0,0,0,1,1,0,0,0,0,0,0,0,2,0,2,0,0,0,0,0,0,0,0,0
198330,37000,370,0,-2,10,0,10,0,0,0,0,0,0,0,0,0,4,0,4,0,0,0,6,0,6,0,0,0,0,0,0,0,0,0
198367,37000,370,0,-2,2,0,2,0,0,0,0,0,0,0,0,0,1,0,1,0,0,0,1,0,1,0,0,0,0,0,0,0,0,0
198385,37000,370,0,-2,5,1,4,0,0,0,0,0,0,2,1,1,1,0,1,0,0,0,2,0,2,0,0,0,0,0,0,0,0,0
198419,37000,370,0,-2,71,28,43,1,1,0,3,2,1,20,8,12,7,3,4,0,0,0,35,13,22,3,1,2,0,0,0,2,0,2
198455,37000,370,0,-2,2,1,1,0,0,0,0,0,0,1,0,1,0,0,0,0,0,0,0,0,0,0,0,0,0,0,0,1,1,0
198464,37000,370,0,-2,77,11,66,0,0,0,0,0,0,24,4,20,26,4,22,0,0,0,23,2,21,3,1,2,0,0,0,1,0,1
198491,37000,370,0,-2,3,1,2,0,0,0,0,0,0,2,0,2,0,0,0,0,0,0,1,1,0,0,0,0,0,0,0,0,0,0
198507,37000,370,0,-2,4,0,4,0,0,0,0,0,0,4,0,4,0,0,0,0,0,0,0,0,0,0,0,0,0,0,0,0,0,0
198516,37000,370,0,-2,23,3,20,0,0,0,0,0,0,7,1,6,3,1,2,0,0,0,9,1,8,1,0,1,1,0,1,2,0,2
198534,37000,370,0,-2,17,4,13,0,0,0,0,0,0,6,2,4,1,1,0,0,0,0,10,1,9,0,0,0,0,0,0,0,0,0
198543,37000,370,0,-2,15,3,12,0,0,0,0,0,0,13,3,10,1,0,1,0,0,0,0,0,0,0,0,0,1,0,1,0,0,0
198552,37000,370,0,-2,3,1,2,0,0,0,0,0,0,1,1,0,0,0,0,0,0,0,2,0,2,0,0,0,0,0,0,0,0,0
198561,37000,370,0,-2,12,1,11,0,0,0,0,0,0,0,0,0,0,0,0,0,0,0,12,1,11,0,0,0,0,0,0,0,0,0
198570,37000,370,0,-2,4,0,4,0,0,0,0,0,0,0,0,0,0,0,0,0,0,0,4,0,4,0,0,0,0,0,0,0,0,0
198598,37000,370,0,-2,1,0,1,0,0,0,0,0,0,0,0,0,0,0,0,0,0,0,1,0,1,0,0,0,0,0,0,0,0,0
198613,37000,370,0,-2,4,0,4,0,0,0,0,0,0,3,0,3,0,0,0,0,0,0,1,0,1,0,0,0,0,0,0,0,0,0
198622,37000,370,0,-2,11,1,10,0,0,0,1,0,1,8,1,7,0,0,0,0,0,0,2,0,2,0,0,0,0,0,0,0,0,0
198640,37000,370,0,-2,3,0,3,1,0,1,0,0,0,2,0,2,0,0,0,0,0,0,0,0,0,0,0,0,0,0,0,0,0,0
198668,37000,370,0,-2,2,0,2,0,0,0,0,0,0,0,0,0,0,0,0,0,0,0,2,0,2,0,0,0,0,0,0,0,0,0
198695,37000,370,0,-2,16,5,11,0,0,0,1,0,1,4,1,3,0,0,0,0,0,0,11,4,7,0,0,0,0,0,0,0,0,0
198729,37000,370,0,-2,1,0,1,0,0,0,0,0,0,0,0,0,0,0,0,0,0,0,1,0,1,0,0,0,0,0,0,0,0,0
198756,37000,370,0,-2,3,0,3,0,0,0,0,0,0,2,0,2,0,0,0,0,0,0,1,0,1,0,0,0,0,0,0,0,0,0
198774,37000,370,0,-2,7,2,5,0,0,0,0,0,0,1,0,1,1,0,1,0,0,0,5,2,3,0,0,0,0,0,0,0,0,0
198808,37000,370,0,-2,2,1,1,0,0,0,0,0,0,0,0,0,0,0,0,0,0,0,2,1,1,0,0,0,0,0,0,0,0,0
198817,37000,370,0,-2,7,1,6,0,0,0,0,0,0,2,0,2,2,0,2,0,0,0,3,1,2,0,0,0,0,0,0,0,0,0
198835,37000,370,0,-2,2,0,2,0,0,0,0,0,0,0,0,0,0,0,0,0,0,0,2,0,2,0,0,0,0,0,0,0,0,0
198862,37000,370,0,-2,6,1,5,0,0,0,0,0,0,6,1,5,0,0,0,0,0,0,0,0,0,0,0,0,0,0,0,0,0,0
198871,37000,370,0,-2,4,1,3,0,0,0,0,0,0,0,0,0,0,0,0,0,0,0,4,1,3,0,0,0,0,0,0,0,0,0
198899,37000,370,0,-2,2,0,2,0,0,0,0,0,0,0,0,0,0,0,0,0,0,0,2,0,2,0,0,0,0,0,0,0,0,0
198905,37000,370,0,-2,1,0,1,0,0,0,0,0,0,0,0,0,0,0,0,0,0,0,1,0,1,0,0,0,0,0,0,0,0,0
198914,37000,370,0,-2,2,0,2,0,0,0,0,0,0,0,0,0,0,0,0,0,0,0,2,0,2,0,0,0,0,0,0,0,0,0
198950,37000,370,0,-2,9,0,9,0,0,0,0,0,0,1,0,1,1,0,1,0,0,0,7,0,7,0,0,0,0,0,0,0,0,0
198969,37000,370,0,-2,6,0,6,0,0,0,0,0,0,1,0,1,0,0,0,0,0,0,4,0,4,1,0,1,0,0,0,0,0,0
198978,37000,370,0,-2,1,0,1,0,0,0,0,0,0,1,0,1,0,0,0,0,0,0,0,0,0,0,0,0,0,0,0,0,0,0
199023,37000,370,0,-2,1,0,1,0,0,0,0,0,0,0,0,0,0,0,0,0,0,0,1,0,1,0,0,0,0,0,0,0,0,0
199032,37000,370,0,-2,5,0,5,0,0,0,0,0,0,1,0,1,0,0,0,0,0,0,4,0,4,0,0,0,0,0,0,0,0,0
199069,37000,370,0,-2,1,0,1,0,0,0,0,0,0,0,0,0,0,0,0,0,0,0,1,0,1,0,0,0,0,0,0,0,0,0
199087,37000,370,0,-2,8,0,8,0,0,0,0,0,0,3,0,3,0,0,0,0,0,0,5,0,5,0,0,0,0,0,0,0,0,0
199102,37000,370,0,-2,15,3,12,0,0,0,0,0,0,8,0,8,1,1,0,0,0,0,0,0,0,1,1,0,5,1,4,0,0,0
199111,37000,370,0,-2,13,1,12,0,0,0,0,0,0,1,0,1,0,0,0,0,0,0,11,1,10,1,0,1,0,0,0,0,0,0
199120,37000,370,0,-2,183,40,143,0,0,0,8,3,5,30,7,23,12,3,9,0,0,0,62,9,53,11,3,8,60,15,45,0,0,0
199139,37000,370,0,-2,57,14,43,1,1,0,1,0,1,21,3,18,4,1,3,1,0,1,28,9,19,1,0,1,0,0,0,0,0,0
199148,37000,370,0,-2,19,4,15,0,0,0,2,0,2,6,2,4,1,0,1,0,0,0,10,2,8,0,0,0,0,0,0,0,0,0
199157,37000,370,0,-2,29,8,21,0,0,0,2,0,2,14,4,10,2,0,2,0,0,0,1,1,0,1,1,0,8,2,6,1,0,1
199175,37000,370,0,-2,10,4,6,0,0,0,0,0,0,5,2,3,0,0,0,0,0,0,5,2,3,0,0,0,0,0,0,0,0,0
199184,37000,370,0,-2,6,1,5,0,0,0,0,0,0,2,1,1,0,0,0,0,0,0,3,0,3,0,0,0,1,0,1,0,0,0
199193,37000,370,0,-2,160,31,129,0,0,0,2,0,2,36,6,30,15,5,10,0,0,0,104,18,86,1,1,0,2,1,1,0,0,0
199218,37000,370,0,-2,56,9,47,0,0,0,2,0,2,3,0,3,3,0,3,0,0,0,43,9,34,0,0,0,4,0,4,1,0,1
199272,37000,370,0,-2,3,1,2,0,0,0,0,0,0,0,0,0,0,0,0,0,0,0,2,0,2,0,0,0,1,1,0,0,0,0
199281,37000,370,0,-2,17,5,12,6,0,6,0,0,0,4,2,2,0,0,0,0,0,0,6,3,3,1,0,1,0,0,0,0,0,0
199306,37000,370,0,-2,2,0,2,0,0,0,0,0,0,0,0,0,0,0,0,0,0,0,2,0,2,0,0,0,0,0,0,0,0,0
199324,37000,370,0,-2,6,0,6,0,0,0,0,0,0,1,0,1,0,0,0,0,0,0,5,0,5,0,0,0,0,0,0,0,0,0
199333,37000,370,0,-2,2,0,2,0,0,0,0,0,0,0,0,0,0,0,0,0,0,0,2,0,2,0,0,0,0,0,0,0,0,0
199412,37000,370,0,-2,15,1,14,0,0,0,0,0,0,4,0,4,0,0,0,0,0,0,11,1,10,0,0,0,0,0,0,0,0,0
199421,37000,370,0,-2,4,1,3,0,0,0,0,0,0,0,0,0,0,0,0,0,0,0,2,1,1,0,0,0,2,0,2,0,0,0
199449,37000,370,0,-2,4,0,4,0,0,0,0,0,0,0,0,0,0,0,0,0,0,0,4,0,4,0,0,0,0,0,0,0,0,0
199467,37000,370,0,-2,1,0,1,0,0,0,0,0,0,0,0,0,0,0,0,0,0,0,1,0,1,0,0,0,0,0,0,0,0,0
199476,37000,370,0,-2,2,0,2,0,0,0,0,0,0,0,0,0,0,0,0,0,0,0,2,0,2,0,0,0,0,0,0,0,0,0
199485,37000,370,0,-2,1,0,1,0,0,0,0,0,0,1,0,1,0,0,0,0,0,0,0,0,0,0,0,0,0,0,0,0,0,0
199494,37000,370,0,-2,5,1,4,0,0,0,0,0,0,1,0,1,0,0,0,0,0,0,4,1,3,0,0,0,0,0,0,0,0,0
199607,37000,370,0,-2,3,2,1,0,0,0,0,0,0,0,0,0,0,0,0,0,0,0,3,2,1,0,0,0,0,0,0,0,0,0
199625,37000,370,0,-2,1,0,1,0,0,0,0,0,0,0,0,0,0,0,0,0,0,0,1,0,1,0,0,0,0,0,0,0,0,0
199634,37000,370,0,-2,1,1,0,0,0,0,0,0,0,1,1,0,0,0,0,0,0,0,0,0,0,0,0,0,0,0,0,0,0,0
199643,37000,370,0,-2,3,0,3,0,0,0,0,0,0,3,0,3,0,0,0,0,0,0,0,0,0,0,0,0,0,0,0,0,0,0
199698,37000,370,0,-2,9,4,5,0,0,0,0,0,0,4,0,4,1,1,0,0,0,0,4,3,1,0,0,0,0,0,0,0,0,0
199722,37000,370,0,-2,2,0,2,0,0,0,0,0,0,1,0,1,0,0,0,0,0,0,1,0,1,0,0,0,0,0,0,0,0,0
199731,37000,370,0,-2,3,0,3,0,0,0,0,0,0,0,0,0,0,0,0,0,0,0,3,0,3,0,0,0,0,0,0,0,0,0
199740,37000,370,0,-2,2,0,2,0,0,0,0,0,0,0,0,0,0,0,0,0,0,0,2,0,2,0,0,0,0,0,0,0,0,0
199759,37000,370,0,-2,8,5,3,0,0,0,0,0,0,0,0,0,0,0,0,0,0,0,8,5,3,0,0,0,0,0,0,0,0,0
199768,37000,370,0,-2,1,0,1,0,0,0,0,0,0,0,0,0,0,0,0,0,0,0,1,0,1,0,0,0,0,0,0,0,0,0
199786,37000,370,0,-2,7,0,7,0,0,0,0,0,0,1,0,1,2,0,2,0,0,0,4,0,4,0,0,0,0,0,0,0,0,0
199795,37000,370,0,-2,2,0,2,0,0,0,0,0,0,0,0,0,0,0,0,0,0,0,2,0,2,0,0,0,0,0,0,0,0,0
199847,37000,370,0,-2,133,24,109,0,0,0,3,1,2,29,1,28,16,3,13,0,0,0,80,18,62,3,1,2,0,0,0,2,0,2
199856,37000,370,0,-2,16,1,15,0,0,0,0,0,0,3,0,3,1,0,1,0,0,0,8,1,7,0,0,0,4,0,4,0,0,0
199865,37000,370,0,-2,6,2,4,0,0,0,0,0,0,1,0,1,0,0,0,0,0,0,5,2,3,0,0,0,0,0,0,0,0,0
199892,37000,370,0,-2,6,1,5,0,0,0,0,0,0,2,0,2,0,0,0,0,0,0,4,1,3,0,0,0,0,0,0,0,0,0
199926,37000,370,0,-2,4,0,4,0,0,0,0,0,0,0,0,0,0,0,0,0,0,0,4,0,4,0,0,0,0,0,0,0,0,0
199953,37000,370,0,-2,1,0,1,0,0,0,0,0,0,0,0,0,0,0,0,0,0,0,1,0,1,0,0,0,0,0,0,0,0,0
199962,37000,370,0,-2,2,0,2,0,0,0,0,0,0,1,0,1,0,0,0,0,0,0,1,0,1,0,0,0,0,0,0,0,0,0
199999,37000,370,0,-2,13,4,9,0,0,0,1,0,1,7,3,4,0,0,0,0,0,0,1,1,0,0,0,0,4,0,4,0,0,0
200004,37000,370,0,-2,22,4,18,0,0,0,0,0,0,0,0,0,2,0,2,0,0,0,19,4,15,1,0,1,0,0,0,0,0,0
200022,37000,370,0,-2,5,2,3,0,0,0,0,0,0,0,0,0,0,0,0,0,0,0,5,2,3,0,0,0,0,0,0,0,0,0
200059,37000,370,0,-2,1,0,1,0,0,0,0,0,0,0,0,0,0,0,0,0,0,0,1,0,1,0,0,0,0,0,0,0,0,0
200156,37000,370,0,-2,7,1,6,0,0,0,0,0,0,0,0,0,0,0,0,0,0,0,7,1,6,0,0,0,0,0,0,0,0,0
200192,37000,370,0,-2,7,2,5,0,0,0,0,0,0,0,0,0,0,0,0,0,0,0,7,2,5,0,0,0,0,0,0,0,0,0
200208,37000,370,0,-2,2,0,2,2,0,2,0,0,0,0,0,0,0,0,0,0,0,0,0,0,0,0,0,0,0,0,0,0,0,0
200217,37000,370,0,-2,12,2,10,0,0,0,0,0,0,0,0,0,2,1,1,0,0,0,10,1,9,0,0,0,0,0,0,0,0,0
200253,37000,370,0,-2,4,0,4,0,0,0,0,0,0,0,0,0,0,0,0,0,0,0,4,0,4,0,0,0,0,0,0,0,0,0
200280,37000,370,0,-2,32,2,30,0,0,0,3,0,3,0,0,0,1,0,1,0,0,0,25,2,23,2,0,2,0,0,0,1,0,1
200305,37000,370,0,-2,7,0,7,0,0,0,0,0,0,0,0,0,0,0,0,0,0,0,7,0,7,0,0,0,0,0,0,0,0,0
200314,37000,370,0,-2,2,0,2,1,0,1,0,0,0,0,0,0,0,0,0,0,0,0,1,0,1,0,0,0,0,0,0,0,0,0
200332,37000,370,0,-2,22,1,21,0,0,0,0,0,0,0,0,0,1,0,1,0,0,0,21,1,20,0,0,0,0,0,0,0,0,0
200341,37000,370,0,-2,6,0,6,0,0,0,0,0,0,0,0,0,0,0,0,0,0,0,5,0,5,1,0,1,0,0,0,0,0,0
200527,37000,370,0,-2,2,1,1,2,1,1,0,0,0,0,0,0,0,0,0,0,0,0,0,0,0,0,0,0,0,0,0,0,0,0
200554,37000,370,0,-2,4,1,3,3,1,2,0,0,0,0,0,0,0,0,0,0,0,0,0,0,0,0,0,0,1,0,1,0,0,0
200572,37000,370,0,-2,3,0,3,0,0,0,0,0,0,0,0,0,0,0,0,0,0,0,3,0,3,0,0,0,0,0,0,0,0,0
200785,37000,370,0,-2,1,0,1,0,0,0,0,0,0,0,0,0,0,0,0,0,0,0,1,0,1,0,0,0,0,0,0,0,0,0
200800,37000,370,0,-2,13,3,10,0,0,0,0,0,0,2,0,2,0,0,0,0,0,0,11,3,8,0,0,0,0,0,0,0,0,0
201061,37000,370,0,-2,1,0,1,0,0,0,0,0,0,0,0,0,0,0,0,0,0,0,1,0,1,0,0,0,0,0,0,0,0,0
201104,37000,370,0,-2,17,3,14,0,0,0,0,0,0,0,0,0,1,1,0,0,0,0,16,2,14,0,0,0,0,0,0,0,0,0
201140,37000,370,0,-2,3,2,1,0,0,0,0,0,0,1,1,0,0,0,0,0,0,0,2,1,1,0,0,0,0,0,0,0,0,0
201195,37000,370,0,-2,7,0,7,0,0,0,0,0,0,1,0,1,0,0,0,0,0,0,5,0,5,1,0,1,0,0,0,0,0,0
201283,37000,370,0,-2,1,0,1,0,0,0,0,0,0,0,0,0,0,0,0,0,0,0,1,0,1,0,0,0,0,0,0,0,0,0
201371,37000,370,0,-2,2,0,2,0,0,0,0,0,0,0,0,0,0,0,0,0,0,0,2,0,2,0,0,0,0,0,0,0,0,0
201441,37000,370,0,-2,7,2,5,0,0,0,0,0,0,0,0,0,1,0,1,0,0,0,6,2,4,0,0,0,0,0,0,0,0,0
201469,37000,370,0,-2,4,1,3,0,0,0,0,0,0,0,0,0,1,0,1,0,0,0,3,1,2,0,0,0,0,0,0,0,0,0
201548,37000,370,0,-2,6,2,4,0,0,0,0,0,0,0,0,0,0,0,0,0,0,0,5,2,3,0,0,0,1,0,1,0,0,0
201645,37000,370,0,-2,47,7,40,0,0,0,3,0,3,13,1,12,1,0,1,0,0,0,30,6,24,0,0,0,0,0,0,0,0,0
201654,37000,370,0,-2,12,4,8,0,0,0,0,0,0,0,0,0,0,0,0,0,0,0,12,4,8,0,0,0,0,0,0,0,0,0
201672,37000,370,0,-2,2,1,1,0,0,0,0,0,0,0,0,0,0,0,0,0,0,0,2,1,1,0,0,0,0,0,0,0,0,0
201690,37000,370,0,-2,9,0,9,0,0,0,0,0,0,5,0,5,0,0,0,0,0,0,3,0,3,0,0,0,1,0,1,0,0,0
201751,37000,370,0,-2,3,0,3,0,0,0,0,0,0,0,0,0,0,0,0,0,0,0,3,0,3,0,0,0,0,0,0,0,0,0
201821,37000,370,0,-2,1,0,1,0,0,0,0,0,0,1,0,1,0,0,0,0,0,0,0,0,0,0,0,0,0,0,0,0,0,0
201885,37000,370,0,-2,27,8,19,0,0,0,0,0,0,4,1,3,1,1,0,0,0,0,19,6,13,2,0,2,1,0,1,0,0,0
201928,37000,370,0,-2,2,0,2,0,0,0,0,0,0,1,0,1,0,0,0,0,0,0,1,0,1,0,0,0,0,0,0,0,0,0
201964,37000,370,0,-2,3,1,2,0,0,0,0,0,0,0,0,0,0,0,0,0,0,0,3,1,2,0,0,0,0,0,0,0,0,0
201973,37000,370,0,-2,5,2,3,0,0,0,0,0,0,2,0,2,0,0,0,0,0,0,2,1,1,0,0,0,1,1,0,0,0,0
202046,37000,370,0,-2,1,0,1,0,0,0,0,0,0,1,0,1,0,0,0,0,0,0,0,0,0,0,0,0,0,0,0,0,0,0
202073,37000,370,0,-2,1,0,1,0,0,0,1,0,1,0,0,0,0,0,0,0,0,0,0,0,0,0,0,0,0,0,0,0,0,0
202134,37000,370,0,-2,15,4,11,0,0,0,0,0,0,4,0,4,1,0,1,0,0,0,10,4,6,0,0,0,0,0,0,0,0,0
202222,37000,370,0,-2,8,2,6,0,0,0,0,0,0,2,0,2,2,0,2,1,0,1,3,2,1,0,0,0,0,0,0,0,0,0
202356,37000,370,0,-2,14,3,11,0,0,0,0,0,0,3,1,2,1,0,1,0,0,0,9,2,7,0,0,0,0,0,0,1,0,1
202480,37000,370,0,-2,28,3,25,0,0,0,1,0,1,3,1,2,1,0,1,0,0,0,19,2,17,2,0,2,2,0,2,0,0,0
202514,37000,370,0,-2,3,0,3,0,0,0,0,0,0,0,0,0,0,0,0,0,0,0,3,0,3,0,0,0,0,0,0,0,0,0
202523,37000,370,0,-2,8,1,7,0,0,0,1,1,0,1,0,1,1,0,1,0,0,0,5,0,5,0,0,0,0,0,0,0,0,0
202648,37000,370,0,-2,2,0,2,0,0,0,0,0,0,0,0,0,1,0,1,0,0,0,0,0,0,0,0,0,1,0,1,0,0,0
202763,37000,370,0,-2,7,0,7,0,0,0,1,0,1,0,0,0,0,0,0,0,0,0,6,0,6,0,0,0,0,0,0,0,0,0
202806,37000,370,0,-2,7,0,7,0,0,0,0,0,0,0,0,0,0,0,0,0,0,0,7,0,7,0,0,0,0,0,0,0,0,0
202903,37000,370,0,-2,1,1,0,0,0,0,0,0,0,0,0,0,0,0,0,0,0,0,1,1,0,0,0,0,0,0,0,0,0,0
203085,37000,370,0,-2,4,0,4,0,0,0,0,0,0,0,0,0,0,0,0,0,0,0,4,0,4,0,0,0,0,0,0,0,0,0
203128,37000,370,0,-2,2,0,2,0,0,0,0,0,0,0,0,0,0,0,0,0,0,0,2,0,2,0,0,0,0,0,0,0,0,0
203155,37000,370,0,-2,2,0,2,0,0,0,0,0,0,1,0,1,0,0,0,0,0,0,1,0,1,0,0,0,0,0,0,0,0,0
203368,37000,370,0,-2,5,0,5,0,0,0,0,0,0,0,0,0,1,0,1,0,0,0,4,0,4,0,0,0,0,0,0,0,0,0
203386,37000,370,0,-2,9,4,5,0,0,0,0,0,0,1,0,1,0,0,0,0,0,0,8,4,4,0,0,0,0,0,0,0,0,0
203474,37000,370,0,-2,1,0,1,0,0,0,0,0,0,0,0,0,0,0,0,0,0,0,1,0,1,0,0,0,0,0,0,0,0,0
203517,37000,370,0,-2,27,7,20,0,0,0,1,0,1,1,1,0,0,0,0,0,0,0,23,5,18,1,0,1,1,1,0,0,0,0
203526,37000,370,0,-2,1,1,0,0,0,0,0,0,0,0,0,0,0,0,0,0,0,0,1,1,0,0,0,0,0,0,0,0,0,0
203535,37000,370,0,-2,8,0,8,0,0,0,0,0,0,0,0,0,0,0,0,0,0,0,8,0,8,0,0,0,0,0,0,0,0,0
203599,37000,370,0,-2,5,0,5,0,0,0,0,0,0,0,0,0,0,0,0,0,0,0,5,0,5,0,0,0,0,0,0,0,0,0
203678,37000,370,0,-2,3,0,3,0,0,0,0,0,0,0,0,0,0,0,0,0,0,0,3,0,3,0,0,0,0,0,0,0,0,0
203720,37000,370,0,-2,1,0,1,0,0,0,0,0,0,0,0,0,1,0,1,0,0,0,0,0,0,0,0,0,0,0,0,0,0,0
203748,37000,370,0,-2,3,1,2,0,0,0,0,0,0,0,0,0,0,0,0,0,0,0,3,1,2,0,0,0,0,0,0,0,0,0
203757,37000,370,0,-2,2,0,2,0,0,0,0,0,0,0,0,0,0,0,0,0,0,0,2,0,2,0,0,0,0,0,0,0,0,0
203775,37000,370,0,-2,9,0,9,0,0,0,0,0,0,0,0,0,0,0,0,0,0,0,7,0,7,2,0,2,0,0,0,0,0,0
203845,37000,370,0,-2,3,0,3,0,0,0,0,0,0,0,0,0,0,0,0,0,0,0,3,0,3,0,0,0,0,0,0,0,0,0
203881,37000,370,0,-2,4,1,3,0,0,0,0,0,0,0,0,0,0,0,0,0,0,0,4,1,3,0,0,0,0,0,0,0,0,0
203960,37000,370,0,-2,1,0,1,0,0,0,0,0,0,0,0,0,0,0,0,0,0,0,1,0,1,0,0,0,0,0,0,0,0,0
204015,37000,370,0,-2,2,1,1,0,0,0,0,0,0,0,0,0,0,0,0,0,0,0,2,1,1,0,0,0,0,0,0,0,0,0
204024,37000,370,0,-2,10,4,6,0,0,0,0,0,0,0,0,0,0,0,0,0,0,0,10,4,6,0,0,0,0,0,0,0,0,0
204185,37000,370,0,-2,4,1,3,0,0,0,1,0,1,0,0,0,1,0,1,0,0,0,2,1,1,0,0,0,0,0,0,0,0,0
204194,37000,370,0,-2,6,2,4,0,0,0,0,0,0,0,0,0,0,0,0,0,0,0,6,2,4,0,0,0,0,0,0,0,0,0
204200,37000,370,0,-2,6,2,4,0,0,0,0,0,0,1,1,0,0,0,0,0,0,0,5,1,4,0,0,0,0,0,0,0,0,0
204264,37000,370,0,-2,1,0,1,0,0,0,0,0,0,0,0,0,0,0,0,0,0,0,1,0,1,0,0,0,0,0,0,0,0,0
204422,37000,370,0,-2,3,0,3,0,0,0,0,0,0,0,0,0,0,0,0,0,0,0,2,0,2,0,0,0,1,0,1,0,0,0
204440,37000,370,0,-2,4,0,4,0,0,0,0,0,0,0,0,0,0,0,0,0,0,0,4,0,4,0,0,0,0,0,0,0,0,0
204468,37000,370,0,-2,3,2,1,0,0,0,0,0,0,2,2,0,0,0,0,0,0,0,1,0,1,0,0,0,0,0,0,0,0,0
204477,37000,370,0,-2,11,2,9,0,0,0,0,0,0,0,0,0,0,0,0,0,0,0,10,1,9,0,0,0,1,1,0,0,0,0
204501,37000,370,0,-2,96,7,89,0,0,0,1,0,1,2,0,2,3,0,3,0,0,0,86,7,79,0,0,0,2,0,2,2,0,2
204617,37000,370,0,-2,3,1,2,0,0,0,0,0,0,1,1,0,0,0,0,0,0,0,2,0,2,0,0,0,0,0,0,0,0,0
204635,37000,370,0,-2,5,0,5,0,0,0,0,0,0,0,0,0,0,0,0,0,0,0,4,0,4,1,0,1,0,0,0,0,0,0
204662,37000,370,0,-2,1,0,1,0,0,0,0,0,0,0,0,0,0,0,0,0,0,0,1,0,1,0,0,0,0,0,0,0,0,0
204680,37000,370,0,-2,1,0,1,0,0,0,0,0,0,0,0,0,0,0,0,0,0,0,1,0,1,0,0,0,0,0,0,0,0,0
204705,37000,370,0,-2,3,0,3,0,0,0,0,0,0,0,0,0,0,0,0,0,0,0,3,0,3,0,0,0,0,0,0,0,0,0
204796,37000,370,0,-2,354,80,274,0,0,0,5,2,3,52,10,42,14,4,10,1,0,1,248,58,190,10,4,6,21,1,20,3,1,2
204857,37000,370,0,-2,5,0,5,0,0,0,0,0,0,0,0,0,0,0,0,0,0,0,5,0,5,0,0,0,0,0,0,0,0,0
204909,37000,370,0,-2,4,0,4,0,0,0,0,0,0,0,0,0,0,0,0,0,0,0,4,0,4,0,0,0,0,0,0,0,0,0
204936,37000,370,0,-2,4,1,3,0,0,0,0,0,0,1,0,1,0,0,0,0,0,0,3,1,2,0,0,0,0,0,0,0,0,0
204945,37000,370,0,-2,19,4,15,0,0,0,0,0,0,2,1,1,0,0,0,0,0,0,17,3,14,0,0,0,0,0,0,0,0,0
204990,37000,370,0,-2,1,1,0,0,0,0,0,0,0,1,1,0,0,0,0,0,0,0,0,0,0,0,0,0,0,0,0,0,0,0
205054,37000,370,0,-2,1,0,1,0,0,0,0,0,0,1,0,1,0,0,0,0,0,0,0,0,0,0,0,0,0,0,0,0,0,0
205179,37000,370,0,-2,3,0,3,0,0,0,0,0,0,0,0,0,1,0,1,0,0,0,2,0,2,0,0,0,0,0,0,0,0,0
205203,37000,370,0,-2,4,1,3,0,0,0,0,0,0,0,0,0,0,0,0,0,0,0,3,1,2,1,0,1,0,0,0,0,0,0
205391,37000,370,0,-2,1,0,1,0,0,0,0,0,0,0,0,0,0,0,0,0,0,0,1,0,1,0,0,0,0,0,0,0,0,0
205443,37000,370,0,-2,2,0,2,0,0,0,0,0,0,0,0,0,0,0,0,0,0,0,2,0,2,0,0,0,0,0,0,0,0,0
205470,37000,370,0,-2,14,3,11,0,0,0,1,0,1,3,1,2,0,0,0,0,0,0,10,2,8,0,0,0,0,0,0,0,0,0
205841,37000,370,0,-2,1,0,1,0,0,0,0,0,0,0,0,0,0,0,0,0,0,0,1,0,1,0,0,0,0,0,0,0,0,0
205887,37000,370,0,-2,4,0,4,0,0,0,0,0,0,0,0,0,1,0,1,0,0,0,3,0,3,0,0,0,0,0,0,0,0,0
205957,37000,370,0,-2,2,0,2,0,0,0,0,0,0,0,0,0,0,0,0,0,0,0,2,0,2,0,0,0,0,0,0,0,0,0
205966,37000,370,0,-2,3,0,3,0,0,0,0,0,0,0,0,0,0,0,0,0,0,0,3,0,3,0,0,0,0,0,0,0,0,0
206011,37000,370,0,-2,2,0,2,0,0,0,0,0,0,0,0,0,0,0,0,0,0,0,2,0,2,0,0,0,0,0,0,0,0,0
206084,37000,370,0,-2,67,13,54,0,0,0,0,0,0,19,4,15,7,3,4,0,0,0,41,6,35,0,0,0,0,0,0,0,0,0
206279,37000,370,0,-2,1,0,1,0,0,0,0,0,0,0,0,0,0,0,0,0,0,0,1,0,1,0,0,0,0,0,0,0,0,0
206288,37000,370,0,-2,2,0,2,0,0,0,1,0,1,0,0,0,0,0,0,0,0,0,1,0,1,0,0,0,0,0,0,0,0,0
206349,37000,370,0,-2,1,0,1,0,0,0,0,0,0,0,0,0,0,0,0,0,0,0,1,0,1,0,0,0,0,0,0,0,0,0
206437,37000,370,0,-2,3,0,3,0,0,0,0,0,0,0,0,0,0,0,0,0,0,0,3,0,3,0,0,0,0,0,0,0,0,0
206446,37000,370,0,-2,4,1,3,0,0,0,0,0,0,0,0,0,0,0,0,0,0,0,4,1,3,0,0,0,0,0,0,0,0,0
206507,37000,370,0,-2,3,0,3,0,0,0,0,0,0,0,0,0,0,0,0,0,0,0,2,0,2,1,0,1,0,0,0,0,0,0
206525,37000,370,0,-2,10,4,6,0,0,0,0,0,0,1,0,1,0,0,0,0,0,0,8,3,5,1,1,0,0,0,0,0,0,0
206589,37000,370,0,-2,5,0,5,0,0,0,0,0,0,1,0,1,0,0,0,0,0,0,4,0,4,0,0,0,0,0,0,0,0,0
206604,37000,370,0,-2,11,1,10,0,0,0,0,0,0,2,1,1,1,0,1,0,0,0,8,0,8,0,0,0,0,0,0,0,0,0
206622,37000,370,0,-2,16,3,13,0,0,0,0,0,0,6,1,5,0,0,0,0,0,0,8,1,7,1,1,0,1,0,1,0,0,0
206695,37000,370,0,-2,14,6,8,0,0,0,0,0,0,2,1,1,1,1,0,0,0,0,11,4,7,0,0,0,0,0,0,0,0,0
206835,37000,370,0,-2,3,0,3,0,0,0,0,0,0,0,0,0,0,0,0,0,0,0,1,0,1,1,0,1,1,0,1,0,0,0
206862,37000,370,0,-2,5,0,5,0,0,0,0,0,0,0,0,0,0,0,0,0,0,0,5,0,5,0,0,0,0,0,0,0,0,0
206914,37000,370,0,-2,19,3,16,0,0,0,1,0,1,2,1,1,4,1,3,0,0,0,8,1,7,4,0,4,0,0,0,0,0,0
206932,37000,370,0,-2,1,0,1,0,0,0,1,0,1,0,0,0,0,0,0,0,0,0,0,0,0,0,0,0,0,0,0,0,0,0
206941,37000,370,0,-2,69,16,53,2,0,2,1,0,1,10,2,8,2,1,1,0,0,0,29,7,22,0,0,0,24,5,19,1,1,0
206996,37000,370,0,-2,5,1,4,1,0,1,0,0,0,0,0,0,0,0,0,0,0,0,4,1,3,0,0,0,0,0,0,0,0,0
207041,37000,370,0,-2,12,3,9,1,1,0,0,0,0,0,0,0,1,0,1,0,0,0,8,2,6,0,0,0,2,0,2,0,0,0
207050,37000,370,0,-2,3,1,2,1,0,1,0,0,0,0,0,0,1,1,0,0,0,0,0,0,0,1,0,1,0,0,0,0,0,0
207157,37000,370,0,-2,1,1,0,0,0,0,0,0,0,0,0,0,0,0,0,0,0,0,1,1,0,0,0,0,0,0,0,0,0,0
207209,37000,370,0,-2,11,2,9,0,0,0,0,0,0,7,2,5,0,0,0,0,0,0,4,0,4,0,0,0,0,0,0,0,0,0
207236,37000,370,0,-2,3,0,3,1,0,1,0,0,0,0,0,0,1,0,1,0,0,0,1,0,1,0,0,0,0,0,0,0,0,0
207254,37000,370,0,-2,1,0,1,0,0,0,0,0,0,1,0,1,0,0,0,0,0,0,0,0,0,0,0,0,0,0,0,0,0,0
207263,37000,370,0,-2,34,3,31,7,0,7,2,0,2,1,1,0,4,1,3,0,0,0,14,1,13,6,0,6,0,0,0,0,0,0
207281,37000,370,0,-2,6,0,6,0,0,0,0,0,0,0,0,0,0,0,0,0,0,0,6,0,6,0,0,0,0,0,0,0,0,0
207290,37000,370,0,-2,15,4,11,2,1,1,0,0,0,0,0,0,1,0,1,0,0,0,10,2,8,2,1,1,0,0,0,0,0,0
207306,37000,370,0,-2,1,0,1,0,0,0,0,0,0,0,0,0,0,0,0,0,0,0,1,0,1,0,0,0,0,0,0,0,0,0
207315,37000,370,0,-2,22,5,17,0,0,0,0,0,0,0,0,0,0,0,0,0,0,0,22,5,17,0,0,0,0,0,0,0,0,0
207324,37000,370,0,-2,4,0,4,0,0,0,0,0,0,0,0,0,0,0,0,0,0,0,3,0,3,0,0,0,1,0,1,0,0,0
207342,37000,370,0,-2,53,10,43,5,1,4,2,0,2,5,1,4,14,1,13,1,0,1,21,5,16,3,2,1,0,0,0,2,0,2
207351,37000,370,0,-2,6,2,4,0,0,0,0,0,0,0,0,0,2,2,0,0,0,0,4,0,4,0,0,0,0,0,0,0,0,0
207388,37000,370,0,-2,152,32,120,8,2,6,5,0,5,6,3,3,13,2,11,0,0,0,110,23,87,7,1,6,1,0,1,2,1,1
207397,37000,370,0,-2,14,6,8,0,0,0,0,0,0,0,0,0,1,1,0,0,0,0,12,4,8,1,1,0,0,0,0,0,0,0
207403,37000,370,0,-2,6,2,4,0,0,0,0,0,0,0,0,0,0,0,0,0,0,0,5,2,3,1,0,1,0,0,0,0,0,0
207449,37000,370,0,-2,15,2,13,2,0,2,0,0,0,3,0,3,0,0,0,0,0,0,8,2,6,1,0,1,1,0,1,0,0,0
207458,37000,370,0,-2,14,1,13,0,0,0,1,0,1,1,1,0,0,0,0,0,0,0,11,0,11,1,0,1,0,0,0,0,0,0
207500,37000,370,0,-2,76,16,60,1,1,0,0,0,0,5,3,2,5,1,4,0,0,0,56,6,50,8,5,3,0,0,0,1,0,1
207564,37000,370,0,-2,10,0,10,1,0,1,0,0,0,2,0,2,0,0,0,0,0,0,7,0,7,0,0,0,0,0,0,0,0,0
207582,37000,370,0,-2,15,1,14,0,0,0,0,0,0,2,0,2,1,0,1,0,0,0,10,0,10,1,1,0,0,0,0,1,0,1
207661,37000,370,0,-2,7,3,4,3,1,2,0,0,0,0,0,0,0,0,0,0,0,0,4,2,2,0,0,0,0,0,0,0,0,0
207670,37000,370,0,-2,5,2,3,2,2,0,0,0,0,1,0,1,0,0,0,0,0,0,2,0,2,0,0,0,0,0,0,0,0,0
207722,37000,370,0,-2,2,0,2,0,0,0,0,0,0,0,0,0,0,0,0,0,0,0,2,0,2,0,0,0,0,0,0,0,0,0
207740,37000,370,0,-2,5,0,5,0,0,0,0,0,0,0,0,0,1,0,1,0,0,0,4,0,4,0,0,0,0,0,0,0,0,0
207847,37000,370,0,-2,4,0,4,1,0,1,0,0,0,0,0,0,0,0,0,0,0,0,3,0,3,0,0,0,0,0,0,0,0,0
207865,37000,370,0,-2,15,1,14,0,0,0,0,0,0,0,0,0,2,0,2,0,0,0,12,1,11,1,0,1,0,0,0,0,0,0
207935,37000,370,0,-2,18,4,14,0,0,0,2,1,1,1,0,1,0,0,0,0,0,0,11,0,11,4,3,1,0,0,0,0,0,0
207962,37000,370,0,-2,3,0,3,0,0,0,1,0,1,0,0,0,1,0,1,0,0,0,1,0,1,0,0,0,0,0,0,0,0,0
207971,37000,370,0,-2,20,4,16,3,0,3,0,0,0,0,0,0,1,0,1,0,0,0,15,3,12,1,1,0,0,0,0,0,0,0
208035,37000,370,0,-2,1,0,1,0,0,0,0,0,0,0,0,0,1,0,1,0,0,0,0,0,0,0,0,0,0,0,0,0,0,0
208318,37000,370,0,-2,2,1,1,0,0,0,0,0,0,0,0,0,0,0,0,0,0,0,2,1,1,0,0,0,0,0,0,0,0,0
208390,37000,370,0,-2,16,3,13,0,0,0,0,0,0,0,0,0,5,1,4,0,0,0,8,2,6,1,0,1,1,0,1,1,0,1
208406,37000,370,0,-2,7,0,7,1,0,1,0,0,0,0,0,0,0,0,0,0,0,0,6,0,6,0,0,0,0,0,0,0,0,0
208479,37000,370,0,-2,2,1,1,0,0,0,0,0,0,0,0,0,1,0,1,0,0,0,1,1,0,0,0,0,0,0,0,0,0,0
208512,37000,370,0,-2,4,1,3,0,0,0,0,0,0,0,0,0,0,0,0,0,0,0,0,0,0,4,1,3,0,0,0,0,0,0
208646,37000,370,0,-2,4,1,3,0,0,0,0,0,0,0,0,0,0,0,0,0,0,0,4,1,3,0,0,0,0,0,0,0,0,0
208822,37000,370,0,-2,13,4,9,0,0,0,0,0,0,0,0,0,3,2,1,0,0,0,8,2,6,0,0,0,2,0,2,0,0,0
209038,37000,370,0,-2,2,1,1,0,0,0,0,0,0,0,0,0,0,0,0,0,0,0,1,0,1,0,0,0,1,1,0,0,0,0
209056,37000,370,0,-2,8,3,5,0,0,0,0,0,0,2,1,1,0,0,0,0,0,0,6,2,4,0,0,0,0,0,0,0,0,0
209065,37000,370,0,-2,4,0,4,0,0,0,1,0,1,0,0,0,1,0,1,0,0,0,2,0,2,0,0,0,0,0,0,0,0,0
209074,37000,370,0,-2,6,0,6,0,0,0,0,0,0,0,0,0,1,0,1,0,0,0,4,0,4,0,0,0,1,0,1,0,0,0
209241,37000,370,0,-2,1,0,1,0,0,0,0,0,0,0,0,0,0,0,0,0,0,0,1,0,1,0,0,0,0,0,0,0,0,0
209250,37000,370,0,-2,8,2,6,0,0,0,0,0,0,0,0,0,3,0,3,0,0,0,4,2,2,0,0,0,1,0,1,0,0,0
209287,37000,370,0,-2,6,0,6,0,0,0,0,0,0,0,0,0,0,0,0,0,0,0,6,0,6,0,0,0,0,0,0,0,0,0
209409,37000,370,0,-2,3,1,2,0,0,0,0,0,0,0,0,0,0,0,0,0,0,0,3,1,2,0,0,0,0,0,0,0,0,0
209490,37000,370,0,-2,160,30,130,2,0,2,15,2,13,10,2,8,28,8,20,3,1,2,85,15,70,7,1,6,8,1,7,2,0,2
209506,37000,370,0,-2,10,2,8,0,0,0,0,0,0,0,0,0,0,0,0,0,0,0,9,2,7,1,0,1,0,0,0,0,0,0
209542,37000,370,0,-2,38,11,27,0,0,0,1,0,1,0,0,0,3,2,1,0,0,0,16,3,13,3,2,1,15,4,11,0,0,0
209551,37000,370,0,-2,84,18,66,0,0,0,1,0,1,1,0,1,9,1,8,0,0,0,64,13,51,3,0,3,5,3,2,1,1,0
209612,37000,370,0,-2,9,1,8,0,0,0,0,0,0,0,0,0,1,1,0,0,0,0,7,0,7,0,0,0,0,0,0,1,0,1
209746,37000,370,0,-2,15,5,10,0,0,0,0,0,0,0,0,0,0,0,0,0,0,0,12,4,8,0,0,0,3,1,2,0,0,0
209807,37000,370,0,-2,7,1,6,0,0,0,0,0,0,1,1,0,1,0,1,0,0,0,4,0,4,1,0,1,0,0,0,0,0,0
209825,37000,370,0,-2,31,7,24,0,0,0,1,0,1,0,0,0,2,0,2,0,0,0,25,5,20,2,1,1,1,1,0,0,0,0
209922,37000,370,0,-2,10,1,9,0,0,0,0,0,0,2,0,2,0,0,0,0,0,0,7,0,7,1,1,0,0,0,0,0,0,0
210146,37000,370,0,-2,5,0,5,1,0,1,0,0,0,0,0,0,0,0,0,0,0,0,3,0,3,0,0,0,1,0,1,0,0,0
210155,37000,370,0,-2,2,0,2,0,0,0,0,0,0,0,0,0,1,0,1,0,0,0,1,0,1,0,0,0,0,0,0,0,0,0
210234,37000,370,0,-2,1,0,1,0,0,0,0,0,0,0,0,0,0,0,0,0,0,0,0,0,0,0,0,0,1,0,1,0,0,0
210270,37000,370,0,-2,8,1,7,0,0,0,0,0,0,0,0,0,0,0,0,0,0,0,6,0,6,2,1,1,0,0,0,0,0,0
210304,37000,370,0,-2,1,0,1,0,0,0,0,0,0,0,0,0,0,0,0,0,0,0,1,0,1,0,0,0,0,0,0,0,0,0
210368,37000,370,0,-2,8,3,5,0,0,0,0,0,0,0,0,0,1,1,0,0,0,0,7,2,5,0,0,0,0,0,0,0,0,0
210401,37000,370,0,-2,14,2,12,0,0,0,1,0,1,1,0,1,0,0,0,0,0,0,10,2,8,0,0,0,2,0,2,0,0,0
210429,37000,370,0,-2,4,1,3,0,0,0,0,0,0,0,0,0,1,0,1,0,0,0,3,1,2,0,0,0,0,0,0,0,0,0
210438,37000,370,0,-2,4,0,4,0,0,0,0,0,0,0,0,0,0,0,0,0,0,0,4,0,4,0,0,0,0,0,0,0,0,0
210571,37000,370,0,-2,5,0,5,0,0,0,1,0,1,1,0,1,1,0,1,0,0,0,2,0,2,0,0,0,0,0,0,0,0,0
210599,37000,370,0,-2,2,0,2,0,0,0,0,0,0,0,0,0,0,0,0,0,0,0,2,0,2,0,0,0,0,0,0,0,0,0
210605,37000,370,0,-2,8,4,4,0,0,0,0,0,0,1,0,1,0,0,0,0,0,0,7,4,3,0,0,0,0,0,0,0,0,0
210669,37000,370,0,-2,4,1,3,0,0,0,0,0,0,0,0,0,0,0,0,0,0,0,4,1,3,0,0,0,0,0,0,0,0,0
210739,37000,370,0,-2,1,0,1,0,0,0,0,0,0,0,0,0,0,0,0,0,0,0,1,0,1,0,0,0,0,0,0,0,0,0
210775,37000,370,0,-2,1,0,1,0,0,0,0,0,0,1,0,1,0,0,0,0,0,0,0,0,0,0,0,0,0,0,0,0,0,0
210809,37000,370,0,-2,4,1,3,0,0,0,0,0,0,1,0,1,0,0,0,0,0,0,3,1,2,0,0,0,0,0,0,0,0,0
211024,37000,370,0,-2,1,0,1,0,0,0,0,0,0,0,0,0,0,0,0,0,0,0,1,0,1,0,0,0,0,0,0,0,0,0
211079,37000,370,0,-2,1,0,1,0,0,0,0,0,0,0,0,0,0,0,0,0,0,0,1,0,1,0,0,0,0,0,0,0,0,0
211088,37000,370,0,-2,10,2,8,0,0,0,0,0,0,1,0,1,2,1,1,0,0,0,7,1,6,0,0,0,0,0,0,0,0,0
211130,37000,370,0,-2,1,0,1,0,0,0,0,0,0,1,0,1,0,0,0,0,0,0,0,0,0,0,0,0,0,0,0,0,0,0
211158,37000,370,0,-2,2,2,0,0,0,0,0,0,0,0,0,0,0,0,0,0,0,0,2,2,0,0,0,0,0,0,0,0,0,0
211273,37000,370,0,-2,6,1,5,0,0,0,0,0,0,2,1,1,0,0,0,0,0,0,4,0,4,0,0,0,0,0,0,0,0,0
211291,37000,370,0,-2,4,1,3,0,0,0,0,0,0,0,0,0,0,0,0,0,0,0,4,1,3,0,0,0,0,0,0,0,0,0
211307,37000,370,0,-2,7,2,5,0,0,0,0,0,0,0,0,0,0,0,0,0,0,0,6,2,4,0,0,0,1,0,1,0,0,0
211343,37000,370,0,-2,2,0,2,0,0,0,0,0,0,0,0,0,0,0,0,0,0,0,2,0,2,0,0,0,0,0,0,0,0,0
211352,37000,370,0,-2,1,0,1,0,0,0,0,0,0,0,0,0,0,0,0,0,0,0,0,0,0,0,0,0,1,0,1,0,0,0
211361,37000,370,0,-2,1,0,1,0,0,0,0,0,0,0,0,0,0,0,0,0,0,0,1,0,1,0,0,0,0,0,0,0,0,0
211431,37000,370,0,-2,8,0,8,0,0,0,0,0,0,3,0,3,0,0,0,0,0,0,5,0,5,0,0,0,0,0,0,0,0,0
211440,37000,370,0,-2,66,15,51,0,0,0,2,0,2,7,1,6,3,0,3,0,0,0,52,14,38,1,0,1,1,0,1,0,0,0
211468,37000,370,0,-2,7,0,7,0,0,0,0,0,0,0,0,0,0,0,0,0,0,0,7,0,7,0,0,0,0,0,0,0,0,0
211583,37000,370,0,-2,3,0,3,0,0,0,0,0,0,1,0,1,0,0,0,0,0,0,2,0,2,0,0,0,0,0,0,0,0,0
211608,37000,370,0,-2,1,0,1,0,0,0,0,0,0,1,0,1,0,0,0,0,0,0,0,0,0,0,0,0,0,0,0,0,0,0
211893,37000,370,0,-2,1,0,1,0,0,0,0,0,0,0,0,0,0,0,0,0,0,0,1,0,1,0,0,0,0,0,0,0,0,0
211927,37000,370,0,-2,6,1,5,0,0,0,0,0,0,3,0,3,0,0,0,0,0,0,2,1,1,0,0,0,1,0,1,0,0,0
212009,37000,370,0,-2,22,1,21,0,0,0,3,0,3,0,0,0,0,0,0,0,0,0,17,1,16,0,0,0,1,0,1,1,0,1
212054,37000,370,0,-2,42,14,28,0,0,0,2,1,1,11,2,9,2,0,2,0,0,0,21,9,12,2,0,2,1,0,1,3,2,1
212106,37000,370,0,-2,19,4,15,0,0,0,2,0,2,3,0,3,2,0,2,0,0,0,12,4,8,0,0,0,0,0,0,0,0,0
212115,37000,370,0,-2,6,1,5,0,0,0,0,0,0,0,0,0,1,0,1,0,0,0,5,1,4,0,0,0,0,0,0,0,0,0
212133,37000,370,0,-2,4,2,2,0,0,0,0,0,0,2,1,1,0,0,0,0,0,0,2,1,1,0,0,0,0,0,0,0,0,0
212160,37000,370,0,-2,6,1,5,0,0,0,0,0,0,0,0,0,0,0,0,0,0,0,6,1,5,0,0,0,0,0,0,0,0,0
212197,37000,370,0,-2,4,1,3,0,0,0,1,0,1,0,0,0,0,0,0,0,0,0,3,1,2,0,0,0,0,0,0,0,0,0
212434,37000,370,0,-2,1,0,1,0,0,0,0,0,0,0,0,0,0,0,0,0,0,0,1,0,1,0,0,0,0,0,0,0,0,0
212577,37000,370,0,-2,9,0,9,0,0,0,0,0,0,0,0,0,0,0,0,0,0,0,9,0,9,0,0,0,0,0,0,0,0,0
212601,37000,370,0,-2,8,1,7,0,0,0,0,0,0,0,0,0,0,0,0,0,0,0,8,1,7,0,0,0,0,0,0,0,0,0
212656,37000,370,0,-2,2,0,2,0,0,0,0,0,0,0,0,0,0,0,0,0,0,0,2,0,2,0,0,0,0,0,0,0,0,0
212674,37000,370,0,-2,5,0,5,0,0,0,0,0,0,0,0,0,0,0,0,0,0,0,5,0,5,0,0,0,0,0,0,0,0,0
212771,37000,370,0,-2,1,0,1,0,0,0,0,0,0,0,0,0,0,0,0,0,0,0,1,0,1,0,0,0,0,0,0,0,0,0
212832,37000,370,0,-2,1,0,1,0,0,0,0,0,0,0,0,0,0,0,0,0,0,0,1,0,1,0,0,0,0,0,0,0,0,0
212878,37000,370,0,-2,6,1,5,0,0,0,0,0,0,0,0,0,2,0,2,0,0,0,4,1,3,0,0,0,0,0,0,0,0,0
212911,37000,370,0,-2,3,2,1,0,0,0,0,0,0,2,1,1,1,1,0,0,0,0,0,0,0,0,0,0,0,0,0,0,0,0
212975,37000,370,0,-2,2,1,1,0,0,0,0,0,0,0,0,0,0,0,0,0,0,0,2,1,1,0,0,0,0,0,0,0,0,0
212984,37000,370,0,-2,7,1,6,0,0,0,0,0,0,3,0,3,0,0,0,0,0,0,4,1,3,0,0,0,0,0,0,0,0,0
213011,37000,370,0,-2,1,0,1,0,0,0,0,0,0,0,0,0,0,0,0,0,0,0,1,0,1,0,0,0,0,0,0,0,0,0
213020,37000,370,0,-2,3,1,2,0,0,0,0,0,0,0,0,0,0,0,0,0,0,0,1,1,0,0,0,0,2,0,2,0,0,0
213181,37000,370,0,-2,5,0,5,0,0,0,0,0,0,0,0,0,0,0,0,0,0,0,5,0,5,0,0,0,0,0,0,0,0,0
213233,37000,370,0,-2,5,0,5,0,0,0,0,0,0,0,0,0,0,0,0,0,0,0,5,0,5,0,0,0,0,0,0,0,0,0
213251,37000,370,0,-2,4,0,4,0,0,0,0,0,0,0,0,0,0,0,0,0,0,0,4,0,4,0,0,0,0,0,0,0,0,0
213321,37000,370,0,-2,1,0,1,0,0,0,0,0,0,0,0,0,0,0,0,0,0,0,1,0,1,0,0,0,0,0,0,0,0,0
213349,37000,370,0,-2,8,0,8,0,0,0,0,0,0,0,0,0,0,0,0,0,0,0,6,0,6,1,0,1,1,0,1,0,0,0
213358,37000,370,0,-2,7,0,7,0,0,0,0,0,0,1,0,1,0,0,0,0,0,0,6,0,6,0,0,0,0,0,0,0,0,0
213367,37000,370,0,-2,3,0,3,0,0,0,0,0,0,1,0,1,1,0,1,0,0,0,1,0,1,0,0,0,0,0,0,0,0,0
213376,37000,370,0,-2,4,1,3,0,0,0,0,0,0,0,0,0,1,0,1,0,0,0,3,1,2,0,0,0,0,0,0,0,0,0
213385,37000,370,0,-2,2,1,1,0,0,0,0,0,0,0,0,0,0,0,0,0,0,0,2,1,1,0,0,0,0,0,0,0,0,0
213400,37000,370,0,-2,7,1,6,0,0,0,0,0,0,2,1,1,0,0,0,0,0,0,5,0,5,0,0,0,0,0,0,0,0,0
213507,37000,370,0,-2,2,0,2,0,0,0,0,0,0,0,0,0,0,0,0,0,0,0,2,0,2,0,0,0,0,0,0,0,0,0
213543,37000,370,0,-2,20,2,18,0,0,0,0,0,0,0,0,0,1,0,1,0,0,0,18,1,17,0,0,0,1,1,0,0,0,0
213570,37000,370,0,-2,2,0,2,0,0,0,0,0,0,0,0,0,0,0,0,0,0,0,2,0,2,0,0,0,0,0,0,0,0,0
213589,37000,370,0,-2,2,1,1,0,0,0,0,0,0,1,1,0,0,0,0,0,0,0,1,0,1,0,0,0,0,0,0,0,0,0
213598,37000,370,0,-2,6,2,4,0,0,0,0,0,0,4,1,3,1,1,0,1,0,1,0,0,0,0,0,0,0,0,0,0,0,0
213613,37000,370,0,-2,3,1,2,0,0,0,0,0,0,0,0,0,0,0,0,0,0,0,3,1,2,0,0,0,0,0,0,0,0,0
213659,37000,370,0,-2,1,0,1,0,0,0,0,0,0,0,0,0,0,0,0,0,0,0,1,0,1,0,0,0,0,0,0,0,0,0
213668,37000,370,0,-2,2,0,2,0,0,0,0,0,0,0,0,0,0,0,0,0,0,0,2,0,2,0,0,0,0,0,0,0,0,0
213774,37000,370,0,-2,1,0,1,0,0,0,0,0,0,0,0,0,0,0,0,0,0,0,1,0,1,0,0,0,0,0,0,0,0,0
213826,37000,370,0,-2,5,2,3,0,0,0,0,0,0,0,0,0,0,0,0,0,0,0,5,2,3,0,0,0,0,0,0,0,0,0
213987,37000,370,0,-2,5,1,4,0,0,0,0,0,0,1,0,1,0,0,0,0,0,0,4,1,3,0,0,0,0,0,0,0,0,0
213996,37000,370,0,-2,7,2,5,0,0,0,0,0,0,0,0,0,0,0,0,0,0,0,7,2,5,0,0,0,0,0,0,0,0,0
214041,37000,370,0,-2,9,0,9,0,0,0,0,0,0,0,0,0,1,0,1,0,0,0,8,0,8,0,0,0,0,0,0,0,0,0
214069,37000,370,0,-2,1,0,1,0,0,0,0,0,0,0,0,0,0,0,0,0,0,0,1,0,1,0,0,0,0,0,0,0,0,0
214111,37000,370,0,-2,5,1,4,0,0,0,0,0,0,0,0,0,0,0,0,0,0,0,4,1,3,0,0,0,1,0,1,0,0,0
214148,37000,370,0,-2,10,3,7,0,0,0,1,0,1,0,0,0,0,0,0,0,0,0,8,2,6,1,1,0,0,0,0,0,0,0
214157,37000,370,0,-2,6,2,4,0,0,0,0,0,0,0,0,0,3,0,3,0,0,0,2,1,1,0,0,0,1,1,0,0,0,0
214166,37000,370,0,-2,1,0,1,0,0,0,0,0,0,0,0,0,0,0,0,0,0,0,1,0,1,0,0,0,0,0,0,0,0,0
214175,37000,370,0,-2,6,1,5,0,0,0,0,0,0,0,0,0,0,0,0,0,0,0,6,1,5,0,0,0,0,0,0,0,0,0
214272,37000,370,0,-2,4,1,3,0,0,0,0,0,0,0,0,0,1,0,1,0,0,0,3,1,2,0,0,0,0,0,0,0,0,0
214564,37000,370,0,-2,5,0,5,0,0,0,0,0,0,1,0,1,0,0,0,0,0,0,4,0,4,0,0,0,0,0,0,0,0,0
214582,37000,370,0,-2,4,0,4,0,0,0,0,0,0,1,0,1,0,0,0,0,0,0,3,0,3,0,0,0,0,0,0,0,0,0
214661,37000,370,0,-2,1,0,1,0,0,0,0,0,0,0,0,0,0,0,0,0,0,0,1,0,1,0,0,0,0,0,0,0,0,0
214892,37000,370,0,-2,3,0,3,0,0,0,0,0,0,1,0,1,0,0,0,0,0,0,2,0,2,0,0,0,0,0,0,0,0,0
214944,37000,370,0,-2,9,0,9,1,0,1,1,0,1,1,0,1,0,0,0,0,0,0,6,0,6,0,0,0,0,0,0,0,0,0
214971,37000,370,0,-2,6,0,6,0,0,0,0,0,0,2,0,2,1,0,1,0,0,0,2,0,2,1,0,1,0,0,0,0,0,0
215062,37000,370,0,-2,195,35,160,0,0,0,12,1,11,57,14,43,15,4,11,0,0,0,95,13,82,5,0,5,11,3,8,0,0,0
215105,37000,370,0,-2,8,0,8,0,0,0,0,0,0,2,0,2,0,0,0,0,0,0,5,0,5,0,0,0,1,0,1,0,0,0
215114,37000,370,0,-2,3,0,3,0,0,0,0,0,0,0,0,0,1,0,1,0,0,0,1,0,1,1,0,1,0,0,0,0,0,0
215123,37000,370,0,-2,4,0,4,0,0,0,1,0,1,2,0,2,0,0,0,0,0,0,1,0,1,0,0,0,0,0,0,0,0,0
215132,37000,370,0,-2,4,0,4,0,0,0,0,0,0,2,0,2,0,0,0,0,0,0,2,0,2,0,0,0,0,0,0,0,0,0
215239,37000,370,0,-2,5,2,3,0,0,0,1,1,0,1,0,1,2,0,2,0,0,0,1,1,0,0,0,0,0,0,0,0,0,0
215266,37000,370,0,-2,10,3,7,0,0,0,0,0,0,0,0,0,1,1,0,0,0,0,9,2,7,0,0,0,0,0,0,0,0,0
215275,37000,370,0,-2,1,0,1,0,0,0,0,0,0,0,0,0,0,0,0,0,0,0,1,0,1,0,0,0,0,0,0,0,0,0
215284,37000,370,0,-2,5,2,3,0,0,0,0,0,0,0,0,0,0,0,0,0,0,0,4,2,2,1,0,1,0,0,0,0,0,0
215293,37000,370,0,-2,206,39,167,0,0,0,6,0,6,24,5,19,10,2,8,0,0,0,145,25,120,5,0,5,16,7,9,0,0,0
215415,37000,370,0,-2,2,0,2,0,0,0,0,0,0,1,0,1,1,0,1,0,0,0,0,0,0,0,0,0,0,0,0,0,0,0
215424,37000,370,0,-2,1,1,0,0,0,0,0,0,0,0,0,0,0,0,0,0,0,0,1,1,0,0,0,0,0,0,0,0,0,0
215442,37000,370,0,-2,7,0,7,0,0,0,0,0,0,0,0,0,0,0,0,0,0,0,7,0,7,0,0,0,0,0,0,0,0,0
215585,37000,370,0,-2,10,3,7,0,0,0,0,0,0,2,1,1,2,1,1,0,0,0,6,1,5,0,0,0,0,0,0,0,0,0
215619,37000,370,0,-2,2,0,2,0,0,0,0,0,0,0,0,0,0,0,0,0,0,0,2,0,2,0,0,0,0,0,0,0,0,0
215682,37000,370,0,-2,1,0,1,0,0,0,0,0,0,0,0,0,0,0,0,0,0,0,1,0,1,0,0,0,0,0,0,0,0,0
215691,37000,370,0,-2,10,3,7,0,0,0,0,0,0,0,0,0,1,0,1,0,0,0,9,3,6,0,0,0,0,0,0,0,0,0
215743,37000,370,0,-2,13,0,13,0,0,0,0,0,0,0,0,0,0,0,0,0,0,0,13,0,13,0,0,0,0,0,0,0,0,0
215770,37000,370,0,-2,11,2,9,0,0,0,0,0,0,3,1,2,0,0,0,0,0,0,6,1,5,0,0,0,2,0,2,0,0,0
215798,37000,370,0,-2,2,0,2,0,0,0,0,0,0,0,0,0,0,0,0,0,0,0,2,0,2,0,0,0,0,0,0,0,0,0
215929,37000,370,0,-2,7,3,4,0,0,0,0,0,0,0,0,0,0,0,0,0,0,0,7,3,4,0,0,0,0,0,0,0,0,0
215947,37000,370,0,-2,3,0,3,0,0,0,0,0,0,0,0,0,0,0,0,0,0,0,3,0,3,0,0,0,0,0,0,0,0,0
216010,37000,370,0,-2,4,1,3,0,0,0,0,0,0,0,0,0,0,0,0,0,0,0,4,1,3,0,0,0,0,0,0,0,0,0
216038,37000,370,0,-2,14,2,12,0,0,0,0,0,0,1,0,1,0,0,0,0,0,0,13,2,11,0,0,0,0,0,0,0,0,0
216278,37000,370,0,-2,6,0,6,0,0,0,1,0,1,0,0,0,0,0,0,0,0,0,5,0,5,0,0,0,0,0,0,0,0,0
216287,37000,370,0,-2,1,0,1,0,0,0,0,0,0,0,0,0,0,0,0,0,0,0,1,0,1,0,0,0,0,0,0,0,0,0
216296,37000,370,0,-2,4,3,1,0,0,0,0,0,0,0,0,0,1,1,0,0,0,0,3,2,1,0,0,0,0,0,0,0,0,0
216339,37000,370,0,-2,73,18,55,0,0,0,4,1,3,21,6,15,7,2,5,1,1,0,34,7,27,2,1,1,3,0,3,1,0,1
216357,37000,370,0,-2,4,0,4,0,0,0,0,0,0,0,0,0,0,0,0,0,0,0,4,0,4,0,0,0,0,0,0,0,0,0
216366,37000,370,0,-2,115,24,91,1,0,1,9,3,6,27,7,20,7,0,7,0,0,0,55,12,43,16,2,14,0,0,0,0,0,0
216463,37000,370,0,-2,1,0,1,0,0,0,0,0,0,0,0,0,0,0,0,0,0,0,1,0,1,0,0,0,0,0,0,0,0,0
216524,37000,370,0,-2,10,1,9,0,0,0,1,0,1,0,0,0,0,0,0,0,0,0,8,1,7,1,0,1,0,0,0,0,0,0
216542,37000,370,0,-2,1,0,1,0,0,0,0,0,0,0,0,0,0,0,0,0,0,0,1,0,1,0,0,0,0,0,0,0,0,0
216597,37000,370,0,-2,37,4,33,0,0,0,4,1,3,3,0,3,0,0,0,0,0,0,30,3,27,0,0,0,0,0,0,0,0,0
216667,37000,370,0,-2,3,1,2,0,0,0,0,0,0,0,0,0,0,0,0,0,0,0,3,1,2,0,0,0,0,0,0,0,0,0
216764,37000,370,0,-2,9,0,9,0,0,0,0,0,0,1,0,1,0,0,0,0,0,0,8,0,8,0,0,0,0,0,0,0,0,0
216807,37000,370,0,-2,2,0,2,0,0,0,0,0,0,0,0,0,0,0,0,0,0,0,2,0,2,0,0,0,0,0,0,0,0,0
216816,37000,370,0,-2,6,1,5,0,0,0,1,0,1,1,1,0,0,0,0,0,0,0,4,0,4,0,0,0,0,0,0,0,0,0
216825,37000,370,0,-2,6,3,3,0,0,0,0,0,0,0,0,0,0,0,0,0,0,0,5,3,2,0,0,0,1,0,1,0,0,0
216852,37000,370,0,-2,10,0,10,0,0,0,0,0,0,2,0,2,0,0,0,0,0,0,8,0,8,0,0,0,0,0,0,0,0,0
216931,37000,370,0,-2,2,0,2,0,0,0,0,0,0,0,0,0,0,0,0,0,0,0,2,0,2,0,0,0,0,0,0,0,0,0
217013,37000,370,0,-2,3,0,3,0,0,0,0,0,0,0,0,0,0,0,0,0,0,0,3,0,3,0,0,0,0,0,0,0,0,0
217059,37000,370,0,-2,4,0,4,0,0,0,0,0,0,0,0,0,0,0,0,0,0,0,4,0,4,0,0,0,0,0,0,0,0,0
217156,37000,370,0,-2,66,9,57,0,0,0,1,0,1,6,1,5,13,2,11,0,0,0,41,6,35,2,0,2,3,0,3,0,0,0
217165,37000,370,0,-2,2,0,2,0,0,0,0,0,0,0,0,0,0,0,0,0,0,0,2,0,2,0,0,0,0,0,0,0,0,0
217235,37000,370,0,-2,3,0,3,0,0,0,0,0,0,0,0,0,0,0,0,0,0,0,3,0,3,0,0,0,0,0,0,0,0,0
217402,37000,370,0,-2,9,1,8,0,0,0,0,0,0,1,0,1,1,0,1,0,0,0,7,1,6,0,0,0,0,0,0,0,0,0
217420,37000,370,0,-2,6,1,5,0,0,0,1,0,1,1,0,1,0,0,0,0,0,0,4,1,3,0,0,0,0,0,0,0,0,0
217475,37000,370,0,-2,8,0,8,0,0,0,0,0,0,1,0,1,2,0,2,0,0,0,5,0,5,0,0,0,0,0,0,0,0,0
217484,37000,370,0,-2,20,4,16,0,0,0,1,1,0,0,0,0,0,0,0,0,0,0,19,3,16,0,0,0,0,0,0,0,0,0
217493,37000,370,0,-2,11,1,10,0,0,0,0,0,0,1,0,1,1,0,1,0,0,0,7,1,6,1,0,1,1,0,1,0,0,0
217518,37000,370,0,-2,2,0,2,0,0,0,0,0,0,0,0,0,0,0,0,0,0,0,2,0,2,0,0,0,0,0,0,0,0,0
217536,37000,370,0,-2,6,0,6,0,0,0,0,0,0,0,0,0,0,0,0,0,0,0,5,0,5,0,0,0,1,0,1,0,0,0
217615,37000,370,0,-2,2,0,2,0,0,0,0,0,0,0,0,0,0,0,0,0,0,0,2,0,2,0,0,0,0,0,0,0,0,0
217633,37000,370,0,-2,17,3,14,0,0,0,0,0,0,2,2,0,1,0,1,0,0,0,14,1,13,0,0,0,0,0,0,0,0,0
217688,37000,370,0,-2,5,1,4,0,0,0,0,0,0,1,0,1,0,0,0,0,0,0,4,1,3,0,0,0,0,0,0,0,0,0
217712,37000,370,0,-2,4,0,4,0,0,0,0,0,0,1,0,1,1,0,1,0,0,0,2,0,2,0,0,0,0,0,0,0,0,0
217721,37000,370,0,-2,4,1,3,0,0,0,0,0,0,4,1,3,0,0,0,0,0,0,0,0,0,0,0,0,0,0,0,0,0,0
217749,37000,370,0,-2,14,2,12,0,0,0,0,0,0,0,0,0,1,0,1,0,0,0,13,2,11,0,0,0,0,0,0,0,0,0
217819,37000,370,0,-2,37,14,23,0,0,0,0,0,0,7,2,5,1,1,0,0,0,0,28,11,17,1,0,1,0,0,0,0,0,0
217837,37000,370,0,-2,2,0,2,0,0,0,0,0,0,1,0,1,0,0,0,0,0,0,1,0,1,0,0,0,0,0,0,0,0,0
217864,37000,370,0,-2,5,0,5,0,0,0,0,0,0,0,0,0,0,0,0,0,0,0,2,0,2,0,0,0,3,0,3,0,0,0
217882,37000,370,0,-2,46,8,38,0,0,0,1,0,1,0,0,0,0,0,0,0,0,0,45,8,37,0,0,0,0,0,0,0,0,0
217907,37000,370,0,-2,1,0,1,0,0,0,0,0,0,0,0,0,0,0,0,0,0,0,0,0,0,1,0,1,0,0,0,0,0,0
217925,37000,370,0,-2,4,2,2,0,0,0,0,0,0,1,1,0,0,0,0,0,0,0,3,1,2,0,0,0,0,0,0,0,0,0
217934,37000,370,0,-2,1,0,1,0,0,0,0,0,0,0,0,0,0,0,0,0,0,0,1,0,1,0,0,0,0,0,0,0,0,0
217961,37000,370,0,-2,4,1,3,0,0,0,0,0,0,1,0,1,0,0,0,0,0,0,3,1,2,0,0,0,0,0,0,0,0,0
217998,37000,370,0,-2,1,0,1,0,0,0,0,0,0,0,0,0,0,0,0,0,0,0,1,0,1,0,0,0,0,0,0,0,0,0
218025,37000,370,0,-2,3,0,3,0,0,0,0,0,0,2,0,2,0,0,0,0,0,0,1,0,1,0,0,0,0,0,0,0,0,0
218061,37000,370,0,-2,10,1,9,0,0,0,0,0,0,3,0,3,1,0,1,0,0,0,6,1,5,0,0,0,0,0,0,0,0,0
218070,37000,370,0,-2,9,3,6,1,0,1,0,0,0,1,1,0,1,0,1,0,0,0,6,2,4,0,0,0,0,0,0,0,0,0
218113,37000,370,0,-2,15,1,14,1,0,1,1,0,1,4,1,3,1,0,1,0,0,0,8,0,8,0,0,0,0,0,0,0,0,0
218140,37000,370,0,-2,6,2,4,0,0,0,0,0,0,2,1,1,1,0,1,0,0,0,3,1,2,0,0,0,0,0,0,0,0,0
218229,37000,370,0,-2,4,0,4,0,0,0,0,0,0,0,0,0,0,0,0,0,0,0,4,0,4,0,0,0,0,0,0,0,0,0
218238,37000,370,0,-2,1,0,1,0,0,0,0,0,0,0,0,0,0,0,0,0,0,0,0,0,0,0,0,0,1,0,1,0,0,0
218335,37000,370,0,-2,5,0,5,0,0,0,0,0,0,2,0,2,0,0,0,0,0,0,3,0,3,0,0,0,0,0,0,0,0,0
218353,37000,370,0,-2,2,1,1,0,0,0,0,0,0,2,1,1,0,0,0,0,0,0,0,0,0,0,0,0,0,0,0,0,0,0
218399,37000,370,0,-2,3,0,3,0,0,0,0,0,0,3,0,3,0,0,0,0,0,0,0,0,0,0,0,0,0,0,0,0,0,0
218414,37000,370,0,-2,2,0,2,0,0,0,0,0,0,0,0,0,0,0,0,0,0,0,2,0,2,0,0,0,0,0,0,0,0,0
218441,37000,370,0,-2,7,0,7,0,0,0,0,0,0,0,0,0,1,0,1,0,0,0,5,0,5,0,0,0,1,0,1,0,0,0
218487,37000,370,0,-2,1,0,1,0,0,0,0,0,0,0,0,0,0,0,0,0,0,0,1,0,1,0,0,0,0,0,0,0,0,0
218520,37000,370,0,-2,7,1,6,0,0,0,0,0,0,3,0,3,0,0,0,0,0,0,4,1,3,0,0,0,0,0,0,0,0,0
218539,37000,370,0,-2,2,1,1,0,0,0,0,0,0,0,0,0,0,0,0,0,0,0,2,1,1,0,0,0,0,0,0,0,0,0
218645,37000,370,0,-2,8,0,8,0,0,0,0,0,0,3,0,3,0,0,0,0,0,0,5,0,5,0,0,0,0,0,0,0,0,0
218654,37000,370,0,-2,2,0,2,0,0,0,0,0,0,0,0,0,0,0,0,0,0,0,2,0,2,0,0,0,0,0,0,0,0,0
218663,37000,370,0,-2,95,15,80,0,0,0,0,0,0,32,3,29,1,0,1,1,0,1,56,12,44,5,0,5,0,0,0,0,0,0
218681,37000,370,0,-2,2,0,2,0,0,0,0,0,0,2,0,2,0,0,0,0,0,0,0,0,0,0,0,0,0,0,0,0,0,0
218690,37000,370,0,-2,1,0,1,0,0,0,0,0,0,0,0,0,0,0,0,0,0,0,1,0,1,0,0,0,0,0,0,0,0,0
218724,37000,370,0,-2,12,2,10,0,0,0,1,1,0,1,0,1,1,0,1,0,0,0,8,1,7,1,0,1,0,0,0,0,0,0
218733,37000,370,0,-2,4,0,4,0,0,0,0,0,0,4,0,4,0,0,0,0,0,0,0,0,0,0,0,0,0,0,0,0,0,0
218742,37000,370,0,-2,5,1,4,0,0,0,0,0,0,4,1,3,0,0,0,0,0,0,1,0,1,0,0,0,0,0,0,0,0,0
218751,37000,370,0,-2,3,1,2,0,0,0,0,0,0,0,0,0,0,0,0,0,0,0,3,1,2,0,0,0,0,0,0,0,0,0
218821,37000,370,0,-2,2,0,2,0,0,0,0,0,0,0,0,0,0,0,0,0,0,0,2,0,2,0,0,0,0,0,0,0,0,0
218830,37000,370,0,-2,4,1,3,0,0,0,0,0,0,1,0,1,0,0,0,0,0,0,3,1,2,0,0,0,0,0,0,0,0,0
218858,37000,370,0,-2,10,1,9,0,0,0,0,0,0,3,0,3,0,0,0,0,0,0,7,1,6,0,0,0,0,0,0,0,0,0
218885,37000,370,0,-2,2,0,2,0,0,0,0,0,0,0,0,0,0,0,0,0,0,0,2,0,2,0,0,0,0,0,0,0,0,0
218919,37000,370,0,-2,4,1,3,0,0,0,0,0,0,4,1,3,0,0,0,0,0,0,0,0,0,0,0,0,0,0,0,0,0,0
218955,37000,370,0,-2,2,0,2,0,0,0,0,0,0,0,0,0,0,0,0,0,0,0,2,0,2,0,0,0,0,0,0,0,0,0
218964,37000,370,0,-2,7,1,6,0,0,0,0,0,0,0,0,0,0,0,0,0,0,0,7,1,6,0,0,0,0,0,0,0,0,0
218973,37000,370,0,-2,1,0,1,0,0,0,0,0,0,0,0,0,0,0,0,0,0,0,1,0,1,0,0,0,0,0,0,0,0,0
219000,37000,370,0,-2,11,2,9,0,0,0,0,0,0,1,1,0,0,0,0,0,0,0,10,1,9,0,0,0,0,0,0,0,0,0
219046,37000,370,0,-2,2,1,1,0,0,0,0,0,0,0,0,0,0,0,0,0,0,0,2,1,1,0,0,0,0,0,0,0,0,0
219082,37000,370,0,-2,4,1,3,0,0,0,0,0,0,0,0,0,0,0,0,0,0,0,4,1,3,0,0,0,0,0,0,0,0,0
219091,37000,370,0,-2,3,0,3,0,0,0,0,0,0,0,0,0,0,0,0,0,0,0,3,0,3,0,0,0,0,0,0,0,0,0
219143,37000,370,0,-2,6,0,6,0,0,0,0,0,0,0,0,0,0,0,0,0,0,0,6,0,6,0,0,0,0,0,0,0,0,0
219198,37000,370,0,-2,1,0,1,0,0,0,0,0,0,0,0,0,0,0,0,0,0,0,1,0,1,0,0,0,0,0,0,0,0,0
219259,37000,370,0,-2,1,0,1,0,0,0,0,0,0,0,0,0,0,0,0,0,0,0,1,0,1,0,0,0,0,0,0,0,0,0
219347,37000,370,0,-2,5,1,4,0,0,0,0,0,0,0,0,0,0,0,0,0,0,0,5,1,4,0,0,0,0,0,0,0,0,0
219356,37000,370,0,-2,30,9,21,1,0,1,1,0,1,0,0,0,1,1,0,0,0,0,25,8,17,1,0,1,1,0,1,0,0,0
219374,37000,370,0,-2,3,0,3,3,0,3,0,0,0,0,0,0,0,0,0,0,0,0,0,0,0,0,0,0,0,0,0,0,0,0
219408,37000,370,0,-2,1,0,1,1,0,1,0,0,0,0,0,0,0,0,0,0,0,0,0,0,0,0,0,0,0,0,0,0,0,0
219426,37000,370,0,-2,3,1,2,0,0,0,0,0,0,0,0,0,1,1,0,0,0,0,2,0,2,0,0,0,0,0,0,0,0,0
219471,37000,370,0,-2,33,4,29,1,0,1,1,0,1,0,0,0,1,0,1,0,0,0,29,4,25,1,0,1,0,0,0,0,0,0
219480,37000,370,0,-2,4,0,4,0,0,0,0,0,0,0,0,0,0,0,0,0,0,0,4,0,4,0,0,0,0,0,0,0,0,0
219602,37000,370,0,-2,17,0,17,0,0,0,0,0,0,1,0,1,1,0,1,0,0,0,14,0,14,1,0,1,0,0,0,0,0,0
219639,37000,370,0,-2,1,0,1,0,0,0,0,0,0,0,0,0,0,0,0,0,0,0,1,0,1,0,0,0,0,0,0,0,0,0
219709,37000,370,0,-2,25,1,24,0,0,0,3,0,3,4,0,4,0,0,0,0,0,0,17,1,16,0,0,0,1,0,1,0,0,0
219718,37000,370,0,-2,9,3,6,0,0,0,0,0,0,1,0,1,2,2,0,0,0,0,6,1,5,0,0,0,0,0,0,0,0,0
219790,37000,370,0,-2,5,0,5,0,0,0,1,0,1,0,0,0,0,0,0,0,0,0,4,0,4,0,0,0,0,0,0,0,0,0
219806,37000,370,0,-2,6,2,4,0,0,0,0,0,0,0,0,0,0,0,0,0,0,0,5,2,3,1,0,1,0,0,0,0,0,0
219824,37000,370,0,-2,6,0,6,0,0,0,1,0,1,1,0,1,0,0,0,0,0,0,4,0,4,0,0,0,0,0,0,0,0,0
219833,37000,370,0,-2,10,0,10,0,0,0,0,0,0,4,0,4,0,0,0,0,0,0,6,0,6,0,0,0,0,0,0,0,0,0
219842,37000,370,0,-2,2,0,2,0,0,0,0,0,0,0,0,0,1,0,1,0,0,0,1,0,1,0,0,0,0,0,0,0,0,0
219879,37000,370,0,-2,5,1,4,0,0,0,0,0,0,0,0,0,0,0,0,0,0,0,5,1,4,0,0,0,0,0,0,0,0,0
219888,37000,370,0,-2,10,1,9,0,0,0,0,0,0,2,0,2,0,0,0,0,0,0,8,1,7,0,0,0,0,0,0,0,0,0
219903,37000,370,0,-2,11,2,9,0,0,0,0,0,0,6,1,5,2,1,1,0,0,0,3,0,3,0,0,0,0,0,0,0,0,0
219949,37000,370,0,-2,3,0,3,0,0,0,0,0,0,0,0,0,0,0,0,0,0,0,3,0,3,0,0,0,0,0,0,0,0,0
219976,37000,370,0,-2,9,0,9,0,0,0,0,0,0,0,0,0,0,0,0,0,0,0,5,0,5,0,0,0,4,0,4,0,0,0
220057,37000,370,0,-2,5,1,4,0,0,0,0,0,0,0,0,0,0,0,0,0,0,0,3,1,2,0,0,0,2,0,2,0,0,0
220075,37000,370,0,-2,112,21,91,0,0,0,2,1,1,5,1,4,2,0,2,0,0,0,101,18,83,0,0,0,0,0,0,2,1,1
220215,37000,370,0,-2,2,0,2,0,0,0,0,0,0,0,0,0,0,0,0,0,0,0,1,0,1,0,0,0,1,0,1,0,0,0
220400,37000,370,0,-2,2,0,2,0,0,0,0,0,0,0,0,0,0,0,0,0,0,0,2,0,2,0,0,0,0,0,0,0,0,0
220473,37000,370,0,-2,5,0,5,0,0,0,0,0,0,0,0,0,0,0,0,0,0,0,5,0,5,0,0,0,0,0,0,0,0,0
220516,37000,370,0,-2,1,0,1,0,0,0,0,0,0,0,0,0,0,0,0,0,0,0,1,0,1,0,0,0,0,0,0,0,0,0
220552,37000,370,0,-2,69,22,47,0,0,0,0,0,0,20,8,12,1,0,1,1,0,1,42,12,30,5,2,3,0,0,0,0,0,0
220598,37000,370,0,-2,7,1,6,0,0,0,0,0,0,6,0,6,0,0,0,0,0,0,1,1,0,0,0,0,0,0,0,0,0,0
220604,37000,370,0,-2,3,0,3,0,0,0,0,0,0,3,0,3,0,0,0,0,0,0,0,0,0,0,0,0,0,0,0,0,0,0
220613,37000,370,0,-2,8,0,8,0,0,0,0,0,0,0,0,0,1,0,1,0,0,0,6,0,6,0,0,0,1,0,1,0,0,0
220631,37000,370,0,-2,35,6,29,0,0,0,0,0,0,0,0,0,0,0,0,0,0,0,34,6,28,1,0,1,0,0,0,0,0,0
220710,37000,370,0,-2,1,0,1,0,0,0,0,0,0,0,0,0,0,0,0,0,0,0,1,0,1,0,0,0,0,0,0,0,0,0
220792,37000,370,0,-2,32,6,26,0,0,0,0,0,0,25,4,21,2,1,1,0,0,0,5,1,4,0,0,0,0,0,0,0,0,0
220862,37000,370,0,-2,20,5,15,0,0,0,0,0,0,9,1,8,1,1,0,0,0,0,10,3,7,0,0,0,0,0,0,0,0,0
220978,37000,370,0,-2,46,11,35,0,0,0,1,0,1,5,0,5,1,0,1,0,0,0,36,9,27,2,1,1,0,0,0,1,1,0
220996,37000,370,0,-2,2,0,2,0,0,0,0,0,0,1,0,1,0,0,0,0,0,0,1,0,1,0,0,0,0,0,0,0,0,0
221096,37000,370,0,-2,6,1,5,0,0,0,0,0,0,2,0,2,0,0,0,0,0,0,4,1,3,0,0,0,0,0,0,0,0,0
221148,37000,370,0,-2,6,1,5,0,0,0,0,0,0,1,0,1,0,0,0,0,0,0,5,1,4,0,0,0,0,0,0,0,0,0
221184,37000,370,0,-2,18,2,16,0,0,0,0,0,0,5,1,4,1,0,1,0,0,0,11,1,10,1,0,1,0,0,0,0,0,0
221351,37000,370,0,-2,4,0,4,0,0,0,0,0,0,2,0,2,0,0,0,0,0,0,1,0,1,0,0,0,1,0,1,0,0,0
221397,37000,370,0,-2,12,4,8,0,0,0,0,0,0,0,0,0,0,0,0,0,0,0,12,4,8,0,0,0,0,0,0,0,0,0
221485,37000,370,0,-2,13,2,11,0,0,0,0,0,0,9,1,8,0,0,0,0,0,0,3,1,2,1,0,1,0,0,0,0,0,0
221519,37000,370,0,-2,27,10,17,0,0,0,1,0,1,2,1,1,1,1,0,0,0,0,22,7,15,0,0,0,1,1,0,0,0,0
221661,37000,370,0,-2,2,1,1,0,0,0,0,0,0,0,0,0,0,0,0,0,0,0,1,0,1,1,1,0,0,0,0,0,0,0
221670,37000,370,0,-2,2,0,2,0,0,0,0,0,0,1,0,1,0,0,0,0,0,0,1,0,1,0,0,0,0,0,0,0,0,0
221731,37000,370,0,-2,5,0,5,0,0,0,0,0,0,0,0,0,0,0,0,0,0,0,5,0,5,0,0,0,0,0,0,0,0,0
221740,37000,370,0,-2,25,4,21,0,0,0,1,0,1,8,0,8,0,0,0,0,0,0,16,4,12,0,0,0,0,0,0,0,0,0
221759,37000,370,0,-2,135,19,116,0,0,0,0,0,0,6,0,6,4,0,4,0,0,0,121,19,102,3,0,3,0,0,0,1,0,1
221768,37000,370,0,-2,15,0,15,0,0,0,0,0,0,2,0,2,0,0,0,0,0,0,13,0,13,0,0,0,0,0,0,0,0,0
221838,37000,370,0,-2,21,4,17,0,0,0,0,0,0,16,3,13,0,0,0,0,0,0,4,1,3,1,0,1,0,0,0,0,0,0
221847,37000,370,0,-2,14,3,11,0,0,0,0,0,0,0,0,0,1,0,1,0,0,0,12,3,9,1,0,1,0,0,0,0,0,0
221892,37000,370,0,-2,20,6,14,0,0,0,0,0,0,2,0,2,0,0,0,0,0,0,17,6,11,1,0,1,0,0,0,0,0,0
221908,37000,370,0,-2,7,3,4,0,0,0,0,0,0,0,0,0,0,0,0,0,0,0,6,3,3,1,0,1,0,0,0,0,0,0
221953,37000,370,0,-2,6,0,6,0,0,0,0,0,0,0,0,0,0,0,0,0,0,0,6,0,6,0,0,0,0,0,0,0,0,0
221971,37000,370,0,-2,8,1,7,0,0,0,0,0,0,1,0,1,0,0,0,0,0,0,7,1,6,0,0,0,0,0,0,0,0,0
221999,37000,370,0,-2,102,34,68,0,0,0,3,1,2,12,6,6,8,2,6,0,0,0,73,21,52,0,0,0,6,4,2,0,0,0
222053,37000,370,0,-2,7,1,6,0,0,0,0,0,0,0,0,0,0,0,0,0,0,0,7,1,6,0,0,0,0,0,0,0,0,0
222062,37000,370,0,-2,3,2,1,0,0,0,0,0,0,0,0,0,0,0,0,0,0,0,3,2,1,0,0,0,0,0,0,0,0,0
222178,37000,370,0,-2,30,13,17,0,0,0,2,1,1,4,3,1,2,1,1,0,0,0,17,6,11,1,0,1,4,2,2,0,0,0
222497,37000,370,0,-2,8,0,8,0,0,0,0,0,0,1,0,1,7,0,7,0,0,0,0,0,0,0,0,0,0,0,0,0,0,0
222567,37000,370,0,-2,1,0,1,0,0,0,0,0,0,0,0,0,0,0,0,0,0,0,1,0,1,0,0,0,0,0,0,0,0,0
222576,37000,370,0,-2,6,1,5,0,0,0,1,0,1,1,0,1,2,1,1,0,0,0,2,0,2,0,0,0,0,0,0,0,0,0
222822,37000,370,0,-2,9,1,8,0,0,0,0,0,0,1,0,1,3,0,3,0,0,0,5,1,4,0,0,0,0,0,0,0,0,0
222831,37000,370,0,-2,17,3,14,0,0,0,0,0,0,0,0,0,6,1,5,0,0,0,11,2,9,0,0,0,0,0,0,0,0,0
222877,37000,370,0,-2,2,0,2,1,0,1,0,0,0,1,0,1,0,0,0,0,0,0,0,0,0,0,0,0,0,0,0,0,0,0
222938,37000,370,0,-2,3,2,1,0,0,0,0,0,0,1,0,1,1,1,0,0,0,0,1,1,0,0,0,0,0,0,0,0,0,0
222983,37000,370,0,-2,8,1,7,0,0,0,0,0,0,1,0,1,0,0,0,0,0,0,6,1,5,1,0,1,0,0,0,0,0,0
222992,37000,370,0,-2,18,3,15,0,0,0,3,0,3,0,0,0,6,2,4,0,0,0,9,1,8,0,0,0,0,0,0,0,0,0
223001,37000,370,0,-2,2,1,1,0,0,0,0,0,0,0,0,0,0,0,0,0,0,0,2,1,1,0,0,0,0,0,0,0,0,0
223223,37000,370,0,-2,196,22,174,2,1,1,18,1,17,76,4,72,44,5,39,0,0,0,28,7,21,3,0,3,25,4,21,0,0,0
223232,37000,370,0,-2,31,4,27,0,0,0,1,0,1,2,0,2,3,0,3,0,0,0,24,4,20,1,0,1,0,0,0,0,0,0
223320,37000,370,0,-2,3,0,3,0,0,0,0,0,0,0,0,0,1,0,1,0,0,0,2,0,2,0,0,0,0,0,0,0,0,0
223427,37000,370,0,-2,5,2,3,0,0,0,0,0,0,0,0,0,0,0,0,0,0,0,5,2,3,0,0,0,0,0,0,0,0,0
223816,37000,370,0,-2,14,3,11,0,0,0,0,0,0,4,3,1,3,0,3,2,0,2,5,0,5,0,0,0,0,0,0,0,0,0
223898,37000,370,0,-2,7,1,6,0,0,0,0,0,0,0,0,0,3,1,2,0,0,0,3,0,3,0,0,0,1,0,1,0,0,0
223922,37000,370,0,-2,1,0,1,0,0,0,0,0,0,0,0,0,0,0,0,0,0,0,1,0,1,0,0,0,0,0,0,0,0,0
224004,37000,370,0,-2,1,0,1,0,0,0,0,0,0,0,0,0,0,0,0,0,0,0,1,0,1,0,0,0,0,0,0,0,0,0
224110,37000,370,0,-2,3,0,3,0,0,0,0,0,0,0,0,0,2,0,2,0,0,0,1,0,1,0,0,0,0,0,0,0,0,0
224147,37000,370,0,-2,21,9,12,0,0,0,0,0,0,2,1,1,13,6,7,0,0,0,6,2,4,0,0,0,0,0,0,0,0,0
224226,37000,370,0,-2,8,2,6,0,0,0,1,0,1,0,0,0,1,0,1,0,0,0,6,2,4,0,0,0,0,0,0,0,0,0
224305,37000,370,0,-2,21,6,15,0,0,0,1,1,0,4,1,3,3,1,2,0,0,0,13,3,10,0,0,0,0,0,0,0,0,0
224323,37000,370,0,-2,15,3,12,0,0,0,0,0,0,2,1,1,3,0,3,0,0,0,8,2,6,1,0,1,1,0,1,0,0,0
224350,37000,370,0,-2,10,2,8,0,0,0,0,0,0,1,0,1,6,1,5,0,0,0,3,1,2,0,0,0,0,0,0,0,0,0
224527,37000,370,0,-2,9,1,8,0,0,0,0,0,0,0,0,0,0,0,0,0,0,0,8,1,7,0,0,0,1,0,1,0,0,0
224554,37000,370,0,-2,26,6,20,1,0,1,3,0,3,2,2,0,4,1,3,0,0,0,16,3,13,0,0,0,0,0,0,0,0,0
224615,37000,370,0,-2,5,1,4,0,0,0,0,0,0,2,1,1,2,0,2,0,0,0,1,0,1,0,0,0,0,0,0,0,0,0
224642,37000,370,0,-2,16,5,11,0,0,0,0,0,0,0,0,0,15,5,10,0,0,0,1,0,1,0,0,0,0,0,0,0,0,0
224660,37000,370,0,-2,2,1,1,0,0,0,0,0,0,0,0,0,2,1,1,0,0,0,0,0,0,0,0,0,0,0,0,0,0,0
224679,37000,370,0,-2,1,0,1,0,0,0,0,0,0,0,0,0,0,0,0,0,0,0,0,0,0,1,0,1,0,0,0,0,0,0
224776,37000,370,0,-2,3,0,3,0,0,0,0,0,0,0,0,0,1,0,1,0,0,0,1,0,1,1,0,1,0,0,0,0,0,0
224891,37000,370,0,-2,11,0,11,0,0,0,0,0,0,0,0,0,3,0,3,0,0,0,8,0,8,0,0,0,0,0,0,0,0,0
224961,37000,370,0,-2,3,0,3,0,0,0,0,0,0,0,0,0,0,0,0,0,0,0,3,0,3,0,0,0,0,0,0,0,0,0
225070,37000,370,0,-2,8,0,8,0,0,0,0,0,0,1,0,1,0,0,0,0,0,0,7,0,7,0,0,0,0,0,0,0,0,0
225247,37000,370,0,-2,5,0,5,0,0,0,0,0,0,0,0,0,2,0,2,0,0,0,3,0,3,0,0,0,0,0,0,0,0,0
225308,37000,370,0,-2,9,1,8,0,0,0,0,0,0,1,0,1,1,0,1,0,0,0,7,1,6,0,0,0,0,0,0,0,0,0
225371,37000,370,0,-2,3,1,2,0,0,0,0,0,0,0,0,0,0,0,0,0,0,0,3,1,2,0,0,0,0,0,0,0,0,0
225399,37000,370,0,-2,23,7,16,0,0,0,1,1,0,8,2,6,2,0,2,0,0,0,9,3,6,1,0,1,0,0,0,2,1,1
225414,37000,370,0,-2,4,0,4,0,0,0,0,0,0,0,0,0,1,0,1,0,0,0,3,0,3,0,0,0,0,0,0,0,0,0
225423,37000,370,0,-2,7,1,6,0,0,0,2,1,1,4,0,4,1,0,1,0,0,0,0,0,0,0,0,0,0,0,0,0,0,0
225432,37000,370,0,-2,4,2,2,0,0,0,0,0,0,2,0,2,0,0,0,0,0,0,1,1,0,0,0,0,1,1,0,0,0,0
225502,37000,370,0,-2,2,0,2,0,0,0,0,0,0,0,0,0,2,0,2,0,0,0,0,0,0,0,0,0,0,0,0,0,0,0
225511,37000,370,0,-2,34,4,30,0,0,0,2,0,2,12,1,11,13,2,11,0,0,0,6,1,5,1,0,1,0,0,0,0,0,0
225520,37000,370,0,-2,4,0,4,0,0,0,0,0,0,0,0,0,0,0,0,0,0,0,4,0,4,0,0,0,0,0,0,0,0,0
225548,37000,370,0,-2,8,1,7,0,0,0,0,0,0,0,0,0,3,0,3,0,0,0,5,1,4,0,0,0,0,0,0,0,0,0
225575,37000,370,0,-2,5,0,5,0,0,0,0,0,0,3,0,3,1,0,1,0,0,0,0,0,0,0,0,0,1,0,1,0,0,0
225627,37000,370,0,-2,16,4,12,0,0,0,0,0,0,0,0,0,13,4,9,0,0,0,3,0,3,0,0,0,0,0,0,0,0,0
225876,37000,370,0,-2,2,0,2,0,0,0,0,0,0,0,0,0,0,0,0,0,0,0,2,0,2,0,0,0,0,0,0,0,0,0
225885,37000,370,0,-2,2,0,2,0,0,0,0,0,0,2,0,2,0,0,0,0,0,0,0,0,0,0,0,0,0,0,0,0,0,0
226019,37000,370,0,-2,7,1,6,0,0,0,0,0,0,1,0,1,0,0,0,0,0,0,6,1,5,0,0,0,0,0,0,0,0,0
226091,37000,370,0,-2,15,2,13,0,0,0,1,0,1,1,0,1,0,0,0,0,0,0,13,2,11,0,0,0,0,0,0,0,0,0
226116,37000,370,0,-2,8,1,7,0,0,0,0,0,0,2,0,2,3,1,2,0,0,0,3,0,3,0,0,0,0,0,0,0,0,0
226134,37000,370,0,-2,5,0,5,0,0,0,0,0,0,0,0,0,5,0,5,0,0,0,0,0,0,0,0,0,0,0,0,0,0,0
226152,37000,370,0,-2,13,3,10,0,0,0,0,0,0,0,0,0,12,2,10,0,0,0,1,1,0,0,0,0,0,0,0,0,0,0
226204,37000,370,0,-2,7,0,7,0,0,0,0,0,0,0,0,0,3,0,3,0,0,0,4,0,4,0,0,0,0,0,0,0,0,0
226231,37000,370,0,-2,6,0,6,0,0,0,0,0,0,0,0,0,0,0,0,0,0,0,6,0,6,0,0,0,0,0,0,0,0,0
226277,37000,370,0,-2,10,2,8,0,0,0,0,0,0,0,0,0,5,0,5,0,0,0,5,2,3,0,0,0,0,0,0,0,0,0
226383,37000,370,0,-2,9,0,9,0,0,0,0,0,0,1,0,1,0,0,0,0,0,0,8,0,8,0,0,0,0,0,0,0,0,0
226408,37000,370,0,-2,3,0,3,0,0,0,0,0,0,0,0,0,0,0,0,0,0,0,2,0,2,1,0,1,0,0,0,0,0,0
226471,37000,370,0,-2,9,1,8,0,0,0,0,0,0,1,0,1,1,0,1,0,0,0,6,1,5,1,0,1,0,0,0,0,0,0
226578,37000,370,0,-2,10,2,8,0,0,0,0,0,0,1,0,1,5,1,4,0,0,0,4,1,3,0,0,0,0,0,0,0,0,0
226587,37000,370,0,-2,8,0,8,0,0,0,0,0,0,0,0,0,3,0,3,0,0,0,5,0,5,0,0,0,0,0,0,0,0,0
226806,37000,370,0,-2,13,0,13,0,0,0,0,0,0,1,0,1,5,0,5,0,0,0,6,0,6,0,0,0,1,0,1,0,0,0
226833,37000,370,0,-2,34,9,25,0,0,0,0,0,0,6,2,4,1,0,1,1,0,1,22,5,17,3,1,2,1,1,0,0,0,0
226903,37000,370,0,-2,4,0,4,0,0,0,0,0,0,0,0,0,4,0,4,0,0,0,0,0,0,0,0,0,0,0,0,0,0,0
227146,37000,370,0,-2,5,2,3,0,0,0,0,0,0,0,0,0,0,0,0,0,0,0,5,2,3,0,0,0,0,0,0,0,0,0
227182,37000,370,0,-2,32,5,27,0,0,0,2,1,1,10,2,8,10,2,8,1,0,1,7,0,7,1,0,1,1,0,1,0,0,0
227216,37000,370,0,-2,87,22,65,0,0,0,1,0,1,9,5,4,29,8,21,0,0,0,42,7,35,4,0,4,2,2,0,0,0,0
227225,37000,370,0,-2,1,0,1,0,0,0,0,0,0,0,0,0,1,0,1,0,0,0,0,0,0,0,0,0,0,0,0,0,0,0
227304,37000,370,0,-2,3,0,3,0,0,0,0,0,0,1,0,1,2,0,2,0,0,0,0,0,0,0,0,0,0,0,0,0,0,0
227331,37000,370,0,-2,6,1,5,1,0,1,0,0,0,0,0,0,5,1,4,0,0,0,0,0,0,0,0,0,0,0,0,0,0,0
227368,37000,370,0,-2,29,4,25,0,0,0,0,0,0,0,0,0,25,2,23,0,0,0,4,2,2,0,0,0,0,0,0,0,0,0
227377,37000,370,0,-2,8,1,7,0,0,0,0,0,0,0,0,0,8,1,7,0,0,0,0,0,0,0,0,0,0,0,0,0,0,0
227386,37000,370,0,-2,4,0,4,0,0,0,0,0,0,1,0,1,0,0,0,0,0,0,3,0,3,0,0,0,0,0,0,0,0,0
227401,37000,370,0,-2,5,1,4,0,0,0,0,0,0,0,0,0,0,0,0,0,0,0,5,1,4,0,0,0,0,0,0,0,0,0
227526,37000,370,0,-2,20,0,20,0,0,0,0,0,0,15,0,15,3,0,3,0,0,0,1,0,1,1,0,1,0,0,0,0,0,0
227757,37000,370,0,-2,23,7,16,0,0,0,2,0,2,6,1,5,6,3,3,0,0,0,8,2,6,0,0,0,1,1,0,0,0,0
227845,37000,370,0,-2,21,8,13,0,0,0,2,1,1,0,0,0,9,3,6,0,0,0,10,4,6,0,0,0,0,0,0,0,0,0
227854,37000,370,0,-2,4,1,3,0,0,0,0,0,0,1,0,1,1,0,1,0,0,0,2,1,1,0,0,0,0,0,0,0,0,0
227863,37000,370,0,-2,11,1,10,0,0,0,1,0,1,3,0,3,5,1,4,0,0,0,2,0,2,0,0,0,0,0,0,0,0,0
227881,37000,370,0,-2,115,36,79,0,0,0,2,1,1,14,7,7,20,4,16,0,0,0,73,20,53,3,2,1,0,0,0,3,2,1
227924,37000,370,0,-2,4,3,1,1,1,0,0,0,0,0,0,0,3,2,1,0,0,0,0,0,0,0,0,0,0,0,0,0,0,0
227979,37000,370,0,-2,32,5,27,0,0,0,0,0,0,7,1,6,13,3,10,0,0,0,11,1,10,0,0,0,0,0,0,1,0,1
228149,37000,370,0,-2,13,6,7,0,0,0,0,0,0,0,0,0,9,4,5,0,0,0,4,2,2,0,0,0,0,0,0,0,0,0
228158,37000,370,0,-2,7,0,7,0,0,0,0,0,0,0,0,0,3,0,3,0,0,0,4,0,4,0,0,0,0,0,0,0,0,0
228194,37000,370,0,-2,3,1,2,0,0,0,0,0,0,0,0,0,1,1,0,0,0,0,2,0,2,0,0,0,0,0,0,0,0,0
228246,37000,370,0,-2,36,4,32,0,0,0,0,0,0,10,2,8,12,2,10,0,0,0,11,0,11,3,0,3,0,0,0,0,0,0
228316,37000,370,0,-2,8,1,7,0,0,0,0,0,0,0,0,0,7,1,6,0,0,0,1,0,1,0,0,0,0,0,0,0,0,0
228325,37000,370,0,-2,6,1,5,1,0,1,0,0,0,0,0,0,1,1,0,0,0,0,4,0,4,0,0,0,0,0,0,0,0,0
228343,37000,370,0,-2,1,1,0,0,0,0,0,0,0,0,0,0,0,0,0,0,0,0,1,1,0,0,0,0,0,0,0,0,0,0
228431,37000,370,0,-2,9,2,7,0,0,0,0,0,0,2,1,1,0,0,0,0,0,0,7,1,6,0,0,0,0,0,0,0,0,0
228459,37000,370,0,-2,48,6,42,1,1,0,0,0,0,2,0,2,19,3,16,0,0,0,23,1,22,1,0,1,2,1,1,0,0,0
228468,37000,370,0,-2,3,0,3,0,0,0,0,0,0,0,0,0,1,0,1,0,0,0,2,0,2,0,0,0,0,0,0,0,0,0
228501,37000,370,0,-2,43,20,23,0,0,0,0,0,0,1,1,0,21,9,12,0,0,0,19,8,11,1,1,0,1,1,0,0,0,0
228529,37000,370,0,-2,32,3,29,0,0,0,0,0,0,0,0,0,6,0,6,0,0,0,26,3,23,0,0,0,0,0,0,0,0,0
228547,37000,370,0,-2,30,6,24,0,0,0,1,0,1,4,2,2,13,2,11,1,0,1,11,2,9,0,0,0,0,0,0,0,0,0
228608,37000,370,0,-2,6,1,5,0,0,0,0,0,0,0,0,0,4,0,4,0,0,0,2,1,1,0,0,0,0,0,0,0,0,0
228635,37000,370,0,-2,161,28,133,1,0,1,20,3,17,40,3,37,38,5,33,1,0,1,50,13,37,6,2,4,0,0,0,5,2,3
228644,37000,370,0,-2,251,19,232,2,0,2,5,0,5,8,4,4,120,7,113,0,0,0,22,1,21,1,0,1,93,7,86,0,0,0
228653,37000,370,0,-2,42,22,20,0,0,0,1,0,1,6,5,1,17,11,6,0,0,0,17,6,11,0,0,0,1,0,1,0,0,0
228699,37000,370,0,-2,3,0,3,0,0,0,0,0,0,1,0,1,1,0,1,0,0,0,1,0,1,0,0,0,0,0,0,0,0,0
228705,37000,370,0,-2,14,3,11,0,0,0,0,0,0,0,0,0,9,2,7,0,0,0,3,0,3,0,0,0,2,1,1,0,0,0
228723,37000,370,0,-2,182,38,144,1,1,0,7,1,6,25,6,19,40,5,35,0,0,0,99,23,76,6,1,5,4,1,3,0,0,0
228732,37000,370,0,-2,3,0,3,0,0,0,0,0,0,1,0,1,1,0,1,0,0,0,1,0,1,0,0,0,0,0,0,0,0,0
228769,37000,370,0,-2,48,6,42,0,0,0,2,0,2,10,1,9,5,0,5,0,0,0,15,3,12,4,1,3,12,1,11,0,0,0
228778,37000,370,0,-2,181,48,133,0,0,0,8,0,8,9,1,8,54,18,36,0,0,0,100,26,74,9,3,6,1,0,1,0,0,0
228787,37000,370,0,-2,54,14,40,0,0,0,8,3,5,8,2,6,6,2,4,0,0,0,26,7,19,2,0,2,4,0,4,0,0,0
228796,37000,370,0,-2,32,10,22,0,0,0,1,0,1,1,1,0,27,8,19,1,1,0,1,0,1,1,0,1,0,0,0,0,0,0
228802,37000,370,0,-2,137,29,108,0,0,0,2,0,2,31,6,25,16,7,9,1,0,1,80,12,68,1,0,1,5,3,2,1,1,0
228866,37000,370,0,-2,3,0,3,0,0,0,0,0,0,0,0,0,2,0,2,0,0,0,1,0,1,0,0,0,0,0,0,0,0,0
228875,37000,370,0,-2,25,3,22,0,0,0,1,1,0,5,0,5,4,1,3,0,0,0,13,1,12,0,0,0,2,0,2,0,0,0
228909,37000,370,0,-2,30,1,29,0,0,0,2,0,2,2,0,2,12,1,11,1,0,1,11,0,11,1,0,1,1,0,1,0,0,0
228981,37000,370,0,-2,4,0,4,0,0,0,0,0,0,0,0,0,1,0,1,0,0,0,3,0,3,0,0,0,0,0,0,0,0,0
229018,37000,370,0,-2,3,1,2,0,0,0,0,0,0,0,0,0,1,0,1,0,0,0,2,1,1,0,0,0,0,0,0,0,0,0
229027,37000,370,0,-2,25,7,18,0,0,0,1,1,0,1,0,1,14,3,11,0,0,0,3,0,3,0,0,0,6,3,3,0,0,0
229063,37000,370,0,-2,25,6,19,0,0,0,1,1,0,22,5,17,0,0,0,0,0,0,1,0,1,0,0,0,0,0,0,1,0,1
229090,37000,370,0,-2,9,0,9,0,0,0,0,0,0,0,0,0,8,0,8,0,0,0,1,0,1,0,0,0,0,0,0,0,0,0
229115,37000,370,0,-2,134,45,89,0,0,0,2,1,1,10,4,6,30,12,18,1,0,1,85,25,60,3,1,2,0,0,0,3,2,1
229160,37000,370,0,-2,9,3,6,0,0,0,0,0,0,0,0,0,3,1,2,0,0,0,6,2,4,0,0,0,0,0,0,0,0,0
229179,37000,370,0,-2,20,4,16,0,0,0,0,0,0,7,1,6,1,0,1,1,1,0,10,2,8,0,0,0,1,0,1,0,0,0
229267,37000,370,0,-2,5,2,3,0,0,0,0,0,0,1,0,1,4,2,2,0,0,0,0,0,0,0,0,0,0,0,0,0,0,0
229300,37000,370,0,-2,357,45,312,2,1,1,23,8,15,108,6,102,149,16,133,1,0,1,47,10,37,10,2,8,14,1,13,3,1,2
229337,37000,370,0,-2,79,11,68,1,0,1,3,0,3,4,0,4,37,5,32,0,0,0,34,6,28,0,0,0,0,0,0,0,0,0
229355,37000,370,0,-2,8,0,8,0,0,0,0,0,0,3,0,3,0,0,0,0,0,0,5,0,5,0,0,0,0,0,0,0,0,0
229407,37000,370,0,-2,1,0,1,0,0,0,0,0,0,1,0,1,0,0,0,0,0,0,0,0,0,0,0,0,0,0,0,0,0,0
229504,37000,370,0,-2,7,0,7,0,0,0,0,0,0,1,0,1,2,0,2,0,0,0,2,0,2,1,0,1,1,0,1,0,0,0
229540,37000,370,0,-2,6,0,6,0,0,0,0,0,0,2,0,2,2,0,2,0,0,0,2,0,2,0,0,0,0,0,0,0,0,0
229780,37000,370,0,-2,10,1,9,0,0,0,0,0,0,1,0,1,0,0,0,1,0,1,7,0,7,1,1,0,0,0,0,0,0,0
229799,37000,370,0,-2,2,0,2,0,0,0,0,0,0,0,0,0,0,0,0,0,0,0,2,0,2,0,0,0,0,0,0,0,0,0
229814,37000,370,0,-2,23,5,18,1,1,0,0,0,0,0,0,0,6,1,5,0,0,0,15,2,13,1,1,0,0,0,0,0,0,0
229841,37000,370,0,-2,1,0,1,0,0,0,0,0,0,0,0,0,0,0,0,0,0,0,1,0,1,0,0,0,0,0,0,0,0,0
229887,37000,370,0,-2,3,0,3,0,0,0,0,0,0,2,0,2,0,0,0,0,0,0,1,0,1,0,0,0,0,0,0,0,0,0
230038,37000,370,0,-2,32,5,27,0,0,0,0,0,0,0,0,0,2,0,2,2,0,2,26,4,22,1,0,1,1,1,0,0,0,0
230047,37000,370,0,-2,8,3,5,0,0,0,0,0,0,0,0,0,1,0,1,5,3,2,2,0,2,0,0,0,0,0,0,0,0,0
230171,37000,370,0,-2,17,4,13,1,1,0,1,0,1,0,0,0,2,0,2,0,0,0,13,3,10,0,0,0,0,0,0,0,0,0
230366,37000,370,0,-2,2,0,2,0,0,0,0,0,0,0,0,0,1,0,1,0,0,0,1,0,1,0,0,0,0,0,0,0,0,0
230603,37000,370,0,-2,1,0,1,0,0,0,0,0,0,0,0,0,0,0,0,0,0,0,1,0,1,0,0,0,0,0,0,0,0,0
230728,37000,370,0,-2,112,26,86,2,1,1,3,0,3,0,0,0,10,1,9,0,0,0,94,23,71,2,1,1,1,0,1,0,0,0
230737,37000,370,0,-2,34,6,28,1,1,0,0,0,0,0,0,0,2,0,2,0,0,0,27,5,22,1,0,1,1,0,1,2,0,2
230746,37000,370,0,-2,33,9,24,0,0,0,0,0,0,2,0,2,4,1,3,2,1,1,25,7,18,0,0,0,0,0,0,0,0,0
230764,37000,370,0,-2,328,76,252,3,2,1,13,3,10,6,1,5,53,8,45,3,1,2,201,43,158,12,5,7,30,11,19,7,2,5
230782,37000,370,0,-2,43,10,33,0,0,0,1,0,1,0,0,0,7,1,6,0,0,0,34,9,25,1,0,1,0,0,0,0,0,0
230807,37000,370,0,-2,3,0,3,0,0,0,0,0,0,0,0,0,0,0,0,0,0,0,3,0,3,0,0,0,0,0,0,0,0,0
230816,37000,370,0,-2,1,0,1,1,0,1,0,0,0,0,0,0,0,0,0,0,0,0,0,0,0,0,0,0,0,0,0,0,0,0
230834,37000,370,0,-2,4,2,2,0,0,0,0,0,0,0,0,0,0,0,0,0,0,0,4,2,2,0,0,0,0,0,0,0,0,0
230852,37000,370,0,-2,6,2,4,0,0,0,1,1,0,0,0,0,0,0,0,0,0,0,3,1,2,0,0,0,2,0,2,0,0,0
230861,37000,370,0,-2,8,3,5,0,0,0,0,0,0,0,0,0,0,0,0,0,0,0,8,3,5,0,0,0,0,0,0,0,0,0
230889,37000,370,0,-2,1,0,1,0,0,0,0,0,0,0,0,0,1,0,1,0,0,0,0,0,0,0,0,0,0,0,0,0,0,0
230913,37000,370,0,-2,11,7,4,0,0,0,0,0,0,3,3,0,0,0,0,0,0,0,7,3,4,0,0,0,1,1,0,0,0,0
230959,37000,370,0,-2,12,1,11,0,0,0,0,0,0,1,1,0,0,0,0,0,0,0,7,0,7,0,0,0,4,0,4,0,0,0
230995,37000,370,0,-2,19,4,15,0,0,0,0,0,0,0,0,0,2,1,1,0,0,0,17,3,14,0,0,0,0,0,0,0,0,0
231059,37000,370,0,-2,3,1,2,0,0,0,0,0,0,0,0,0,0,0,0,0,0,0,2,1,1,0,0,0,1,0,1,0,0,0
231147,37000,370,0,-2,1,0,1,0,0,0,0,0,0,0,0,0,0,0,0,0,0,0,1,0,1,0,0,0,0,0,0,0,0,0
231165,37000,370,0,-2,4,2,2,0,0,0,0,0,0,0,0,0,0,0,0,0,0,0,4,2,2,0,0,0,0,0,0,0,0,0
231174,37000,370,0,-2,60,20,40,0,0,0,0,0,0,0,0,0,4,1,3,0,0,0,53,19,34,1,0,1,2,0,2,0,0,0
231420,37000,370,0,-2,5,2,3,0,0,0,1,1,0,0,0,0,0,0,0,0,0,0,4,1,3,0,0,0,0,0,0,0,0,0
231536,37000,370,0,-2,3,0,3,0,0,0,0,0,0,0,0,0,0,0,0,0,0,0,3,0,3,0,0,0,0,0,0,0,0,0
231581,37000,370,0,-2,8,2,6,0,0,0,0,0,0,0,0,0,0,0,0,0,0,0,8,2,6,0,0,0,0,0,0,0,0,0
231624,37000,370,0,-2,34,8,26,0,0,0,0,0,0,8,2,6,1,0,1,0,0,0,20,4,16,3,1,2,2,1,1,0,0,0
231651,37000,370,0,-2,1,0,1,0,0,0,0,0,0,0,0,0,0,0,0,0,0,0,1,0,1,0,0,0,0,0,0,0,0,0
231697,37000,370,0,-2,2,0,2,0,0,0,0,0,0,1,0,1,0,0,0,0,0,0,1,0,1,0,0,0,0,0,0,0,0,0
231785,37000,370,0,-2,8,0,8,0,0,0,0,0,0,5,0,5,0,0,0,0,0,0,0,0,0,2,0,2,1,0,1,0,0,0
231873,37000,370,0,-2,2,1,1,0,0,0,0,0,0,0,0,0,0,0,0,0,0,0,2,1,1,0,0,0,0,0,0,0,0,0
231882,37000,370,0,-2,3,0,3,0,0,0,0,0,0,1,0,1,0,0,0,0,0,0,2,0,2,0,0,0,0,0,0,0,0,0
231970,37000,370,0,-2,37,1,36,0,0,0,1,0,1,19,0,19,3,1,2,0,0,0,10,0,10,4,0,4,0,0,0,0,0,0
232016,37000,370,0,-2,2,0,2,0,0,0,0,0,0,2,0,2,0,0,0,0,0,0,0,0,0,0,0,0,0,0,0,0,0,0
232025,37000,370,0,-2,3,0,3,0,0,0,0,0,0,0,0,0,0,0,0,0,0,0,1,0,1,0,0,0,2,0,2,0,0,0
232043,37000,370,0,-2,4,0,4,0,0,0,0,0,0,1,0,1,0,0,0,0,0,0,3,0,3,0,0,0,0,0,0,0,0,0
232089,37000,370,0,-2,1,0,1,0,0,0,0,0,0,0,0,0,0,0,0,0,0,0,0,0,0,0,0,0,1,0,1,0,0,0
232186,37000,370,0,-2,61,13,48,0,0,0,8,0,8,14,3,11,4,1,3,0,0,0,31,9,22,4,0,4,0,0,0,0,0,0
232195,37000,370,0,-2,2,0,2,0,0,0,0,0,0,0,0,0,0,0,0,0,0,0,2,0,2,0,0,0,0,0,0,0,0,0
232256,37000,370,0,-2,2,0,2,0,0,0,0,0,0,0,0,0,0,0,0,0,0,0,2,0,2,0,0,0,0,0,0,0,0,0
232265,37000,370,0,-2,24,2,22,0,0,0,0,0,0,19,2,17,0,0,0,0,0,0,5,0,5,0,0,0,0,0,0,0,0,0
232308,37000,370,0,-2,7,2,5,0,0,0,0,0,0,0,0,0,1,0,1,0,0,0,6,2,4,0,0,0,0,0,0,0,0,0
232414,37000,370,0,-2,7,1,6,0,0,0,0,0,0,3,0,3,0,0,0,0,0,0,4,1,3,0,0,0,0,0,0,0,0,0
232423,37000,370,0,-2,19,2,17,0,0,0,0,0,0,1,0,1,3,1,2,0,0,0,15,1,14,0,0,0,0,0,0,0,0,0
232450,37000,370,0,-2,2,0,2,0,0,0,0,0,0,1,0,1,0,0,0,0,0,0,1,0,1,0,0,0,0,0,0,0,0,0
232557,37000,370,0,-2,206,62,144,1,0,1,9,2,7,25,11,14,8,3,5,0,0,0,161,46,115,0,0,0,2,0,2,0,0,0
232575,37000,370,0,-2,2,0,2,0,0,0,0,0,0,0,0,0,0,0,0,0,0,0,2,0,2,0,0,0,0,0,0,0,0,0
232609,37000,370,0,-2,1,0,1,0,0,0,0,0,0,0,0,0,0,0,0,0,0,0,1,0,1,0,0,0,0,0,0,0,0,0
232672,37000,370,0,-2,2,0,2,0,0,0,0,0,0,0,0,0,0,0,0,0,0,0,2,0,2,0,0,0,0,0,0,0,0,0
232681,37000,370,0,-2,4,0,4,0,0,0,0,0,0,1,0,1,0,0,0,0,0,0,3,0,3,0,0,0,0,0,0,0,0,0
232706,37000,370,0,-2,9,1,8,0,0,0,0,0,0,2,1,1,0,0,0,0,0,0,7,0,7,0,0,0,0,0,0,0,0,0
232788,37000,370,0,-2,3,0,3,0,0,0,0,0,0,0,0,0,0,0,0,0,0,0,2,0,2,1,0,1,0,0,0,0,0,0
232797,37000,370,0,-2,15,6,9,0,0,0,1,0,1,5,1,4,1,0,1,0,0,0,7,4,3,0,0,0,1,1,0,0,0,0
232937,37000,370,0,-2,2,0,2,0,0,0,0,0,0,2,0,2,0,0,0,0,0,0,0,0,0,0,0,0,0,0,0,0,0,0
232946,37000,370,0,-2,12,6,6,0,0,0,3,2,1,6,3,3,0,0,0,0,0,0,3,1,2,0,0,0,0,0,0,0,0,0
232982,37000,370,0,-2,18,4,14,0,0,0,1,1,0,7,1,6,0,0,0,0,0,0,10,2,8,0,0,0,0,0,0,0,0,0
233019,37000,370,0,-2,1,0,1,0,0,0,0,0,0,0,0,0,0,0,0,0,0,0,1,0,1,0,0,0,0,0,0,0,0,0
233116,37000,370,0,-2,4,0,4,0,0,0,0,0,0,0,0,0,0,0,0,0,0,0,4,0,4,0,0,0,0,0,0,0,0,0
233277,37000,370,0,-2,25,5,20,0,0,0,0,0,0,3,1,2,1,0,1,0,0,0,21,4,17,0,0,0,0,0,0,0,0,0
233295,37000,370,0,-2,8,0,8,0,0,0,0,0,0,0,0,0,1,0,1,0,0,0,7,0,7,0,0,0,0,0,0,0,0,0
233301,37000,370,0,-2,1,0,1,0,0,0,0,0,0,0,0,0,0,0,0,0,0,0,1,0,1,0,0,0,0,0,0,0,0,0
233310,37000,370,0,-2,1,0,1,0,0,0,0,0,0,0,0,0,0,0,0,0,0,0,1,0,1,0,0,0,0,0,0,0,0,0
233329,37000,370,0,-2,1,0,1,0,0,0,0,0,0,0,0,0,0,0,0,0,0,0,1,0,1,0,0,0,0,0,0,0,0,0
233356,37000,370,0,-2,1,0,1,0,0,0,0,0,0,0,0,0,0,0,0,0,0,0,1,0,1,0,0,0,0,0,0,0,0,0
233374,37000,370,0,-2,15,2,13,0,0,0,0,0,0,0,0,0,1,0,1,0,0,0,14,2,12,0,0,0,0,0,0,0,0,0
233426,37000,370,0,-2,3,0,3,0,0,0,0,0,0,1,0,1,1,0,1,0,0,0,1,0,1,0,0,0,0,0,0,0,0,0
233541,37000,370,0,-2,13,0,13,0,0,0,1,0,1,0,0,0,2,0,2,0,0,0,7,0,7,1,0,1,2,0,2,0,0,0
233611,37000,370,0,-2,2,2,0,0,0,0,0,0,0,0,0,0,0,0,0,0,0,0,2,2,0,0,0,0,0,0,0,0,0,0
233639,37000,370,0,-2,1,1,0,0,0,0,0,0,0,0,0,0,0,0,0,0,0,0,1,1,0,0,0,0,0,0,0,0,0,0
233648,37000,370,0,-2,5,1,4,0,0,0,0,0,0,0,0,0,0,0,0,0,0,0,5,1,4,0,0,0,0,0,0,0,0,0
233718,37000,370,0,-2,6,1,5,0,0,0,0,0,0,1,0,1,0,0,0,0,0,0,5,1,4,0,0,0,0,0,0,0,0,0
233772,37000,370,0,-2,4,3,1,0,0,0,0,0,0,2,1,1,0,0,0,0,0,0,2,2,0,0,0,0,0,0,0,0,0,0
233842,37000,370,0,-2,2,0,2,0,0,0,0,0,0,1,0,1,0,0,0,0,0,0,1,0,1,0,0,0,0,0,0,0,0,0
233897,37000,370,0,-2,9,2,7,0,0,0,0,0,0,0,0,0,0,0,0,0,0,0,9,2,7,0,0,0,0,0,0,0,0,0
233903,37000,370,0,-2,2,0,2,0,0,0,0,0,0,0,0,0,0,0,0,0,0,0,2,0,2,0,0,0,0,0,0,0,0,0
233921,37000,370,0,-2,102,19,83,0,0,0,2,0,2,9,3,6,8,3,5,0,0,0,79,11,68,3,1,2,0,0,0,1,1,0
233949,37000,370,0,-2,2,0,2,0,0,0,0,0,0,0,0,0,0,0,0,0,0,0,2,0,2,0,0,0,0,0,0,0,0,0
234030,37000,370,0,-2,43,11,32,0,0,0,1,0,1,22,4,18,2,1,1,0,0,0,17,6,11,1,0,1,0,0,0,0,0,0
234076,37000,370,0,-2,53,8,45,0,0,0,0,0,0,6,0,6,1,0,1,0,0,0,41,7,34,2,0,2,3,1,2,0,0,0
234085,37000,370,0,-2,10,3,7,0,0,0,0,0,0,0,0,0,1,1,0,0,0,0,9,2,7,0,0,0,0,0,0,0,0,0
234155,37000,370,0,-2,4,1,3,0,0,0,0,0,0,3,0,3,0,0,0,0,0,0,1,1,0,0,0,0,0,0,0,0,0,0
234173,37000,370,0,-2,6,0,6,0,0,0,0,0,0,1,0,1,0,0,0,0,0,0,5,0,5,0,0,0,0,0,0,0,0,0
234207,37000,370,0,-2,14,1,13,0,0,0,0,0,0,0,0,0,1,0,1,0,0,0,13,1,12,0,0,0,0,0,0,0,0,0
234669,37000,370,0,-2,14,7,7,0,0,0,4,2,2,0,0,0,1,1,0,0,0,0,7,4,3,1,0,1,1,0,1,0,0,0
234696,37000,370,0,-2,10,1,9,0,0,0,1,0,1,0,0,0,1,0,1,0,0,0,7,1,6,1,0,1,0,0,0,0,0,0
234711,37000,370,0,-2,6,0,6,0,0,0,0,0,0,0,0,0,5,0,5,0,0,0,1,0,1,0,0,0,0,0,0,0,0,0
234827,37000,370,0,-2,11,3,8,1,0,1,0,0,0,0,0,0,2,1,1,0,0,0,7,2,5,1,0,1,0,0,0,0,0,0
234845,37000,370,0,-2,5,1,4,0,0,0,0,0,0,1,0,1,0,0,0,1,0,1,2,1,1,1,0,1,0,0,0,0,0,0
234915,37000,370,0,-2,2,1,1,0,0,0,0,0,0,1,0,1,0,0,0,0,0,0,1,1,0,0,0,0,0,0,0,0,0,0
234933,37000,370,0,-2,14,4,10,0,0,0,1,0,1,0,0,0,2,0,2,0,0,0,7,3,4,3,0,3,1,1,0,0,0,0
234951,37000,370,0,-2,8,1,7,0,0,0,2,0,2,1,0,1,0,0,0,1,0,1,4,1,3,0,0,0,0,0,0,0,0,0
234979,37000,370,0,-2,28,7,21,0,0,0,0,0,0,1,0,1,10,4,6,0,0,0,15,3,12,2,0,2,0,0,0,0,0,0
235024,37000,370,0,-2,2,0,2,0,0,0,0,0,0,0,0,0,1,0,1,0,0,0,1,0,1,0,0,0,0,0,0,0,0,0
235097,37000,370,0,-2,12,3,9,1,0,1,1,0,1,0,0,0,4,3,1,0,0,0,6,0,6,0,0,0,0,0,0,0,0,0
235103,37000,370,0,-2,33,9,24,0,0,0,1,0,1,1,1,0,3,2,1,0,0,0,17,2,15,8,2,6,3,2,1,0,0,0
235149,37000,370,0,-2,4,0,4,0,0,0,1,0,1,0,0,0,0,0,0,0,0,0,2,0,2,0,0,0,1,0,1,0,0,0
235167,37000,370,0,-2,4,0,4,0,0,0,0,0,0,0,0,0,0,0,0,0,0,0,0,0,0,0,0,0,4,0,4,0,0,0
235237,37000,370,0,-2,15,6,9,0,0,0,2,0,2,2,1,1,1,0,1,1,0,1,4,1,3,0,0,0,5,4,1,0,0,0
235316,37000,370,0,-2,61,21,40,2,1,1,1,1,0,3,2,1,3,1,2,0,0,0,27,8,19,1,0,1,24,8,16,0,0,0
235334,37000,370,0,-2,6,4,2,0,0,0,0,0,0,0,0,0,0,0,0,0,0,0,6,4,2,0,0,0,0,0,0,0,0,0
235343,37000,370,0,-2,14,4,10,0,0,0,4,1,3,0,0,0,0,0,0,1,0,1,4,2,2,2,1,1,3,0,3,0,0,0
235422,37000,370,0,-2,4,0,4,1,0,1,0,0,0,0,0,0,1,0,1,0,0,0,2,0,2,0,0,0,0,0,0,0,0,0
235431,37000,370,0,-2,1,0,1,0,0,0,0,0,0,0,0,0,0,0,0,0,0,0,1,0,1,0,0,0,0,0,0,0,0,0
235547,37000,370,0,-2,3,0,3,0,0,0,0,0,0,0,0,0,0,0,0,0,0,0,3,0,3,0,0,0,0,0,0,0,0,0
235671,37000,370,0,-2,3,1,2,0,0,0,0,0,0,1,1,0,0,0,0,0,0,0,2,0,2,0,0,0,0,0,0,0,0,0
235699,37000,370,0,-2,8,2,6,0,0,0,3,1,2,1,0,1,0,0,0,0,0,0,4,1,3,0,0,0,0,0,0,0,0,0
235750,37000,370,0,-2,7,1,6,0,0,0,0,0,0,0,0,0,0,0,0,0,0,0,6,1,5,1,0,1,0,0,0,0,0,0
236072,37000,370,0,-2,1,1,0,0,0,0,0,0,0,0,0,0,0,0,0,0,0,0,0,0,0,0,0,0,1,1,0,0,0,0
236133,37000,370,0,-2,11,5,6,0,0,0,2,1,1,0,0,0,1,0,1,0,0,0,7,3,4,1,1,0,0,0,0,0,0,0
236188,37000,370,0,-2,15,3,12,0,0,0,1,0,1,1,0,1,0,0,0,0,0,0,13,3,10,0,0,0,0,0,0,0,0,0
236212,37000,370,0,-2,6,0,6,0,0,0,0,0,0,0,0,0,1,0,1,0,0,0,5,0,5,0,0,0,0,0,0,0,0,0
236230,37000,370,0,-2,12,5,7,0,0,0,0,0,0,0,0,0,0,0,0,0,0,0,10,5,5,2,0,2,0,0,0,0,0,0
236258,37000,370,0,-2,11,2,9,0,0,0,0,0,0,0,0,0,0,0,0,0,0,0,7,1,6,1,0,1,3,1,2,0,0,0
236328,37000,370,0,-2,10,0,10,0,0,0,0,0,0,1,0,1,0,0,0,0,0,0,9,0,9,0,0,0,0,0,0,0,0,0
236382,37000,370,0,-2,4,0,4,0,0,0,0,0,0,2,0,2,0,0,0,0,0,0,2,0,2,0,0,0,0,0,0,0,0,0
236452,37000,370,0,-2,13,3,10,0,0,0,2,0,2,1,0,1,0,0,0,0,0,0,9,3,6,0,0,0,1,0,1,0,0,0
236504,37000,370,0,-2,4,3,1,0,0,0,2,2,0,0,0,0,1,0,1,0,0,0,0,0,0,0,0,0,1,1,0,0,0,0
236513,37000,370,0,-2,10,6,4,0,0,0,0,0,0,1,1,0,0,0,0,0,0,0,3,2,1,0,0,0,6,3,3,0,0,0
236577,37000,370,0,-2,45,14,31,0,0,0,3,0,3,5,3,2,5,2,3,0,0,0,24,5,19,3,2,1,5,2,3,0,0,0
236595,37000,370,0,-2,19,4,15,1,0,1,0,0,0,4,1,3,1,1,0,0,0,0,12,2,10,0,0,0,1,0,1,0,0,0
236610,37000,370,0,-2,5,2,3,0,0,0,1,0,1,0,0,0,0,0,0,0,0,0,0,0,0,0,0,0,4,2,2,0,0,0
236638,37000,370,0,-2,8,0,8,0,0,0,0,0,0,0,0,0,0,0,0,0,0,0,6,0,6,2,0,2,0,0,0,0,0,0
236656,37000,370,0,-2,5,3,2,0,0,0,0,0,0,0,0,0,1,0,1,0,0,0,2,1,1,2,2,0,0,0,0,0,0,0
236692,37000,370,0,-2,8,1,7,0,0,0,0,0,0,1,0,1,0,0,0,0,0,0,6,1,5,1,0,1,0,0,0,0,0,0
236708,37000,370,0,-2,2,0,2,0,0,0,0,0,0,0,0,0,0,0,0,0,0,0,2,0,2,0,0,0,0,0,0,0,0,0
236753,37000,370,0,-2,10,2,8,1,0,1,0,0,0,0,0,0,0,0,0,1,0,1,5,1,4,2,1,1,1,0,1,0,0,0
236887,37000,370,0,-2,6,2,4,0,0,0,0,0,0,0,0,0,2,0,2,0,0,0,3,2,1,0,0,0,1,0,1,0,0,0
236896,37000,370,0,-2,2,1,1,0,0,0,0,0,0,0,0,0,0,0,0,0,0,0,2,1,1,0,0,0,0,0,0,0,0,0
236939,37000,370,0,-2,70,20,50,1,1,0,1,0,1,2,0,2,5,2,3,1,0,1,39,10,29,2,1,1,19,6,13,0,0,0
236948,37000,370,0,-2,116,24,92,0,0,0,15,2,13,10,3,7,10,3,7,1,0,1,64,15,49,6,0,6,9,0,9,1,1,0
236975,37000,370,0,-2,9,2,7,0,0,0,0,0,0,0,0,0,7,2,5,0,0,0,2,0,2,0,0,0,0,0,0,0,0,0
237011,37000,370,0,-2,37,11,26,0,0,0,7,3,4,0,0,0,0,0,0,0,0,0,18,5,13,4,0,4,8,3,5,0,0,0
237039,37000,370,0,-2,8,4,4,0,0,0,1,1,0,0,0,0,0,0,0,0,0,0,6,2,4,1,1,0,0,0,0,0,0,0
237057,37000,370,0,-2,5,1,4,0,0,0,0,0,0,1,1,0,0,0,0,0,0,0,3,0,3,0,0,0,1,0,1,0,0,0
237066,37000,370,0,-2,2,2,0,0,0,0,0,0,0,0,0,0,0,0,0,0,0,0,1,1,0,1,1,0,0,0,0,0,0,0
237109,37000,370,0,-2,8,3,5,1,1,0,1,0,1,0,0,0,4,2,2,0,0,0,2,0,2,0,0,0,0,0,0,0,0,0
237118,37000,370,0,-2,4,0,4,0,0,0,0,0,0,0,0,0,0,0,0,0,0,0,4,0,4,0,0,0,0,0,0,0,0,0
237181,37000,370,0,-2,2,0,2,0,0,0,0,0,0,0,0,0,0,0,0,0,0,0,2,0,2,0,0,0,0,0,0,0,0,0
237312,37000,370,0,-2,5,0,5,0,0,0,0,0,0,0,0,0,0,0,0,0,0,0,5,0,5,0,0,0,0,0,0,0,0,0
237330,37000,370,0,-2,4,0,4,0,0,0,0,0,0,0,0,0,0,0,0,0,0,0,4,0,4,0,0,0,0,0,0,0,0,0
237358,37000,370,0,-2,4,0,4,0,0,0,0,0,0,0,0,0,0,0,0,0,0,0,4,0,4,0,0,0,0,0,0,0,0,0
237367,37000,370,0,-2,2,0,2,0,0,0,0,0,0,1,0,1,0,0,0,0,0,0,1,0,1,0,0,0,0,0,0,0,0,0
237525,37000,370,0,-2,7,1,6,0,0,0,0,0,0,0,0,0,2,0,2,0,0,0,5,1,4,0,0,0,0,0,0,0,0,0
237686,37000,370,0,-2,14,4,10,0,0,0,0,0,0,0,0,0,0,0,0,0,0,0,13,3,10,1,1,0,0,0,0,0,0,0
237701,37000,370,0,-2,2,0,2,0,0,0,0,0,0,0,0,0,0,0,0,0,0,0,2,0,2,0,0,0,0,0,0,0,0,0
237783,37000,370,0,-2,2,0,2,0,0,0,0,0,0,0,0,0,0,0,0,0,0,0,2,0,2,0,0,0,0,0,0,0,0,0
237792,37000,370,0,-2,9,2,7,0,0,0,0,0,0,0,0,0,1,0,1,0,0,0,8,2,6,0,0,0,0,0,0,0,0,0
237817,37000,370,0,-2,5,1,4,0,0,0,0,0,0,0,0,0,0,0,0,0,0,0,5,1,4,0,0,0,0,0,0,0,0,0
237880,37000,370,0,-2,2,0,2,0,0,0,0,0,0,0,0,0,0,0,0,0,0,0,2,0,2,0,0,0,0,0,0,0,0,0
237899,37000,370,0,-2,7,1,6,0,0,0,0,0,0,2,0,2,0,0,0,0,0,0,5,1,4,0,0,0,0,0,0,0,0,0
237950,37000,370,0,-2,3,1,2,0,0,0,1,0,1,0,0,0,0,0,0,0,0,0,2,1,1,0,0,0,0,0,0,0,0,0
237969,37000,370,0,-2,4,0,4,0,0,0,0,0,0,0,0,0,0,0,0,0,0,0,4,0,4,0,0,0,0,0,0,0,0,0
237996,37000,370,0,-2,2,0,2,0,0,0,0,0,0,0,0,0,0,0,0,0,0,0,1,0,1,1,0,1,0,0,0,0,0,0
238014,37000,370,0,-2,2,0,2,0,0,0,0,0,0,0,0,0,0,0,0,0,0,0,2,0,2,0,0,0,0,0,0,0,0,0
238032,37000,370,0,-2,10,2,8,0,0,0,1,0,1,1,0,1,0,0,0,0,0,0,8,2,6,0,0,0,0,0,0,0,0,0
238193,37000,370,0,-2,4,0,4,0,0,0,0,0,0,1,0,1,1,0,1,0,0,0,2,0,2,0,0,0,0,0,0,0,0,0
238263,37000,370,0,-2,18,5,13,0,0,0,2,1,1,3,0,3,3,1,2,0,0,0,10,3,7,0,0,0,0,0,0,0,0,0
238333,37000,370,0,-2,6,0,6,0,0,0,0,0,0,0,0,0,1,0,1,0,0,0,4,0,4,0,0,0,0,0,0,1,0,1
238397,37000,370,0,-2,6,1,5,0,0,0,0,0,0,0,0,0,0,0,0,0,0,0,6,1,5,0,0,0,0,0,0,0,0,0
238430,37000,370,0,-2,2,0,2,0,0,0,0,0,0,1,0,1,1,0,1,0,0,0,0,0,0,0,0,0,0,0,0,0,0,0
238458,37000,370,0,-2,6,1,5,0,0,0,0,0,0,0,0,0,0,0,0,0,0,0,6,1,5,0,0,0,0,0,0,0,0,0
238476,37000,370,0,-2,12,3,9,0,0,0,0,0,0,0,0,0,1,0,1,0,0,0,7,2,5,0,0,0,4,1,3,0,0,0
238616,37000,370,0,-2,9,2,7,0,0,0,0,0,0,0,0,0,0,0,0,0,0,0,9,2,7,0,0,0,0,0,0,0,0,0
238661,37000,370,0,-2,1,0,1,0,0,0,0,0,0,0,0,0,0,0,0,0,0,0,1,0,1,0,0,0,0,0,0,0,0,0
238722,37000,370,0,-2,19,5,14,0,0,0,1,1,0,0,0,0,0,0,0,0,0,0,14,4,10,0,0,0,4,0,4,0,0,0
238759,37000,370,0,-2,6,0,6,0,0,0,0,0,0,0,0,0,1,0,1,0,0,0,5,0,5,0,0,0,0,0,0,0,0,0
238980,37000,370,0,-2,1,0,1,0,0,0,0,0,0,0,0,0,0,0,0,0,0,0,1,0,1,0,0,0,0,0,0,0,0,0
239008,37000,370,0,-2,4,1,3,0,0,0,0,0,0,0,0,0,1,0,1,0,0,0,3,1,2,0,0,0,0,0,0,0,0,0
239017,37000,370,0,-2,7,2,5,0,0,0,0,0,0,0,0,0,0,0,0,0,0,0,7,2,5,0,0,0,0,0,0,0,0,0
239071,37000,370,0,-2,4,1,3,0,0,0,0,0,0,0,0,0,0,0,0,0,0,0,4,1,3,0,0,0,0,0,0,0,0,0
239080,37000,370,0,-2,2,1,1,0,0,0,0,0,0,0,0,0,0,0,0,0,0,0,2,1,1,0,0,0,0,0,0,0,0,0
239105,37000,370,0,-2,16,5,11,0,0,0,0,0,0,2,1,1,1,0,1,0,0,0,12,4,8,1,0,1,0,0,0,0,0,0
239169,37000,370,0,-2,76,10,66,1,0,1,1,1,0,8,1,7,14,1,13,0,0,0,49,6,43,3,1,2,0,0,0,0,0,0
239220,37000,370,0,-2,6,0,6,0,0,0,0,0,0,0,0,0,0,0,0,0,0,0,6,0,6,0,0,0,0,0,0,0,0,0
239248,37000,370,0,-2,25,7,18,0,0,0,0,0,0,6,2,4,3,0,3,0,0,0,16,5,11,0,0,0,0,0,0,0,0,0
239318,37000,370,0,-2,5,1,4,0,0,0,1,0,1,0,0,0,1,1,0,0,0,0,3,0,3,0,0,0,0,0,0,0,0,0
239372,37000,370,0,-2,8,0,8,0,0,0,0,0,0,0,0,0,0,0,0,0,0,0,8,0,8,0,0,0,0,0,0,0,0,0
239390,37000,370,0,-2,3,0,3,0,0,0,0,0,0,0,0,0,0,0,0,0,0,0,3,0,3,0,0,0,0,0,0,0,0,0
239442,37000,370,0,-2,1,0,1,0,0,0,0,0,0,0,0,0,0,0,0,0,0,0,1,0,1,0,0,0,0,0,0,0,0,0
239460,37000,370,0,-2,8,0,8,0,0,0,2,0,2,0,0,0,0,0,0,0,0,0,6,0,6,0,0,0,0,0,0,0,0,0
239488,37000,370,0,-2,18,1,17,1,0,1,1,0,1,1,1,0,1,0,1,0,0,0,14,0,14,0,0,0,0,0,0,0,0,0
239628,37000,370,0,-2,1,0,1,0,0,0,0,0,0,0,0,0,0,0,0,0,0,0,1,0,1,0,0,0,0,0,0,0,0,0
239637,37000,370,0,-2,1,0,1,0,0,0,0,0,0,0,0,0,0,0,0,0,0,0,1,0,1,0,0,0,0,0,0,0,0,0
239716,37000,370,0,-2,8,1,7,0,0,0,2,0,2,1,0,1,0,0,0,0,0,0,5,1,4,0,0,0,0,0,0,0,0,0
240107,37000,370,0,-2,6,1,5,0,0,0,0,0,0,0,0,0,1,0,1,0,0,0,5,1,4,0,0,0,0,0,0,0,0,0
240116,37000,370,0,-2,18,4,14,0,0,0,1,0,1,0,0,0,1,1,0,0,0,0,16,3,13,0,0,0,0,0,0,0,0,0
240125,37000,370,0,-2,11,3,8,0,0,0,1,0,1,0,0,0,1,1,0,0,0,0,9,2,7,0,0,0,0,0,0,0,0,0
240189,37000,370,0,-2,8,0,8,0,0,0,0,0,0,1,0,1,1,0,1,0,0,0,6,0,6,0,0,0,0,0,0,0,0,0
240198,37000,370,0,-2,3,0,3,0,0,0,0,0,0,0,0,0,0,0,0,0,0,0,3,0,3,0,0,0,0,0,0,0,0,0
240268,37000,370,0,-2,17,2,15,0,0,0,1,0,1,0,0,0,0,0,0,0,0,0,13,2,11,0,0,0,3,0,3,0,0,0
240277,37000,370,0,-2,9,2,7,0,0,0,1,0,1,0,0,0,0,0,0,0,0,0,8,2,6,0,0,0,0,0,0,0,0,0
240329,37000,370,0,-2,19,2,17,0,0,0,0,0,0,0,0,0,0,0,0,0,0,0,12,2,10,0,0,0,7,0,7,0,0,0
240338,37000,370,0,-2,3,0,3,0,0,0,0,0,0,0,0,0,0,0,0,0,0,0,2,0,2,0,0,0,1,0,1,0,0,0
240365,37000,370,0,-2,20,4,16,0,0,0,1,0,1,0,0,0,0,0,0,0,0,0,16,3,13,1,0,1,2,1,1,0,0,0
240374,37000,370,0,-2,4,2,2,0,0,0,0,0,0,0,0,0,1,0,1,0,0,0,3,2,1,0,0,0,0,0,0,0,0,0
240392,37000,370,0,-2,2,0,2,0,0,0,0,0,0,0,0,0,0,0,0,0,0,0,2,0,2,0,0,0,0,0,0,0,0,0
240417,37000,370,0,-2,9,2,7,0,0,0,0,0,0,0,0,0,0,0,0,0,0,0,9,2,7,0,0,0,0,0,0,0,0,0
240426,37000,370,0,-2,1,0,1,0,0,0,0,0,0,0,0,0,0,0,0,0,0,0,1,0,1,0,0,0,0,0,0,0,0,0
240435,37000,370,0,-2,30,6,24,0,0,0,0,0,0,1,0,1,0,0,0,0,0,0,27,6,21,0,0,0,2,0,2,0,0,0
240444,37000,370,0,-2,137,34,103,1,0,1,9,1,8,3,1,2,5,0,5,0,0,0,110,29,81,4,2,2,4,1,3,1,0,1
240453,37000,370,0,-2,19,2,17,0,0,0,3,1,2,4,0,4,1,0,1,0,0,0,9,1,8,2,0,2,0,0,0,0,0,0
240462,37000,370,0,-2,6,0,6,0,0,0,1,0,1,0,0,0,0,0,0,0,0,0,5,0,5,0,0,0,0,0,0,0,0,0
240471,37000,370,0,-2,4,0,4,0,0,0,0,0,0,0,0,0,0,0,0,0,0,0,4,0,4,0,0,0,0,0,0,0,0,0
240480,37000,370,0,-2,4,1,3,0,0,0,0,0,0,0,0,0,0,0,0,0,0,0,4,1,3,0,0,0,0,0,0,0,0,0
240505,37000,370,0,-2,3,2,1,0,0,0,0,0,0,0,0,0,0,0,0,0,0,0,2,1,1,0,0,0,1,1,0,0,0,0
240514,37000,370,0,-2,1,0,1,0,0,0,0,0,0,0,0,0,0,0,0,0,0,0,1,0,1,0,0,0,0,0,0,0,0,0
240620,37000,370,0,-2,2,0,2,0,0,0,0,0,0,0,0,0,0,0,0,0,0,0,2,0,2,0,0,0,0,0,0,0,0,0
240657,37000,370,0,-2,1,0,1,0,0,0,0,0,0,0,0,0,0,0,0,0,0,0,1,0,1,0,0,0,0,0,0,0,0,0
240666,37000,370,0,-2,3,0,3,0,0,0,0,0,0,0,0,0,0,0,0,0,0,0,3,0,3,0,0,0,0,0,0,0,0,0
240693,37000,370,0,-2,6,0,6,0,0,0,0,0,0,0,0,0,1,0,1,0,0,0,5,0,5,0,0,0,0,0,0,0,0,0
240718,37000,370,0,-2,7,0,7,0,0,0,0,0,0,0,0,0,0,0,0,0,0,0,7,0,7,0,0,0,0,0,0,0,0,0
240727,37000,370,0,-2,33,5,28,0,0,0,0,0,0,0,0,0,1,0,1,0,0,0,24,3,21,0,0,0,7,2,5,1,0,1
240745,37000,370,0,-2,5,2,3,0,0,0,1,1,0,0,0,0,0,0,0,2,1,1,1,0,1,0,0,0,0,0,0,1,0,1
240754,37000,370,0,-2,3,0,3,0,0,0,2,0,2,0,0,0,0,0,0,1,0,1,0,0,0,0,0,0,0,0,0,0,0,0
240790,37000,370,0,-2,13,7,6,0,0,0,3,2,1,0,0,0,0,0,0,8,4,4,1,1,0,0,0,0,0,0,0,1,0,1
241100,37000,370,0,-2,4,3,1,0,0,0,0,0,0,0,0,0,4,3,1,0,0,0,0,0,0,0,0,0,0,0,0,0,0,0
241191,37000,370,0,-2,2,1,1,0,0,0,0,0,0,0,0,0,2,1,1,0,0,0,0,0,0,0,0,0,0,0,0,0,0,0
241225,37000,370,0,-2,3,1,2,0,0,0,0,0,0,0,0,0,3,1,2,0,0,0,0,0,0,0,0,0,0,0,0,0,0,0
241331,37000,370,0,-2,2,0,2,0,0,0,0,0,0,0,0,0,2,0,2,0,0,0,0,0,0,0,0,0,0,0,0,0,0,0
241377,37000,370,0,-2,8,0,8,0,0,0,0,0,0,0,0,0,8,0,8,0,0,0,0,0,0,0,0,0,0,0,0,0,0,0
241395,37000,370,0,-2,1,0,1,0,0,0,0,0,0,0,0,0,1,0,1,0,0,0,0,0,0,0,0,0,0,0,0,0,0,0
241739,37000,370,0,-2,4,0,4,0,0,0,0,0,0,0,0,0,4,0,4,0,0,0,0,0,0,0,0,0,0,0,0,0,0,0
241951,37000,370,0,-2,1,0,1,0,0,0,0,0,0,0,0,0,1,0,1,0,0,0,0,0,0,0,0,0,0,0,0,0,0,0
242060,37000,370,0,-2,1,1,0,0,0,0,0,0,0,0,0,0,1,1,0,0,0,0,0,0,0,0,0,0,0,0,0,0,0,0
242112,37000,370,0,-2,2,0,2,0,0,0,0,0,0,0,0,0,2,0,2,0,0,0,0,0,0,0,0,0,0,0,0,0,0,0
242130,37000,370,0,-2,1,0,1,0,0,0,0,0,0,0,0,0,1,0,1,0,0,0,0,0,0,0,0,0,0,0,0,0,0,0
242617,37000,370,0,-2,4,1,3,0,0,0,0,0,0,0,0,0,4,1,3,0,0,0,0,0,0,0,0,0,0,0,0,0,0,0
242635,37000,370,0,-2,5,1,4,0,0,0,0,0,0,0,0,0,5,1,4,0,0,0,0,0,0,0,0,0,0,0,0,0,0,0
242644,37000,370,0,-2,6,2,4,0,0,0,0,0,0,0,0,0,6,2,4,0,0,0,0,0,0,0,0,0,0,0,0,0,0,0
242653,37000,370,0,-2,12,2,10,0,0,0,0,0,0,0,0,0,12,2,10,0,0,0,0,0,0,0,0,0,0,0,0,0,0,0
242662,37000,370,0,-2,8,1,7,0,0,0,0,0,0,0,0,0,8,1,7,0,0,0,0,0,0,0,0,0,0,0,0,0,0,0
242671,37000,370,0,-2,4,2,2,0,0,0,0,0,0,0,0,0,4,2,2,0,0,0,0,0,0,0,0,0,0,0,0,0,0,0
242680,37000,370,0,-2,3,0,3,0,0,0,0,0,0,0,0,0,3,0,3,0,0,0,0,0,0,0,0,0,0,0,0,0,0,0
242699,37000,370,0,-2,2,0,2,0,0,0,0,0,0,0,0,0,2,0,2,0,0,0,0,0,0,0,0,0,0,0,0,0,0,0
242705,37000,370,0,-2,4,2,2,0,0,0,0,0,0,0,0,0,4,2,2,0,0,0,0,0,0,0,0,0,0,0,0,0,0,0
242723,37000,370,0,-2,2,2,0,0,0,0,0,0,0,0,0,0,2,2,0,0,0,0,0,0,0,0,0,0,0,0,0,0,0,0
242972,37000,370,0,-2,77,11,66,0,0,0,1,0,1,0,0,0,76,11,65,0,0,0,0,0,0,0,0,0,0,0,0,0,0,0
243081,37000,370,0,-2,20,1,19,0,0,0,0,0,0,0,0,0,20,1,19,0,0,0,0,0,0,0,0,0,0,0,0,0,0,0
243160,37000,370,0,-2,1,0,1,0,0,0,0,0,0,0,0,0,0,0,0,0,0,0,0,0,0,0,0,0,1,0,1,0,0,0
243197,37000,370,0,-2,6,1,5,0,0,0,0,0,0,0,0,0,2,1,1,0,0,0,0,0,0,0,0,0,4,0,4,0,0,0
243346,37000,370,0,-2,5,3,2,0,0,0,0,0,0,0,0,0,5,3,2,0,0,0,0,0,0,0,0,0,0,0,0,0,0,0
243443,37000,370,0,-2,3,0,3,0,0,0,0,0,0,0,0,0,3,0,3,0,0,0,0,0,0,0,0,0,0,0,0,0,0,0
243568,37000,370,0,-2,4,1,3,0,0,0,0,0,0,0,0,0,4,1,3,0,0,0,0,0,0,0,0,0,0,0,0,0,0,0
243577,37000,370,0,-2,6,0,6,0,0,0,0,0,0,0,0,0,6,0,6,0,0,0,0,0,0,0,0,0,0,0,0,0,0,0
243601,37000,370,0,-2,4,1,3,0,0,0,0,0,0,0,0,0,4,1,3,0,0,0,0,0,0,0,0,0,0,0,0,0,0,0
243638,37000,370,0,-2,3,0,3,0,0,0,0,0,0,0,0,0,0,0,0,3,0,3,0,0,0,0,0,0,0,0,0,0,0,0
243647,37000,370,0,-2,4,0,4,0,0,0,0,0,0,0,0,0,0,0,0,4,0,4,0,0,0,0,0,0,0,0,0,0,0,0
243744,37000,370,0,-2,212,36,176,0,0,0,37,8,29,14,2,12,36,8,28,0,0,0,55,5,50,2,1,1,65,11,54,3,1,2
243780,37000,370,0,-2,92,12,80,1,0,1,5,1,4,2,0,2,10,1,9,0,0,0,72,10,62,0,0,0,2,0,2,0,0,0
243823,37000,370,0,-2,7,1,6,0,0,0,0,0,0,3,0,3,0,0,0,0,0,0,3,1,2,0,0,0,1,0,1,0,0,0
243832,37000,370,0,-2,12,3,9,0,0,0,0,0,0,0,0,0,12,3,9,0,0,0,0,0,0,0,0,0,0,0,0,0,0,0
243841,37000,370,0,-2,4,1,3,0,0,0,0,0,0,0,0,0,4,1,3,0,0,0,0,0,0,0,0,0,0,0,0,0,0,0
244437,37000,370,0,-2,1,0,1,0,0,0,0,0,0,1,0,1,0,0,0,0,0,0,0,0,0,0,0,0,0,0,0,0,0,0
244446,37000,370,0,-2,11,2,9,0,0,0,0,0,0,10,2,8,0,0,0,0,0,0,1,0,1,0,0,0,0,0,0,0,0,0
245652,37000,370,0,-2,7,4,3,0,0,0,0,0,0,0,0,0,1,1,0,0,0,0,6,3,3,0,0,0,0,0,0,0,0,0
245953,37000,370,0,-2,4,0,4,0,0,0,0,0,0,0,0,0,1,0,1,0,0,0,3,0,3,0,0,0,0,0,0,0,0,0
245962,37000,370,0,-2,1,0,1,0,0,0,0,0,0,1,0,1,0,0,0,0,0,0,0,0,0,0,0,0,0,0,0,0,0,0
246354,37000,370,0,-2,3,0,3,0,0,0,0,0,0,0,0,0,3,0,3,0,0,0,0,0,0,0,0,0,0,0,0,0,0,0
246813,37000,370,0,-2,11,0,11,0,0,0,0,0,0,2,0,2,0,0,0,0,0,0,9,0,9,0,0,0,0,0,0,0,0,0
246974,37000,370,0,-2,1,1,0,0,0,0,0,0,0,1,1,0,0,0,0,0,0,0,0,0,0,0,0,0,0,0,0,0,0,0
247603,37000,370,0,-2,1,0,1,0,0,0,0,0,0,0,0,0,1,0,1,0,0,0,0,0,0,0,0,0,0,0,0,0,0,0
247649,37000,370,0,-2,2,1,1,0,0,0,0,0,0,0,0,0,0,0,0,0,0,0,2,1,1,0,0,0,0,0,0,0,0,0
247834,37000,370,0,-2,37,10,27,0,0,0,2,0,2,8,2,6,2,0,2,0,0,0,19,6,13,3,1,2,3,1,2,0,0,0
247940,37000,370,0,-2,1,0,1,0,0,0,0,0,0,0,0,0,0,0,0,0,0,0,1,0,1,0,0,0,0,0,0,0,0,0
248934,37000,370,0,-2,32,4,28,0,0,0,4,1,3,10,0,10,3,0,3,0,0,0,13,2,11,2,1,1,0,0,0,0,0,0
250027,37000,370,0,-2,1,0,1,0,0,0,0,0,0,0,0,0,0,0,0,0,0,0,1,0,1,0,0,0,0,0,0,0,0,0
251260,37000,370,0,-2,11,2,9,0,0,0,0,0,0,4,0,4,0,0,0,0,0,0,7,2,5,0,0,0,0,0,0,0,0,0
251312,37000,370,0,-2,3,0,3,0,0,0,0,0,0,2,0,2,0,0,0,0,0,0,1,0,1,0,0,0,0,0,0,0,0,0
260372,37000,370,0,-2,2,0,2,1,0,1,0,0,0,0,0,0,0,0,0,0,0,0,1,0,1,0,0,0,0,0,0,0,0,0
260691,37000,370,0,-2,3,0,3,0,0,0,0,0,0,1,0,1,0,0,0,0,0,0,2,0,2,0,0,0,0,0,0,0,0,0
260789,37000,370,0,-2,4,0,4,0,0,0,0,0,0,0,0,0,2,0,2,0,0,0,2,0,2,0,0,0,0,0,0,0,0,0
260992,37000,370,0,-2,1,1,0,0,0,0,0,0,0,1,1,0,0,0,0,0,0,0,0,0,0,0,0,0,0,0,0,0,0,0
262031,37000,370,0,-2,4,2,2,0,0,0,0,0,0,0,0,0,0,0,0,0,0,0,4,2,2,0,0,0,0,0,0,0,0,0
262086,37000,370,0,-2,1,1,0,0,0,0,0,0,0,0,0,0,0,0,0,0,0,0,1,1,0,0,0,0,0,0,0,0,0,0
262129,37000,370,0,-2,9,1,8,1,0,1,0,0,0,1,0,1,1,0,1,0,0,0,6,1,5,0,0,0,0,0,0,0,0,0
262457,37000,370,0,-2,3,0,3,0,0,0,0,0,0,0,0,0,3,0,3,0,0,0,0,0,0,0,0,0,0,0,0,0,0,0
363934,37000,370,0,-2,3,0,3,0,0,0,0,0,0,0,0,0,1,0,1,0,0,0,2,0,2,0,0,0,0,0,0,0,0,0
364016,37000,370,0,-2,1,0,1,0,0,0,0,0,0,0,0,0,0,0,0,0,0,0,1,0,1,0,0,0,0,0,0,0,0,0
364025,37000,370,0,-2,5,0,5,0,0,0,0,0,0,0,0,0,1,0,1,0,0,0,3,0,3,1,0,1,0,0,0,0,0,0
366252,37000,370,0,-2,6,2,4,0,0,0,0,0,0,0,0,0,0,0,0,0,0,0,6,2,4,0,0,0,0,0,0,0,0,0
366340,37000,370,0,-2,4,1,3,4,1,3,0,0,0,0,0,0,0,0,0,0,0,0,0,0,0,0,0,0,0,0,0,0,0,0
366395,37000,370,0,-2,2,0,2,0,0,0,0,0,0,0,0,0,0,0,0,0,0,0,2,0,2,0,0,0,0,0,0,0,0,0
366401,37000,370,0,-2,4,1,3,0,0,0,0,0,0,1,0,1,1,0,1,0,0,0,2,1,1,0,0,0,0,0,0,0,0,0
366553,37000,370,0,-2,2,1,1,0,0,0,0,0,0,0,0,0,0,0,0,0,0,0,2,1,1,0,0,0,0,0,0,0,0,0
366711,37000,370,0,-2,18,3,15,1,0,1,0,0,0,1,0,1,10,1,9,0,0,0,6,2,4,0,0,0,0,0,0,0,0,0
367459,37000,370,0,-2,7,3,4,0,0,0,0,0,0,0,0,0,0,0,0,0,0,0,7,3,4,0,0,0,0,0,0,0,0,0
367884,37000,370,0,-2,5,0,5,0,0,0,0,0,0,1,0,1,0,0,0,0,0,0,4,0,4,0,0,0,0,0,0,0,0,0
367954,37000,370,0,-2,11,1,10,0,0,0,0,0,0,2,0,2,2,0,2,0,0,0,7,1,6,0,0,0,0,0,0,0,0,0
368629,37000,370,0,-2,4,0,4,0,0,0,1,0,1,0,0,0,0,0,0,0,0,0,1,0,1,2,0,2,0,0,0,0,0,0
369400,37000,370,0,-2,3,0,3,0,0,0,0,0,0,1,0,1,0,0,0,0,0,0,2,0,2,0,0,0,0,0,0,0,0,0
376695,37000,370,0,-2,2,1,1,0,0,0,0,0,0,0,0,0,0,0,0,2,1,1,0,0,0,0,0,0,0,0,0,0,0,0
377111,37000,370,0,-2,1,0,1,0,0,0,0,0,0,0,0,0,0,0,0,0,0,0,1,0,1,0,0,0,0,0,0,0,0,0
377449,37000,370,0,-2,5,1,4,0,0,0,0,0,0,4,0,4,0,0,0,0,0,0,1,1,0,0,0,0,0,0,0,0,0,0
377458,37000,370,0,-2,3,1,2,0,0,0,0,0,0,3,1,2,0,0,0,0,0,0,0,0,0,0,0,0,0,0,0,0,0,0
377555,37000,370,0,-2,10,1,9,0,0,0,1,0,1,0,0,0,0,0,0,0,0,0,7,0,7,2,1,1,0,0,0,0,0,0
377564,37000,370,0,-2,6,1,5,0,0,0,0,0,0,0,0,0,1,1,0,0,0,0,3,0,3,1,0,1,1,0,1,0,0,0
378105,37000,370,0,-2,1,0,1,0,0,0,0,0,0,0,0,0,1,0,1,0,0,0,0,0,0,0,0,0,0,0,0,0,0,0
378576,37000,370,0,-2,11,3,8,0,0,0,0,0,0,0,0,0,0,0,0,0,0,0,0,0,0,0,0,0,11,3,8,0,0,0
380359,37000,370,0,-2,2,0,2,2,0,2,0,0,0,0,0,0,0,0,0,0,0,0,0,0,0,0,0,0,0,0,0,0,0,0
380368,37000,370,0,-2,1,0,1,0,0,0,0,0,0,0,0,0,0,0,0,0,0,0,1,0,1,0,0,0,0,0,0,0,0,0
380377,37000,370,0,-2,5,1,4,5,1,4,0,0,0,0,0,0,0,0,0,0,0,0,0,0,0,0,0,0,0,0,0,0,0,0
380438,37000,370,0,-2,2,1,1,0,0,0,0,0,0,0,0,0,1,1,0,0,0,0,1,0,1,0,0,0,0,0,0,0,0,0
382957,37000,370,0,-2,1,0,1,0,0,0,0,0,0,0,0,0,0,0,0,0,0,0,1,0,1,0,0,0,0,0,0,0,0,0
383996,37000,370,0,-2,3,0,3,0,0,0,0,0,0,0,0,0,3,0,3,0,0,0,0,0,0,0,0,0,0,0,0,0,0,0
384254,37000,370,0,-2,3,0,3,0,0,0,0,0,0,0,0,0,1,0,1,0,0,0,2,0,2,0,0,0,0,0,0,0,0,0
384333,37000,370,0,-2,1,0,1,0,0,0,0,0,0,0,0,0,1,0,1,0,0,0,0,0,0,0,0,0,0,0,0,0,0,0
384342,37000,370,0,-2,9,0,9,0,0,0,1,0,1,0,0,0,1,0,1,0,0,0,7,0,7,0,0,0,0,0,0,0,0,0
385415,37000,370,0,-2,11,0,11,0,0,0,1,0,1,2,0,2,5,0,5,0,0,0,2,0,2,1,0,1,0,0,0,0,0,0
385619,37000,370,0,-2,52,16,36,0,0,0,1,0,1,17,4,13,13,1,12,0,0,0,16,9,7,5,2,3,0,0,0,0,0,0
392257,37000,370,0,-2,2,0,2,0,0,0,0,0,0,1,0,1,1,0,1,0,0,0,0,0,0,0,0,0,0,0,0,0,0,0
392415,37000,370,0,-2,1,0,1,0,0,0,0,0,0,0,0,0,1,0,1,0,0,0,0,0,0,0,0,0,0,0,0,0,0,0
395362,37000,370,0,-2,4,0,4,0,0,0,0,0,0,1,0,1,2,0,2,0,0,0,1,0,1,0,0,0,0,0,0,0,0,0
399212,37000,370,0,-2,1,0,1,0,0,0,0,0,0,0,0,0,0,0,0,1,0,1,0,0,0,0,0,0,0,0,0,0,0,0
399869,37000,370,0,-2,1,1,0,0,0,0,0,0,0,0,0,0,0,0,0,0,0,0,1,1,0,0,0,0,0,0,0,0,0,0
399911,37000,370,0,-2,3,0,3,0,0,0,2,0,2,0,0,0,1,0,1,0,0,0,0,0,0,0,0,0,0,0,0,0,0,0
403469,37000,370,0,-2,2,0,2,0,0,0,0,0,0,0,0,0,0,0,0,0,0,0,2,0,2,0,0,0,0,0,0,0,0,0
403478,37000,370,0,-2,1,0,1,0,0,0,0,0,0,0,0,0,0,0,0,0,0,0,1,0,1,0,0,0,0,0,0,0,0,0
404055,37000,370,0,-2,5,1,4,0,0,0,1,1,0,0,0,0,1,0,1,0,0,0,2,0,2,1,0,1,0,0,0,0,0,0
404222,37000,370,0,-2,1,0,1,0,0,0,0,0,0,0,0,0,1,0,1,0,0,0,0,0,0,0,0,0,0,0,0,0,0,0
404426,37000,370,0,-2,8,0,8,3,0,3,0,0,0,0,0,0,1,0,1,0,0,0,3,0,3,0,0,0,1,0,1,0,0,0
404994,37000,370,0,-2,5,2,3,0,0,0,0,0,0,4,2,2,1,0,1,0,0,0,0,0,0,0,0,0,0,0,0,0,0,0
405872,37000,370,0,-2,2,0,2,0,0,0,0,0,0,0,0,0,0,0,0,0,0,0,2,0,2,0,0,0,0,0,0,0,0,0
406024,37000,370,0,-2,6,0,6,0,0,0,0,0,0,0,0,0,0,0,0,0,0,0,3,0,3,3,0,3,0,0,0,0,0,0
406033,37000,370,0,-2,11,0,11,0,0,0,1,0,1,5,0,5,5,0,5,0,0,0,0,0,0,0,0,0,0,0,0,0,0,0
407629,37000,370,0,-2,19,1,18,0,0,0,1,0,1,0,0,0,3,0,3,0,0,0,14,1,13,1,0,1,0,0,0,0,0,0
408729,37000,370,0,-2,1,0,1,0,0,0,0,0,0,0,0,0,0,0,0,0,0,0,1,0,1,0,0,0,0,0,0,0,0,0
408844,37000,370,0,-2,64,17,47,0,0,0,0,0,0,1,1,0,63,16,47,0,0,0,0,0,0,0,0,0,0,0,0,0,0,0
409254,37000,370,0,-2,7,3,4,0,0,0,0,0,0,2,0,2,2,1,1,0,0,0,3,2,1,0,0,0,0,0,0,0,0,0
409315,37000,370,0,-2,34,5,29,0,0,0,0,0,0,0,0,0,29,3,26,0,0,0,2,1,1,0,0,0,0,0,0,3,1,2
409379,37000,370,0,-2,22,4,18,0,0,0,0,0,0,5,0,5,2,0,2,0,0,0,15,4,11,0,0,0,0,0,0,0,0,0
409616,37000,370,0,-2,2,0,2,0,0,0,0,0,0,0,0,0,0,0,0,0,0,0,2,0,2,0,0,0,0,0,0,0,0,0
409698,37000,370,0,-2,4,1,3,0,0,0,0,0,0,0,0,0,1,0,1,0,0,0,2,1,1,1,0,1,0,0,0,0,0,0
413413,37000,370,0,-2,18,4,14,1,0,1,2,0,2,2,1,1,0,0,0,0,0,0,11,2,9,0,0,0,2,1,1,0,0,0
413617,37000,370,0,-2,4,0,4,4,0,4,0,0,0,0,0,0,0,0,0,0,0,0,0,0,0,0,0,0,0,0,0,0,0,0
414595,37000,370,0,-2,3,0,3,0,0,0,0,0,0,0,0,0,0,0,0,0,0,0,0,0,0,0,0,0,3,0,3,0,0,0
414911,37000,370,0,-2,1,0,1,0,0,0,0,0,0,0,0,0,0,0,0,0,0,0,1,0,1,0,0,0,0,0,0,0,0,0
416458,37000,370,0,-2,2,0,2,0,0,0,0,0,0,0,0,0,2,0,2,0,0,0,0,0,0,0,0,0,0,0,0,0,0,0
418533,37000,370,0,-2,1,0,1,0,0,0,0,0,0,0,0,0,0,0,0,0,0,0,1,0,1,0,0,0,0,0,0,0,0,0
420024,37000,370,0,-2,6,1,5,0,0,0,0,0,0,5,1,4,0,0,0,0,0,0,0,0,0,1,0,1,0,0,0,0,0,0
420246,37000,370,0,-2,3,0,3,0,0,0,0,0,0,0,0,0,0,0,0,0,0,0,3,0,3,0,0,0,0,0,0,0,0,0
420431,37000,370,0,-2,10,0,10,0,0,0,0,0,0,5,0,5,0,0,0,0,0,0,5,0,5,0,0,0,0,0,0,0,0,0
420556,37000,370,0,-2,4,0,4,0,0,0,0,0,0,0,0,0,0,0,0,0,0,0,4,0,4,0,0,0,0,0,0,0,0,0
422695,37000,370,0,-2,4,1,3,0,0,0,2,0,2,0,0,0,0,0,0,0,0,0,1,0,1,1,1,0,0,0,0,0,0,0
423643,37000,370,0,-2,26,1,25,0,0,0,1,0,1,1,0,1,10,0,10,0,0,0,13,1,12,1,0,1,0,0,0,0,0,0
423652,37000,370,0,-2,1,0,1,0,0,0,0,0,0,0,0,0,0,0,0,0,0,0,1,0,1,0,0,0,0,0,0,0,0,0
426314,37000,370,0,-2,3,2,1,0,0,0,0,0,0,1,1,0,0,0,0,0,0,0,2,1,1,0,0,0,0,0,0,0,0,0
427982,37000,370,0,-2,5,4,1,0,0,0,0,0,0,5,4,1,0,0,0,0,0,0,0,0,0,0,0,0,0,0,0,0,0,0
428170,37000,370,0,-2,10,4,6,0,0,0,0,0,0,1,0,1,5,2,3,0,0,0,4,2,2,0,0,0,0,0,0,0,0,0
428392,37000,370,0,-2,3,1,2,0,0,0,0,0,0,1,0,1,0,0,0,0,0,0,1,1,0,0,0,0,1,0,1,0,0,0
429128,37000,370,0,-2,1,1,0,0,0,0,0,0,0,0,0,0,1,1,0,0,0,0,0,0,0,0,0,0,0,0,0,0,0,0
431141,37000,370,0,-2,4,0,4,0,0,0,0,0,0,0,0,0,1,0,1,0,0,0,3,0,3,0,0,0,0,0,0,0,0,0
432144,37000,370,0,-2,1,0,1,0,0,0,0,0,0,0,0,0,1,0,1,0,0,0,0,0,0,0,0,0,0,0,0,0,0,0
432348,37000,370,0,-2,1,0,1,0,0,0,0,0,0,0,0,0,0,0,0,0,0,0,1,0,1,0,0,0,0,0,0,0,0,0
432384,37000,370,0,-2,2,0,2,0,0,0,0,0,0,0,0,0,2,0,2,0,0,0,0,0,0,0,0,0,0,0,0,0,0,0
432524,37000,370,0,-2,4,1,3,0,0,0,0,0,0,1,0,1,0,0,0,0,0,0,3,1,2,0,0,0,0,0,0,0,0,0
433004,37000,370,0,-2,1,0,1,0,0,0,1,0,1,0,0,0,0,0,0,0,0,0,0,0,0,0,0,0,0,0,0,0,0,0
433174,37000,370,0,-2,2,0,2,0,0,0,0,0,0,2,0,2,0,0,0,0,0,0,0,0,0,0,0,0,0,0,0,0,0,0
433387,37000,370,0,-2,10,1,9,0,0,0,0,0,0,1,0,1,0,0,0,0,0,0,7,1,6,1,0,1,1,0,1,0,0,0
433420,37000,370,0,-2,2,2,0,0,0,0,0,0,0,1,1,0,0,0,0,0,0,0,1,1,0,0,0,0,0,0,0,0,0,0
433660,37000,370,0,-2,26,4,22,0,0,0,1,0,1,0,0,0,3,1,2,0,0,0,21,3,18,0,0,0,0,0,0,1,0,1
434016,37000,370,0,-2,4,1,3,2,1,1,0,0,0,0,0,0,0,0,0,0,0,0,2,0,2,0,0,0,0,0,0,0,0,0
434061,37000,370,0,-2,5,0,5,0,0,0,0,0,0,4,0,4,1,0,1,0,0,0,0,0,0,0,0,0,0,0,0,0,0,0
434140,37000,370,0,-2,4,0,4,0,0,0,0,0,0,0,0,0,2,0,2,0,0,0,0,0,0,2,0,2,0,0,0,0,0,0
434159,37000,370,0,-2,1,0,1,0,0,0,0,0,0,1,0,1,0,0,0,0,0,0,0,0,0,0,0,0,0,0,0,0,0,0
434584,37000,370,0,-2,6,0,6,1,0,1,1,0,1,0,0,0,0,0,0,3,0,3,1,0,1,0,0,0,0,0,0,0,0,0
434672,37000,370,0,-2,16,3,13,0,0,0,0,0,0,5,0,5,2,0,2,0,0,0,8,3,5,1,0,1,0,0,0,0,0,0
435000,37000,370,0,-2,2,0,2,0,0,0,0,0,0,2,0,2,0,0,0,0,0,0,0,0,0,0,0,0,0,0,0,0,0,0
436429,37000,370,0,-2,2,1,1,0,0,0,0,0,0,1,1,0,0,0,0,0,0,0,1,0,1,0,0,0,0,0,0,0,0,0
437635,37000,370,0,-2,1,0,1,0,0,0,0,0,0,0,0,0,1,0,1,0,0,0,0,0,0,0,0,0,0,0,0,0,0,0
437936,37000,370,0,-2,2,0,2,0,0,0,0,0,0,0,0,0,1,0,1,0,0,0,0,0,0,0,0,0,1,0,1,0,0,0
438179,37000,370,0,-2,1,0,1,0,0,0,0,0,0,0,0,0,0,0,0,0,0,0,1,0,1,0,0,0,0,0,0,0,0,0
438504,37000,370,0,-2,2,0,2,0,0,0,0,0,0,0,0,0,1,0,1,0,0,0,1,0,1,0,0,0,0,0,0,0,0,0
438665,37000,370,0,-2,2,1,1,0,0,0,0,0,0,0,0,0,2,1,1,0,0,0,0,0,0,0,0,0,0,0,0,0,0,0
438708,37000,370,0,-2,2,0,2,0,0,0,0,0,0,0,0,0,0,0,0,0,0,0,2,0,2,0,0,0,0,0,0,0,0,0
439154,37000,370,0,-2,8,3,5,0,0,0,0,0,0,0,0,0,4,0,4,0,0,0,4,3,1,0,0,0,0,0,0,0,0,0
439190,37000,370,0,-2,5,3,2,0,0,0,0,0,0,0,0,0,0,0,0,0,0,0,1,1,0,2,0,2,2,2,0,0,0,0
439367,37000,370,0,-2,3,1,2,0,0,0,0,0,0,1,0,1,0,0,0,0,0,0,2,1,1,0,0,0,0,0,0,0,0,0
439570,37000,370,0,-2,1,0,1,0,0,0,0,0,0,0,0,0,0,0,0,0,0,0,1,0,1,0,0,0,0,0,0,0,0,0
440031,37000,370,0,-2,9,1,8,0,0,0,1,0,1,0,0,0,1,1,0,0,0,0,4,0,4,2,0,2,1,0,1,0,0,0
440059,37000,370,0,-2,20,8,12,0,0,0,0,0,0,16,7,9,0,0,0,0,0,0,2,0,2,1,1,0,1,0,1,0,0,0
440262,37000,370,0,-2,1,0,1,0,0,0,0,0,0,0,0,0,0,0,0,0,0,0,1,0,1,0,0,0,0,0,0,0,0,0
440396,37000,370,0,-2,1,1,0,0,0,0,0,0,0,0,0,0,0,0,0,0,0,0,1,1,0,0,0,0,0,0,0,0,0,0
440402,37000,370,0,-2,1,0,1,0,0,0,0,0,0,0,0,0,0,0,0,0,0,0,1,0,1,0,0,0,0,0,0,0,0,0
440651,37000,370,0,-2,6,2,4,0,0,0,0,0,0,0,0,0,6,2,4,0,0,0,0,0,0,0,0,0,0,0,0,0,0,0
440794,37000,370,0,-2,1,0,1,0,0,0,0,0,0,0,0,0,1,0,1,0,0,0,0,0,0,0,0,0,0,0,0,0,0,0
440916,37000,370,0,-2,2,0,2,0,0,0,0,0,0,2,0,2,0,0,0,0,0,0,0,0,0,0,0,0,0,0,0,0,0,0
441052,37000,370,0,-2,5,0,5,0,0,0,0,0,0,0,0,0,4,0,4,0,0,0,1,0,1,0,0,0,0,0,0,0,0,0
441104,37000,370,0,-2,1,0,1,0,0,0,0,0,0,1,0,1,0,0,0,0,0,0,0,0,0,0,0,0,0,0,0,0,0,0
441131,37000,370,0,-2,1,0,1,0,0,0,0,0,0,0,0,0,0,0,0,0,0,0,1,0,1,0,0,0,0,0,0,0,0,0
441229,37000,370,0,-2,15,1,14,0,0,0,1,0,1,2,1,1,4,0,4,0,0,0,5,0,5,0,0,0,3,0,3,0,0,0
441371,37000,370,0,-2,2,0,2,0,0,0,0,0,0,1,0,1,1,0,1,0,0,0,0,0,0,0,0,0,0,0,0,0,0,0
441423,37000,370,0,-2,1,0,1,0,0,0,0,0,0,0,0,0,1,0,1,0,0,0,0,0,0,0,0,0,0,0,0,0,0,0
441636,37000,370,0,-2,2,0,2,0,0,0,0,0,0,1,0,1,0,0,0,0,0,0,1,0,1,0,0,0,0,0,0,0,0,0
441742,37000,370,0,-2,9,0,9,0,0,0,0,0,0,3,0,3,3,0,3,0,0,0,3,0,3,0,0,0,0,0,0,0,0,0
441760,37000,370,0,-2,12,0,12,0,0,0,1,0,1,3,0,3,1,0,1,0,0,0,5,0,5,0,0,0,2,0,2,0,0,0
441900,37000,370,0,-2,5,1,4,1,0,1,0,0,0,0,0,0,1,0,1,0,0,0,3,1,2,0,0,0,0,0,0,0,0,0
441937,37000,370,0,-2,15,2,13,0,0,0,1,0,1,0,0,0,10,2,8,0,0,0,2,0,2,0,0,0,1,0,1,1,0,1
442134,37000,370,0,-2,1,0,1,0,0,0,0,0,0,0,0,0,0,0,0,0,0,0,1,0,1,0,0,0,0,0,0,0,0,0
442295,37000,370,0,-2,1,0,1,0,0,0,0,0,0,0,0,0,1,0,1,0,0,0,0,0,0,0,0,0,0,0,0,0,0,0
442356,37000,370,0,-2,4,0,4,0,0,0,1,0,1,1,0,1,0,0,0,0,0,0,2,0,2,0,0,0,0,0,0,0,0,0
442383,37000,370,0,-2,2,0,2,0,0,0,0,0,0,0,0,0,0,0,0,0,0,0,2,0,2,0,0,0,0,0,0,0,0,0
442444,37000,370,0,-2,1,0,1,0,0,0,0,0,0,0,0,0,0,0,0,0,0,0,1,0,1,0,0,0,0,0,0,0,0,0
442569,37000,370,0,-2,1,0,1,0,0,0,0,0,0,0,0,0,0,0,0,0,0,0,1,0,1,0,0,0,0,0,0,0,0,0
442781,37000,370,0,-2,3,0,3,3,0,3,0,0,0,0,0,0,0,0,0,0,0,0,0,0,0,0,0,0,0,0,0,0,0,0
442806,37000,370,0,-2,5,0,5,0,0,0,0,0,0,1,0,1,0,0,0,0,0,0,4,0,4,0,0,0,0,0,0,0,0,0
442842,37000,370,0,-2,1,0,1,0,0,0,0,0,0,0,0,0,0,0,0,0,0,0,0,0,0,0,0,0,1,0,1,0,0,0
442930,37000,370,0,-2,10,4,6,0,0,0,0,0,0,1,0,1,7,3,4,0,0,0,2,1,1,0,0,0,0,0,0,0,0,0
443076,37000,370,0,-2,1,0,1,0,0,0,0,0,0,1,0,1,0,0,0,0,0,0,0,0,0,0,0,0,0,0,0,0,0,0
443261,37000,370,0,-2,5,1,4,0,0,0,0,0,0,2,1,1,1,0,1,0,0,0,2,0,2,0,0,0,0,0,0,0,0,0
443331,37000,370,0,-2,4,0,4,0,0,0,1,0,1,1,0,1,1,0,1,0,0,0,1,0,1,0,0,0,0,0,0,0,0,0
443410,37000,370,0,-2,6,1,5,1,0,1,0,0,0,0,0,0,2,0,2,0,0,0,3,1,2,0,0,0,0,0,0,0,0,0
443571,37000,370,0,-2,7,2,5,0,0,0,0,0,0,2,0,2,5,2,3,0,0,0,0,0,0,0,0,0,0,0,0,0,0,0
443711,37000,370,0,-2,9,3,6,0,0,0,1,0,1,2,0,2,1,0,1,0,0,0,4,2,2,1,1,0,0,0,0,0,0,0
443748,37000,370,0,-2,2,0,2,0,0,0,0,0,0,1,0,1,1,0,1,0,0,0,0,0,0,0,0,0,0,0,0,0,0,0
444088,37000,370,0,-2,6,1,5,0,0,0,0,0,0,1,0,1,0,0,0,0,0,0,4,0,4,1,1,0,0,0,0,0,0,0
444556,37000,370,0,-2,1,1,0,0,0,0,0,0,0,0,0,0,0,0,0,0,0,0,0,0,0,1,1,0,0,0,0,0,0,0
444565,37000,370,0,-2,1,0,1,0,0,0,0,0,0,0,0,0,1,0,1,0,0,0,0,0,0,0,0,0,0,0,0,0,0,0
444787,37000,370,0,-2,19,3,16,0,0,0,0,0,0,3,0,3,3,2,1,1,0,1,10,1,9,2,0,2,0,0,0,0,0,0
444866,37000,370,0,-2,3,0,3,0,0,0,0,0,0,2,0,2,0,0,0,0,0,0,1,0,1,0,0,0,0,0,0,0,0,0
445188,37000,370,0,-2,8,2,6,0,0,0,1,0,1,0,0,0,3,1,2,0,0,0,3,1,2,1,0,1,0,0,0,0,0,0
445230,37000,370,0,-2,2,0,2,0,0,0,0,0,0,0,0,0,0,0,0,0,0,0,2,0,2,0,0,0,0,0,0,0,0,0
445249,37000,370,0,-2,2,0,2,0,0,0,0,0,0,2,0,2,0,0,0,0,0,0,0,0,0,0,0,0,0,0,0,0,0,0
445267,37000,370,0,-2,2,1,1,0,0,0,0,0,0,0,0,0,0,0,0,0,0,0,2,1,1,0,0,0,0,0,0,0,0,0
445461,37000,370,0,-2,4,0,4,0,0,0,0,0,0,2,0,2,0,0,0,0,0,0,1,0,1,1,0,1,0,0,0,0,0,0
445692,37000,370,0,-2,1,0,1,0,0,0,0,0,0,0,0,0,0,0,0,0,0,0,1,0,1,0,0,0,0,0,0,0,0,0
445735,37000,370,0,-2,19,1,18,0,0,0,0,0,0,1,0,1,10,1,9,1,0,1,7,0,7,0,0,0,0,0,0,0,0,0
445744,37000,370,0,-2,1,0,1,0,0,0,0,0,0,1,0,1,0,0,0,0,0,0,0,0,0,0,0,0,0,0,0,0,0,0
445869,37000,370,0,-2,3,1,2,0,0,0,0,0,0,0,0,0,0,0,0,0,0,0,3,1,2,0,0,0,0,0,0,0,0,0
445948,37000,370,0,-2,2,0,2,0,0,0,0,0,0,0,0,0,1,0,1,0,0,0,0,0,0,1,0,1,0,0,0,0,0,0
446048,37000,370,0,-2,1,0,1,0,0,0,1,0,1,0,0,0,0,0,0,0,0,0,0,0,0,0,0,0,0,0,0,0,0,0
446118,37000,370,0,-2,4,0,4,0,0,0,2,0,2,0,0,0,1,0,1,1,0,1,0,0,0,0,0,0,0,0,0,0,0,0
446127,37000,370,0,-2,1,0,1,0,0,0,0,0,0,0,0,0,0,0,0,0,0,0,1,0,1,0,0,0,0,0,0,0,0,0
446233,37000,370,0,-2,1,1,0,0,0,0,0,0,0,0,0,0,0,0,0,0,0,0,1,1,0,0,0,0,0,0,0,0,0,0
446552,37000,370,0,-2,1,0,1,0,0,0,0,0,0,1,0,1,0,0,0,0,0,0,0,0,0,0,0,0,0,0,0,0,0,0
446561,37000,370,0,-2,4,1,3,0,0,0,0,0,0,0,0,0,1,0,1,0,0,0,3,1,2,0,0,0,0,0,0,0,0,0
446604,37000,370,0,-2,1,1,0,0,0,0,0,0,0,0,0,0,0,0,0,0,0,0,1,1,0,0,0,0,0,0,0,0,0,0
446640,37000,370,0,-2,4,4,0,0,0,0,0,0,0,1,1,0,0,0,0,0,0,0,1,1,0,0,0,0,2,2,0,0,0,0
446978,37000,370,0,-2,1,0,1,0,0,0,0,0,0,0,0,0,0,0,0,0,0,0,0,0,0,0,0,0,1,0,1,0,0,0
447050,37000,370,0,-2,1,0,1,0,0,0,0,0,0,1,0,1,0,0,0,0,0,0,0,0,0,0,0,0,0,0,0,0,0,0
447263,37000,370,0,-2,10,5,5,1,0,1,0,0,0,1,1,0,0,0,0,0,0,0,6,4,2,0,0,0,2,0,2,0,0,0
447421,37000,370,0,-2,1,0,1,0,0,0,1,0,1,0,0,0,0,0,0,0,0,0,0,0,0,0,0,0,0,0,0,0,0,0
447582,37000,370,0,-2,3,1,2,0,0,0,0,0,0,0,0,0,0,0,0,0,0,0,3,1,2,0,0,0,0,0,0,0,0,0
447591,37000,370,0,-2,1,0,1,0,0,0,0,0,0,1,0,1,0,0,0,0,0,0,0,0,0,0,0,0,0,0,0,0,0,0
447689,37000,370,0,-2,9,1,8,0,0,0,0,0,0,3,0,3,1,0,1,0,0,0,3,1,2,1,0,1,1,0,1,0,0,0
447698,37000,370,0,-2,2,0,2,0,0,0,0,0,0,0,0,0,0,0,0,0,0,0,1,0,1,0,0,0,1,0,1,0,0,0
447768,37000,370,0,-2,4,0,4,0,0,0,2,0,2,2,0,2,0,0,0,0,0,0,0,0,0,0,0,0,0,0,0,0,0,0
448594,37000,370,0,-2,1,0,1,0,0,0,0,0,0,0,0,0,0,0,0,0,0,0,0,0,0,1,0,1,0,0,0,0,0,0
448600,37000,370,0,-2,3,0,3,0,0,0,0,0,0,0,0,0,0,0,0,0,0,0,3,0,3,0,0,0,0,0,0,0,0,0
448637,37000,370,0,-2,1,0,1,0,0,0,0,0,0,0,0,0,0,0,0,0,0,0,1,0,1,0,0,0,0,0,0,0,0,0
448673,37000,370,0,-2,3,1,2,0,0,0,0,0,0,0,0,0,1,1,0,0,0,0,2,0,2,0,0,0,0,0,0,0,0,0
448691,37000,370,0,-2,5,0,5,0,0,0,0,0,0,0,0,0,1,0,1,0,0,0,3,0,3,1,0,1,0,0,0,0,0,0
449074,37000,370,0,-2,4,0,4,0,0,0,0,0,0,1,0,1,1,0,1,0,0,0,1,0,1,1,0,1,0,0,0,0,0,0
449250,37000,370,0,-2,1,0,1,0,0,0,0,0,0,0,0,0,0,0,0,0,0,0,1,0,1,0,0,0,0,0,0,0,0,0
449339,37000,370,0,-2,5,1,4,0,0,0,0,0,0,0,0,0,0,0,0,0,0,0,5,1,4,0,0,0,0,0,0,0,0,0
449384,37000,370,0,-2,2,1,1,0,0,0,0,0,0,1,0,1,0,0,0,0,0,0,1,1,0,0,0,0,0,0,0,0,0,0
449524,37000,370,0,-2,3,2,1,0,0,0,0,0,0,0,0,0,2,1,1,0,0,0,1,1,0,0,0,0,0,0,0,0,0,0
449898,37000,370,0,-2,3,0,3,0,0,0,1,0,1,0,0,0,1,0,1,0,0,0,1,0,1,0,0,0,0,0,0,0,0,0
450058,37000,370,0,-2,1,0,1,0,0,0,0,0,0,0,0,0,0,0,0,0,0,0,1,0,1,0,0,0,0,0,0,0,0,0
450067,37000,370,0,-2,3,0,3,0,0,0,0,0,0,0,0,0,0,0,0,0,0,0,3,0,3,0,0,0,0,0,0,0,0,0
450571,37000,370,0,-2,2,0,2,0,0,0,0,0,0,0,0,0,0,0,0,0,0,0,2,0,2,0,0,0,0,0,0,0,0,0
450933,37000,370,0,-2,7,1,6,0,0,0,0,0,0,1,0,1,1,0,1,0,0,0,3,1,2,0,0,0,2,0,2,0,0,0
451103,37000,370,0,-2,4,1,3,0,0,0,0,0,0,0,0,0,4,1,3,0,0,0,0,0,0,0,0,0,0,0,0,0,0,0
451477,37000,370,0,-2,1,0,1,0,0,0,0,0,0,0,0,0,0,0,0,0,0,0,1,0,1,0,0,0,0,0,0,0,0,0
451556,37000,370,0,-2,17,3,14,0,0,0,0,0,0,1,0,1,15,3,12,0,0,0,1,0,1,0,0,0,0,0,0,0,0,0
451741,37000,370,0,-2,1,0,1,0,0,0,0,0,0,0,0,0,1,0,1,0,0,0,0,0,0,0,0,0,0,0,0,0,0,0
451750,37000,370,0,-2,2,0,2,0,0,0,1,0,1,0,0,0,0,0,0,0,0,0,1,0,1,0,0,0,0,0,0,0,0,0
451866,37000,370,0,-2,2,0,2,0,0,0,0,0,0,1,0,1,0,0,0,0,0,0,1,0,1,0,0,0,0,0,0,0,0,0
451927,37000,370,0,-2,4,2,2,0,0,0,0,0,0,0,0,0,0,0,0,0,0,0,4,2,2,0,0,0,0,0,0,0,0,0
452373,37000,370,0,-2,2,0,2,0,0,0,0,0,0,2,0,2,0,0,0,0,0,0,0,0,0,0,0,0,0,0,0,0,0,0
452948,37000,370,0,-2,1,0,1,0,0,0,0,0,0,0,0,0,0,0,0,0,0,0,0,0,0,0,0,0,1,0,1,0,0,0
454184,37000,370,0,-2,9,3,6,1,0,1,0,0,0,4,1,3,1,0,1,0,0,0,1,1,0,0,0,0,2,1,1,0,0,0
454218,37000,370,0,-2,17,1,16,0,0,0,0,0,0,3,0,3,3,0,3,0,0,0,6,0,6,1,1,0,4,0,4,0,0,0
454698,37000,370,0,-2,2,0,2,0,0,0,0,0,0,0,0,0,2,0,2,0,0,0,0,0,0,0,0,0,0,0,0,0,0,0
454829,37000,370,0,-2,3,0,3,0,0,0,0,0,0,0,0,0,1,0,1,0,0,0,2,0,2,0,0,0,0,0,0,0,0,0
454856,37000,370,0,-2,2,0,2,0,0,0,0,0,0,0,0,0,0,0,0,0,0,0,2,0,2,0,0,0,0,0,0,0,0,0
455114,37000,370,0,-2,12,6,6,0,0,0,2,1,1,0,0,0,2,1,1,1,1,0,7,3,4,0,0,0,0,0,0,0,0,0
455196,37000,370,0,-2,4,2,2,0,0,0,0,0,0,2,0,2,0,0,0,0,0,0,2,2,0,0,0,0,0,0,0,0,0,0
455406,37000,370,0,-2,8,0,8,0,0,0,1,0,1,1,0,1,2,0,2,0,0,0,3,0,3,0,0,0,1,0,1,0,0,0
455479,37000,370,0,-2,1,0,1,0,0,0,0,0,0,0,0,0,1,0,1,0,0,0,0,0,0,0,0,0,0,0,0,0,0,0
455628,37000,370,0,-2,1,0,1,0,0,0,0,0,0,0,0,0,0,0,0,0,0,0,0,0,0,0,0,0,1,0,1,0,0,0
455664,37000,370,0,-2,3,1,2,0,0,0,0,0,0,0,0,0,0,0,0,0,0,0,2,1,1,1,0,1,0,0,0,0,0,0
455804,37000,370,0,-2,1,0,1,0,0,0,0,0,0,0,0,0,0,0,0,0,0,0,1,0,1,0,0,0,0,0,0,0,0,0
455983,37000,370,0,-2,4,0,4,0,0,0,2,0,2,1,0,1,1,0,1,0,0,0,0,0,0,0,0,0,0,0,0,0,0,0
455992,37000,370,0,-2,2,1,1,0,0,0,0,0,0,0,0,0,0,0,0,0,0,0,2,1,1,0,0,0,0,0,0,0,0,0
456038,37000,370,0,-2,2,0,2,0,0,0,0,0,0,0,0,0,2,0,2,0,0,0,0,0,0,0,0,0,0,0,0,0,0,0
456205,37000,370,0,-2,1,0,1,0,0,0,0,0,0,1,0,1,0,0,0,0,0,0,0,0,0,0,0,0,0,0,0,0,0,0
456454,37000,370,0,-2,2,0,2,0,0,0,0,0,0,0,0,0,0,0,0,0,0,0,2,0,2,0,0,0,0,0,0,0,0,0
456490,37000,370,0,-2,3,1,2,0,0,0,0,0,0,0,0,0,3,1,2,0,0,0,0,0,0,0,0,0,0,0,0,0,0,0
456542,37000,370,0,-2,6,1,5,0,0,0,0,0,0,1,0,1,0,0,0,0,0,0,4,1,3,1,0,1,0,0,0,0,0,0
456852,37000,370,0,-2,1,0,1,0,0,0,0,0,0,0,0,0,0,0,0,0,0,0,1,0,1,0,0,0,0,0,0,0,0,0
457086,37000,370,0,-2,1,0,1,0,0,0,0,0,0,0,0,0,0,0,0,0,0,0,0,0,0,0,0,0,1,0,1,0,0,0
457101,37000,370,0,-2,1,0,1,0,0,0,0,0,0,1,0,1,0,0,0,0,0,0,0,0,0,0,0,0,0,0,0,0,0,0
457110,37000,370,0,-2,1,0,1,0,0,0,0,0,0,0,0,0,0,0,0,0,0,0,1,0,1,0,0,0,0,0,0,0,0,0
457299,37000,370,0,-2,11,0,11,0,0,0,8,0,8,0,0,0,3,0,3,0,0,0,0,0,0,0,0,0,0,0,0,0,0,0
457527,37000,370,0,-2,1,1,0,0,0,0,0,0,0,0,0,0,1,1,0,0,0,0,0,0,0,0,0,0,0,0,0,0,0,0
457536,37000,370,0,-2,2,0,2,0,0,0,0,0,0,0,0,0,2,0,2,0,0,0,0,0,0,0,0,0,0,0,0,0,0,0
458210,37000,370,0,-2,8,1,7,0,0,0,0,0,0,1,0,1,3,0,3,0,0,0,4,1,3,0,0,0,0,0,0,0,0,0
458229,37000,370,0,-2,5,0,5,0,0,0,0,0,0,0,0,0,3,0,3,0,0,0,2,0,2,0,0,0,0,0,0,0,0,0
458405,37000,370,0,-2,1,0,1,0,0,0,0,0,0,1,0,1,0,0,0,0,0,0,0,0,0,0,0,0,0,0,0,0,0,0
458681,37000,370,0,-2,2,0,2,0,0,0,0,0,0,2,0,2,0,0,0,0,0,0,0,0,0,0,0,0,0,0,0,0,0,0
459204,37000,370,0,-2,4,0,4,0,0,0,3,0,3,1,0,1,0,0,0,0,0,0,0,0,0,0,0,0,0,0,0,0,0,0
459213,37000,370,0,-2,17,5,12,0,0,0,3,1,2,3,1,2,2,0,2,0,0,0,2,0,2,2,1,1,5,2,3,0,0,0
459259,37000,370,0,-2,1,0,1,0,0,0,0,0,0,0,0,0,0,0,0,0,0,0,1,0,1,0,0,0,0,0,0,0,0,0
459268,37000,370,0,-2,1,0,1,0,0,0,0,0,0,0,0,0,0,0,0,0,0,0,1,0,1,0,0,0,0,0,0,0,0,0
459736,37000,370,0,-2,9,3,6,0,0,0,2,1,1,1,0,1,3,1,2,1,0,1,2,1,1,0,0,0,0,0,0,0,0,0
459824,37000,370,0,-2,17,1,16,0,0,0,1,0,1,3,1,2,3,0,3,1,0,1,8,0,8,1,0,1,0,0,0,0,0,0
459842,37000,370,0,-2,2,0,2,0,0,0,0,0,0,0,0,0,0,0,0,0,0,0,2,0,2,0,0,0,0,0,0,0,0,0
459851,37000,370,0,-2,2,0,2,0,0,0,0,0,0,0,0,0,1,0,1,0,0,0,1,0,1,0,0,0,0,0,0,0,0,0
459949,37000,370,0,-2,21,5,16,0,0,0,0,0,0,2,1,1,15,2,13,0,0,0,3,2,1,0,0,0,1,0,1,0,0,0
460020,37000,370,0,-2,1,0,1,0,0,0,0,0,0,1,0,1,0,0,0,0,0,0,0,0,0,0,0,0,0,0,0,0,0,0
460136,37000,370,0,-2,5,0,5,0,0,0,0,0,0,0,0,0,3,0,3,0,0,0,0,0,0,2,0,2,0,0,0,0,0,0
460181,37000,370,0,-2,4,1,3,0,0,0,0,0,0,2,0,2,2,1,1,0,0,0,0,0,0,0,0,0,0,0,0,0,0,0
460190,37000,370,0,-2,1,0,1,0,0,0,0,0,0,1,0,1,0,0,0,0,0,0,0,0,0,0,0,0,0,0,0,0,0,0
460206,37000,370,0,-2,5,1,4,0,0,0,0,0,0,2,0,2,3,1,2,0,0,0,0,0,0,0,0,0,0,0,0,0,0,0
460376,37000,370,0,-2,6,4,2,0,0,0,0,0,0,5,3,2,0,0,0,0,0,0,1,1,0,0,0,0,0,0,0,0,0,0
460394,37000,370,0,-2,2,2,0,0,0,0,1,1,0,0,0,0,0,0,0,0,0,0,0,0,0,0,0,0,0,0,0,1,1,0
460756,37000,370,0,-2,1,0,1,0,0,0,1,0,1,0,0,0,0,0,0,0,0,0,0,0,0,0,0,0,0,0,0,0,0,0
461014,37000,370,0,-2,1,0,1,0,0,0,0,0,0,1,0,1,0,0,0,0,0,0,0,0,0,0,0,0,0,0,0,0,0,0
461148,37000,370,0,-2,6,1,5,0,0,0,1,0,1,1,0,1,1,0,1,0,0,0,3,1,2,0,0,0,0,0,0,0,0,0
461218,37000,370,0,-2,6,2,4,0,0,0,0,0,0,1,0,1,0,0,0,0,0,0,4,2,2,0,0,0,1,0,1,0,0,0
461689,37000,370,0,-2,1,0,1,0,0,0,0,0,0,0,0,0,1,0,1,0,0,0,0,0,0,0,0,0,0,0,0,0,0,0
461795,37000,370,0,-2,2,1,1,0,0,0,0,0,0,1,0,1,1,1,0,0,0,0,0,0,0,0,0,0,0,0,0,0,0,0
475033,37000,370,0,-2,15,3,12,0,0,0,0,0,0,4,0,4,3,1,2,0,0,0,6,1,5,1,0,1,1,1,0,0,0,0
475176,37000,370,0,-2,1,0,1,0,0,0,0,0,0,0,0,0,1,0,1,0,0,0,0,0,0,0,0,0,0,0,0,0,0,0
475273,37000,370,0,-2,1,0,1,0,0,0,0,0,0,1,0,1,0,0,0,0,0,0,0,0,0,0,0,0,0,0,0,0,0,0
475495,37000,370,0,-2,3,0,3,0,0,0,0,0,0,0,0,0,1,0,1,0,0,0,1,0,1,1,0,1,0,0,0,0,0,0
475565,37000,370,0,-2,2,0,2,0,0,0,1,0,1,1,0,1,0,0,0,0,0,0,0,0,0,0,0,0,0,0,0,0,0,0
475608,37000,370,0,-2,2,1,1,1,1,0,0,0,0,0,0,0,0,0,0,0,0,0,1,0,1,0,0,0,0,0,0,0,0,0
475714,37000,370,0,-2,5,2,3,0,0,0,0,0,0,0,0,0,5,2,3,0,0,0,0,0,0,0,0,0,0,0,0,0,0,0
476717,37000,370,0,-2,1,0,1,0,0,0,0,0,0,0,0,0,0,0,0,0,0,0,1,0,1,0,0,0,0,0,0,0,0,0
476726,37000,370,0,-2,7,0,7,0,0,0,0,0,0,0,0,0,7,0,7,0,0,0,0,0,0,0,0,0,0,0,0,0,0,0
476975,37000,370,0,-2,18,2,16,0,0,0,0,0,0,2,1,1,2,0,2,0,0,0,13,1,12,1,0,1,0,0,0,0,0,0
477039,37000,370,0,-2,9,2,7,0,0,0,0,0,0,5,1,4,1,0,1,0,0,0,2,1,1,1,0,1,0,0,0,0,0,0
480073,37000,370,0,-2,1,1,0,0,0,0,0,0,0,0,0,0,0,0,0,0,0,0,1,1,0,0,0,0,0,0,0,0,0,0
480091,37000,370,0,-2,9,2,7,0,0,0,0,0,0,0,0,0,1,0,1,0,0,0,8,2,6,0,0,0,0,0,0,0,0,0
480204,37000,370,0,-2,2,0,2,0,0,0,0,0,0,0,0,0,1,0,1,0,0,0,1,0,1,0,0,0,0,0,0,0,0,0
480657,37000,370,0,-2,1,0,1,0,0,0,0,0,0,0,0,0,0,0,0,0,0,0,1,0,1,0,0,0,0,0,0,0,0,0
480790,37000,370,0,-2,13,0,13,0,0,0,1,0,1,0,0,0,1,0,1,0,0,0,11,0,11,0,0,0,0,0,0,0,0,0
480833,37000,370,0,-2,1,0,1,0,0,0,0,0,0,0,0,0,1,0,1,0,0,0,0,0,0,0,0,0,0,0,0,0,0,0
480967,37000,370,0,-2,3,0,3,3,0,3,0,0,0,0,0,0,0,0,0,0,0,0,0,0,0,0,0,0,0,0,0,0,0,0
481535,37000,370,0,-2,5,0,5,0,0,0,0,0,0,1,0,1,1,0,1,0,0,0,2,0,2,1,0,1,0,0,0,0,0,0
481775,37000,370,0,-2,2,0,2,0,0,0,0,0,0,1,0,1,1,0,1,0,0,0,0,0,0,0,0,0,0,0,0,0,0,0
482149,37000,370,0,-2,60,6,54,0,0,0,2,0,2,25,2,23,4,1,3,0,0,0,28,3,25,1,0,1,0,0,0,0,0,0
482158,37000,370,0,-2,13,2,11,0,0,0,0,0,0,4,1,3,2,0,2,0,0,0,7,1,6,0,0,0,0,0,0,0,0,0
482680,37000,370,0,-2,14,2,12,0,0,0,0,0,0,4,0,4,1,0,1,0,0,0,8,2,6,0,0,0,1,0,1,0,0,0
482699,37000,370,0,-2,5,0,5,0,0,0,0,0,0,0,0,0,0,0,0,0,0,0,4,0,4,1,0,1,0,0,0,0,0,0
482705,37000,370,0,-2,1,0,1,0,0,0,0,0,0,0,0,0,0,0,0,0,0,0,0,0,0,0,0,0,1,0,1,0,0,0
482936,37000,370,0,-2,5,1,4,0,0,0,0,0,0,0,0,0,1,0,1,0,0,0,4,1,3,0,0,0,0,0,0,0,0,0
483018,37000,370,0,-2,1,1,0,0,0,0,0,0,0,0,0,0,0,0,0,0,0,0,0,0,0,1,1,0,0,0,0,0,0,0
483036,37000,370,0,-2,10,2,8,0,0,0,0,0,0,4,0,4,2,1,1,0,0,0,3,1,2,1,0,1,0,0,0,0,0,0
483045,37000,370,0,-2,9,2,7,0,0,0,0,0,0,6,2,4,0,0,0,0,0,0,3,0,3,0,0,0,0,0,0,0,0,0
483124,37000,370,0,-2,2,0,2,0,0,0,0,0,0,0,0,0,1,0,1,0,0,0,1,0,1,0,0,0,0,0,0,0,0,0
483647,37000,370,0,-2,3,0,3,0,0,0,0,0,0,0,0,0,0,0,0,0,0,0,3,0,3,0,0,0,0,0,0,0,0,0
484002,37000,370,0,-2,7,0,7,0,0,0,1,0,1,0,0,0,5,0,5,0,0,0,1,0,1,0,0,0,0,0,0,0,0,0
484613,37000,370,0,-2,28,12,16,0,0,0,2,1,1,2,0,2,0,0,0,0,0,0,13,6,7,4,3,1,5,1,4,2,1,1
484835,37000,370,0,-2,1,0,1,0,0,0,0,0,0,0,0,0,1,0,1,0,0,0,0,0,0,0,0,0,0,0,0,0,0,0
484844,37000,370,0,-2,2,1,1,0,0,0,0,0,0,0,0,0,0,0,0,0,0,0,0,0,0,0,0,0,0,0,0,2,1,1
484905,37000,370,0,-2,9,3,6,0,0,0,1,1,0,4,1,3,1,0,1,0,0,0,1,1,0,1,0,1,1,0,1,0,0,0
485111,37000,370,0,-2,1,0,1,0,0,0,0,0,0,0,0,0,0,0,0,0,0,0,1,0,1,0,0,0,0,0,0,0,0,0
485272,37000,370,0,-2,3,2,1,0,0,0,0,0,0,1,1,0,1,1,0,0,0,0,1,0,1,0,0,0,0,0,0,0,0,0
485458,37000,370,0,-2,4,0,4,0,0,0,0,0,0,1,0,1,0,0,0,0,0,0,3,0,3,0,0,0,0,0,0,0,0,0
486284,37000,370,0,-2,5,2,3,0,0,0,0,0,0,0,0,0,0,0,0,0,0,0,5,2,3,0,0,0,0,0,0,0,0,0
486813,37000,370,0,-2,3,0,3,0,0,0,0,0,0,0,0,0,3,0,3,0,0,0,0,0,0,0,0,0,0,0,0,0,0,0
486822,37000,370,0,-2,4,3,1,0,0,0,0,0,0,0,0,0,1,1,0,0,0,0,3,2,1,0,0,0,0,0,0,0,0,0
486840,37000,370,0,-2,48,11,37,1,0,1,4,0,4,12,0,12,5,3,2,0,0,0,24,7,17,1,0,1,1,1,0,0,0,0
487010,37000,370,0,-2,60,10,50,0,0,0,0,0,0,35,9,26,3,0,3,0,0,0,21,1,20,1,0,1,0,0,0,0,0,0
487092,37000,370,0,-2,1,0,1,0,0,0,0,0,0,0,0,0,0,0,0,0,0,0,1,0,1,0,0,0,0,0,0,0,0,0
487162,37000,370,0,-2,4,0,4,0,0,0,0,0,0,1,0,1,0,0,0,0,0,0,3,0,3,0,0,0,0,0,0,0,0,0
487302,37000,370,0,-2,1,0,1,0,0,0,0,0,0,1,0,1,0,0,0,0,0,0,0,0,0,0,0,0,0,0,0,0,0,0
487320,37000,370,0,-2,31,6,25,0,0,0,1,0,1,0,0,0,12,3,9,1,0,1,16,3,13,0,0,0,1,0,1,0,0,0
487375,37000,370,0,-2,2,1,1,0,0,0,0,0,0,0,0,0,1,0,1,0,0,0,1,1,0,0,0,0,0,0,0,0,0,0
487384,37000,370,0,-2,10,3,7,0,0,0,0,0,0,5,2,3,0,0,0,0,0,0,1,0,1,3,0,3,1,1,0,0,0,0
487393,37000,370,0,-2,11,3,8,0,0,0,0,0,0,8,3,5,3,0,3,0,0,0,0,0,0,0,0,0,0,0,0,0,0,0
487409,37000,370,0,-2,13,5,8,0,0,0,0,0,0,6,3,3,6,2,4,0,0,0,0,0,0,0,0,0,1,0,1,0,0,0
487418,37000,370,0,-2,11,3,8,0,0,0,0,0,0,7,0,7,0,0,0,0,0,0,2,2,0,1,0,1,1,1,0,0,0,0
487427,37000,370,0,-2,13,1,12,0,0,0,0,0,0,2,0,2,2,0,2,0,0,0,7,1,6,1,0,1,1,0,1,0,0,0
487454,37000,370,0,-2,9,2,7,0,0,0,2,0,2,2,1,1,4,1,3,0,0,0,1,0,1,0,0,0,0,0,0,0,0,0
487472,37000,370,0,-2,13,6,7,0,0,0,0,0,0,4,1,3,5,3,2,0,0,0,2,1,1,1,0,1,1,1,0,0,0,0
487524,37000,370,0,-2,5,1,4,0,0,0,0,0,0,0,0,0,0,0,0,0,0,0,5,1,4,0,0,0,0,0,0,0,0,0
487588,37000,370,0,-2,4,0,4,0,0,0,0,0,0,3,0,3,0,0,0,0,0,0,1,0,1,0,0,0,0,0,0,0,0,0
487597,37000,370,0,-2,1,0,1,0,0,0,0,0,0,0,0,0,1,0,1,0,0,0,0,0,0,0,0,0,0,0,0,0,0,0
487603,37000,370,0,-2,2,0,2,0,0,0,1,0,1,0,0,0,0,0,0,0,0,0,0,0,0,1,0,1,0,0,0,0,0,0
487649,37000,370,0,-2,1,0,1,0,0,0,0,0,0,0,0,0,1,0,1,0,0,0,0,0,0,0,0,0,0,0,0,0,0,0
487861,37000,370,0,-2,1,0,1,0,0,0,0,0,0,1,0,1,0,0,0,0,0,0,0,0,0,0,0,0,0,0,0,0,0,0
488305,37000,370,0,-2,3,1,2,0,0,0,0,0,0,0,0,0,0,0,0,0,0,0,3,1,2,0,0,0,0,0,0,0,0,0
488527,37000,370,0,-2,5,1,4,0,0,0,0,0,0,0,0,0,0,0,0,0,0,0,4,1,3,0,0,0,1,0,1,0,0,0
488554,37000,370,0,-2,1,0,1,0,0,0,0,0,0,0,0,0,0,0,0,0,0,0,1,0,1,0,0,0,0,0,0,0,0,0
488572,37000,370,0,-2,10,3,7,0,0,0,2,1,1,1,1,0,4,1,3,0,0,0,3,0,3,0,0,0,0,0,0,0,0,0
488730,37000,370,0,-2,2,0,2,0,0,0,0,0,0,1,0,1,1,0,1,0,0,0,0,0,0,0,0,0,0,0,0,0,0,0
489283,37000,370,0,-2,1,0,1,0,0,0,0,0,0,0,0,0,1,0,1,0,0,0,0,0,0,0,0,0,0,0,0,0,0,0
489858,37000,370,0,-2,4,0,4,0,0,0,1,0,1,1,0,1,2,0,2,0,0,0,0,0,0,0,0,0,0,0,0,0,0,0
490106,37000,370,0,-2,3,1,2,0,0,0,3,1,2,0,0,0,0,0,0,0,0,0,0,0,0,0,0,0,0,0,0,0,0,0
490133,37000,370,0,-2,1,0,1,0,0,0,0,0,0,0,0,0,0,0,0,0,0,0,1,0,1,0,0,0,0,0,0,0,0,0
490373,37000,370,0,-2,18,1,17,0,0,0,0,0,0,0,0,0,4,0,4,0,0,0,10,1,9,1,0,1,3,0,3,0,0,0
490805,37000,370,0,-2,2,0,2,0,0,0,0,0,0,0,0,0,0,0,0,0,0,0,2,0,2,0,0,0,0,0,0,0,0,0
490975,37000,370,0,-2,2,0,2,0,0,0,0,0,0,0,0,0,2,0,2,0,0,0,0,0,0,0,0,0,0,0,0,0,0,0
491525,37000,370,0,-2,4,3,1,0,0,0,0,0,0,0,0,0,0,0,0,0,0,0,4,3,1,0,0,0,0,0,0,0,0,0
491808,37000,370,0,-2,7,1,6,0,0,0,1,0,1,1,0,1,0,0,0,0,0,0,5,1,4,0,0,0,0,0,0,0,0,0
492263,37000,370,0,-2,9,0,9,0,0,0,0,0,0,1,0,1,1,0,1,0,0,0,7,0,7,0,0,0,0,0,0,0,0,0
492449,37000,370,0,-2,1,0,1,0,0,0,0,0,0,0,0,0,1,0,1,0,0,0,0,0,0,0,0,0,0,0,0,0,0,0
492689,37000,370,0,-2,96,22,74,0,0,0,1,0,1,0,0,0,85,20,65,0,0,0,6,0,6,1,0,1,0,0,0,3,2,1
492722,37000,370,0,-2,1,0,1,0,0,0,0,0,0,0,0,0,1,0,1,0,0,0,0,0,0,0,0,0,0,0,0,0,0,0
493822,37000,370,0,-2,1,0,1,0,0,0,0,0,0,0,0,0,0,0,0,0,0,0,1,0,1,0,0,0,0,0,0,0,0,0
494010,37000,370,0,-2,1,0,1,0,0,0,0,0,0,0,0,0,0,0,0,0,0,0,0,0,0,0,0,0,1,0,1,0,0,0
494250,37000,370,0,-2,3,0,3,0,0,0,0,0,0,0,0,0,1,0,1,0,0,0,2,0,2,0,0,0,0,0,0,0,0,0
494287,37000,370,0,-2,3,0,3,0,0,0,0,0,0,0,0,0,3,0,3,0,0,0,0,0,0,0,0,0,0,0,0,0,0,0
494436,37000,370,0,-2,1,1,0,0,0,0,0,0,0,0,0,0,0,0,0,0,0,0,1,1,0,0,0,0,0,0,0,0,0,0
494603,37000,370,0,-2,6,4,2,0,0,0,1,1,0,0,0,0,0,0,0,0,0,0,5,3,2,0,0,0,0,0,0,0,0,0
494746,37000,370,0,-2,1,0,1,0,0,0,0,0,0,0,0,0,0,0,0,0,0,0,0,0,0,0,0,0,1,0,1,0,0,0
494755,37000,370,0,-2,1,0,1,0,0,0,0,0,0,0,0,0,0,0,0,0,0,0,1,0,1,0,0,0,0,0,0,0,0,0
494843,37000,370,0,-2,1,0,1,0,0,0,0,0,0,1,0,1,0,0,0,0,0,0,0,0,0,0,0,0,0,0,0,0,0,0
494852,37000,370,0,-2,3,0,3,0,0,0,0,0,0,1,0,1,0,0,0,0,0,0,2,0,2,0,0,0,0,0,0,0,0,0
495314,37000,370,0,-2,5,1,4,0,0,0,0,0,0,0,0,0,3,1,2,0,0,0,0,0,0,0,0,0,2,0,2,0,0,0
495420,37000,370,0,-2,3,0,3,0,0,0,0,0,0,1,0,1,0,0,0,0,0,0,2,0,2,0,0,0,0,0,0,0,0,0
495448,37000,370,0,-2,1,0,1,0,0,0,0,0,0,0,0,0,0,0,0,0,0,0,1,0,1,0,0,0,0,0,0,0,0,0
495457,37000,370,0,-2,1,0,1,0,0,0,0,0,0,0,0,0,0,0,0,0,0,0,1,0,1,0,0,0,0,0,0,0,0,0
495767,37000,370,0,-2,96,11,85,0,0,0,2,0,2,3,0,3,4,0,4,0,0,0,80,11,69,4,0,4,2,0,2,1,0,1
496043,37000,370,0,-2,3,0,3,0,0,0,0,0,0,0,0,0,2,0,2,0,0,0,1,0,1,0,0,0,0,0,0,0,0,0
496283,37000,370,0,-2,2,1,1,0,0,0,0,0,0,0,0,0,0,0,0,0,0,0,2,1,1,0,0,0,0,0,0,0,0,0
496326,37000,370,0,-2,4,0,4,0,0,0,0,0,0,1,0,1,0,0,0,0,0,0,2,0,2,0,0,0,1,0,1,0,0,0
496627,37000,370,0,-2,22,9,13,0,0,0,7,4,3,2,0,2,2,1,1,0,0,0,5,2,3,4,0,4,2,2,0,0,0,0
496991,37000,370,0,-2,6,2,4,0,0,0,0,0,0,5,1,4,0,0,0,0,0,0,0,0,0,1,1,0,0,0,0,0,0,0
497046,37000,370,0,-2,1,0,1,0,0,0,0,0,0,0,0,0,1,0,1,0,0,0,0,0,0,0,0,0,0,0,0,0,0,0
497277,37000,370,0,-2,2,0,2,0,0,0,0,0,0,0,0,0,0,0,0,0,0,0,0,0,0,1,0,1,1,0,1,0,0,0
100654,38000,380,0,-2,1,0,1,0,0,0,0,0,0,0,0,0,0,0,0,0,0,0,0,0,0,0,0,0,0,0,0,1,0,1
100663,38000,380,0,-2,30,30,0,0,0,0,0,0,0,8,8,0,0,0,0,0,0,0,20,20,0,1,1,0,1,1,0,0,0,0
100706,38000,380,0,-2,2,2,0,0,0,0,0,0,0,0,0,0,0,0,0,0,0,0,2,2,0,0,0,0,0,0,0,0,0,0
100724,38000,380,0,-2,4,2,2,0,0,0,0,0,0,2,2,0,0,0,0,0,0,0,0,0,0,0,0,0,2,0,2,0,0,0
100751,38000,380,0,-2,9,9,0,0,0,0,1,1,0,0,0,0,0,0,0,0,0,0,8,8,0,0,0,0,0,0,0,0,0,0
100858,38000,380,0,-2,11,11,0,0,0,0,0,0,0,2,2,0,0,0,0,0,0,0,9,9,0,0,0,0,0,0,0,0,0,0
100937,38000,380,0,-2,1,1,0,0,0,0,0,0,0,0,0,0,0,0,0,0,0,0,1,1,0,0,0,0,0,0,0,0,0,0
101240,38000,380,0,-2,3,3,0,0,0,0,0,0,0,0,0,0,0,0,0,0,0,0,3,3,0,0,0,0,0,0,0,0,0,0
101471,38000,380,0,-2,1,1,0,0,0,0,0,0,0,0,0,0,0,0,0,0,0,0,1,1,0,0,0,0,0,0,0,0,0,0
101480,38000,380,0,-2,4,4,0,0,0,0,0,0,0,0,0,0,0,0,0,0,0,0,4,4,0,0,0,0,0,0,0,0,0,0
101505,38000,380,0,-2,2,2,0,0,0,0,0,0,0,0,0,0,1,1,0,0,0,0,1,1,0,0,0,0,0,0,0,0,0,0
101709,38000,380,0,-2,1,1,0,0,0,0,0,0,0,0,0,0,0,0,0,0,0,0,1,1,0,0,0,0,0,0,0,0,0,0
101879,38000,380,0,-2,1,1,0,0,0,0,0,0,0,0,0,0,0,0,0,0,0,0,1,1,0,0,0,0,0,0,0,0,0,0
102067,38000,380,0,-2,1,0,1,0,0,0,0,0,0,1,0,1,0,0,0,0,0,0,0,0,0,0,0,0,0,0,0,0,0,0
102094,38000,380,0,-2,11,11,0,0,0,0,0,0,0,2,2,0,0,0,0,0,0,0,9,9,0,0,0,0,0,0,0,0,0,0
102234,38000,380,0,-2,1,1,0,0,0,0,0,0,0,0,0,0,0,0,0,0,0,0,1,1,0,0,0,0,0,0,0,0,0,0
102313,38000,380,0,-2,1,1,0,0,0,0,0,0,0,1,1,0,0,0,0,0,0,0,0,0,0,0,0,0,0,0,0,0,0,0
102553,38000,380,0,-2,6,6,0,0,0,0,0,0,0,0,0,0,1,1,0,0,0,0,4,4,0,0,0,0,1,1,0,0,0,0
102614,38000,380,0,-2,8,7,1,0,0,0,0,0,0,0,0,0,0,0,0,0,0,0,4,3,1,2,2,0,2,2,0,0,0,0
102632,38000,380,0,-2,1,1,0,0,0,0,0,0,0,0,0,0,0,0,0,0,0,0,1,1,0,0,0,0,0,0,0,0,0,0
104151,38000,380,0,-2,17,16,1,0,0,0,0,0,0,0,0,0,0,0,0,0,0,0,4,4,0,0,0,0,13,12,1,0,0,0
104179,38000,380,0,-2,3,3,0,0,0,0,0,0,0,0,0,0,0,0,0,0,0,0,3,3,0,0,0,0,0,0,0,0,0,0
104425,38000,380,0,-2,1,1,0,0,0,0,0,0,0,0,0,0,0,0,0,0,0,0,1,1,0,0,0,0,0,0,0,0,0,0
104586,38000,380,0,-2,7,6,1,0,0,0,0,0,0,0,0,0,2,2,0,0,0,0,5,4,1,0,0,0,0,0,0,0,0,0
104708,38000,380,0,-2,1,1,0,0,0,0,0,0,0,0,0,0,0,0,0,0,0,0,0,0,0,0,0,0,1,1,0,0,0,0
104717,38000,380,0,-2,79,72,7,2,2,0,2,2,0,2,1,1,24,22,2,1,1,0,33,31,2,4,3,1,11,10,1,0,0,0
105154,38000,380,0,-2,1,1,0,0,0,0,0,0,0,0,0,0,0,0,0,0,0,0,0,0,0,0,0,0,1,1,0,0,0,0
105330,38000,380,0,-2,7,7,0,0,0,0,0,0,0,0,0,0,1,1,0,0,0,0,4,4,0,1,1,0,1,1,0,0,0,0
105349,38000,380,0,-2,4,4,0,0,0,0,0,0,0,0,0,0,1,1,0,0,0,0,3,3,0,0,0,0,0,0,0,0,0,0
105659,38000,380,0,-2,1,1,0,1,1,0,0,0,0,0,0,0,0,0,0,0,0,0,0,0,0,0,0,0,0,0,0,0,0,0
105792,38000,380,0,-2,1,1,0,0,0,0,0,0,0,0,0,0,0,0,0,0,0,0,0,0,0,0,0,0,1,1,0,0,0,0
106148,38000,380,0,-2,8,8,0,0,0,0,0,0,0,0,0,0,1,1,0,1,1,0,6,6,0,0,0,0,0,0,0,0,0,0
106245,38000,380,0,-2,1,0,1,0,0,0,0,0,0,0,0,0,0,0,0,0,0,0,1,0,1,0,0,0,0,0,0,0,0,0
106263,38000,380,0,-2,23,22,1,0,0,0,1,1,0,2,2,0,2,1,1,0,0,0,18,18,0,0,0,0,0,0,0,0,0,0
106397,38000,380,0,-2,25,20,5,0,0,0,0,0,0,0,0,0,1,1,0,0,0,0,23,18,5,1,1,0,0,0,0,0,0,0
106412,38000,380,0,-2,1,0,1,0,0,0,0,0,0,1,0,1,0,0,0,0,0,0,0,0,0,0,0,0,0,0,0,0,0,0
106449,38000,380,0,-2,1,1,0,0,0,0,0,0,0,0,0,0,0,0,0,0,0,0,1,1,0,0,0,0,0,0,0,0,0,0
106458,38000,380,0,-2,7,7,0,0,0,0,0,0,0,0,0,0,0,0,0,0,0,0,7,7,0,0,0,0,0,0,0,0,0,0
106485,38000,380,0,-2,2,2,0,0,0,0,0,0,0,0,0,0,0,0,0,0,0,0,2,2,0,0,0,0,0,0,0,0,0,0
106704,38000,380,0,-2,7,7,0,0,0,0,0,0,0,0,0,0,0,0,0,0,0,0,7,7,0,0,0,0,0,0,0,0,0,0
106810,38000,380,0,-2,1,1,0,0,0,0,0,0,0,0,0,0,0,0,0,0,0,0,1,1,0,0,0,0,0,0,0,0,0,0
107044,38000,380,0,-2,2,2,0,0,0,0,0,0,0,0,0,0,0,0,0,0,0,0,1,1,0,0,0,0,1,1,0,0,0,0
107080,38000,380,0,-2,1,1,0,0,0,0,0,0,0,0,0,0,0,0,0,0,0,0,1,1,0,0,0,0,0,0,0,0,0,0
107141,38000,380,0,-2,2,2,0,1,1,0,0,0,0,0,0,0,0,0,0,0,0,0,1,1,0,0,0,0,0,0,0,0,0,0
107512,38000,380,0,-2,1,1,0,0,0,0,0,0,0,0,0,0,0,0,0,0,0,0,1,1,0,0,0,0,0,0,0,0,0,0
107549,38000,380,0,-2,2,2,0,0,0,0,0,0,0,0,0,0,0,0,0,0,0,0,2,2,0,0,0,0,0,0,0,0,0,0
107558,38000,380,0,-2,3,3,0,0,0,0,0,0,0,0,0,0,0,0,0,0,0,0,3,3,0,0,0,0,0,0,0,0,0,0
107585,38000,380,0,-2,2,0,2,0,0,0,0,0,0,0,0,0,0,0,0,0,0,0,2,0,2,0,0,0,0,0,0,0,0,0
107637,38000,380,0,-2,1,1,0,0,0,0,0,0,0,1,1,0,0,0,0,0,0,0,0,0,0,0,0,0,0,0,0,0,0,0
107664,38000,380,0,-2,1,0,1,0,0,0,0,0,0,0,0,0,0,0,0,0,0,0,1,0,1,0,0,0,0,0,0,0,0,0
107877,38000,380,0,-2,1,0,1,0,0,0,0,0,0,0,0,0,0,0,0,0,0,0,1,0,1,0,0,0,0,0,0,0,0,0
107974,38000,380,0,-2,1,1,0,0,0,0,0,0,0,1,1,0,0,0,0,0,0,0,0,0,0,0,0,0,0,0,0,0,0,0
107983,38000,380,0,-2,2,2,0,0,0,0,0,0,0,1,1,0,0,0,0,0,0,0,1,1,0,0,0,0,0,0,0,0,0,0
108092,38000,380,0,-2,1,1,0,0,0,0,0,0,0,0,0,0,0,0,0,0,0,0,1,1,0,0,0,0,0,0,0,0,0,0
110097,38000,380,0,-2,5,5,0,0,0,0,1,1,0,0,0,0,1,1,0,0,0,0,3,3,0,0,0,0,0,0,0,0,0,0
110361,38000,380,0,-2,5,4,1,0,0,0,0,0,0,0,0,0,2,2,0,0,0,0,3,2,1,0,0,0,0,0,0,0,0,0
110370,38000,380,0,-2,2,1,1,0,0,0,0,0,0,0,0,0,1,1,0,0,0,0,1,0,1,0,0,0,0,0,0,0,0,0
110398,38000,380,0,-2,1,0,1,0,0,0,1,0,1,0,0,0,0,0,0,0,0,0,0,0,0,0,0,0,0,0,0,0,0,0
110404,38000,380,0,-2,6,5,1,0,0,0,0,0,0,0,0,0,1,1,0,0,0,0,3,2,1,0,0,0,2,2,0,0,0,0
110413,38000,380,0,-2,2,2,0,0,0,0,1,1,0,0,0,0,0,0,0,0,0,0,1,1,0,0,0,0,0,0,0,0,0,0
110422,38000,380,0,-2,7,7,0,0,0,0,0,0,0,0,0,0,0,0,0,0,0,0,6,6,0,0,0,0,1,1,0,0,0,0
110486,38000,380,0,-2,1,1,0,0,0,0,0,0,0,0,0,0,0,0,0,0,0,0,0,0,0,0,0,0,1,1,0,0,0,0
110495,38000,380,0,-2,3,3,0,1,1,0,0,0,0,0,0,0,1,1,0,0,0,0,1,1,0,0,0,0,0,0,0,0,0,0
110529,38000,380,0,-2,2,1,1,0,0,0,0,0,0,0,0,0,1,1,0,0,0,0,1,0,1,0,0,0,0,0,0,0,0,0
110538,38000,380,0,-2,3,2,1,0,0,0,0,0,0,0,0,0,0,0,0,0,0,0,3,2,1,0,0,0,0,0,0,0,0,0
110547,38000,380,0,-2,1,1,0,0,0,0,0,0,0,0,0,0,1,1,0,0,0,0,0,0,0,0,0,0,0,0,0,0,0,0
110583,38000,380,0,-2,7,6,1,0,0,0,1,0,1,1,1,0,0,0,0,0,0,0,3,3,0,0,0,0,2,2,0,0,0,0
110592,38000,380,0,-2,4,3,1,0,0,0,0,0,0,0,0,0,3,3,0,0,0,0,1,0,1,0,0,0,0,0,0,0,0,0
110608,38000,380,0,-2,2,2,0,0,0,0,0,0,0,0,0,0,1,1,0,0,0,0,0,0,0,0,0,0,1,1,0,0,0,0
110617,38000,380,0,-2,2,1,1,0,0,0,0,0,0,0,0,0,0,0,0,0,0,0,2,1,1,0,0,0,0,0,0,0,0,0
110635,38000,380,0,-2,7,6,1,0,0,0,1,1,0,0,0,0,0,0,0,0,0,0,6,5,1,0,0,0,0,0,0,0,0,0
110644,38000,380,0,-2,32,28,4,1,1,0,0,0,0,2,2,0,11,11,0,0,0,0,10,9,1,0,0,0,8,5,3,0,0,0
110653,38000,380,0,-2,7,7,0,0,0,0,0,0,0,0,0,0,4,4,0,0,0,0,2,2,0,0,0,0,0,0,0,1,1,0
110662,38000,380,0,-2,14,14,0,0,0,0,1,1,0,3,3,0,7,7,0,0,0,0,2,2,0,1,1,0,0,0,0,0,0,0
110671,38000,380,0,-2,13,13,0,0,0,0,1,1,0,0,0,0,6,6,0,1,1,0,5,5,0,0,0,0,0,0,0,0,0,0
110680,38000,380,0,-2,34,32,2,0,0,0,3,3,0,1,1,0,14,13,1,0,0,0,11,11,0,1,1,0,3,2,1,1,1,0
110699,38000,380,0,-2,12,12,0,0,0,0,4,4,0,1,1,0,2,2,0,0,0,0,4,4,0,1,1,0,0,0,0,0,0,0
110705,38000,380,0,-2,1,1,0,0,0,0,0,0,0,0,0,0,0,0,0,0,0,0,1,1,0,0,0,0,0,0,0,0,0,0
110714,38000,380,0,-2,5,5,0,0,0,0,0,0,0,0,0,0,2,2,0,0,0,0,1,1,0,0,0,0,1,1,0,1,1,0
111081,38000,380,0,-2,1,1,0,0,0,0,0,0,0,0,0,0,1,1,0,0,0,0,0,0,0,0,0,0,0,0,0,0,0,0
111391,38000,380,0,-2,1,1,0,0,0,0,0,0,0,0,0,0,0,0,0,0,0,0,1,1,0,0,0,0,0,0,0,0,0,0
111461,38000,380,0,-2,2,2,0,0,0,0,0,0,0,0,0,0,0,0,0,0,0,0,2,2,0,0,0,0,0,0,0,0,0,0
113573,38000,380,0,-2,3,1,2,0,0,0,0,0,0,0,0,0,1,0,1,0,0,0,0,0,0,0,0,0,0,0,0,2,1,1
117636,38000,380,0,-2,5,5,0,0,0,0,0,0,0,0,0,0,2,2,0,0,0,0,3,3,0,0,0,0,0,0,0,0,0,0
117672,38000,380,0,-2,1,1,0,0,0,0,0,0,0,0,0,0,1,1,0,0,0,0,0,0,0,0,0,0,0,0,0,0,0,0
117751,38000,380,0,-2,1,1,0,0,0,0,0,0,0,0,0,0,1,1,0,0,0,0,0,0,0,0,0,0,0,0,0,0,0,0
117946,38000,380,0,-2,2,2,0,0,0,0,0,0,0,0,0,0,1,1,0,0,0,0,0,0,0,0,0,0,1,1,0,0,0,0
118693,38000,380,0,-2,1,1,0,0,0,0,0,0,0,0,0,0,1,1,0,0,0,0,0,0,0,0,0,0,0,0,0,0,0,0
120166,38000,380,0,-2,1,1,0,0,0,0,0,0,0,0,0,0,0,0,0,0,0,0,1,1,0,0,0,0,0,0,0,0,0,0
121150,38000,380,0,-2,1,1,0,0,0,0,0,0,0,0,0,0,0,0,0,0,0,0,0,0,0,1,1,0,0,0,0,0,0,0
121309,38000,380,0,-2,2,2,0,0,0,0,0,0,0,0,0,0,1,1,0,0,0,0,0,0,0,1,1,0,0,0,0,0,0,0
121345,38000,380,0,-2,3,3,0,0,0,0,0,0,0,0,0,0,2,2,0,0,0,0,1,1,0,0,0,0,0,0,0,0,0,0
121691,38000,380,0,-2,2,2,0,0,0,0,0,0,0,0,0,0,1,1,0,0,0,0,0,0,0,0,0,0,1,1,0,0,0,0
122409,38000,380,0,-2,10,10,0,0,0,0,1,1,0,0,0,0,5,5,0,0,0,0,4,4,0,0,0,0,0,0,0,0,0,0
122436,38000,380,0,-2,4,4,0,0,0,0,0,0,0,0,0,0,2,2,0,0,0,0,2,2,0,0,0,0,0,0,0,0,0,0
122597,38000,380,0,-2,3,3,0,0,0,0,0,0,0,0,0,0,1,1,0,0,0,0,2,2,0,0,0,0,0,0,0,0,0,0
122612,38000,380,0,-2,10,9,1,0,0,0,3,3,0,1,1,0,3,2,1,0,0,0,2,2,0,0,0,0,1,1,0,0,0,0
122728,38000,380,0,-2,1,0,1,0,0,0,0,0,0,1,0,1,0,0,0,0,0,0,0,0,0,0,0,0,0,0,0,0,0,0
122931,38000,380,0,-2,2,2,0,0,0,0,0,0,0,0,0,0,2,2,0,0,0,0,0,0,0,0,0,0,0,0,0,0,0,0
123800,38000,380,0,-2,1,1,0,0,0,0,1,1,0,0,0,0,0,0,0,0,0,0,0,0,0,0,0,0,0,0,0,0,0,0
123961,38000,380,0,-2,7,6,1,0,0,0,0,0,0,0,0,0,5,5,0,0,0,0,2,1,1,0,0,0,0,0,0,0,0,0
124557,38000,380,0,-2,4,4,0,0,0,0,0,0,0,0,0,0,2,2,0,0,0,0,1,1,0,0,0,0,1,1,0,0,0,0
126182,38000,380,0,-2,1,1,0,0,0,0,0,0,0,0,0,0,1,1,0,0,0,0,0,0,0,0,0,0,0,0,0,0,0,0
126562,38000,380,0,-2,6,6,0,0,0,0,1,1,0,0,0,0,1,1,0,0,0,0,3,3,0,0,0,0,1,1,0,0,0,0
126580,38000,380,0,-2,2,2,0,0,0,0,0,0,0,0,0,0,0,0,0,0,0,0,2,2,0,0,0,0,0,0,0,0,0,0
126614,38000,380,0,-2,12,12,0,0,0,0,0,0,0,0,0,0,4,4,0,0,0,0,7,7,0,0,0,0,1,1,0,0,0,0
126669,38000,380,0,-2,1,1,0,0,0,0,0,0,0,0,0,0,0,0,0,0,0,0,1,1,0,0,0,0,0,0,0,0,0,0
126678,38000,380,0,-2,1,1,0,0,0,0,0,0,0,0,0,0,0,0,0,0,0,0,1,1,0,0,0,0,0,0,0,0,0,0
126711,38000,380,0,-2,1,1,0,0,0,0,0,0,0,0,0,0,0,0,0,0,0,0,1,1,0,0,0,0,0,0,0,0,0,0
126818,38000,380,0,-2,30,27,3,0,0,0,1,1,0,0,0,0,3,3,0,2,2,0,20,18,2,2,2,0,2,1,1,0,0,0
127060,38000,380,0,-2,3,3,0,0,0,0,0,0,0,0,0,0,1,1,0,0,0,0,1,1,0,1,1,0,0,0,0,0,0,0
127185,38000,380,0,-2,3,2,1,0,0,0,0,0,0,0,0,0,0,0,0,0,0,0,3,2,1,0,0,0,0,0,0,0,0,0
127200,38000,380,0,-2,4,4,0,0,0,0,0,0,0,0,0,0,1,1,0,0,0,0,3,3,0,0,0,0,0,0,0,0,0,0
127389,38000,380,0,-2,1,1,0,0,0,0,0,0,0,0,0,0,1,1,0,0,0,0,0,0,0,0,0,0,0,0,0,0,0,0
127732,38000,380,0,-2,1,1,0,0,0,0,0,0,0,0,0,0,0,0,0,0,0,0,1,1,0,0,0,0,0,0,0,0,0,0
127741,38000,380,0,-2,8,8,0,0,0,0,0,0,0,0,0,0,1,1,0,0,0,0,4,4,0,0,0,0,3,3,0,0,0,0
127820,38000,380,0,-2,3,3,0,0,0,0,0,0,0,0,0,0,1,1,0,0,0,0,2,2,0,0,0,0,0,0,0,0,0,0
127918,38000,380,0,-2,5,5,0,0,0,0,0,0,0,0,0,0,2,2,0,0,0,0,2,2,0,0,0,0,1,1,0,0,0,0
128391,38000,380,0,-2,2,1,1,0,0,0,0,0,0,0,0,0,0,0,0,0,0,0,2,1,1,0,0,0,0,0,0,0,0,0
128902,38000,380,0,-2,4,4,0,0,0,0,0,0,0,0,0,0,0,0,0,0,0,0,4,4,0,0,0,0,0,0,0,0,0,0
129020,38000,380,0,-2,48,37,11,0,0,0,1,1,0,1,1,0,10,5,5,0,0,0,21,18,3,0,0,0,15,12,3,0,0,0
129215,38000,380,0,-2,2,2,0,0,0,0,0,0,0,0,0,0,1,1,0,0,0,0,1,1,0,0,0,0,0,0,0,0,0,0
129774,38000,380,0,-2,1,1,0,0,0,0,0,0,0,0,0,0,1,1,0,0,0,0,0,0,0,0,0,0,0,0,0,0,0,0
130217,38000,380,0,-2,2,2,0,0,0,0,0,0,0,0,0,0,0,0,0,0,0,0,2,2,0,0,0,0,0,0,0,0,0,0
130493,38000,380,0,-2,3,2,1,0,0,0,0,0,0,0,0,0,0,0,0,0,0,0,1,0,1,0,0,0,2,2,0,0,0,0
130590,38000,380,0,-2,1,0,1,0,0,0,0,0,0,0,0,0,0,0,0,0,0,0,1,0,1,0,0,0,0,0,0,0,0,0
130624,38000,380,0,-2,51,50,1,0,0,0,1,0,1,0,0,0,0,0,0,0,0,0,3,3,0,2,2,0,44,44,0,1,1,0
130776,38000,380,0,-2,1,1,0,0,0,0,0,0,0,0,0,0,0,0,0,0,0,0,1,1,0,0,0,0,0,0,0,0,0,0
130794,38000,380,0,-2,4,4,0,0,0,0,0,0,0,0,0,0,1,1,0,0,0,0,3,3,0,0,0,0,0,0,0,0,0,0
130907,38000,380,0,-2,1,1,0,0,0,0,0,0,0,1,1,0,0,0,0,0,0,0,0,0,0,0,0,0,0,0,0,0,0,0
130943,38000,380,0,-2,24,21,3,0,0,0,0,0,0,0,0,0,2,2,0,0,0,0,21,18,3,1,1,0,0,0,0,0,0,0
131159,38000,380,0,-2,4,4,0,1,1,0,0,0,0,1,1,0,0,0,0,0,0,0,1,1,0,0,0,0,1,1,0,0,0,0
131283,38000,380,0,-2,1,1,0,0,0,0,0,0,0,0,0,0,0,0,0,0,0,0,1,1,0,0,0,0,0,0,0,0,0,0
131399,38000,380,0,-2,2,0,2,0,0,0,0,0,0,0,0,0,0,0,0,0,0,0,1,0,1,0,0,0,1,0,1,0,0,0
131450,38000,380,0,-2,4,4,0,0,0,0,0,0,0,3,3,0,0,0,0,0,0,0,1,1,0,0,0,0,0,0,0,0,0,0
131469,38000,380,0,-2,7,7,0,0,0,0,0,0,0,3,3,0,0,0,0,0,0,0,4,4,0,0,0,0,0,0,0,0,0,0
131496,38000,380,0,-2,3,2,1,0,0,0,1,0,1,1,1,0,0,0,0,0,0,0,0,0,0,0,0,0,1,1,0,0,0,0
131520,38000,380,0,-2,1,1,0,0,0,0,0,0,0,1,1,0,0,0,0,0,0,0,0,0,0,0,0,0,0,0,0,0,0,0
132471,38000,380,0,-2,2,2,0,0,0,0,0,0,0,0,0,0,1,1,0,0,0,0,0,0,0,1,1,0,0,0,0,0,0,0
132657,38000,380,0,-2,1,1,0,0,0,0,0,0,0,0,0,0,0,0,0,0,0,0,1,1,0,0,0,0,0,0,0,0,0,0
132851,38000,380,0,-2,1,1,0,0,0,0,0,0,0,0,0,0,0,0,0,0,0,0,1,1,0,0,0,0,0,0,0,0,0,0
132903,38000,380,0,-2,1,1,0,0,0,0,0,0,0,0,0,0,1,1,0,0,0,0,0,0,0,0,0,0,0,0,0,0,0,0
133386,38000,380,0,-2,13,9,4,0,0,0,0,0,0,4,2,2,1,1,0,0,0,0,7,5,2,0,0,0,1,1,0,0,0,0
133492,38000,380,0,-2,2,1,1,0,0,0,0,0,0,0,0,0,0,0,0,0,0,0,2,1,1,0,0,0,0,0,0,0,0,0
133508,38000,380,0,-2,1,0,1,0,0,0,0,0,0,0,0,0,0,0,0,0,0,0,1,0,1,0,0,0,0,0,0,0,0,0
133553,38000,380,0,-2,11,10,1,0,0,0,0,0,0,0,0,0,2,2,0,0,0,0,9,8,1,0,0,0,0,0,0,0,0,0
133702,38000,380,0,-2,12,6,6,0,0,0,0,0,0,3,1,2,2,0,2,0,0,0,7,5,2,0,0,0,0,0,0,0,0,0
133809,38000,380,0,-2,1,1,0,0,0,0,0,0,0,0,0,0,0,0,0,0,0,0,1,1,0,0,0,0,0,0,0,0,0,0
133881,38000,380,0,-2,3,3,0,0,0,0,0,0,0,0,0,0,0,0,0,0,0,0,3,3,0,0,0,0,0,0,0,0,0,0
133960,38000,380,0,-2,2,2,0,0,0,0,0,0,0,0,0,0,0,0,0,0,0,0,2,2,0,0,0,0,0,0,0,0,0,0
134079,38000,380,0,-2,3,3,0,0,0,0,0,0,0,0,0,0,2,2,0,0,0,0,1,1,0,0,0,0,0,0,0,0,0,0
134097,38000,380,0,-2,2,1,1,0,0,0,0,0,0,0,0,0,0,0,0,0,0,0,2,1,1,0,0,0,0,0,0,0,0,0
134130,38000,380,0,-2,37,29,8,0,0,0,0,0,0,3,0,3,3,2,1,0,0,0,28,24,4,0,0,0,3,3,0,0,0,0
134237,38000,380,0,-2,1,1,0,0,0,0,0,0,0,0,0,0,0,0,0,0,0,0,1,1,0,0,0,0,0,0,0,0,0,0
134608,38000,380,0,-2,3,3,0,0,0,0,0,0,0,0,0,0,1,1,0,0,0,0,2,2,0,0,0,0,0,0,0,0,0,0
135160,38000,380,0,-2,2,2,0,0,0,0,0,0,0,0,0,0,0,0,0,0,0,0,2,2,0,0,0,0,0,0,0,0,0,0
135188,38000,380,0,-2,3,3,0,0,0,0,0,0,0,0,0,0,0,0,0,0,0,0,3,3,0,0,0,0,0,0,0,0,0,0
135391,38000,380,0,-2,1,1,0,0,0,0,0,0,0,0,0,0,0,0,0,0,0,0,1,1,0,0,0,0,0,0,0,0,0,0
135717,38000,380,0,-2,4,4,0,0,0,0,0,0,0,1,1,0,3,3,0,0,0,0,0,0,0,0,0,0,0,0,0,0,0,0
135726,38000,380,0,-2,20,17,3,0,0,0,0,0,0,3,2,1,10,10,0,0,0,0,6,4,2,0,0,0,0,0,0,1,1,0
136172,38000,380,0,-2,6,6,0,0,0,0,0,0,0,0,0,0,0,0,0,0,0,0,5,5,0,1,1,0,0,0,0,0,0,0
136215,38000,380,0,-2,4,4,0,0,0,0,0,0,0,0,0,0,3,3,0,0,0,0,1,1,0,0,0,0,0,0,0,0,0,0
136233,38000,380,0,-2,2,2,0,0,0,0,0,0,0,0,0,0,0,0,0,0,0,0,2,2,0,0,0,0,0,0,0,0,0,0
136358,38000,380,0,-2,2,1,1,0,0,0,1,0,1,0,0,0,0,0,0,0,0,0,1,1,0,0,0,0,0,0,0,0,0,0
136400,38000,380,0,-2,1,1,0,0,0,0,0,0,0,0,0,0,0,0,0,0,0,0,1,1,0,0,0,0,0,0,0,0,0,0
136473,38000,380,0,-2,2,2,0,0,0,0,0,0,0,0,0,0,0,0,0,0,0,0,2,2,0,0,0,0,0,0,0,0,0,0
136701,38000,380,0,-2,1,1,0,0,0,0,0,0,0,0,0,0,0,0,0,0,0,0,1,1,0,0,0,0,0,0,0,0,0,0
136774,38000,380,0,-2,7,7,0,0,0,0,0,0,0,0,0,0,2,2,0,0,0,0,5,5,0,0,0,0,0,0,0,0,0,0
137032,38000,380,0,-2,2,2,0,0,0,0,0,0,0,0,0,0,0,0,0,0,0,0,2,2,0,0,0,0,0,0,0,0,0,0
137078,38000,380,0,-2,1,1,0,0,0,0,0,0,0,1,1,0,0,0,0,0,0,0,0,0,0,0,0,0,0,0,0,0,0,0
137096,38000,380,0,-2,1,1,0,0,0,0,0,0,0,1,1,0,0,0,0,0,0,0,0,0,0,0,0,0,0,0,0,0,0,0
137315,38000,380,0,-2,1,0,1,0,0,0,0,0,0,0,0,0,0,0,0,0,0,0,1,0,1,0,0,0,0,0,0,0,0,0
137351,38000,380,0,-2,13,11,2,0,0,0,0,0,0,3,3,0,6,5,1,0,0,0,2,1,1,2,2,0,0,0,0,0,0,0
137476,38000,380,0,-2,1,1,0,0,0,0,0,0,0,0,0,0,1,1,0,0,0,0,0,0,0,0,0,0,0,0,0,0,0,0
137546,38000,380,0,-2,11,10,1,0,0,0,0,0,0,1,1,0,2,2,0,0,0,0,7,6,1,1,1,0,0,0,0,0,0,0
137564,38000,380,0,-2,1,1,0,0,0,0,0,0,0,0,0,0,0,0,0,0,0,0,1,1,0,0,0,0,0,0,0,0,0,0
137759,38000,380,0,-2,2,2,0,0,0,0,0,0,0,1,1,0,1,1,0,0,0,0,0,0,0,0,0,0,0,0,0,0,0,0
138187,38000,380,0,-2,3,2,1,0,0,0,0,0,0,0,0,0,2,1,1,0,0,0,0,0,0,0,0,0,0,0,0,1,1,0
138275,38000,380,0,-2,4,4,0,0,0,0,0,0,0,2,2,0,0,0,0,0,0,0,2,2,0,0,0,0,0,0,0,0,0,0
138354,38000,380,0,-2,1,1,0,0,0,0,0,0,0,0,0,0,0,0,0,0,0,0,1,1,0,0,0,0,0,0,0,0,0,0
138716,38000,380,0,-2,1,1,0,0,0,0,0,0,0,0,0,0,0,0,0,0,0,0,1,1,0,0,0,0,0,0,0,0,0,0
139144,38000,380,0,-2,1,1,0,0,0,0,0,0,0,0,0,0,0,0,0,0,0,0,1,1,0,0,0,0,0,0,0,0,0,0
139205,38000,380,0,-2,2,2,0,0,0,0,0,0,0,0,0,0,0,0,0,0,0,0,2,2,0,0,0,0,0,0,0,0,0,0
139366,38000,380,0,-2,3,3,0,0,0,0,0,0,0,1,1,0,0,0,0,0,0,0,2,2,0,0,0,0,0,0,0,0,0,0
139463,38000,380,0,-2,3,2,1,0,0,0,0,0,0,0,0,0,0,0,0,0,0,0,3,2,1,0,0,0,0,0,0,0,0,0
139658,38000,380,0,-2,5,5,0,0,0,0,1,1,0,2,2,0,0,0,0,0,0,0,1,1,0,1,1,0,0,0,0,0,0,0
139700,38000,380,0,-2,1,1,0,0,0,0,0,0,0,0,0,0,0,0,0,0,0,0,1,1,0,0,0,0,0,0,0,0,0,0
139719,38000,380,0,-2,2,2,0,0,0,0,0,0,0,1,1,0,0,0,0,0,0,0,1,1,0,0,0,0,0,0,0,0,0,0
139755,38000,380,0,-2,15,12,3,0,0,0,1,1,0,6,5,1,2,2,0,0,0,0,5,4,1,0,0,0,1,0,1,0,0,0
139764,38000,380,0,-2,1,1,0,0,0,0,0,0,0,0,0,0,0,0,0,0,0,0,0,0,0,0,0,0,1,1,0,0,0,0
139861,38000,380,0,-2,2,2,0,0,0,0,0,0,0,0,0,0,0,0,0,0,0,0,2,2,0,0,0,0,0,0,0,0,0,0
139931,38000,380,0,-2,4,3,1,0,0,0,0,0,0,1,1,0,0,0,0,0,0,0,2,2,0,1,0,1,0,0,0,0,0,0
139940,38000,380,0,-2,12,9,3,0,0,0,2,1,1,3,2,1,0,0,0,0,0,0,6,5,1,0,0,0,1,1,0,0,0,0
139959,38000,380,0,-2,29,25,4,0,0,0,1,1,0,2,2,0,2,2,0,0,0,0,21,18,3,1,0,1,0,0,0,2,2,0
139968,38000,380,0,-2,1,1,0,0,0,0,0,0,0,1,1,0,0,0,0,0,0,0,0,0,0,0,0,0,0,0,0,0,0,0
140252,38000,380,0,-2,3,3,0,0,0,0,0,0,0,2,2,0,0,0,0,0,0,0,1,1,0,0,0,0,0,0,0,0,0,0
140818,38000,380,0,-2,3,3,0,0,0,0,0,0,0,0,0,0,0,0,0,0,0,0,3,3,0,0,0,0,0,0,0,0,0,0
140942,38000,380,0,-2,1,1,0,0,0,0,0,0,0,0,0,0,0,0,0,0,0,0,1,1,0,0,0,0,0,0,0,0,0,0
140951,38000,380,0,-2,5,4,1,0,0,0,0,0,0,2,2,0,1,1,0,0,0,0,2,1,1,0,0,0,0,0,0,0,0,0
141264,38000,380,0,-2,4,3,1,0,0,0,0,0,0,0,0,0,0,0,0,0,0,0,4,3,1,0,0,0,0,0,0,0,0,0
141325,38000,380,0,-2,1,1,0,0,0,0,0,0,0,0,0,0,0,0,0,0,0,0,1,1,0,0,0,0,0,0,0,0,0,0
141334,38000,380,0,-2,3,3,0,0,0,0,0,0,0,0,0,0,1,1,0,0,0,0,2,2,0,0,0,0,0,0,0,0,0,0
141574,38000,380,0,-2,1,1,0,0,0,0,0,0,0,0,0,0,0,0,0,0,0,0,0,0,0,1,1,0,0,0,0,0,0,0
141644,38000,380,0,-2,1,1,0,0,0,0,1,1,0,0,0,0,0,0,0,0,0,0,0,0,0,0,0,0,0,0,0,0,0,0
141981,38000,380,0,-2,1,1,0,0,0,0,0,0,0,0,0,0,0,0,0,0,0,0,0,0,0,1,1,0,0,0,0,0,0,0
142115,38000,380,0,-2,5,5,0,0,0,0,0,0,0,1,1,0,0,0,0,0,0,0,4,4,0,0,0,0,0,0,0,0,0,0
142179,38000,380,0,-2,1,1,0,0,0,0,0,0,0,0,0,0,0,0,0,0,0,0,1,1,0,0,0,0,0,0,0,0,0,0
142276,38000,380,0,-2,5,3,2,0,0,0,0,0,0,0,0,0,0,0,0,0,0,0,2,1,1,0,0,0,3,2,1,0,0,0
142285,38000,380,0,-2,4,4,0,0,0,0,0,0,0,0,0,0,1,1,0,0,0,0,3,3,0,0,0,0,0,0,0,0,0,0
142328,38000,380,0,-2,3,3,0,0,0,0,0,0,0,0,0,0,0,0,0,0,0,0,3,3,0,0,0,0,0,0,0,0,0,0
142443,38000,380,0,-2,2,2,0,0,0,0,0,0,0,0,0,0,0,0,0,0,0,0,2,2,0,0,0,0,0,0,0,0,0,0
142522,38000,380,0,-2,7,7,0,0,0,0,0,0,0,0,0,0,0,0,0,0,0,0,6,6,0,0,0,0,1,1,0,0,0,0
143288,38000,380,0,-2,1,1,0,0,0,0,0,0,0,0,0,0,0,0,0,0,0,0,1,1,0,0,0,0,0,0,0,0,0,0
143358,38000,380,0,-2,4,4,0,0,0,0,0,0,0,0,0,0,0,0,0,0,0,0,4,4,0,0,0,0,0,0,0,0,0,0
144005,38000,380,0,-2,1,1,0,0,0,0,0,0,0,0,0,0,0,0,0,0,0,0,1,1,0,0,0,0,0,0,0,0,0,0
144050,38000,380,0,-2,16,7,9,0,0,0,2,1,1,3,1,2,0,0,0,0,0,0,6,3,3,0,0,0,2,0,2,3,2,1
144892,38000,380,0,-2,1,1,0,0,0,0,0,0,0,0,0,0,0,0,0,0,0,0,1,1,0,0,0,0,0,0,0,0,0,0
144962,38000,380,0,-2,1,1,0,0,0,0,0,0,0,0,0,0,0,0,0,0,0,0,1,1,0,0,0,0,0,0,0,0,0,0
145336,38000,380,0,-2,1,1,0,0,0,0,0,0,0,0,0,0,0,0,0,0,0,0,1,1,0,0,0,0,0,0,0,0,0,0
145372,38000,380,0,-2,1,1,0,0,0,0,0,0,0,0,0,0,0,0,0,0,0,0,1,1,0,0,0,0,0,0,0,0,0,0
145600,38000,380,0,-2,4,3,1,0,0,0,0,0,0,1,0,1,3,3,0,0,0,0,0,0,0,0,0,0,0,0,0,0,0,0
145637,38000,380,0,-2,23,18,5,0,0,0,0,0,0,1,1,0,1,1,0,0,0,0,21,16,5,0,0,0,0,0,0,0,0,0
145646,38000,380,0,-2,1,1,0,0,0,0,0,0,0,0,0,0,0,0,0,0,0,0,0,0,0,1,1,0,0,0,0,0,0,0
145813,38000,380,0,-2,3,3,0,0,0,0,0,0,0,0,0,0,0,0,0,0,0,0,3,3,0,0,0,0,0,0,0,0,0,0
146427,38000,380,0,-2,1,1,0,0,0,0,0,0,0,0,0,0,0,0,0,0,0,0,1,1,0,0,0,0,0,0,0,0,0,0
146481,38000,380,0,-2,4,4,0,0,0,0,1,1,0,1,1,0,1,1,0,0,0,0,1,1,0,0,0,0,0,0,0,0,0,0
146612,38000,380,0,-2,1,1,0,0,0,0,0,0,0,0,0,0,0,0,0,0,0,0,1,1,0,0,0,0,0,0,0,0,0,0
146676,38000,380,0,-2,2,2,0,0,0,0,0,0,0,0,0,0,0,0,0,0,0,0,2,2,0,0,0,0,0,0,0,0,0,0
146685,38000,380,0,-2,1,1,0,0,0,0,0,0,0,0,0,0,0,0,0,0,0,0,1,1,0,0,0,0,0,0,0,0,0,0
146719,38000,380,0,-2,2,2,0,0,0,0,0,0,0,0,0,0,0,0,0,0,0,0,2,2,0,0,0,0,0,0,0,0,0,0
147341,38000,380,0,-2,1,1,0,0,0,0,0,0,0,0,0,0,0,0,0,0,0,0,1,1,0,0,0,0,0,0,0,0,0,0
147369,38000,380,0,-2,3,3,0,0,0,0,1,1,0,0,0,0,0,0,0,0,0,0,2,2,0,0,0,0,0,0,0,0,0,0
147660,38000,380,0,-2,4,3,1,0,0,0,0,0,0,0,0,0,1,0,1,0,0,0,2,2,0,1,1,0,0,0,0,0,0,0
147767,38000,380,0,-2,17,15,2,0,0,0,0,0,0,0,0,0,7,6,1,0,0,0,8,7,1,0,0,0,2,2,0,0,0,0
147776,38000,380,0,-2,1,1,0,0,0,0,0,0,0,0,0,0,1,1,0,0,0,0,0,0,0,0,0,0,0,0,0,0,0,0
148487,38000,380,0,-2,4,4,0,0,0,0,0,0,0,0,0,0,0,0,0,0,0,0,2,2,0,0,0,0,2,2,0,0,0,0
148496,38000,380,0,-2,2,2,0,0,0,0,0,0,0,0,0,0,2,2,0,0,0,0,0,0,0,0,0,0,0,0,0,0,0,0
148654,38000,380,0,-2,3,3,0,0,0,0,0,0,0,1,1,0,0,0,0,0,0,0,2,2,0,0,0,0,0,0,0,0,0,0
148885,38000,380,0,-2,1,1,0,0,0,0,0,0,0,0,0,0,0,0,0,0,0,0,1,1,0,0,0,0,0,0,0,0,0,0
149222,38000,380,0,-2,5,3,2,0,0,0,0,0,0,0,0,0,0,0,0,0,0,0,5,3,2,0,0,0,0,0,0,0,0,0
149231,38000,380,0,-2,1,1,0,0,0,0,0,0,0,0,0,0,0,0,0,0,0,0,1,1,0,0,0,0,0,0,0,0,0,0
149772,38000,380,0,-2,2,2,0,0,0,0,0,0,0,0,0,0,0,0,0,0,0,0,2,2,0,0,0,0,0,0,0,0,0,0
150145,38000,380,0,-2,1,1,0,0,0,0,0,0,0,0,0,0,0,0,0,0,0,0,1,1,0,0,0,0,0,0,0,0,0,0
150163,38000,380,0,-2,1,1,0,0,0,0,0,0,0,0,0,0,0,0,0,0,0,0,1,1,0,0,0,0,0,0,0,0,0,0
150400,38000,380,0,-2,1,1,0,0,0,0,0,0,0,1,1,0,0,0,0,0,0,0,0,0,0,0,0,0,0,0,0,0,0,0
150604,38000,380,0,-2,1,1,0,0,0,0,0,0,0,0,0,0,0,0,0,0,0,0,1,1,0,0,0,0,0,0,0,0,0,0
150668,38000,380,0,-2,1,1,0,0,0,0,0,0,0,0,0,0,0,0,0,0,0,0,1,1,0,0,0,0,0,0,0,0,0,0
151102,38000,380,0,-2,2,2,0,0,0,0,0,0,0,0,0,0,0,0,0,0,0,0,2,2,0,0,0,0,0,0,0,0,0,0
151111,38000,380,0,-2,1,1,0,0,0,0,0,0,0,0,0,0,0,0,0,0,0,0,1,1,0,0,0,0,0,0,0,0,0,0
151263,38000,380,0,-2,1,1,0,0,0,0,0,0,0,0,0,0,0,0,0,0,0,0,1,1,0,0,0,0,0,0,0,0,0,0
151306,38000,380,0,-2,7,7,0,0,0,0,0,0,0,0,0,0,0,0,0,0,0,0,7,7,0,0,0,0,0,0,0,0,0,0
151324,38000,380,0,-2,2,2,0,0,0,0,0,0,0,0,0,0,0,0,0,0,0,0,2,2,0,0,0,0,0,0,0,0,0,0
151351,38000,380,0,-2,14,13,1,0,0,0,0,0,0,0,0,0,0,0,0,0,0,0,14,13,1,0,0,0,0,0,0,0,0,0
151777,38000,380,0,-2,1,1,0,0,0,0,0,0,0,0,0,0,0,0,0,0,0,0,1,1,0,0,0,0,0,0,0,0,0,0
152099,38000,380,0,-2,3,2,1,0,0,0,0,0,0,0,0,0,0,0,0,0,0,0,3,2,1,0,0,0,0,0,0,0,0,0
152381,38000,380,0,-2,1,1,0,0,0,0,0,0,0,0,0,0,0,0,0,0,0,0,1,1,0,0,0,0,0,0,0,0,0,0
152390,38000,380,0,-2,2,2,0,0,0,0,0,0,0,0,0,0,0,0,0,0,0,0,2,2,0,0,0,0,0,0,0,0,0,0
152567,38000,380,0,-2,10,6,4,0,0,0,0,0,0,0,0,0,0,0,0,0,0,0,9,5,4,0,0,0,1,1,0,0,0,0
152637,38000,380,0,-2,10,9,1,0,0,0,0,0,0,1,1,0,0,0,0,0,0,0,9,8,1,0,0,0,0,0,0,0,0,0
153214,38000,380,0,-2,3,3,0,0,0,0,0,0,0,0,0,0,0,0,0,0,0,0,3,3,0,0,0,0,0,0,0,0,0,0
153250,38000,380,0,-2,1,1,0,0,0,0,0,0,0,0,0,0,0,0,0,0,0,0,1,1,0,0,0,0,0,0,0,0,0,0
153269,38000,380,0,-2,2,2,0,0,0,0,0,0,0,0,0,0,0,0,0,0,0,0,1,1,0,0,0,0,1,1,0,0,0,0
153366,38000,380,0,-2,4,4,0,0,0,0,0,0,0,0,0,0,0,0,0,0,0,0,4,4,0,0,0,0,0,0,0,0,0,0
153375,38000,380,0,-2,1,1,0,0,0,0,0,0,0,0,0,0,0,0,0,0,0,0,1,1,0,0,0,0,0,0,0,0,0,0
153384,38000,380,0,-2,1,1,0,0,0,0,0,0,0,0,0,0,0,0,0,0,0,0,1,1,0,0,0,0,0,0,0,0,0,0
153524,38000,380,0,-2,1,1,0,0,0,0,0,0,0,0,0,0,0,0,0,0,0,0,1,1,0,0,0,0,0,0,0,0,0,0
153603,38000,380,0,-2,37,31,6,1,1,0,0,0,0,1,1,0,0,0,0,0,0,0,34,28,6,1,1,0,0,0,0,0,0,0
153658,38000,380,0,-2,10,9,1,0,0,0,0,0,0,0,0,0,1,1,0,0,0,0,8,7,1,0,0,0,1,1,0,0,0,0
153737,38000,380,0,-2,5,4,1,0,0,0,0,0,0,0,0,0,0,0,0,0,0,0,4,3,1,0,0,0,1,1,0,0,0,0
153834,38000,380,0,-2,2,1,1,0,0,0,0,0,0,0,0,0,0,0,0,0,0,0,2,1,1,0,0,0,0,0,0,0,0,0
153861,38000,380,0,-2,1,0,1,0,0,0,0,0,0,0,0,0,0,0,0,0,0,0,1,0,1,0,0,0,0,0,0,0,0,0
154004,38000,380,0,-2,1,1,0,0,0,0,0,0,0,0,0,0,0,0,0,0,0,0,1,1,0,0,0,0,0,0,0,0,0,0
154013,38000,380,0,-2,2,2,0,0,0,0,0,0,0,0,0,0,0,0,0,0,0,0,2,2,0,0,0,0,0,0,0,0,0,0
154095,38000,380,0,-2,4,4,0,0,0,0,0,0,0,0,0,0,0,0,0,0,0,0,4,4,0,0,0,0,0,0,0,0,0,0
154129,38000,380,0,-2,2,2,0,0,0,0,0,0,0,0,0,0,0,0,0,0,0,0,2,2,0,0,0,0,0,0,0,0,0,0
154174,38000,380,0,-2,1,1,0,0,0,0,0,0,0,0,0,0,0,0,0,0,0,0,1,1,0,0,0,0,0,0,0,0,0,0
154235,38000,380,0,-2,1,1,0,0,0,0,0,0,0,0,0,0,0,0,0,0,0,0,1,1,0,0,0,0,0,0,0,0,0,0
154396,38000,380,0,-2,1,1,0,0,0,0,0,0,0,0,0,0,0,0,0,0,0,0,1,1,0,0,0,0,0,0,0,0,0,0
154518,38000,380,0,-2,2,2,0,0,0,0,0,0,0,0,0,0,0,0,0,0,0,0,2,2,0,0,0,0,0,0,0,0,0,0
154697,38000,380,0,-2,1,1,0,0,0,0,0,0,0,0,0,0,0,0,0,0,0,0,1,1,0,0,0,0,0,0,0,0,0,0
154721,38000,380,0,-2,1,1,0,0,0,0,0,0,0,0,0,0,0,0,0,0,0,0,1,1,0,0,0,0,0,0,0,0,0,0
154800,38000,380,0,-2,1,1,0,0,0,0,0,0,0,0,0,0,0,0,0,0,0,0,1,1,0,0,0,0,0,0,0,0,0,0
154998,38000,380,0,-2,1,1,0,0,0,0,0,0,0,0,0,0,0,0,0,0,0,0,1,1,0,0,0,0,0,0,0,0,0,0
155025,38000,380,0,-2,1,1,0,0,0,0,0,0,0,0,0,0,0,0,0,0,0,0,0,0,0,0,0,0,1,1,0,0,0,0
155186,38000,380,0,-2,4,3,1,0,0,0,0,0,0,0,0,0,0,0,0,0,0,0,4,3,1,0,0,0,0,0,0,0,0,0
155195,38000,380,0,-2,1,1,0,0,0,0,0,0,0,0,0,0,0,0,0,0,0,0,1,1,0,0,0,0,0,0,0,0,0,0
155201,38000,380,0,-2,1,1,0,0,0,0,0,0,0,0,0,0,0,0,0,0,0,0,1,1,0,0,0,0,0,0,0,0,0,0
155210,38000,380,0,-2,4,4,0,0,0,0,0,0,0,0,0,0,0,0,0,0,0,0,4,4,0,0,0,0,0,0,0,0,0,0
155308,38000,380,0,-2,1,1,0,0,0,0,0,0,0,0,0,0,0,0,0,0,0,0,1,1,0,0,0,0,0,0,0,0,0,0
155317,38000,380,0,-2,22,22,0,1,1,0,0,0,0,1,1,0,0,0,0,0,0,0,19,19,0,1,1,0,0,0,0,0,0,0
155335,38000,380,0,-2,1,1,0,0,0,0,0,0,0,0,0,0,0,0,0,0,0,0,1,1,0,0,0,0,0,0,0,0,0,0
155399,38000,380,0,-2,9,9,0,0,0,0,0,0,0,0,0,0,1,1,0,0,0,0,8,8,0,0,0,0,0,0,0,0,0,0
155511,38000,380,0,-2,1,1,0,0,0,0,0,0,0,0,0,0,0,0,0,0,0,0,1,1,0,0,0,0,0,0,0,0,0,0
155566,38000,380,0,-2,2,2,0,0,0,0,0,0,0,0,0,0,0,0,0,0,0,0,2,2,0,0,0,0,0,0,0,0,0,0
155593,38000,380,0,-2,1,1,0,0,0,0,0,0,0,0,0,0,0,0,0,0,0,0,1,1,0,0,0,0,0,0,0,0,0,0
155715,38000,380,0,-2,1,1,0,0,0,0,0,0,0,0,0,0,0,0,0,0,0,0,1,1,0,0,0,0,0,0,0,0,0,0
155937,38000,380,0,-2,1,1,0,0,0,0,0,0,0,0,0,0,0,0,0,0,0,0,1,1,0,0,0,0,0,0,0,0,0,0
156082,38000,380,0,-2,1,1,0,0,0,0,0,0,0,0,0,0,0,0,0,0,0,0,1,1,0,0,0,0,0,0,0,0,0,0
156125,38000,380,0,-2,8,7,1,0,0,0,0,0,0,0,0,0,0,0,0,0,0,0,6,5,1,0,0,0,1,1,0,1,1,0
156189,38000,380,0,-2,1,1,0,0,0,0,0,0,0,0,0,0,0,0,0,0,0,0,1,1,0,0,0,0,0,0,0,0,0,0
156286,38000,380,0,-2,3,3,0,0,0,0,0,0,0,0,0,0,0,0,0,0,0,0,3,3,0,0,0,0,0,0,0,0,0,0
156295,38000,380,0,-2,5,5,0,0,0,0,0,0,0,0,0,0,1,1,0,0,0,0,4,4,0,0,0,0,0,0,0,0,0,0
156365,38000,380,0,-2,3,3,0,0,0,0,0,0,0,0,0,0,0,0,0,0,0,0,3,3,0,0,0,0,0,0,0,0,0,0
156408,38000,380,0,-2,2,2,0,0,0,0,0,0,0,0,0,0,0,0,0,0,0,0,2,2,0,0,0,0,0,0,0,0,0,0
156541,38000,380,0,-2,1,1,0,0,0,0,0,0,0,0,0,0,0,0,0,0,0,0,1,1,0,0,0,0,0,0,0,0,0,0
156620,38000,380,0,-2,17,16,1,0,0,0,0,0,0,0,0,0,0,0,0,0,0,0,16,15,1,1,1,0,0,0,0,0,0,0
156727,38000,380,0,-2,1,1,0,0,0,0,0,0,0,0,0,0,0,0,0,0,0,0,1,1,0,0,0,0,0,0,0,0,0,0
157021,38000,380,0,-2,2,2,0,0,0,0,0,0,0,0,0,0,0,0,0,0,0,0,2,2,0,0,0,0,0,0,0,0,0,0
157058,38000,380,0,-2,7,6,1,0,0,0,0,0,0,1,1,0,0,0,0,0,0,0,4,3,1,0,0,0,2,2,0,0,0,0
157085,38000,380,0,-2,34,33,1,0,0,0,0,0,0,3,3,0,0,0,0,0,0,0,29,28,1,2,2,0,0,0,0,0,0,0
157100,38000,380,0,-2,4,1,3,0,0,0,0,0,0,0,0,0,0,0,0,0,0,0,4,1,3,0,0,0,0,0,0,0,0,0
157216,38000,380,0,-2,4,4,0,0,0,0,0,0,0,0,0,0,0,0,0,0,0,0,4,4,0,0,0,0,0,0,0,0,0,0
157289,38000,380,0,-2,10,10,0,0,0,0,0,0,0,2,2,0,1,1,0,0,0,0,6,6,0,1,1,0,0,0,0,0,0,0
157447,38000,380,0,-2,3,3,0,0,0,0,0,0,0,0,0,0,0,0,0,0,0,0,3,3,0,0,0,0,0,0,0,0,0,0
157757,38000,380,0,-2,1,1,0,0,0,0,0,0,0,1,1,0,0,0,0,0,0,0,0,0,0,0,0,0,0,0,0,0,0,0
157818,38000,380,0,-2,3,3,0,0,0,0,0,0,0,0,0,0,0,0,0,0,0,0,3,3,0,0,0,0,0,0,0,0,0,0
157951,38000,380,0,-2,4,4,0,0,0,0,0,0,0,0,0,0,0,0,0,0,0,0,4,4,0,0,0,0,0,0,0,0,0,0
158662,38000,380,0,-2,1,1,0,0,0,0,0,0,0,1,1,0,0,0,0,0,0,0,0,0,0,0,0,0,0,0,0,0,0,0
159009,38000,380,0,-2,2,2,0,0,0,0,0,0,0,1,1,0,0,0,0,0,0,0,0,0,0,0,0,0,1,1,0,0,0,0
159373,38000,380,0,-2,2,2,0,0,0,0,0,0,0,1,1,0,0,0,0,0,0,0,1,1,0,0,0,0,0,0,0,0,0,0
159391,38000,380,0,-2,24,23,1,0,0,0,0,0,0,4,4,0,0,0,0,1,1,0,17,16,1,0,0,0,2,2,0,0,0,0
159407,38000,380,0,-2,1,1,0,0,0,0,0,0,0,1,1,0,0,0,0,0,0,0,0,0,0,0,0,0,0,0,0,0,0,0
159416,38000,380,0,-2,3,3,0,0,0,0,0,0,0,0,0,0,0,0,0,0,0,0,3,3,0,0,0,0,0,0,0,0,0,0
159647,38000,380,0,-2,4,4,0,0,0,0,0,0,0,0,0,0,0,0,0,0,0,0,4,4,0,0,0,0,0,0,0,0,0,0
159656,38000,380,0,-2,1,1,0,0,0,0,0,0,0,0,0,0,0,0,0,0,0,0,0,0,0,0,0,0,1,1,0,0,0,0
159717,38000,380,0,-2,2,2,0,0,0,0,0,0,0,0,0,0,0,0,0,0,0,0,2,2,0,0,0,0,0,0,0,0,0,0
159948,38000,380,0,-2,3,3,0,0,0,0,0,0,0,0,0,0,0,0,0,0,0,0,3,3,0,0,0,0,0,0,0,0,0,0
159993,38000,380,0,-2,4,4,0,0,0,0,0,0,0,1,1,0,0,0,0,0,0,0,2,2,0,0,0,0,1,1,0,0,0,0
160038,38000,380,0,-2,4,4,0,0,0,0,0,0,0,0,0,0,0,0,0,0,0,0,0,0,0,0,0,0,4,4,0,0,0,0
160481,38000,380,0,-2,1,1,0,0,0,0,0,0,0,1,1,0,0,0,0,0,0,0,0,0,0,0,0,0,0,0,0,0,0,0
160612,38000,380,0,-2,4,4,0,0,0,0,0,0,0,0,0,0,0,0,0,0,0,0,4,4,0,0,0,0,0,0,0,0,0,0
160621,38000,380,0,-2,10,10,0,0,0,0,0,0,0,10,10,0,0,0,0,0,0,0,0,0,0,0,0,0,0,0,0,0,0,0
160658,38000,380,0,-2,1,1,0,0,0,0,0,0,0,0,0,0,0,0,0,0,0,0,1,1,0,0,0,0,0,0,0,0,0,0
160755,38000,380,0,-2,17,17,0,0,0,0,2,2,0,6,6,0,2,2,0,0,0,0,7,7,0,0,0,0,0,0,0,0,0,0
160959,38000,380,0,-2,1,0,1,0,0,0,0,0,0,0,0,0,0,0,0,0,0,0,1,0,1,0,0,0,0,0,0,0,0,0
160977,38000,380,0,-2,2,2,0,0,0,0,0,0,0,1,1,0,0,0,0,0,0,0,1,1,0,0,0,0,0,0,0,0,0,0
160995,38000,380,0,-2,2,2,0,0,0,0,0,0,0,0,0,0,0,0,0,0,0,0,2,2,0,0,0,0,0,0,0,0,0,0
161004,38000,380,0,-2,1,0,1,0,0,0,0,0,0,0,0,0,0,0,0,0,0,0,1,0,1,0,0,0,0,0,0,0,0,0
161077,38000,380,0,-2,2,2,0,0,0,0,0,0,0,0,0,0,0,0,0,1,1,0,1,1,0,0,0,0,0,0,0,0,0,0
161086,38000,380,0,-2,2,2,0,0,0,0,0,0,0,0,0,0,0,0,0,0,0,0,1,1,0,0,0,0,1,1,0,0,0,0
161217,38000,380,0,-2,1,1,0,0,0,0,0,0,0,0,0,0,0,0,0,0,0,0,1,1,0,0,0,0,0,0,0,0,0,0
161226,38000,380,0,-2,1,1,0,0,0,0,0,0,0,0,0,0,0,0,0,0,0,0,1,1,0,0,0,0,0,0,0,0,0,0
161235,38000,380,0,-2,1,1,0,0,0,0,0,0,0,0,0,0,0,0,0,0,0,0,1,1,0,0,0,0,0,0,0,0,0,0
161253,38000,380,0,-2,11,10,1,0,0,0,0,0,0,0,0,0,0,0,0,0,0,0,10,9,1,0,0,0,1,1,0,0,0,0
161341,38000,380,0,-2,2,2,0,0,0,0,0,0,0,0,0,0,0,0,0,0,0,0,2,2,0,0,0,0,0,0,0,0,0,0
161457,38000,380,0,-2,3,3,0,0,0,0,0,0,0,0,0,0,0,0,0,0,0,0,3,3,0,0,0,0,0,0,0,0,0,0
161518,38000,380,0,-2,2,2,0,0,0,0,0,0,0,0,0,0,0,0,0,0,0,0,1,1,0,1,1,0,0,0,0,0,0,0
161554,38000,380,0,-2,3,3,0,0,0,0,0,0,0,0,0,0,0,0,0,0,0,0,3,3,0,0,0,0,0,0,0,0,0,0
161688,38000,380,0,-2,1,1,0,0,0,0,0,0,0,0,0,0,0,0,0,0,0,0,1,1,0,0,0,0,0,0,0,0,0,0
161864,38000,380,0,-2,3,3,0,0,0,0,0,0,0,2,2,0,0,0,0,0,0,0,1,1,0,0,0,0,0,0,0,0,0,0
162122,38000,380,0,-2,3,3,0,0,0,0,0,0,0,0,0,0,0,0,0,0,0,0,3,3,0,0,0,0,0,0,0,0,0,0
162609,38000,380,0,-2,2,1,1,0,0,0,0,0,0,0,0,0,0,0,0,0,0,0,2,1,1,0,0,0,0,0,0,0,0,0
162654,38000,380,0,-2,2,2,0,0,0,0,0,0,0,0,0,0,0,0,0,0,0,0,2,2,0,0,0,0,0,0,0,0,0,0
162928,38000,380,0,-2,5,4,1,0,0,0,0,0,0,1,1,0,0,0,0,0,0,0,4,3,1,0,0,0,0,0,0,0,0,0
163046,38000,380,0,-2,3,3,0,0,0,0,0,0,0,0,0,0,0,0,0,0,0,0,3,3,0,0,0,0,0,0,0,0,0,0
163259,38000,380,0,-2,9,9,0,1,1,0,0,0,0,2,2,0,0,0,0,0,0,0,6,6,0,0,0,0,0,0,0,0,0,0
163268,38000,380,0,-2,1,1,0,0,0,0,0,0,0,0,0,0,0,0,0,0,0,0,1,1,0,0,0,0,0,0,0,0,0,0
163286,38000,380,0,-2,19,17,2,0,0,0,0,0,0,8,8,0,2,2,0,0,0,0,5,5,0,0,0,0,3,2,1,1,0,1
163295,38000,380,0,-2,1,0,1,0,0,0,0,0,0,0,0,0,0,0,0,0,0,0,1,0,1,0,0,0,0,0,0,0,0,0
163453,38000,380,0,-2,25,7,18,0,0,0,0,0,0,20,6,14,0,0,0,0,0,0,0,0,0,0,0,0,2,1,1,3,0,3
163462,38000,380,0,-2,4,4,0,0,0,0,0,0,0,0,0,0,0,0,0,0,0,0,4,4,0,0,0,0,0,0,0,0,0,0
163578,38000,380,0,-2,2,2,0,0,0,0,0,0,0,0,0,0,1,1,0,0,0,0,1,1,0,0,0,0,0,0,0,0,0,0
164076,38000,380,0,-2,1,1,0,0,0,0,0,0,0,0,0,0,0,0,0,0,0,0,1,1,0,0,0,0,0,0,0,0,0,0
164155,38000,380,0,-2,3,3,0,0,0,0,0,0,0,1,1,0,0,0,0,0,0,0,2,2,0,0,0,0,0,0,0,0,0,0
164173,38000,380,0,-2,1,1,0,0,0,0,0,0,0,0,0,0,0,0,0,1,1,0,0,0,0,0,0,0,0,0,0,0,0,0
164216,38000,380,0,-2,5,5,0,0,0,0,0,0,0,0,0,0,0,0,0,0,0,0,5,5,0,0,0,0,0,0,0,0,0,0
164270,38000,380,0,-2,3,3,0,0,0,0,0,0,0,0,0,0,0,0,0,0,0,0,3,3,0,0,0,0,0,0,0,0,0,0
164465,38000,380,0,-2,1,1,0,0,0,0,0,0,0,0,0,0,0,0,0,0,0,0,1,1,0,0,0,0,0,0,0,0,0,0
164580,38000,380,0,-2,1,1,0,0,0,0,0,0,0,0,0,0,0,0,0,0,0,0,1,1,0,0,0,0,0,0,0,0,0,0
164748,38000,380,0,-2,1,1,0,0,0,0,0,0,0,1,1,0,0,0,0,0,0,0,0,0,0,0,0,0,0,0,0,0,0,0
164924,38000,380,0,-2,5,5,0,0,0,0,0,0,0,0,0,0,0,0,0,0,0,0,5,5,0,0,0,0,0,0,0,0,0,0
164988,38000,380,0,-2,6,6,0,0,0,0,0,0,0,0,0,0,0,0,0,0,0,0,5,5,0,0,0,0,1,1,0,0,0,0
165015,38000,380,0,-2,3,3,0,0,0,0,0,0,0,1,1,0,0,0,0,0,0,0,2,2,0,0,0,0,0,0,0,0,0,0
165024,38000,380,0,-2,2,2,0,0,0,0,0,0,0,0,0,0,0,0,0,0,0,0,1,1,0,0,0,0,1,1,0,0,0,0
165574,38000,380,0,-2,3,3,0,0,0,0,0,0,0,0,0,0,0,0,0,0,0,0,2,2,0,0,0,0,1,1,0,0,0,0
165662,38000,380,0,-2,2,2,0,0,0,0,0,0,0,0,0,0,0,0,0,0,0,0,1,1,0,1,1,0,0,0,0,0,0,0
165936,38000,380,0,-2,1,1,0,0,0,0,0,0,0,0,0,0,0,0,0,0,0,0,0,0,0,0,0,0,1,1,0,0,0,0
165981,38000,380,0,-2,1,0,1,0,0,0,0,0,0,0,0,0,0,0,0,0,0,0,1,0,1,0,0,0,0,0,0,0,0,0
166018,38000,380,0,-2,3,2,1,0,0,0,0,0,0,0,0,0,0,0,0,0,0,0,3,2,1,0,0,0,0,0,0,0,0,0
166027,38000,380,0,-2,10,9,1,0,0,0,0,0,0,0,0,0,1,0,1,0,0,0,9,9,0,0,0,0,0,0,0,0,0,0
166124,38000,380,0,-2,1,1,0,0,0,0,0,0,0,0,0,0,0,0,0,0,0,0,1,1,0,0,0,0,0,0,0,0,0,0
166391,38000,380,0,-2,1,1,0,0,0,0,0,0,0,0,0,0,0,0,0,0,0,0,0,0,0,0,0,0,1,1,0,0,0,0
166629,38000,380,0,-2,9,8,1,0,0,0,0,0,0,1,1,0,0,0,0,0,0,0,7,6,1,0,0,0,0,0,0,1,1,0
166683,38000,380,0,-2,38,32,6,0,0,0,1,0,1,0,0,0,3,3,0,0,0,0,31,27,4,1,0,1,2,2,0,0,0,0
166708,38000,380,0,-2,10,10,0,0,0,0,1,1,0,1,1,0,0,0,0,0,0,0,8,8,0,0,0,0,0,0,0,0,0,0
166939,38000,380,0,-2,1,1,0,0,0,0,0,0,0,0,0,0,0,0,0,0,0,0,1,1,0,0,0,0,0,0,0,0,0,0
167288,38000,380,0,-2,1,1,0,0,0,0,0,0,0,0,0,0,0,0,0,0,0,0,1,1,0,0,0,0,0,0,0,0,0,0
167358,38000,380,0,-2,1,1,0,0,0,0,0,0,0,0,0,0,0,0,0,0,0,0,1,1,0,0,0,0,0,0,0,0,0,0
167792,38000,380,0,-2,3,3,0,0,0,0,0,0,0,0,0,0,0,0,0,0,0,0,3,3,0,0,0,0,0,0,0,0,0,0
167835,38000,380,0,-2,5,4,1,0,0,0,0,0,0,0,0,0,0,0,0,0,0,0,5,4,1,0,0,0,0,0,0,0,0,0
168148,38000,380,0,-2,8,6,2,0,0,0,0,0,0,1,1,0,0,0,0,0,0,0,6,4,2,0,0,0,1,1,0,0,0,0
168218,38000,380,0,-2,3,3,0,0,0,0,0,0,0,0,0,0,1,1,0,0,0,0,2,2,0,0,0,0,0,0,0,0,0,0
168227,38000,380,0,-2,1,1,0,0,0,0,0,0,0,0,0,0,0,0,0,0,0,0,0,0,0,0,0,0,1,1,0,0,0,0
168254,38000,380,0,-2,1,1,0,0,0,0,0,0,0,0,0,0,0,0,0,0,0,0,1,1,0,0,0,0,0,0,0,0,0,0
168263,38000,380,0,-2,6,4,2,0,0,0,0,0,0,0,0,0,2,2,0,0,0,0,4,2,2,0,0,0,0,0,0,0,0,0
168281,38000,380,0,-2,1,1,0,0,0,0,0,0,0,0,0,0,0,0,0,0,0,0,1,1,0,0,0,0,0,0,0,0,0,0
168421,38000,380,0,-2,2,2,0,0,0,0,0,0,0,0,0,0,1,1,0,0,0,0,1,1,0,0,0,0,0,0,0,0,0,0
168430,38000,380,0,-2,1,1,0,0,0,0,0,0,0,0,0,0,0,0,0,0,0,0,1,1,0,0,0,0,0,0,0,0,0,0
168546,38000,380,0,-2,1,1,0,0,0,0,0,0,0,0,0,0,0,0,0,0,0,0,1,1,0,0,0,0,0,0,0,0,0,0
168740,38000,380,0,-2,1,1,0,0,0,0,0,0,0,0,0,0,0,0,0,0,0,0,1,1,0,0,0,0,0,0,0,0,0,0
169716,38000,380,0,-2,1,1,0,0,0,0,0,0,0,1,1,0,0,0,0,0,0,0,0,0,0,0,0,0,0,0,0,0,0,0
169798,38000,380,0,-2,1,1,0,0,0,0,0,0,0,0,0,0,0,0,0,0,0,0,1,1,0,0,0,0,0,0,0,0,0,0
169910,38000,380,0,-2,2,2,0,0,0,0,0,0,0,0,0,0,0,0,0,0,0,0,2,2,0,0,0,0,0,0,0,0,0,0
170286,38000,380,0,-2,2,2,0,0,0,0,0,0,0,0,0,0,0,0,0,0,0,0,0,0,0,0,0,0,2,2,0,0,0,0
170301,38000,380,0,-2,1,1,0,0,0,0,0,0,0,0,0,0,0,0,0,0,0,0,1,1,0,0,0,0,0,0,0,0,0,0
170444,38000,380,0,-2,1,1,0,0,0,0,0,0,0,0,0,0,0,0,0,0,0,0,1,1,0,0,0,0,0,0,0,0,0,0
170532,38000,380,0,-2,6,6,0,0,0,0,0,0,0,0,0,0,0,0,0,0,0,0,2,2,0,0,0,0,4,4,0,0,0,0
170541,38000,380,0,-2,1,1,0,0,0,0,0,0,0,0,0,0,0,0,0,0,0,0,1,1,0,0,0,0,0,0,0,0,0,0
170550,38000,380,0,-2,2,2,0,0,0,0,0,0,0,0,0,0,0,0,0,0,0,0,2,2,0,0,0,0,0,0,0,0,0,0
170639,38000,380,0,-2,5,4,1,1,1,0,0,0,0,0,0,0,0,0,0,0,0,0,4,3,1,0,0,0,0,0,0,0,0,0
170967,38000,380,0,-2,2,2,0,0,0,0,0,0,0,0,0,0,0,0,0,0,0,0,2,2,0,0,0,0,0,0,0,0,0,0
170976,38000,380,0,-2,20,18,2,0,0,0,0,0,0,1,1,0,0,0,0,0,0,0,19,17,2,0,0,0,0,0,0,0,0,0
171100,38000,380,0,-2,9,9,0,0,0,0,0,0,0,0,0,0,0,0,0,0,0,0,8,8,0,0,0,0,1,1,0,0,0,0
171128,38000,380,0,-2,3,3,0,0,0,0,0,0,0,0,0,0,0,0,0,0,0,0,3,3,0,0,0,0,0,0,0,0,0,0
171137,38000,380,0,-2,2,2,0,0,0,0,0,0,0,0,0,0,0,0,0,0,0,0,2,2,0,0,0,0,0,0,0,0,0,0
171395,38000,380,0,-2,1,1,0,0,0,0,0,0,0,0,0,0,0,0,0,0,0,0,1,1,0,0,0,0,0,0,0,0,0,0
171492,38000,380,0,-2,1,1,0,0,0,0,0,0,0,0,0,0,0,0,0,0,0,0,1,1,0,0,0,0,0,0,0,0,0,0
171571,38000,380,0,-2,1,1,0,0,0,0,1,1,0,0,0,0,0,0,0,0,0,0,0,0,0,0,0,0,0,0,0,0,0,0
172264,38000,380,0,-2,1,1,0,0,0,0,0,0,0,0,0,0,0,0,0,0,0,0,1,1,0,0,0,0,0,0,0,0,0,0
172617,38000,380,0,-2,3,3,0,0,0,0,0,0,0,2,2,0,0,0,0,0,0,0,0,0,0,0,0,0,1,1,0,0,0,0
172644,38000,380,0,-2,4,4,0,0,0,0,0,0,0,0,0,0,0,0,0,0,0,0,4,4,0,0,0,0,0,0,0,0,0,0
172699,38000,380,0,-2,4,4,0,0,0,0,0,0,0,0,0,0,0,0,0,0,0,0,4,4,0,0,0,0,0,0,0,0,0,0
173142,38000,380,0,-2,2,2,0,0,0,0,0,0,0,0,0,0,0,0,0,0,0,0,1,1,0,0,0,0,1,1,0,0,0,0
173160,38000,380,0,-2,1,1,0,0,0,0,0,0,0,0,0,0,0,0,0,0,0,0,1,1,0,0,0,0,0,0,0,0,0,0
173258,38000,380,0,-2,2,2,0,0,0,0,0,0,0,0,0,0,0,0,0,0,0,0,2,2,0,0,0,0,0,0,0,0,0,0
173300,38000,380,0,-2,3,3,0,0,0,0,0,0,0,0,0,0,0,0,0,0,0,0,2,2,0,0,0,0,0,0,0,1,1,0
173920,38000,380,0,-2,2,2,0,0,0,0,0,0,0,0,0,0,0,0,0,0,0,0,2,2,0,0,0,0,0,0,0,0,0,0
174066,38000,380,0,-2,38,36,2,0,0,0,0,0,0,2,2,0,3,3,0,0,0,0,32,30,2,0,0,0,1,1,0,0,0,0
174075,38000,380,0,-2,2,2,0,0,0,0,0,0,0,0,0,0,0,0,0,0,0,0,2,2,0,0,0,0,0,0,0,0,0,0
174127,38000,380,0,-2,4,4,0,0,0,0,0,0,0,0,0,0,2,2,0,0,0,0,1,1,0,0,0,0,1,1,0,0,0,0
174233,38000,380,0,-2,4,4,0,0,0,0,0,0,0,0,0,0,0,0,0,0,0,0,4,4,0,0,0,0,0,0,0,0,0,0
174251,38000,380,0,-2,1,1,0,0,0,0,0,0,0,0,0,0,0,0,0,0,0,0,1,1,0,0,0,0,0,0,0,0,0,0
174376,38000,380,0,-2,1,1,0,0,0,0,0,0,0,0,0,0,0,0,0,0,0,0,1,1,0,0,0,0,0,0,0,0,0,0
174747,38000,380,0,-2,1,1,0,0,0,0,0,0,0,0,0,0,0,0,0,0,0,0,0,0,0,0,0,0,1,1,0,0,0,0
174756,38000,380,0,-2,1,1,0,0,0,0,0,0,0,0,0,0,0,0,0,0,0,0,1,1,0,0,0,0,0,0,0,0,0,0
174783,38000,380,0,-2,3,3,0,0,0,0,0,0,0,0,0,0,0,0,0,0,0,0,3,3,0,0,0,0,0,0,0,0,0,0
174817,38000,380,0,-2,1,1,0,0,0,0,0,0,0,0,0,0,0,0,0,0,0,0,1,1,0,0,0,0,0,0,0,0,0,0
174844,38000,380,0,-2,1,1,0,0,0,0,0,0,0,0,0,0,0,0,0,0,0,0,1,1,0,0,0,0,0,0,0,0,0,0
174914,38000,380,0,-2,5,4,1,0,0,0,0,0,0,0,0,0,0,0,0,0,0,0,5,4,1,0,0,0,0,0,0,0,0,0
175078,38000,380,0,-2,1,1,0,0,0,0,0,0,0,0,0,0,0,0,0,0,0,0,1,1,0,0,0,0,0,0,0,0,0,0
175272,38000,380,0,-2,2,2,0,0,0,0,0,0,0,0,0,0,0,0,0,0,0,0,2,2,0,0,0,0,0,0,0,0,0,0
175281,38000,380,0,-2,2,2,0,0,0,0,0,0,0,0,0,0,0,0,0,0,0,0,2,2,0,0,0,0,0,0,0,0,0,0
175315,38000,380,0,-2,3,3,0,0,0,0,0,0,0,0,0,0,1,1,0,0,0,0,2,2,0,0,0,0,0,0,0,0,0,0
175342,38000,380,0,-2,2,1,1,0,0,0,0,0,0,2,1,1,0,0,0,0,0,0,0,0,0,0,0,0,0,0,0,0,0,0
175430,38000,380,0,-2,1,1,0,0,0,0,0,0,0,0,0,0,0,0,0,0,0,0,1,1,0,0,0,0,0,0,0,0,0,0
175573,38000,380,0,-2,1,1,0,0,0,0,0,0,0,0,0,0,0,0,0,0,0,0,1,1,0,0,0,0,0,0,0,0,0,0
175616,38000,380,0,-2,4,4,0,0,0,0,0,0,0,0,0,0,0,0,0,0,0,0,4,4,0,0,0,0,0,0,0,0,0,0
175786,38000,380,0,-2,4,4,0,0,0,0,0,0,0,2,2,0,0,0,0,0,0,0,2,2,0,0,0,0,0,0,0,0,0,0
175829,38000,380,0,-2,4,4,0,0,0,0,0,0,0,0,0,0,0,0,0,0,0,0,4,4,0,0,0,0,0,0,0,0,0,0
175856,38000,380,0,-2,3,3,0,0,0,0,0,0,0,3,3,0,0,0,0,0,0,0,0,0,0,0,0,0,0,0,0,0,0,0
175883,38000,380,0,-2,1,1,0,0,0,0,0,0,0,0,0,0,0,0,0,0,0,0,1,1,0,0,0,0,0,0,0,0,0,0
176017,38000,380,0,-2,29,28,1,0,0,0,0,0,0,9,8,1,0,0,0,0,0,0,20,20,0,0,0,0,0,0,0,0,0,0
176044,38000,380,0,-2,1,1,0,0,0,0,0,0,0,1,1,0,0,0,0,0,0,0,0,0,0,0,0,0,0,0,0,0,0,0
176053,38000,380,0,-2,1,1,0,0,0,0,0,0,0,0,0,0,0,0,0,0,0,0,0,0,0,0,0,0,1,1,0,0,0,0
176080,38000,380,0,-2,27,25,2,0,0,0,0,0,0,5,5,0,2,2,0,0,0,0,18,17,1,2,1,1,0,0,0,0,0,0
176178,38000,380,0,-2,3,3,0,0,0,0,0,0,0,0,0,0,0,0,0,0,0,0,3,3,0,0,0,0,0,0,0,0,0,0
176239,38000,380,0,-2,1,1,0,0,0,0,0,0,0,0,0,0,0,0,0,0,0,0,1,1,0,0,0,0,0,0,0,0,0,0
176318,38000,380,0,-2,1,1,0,0,0,0,0,0,0,1,1,0,0,0,0,0,0,0,0,0,0,0,0,0,0,0,0,0,0,0
176406,38000,380,0,-2,1,1,0,0,0,0,0,0,0,1,1,0,0,0,0,0,0,0,0,0,0,0,0,0,0,0,0,0,0,0
176965,38000,380,0,-2,3,2,1,0,0,0,0,0,0,0,0,0,0,0,0,0,0,0,3,2,1,0,0,0,0,0,0,0,0,0
177135,38000,380,0,-2,1,1,0,0,0,0,0,0,0,0,0,0,0,0,0,0,0,0,1,1,0,0,0,0,0,0,0,0,0,0
177214,38000,380,0,-2,1,0,1,0,0,0,0,0,0,0,0,0,0,0,0,0,0,0,1,0,1,0,0,0,0,0,0,0,0,0
177339,38000,380,0,-2,4,4,0,0,0,0,0,0,0,0,0,0,1,1,0,0,0,0,2,2,0,1,1,0,0,0,0,0,0,0
177551,38000,380,0,-2,3,3,0,0,0,0,0,0,0,2,2,0,0,0,0,0,0,0,1,1,0,0,0,0,0,0,0,0,0,0
177676,38000,380,0,-2,1,1,0,0,0,0,0,0,0,0,0,0,0,0,0,0,0,0,1,1,0,0,0,0,0,0,0,0,0,0
177940,38000,380,0,-2,7,3,4,0,0,0,0,0,0,0,0,0,0,0,0,0,0,0,5,3,2,2,0,2,0,0,0,0,0,0
177977,38000,380,0,-2,2,2,0,0,0,0,0,0,0,0,0,0,0,0,0,0,0,0,2,2,0,0,0,0,0,0,0,0,0,0
177986,38000,380,0,-2,6,6,0,0,0,0,0,0,0,0,0,0,0,0,0,0,0,0,6,6,0,0,0,0,0,0,0,0,0,0
178208,38000,380,0,-2,3,3,0,0,0,0,0,0,0,0,0,0,0,0,0,0,0,0,3,3,0,0,0,0,0,0,0,0,0,0
178396,38000,380,0,-2,12,12,0,0,0,0,0,0,0,0,0,0,0,0,0,0,0,0,11,11,0,0,0,0,1,1,0,0,0,0
178402,38000,380,0,-2,4,4,0,0,0,0,0,0,0,1,1,0,0,0,0,0,0,0,2,2,0,0,0,0,1,1,0,0,0,0
178411,38000,380,0,-2,3,3,0,0,0,0,0,0,0,0,0,0,0,0,0,0,0,0,3,3,0,0,0,0,0,0,0,0,0,0
178420,38000,380,0,-2,4,4,0,0,0,0,0,0,0,1,1,0,0,0,0,0,0,0,2,2,0,0,0,0,1,1,0,0,0,0
178448,38000,380,0,-2,1,1,0,0,0,0,0,0,0,0,0,0,0,0,0,0,0,0,1,1,0,0,0,0,0,0,0,0,0,0
178615,38000,380,0,-2,7,7,0,0,0,0,0,0,0,0,0,0,1,1,0,0,0,0,6,6,0,0,0,0,0,0,0,0,0,0
178624,38000,380,0,-2,3,1,2,0,0,0,0,0,0,0,0,0,0,0,0,0,0,0,3,1,2,0,0,0,0,0,0,0,0,0
178679,38000,380,0,-2,1,1,0,0,0,0,0,0,0,0,0,0,0,0,0,0,0,0,1,1,0,0,0,0,0,0,0,0,0,0
178721,38000,380,0,-2,3,3,0,0,0,0,0,0,0,0,0,0,0,0,0,0,0,0,1,1,0,2,2,0,0,0,0,0,0,0
179308,38000,380,0,-2,3,3,0,0,0,0,0,0,0,0,0,0,0,0,0,0,0,0,3,3,0,0,0,0,0,0,0,0,0,0
179557,38000,380,0,-2,1,1,0,0,0,0,0,0,0,0,0,0,0,0,0,0,0,0,1,1,0,0,0,0,0,0,0,0,0,0
179566,38000,380,0,-2,1,1,0,0,0,0,0,0,0,0,0,0,0,0,0,0,0,0,1,1,0,0,0,0,0,0,0,0,0,0
179812,38000,380,0,-2,4,4,0,0,0,0,0,0,0,0,0,0,2,2,0,0,0,0,2,2,0,0,0,0,0,0,0,0,0,0
179867,38000,380,0,-2,25,24,1,0,0,0,0,0,0,4,4,0,0,0,0,0,0,0,21,20,1,0,0,0,0,0,0,0,0,0
179964,38000,380,0,-2,2,2,0,0,0,0,0,0,0,0,0,0,0,0,0,0,0,0,2,2,0,0,0,0,0,0,0,0,0,0
180106,38000,380,0,-2,1,0,1,0,0,0,0,0,0,0,0,0,0,0,0,0,0,0,1,0,1,0,0,0,0,0,0,0,0,0
180212,38000,380,0,-2,2,2,0,2,2,0,0,0,0,0,0,0,0,0,0,0,0,0,0,0,0,0,0,0,0,0,0,0,0,0
180416,38000,380,0,-2,1,1,0,0,0,0,0,0,0,0,0,0,0,0,0,0,0,0,1,1,0,0,0,0,0,0,0,0,0,0
180461,38000,380,0,-2,16,16,0,1,1,0,0,0,0,0,0,0,1,1,0,0,0,0,12,12,0,0,0,0,2,2,0,0,0,0
180489,38000,380,0,-2,7,7,0,0,0,0,0,0,0,0,0,0,0,0,0,0,0,0,7,7,0,0,0,0,0,0,0,0,0,0
180595,38000,380,0,-2,1,1,0,0,0,0,0,0,0,0,0,0,0,0,0,0,0,0,1,1,0,0,0,0,0,0,0,0,0,0
180647,38000,380,0,-2,1,1,0,1,1,0,0,0,0,0,0,0,0,0,0,0,0,0,0,0,0,0,0,0,0,0,0,0,0,0
180692,38000,380,0,-2,1,1,0,0,0,0,0,0,0,0,0,0,0,0,0,0,0,0,1,1,0,0,0,0,0,0,0,0,0,0
180902,38000,380,0,-2,1,1,0,0,0,0,0,0,0,0,0,0,0,0,0,0,0,0,1,1,0,0,0,0,0,0,0,0,0,0
180948,38000,380,0,-2,2,2,0,1,1,0,0,0,0,0,0,0,0,0,0,0,0,0,1,1,0,0,0,0,0,0,0,0,0,0
181002,38000,380,0,-2,5,5,0,0,0,0,0,0,0,0,0,0,0,0,0,0,0,0,3,3,0,0,0,0,2,2,0,0,0,0
181215,38000,380,0,-2,5,5,0,0,0,0,0,0,0,0,0,0,0,0,0,0,0,0,5,5,0,0,0,0,0,0,0,0,0,0
181303,38000,380,0,-2,2,2,0,0,0,0,0,0,0,0,0,0,0,0,0,0,0,0,2,2,0,0,0,0,0,0,0,0,0,0
181428,38000,380,0,-2,5,5,0,0,0,0,0,0,0,0,0,0,1,1,0,0,0,0,4,4,0,0,0,0,0,0,0,0,0,0
181464,38000,380,0,-2,14,10,4,0,0,0,0,0,0,0,0,0,0,0,0,0,0,0,14,10,4,0,0,0,0,0,0,0,0,0
181491,38000,380,0,-2,4,4,0,0,0,0,0,0,0,0,0,0,0,0,0,0,0,0,4,4,0,0,0,0,0,0,0,0,0,0
181534,38000,380,0,-2,8,5,3,0,0,0,0,0,0,0,0,0,1,0,1,0,0,0,7,5,2,0,0,0,0,0,0,0,0,0
181604,38000,380,0,-2,1,1,0,0,0,0,0,0,0,0,0,0,1,1,0,0,0,0,0,0,0,0,0,0,0,0,0,0,0,0
181640,38000,380,0,-2,2,2,0,0,0,0,0,0,0,0,0,0,0,0,0,0,0,0,2,2,0,0,0,0,0,0,0,0,0,0
181783,38000,380,0,-2,2,2,0,0,0,0,0,0,0,0,0,0,0,0,0,0,0,0,2,2,0,0,0,0,0,0,0,0,0,0
181817,38000,380,0,-2,1,1,0,0,0,0,0,0,0,0,0,0,0,0,0,0,0,0,1,1,0,0,0,0,0,0,0,0,0,0
182005,38000,380,0,-2,1,1,0,0,0,0,0,0,0,0,0,0,1,1,0,0,0,0,0,0,0,0,0,0,0,0,0,0,0,0
182281,38000,380,0,-2,5,5,0,0,0,0,0,0,0,1,1,0,0,0,0,0,0,0,3,3,0,1,1,0,0,0,0,0,0,0
182290,38000,380,0,-2,1,1,0,0,0,0,0,0,0,0,0,0,0,0,0,0,0,0,1,1,0,0,0,0,0,0,0,0,0,0
182306,38000,380,0,-2,3,3,0,1,1,0,0,0,0,0,0,0,0,0,0,0,0,0,2,2,0,0,0,0,0,0,0,0,0,0
182564,38000,380,0,-2,1,1,0,0,0,0,0,0,0,0,0,0,0,0,0,0,0,0,1,1,0,0,0,0,0,0,0,0,0,0
182670,38000,380,0,-2,8,8,0,0,0,0,0,0,0,0,0,0,0,0,0,0,0,0,8,8,0,0,0,0,0,0,0,0,0,0
182795,38000,380,0,-2,4,4,0,0,0,0,0,0,0,0,0,0,0,0,0,0,0,0,4,4,0,0,0,0,0,0,0,0,0,0
183044,38000,380,0,-2,11,9,2,0,0,0,0,0,0,0,0,0,0,0,0,0,0,0,9,7,2,0,0,0,2,2,0,0,0,0
183062,38000,380,0,-2,3,3,0,0,0,0,0,0,0,0,0,0,0,0,0,0,0,0,3,3,0,0,0,0,0,0,0,0,0,0
183080,38000,380,0,-2,3,3,0,0,0,0,0,0,0,0,0,0,0,0,0,0,0,0,2,2,0,0,0,0,1,1,0,0,0,0
183743,38000,380,0,-2,2,2,0,0,0,0,0,0,0,0,0,0,2,2,0,0,0,0,0,0,0,0,0,0,0,0,0,0,0,0
183859,38000,380,0,-2,2,2,0,0,0,0,0,0,0,0,0,0,0,0,0,0,0,0,2,2,0,0,0,0,0,0,0,0,0,0
183974,38000,380,0,-2,6,4,2,0,0,0,0,0,0,0,0,0,0,0,0,0,0,0,6,4,2,0,0,0,0,0,0,0,0,0
184782,38000,380,0,-2,3,3,0,0,0,0,0,0,0,1,1,0,0,0,0,0,0,0,2,2,0,0,0,0,0,0,0,0,0,0
184791,38000,380,0,-2,1,1,0,0,0,0,0,0,0,0,0,0,0,0,0,0,0,0,1,1,0,0,0,0,0,0,0,0,0,0
184995,38000,380,0,-2,1,1,0,0,0,0,0,0,0,0,0,0,0,0,0,0,0,0,1,1,0,0,0,0,0,0,0,0,0,0
185129,38000,380,0,-2,3,2,1,0,0,0,1,1,0,1,0,1,1,1,0,0,0,0,0,0,0,0,0,0,0,0,0,0,0,0
185536,38000,380,0,-2,2,2,0,0,0,0,0,0,0,1,1,0,1,1,0,0,0,0,0,0,0,0,0,0,0,0,0,0,0,0
185590,38000,380,0,-2,6,6,0,0,0,0,0,0,0,0,0,0,0,0,0,0,0,0,5,5,0,0,0,0,1,1,0,0,0,0
185721,38000,380,0,-2,2,2,0,0,0,0,0,0,0,1,1,0,0,0,0,0,0,0,1,1,0,0,0,0,0,0,0,0,0,0
185828,38000,380,0,-2,1,1,0,0,0,0,0,0,0,0,0,0,0,0,0,0,0,0,0,0,0,0,0,0,1,1,0,0,0,0
186034,38000,380,0,-2,1,1,0,0,0,0,0,0,0,0,0,0,0,0,0,0,0,0,1,1,0,0,0,0,0,0,0,0,0,0
186131,38000,380,0,-2,14,13,1,0,0,0,0,0,0,1,1,0,3,3,0,0,0,0,9,8,1,0,0,0,0,0,0,1,1,0
186380,38000,380,0,-2,25,24,1,0,0,0,0,0,0,0,0,0,0,0,0,2,2,0,3,2,1,0,0,0,20,20,0,0,0,0
186399,38000,380,0,-2,4,4,0,0,0,0,0,0,0,0,0,0,0,0,0,0,0,0,0,0,0,0,0,0,4,4,0,0,0,0
186876,38000,380,0,-2,1,1,0,0,0,0,0,0,0,0,0,0,0,0,0,0,0,0,1,1,0,0,0,0,0,0,0,0,0,0
187134,38000,380,0,-2,2,2,0,0,0,0,0,0,0,0,0,0,0,0,0,0,0,0,0,0,0,0,0,0,2,2,0,0,0,0
187532,38000,380,0,-2,2,2,0,1,1,0,0,0,0,0,0,0,1,1,0,0,0,0,0,0,0,0,0,0,0,0,0,0,0,0
187648,38000,380,0,-2,1,0,1,0,0,0,0,0,0,0,0,0,1,0,1,0,0,0,0,0,0,0,0,0,0,0,0,0,0,0
187666,38000,380,0,-2,1,1,0,0,0,0,0,0,0,0,0,0,1,1,0,0,0,0,0,0,0,0,0,0,0,0,0,0,0,0
187897,38000,380,0,-2,4,0,4,0,0,0,0,0,0,0,0,0,4,0,4,0,0,0,0,0,0,0,0,0,0,0,0,0,0,0
187912,38000,380,0,-2,2,2,0,0,0,0,0,0,0,0,0,0,0,0,0,0,0,0,2,2,0,0,0,0,0,0,0,0,0,0
187967,38000,380,0,-2,20,20,0,0,0,0,0,0,0,2,2,0,12,12,0,0,0,0,6,6,0,0,0,0,0,0,0,0,0,0
187985,38000,380,0,-2,16,14,2,2,2,0,1,1,0,0,0,0,8,7,1,0,0,0,5,4,1,0,0,0,0,0,0,0,0,0
188030,38000,380,0,-2,3,3,0,1,1,0,0,0,0,0,0,0,0,0,0,0,0,0,2,2,0,0,0,0,0,0,0,0,0,0
188137,38000,380,0,-2,2,2,0,1,1,0,0,0,0,0,0,0,1,1,0,0,0,0,0,0,0,0,0,0,0,0,0,0,0,0
188225,38000,380,0,-2,1,1,0,0,0,0,0,0,0,0,0,0,1,1,0,0,0,0,0,0,0,0,0,0,0,0,0,0,0,0
188304,38000,380,0,-2,2,2,0,0,0,0,0,0,0,0,0,0,1,1,0,0,0,0,1,1,0,0,0,0,0,0,0,0,0,0
188429,38000,380,0,-2,1,1,0,0,0,0,0,0,0,0,0,0,0,0,0,0,0,0,1,1,0,0,0,0,0,0,0,0,0,0
188641,38000,380,0,-2,4,3,1,0,0,0,0,0,0,0,0,0,1,1,0,0,0,0,3,2,1,0,0,0,0,0,0,0,0,0
189088,38000,380,0,-2,7,6,1,0,0,0,0,0,0,0,0,0,0,0,0,0,0,0,7,6,1,0,0,0,0,0,0,0,0,0
189097,38000,380,0,-2,4,4,0,0,0,0,1,1,0,1,1,0,0,0,0,0,0,0,0,0,0,0,0,0,2,2,0,0,0,0
189501,38000,380,0,-2,2,2,0,0,0,0,0,0,0,0,0,0,2,2,0,0,0,0,0,0,0,0,0,0,0,0,0,0,0,0
189547,38000,380,0,-2,1,1,0,0,0,0,0,0,0,0,0,0,0,0,0,0,0,0,1,1,0,0,0,0,0,0,0,0,0,0
190044,38000,380,0,-2,1,1,0,0,0,0,0,0,0,0,0,0,1,1,0,0,0,0,0,0,0,0,0,0,0,0,0,0,0,0
190099,38000,380,0,-2,3,3,0,0,0,0,0,0,0,0,0,0,0,0,0,0,0,0,3,3,0,0,0,0,0,0,0,0,0,0
190150,38000,380,0,-2,11,11,0,0,0,0,3,3,0,2,2,0,1,1,0,0,0,0,2,2,0,0,0,0,2,2,0,1,1,0
190415,38000,380,0,-2,55,51,4,2,2,0,1,1,0,0,0,0,1,1,0,0,0,0,51,47,4,0,0,0,0,0,0,0,0,0
190424,38000,380,0,-2,3,3,0,0,0,0,0,0,0,1,1,0,0,0,0,0,0,0,0,0,0,0,0,0,0,0,0,2,2,0
190503,38000,380,0,-2,2,1,1,0,0,0,1,0,1,0,0,0,0,0,0,0,0,0,1,1,0,0,0,0,0,0,0,0,0,0
190512,38000,380,0,-2,5,5,0,0,0,0,0,0,0,0,0,0,2,2,0,0,0,0,3,3,0,0,0,0,0,0,0,0,0,0
190521,38000,380,0,-2,3,3,0,0,0,0,1,1,0,0,0,0,1,1,0,0,0,0,1,1,0,0,0,0,0,0,0,0,0,0
190530,38000,380,0,-2,3,3,0,0,0,0,0,0,0,0,0,0,0,0,0,0,0,0,3,3,0,0,0,0,0,0,0,0,0,0
190549,38000,380,0,-2,6,6,0,0,0,0,0,0,0,2,2,0,1,1,0,0,0,0,3,3,0,0,0,0,0,0,0,0,0,0
190567,38000,380,0,-2,2,2,0,0,0,0,0,0,0,1,1,0,1,1,0,0,0,0,0,0,0,0,0,0,0,0,0,0,0,0
190585,38000,380,0,-2,1,1,0,0,0,0,0,0,0,0,0,0,1,1,0,0,0,0,0,0,0,0,0,0,0,0,0,0,0,0
190600,38000,380,0,-2,1,1,0,0,0,0,0,0,0,1,1,0,0,0,0,0,0,0,0,0,0,0,0,0,0,0,0,0,0,0
190619,38000,380,0,-2,3,3,0,0,0,0,0,0,0,1,1,0,1,1,0,0,0,0,1,1,0,0,0,0,0,0,0,0,0,0
190637,38000,380,0,-2,2,2,0,0,0,0,0,0,0,0,0,0,0,0,0,0,0,0,2,2,0,0,0,0,0,0,0,0,0,0
190646,38000,380,0,-2,1,1,0,0,0,0,0,0,0,1,1,0,0,0,0,0,0,0,0,0,0,0,0,0,0,0,0,0,0,0
190664,38000,380,0,-2,1,1,0,0,0,0,0,0,0,0,0,0,0,0,0,0,0,0,1,1,0,0,0,0,0,0,0,0,0,0
190673,38000,380,0,-2,1,1,0,0,0,0,0,0,0,0,0,0,0,0,0,0,0,0,1,1,0,0,0,0,0,0,0,0,0,0
190691,38000,380,0,-2,2,2,0,0,0,0,0,0,0,0,0,0,0,0,0,0,0,0,2,2,0,0,0,0,0,0,0,0,0,0
190840,38000,380,0,-2,1,1,0,0,0,0,0,0,0,0,0,0,0,0,0,0,0,0,0,0,0,0,0,0,1,1,0,0,0,0
190983,38000,380,0,-2,1,1,0,0,0,0,0,0,0,0,0,0,0,0,0,0,0,0,1,1,0,0,0,0,0,0,0,0,0,0
191083,38000,380,0,-2,2,2,0,0,0,0,0,0,0,0,0,0,0,0,0,0,0,0,2,2,0,0,0,0,0,0,0,0,0,0
191205,38000,380,0,-2,3,3,0,0,0,0,0,0,0,0,0,0,0,0,0,0,0,0,3,3,0,0,0,0,0,0,0,0,0,0
191241,38000,380,0,-2,1,1,0,0,0,0,0,0,0,0,0,0,0,0,0,0,0,0,1,1,0,0,0,0,0,0,0,0,0,0
191339,38000,380,0,-2,3,3,0,0,0,0,0,0,0,0,0,0,0,0,0,0,0,0,3,3,0,0,0,0,0,0,0,0,0,0
191515,38000,380,0,-2,2,2,0,0,0,0,0,0,0,0,0,0,0,0,0,0,0,0,2,2,0,0,0,0,0,0,0,0,0,0
191931,38000,380,0,-2,3,3,0,0,0,0,0,0,0,0,0,0,1,1,0,0,0,0,1,1,0,0,0,0,1,1,0,0,0,0
191968,38000,380,0,-2,1,1,0,0,0,0,0,0,0,0,0,0,0,0,0,0,0,0,0,0,0,0,0,0,1,1,0,0,0,0
192749,38000,380,0,-2,1,1,0,0,0,0,0,0,0,0,0,0,0,0,0,0,0,0,1,1,0,0,0,0,0,0,0,0,0,0
193292,38000,380,0,-2,1,1,0,0,0,0,0,0,0,0,0,0,0,0,0,0,0,0,1,1,0,0,0,0,0,0,0,0,0,0
193326,38000,380,0,-2,1,1,0,0,0,0,0,0,0,0,0,0,0,0,0,0,0,0,1,1,0,0,0,0,0,0,0,0,0,0
193405,38000,380,0,-2,1,1,0,0,0,0,0,0,0,0,0,0,1,1,0,0,0,0,0,0,0,0,0,0,0,0,0,0,0,0
193654,38000,380,0,-2,2,1,1,0,0,0,0,0,0,0,0,0,0,0,0,0,0,0,1,1,0,1,0,1,0,0,0,0,0,0
193900,38000,380,0,-2,5,4,1,0,0,0,0,0,0,3,3,0,0,0,0,0,0,0,1,1,0,0,0,0,1,0,1,0,0,0
193946,38000,380,0,-2,1,1,0,0,0,0,0,0,0,0,0,0,0,0,0,0,0,0,1,1,0,0,0,0,0,0,0,0,0,0
194073,38000,380,0,-2,1,1,0,0,0,0,0,0,0,0,0,0,1,1,0,0,0,0,0,0,0,0,0,0,0,0,0,0,0,0
194824,38000,380,0,-2,2,1,1,0,0,0,0,0,0,0,0,0,0,0,0,0,0,0,2,1,1,0,0,0,0,0,0,0,0,0
194958,38000,380,0,-2,1,1,0,0,0,0,0,0,0,0,0,0,0,0,0,0,0,0,0,0,0,1,1,0,0,0,0,0,0,0
195003,38000,380,0,-2,3,3,0,0,0,0,0,0,0,0,0,0,0,0,0,0,0,0,1,1,0,1,1,0,1,1,0,0,0,0
195030,38000,380,0,-2,7,5,2,0,0,0,2,0,2,4,4,0,1,1,0,0,0,0,0,0,0,0,0,0,0,0,0,0,0,0
195049,38000,380,0,-2,2,2,0,0,0,0,0,0,0,0,0,0,1,1,0,0,0,0,1,1,0,0,0,0,0,0,0,0,0,0
195058,38000,380,0,-2,1,1,0,0,0,0,0,0,0,0,0,0,0,0,0,0,0,0,1,1,0,0,0,0,0,0,0,0,0,0
195128,38000,380,0,-2,2,2,0,0,0,0,0,0,0,0,0,0,0,0,0,0,0,0,2,2,0,0,0,0,0,0,0,0,0,0
195164,38000,380,0,-2,2,2,0,0,0,0,0,0,0,0,0,0,0,0,0,0,0,0,2,2,0,0,0,0,0,0,0,0,0,0
195234,38000,380,0,-2,1,1,0,0,0,0,0,0,0,1,1,0,0,0,0,0,0,0,0,0,0,0,0,0,0,0,0,0,0,0
195474,38000,380,0,-2,2,2,0,0,0,0,0,0,0,1,1,0,0,0,0,0,0,0,1,1,0,0,0,0,0,0,0,0,0,0
195526,38000,380,0,-2,4,3,1,0,0,0,0,0,0,0,0,0,0,0,0,0,0,0,4,3,1,0,0,0,0,0,0,0,0,0
195827,38000,380,0,-2,1,1,0,0,0,0,0,0,0,0,0,0,0,0,0,0,0,0,1,1,0,0,0,0,0,0,0,0,0,0
196006,38000,380,0,-2,7,4,3,0,0,0,0,0,0,0,0,0,1,1,0,0,0,0,6,3,3,0,0,0,0,0,0,0,0,0
196024,38000,380,0,-2,2,1,1,0,0,0,0,0,0,0,0,0,0,0,0,0,0,0,2,1,1,0,0,0,0,0,0,0,0,0
196033,38000,380,0,-2,4,4,0,0,0,0,0,0,0,0,0,0,0,0,0,0,0,0,4,4,0,0,0,0,0,0,0,0,0,0
196042,38000,380,0,-2,2,2,0,0,0,0,0,0,0,0,0,0,0,0,0,0,0,0,2,2,0,0,0,0,0,0,0,0,0,0
196051,38000,380,0,-2,2,2,0,0,0,0,0,0,0,0,0,0,0,0,0,0,0,0,2,2,0,0,0,0,0,0,0,0,0,0
196060,38000,380,0,-2,10,9,1,0,0,0,1,1,0,4,3,1,0,0,0,0,0,0,5,5,0,0,0,0,0,0,0,0,0,0
196079,38000,380,0,-2,38,27,11,0,0,0,1,1,0,1,1,0,0,0,0,0,0,0,31,22,9,0,0,0,0,0,0,5,3,2
196088,38000,380,0,-2,3,3,0,0,0,0,0,0,0,1,1,0,0,0,0,0,0,0,2,2,0,0,0,0,0,0,0,0,0,0
196097,38000,380,0,-2,8,8,0,0,0,0,0,0,0,1,1,0,0,0,0,0,0,0,7,7,0,0,0,0,0,0,0,0,0,0
196103,38000,380,0,-2,7,6,1,0,0,0,0,0,0,0,0,0,0,0,0,0,0,0,7,6,1,0,0,0,0,0,0,0,0,0
196121,38000,380,0,-2,2,2,0,0,0,0,0,0,0,0,0,0,0,0,0,0,0,0,2,2,0,0,0,0,0,0,0,0,0,0
196130,38000,380,0,-2,2,2,0,0,0,0,0,0,0,0,0,0,0,0,0,0,0,0,2,2,0,0,0,0,0,0,0,0,0,0
196158,38000,380,0,-2,1,1,0,0,0,0,0,0,0,0,0,0,0,0,0,0,0,0,1,1,0,0,0,0,0,0,0,0,0,0
196167,38000,380,0,-2,6,6,0,0,0,0,0,0,0,0,0,0,0,0,0,0,0,0,6,6,0,0,0,0,0,0,0,0,0,0
196185,38000,380,0,-2,1,1,0,0,0,0,0,0,0,0,0,0,0,0,0,0,0,0,1,1,0,0,0,0,0,0,0,0,0,0
196219,38000,380,0,-2,1,1,0,0,0,0,0,0,0,0,0,0,1,1,0,0,0,0,0,0,0,0,0,0,0,0,0,0,0,0
196255,38000,380,0,-2,6,5,1,0,0,0,0,0,0,4,3,1,1,1,0,0,0,0,0,0,0,1,1,0,0,0,0,0,0,0
196264,38000,380,0,-2,1,1,0,0,0,0,0,0,0,0,0,0,0,0,0,0,0,0,1,1,0,0,0,0,0,0,0,0,0,0
196291,38000,380,0,-2,1,1,0,0,0,0,0,0,0,0,0,0,1,1,0,0,0,0,0,0,0,0,0,0,0,0,0,0,0,0
196307,38000,380,0,-2,5,5,0,0,0,0,0,0,0,1,1,0,0,0,0,0,0,0,4,4,0,0,0,0,0,0,0,0,0,0
196413,38000,380,0,-2,12,12,0,0,0,0,0,0,0,1,1,0,0,0,0,0,0,0,11,11,0,0,0,0,0,0,0,0,0,0
196592,38000,380,0,-2,1,0,1,0,0,0,0,0,0,0,0,0,0,0,0,0,0,0,1,0,1,0,0,0,0,0,0,0,0,0
196866,38000,380,0,-2,1,0,1,0,0,0,0,0,0,0,0,0,0,0,0,1,0,1,0,0,0,0,0,0,0,0,0,0,0,0
197027,38000,380,0,-2,4,3,1,0,0,0,0,0,0,0,0,0,2,2,0,0,0,0,2,1,1,0,0,0,0,0,0,0,0,0
197036,38000,380,0,-2,11,11,0,0,0,0,0,0,0,0,0,0,0,0,0,0,0,0,11,11,0,0,0,0,0,0,0,0,0,0
197133,38000,380,0,-2,4,2,2,0,0,0,0,0,0,0,0,0,0,0,0,0,0,0,4,2,2,0,0,0,0,0,0,0,0,0
197142,38000,380,0,-2,1,1,0,0,0,0,0,0,0,0,0,0,0,0,0,0,0,0,1,1,0,0,0,0,0,0,0,0,0,0
197197,38000,380,0,-2,1,1,0,0,0,0,0,0,0,1,1,0,0,0,0,0,0,0,0,0,0,0,0,0,0,0,0,0,0,0
197708,38000,380,0,-2,1,1,0,0,0,0,0,0,0,0,0,0,1,1,0,0,0,0,0,0,0,0,0,0,0,0,0,0,0,0
197850,38000,380,0,-2,2,2,0,0,0,0,0,0,0,1,1,0,0,0,0,0,0,0,1,1,0,0,0,0,0,0,0,0,0,0
197869,38000,380,0,-2,6,6,0,0,0,0,0,0,0,0,0,0,0,0,0,0,0,0,6,6,0,0,0,0,0,0,0,0,0,0
197887,38000,380,0,-2,1,1,0,0,0,0,0,0,0,0,0,0,0,0,0,0,0,0,1,1,0,0,0,0,0,0,0,0,0,0
198011,38000,380,0,-2,1,1,0,0,0,0,0,0,0,0,0,0,0,0,0,0,0,0,1,1,0,0,0,0,0,0,0,0,0,0
198039,38000,380,0,-2,2,2,0,0,0,0,0,0,0,0,0,0,0,0,0,0,0,0,2,2,0,0,0,0,0,0,0,0,0,0
198084,38000,380,0,-2,1,1,0,0,0,0,0,0,0,0,0,0,0,0,0,0,0,0,1,1,0,0,0,0,0,0,0,0,0,0
198118,38000,380,0,-2,1,1,0,0,0,0,0,0,0,0,0,0,0,0,0,0,0,0,1,1,0,0,0,0,0,0,0,0,0,0
198136,38000,380,0,-2,2,2,0,0,0,0,0,0,0,0,0,0,0,0,0,0,0,0,2,2,0,0,0,0,0,0,0,0,0,0
198215,38000,380,0,-2,2,2,0,1,1,0,0,0,0,0,0,0,0,0,0,0,0,0,1,1,0,0,0,0,0,0,0,0,0,0
198251,38000,380,0,-2,1,1,0,0,0,0,0,0,0,0,0,0,0,0,0,0,0,0,0,0,0,0,0,0,1,1,0,0,0,0
198367,38000,380,0,-2,5,2,3,0,0,0,0,0,0,2,1,1,0,0,0,0,0,0,3,1,2,0,0,0,0,0,0,0,0,0
198385,38000,380,0,-2,3,2,1,0,0,0,0,0,0,0,0,0,0,0,0,0,0,0,3,2,1,0,0,0,0,0,0,0,0,0
198419,38000,380,0,-2,8,8,0,0,0,0,0,0,0,0,0,0,1,1,0,0,0,0,6,6,0,1,1,0,0,0,0,0,0,0
198464,38000,380,0,-2,6,6,0,0,0,0,0,0,0,1,1,0,2,2,0,0,0,0,3,3,0,0,0,0,0,0,0,0,0,0
198507,38000,380,0,-2,1,1,0,0,0,0,0,0,0,1,1,0,0,0,0,0,0,0,0,0,0,0,0,0,0,0,0,0,0,0
198516,38000,380,0,-2,3,3,0,0,0,0,0,0,0,0,0,0,0,0,0,0,0,0,3,3,0,0,0,0,0,0,0,0,0,0
198543,38000,380,0,-2,11,7,4,1,0,1,0,0,0,9,6,3,0,0,0,0,0,0,1,1,0,0,0,0,0,0,0,0,0,0
198552,38000,380,0,-2,2,2,0,0,0,0,0,0,0,0,0,0,0,0,0,0,0,0,2,2,0,0,0,0,0,0,0,0,0,0
198871,38000,380,0,-2,2,2,0,0,0,0,0,0,0,0,0,0,0,0,0,0,0,0,2,2,0,0,0,0,0,0,0,0,0,0
198950,38000,380,0,-2,1,1,0,0,0,0,0,0,0,0,0,0,0,0,0,0,0,0,1,1,0,0,0,0,0,0,0,0,0,0
198987,38000,380,0,-2,3,3,0,0,0,0,0,0,0,0,0,0,0,0,0,0,0,0,3,3,0,0,0,0,0,0,0,0,0,0
199087,38000,380,0,-2,1,1,0,0,0,0,0,0,0,0,0,0,0,0,0,0,0,0,1,1,0,0,0,0,0,0,0,0,0,0
199102,38000,380,0,-2,7,6,1,0,0,0,0,0,0,3,3,0,1,1,0,0,0,0,1,1,0,0,0,0,2,1,1,0,0,0
199111,38000,380,0,-2,1,1,0,0,0,0,0,0,0,0,0,0,0,0,0,0,0,0,1,1,0,0,0,0,0,0,0,0,0,0
199120,38000,380,0,-2,6,5,1,0,0,0,0,0,0,0,0,0,0,0,0,0,0,0,2,1,1,0,0,0,4,4,0,0,0,0
199139,38000,380,0,-2,9,6,3,0,0,0,1,1,0,3,0,3,1,1,0,0,0,0,2,2,0,0,0,0,0,0,0,2,2,0
199148,38000,380,0,-2,12,12,0,0,0,0,0,0,0,2,2,0,0,0,0,0,0,0,10,10,0,0,0,0,0,0,0,0,0,0
199157,38000,380,0,-2,8,8,0,0,0,0,0,0,0,0,0,0,1,1,0,0,0,0,0,0,0,0,0,0,7,7,0,0,0,0
199184,38000,380,0,-2,1,0,1,0,0,0,0,0,0,0,0,0,0,0,0,0,0,0,0,0,0,0,0,0,1,0,1,0,0,0
199193,38000,380,0,-2,27,23,4,0,0,0,0,0,0,4,4,0,3,3,0,0,0,0,20,16,4,0,0,0,0,0,0,0,0,0
199218,38000,380,0,-2,8,8,0,0,0,0,0,0,0,0,0,0,0,0,0,0,0,0,7,7,0,0,0,0,1,1,0,0,0,0
199333,38000,380,0,-2,1,1,0,0,0,0,0,0,0,0,0,0,0,0,0,0,0,0,1,1,0,0,0,0,0,0,0,0,0,0
199449,38000,380,0,-2,3,3,0,1,1,0,0,0,0,0,0,0,0,0,0,0,0,0,1,1,0,1,1,0,0,0,0,0,0,0
199731,38000,380,0,-2,1,1,0,0,0,0,0,0,0,0,0,0,0,0,0,0,0,0,1,1,0,0,0,0,0,0,0,0,0,0
199759,38000,380,0,-2,1,1,0,0,0,0,0,0,0,0,0,0,0,0,0,0,0,0,1,1,0,0,0,0,0,0,0,0,0,0
199786,38000,380,0,-2,1,1,0,0,0,0,0,0,0,0,0,0,0,0,0,0,0,0,1,1,0,0,0,0,0,0,0,0,0,0
199847,38000,380,0,-2,5,5,0,0,0,0,0,0,0,0,0,0,0,0,0,0,0,0,5,5,0,0,0,0,0,0,0,0,0,0
199962,38000,380,0,-2,1,1,0,0,0,0,0,0,0,0,0,0,0,0,0,0,0,0,1,1,0,0,0,0,0,0,0,0,0,0
199999,38000,380,0,-2,6,5,1,0,0,0,0,0,0,4,3,1,0,0,0,0,0,0,0,0,0,0,0,0,2,2,0,0,0,0
200004,38000,380,0,-2,8,8,0,0,0,0,0,0,0,0,0,0,0,0,0,0,0,0,8,8,0,0,0,0,0,0,0,0,0,0
200022,38000,380,0,-2,1,1,0,0,0,0,0,0,0,0,0,0,0,0,0,0,0,0,0,0,0,0,0,0,1,1,0,0,0,0
200059,38000,380,0,-2,1,1,0,0,0,0,0,0,0,0,0,0,0,0,0,0,0,0,1,1,0,0,0,0,0,0,0,0,0,0
200156,38000,380,0,-2,1,1,0,0,0,0,0,0,0,0,0,0,0,0,0,0,0,0,1,1,0,0,0,0,0,0,0,0,0,0
200208,38000,380,0,-2,1,0,1,0,0,0,0,0,0,0,0,0,0,0,0,0,0,0,1,0,1,0,0,0,0,0,0,0,0,0
200226,38000,380,0,-2,1,1,0,0,0,0,0,0,0,0,0,0,0,0,0,0,0,0,1,1,0,0,0,0,0,0,0,0,0,0
200280,38000,380,0,-2,2,2,0,0,0,0,0,0,0,0,0,0,0,0,0,0,0,0,2,2,0,0,0,0,0,0,0,0,0,0
200305,38000,380,0,-2,2,2,0,0,0,0,0,0,0,0,0,0,0,0,0,0,0,0,2,2,0,0,0,0,0,0,0,0,0,0
200332,38000,380,0,-2,6,5,1,0,0,0,0,0,0,1,1,0,0,0,0,0,0,0,5,4,1,0,0,0,0,0,0,0,0,0
200572,38000,380,0,-2,2,2,0,0,0,0,0,0,0,0,0,0,0,0,0,0,0,0,2,2,0,0,0,0,0,0,0,0,0,0
200800,38000,380,0,-2,1,1,0,0,0,0,0,0,0,0,0,0,0,0,0,0,0,0,1,1,0,0,0,0,0,0,0,0,0,0
201104,38000,380,0,-2,1,1,0,0,0,0,0,0,0,0,0,0,0,0,0,0,0,0,1,1,0,0,0,0,0,0,0,0,0,0
201140,38000,380,0,-2,1,1,0,0,0,0,0,0,0,0,0,0,0,0,0,0,0,0,1,1,0,0,0,0,0,0,0,0,0,0
201195,38000,380,0,-2,2,2,0,0,0,0,0,0,0,1,1,0,0,0,0,0,0,0,1,1,0,0,0,0,0,0,0,0,0,0
201548,38000,380,0,-2,2,2,0,0,0,0,0,0,0,0,0,0,0,0,0,0,0,0,2,2,0,0,0,0,0,0,0,0,0,0
201645,38000,380,0,-2,1,0,1,0,0,0,0,0,0,0,0,0,0,0,0,0,0,0,1,0,1,0,0,0,0,0,0,0,0,0
201885,38000,380,0,-2,4,4,0,0,0,0,0,0,0,1,1,0,1,1,0,0,0,0,2,2,0,0,0,0,0,0,0,0,0,0
202073,38000,380,0,-2,2,2,0,0,0,0,0,0,0,0,0,0,0,0,0,0,0,0,2,2,0,0,0,0,0,0,0,0,0,0
202170,38000,380,0,-2,5,1,4,0,0,0,0,0,0,2,0,2,1,0,1,0,0,0,2,1,1,0,0,0,0,0,0,0,0,0
202480,38000,380,0,-2,1,1,0,0,0,0,0,0,0,0,0,0,0,0,0,0,0,0,1,1,0,0,0,0,0,0,0,0,0,0
202514,38000,380,0,-2,1,1,0,0,0,0,0,0,0,0,0,0,0,0,0,0,0,0,1,1,0,0,0,0,0,0,0,0,0,0
202763,38000,380,0,-2,4,2,2,0,0,0,0,0,0,0,0,0,1,1,0,0,0,0,3,1,2,0,0,0,0,0,0,0,0,0
202806,38000,380,0,-2,2,2,0,0,0,0,0,0,0,0,0,0,0,0,0,0,0,0,2,2,0,0,0,0,0,0,0,0,0,0
203368,38000,380,0,-2,3,3,0,0,0,0,0,0,0,0,0,0,0,0,0,0,0,0,2,2,0,1,1,0,0,0,0,0,0,0
203447,38000,380,0,-2,2,2,0,0,0,0,0,0,0,0,0,0,0,0,0,0,0,0,1,1,0,0,0,0,1,1,0,0,0,0
203517,38000,380,0,-2,3,3,0,0,0,0,0,0,0,0,0,0,0,0,0,0,0,0,2,2,0,0,0,0,1,1,0,0,0,0
203580,38000,380,0,-2,3,0,3,0,0,0,0,0,0,0,0,0,0,0,0,0,0,0,3,0,3,0,0,0,0,0,0,0,0,0
203775,38000,380,0,-2,2,2,0,0,0,0,0,0,0,0,0,0,0,0,0,0,0,0,2,2,0,0,0,0,0,0,0,0,0,0
204024,38000,380,0,-2,2,2,0,0,0,0,0,0,0,0,0,0,0,0,0,0,0,0,2,2,0,0,0,0,0,0,0,0,0,0
204185,38000,380,0,-2,1,1,0,0,0,0,0,0,0,0,0,0,0,0,0,0,0,0,1,1,0,0,0,0,0,0,0,0,0,0
204194,38000,380,0,-2,1,1,0,0,0,0,0,0,0,0,0,0,0,0,0,0,0,0,1,1,0,0,0,0,0,0,0,0,0,0
204477,38000,380,0,-2,1,0,1,0,0,0,0,0,0,0,0,0,0,0,0,0,0,0,0,0,0,0,0,0,1,0,1,0,0,0
204501,38000,380,0,-2,7,7,0,0,0,0,0,0,0,0,0,0,1,1,0,0,0,0,6,6,0,0,0,0,0,0,0,0,0,0
204705,38000,380,0,-2,1,1,0,0,0,0,0,0,0,0,0,0,0,0,0,0,0,0,1,1,0,0,0,0,0,0,0,0,0,0
204796,38000,380,0,-2,31,31,0,0,0,0,1,1,0,3,3,0,0,0,0,0,0,0,26,26,0,0,0,0,1,1,0,0,0,0
204857,38000,380,0,-2,2,2,0,0,0,0,0,0,0,0,0,0,0,0,0,0,0,0,2,2,0,0,0,0,0,0,0,0,0,0
204909,38000,380,0,-2,4,4,0,0,0,0,0,0,0,0,0,0,0,0,0,0,0,0,4,4,0,0,0,0,0,0,0,0,0,0
204945,38000,380,0,-2,1,1,0,0,0,0,0,0,0,0,0,0,0,0,0,0,0,0,1,1,0,0,0,0,0,0,0,0,0,0
205203,38000,380,0,-2,4,4,0,0,0,0,0,0,0,0,0,0,0,0,0,0,0,0,4,4,0,0,0,0,0,0,0,0,0,0
205443,38000,380,0,-2,1,1,0,0,0,0,0,0,0,0,0,0,0,0,0,0,0,0,1,1,0,0,0,0,0,0,0,0,0,0
205470,38000,380,0,-2,12,11,1,0,0,0,0,0,0,2,1,1,0,0,0,0,0,0,10,10,0,0,0,0,0,0,0,0,0,0
205957,38000,380,0,-2,1,1,0,0,0,0,0,0,0,0,0,0,0,0,0,0,0,0,1,1,0,0,0,0,0,0,0,0,0,0
206011,38000,380,0,-2,2,2,0,0,0,0,0,0,0,0,0,0,0,0,0,0,0,0,2,2,0,0,0,0,0,0,0,0,0,0
206084,38000,380,0,-2,3,3,0,0,0,0,0,0,0,1,1,0,0,0,0,0,0,0,2,2,0,0,0,0,0,0,0,0,0,0
206437,38000,380,0,-2,3,3,0,0,0,0,0,0,0,0,0,0,0,0,0,0,0,0,2,2,0,0,0,0,1,1,0,0,0,0
206446,38000,380,0,-2,3,3,0,0,0,0,0,0,0,0,0,0,0,0,0,0,0,0,3,3,0,0,0,0,0,0,0,0,0,0
206507,38000,380,0,-2,2,2,0,0,0,0,0,0,0,0,0,0,0,0,0,0,0,0,2,2,0,0,0,0,0,0,0,0,0,0
206525,38000,380,0,-2,2,2,0,0,0,0,0,0,0,0,0,0,1,1,0,0,0,0,1,1,0,0,0,0,0,0,0,0,0,0
206589,38000,380,0,-2,2,1,1,0,0,0,0,0,0,0,0,0,0,0,0,0,0,0,2,1,1,0,0,0,0,0,0,0,0,0
206604,38000,380,0,-2,3,2,1,0,0,0,0,0,0,0,0,0,0,0,0,0,0,0,3,2,1,0,0,0,0,0,0,0,0,0
206695,38000,380,0,-2,3,3,0,0,0,0,0,0,0,0,0,0,1,1,0,0,0,0,2,2,0,0,0,0,0,0,0,0,0,0
206914,38000,380,0,-2,4,4,0,0,0,0,0,0,0,1,1,0,2,2,0,0,0,0,1,1,0,0,0,0,0,0,0,0,0,0
206941,38000,380,0,-2,1,1,0,0,0,0,0,0,0,0,0,0,0,0,0,0,0,0,1,1,0,0,0,0,0,0,0,0,0,0
206996,38000,380,0,-2,1,1,0,0,0,0,0,0,0,0,0,0,0,0,0,0,0,0,1,1,0,0,0,0,0,0,0,0,0,0
207041,38000,380,0,-2,2,2,0,0,0,0,0,0,0,0,0,0,0,0,0,0,0,0,2,2,0,0,0,0,0,0,0,0,0,0
207050,38000,380,0,-2,1,1,0,0,0,0,0,0,0,0,0,0,0,0,0,0,0,0,1,1,0,0,0,0,0,0,0,0,0,0
207069,38000,380,0,-2,2,2,0,0,0,0,0,0,0,0,0,0,1,1,0,0,0,0,1,1,0,0,0,0,0,0,0,0,0,0
207209,38000,380,0,-2,2,2,0,0,0,0,0,0,0,1,1,0,0,0,0,0,0,0,0,0,0,0,0,0,0,0,0,1,1,0
207263,38000,380,0,-2,1,1,0,0,0,0,0,0,0,0,0,0,0,0,0,0,0,0,1,1,0,0,0,0,0,0,0,0,0,0
207281,38000,380,0,-2,2,2,0,0,0,0,0,0,0,0,0,0,0,0,0,0,0,0,2,2,0,0,0,0,0,0,0,0,0,0
207290,38000,380,0,-2,1,1,0,0,0,0,0,0,0,0,0,0,0,0,0,1,1,0,0,0,0,0,0,0,0,0,0,0,0,0
207324,38000,380,0,-2,1,1,0,0,0,0,0,0,0,0,0,0,0,0,0,0,0,0,1,1,0,0,0,0,0,0,0,0,0,0
207342,38000,380,0,-2,6,6,0,1,1,0,1,1,0,0,0,0,1,1,0,0,0,0,2,2,0,1,1,0,0,0,0,0,0,0
207388,38000,380,0,-2,37,29,8,0,0,0,0,0,0,1,1,0,5,2,3,0,0,0,28,23,5,2,2,0,1,1,0,0,0,0
207403,38000,380,0,-2,1,1,0,0,0,0,0,0,0,0,0,0,0,0,0,0,0,0,1,1,0,0,0,0,0,0,0,0,0,0
207449,38000,380,0,-2,2,2,0,0,0,0,0,0,0,0,0,0,0,0,0,0,0,0,1,1,0,1,1,0,0,0,0,0,0,0
207458,38000,380,0,-2,1,1,0,0,0,0,0,0,0,0,0,0,1,1,0,0,0,0,0,0,0,0,0,0,0,0,0,0,0,0
207500,38000,380,0,-2,38,38,0,3,3,0,0,0,0,3,3,0,3,3,0,0,0,0,23,23,0,5,5,0,1,1,0,0,0,0
207564,38000,380,0,-2,1,1,0,0,0,0,0,0,0,0,0,0,0,0,0,0,0,0,1,1,0,0,0,0,0,0,0,0,0,0
207582,38000,380,0,-2,5,4,1,0,0,0,0,0,0,0,0,0,0,0,0,0,0,0,5,4,1,0,0,0,0,0,0,0,0,0
207670,38000,380,0,-2,1,0,1,0,0,0,1,0,1,0,0,0,0,0,0,0,0,0,0,0,0,0,0,0,0,0,0,0,0,0
207740,38000,380,0,-2,2,2,0,0,0,0,0,0,0,0,0,0,0,0,0,0,0,0,2,2,0,0,0,0,0,0,0,0,0,0
207847,38000,380,0,-2,1,1,0,0,0,0,0,0,0,0,0,0,0,0,0,0,0,0,1,1,0,0,0,0,0,0,0,0,0,0
207856,38000,380,0,-2,1,1,0,0,0,0,0,0,0,0,0,0,0,0,0,0,0,0,1,1,0,0,0,0,0,0,0,0,0,0
207865,38000,380,0,-2,1,1,0,0,0,0,0,0,0,0,0,0,0,0,0,0,0,0,1,1,0,0,0,0,0,0,0,0,0,0
207935,38000,380,0,-2,8,8,0,0,0,0,0,0,0,1,1,0,0,0,0,0,0,0,4,4,0,3,3,0,0,0,0,0,0,0
207962,38000,380,0,-2,1,0,1,0,0,0,0,0,0,0,0,0,0,0,0,0,0,0,1,0,1,0,0,0,0,0,0,0,0,0
208406,38000,380,0,-2,3,3,0,0,0,0,0,0,0,0,0,0,1,1,0,0,0,0,2,2,0,0,0,0,0,0,0,0,0,0
208822,38000,380,0,-2,1,1,0,0,0,0,0,0,0,0,0,0,1,1,0,0,0,0,0,0,0,0,0,0,0,0,0,0,0,0
209065,38000,380,0,-2,3,3,0,0,0,0,0,0,0,0,0,0,0,0,0,0,0,0,3,3,0,0,0,0,0,0,0,0,0,0
209074,38000,380,0,-2,1,1,0,0,0,0,0,0,0,0,0,0,0,0,0,0,0,0,0,0,0,0,0,0,1,1,0,0,0,0
209250,38000,380,0,-2,1,1,0,0,0,0,0,0,0,0,0,0,0,0,0,0,0,0,1,1,0,0,0,0,0,0,0,0,0,0
209490,38000,380,0,-2,4,3,1,0,0,0,0,0,0,0,0,0,2,2,0,0,0,0,2,1,1,0,0,0,0,0,0,0,0,0
209542,38000,380,0,-2,4,4,0,0,0,0,0,0,0,0,0,0,1,1,0,0,0,0,2,2,0,0,0,0,1,1,0,0,0,0
209551,38000,380,0,-2,24,23,1,0,0,0,0,0,0,0,0,0,4,4,0,0,0,0,19,18,1,0,0,0,1,1,0,0,0,0
209612,38000,380,0,-2,2,2,0,0,0,0,0,0,0,0,0,0,0,0,0,0,0,0,2,2,0,0,0,0,0,0,0,0,0,0
209807,38000,380,0,-2,1,1,0,0,0,0,0,0,0,0,0,0,0,0,0,0,0,0,1,1,0,0,0,0,0,0,0,0,0,0
209825,38000,380,0,-2,4,4,0,0,0,0,0,0,0,0,0,0,0,0,0,0,0,0,4,4,0,0,0,0,0,0,0,0,0,0
210438,38000,380,0,-2,1,1,0,0,0,0,0,0,0,0,0,0,0,0,0,0,0,0,1,1,0,0,0,0,0,0,0,0,0,0
210571,38000,380,0,-2,1,1,0,0,0,0,0,0,0,0,0,0,0,0,0,0,0,0,1,1,0,0,0,0,0,0,0,0,0,0
210775,38000,380,0,-2,1,1,0,0,0,0,0,0,0,0,0,0,1,1,0,0,0,0,0,0,0,0,0,0,0,0,0,0,0,0
211352,38000,380,0,-2,2,2,0,0,0,0,0,0,0,0,0,0,0,0,0,0,0,0,2,2,0,0,0,0,0,0,0,0,0,0
211361,38000,380,0,-2,2,2,0,0,0,0,0,0,0,0,0,0,0,0,0,0,0,0,2,2,0,0,0,0,0,0,0,0,0,0
211431,38000,380,0,-2,1,1,0,0,0,0,0,0,0,0,0,0,0,0,0,0,0,0,1,1,0,0,0,0,0,0,0,0,0,0
211440,38000,380,0,-2,3,2,1,0,0,0,0,0,0,0,0,0,0,0,0,0,0,0,3,2,1,0,0,0,0,0,0,0,0,0
211468,38000,380,0,-2,1,0,1,0,0,0,0,0,0,0,0,0,0,0,0,0,0,0,1,0,1,0,0,0,0,0,0,0,0,0
211556,38000,380,0,-2,2,0,2,0,0,0,0,0,0,0,0,0,0,0,0,0,0,0,2,0,2,0,0,0,0,0,0,0,0,0
211981,38000,380,0,-2,5,1,4,0,0,0,0,0,0,1,1,0,1,0,1,0,0,0,2,0,2,0,0,0,1,0,1,0,0,0
212009,38000,380,0,-2,3,3,0,0,0,0,0,0,0,0,0,0,0,0,0,0,0,0,3,3,0,0,0,0,0,0,0,0,0,0
212045,38000,380,0,-2,2,2,0,0,0,0,0,0,0,0,0,0,0,0,0,0,0,0,2,2,0,0,0,0,0,0,0,0,0,0
212054,38000,380,0,-2,4,3,1,0,0,0,0,0,0,1,1,0,1,1,0,0,0,0,2,1,1,0,0,0,0,0,0,0,0,0
212106,38000,380,0,-2,5,5,0,0,0,0,0,0,0,0,0,0,0,0,0,0,0,0,5,5,0,0,0,0,0,0,0,0,0,0
212197,38000,380,0,-2,1,1,0,0,0,0,0,0,0,0,0,0,0,0,0,0,0,0,1,1,0,0,0,0,0,0,0,0,0,0
212577,38000,380,0,-2,1,1,0,0,0,0,0,0,0,0,0,0,0,0,0,0,0,0,1,1,0,0,0,0,0,0,0,0,0,0
212601,38000,380,0,-2,2,2,0,0,0,0,0,0,0,0,0,0,0,0,0,0,0,0,2,2,0,0,0,0,0,0,0,0,0,0
212656,38000,380,0,-2,1,1,0,0,0,0,0,0,0,0,0,0,0,0,0,0,0,0,1,1,0,0,0,0,0,0,0,0,0,0
212674,38000,380,0,-2,1,1,0,0,0,0,0,0,0,0,0,0,0,0,0,0,0,0,1,1,0,0,0,0,0,0,0,0,0,0
212832,38000,380,0,-2,1,1,0,0,0,0,0,0,0,0,0,0,0,0,0,0,0,0,1,1,0,0,0,0,0,0,0,0,0,0
212911,38000,380,0,-2,1,1,0,0,0,0,0,0,0,0,0,0,0,0,0,0,0,0,1,1,0,0,0,0,0,0,0,0,0,0
213011,38000,380,0,-2,4,4,0,0,0,0,0,0,0,0,0,0,0,0,0,0,0,0,4,4,0,0,0,0,0,0,0,0,0,0
213233,38000,380,0,-2,1,1,0,0,0,0,0,0,0,0,0,0,0,0,0,0,0,0,1,1,0,0,0,0,0,0,0,0,0,0
213321,38000,380,0,-2,4,3,1,0,0,0,0,0,0,0,0,0,0,0,0,0,0,0,4,3,1,0,0,0,0,0,0,0,0,0
213358,38000,380,0,-2,3,3,0,0,0,0,0,0,0,0,0,0,0,0,0,0,0,0,3,3,0,0,0,0,0,0,0,0,0,0
213367,38000,380,0,-2,6,6,0,0,0,0,0,0,0,1,1,0,1,1,0,0,0,0,4,4,0,0,0,0,0,0,0,0,0,0
213507,38000,380,0,-2,1,1,0,0,0,0,0,0,0,0,0,0,0,0,0,0,0,0,1,1,0,0,0,0,0,0,0,0,0,0
213543,38000,380,0,-2,6,6,0,0,0,0,0,0,0,0,0,0,0,0,0,0,0,0,4,4,0,1,1,0,1,1,0,0,0,0
213783,38000,380,0,-2,1,1,0,0,0,0,0,0,0,0,0,0,0,0,0,0,0,0,1,1,0,0,0,0,0,0,0,0,0,0
213826,38000,380,0,-2,1,1,0,0,0,0,0,0,0,0,0,0,0,0,0,0,0,0,1,1,0,0,0,0,0,0,0,0,0,0
213996,38000,380,0,-2,2,1,1,0,0,0,0,0,0,0,0,0,0,0,0,0,0,0,2,1,1,0,0,0,0,0,0,0,0,0
214041,38000,380,0,-2,2,2,0,0,0,0,0,0,0,0,0,0,0,0,0,0,0,0,2,2,0,0,0,0,0,0,0,0,0,0
214157,38000,380,0,-2,1,1,0,0,0,0,0,0,0,0,0,0,0,0,0,0,0,0,1,1,0,0,0,0,0,0,0,0,0,0
214564,38000,380,0,-2,1,1,0,0,0,0,0,0,0,1,1,0,0,0,0,0,0,0,0,0,0,0,0,0,0,0,0,0,0,0
215062,38000,380,0,-2,19,16,3,0,0,0,0,0,0,4,4,0,3,2,1,0,0,0,11,9,2,0,0,0,1,1,0,0,0,0
215239,38000,380,0,-2,2,2,0,0,0,0,0,0,0,1,1,0,0,0,0,0,0,0,1,1,0,0,0,0,0,0,0,0,0,0
215266,38000,380,0,-2,1,1,0,0,0,0,0,0,0,0,0,0,1,1,0,0,0,0,0,0,0,0,0,0,0,0,0,0,0,0
215275,38000,380,0,-2,2,2,0,0,0,0,0,0,0,0,0,0,0,0,0,0,0,0,2,2,0,0,0,0,0,0,0,0,0,0
215293,38000,380,0,-2,9,9,0,0,0,0,0,0,0,0,0,0,0,0,0,0,0,0,8,8,0,0,0,0,1,1,0,0,0,0
215309,38000,380,0,-2,2,2,0,0,0,0,0,0,0,0,0,0,0,0,0,0,0,0,1,1,0,0,0,0,1,1,0,0,0,0
215442,38000,380,0,-2,1,1,0,0,0,0,0,0,0,0,0,0,0,0,0,0,0,0,1,1,0,0,0,0,0,0,0,0,0,0
215655,38000,380,0,-2,2,2,0,0,0,0,0,0,0,0,0,0,2,2,0,0,0,0,0,0,0,0,0,0,0,0,0,0,0,0
215743,38000,380,0,-2,3,3,0,0,0,0,0,0,0,0,0,0,0,0,0,0,0,0,3,3,0,0,0,0,0,0,0,0,0,0
215770,38000,380,0,-2,4,4,0,0,0,0,1,1,0,1,1,0,0,0,0,0,0,0,2,2,0,0,0,0,0,0,0,0,0,0
215929,38000,380,0,-2,7,5,2,0,0,0,0,0,0,0,0,0,1,0,1,0,0,0,6,5,1,0,0,0,0,0,0,0,0,0
215947,38000,380,0,-2,1,1,0,0,0,0,0,0,0,0,0,0,0,0,0,0,0,0,1,1,0,0,0,0,0,0,0,0,0,0
216038,38000,380,0,-2,8,8,0,0,0,0,0,0,0,0,0,0,0,0,0,0,0,0,8,8,0,0,0,0,0,0,0,0,0,0
216287,38000,380,0,-2,1,1,0,0,0,0,0,0,0,0,0,0,0,0,0,0,0,0,1,1,0,0,0,0,0,0,0,0,0,0
216339,38000,380,0,-2,5,5,0,0,0,0,0,0,0,0,0,0,1,1,0,0,0,0,4,4,0,0,0,0,0,0,0,0,0,0
216357,38000,380,0,-2,5,5,0,0,0,0,0,0,0,0,0,0,0,0,0,0,0,0,5,5,0,0,0,0,0,0,0,0,0,0
216366,38000,380,0,-2,8,7,1,0,0,0,0,0,0,3,3,0,0,0,0,0,0,0,5,4,1,0,0,0,0,0,0,0,0,0
216542,38000,380,0,-2,5,5,0,0,0,0,0,0,0,0,0,0,2,2,0,0,0,0,3,3,0,0,0,0,0,0,0,0,0,0
216597,38000,380,0,-2,6,6,0,0,0,0,0,0,0,0,0,0,0,0,0,0,0,0,6,6,0,0,0,0,0,0,0,0,0,0
216667,38000,380,0,-2,1,1,0,0,0,0,0,0,0,0,0,0,0,0,0,0,0,0,1,1,0,0,0,0,0,0,0,0,0,0
216764,38000,380,0,-2,2,2,0,0,0,0,1,1,0,0,0,0,0,0,0,0,0,0,1,1,0,0,0,0,0,0,0,0,0,0
216782,38000,380,0,-2,1,1,0,0,0,0,0,0,0,1,1,0,0,0,0,0,0,0,0,0,0,0,0,0,0,0,0,0,0,0
216807,38000,380,0,-2,2,2,0,0,0,0,0,0,0,0,0,0,0,0,0,0,0,0,2,2,0,0,0,0,0,0,0,0,0,0
216931,38000,380,0,-2,1,1,0,0,0,0,0,0,0,0,0,0,0,0,0,0,0,0,1,1,0,0,0,0,0,0,0,0,0,0
217156,38000,380,0,-2,10,10,0,0,0,0,0,0,0,0,0,0,0,0,0,0,0,0,10,10,0,0,0,0,0,0,0,0,0,0
217235,38000,380,0,-2,3,2,1,0,0,0,0,0,0,0,0,0,1,1,0,0,0,0,2,1,1,0,0,0,0,0,0,0,0,0
217402,38000,380,0,-2,1,1,0,0,0,0,0,0,0,0,0,0,0,0,0,0,0,0,1,1,0,0,0,0,0,0,0,0,0,0
217420,38000,380,0,-2,3,3,0,0,0,0,0,0,0,1,1,0,0,0,0,0,0,0,2,2,0,0,0,0,0,0,0,0,0,0
217484,38000,380,0,-2,3,3,0,0,0,0,0,0,0,0,0,0,0,0,0,0,0,0,3,3,0,0,0,0,0,0,0,0,0,0
217493,38000,380,0,-2,6,3,3,0,0,0,0,0,0,0,0,0,0,0,0,0,0,0,4,2,2,0,0,0,2,1,1,0,0,0
217518,38000,380,0,-2,1,1,0,0,0,0,0,0,0,0,0,0,0,0,0,0,0,0,1,1,0,0,0,0,0,0,0,0,0,0
217536,38000,380,0,-2,1,0,1,0,0,0,0,0,0,0,0,0,0,0,0,0,0,0,1,0,1,0,0,0,0,0,0,0,0,0
217624,38000,380,0,-2,7,5,2,0,0,0,0,0,0,7,5,2,0,0,0,0,0,0,0,0,0,0,0,0,0,0,0,0,0,0
217633,38000,380,0,-2,5,5,0,0,0,0,0,0,0,0,0,0,0,0,0,0,0,0,5,5,0,0,0,0,0,0,0,0,0,0
217749,38000,380,0,-2,1,1,0,0,0,0,0,0,0,0,0,0,1,1,0,0,0,0,0,0,0,0,0,0,0,0,0,0,0,0
217819,38000,380,0,-2,6,6,0,0,0,0,0,0,0,1,1,0,0,0,0,0,0,0,4,4,0,1,1,0,0,0,0,0,0,0
217864,38000,380,0,-2,2,2,0,0,0,0,0,0,0,0,0,0,0,0,0,0,0,0,1,1,0,0,0,0,1,1,0,0,0,0
217882,38000,380,0,-2,66,47,19,0,0,0,0,0,0,0,0,0,0,0,0,0,0,0,64,46,18,0,0,0,0,0,0,2,1,1
217925,38000,380,0,-2,1,1,0,0,0,0,0,0,0,0,0,0,0,0,0,0,0,0,1,1,0,0,0,0,0,0,0,0,0,0
218061,38000,380,0,-2,2,2,0,0,0,0,0,0,0,1,1,0,0,0,0,0,0,0,1,1,0,0,0,0,0,0,0,0,0,0
218229,38000,380,0,-2,12,10,2,0,0,0,0,0,0,3,2,1,0,0,0,0,0,0,9,8,1,0,0,0,0,0,0,0,0,0
218353,38000,380,0,-2,4,4,0,0,0,0,0,0,0,2,2,0,0,0,0,0,0,0,2,2,0,0,0,0,0,0,0,0,0,0
218441,38000,380,0,-2,7,7,0,0,0,0,0,0,0,0,0,0,1,1,0,0,0,0,6,6,0,0,0,0,0,0,0,0,0,0
218487,38000,380,0,-2,1,1,0,0,0,0,0,0,0,0,0,0,0,0,0,0,0,0,1,1,0,0,0,0,0,0,0,0,0,0
218539,38000,380,0,-2,1,1,0,0,0,0,0,0,0,0,0,0,0,0,0,0,0,0,1,1,0,0,0,0,0,0,0,0,0,0
218645,38000,380,0,-2,2,2,0,0,0,0,0,0,0,0,0,0,0,0,0,0,0,0,2,2,0,0,0,0,0,0,0,0,0,0
218654,38000,380,0,-2,1,1,0,0,0,0,0,0,0,0,0,0,0,0,0,0,0,0,1,1,0,0,0,0,0,0,0,0,0,0
218663,38000,380,0,-2,12,11,1,0,0,0,0,0,0,3,3,0,1,1,0,0,0,0,7,6,1,0,0,0,0,0,0,1,1,0
218724,38000,380,0,-2,9,9,0,0,0,0,0,0,0,0,0,0,1,1,0,0,0,0,8,8,0,0,0,0,0,0,0,0,0,0
218830,38000,380,0,-2,1,1,0,0,0,0,0,0,0,0,0,0,0,0,0,0,0,0,1,1,0,0,0,0,0,0,0,0,0,0
218858,38000,380,0,-2,2,2,0,0,0,0,0,0,0,0,0,0,0,0,0,0,0,0,2,2,0,0,0,0,0,0,0,0,0,0
218885,38000,380,0,-2,1,1,0,0,0,0,0,0,0,0,0,0,0,0,0,0,0,0,1,1,0,0,0,0,0,0,0,0,0,0
218894,38000,380,0,-2,1,1,0,0,0,0,0,0,0,0,0,0,0,0,0,0,0,0,1,1,0,0,0,0,0,0,0,0,0,0
218964,38000,380,0,-2,2,2,0,0,0,0,0,0,0,0,0,0,0,0,0,0,0,0,2,2,0,0,0,0,0,0,0,0,0,0
218973,38000,380,0,-2,2,2,0,0,0,0,0,0,0,1,1,0,0,0,0,0,0,0,1,1,0,0,0,0,0,0,0,0,0,0
219000,38000,380,0,-2,2,2,0,0,0,0,0,0,0,0,0,0,0,0,0,0,0,0,2,2,0,0,0,0,0,0,0,0,0,0
219143,38000,380,0,-2,1,1,0,0,0,0,0,0,0,0,0,0,0,0,0,0,0,0,1,1,0,0,0,0,0,0,0,0,0,0
219356,38000,380,0,-2,8,8,0,0,0,0,0,0,0,0,0,0,0,0,0,0,0,0,8,8,0,0,0,0,0,0,0,0,0,0
219374,38000,380,0,-2,2,2,0,2,2,0,0,0,0,0,0,0,0,0,0,0,0,0,0,0,0,0,0,0,0,0,0,0,0,0
219471,38000,380,0,-2,1,1,0,0,0,0,0,0,0,0,0,0,0,0,0,0,0,0,1,1,0,0,0,0,0,0,0,0,0,0
219505,38000,380,0,-2,2,2,0,0,0,0,0,0,0,1,1,0,1,1,0,0,0,0,0,0,0,0,0,0,0,0,0,0,0,0
219602,38000,380,0,-2,5,5,0,0,0,0,0,0,0,0,0,0,1,1,0,0,0,0,3,3,0,0,0,0,1,1,0,0,0,0
219709,38000,380,0,-2,2,2,0,0,0,0,0,0,0,0,0,0,1,1,0,0,0,0,0,0,0,0,0,0,1,1,0,0,0,0
219790,38000,380,0,-2,1,1,0,0,0,0,0,0,0,0,0,0,0,0,0,0,0,0,1,1,0,0,0,0,0,0,0,0,0,0
219824,38000,380,0,-2,4,3,1,0,0,0,0,0,0,0,0,0,0,0,0,0,0,0,4,3,1,0,0,0,0,0,0,0,0,0
219976,38000,380,0,-2,3,3,0,0,0,0,0,0,0,0,0,0,0,0,0,0,0,0,0,0,0,0,0,0,3,3,0,0,0,0
220075,38000,380,0,-2,21,16,5,1,1,0,0,0,0,1,1,0,1,0,1,0,0,0,18,14,4,0,0,0,0,0,0,0,0,0
220215,38000,380,0,-2,1,1,0,0,0,0,0,0,0,0,0,0,0,0,0,0,0,0,1,1,0,0,0,0,0,0,0,0,0,0
220516,38000,380,0,-2,1,1,0,0,0,0,0,0,0,0,0,0,0,0,0,0,0,0,1,1,0,0,0,0,0,0,0,0,0,0
220631,38000,380,0,-2,2,2,0,0,0,0,0,0,0,0,0,0,0,0,0,0,0,0,2,2,0,0,0,0,0,0,0,0,0,0
220710,38000,380,0,-2,3,3,0,0,0,0,0,0,0,0,0,0,0,0,0,0,0,0,3,3,0,0,0,0,0,0,0,0,0,0
220862,38000,380,0,-2,6,4,2,0,0,0,0,0,0,3,3,0,0,0,0,0,0,0,2,1,1,1,0,1,0,0,0,0,0,0
220978,38000,380,0,-2,8,8,0,0,0,0,0,0,0,1,1,0,0,0,0,0,0,0,5,5,0,1,1,0,0,0,0,1,1,0
221096,38000,380,0,-2,1,1,0,0,0,0,0,0,0,0,0,0,0,0,0,0,0,0,1,1,0,0,0,0,0,0,0,0,0,0
221351,38000,380,0,-2,2,2,0,0,0,0,0,0,0,1,1,0,0,0,0,0,0,0,1,1,0,0,0,0,0,0,0,0,0,0
221397,38000,380,0,-2,1,1,0,0,0,0,0,0,0,0,0,0,0,0,0,0,0,0,1,1,0,0,0,0,0,0,0,0,0,0
221519,38000,380,0,-2,5,3,2,0,0,0,0,0,0,0,0,0,0,0,0,0,0,0,5,3,2,0,0,0,0,0,0,0,0,0
221643,38000,380,0,-2,2,2,0,0,0,0,0,0,0,0,0,0,0,0,0,0,0,0,2,2,0,0,0,0,0,0,0,0,0,0
221661,38000,380,0,-2,1,1,0,0,0,0,0,0,0,0,0,0,0,0,0,0,0,0,1,1,0,0,0,0,0,0,0,0,0,0
221670,38000,380,0,-2,1,1,0,0,0,0,0,0,0,0,0,0,0,0,0,0,0,0,1,1,0,0,0,0,0,0,0,0,0,0
221740,38000,380,0,-2,5,5,0,0,0,0,0,0,0,0,0,0,0,0,0,0,0,0,5,5,0,0,0,0,0,0,0,0,0,0
221759,38000,380,0,-2,27,23,4,0,0,0,0,0,0,1,0,1,0,0,0,0,0,0,26,23,3,0,0,0,0,0,0,0,0,0
221768,38000,380,0,-2,1,1,0,0,0,0,0,0,0,0,0,0,0,0,0,0,0,0,1,1,0,0,0,0,0,0,0,0,0,0
221838,38000,380,0,-2,4,4,0,0,0,0,0,0,0,4,4,0,0,0,0,0,0,0,0,0,0,0,0,0,0,0,0,0,0,0
221847,38000,380,0,-2,6,5,1,0,0,0,0,0,0,0,0,0,1,1,0,0,0,0,5,4,1,0,0,0,0,0,0,0,0,0
221999,38000,380,0,-2,13,11,2,0,0,0,2,1,1,3,2,1,0,0,0,0,0,0,8,8,0,0,0,0,0,0,0,0,0,0
222178,38000,380,0,-2,2,0,2,0,0,0,0,0,0,0,0,0,0,0,0,0,0,0,2,0,2,0,0,0,0,0,0,0,0,0
222567,38000,380,0,-2,1,1,0,0,0,0,0,0,0,0,0,0,0,0,0,0,0,0,1,1,0,0,0,0,0,0,0,0,0,0
222576,38000,380,0,-2,3,3,0,1,1,0,0,0,0,0,0,0,0,0,0,0,0,0,2,2,0,0,0,0,0,0,0,0,0,0
222831,38000,380,0,-2,3,3,0,0,0,0,0,0,0,0,0,0,1,1,0,0,0,0,2,2,0,0,0,0,0,0,0,0,0,0
222983,38000,380,0,-2,3,3,0,0,0,0,0,0,0,0,0,0,0,0,0,0,0,0,2,2,0,0,0,0,1,1,0,0,0,0
222992,38000,380,0,-2,5,5,0,0,0,0,1,1,0,1,1,0,3,3,0,0,0,0,0,0,0,0,0,0,0,0,0,0,0,0
223223,38000,380,0,-2,3,3,0,0,0,0,0,0,0,0,0,0,3,3,0,0,0,0,0,0,0,0,0,0,0,0,0,0,0,0
223232,38000,380,0,-2,1,1,0,0,0,0,0,0,0,0,0,0,0,0,0,0,0,0,1,1,0,0,0,0,0,0,0,0,0,0
223320,38000,380,0,-2,2,2,0,0,0,0,0,0,0,0,0,0,0,0,0,0,0,0,2,2,0,0,0,0,0,0,0,0,0,0
223816,38000,380,0,-2,3,3,0,0,0,0,0,0,0,0,0,0,1,1,0,0,0,0,2,2,0,0,0,0,0,0,0,0,0,0
223922,38000,380,0,-2,1,1,0,0,0,0,0,0,0,0,0,0,0,0,0,0,0,0,1,1,0,0,0,0,0,0,0,0,0,0
224110,38000,380,0,-2,1,1,0,0,0,0,0,0,0,0,0,0,0,0,0,0,0,0,1,1,0,0,0,0,0,0,0,0,0,0
224226,38000,380,0,-2,6,6,0,0,0,0,0,0,0,0,0,0,0,0,0,0,0,0,6,6,0,0,0,0,0,0,0,0,0,0
224961,38000,380,0,-2,1,1,0,0,0,0,0,0,0,0,0,0,1,1,0,0,0,0,0,0,0,0,0,0,0,0,0,0,0,0
225247,38000,380,0,-2,3,2,1,0,0,0,0,0,0,0,0,0,0,0,0,0,0,0,3,2,1,0,0,0,0,0,0,0,0,0
225308,38000,380,0,-2,1,1,0,0,0,0,0,0,0,0,0,0,0,0,0,0,0,0,1,1,0,0,0,0,0,0,0,0,0,0
225399,38000,380,0,-2,2,2,0,0,0,0,0,0,0,0,0,0,2,2,0,0,0,0,0,0,0,0,0,0,0,0,0,0,0,0
225414,38000,380,0,-2,1,1,0,0,0,0,0,0,0,0,0,0,1,1,0,0,0,0,0,0,0,0,0,0,0,0,0,0,0,0
225432,38000,380,0,-2,2,2,0,0,0,0,0,0,0,1,1,0,1,1,0,0,0,0,0,0,0,0,0,0,0,0,0,0,0,0
225511,38000,380,0,-2,17,17,0,0,0,0,3,3,0,3,3,0,7,7,0,0,0,0,3,3,0,0,0,0,1,1,0,0,0,0
225627,38000,380,0,-2,4,3,1,0,0,0,0,0,0,0,0,0,2,1,1,0,0,0,1,1,0,1,1,0,0,0,0,0,0,0
225876,38000,380,0,-2,1,1,0,0,0,0,0,0,0,0,0,0,0,0,0,0,0,0,1,1,0,0,0,0,0,0,0,0,0,0
226091,38000,380,0,-2,3,3,0,0,0,0,0,0,0,0,0,0,0,0,0,0,0,0,3,3,0,0,0,0,0,0,0,0,0,0
226116,38000,380,0,-2,1,1,0,0,0,0,0,0,0,0,0,0,0,0,0,0,0,0,1,1,0,0,0,0,0,0,0,0,0,0
226134,38000,380,0,-2,4,4,0,0,0,0,0,0,0,0,0,0,4,4,0,0,0,0,0,0,0,0,0,0,0,0,0,0,0,0
226204,38000,380,0,-2,1,1,0,0,0,0,0,0,0,0,0,0,1,1,0,0,0,0,0,0,0,0,0,0,0,0,0,0,0,0
226231,38000,380,0,-2,3,3,0,0,0,0,0,0,0,0,0,0,0,0,0,0,0,0,3,3,0,0,0,0,0,0,0,0,0,0
226587,38000,380,0,-2,1,1,0,0,0,0,0,0,0,0,0,0,0,0,0,0,0,0,0,0,0,1,1,0,0,0,0,0,0,0
226833,38000,380,0,-2,4,4,0,0,0,0,0,0,0,0,0,0,0,0,0,0,0,0,4,4,0,0,0,0,0,0,0,0,0,0
227146,38000,380,0,-2,1,1,0,0,0,0,0,0,0,0,0,0,1,1,0,0,0,0,0,0,0,0,0,0,0,0,0,0,0,0
227182,38000,380,0,-2,3,3,0,0,0,0,0,0,0,0,0,0,2,2,0,0,0,0,1,1,0,0,0,0,0,0,0,0,0,0
227216,38000,380,0,-2,14,12,2,1,1,0,0,0,0,0,0,0,2,1,1,0,0,0,9,8,1,0,0,0,2,2,0,0,0,0
227304,38000,380,0,-2,1,1,0,0,0,0,0,0,0,0,0,0,1,1,0,0,0,0,0,0,0,0,0,0,0,0,0,0,0,0
227368,38000,380,0,-2,9,8,1,0,0,0,0,0,0,0,0,0,8,7,1,0,0,0,1,1,0,0,0,0,0,0,0,0,0,0
227526,38000,380,0,-2,2,2,0,0,0,0,0,0,0,0,0,0,1,1,0,0,0,0,1,1,0,0,0,0,0,0,0,0,0,0
227757,38000,380,0,-2,1,1,0,0,0,0,0,0,0,0,0,0,1,1,0,0,0,0,0,0,0,0,0,0,0,0,0,0,0,0
227845,38000,380,0,-2,1,1,0,0,0,0,0,0,0,0,0,0,1,1,0,0,0,0,0,0,0,0,0,0,0,0,0,0,0,0
227863,38000,380,0,-2,1,1,0,0,0,0,0,0,0,0,0,0,1,1,0,0,0,0,0,0,0,0,0,0,0,0,0,0,0,0
227881,38000,380,0,-2,7,7,0,0,0,0,0,0,0,2,2,0,2,2,0,0,0,0,3,3,0,0,0,0,0,0,0,0,0,0
227979,38000,380,0,-2,1,1,0,0,0,0,0,0,0,0,0,0,1,1,0,0,0,0,0,0,0,0,0,0,0,0,0,0,0,0
228042,38000,380,0,-2,2,2,0,0,0,0,0,0,0,0,0,0,2,2,0,0,0,0,0,0,0,0,0,0,0,0,0,0,0,0
228158,38000,380,0,-2,1,1,0,0,0,0,0,0,0,0,0,0,0,0,0,0,0,0,1,1,0,0,0,0,0,0,0,0,0,0
228246,38000,380,0,-2,3,3,0,0,0,0,2,2,0,0,0,0,1,1,0,0,0,0,0,0,0,0,0,0,0,0,0,0,0,0
228316,38000,380,0,-2,2,2,0,0,0,0,0,0,0,0,0,0,2,2,0,0,0,0,0,0,0,0,0,0,0,0,0,0,0,0
228343,38000,380,0,-2,2,2,0,0,0,0,0,0,0,0,0,0,0,0,0,0,0,0,2,2,0,0,0,0,0,0,0,0,0,0
228431,38000,380,0,-2,1,1,0,0,0,0,0,0,0,0,0,0,0,0,0,0,0,0,1,1,0,0,0,0,0,0,0,0,0,0
228459,38000,380,0,-2,6,5,1,0,0,0,0,0,0,0,0,0,5,4,1,0,0,0,1,1,0,0,0,0,0,0,0,0,0,0
228468,38000,380,0,-2,1,1,0,0,0,0,0,0,0,0,0,0,0,0,0,0,0,0,1,1,0,0,0,0,0,0,0,0,0,0
228501,38000,380,0,-2,2,2,0,0,0,0,0,0,0,0,0,0,2,2,0,0,0,0,0,0,0,0,0,0,0,0,0,0,0,0
228529,38000,380,0,-2,1,1,0,0,0,0,0,0,0,0,0,0,0,0,0,0,0,0,1,1,0,0,0,0,0,0,0,0,0,0
228547,38000,380,0,-2,4,4,0,0,0,0,0,0,0,1,1,0,1,1,0,0,0,0,2,2,0,0,0,0,0,0,0,0,0,0
228635,38000,380,0,-2,40,35,5,0,0,0,11,9,2,11,9,2,6,6,0,0,0,0,12,11,1,0,0,0,0,0,0,0,0,0
228644,38000,380,0,-2,11,11,0,0,0,0,0,0,0,1,1,0,0,0,0,0,0,0,3,3,0,0,0,0,7,7,0,0,0,0
228653,38000,380,0,-2,6,4,2,0,0,0,0,0,0,1,1,0,1,1,0,0,0,0,4,2,2,0,0,0,0,0,0,0,0,0
228723,38000,380,0,-2,10,10,0,0,0,0,1,1,0,0,0,0,2,2,0,0,0,0,7,7,0,0,0,0,0,0,0,0,0,0
228769,38000,380,0,-2,18,13,5,0,0,0,0,0,0,0,0,0,2,2,0,0,0,0,4,2,2,0,0,0,12,9,3,0,0,0
228778,38000,380,0,-2,47,46,1,2,2,0,1,1,0,1,1,0,8,8,0,0,0,0,32,32,0,2,1,1,0,0,0,1,1,0
228787,38000,380,0,-2,10,10,0,1,1,0,0,0,0,0,0,0,1,1,0,0,0,0,6,6,0,2,2,0,0,0,0,0,0,0
228796,38000,380,0,-2,2,2,0,0,0,0,0,0,0,0,0,0,2,2,0,0,0,0,0,0,0,0,0,0,0,0,0,0,0,0
228802,38000,380,0,-2,15,14,1,0,0,0,0,0,0,2,2,0,1,1,0,0,0,0,12,11,1,0,0,0,0,0,0,0,0,0
228875,38000,380,0,-2,7,6,1,0,0,0,0,0,0,0,0,0,3,3,0,0,0,0,4,3,1,0,0,0,0,0,0,0,0,0
228909,38000,380,0,-2,2,1,1,0,0,0,0,0,0,0,0,0,1,0,1,0,0,0,1,1,0,0,0,0,0,0,0,0,0,0
229027,38000,380,0,-2,10,10,0,0,0,0,0,0,0,1,1,0,2,2,0,0,0,0,2,2,0,0,0,0,5,5,0,0,0,0
229063,38000,380,0,-2,1,1,0,0,0,0,0,0,0,1,1,0,0,0,0,0,0,0,0,0,0,0,0,0,0,0,0,0,0,0
229090,38000,380,0,-2,1,0,1,0,0,0,0,0,0,0,0,0,0,0,0,0,0,0,1,0,1,0,0,0,0,0,0,0,0,0
229115,38000,380,0,-2,9,9,0,0,0,0,0,0,0,0,0,0,4,4,0,0,0,0,5,5,0,0,0,0,0,0,0,0,0,0
229179,38000,380,0,-2,1,1,0,0,0,0,0,0,0,0,0,0,0,0,0,0,0,0,0,0,0,0,0,0,1,1,0,0,0,0
229300,38000,380,0,-2,10,10,0,1,1,0,0,0,0,1,1,0,4,4,0,0,0,0,4,4,0,0,0,0,0,0,0,0,0,0
229337,38000,380,0,-2,6,6,0,0,0,0,0,0,0,0,0,0,1,1,0,0,0,0,5,5,0,0,0,0,0,0,0,0,0,0
229355,38000,380,0,-2,2,2,0,0,0,0,0,0,0,0,0,0,1,1,0,0,0,0,1,1,0,0,0,0,0,0,0,0,0,0
229504,38000,380,0,-2,1,1,0,0,0,0,0,0,0,0,0,0,0,0,0,0,0,0,1,1,0,0,0,0,0,0,0,0,0,0
230038,38000,380,0,-2,8,7,1,0,0,0,0,0,0,0,0,0,0,0,0,0,0,0,7,6,1,0,0,0,1,1,0,0,0,0
230047,38000,380,0,-2,1,1,0,0,0,0,0,0,0,0,0,0,0,0,0,1,1,0,0,0,0,0,0,0,0,0,0,0,0,0
230171,38000,380,0,-2,3,2,1,0,0,0,0,0,0,0,0,0,1,1,0,0,0,0,2,1,1,0,0,0,0,0,0,0,0,0
230597,38000,380,0,-2,2,2,0,0,0,0,0,0,0,0,0,0,0,0,0,0,0,0,2,2,0,0,0,0,0,0,0,0,0,0
230603,38000,380,0,-2,15,14,1,0,0,0,0,0,0,0,0,0,0,0,0,0,0,0,14,13,1,1,1,0,0,0,0,0,0,0
230728,38000,380,0,-2,13,12,1,0,0,0,0,0,0,0,0,0,2,2,0,0,0,0,11,10,1,0,0,0,0,0,0,0,0,0
230737,38000,380,0,-2,6,6,0,0,0,0,0,0,0,1,1,0,0,0,0,0,0,0,5,5,0,0,0,0,0,0,0,0,0,0
230746,38000,380,0,-2,6,4,2,0,0,0,0,0,0,1,1,0,0,0,0,0,0,0,4,3,1,1,0,1,0,0,0,0,0,0
230764,38000,380,0,-2,29,26,3,0,0,0,0,0,0,0,0,0,4,4,0,0,0,0,22,19,3,1,1,0,2,2,0,0,0,0
230782,38000,380,0,-2,5,5,0,0,0,0,0,0,0,0,0,0,1,1,0,0,0,0,4,4,0,0,0,0,0,0,0,0,0,0
230807,38000,380,0,-2,1,1,0,0,0,0,0,0,0,0,0,0,1,1,0,0,0,0,0,0,0,0,0,0,0,0,0,0,0,0
230852,38000,380,0,-2,1,1,0,0,0,0,0,0,0,0,0,0,0,0,0,0,0,0,0,0,0,0,0,0,1,1,0,0,0,0
230959,38000,380,0,-2,2,2,0,0,0,0,0,0,0,0,0,0,0,0,0,0,0,0,1,1,0,0,0,0,1,1,0,0,0,0
230995,38000,380,0,-2,1,1,0,0,0,0,0,0,0,0,0,0,0,0,0,0,0,0,1,1,0,0,0,0,0,0,0,0,0,0
231059,38000,380,0,-2,1,0,1,0,0,0,0,0,0,0,0,0,0,0,0,0,0,0,1,0,1,0,0,0,0,0,0,0,0,0
231147,38000,380,0,-2,1,1,0,0,0,0,0,0,0,0,0,0,0,0,0,0,0,0,1,1,0,0,0,0,0,0,0,0,0,0
231174,38000,380,0,-2,5,5,0,0,0,0,0,0,0,0,0,0,0,0,0,0,0,0,5,5,0,0,0,0,0,0,0,0,0,0
231420,38000,380,0,-2,1,1,0,0,0,0,0,0,0,0,0,0,0,0,0,0,0,0,1,1,0,0,0,0,0,0,0,0,0,0
231536,38000,380,0,-2,1,1,0,0,0,0,0,0,0,1,1,0,0,0,0,0,0,0,0,0,0,0,0,0,0,0,0,0,0,0
231581,38000,380,0,-2,5,4,1,0,0,0,0,0,0,0,0,0,0,0,0,0,0,0,4,3,1,1,1,0,0,0,0,0,0,0
231624,38000,380,0,-2,9,8,1,1,1,0,0,0,0,0,0,0,0,0,0,0,0,0,4,4,0,1,1,0,3,2,1,0,0,0
231651,38000,380,0,-2,1,1,0,1,1,0,0,0,0,0,0,0,0,0,0,0,0,0,0,0,0,0,0,0,0,0,0,0,0,0
231697,38000,380,0,-2,2,2,0,0,0,0,0,0,0,0,0,0,0,0,0,0,0,0,2,2,0,0,0,0,0,0,0,0,0,0
231882,38000,380,0,-2,3,3,0,0,0,0,0,0,0,1,1,0,0,0,0,0,0,0,2,2,0,0,0,0,0,0,0,0,0,0
231970,38000,380,0,-2,3,3,0,0,0,0,0,0,0,1,1,0,0,0,0,0,0,0,2,2,0,0,0,0,0,0,0,0,0,0
232043,38000,380,0,-2,1,1,0,0,0,0,0,0,0,0,0,0,0,0,0,0,0,0,1,1,0,0,0,0,0,0,0,0,0,0
232089,38000,380,0,-2,2,2,0,0,0,0,0,0,0,0,0,0,0,0,0,0,0,0,1,1,0,0,0,0,1,1,0,0,0,0
232186,38000,380,0,-2,11,11,0,0,0,0,0,0,0,1,1,0,3,3,0,0,0,0,6,6,0,1,1,0,0,0,0,0,0,0
232256,38000,380,0,-2,1,1,0,0,0,0,0,0,0,0,0,0,0,0,0,0,0,0,1,1,0,0,0,0,0,0,0,0,0,0
232308,38000,380,0,-2,1,0,1,0,0,0,0,0,0,0,0,0,0,0,0,0,0,0,1,0,1,0,0,0,0,0,0,0,0,0
232414,38000,380,0,-2,4,4,0,0,0,0,0,0,0,2,2,0,0,0,0,0,0,0,1,1,0,1,1,0,0,0,0,0,0,0
232423,38000,380,0,-2,6,6,0,0,0,0,0,0,0,0,0,0,0,0,0,0,0,0,6,6,0,0,0,0,0,0,0,0,0,0
232557,38000,380,0,-2,25,23,2,1,1,0,0,0,0,1,0,1,0,0,0,0,0,0,23,22,1,0,0,0,0,0,0,0,0,0
232566,38000,380,0,-2,2,2,0,0,0,0,0,0,0,0,0,0,0,0,0,0,0,0,2,2,0,0,0,0,0,0,0,0,0,0
232609,38000,380,0,-2,2,2,0,0,0,0,0,0,0,0,0,0,0,0,0,0,0,0,2,2,0,0,0,0,0,0,0,0,0,0
232672,38000,380,0,-2,2,2,0,0,0,0,0,0,0,0,0,0,0,0,0,0,0,0,2,2,0,0,0,0,0,0,0,0,0,0
232797,38000,380,0,-2,1,1,0,0,0,0,0,0,0,0,0,0,0,0,0,0,0,0,1,1,0,0,0,0,0,0,0,0,0,0
232946,38000,380,0,-2,7,7,0,0,0,0,2,2,0,3,3,0,0,0,0,0,0,0,2,2,0,0,0,0,0,0,0,0,0,0
232982,38000,380,0,-2,3,3,0,0,0,0,0,0,0,1,1,0,0,0,0,0,0,0,2,2,0,0,0,0,0,0,0,0,0,0
233037,38000,380,0,-2,3,3,0,0,0,0,0,0,0,0,0,0,0,0,0,0,0,0,3,3,0,0,0,0,0,0,0,0,0,0
233116,38000,380,0,-2,1,1,0,0,0,0,0,0,0,0,0,0,0,0,0,0,0,0,1,1,0,0,0,0,0,0,0,0,0,0
233277,38000,380,0,-2,4,4,0,0,0,0,0,0,0,0,0,0,0,0,0,0,0,0,4,4,0,0,0,0,0,0,0,0,0,0
233295,38000,380,0,-2,1,1,0,0,0,0,0,0,0,0,0,0,0,0,0,0,0,0,1,1,0,0,0,0,0,0,0,0,0,0
233301,38000,380,0,-2,1,1,0,0,0,0,0,0,0,1,1,0,0,0,0,0,0,0,0,0,0,0,0,0,0,0,0,0,0,0
233374,38000,380,0,-2,7,7,0,0,0,0,0,0,0,0,0,0,0,0,0,0,0,0,7,7,0,0,0,0,0,0,0,0,0,0
233426,38000,380,0,-2,2,2,0,0,0,0,0,0,0,0,0,0,0,0,0,0,0,0,2,2,0,0,0,0,0,0,0,0,0,0
233541,38000,380,0,-2,1,1,0,0,0,0,0,0,0,0,0,0,0,0,0,0,0,0,0,0,0,0,0,0,1,1,0,0,0,0
233639,38000,380,0,-2,1,1,0,0,0,0,0,0,0,0,0,0,0,0,0,0,0,0,1,1,0,0,0,0,0,0,0,0,0,0
233648,38000,380,0,-2,1,1,0,0,0,0,0,0,0,0,0,0,0,0,0,0,0,0,1,1,0,0,0,0,0,0,0,0,0,0
233718,38000,380,0,-2,5,4,1,0,0,0,0,0,0,0,0,0,1,1,0,0,0,0,3,3,0,0,0,0,1,0,1,0,0,0
233772,38000,380,0,-2,1,1,0,0,0,0,0,0,0,0,0,0,0,0,0,0,0,0,1,1,0,0,0,0,0,0,0,0,0,0
233921,38000,380,0,-2,27,26,1,0,0,0,0,0,0,2,2,0,0,0,0,0,0,0,24,24,0,0,0,0,0,0,0,1,0,1
234030,38000,380,0,-2,12,7,5,0,0,0,0,0,0,6,2,4,0,0,0,0,0,0,6,5,1,0,0,0,0,0,0,0,0,0
234076,38000,380,0,-2,38,35,3,0,0,0,0,0,0,3,3,0,1,1,0,0,0,0,30,28,2,2,1,1,2,2,0,0,0,0
234207,38000,380,0,-2,1,1,0,0,0,0,0,0,0,0,0,0,0,0,0,0,0,0,1,1,0,0,0,0,0,0,0,0,0,0
234669,38000,380,0,-2,4,3,1,0,0,0,0,0,0,0,0,0,2,2,0,0,0,0,2,1,1,0,0,0,0,0,0,0,0,0
234696,38000,380,0,-2,1,1,0,0,0,0,0,0,0,0,0,0,0,0,0,0,0,0,0,0,0,0,0,0,1,1,0,0,0,0
234711,38000,380,0,-2,1,1,0,0,0,0,0,0,0,0,0,0,0,0,0,0,0,0,1,1,0,0,0,0,0,0,0,0,0,0
234827,38000,380,0,-2,3,3,0,0,0,0,0,0,0,0,0,0,0,0,0,0,0,0,3,3,0,0,0,0,0,0,0,0,0,0
234933,38000,380,0,-2,1,1,0,0,0,0,1,1,0,0,0,0,0,0,0,0,0,0,0,0,0,0,0,0,0,0,0,0,0,0
234951,38000,380,0,-2,1,1,0,0,0,0,0,0,0,0,0,0,0,0,0,0,0,0,1,1,0,0,0,0,0,0,0,0,0,0
234979,38000,380,0,-2,5,2,3,0,0,0,0,0,0,0,0,0,0,0,0,0,0,0,4,2,2,1,0,1,0,0,0,0,0,0
235097,38000,380,0,-2,6,6,0,0,0,0,0,0,0,0,0,0,0,0,0,0,0,0,6,6,0,0,0,0,0,0,0,0,0,0
235103,38000,380,0,-2,13,12,1,0,0,0,0,0,0,1,0,1,1,1,0,0,0,0,8,8,0,1,1,0,2,2,0,0,0,0
235149,38000,380,0,-2,1,1,0,0,0,0,0,0,0,0,0,0,0,0,0,0,0,0,0,0,0,0,0,0,1,1,0,0,0,0
235167,38000,380,0,-2,1,1,0,0,0,0,0,0,0,0,0,0,0,0,0,0,0,0,0,0,0,0,0,0,1,1,0,0,0,0
235316,38000,380,0,-2,2,2,0,0,0,0,0,0,0,0,0,0,0,0,0,0,0,0,2,2,0,0,0,0,0,0,0,0,0,0
235343,38000,380,0,-2,1,1,0,0,0,0,0,0,0,0,0,0,0,0,0,0,0,0,0,0,0,0,0,0,1,1,0,0,0,0
236188,38000,380,0,-2,1,0,1,0,0,0,0,0,0,0,0,0,0,0,0,0,0,0,1,0,1,0,0,0,0,0,0,0,0,0
236230,38000,380,0,-2,1,1,0,0,0,0,0,0,0,0,0,0,0,0,0,0,0,0,1,1,0,0,0,0,0,0,0,0,0,0
236258,38000,380,0,-2,2,2,0,0,0,0,0,0,0,0,0,0,0,0,0,0,0,0,0,0,0,0,0,0,2,2,0,0,0,0
236328,38000,380,0,-2,3,3,0,0,0,0,0,0,0,0,0,0,0,0,0,0,0,0,3,3,0,0,0,0,0,0,0,0,0,0
236513,38000,380,0,-2,1,1,0,0,0,0,0,0,0,0,0,0,1,1,0,0,0,0,0,0,0,0,0,0,0,0,0,0,0,0
236595,38000,380,0,-2,3,3,0,0,0,0,0,0,0,0,0,0,1,1,0,0,0,0,2,2,0,0,0,0,0,0,0,0,0,0
236610,38000,380,0,-2,1,1,0,0,0,0,0,0,0,0,0,0,1,1,0,0,0,0,0,0,0,0,0,0,0,0,0,0,0,0
236656,38000,380,0,-2,3,2,1,0,0,0,0,0,0,0,0,0,1,0,1,0,0,0,1,1,0,1,1,0,0,0,0,0,0,0
236692,38000,380,0,-2,6,6,0,0,0,0,0,0,0,0,0,0,0,0,0,0,0,0,6,6,0,0,0,0,0,0,0,0,0,0
236753,38000,380,0,-2,2,2,0,0,0,0,0,0,0,1,1,0,0,0,0,0,0,0,1,1,0,0,0,0,0,0,0,0,0,0
236939,38000,380,0,-2,5,4,1,0,0,0,0,0,0,0,0,0,1,1,0,0,0,0,1,1,0,0,0,0,3,2,1,0,0,0
236948,38000,380,0,-2,37,37,0,1,1,0,1,1,0,2,2,0,5,5,0,0,0,0,19,19,0,3,3,0,6,6,0,0,0,0
237011,38000,380,0,-2,1,1,0,0,0,0,0,0,0,0,0,0,0,0,0,0,0,0,1,1,0,0,0,0,0,0,0,0,0,0
237057,38000,380,0,-2,2,2,0,0,0,0,0,0,0,0,0,0,0,0,0,0,0,0,2,2,0,0,0,0,0,0,0,0,0,0
237066,38000,380,0,-2,1,1,0,0,0,0,1,1,0,0,0,0,0,0,0,0,0,0,0,0,0,0,0,0,0,0,0,0,0,0
237109,38000,380,0,-2,2,2,0,0,0,0,0,0,0,0,0,0,1,1,0,0,0,0,1,1,0,0,0,0,0,0,0,0,0,0
237181,38000,380,0,-2,1,1,0,0,0,0,0,0,0,0,0,0,0,0,0,0,0,0,1,1,0,0,0,0,0,0,0,0,0,0
237330,38000,380,0,-2,1,1,0,0,0,0,0,0,0,0,0,0,0,0,0,0,0,0,1,1,0,0,0,0,0,0,0,0,0,0
237367,38000,380,0,-2,1,1,0,0,0,0,0,0,0,0,0,0,0,0,0,0,0,0,1,1,0,0,0,0,0,0,0,0,0,0
237525,38000,380,0,-2,1,1,0,0,0,0,0,0,0,0,0,0,0,0,0,0,0,0,1,1,0,0,0,0,0,0,0,0,0,0
237686,38000,380,0,-2,3,1,2,0,0,0,0,0,0,0,0,0,0,0,0,0,0,0,3,1,2,0,0,0,0,0,0,0,0,0
237701,38000,380,0,-2,1,1,0,0,0,0,0,0,0,0,0,0,0,0,0,0,0,0,0,0,0,0,0,0,1,1,0,0,0,0
237783,38000,380,0,-2,1,0,1,0,0,0,0,0,0,0,0,0,0,0,0,0,0,0,1,0,1,0,0,0,0,0,0,0,0,0
237792,38000,380,0,-2,1,0,1,0,0,0,0,0,0,0,0,0,0,0,0,0,0,0,1,0,1,0,0,0,0,0,0,0,0,0
237817,38000,380,0,-2,1,1,0,0,0,0,0,0,0,0,0,0,0,0,0,0,0,0,1,1,0,0,0,0,0,0,0,0,0,0
237880,38000,380,0,-2,3,2,1,0,0,0,0,0,0,0,0,0,0,0,0,0,0,0,3,2,1,0,0,0,0,0,0,0,0,0
237950,38000,380,0,-2,1,1,0,0,0,0,0,0,0,0,0,0,0,0,0,0,0,0,1,1,0,0,0,0,0,0,0,0,0,0
237969,38000,380,0,-2,2,2,0,0,0,0,0,0,0,0,0,0,0,0,0,0,0,0,2,2,0,0,0,0,0,0,0,0,0,0
238032,38000,380,0,-2,2,2,0,0,0,0,0,0,0,0,0,0,0,0,0,0,0,0,2,2,0,0,0,0,0,0,0,0,0,0
238397,38000,380,0,-2,1,1,0,0,0,0,0,0,0,0,0,0,0,0,0,0,0,0,1,1,0,0,0,0,0,0,0,0,0,0
238458,38000,380,0,-2,2,2,0,0,0,0,0,0,0,0,0,0,0,0,0,0,0,0,2,2,0,0,0,0,0,0,0,0,0,0
238476,38000,380,0,-2,2,2,0,0,0,0,0,0,0,0,0,0,0,0,0,0,0,0,0,0,0,0,0,0,2,2,0,0,0,0
238759,38000,380,0,-2,1,1,0,0,0,0,0,0,0,0,0,0,1,1,0,0,0,0,0,0,0,0,0,0,0,0,0,0,0,0
239071,38000,380,0,-2,1,1,0,0,0,0,0,0,0,0,0,0,0,0,0,0,0,0,1,1,0,0,0,0,0,0,0,0,0,0
239105,38000,380,0,-2,3,3,0,0,0,0,0,0,0,0,0,0,0,0,0,0,0,0,3,3,0,0,0,0,0,0,0,0,0,0
239248,38000,380,0,-2,1,0,1,0,0,0,0,0,0,0,0,0,0,0,0,0,0,0,1,0,1,0,0,0,0,0,0,0,0,0
239372,38000,380,0,-2,1,1,0,0,0,0,0,0,0,0,0,0,0,0,0,0,0,0,1,1,0,0,0,0,0,0,0,0,0,0
239424,38000,380,0,-2,1,1,0,0,0,0,0,0,0,0,0,0,1,1,0,0,0,0,0,0,0,0,0,0,0,0,0,0,0,0
239460,38000,380,0,-2,1,1,0,0,0,0,0,0,0,0,0,0,0,0,0,0,0,0,1,1,0,0,0,0,0,0,0,0,0,0
239488,38000,380,0,-2,1,1,0,0,0,0,1,1,0,0,0,0,0,0,0,0,0,0,0,0,0,0,0,0,0,0,0,0,0,0
239716,38000,380,0,-2,2,2,0,0,0,0,0,0,0,0,0,0,0,0,0,0,0,0,2,2,0,0,0,0,0,0,0,0,0,0
239910,38000,380,0,-2,7,6,1,0,0,0,0,0,0,0,0,0,0,0,0,0,0,0,7,6,1,0,0,0,0,0,0,0,0,0
240116,38000,380,0,-2,2,2,0,0,0,0,0,0,0,0,0,0,0,0,0,0,0,0,2,2,0,0,0,0,0,0,0,0,0,0
240125,38000,380,0,-2,2,2,0,0,0,0,0,0,0,0,0,0,0,0,0,0,0,0,2,2,0,0,0,0,0,0,0,0,0,0
240189,38000,380,0,-2,1,1,0,0,0,0,0,0,0,0,0,0,0,0,0,0,0,0,0,0,0,0,0,0,1,1,0,0,0,0
240268,38000,380,0,-2,4,4,0,0,0,0,0,0,0,0,0,0,0,0,0,0,0,0,3,3,0,0,0,0,1,1,0,0,0,0
240277,38000,380,0,-2,4,4,0,0,0,0,0,0,0,0,0,0,1,1,0,0,0,0,2,2,0,1,1,0,0,0,0,0,0,0
240365,38000,380,0,-2,1,1,0,0,0,0,0,0,0,0,0,0,0,0,0,0,0,0,1,1,0,0,0,0,0,0,0,0,0,0
240374,38000,380,0,-2,3,3,0,0,0,0,0,0,0,0,0,0,0,0,0,0,0,0,3,3,0,0,0,0,0,0,0,0,0,0
240426,38000,380,0,-2,1,1,0,0,0,0,0,0,0,0,0,0,0,0,0,0,0,0,1,1,0,0,0,0,0,0,0,0,0,0
240444,38000,380,0,-2,25,24,1,0,0,0,0,0,0,1,1,0,1,1,0,0,0,0,22,21,1,1,1,0,0,0,0,0,0,0
240453,38000,380,0,-2,4,4,0,0,0,0,0,0,0,0,0,0,0,0,0,0,0,0,4,4,0,0,0,0,0,0,0,0,0,0
240471,38000,380,0,-2,8,8,0,0,0,0,0,0,0,1,1,0,0,0,0,0,0,0,7,7,0,0,0,0,0,0,0,0,0,0
240505,38000,380,0,-2,1,1,0,0,0,0,0,0,0,0,0,0,1,1,0,0,0,0,0,0,0,0,0,0,0,0,0,0,0,0
240620,38000,380,0,-2,3,3,0,0,0,0,0,0,0,0,0,0,0,0,0,0,0,0,3,3,0,0,0,0,0,0,0,0,0,0
240727,38000,380,0,-2,8,7,1,0,0,0,0,0,0,0,0,0,0,0,0,0,0,0,4,3,1,0,0,0,4,4,0,0,0,0
240745,38000,380,0,-2,2,2,0,0,0,0,2,2,0,0,0,0,0,0,0,0,0,0,0,0,0,0,0,0,0,0,0,0,0,0
240754,38000,380,0,-2,2,2,0,0,0,0,1,1,0,0,0,0,0,0,0,1,1,0,0,0,0,0,0,0,0,0,0,0,0,0
241191,38000,380,0,-2,1,1,0,0,0,0,0,0,0,0,0,0,1,1,0,0,0,0,0,0,0,0,0,0,0,0,0,0,0,0
241395,38000,380,0,-2,1,1,0,0,0,0,0,0,0,0,0,0,1,1,0,0,0,0,0,0,0,0,0,0,0,0,0,0,0,0
241836,38000,380,0,-2,1,1,0,0,0,0,0,0,0,0,0,0,1,1,0,0,0,0,0,0,0,0,0,0,0,0,0,0,0,0
242112,38000,380,0,-2,1,1,0,0,0,0,0,0,0,0,0,0,1,1,0,0,0,0,0,0,0,0,0,0,0,0,0,0,0,0
242565,38000,380,0,-2,4,2,2,0,0,0,0,0,0,0,0,0,4,2,2,0,0,0,0,0,0,0,0,0,0,0,0,0,0,0
243197,38000,380,0,-2,17,14,3,0,0,0,0,0,0,0,0,0,15,13,2,0,0,0,0,0,0,0,0,0,2,1,1,0,0,0
243443,38000,380,0,-2,4,4,0,0,0,0,0,0,0,0,0,0,4,4,0,0,0,0,0,0,0,0,0,0,0,0,0,0,0,0
243638,38000,380,0,-2,3,3,0,0,0,0,0,0,0,0,0,0,0,0,0,3,3,0,0,0,0,0,0,0,0,0,0,0,0,0
243647,38000,380,0,-2,1,1,0,0,0,0,0,0,0,0,0,0,0,0,0,1,1,0,0,0,0,0,0,0,0,0,0,0,0,0
243744,38000,380,0,-2,30,22,8,0,0,0,2,1,1,0,0,0,6,6,0,0,0,0,8,3,5,0,0,0,13,12,1,1,0,1
243780,38000,380,0,-2,14,14,0,0,0,0,0,0,0,1,1,0,1,1,0,0,0,0,11,11,0,0,0,0,1,1,0,0,0,0
246354,38000,380,0,-2,1,1,0,0,0,0,0,0,0,0,0,0,0,0,0,0,0,0,0,0,0,1,1,0,0,0,0,0,0,0
247649,38000,380,0,-2,1,1,0,0,0,0,0,0,0,0,0,0,0,0,0,0,0,0,1,1,0,0,0,0,0,0,0,0,0,0
247834,38000,380,0,-2,9,8,1,0,0,0,2,1,1,1,1,0,0,0,0,0,0,0,5,5,0,0,0,0,1,1,0,0,0,0
250027,38000,380,0,-2,1,0,1,0,0,0,0,0,0,0,0,0,0,0,0,0,0,0,1,0,1,0,0,0,0,0,0,0,0,0
366252,38000,380,0,-2,7,6,1,0,0,0,0,0,0,0,0,0,0,0,0,0,0,0,7,6,1,0,0,0,0,0,0,0,0,0
366395,38000,380,0,-2,1,1,0,0,0,0,1,1,0,0,0,0,0,0,0,0,0,0,0,0,0,0,0,0,0,0,0,0,0,0
369400,38000,380,0,-2,1,1,0,0,0,0,0,0,0,0,0,0,1,1,0,0,0,0,0,0,0,0,0,0,0,0,0,0,0,0
376695,38000,380,0,-2,2,2,0,0,0,0,0,0,0,0,0,0,0,0,0,2,2,0,0,0,0,0,0,0,0,0,0,0,0,0
380359,38000,380,0,-2,1,0,1,0,0,0,0,0,0,0,0,0,0,0,0,0,0,0,1,0,1,0,0,0,0,0,0,0,0,0
384342,38000,380,0,-2,1,1,0,0,0,0,0,0,0,0,0,0,0,0,0,0,0,0,1,1,0,0,0,0,0,0,0,0,0,0
385415,38000,380,0,-2,3,3,0,0,0,0,1,1,0,1,1,0,1,1,0,0,0,0,0,0,0,0,0,0,0,0,0,0,0,0
407629,38000,380,0,-2,3,3,0,0,0,0,0,0,0,1,1,0,0,0,0,0,0,0,2,2,0,0,0,0,0,0,0,0,0,0
408844,38000,380,0,-2,5,5,0,0,0,0,0,0,0,0,0,0,5,5,0,0,0,0,0,0,0,0,0,0,0,0,0,0,0,0
409698,38000,380,0,-2,1,1,0,0,0,0,0,0,0,0,0,0,1,1,0,0,0,0,0,0,0,0,0,0,0,0,0,0,0,0
414461,38000,380,0,-2,10,7,3,0,0,0,0,0,0,0,0,0,10,7,3,0,0,0,0,0,0,0,0,0,0,0,0,0,0,0
420538,38000,380,0,-2,1,1,0,0,0,0,0,0,0,0,0,0,0,0,0,0,0,0,1,1,0,0,0,0,0,0,0,0,0,0
433420,38000,380,0,-2,1,1,0,0,0,0,0,0,0,0,0,0,1,1,0,0,0,0,0,0,0,0,0,0,0,0,0,0,0,0
433660,38000,380,0,-2,1,1,0,0,0,0,0,0,0,0,0,0,0,0,0,0,0,0,1,1,0,0,0,0,0,0,0,0,0,0
434061,38000,380,0,-2,1,1,0,0,0,0,0,0,0,1,1,0,0,0,0,0,0,0,0,0,0,0,0,0,0,0,0,0,0,0
434672,38000,380,0,-2,4,4,0,0,0,0,0,0,0,2,2,0,1,1,0,0,0,0,1,1,0,0,0,0,0,0,0,0,0,0
436304,38000,380,0,-2,1,1,0,0,0,0,0,0,0,0,0,0,0,0,0,0,0,0,1,1,0,0,0,0,0,0,0,0,0,0
436429,38000,380,0,-2,4,4,0,0,0,0,1,1,0,0,0,0,2,2,0,0,0,0,1,1,0,0,0,0,0,0,0,0,0,0
438504,38000,380,0,-2,1,1,0,0,0,0,0,0,0,0,0,0,1,1,0,0,0,0,0,0,0,0,0,0,0,0,0,0,0,0
440396,38000,380,0,-2,1,1,0,0,0,0,0,0,0,0,0,0,0,0,0,0,0,0,1,1,0,0,0,0,0,0,0,0,0,0
440916,38000,380,0,-2,1,1,0,0,0,0,0,0,0,1,1,0,0,0,0,0,0,0,0,0,0,0,0,0,0,0,0,0,0,0
441760,38000,380,0,-2,2,2,0,0,0,0,0,0,0,0,0,0,0,0,0,0,0,0,2,2,0,0,0,0,0,0,0,0,0,0
443331,38000,380,0,-2,1,1,0,0,0,0,0,0,0,0,0,0,1,1,0,0,0,0,0,0,0,0,0,0,0,0,0,0,0,0
443711,38000,380,0,-2,2,1,1,0,0,0,0,0,0,0,0,0,0,0,0,0,0,0,1,0,1,0,0,0,1,1,0,0,0,0
445188,38000,380,0,-2,2,2,0,0,0,0,0,0,0,0,0,0,1,1,0,0,0,0,0,0,0,1,1,0,0,0,0,0,0,0
445461,38000,380,0,-2,3,3,0,0,0,0,0,0,0,2,2,0,1,1,0,0,0,0,0,0,0,0,0,0,0,0,0,0,0,0
445708,38000,380,0,-2,1,1,0,0,0,0,0,0,0,0,0,0,0,0,0,0,0,0,0,0,0,0,0,0,1,1,0,0,0,0
445735,38000,380,0,-2,1,1,0,0,0,0,0,0,0,0,0,0,0,0,0,0,0,0,1,1,0,0,0,0,0,0,0,0,0,0
446978,38000,380,0,-2,1,0,1,0,0,0,0,0,0,0,0,0,0,0,0,0,0,0,1,0,1,0,0,0,0,0,0,0,0,0
447582,38000,380,0,-2,2,2,0,0,0,0,0,0,0,0,0,0,0,0,0,0,0,0,2,2,0,0,0,0,0,0,0,0,0,0
455114,38000,380,0,-2,2,2,0,0,0,0,0,0,0,0,0,0,0,0,0,0,0,0,2,2,0,0,0,0,0,0,0,0,0,0
459824,38000,380,0,-2,2,1,1,0,0,0,0,0,0,1,0,1,1,1,0,0,0,0,0,0,0,0,0,0,0,0,0,0,0,0
475608,38000,380,0,-2,1,1,0,0,0,0,0,0,0,0,0,0,0,0,0,0,0,0,1,1,0,0,0,0,0,0,0,0,0,0
480790,38000,380,0,-2,1,1,0,0,0,0,0,0,0,1,1,0,0,0,0,0,0,0,0,0,0,0,0,0,0,0,0,0,0,0
481535,38000,380,0,-2,1,1,0,0,0,0,0,0,0,0,0,0,0,0,0,0,0,0,1,1,0,0,0,0,0,0,0,0,0,0
482149,38000,380,0,-2,1,1,0,0,0,0,0,0,0,0,0,0,0,0,0,0,0,0,0,0,0,1,1,0,0,0,0,0,0,0
482158,38000,380,0,-2,11,10,1,0,0,0,0,0,0,3,3,0,1,0,1,0,0,0,7,7,0,0,0,0,0,0,0,0,0,0
482680,38000,380,0,-2,2,2,0,0,0,0,0,0,0,0,0,0,0,0,0,0,0,0,2,2,0,0,0,0,0,0,0,0,0,0
484002,38000,380,0,-2,3,2,1,0,0,0,0,0,0,0,0,0,1,0,1,0,0,0,2,2,0,0,0,0,0,0,0,0,0,0
486840,38000,380,0,-2,4,4,0,0,0,0,0,0,0,3,3,0,0,0,0,0,0,0,1,1,0,0,0,0,0,0,0,0,0,0
486901,38000,380,0,-2,1,1,0,0,0,0,0,0,0,0,0,0,0,0,0,0,0,0,1,1,0,0,0,0,0,0,0,0,0,0
487010,38000,380,0,-2,3,3,0,0,0,0,0,0,0,2,2,0,0,0,0,0,0,0,1,1,0,0,0,0,0,0,0,0,0,0
487320,38000,380,0,-2,2,2,0,0,0,0,0,0,0,1,1,0,1,1,0,0,0,0,0,0,0,0,0,0,0,0,0,0,0,0
488305,38000,380,0,-2,1,1,0,0,0,0,0,0,0,0,0,0,0,0,0,0,0,0,1,1,0,0,0,0,0,0,0,0,0,0
492476,38000,380,0,-2,1,1,0,0,0,0,0,0,0,0,0,0,1,1,0,0,0,0,0,0,0,0,0,0,0,0,0,0,0,0
492689,38000,380,0,-2,1,1,0,0,0,0,0,0,0,0,0,0,1,1,0,0,0,0,0,0,0,0,0,0,0,0,0,0,0,0
494603,38000,380,0,-2,7,7,0,0,0,0,0,0,0,0,0,0,2,2,0,0,0,0,4,4,0,0,0,0,1,1,0,0,0,0
495767,38000,380,0,-2,16,15,1,0,0,0,0,0,0,0,0,0,0,0,0,0,0,0,16,15,1,0,0,0,0,0,0,0,0,0
100654,39000,390,0,-2,1,0,1,0,0,0,0,0,0,0,0,0,0,0,0,0,0,0,1,0,1,0,0,0,0,0,0,0,0,0
100663,39000,390,0,-2,5,5,0,0,0,0,0,0,0,2,2,0,0,0,0,0,0,0,3,3,0,0,0,0,0,0,0,0,0,0
100724,39000,390,0,-2,2,1,1,0,0,0,0,0,0,0,0,0,0,0,0,0,0,0,0,0,0,0,0,0,2,1,1,0,0,0
100751,39000,390,0,-2,17,12,5,0,0,0,0,0,0,7,4,3,2,1,1,0,0,0,8,7,1,0,0,0,0,0,0,0,0,0
100858,39000,390,0,-2,3,3,0,0,0,0,0,0,0,0,0,0,0,0,0,0,0,0,3,3,0,0,0,0,0,0,0,0,0,0
101480,39000,390,0,-2,2,1,1,0,0,0,1,1,0,0,0,0,0,0,0,0,0,0,1,0,1,0,0,0,0,0,0,0,0,0
102094,39000,390,0,-2,1,1,0,0,0,0,0,0,0,0,0,0,0,0,0,0,0,0,1,1,0,0,0,0,0,0,0,0,0,0
102377,39000,390,0,-2,2,2,0,0,0,0,0,0,0,2,2,0,0,0,0,0,0,0,0,0,0,0,0,0,0,0,0,0,0,0
102553,39000,390,0,-2,1,1,0,0,0,0,0,0,0,0,0,0,0,0,0,0,0,0,1,1,0,0,0,0,0,0,0,0,0,0
102614,39000,390,0,-2,1,1,0,1,1,0,0,0,0,0,0,0,0,0,0,0,0,0,0,0,0,0,0,0,0,0,0,0,0,0
104151,39000,390,0,-2,13,10,3,0,0,0,0,0,0,1,0,1,2,2,0,0,0,0,4,3,1,0,0,0,6,5,1,0,0,0
104179,39000,390,0,-2,4,2,2,0,0,0,0,0,0,0,0,0,2,1,1,0,0,0,2,1,1,0,0,0,0,0,0,0,0,0
104708,39000,390,0,-2,1,0,1,0,0,0,0,0,0,0,0,0,0,0,0,0,0,0,1,0,1,0,0,0,0,0,0,0,0,0
104717,39000,390,0,-2,5,3,2,0,0,0,0,0,0,0,0,0,4,3,1,0,0,0,0,0,0,0,0,0,1,0,1,0,0,0
105330,39000,390,0,-2,8,8,0,2,2,0,0,0,0,0,0,0,1,1,0,0,0,0,5,5,0,0,0,0,0,0,0,0,0,0
105525,39000,390,0,-2,1,1,0,0,0,0,0,0,0,0,0,0,1,1,0,0,0,0,0,0,0,0,0,0,0,0,0,0,0,0
106397,39000,390,0,-2,6,5,1,1,1,0,0,0,0,0,0,0,0,0,0,0,0,0,4,3,1,0,0,0,1,1,0,0,0,0
106458,39000,390,0,-2,1,1,0,0,0,0,0,0,0,0,0,0,0,0,0,0,0,0,1,1,0,0,0,0,0,0,0,0,0,0
106704,39000,390,0,-2,2,2,0,0,0,0,0,0,0,0,0,0,0,0,0,0,0,0,2,2,0,0,0,0,0,0,0,0,0,0
107080,39000,390,0,-2,1,1,0,0,0,0,0,0,0,0,0,0,0,0,0,0,0,0,1,1,0,0,0,0,0,0,0,0,0,0
107141,39000,390,0,-2,1,1,0,0,0,0,0,0,0,0,0,0,0,0,0,0,0,0,1,1,0,0,0,0,0,0,0,0,0,0
107619,39000,390,0,-2,1,0,1,0,0,0,0,0,0,0,0,0,0,0,0,0,0,0,1,0,1,0,0,0,0,0,0,0,0,0
109651,39000,390,0,-2,6,6,0,0,0,0,2,2,0,0,0,0,2,2,0,0,0,0,2,2,0,0,0,0,0,0,0,0,0,0
110361,39000,390,0,-2,4,4,0,0,0,0,0,0,0,0,0,0,3,3,0,0,0,0,1,1,0,0,0,0,0,0,0,0,0,0
110370,39000,390,0,-2,2,1,1,0,0,0,0,0,0,0,0,0,0,0,0,0,0,0,2,1,1,0,0,0,0,0,0,0,0,0
110495,39000,390,0,-2,1,1,0,0,0,0,0,0,0,0,0,0,1,1,0,0,0,0,0,0,0,0,0,0,0,0,0,0,0,0
110529,39000,390,0,-2,2,2,0,0,0,0,0,0,0,1,1,0,0,0,0,0,0,0,1,1,0,0,0,0,0,0,0,0,0,0
110538,39000,390,0,-2,1,1,0,0,0,0,0,0,0,0,0,0,1,1,0,0,0,0,0,0,0,0,0,0,0,0,0,0,0,0
110608,39000,390,0,-2,1,1,0,0,0,0,0,0,0,0,0,0,0,0,0,0,0,0,1,1,0,0,0,0,0,0,0,0,0,0
110617,39000,390,0,-2,1,1,0,0,0,0,0,0,0,0,0,0,0,0,0,0,0,0,1,1,0,0,0,0,0,0,0,0,0,0
110635,39000,390,0,-2,1,0,1,0,0,0,0,0,0,0,0,0,0,0,0,0,0,0,0,0,0,1,0,1,0,0,0,0,0,0
110644,39000,390,0,-2,4,4,0,0,0,0,0,0,0,0,0,0,2,2,0,0,0,0,1,1,0,1,1,0,0,0,0,0,0,0
110653,39000,390,0,-2,3,3,0,0,0,0,0,0,0,1,1,0,0,0,0,1,1,0,1,1,0,0,0,0,0,0,0,0,0,0
110662,39000,390,0,-2,3,3,0,0,0,0,0,0,0,0,0,0,1,1,0,0,0,0,1,1,0,1,1,0,0,0,0,0,0,0
110671,39000,390,0,-2,3,2,1,0,0,0,0,0,0,0,0,0,2,1,1,0,0,0,1,1,0,0,0,0,0,0,0,0,0,0
110680,39000,390,0,-2,7,6,1,0,0,0,1,1,0,0,0,0,2,2,0,0,0,0,3,3,0,0,0,0,1,0,1,0,0,0
110699,39000,390,0,-2,13,13,0,0,0,0,9,9,0,1,1,0,1,1,0,0,0,0,1,1,0,0,0,0,0,0,0,1,1,0
110714,39000,390,0,-2,4,4,0,0,0,0,0,0,0,0,0,0,3,3,0,0,0,0,1,1,0,0,0,0,0,0,0,0,0,0
112084,39000,390,0,-2,1,1,0,0,0,0,0,0,0,0,0,0,0,0,0,0,0,0,1,1,0,0,0,0,0,0,0,0,0,0
112570,39000,390,0,-2,1,1,0,0,0,0,0,0,0,0,0,0,0,0,0,0,0,0,1,1,0,0,0,0,0,0,0,0,0,0
114354,39000,390,0,-2,1,1,0,0,0,0,0,0,0,0,0,0,1,1,0,0,0,0,0,0,0,0,0,0,0,0,0,0,0,0
119678,39000,390,0,-2,1,1,0,0,0,0,1,1,0,0,0,0,0,0,0,0,0,0,0,0,0,0,0,0,0,0,0,0,0,0
120403,39000,390,0,-2,1,1,0,0,0,0,0,0,0,0,0,0,0,0,0,0,0,0,1,1,0,0,0,0,0,0,0,0,0,0
121150,39000,390,0,-2,2,2,0,0,0,0,0,0,0,0,0,0,2,2,0,0,0,0,0,0,0,0,0,0,0,0,0,0,0,0
122409,39000,390,0,-2,4,4,0,0,0,0,0,0,0,0,0,0,1,1,0,0,0,0,2,2,0,0,0,0,1,1,0,0,0,0
122506,39000,390,0,-2,5,2,3,0,0,0,0,0,0,0,0,0,1,1,0,0,0,0,2,0,2,2,1,1,0,0,0,0,0,0
122755,39000,390,0,-2,1,1,0,0,0,0,0,0,0,0,0,0,0,0,0,0,0,0,0,0,0,0,0,0,1,1,0,0,0,0
123961,39000,390,0,-2,22,13,9,0,0,0,0,0,0,6,3,3,14,8,6,0,0,0,2,2,0,0,0,0,0,0,0,0,0,0
126207,39000,390,0,-2,6,5,1,0,0,0,0,0,0,1,0,1,1,1,0,0,0,0,3,3,0,1,1,0,0,0,0,0,0,0
126562,39000,390,0,-2,2,1,1,0,0,0,0,0,0,0,0,0,1,0,1,0,0,0,0,0,0,0,0,0,1,1,0,0,0,0
126580,39000,390,0,-2,1,1,0,0,0,0,0,0,0,0,0,0,0,0,0,0,0,0,1,1,0,0,0,0,0,0,0,0,0,0
126614,39000,390,0,-2,6,5,1,0,0,0,0,0,0,0,0,0,0,0,0,0,0,0,5,4,1,0,0,0,1,1,0,0,0,0
126678,39000,390,0,-2,3,3,0,0,0,0,0,0,0,0,0,0,0,0,0,0,0,0,2,2,0,0,0,0,1,1,0,0,0,0
126818,39000,390,0,-2,6,6,0,0,0,0,0,0,0,0,0,0,0,0,0,0,0,0,6,6,0,0,0,0,0,0,0,0,0,0
127060,39000,390,0,-2,1,1,0,0,0,0,0,0,0,0,0,0,0,0,0,0,0,0,1,1,0,0,0,0,0,0,0,0,0,0
127820,39000,390,0,-2,1,1,0,0,0,0,0,0,0,0,0,0,0,0,0,0,0,0,1,1,0,0,0,0,0,0,0,0,0,0
127909,39000,390,0,-2,1,1,0,0,0,0,0,0,0,0,0,0,1,1,0,0,0,0,0,0,0,0,0,0,0,0,0,0,0,0
129543,39000,390,0,-2,1,1,0,0,0,0,0,0,0,0,0,0,0,0,0,0,0,0,1,1,0,0,0,0,0,0,0,0,0,0
130624,39000,390,0,-2,13,11,2,0,0,0,0,0,0,0,0,0,0,0,0,0,0,0,0,0,0,0,0,0,13,11,2,0,0,0
130934,39000,390,0,-2,1,1,0,0,0,0,0,0,0,1,1,0,0,0,0,0,0,0,0,0,0,0,0,0,0,0,0,0,0,0
130943,39000,390,0,-2,13,8,5,0,0,0,0,0,0,4,2,2,1,0,1,0,0,0,8,6,2,0,0,0,0,0,0,0,0,0
131469,39000,390,0,-2,1,1,0,0,0,0,0,0,0,1,1,0,0,0,0,0,0,0,0,0,0,0,0,0,0,0,0,0,0,0
132657,39000,390,0,-2,1,1,0,0,0,0,0,0,0,0,0,0,0,0,0,0,0,0,1,1,0,0,0,0,0,0,0,0,0,0
133386,39000,390,0,-2,1,1,0,0,0,0,0,0,0,1,1,0,0,0,0,0,0,0,0,0,0,0,0,0,0,0,0,0,0,0
133650,39000,390,0,-2,1,0,1,0,0,0,0,0,0,1,0,1,0,0,0,0,0,0,0,0,0,0,0,0,0,0,0,0,0,0
133881,39000,390,0,-2,2,1,1,0,0,0,0,0,0,0,0,0,2,1,1,0,0,0,0,0,0,0,0,0,0,0,0,0,0,0
134079,39000,390,0,-2,3,3,0,0,0,0,0,0,0,1,1,0,0,0,0,0,0,0,2,2,0,0,0,0,0,0,0,0,0,0
134130,39000,390,0,-2,8,6,2,0,0,0,0,0,0,1,1,0,2,2,0,0,0,0,4,3,1,0,0,0,1,0,1,0,0,0
134237,39000,390,0,-2,2,1,1,0,0,0,0,0,0,0,0,0,1,0,1,0,0,0,1,1,0,0,0,0,0,0,0,0,0,0
135726,39000,390,0,-2,13,7,6,0,0,0,1,0,1,6,2,4,2,2,0,0,0,0,2,2,0,0,0,0,0,0,0,2,1,1
136233,39000,390,0,-2,1,1,0,0,0,0,0,0,0,0,0,0,0,0,0,0,0,0,1,1,0,0,0,0,0,0,0,0,0,0
137078,39000,390,0,-2,1,1,0,0,0,0,0,0,0,1,1,0,0,0,0,0,0,0,0,0,0,0,0,0,0,0,0,0,0,0
137351,39000,390,0,-2,5,4,1,0,0,0,0,0,0,3,3,0,0,0,0,0,0,0,1,0,1,1,1,0,0,0,0,0,0,0
138354,39000,390,0,-2,2,2,0,0,0,0,0,0,0,0,0,0,0,0,0,0,0,0,2,2,0,0,0,0,0,0,0,0,0,0
139144,39000,390,0,-2,2,2,0,0,0,0,0,0,0,0,0,0,0,0,0,0,0,0,2,2,0,0,0,0,0,0,0,0,0,0
139658,39000,390,0,-2,1,1,0,0,0,0,0,0,0,1,1,0,0,0,0,0,0,0,0,0,0,0,0,0,0,0,0,0,0,0
140553,39000,390,0,-2,1,1,0,0,0,0,0,0,0,1,1,0,0,0,0,0,0,0,0,0,0,0,0,0,0,0,0,0,0,0
140951,39000,390,0,-2,4,2,2,0,0,0,0,0,0,0,0,0,1,0,1,0,0,0,2,2,0,0,0,0,0,0,0,1,0,1
141574,39000,390,0,-2,1,1,0,0,0,0,1,1,0,0,0,0,0,0,0,0,0,0,0,0,0,0,0,0,0,0,0,0,0,0
141644,39000,390,0,-2,1,0,1,0,0,0,0,0,0,0,0,0,0,0,0,1,0,1,0,0,0,0,0,0,0,0,0,0,0,0
141981,39000,390,0,-2,2,2,0,0,0,0,0,0,0,0,0,0,1,1,0,0,0,0,0,0,0,1,1,0,0,0,0,0,0,0
142115,39000,390,0,-2,2,1,1,0,0,0,0,0,0,0,0,0,0,0,0,0,0,0,0,0,0,1,0,1,1,1,0,0,0,0
142285,39000,390,0,-2,4,4,0,0,0,0,0,0,0,0,0,0,0,0,0,0,0,0,3,3,0,1,1,0,0,0,0,0,0,0
144050,39000,390,0,-2,2,1,1,0,0,0,0,0,0,1,1,0,0,0,0,0,0,0,1,0,1,0,0,0,0,0,0,0,0,0
144740,39000,390,0,-2,1,1,0,0,0,0,0,0,0,0,0,0,0,0,0,0,0,0,0,0,0,1,1,0,0,0,0,0,0,0
145336,39000,390,0,-2,1,1,0,0,0,0,0,0,0,0,0,0,0,0,0,0,0,0,1,1,0,0,0,0,0,0,0,0,0,0
145600,39000,390,0,-2,2,2,0,0,0,0,0,0,0,1,1,0,0,0,0,0,0,0,1,1,0,0,0,0,0,0,0,0,0,0
145637,39000,390,0,-2,16,15,1,1,1,0,0,0,0,1,1,0,0,0,0,0,0,0,12,11,1,1,1,0,1,1,0,0,0,0
145813,39000,390,0,-2,1,1,0,0,0,0,0,0,0,0,0,0,0,0,0,0,0,0,1,1,0,0,0,0,0,0,0,0,0,0
148654,39000,390,0,-2,2,2,0,0,0,0,0,0,0,0,0,0,0,0,0,0,0,0,2,2,0,0,0,0,0,0,0,0,0,0
149222,39000,390,0,-2,1,1,0,0,0,0,0,0,0,0,0,0,0,0,0,0,0,0,1,1,0,0,0,0,0,0,0,0,0,0
150455,39000,390,0,-2,1,1,0,0,0,0,0,0,0,0,0,0,0,0,0,0,0,0,1,1,0,0,0,0,0,0,0,0,0,0
151324,39000,390,0,-2,1,1,0,0,0,0,0,0,0,0,0,0,0,0,0,0,0,0,1,1,0,0,0,0,0,0,0,0,0,0
151351,39000,390,0,-2,11,8,3,0,0,0,0,0,0,0,0,0,1,0,1,0,0,0,9,7,2,1,1,0,0,0,0,0,0,0
151801,39000,390,0,-2,2,2,0,0,0,0,0,0,0,0,0,0,0,0,0,0,0,0,2,2,0,0,0,0,0,0,0,0,0,0
152080,39000,390,0,-2,1,1,0,0,0,0,0,0,0,1,1,0,0,0,0,0,0,0,0,0,0,0,0,0,0,0,0,0,0,0
152992,39000,390,0,-2,1,1,0,0,0,0,0,0,0,0,0,0,0,0,0,0,0,0,0,0,0,0,0,0,1,1,0,0,0,0
153214,39000,390,0,-2,2,2,0,0,0,0,0,0,0,0,0,0,0,0,0,0,0,0,2,2,0,0,0,0,0,0,0,0,0,0
153269,39000,390,0,-2,1,0,1,0,0,0,0,0,0,0,0,0,0,0,0,0,0,0,1,0,1,0,0,0,0,0,0,0,0,0
153384,39000,390,0,-2,1,0,1,0,0,0,0,0,0,0,0,0,0,0,0,0,0,0,1,0,1,0,0,0,0,0,0,0,0,0
153524,39000,390,0,-2,2,2,0,0,0,0,0,0,0,0,0,0,0,0,0,0,0,0,2,2,0,0,0,0,0,0,0,0,0,0
153603,39000,390,0,-2,7,7,0,0,0,0,0,0,0,0,0,0,0,0,0,0,0,0,7,7,0,0,0,0,0,0,0,0,0,0
153658,39000,390,0,-2,11,6,5,0,0,0,1,0,1,4,2,2,1,1,0,0,0,0,4,2,2,0,0,0,1,1,0,0,0,0
154095,39000,390,0,-2,2,2,0,0,0,0,0,0,0,0,0,0,0,0,0,0,0,0,2,2,0,0,0,0,0,0,0,0,0,0
154749,39000,390,0,-2,1,1,0,0,0,0,0,0,0,0,0,0,0,0,0,0,0,0,1,1,0,0,0,0,0,0,0,0,0,0
155399,39000,390,0,-2,6,6,0,0,0,0,0,0,0,0,0,0,0,0,0,0,0,0,4,4,0,1,1,0,0,0,0,1,1,0
156125,39000,390,0,-2,5,5,0,0,0,0,0,0,0,0,0,0,0,0,0,0,0,0,5,5,0,0,0,0,0,0,0,0,0,0
156286,39000,390,0,-2,1,1,0,0,0,0,0,0,0,0,0,0,0,0,0,0,0,0,1,1,0,0,0,0,0,0,0,0,0,0
156295,39000,390,0,-2,1,1,0,1,1,0,0,0,0,0,0,0,0,0,0,0,0,0,0,0,0,0,0,0,0,0,0,0,0,0
156365,39000,390,0,-2,1,1,0,0,0,0,0,0,0,0,0,0,0,0,0,0,0,0,1,1,0,0,0,0,0,0,0,0,0,0
156620,39000,390,0,-2,4,4,0,0,0,0,0,0,0,0,0,0,0,0,0,0,0,0,4,4,0,0,0,0,0,0,0,0,0,0
157058,39000,390,0,-2,1,1,0,0,0,0,0,0,0,0,0,0,0,0,0,0,0,0,0,0,0,0,0,0,1,1,0,0,0,0
157085,39000,390,0,-2,3,2,1,0,0,0,0,0,0,2,1,1,0,0,0,0,0,0,1,1,0,0,0,0,0,0,0,0,0,0
157216,39000,390,0,-2,1,1,0,0,0,0,0,0,0,0,0,0,0,0,0,0,0,0,1,1,0,0,0,0,0,0,0,0,0,0
157401,39000,390,0,-2,1,1,0,0,0,0,0,0,0,1,1,0,0,0,0,0,0,0,0,0,0,0,0,0,0,0,0,0,0,0
157951,39000,390,0,-2,4,4,0,0,0,0,0,0,0,0,0,0,0,0,0,0,0,0,3,3,0,0,0,0,1,1,0,0,0,0
159391,39000,390,0,-2,1,1,0,0,0,0,0,0,0,1,1,0,0,0,0,0,0,0,0,0,0,0,0,0,0,0,0,0,0,0
159568,39000,390,0,-2,2,2,0,0,0,0,0,0,0,0,0,0,1,1,0,0,0,0,1,1,0,0,0,0,0,0,0,0,0,0
159647,39000,390,0,-2,1,1,0,0,0,0,0,0,0,0,0,0,0,0,0,0,0,0,1,1,0,0,0,0,0,0,0,0,0,0
159656,39000,390,0,-2,1,1,0,0,0,0,0,0,0,1,1,0,0,0,0,0,0,0,0,0,0,0,0,0,0,0,0,0,0,0
160612,39000,390,0,-2,2,1,1,0,0,0,0,0,0,1,0,1,0,0,0,0,0,0,1,1,0,0,0,0,0,0,0,0,0,0
160621,39000,390,0,-2,1,1,0,0,0,0,0,0,0,1,1,0,0,0,0,0,0,0,0,0,0,0,0,0,0,0,0,0,0,0
160658,39000,390,0,-2,1,1,0,0,0,0,0,0,0,1,1,0,0,0,0,0,0,0,0,0,0,0,0,0,0,0,0,0,0,0
160755,39000,390,0,-2,1,1,0,0,0,0,0,0,0,0,0,0,0,0,0,0,0,0,1,1,0,0,0,0,0,0,0,0,0,0
161004,39000,390,0,-2,3,3,0,0,0,0,0,0,0,0,0,0,0,0,0,0,0,0,3,3,0,0,0,0,0,0,0,0,0,0
161299,39000,390,0,-2,3,3,0,0,0,0,0,0,0,0,0,0,0,0,0,0,0,0,3,3,0,0,0,0,0,0,0,0,0,0
162283,39000,390,0,-2,2,2,0,0,0,0,0,0,0,2,2,0,0,0,0,0,0,0,0,0,0,0,0,0,0,0,0,0,0,0
163268,39000,390,0,-2,2,2,0,0,0,0,0,0,0,1,1,0,0,0,0,0,0,0,1,1,0,0,0,0,0,0,0,0,0,0
163286,39000,390,0,-2,1,1,0,0,0,0,1,1,0,0,0,0,0,0,0,0,0,0,0,0,0,0,0,0,0,0,0,0,0,0
163453,39000,390,0,-2,1,1,0,0,0,0,0,0,0,1,1,0,0,0,0,0,0,0,0,0,0,0,0,0,0,0,0,0,0,0
164076,39000,390,0,-2,6,3,3,0,0,0,1,1,0,5,2,3,0,0,0,0,0,0,0,0,0,0,0,0,0,0,0,0,0,0
164155,39000,390,0,-2,2,0,2,0,0,0,0,0,0,0,0,0,0,0,0,0,0,0,2,0,2,0,0,0,0,0,0,0,0,0
164216,39000,390,0,-2,2,2,0,0,0,0,0,0,0,1,1,0,0,0,0,0,0,0,1,1,0,0,0,0,0,0,0,0,0,0
164465,39000,390,0,-2,2,1,1,0,0,0,0,0,0,0,0,0,0,0,0,0,0,0,2,1,1,0,0,0,0,0,0,0,0,0
164924,39000,390,0,-2,2,2,0,0,0,0,1,1,0,1,1,0,0,0,0,0,0,0,0,0,0,0,0,0,0,0,0,0,0,0
164988,39000,390,0,-2,3,3,0,0,0,0,0,0,0,1,1,0,0,0,0,0,0,0,2,2,0,0,0,0,0,0,0,0,0,0
166027,39000,390,0,-2,3,3,0,0,0,0,0,0,0,1,1,0,1,1,0,0,0,0,1,1,0,0,0,0,0,0,0,0,0,0
166629,39000,390,0,-2,1,1,0,0,0,0,0,0,0,0,0,0,0,0,0,0,0,0,1,1,0,0,0,0,0,0,0,0,0,0
166674,39000,390,0,-2,1,1,0,0,0,0,0,0,0,0,0,0,0,0,0,0,0,0,1,1,0,0,0,0,0,0,0,0,0,0
166683,39000,390,0,-2,2,2,0,0,0,0,0,0,0,0,0,0,0,0,0,0,0,0,2,2,0,0,0,0,0,0,0,0,0,0
166692,39000,390,0,-2,1,0,1,0,0,0,0,0,0,0,0,0,0,0,0,0,0,0,1,0,1,0,0,0,0,0,0,0,0,0
166708,39000,390,0,-2,1,1,0,0,0,0,0,0,0,0,0,0,0,0,0,0,0,0,1,1,0,0,0,0,0,0,0,0,0,0
166939,39000,390,0,-2,1,0,1,0,0,0,0,0,0,0,0,0,0,0,0,0,0,0,0,0,0,0,0,0,1,0,1,0,0,0
167093,39000,390,0,-2,1,0,1,0,0,0,0,0,0,0,0,0,0,0,0,0,0,0,0,0,0,0,0,0,1,0,1,0,0,0
167729,39000,390,0,-2,1,1,0,0,0,0,0,0,0,0,0,0,0,0,0,0,0,0,1,1,0,0,0,0,0,0,0,0,0,0
167835,39000,390,0,-2,3,3,0,0,0,0,0,0,0,0,0,0,1,1,0,0,0,0,2,2,0,0,0,0,0,0,0,0,0,0
167987,39000,390,0,-2,1,1,0,0,0,0,0,0,0,1,1,0,0,0,0,0,0,0,0,0,0,0,0,0,0,0,0,0,0,0
168281,39000,390,0,-2,2,2,0,0,0,0,0,0,0,0,0,0,0,0,0,0,0,0,2,2,0,0,0,0,0,0,0,0,0,0
168342,39000,390,0,-2,2,1,1,0,0,0,0,0,0,0,0,0,0,0,0,0,0,0,2,1,1,0,0,0,0,0,0,0,0,0
169910,39000,390,0,-2,1,1,0,0,0,0,0,0,0,0,0,0,0,0,0,0,0,0,1,1,0,0,0,0,0,0,0,0,0,0
170240,39000,390,0,-2,1,1,0,0,0,0,0,0,0,1,1,0,0,0,0,0,0,0,0,0,0,0,0,0,0,0,0,0,0,0
170301,39000,390,0,-2,1,1,0,0,0,0,0,0,0,0,0,0,1,1,0,0,0,0,0,0,0,0,0,0,0,0,0,0,0,0
170976,39000,390,0,-2,18,16,2,1,1,0,0,0,0,4,4,0,0,0,0,0,0,0,13,11,2,0,0,0,0,0,0,0,0,0
171100,39000,390,0,-2,6,6,0,0,0,0,0,0,0,1,1,0,0,0,0,0,0,0,5,5,0,0,0,0,0,0,0,0,0,0
171128,39000,390,0,-2,2,2,0,0,0,0,0,0,0,0,0,0,0,0,0,0,0,0,2,2,0,0,0,0,0,0,0,0,0,0
171535,39000,390,0,-2,1,1,0,0,0,0,0,0,0,0,0,0,0,0,0,0,0,0,0,0,0,0,0,0,1,1,0,0,0,0
172699,39000,390,0,-2,3,3,0,0,0,0,0,0,0,0,0,0,0,0,0,0,0,0,3,3,0,0,0,0,0,0,0,0,0,0
173300,39000,390,0,-2,1,1,0,0,0,0,0,0,0,0,0,0,0,0,0,0,0,0,0,0,0,0,0,0,1,1,0,0,0,0
173665,39000,390,0,-2,1,1,0,0,0,0,0,0,0,0,0,0,0,0,0,0,0,0,1,1,0,0,0,0,0,0,0,0,0,0
173902,39000,390,0,-2,2,2,0,0,0,0,0,0,0,0,0,0,0,0,0,0,0,0,2,2,0,0,0,0,0,0,0,0,0,0
174066,39000,390,0,-2,9,7,2,0,0,0,0,0,0,0,0,0,1,1,0,0,0,0,7,5,2,0,0,0,1,1,0,0,0,0
174491,39000,390,0,-2,1,0,1,0,0,0,0,0,0,0,0,0,0,0,0,0,0,0,1,0,1,0,0,0,0,0,0,0,0,0
174747,39000,390,0,-2,2,2,0,0,0,0,0,0,0,0,0,0,0,0,0,0,0,0,2,2,0,0,0,0,0,0,0,0,0,0
175616,39000,390,0,-2,1,1,0,0,0,0,0,0,0,0,0,0,0,0,0,0,0,0,1,1,0,0,0,0,0,0,0,0,0,0
175786,39000,390,0,-2,5,5,0,0,0,0,0,0,0,1,1,0,0,0,0,0,0,0,4,4,0,0,0,0,0,0,0,0,0,0
175856,39000,390,0,-2,2,2,0,0,0,0,0,0,0,1,1,0,0,0,0,0,0,0,1,1,0,0,0,0,0,0,0,0,0,0
176017,39000,390,0,-2,2,2,0,0,0,0,0,0,0,1,1,0,0,0,0,0,0,0,1,1,0,0,0,0,0,0,0,0,0,0
176044,39000,390,0,-2,1,1,0,0,0,0,0,0,0,1,1,0,0,0,0,0,0,0,0,0,0,0,0,0,0,0,0,0,0,0
176071,39000,390,0,-2,1,1,0,0,0,0,0,0,0,0,0,0,0,0,0,0,0,0,1,1,0,0,0,0,0,0,0,0,0,0
176080,39000,390,0,-2,17,14,3,0,0,0,0,0,0,9,6,3,0,0,0,0,0,0,8,8,0,0,0,0,0,0,0,0,0,0
177986,39000,390,0,-2,1,1,0,0,0,0,0,0,0,0,0,0,0,0,0,0,0,0,1,1,0,0,0,0,0,0,0,0,0,0
178396,39000,390,0,-2,9,9,0,0,0,0,0,0,0,0,0,0,0,0,0,0,0,0,9,9,0,0,0,0,0,0,0,0,0,0
178402,39000,390,0,-2,1,1,0,0,0,0,0,0,0,1,1,0,0,0,0,0,0,0,0,0,0,0,0,0,0,0,0,0,0,0
178448,39000,390,0,-2,1,0,1,0,0,0,0,0,0,0,0,0,0,0,0,0,0,0,1,0,1,0,0,0,0,0,0,0,0,0
178615,39000,390,0,-2,2,2,0,0,0,0,0,0,0,0,0,0,0,0,0,0,0,0,2,2,0,0,0,0,0,0,0,0,0,0
178624,39000,390,0,-2,2,2,0,0,0,0,0,0,0,0,0,0,0,0,0,0,0,0,2,2,0,0,0,0,0,0,0,0,0,0
178697,39000,390,0,-2,1,0,1,0,0,0,0,0,0,0,0,0,0,0,0,0,0,0,1,0,1,0,0,0,0,0,0,0,0,0
179159,39000,390,0,-2,6,4,2,0,0,0,0,0,0,2,1,1,0,0,0,0,0,0,4,3,1,0,0,0,0,0,0,0,0,0
179557,39000,390,0,-2,2,2,0,0,0,0,0,0,0,0,0,0,0,0,0,0,0,0,2,2,0,0,0,0,0,0,0,0,0,0
179867,39000,390,0,-2,9,4,5,0,0,0,0,0,0,2,1,1,0,0,0,0,0,0,7,3,4,0,0,0,0,0,0,0,0,0
180328,39000,390,0,-2,1,1,0,1,1,0,0,0,0,0,0,0,0,0,0,0,0,0,0,0,0,0,0,0,0,0,0,0,0,0
180461,39000,390,0,-2,2,1,1,0,0,0,0,0,0,0,0,0,0,0,0,0,0,0,1,0,1,0,0,0,1,1,0,0,0,0
180489,39000,390,0,-2,1,1,0,0,0,0,0,0,0,0,0,0,0,0,0,0,0,0,1,1,0,0,0,0,0,0,0,0,0,0
180948,39000,390,0,-2,1,1,0,0,0,0,0,0,0,0,0,0,0,0,0,0,0,0,1,1,0,0,0,0,0,0,0,0,0,0
181002,39000,390,0,-2,1,0,1,0,0,0,0,0,0,0,0,0,0,0,0,0,0,0,0,0,0,0,0,0,1,0,1,0,0,0
181215,39000,390,0,-2,2,2,0,0,0,0,0,0,0,0,0,0,0,0,0,0,0,0,2,2,0,0,0,0,0,0,0,0,0,0
181394,39000,390,0,-2,1,1,0,0,0,0,0,0,0,0,0,0,0,0,0,0,0,0,1,1,0,0,0,0,0,0,0,0,0,0
181464,39000,390,0,-2,9,9,0,0,0,0,0,0,0,0,0,0,1,1,0,0,0,0,8,8,0,0,0,0,0,0,0,0,0,0
182281,39000,390,0,-2,1,1,0,0,0,0,0,0,0,0,0,0,0,0,0,0,0,0,1,1,0,0,0,0,0,0,0,0,0,0
182670,39000,390,0,-2,1,1,0,0,0,0,1,1,0,0,0,0,0,0,0,0,0,0,0,0,0,0,0,0,0,0,0,0,0,0
183044,39000,390,0,-2,2,2,0,0,0,0,0,0,0,0,0,0,0,0,0,0,0,0,2,2,0,0,0,0,0,0,0,0,0,0
183062,39000,390,0,-2,1,1,0,0,0,0,0,0,0,0,0,0,0,0,0,0,0,0,1,1,0,0,0,0,0,0,0,0,0,0
184782,39000,390,0,-2,2,2,0,0,0,0,0,0,0,0,0,0,0,0,0,0,0,0,2,2,0,0,0,0,0,0,0,0,0,0
185590,39000,390,0,-2,1,1,0,0,0,0,0,0,0,1,1,0,0,0,0,0,0,0,0,0,0,0,0,0,0,0,0,0,0,0
187532,39000,390,0,-2,1,1,0,0,0,0,0,0,0,0,0,0,0,0,0,0,0,0,1,1,0,0,0,0,0,0,0,0,0,0
187967,39000,390,0,-2,1,1,0,0,0,0,0,0,0,0,0,0,0,0,0,0,0,0,1,1,0,0,0,0,0,0,0,0,0,0
187985,39000,390,0,-2,3,2,1,1,1,0,0,0,0,0,0,0,2,1,1,0,0,0,0,0,0,0,0,0,0,0,0,0,0,0
188030,39000,390,0,-2,3,2,1,0,0,0,0,0,0,0,0,0,1,1,0,0,0,0,2,1,1,0,0,0,0,0,0,0,0,0
188304,39000,390,0,-2,1,1,0,0,0,0,0,0,0,0,0,0,0,0,0,0,0,0,1,1,0,0,0,0,0,0,0,0,0,0
189088,39000,390,0,-2,2,0,2,0,0,0,0,0,0,0,0,0,0,0,0,0,0,0,2,0,2,0,0,0,0,0,0,0,0,0
190150,39000,390,0,-2,2,2,0,0,0,0,0,0,0,0,0,0,0,0,0,0,0,0,1,1,0,0,0,0,0,0,0,1,1,0
190415,39000,390,0,-2,5,4,1,0,0,0,0,0,0,1,0,1,1,1,0,0,0,0,3,3,0,0,0,0,0,0,0,0,0,0
190503,39000,390,0,-2,4,3,1,0,0,0,0,0,0,0,0,0,0,0,0,0,0,0,2,1,1,0,0,0,2,2,0,0,0,0
190512,39000,390,0,-2,2,2,0,0,0,0,1,1,0,0,0,0,0,0,0,0,0,0,1,1,0,0,0,0,0,0,0,0,0,0
190530,39000,390,0,-2,1,1,0,0,0,0,0,0,0,0,0,0,0,0,0,0,0,0,1,1,0,0,0,0,0,0,0,0,0,0
190549,39000,390,0,-2,3,3,0,0,0,0,0,0,0,0,0,0,0,0,0,0,0,0,3,3,0,0,0,0,0,0,0,0,0,0
190594,39000,390,0,-2,1,1,0,0,0,0,0,0,0,0,0,0,0,0,0,0,0,0,1,1,0,0,0,0,0,0,0,0,0,0
190619,39000,390,0,-2,2,2,0,0,0,0,0,0,0,1,1,0,0,0,0,0,0,0,1,1,0,0,0,0,0,0,0,0,0,0
190637,39000,390,0,-2,3,3,0,0,0,0,0,0,0,1,1,0,0,0,0,0,0,0,2,2,0,0,0,0,0,0,0,0,0,0
190664,39000,390,0,-2,1,1,0,0,0,0,0,0,0,0,0,0,0,0,0,0,0,0,1,1,0,0,0,0,0,0,0,0,0,0
190840,39000,390,0,-2,2,2,0,0,0,0,0,0,0,0,0,0,1,1,0,0,0,0,1,1,0,0,0,0,0,0,0,0,0,0
192110,39000,390,0,-2,1,1,0,0,0,0,0,0,0,0,0,0,0,0,0,0,0,0,1,1,0,0,0,0,0,0,0,0,0,0
192448,39000,390,0,-2,1,1,0,0,0,0,0,0,0,0,0,0,0,0,0,0,0,0,1,1,0,0,0,0,0,0,0,0,0,0
194958,39000,390,0,-2,1,1,0,0,0,0,0,0,0,0,0,0,0,0,0,0,0,0,1,1,0,0,0,0,0,0,0,0,0,0
195003,39000,390,0,-2,4,3,1,0,0,0,0,0,0,0,0,0,0,0,0,0,0,0,4,3,1,0,0,0,0,0,0,0,0,0
195030,39000,390,0,-2,30,30,0,0,0,0,1,1,0,2,2,0,0,0,0,0,0,0,25,25,0,2,2,0,0,0,0,0,0,0
195216,39000,390,0,-2,1,1,0,1,1,0,0,0,0,0,0,0,0,0,0,0,0,0,0,0,0,0,0,0,0,0,0,0,0,0
196033,39000,390,0,-2,1,1,0,0,0,0,0,0,0,0,0,0,0,0,0,0,0,0,1,1,0,0,0,0,0,0,0,0,0,0
196060,39000,390,0,-2,3,3,0,0,0,0,0,0,0,1,1,0,0,0,0,0,0,0,2,2,0,0,0,0,0,0,0,0,0,0
196097,39000,390,0,-2,8,7,1,0,0,0,0,0,0,0,0,0,0,0,0,0,0,0,8,7,1,0,0,0,0,0,0,0,0,0
196149,39000,390,0,-2,2,1,1,0,0,0,0,0,0,0,0,0,0,0,0,0,0,0,2,1,1,0,0,0,0,0,0,0,0,0
196255,39000,390,0,-2,1,1,0,0,0,0,0,0,0,1,1,0,0,0,0,0,0,0,0,0,0,0,0,0,0,0,0,0,0,0
196307,39000,390,0,-2,1,1,0,0,0,0,0,0,0,0,0,0,0,0,0,0,0,0,1,1,0,0,0,0,0,0,0,0,0,0
196413,39000,390,0,-2,3,3,0,0,0,0,0,0,0,1,1,0,0,0,0,0,0,0,2,2,0,0,0,0,0,0,0,0,0,0
196592,39000,390,0,-2,1,1,0,0,0,0,0,0,0,0,0,0,1,1,0,0,0,0,0,0,0,0,0,0,0,0,0,0,0,0
197036,39000,390,0,-2,17,11,6,0,0,0,1,0,1,2,1,1,2,2,0,0,0,0,12,8,4,0,0,0,0,0,0,0,0,0
197197,39000,390,0,-2,1,1,0,0,0,0,0,0,0,0,0,0,0,0,0,0,0,0,1,1,0,0,0,0,0,0,0,0,0,0
197869,39000,390,0,-2,4,4,0,0,0,0,0,0,0,0,0,0,0,0,0,0,0,0,4,4,0,0,0,0,0,0,0,0,0,0
197984,39000,390,0,-2,1,1,0,0,0,0,0,0,0,0,0,0,0,0,0,0,0,0,1,1,0,0,0,0,0,0,0,0,0,0
198154,39000,390,0,-2,1,1,0,0,0,0,0,0,0,0,0,0,0,0,0,0,0,0,1,1,0,0,0,0,0,0,0,0,0,0
198330,39000,390,0,-2,1,0,1,0,0,0,0,0,0,1,0,1,0,0,0,0,0,0,0,0,0,0,0,0,0,0,0,0,0,0
198419,39000,390,0,-2,4,4,0,0,0,0,0,0,0,1,1,0,0,0,0,0,0,0,3,3,0,0,0,0,0,0,0,0,0,0
198695,39000,390,0,-2,4,3,1,0,0,0,0,0,0,1,1,0,0,0,0,0,0,0,2,1,1,1,1,0,0,0,0,0,0,0
199120,39000,390,0,-2,1,0,1,0,0,0,0,0,0,1,0,1,0,0,0,0,0,0,0,0,0,0,0,0,0,0,0,0,0,0
199148,39000,390,0,-2,3,2,1,0,0,0,0,0,0,2,1,1,0,0,0,0,0,0,1,1,0,0,0,0,0,0,0,0,0,0
199193,39000,390,0,-2,4,4,0,0,0,0,0,0,0,1,1,0,0,0,0,0,0,0,3,3,0,0,0,0,0,0,0,0,0,0
199847,39000,390,0,-2,1,1,0,0,0,0,0,0,0,0,0,0,0,0,0,0,0,0,1,1,0,0,0,0,0,0,0,0,0,0
200004,39000,390,0,-2,2,0,2,0,0,0,0,0,0,0,0,0,0,0,0,0,0,0,2,0,2,0,0,0,0,0,0,0,0,0
200280,39000,390,0,-2,18,15,3,0,0,0,1,1,0,0,0,0,1,1,0,0,0,0,16,13,3,0,0,0,0,0,0,0,0,0
200305,39000,390,0,-2,1,1,0,0,0,0,0,0,0,0,0,0,0,0,0,0,0,0,1,1,0,0,0,0,0,0,0,0,0,0
200332,39000,390,0,-2,3,3,0,1,1,0,0,0,0,0,0,0,0,0,0,0,0,0,1,1,0,0,0,0,1,1,0,0,0,0
200466,39000,390,0,-2,2,1,1,1,1,0,0,0,0,0,0,0,0,0,0,0,0,0,1,0,1,0,0,0,0,0,0,0,0,0
200800,39000,390,0,-2,2,2,0,0,0,0,0,0,0,0,0,0,0,0,0,0,0,0,2,2,0,0,0,0,0,0,0,0,0,0
201654,39000,390,0,-2,2,1,1,0,0,0,0,0,0,0,0,0,0,0,0,0,0,0,1,0,1,0,0,0,1,1,0,0,0,0
202134,39000,390,0,-2,3,3,0,0,0,0,0,0,0,0,0,0,0,0,0,0,0,0,2,2,0,1,1,0,0,0,0,0,0,0
203517,39000,390,0,-2,1,1,0,0,0,0,0,0,0,0,0,0,0,0,0,0,0,0,1,1,0,0,0,0,0,0,0,0,0,0
203535,39000,390,0,-2,1,0,1,0,0,0,0,0,0,0,0,0,0,0,0,0,0,0,0,0,0,0,0,0,1,0,1,0,0,0
204501,39000,390,0,-2,1,1,0,0,0,0,0,0,0,0,0,0,0,0,0,0,0,0,1,1,0,0,0,0,0,0,0,0,0,0
204796,39000,390,0,-2,45,37,8,0,0,0,1,1,0,16,11,5,1,1,0,0,0,0,22,20,2,1,1,0,4,3,1,0,0,0
204857,39000,390,0,-2,1,1,0,0,0,0,0,0,0,0,0,0,0,0,0,0,0,0,1,1,0,0,0,0,0,0,0,0,0,0
207263,39000,390,0,-2,1,0,1,1,0,1,0,0,0,0,0,0,0,0,0,0,0,0,0,0,0,0,0,0,0,0,0,0,0,0
207290,39000,390,0,-2,2,2,0,1,1,0,0,0,0,0,0,0,0,0,0,0,0,0,1,1,0,0,0,0,0,0,0,0,0,0
207388,39000,390,0,-2,13,11,2,0,0,0,0,0,0,0,0,0,0,0,0,0,0,0,10,8,2,3,3,0,0,0,0,0,0,0
207449,39000,390,0,-2,1,1,0,0,0,0,0,0,0,0,0,0,0,0,0,0,0,0,1,1,0,0,0,0,0,0,0,0,0,0
207458,39000,390,0,-2,1,0,1,0,0,0,0,0,0,0,0,0,0,0,0,0,0,0,1,0,1,0,0,0,0,0,0,0,0,0
207500,39000,390,0,-2,4,4,0,0,0,0,0,0,0,0,0,0,0,0,0,0,0,0,4,4,0,0,0,0,0,0,0,0,0,0
209490,39000,390,0,-2,4,4,0,0,0,0,0,0,0,0,0,0,1,1,0,0,0,0,2,2,0,0,0,0,0,0,0,1,1,0
209542,39000,390,0,-2,12,10,2,0,0,0,0,0,0,0,0,0,0,0,0,0,0,0,1,1,0,0,0,0,11,9,2,0,0,0
209551,39000,390,0,-2,5,4,1,0,0,0,0,0,0,0,0,0,0,0,0,0,0,0,5,4,1,0,0,0,0,0,0,0,0,0
209746,39000,390,0,-2,1,1,0,0,0,0,0,0,0,0,0,0,0,0,0,0,0,0,1,1,0,0,0,0,0,0,0,0,0,0
210775,39000,390,0,-2,1,1,0,0,0,0,0,0,0,0,0,0,0,0,0,0,0,0,1,1,0,0,0,0,0,0,0,0,0,0
211291,39000,390,0,-2,2,2,0,0,0,0,0,0,0,0,0,0,0,0,0,0,0,0,2,2,0,0,0,0,0,0,0,0,0,0
211440,39000,390,0,-2,1,0,1,0,0,0,0,0,0,1,0,1,0,0,0,0,0,0,0,0,0,0,0,0,0,0,0,0,0,0
212054,39000,390,0,-2,5,5,0,0,0,0,0,0,0,4,4,0,0,0,0,0,0,0,1,1,0,0,0,0,0,0,0,0,0,0
212197,39000,390,0,-2,1,0,1,0,0,0,0,0,0,0,0,0,0,0,0,0,0,0,1,0,1,0,0,0,0,0,0,0,0,0
212674,39000,390,0,-2,1,0,1,0,0,0,0,0,0,0,0,0,0,0,0,0,0,0,1,0,1,0,0,0,0,0,0,0,0,0
213543,39000,390,0,-2,2,1,1,0,0,0,0,0,0,0,0,0,0,0,0,0,0,0,1,1,0,0,0,0,1,0,1,0,0,0
213987,39000,390,0,-2,1,0,1,0,0,0,0,0,0,0,0,0,0,0,0,0,0,0,1,0,1,0,0,0,0,0,0,0,0,0
215062,39000,390,0,-2,3,3,0,0,0,0,0,0,0,3,3,0,0,0,0,0,0,0,0,0,0,0,0,0,0,0,0,0,0,0
215442,39000,390,0,-2,1,0,1,0,0,0,0,0,0,0,0,0,0,0,0,0,0,0,1,0,1,0,0,0,0,0,0,0,0,0
215929,39000,390,0,-2,2,1,1,0,0,0,0,0,0,0,0,0,0,0,0,0,0,0,2,1,1,0,0,0,0,0,0,0,0,0
216339,39000,390,0,-2,3,3,0,0,0,0,0,0,0,2,2,0,0,0,0,0,0,0,1,1,0,0,0,0,0,0,0,0,0,0
216366,39000,390,0,-2,2,1,1,0,0,0,0,0,0,1,0,1,0,0,0,0,0,0,1,1,0,0,0,0,0,0,0,0,0,0
216597,39000,390,0,-2,3,3,0,0,0,0,0,0,0,0,0,0,0,0,0,0,0,0,3,3,0,0,0,0,0,0,0,0,0,0
217235,39000,390,0,-2,3,3,0,0,0,0,0,0,0,1,1,0,0,0,0,0,0,0,2,2,0,0,0,0,0,0,0,0,0,0
217402,39000,390,0,-2,1,1,0,0,0,0,0,0,0,0,0,0,0,0,0,0,0,0,1,1,0,0,0,0,0,0,0,0,0,0
217484,39000,390,0,-2,1,1,0,0,0,0,0,0,0,0,0,0,0,0,0,0,0,0,1,1,0,0,0,0,0,0,0,0,0,0
217633,39000,390,0,-2,2,1,1,0,0,0,0,0,0,0,0,0,0,0,0,0,0,0,2,1,1,0,0,0,0,0,0,0,0,0
217864,39000,390,0,-2,1,0,1,0,0,0,0,0,0,0,0,0,0,0,0,0,0,0,0,0,0,0,0,0,1,0,1,0,0,0
217882,39000,390,0,-2,3,0,3,0,0,0,0,0,0,0,0,0,0,0,0,0,0,0,3,0,3,0,0,0,0,0,0,0,0,0
218061,39000,390,0,-2,1,0,1,0,0,0,0,0,0,1,0,1,0,0,0,0,0,0,0,0,0,0,0,0,0,0,0,0,0,0
218229,39000,390,0,-2,3,1,2,0,0,0,0,0,0,1,0,1,0,0,0,0,0,0,2,1,1,0,0,0,0,0,0,0,0,0
218663,39000,390,0,-2,2,1,1,0,0,0,1,0,1,0,0,0,0,0,0,0,0,0,1,1,0,0,0,0,0,0,0,0,0,0
218724,39000,390,0,-2,3,3,0,0,0,0,0,0,0,0,0,0,0,0,0,0,0,0,3,3,0,0,0,0,0,0,0,0,0,0
218964,39000,390,0,-2,1,1,0,0,0,0,0,0,0,0,0,0,0,0,0,0,0,0,1,1,0,0,0,0,0,0,0,0,0,0
218973,39000,390,0,-2,1,1,0,0,0,0,0,0,0,0,0,0,0,0,0,0,0,0,0,0,0,0,0,0,1,1,0,0,0,0
219709,39000,390,0,-2,2,2,0,0,0,0,0,0,0,0,0,0,0,0,0,0,0,0,2,2,0,0,0,0,0,0,0,0,0,0
220075,39000,390,0,-2,6,5,1,0,0,0,0,0,0,0,0,0,0,0,0,0,0,0,6,5,1,0,0,0,0,0,0,0,0,0
220215,39000,390,0,-2,1,1,0,0,0,0,0,0,0,0,0,0,0,0,0,0,0,0,1,1,0,0,0,0,0,0,0,0,0,0
220862,39000,390,0,-2,1,1,0,0,0,0,0,0,0,0,0,0,0,0,0,0,0,0,1,1,0,0,0,0,0,0,0,0,0,0
220978,39000,390,0,-2,3,3,0,0,0,0,0,0,0,0,0,0,0,0,0,0,0,0,3,3,0,0,0,0,0,0,0,0,0,0
221519,39000,390,0,-2,2,1,1,0,0,0,0,0,0,0,0,0,0,0,0,0,0,0,2,1,1,0,0,0,0,0,0,0,0,0
221661,39000,390,0,-2,2,2,0,0,0,0,0,0,0,0,0,0,0,0,0,0,0,0,1,1,0,0,0,0,1,1,0,0,0,0
221759,39000,390,0,-2,2,2,0,0,0,0,0,0,0,0,0,0,0,0,0,0,0,0,2,2,0,0,0,0,0,0,0,0,0,0
221768,39000,390,0,-2,1,1,0,0,0,0,0,0,0,0,0,0,0,0,0,0,0,0,1,1,0,0,0,0,0,0,0,0,0,0
221999,39000,390,0,-2,9,8,1,0,0,0,0,0,0,2,2,0,1,1,0,0,0,0,6,5,1,0,0,0,0,0,0,0,0,0
222576,39000,390,0,-2,4,4,0,0,0,0,0,0,0,0,0,0,0,0,0,0,0,0,4,4,0,0,0,0,0,0,0,0,0,0
223223,39000,390,0,-2,5,4,1,0,0,0,0,0,0,0,0,0,2,2,0,0,0,0,3,2,1,0,0,0,0,0,0,0,0,0
223816,39000,390,0,-2,1,0,1,0,0,0,0,0,0,0,0,0,1,0,1,0,0,0,0,0,0,0,0,0,0,0,0,0,0,0
224147,39000,390,0,-2,2,2,0,0,0,0,0,0,0,0,0,0,0,0,0,0,0,0,2,2,0,0,0,0,0,0,0,0,0,0
225511,39000,390,0,-2,1,1,0,0,0,0,0,0,0,1,1,0,0,0,0,0,0,0,0,0,0,0,0,0,0,0,0,0,0,0
225627,39000,390,0,-2,3,3,0,0,0,0,0,0,0,0,0,0,1,1,0,0,0,0,2,2,0,0,0,0,0,0,0,0,0,0
227757,39000,390,0,-2,7,5,2,0,0,0,0,0,0,5,3,2,1,1,0,0,0,0,0,0,0,0,0,0,1,1,0,0,0,0
228343,39000,390,0,-2,2,2,0,0,0,0,0,0,0,1,1,0,0,0,0,0,0,0,1,1,0,0,0,0,0,0,0,0,0,0
228459,39000,390,0,-2,6,5,1,0,0,0,0,0,0,0,0,0,2,2,0,0,0,0,4,3,1,0,0,0,0,0,0,0,0,0
228547,39000,390,0,-2,3,2,1,0,0,0,0,0,0,1,1,0,0,0,0,0,0,0,2,1,1,0,0,0,0,0,0,0,0,0
228635,39000,390,0,-2,5,3,2,0,0,0,0,0,0,1,0,1,0,0,0,1,1,0,1,1,0,2,1,1,0,0,0,0,0,0
228644,39000,390,0,-2,23,13,10,1,1,0,0,0,0,0,0,0,9,3,6,0,0,0,4,2,2,0,0,0,9,7,2,0,0,0
228723,39000,390,0,-2,12,10,2,0,0,0,0,0,0,2,1,1,1,1,0,0,0,0,8,7,1,0,0,0,1,1,0,0,0,0
228778,39000,390,0,-2,20,17,3,0,0,0,2,2,0,1,0,1,5,4,1,0,0,0,12,11,1,0,0,0,0,0,0,0,0,0
228796,39000,390,0,-2,4,4,0,0,0,0,0,0,0,0,0,0,4,4,0,0,0,0,0,0,0,0,0,0,0,0,0,0,0,0
228909,39000,390,0,-2,2,1,1,0,0,0,0,0,0,0,0,0,0,0,0,0,0,0,1,0,1,0,0,0,1,1,0,0,0,0
229027,39000,390,0,-2,5,4,1,0,0,0,0,0,0,1,1,0,1,1,0,0,0,0,1,0,1,0,0,0,2,2,0,0,0,0
229063,39000,390,0,-2,1,1,0,0,0,0,0,0,0,0,0,0,1,1,0,0,0,0,0,0,0,0,0,0,0,0,0,0,0,0
229115,39000,390,0,-2,12,8,4,0,0,0,0,0,0,0,0,0,3,2,1,0,0,0,9,6,3,0,0,0,0,0,0,0,0,0
229179,39000,390,0,-2,1,1,0,0,0,0,0,0,0,0,0,0,0,0,0,0,0,0,1,1,0,0,0,0,0,0,0,0,0,0
229300,39000,390,0,-2,2,1,1,0,0,0,0,0,0,1,1,0,1,0,1,0,0,0,0,0,0,0,0,0,0,0,0,0,0,0
229337,39000,390,0,-2,2,2,0,0,0,0,0,0,0,0,0,0,0,0,0,0,0,0,2,2,0,0,0,0,0,0,0,0,0,0
229799,39000,390,0,-2,1,0,1,0,0,0,0,0,0,0,0,0,0,0,0,0,0,0,0,0,0,0,0,0,1,0,1,0,0,0
230038,39000,390,0,-2,2,2,0,0,0,0,0,0,0,0,0,0,1,1,0,0,0,0,1,1,0,0,0,0,0,0,0,0,0,0
230171,39000,390,0,-2,1,1,0,0,0,0,0,0,0,0,0,0,0,0,0,0,0,0,1,1,0,0,0,0,0,0,0,0,0,0
230603,39000,390,0,-2,24,22,2,0,0,0,0,0,0,1,1,0,2,2,0,0,0,0,20,19,1,1,0,1,0,0,0,0,0,0
230728,39000,390,0,-2,2,2,0,0,0,0,0,0,0,0,0,0,0,0,0,0,0,0,2,2,0,0,0,0,0,0,0,0,0,0
230737,39000,390,0,-2,2,2,0,0,0,0,0,0,0,0,0,0,0,0,0,0,0,0,2,2,0,0,0,0,0,0,0,0,0,0
230764,39000,390,0,-2,11,8,3,0,0,0,1,0,1,0,0,0,3,3,0,0,0,0,6,4,2,0,0,0,1,1,0,0,0,0
230959,39000,390,0,-2,1,1,0,0,0,0,0,0,0,0,0,0,0,0,0,0,0,0,1,1,0,0,0,0,0,0,0,0,0,0
231624,39000,390,0,-2,3,3,0,0,0,0,0,0,0,0,0,0,0,0,0,0,0,0,3,3,0,0,0,0,0,0,0,0,0,0
232186,39000,390,0,-2,1,1,0,0,0,0,1,1,0,0,0,0,0,0,0,0,0,0,0,0,0,0,0,0,0,0,0,0,0,0
232423,39000,390,0,-2,5,5,0,0,0,0,0,0,0,0,0,0,0,0,0,0,0,0,5,5,0,0,0,0,0,0,0,0,0,0
232557,39000,390,0,-2,23,18,5,0,0,0,2,1,1,2,1,1,1,0,1,0,0,0,18,16,2,0,0,0,0,0,0,0,0,0
232566,39000,390,0,-2,2,2,0,0,0,0,0,0,0,0,0,0,0,0,0,0,0,0,2,2,0,0,0,0,0,0,0,0,0,0
232609,39000,390,0,-2,1,1,0,0,0,0,0,0,0,0,0,0,0,0,0,0,0,0,1,1,0,0,0,0,0,0,0,0,0,0
232982,39000,390,0,-2,1,1,0,0,0,0,0,0,0,0,0,0,0,0,0,0,0,0,1,1,0,0,0,0,0,0,0,0,0,0
233374,39000,390,0,-2,1,1,0,0,0,0,0,0,0,1,1,0,0,0,0,0,0,0,0,0,0,0,0,0,0,0,0,0,0,0
233921,39000,390,0,-2,9,8,1,0,0,0,0,0,0,0,0,0,0,0,0,0,0,0,9,8,1,0,0,0,0,0,0,0,0,0
234076,39000,390,0,-2,8,7,1,0,0,0,0,0,0,0,0,0,0,0,0,0,0,0,8,7,1,0,0,0,0,0,0,0,0,0
234085,39000,390,0,-2,11,1,10,0,0,0,0,0,0,0,0,0,0,0,0,0,0,0,11,1,10,0,0,0,0,0,0,0,0,0
234155,39000,390,0,-2,1,1,0,0,0,0,0,0,0,0,0,0,0,0,0,0,0,0,1,1,0,0,0,0,0,0,0,0,0,0
234979,39000,390,0,-2,1,1,0,0,0,0,0,0,0,0,0,0,1,1,0,0,0,0,0,0,0,0,0,0,0,0,0,0,0,0
235316,39000,390,0,-2,3,2,1,0,0,0,0,0,0,1,1,0,0,0,0,0,0,0,1,0,1,0,0,0,1,1,0,0,0,0
236230,39000,390,0,-2,1,0,1,0,0,0,0,0,0,0,0,0,1,0,1,0,0,0,0,0,0,0,0,0,0,0,0,0,0,0
236939,39000,390,0,-2,5,4,1,0,0,0,0,0,0,0,0,0,0,0,0,0,0,0,1,1,0,0,0,0,4,3,1,0,0,0
236948,39000,390,0,-2,14,14,0,1,1,0,1,1,0,0,0,0,0,0,0,1,1,0,11,11,0,0,0,0,0,0,0,0,0,0
237011,39000,390,0,-2,1,1,0,0,0,0,0,0,0,0,0,0,0,0,0,0,0,0,1,1,0,0,0,0,0,0,0,0,0,0
238032,39000,390,0,-2,1,1,0,0,0,0,0,0,0,1,1,0,0,0,0,0,0,0,0,0,0,0,0,0,0,0,0,0,0,0
238759,39000,390,0,-2,1,1,0,0,0,0,0,0,0,0,0,0,0,0,0,0,0,0,1,1,0,0,0,0,0,0,0,0,0,0
240189,39000,390,0,-2,4,4,0,0,0,0,0,0,0,0,0,0,0,0,0,0,0,0,4,4,0,0,0,0,0,0,0,0,0,0
240268,39000,390,0,-2,4,4,0,0,0,0,0,0,0,0,0,0,0,0,0,0,0,0,2,2,0,0,0,0,2,2,0,0,0,0
240277,39000,390,0,-2,1,1,0,0,0,0,0,0,0,0,0,0,0,0,0,0,0,0,1,1,0,0,0,0,0,0,0,0,0,0
240329,39000,390,0,-2,2,2,0,0,0,0,0,0,0,0,0,0,0,0,0,0,0,0,1,1,0,0,0,0,1,1,0,0,0,0
240365,39000,390,0,-2,1,1,0,0,0,0,0,0,0,0,0,0,0,0,0,0,0,0,1,1,0,0,0,0,0,0,0,0,0,0
240374,39000,390,0,-2,4,4,0,0,0,0,0,0,0,1,1,0,2,2,0,0,0,0,0,0,0,0,0,0,1,1,0,0,0,0
240417,39000,390,0,-2,1,1,0,0,0,0,0,0,0,0,0,0,0,0,0,0,0,0,1,1,0,0,0,0,0,0,0,0,0,0
240444,39000,390,0,-2,5,5,0,0,0,0,0,0,0,0,0,0,0,0,0,0,0,0,4,4,0,0,0,0,1,1,0,0,0,0
240453,39000,390,0,-2,2,2,0,0,0,0,0,0,0,0,0,0,0,0,0,0,0,0,2,2,0,0,0,0,0,0,0,0,0,0
240471,39000,390,0,-2,4,3,1,0,0,0,0,0,0,0,0,0,0,0,0,0,0,0,4,3,1,0,0,0,0,0,0,0,0,0
240480,39000,390,0,-2,3,3,0,0,0,0,0,0,0,0,0,0,0,0,0,1,1,0,2,2,0,0,0,0,0,0,0,0,0,0
240727,39000,390,0,-2,9,8,1,0,0,0,1,1,0,0,0,0,1,1,0,0,0,0,6,5,1,1,1,0,0,0,0,0,0,0
240754,39000,390,0,-2,2,1,1,0,0,0,2,1,1,0,0,0,0,0,0,0,0,0,0,0,0,0,0,0,0,0,0,0,0,0
243081,39000,390,0,-2,1,1,0,0,0,0,0,0,0,0,0,0,1,1,0,0,0,0,0,0,0,0,0,0,0,0,0,0,0,0
243780,39000,390,0,-2,7,7,0,0,0,0,0,0,0,0,0,0,0,0,0,0,0,0,6,6,0,1,1,0,0,0,0,0,0,0
364025,39000,390,0,-2,1,0,1,1,0,1,0,0,0,0,0,0,0,0,0,0,0,0,0,0,0,0,0,0,0,0,0,0,0,0
384254,39000,390,0,-2,2,0,2,0,0,0,0,0,0,1,0,1,0,0,0,0,0,0,1,0,1,0,0,0,0,0,0,0,0,0
404222,39000,390,0,-2,1,0,1,0,0,0,0,0,0,0,0,0,1,0,1,0,0,0,0,0,0,0,0,0,0,0,0,0,0,0
409315,39000,390,0,-2,1,1,0,0,0,0,0,0,0,0,0,0,1,1,0,0,0,0,0,0,0,0,0,0,0,0,0,0,0,0
409698,39000,390,0,-2,1,1,0,0,0,0,0,0,0,0,0,0,1,1,0,0,0,0,0,0,0,0,0,0,0,0,0,0,0,0
434672,39000,390,0,-2,1,1,0,0,0,0,0,0,0,0,0,0,0,0,0,0,0,0,1,1,0,0,0,0,0,0,0,0,0,0
443410,39000,390,0,-2,1,1,0,0,0,0,1,1,0,0,0,0,0,0,0,0,0,0,0,0,0,0,0,0,0,0,0,0,0,0
443599,39000,390,0,-2,1,1,0,0,0,0,0,0,0,0,0,0,0,0,0,0,0,0,1,1,0,0,0,0,0,0,0,0,0,0
445188,39000,390,0,-2,1,1,0,0,0,0,0,0,0,0,0,0,0,0,0,0,0,0,0,0,0,0,0,0,1,1,0,0,0,0
446561,39000,390,0,-2,3,3,0,0,0,0,0,0,0,0,0,0,1,1,0,0,0,0,2,2,0,0,0,0,0,0,0,0,0,0
461148,39000,390,0,-2,1,0,1,0,0,0,0,0,0,0,0,0,1,0,1,0,0,0,0,0,0,0,0,0,0,0,0,0,0,0
487320,39000,390,0,-2,2,2,0,0,0,0,0,0,0,0,0,0,1,1,0,0,0,0,0,0,0,0,0,0,1,1,0,0,0,0
494603,39000,390,0,-2,1,1,0,0,0,0,0,0,0,0,0,0,0,0,0,0,0,0,1,1,0,0,0,0,0,0,0,0,0,0
495767,39000,390,0,-2,6,6,0,0,0,0,0,0,0,0,0,0,0,0,0,0,0,0,6,6,0,0,0,0,0,0,0,0,0,0
